flowDurationMilliseconds,protocolIdentifier,TotPackets,TotBytes,packetTotalCount,octetTotalCount,averageInterarrivalTime,maxPacketSize,bytesPerPacket,reversePacketTotalCount,reverseOctetTotalCount,reverseAverageInterarrivalTime,reverseMaxPacketSize,reverseBytesPerPacket
310.436,17,20,1124,10,716,34477.0,48.0,43.0,10,408,34478.0,20.0,12.0
0.005,6,10,1989,5,927,1.0,659.0,659.0,5,1062,1.0,794.0,794.0
0.055,17,2,144,1,64,0.0,36.0,36.0,1,80,0.0,52.0,52.0
0.004,6,10,2000,5,927,1.0,659.0,659.0,5,1073,1.0,805.0,805.0
0.006,6,10,1689,5,839,1.0,571.0,571.0,5,850,1.0,582.0,582.0
0.013,6,10,1989,5,910,3.0,642.0,642.0,5,1079,3.0,811.0,811.0
0.013,6,10,1631,5,848,3.0,580.0,580.0,5,783,3.0,515.0,515.0
40.048,17,10,676,5,460,10011.0,104.0,64.0,5,216,10011.0,20.0,15.0
0.04,17,2,152,1,76,0.0,48.0,48.0,1,76,0.0,48.0,48.0
0.006,6,10,1547,5,764,1.0,496.0,496.0,5,783,1.0,515.0,515.0
0.006,6,10,1547,5,764,1.0,496.0,496.0,5,783,1.0,515.0,515.0
10.782,17,26,4101,13,1822,889.0,269.0,112.0,13,2279,889.0,586.0,147.0
0.004,6,10,2006,5,927,1.0,659.0,659.0,5,1079,1.0,811.0,811.0
0.068,6,10,1506,5,395,15.0,127.0,127.0,5,1111,13.0,843.0,843.0
0.004,6,10,1779,5,928,1.0,660.0,660.0,5,851,1.0,583.0,583.0
0.012,6,10,1983,5,910,3.0,642.0,642.0,5,1073,3.0,805.0,805.0
0.038,6,10,1972,5,910,9.0,642.0,642.0,5,1062,9.0,794.0,794.0
0.012,6,10,1631,5,848,3.0,580.0,580.0,5,783,3.0,515.0,515.0
0.076,6,10,1506,5,395,17.0,127.0,127.0,5,1111,18.0,843.0,843.0
1.353,6,20,9197,11,3370,135.0,1414.0,729.0,9,5827,136.0,1414.0,1091.0
0.004,6,10,2006,5,927,1.0,659.0,659.0,5,1079,1.0,811.0,811.0
8.981,6,39,10487,20,4929,472.0,1360.0,682.0,19,5558,487.0,2667.0,435.0
0.071,17,4,596,2,122,0.0,33.0,33.0,2,474,34.0,323.0,209.0
0.005,6,10,1989,5,927,1.0,659.0,659.0,5,1062,1.0,794.0,794.0
0.007,6,10,1547,5,764,1.0,496.0,496.0,5,783,1.0,515.0,515.0
0.005,17,2,164,1,74,0.0,46.0,46.0,1,90,0.0,62.0,62.0
0.162,6,10,1506,5,395,34.0,127.0,127.0,5,1111,29.0,843.0,843.0
0.022,6,10,1677,5,827,5.0,559.0,559.0,5,850,5.0,582.0,582.0
0.007,6,10,1989,5,910,1.0,642.0,642.0,5,1079,1.0,811.0,811.0
0.016,6,10,1989,5,910,4.0,642.0,642.0,5,1079,4.0,811.0,811.0
1777.941,17,144,41760,72,22752,25041.0,288.0,288.0,72,19008,25041.0,236.0,236.0
0.022,6,10,1990,5,911,5.0,643.0,643.0,5,1079,5.0,811.0,811.0
0.901,6,26,5776,13,1666,65.0,267.0,142.0,13,4110,62.0,1414.0,597.0
0.018,6,10,1762,5,911,4.0,643.0,643.0,5,851,4.0,583.0,583.0
178.351,17,84,12045,42,2807,4349.0,44.0,38.0,42,9238,4349.0,261.0,191.0
0.007,6,10,1989,5,910,1.0,642.0,642.0,5,1079,1.0,811.0,811.0
0.005,6,10,2007,5,928,1.0,660.0,660.0,5,1079,1.0,811.0,811.0
0.005,6,10,1779,5,928,1.0,660.0,660.0,5,851,1.0,583.0,583.0
354.03,6,21,1795,16,1030,23602.0,190.0,190.0,5,765,60002.0,464.0,248.0
0.132,17,2,144,1,64,0.0,36.0,36.0,1,80,0.0,52.0,52.0
0.019,6,13,3735,7,497,3.0,125.0,125.0,6,3238,3.0,1470.0,1459.0
0.012,6,10,1631,5,848,3.0,580.0,580.0,5,783,2.0,515.0,515.0
10.966,17,34,6370,17,2658,678.0,270.0,128.0,17,3712,678.0,1146.0,190.0
0.005,6,10,2000,5,927,1.0,659.0,659.0,5,1073,1.0,805.0,805.0
0.069,17,8,3613,4,1874,23.0,1350.0,440.0,4,1739,11.0,1350.0,406.0
241.239,6,401,349097,201,21975,1206.0,2736.0,959.0,200,327122,1212.0,2804.0,1666.0
0.113,6,10,1506,5,395,25.0,127.0,127.0,5,1111,25.0,843.0,843.0
0.099,6,10,1506,5,395,21.0,127.0,127.0,5,1111,20.0,843.0,843.0
1778.239,17,144,45504,72,22752,25045.0,288.0,288.0,72,22752,25045.0,288.0,288.0
0.005,6,10,2007,5,928,1.0,660.0,660.0,5,1079,1.0,811.0,811.0
174.466,17,86,12473,43,2885,4153.0,44.0,39.0,43,9588,4153.0,239.0,194.0
0.012,6,10,1990,5,911,2.0,643.0,643.0,5,1079,3.0,811.0,811.0
0.001,17,2,136,1,60,0.0,32.0,32.0,1,76,0.0,48.0,48.0
0.001,17,2,180,1,66,0.0,38.0,38.0,1,114,0.0,86.0,86.0
0.011,6,10,1972,5,910,2.0,642.0,642.0,5,1062,2.0,794.0,794.0
300.084,6,19,4660,11,1102,30008.0,238.0,130.0,8,3558,42868.0,1402.0,786.0
0.004,6,10,2007,5,928,1.0,660.0,660.0,5,1079,1.0,811.0,811.0
308.303,17,20,1124,10,716,34241.0,48.0,43.0,10,408,34241.0,20.0,12.0
335.908,6,36,11145,19,3071,18661.0,676.0,345.0,17,8074,20994.0,1402.0,719.0
0.016,6,10,1989,5,910,3.0,642.0,642.0,5,1079,3.0,811.0,811.0
0.003,17,2,136,1,60,0.0,32.0,32.0,1,76,0.0,48.0,48.0
289.403,6,388,348788,186,21249,1564.0,2692.0,889.0,202,327539,1439.0,2804.0,1686.0
0.005,6,10,2006,5,927,1.0,659.0,659.0,5,1079,1.0,811.0,811.0
0.008,6,10,1990,5,911,2.0,643.0,643.0,5,1079,1.0,811.0,811.0
0.004,17,2,136,1,60,0.0,32.0,32.0,1,76,0.0,48.0,48.0
0.005,6,10,1689,5,839,1.0,571.0,571.0,5,850,1.0,582.0,582.0
0.007,6,10,2007,5,928,1.0,660.0,660.0,5,1079,1.0,811.0,811.0
0.004,6,10,2000,5,927,1.0,659.0,659.0,5,1073,1.0,805.0,805.0
0.003,17,2,148,1,60,0.0,32.0,32.0,1,88,0.0,60.0,60.0
0.006,6,10,1643,5,860,1.0,592.0,592.0,5,783,1.0,515.0,515.0
0.014,6,10,1989,5,910,3.0,642.0,642.0,5,1079,3.0,811.0,811.0
0.005,6,10,2006,5,927,1.0,659.0,659.0,5,1079,1.0,811.0,811.0
0.075,6,10,1506,5,395,17.0,127.0,127.0,5,1111,15.0,843.0,843.0
0.008,6,10,1989,5,910,1.0,642.0,642.0,5,1079,2.0,811.0,811.0
0.005,6,10,2000,5,927,1.0,659.0,659.0,5,1073,1.0,805.0,805.0
0.005,17,2,170,1,65,0.0,37.0,37.0,1,105,0.0,77.0,77.0
1790.467,6,320,36280,161,16860,11190.0,2736.0,529.0,159,19420,11332.0,1625.0,76.0
1793.493,6,487,98813,246,87583,7319.0,421.0,368.0,241,11230,7472.0,53.0,53.0
40.064,17,10,676,5,460,10015.0,104.0,64.0,5,216,10015.0,20.0,15.0
0.085,6,10,1506,5,395,19.0,127.0,127.0,5,1111,18.0,843.0,843.0
0.018,6,10,1989,5,910,4.0,642.0,642.0,5,1079,4.0,811.0,811.0
0.006,6,10,1547,5,764,1.0,496.0,496.0,5,783,1.0,515.0,515.0
0.031,6,10,1989,5,910,7.0,642.0,642.0,5,1079,7.0,811.0,811.0
0.057,6,10,1506,5,395,13.0,127.0,127.0,5,1111,11.0,843.0,843.0
0.004,6,10,1989,5,927,1.0,659.0,659.0,5,1062,1.0,794.0,794.0
0.094,6,10,1506,5,395,20.0,127.0,127.0,5,1111,21.0,843.0,843.0
241.164,6,296,343350,117,17593,2079.0,2736.0,885.0,179,325757,1354.0,3940.0,1872.0
0.062,6,10,1506,5,395,13.0,127.0,127.0,5,1111,15.0,843.0,843.0
158.503,17,76,10855,38,2545,4283.0,44.0,38.0,38,8310,4283.0,261.0,190.0
40.085,17,10,676,5,460,10018.0,104.0,64.0,5,216,10020.0,20.0,15.0
310.262,17,20,1124,10,716,34459.0,48.0,43.0,10,408,34459.0,20.0,12.0
174.409,17,102,14771,51,3448,3488.0,44.0,39.0,51,11323,3488.0,239.0,194.0
351.989,6,20,2210,6,1308,12003.0,494.0,494.0,14,902,27075.0,83.0,83.0
0.005,6,14,3742,8,504,0.0,80.0,80.0,6,3238,0.0,1470.0,1459.0
0.006,6,10,1547,5,764,1.0,496.0,496.0,5,783,1.0,515.0,515.0
0.108,6,10,1506,5,395,21.0,127.0,127.0,5,1111,22.0,843.0,843.0
0.001,17,2,166,1,75,0.0,47.0,47.0,1,91,0.0,63.0,63.0
0.025,6,10,1989,5,910,6.0,642.0,642.0,5,1079,6.0,811.0,811.0
0.004,6,10,1989,5,927,1.0,659.0,659.0,5,1062,1.0,794.0,794.0
0.012,6,14,3787,7,497,1.0,125.0,125.0,7,3290,2.0,1448.0,972.0
0.008,6,13,3735,7,497,1.0,125.0,125.0,6,3238,1.0,1470.0,1459.0
0.005,17,2,164,1,74,0.0,46.0,46.0,1,90,0.0,62.0,62.0
0.093,6,10,1506,5,395,21.0,127.0,127.0,5,1111,19.0,843.0,843.0
0.001,17,2,180,1,66,0.0,38.0,38.0,1,114,0.0,86.0,86.0
0.015,6,10,1983,5,910,3.0,642.0,642.0,5,1073,3.0,805.0,805.0
40.053,17,10,676,5,460,10011.0,104.0,64.0,5,216,10012.0,20.0,15.0
0.008,6,12,1926,6,1189,1.0,659.0,434.0,6,737,1.0,417.0,417.0
0.01,6,10,1983,5,910,2.0,642.0,642.0,5,1073,2.0,805.0,805.0
0.005,17,2,170,1,65,0.0,37.0,37.0,1,105,0.0,77.0,77.0
0.005,6,10,2006,5,927,1.0,659.0,659.0,5,1079,1.0,811.0,811.0
0.006,6,10,1547,5,764,1.0,496.0,496.0,5,783,1.0,515.0,515.0
0.006,6,10,1689,5,839,1.0,571.0,571.0,5,850,1.0,582.0,582.0
40.067,17,10,676,5,460,10015.0,104.0,64.0,5,216,10015.0,20.0,15.0
290.322,6,423,350044,191,21484,1528.0,2736.0,888.0,232,328560,1256.0,2804.0,1458.0
0.114,6,10,1506,5,395,26.0,127.0,127.0,5,1111,24.0,843.0,843.0
308.566,17,20,1124,10,716,34278.0,48.0,43.0,10,408,34278.0,20.0,12.0
1761.22,6,64,7360,42,4484,42956.0,1640.0,109.0,22,2876,83859.0,1112.0,82.0
0.005,6,13,3690,7,452,0.0,80.0,80.0,6,3238,1.0,1470.0,1459.0
308.713,17,20,1124,10,716,34294.0,48.0,43.0,10,408,34294.0,20.0,12.0
0.013,6,10,1989,5,910,3.0,642.0,642.0,5,1079,3.0,811.0,811.0
0.001,17,2,142,1,63,0.0,35.0,35.0,1,79,0.0,51.0,51.0
0.005,6,10,1547,5,764,1.0,496.0,496.0,5,783,1.0,515.0,515.0
40.067,17,10,676,5,460,10014.0,104.0,64.0,5,216,10015.0,20.0,15.0
0.004,6,10,1774,5,923,1.0,655.0,655.0,5,851,1.0,583.0,583.0
0.039,17,2,182,1,65,0.0,37.0,37.0,1,117,0.0,89.0,89.0
0.013,6,10,1989,5,910,3.0,642.0,642.0,5,1079,3.0,811.0,811.0
0.013,6,10,1989,5,910,3.0,642.0,642.0,5,1079,3.0,811.0,811.0
0.039,17,4,284,2,120,0.0,32.0,32.0,2,164,36.0,60.0,54.0
0.14,6,10,1506,5,395,33.0,127.0,127.0,5,1111,32.0,843.0,843.0
0.056,17,4,284,2,120,0.0,32.0,32.0,2,164,46.0,60.0,54.0
1770.307,6,84,4420,42,2210,43177.0,26.0,26.0,42,2210,43177.0,26.0,26.0
0.005,6,10,1774,5,923,1.0,655.0,655.0,5,851,1.0,583.0,583.0
0.015,6,10,1989,5,910,3.0,642.0,642.0,5,1079,3.0,811.0,811.0
240.015,6,9,787,5,488,60003.0,232.0,232.0,4,299,80003.0,83.0,83.0
0.006,6,10,2006,5,927,1.0,659.0,659.0,5,1079,1.0,811.0,811.0
0.018,6,10,1989,5,910,4.0,642.0,642.0,5,1079,4.0,811.0,811.0
0.005,6,10,1689,5,839,1.0,571.0,571.0,5,850,1.0,582.0,582.0
0.071,17,2,144,1,64,0.0,36.0,36.0,1,80,0.0,52.0,52.0
0.008,6,10,1972,5,910,2.0,642.0,642.0,5,1062,2.0,794.0,794.0
0.004,6,10,1989,5,927,1.0,659.0,659.0,5,1062,1.0,794.0,794.0
0.005,6,14,3742,8,504,0.0,80.0,80.0,6,3238,0.0,1470.0,1459.0
0.064,6,10,1506,5,395,15.0,127.0,127.0,5,1111,14.0,843.0,843.0
309.076,17,20,1124,10,716,34327.0,48.0,43.0,10,408,34327.0,20.0,12.0
0.006,6,10,2000,5,927,1.0,659.0,659.0,5,1073,1.0,805.0,805.0
40.067,17,10,676,5,460,10013.0,104.0,64.0,5,216,10015.0,20.0,15.0
10.818,17,28,4422,14,1994,823.0,269.0,114.0,14,2428,823.0,587.0,145.0
1772.37,6,105,6270,60,3525,30039.0,27.0,27.0,45,2745,40280.0,27.0,27.0
0.005,6,10,2006,5,927,1.0,659.0,659.0,5,1079,1.0,811.0,811.0
1.286,6,20,9197,11,3370,128.0,1414.0,729.0,9,5827,130.0,1414.0,1091.0
0.006,6,10,1547,5,764,1.0,496.0,496.0,5,783,1.0,515.0,515.0
0.004,6,10,2000,5,927,1.0,659.0,659.0,5,1073,1.0,805.0,805.0
0.005,17,2,168,1,76,0.0,48.0,48.0,1,92,0.0,64.0,64.0
0.166,17,2,152,1,76,0.0,48.0,48.0,1,76,0.0,48.0,48.0
0.022,6,10,1972,5,910,5.0,642.0,642.0,5,1062,5.0,794.0,794.0
300.416,6,16,2170,9,684,37531.0,146.0,146.0,7,1486,50041.0,419.0,398.0
0.013,6,10,1972,5,910,3.0,642.0,642.0,5,1062,3.0,794.0,794.0
0.017,6,10,1989,5,910,4.0,642.0,642.0,5,1079,4.0,811.0,811.0
0.037,17,2,182,1,65,0.0,37.0,37.0,1,117,0.0,89.0,89.0
0.01,6,10,1989,5,910,2.0,642.0,642.0,5,1079,2.0,811.0,811.0
0.225,6,16,2777,8,1395,32.0,533.0,323.0,8,1382,21.0,529.0,239.0
0.097,6,10,1506,5,395,21.0,127.0,127.0,5,1111,21.0,843.0,843.0
0.009,6,10,1989,5,910,2.0,642.0,642.0,5,1079,2.0,811.0,811.0
0.005,6,10,2007,5,928,1.0,660.0,660.0,5,1079,1.0,811.0,811.0
0.016,6,10,1989,5,910,4.0,642.0,642.0,5,1079,4.0,811.0,811.0
0.005,6,10,1689,5,839,1.0,571.0,571.0,5,850,1.0,582.0,582.0
0.071,17,4,284,2,120,0.0,32.0,32.0,2,164,32.0,60.0,54.0
0.016,17,2,198,1,91,0.0,63.0,63.0,1,107,0.0,79.0,79.0
0.005,6,13,3747,7,509,0.0,137.0,137.0,6,3238,1.0,1470.0,1459.0
0.004,6,10,2006,5,927,1.0,659.0,659.0,5,1079,1.0,811.0,811.0
0.004,6,10,1989,5,927,1.0,659.0,659.0,5,1062,1.0,794.0,794.0
300.02,6,12,1782,7,1348,50003.0,494.0,494.0,5,434,75003.0,83.0,83.0
0.056,17,2,160,1,72,0.0,44.0,44.0,1,88,0.0,60.0,60.0
240.096,6,16,4481,9,963,30012.0,238.0,166.0,7,3518,40015.0,1402.0,786.0
0.005,6,10,2007,5,928,1.0,660.0,660.0,5,1079,1.0,811.0,811.0
1798.845,17,3105,237294,1543,125111,1166.0,84.0,53.0,1562,112183,1152.0,225.0,43.0
0.096,6,10,1506,5,395,19.0,127.0,127.0,5,1111,22.0,843.0,843.0
176.468,17,82,11575,41,2740,4411.0,44.0,38.0,41,8835,4411.0,239.0,187.0
0.001,17,2,226,1,97,0.0,69.0,69.0,1,129,0.0,101.0,101.0
0.009,6,10,1989,5,910,2.0,642.0,642.0,5,1079,2.0,811.0,811.0
0.004,17,2,136,1,60,0.0,32.0,32.0,1,76,0.0,48.0,48.0
0.1,6,10,1506,5,395,21.0,127.0,127.0,5,1111,22.0,843.0,843.0
373.866,6,24,2405,17,919,23366.0,195.0,195.0,7,1486,3907.0,419.0,398.0
0.022,6,10,1677,5,827,5.0,559.0,559.0,5,850,5.0,582.0,582.0
0.005,6,14,3799,7,509,0.0,137.0,137.0,7,3290,0.0,1448.0,972.0
0.077,6,10,1506,5,395,17.0,127.0,127.0,5,1111,18.0,843.0,843.0
0.103,6,10,1506,5,395,24.0,127.0,127.0,5,1111,22.0,843.0,843.0
0.001,17,2,166,1,75,0.0,47.0,47.0,1,91,0.0,63.0,63.0
0.153,6,10,1506,5,395,37.0,127.0,127.0,5,1111,35.0,843.0,843.0
0.097,6,10,1506,5,395,19.0,127.0,127.0,5,1111,23.0,843.0,843.0
11.169,17,28,4421,14,1994,846.0,269.0,114.0,14,2427,846.0,586.0,145.0
75.673,6,21,8144,11,1985,84.0,1174.0,504.0,10,6159,8389.0,2720.0,957.0
0.001,17,2,180,1,66,0.0,38.0,38.0,1,114,0.0,86.0,86.0
354.071,6,21,1795,16,1030,23604.0,190.0,190.0,5,765,60002.0,464.0,248.0
0.011,6,10,1983,5,910,2.0,642.0,642.0,5,1073,2.0,805.0,805.0
0.025,6,10,1990,5,911,6.0,643.0,643.0,5,1079,6.0,811.0,811.0
0.004,6,10,1989,5,927,1.0,659.0,659.0,5,1062,1.0,794.0,794.0
15.072,17,15,9238,8,6902,2149.0,1350.0,834.0,7,2336,2507.0,1350.0,305.0
0.001,17,2,180,1,66,0.0,38.0,38.0,1,114,0.0,86.0,86.0
0.023,6,10,1983,5,910,5.0,642.0,642.0,5,1073,5.0,805.0,805.0
0.014,6,10,1989,5,910,3.0,642.0,642.0,5,1079,3.0,811.0,811.0
0.003,17,4,284,2,120,0.0,32.0,32.0,2,164,1.0,60.0,54.0
0.006,6,10,1547,5,764,1.0,496.0,496.0,5,783,1.0,515.0,515.0
240.12,6,31,7376,16,5099,16008.0,1515.0,474.0,15,2277,17150.0,580.0,186.0
0.003,17,2,148,1,60,0.0,32.0,32.0,1,88,0.0,60.0,60.0
0.026,6,10,1677,5,827,6.0,559.0,559.0,5,850,6.0,582.0,582.0
9.037,17,6,376,5,280,2259.0,28.0,28.0,1,96,0.0,68.0,68.0
0.015,6,10,1989,5,910,3.0,642.0,642.0,5,1079,3.0,811.0,811.0
0.005,6,10,1779,5,928,1.0,660.0,660.0,5,851,1.0,583.0,583.0
0.078,6,10,1506,5,395,18.0,127.0,127.0,5,1111,17.0,843.0,843.0
0.013,17,2,152,1,56,0.0,28.0,28.0,1,96,0.0,68.0,68.0
0.166,6,10,1506,5,395,38.0,127.0,127.0,5,1111,36.0,843.0,843.0
0.006,6,10,1643,5,860,1.0,592.0,592.0,5,783,1.0,515.0,515.0
0.004,17,4,420,2,122,1.0,33.0,33.0,2,298,0.0,145.0,121.0
0.126,6,10,1506,5,395,29.0,127.0,127.0,5,1111,30.0,843.0,843.0
0.104,6,10,1506,5,395,23.0,127.0,127.0,5,1111,24.0,843.0,843.0
0.006,6,10,2007,5,928,1.0,660.0,660.0,5,1079,1.0,811.0,811.0
0.008,6,10,1989,5,910,1.0,642.0,642.0,5,1079,1.0,811.0,811.0
0.004,17,2,136,1,60,0.0,32.0,32.0,1,76,0.0,48.0,48.0
0.005,6,10,1774,5,923,1.0,655.0,655.0,5,851,1.0,583.0,583.0
0.004,17,2,148,1,60,0.0,32.0,32.0,1,88,0.0,60.0,60.0
0.005,6,10,2007,5,928,1.0,660.0,660.0,5,1079,1.0,811.0,811.0
0.077,6,43,13987,24,2565,3.0,517.0,146.0,19,11422,3.0,1402.0,802.0
65.925,6,22,10140,12,3973,5993.0,1579.0,835.0,10,6167,7306.0,2111.0,939.0
0.018,6,10,1972,5,910,4.0,642.0,642.0,5,1062,4.0,794.0,794.0
0.008,6,10,1983,5,910,2.0,642.0,642.0,5,1073,1.0,805.0,805.0
0.006,6,10,1547,5,764,1.0,496.0,496.0,5,783,1.0,515.0,515.0
166.141,17,74,10570,37,2466,4614.0,44.0,38.0,37,8104,4615.0,260.0,191.0
176.413,17,78,11315,39,2618,4642.0,44.0,39.0,39,8697,4642.0,239.0,195.0
242.415,6,33,12438,18,1760,14259.0,260.0,207.0,15,10678,17315.0,1561.0,899.0
0.039,17,2,170,1,65,0.0,37.0,37.0,1,105,0.0,77.0,77.0
0.079,17,2,184,1,61,0.0,33.0,33.0,1,123,0.0,95.0,95.0
0.013,6,10,1983,5,910,3.0,642.0,642.0,5,1073,3.0,805.0,805.0
0.013,17,2,152,1,56,0.0,28.0,28.0,1,96,0.0,68.0,68.0
0.012,6,10,1990,5,911,3.0,643.0,643.0,5,1079,3.0,811.0,811.0
0.125,6,10,1506,5,395,26.0,127.0,127.0,5,1111,26.0,843.0,843.0
40.062,17,10,676,5,460,10013.0,104.0,64.0,5,216,10014.0,20.0,15.0
240.325,6,29,11788,14,5563,18486.0,1368.0,804.0,15,6225,17165.0,1708.0,776.0
68.355,6,39,8464,21,1992,432.0,728.0,361.0,18,6472,4013.0,2720.0,478.0
0.005,6,10,1989,5,927,1.0,659.0,659.0,5,1062,1.0,794.0,794.0
0.005,6,10,2007,5,928,1.0,660.0,660.0,5,1079,1.0,811.0,811.0
0.005,6,10,1689,5,839,1.0,571.0,571.0,5,850,1.0,582.0,582.0
0.005,6,10,2006,5,927,1.0,659.0,659.0,5,1079,1.0,811.0,811.0
0.007,6,10,1547,5,764,1.0,496.0,496.0,5,783,1.0,515.0,515.0
0.124,6,10,1506,5,395,27.0,127.0,127.0,5,1111,24.0,843.0,843.0
0.145,6,10,1506,5,395,35.0,127.0,127.0,5,1111,33.0,843.0,843.0
0.004,17,2,136,1,60,0.0,32.0,32.0,1,76,0.0,48.0,48.0
0.217,6,16,2778,8,1396,31.0,533.0,324.0,8,1382,19.0,529.0,239.0
0.068,6,10,1506,5,395,14.0,127.0,127.0,5,1111,15.0,843.0,843.0
15.187,17,21,12378,11,8690,1515.0,1350.0,762.0,10,3688,1684.0,1350.0,340.0
0.052,17,2,152,1,76,0.0,48.0,48.0,1,76,0.0,48.0,48.0
358.841,6,25,3071,8,1918,8602.0,494.0,494.0,17,1153,22427.0,83.0,83.0
0.015,6,10,1990,5,911,3.0,643.0,643.0,5,1079,3.0,811.0,811.0
0.008,6,10,1779,5,928,2.0,660.0,660.0,5,851,1.0,583.0,583.0
0.006,17,2,136,1,60,0.0,32.0,32.0,1,76,0.0,48.0,48.0
0.065,6,10,1506,5,395,14.0,127.0,127.0,5,1111,15.0,843.0,843.0
240.241,6,26,11845,14,6932,18480.0,1368.0,886.0,12,4913,21839.0,1656.0,1427.0
0.077,6,10,1506,5,395,17.0,127.0,127.0,5,1111,15.0,843.0,843.0
0.005,6,10,2006,5,927,1.0,659.0,659.0,5,1079,1.0,811.0,811.0
0.012,6,10,1972,5,910,2.0,642.0,642.0,5,1062,2.0,794.0,794.0
0.009,6,10,1990,5,911,2.0,643.0,643.0,5,1079,2.0,811.0,811.0
0.004,17,4,284,2,120,0.0,32.0,32.0,2,164,1.0,60.0,54.0
0.006,6,10,2007,5,928,1.0,660.0,660.0,5,1079,1.0,811.0,811.0
0.145,6,10,1506,5,395,33.0,127.0,127.0,5,1111,30.0,843.0,843.0
0.011,6,10,1990,5,911,2.0,643.0,643.0,5,1079,2.0,811.0,811.0
0.006,6,10,1547,5,764,1.0,496.0,496.0,5,783,1.0,515.0,515.0
40.086,17,10,676,5,460,10019.0,104.0,64.0,5,216,10020.0,20.0,15.0
0.004,6,10,2000,5,927,1.0,659.0,659.0,5,1073,1.0,805.0,805.0
300.47,6,29,8693,14,2476,23112.0,1224.0,348.0,15,6217,21461.0,1592.0,604.0
0.005,6,10,1989,5,927,1.0,659.0,659.0,5,1062,1.0,794.0,794.0
291.417,6,391,348643,209,22418,1401.0,2736.0,888.0,182,326225,1610.0,2769.0,1885.0
0.091,6,10,1506,5,395,16.0,127.0,127.0,5,1111,20.0,843.0,843.0
0.006,6,10,1547,5,764,1.0,496.0,496.0,5,783,1.0,515.0,515.0
0.041,17,4,596,2,122,0.0,33.0,33.0,2,474,2.0,323.0,209.0
0.013,6,10,1983,5,910,3.0,642.0,642.0,5,1073,3.0,805.0,805.0
40.057,17,10,676,5,460,10012.0,104.0,64.0,5,216,10013.0,20.0,15.0
0.111,6,10,1506,5,395,24.0,127.0,127.0,5,1111,23.0,843.0,843.0
0.006,17,2,230,1,68,0.0,40.0,40.0,1,162,0.0,134.0,134.0
0.017,6,10,1677,5,827,4.0,559.0,559.0,5,850,4.0,582.0,582.0
0.107,6,10,1506,5,395,24.0,127.0,127.0,5,1111,19.0,843.0,843.0
0.133,6,10,1506,5,395,31.0,127.0,127.0,5,1111,27.0,843.0,843.0
0.005,6,10,2007,5,928,1.0,660.0,660.0,5,1079,1.0,811.0,811.0
0.004,6,10,2007,5,928,1.0,660.0,660.0,5,1079,1.0,811.0,811.0
0.008,6,10,1989,5,910,1.0,642.0,642.0,5,1079,1.0,811.0,811.0
0.01,6,10,1989,5,910,2.0,642.0,642.0,5,1079,2.0,811.0,811.0
0.001,17,2,180,1,66,0.0,38.0,38.0,1,114,0.0,86.0,86.0
0.001,17,2,180,1,66,0.0,38.0,38.0,1,114,0.0,86.0,86.0
0.182,6,10,1506,5,395,42.0,127.0,127.0,5,1111,38.0,843.0,843.0
0.005,6,10,2007,5,928,1.0,660.0,660.0,5,1079,1.0,811.0,811.0
0.005,17,2,213,1,69,0.0,41.0,41.0,1,144,0.0,116.0,116.0
0.006,17,2,170,1,65,0.0,37.0,37.0,1,105,0.0,77.0,77.0
0.001,17,2,180,1,66,0.0,38.0,38.0,1,114,0.0,86.0,86.0
0.018,6,10,1990,5,911,4.0,643.0,643.0,5,1079,4.0,811.0,811.0
0.06,17,2,152,1,76,0.0,48.0,48.0,1,76,0.0,48.0,48.0
0.005,6,10,1989,5,927,1.0,659.0,659.0,5,1062,1.0,794.0,794.0
10.829,17,28,4421,14,1994,824.0,269.0,114.0,14,2427,824.0,586.0,145.0
11.613,17,28,4394,14,2312,880.0,587.0,137.0,14,2082,880.0,269.0,120.0
0.013,6,10,1989,5,910,3.0,642.0,642.0,5,1079,3.0,811.0,811.0
0.131,17,2,234,1,61,0.0,33.0,33.0,1,173,0.0,145.0,145.0
0.004,6,10,2007,5,928,1.0,660.0,660.0,5,1079,1.0,811.0,811.0
0.023,6,10,1989,5,910,5.0,642.0,642.0,5,1079,5.0,811.0,811.0
0.011,6,10,1631,5,848,2.0,580.0,580.0,5,783,2.0,515.0,515.0
0.019,6,10,1972,5,910,4.0,642.0,642.0,5,1062,4.0,794.0,794.0
0.005,6,13,3747,7,509,0.0,137.0,137.0,6,3238,1.0,1470.0,1459.0
0.006,6,10,1989,5,927,1.0,659.0,659.0,5,1062,1.0,794.0,794.0
40.055,17,10,676,5,460,10012.0,104.0,64.0,5,216,10012.0,20.0,15.0
0.037,17,2,148,1,60,0.0,32.0,32.0,1,88,0.0,60.0,60.0
0.02,6,10,1990,5,911,5.0,643.0,643.0,5,1079,4.0,811.0,811.0
0.116,6,10,1506,5,395,24.0,127.0,127.0,5,1111,25.0,843.0,843.0
177.065,17,84,12236,42,2827,4318.0,44.0,39.0,42,9409,4318.0,239.0,196.0
0.006,6,10,1643,5,860,1.0,592.0,592.0,5,783,1.0,515.0,515.0
0.011,6,10,1989,5,910,2.0,642.0,642.0,5,1079,2.0,811.0,811.0
0.014,17,2,148,1,60,0.0,32.0,32.0,1,88,0.0,60.0,60.0
0.006,6,12,1698,6,863,1.0,327.0,271.0,6,835,1.0,515.0,515.0
40.07,17,10,676,5,460,10015.0,104.0,64.0,5,216,10016.0,20.0,15.0
0.102,6,10,1506,5,395,22.0,127.0,127.0,5,1111,23.0,843.0,843.0
0.012,6,13,3735,7,497,2.0,125.0,125.0,6,3238,2.0,1470.0,1459.0
0.009,6,10,1990,5,911,2.0,643.0,643.0,5,1079,2.0,811.0,811.0
0.017,6,10,1990,5,911,4.0,643.0,643.0,5,1079,4.0,811.0,811.0
0.021,17,2,180,1,66,0.0,38.0,38.0,1,114,0.0,86.0,86.0
172.374,17,72,10313,36,2394,4924.0,44.0,38.0,36,7919,4924.0,261.0,191.0
308.691,17,20,1124,10,716,34285.0,48.0,43.0,10,408,34286.0,20.0,12.0
0.005,6,10,2007,5,928,1.0,660.0,660.0,5,1079,1.0,811.0,811.0
240.018,6,9,787,5,488,60004.0,232.0,232.0,4,299,80005.0,83.0,83.0
0.011,6,10,1972,5,910,2.0,642.0,642.0,5,1062,2.0,794.0,794.0
0.004,6,10,1989,5,927,1.0,659.0,659.0,5,1062,1.0,794.0,794.0
0.003,17,4,284,2,120,0.0,32.0,32.0,2,164,0.0,60.0,54.0
0.005,6,10,1989,5,927,1.0,659.0,659.0,5,1062,1.0,794.0,794.0
0.003,17,2,148,1,60,0.0,32.0,32.0,1,88,0.0,60.0,60.0
0.005,17,2,144,1,64,0.0,36.0,36.0,1,80,0.0,52.0,52.0
0.079,6,10,1506,5,395,17.0,127.0,127.0,5,1111,17.0,843.0,843.0
0.006,17,2,166,1,75,0.0,47.0,47.0,1,91,0.0,63.0,63.0
0.068,6,10,1506,5,395,15.0,127.0,127.0,5,1111,15.0,843.0,843.0
0.091,6,10,1506,5,395,17.0,127.0,127.0,5,1111,21.0,843.0,843.0
0.101,6,10,1506,5,395,22.0,127.0,127.0,5,1111,20.0,843.0,843.0
0.008,6,10,1972,5,910,1.0,642.0,642.0,5,1062,1.0,794.0,794.0
0.041,17,2,136,1,60,0.0,32.0,32.0,1,76,0.0,48.0,48.0
0.074,6,10,1506,5,395,16.0,127.0,127.0,5,1111,16.0,843.0,843.0
0.006,6,10,1643,5,860,1.0,592.0,592.0,5,783,1.0,515.0,515.0
0.096,6,10,1506,5,395,23.0,127.0,127.0,5,1111,22.0,843.0,843.0
0.04,17,4,284,2,120,0.0,32.0,32.0,2,164,36.0,60.0,54.0
10.953,17,28,4395,14,2312,834.0,587.0,137.0,14,2083,833.0,270.0,120.0
0.005,17,2,212,1,74,0.0,46.0,46.0,1,138,0.0,110.0,110.0
0.004,17,2,179,1,71,0.0,43.0,43.0,1,108,0.0,80.0,80.0
0.008,6,10,1989,5,910,1.0,642.0,642.0,5,1079,2.0,811.0,811.0
0.1,6,10,1506,5,395,22.0,127.0,127.0,5,1111,20.0,843.0,843.0
0.012,17,2,194,1,59,0.0,31.0,31.0,1,135,0.0,107.0,107.0
300.022,6,12,1782,7,1348,50003.0,494.0,494.0,5,434,75004.0,83.0,83.0
0.012,6,10,1631,5,848,3.0,580.0,580.0,5,783,2.0,515.0,515.0
0.005,6,10,2007,5,928,1.0,660.0,660.0,5,1079,1.0,811.0,811.0
0.014,6,10,1990,5,911,3.0,643.0,643.0,5,1079,3.0,811.0,811.0
0.005,17,2,166,1,75,0.0,47.0,47.0,1,91,0.0,63.0,63.0
0.005,17,2,164,1,74,0.0,46.0,46.0,1,90,0.0,62.0,62.0
0.004,6,10,1989,5,927,1.0,659.0,659.0,5,1062,1.0,794.0,794.0
0.006,6,10,1643,5,860,1.0,592.0,592.0,5,783,1.0,515.0,515.0
0.106,6,10,1506,5,395,24.0,127.0,127.0,5,1111,23.0,843.0,843.0
0.018,6,10,1677,5,827,4.0,559.0,559.0,5,850,4.0,582.0,582.0
0.014,6,10,1762,5,911,3.0,643.0,643.0,5,851,3.0,583.0,583.0
0.063,6,10,1506,5,395,13.0,127.0,127.0,5,1111,14.0,843.0,843.0
0.008,6,10,2000,5,927,2.0,659.0,659.0,5,1073,2.0,805.0,805.0
0.013,6,10,1972,5,910,3.0,642.0,642.0,5,1062,3.0,794.0,794.0
0.004,6,10,1989,5,927,1.0,659.0,659.0,5,1062,1.0,794.0,794.0
0.013,17,2,152,1,76,0.0,48.0,48.0,1,76,0.0,48.0,48.0
0.003,6,10,1702,5,863,0.0,595.0,595.0,5,839,0.0,571.0,571.0
0.003,17,2,152,1,76,0.0,48.0,48.0,1,76,0.0,48.0,48.0
0.014,6,10,1983,5,910,3.0,642.0,642.0,5,1073,3.0,805.0,805.0
309.358,17,20,1124,10,716,34358.0,48.0,43.0,10,408,34358.0,20.0,12.0
0.009,6,10,1972,5,910,2.0,642.0,642.0,5,1062,2.0,794.0,794.0
0.013,6,10,1990,5,911,3.0,643.0,643.0,5,1079,3.0,811.0,811.0
0.098,6,10,1506,5,395,21.0,127.0,127.0,5,1111,20.0,843.0,843.0
0.147,6,10,1506,5,395,28.0,127.0,127.0,5,1111,36.0,843.0,843.0
0.005,6,14,3799,7,509,0.0,137.0,137.0,7,3290,0.0,1448.0,972.0
0.006,6,10,1854,5,889,1.0,621.0,621.0,5,965,1.0,697.0,697.0
0.266,17,44,24451,24,21179,11.0,1350.0,854.0,20,3272,10.0,1350.0,135.0
0.004,6,10,2007,5,928,1.0,660.0,660.0,5,1079,1.0,811.0,811.0
0.016,6,10,1989,5,910,4.0,642.0,642.0,5,1079,3.0,811.0,811.0
240.092,6,16,4481,9,963,30011.0,238.0,166.0,7,3518,40014.0,1402.0,786.0
0.077,6,10,1506,5,395,16.0,127.0,127.0,5,1111,15.0,843.0,843.0
0.006,6,10,2007,5,928,1.0,660.0,660.0,5,1079,1.0,811.0,811.0
0.003,17,2,136,1,60,0.0,32.0,32.0,1,76,0.0,48.0,48.0
0.01,6,10,1972,5,910,2.0,642.0,642.0,5,1062,2.0,794.0,794.0
0.003,17,2,148,1,60,0.0,32.0,32.0,1,88,0.0,60.0,60.0
0.062,17,2,80,1,32,0.0,4.0,4.0,1,48,0.0,20.0,20.0
0.067,17,8,3613,4,1874,22.0,1350.0,440.0,4,1739,11.0,1350.0,406.0
0.005,6,10,1774,5,923,1.0,655.0,655.0,5,851,1.0,583.0,583.0
0.084,6,10,1506,5,395,17.0,127.0,127.0,5,1111,17.0,843.0,843.0
0.005,6,10,2006,5,927,1.0,659.0,659.0,5,1079,1.0,811.0,811.0
0.003,17,4,284,2,120,0.0,32.0,32.0,2,164,0.0,60.0,54.0
0.014,6,10,1677,5,827,3.0,559.0,559.0,5,850,3.0,582.0,582.0
0.038,17,2,184,1,61,0.0,33.0,33.0,1,123,0.0,95.0,95.0
0.094,6,10,1506,5,395,22.0,127.0,127.0,5,1111,18.0,843.0,843.0
40.069,17,10,676,5,460,10015.0,104.0,64.0,5,216,10016.0,20.0,15.0
0.088,6,10,1506,5,395,20.0,127.0,127.0,5,1111,20.0,843.0,843.0
0.005,6,10,2006,5,927,1.0,659.0,659.0,5,1079,1.0,811.0,811.0
0.006,6,10,1547,5,764,1.0,496.0,496.0,5,783,1.0,515.0,515.0
31.97,6,669,645736,334,622729,59.0,4080.0,2037.0,335,23007,95.0,1360.0,177.0
0.022,6,10,1989,5,910,5.0,642.0,642.0,5,1079,5.0,811.0,811.0
0.006,6,10,1547,5,764,1.0,496.0,496.0,5,783,1.0,515.0,515.0
0.005,17,2,166,1,75,0.0,47.0,47.0,1,91,0.0,63.0,63.0
0.057,17,2,299,1,65,0.0,37.0,37.0,1,234,0.0,206.0,206.0
0.014,6,10,1972,5,910,3.0,642.0,642.0,5,1062,3.0,794.0,794.0
0.001,17,2,179,1,62,0.0,34.0,34.0,1,117,0.0,89.0,89.0
0.075,6,10,1506,5,395,16.0,127.0,127.0,5,1111,17.0,843.0,843.0
10.812,17,28,4420,14,1993,822.0,268.0,114.0,14,2427,822.0,586.0,145.0
0.068,6,10,1506,5,395,15.0,127.0,127.0,5,1111,15.0,843.0,843.0
0.012,6,10,1990,5,911,3.0,643.0,643.0,5,1079,2.0,811.0,811.0
0.005,6,10,2007,5,928,1.0,660.0,660.0,5,1079,1.0,811.0,811.0
0.005,17,2,170,1,65,0.0,37.0,37.0,1,105,0.0,77.0,77.0
0.013,6,10,1989,5,910,3.0,642.0,642.0,5,1079,3.0,811.0,811.0
0.015,6,11,2024,6,962,3.0,642.0,642.0,5,1062,3.0,794.0,794.0
0.008,6,10,1983,5,910,2.0,642.0,642.0,5,1073,2.0,805.0,805.0
0.01,6,10,1972,5,910,2.0,642.0,642.0,5,1062,2.0,794.0,794.0
0.014,6,10,1990,5,911,3.0,643.0,643.0,5,1079,3.0,811.0,811.0
240.091,6,31,9301,15,6848,17149.0,1973.0,674.0,16,2453,16005.0,580.0,201.0
0.008,6,10,1689,5,839,2.0,571.0,571.0,5,850,2.0,582.0,582.0
40.065,17,10,676,5,460,10015.0,104.0,64.0,5,216,10015.0,20.0,15.0
0.096,6,10,1506,5,395,22.0,127.0,127.0,5,1111,22.0,843.0,843.0
40.056,17,10,676,5,460,10012.0,104.0,64.0,5,216,10011.0,20.0,15.0
0.012,6,14,3787,7,497,1.0,125.0,125.0,7,3290,1.0,1448.0,972.0
40.054,17,10,676,5,460,10012.0,104.0,64.0,5,216,10012.0,20.0,15.0
0.006,6,10,1689,5,839,1.0,571.0,571.0,5,850,1.0,582.0,582.0
0.005,6,10,1854,5,889,1.0,621.0,621.0,5,965,1.0,697.0,697.0
0.017,6,10,1990,5,911,4.0,643.0,643.0,5,1079,4.0,811.0,811.0
0.318,6,25,8238,13,1725,26.0,746.0,257.0,12,6513,28.0,2335.0,980.0
0.041,17,2,152,1,76,0.0,48.0,48.0,1,76,0.0,48.0,48.0
0.005,17,2,136,1,60,0.0,32.0,32.0,1,76,0.0,48.0,48.0
0.007,6,10,1762,5,911,1.0,643.0,643.0,5,851,1.0,583.0,583.0
0.157,6,10,1506,5,395,36.0,127.0,127.0,5,1111,38.0,843.0,843.0
0.04,17,2,152,1,76,0.0,48.0,48.0,1,76,0.0,48.0,48.0
0.011,6,10,1989,5,910,2.0,642.0,642.0,5,1079,2.0,811.0,811.0
0.021,6,10,1989,5,910,5.0,642.0,642.0,5,1079,5.0,811.0,811.0
0.133,17,2,170,1,65,0.0,37.0,37.0,1,105,0.0,77.0,77.0
0.081,6,10,1506,5,395,18.0,127.0,127.0,5,1111,16.0,843.0,843.0
40.062,17,10,676,5,460,10012.0,104.0,64.0,5,216,10014.0,20.0,15.0
0.082,6,10,1506,5,395,18.0,127.0,127.0,5,1111,17.0,843.0,843.0
0.005,6,10,2006,5,927,1.0,659.0,659.0,5,1079,1.0,811.0,811.0
0.006,6,10,1547,5,764,1.0,496.0,496.0,5,783,1.0,515.0,515.0
0.142,6,10,1506,5,395,32.0,127.0,127.0,5,1111,30.0,843.0,843.0
0.568,6,27,8977,15,1639,33.0,517.0,211.0,12,7338,42.0,1288.0,839.0
15.071,17,15,9238,8,6902,2149.0,1350.0,834.0,7,2336,2507.0,1350.0,305.0
0.006,17,2,212,1,74,0.0,46.0,46.0,1,138,0.0,110.0,110.0
0.175,17,2,152,1,76,0.0,48.0,48.0,1,76,0.0,48.0,48.0
0.005,6,10,2007,5,928,1.0,660.0,660.0,5,1079,1.0,811.0,811.0
0.014,6,10,1983,5,910,3.0,642.0,642.0,5,1073,3.0,805.0,805.0
0.026,6,10,1990,5,911,6.0,643.0,643.0,5,1079,6.0,811.0,811.0
0.005,17,2,214,1,75,0.0,47.0,47.0,1,139,0.0,111.0,111.0
0.005,6,10,2006,5,927,1.0,659.0,659.0,5,1079,1.0,811.0,811.0
0.012,6,10,1989,5,910,2.0,642.0,642.0,5,1079,3.0,811.0,811.0
0.01,6,10,1983,5,910,2.0,642.0,642.0,5,1073,2.0,805.0,805.0
0.067,17,8,3613,4,1874,22.0,1350.0,440.0,4,1739,11.0,1350.0,406.0
0.011,6,10,1677,5,827,2.0,559.0,559.0,5,850,2.0,582.0,582.0
0.004,6,10,2000,5,927,1.0,659.0,659.0,5,1073,1.0,805.0,805.0
0.013,6,10,1972,5,910,3.0,642.0,642.0,5,1062,3.0,794.0,794.0
0.006,17,2,170,1,65,0.0,37.0,37.0,1,105,0.0,77.0,77.0
372.121,6,21,1793,16,1030,24808.0,190.0,190.0,5,763,60019.0,462.0,247.0
0.143,6,10,1506,5,395,31.0,127.0,127.0,5,1111,33.0,843.0,843.0
0.011,17,2,169,1,62,0.0,34.0,34.0,1,107,0.0,79.0,79.0
0.006,6,10,1547,5,764,1.0,496.0,496.0,5,783,1.0,515.0,515.0
0.065,6,10,1506,5,395,14.0,127.0,127.0,5,1111,15.0,843.0,843.0
361.776,6,21,1793,16,1030,24118.0,190.0,190.0,5,763,60010.0,462.0,247.0
0.135,6,10,1506,5,395,28.0,127.0,127.0,5,1111,29.0,843.0,843.0
0.006,6,10,1547,5,764,1.0,496.0,496.0,5,783,1.0,515.0,515.0
0.171,17,2,152,1,76,0.0,48.0,48.0,1,76,0.0,48.0,48.0
0.003,17,2,136,1,60,0.0,32.0,32.0,1,76,0.0,48.0,48.0
0.005,6,10,2007,5,928,1.0,660.0,660.0,5,1079,1.0,811.0,811.0
0.013,6,10,1972,5,910,3.0,642.0,642.0,5,1062,3.0,794.0,794.0
0.101,6,10,1506,5,395,21.0,127.0,127.0,5,1111,19.0,843.0,843.0
0.073,6,10,1506,5,395,15.0,127.0,127.0,5,1111,17.0,843.0,843.0
0.003,6,10,1702,5,863,0.0,595.0,595.0,5,839,0.0,571.0,571.0
0.041,17,4,352,2,130,1.0,37.0,37.0,2,222,2.0,89.0,83.0
0.005,6,10,1989,5,927,1.0,659.0,659.0,5,1062,1.0,794.0,794.0
40.094,17,10,676,5,460,10018.0,104.0,64.0,5,216,10022.0,20.0,15.0
0.011,6,10,1972,5,910,2.0,642.0,642.0,5,1062,2.0,794.0,794.0
0.069,6,10,1506,5,395,15.0,127.0,127.0,5,1111,15.0,843.0,843.0
0.004,17,2,136,1,60,0.0,32.0,32.0,1,76,0.0,48.0,48.0
0.072,6,10,1506,5,395,13.0,127.0,127.0,5,1111,16.0,843.0,843.0
0.005,6,10,1989,5,927,1.0,659.0,659.0,5,1062,1.0,794.0,794.0
0.024,6,10,1631,5,848,5.0,580.0,580.0,5,783,5.0,515.0,515.0
0.089,6,10,1506,5,395,20.0,127.0,127.0,5,1111,20.0,843.0,843.0
0.006,6,10,1643,5,860,1.0,592.0,592.0,5,783,1.0,515.0,515.0
0.01,6,12,1926,6,1189,2.0,659.0,434.0,6,737,2.0,417.0,417.0
0.089,6,10,1506,5,395,19.0,127.0,127.0,5,1111,15.0,843.0,843.0
300.392,6,16,2170,9,684,37528.0,146.0,146.0,7,1486,50037.0,419.0,398.0
0.017,6,10,1972,5,910,4.0,642.0,642.0,5,1062,4.0,794.0,794.0
174.394,17,102,14500,51,3441,3487.0,44.0,39.0,51,11059,3487.0,261.0,188.0
0.014,6,10,1990,5,911,3.0,643.0,643.0,5,1079,3.0,811.0,811.0
0.009,6,10,1972,5,910,2.0,642.0,642.0,5,1062,2.0,794.0,794.0
11.46,17,28,4391,14,2312,869.0,587.0,137.0,14,2079,869.0,270.0,120.0
0.106,6,10,1506,5,395,24.0,127.0,127.0,5,1111,18.0,843.0,843.0
0.008,6,10,1972,5,910,2.0,642.0,642.0,5,1062,1.0,794.0,794.0
0.016,6,10,1677,5,827,4.0,559.0,559.0,5,850,3.0,582.0,582.0
0.006,6,10,1854,5,889,1.0,621.0,621.0,5,965,1.0,697.0,697.0
0.003,17,2,136,1,60,0.0,32.0,32.0,1,76,0.0,48.0,48.0
0.012,6,10,2000,5,927,2.0,659.0,659.0,5,1073,3.0,805.0,805.0
0.001,17,2,180,1,66,0.0,38.0,38.0,1,114,0.0,86.0,86.0
0.004,17,2,148,1,60,0.0,32.0,32.0,1,88,0.0,60.0,60.0
0.01,6,10,1990,5,911,2.0,643.0,643.0,5,1079,2.0,811.0,811.0
0.078,6,10,1506,5,395,13.0,127.0,127.0,5,1111,18.0,843.0,843.0
0.005,17,2,140,1,62,0.0,34.0,34.0,1,78,0.0,50.0,50.0
0.01,6,10,1972,5,910,2.0,642.0,642.0,5,1062,2.0,794.0,794.0
10.807,17,28,4421,14,1994,822.0,269.0,114.0,14,2427,822.0,586.0,145.0
0.01,6,10,1990,5,911,2.0,643.0,643.0,5,1079,2.0,811.0,811.0
0.005,6,10,1989,5,927,1.0,659.0,659.0,5,1062,1.0,794.0,794.0
0.076,6,10,1506,5,395,18.0,127.0,127.0,5,1111,17.0,843.0,843.0
0.01,6,10,1990,5,911,2.0,643.0,643.0,5,1079,2.0,811.0,811.0
0.005,6,14,3742,7,452,0.0,80.0,80.0,7,3290,0.0,1448.0,972.0
0.004,6,10,1702,5,863,1.0,595.0,595.0,5,839,1.0,571.0,571.0
0.008,6,10,1972,5,910,2.0,642.0,642.0,5,1062,1.0,794.0,794.0
0.006,17,2,170,1,65,0.0,37.0,37.0,1,105,0.0,77.0,77.0
0.041,17,4,596,2,122,0.0,33.0,33.0,2,474,3.0,323.0,209.0
0.014,6,10,1762,5,911,3.0,643.0,643.0,5,851,3.0,583.0,583.0
0.04,6,10,1989,5,910,10.0,642.0,642.0,5,1079,9.0,811.0,811.0
0.061,17,2,80,1,32,0.0,4.0,4.0,1,48,0.0,20.0,20.0
0.014,6,10,1990,5,911,3.0,643.0,643.0,5,1079,3.0,811.0,811.0
0.005,6,10,2000,5,927,1.0,659.0,659.0,5,1073,1.0,805.0,805.0
0.001,17,2,136,1,60,0.0,32.0,32.0,1,76,0.0,48.0,48.0
0.01,6,10,1677,5,827,2.0,559.0,559.0,5,850,2.0,582.0,582.0
0.054,17,2,152,1,76,0.0,48.0,48.0,1,76,0.0,48.0,48.0
0.005,6,10,1643,5,860,1.0,592.0,592.0,5,783,1.0,515.0,515.0
0.074,6,10,1506,5,395,16.0,127.0,127.0,5,1111,16.0,843.0,843.0
0.005,6,10,2006,5,927,1.0,659.0,659.0,5,1079,1.0,811.0,811.0
0.002,17,2,180,1,66,0.0,38.0,38.0,1,114,0.0,86.0,86.0
0.09,6,10,1506,5,395,20.0,127.0,127.0,5,1111,20.0,843.0,843.0
0.02,6,10,1972,5,910,4.0,642.0,642.0,5,1062,5.0,794.0,794.0
0.005,6,10,1689,5,839,1.0,571.0,571.0,5,850,1.0,582.0,582.0
0.006,17,2,166,1,75,0.0,47.0,47.0,1,91,0.0,63.0,63.0
0.127,17,2,148,1,60,0.0,32.0,32.0,1,88,0.0,60.0,60.0
0.001,17,2,180,1,66,0.0,38.0,38.0,1,114,0.0,86.0,86.0
15.081,17,15,8380,8,6199,2150.0,1350.0,746.0,7,2181,2508.0,1350.0,283.0
0.005,6,13,3747,7,509,0.0,137.0,137.0,6,3238,0.0,1470.0,1459.0
0.004,17,2,136,1,60,0.0,32.0,32.0,1,76,0.0,48.0,48.0
0.08,6,10,1506,5,395,18.0,127.0,127.0,5,1111,15.0,843.0,843.0
0.005,6,10,2000,5,927,1.0,659.0,659.0,5,1073,1.0,805.0,805.0
0.069,17,8,3613,4,1874,23.0,1350.0,440.0,4,1739,11.0,1350.0,406.0
0.014,6,10,1990,5,911,3.0,643.0,643.0,5,1079,3.0,811.0,811.0
0.075,17,4,596,2,122,3.0,33.0,33.0,2,474,34.0,323.0,209.0
319.592,17,18,1008,9,640,39928.0,48.0,43.0,9,368,39931.0,20.0,12.0
0.004,17,2,148,1,60,0.0,32.0,32.0,1,88,0.0,60.0,60.0
0.005,6,10,1547,5,764,1.0,496.0,496.0,5,783,1.0,515.0,515.0
0.013,6,10,1972,5,910,3.0,642.0,642.0,5,1062,3.0,794.0,794.0
0.08,6,10,1506,5,395,17.0,127.0,127.0,5,1111,17.0,843.0,843.0
0.014,6,10,1983,5,910,3.0,642.0,642.0,5,1073,3.0,805.0,805.0
40.06,17,10,676,5,460,10014.0,104.0,64.0,5,216,10014.0,20.0,15.0
0.013,6,10,1983,5,910,3.0,642.0,642.0,5,1073,3.0,805.0,805.0
0.006,6,10,2000,5,927,1.0,659.0,659.0,5,1073,1.0,805.0,805.0
0.005,6,14,3799,7,509,0.0,137.0,137.0,7,3290,0.0,1448.0,972.0
0.006,6,14,3799,7,509,1.0,137.0,137.0,7,3290,0.0,1448.0,972.0
1730.404,6,45,2790,30,1725,59669.0,35.0,35.0,15,1065,123594.0,31.0,31.0
0.005,6,10,1779,5,928,1.0,660.0,660.0,5,851,1.0,583.0,583.0
0.01,6,10,1762,5,911,2.0,643.0,643.0,5,851,2.0,583.0,583.0
0.003,17,2,148,1,60,0.0,32.0,32.0,1,88,0.0,60.0,60.0
0.115,6,10,1506,5,395,27.0,127.0,127.0,5,1111,26.0,843.0,843.0
0.085,6,10,1506,5,395,19.0,127.0,127.0,5,1111,17.0,843.0,843.0
0.011,6,10,1989,5,910,2.0,642.0,642.0,5,1079,2.0,811.0,811.0
0.005,6,13,3747,7,509,0.0,137.0,137.0,6,3238,0.0,1470.0,1459.0
0.004,17,4,284,2,120,0.0,32.0,32.0,2,164,0.0,60.0,54.0
0.003,17,2,148,1,60,0.0,32.0,32.0,1,88,0.0,60.0,60.0
0.003,6,10,1702,5,863,0.0,595.0,595.0,5,839,0.0,571.0,571.0
40.063,17,10,676,5,460,10013.0,104.0,64.0,5,216,10014.0,20.0,15.0
0.005,6,14,3742,7,452,0.0,80.0,80.0,7,3290,0.0,1448.0,972.0
0.033,6,10,1990,5,911,8.0,643.0,643.0,5,1079,8.0,811.0,811.0
0.008,6,10,1989,5,910,2.0,642.0,642.0,5,1079,1.0,811.0,811.0
11.19,17,28,4422,14,1994,848.0,269.0,114.0,14,2428,848.0,587.0,145.0
0.004,6,10,1779,5,928,1.0,660.0,660.0,5,851,1.0,583.0,583.0
0.005,6,10,2007,5,928,1.0,660.0,660.0,5,1079,1.0,811.0,811.0
0.004,17,2,164,1,74,0.0,46.0,46.0,1,90,0.0,62.0,62.0
0.009,6,10,1643,5,860,2.0,592.0,592.0,5,783,2.0,515.0,515.0
0.004,6,10,1989,5,927,1.0,659.0,659.0,5,1062,1.0,794.0,794.0
0.006,6,10,2000,5,927,1.0,659.0,659.0,5,1073,1.0,805.0,805.0
353.445,6,20,2210,6,1308,12004.0,494.0,494.0,14,902,27187.0,83.0,83.0
40.057,17,10,676,5,460,10013.0,104.0,64.0,5,216,10013.0,20.0,15.0
0.11,6,10,1506,5,395,25.0,127.0,127.0,5,1111,24.0,843.0,843.0
0.005,6,13,3747,7,509,0.0,137.0,137.0,6,3238,0.0,1470.0,1459.0
1798.094,6,252,40695,96,31047,18926.0,2790.0,331.0,156,9648,11599.0,148.0,48.0
0.005,6,10,2000,5,927,1.0,659.0,659.0,5,1073,1.0,805.0,805.0
240.046,6,9,787,5,488,60011.0,232.0,232.0,4,299,80014.0,83.0,83.0
0.004,17,2,180,1,66,0.0,38.0,38.0,1,114,0.0,86.0,86.0
0.037,17,2,148,1,60,0.0,32.0,32.0,1,88,0.0,60.0,60.0
0.006,17,2,168,1,76,0.0,48.0,48.0,1,92,0.0,64.0,64.0
78.727,6,24,7517,13,1385,6560.0,530.0,277.0,11,6132,7856.0,2720.0,946.0
0.001,17,2,166,1,75,0.0,47.0,47.0,1,91,0.0,63.0,63.0
0.006,17,2,230,1,68,0.0,40.0,40.0,1,162,0.0,134.0,134.0
0.042,17,4,284,2,120,0.0,32.0,32.0,2,164,39.0,60.0,54.0
0.001,17,2,180,1,66,0.0,38.0,38.0,1,114,0.0,86.0,86.0
0.081,6,10,1506,5,395,18.0,127.0,127.0,5,1111,16.0,843.0,843.0
0.004,6,10,2000,5,927,1.0,659.0,659.0,5,1073,1.0,805.0,805.0
0.006,6,10,1547,5,764,1.0,496.0,496.0,5,783,1.0,515.0,515.0
0.006,17,2,214,1,75,0.0,47.0,47.0,1,139,0.0,111.0,111.0
0.082,6,10,1506,5,395,17.0,127.0,127.0,5,1111,17.0,843.0,843.0
0.174,6,3,453,2,321,174.0,241.0,241.0,1,132,0.0,92.0,92.0
0.005,6,10,2006,5,927,1.0,659.0,659.0,5,1079,1.0,811.0,811.0
0.004,6,10,2000,5,927,1.0,659.0,659.0,5,1073,1.0,805.0,805.0
366.989,6,22,2313,16,867,24465.0,195.0,195.0,6,1446,4636.0,419.0,398.0
308.696,17,18,1008,9,640,38571.0,48.0,43.0,9,368,38572.0,20.0,12.0
0.017,6,10,1631,5,848,4.0,580.0,580.0,5,783,4.0,515.0,515.0
0.105,6,10,1506,5,395,22.0,127.0,127.0,5,1111,23.0,843.0,843.0
0.005,6,10,2006,5,927,1.0,659.0,659.0,5,1079,1.0,811.0,811.0
0.006,6,10,1547,5,764,1.0,496.0,496.0,5,783,1.0,515.0,515.0
0.004,6,10,2007,5,928,1.0,660.0,660.0,5,1079,1.0,811.0,811.0
240.085,6,16,4482,9,963,30010.0,238.0,166.0,7,3519,40013.0,1402.0,786.0
0.001,17,2,180,1,66,0.0,38.0,38.0,1,114,0.0,86.0,86.0
0.13,17,2,80,1,32,0.0,4.0,4.0,1,48,0.0,20.0,20.0
0.375,17,44,22082,23,18484,17.0,1350.0,775.0,21,3598,15.0,1350.0,143.0
174.215,17,76,10791,38,2541,4708.0,44.0,38.0,38,8250,4708.0,260.0,189.0
0.004,17,2,136,1,60,0.0,32.0,32.0,1,76,0.0,48.0,48.0
0.111,6,10,1506,5,395,25.0,127.0,127.0,5,1111,25.0,843.0,843.0
0.123,6,10,1506,5,395,29.0,127.0,127.0,5,1111,25.0,843.0,843.0
0.001,17,2,180,1,66,0.0,38.0,38.0,1,114,0.0,86.0,86.0
0.007,17,2,299,1,65,0.0,37.0,37.0,1,234,0.0,206.0,206.0
0.01,6,10,1989,5,910,2.0,642.0,642.0,5,1079,2.0,811.0,811.0
0.005,6,10,1774,5,923,1.0,655.0,655.0,5,851,1.0,583.0,583.0
0.005,6,14,3736,7,446,0.0,74.0,74.0,7,3290,0.0,1448.0,972.0
0.005,6,10,1779,5,928,1.0,660.0,660.0,5,851,1.0,583.0,583.0
241.665,6,35,18259,17,12676,15104.0,2736.0,1310.0,18,5583,14215.0,1655.0,1159.0
0.005,6,14,3742,7,452,0.0,80.0,80.0,7,3290,0.0,1448.0,972.0
0.08,6,10,1506,5,395,17.0,127.0,127.0,5,1111,18.0,843.0,843.0
0.035,6,10,1972,5,910,8.0,642.0,642.0,5,1062,8.0,794.0,794.0
0.003,17,2,136,1,60,0.0,32.0,32.0,1,76,0.0,48.0,48.0
0.014,6,10,1990,5,911,3.0,643.0,643.0,5,1079,3.0,811.0,811.0
0.001,17,2,136,1,60,0.0,32.0,32.0,1,76,0.0,48.0,48.0
290.752,6,405,348190,198,21857,1475.0,2695.0,889.0,207,326333,1411.0,2804.0,1635.0
0.126,6,10,1506,5,395,30.0,127.0,127.0,5,1111,30.0,843.0,843.0
0.01,6,10,1989,5,910,2.0,642.0,642.0,5,1079,2.0,811.0,811.0
0.005,6,10,1689,5,839,1.0,571.0,571.0,5,850,1.0,582.0,582.0
0.114,6,10,1506,5,395,25.0,127.0,127.0,5,1111,25.0,843.0,843.0
0.013,6,10,1762,5,911,3.0,643.0,643.0,5,851,3.0,583.0,583.0
192.585,6,55,10807,32,4068,6212.0,633.0,185.0,23,6739,8753.0,1402.0,462.0
0.005,17,2,180,1,58,0.0,30.0,30.0,1,122,0.0,94.0,94.0
0.005,6,10,1643,5,860,1.0,592.0,592.0,5,783,1.0,515.0,515.0
176.332,6,22,9233,11,1575,81.0,794.0,367.0,11,7658,17619.0,1360.0,1029.0
0.006,6,10,1547,5,764,1.0,496.0,496.0,5,783,1.0,515.0,515.0
0.004,6,10,1702,5,863,0.0,595.0,595.0,5,839,1.0,571.0,571.0
0.01,6,10,1989,5,910,2.0,642.0,642.0,5,1079,2.0,811.0,811.0
0.005,6,10,2000,5,927,1.0,659.0,659.0,5,1073,1.0,805.0,805.0
0.005,6,10,1643,5,860,1.0,592.0,592.0,5,783,1.0,515.0,515.0
0.006,6,10,2000,5,927,1.0,659.0,659.0,5,1073,1.0,805.0,805.0
0.006,17,2,166,1,75,0.0,47.0,47.0,1,91,0.0,63.0,63.0
0.113,6,10,1506,5,395,25.0,127.0,127.0,5,1111,25.0,843.0,843.0
0.037,17,2,182,1,65,0.0,37.0,37.0,1,117,0.0,89.0,89.0
0.005,6,10,2007,5,928,1.0,660.0,660.0,5,1079,1.0,811.0,811.0
40.057,17,10,676,5,460,10013.0,104.0,64.0,5,216,10013.0,20.0,15.0
0.103,6,10,1506,5,395,23.0,127.0,127.0,5,1111,24.0,843.0,843.0
0.106,6,10,1506,5,395,25.0,127.0,127.0,5,1111,24.0,843.0,843.0
0.812,6,10,937,6,427,162.0,107.0,107.0,4,510,181.0,294.0,294.0
308.489,17,20,1124,10,716,34264.0,48.0,43.0,10,408,34265.0,20.0,12.0
0.007,6,10,1989,5,910,1.0,642.0,642.0,5,1079,1.0,811.0,811.0
1778.77,17,144,45504,72,22752,25053.0,288.0,288.0,72,22752,25053.0,288.0,288.0
300.321,6,27,7433,16,1409,20021.0,217.0,142.0,11,6024,24027.0,1679.0,777.0
0.006,17,2,170,1,65,0.0,37.0,37.0,1,105,0.0,77.0,77.0
0.015,6,10,1631,5,848,3.0,580.0,580.0,5,783,3.0,515.0,515.0
0.009,6,10,1989,5,910,2.0,642.0,642.0,5,1079,2.0,811.0,811.0
0.005,17,2,148,1,60,0.0,32.0,32.0,1,88,0.0,60.0,60.0
0.001,17,2,136,1,60,0.0,32.0,32.0,1,76,0.0,48.0,48.0
0.008,6,10,1989,5,910,2.0,642.0,642.0,5,1079,1.0,811.0,811.0
0.005,6,10,2006,5,927,1.0,659.0,659.0,5,1079,1.0,811.0,811.0
0.005,6,10,2000,5,927,1.0,659.0,659.0,5,1073,1.0,805.0,805.0
0.001,17,2,180,1,66,0.0,38.0,38.0,1,114,0.0,86.0,86.0
0.027,6,10,1972,5,910,6.0,642.0,642.0,5,1062,6.0,794.0,794.0
0.005,6,10,2007,5,928,1.0,660.0,660.0,5,1079,1.0,811.0,811.0
0.014,6,10,1972,5,910,3.0,642.0,642.0,5,1062,3.0,794.0,794.0
0.015,6,10,1990,5,911,3.0,643.0,643.0,5,1079,3.0,811.0,811.0
0.016,6,10,1990,5,911,3.0,643.0,643.0,5,1079,4.0,811.0,811.0
0.133,17,2,80,1,32,0.0,4.0,4.0,1,48,0.0,20.0,20.0
1799.208,6,240,46595,114,34014,15922.0,2499.0,1002.0,126,12581,14393.0,580.0,62.0
0.082,17,4,596,2,122,42.0,33.0,33.0,2,474,42.0,323.0,209.0
0.005,6,10,1702,5,863,1.0,595.0,595.0,5,839,1.0,571.0,571.0
0.001,17,2,136,1,60,0.0,32.0,32.0,1,76,0.0,48.0,48.0
0.015,6,10,1989,5,910,3.0,642.0,642.0,5,1079,3.0,811.0,811.0
0.005,6,10,1547,5,764,1.0,496.0,496.0,5,783,1.0,515.0,515.0
0.004,17,4,284,2,120,0.0,32.0,32.0,2,164,1.0,60.0,54.0
0.018,6,10,1989,5,910,4.0,642.0,642.0,5,1079,4.0,811.0,811.0
0.006,6,10,1854,5,889,1.0,621.0,621.0,5,965,1.0,697.0,697.0
0.008,6,13,3747,7,509,1.0,137.0,137.0,6,3238,1.0,1470.0,1459.0
0.005,17,2,170,1,65,0.0,37.0,37.0,1,105,0.0,77.0,77.0
0.006,6,12,1698,6,863,1.0,327.0,271.0,6,835,1.0,515.0,515.0
0.093,6,10,1506,5,395,21.0,127.0,127.0,5,1111,20.0,843.0,843.0
0.005,17,2,170,1,65,0.0,37.0,37.0,1,105,0.0,77.0,77.0
0.222,17,14,8577,7,4012,37.0,1350.0,545.0,7,4565,27.0,1350.0,624.0
0.001,17,2,178,1,81,0.0,53.0,53.0,1,97,0.0,69.0,69.0
0.016,6,10,1990,5,911,3.0,643.0,643.0,5,1079,4.0,811.0,811.0
0.043,17,4,596,2,122,3.0,33.0,33.0,2,474,2.0,323.0,209.0
0.008,6,10,1972,5,910,1.0,642.0,642.0,5,1062,2.0,794.0,794.0
0.004,6,10,2006,5,927,1.0,659.0,659.0,5,1079,1.0,811.0,811.0
314.911,17,20,1124,10,716,34983.0,48.0,43.0,10,408,34983.0,20.0,12.0
280.27,6,23,6075,10,1186,31141.0,267.0,156.0,13,4889,23354.0,1400.0,873.0
1770.631,17,120,11460,60,5460,30010.0,63.0,63.0,60,6000,30010.0,72.0,72.0
0.007,6,10,1547,5,764,1.0,496.0,496.0,5,783,1.0,515.0,515.0
0.004,17,2,136,1,60,0.0,32.0,32.0,1,76,0.0,48.0,48.0
0.006,6,10,1547,5,764,1.0,496.0,496.0,5,783,1.0,515.0,515.0
10.828,17,28,4423,14,1995,824.0,270.0,114.0,14,2428,824.0,587.0,145.0
0.001,17,2,180,1,66,0.0,38.0,38.0,1,114,0.0,86.0,86.0
0.117,6,10,1506,5,395,27.0,127.0,127.0,5,1111,25.0,843.0,843.0
0.012,6,10,1990,5,911,3.0,643.0,643.0,5,1079,2.0,811.0,811.0
0.006,6,10,2007,5,928,1.0,660.0,660.0,5,1079,1.0,811.0,811.0
0.008,17,2,179,1,71,0.0,43.0,43.0,1,108,0.0,80.0,80.0
0.219,6,16,2777,8,1395,31.0,533.0,323.0,8,1382,20.0,529.0,239.0
0.001,17,2,180,1,66,0.0,38.0,38.0,1,114,0.0,86.0,86.0
1770.467,6,83,4368,42,2210,43181.0,26.0,26.0,41,2158,44260.0,26.0,26.0
0.006,6,10,1547,5,764,1.0,496.0,496.0,5,783,1.0,515.0,515.0
0.01,6,10,1989,5,910,2.0,642.0,642.0,5,1079,2.0,811.0,811.0
1.217,6,31,13280,18,5881,71.0,1360.0,732.0,13,7399,86.0,2720.0,858.0
0.01,6,10,1677,5,827,2.0,559.0,559.0,5,850,2.0,582.0,582.0
10.868,17,28,4424,14,1995,827.0,270.0,114.0,14,2429,827.0,588.0,145.0
10.987,17,28,4421,14,1993,836.0,268.0,114.0,14,2428,836.0,587.0,145.0
40.054,17,10,676,5,460,10012.0,104.0,64.0,5,216,10012.0,20.0,15.0
0.077,6,10,1506,5,395,17.0,127.0,127.0,5,1111,17.0,843.0,843.0
0.156,6,10,1506,5,395,24.0,127.0,127.0,5,1111,36.0,843.0,843.0
0.019,6,10,1677,5,827,4.0,559.0,559.0,5,850,4.0,582.0,582.0
0.005,6,10,2006,5,927,1.0,659.0,659.0,5,1079,1.0,811.0,811.0
0.005,6,10,1989,5,927,1.0,659.0,659.0,5,1062,1.0,794.0,794.0
0.005,6,10,2006,5,927,1.0,659.0,659.0,5,1079,1.0,811.0,811.0
15.074,17,15,9239,8,6902,2149.0,1350.0,834.0,7,2337,2507.0,1350.0,305.0
0.009,6,10,1989,5,910,2.0,642.0,642.0,5,1079,2.0,811.0,811.0
0.006,17,2,166,1,75,0.0,47.0,47.0,1,91,0.0,63.0,63.0
0.004,17,2,136,1,60,0.0,32.0,32.0,1,76,0.0,48.0,48.0
0.005,6,10,1547,5,764,1.0,496.0,496.0,5,783,1.0,515.0,515.0
0.004,6,10,2000,5,927,1.0,659.0,659.0,5,1073,1.0,805.0,805.0
0.01,6,10,1677,5,827,2.0,559.0,559.0,5,850,2.0,582.0,582.0
0.001,17,2,180,1,66,0.0,38.0,38.0,1,114,0.0,86.0,86.0
40.063,17,10,676,5,460,10013.0,104.0,64.0,5,216,10015.0,20.0,15.0
240.101,6,31,9435,15,7040,17150.0,2164.0,696.0,16,2395,16006.0,580.0,194.0
0.218,6,16,2777,8,1395,31.0,533.0,323.0,8,1382,19.0,529.0,239.0
0.006,6,10,1547,5,764,1.0,496.0,496.0,5,783,1.0,515.0,515.0
0.106,6,10,1506,5,395,25.0,127.0,127.0,5,1111,23.0,843.0,843.0
9.047,6,39,10487,20,4929,476.0,1360.0,682.0,19,5558,490.0,2667.0,435.0
0.139,6,10,1506,5,395,33.0,127.0,127.0,5,1111,33.0,843.0,843.0
0.006,17,2,299,1,65,0.0,37.0,37.0,1,234,0.0,206.0,206.0
0.005,6,10,2006,5,927,1.0,659.0,659.0,5,1079,1.0,811.0,811.0
0.005,6,10,2006,5,927,1.0,659.0,659.0,5,1079,1.0,811.0,811.0
0.004,6,10,1779,5,928,1.0,660.0,660.0,5,851,1.0,583.0,583.0
0.022,6,10,1762,5,911,5.0,643.0,643.0,5,851,5.0,583.0,583.0
0.009,6,10,1972,5,910,2.0,642.0,642.0,5,1062,2.0,794.0,794.0
0.037,17,4,284,2,120,1.0,32.0,32.0,2,164,32.0,60.0,54.0
0.126,6,10,1506,5,395,23.0,127.0,127.0,5,1111,28.0,843.0,843.0
0.038,6,10,1983,5,910,9.0,642.0,642.0,5,1073,9.0,805.0,805.0
0.005,17,2,187,1,71,0.0,43.0,43.0,1,116,0.0,88.0,88.0
241.634,6,375,347517,191,21459,1271.0,2736.0,959.0,184,326058,1320.0,2804.0,1818.0
1787.058,6,154,19574,92,13852,19637.0,302.0,302.0,62,5722,29295.0,83.0,83.0
0.009,6,10,1762,5,911,2.0,643.0,643.0,5,851,2.0,583.0,583.0
0.09,6,10,1506,5,395,19.0,127.0,127.0,5,1111,19.0,843.0,843.0
0.04,17,4,284,2,120,0.0,32.0,32.0,2,164,33.0,60.0,54.0
0.005,6,10,2006,5,927,1.0,659.0,659.0,5,1079,1.0,811.0,811.0
0.011,6,10,1983,5,910,2.0,642.0,642.0,5,1073,2.0,805.0,805.0
0.021,6,10,1972,5,910,5.0,642.0,642.0,5,1062,5.0,794.0,794.0
0.005,17,2,179,1,71,0.0,43.0,43.0,1,108,0.0,80.0,80.0
0.116,6,10,1506,5,395,22.0,127.0,127.0,5,1111,26.0,843.0,843.0
0.004,6,10,1774,5,923,1.0,655.0,655.0,5,851,0.0,583.0,583.0
0.016,6,10,1989,5,910,4.0,642.0,642.0,5,1079,4.0,811.0,811.0
413.351,6,29,4409,12,3102,10913.0,494.0,494.0,17,1307,25834.0,83.0,83.0
0.014,6,13,3735,7,497,2.0,125.0,125.0,6,3238,2.0,1470.0,1459.0
0.006,6,10,1547,5,764,1.0,496.0,496.0,5,783,1.0,515.0,515.0
0.013,6,10,1990,5,911,3.0,643.0,643.0,5,1079,3.0,811.0,811.0
0.388,17,49,28109,28,24891,14.0,1350.0,860.0,21,3218,16.0,1350.0,125.0
0.011,6,10,1983,5,910,2.0,642.0,642.0,5,1073,2.0,805.0,805.0
0.01,6,13,3735,7,497,1.0,125.0,125.0,6,3238,2.0,1470.0,1459.0
293.608,6,303,343857,117,17624,2531.0,2686.0,824.0,186,326233,1587.0,4136.0,1829.0
0.014,6,10,1989,5,910,3.0,642.0,642.0,5,1079,3.0,811.0,811.0
0.006,6,10,1643,5,860,1.0,592.0,592.0,5,783,1.0,515.0,515.0
0.01,6,10,1989,5,910,2.0,642.0,642.0,5,1079,2.0,811.0,811.0
0.006,6,10,1854,5,889,1.0,621.0,621.0,5,965,1.0,697.0,697.0
0.098,6,10,1506,5,395,22.0,127.0,127.0,5,1111,21.0,843.0,843.0
0.01,6,10,1990,5,911,2.0,643.0,643.0,5,1079,2.0,811.0,811.0
0.004,6,10,1702,5,863,1.0,595.0,595.0,5,839,1.0,571.0,571.0
0.014,6,10,1990,5,911,3.0,643.0,643.0,5,1079,3.0,811.0,811.0
0.004,6,10,1989,5,927,1.0,659.0,659.0,5,1062,1.0,794.0,794.0
0.001,17,2,180,1,66,0.0,38.0,38.0,1,114,0.0,86.0,86.0
310.231,17,20,1124,10,716,34455.0,48.0,43.0,10,408,34455.0,20.0,12.0
0.004,17,2,136,1,60,0.0,32.0,32.0,1,76,0.0,48.0,48.0
0.108,6,10,1506,5,395,23.0,127.0,127.0,5,1111,22.0,843.0,843.0
0.073,6,10,1506,5,395,15.0,127.0,127.0,5,1111,16.0,843.0,843.0
0.004,6,10,1779,5,928,1.0,660.0,660.0,5,851,1.0,583.0,583.0
0.004,6,10,2006,5,927,1.0,659.0,659.0,5,1079,1.0,811.0,811.0
0.006,6,10,1689,5,839,1.0,571.0,571.0,5,850,1.0,582.0,582.0
308.532,17,20,1124,10,716,34267.0,48.0,43.0,10,408,34267.0,20.0,12.0
40.06,17,10,676,5,460,10013.0,104.0,64.0,5,216,10014.0,20.0,15.0
0.005,6,10,2000,5,927,1.0,659.0,659.0,5,1073,1.0,805.0,805.0
0.108,6,10,1506,5,395,23.0,127.0,127.0,5,1111,19.0,843.0,843.0
0.006,6,10,1643,5,860,1.0,592.0,592.0,5,783,1.0,515.0,515.0
0.001,17,2,180,1,66,0.0,38.0,38.0,1,114,0.0,86.0,86.0
300.036,6,46,17863,25,12225,12494.0,2720.0,1119.0,21,5638,14993.0,2667.0,435.0
0.048,17,2,152,1,76,0.0,48.0,48.0,1,76,0.0,48.0,48.0
40.068,17,10,676,5,460,10014.0,104.0,64.0,5,216,10016.0,20.0,15.0
0.006,17,2,194,1,59,0.0,31.0,31.0,1,135,0.0,107.0,107.0
0.004,6,10,1702,5,863,1.0,595.0,595.0,5,839,1.0,571.0,571.0
0.023,6,10,1762,5,911,5.0,643.0,643.0,5,851,5.0,583.0,583.0
0.009,6,10,1972,5,910,2.0,642.0,642.0,5,1062,2.0,794.0,794.0
0.004,6,10,2006,5,927,1.0,659.0,659.0,5,1079,1.0,811.0,811.0
0.073,6,10,1506,5,395,16.0,127.0,127.0,5,1111,16.0,843.0,843.0
0.111,17,2,193,1,71,0.0,43.0,43.0,1,122,0.0,94.0,94.0
240.017,6,9,787,5,488,60004.0,232.0,232.0,4,299,80003.0,83.0,83.0
0.02,17,2,198,1,91,0.0,63.0,63.0,1,107,0.0,79.0,79.0
0.086,6,10,1506,5,395,20.0,127.0,127.0,5,1111,18.0,843.0,843.0
0.005,6,10,2006,5,927,1.0,659.0,659.0,5,1079,1.0,811.0,811.0
353.717,6,20,2210,6,1308,12004.0,494.0,494.0,14,902,27208.0,83.0,83.0
0.001,17,2,180,1,66,0.0,38.0,38.0,1,114,0.0,86.0,86.0
0.003,17,2,132,1,58,0.0,30.0,30.0,1,74,0.0,46.0,46.0
0.006,6,10,1643,5,860,1.0,592.0,592.0,5,783,1.0,515.0,515.0
40.047,17,10,676,5,460,10010.0,104.0,64.0,5,216,10010.0,20.0,15.0
0.009,6,12,1926,6,1189,1.0,659.0,434.0,6,737,1.0,417.0,417.0
0.005,6,10,2000,5,927,1.0,659.0,659.0,5,1073,1.0,805.0,805.0
0.01,6,10,1989,5,910,2.0,642.0,642.0,5,1079,2.0,811.0,811.0
0.005,6,10,2006,5,927,1.0,659.0,659.0,5,1079,1.0,811.0,811.0
0.005,6,10,2000,5,927,1.0,659.0,659.0,5,1073,1.0,805.0,805.0
240.122,6,31,9274,15,6948,17151.0,2072.0,685.0,16,2326,16007.0,580.0,185.0
0.006,6,10,1547,5,764,1.0,496.0,496.0,5,783,1.0,515.0,515.0
0.006,17,2,180,1,66,0.0,38.0,38.0,1,114,0.0,86.0,86.0
0.007,17,2,194,1,59,0.0,31.0,31.0,1,135,0.0,107.0,107.0
0.015,6,10,1990,5,911,3.0,643.0,643.0,5,1079,3.0,811.0,811.0
0.017,6,10,1990,5,911,4.0,643.0,643.0,5,1079,4.0,811.0,811.0
0.111,6,10,1506,5,395,26.0,127.0,127.0,5,1111,24.0,843.0,843.0
0.001,17,2,166,1,75,0.0,47.0,47.0,1,91,0.0,63.0,63.0
0.006,17,2,144,1,64,0.0,36.0,36.0,1,80,0.0,52.0,52.0
0.015,6,10,1972,5,910,3.0,642.0,642.0,5,1062,3.0,794.0,794.0
0.005,6,10,1774,5,923,1.0,655.0,655.0,5,851,1.0,583.0,583.0
0.014,6,10,1990,5,911,3.0,643.0,643.0,5,1079,3.0,811.0,811.0
0.009,6,10,1989,5,910,2.0,642.0,642.0,5,1079,2.0,811.0,811.0
0.011,6,10,1989,5,910,2.0,642.0,642.0,5,1079,2.0,811.0,811.0
0.008,6,10,1989,5,910,2.0,642.0,642.0,5,1079,2.0,811.0,811.0
0.005,6,10,2007,5,928,1.0,660.0,660.0,5,1079,1.0,811.0,811.0
0.018,6,10,1631,5,848,4.0,580.0,580.0,5,783,4.0,515.0,515.0
0.006,17,2,179,1,71,0.0,43.0,43.0,1,108,0.0,80.0,80.0
0.006,6,10,2006,5,927,1.0,659.0,659.0,5,1079,1.0,811.0,811.0
0.024,6,10,1762,5,911,5.0,643.0,643.0,5,851,6.0,583.0,583.0
0.226,6,16,2670,8,1396,32.0,533.0,324.0,8,1274,20.0,529.0,212.0
15.078,17,15,8109,8,6018,2150.0,1350.0,724.0,7,2091,2508.0,1350.0,270.0
0.164,17,2,152,1,76,0.0,48.0,48.0,1,76,0.0,48.0,48.0
0.005,6,13,3747,7,509,0.0,137.0,137.0,6,3238,0.0,1470.0,1459.0
0.012,6,10,1989,5,910,2.0,642.0,642.0,5,1079,2.0,811.0,811.0
0.017,6,10,1854,5,889,4.0,621.0,621.0,5,965,4.0,697.0,697.0
0.006,6,10,1547,5,764,1.0,496.0,496.0,5,783,1.0,515.0,515.0
0.005,6,13,3690,7,452,0.0,80.0,80.0,6,3238,1.0,1470.0,1459.0
0.001,17,2,179,1,62,0.0,34.0,34.0,1,117,0.0,89.0,89.0
0.03,6,10,1983,5,910,7.0,642.0,642.0,5,1073,7.0,805.0,805.0
0.115,17,2,80,1,32,0.0,4.0,4.0,1,48,0.0,20.0,20.0
0.003,17,2,136,1,60,0.0,32.0,32.0,1,76,0.0,48.0,48.0
0.089,6,10,1506,5,395,20.0,127.0,127.0,5,1111,20.0,843.0,843.0
0.296,17,41,20299,21,17036,14.0,1350.0,783.0,20,3263,12.0,1350.0,135.0
0.068,6,10,1506,5,395,16.0,127.0,127.0,5,1111,16.0,843.0,843.0
0.005,6,14,3742,7,452,0.0,80.0,80.0,7,3290,0.0,1448.0,972.0
294.206,6,323,345137,126,18101,2353.0,2736.0,825.0,197,327036,1501.0,2769.0,1731.0
0.001,17,2,180,1,66,0.0,38.0,38.0,1,114,0.0,86.0,86.0
291.487,6,316,343838,119,17737,2470.0,2736.0,825.0,197,326101,1487.0,2804.0,1725.0
0.01,6,10,1677,5,827,2.0,559.0,559.0,5,850,2.0,582.0,582.0
60.829,6,20,10024,11,3909,6082.0,1579.0,835.0,9,6115,7587.0,2225.0,939.0
40.056,17,10,676,5,460,10012.0,104.0,64.0,5,216,10013.0,20.0,15.0
0.006,17,2,179,1,71,0.0,43.0,43.0,1,108,0.0,80.0,80.0
301.609,6,64,35949,34,29722,9139.0,2720.0,1573.0,30,6227,325.0,2667.0,385.0
40.061,17,10,676,5,460,10014.0,104.0,64.0,5,216,10014.0,20.0,15.0
0.01,6,10,1972,5,910,2.0,642.0,642.0,5,1062,2.0,794.0,794.0
0.005,6,10,2000,5,927,1.0,659.0,659.0,5,1073,1.0,805.0,805.0
240.094,6,16,4482,9,963,30011.0,238.0,166.0,7,3519,40015.0,1402.0,786.0
0.071,6,10,1506,5,395,15.0,127.0,127.0,5,1111,14.0,843.0,843.0
0.008,17,2,140,1,62,0.0,34.0,34.0,1,78,0.0,50.0,50.0
40.072,17,10,676,5,460,10016.0,104.0,64.0,5,216,10017.0,20.0,15.0
0.005,6,10,2000,5,927,1.0,659.0,659.0,5,1073,1.0,805.0,805.0
0.094,6,10,1506,5,395,21.0,127.0,127.0,5,1111,17.0,843.0,843.0
9.039,17,6,376,5,280,2259.0,28.0,28.0,1,96,0.0,68.0,68.0
0.011,6,10,1990,5,911,2.0,643.0,643.0,5,1079,2.0,811.0,811.0
0.005,17,2,168,1,76,0.0,48.0,48.0,1,92,0.0,64.0,64.0
0.005,6,10,2006,5,927,1.0,659.0,659.0,5,1079,1.0,811.0,811.0
0.014,6,10,1989,5,910,3.0,642.0,642.0,5,1079,3.0,811.0,811.0
0.129,6,10,1506,5,395,28.0,127.0,127.0,5,1111,28.0,843.0,843.0
10.978,17,28,4368,14,2311,835.0,586.0,137.0,14,2057,835.0,268.0,118.0
0.019,6,10,1989,5,910,4.0,642.0,642.0,5,1079,4.0,811.0,811.0
0.004,17,2,136,1,60,0.0,32.0,32.0,1,76,0.0,48.0,48.0
0.005,6,10,2007,5,928,1.0,660.0,660.0,5,1079,1.0,811.0,811.0
0.005,17,2,335,1,68,0.0,40.0,40.0,1,267,0.0,239.0,239.0
0.004,6,10,2007,5,928,1.0,660.0,660.0,5,1079,1.0,811.0,811.0
0.174,17,2,80,1,32,0.0,4.0,4.0,1,48,0.0,20.0,20.0
0.006,6,10,1689,5,839,1.0,571.0,571.0,5,850,1.0,582.0,582.0
0.013,6,10,1762,5,911,3.0,643.0,643.0,5,851,3.0,583.0,583.0
0.121,6,10,1506,5,395,27.0,127.0,127.0,5,1111,25.0,843.0,843.0
0.003,17,2,136,1,60,0.0,32.0,32.0,1,76,0.0,48.0,48.0
40.059,17,10,676,5,460,10013.0,104.0,64.0,5,216,10014.0,20.0,15.0
0.08,6,10,1506,5,395,18.0,127.0,127.0,5,1111,17.0,843.0,843.0
0.018,6,10,1762,5,911,4.0,643.0,643.0,5,851,4.0,583.0,583.0
1729.22,6,60,4400,40,2740,44338.0,33.0,33.0,20,1660,91002.0,31.0,31.0
0.004,17,2,148,1,60,0.0,32.0,32.0,1,88,0.0,60.0,60.0
0.005,6,10,2006,5,927,1.0,659.0,659.0,5,1079,1.0,811.0,811.0
0.227,6,16,2777,8,1395,32.0,533.0,323.0,8,1382,20.0,529.0,239.0
0.039,17,2,148,1,60,0.0,32.0,32.0,1,88,0.0,60.0,60.0
0.014,6,10,1677,5,827,3.0,559.0,559.0,5,850,3.0,582.0,582.0
0.006,17,2,214,1,75,0.0,47.0,47.0,1,139,0.0,111.0,111.0
0.005,6,10,1989,5,927,1.0,659.0,659.0,5,1062,1.0,794.0,794.0
0.07,17,8,3613,4,1874,23.0,1350.0,440.0,4,1739,12.0,1350.0,406.0
1799.994,6,137,6590,76,3625,23996.0,39.0,39.0,61,2965,29996.0,35.0,35.0
0.003,17,2,136,1,60,0.0,32.0,32.0,1,76,0.0,48.0,48.0
0.005,17,2,148,1,60,0.0,32.0,32.0,1,88,0.0,60.0,60.0
0.014,6,10,1989,5,910,3.0,642.0,642.0,5,1079,3.0,811.0,811.0
361.827,6,19,1689,15,978,25844.0,190.0,190.0,4,711,80014.0,495.0,495.0
0.06,17,2,152,1,76,0.0,48.0,48.0,1,76,0.0,48.0,48.0
0.07,17,8,3613,4,1874,23.0,1350.0,440.0,4,1739,11.0,1350.0,406.0
40.097,17,10,676,5,460,10021.0,104.0,64.0,5,216,10023.0,20.0,15.0
0.229,6,16,2772,8,1390,32.0,533.0,322.0,8,1382,21.0,529.0,239.0
0.008,6,10,1677,5,827,2.0,559.0,559.0,5,850,2.0,582.0,582.0
0.006,6,13,3747,7,509,0.0,137.0,137.0,6,3238,1.0,1470.0,1459.0
0.005,6,10,2007,5,928,1.0,660.0,660.0,5,1079,1.0,811.0,811.0
0.013,6,10,1972,5,910,3.0,642.0,642.0,5,1062,3.0,794.0,794.0
0.006,6,10,1689,5,839,1.0,571.0,571.0,5,850,1.0,582.0,582.0
0.005,6,10,2006,5,927,1.0,659.0,659.0,5,1079,1.0,811.0,811.0
0.014,6,10,1983,5,910,3.0,642.0,642.0,5,1073,3.0,805.0,805.0
0.107,6,10,1506,5,395,24.0,127.0,127.0,5,1111,25.0,843.0,843.0
40.061,17,10,676,5,460,10013.0,104.0,64.0,5,216,10013.0,20.0,15.0
0.006,17,2,230,1,68,0.0,40.0,40.0,1,162,0.0,134.0,134.0
0.004,6,10,2006,5,927,1.0,659.0,659.0,5,1079,1.0,811.0,811.0
0.004,17,2,169,1,62,0.0,34.0,34.0,1,107,0.0,79.0,79.0
0.003,17,2,148,1,60,0.0,32.0,32.0,1,88,0.0,60.0,60.0
176.042,17,80,11486,40,2682,4513.0,44.0,39.0,40,8804,4513.0,249.0,192.0
0.085,6,10,1506,5,395,19.0,127.0,127.0,5,1111,20.0,843.0,843.0
0.011,6,10,1989,5,910,2.0,642.0,642.0,5,1079,2.0,811.0,811.0
0.005,6,10,1774,5,923,1.0,655.0,655.0,5,851,1.0,583.0,583.0
40.078,17,10,676,5,460,10017.0,104.0,64.0,5,216,10018.0,20.0,15.0
0.07,6,10,1506,5,395,16.0,127.0,127.0,5,1111,14.0,843.0,843.0
0.04,17,2,148,1,60,0.0,32.0,32.0,1,88,0.0,60.0,60.0
0.071,6,10,1506,5,395,15.0,127.0,127.0,5,1111,16.0,843.0,843.0
0.005,6,10,2006,5,927,1.0,659.0,659.0,5,1079,1.0,811.0,811.0
0.13,6,10,1506,5,395,29.0,127.0,127.0,5,1111,29.0,843.0,843.0
0.01,6,13,3735,7,497,1.0,125.0,125.0,6,3238,1.0,1470.0,1459.0
0.006,6,10,1547,5,764,1.0,496.0,496.0,5,783,1.0,515.0,515.0
0.014,6,10,1990,5,911,3.0,643.0,643.0,5,1079,3.0,811.0,811.0
0.01,6,10,1983,5,910,2.0,642.0,642.0,5,1073,2.0,805.0,805.0
0.006,6,10,1989,5,927,1.0,659.0,659.0,5,1062,1.0,794.0,794.0
0.005,6,10,2006,5,927,1.0,659.0,659.0,5,1079,1.0,811.0,811.0
0.005,6,14,3736,7,446,0.0,74.0,74.0,7,3290,0.0,1448.0,972.0
95.749,6,22,8498,12,2236,72.0,1345.0,574.0,10,6262,10619.0,2720.0,975.0
0.003,17,2,136,1,60,0.0,32.0,32.0,1,76,0.0,48.0,48.0
0.003,17,2,160,1,72,0.0,44.0,44.0,1,88,0.0,60.0,60.0
0.104,6,10,1506,5,395,23.0,127.0,127.0,5,1111,20.0,843.0,843.0
0.004,6,10,2006,5,927,1.0,659.0,659.0,5,1079,1.0,811.0,811.0
0.009,6,10,2007,5,928,2.0,660.0,660.0,5,1079,2.0,811.0,811.0
0.004,6,10,1779,5,928,1.0,660.0,660.0,5,851,1.0,583.0,583.0
0.072,17,2,148,1,60,0.0,32.0,32.0,1,88,0.0,60.0,60.0
0.007,6,10,1547,5,764,1.0,496.0,496.0,5,783,1.0,515.0,515.0
0.004,6,10,2006,5,927,1.0,659.0,659.0,5,1079,1.0,811.0,811.0
353.33,6,20,2210,6,1308,12003.0,494.0,494.0,14,902,27179.0,83.0,83.0
0.002,17,2,180,1,66,0.0,38.0,38.0,1,114,0.0,86.0,86.0
0.005,6,10,2007,5,928,1.0,660.0,660.0,5,1079,1.0,811.0,811.0
0.004,17,4,284,2,120,0.0,32.0,32.0,2,164,0.0,60.0,54.0
0.071,17,2,148,1,60,0.0,32.0,32.0,1,88,0.0,60.0,60.0
0.004,17,2,234,1,61,0.0,33.0,33.0,1,173,0.0,145.0,145.0
0.005,17,2,170,1,65,0.0,37.0,37.0,1,105,0.0,77.0,77.0
172.116,17,74,10507,37,2458,4780.0,44.0,38.0,37,8049,4780.0,239.0,189.0
0.005,6,10,2007,5,928,1.0,660.0,660.0,5,1079,1.0,811.0,811.0
0.01,6,10,1983,5,910,2.0,642.0,642.0,5,1073,2.0,805.0,805.0
94.938,6,33,6264,18,1338,5584.0,267.0,195.0,15,4926,603.0,1823.0,392.0
0.004,17,2,136,1,60,0.0,32.0,32.0,1,76,0.0,48.0,48.0
0.001,17,2,140,1,62,0.0,34.0,34.0,1,78,0.0,50.0,50.0
0.133,17,2,80,1,32,0.0,4.0,4.0,1,48,0.0,20.0,20.0
0.15,6,32,8653,17,2013,8.0,490.0,219.0,15,6640,9.0,1368.0,731.0
0.04,17,2,136,1,60,0.0,32.0,32.0,1,76,0.0,48.0,48.0
0.01,6,10,1989,5,910,2.0,642.0,642.0,5,1079,2.0,811.0,811.0
0.128,6,10,1506,5,395,29.0,127.0,127.0,5,1111,29.0,843.0,843.0
0.009,6,10,1989,5,910,2.0,642.0,642.0,5,1079,2.0,811.0,811.0
240.271,6,37,10226,19,2247,13348.0,524.0,250.0,18,7979,14133.0,1402.0,640.0
0.005,6,10,1989,5,927,1.0,659.0,659.0,5,1062,1.0,794.0,794.0
0.006,17,2,214,1,75,0.0,47.0,47.0,1,139,0.0,111.0,111.0
0.006,6,10,1854,5,889,1.0,621.0,621.0,5,965,1.0,697.0,697.0
0.005,6,10,1989,5,927,1.0,659.0,659.0,5,1062,1.0,794.0,794.0
0.005,6,10,2007,5,928,1.0,660.0,660.0,5,1079,1.0,811.0,811.0
0.004,17,2,136,1,60,0.0,32.0,32.0,1,76,0.0,48.0,48.0
0.005,17,2,169,1,62,0.0,34.0,34.0,1,107,0.0,79.0,79.0
0.126,6,10,1506,5,395,28.0,127.0,127.0,5,1111,29.0,843.0,843.0
0.006,6,10,1547,5,764,1.0,496.0,496.0,5,783,1.0,515.0,515.0
0.103,6,10,1506,5,395,25.0,127.0,127.0,5,1111,22.0,843.0,843.0
0.016,6,10,1677,5,827,4.0,559.0,559.0,5,850,3.0,582.0,582.0
0.025,6,10,1989,5,910,6.0,642.0,642.0,5,1079,6.0,811.0,811.0
0.066,6,10,1506,5,395,14.0,127.0,127.0,5,1111,13.0,843.0,843.0
0.073,17,4,596,2,122,1.0,33.0,33.0,2,474,32.0,323.0,209.0
293.379,6,396,347845,197,21810,1496.0,2736.0,889.0,199,326035,1481.0,2804.0,1706.0
0.006,6,10,1547,5,764,1.0,496.0,496.0,5,783,1.0,515.0,515.0
1756.769,6,105,6270,60,3525,29775.0,27.0,27.0,45,2745,39925.0,27.0,27.0
0.005,6,10,2006,5,927,1.0,659.0,659.0,5,1079,1.0,811.0,811.0
0.005,17,2,164,1,74,0.0,46.0,46.0,1,90,0.0,62.0,62.0
0.001,17,2,174,1,72,0.0,44.0,44.0,1,102,0.0,74.0,74.0
0.11,6,10,1506,5,395,25.0,127.0,127.0,5,1111,26.0,843.0,843.0
0.004,6,10,2007,5,928,1.0,660.0,660.0,5,1079,1.0,811.0,811.0
40.058,17,10,676,5,460,10013.0,104.0,64.0,5,216,10013.0,20.0,15.0
0.103,6,10,1506,5,395,23.0,127.0,127.0,5,1111,22.0,843.0,843.0
240.028,6,9,787,5,488,60007.0,232.0,232.0,4,299,80008.0,83.0,83.0
0.004,17,2,136,1,60,0.0,32.0,32.0,1,76,0.0,48.0,48.0
0.006,6,10,1547,5,764,1.0,496.0,496.0,5,783,1.0,515.0,515.0
0.005,6,10,2007,5,928,1.0,660.0,660.0,5,1079,1.0,811.0,811.0
0.071,17,4,284,2,120,0.0,32.0,32.0,2,164,68.0,60.0,54.0
0.015,6,10,1990,5,911,3.0,643.0,643.0,5,1079,3.0,811.0,811.0
0.005,6,10,1547,5,764,1.0,496.0,496.0,5,783,1.0,515.0,515.0
0.003,17,2,136,1,60,0.0,32.0,32.0,1,76,0.0,48.0,48.0
0.013,17,2,152,1,56,0.0,28.0,28.0,1,96,0.0,68.0,68.0
0.005,6,10,2006,5,927,1.0,659.0,659.0,5,1079,1.0,811.0,811.0
1770.307,6,84,4420,42,2210,43177.0,26.0,26.0,42,2210,43177.0,26.0,26.0
0.005,6,10,1989,5,927,1.0,659.0,659.0,5,1062,1.0,794.0,794.0
0.005,17,2,144,1,64,0.0,36.0,36.0,1,80,0.0,52.0,52.0
0.005,17,2,179,1,71,0.0,43.0,43.0,1,108,0.0,80.0,80.0
0.143,6,10,1506,5,395,33.0,127.0,127.0,5,1111,31.0,843.0,843.0
0.003,17,2,148,1,60,0.0,32.0,32.0,1,88,0.0,60.0,60.0
0.004,17,2,169,1,62,0.0,34.0,34.0,1,107,0.0,79.0,79.0
0.003,17,2,136,1,60,0.0,32.0,32.0,1,76,0.0,48.0,48.0
0.016,6,10,1983,5,910,4.0,642.0,642.0,5,1073,4.0,805.0,805.0
0.006,6,10,1983,5,910,1.0,642.0,642.0,5,1073,1.0,805.0,805.0
0.106,6,10,1506,5,395,23.0,127.0,127.0,5,1111,26.0,843.0,843.0
0.052,17,2,152,1,76,0.0,48.0,48.0,1,76,0.0,48.0,48.0
0.011,6,10,1677,5,827,2.0,559.0,559.0,5,850,2.0,582.0,582.0
0.007,6,10,1547,5,764,1.0,496.0,496.0,5,783,1.0,515.0,515.0
0.082,6,10,1506,5,395,18.0,127.0,127.0,5,1111,17.0,843.0,843.0
0.005,6,10,2000,5,927,1.0,659.0,659.0,5,1073,1.0,805.0,805.0
15.076,17,15,9238,8,6902,2149.0,1350.0,834.0,7,2336,2507.0,1350.0,305.0
0.008,6,10,1990,5,911,2.0,643.0,643.0,5,1079,2.0,811.0,811.0
0.018,6,10,1989,5,910,4.0,642.0,642.0,5,1079,4.0,811.0,811.0
0.006,6,10,1689,5,839,1.0,571.0,571.0,5,850,1.0,582.0,582.0
0.073,6,10,1506,5,395,17.0,127.0,127.0,5,1111,16.0,843.0,843.0
0.08,6,10,1506,5,395,17.0,127.0,127.0,5,1111,14.0,843.0,843.0
240.013,6,9,787,5,488,60003.0,232.0,232.0,4,299,80003.0,83.0,83.0
0.071,6,10,1506,5,395,15.0,127.0,127.0,5,1111,15.0,843.0,843.0
0.012,6,10,1983,5,910,3.0,642.0,642.0,5,1073,2.0,805.0,805.0
0.091,6,10,1506,5,395,20.0,127.0,127.0,5,1111,19.0,843.0,843.0
40.041,17,10,676,5,460,10009.0,104.0,64.0,5,216,10009.0,20.0,15.0
0.005,6,10,2007,5,928,1.0,660.0,660.0,5,1079,1.0,811.0,811.0
0.001,17,2,180,1,66,0.0,38.0,38.0,1,114,0.0,86.0,86.0
0.081,6,10,1506,5,395,18.0,127.0,127.0,5,1111,17.0,843.0,843.0
0.084,6,10,1506,5,395,19.0,127.0,127.0,5,1111,20.0,843.0,843.0
15.07,17,15,9238,8,6902,2148.0,1350.0,834.0,7,2336,2506.0,1350.0,305.0
0.085,6,10,1506,5,395,18.0,127.0,127.0,5,1111,20.0,843.0,843.0
0.008,6,10,1547,5,764,2.0,496.0,496.0,5,783,1.0,515.0,515.0
0.017,6,10,1983,5,910,4.0,642.0,642.0,5,1073,4.0,805.0,805.0
0.104,6,10,1506,5,395,24.0,127.0,127.0,5,1111,22.0,843.0,843.0
0.005,17,2,144,1,64,0.0,36.0,36.0,1,80,0.0,52.0,52.0
0.004,6,14,3736,7,446,0.0,74.0,74.0,7,3290,0.0,1448.0,972.0
1756.995,6,106,6322,60,3525,29778.0,27.0,27.0,46,2797,39043.0,27.0,27.0
0.011,6,10,1972,5,910,2.0,642.0,642.0,5,1062,2.0,794.0,794.0
0.078,6,10,1506,5,395,16.0,127.0,127.0,5,1111,19.0,843.0,843.0
354.017,6,21,1795,16,1030,23601.0,190.0,190.0,5,765,60002.0,464.0,248.0
368.68,6,24,2405,17,919,23042.0,195.0,195.0,7,1486,3902.0,419.0,398.0
0.011,6,10,1983,5,910,2.0,642.0,642.0,5,1073,2.0,805.0,805.0
967.221,6,83,34052,43,8392,23029.0,676.0,512.0,40,25660,23261.0,1942.0,873.0
0.016,6,10,1983,5,910,4.0,642.0,642.0,5,1073,4.0,805.0,805.0
0.011,6,10,1989,5,910,2.0,642.0,642.0,5,1079,2.0,811.0,811.0
0.008,6,10,1989,5,910,2.0,642.0,642.0,5,1079,1.0,811.0,811.0
0.014,6,10,1989,5,910,3.0,642.0,642.0,5,1079,3.0,811.0,811.0
0.005,6,10,1689,5,839,1.0,571.0,571.0,5,850,1.0,582.0,582.0
0.004,6,10,2000,5,927,1.0,659.0,659.0,5,1073,1.0,805.0,805.0
0.005,6,10,1989,5,927,1.0,659.0,659.0,5,1062,1.0,794.0,794.0
40.052,17,10,676,5,460,10012.0,104.0,64.0,5,216,10012.0,20.0,15.0
0.014,6,10,1677,5,827,3.0,559.0,559.0,5,850,3.0,582.0,582.0
0.005,17,2,169,1,62,0.0,34.0,34.0,1,107,0.0,79.0,79.0
0.003,17,2,148,1,60,0.0,32.0,32.0,1,88,0.0,60.0,60.0
0.009,6,10,1983,5,910,2.0,642.0,642.0,5,1073,2.0,805.0,805.0
0.019,6,10,1989,5,910,4.0,642.0,642.0,5,1079,4.0,811.0,811.0
0.004,6,10,1779,5,928,1.0,660.0,660.0,5,851,1.0,583.0,583.0
300.43,6,16,2170,9,684,37532.0,146.0,146.0,7,1486,50042.0,419.0,398.0
0.001,17,2,180,1,66,0.0,38.0,38.0,1,114,0.0,86.0,86.0
0.116,6,10,1506,5,395,24.0,127.0,127.0,5,1111,24.0,843.0,843.0
0.009,6,10,1989,5,910,2.0,642.0,642.0,5,1079,2.0,811.0,811.0
0.018,6,10,1989,5,910,4.0,642.0,642.0,5,1079,4.0,811.0,811.0
0.013,6,10,1989,5,910,3.0,642.0,642.0,5,1079,3.0,811.0,811.0
0.008,6,10,1989,5,910,2.0,642.0,642.0,5,1079,2.0,811.0,811.0
0.006,6,10,1689,5,839,1.0,571.0,571.0,5,850,1.0,582.0,582.0
0.01,6,10,1989,5,910,2.0,642.0,642.0,5,1079,2.0,811.0,811.0
0.007,6,10,1643,5,860,1.0,592.0,592.0,5,783,1.0,515.0,515.0
0.101,6,10,1506,5,395,23.0,127.0,127.0,5,1111,22.0,843.0,843.0
0.005,6,10,1989,5,927,1.0,659.0,659.0,5,1062,1.0,794.0,794.0
0.071,17,2,186,1,61,0.0,33.0,33.0,1,125,0.0,97.0,97.0
0.014,6,13,3735,7,497,2.0,125.0,125.0,6,3238,2.0,1470.0,1459.0
40.079,17,10,676,5,460,10018.0,104.0,64.0,5,216,10018.0,20.0,15.0
0.007,6,13,3690,7,452,1.0,80.0,80.0,6,3238,1.0,1470.0,1459.0
0.005,6,10,2000,5,927,1.0,659.0,659.0,5,1073,1.0,805.0,805.0
0.005,6,10,1989,5,927,1.0,659.0,659.0,5,1062,1.0,794.0,794.0
308.553,17,20,1124,10,716,34269.0,48.0,43.0,10,408,34270.0,20.0,12.0
0.004,6,10,2007,5,928,1.0,660.0,660.0,5,1079,1.0,811.0,811.0
0.011,6,10,1989,5,910,2.0,642.0,642.0,5,1079,2.0,811.0,811.0
0.005,6,10,2006,5,927,1.0,659.0,659.0,5,1079,1.0,811.0,811.0
0.082,6,10,1506,5,395,18.0,127.0,127.0,5,1111,19.0,843.0,843.0
0.009,6,10,1990,5,911,2.0,643.0,643.0,5,1079,2.0,811.0,811.0
0.096,6,10,1506,5,395,21.0,127.0,127.0,5,1111,18.0,843.0,843.0
290.928,6,335,345625,124,18008,2365.0,2736.0,888.0,211,327617,1385.0,2933.0,1607.0
0.074,6,10,1506,5,395,16.0,127.0,127.0,5,1111,15.0,843.0,843.0
0.005,6,10,1779,5,928,1.0,660.0,660.0,5,851,1.0,583.0,583.0
0.066,17,8,3613,4,1874,22.0,1350.0,440.0,4,1739,11.0,1350.0,406.0
241.823,6,301,342580,117,17591,2084.0,2736.0,885.0,184,324989,1321.0,2804.0,1812.0
0.074,6,10,1506,5,395,16.0,127.0,127.0,5,1111,17.0,843.0,843.0
297.0,6,367,347430,189,21396,1579.0,2736.0,889.0,178,326034,1677.0,2804.0,1931.0
0.004,6,10,1702,5,863,0.0,595.0,595.0,5,839,1.0,571.0,571.0
0.005,6,10,1989,5,927,1.0,659.0,659.0,5,1062,1.0,794.0,794.0
0.004,6,10,2007,5,928,1.0,660.0,660.0,5,1079,1.0,811.0,811.0
0.006,6,10,1547,5,764,1.0,496.0,496.0,5,783,1.0,515.0,515.0
0.004,17,2,148,1,60,0.0,32.0,32.0,1,88,0.0,60.0,60.0
0.009,6,10,1762,5,911,2.0,643.0,643.0,5,851,2.0,583.0,583.0
0.01,6,10,1972,5,910,2.0,642.0,642.0,5,1062,2.0,794.0,794.0
0.087,6,10,1506,5,395,18.0,127.0,127.0,5,1111,19.0,843.0,843.0
0.079,6,10,1506,5,395,16.0,127.0,127.0,5,1111,16.0,843.0,843.0
0.017,6,10,1983,5,910,4.0,642.0,642.0,5,1073,4.0,805.0,805.0
0.008,17,2,169,1,62,0.0,34.0,34.0,1,107,0.0,79.0,79.0
0.015,6,10,1762,5,911,3.0,643.0,643.0,5,851,3.0,583.0,583.0
0.004,6,10,2006,5,927,1.0,659.0,659.0,5,1079,1.0,811.0,811.0
0.117,6,10,1506,5,395,27.0,127.0,127.0,5,1111,24.0,843.0,843.0
0.005,6,10,2006,5,927,1.0,659.0,659.0,5,1079,1.0,811.0,811.0
0.191,17,4,352,2,130,153.0,37.0,37.0,2,222,150.0,89.0,83.0
0.008,6,10,2000,5,927,2.0,659.0,659.0,5,1073,2.0,805.0,805.0
0.216,6,16,2669,8,1395,30.0,533.0,323.0,8,1274,19.0,529.0,212.0
291.902,6,393,347725,192,21548,1528.0,2692.0,888.0,201,326177,1459.0,2804.0,1688.0
309.128,17,20,1124,10,716,34333.0,48.0,43.0,10,408,34333.0,20.0,12.0
0.029,17,2,180,1,66,0.0,38.0,38.0,1,114,0.0,86.0,86.0
0.163,17,2,152,1,76,0.0,48.0,48.0,1,76,0.0,48.0,48.0
308.251,17,20,1124,10,716,34235.0,48.0,43.0,10,408,34235.0,20.0,12.0
0.001,17,2,179,1,62,0.0,34.0,34.0,1,117,0.0,89.0,89.0
0.005,6,10,1854,5,889,1.0,621.0,621.0,5,965,1.0,697.0,697.0
0.071,17,2,136,1,60,0.0,32.0,32.0,1,76,0.0,48.0,48.0
0.005,17,2,180,1,58,0.0,30.0,30.0,1,122,0.0,94.0,94.0
0.011,6,10,1631,5,848,2.0,580.0,580.0,5,783,2.0,515.0,515.0
308.979,17,20,1124,10,716,34316.0,48.0,43.0,10,408,34316.0,20.0,12.0
0.005,6,10,2006,5,927,1.0,659.0,659.0,5,1079,1.0,811.0,811.0
0.004,17,4,284,2,120,0.0,32.0,32.0,2,164,0.0,60.0,54.0
175.135,17,96,13780,48,3228,3726.0,44.0,39.0,48,10552,3726.0,261.0,191.0
0.004,6,10,1779,5,928,1.0,660.0,660.0,5,851,1.0,583.0,583.0
0.013,17,2,152,1,56,0.0,28.0,28.0,1,96,0.0,68.0,68.0
0.175,17,2,80,1,32,0.0,4.0,4.0,1,48,0.0,20.0,20.0
0.086,6,10,1506,5,395,18.0,127.0,127.0,5,1111,19.0,843.0,843.0
0.062,17,2,152,1,76,0.0,48.0,48.0,1,76,0.0,48.0,48.0
0.005,6,10,2000,5,927,1.0,659.0,659.0,5,1073,1.0,805.0,805.0
0.012,17,2,148,1,60,0.0,32.0,32.0,1,88,0.0,60.0,60.0
0.013,6,10,1631,5,848,3.0,580.0,580.0,5,783,3.0,515.0,515.0
0.011,6,10,2006,5,927,2.0,659.0,659.0,5,1079,2.0,811.0,811.0
0.072,17,2,148,1,60,0.0,32.0,32.0,1,88,0.0,60.0,60.0
0.014,6,10,1989,5,910,3.0,642.0,642.0,5,1079,3.0,811.0,811.0
0.014,6,10,1989,5,910,3.0,642.0,642.0,5,1079,3.0,811.0,811.0
0.073,17,4,284,2,120,0.0,32.0,32.0,2,164,68.0,60.0,54.0
0.005,17,2,140,1,62,0.0,34.0,34.0,1,78,0.0,50.0,50.0
622.736,6,48,20247,26,6825,24909.0,1402.0,605.0,22,13422,26794.0,1402.0,943.0
0.126,6,10,1242,5,751,31.0,495.0,495.0,5,491,29.0,223.0,223.0
0.108,6,10,1506,5,395,25.0,127.0,127.0,5,1111,23.0,843.0,843.0
0.004,6,10,2000,5,927,1.0,659.0,659.0,5,1073,1.0,805.0,805.0
0.105,6,10,1506,5,395,22.0,127.0,127.0,5,1111,24.0,843.0,843.0
0.006,6,10,1547,5,764,1.0,496.0,496.0,5,783,1.0,515.0,515.0
0.114,6,10,1506,5,395,24.0,127.0,127.0,5,1111,24.0,843.0,843.0
0.123,17,2,80,1,32,0.0,4.0,4.0,1,48,0.0,20.0,20.0
298.006,6,322,344966,129,18267,2328.0,2736.0,889.0,193,326699,1552.0,2804.0,1769.0
300.031,6,12,1782,7,1348,50005.0,494.0,494.0,5,434,75006.0,83.0,83.0
0.005,6,10,2007,5,928,1.0,660.0,660.0,5,1079,1.0,811.0,811.0
0.01,6,10,1972,5,910,2.0,642.0,642.0,5,1062,2.0,794.0,794.0
0.01,6,13,3735,7,497,1.0,125.0,125.0,6,3238,2.0,1470.0,1459.0
0.013,6,10,1990,5,911,3.0,643.0,643.0,5,1079,3.0,811.0,811.0
0.017,6,13,3735,7,497,2.0,125.0,125.0,6,3238,3.0,1470.0,1459.0
0.004,6,10,2006,5,927,1.0,659.0,659.0,5,1079,1.0,811.0,811.0
0.005,6,10,1689,5,839,1.0,571.0,571.0,5,850,1.0,582.0,582.0
0.017,6,10,1990,5,911,4.0,643.0,643.0,5,1079,4.0,811.0,811.0
0.041,17,2,148,1,60,0.0,32.0,32.0,1,88,0.0,60.0,60.0
0.007,17,2,194,1,59,0.0,31.0,31.0,1,135,0.0,107.0,107.0
40.061,17,10,676,5,460,10013.0,104.0,64.0,5,216,10014.0,20.0,15.0
0.008,6,12,1926,6,1189,1.0,659.0,434.0,6,737,1.0,417.0,417.0
0.004,6,10,1989,5,927,1.0,659.0,659.0,5,1062,1.0,794.0,794.0
0.006,6,10,2007,5,928,1.0,660.0,660.0,5,1079,1.0,811.0,811.0
15.073,17,15,9238,8,6902,2149.0,1350.0,834.0,7,2336,2507.0,1350.0,305.0
0.014,6,10,1990,5,911,3.0,643.0,643.0,5,1079,3.0,811.0,811.0
290.975,6,393,348310,212,22576,1379.0,2736.0,888.0,181,325734,1616.0,2769.0,1894.0
0.007,6,10,1547,5,764,1.0,496.0,496.0,5,783,1.0,515.0,515.0
0.008,6,10,1989,5,910,2.0,642.0,642.0,5,1079,1.0,811.0,811.0
0.004,17,2,144,1,64,0.0,36.0,36.0,1,80,0.0,52.0,52.0
0.005,6,10,2006,5,927,1.0,659.0,659.0,5,1079,1.0,811.0,811.0
0.009,6,10,1990,5,911,2.0,643.0,643.0,5,1079,2.0,811.0,811.0
0.005,6,10,2007,5,928,1.0,660.0,660.0,5,1079,1.0,811.0,811.0
0.021,6,10,1990,5,911,5.0,643.0,643.0,5,1079,5.0,811.0,811.0
0.007,6,10,1774,5,923,1.0,655.0,655.0,5,851,1.0,583.0,583.0
300.369,6,16,2170,9,684,37525.0,146.0,146.0,7,1486,50034.0,419.0,398.0
0.13,17,2,136,1,60,0.0,32.0,32.0,1,76,0.0,48.0,48.0
0.123,6,10,1506,5,395,26.0,127.0,127.0,5,1111,29.0,843.0,843.0
0.003,17,2,148,1,60,0.0,32.0,32.0,1,88,0.0,60.0,60.0
0.037,17,2,152,1,76,0.0,48.0,48.0,1,76,0.0,48.0,48.0
0.127,17,2,144,1,64,0.0,36.0,36.0,1,80,0.0,52.0,52.0
0.01,6,10,1990,5,911,2.0,643.0,643.0,5,1079,2.0,811.0,811.0
40.067,17,10,676,5,460,10014.0,104.0,64.0,5,216,10016.0,20.0,15.0
40.11,17,10,676,5,460,10014.0,104.0,64.0,5,216,10024.0,20.0,15.0
0.005,17,2,170,1,65,0.0,37.0,37.0,1,105,0.0,77.0,77.0
0.043,6,10,1972,5,910,10.0,642.0,642.0,5,1062,10.0,794.0,794.0
240.016,6,9,787,5,488,60004.0,232.0,232.0,4,299,80004.0,83.0,83.0
0.005,6,10,1643,5,860,1.0,592.0,592.0,5,783,1.0,515.0,515.0
0.009,6,10,1972,5,910,2.0,642.0,642.0,5,1062,2.0,794.0,794.0
0.014,6,10,1972,5,910,3.0,642.0,642.0,5,1062,3.0,794.0,794.0
40.06,17,10,676,5,460,10012.0,104.0,64.0,5,216,10013.0,20.0,15.0
0.079,6,10,1506,5,395,18.0,127.0,127.0,5,1111,18.0,843.0,843.0
172.071,17,88,12769,44,2960,4001.0,44.0,39.0,44,9809,4001.0,261.0,194.0
0.004,17,2,146,1,65,0.0,37.0,37.0,1,81,0.0,53.0,53.0
0.016,6,10,1990,5,911,4.0,643.0,643.0,5,1079,3.0,811.0,811.0
40.062,17,10,676,5,460,10014.0,104.0,64.0,5,216,10014.0,20.0,15.0
0.003,17,2,148,1,60,0.0,32.0,32.0,1,88,0.0,60.0,60.0
0.04,17,2,412,1,61,0.0,33.0,33.0,1,351,0.0,323.0,323.0
0.005,17,2,212,1,63,0.0,35.0,35.0,1,149,0.0,121.0,121.0
0.118,6,10,1506,5,395,25.0,127.0,127.0,5,1111,27.0,843.0,843.0
0.016,6,10,1990,5,911,4.0,643.0,643.0,5,1079,4.0,811.0,811.0
0.024,6,14,3868,7,578,3.0,206.0,206.0,7,3290,4.0,1448.0,972.0
0.006,6,10,1547,5,764,1.0,496.0,496.0,5,783,1.0,515.0,515.0
0.064,6,10,1506,5,395,13.0,127.0,127.0,5,1111,15.0,843.0,843.0
0.01,17,2,154,1,69,0.0,41.0,41.0,1,85,0.0,57.0,57.0
0.009,6,10,1989,5,910,2.0,642.0,642.0,5,1079,2.0,811.0,811.0
0.013,6,10,1990,5,911,3.0,643.0,643.0,5,1079,3.0,811.0,811.0
0.069,17,8,3613,4,1874,23.0,1350.0,440.0,4,1739,11.0,1350.0,406.0
11.15,17,28,4421,14,1994,845.0,269.0,114.0,14,2427,845.0,586.0,145.0
0.009,6,12,1926,6,1189,1.0,659.0,434.0,6,737,1.0,417.0,417.0
0.005,17,2,164,1,74,0.0,46.0,46.0,1,90,0.0,62.0,62.0
0.081,6,10,1506,5,395,17.0,127.0,127.0,5,1111,18.0,843.0,843.0
0.006,17,2,164,1,74,0.0,46.0,46.0,1,90,0.0,62.0,62.0
0.019,17,2,138,1,61,0.0,33.0,33.0,1,77,0.0,49.0,49.0
240.015,6,9,787,5,488,60003.0,232.0,232.0,4,299,80003.0,83.0,83.0
0.006,6,10,1547,5,764,1.0,496.0,496.0,5,783,1.0,515.0,515.0
0.001,17,2,180,1,66,0.0,38.0,38.0,1,114,0.0,86.0,86.0
0.011,6,10,1989,5,910,2.0,642.0,642.0,5,1079,2.0,811.0,811.0
0.103,6,10,1506,5,395,18.0,127.0,127.0,5,1111,24.0,843.0,843.0
0.016,6,10,1990,5,911,3.0,643.0,643.0,5,1079,4.0,811.0,811.0
0.009,6,10,1990,5,911,2.0,643.0,643.0,5,1079,2.0,811.0,811.0
0.005,6,10,1689,5,839,1.0,571.0,571.0,5,850,1.0,582.0,582.0
0.079,6,10,1506,5,395,16.0,127.0,127.0,5,1111,14.0,843.0,843.0
0.014,6,10,1983,5,910,3.0,642.0,642.0,5,1073,3.0,805.0,805.0
15.073,17,15,9239,8,6902,2149.0,1350.0,834.0,7,2337,2507.0,1350.0,305.0
0.005,17,2,170,1,65,0.0,37.0,37.0,1,105,0.0,77.0,77.0
10.789,17,28,4423,14,1995,821.0,270.0,114.0,14,2428,821.0,587.0,145.0
0.005,6,10,1989,5,927,1.0,659.0,659.0,5,1062,1.0,794.0,794.0
0.005,6,10,2006,5,927,1.0,659.0,659.0,5,1079,1.0,811.0,811.0
0.01,6,13,3735,7,497,1.0,125.0,125.0,6,3238,2.0,1470.0,1459.0
240.341,6,33,9268,16,1836,16022.0,624.0,199.0,17,7432,15021.0,1402.0,595.0
0.072,6,10,1506,5,395,15.0,127.0,127.0,5,1111,16.0,843.0,843.0
0.003,6,10,1702,5,863,0.0,595.0,595.0,5,839,0.0,571.0,571.0
0.005,17,2,140,1,62,0.0,34.0,34.0,1,78,0.0,50.0,50.0
0.009,6,12,1926,6,1189,1.0,659.0,434.0,6,737,1.0,417.0,417.0
0.006,6,10,1854,5,889,1.0,621.0,621.0,5,965,1.0,697.0,697.0
0.008,6,10,1989,5,910,2.0,642.0,642.0,5,1079,2.0,811.0,811.0
177.017,17,106,15447,53,3579,3404.0,44.0,39.0,53,11868,3404.0,239.0,195.0
0.079,6,10,1506,5,395,17.0,127.0,127.0,5,1111,18.0,843.0,843.0
0.008,6,10,1972,5,910,2.0,642.0,642.0,5,1062,2.0,794.0,794.0
0.127,6,10,1506,5,395,30.0,127.0,127.0,5,1111,23.0,843.0,843.0
0.057,6,10,1506,5,395,13.0,127.0,127.0,5,1111,14.0,843.0,843.0
40.056,17,10,676,5,460,10013.0,104.0,64.0,5,216,10013.0,20.0,15.0
10.781,17,28,4418,14,1993,820.0,268.0,114.0,14,2425,820.0,588.0,145.0
0.005,6,10,2006,5,927,1.0,659.0,659.0,5,1079,1.0,811.0,811.0
0.006,6,10,1643,5,860,1.0,592.0,592.0,5,783,1.0,515.0,515.0
0.006,6,10,1547,5,764,1.0,496.0,496.0,5,783,1.0,515.0,515.0
0.008,6,10,1990,5,911,2.0,643.0,643.0,5,1079,2.0,811.0,811.0
300.319,6,16,2170,9,684,37519.0,146.0,146.0,7,1486,50025.0,419.0,398.0
0.017,6,10,1989,5,910,4.0,642.0,642.0,5,1079,4.0,811.0,811.0
0.01,6,10,1762,5,911,2.0,643.0,643.0,5,851,2.0,583.0,583.0
240.403,6,33,9689,16,1763,16024.0,539.0,184.0,17,7926,15022.0,1402.0,640.0
40.057,17,10,676,5,460,10013.0,104.0,64.0,5,216,10013.0,20.0,15.0
0.005,17,2,170,1,65,0.0,37.0,37.0,1,105,0.0,77.0,77.0
0.101,6,10,1506,5,395,22.0,127.0,127.0,5,1111,22.0,843.0,843.0
0.092,6,10,1506,5,395,21.0,127.0,127.0,5,1111,22.0,843.0,843.0
0.042,17,2,136,1,60,0.0,32.0,32.0,1,76,0.0,48.0,48.0
354.009,6,19,1691,15,978,25286.0,190.0,190.0,4,713,80003.0,497.0,497.0
0.005,17,2,169,1,62,0.0,34.0,34.0,1,107,0.0,79.0,79.0
0.013,6,10,1989,5,910,3.0,642.0,642.0,5,1079,3.0,811.0,811.0
0.007,6,10,1547,5,764,1.0,496.0,496.0,5,783,1.0,515.0,515.0
0.016,6,10,1972,5,910,4.0,642.0,642.0,5,1062,3.0,794.0,794.0
0.157,6,10,1506,5,395,30.0,127.0,127.0,5,1111,38.0,843.0,843.0
0.008,17,2,179,1,71,0.0,43.0,43.0,1,108,0.0,80.0,80.0
0.011,6,10,1631,5,848,2.0,580.0,580.0,5,783,2.0,515.0,515.0
0.007,6,10,1689,5,839,1.0,571.0,571.0,5,850,1.0,582.0,582.0
0.025,6,10,1989,5,910,6.0,642.0,642.0,5,1079,6.0,811.0,811.0
0.07,6,10,1506,5,395,16.0,127.0,127.0,5,1111,16.0,843.0,843.0
0.013,6,10,1972,5,910,3.0,642.0,642.0,5,1062,3.0,794.0,794.0
0.089,6,10,1506,5,395,17.0,127.0,127.0,5,1111,20.0,843.0,843.0
0.005,6,10,1643,5,860,1.0,592.0,592.0,5,783,1.0,515.0,515.0
0.006,6,10,1854,5,889,1.0,621.0,621.0,5,965,1.0,697.0,697.0
240.016,6,9,787,5,488,60004.0,232.0,232.0,4,299,80004.0,83.0,83.0
0.11,6,10,1506,5,395,26.0,127.0,127.0,5,1111,24.0,843.0,843.0
0.008,6,10,1989,5,910,1.0,642.0,642.0,5,1079,1.0,811.0,811.0
0.005,6,10,2007,5,928,1.0,660.0,660.0,5,1079,1.0,811.0,811.0
10.932,17,28,4422,14,1995,832.0,270.0,114.0,14,2427,832.0,586.0,145.0
40.074,17,10,676,5,460,10017.0,104.0,64.0,5,216,10017.0,20.0,15.0
0.004,6,10,2007,5,928,1.0,660.0,660.0,5,1079,1.0,811.0,811.0
0.003,17,2,152,1,76,0.0,48.0,48.0,1,76,0.0,48.0,48.0
0.006,6,10,2007,5,928,1.0,660.0,660.0,5,1079,1.0,811.0,811.0
0.071,17,2,170,1,65,0.0,37.0,37.0,1,105,0.0,77.0,77.0
0.005,6,13,3690,7,452,0.0,80.0,80.0,6,3238,0.0,1470.0,1459.0
0.005,6,10,2007,5,928,1.0,660.0,660.0,5,1079,1.0,811.0,811.0
0.006,17,2,179,1,71,0.0,43.0,43.0,1,108,0.0,80.0,80.0
0.072,17,4,596,2,122,1.0,33.0,33.0,2,474,32.0,323.0,209.0
0.167,17,2,152,1,76,0.0,48.0,48.0,1,76,0.0,48.0,48.0
0.022,6,10,1989,5,910,5.0,642.0,642.0,5,1079,5.0,811.0,811.0
0.157,6,10,1506,5,395,34.0,127.0,127.0,5,1111,34.0,843.0,843.0
0.012,6,10,1990,5,911,3.0,643.0,643.0,5,1079,3.0,811.0,811.0
0.005,6,10,1989,5,927,1.0,659.0,659.0,5,1062,1.0,794.0,794.0
0.004,17,4,284,2,120,0.0,32.0,32.0,2,164,1.0,60.0,54.0
0.01,6,10,1989,5,910,2.0,642.0,642.0,5,1079,2.0,811.0,811.0
0.004,17,4,284,2,120,0.0,32.0,32.0,2,164,0.0,60.0,54.0
0.005,6,10,2006,5,927,1.0,659.0,659.0,5,1079,1.0,811.0,811.0
0.013,6,10,1990,5,911,3.0,643.0,643.0,5,1079,3.0,811.0,811.0
0.003,17,2,136,1,60,0.0,32.0,32.0,1,76,0.0,48.0,48.0
0.074,6,10,1506,5,395,16.0,127.0,127.0,5,1111,17.0,843.0,843.0
10.78,17,28,4420,14,1993,820.0,268.0,114.0,14,2427,820.0,586.0,145.0
0.211,6,16,2779,8,1397,30.0,533.0,324.0,8,1382,19.0,529.0,239.0
0.005,6,10,1989,5,927,1.0,659.0,659.0,5,1062,1.0,794.0,794.0
0.011,6,10,1989,5,910,2.0,642.0,642.0,5,1079,2.0,811.0,811.0
0.144,6,10,1506,5,395,17.0,127.0,127.0,5,1111,33.0,843.0,843.0
0.006,6,10,2006,5,927,1.0,659.0,659.0,5,1079,1.0,811.0,811.0
0.005,6,10,2006,5,927,1.0,659.0,659.0,5,1079,1.0,811.0,811.0
0.005,6,10,2007,5,928,1.0,660.0,660.0,5,1079,1.0,811.0,811.0
0.005,6,10,1989,5,927,1.0,659.0,659.0,5,1062,1.0,794.0,794.0
0.093,6,10,1506,5,395,19.0,127.0,127.0,5,1111,22.0,843.0,843.0
11.222,17,28,4417,14,1993,850.0,268.0,114.0,14,2424,851.0,587.0,145.0
0.005,6,10,1643,5,860,1.0,592.0,592.0,5,783,1.0,515.0,515.0
0.008,17,4,284,2,120,5.0,32.0,32.0,2,164,4.0,60.0,54.0
0.008,6,10,1972,5,910,2.0,642.0,642.0,5,1062,2.0,794.0,794.0
0.026,6,10,1989,5,910,6.0,642.0,642.0,5,1079,6.0,811.0,811.0
0.126,6,10,1506,5,395,29.0,127.0,127.0,5,1111,29.0,843.0,843.0
40.073,17,10,676,5,460,10016.0,104.0,64.0,5,216,10017.0,20.0,15.0
0.006,6,10,1547,5,764,1.0,496.0,496.0,5,783,1.0,515.0,515.0
0.006,6,10,1689,5,839,1.0,571.0,571.0,5,850,1.0,582.0,582.0
0.017,6,10,1762,5,911,4.0,643.0,643.0,5,851,4.0,583.0,583.0
291.252,6,410,348395,199,21915,1470.0,2691.0,770.0,211,326480,1386.0,2804.0,1601.0
0.113,6,10,1506,5,395,25.0,127.0,127.0,5,1111,23.0,843.0,843.0
0.004,17,2,136,1,60,0.0,32.0,32.0,1,76,0.0,48.0,48.0
0.016,6,10,1762,5,911,4.0,643.0,643.0,5,851,3.0,583.0,583.0
0.005,6,13,3747,7,509,0.0,137.0,137.0,6,3238,1.0,1470.0,1459.0
0.007,6,12,1698,6,863,1.0,327.0,271.0,6,835,1.0,515.0,515.0
0.005,17,2,194,1,59,0.0,31.0,31.0,1,135,0.0,107.0,107.0
0.006,6,10,1989,5,927,1.0,659.0,659.0,5,1062,1.0,794.0,794.0
0.103,6,10,1506,5,395,22.0,127.0,127.0,5,1111,24.0,843.0,843.0
0.001,17,2,180,1,66,0.0,38.0,38.0,1,114,0.0,86.0,86.0
0.008,6,10,1972,5,910,2.0,642.0,642.0,5,1062,2.0,794.0,794.0
0.233,6,16,2778,8,1396,33.0,533.0,324.0,8,1382,21.0,529.0,239.0
0.005,17,2,213,1,69,0.0,41.0,41.0,1,144,0.0,116.0,116.0
0.005,6,10,2006,5,927,1.0,659.0,659.0,5,1079,1.0,811.0,811.0
0.005,6,10,2000,5,927,1.0,659.0,659.0,5,1073,1.0,805.0,805.0
0.004,17,2,148,1,60,0.0,32.0,32.0,1,88,0.0,60.0,60.0
0.012,6,10,1989,5,910,2.0,642.0,642.0,5,1079,2.0,811.0,811.0
0.004,6,10,2006,5,927,1.0,659.0,659.0,5,1079,1.0,811.0,811.0
0.005,17,2,179,1,71,0.0,43.0,43.0,1,108,0.0,80.0,80.0
0.006,6,10,1643,5,860,1.0,592.0,592.0,5,783,1.0,515.0,515.0
0.113,6,10,1506,5,395,18.0,127.0,127.0,5,1111,26.0,843.0,843.0
40.066,17,10,676,5,460,10015.0,104.0,64.0,5,216,10015.0,20.0,15.0
40.074,17,10,676,5,460,10015.0,104.0,64.0,5,216,10017.0,20.0,15.0
0.006,6,10,1547,5,764,1.0,496.0,496.0,5,783,1.0,515.0,515.0
0.007,6,10,1854,5,889,1.0,621.0,621.0,5,965,1.0,697.0,697.0
300.123,6,40,10153,21,4595,14997.0,1360.0,620.0,19,5558,16664.0,2667.0,435.0
0.004,6,10,2007,5,928,1.0,660.0,660.0,5,1079,1.0,811.0,811.0
0.016,6,10,1990,5,911,4.0,643.0,643.0,5,1079,3.0,811.0,811.0
0.008,6,10,1762,5,911,2.0,643.0,643.0,5,851,1.0,583.0,583.0
0.111,6,10,1506,5,395,25.0,127.0,127.0,5,1111,26.0,843.0,843.0
0.016,6,10,1990,5,911,3.0,643.0,643.0,5,1079,4.0,811.0,811.0
240.329,6,26,11134,13,4936,20027.0,1740.0,852.0,13,6198,20027.0,1656.0,919.0
360.072,6,21,3981,13,3142,30006.0,494.0,494.0,8,839,51438.0,83.0,83.0
0.009,6,10,1689,5,839,2.0,571.0,571.0,5,850,2.0,582.0,582.0
0.104,6,10,1506,5,395,23.0,127.0,127.0,5,1111,19.0,843.0,843.0
0.006,6,10,1854,5,889,1.0,621.0,621.0,5,965,1.0,697.0,697.0
0.005,6,10,1689,5,839,1.0,571.0,571.0,5,850,1.0,582.0,582.0
0.062,6,8,832,4,522,20.0,302.0,302.0,4,310,20.0,102.0,102.0
0.001,17,2,180,1,66,0.0,38.0,38.0,1,114,0.0,86.0,86.0
0.217,6,16,2779,8,1397,31.0,533.0,324.0,8,1382,19.0,529.0,239.0
172.369,17,84,11934,42,2800,4204.0,44.0,38.0,42,9134,4204.0,239.0,189.0
0.005,17,2,230,1,68,0.0,40.0,40.0,1,162,0.0,134.0,134.0
0.004,6,10,1702,5,863,1.0,595.0,595.0,5,839,1.0,571.0,571.0
0.044,17,2,148,1,60,0.0,32.0,32.0,1,88,0.0,60.0,60.0
0.119,6,10,1506,5,395,24.0,127.0,127.0,5,1111,23.0,843.0,843.0
0.006,6,10,1547,5,764,1.0,496.0,496.0,5,783,1.0,515.0,515.0
0.11,6,10,1506,5,395,23.0,127.0,127.0,5,1111,23.0,843.0,843.0
15.083,17,15,8654,8,6415,2150.0,1350.0,773.0,7,2239,2509.0,1350.0,291.0
0.015,6,10,1989,5,910,3.0,642.0,642.0,5,1079,3.0,811.0,811.0
0.01,6,10,1631,5,848,2.0,580.0,580.0,5,783,2.0,515.0,515.0
0.004,6,10,2007,5,928,1.0,660.0,660.0,5,1079,1.0,811.0,811.0
0.078,6,10,1506,5,395,17.0,127.0,127.0,5,1111,17.0,843.0,843.0
241.548,6,373,347165,188,21314,1291.0,2736.0,960.0,185,325851,1312.0,2804.0,1806.0
0.124,6,10,1506,5,395,30.0,127.0,127.0,5,1111,27.0,843.0,843.0
0.005,6,10,1643,5,860,1.0,592.0,592.0,5,783,1.0,515.0,515.0
0.077,6,10,1506,5,395,18.0,127.0,127.0,5,1111,17.0,843.0,843.0
0.012,6,10,1990,5,911,3.0,643.0,643.0,5,1079,2.0,811.0,811.0
0.005,6,10,2000,5,927,1.0,659.0,659.0,5,1073,1.0,805.0,805.0
240.15,6,46,6798,22,3221,11435.0,588.0,229.0,24,3577,10441.0,580.0,211.0
40.066,17,10,676,5,460,10014.0,104.0,64.0,5,216,10015.0,20.0,15.0
240.013,6,9,787,5,488,60003.0,232.0,232.0,4,299,80003.0,83.0,83.0
0.005,6,10,2007,5,928,1.0,660.0,660.0,5,1079,1.0,811.0,811.0
0.009,6,10,1989,5,910,2.0,642.0,642.0,5,1079,2.0,811.0,811.0
11.001,17,28,4392,14,2313,837.0,588.0,137.0,14,2079,837.0,270.0,120.0
0.004,17,2,148,1,60,0.0,32.0,32.0,1,88,0.0,60.0,60.0
0.001,17,2,179,1,62,0.0,34.0,34.0,1,117,0.0,89.0,89.0
0.008,6,10,1983,5,910,2.0,642.0,642.0,5,1073,1.0,805.0,805.0
66.121,6,27,17543,15,9603,4722.0,2804.0,1469.0,12,7940,5995.0,2311.0,1218.0
300.391,6,16,2170,9,684,37527.0,146.0,146.0,7,1486,50037.0,419.0,398.0
40.077,17,10,676,5,460,10018.0,104.0,64.0,5,216,10018.0,20.0,15.0
0.013,6,10,1990,5,911,3.0,643.0,643.0,5,1079,3.0,811.0,811.0
0.007,6,10,1547,5,764,1.0,496.0,496.0,5,783,1.0,515.0,515.0
534.172,6,73,18500,35,14295,15710.0,2497.0,891.0,38,4205,14436.0,580.0,92.0
0.133,6,10,1506,5,395,32.0,127.0,127.0,5,1111,27.0,843.0,843.0
0.116,6,10,1506,5,395,25.0,127.0,127.0,5,1111,27.0,843.0,843.0
1770.288,6,83,4368,42,2210,43176.0,26.0,26.0,41,2158,44256.0,26.0,26.0
0.224,6,16,2670,8,1396,32.0,533.0,324.0,8,1274,20.0,529.0,212.0
0.171,6,3,453,2,321,171.0,241.0,241.0,1,132,0.0,92.0,92.0
240.243,6,39,5331,18,2602,14131.0,588.0,207.0,21,2729,12012.0,580.0,202.0
0.038,17,2,184,1,61,0.0,33.0,33.0,1,123,0.0,95.0,95.0
0.018,6,10,1989,5,910,4.0,642.0,642.0,5,1079,4.0,811.0,811.0
0.005,6,10,1547,5,764,1.0,496.0,496.0,5,783,1.0,515.0,515.0
0.013,6,10,1972,5,910,3.0,642.0,642.0,5,1062,3.0,794.0,794.0
240.096,6,16,4481,9,963,30012.0,238.0,166.0,7,3518,40015.0,1402.0,786.0
0.06,17,2,152,1,76,0.0,48.0,48.0,1,76,0.0,48.0,48.0
40.08,17,10,676,5,460,10018.0,104.0,64.0,5,216,10019.0,20.0,15.0
0.006,17,2,166,1,75,0.0,47.0,47.0,1,91,0.0,63.0,63.0
0.005,17,2,144,1,64,0.0,36.0,36.0,1,80,0.0,52.0,52.0
0.072,17,2,424,1,72,0.0,44.0,44.0,1,352,0.0,324.0,324.0
0.037,6,10,1990,5,911,9.0,643.0,643.0,5,1079,9.0,811.0,811.0
0.005,6,10,1989,5,927,1.0,659.0,659.0,5,1062,1.0,794.0,794.0
0.003,17,2,136,1,60,0.0,32.0,32.0,1,76,0.0,48.0,48.0
300.183,6,27,7436,16,1409,20012.0,217.0,142.0,11,6027,24016.0,1679.0,778.0
0.01,6,10,1677,5,827,2.0,559.0,559.0,5,850,2.0,582.0,582.0
300.405,6,16,2170,9,684,37528.0,146.0,146.0,7,1486,50038.0,419.0,398.0
0.126,6,10,1506,5,395,29.0,127.0,127.0,5,1111,27.0,843.0,843.0
0.008,6,10,2000,5,927,1.0,659.0,659.0,5,1073,2.0,805.0,805.0
0.125,6,10,1506,5,395,28.0,127.0,127.0,5,1111,28.0,843.0,843.0
0.012,6,10,1983,5,910,2.0,642.0,642.0,5,1073,2.0,805.0,805.0
40.073,17,10,676,5,460,10017.0,104.0,64.0,5,216,10017.0,20.0,15.0
0.072,6,10,1506,5,395,16.0,127.0,127.0,5,1111,15.0,843.0,843.0
0.006,6,10,1854,5,889,1.0,621.0,621.0,5,965,1.0,697.0,697.0
0.006,17,2,136,1,60,0.0,32.0,32.0,1,76,0.0,48.0,48.0
0.117,6,10,1506,5,395,28.0,127.0,127.0,5,1111,27.0,843.0,843.0
40.065,17,10,676,5,460,10015.0,104.0,64.0,5,216,10013.0,20.0,15.0
0.004,6,10,2007,5,928,1.0,660.0,660.0,5,1079,1.0,811.0,811.0
0.004,6,10,2006,5,927,1.0,659.0,659.0,5,1079,1.0,811.0,811.0
0.005,6,10,1989,5,927,1.0,659.0,659.0,5,1062,1.0,794.0,794.0
0.005,6,10,2006,5,927,1.0,659.0,659.0,5,1079,1.0,811.0,811.0
0.005,6,10,2000,5,927,1.0,659.0,659.0,5,1073,1.0,805.0,805.0
0.005,17,2,214,1,75,0.0,47.0,47.0,1,139,0.0,111.0,111.0
0.081,6,10,1506,5,395,16.0,127.0,127.0,5,1111,18.0,843.0,843.0
0.172,17,2,152,1,76,0.0,48.0,48.0,1,76,0.0,48.0,48.0
0.006,6,10,1643,5,860,1.0,592.0,592.0,5,783,1.0,515.0,515.0
0.008,6,10,1972,5,910,2.0,642.0,642.0,5,1062,1.0,794.0,794.0
0.006,6,10,1689,5,839,1.0,571.0,571.0,5,850,1.0,582.0,582.0
11.398,17,28,4397,14,2312,864.0,587.0,137.0,14,2085,864.0,268.0,120.0
0.004,17,2,148,1,60,0.0,32.0,32.0,1,88,0.0,60.0,60.0
0.004,17,4,284,2,120,0.0,32.0,32.0,2,164,1.0,60.0,54.0
353.277,6,20,2210,6,1308,12005.0,494.0,494.0,14,902,27174.0,83.0,83.0
0.005,6,10,2006,5,927,1.0,659.0,659.0,5,1079,1.0,811.0,811.0
0.002,17,2,136,1,60,0.0,32.0,32.0,1,76,0.0,48.0,48.0
0.081,6,10,1506,5,395,17.0,127.0,127.0,5,1111,17.0,843.0,843.0
240.01,6,9,787,5,488,60002.0,232.0,232.0,4,299,80002.0,83.0,83.0
0.012,6,10,1631,5,848,3.0,580.0,580.0,5,783,3.0,515.0,515.0
0.005,6,10,2000,5,927,1.0,659.0,659.0,5,1073,1.0,805.0,805.0
40.05,17,10,676,5,460,10011.0,104.0,64.0,5,216,10011.0,20.0,15.0
0.006,6,10,2006,5,927,1.0,659.0,659.0,5,1079,1.0,811.0,811.0
0.021,6,10,1989,5,910,5.0,642.0,642.0,5,1079,5.0,811.0,811.0
412.259,6,29,4409,12,3102,10911.0,494.0,494.0,17,1307,25766.0,83.0,83.0
0.008,6,10,1989,5,910,2.0,642.0,642.0,5,1079,2.0,811.0,811.0
0.012,17,2,136,1,60,0.0,32.0,32.0,1,76,0.0,48.0,48.0
0.006,6,10,1689,5,839,1.0,571.0,571.0,5,850,1.0,582.0,582.0
0.011,6,10,1762,5,911,2.0,643.0,643.0,5,851,2.0,583.0,583.0
0.003,17,2,136,1,60,0.0,32.0,32.0,1,76,0.0,48.0,48.0
0.006,6,10,1989,5,927,1.0,659.0,659.0,5,1062,1.0,794.0,794.0
0.073,6,10,1506,5,395,17.0,127.0,127.0,5,1111,14.0,843.0,843.0
0.005,6,10,2007,5,928,1.0,660.0,660.0,5,1079,1.0,811.0,811.0
0.014,6,10,1983,5,910,3.0,642.0,642.0,5,1073,3.0,805.0,805.0
0.224,6,16,2778,8,1396,32.0,533.0,324.0,8,1382,20.0,529.0,239.0
0.005,6,14,3742,7,452,0.0,80.0,80.0,7,3290,0.0,1448.0,972.0
0.034,6,10,1677,5,827,8.0,559.0,559.0,5,850,8.0,582.0,582.0
0.013,6,10,1972,5,910,3.0,642.0,642.0,5,1062,3.0,794.0,794.0
0.005,6,10,1989,5,927,1.0,659.0,659.0,5,1062,1.0,794.0,794.0
0.115,6,10,1506,5,395,24.0,127.0,127.0,5,1111,27.0,843.0,843.0
292.088,6,404,348149,196,21765,1497.0,2736.0,826.0,208,326384,1411.0,2804.0,1626.0
0.009,6,10,1972,5,910,2.0,642.0,642.0,5,1062,2.0,794.0,794.0
0.069,6,10,1989,5,910,17.0,642.0,642.0,5,1079,17.0,811.0,811.0
0.005,6,10,2006,5,927,1.0,659.0,659.0,5,1079,1.0,811.0,811.0
0.009,6,10,1972,5,910,2.0,642.0,642.0,5,1062,2.0,794.0,794.0
0.191,6,3,453,2,321,191.0,241.0,241.0,1,132,0.0,92.0,92.0
40.064,17,10,676,5,460,10015.0,104.0,64.0,5,216,10015.0,20.0,15.0
0.016,6,10,1631,5,848,4.0,580.0,580.0,5,783,4.0,515.0,515.0
0.006,6,10,1547,5,764,1.0,496.0,496.0,5,783,1.0,515.0,515.0
0.111,6,10,1506,5,395,25.0,127.0,127.0,5,1111,24.0,843.0,843.0
0.014,6,10,1990,5,911,3.0,643.0,643.0,5,1079,3.0,811.0,811.0
0.087,6,10,1506,5,395,20.0,127.0,127.0,5,1111,19.0,843.0,843.0
15.07,17,15,9238,8,6902,2148.0,1350.0,834.0,7,2336,2506.0,1350.0,305.0
0.006,6,10,1547,5,764,1.0,496.0,496.0,5,783,1.0,515.0,515.0
280.252,6,24,6115,11,1226,28025.0,267.0,156.0,13,4889,23353.0,1400.0,873.0
300.261,6,19,3084,11,1647,30026.0,517.0,266.0,8,1437,34321.0,824.0,337.0
0.013,6,10,1762,5,911,3.0,643.0,643.0,5,851,3.0,583.0,583.0
0.006,6,10,1547,5,764,1.0,496.0,496.0,5,783,1.0,515.0,515.0
0.012,6,10,1677,5,827,3.0,559.0,559.0,5,850,3.0,582.0,582.0
0.005,6,10,1989,5,927,1.0,659.0,659.0,5,1062,1.0,794.0,794.0
40.067,17,10,676,5,460,10015.0,104.0,64.0,5,216,10016.0,20.0,15.0
0.019,6,10,1972,5,910,4.0,642.0,642.0,5,1062,4.0,794.0,794.0
0.008,17,2,162,1,65,0.0,37.0,37.0,1,97,0.0,69.0,69.0
0.006,6,10,1547,5,764,1.0,496.0,496.0,5,783,1.0,515.0,515.0
0.09,6,10,1506,5,395,20.0,127.0,127.0,5,1111,21.0,843.0,843.0
0.587,17,15,8557,7,6010,97.0,1350.0,830.0,8,2547,79.0,1350.0,290.0
0.004,6,10,1989,5,927,1.0,659.0,659.0,5,1062,1.0,794.0,794.0
40.079,17,10,676,5,460,10016.0,104.0,64.0,5,216,10018.0,20.0,15.0
0.006,6,10,1547,5,764,1.0,496.0,496.0,5,783,1.0,515.0,515.0
308.529,17,20,1124,10,716,34266.0,48.0,43.0,10,408,34266.0,20.0,12.0
0.013,6,10,1983,5,910,3.0,642.0,642.0,5,1073,3.0,805.0,805.0
0.095,6,10,1506,5,395,21.0,127.0,127.0,5,1111,22.0,843.0,843.0
290.217,6,370,347545,182,21022,1603.0,2736.0,825.0,188,326523,1551.0,2804.0,1809.0
0.098,6,10,1506,5,395,23.0,127.0,127.0,5,1111,19.0,843.0,843.0
300.984,6,45,14739,24,8872,13086.0,2720.0,985.0,21,5867,440.0,2667.0,385.0
300.98,6,50,16133,25,10061,12540.0,4080.0,1288.0,25,6072,367.0,1360.0,337.0
0.003,17,2,136,1,60,0.0,32.0,32.0,1,76,0.0,48.0,48.0
0.002,17,2,180,1,66,0.0,38.0,38.0,1,114,0.0,86.0,86.0
0.013,6,10,1972,5,910,3.0,642.0,642.0,5,1062,3.0,794.0,794.0
0.013,6,10,1972,5,910,3.0,642.0,642.0,5,1062,3.0,794.0,794.0
0.011,6,10,1972,5,910,2.0,642.0,642.0,5,1062,2.0,794.0,794.0
0.013,6,10,1677,5,827,3.0,559.0,559.0,5,850,3.0,582.0,582.0
0.095,6,10,1506,5,395,20.0,127.0,127.0,5,1111,21.0,843.0,843.0
0.006,6,10,1854,5,889,1.0,621.0,621.0,5,965,1.0,697.0,697.0
0.005,6,10,2006,5,927,1.0,659.0,659.0,5,1079,1.0,811.0,811.0
0.201,6,3,453,2,321,201.0,241.0,241.0,1,132,0.0,92.0,92.0
0.01,6,13,3735,7,497,1.0,125.0,125.0,6,3238,1.0,1470.0,1459.0
0.018,17,4,284,2,120,10.0,32.0,32.0,2,164,9.0,60.0,54.0
0.011,6,13,3735,7,497,1.0,125.0,125.0,6,3238,2.0,1470.0,1459.0
0.005,6,10,1689,5,839,1.0,571.0,571.0,5,850,1.0,582.0,582.0
0.083,6,10,1506,5,395,18.0,127.0,127.0,5,1111,18.0,843.0,843.0
0.016,6,10,1631,5,848,4.0,580.0,580.0,5,783,4.0,515.0,515.0
0.013,6,10,1972,5,910,3.0,642.0,642.0,5,1062,3.0,794.0,794.0
0.005,6,10,2006,5,927,1.0,659.0,659.0,5,1079,1.0,811.0,811.0
0.006,17,2,164,1,74,0.0,46.0,46.0,1,90,0.0,62.0,62.0
40.056,17,10,676,5,460,10013.0,104.0,64.0,5,216,10013.0,20.0,15.0
0.128,6,10,1506,5,395,28.0,127.0,127.0,5,1111,27.0,843.0,843.0
0.012,6,10,1972,5,910,3.0,642.0,642.0,5,1062,2.0,794.0,794.0
0.021,6,10,1677,5,827,5.0,559.0,559.0,5,850,5.0,582.0,582.0
0.071,6,10,1506,5,395,13.0,127.0,127.0,5,1111,16.0,843.0,843.0
0.004,6,10,1989,5,927,1.0,659.0,659.0,5,1062,1.0,794.0,794.0
0.005,17,2,164,1,74,0.0,46.0,46.0,1,90,0.0,62.0,62.0
0.006,6,10,1854,5,889,1.0,621.0,621.0,5,965,1.0,697.0,697.0
0.009,6,10,1972,5,910,2.0,642.0,642.0,5,1062,2.0,794.0,794.0
0.008,6,10,1989,5,910,2.0,642.0,642.0,5,1079,1.0,811.0,811.0
0.004,17,2,148,1,60,0.0,32.0,32.0,1,88,0.0,60.0,60.0
0.013,6,10,1989,5,910,3.0,642.0,642.0,5,1079,3.0,811.0,811.0
0.162,6,10,1506,5,395,28.0,127.0,127.0,5,1111,37.0,843.0,843.0
0.003,6,10,1702,5,863,0.0,595.0,595.0,5,839,0.0,571.0,571.0
0.126,6,10,1506,5,395,28.0,127.0,127.0,5,1111,24.0,843.0,843.0
40.056,17,10,676,5,460,10013.0,104.0,64.0,5,216,10012.0,20.0,15.0
0.069,6,10,1506,5,395,15.0,127.0,127.0,5,1111,15.0,843.0,843.0
0.005,6,10,2007,5,928,1.0,660.0,660.0,5,1079,1.0,811.0,811.0
0.01,6,10,1854,5,889,2.0,621.0,621.0,5,965,2.0,697.0,697.0
0.007,6,10,1972,5,910,1.0,642.0,642.0,5,1062,1.0,794.0,794.0
0.005,6,10,1989,5,927,1.0,659.0,659.0,5,1062,1.0,794.0,794.0
0.005,17,2,166,1,75,0.0,47.0,47.0,1,91,0.0,63.0,63.0
0.005,6,10,1779,5,928,1.0,660.0,660.0,5,851,1.0,583.0,583.0
0.006,6,10,1547,5,764,1.0,496.0,496.0,5,783,1.0,515.0,515.0
0.029,6,10,1989,5,910,7.0,642.0,642.0,5,1079,7.0,811.0,811.0
0.001,17,2,180,1,66,0.0,38.0,38.0,1,114,0.0,86.0,86.0
0.005,6,10,1989,5,927,1.0,659.0,659.0,5,1062,1.0,794.0,794.0
40.048,17,10,676,5,460,10011.0,104.0,64.0,5,216,10011.0,20.0,15.0
0.111,17,2,412,1,61,0.0,33.0,33.0,1,351,0.0,323.0,323.0
40.091,17,10,676,5,460,10021.0,104.0,64.0,5,216,10022.0,20.0,15.0
0.006,6,10,2006,5,927,1.0,659.0,659.0,5,1079,1.0,811.0,811.0
0.005,6,10,2007,5,928,1.0,660.0,660.0,5,1079,1.0,811.0,811.0
169.291,17,78,11601,39,2609,4454.0,44.0,38.0,39,8992,4454.0,279.0,202.0
0.014,6,10,1990,5,911,3.0,643.0,643.0,5,1079,3.0,811.0,811.0
240.086,6,16,4482,9,963,30010.0,238.0,166.0,7,3519,40013.0,1402.0,786.0
0.011,6,10,1990,5,911,2.0,643.0,643.0,5,1079,2.0,811.0,811.0
0.008,6,10,1989,5,910,2.0,642.0,642.0,5,1079,2.0,811.0,811.0
0.007,17,2,179,1,71,0.0,43.0,43.0,1,108,0.0,80.0,80.0
10.816,17,28,4421,14,1994,823.0,269.0,114.0,14,2427,823.0,586.0,145.0
0.079,6,10,1506,5,395,15.0,127.0,127.0,5,1111,18.0,843.0,843.0
0.005,6,13,3747,7,509,0.0,137.0,137.0,6,3238,0.0,1470.0,1459.0
0.013,6,10,1677,5,827,3.0,559.0,559.0,5,850,3.0,582.0,582.0
0.006,6,10,1547,5,764,1.0,496.0,496.0,5,783,1.0,515.0,515.0
0.071,6,10,1506,5,395,13.0,127.0,127.0,5,1111,17.0,843.0,843.0
0.035,6,10,1972,5,910,8.0,642.0,642.0,5,1062,8.0,794.0,794.0
0.01,6,10,1989,5,910,2.0,642.0,642.0,5,1079,2.0,811.0,811.0
0.006,17,2,193,1,71,0.0,43.0,43.0,1,122,0.0,94.0,94.0
0.017,6,14,3787,7,497,2.0,125.0,125.0,7,3290,2.0,1448.0,972.0
0.014,6,10,1972,5,910,3.0,642.0,642.0,5,1062,3.0,794.0,794.0
0.04,17,2,148,1,60,0.0,32.0,32.0,1,88,0.0,60.0,60.0
0.004,6,10,2006,5,927,1.0,659.0,659.0,5,1079,1.0,811.0,811.0
0.041,17,2,136,1,60,0.0,32.0,32.0,1,76,0.0,48.0,48.0
0.16,17,2,152,1,76,0.0,48.0,48.0,1,76,0.0,48.0,48.0
0.036,6,10,1983,5,910,8.0,642.0,642.0,5,1073,8.0,805.0,805.0
0.005,6,10,2006,5,927,1.0,659.0,659.0,5,1079,1.0,811.0,811.0
0.005,6,10,1989,5,927,1.0,659.0,659.0,5,1062,1.0,794.0,794.0
15.088,17,15,9238,8,6902,2149.0,1350.0,834.0,7,2336,2509.0,1350.0,305.0
0.09,6,10,1506,5,395,21.0,127.0,127.0,5,1111,20.0,843.0,843.0
1799.939,17,3342,256060,1661,134625,1084.0,84.0,53.0,1681,121435,1071.0,227.0,44.0
0.126,17,2,80,1,32,0.0,4.0,4.0,1,48,0.0,20.0,20.0
0.009,6,12,1926,6,1189,1.0,659.0,434.0,6,737,1.0,417.0,417.0
0.062,6,10,1506,5,395,11.0,127.0,127.0,5,1111,14.0,843.0,843.0
0.004,17,4,284,2,120,0.0,32.0,32.0,2,164,0.0,60.0,54.0
0.005,6,10,2007,5,928,1.0,660.0,660.0,5,1079,1.0,811.0,811.0
0.117,6,10,1506,5,395,28.0,127.0,127.0,5,1111,25.0,843.0,843.0
0.282,17,37,19970,21,17024,14.0,1350.0,782.0,16,2946,14.0,1350.0,156.0
0.005,17,2,179,1,71,0.0,43.0,43.0,1,108,0.0,80.0,80.0
0.005,17,2,180,1,66,0.0,38.0,38.0,1,114,0.0,86.0,86.0
0.092,6,10,1506,5,395,14.0,127.0,127.0,5,1111,22.0,843.0,843.0
1781.911,6,575,191531,300,164945,5959.0,2883.0,873.0,275,26586,6503.0,580.0,120.0
368.688,6,22,2313,16,867,24579.0,195.0,195.0,6,1446,4635.0,419.0,398.0
40.063,17,10,676,5,460,10015.0,104.0,64.0,5,216,10015.0,20.0,15.0
264.742,17,18,1008,9,640,33075.0,48.0,43.0,9,368,33074.0,20.0,12.0
0.005,17,2,170,1,65,0.0,37.0,37.0,1,105,0.0,77.0,77.0
0.006,6,10,1774,5,923,1.0,655.0,655.0,5,851,1.0,583.0,583.0
0.015,6,10,1990,5,911,3.0,643.0,643.0,5,1079,3.0,811.0,811.0
0.01,6,10,1983,5,910,2.0,642.0,642.0,5,1073,2.0,805.0,805.0
0.011,6,10,1762,5,911,2.0,643.0,643.0,5,851,2.0,583.0,583.0
0.006,6,10,1547,5,764,1.0,496.0,496.0,5,783,1.0,515.0,515.0
0.009,6,12,1926,6,1189,1.0,659.0,434.0,6,737,1.0,417.0,417.0
0.005,6,10,1547,5,764,1.0,496.0,496.0,5,783,1.0,515.0,515.0
0.011,6,10,1989,5,910,2.0,642.0,642.0,5,1079,2.0,811.0,811.0
0.005,6,10,1643,5,860,1.0,592.0,592.0,5,783,1.0,515.0,515.0
0.012,6,10,1972,5,910,3.0,642.0,642.0,5,1062,3.0,794.0,794.0
0.006,6,10,1547,5,764,1.0,496.0,496.0,5,783,1.0,515.0,515.0
0.003,17,2,136,1,60,0.0,32.0,32.0,1,76,0.0,48.0,48.0
0.005,6,10,1989,5,927,1.0,659.0,659.0,5,1062,1.0,794.0,794.0
0.008,6,10,1989,5,910,1.0,642.0,642.0,5,1079,2.0,811.0,811.0
300.329,6,16,2170,9,684,37520.0,146.0,146.0,7,1486,50027.0,419.0,398.0
0.136,6,10,1506,5,395,27.0,127.0,127.0,5,1111,31.0,843.0,843.0
0.005,6,10,2006,5,927,1.0,659.0,659.0,5,1079,1.0,811.0,811.0
0.005,6,10,1989,5,927,1.0,659.0,659.0,5,1062,1.0,794.0,794.0
0.094,6,10,1506,5,395,21.0,127.0,127.0,5,1111,21.0,843.0,843.0
0.005,17,2,154,1,69,0.0,41.0,41.0,1,85,0.0,57.0,57.0
0.001,17,2,152,1,68,0.0,40.0,40.0,1,84,0.0,56.0,56.0
0.005,6,10,1774,5,923,1.0,655.0,655.0,5,851,1.0,583.0,583.0
0.023,6,10,1990,5,911,5.0,643.0,643.0,5,1079,5.0,811.0,811.0
0.004,6,10,1989,5,927,1.0,659.0,659.0,5,1062,1.0,794.0,794.0
0.114,6,10,1506,5,395,26.0,127.0,127.0,5,1111,25.0,843.0,843.0
0.006,6,10,1547,5,764,1.0,496.0,496.0,5,783,1.0,515.0,515.0
0.097,6,10,1506,5,395,22.0,127.0,127.0,5,1111,22.0,843.0,843.0
240.094,6,16,4481,9,963,30011.0,238.0,166.0,7,3518,40015.0,1402.0,786.0
0.006,6,10,1689,5,839,1.0,571.0,571.0,5,850,1.0,582.0,582.0
0.01,6,12,1926,6,1189,1.0,659.0,434.0,6,737,2.0,417.0,417.0
0.004,6,10,2006,5,927,1.0,659.0,659.0,5,1079,1.0,811.0,811.0
0.006,6,10,2000,5,927,1.0,659.0,659.0,5,1073,1.0,805.0,805.0
0.011,17,2,157,1,59,0.0,31.0,31.0,1,98,0.0,70.0,70.0
300.404,6,16,2170,9,684,37529.0,146.0,146.0,7,1486,50039.0,419.0,398.0
0.108,6,10,1506,5,395,24.0,127.0,127.0,5,1111,22.0,843.0,843.0
0.006,6,10,1643,5,860,1.0,592.0,592.0,5,783,1.0,515.0,515.0
0.093,6,10,1506,5,395,21.0,127.0,127.0,5,1111,21.0,843.0,843.0
0.016,6,10,1989,5,910,3.0,642.0,642.0,5,1079,4.0,811.0,811.0
0.015,6,10,1990,5,911,3.0,643.0,643.0,5,1079,3.0,811.0,811.0
0.107,6,10,1506,5,395,22.0,127.0,127.0,5,1111,23.0,843.0,843.0
0.171,17,2,152,1,76,0.0,48.0,48.0,1,76,0.0,48.0,48.0
0.046,17,2,164,1,74,0.0,46.0,46.0,1,90,0.0,62.0,62.0
0.009,6,10,1990,5,911,2.0,643.0,643.0,5,1079,2.0,811.0,811.0
0.006,6,10,1643,5,860,1.0,592.0,592.0,5,783,1.0,515.0,515.0
0.119,6,10,1506,5,395,23.0,127.0,127.0,5,1111,27.0,843.0,843.0
0.019,6,10,1989,5,910,4.0,642.0,642.0,5,1079,4.0,811.0,811.0
11.025,17,28,4422,14,1994,839.0,269.0,114.0,14,2428,839.0,587.0,145.0
1771.575,6,88,4703,44,2342,41198.0,27.0,27.0,44,2361,41198.0,26.0,24.0
0.005,6,10,1989,5,927,1.0,659.0,659.0,5,1062,1.0,794.0,794.0
0.005,17,2,214,1,75,0.0,47.0,47.0,1,139,0.0,111.0,111.0
1770.439,17,92,8096,46,4048,39342.0,60.0,60.0,46,4048,39342.0,60.0,60.0
0.004,6,10,1702,5,863,1.0,595.0,595.0,5,839,0.0,571.0,571.0
0.008,6,10,1762,5,911,2.0,643.0,643.0,5,851,1.0,583.0,583.0
0.01,6,10,1989,5,910,2.0,642.0,642.0,5,1079,2.0,811.0,811.0
0.005,6,10,1643,5,860,1.0,592.0,592.0,5,783,1.0,515.0,515.0
0.09,6,10,1506,5,395,20.0,127.0,127.0,5,1111,19.0,843.0,843.0
0.006,17,4,495,2,132,0.0,38.0,38.0,2,363,3.0,176.0,153.0
0.006,6,10,1547,5,764,1.0,496.0,496.0,5,783,1.0,515.0,515.0
0.068,6,10,1506,5,395,16.0,127.0,127.0,5,1111,14.0,843.0,843.0
0.012,6,10,1989,5,910,3.0,642.0,642.0,5,1079,3.0,811.0,811.0
0.009,6,10,1990,5,911,2.0,643.0,643.0,5,1079,2.0,811.0,811.0
11.441,17,28,4399,14,2312,867.0,587.0,137.0,14,2087,867.0,270.0,121.0
0.006,6,10,1779,5,928,1.0,660.0,660.0,5,851,1.0,583.0,583.0
0.12,6,10,1506,5,395,27.0,127.0,127.0,5,1111,24.0,843.0,843.0
0.011,6,10,1989,5,910,2.0,642.0,642.0,5,1079,2.0,811.0,811.0
0.012,6,10,1990,5,911,2.0,643.0,643.0,5,1079,3.0,811.0,811.0
0.014,6,10,1983,5,910,3.0,642.0,642.0,5,1073,3.0,805.0,805.0
240.389,6,33,9269,16,1836,16025.0,523.0,199.0,17,7433,15024.0,1402.0,595.0
0.006,6,10,1547,5,764,1.0,496.0,496.0,5,783,1.0,515.0,515.0
0.016,6,10,1989,5,910,4.0,642.0,642.0,5,1079,4.0,811.0,811.0
0.123,17,2,80,1,32,0.0,4.0,4.0,1,48,0.0,20.0,20.0
0.006,6,10,1547,5,764,1.0,496.0,496.0,5,783,1.0,515.0,515.0
0.212,17,2,152,1,76,0.0,48.0,48.0,1,76,0.0,48.0,48.0
0.011,6,10,1989,5,910,2.0,642.0,642.0,5,1079,2.0,811.0,811.0
0.123,17,2,80,1,32,0.0,4.0,4.0,1,48,0.0,20.0,20.0
0.006,6,10,1689,5,839,1.0,571.0,571.0,5,850,1.0,582.0,582.0
0.001,17,2,136,1,60,0.0,32.0,32.0,1,76,0.0,48.0,48.0
0.012,6,13,3735,7,497,2.0,125.0,125.0,6,3238,2.0,1470.0,1459.0
0.011,6,10,1983,5,910,2.0,642.0,642.0,5,1073,2.0,805.0,805.0
0.201,6,39,13318,18,8391,11.0,2857.0,744.0,21,4927,9.0,1586.0,478.0
0.006,17,2,230,1,68,0.0,40.0,40.0,1,162,0.0,134.0,134.0
0.011,6,10,1972,5,910,2.0,642.0,642.0,5,1062,2.0,794.0,794.0
0.007,6,12,1698,6,863,1.0,327.0,271.0,6,835,1.0,515.0,515.0
173.362,17,72,10277,36,2402,4953.0,44.0,38.0,36,7875,4953.0,260.0,190.0
0.014,6,10,1989,5,910,3.0,642.0,642.0,5,1079,3.0,811.0,811.0
0.005,6,10,2007,5,928,1.0,660.0,660.0,5,1079,1.0,811.0,811.0
0.039,17,4,284,2,120,0.0,32.0,32.0,2,164,35.0,60.0,54.0
0.04,17,2,144,1,64,0.0,36.0,36.0,1,80,0.0,52.0,52.0
0.006,6,10,1702,5,863,1.0,595.0,595.0,5,839,1.0,571.0,571.0
0.005,6,10,2006,5,927,1.0,659.0,659.0,5,1079,1.0,811.0,811.0
0.005,6,10,2006,5,927,1.0,659.0,659.0,5,1079,1.0,811.0,811.0
0.005,17,2,213,1,69,0.0,41.0,41.0,1,144,0.0,116.0,116.0
32.349,6,46,18788,24,13065,396.0,2720.0,1507.0,22,5723,1532.0,2667.0,402.0
0.005,6,10,1689,5,839,1.0,571.0,571.0,5,850,1.0,582.0,582.0
0.082,6,10,1506,5,395,19.0,127.0,127.0,5,1111,19.0,843.0,843.0
0.081,6,10,1506,5,395,16.0,127.0,127.0,5,1111,16.0,843.0,843.0
0.006,6,10,1689,5,839,1.0,571.0,571.0,5,850,1.0,582.0,582.0
0.009,6,12,1926,6,1189,1.0,659.0,434.0,6,737,1.0,417.0,417.0
0.011,6,10,1983,5,910,2.0,642.0,642.0,5,1073,2.0,805.0,805.0
0.101,6,10,1506,5,395,21.0,127.0,127.0,5,1111,20.0,843.0,843.0
0.004,17,4,284,2,120,1.0,32.0,32.0,2,164,1.0,60.0,54.0
0.004,17,2,148,1,60,0.0,32.0,32.0,1,88,0.0,60.0,60.0
11.255,17,28,4423,14,1994,853.0,269.0,114.0,14,2429,853.0,588.0,145.0
0.004,17,2,148,1,60,0.0,32.0,32.0,1,88,0.0,60.0,60.0
0.003,6,10,1702,5,863,0.0,595.0,595.0,5,839,0.0,571.0,571.0
240.416,6,28,11106,14,5420,18493.0,1444.0,939.0,14,5686,18493.0,1656.0,825.0
0.009,6,10,1972,5,910,2.0,642.0,642.0,5,1062,2.0,794.0,794.0
0.005,6,14,3799,7,509,0.0,137.0,137.0,7,3290,0.0,1448.0,972.0
0.027,6,10,1972,5,910,6.0,642.0,642.0,5,1062,6.0,794.0,794.0
0.006,6,10,1689,5,839,1.0,571.0,571.0,5,850,1.0,582.0,582.0
0.005,6,14,3742,7,452,0.0,80.0,80.0,7,3290,0.0,1448.0,972.0
0.012,6,10,1990,5,911,3.0,643.0,643.0,5,1079,2.0,811.0,811.0
0.012,6,10,1983,5,910,3.0,642.0,642.0,5,1073,3.0,805.0,805.0
0.004,6,10,1702,5,863,1.0,595.0,595.0,5,839,0.0,571.0,571.0
0.013,6,10,1990,5,911,3.0,643.0,643.0,5,1079,3.0,811.0,811.0
66.279,6,27,17541,15,9603,4734.0,2804.0,1469.0,12,7938,6010.0,2309.0,1217.0
0.113,6,10,1506,5,395,26.0,127.0,127.0,5,1111,26.0,843.0,843.0
0.017,6,10,1990,5,911,4.0,643.0,643.0,5,1079,4.0,811.0,811.0
0.006,17,2,230,1,68,0.0,40.0,40.0,1,162,0.0,134.0,134.0
0.003,17,4,284,2,120,0.0,32.0,32.0,2,164,0.0,60.0,54.0
0.011,6,13,3735,7,497,1.0,125.0,125.0,6,3238,2.0,1470.0,1459.0
40.068,17,10,676,5,460,10014.0,104.0,64.0,5,216,10016.0,20.0,15.0
0.005,6,10,1689,5,839,1.0,571.0,571.0,5,850,1.0,582.0,582.0
0.094,6,10,1506,5,395,21.0,127.0,127.0,5,1111,21.0,843.0,843.0
0.041,17,2,152,1,76,0.0,48.0,48.0,1,76,0.0,48.0,48.0
0.016,6,10,1989,5,910,4.0,642.0,642.0,5,1079,4.0,811.0,811.0
0.004,17,2,136,1,60,0.0,32.0,32.0,1,76,0.0,48.0,48.0
10.804,17,28,4422,14,1994,822.0,269.0,114.0,14,2428,822.0,587.0,145.0
0.141,6,10,1506,5,395,32.0,127.0,127.0,5,1111,32.0,843.0,843.0
0.006,6,10,2007,5,928,1.0,660.0,660.0,5,1079,1.0,811.0,811.0
0.005,6,10,1547,5,764,1.0,496.0,496.0,5,783,1.0,515.0,515.0
40.054,17,10,676,5,460,10012.0,104.0,64.0,5,216,10011.0,20.0,15.0
0.104,6,10,1506,5,395,22.0,127.0,127.0,5,1111,25.0,843.0,843.0
0.036,17,2,136,1,60,0.0,32.0,32.0,1,76,0.0,48.0,48.0
0.005,6,10,2006,5,927,1.0,659.0,659.0,5,1079,1.0,811.0,811.0
0.006,6,10,2007,5,928,1.0,660.0,660.0,5,1079,1.0,811.0,811.0
0.014,6,10,1989,5,910,3.0,642.0,642.0,5,1079,3.0,811.0,811.0
0.006,6,10,2006,5,927,1.0,659.0,659.0,5,1079,1.0,811.0,811.0
11.373,17,28,4423,14,1995,859.0,270.0,114.0,14,2428,860.0,587.0,145.0
10.936,17,28,4416,14,1993,832.0,268.0,114.0,14,2423,832.0,586.0,145.0
0.015,6,10,1990,5,911,3.0,643.0,643.0,5,1079,3.0,811.0,811.0
0.015,6,10,1631,5,848,3.0,580.0,580.0,5,783,3.0,515.0,515.0
0.011,6,10,1989,5,910,2.0,642.0,642.0,5,1079,2.0,811.0,811.0
40.081,17,10,676,5,460,10018.0,104.0,64.0,5,216,10019.0,20.0,15.0
0.005,6,10,2006,5,927,1.0,659.0,659.0,5,1079,1.0,811.0,811.0
0.025,6,10,1677,5,827,6.0,559.0,559.0,5,850,6.0,582.0,582.0
0.006,6,10,1643,5,860,1.0,592.0,592.0,5,783,1.0,515.0,515.0
0.006,6,10,1854,5,889,1.0,621.0,621.0,5,965,1.0,697.0,697.0
0.016,6,10,1983,5,910,4.0,642.0,642.0,5,1073,4.0,805.0,805.0
0.004,17,2,136,1,60,0.0,32.0,32.0,1,76,0.0,48.0,48.0
0.114,6,10,1506,5,395,26.0,127.0,127.0,5,1111,16.0,843.0,843.0
0.005,6,10,1547,5,764,1.0,496.0,496.0,5,783,1.0,515.0,515.0
240.091,6,16,4480,9,963,30011.0,238.0,166.0,7,3517,40014.0,1402.0,786.0
0.04,6,10,1762,5,911,9.0,643.0,643.0,5,851,9.0,583.0,583.0
0.006,17,2,170,1,65,0.0,37.0,37.0,1,105,0.0,77.0,77.0
0.009,6,10,1989,5,910,2.0,642.0,642.0,5,1079,2.0,811.0,811.0
0.091,6,10,1506,5,395,21.0,127.0,127.0,5,1111,19.0,843.0,843.0
0.01,6,10,1989,5,910,2.0,642.0,642.0,5,1079,2.0,811.0,811.0
40.308,17,12,756,6,492,8057.0,104.0,54.0,6,264,8059.0,20.0,16.0
0.005,6,10,2006,5,927,1.0,659.0,659.0,5,1079,1.0,811.0,811.0
40.063,17,10,676,5,460,10013.0,104.0,64.0,5,216,10014.0,20.0,15.0
0.004,17,2,136,1,60,0.0,32.0,32.0,1,76,0.0,48.0,48.0
0.005,17,2,187,1,71,0.0,43.0,43.0,1,116,0.0,88.0,88.0
0.089,6,10,1506,5,395,20.0,127.0,127.0,5,1111,17.0,843.0,843.0
0.006,6,10,1689,5,839,1.0,571.0,571.0,5,850,1.0,582.0,582.0
0.006,6,10,1689,5,839,1.0,571.0,571.0,5,850,1.0,582.0,582.0
0.143,6,10,1506,5,395,33.0,127.0,127.0,5,1111,23.0,843.0,843.0
0.006,6,10,1643,5,860,1.0,592.0,592.0,5,783,1.0,515.0,515.0
0.13,17,4,596,2,122,0.0,33.0,33.0,2,474,90.0,323.0,209.0
0.005,6,10,1689,5,839,1.0,571.0,571.0,5,850,1.0,582.0,582.0
0.003,17,2,136,1,60,0.0,32.0,32.0,1,76,0.0,48.0,48.0
0.006,17,2,164,1,74,0.0,46.0,46.0,1,90,0.0,62.0,62.0
0.004,6,10,2006,5,927,1.0,659.0,659.0,5,1079,1.0,811.0,811.0
291.159,6,313,343679,129,18257,2274.0,2736.0,888.0,184,325422,1591.0,2804.0,1857.0
0.013,6,10,1989,5,910,3.0,642.0,642.0,5,1079,3.0,811.0,811.0
47.611,6,36,8427,18,1955,515.0,887.0,401.0,18,6472,2792.0,2126.0,478.0
0.005,6,10,2006,5,927,1.0,659.0,659.0,5,1079,1.0,811.0,811.0
0.01,6,10,1989,5,910,2.0,642.0,642.0,5,1079,2.0,811.0,811.0
0.073,17,2,412,1,61,0.0,33.0,33.0,1,351,0.0,323.0,323.0
0.013,6,10,1983,5,910,3.0,642.0,642.0,5,1073,3.0,805.0,805.0
0.004,17,2,148,1,60,0.0,32.0,32.0,1,88,0.0,60.0,60.0
0.02,6,10,1990,5,911,4.0,643.0,643.0,5,1079,4.0,811.0,811.0
0.015,6,13,3735,7,497,2.0,125.0,125.0,6,3238,2.0,1470.0,1459.0
0.165,17,2,152,1,76,0.0,48.0,48.0,1,76,0.0,48.0,48.0
0.004,6,10,2000,5,927,1.0,659.0,659.0,5,1073,1.0,805.0,805.0
0.012,6,10,1989,5,910,3.0,642.0,642.0,5,1079,2.0,811.0,811.0
40.057,17,10,676,5,460,10013.0,104.0,64.0,5,216,10012.0,20.0,15.0
0.005,17,2,140,1,62,0.0,34.0,34.0,1,78,0.0,50.0,50.0
0.007,6,10,1547,5,764,1.0,496.0,496.0,5,783,1.0,515.0,515.0
0.012,6,10,1989,5,910,2.0,642.0,642.0,5,1079,2.0,811.0,811.0
0.004,6,10,1702,5,863,1.0,595.0,595.0,5,839,0.0,571.0,571.0
240.1,6,32,9576,15,7130,17149.0,2242.0,704.0,17,2446,15006.0,580.0,194.0
0.087,6,10,1506,5,395,21.0,127.0,127.0,5,1111,19.0,843.0,843.0
0.014,17,2,152,1,56,0.0,28.0,28.0,1,96,0.0,68.0,68.0
0.191,6,10,1506,5,395,46.0,127.0,127.0,5,1111,41.0,843.0,843.0
0.006,6,10,1547,5,764,1.0,496.0,496.0,5,783,1.0,515.0,515.0
0.301,17,4,352,2,130,230.0,37.0,37.0,2,222,174.0,89.0,83.0
11.116,17,28,4421,14,1994,842.0,269.0,114.0,14,2427,842.0,586.0,145.0
15.076,17,16,8646,8,6586,2149.0,1350.0,795.0,8,2060,2149.0,1350.0,229.0
0.038,17,2,182,1,65,0.0,37.0,37.0,1,117,0.0,89.0,89.0
0.015,6,10,1990,5,911,3.0,643.0,643.0,5,1079,3.0,811.0,811.0
0.001,17,2,212,1,64,0.0,36.0,36.0,1,148,0.0,120.0,120.0
0.017,6,10,1972,5,910,4.0,642.0,642.0,5,1062,4.0,794.0,794.0
0.065,17,8,3613,4,1874,21.0,1350.0,440.0,4,1739,11.0,1350.0,406.0
0.008,6,12,1698,6,863,1.0,327.0,271.0,6,835,1.0,515.0,515.0
0.072,6,10,1506,5,395,16.0,127.0,127.0,5,1111,15.0,843.0,843.0
0.012,6,13,3735,7,497,2.0,125.0,125.0,6,3238,2.0,1470.0,1459.0
0.019,6,10,1990,5,911,4.0,643.0,643.0,5,1079,4.0,811.0,811.0
0.087,6,10,1506,5,395,18.0,127.0,127.0,5,1111,20.0,843.0,843.0
0.011,6,10,1631,5,848,2.0,580.0,580.0,5,783,2.0,515.0,515.0
0.012,6,10,1972,5,910,2.0,642.0,642.0,5,1062,3.0,794.0,794.0
0.06,6,10,1506,5,395,12.0,127.0,127.0,5,1111,13.0,843.0,843.0
40.068,17,10,676,5,460,10015.0,104.0,64.0,5,216,10016.0,20.0,15.0
0.014,6,10,1989,5,910,3.0,642.0,642.0,5,1079,3.0,811.0,811.0
0.003,6,10,1702,5,863,0.0,595.0,595.0,5,839,0.0,571.0,571.0
0.005,6,10,2000,5,927,1.0,659.0,659.0,5,1073,1.0,805.0,805.0
0.01,6,10,1677,5,827,2.0,559.0,559.0,5,850,2.0,582.0,582.0
0.222,6,16,2669,8,1395,31.0,533.0,323.0,8,1274,20.0,529.0,212.0
0.005,6,10,2007,5,928,1.0,660.0,660.0,5,1079,1.0,811.0,811.0
0.013,6,10,1983,5,910,3.0,642.0,642.0,5,1073,3.0,805.0,805.0
0.07,6,10,1506,5,395,14.0,127.0,127.0,5,1111,15.0,843.0,843.0
0.143,6,10,1506,5,395,32.0,127.0,127.0,5,1111,32.0,843.0,843.0
0.098,6,10,1506,5,395,21.0,127.0,127.0,5,1111,22.0,843.0,843.0
0.071,6,10,1506,5,395,14.0,127.0,127.0,5,1111,15.0,843.0,843.0
0.005,6,10,2006,5,927,1.0,659.0,659.0,5,1079,1.0,811.0,811.0
0.005,6,10,1702,5,863,1.0,595.0,595.0,5,839,1.0,571.0,571.0
0.008,6,10,1762,5,911,2.0,643.0,643.0,5,851,1.0,583.0,583.0
0.006,6,10,1547,5,764,1.0,496.0,496.0,5,783,1.0,515.0,515.0
0.005,6,10,1989,5,927,1.0,659.0,659.0,5,1062,1.0,794.0,794.0
0.011,6,10,1677,5,827,2.0,559.0,559.0,5,850,2.0,582.0,582.0
0.001,17,2,180,1,66,0.0,38.0,38.0,1,114,0.0,86.0,86.0
0.001,17,2,180,1,66,0.0,38.0,38.0,1,114,0.0,86.0,86.0
0.001,17,2,180,1,66,0.0,38.0,38.0,1,114,0.0,86.0,86.0
11.318,17,28,4418,14,1994,855.0,269.0,114.0,14,2424,857.0,587.0,145.0
0.003,17,4,284,2,120,0.0,32.0,32.0,2,164,0.0,60.0,54.0
0.016,17,2,198,1,91,0.0,63.0,63.0,1,107,0.0,79.0,79.0
0.003,17,2,136,1,60,0.0,32.0,32.0,1,76,0.0,48.0,48.0
0.014,6,10,1972,5,910,3.0,642.0,642.0,5,1062,3.0,794.0,794.0
0.005,6,10,2006,5,927,1.0,659.0,659.0,5,1079,1.0,811.0,811.0
0.103,6,10,1506,5,395,22.0,127.0,127.0,5,1111,23.0,843.0,843.0
0.005,6,10,2007,5,928,1.0,660.0,660.0,5,1079,1.0,811.0,811.0
0.077,6,10,1506,5,395,18.0,127.0,127.0,5,1111,15.0,843.0,843.0
0.004,6,10,1989,5,927,1.0,659.0,659.0,5,1062,1.0,794.0,794.0
0.12,6,10,1506,5,395,27.0,127.0,127.0,5,1111,27.0,843.0,843.0
0.003,17,2,170,1,65,0.0,37.0,37.0,1,105,0.0,77.0,77.0
0.005,6,10,2006,5,927,1.0,659.0,659.0,5,1079,1.0,811.0,811.0
0.005,6,10,2006,5,927,1.0,659.0,659.0,5,1079,1.0,811.0,811.0
0.013,6,14,3787,7,497,2.0,125.0,125.0,7,3290,2.0,1448.0,972.0
0.006,17,2,298,1,65,0.0,37.0,37.0,1,233,0.0,205.0,205.0
0.007,17,2,140,1,62,0.0,34.0,34.0,1,78,0.0,50.0,50.0
0.077,6,10,1506,5,395,16.0,127.0,127.0,5,1111,14.0,843.0,843.0
9.044,17,6,376,5,280,2261.0,28.0,28.0,1,96,0.0,68.0,68.0
0.004,6,10,1989,5,927,1.0,659.0,659.0,5,1062,1.0,794.0,794.0
0.076,6,10,1506,5,395,17.0,127.0,127.0,5,1111,16.0,843.0,843.0
0.04,17,2,136,1,60,0.0,32.0,32.0,1,76,0.0,48.0,48.0
0.007,6,10,1989,5,910,1.0,642.0,642.0,5,1079,1.0,811.0,811.0
0.038,17,2,152,1,76,0.0,48.0,48.0,1,76,0.0,48.0,48.0
0.005,6,10,2000,5,927,1.0,659.0,659.0,5,1073,1.0,805.0,805.0
0.007,6,10,1547,5,764,1.0,496.0,496.0,5,783,1.0,515.0,515.0
0.004,6,10,2000,5,927,1.0,659.0,659.0,5,1073,1.0,805.0,805.0
0.005,6,10,2007,5,928,1.0,660.0,660.0,5,1079,1.0,811.0,811.0
0.073,17,2,170,1,65,0.0,37.0,37.0,1,105,0.0,77.0,77.0
0.005,6,10,2000,5,927,1.0,659.0,659.0,5,1073,1.0,805.0,805.0
0.005,6,10,2000,5,927,1.0,659.0,659.0,5,1073,1.0,805.0,805.0
0.008,6,10,1990,5,911,1.0,643.0,643.0,5,1079,2.0,811.0,811.0
0.006,6,10,2007,5,928,1.0,660.0,660.0,5,1079,1.0,811.0,811.0
0.019,6,10,1990,5,911,4.0,643.0,643.0,5,1079,4.0,811.0,811.0
0.003,17,2,148,1,60,0.0,32.0,32.0,1,88,0.0,60.0,60.0
310.813,17,20,1124,10,716,34520.0,48.0,43.0,10,408,34520.0,20.0,12.0
0.013,6,10,1631,5,848,3.0,580.0,580.0,5,783,3.0,515.0,515.0
0.001,17,2,180,1,66,0.0,38.0,38.0,1,114,0.0,86.0,86.0
0.008,6,10,1990,5,911,2.0,643.0,643.0,5,1079,1.0,811.0,811.0
0.005,6,10,2006,5,927,1.0,659.0,659.0,5,1079,1.0,811.0,811.0
0.006,6,10,1643,5,860,1.0,592.0,592.0,5,783,1.0,515.0,515.0
0.005,17,2,154,1,69,0.0,41.0,41.0,1,85,0.0,57.0,57.0
0.072,17,2,148,1,60,0.0,32.0,32.0,1,88,0.0,60.0,60.0
0.011,6,10,1972,5,910,2.0,642.0,642.0,5,1062,2.0,794.0,794.0
240.456,6,35,8928,18,2076,14144.0,697.0,226.0,17,6852,15028.0,1402.0,597.0
0.006,6,10,2007,5,928,1.0,660.0,660.0,5,1079,1.0,811.0,811.0
0.004,17,4,284,2,120,0.0,32.0,32.0,2,164,0.0,60.0,54.0
0.169,17,2,152,1,76,0.0,48.0,48.0,1,76,0.0,48.0,48.0
0.004,6,10,1774,5,923,1.0,655.0,655.0,5,851,1.0,583.0,583.0
0.005,6,10,1774,5,923,1.0,655.0,655.0,5,851,1.0,583.0,583.0
0.005,6,10,2006,5,927,1.0,659.0,659.0,5,1079,1.0,811.0,811.0
0.01,6,10,1972,5,910,2.0,642.0,642.0,5,1062,2.0,794.0,794.0
0.003,17,2,234,1,61,0.0,33.0,33.0,1,173,0.0,145.0,145.0
9.038,17,6,376,5,280,2259.0,28.0,28.0,1,96,0.0,68.0,68.0
0.003,17,2,136,1,60,0.0,32.0,32.0,1,76,0.0,48.0,48.0
0.04,17,2,166,1,75,0.0,47.0,47.0,1,91,0.0,63.0,63.0
0.125,6,10,1506,5,395,28.0,127.0,127.0,5,1111,28.0,843.0,843.0
0.122,6,10,1506,5,395,26.0,127.0,127.0,5,1111,25.0,843.0,843.0
0.039,17,4,284,2,120,0.0,32.0,32.0,2,164,1.0,60.0,54.0
0.013,17,2,152,1,56,0.0,28.0,28.0,1,96,0.0,68.0,68.0
0.014,6,10,1631,5,848,3.0,580.0,580.0,5,783,3.0,515.0,515.0
0.013,6,10,1990,5,911,3.0,643.0,643.0,5,1079,3.0,811.0,811.0
0.062,6,10,1506,5,395,13.0,127.0,127.0,5,1111,12.0,843.0,843.0
0.009,6,12,1926,6,1189,1.0,659.0,434.0,6,737,1.0,417.0,417.0
0.021,6,10,1990,5,911,5.0,643.0,643.0,5,1079,5.0,811.0,811.0
0.006,6,10,1547,5,764,1.0,496.0,496.0,5,783,1.0,515.0,515.0
0.003,17,4,284,2,120,0.0,32.0,32.0,2,164,1.0,60.0,54.0
40.066,17,10,676,5,460,10013.0,104.0,64.0,5,216,10015.0,20.0,15.0
0.004,6,10,2006,5,927,1.0,659.0,659.0,5,1079,1.0,811.0,811.0
0.037,17,2,148,1,60,0.0,32.0,32.0,1,88,0.0,60.0,60.0
0.01,6,10,1983,5,910,2.0,642.0,642.0,5,1073,2.0,805.0,805.0
0.011,6,10,1989,5,910,2.0,642.0,642.0,5,1079,2.0,811.0,811.0
0.072,6,10,1506,5,395,15.0,127.0,127.0,5,1111,15.0,843.0,843.0
0.117,6,10,1506,5,395,24.0,127.0,127.0,5,1111,25.0,843.0,843.0
0.001,17,2,140,1,62,0.0,34.0,34.0,1,78,0.0,50.0,50.0
0.005,6,10,2006,5,927,1.0,659.0,659.0,5,1079,1.0,811.0,811.0
177.08,17,80,11206,40,2649,4540.0,44.0,38.0,40,8557,4540.0,252.0,185.0
174.437,17,88,12582,44,2959,4056.0,44.0,39.0,44,9623,4056.0,239.0,190.0
0.006,6,10,1547,5,764,1.0,496.0,496.0,5,783,1.0,515.0,515.0
240.106,6,16,4481,9,963,30013.0,238.0,166.0,7,3518,40017.0,1402.0,786.0
0.011,6,13,3735,7,497,1.0,125.0,125.0,6,3238,2.0,1470.0,1459.0
0.083,6,10,1506,5,395,17.0,127.0,127.0,5,1111,17.0,843.0,843.0
0.129,17,2,148,1,60,0.0,32.0,32.0,1,88,0.0,60.0,60.0
0.016,6,10,1989,5,910,3.0,642.0,642.0,5,1079,3.0,811.0,811.0
291.969,6,32,12206,17,2631,18247.0,585.0,345.0,15,9575,20854.0,1402.0,977.0
0.005,6,10,2007,5,928,1.0,660.0,660.0,5,1079,1.0,811.0,811.0
0.012,6,10,1989,5,910,3.0,642.0,642.0,5,1079,3.0,811.0,811.0
0.004,17,2,154,1,69,0.0,41.0,41.0,1,85,0.0,57.0,57.0
0.005,17,2,136,1,60,0.0,32.0,32.0,1,76,0.0,48.0,48.0
0.021,6,10,1983,5,910,5.0,642.0,642.0,5,1073,5.0,805.0,805.0
0.006,6,10,2006,5,927,1.0,659.0,659.0,5,1079,1.0,811.0,811.0
0.003,17,2,148,1,60,0.0,32.0,32.0,1,88,0.0,60.0,60.0
0.003,17,4,284,2,120,0.0,32.0,32.0,2,164,0.0,60.0,54.0
0.008,6,10,1983,5,910,1.0,642.0,642.0,5,1073,2.0,805.0,805.0
0.091,6,10,1506,5,395,20.0,127.0,127.0,5,1111,21.0,843.0,843.0
0.019,6,10,1677,5,827,4.0,559.0,559.0,5,850,4.0,582.0,582.0
0.022,17,2,136,1,60,0.0,32.0,32.0,1,76,0.0,48.0,48.0
10.82,17,28,4417,14,1993,823.0,268.0,114.0,14,2424,823.0,587.0,145.0
10.824,17,28,4418,14,1994,824.0,269.0,114.0,14,2424,823.0,587.0,145.0
0.004,6,10,2006,5,927,1.0,659.0,659.0,5,1079,1.0,811.0,811.0
0.006,17,2,144,1,64,0.0,36.0,36.0,1,80,0.0,52.0,52.0
0.005,17,2,230,1,68,0.0,40.0,40.0,1,162,0.0,134.0,134.0
0.004,6,10,1702,5,863,0.0,595.0,595.0,5,839,1.0,571.0,571.0
0.005,6,10,1774,5,923,1.0,655.0,655.0,5,851,1.0,583.0,583.0
0.005,6,10,2000,5,927,1.0,659.0,659.0,5,1073,1.0,805.0,805.0
0.008,6,10,1989,5,910,2.0,642.0,642.0,5,1079,2.0,811.0,811.0
0.126,17,2,80,1,32,0.0,4.0,4.0,1,48,0.0,20.0,20.0
0.006,6,10,1854,5,889,1.0,621.0,621.0,5,965,1.0,697.0,697.0
0.037,17,2,182,1,65,0.0,37.0,37.0,1,117,0.0,89.0,89.0
0.009,6,10,1989,5,910,2.0,642.0,642.0,5,1079,2.0,811.0,811.0
0.17,6,3,453,2,321,170.0,241.0,241.0,1,132,0.0,92.0,92.0
0.005,6,10,1774,5,923,1.0,655.0,655.0,5,851,1.0,583.0,583.0
15.175,17,20,11130,10,7400,1683.0,1350.0,712.0,10,3730,1682.0,1350.0,345.0
0.018,6,10,1677,5,827,4.0,559.0,559.0,5,850,4.0,582.0,582.0
0.005,6,10,2006,5,927,1.0,659.0,659.0,5,1079,1.0,811.0,811.0
0.005,6,10,1779,5,928,1.0,660.0,660.0,5,851,1.0,583.0,583.0
0.014,6,10,1989,5,910,3.0,642.0,642.0,5,1079,3.0,811.0,811.0
0.005,6,10,1779,5,928,1.0,660.0,660.0,5,851,1.0,583.0,583.0
0.018,6,10,1677,5,827,4.0,559.0,559.0,5,850,4.0,582.0,582.0
0.041,17,2,152,1,76,0.0,48.0,48.0,1,76,0.0,48.0,48.0
0.102,6,10,1506,5,395,22.0,127.0,127.0,5,1111,22.0,843.0,843.0
0.007,6,10,1972,5,910,1.0,642.0,642.0,5,1062,1.0,794.0,794.0
0.004,17,2,186,1,61,0.0,33.0,33.0,1,125,0.0,97.0,97.0
0.004,6,10,2007,5,928,1.0,660.0,660.0,5,1079,1.0,811.0,811.0
361.751,6,19,1688,15,978,25839.0,190.0,190.0,4,710,80014.0,494.0,494.0
0.011,6,13,3735,7,497,1.0,125.0,125.0,6,3238,2.0,1470.0,1459.0
0.005,6,10,1689,5,839,1.0,571.0,571.0,5,850,1.0,582.0,582.0
0.122,6,10,1506,5,395,30.0,127.0,127.0,5,1111,27.0,843.0,843.0
0.005,6,10,2006,5,927,1.0,659.0,659.0,5,1079,1.0,811.0,811.0
240.021,6,9,787,5,488,60005.0,232.0,232.0,4,299,80006.0,83.0,83.0
0.011,6,10,1990,5,911,2.0,643.0,643.0,5,1079,2.0,811.0,811.0
0.122,6,10,1506,5,395,25.0,127.0,127.0,5,1111,27.0,843.0,843.0
0.011,6,10,1983,5,910,2.0,642.0,642.0,5,1073,2.0,805.0,805.0
0.042,17,2,152,1,76,0.0,48.0,48.0,1,76,0.0,48.0,48.0
0.009,6,10,1762,5,911,2.0,643.0,643.0,5,851,2.0,583.0,583.0
0.01,6,10,1677,5,827,2.0,559.0,559.0,5,850,2.0,582.0,582.0
0.073,6,10,1506,5,395,16.0,127.0,127.0,5,1111,16.0,843.0,843.0
0.006,17,2,212,1,74,0.0,46.0,46.0,1,138,0.0,110.0,110.0
0.683,6,22,5072,11,1250,58.0,325.0,133.0,11,3822,57.0,1414.0,563.0
0.015,6,10,1990,5,911,3.0,643.0,643.0,5,1079,3.0,811.0,811.0
0.007,6,10,1983,5,910,1.0,642.0,642.0,5,1073,1.0,805.0,805.0
300.985,6,45,14419,24,8552,13086.0,2720.0,945.0,21,5867,440.0,2667.0,385.0
0.008,6,10,1762,5,911,2.0,643.0,643.0,5,851,1.0,583.0,583.0
0.004,6,10,1774,5,923,1.0,655.0,655.0,5,851,1.0,583.0,583.0
0.011,6,10,1983,5,910,2.0,642.0,642.0,5,1073,2.0,805.0,805.0
0.017,6,10,1989,5,910,4.0,642.0,642.0,5,1079,4.0,811.0,811.0
0.017,6,12,1926,6,1189,3.0,659.0,434.0,6,737,3.0,417.0,417.0
1772.657,17,120,11460,60,5460,30044.0,63.0,63.0,60,6000,30044.0,72.0,72.0
0.004,17,2,136,1,60,0.0,32.0,32.0,1,76,0.0,48.0,48.0
0.005,6,10,2007,5,928,1.0,660.0,660.0,5,1079,1.0,811.0,811.0
0.004,17,4,284,2,120,0.0,32.0,32.0,2,164,1.0,60.0,54.0
0.01,6,10,1983,5,910,2.0,642.0,642.0,5,1073,2.0,805.0,805.0
412.045,6,29,4409,12,3102,10915.0,494.0,494.0,17,1307,25752.0,83.0,83.0
0.133,6,10,1506,5,395,31.0,127.0,127.0,5,1111,30.0,843.0,843.0
10.77,17,28,4423,14,1994,820.0,269.0,114.0,14,2429,820.0,588.0,145.0
0.022,6,10,1989,5,910,5.0,642.0,642.0,5,1079,5.0,811.0,811.0
0.005,6,10,2006,5,927,1.0,659.0,659.0,5,1079,1.0,811.0,811.0
0.005,6,10,1854,5,889,1.0,621.0,621.0,5,965,1.0,697.0,697.0
372.392,6,22,2313,16,867,24826.0,195.0,195.0,6,1446,4636.0,419.0,398.0
0.025,6,13,3735,7,497,4.0,125.0,125.0,6,3238,4.0,1470.0,1459.0
0.014,6,10,1989,5,910,3.0,642.0,642.0,5,1079,3.0,811.0,811.0
0.008,6,10,1989,5,910,2.0,642.0,642.0,5,1079,2.0,811.0,811.0
0.02,6,10,1989,5,910,5.0,642.0,642.0,5,1079,4.0,811.0,811.0
0.03,6,10,1631,5,848,7.0,580.0,580.0,5,783,7.0,515.0,515.0
0.042,17,2,156,1,64,0.0,36.0,36.0,1,92,0.0,64.0,64.0
0.108,6,10,1506,5,395,23.0,127.0,127.0,5,1111,25.0,843.0,843.0
0.076,6,10,1506,5,395,18.0,127.0,127.0,5,1111,15.0,843.0,843.0
0.039,17,2,136,1,60,0.0,32.0,32.0,1,76,0.0,48.0,48.0
0.016,6,10,1990,5,911,4.0,643.0,643.0,5,1079,3.0,811.0,811.0
40.059,17,10,676,5,460,10014.0,104.0,64.0,5,216,10014.0,20.0,15.0
0.009,6,10,1983,5,910,2.0,642.0,642.0,5,1073,2.0,805.0,805.0
0.005,6,10,1989,5,927,1.0,659.0,659.0,5,1062,1.0,794.0,794.0
0.005,6,10,2007,5,928,1.0,660.0,660.0,5,1079,1.0,811.0,811.0
0.001,17,2,136,1,60,0.0,32.0,32.0,1,76,0.0,48.0,48.0
0.005,6,13,3747,7,509,0.0,137.0,137.0,6,3238,0.0,1470.0,1459.0
0.11,6,10,1506,5,395,24.0,127.0,127.0,5,1111,22.0,843.0,843.0
0.01,6,10,1972,5,910,2.0,642.0,642.0,5,1062,2.0,794.0,794.0
0.006,17,2,179,1,71,0.0,43.0,43.0,1,108,0.0,80.0,80.0
0.005,6,10,2007,5,928,1.0,660.0,660.0,5,1079,1.0,811.0,811.0
0.006,6,10,2006,5,927,1.0,659.0,659.0,5,1079,1.0,811.0,811.0
0.044,17,2,152,1,76,0.0,48.0,48.0,1,76,0.0,48.0,48.0
0.221,6,16,2670,8,1396,31.0,533.0,324.0,8,1274,20.0,529.0,212.0
0.067,6,10,1506,5,395,14.0,127.0,127.0,5,1111,14.0,843.0,843.0
0.012,6,10,1990,5,911,2.0,643.0,643.0,5,1079,3.0,811.0,811.0
0.075,6,10,1506,5,395,18.0,127.0,127.0,5,1111,17.0,843.0,843.0
0.007,6,10,1643,5,860,1.0,592.0,592.0,5,783,1.0,515.0,515.0
0.004,17,2,148,1,60,0.0,32.0,32.0,1,88,0.0,60.0,60.0
1798.739,6,299,51790,122,34279,14864.0,2790.0,302.0,177,17511,10219.0,1360.0,128.0
0.005,6,10,1989,5,927,1.0,659.0,659.0,5,1062,1.0,794.0,794.0
0.007,6,10,1547,5,764,1.0,496.0,496.0,5,783,1.0,515.0,515.0
240.089,6,31,9491,15,7110,17149.0,2233.0,703.0,16,2381,16005.0,580.0,192.0
0.019,6,10,1983,5,910,4.0,642.0,642.0,5,1073,4.0,805.0,805.0
300.766,6,36,9586,19,4108,16709.0,2932.0,829.0,17,5478,536.0,2667.0,435.0
0.066,17,8,3613,4,1874,22.0,1350.0,440.0,4,1739,11.0,1350.0,406.0
0.108,6,10,1506,5,395,25.0,127.0,127.0,5,1111,25.0,843.0,843.0
0.011,6,13,3735,7,497,1.0,125.0,125.0,6,3238,2.0,1470.0,1459.0
0.014,6,10,1989,5,910,3.0,642.0,642.0,5,1079,3.0,811.0,811.0
0.005,6,10,1547,5,764,1.0,496.0,496.0,5,783,1.0,515.0,515.0
169.414,17,78,11075,39,2601,4457.0,44.0,38.0,39,8474,4458.0,239.0,189.0
0.068,17,8,3613,4,1874,22.0,1350.0,440.0,4,1739,13.0,1350.0,406.0
0.005,6,13,3690,7,452,0.0,80.0,80.0,6,3238,0.0,1470.0,1459.0
240.534,6,38,9721,20,2238,12659.0,746.0,235.0,18,7483,14148.0,1402.0,595.0
0.001,17,2,180,1,66,0.0,38.0,38.0,1,114,0.0,86.0,86.0
366.616,6,39,8379,25,6730,15275.0,494.0,494.0,14,1649,28201.0,83.0,83.0
0.005,6,10,1854,5,889,1.0,621.0,621.0,5,965,1.0,697.0,697.0
0.021,6,10,1990,5,911,5.0,643.0,643.0,5,1079,5.0,811.0,811.0
0.005,6,10,1774,5,923,1.0,655.0,655.0,5,851,1.0,583.0,583.0
10.924,17,28,4422,14,1995,831.0,270.0,114.0,14,2427,831.0,586.0,145.0
0.005,6,10,1989,5,927,1.0,659.0,659.0,5,1062,1.0,794.0,794.0
365.853,6,22,2313,16,867,24390.0,195.0,195.0,6,1446,4636.0,419.0,398.0
0.004,6,10,1702,5,863,1.0,595.0,595.0,5,839,0.0,571.0,571.0
0.009,6,10,1972,5,910,2.0,642.0,642.0,5,1062,2.0,794.0,794.0
0.272,17,4,596,2,122,143.0,33.0,33.0,2,474,231.0,323.0,209.0
0.005,6,10,1689,5,839,1.0,571.0,571.0,5,850,1.0,582.0,582.0
0.079,6,10,1506,5,395,18.0,127.0,127.0,5,1111,18.0,843.0,843.0
0.077,6,10,1506,5,395,15.0,127.0,127.0,5,1111,17.0,843.0,843.0
0.001,17,2,179,1,62,0.0,34.0,34.0,1,117,0.0,89.0,89.0
0.004,17,2,136,1,60,0.0,32.0,32.0,1,76,0.0,48.0,48.0
0.004,17,2,136,1,60,0.0,32.0,32.0,1,76,0.0,48.0,48.0
0.095,6,10,1506,5,395,21.0,127.0,127.0,5,1111,21.0,843.0,843.0
15.075,17,15,9238,8,6902,2149.0,1350.0,834.0,7,2336,2507.0,1350.0,305.0
0.069,6,10,1506,5,395,15.0,127.0,127.0,5,1111,14.0,843.0,843.0
0.011,6,10,1989,5,910,2.0,642.0,642.0,5,1079,2.0,811.0,811.0
10.758,17,28,4418,14,1994,819.0,269.0,114.0,14,2424,819.0,587.0,145.0
0.005,6,10,1547,5,764,1.0,496.0,496.0,5,783,1.0,515.0,515.0
0.012,6,10,1989,5,927,3.0,659.0,659.0,5,1062,2.0,794.0,794.0
0.22,6,16,2669,8,1395,31.0,533.0,323.0,8,1274,20.0,529.0,212.0
0.005,6,10,2007,5,928,1.0,660.0,660.0,5,1079,1.0,811.0,811.0
0.108,6,10,1506,5,395,24.0,127.0,127.0,5,1111,24.0,843.0,843.0
300.016,6,12,1782,7,1348,50002.0,494.0,494.0,5,434,75003.0,83.0,83.0
179.054,17,74,10499,37,2473,4973.0,44.0,38.0,37,8026,4973.0,239.0,188.0
240.219,6,25,11883,14,6945,18478.0,2736.0,1034.0,11,4938,24021.0,1657.0,1089.0
0.009,6,10,1677,5,827,2.0,559.0,559.0,5,850,2.0,582.0,582.0
0.004,17,2,136,1,60,0.0,32.0,32.0,1,76,0.0,48.0,48.0
0.006,6,10,1547,5,764,1.0,496.0,496.0,5,783,1.0,515.0,515.0
0.009,6,10,1983,5,910,2.0,642.0,642.0,5,1073,2.0,805.0,805.0
0.005,6,10,1989,5,927,1.0,659.0,659.0,5,1062,1.0,794.0,794.0
0.013,6,10,1989,5,910,3.0,642.0,642.0,5,1079,3.0,811.0,811.0
0.06,17,2,152,1,76,0.0,48.0,48.0,1,76,0.0,48.0,48.0
66.274,6,45,38205,25,23417,2761.0,2848.0,1842.0,20,14788,3478.0,2576.0,1526.0
0.006,6,10,1547,5,764,1.0,496.0,496.0,5,783,1.0,515.0,515.0
0.112,6,10,1506,5,395,27.0,127.0,127.0,5,1111,27.0,843.0,843.0
0.004,17,2,136,1,60,0.0,32.0,32.0,1,76,0.0,48.0,48.0
0.004,6,10,2006,5,927,1.0,659.0,659.0,5,1079,1.0,811.0,811.0
0.116,6,10,1506,5,395,26.0,127.0,127.0,5,1111,25.0,843.0,843.0
0.103,6,10,1506,5,395,19.0,127.0,127.0,5,1111,22.0,843.0,843.0
178.095,17,82,11643,41,2741,4452.0,44.0,38.0,41,8902,4452.0,239.0,189.0
0.005,6,10,2007,5,928,1.0,660.0,660.0,5,1079,1.0,811.0,811.0
300.285,6,16,2170,9,684,37514.0,146.0,146.0,7,1486,50019.0,419.0,398.0
0.013,6,10,1989,5,910,3.0,642.0,642.0,5,1079,3.0,811.0,811.0
0.261,17,2,144,1,64,0.0,36.0,36.0,1,80,0.0,52.0,52.0
0.088,6,10,1506,5,395,19.0,127.0,127.0,5,1111,18.0,843.0,843.0
0.005,6,10,1989,5,927,1.0,659.0,659.0,5,1062,1.0,794.0,794.0
0.005,6,10,2006,5,927,1.0,659.0,659.0,5,1079,1.0,811.0,811.0
0.021,6,13,3735,7,497,3.0,125.0,125.0,6,3238,4.0,1470.0,1459.0
240.089,6,16,4481,9,963,30011.0,238.0,166.0,7,3518,40014.0,1402.0,786.0
0.019,6,10,1989,5,910,4.0,642.0,642.0,5,1079,4.0,811.0,811.0
0.017,6,10,1989,5,910,4.0,642.0,642.0,5,1079,4.0,811.0,811.0
0.02,6,10,1989,5,910,4.0,642.0,642.0,5,1079,4.0,811.0,811.0
240.094,6,16,4481,9,963,30011.0,238.0,166.0,7,3518,40014.0,1402.0,786.0
0.171,6,3,453,2,321,171.0,241.0,241.0,1,132,0.0,92.0,92.0
0.096,6,10,1506,5,395,20.0,127.0,127.0,5,1111,18.0,843.0,843.0
0.011,6,10,1989,5,910,2.0,642.0,642.0,5,1079,2.0,811.0,811.0
0.009,6,10,1762,5,911,2.0,643.0,643.0,5,851,2.0,583.0,583.0
0.013,6,10,1677,5,827,3.0,559.0,559.0,5,850,3.0,582.0,582.0
0.062,6,10,1506,5,395,14.0,127.0,127.0,5,1111,13.0,843.0,843.0
0.004,6,10,1989,5,927,1.0,659.0,659.0,5,1062,1.0,794.0,794.0
0.005,6,10,1989,5,927,1.0,659.0,659.0,5,1062,1.0,794.0,794.0
0.126,17,2,148,1,60,0.0,32.0,32.0,1,88,0.0,60.0,60.0
0.004,17,2,148,1,60,0.0,32.0,32.0,1,88,0.0,60.0,60.0
0.025,6,10,1989,5,910,6.0,642.0,642.0,5,1079,6.0,811.0,811.0
0.01,6,14,3787,7,497,1.0,125.0,125.0,7,3290,1.0,1448.0,972.0
40.086,17,10,676,5,460,10019.0,104.0,64.0,5,216,10020.0,20.0,15.0
0.009,6,10,1990,5,911,2.0,643.0,643.0,5,1079,2.0,811.0,811.0
0.005,6,10,2006,5,927,1.0,659.0,659.0,5,1079,1.0,811.0,811.0
0.091,6,10,1506,5,395,17.0,127.0,127.0,5,1111,20.0,843.0,843.0
352.002,6,20,2210,6,1308,12003.0,494.0,494.0,14,902,27076.0,83.0,83.0
0.011,6,10,1989,5,910,2.0,642.0,642.0,5,1079,2.0,811.0,811.0
0.006,6,10,1547,5,764,1.0,496.0,496.0,5,783,1.0,515.0,515.0
240.093,6,30,8782,15,6421,17149.0,1546.0,627.0,15,2361,17149.0,580.0,196.0
0.009,6,12,1926,6,1189,1.0,659.0,434.0,6,737,1.0,417.0,417.0
0.056,6,10,1506,5,395,11.0,127.0,127.0,5,1111,13.0,843.0,843.0
0.01,6,12,1926,6,1189,2.0,659.0,434.0,6,737,1.0,417.0,417.0
300.352,6,28,7486,16,1409,20023.0,217.0,142.0,12,6077,21842.0,1402.0,680.0
0.005,6,10,1774,5,923,1.0,655.0,655.0,5,851,1.0,583.0,583.0
0.004,6,10,1989,5,927,1.0,659.0,659.0,5,1062,1.0,794.0,794.0
40.076,17,10,676,5,460,10018.0,104.0,64.0,5,216,10018.0,20.0,15.0
40.063,17,10,676,5,460,10013.0,104.0,64.0,5,216,10014.0,20.0,15.0
40.065,17,10,676,5,460,10015.0,104.0,64.0,5,216,10015.0,20.0,15.0
0.066,6,10,1506,5,395,15.0,127.0,127.0,5,1111,15.0,843.0,843.0
0.004,6,10,2000,5,927,1.0,659.0,659.0,5,1073,1.0,805.0,805.0
0.086,6,10,1506,5,395,19.0,127.0,127.0,5,1111,20.0,843.0,843.0
0.004,17,2,412,1,61,0.0,33.0,33.0,1,351,0.0,323.0,323.0
0.004,17,4,284,2,120,0.0,32.0,32.0,2,164,1.0,60.0,54.0
180.1,17,80,11450,40,2688,4617.0,44.0,39.0,40,8762,4617.0,239.0,191.0
0.004,6,10,2007,5,928,1.0,660.0,660.0,5,1079,1.0,811.0,811.0
0.211,6,42,11425,23,3170,9.0,1022.0,197.0,19,8255,11.0,1402.0,659.0
0.212,6,16,2777,8,1395,30.0,533.0,323.0,8,1382,19.0,529.0,239.0
0.132,6,10,1506,5,395,25.0,127.0,127.0,5,1111,27.0,843.0,843.0
0.039,17,2,136,1,60,0.0,32.0,32.0,1,76,0.0,48.0,48.0
0.012,6,10,1989,5,910,3.0,642.0,642.0,5,1079,3.0,811.0,811.0
0.004,17,2,136,1,60,0.0,32.0,32.0,1,76,0.0,48.0,48.0
0.022,6,10,1983,5,910,5.0,642.0,642.0,5,1073,5.0,805.0,805.0
0.004,6,10,1989,5,927,1.0,659.0,659.0,5,1062,1.0,794.0,794.0
11.298,17,28,4422,14,1995,855.0,270.0,114.0,14,2427,856.0,586.0,145.0
0.004,17,2,136,1,60,0.0,32.0,32.0,1,76,0.0,48.0,48.0
0.067,6,10,1506,5,395,14.0,127.0,127.0,5,1111,14.0,843.0,843.0
0.009,6,10,1990,5,911,2.0,643.0,643.0,5,1079,2.0,811.0,811.0
0.008,6,10,1972,5,910,2.0,642.0,642.0,5,1062,1.0,794.0,794.0
0.006,6,10,2000,5,927,1.0,659.0,659.0,5,1073,1.0,805.0,805.0
0.005,6,10,2007,5,928,1.0,660.0,660.0,5,1079,1.0,811.0,811.0
0.011,6,10,1989,5,910,2.0,642.0,642.0,5,1079,2.0,811.0,811.0
0.004,6,10,1989,5,927,1.0,659.0,659.0,5,1062,1.0,794.0,794.0
0.001,17,2,180,1,66,0.0,38.0,38.0,1,114,0.0,86.0,86.0
0.005,6,10,2007,5,928,1.0,660.0,660.0,5,1079,1.0,811.0,811.0
15.074,17,15,9238,8,6902,2149.0,1350.0,834.0,7,2336,2507.0,1350.0,305.0
0.118,6,10,1506,5,395,24.0,127.0,127.0,5,1111,27.0,843.0,843.0
0.006,6,10,2007,5,928,1.0,660.0,660.0,5,1079,1.0,811.0,811.0
364.356,6,21,1793,16,1030,24290.0,190.0,190.0,5,763,60009.0,462.0,247.0
0.007,17,2,166,1,75,0.0,47.0,47.0,1,91,0.0,63.0,63.0
0.037,17,2,170,1,65,0.0,37.0,37.0,1,105,0.0,77.0,77.0
1792.05,6,569,191520,288,164527,6244.0,2883.0,934.0,281,26993,6400.0,580.0,120.0
0.159,6,10,1506,5,395,30.0,127.0,127.0,5,1111,33.0,843.0,843.0
0.006,6,10,1689,5,839,1.0,571.0,571.0,5,850,1.0,582.0,582.0
0.093,6,10,1506,5,395,20.0,127.0,127.0,5,1111,21.0,843.0,843.0
0.008,17,2,194,1,59,0.0,31.0,31.0,1,135,0.0,107.0,107.0
0.098,6,10,1506,5,395,20.0,127.0,127.0,5,1111,22.0,843.0,843.0
40.051,17,10,676,5,460,10009.0,104.0,64.0,5,216,10011.0,20.0,15.0
0.085,6,10,1506,5,395,20.0,127.0,127.0,5,1111,19.0,843.0,843.0
0.013,6,10,1983,5,910,3.0,642.0,642.0,5,1073,3.0,805.0,805.0
1792.566,6,544,189146,275,163150,6542.0,2883.0,979.0,269,25996,6688.0,378.0,117.0
0.006,6,10,1547,5,764,1.0,496.0,496.0,5,783,1.0,515.0,515.0
0.004,17,2,136,1,60,0.0,32.0,32.0,1,76,0.0,48.0,48.0
1.007,6,12,3134,6,2099,151.0,1328.0,923.0,6,1035,151.0,791.0,791.0
0.013,6,10,1677,5,827,3.0,559.0,559.0,5,850,3.0,582.0,582.0
0.009,6,10,1677,5,827,2.0,559.0,559.0,5,850,2.0,582.0,582.0
0.006,6,10,2006,5,927,1.0,659.0,659.0,5,1079,1.0,811.0,811.0
0.005,6,10,1989,5,927,1.0,659.0,659.0,5,1062,1.0,794.0,794.0
0.017,6,10,1989,5,910,4.0,642.0,642.0,5,1079,4.0,811.0,811.0
240.015,6,9,787,5,488,60003.0,232.0,232.0,4,299,80004.0,83.0,83.0
0.005,17,2,154,1,69,0.0,41.0,41.0,1,85,0.0,57.0,57.0
0.005,6,10,1989,5,927,1.0,659.0,659.0,5,1062,1.0,794.0,794.0
354.053,6,21,1795,16,1030,23603.0,190.0,190.0,5,765,60001.0,464.0,248.0
0.726,6,22,5072,11,1250,61.0,325.0,133.0,11,3822,61.0,1414.0,563.0
0.005,6,10,1643,5,860,1.0,592.0,592.0,5,783,1.0,515.0,515.0
0.004,6,10,1779,5,928,1.0,660.0,660.0,5,851,1.0,583.0,583.0
0.122,6,10,1506,5,395,18.0,127.0,127.0,5,1111,27.0,843.0,843.0
0.015,6,10,1989,5,910,3.0,642.0,642.0,5,1079,3.0,811.0,811.0
0.004,17,2,148,1,60,0.0,32.0,32.0,1,88,0.0,60.0,60.0
0.005,17,2,144,1,64,0.0,36.0,36.0,1,80,0.0,52.0,52.0
0.149,6,10,1506,5,395,33.0,127.0,127.0,5,1111,36.0,843.0,843.0
0.014,17,2,230,1,68,0.0,40.0,40.0,1,162,0.0,134.0,134.0
0.037,17,2,136,1,60,0.0,32.0,32.0,1,76,0.0,48.0,48.0
0.005,17,2,164,1,74,0.0,46.0,46.0,1,90,0.0,62.0,62.0
0.01,6,14,3787,7,497,1.0,125.0,125.0,7,3290,1.0,1448.0,972.0
0.005,6,10,2000,5,927,1.0,659.0,659.0,5,1073,1.0,805.0,805.0
0.016,6,10,1990,5,911,4.0,643.0,643.0,5,1079,4.0,811.0,811.0
0.005,6,10,2007,5,928,1.0,660.0,660.0,5,1079,1.0,811.0,811.0
0.003,17,4,284,2,120,0.0,32.0,32.0,2,164,0.0,60.0,54.0
0.004,17,2,136,1,60,0.0,32.0,32.0,1,76,0.0,48.0,48.0
0.006,17,2,179,1,71,0.0,43.0,43.0,1,108,0.0,80.0,80.0
0.068,17,8,3613,4,1874,22.0,1350.0,440.0,4,1739,11.0,1350.0,406.0
0.006,6,10,1547,5,764,1.0,496.0,496.0,5,783,1.0,515.0,515.0
354.081,6,19,1691,15,978,25291.0,190.0,190.0,4,713,80002.0,497.0,497.0
1.932,6,39,6879,21,3555,96.0,1103.0,204.0,18,3324,105.0,1402.0,340.0
310.27,17,20,1124,10,716,34460.0,48.0,43.0,10,408,34460.0,20.0,12.0
0.006,17,2,230,1,68,0.0,40.0,40.0,1,162,0.0,134.0,134.0
55.262,6,52,20868,27,14796,358.0,2720.0,1367.0,25,6072,2295.0,2667.0,361.0
0.006,6,10,1854,5,889,1.0,621.0,621.0,5,965,1.0,697.0,697.0
0.006,6,13,3747,7,509,1.0,137.0,137.0,6,3238,1.0,1470.0,1459.0
40.061,17,10,676,5,460,10013.0,104.0,64.0,5,216,10014.0,20.0,15.0
0.13,6,10,1506,5,395,30.0,127.0,127.0,5,1111,24.0,843.0,843.0
0.019,6,10,1972,5,910,4.0,642.0,642.0,5,1062,4.0,794.0,794.0
0.006,6,10,1689,5,839,1.0,571.0,571.0,5,850,1.0,582.0,582.0
0.116,6,10,1506,5,395,26.0,127.0,127.0,5,1111,26.0,843.0,843.0
0.004,6,10,2000,5,927,1.0,659.0,659.0,5,1073,1.0,805.0,805.0
0.004,6,10,1702,5,863,1.0,595.0,595.0,5,839,0.0,571.0,571.0
0.011,6,10,1972,5,910,2.0,642.0,642.0,5,1062,2.0,794.0,794.0
0.011,6,10,1990,5,911,2.0,643.0,643.0,5,1079,2.0,811.0,811.0
301.167,6,54,25722,29,19695,10755.0,4080.0,1423.0,25,6027,374.0,2667.0,385.0
0.012,6,10,1990,5,911,3.0,643.0,643.0,5,1079,3.0,811.0,811.0
0.004,17,2,148,1,60,0.0,32.0,32.0,1,88,0.0,60.0,60.0
0.017,6,10,1972,5,910,4.0,642.0,642.0,5,1062,4.0,794.0,794.0
15.072,17,15,9238,8,6902,2149.0,1350.0,834.0,7,2336,2507.0,1350.0,305.0
40.056,17,10,676,5,460,10012.0,104.0,64.0,5,216,10013.0,20.0,15.0
0.01,6,10,1989,5,910,2.0,642.0,642.0,5,1079,2.0,811.0,811.0
310.541,17,20,1124,10,716,34490.0,48.0,43.0,10,408,34490.0,20.0,12.0
177.175,17,78,10907,39,2610,4662.0,44.0,38.0,39,8297,4662.0,239.0,184.0
0.006,17,2,214,1,75,0.0,47.0,47.0,1,139,0.0,111.0,111.0
0.079,6,10,1506,5,395,17.0,127.0,127.0,5,1111,18.0,843.0,843.0
0.167,17,2,152,1,76,0.0,48.0,48.0,1,76,0.0,48.0,48.0
308.416,17,20,1124,10,716,34261.0,48.0,43.0,10,408,34261.0,20.0,12.0
11.448,17,28,4395,14,2313,868.0,588.0,137.0,14,2082,868.0,269.0,120.0
241.329,6,29,11567,16,5851,16088.0,1368.0,837.0,13,5716,20109.0,1657.0,838.0
0.104,6,10,1506,5,395,23.0,127.0,127.0,5,1111,24.0,843.0,843.0
240.013,6,9,787,5,488,60003.0,232.0,232.0,4,299,80003.0,83.0,83.0
170.174,17,82,11391,41,2744,4254.0,44.0,38.0,41,8647,4254.0,239.0,182.0
1770.726,6,83,4368,42,2210,43187.0,26.0,26.0,41,2158,44267.0,26.0,26.0
0.101,6,10,1506,5,395,22.0,127.0,127.0,5,1111,23.0,843.0,843.0
0.008,6,10,2006,5,927,1.0,659.0,659.0,5,1079,1.0,811.0,811.0
0.005,6,10,1689,5,839,1.0,571.0,571.0,5,850,1.0,582.0,582.0
0.041,17,4,284,2,120,0.0,32.0,32.0,2,164,37.0,60.0,54.0
0.012,6,10,1989,5,910,3.0,642.0,642.0,5,1079,3.0,811.0,811.0
0.003,17,2,136,1,60,0.0,32.0,32.0,1,76,0.0,48.0,48.0
563.344,6,215,182346,121,7716,4694.0,525.0,278.0,94,174630,6057.0,2945.0,1865.0
0.006,6,10,1689,5,839,1.0,571.0,571.0,5,850,1.0,582.0,582.0
0.005,6,10,2006,5,927,1.0,659.0,659.0,5,1079,1.0,811.0,811.0
0.01,6,10,1989,5,910,2.0,642.0,642.0,5,1079,2.0,811.0,811.0
0.005,6,10,2006,5,927,1.0,659.0,659.0,5,1079,1.0,811.0,811.0
0.087,6,10,1506,5,395,20.0,127.0,127.0,5,1111,19.0,843.0,843.0
0.004,17,2,148,1,60,0.0,32.0,32.0,1,88,0.0,60.0,60.0
0.01,6,10,1989,5,910,2.0,642.0,642.0,5,1079,2.0,811.0,811.0
0.005,6,10,1989,5,927,1.0,659.0,659.0,5,1062,1.0,794.0,794.0
0.069,6,10,1506,5,395,16.0,127.0,127.0,5,1111,13.0,843.0,843.0
0.005,6,13,3747,7,509,0.0,137.0,137.0,6,3238,1.0,1470.0,1459.0
0.015,6,10,1989,5,910,3.0,642.0,642.0,5,1079,3.0,811.0,811.0
0.076,6,10,1506,5,395,17.0,127.0,127.0,5,1111,17.0,843.0,843.0
0.006,6,10,1989,5,927,1.0,659.0,659.0,5,1062,1.0,794.0,794.0
0.101,6,10,1506,5,395,23.0,127.0,127.0,5,1111,23.0,843.0,843.0
0.012,6,10,1762,5,911,2.0,643.0,643.0,5,851,3.0,583.0,583.0
0.007,6,10,1989,5,910,1.0,642.0,642.0,5,1079,1.0,811.0,811.0
0.005,6,10,2007,5,928,1.0,660.0,660.0,5,1079,1.0,811.0,811.0
0.008,6,12,1926,6,1189,1.0,659.0,434.0,6,737,1.0,417.0,417.0
15.083,17,15,8099,8,5915,2150.0,1350.0,711.0,7,2184,2508.0,1350.0,284.0
0.005,17,2,154,1,69,0.0,41.0,41.0,1,85,0.0,57.0,57.0
0.079,6,10,1506,5,395,17.0,127.0,127.0,5,1111,18.0,843.0,843.0
0.003,17,2,170,1,65,0.0,37.0,37.0,1,105,0.0,77.0,77.0
0.004,6,10,2006,5,927,1.0,659.0,659.0,5,1079,1.0,811.0,811.0
0.12,6,10,1506,5,395,23.0,127.0,127.0,5,1111,24.0,843.0,843.0
0.018,6,10,1983,5,910,4.0,642.0,642.0,5,1073,4.0,805.0,805.0
0.005,6,10,2006,5,927,1.0,659.0,659.0,5,1079,1.0,811.0,811.0
0.004,6,10,1989,5,927,1.0,659.0,659.0,5,1062,1.0,794.0,794.0
0.003,17,2,136,1,60,0.0,32.0,32.0,1,76,0.0,48.0,48.0
0.083,6,10,1506,5,395,16.0,127.0,127.0,5,1111,17.0,843.0,843.0
0.013,6,10,1989,5,910,3.0,642.0,642.0,5,1079,3.0,811.0,811.0
0.006,6,10,1547,5,764,1.0,496.0,496.0,5,783,1.0,515.0,515.0
0.006,6,10,1547,5,764,1.0,496.0,496.0,5,783,1.0,515.0,515.0
0.072,17,4,284,2,120,0.0,32.0,32.0,2,164,68.0,60.0,54.0
0.011,6,10,1972,5,910,2.0,642.0,642.0,5,1062,2.0,794.0,794.0
0.023,6,10,1989,5,910,5.0,642.0,642.0,5,1079,5.0,811.0,811.0
0.015,6,13,3735,7,497,2.0,125.0,125.0,6,3238,3.0,1470.0,1459.0
0.115,6,10,1506,5,395,27.0,127.0,127.0,5,1111,24.0,843.0,843.0
165.642,6,23,8984,11,1295,89.0,514.0,274.0,12,7689,15046.0,1360.0,1028.0
0.005,6,10,2006,5,927,1.0,659.0,659.0,5,1079,1.0,811.0,811.0
0.015,6,10,1989,5,910,3.0,642.0,642.0,5,1079,3.0,811.0,811.0
0.007,17,2,212,1,74,0.0,46.0,46.0,1,138,0.0,110.0,110.0
0.072,17,2,412,1,61,0.0,33.0,33.0,1,351,0.0,323.0,323.0
0.069,6,10,1506,5,395,16.0,127.0,127.0,5,1111,16.0,843.0,843.0
0.074,6,10,1506,5,395,17.0,127.0,127.0,5,1111,17.0,843.0,843.0
0.109,6,10,1506,5,395,24.0,127.0,127.0,5,1111,23.0,843.0,843.0
0.005,6,13,3747,7,509,0.0,137.0,137.0,6,3238,0.0,1470.0,1459.0
0.095,6,10,1506,5,395,21.0,127.0,127.0,5,1111,20.0,843.0,843.0
10.827,17,28,4420,14,1995,824.0,270.0,114.0,14,2425,823.0,588.0,145.0
0.001,17,2,180,1,66,0.0,38.0,38.0,1,114,0.0,86.0,86.0
0.086,6,10,1631,5,848,21.0,580.0,580.0,5,783,21.0,515.0,515.0
40.054,17,10,676,5,460,10011.0,104.0,64.0,5,216,10012.0,20.0,15.0
0.09,6,10,1506,5,395,20.0,127.0,127.0,5,1111,18.0,843.0,843.0
0.007,17,2,184,1,68,0.0,40.0,40.0,1,116,0.0,88.0,88.0
0.005,6,10,2007,5,928,1.0,660.0,660.0,5,1079,1.0,811.0,811.0
0.004,17,2,136,1,60,0.0,32.0,32.0,1,76,0.0,48.0,48.0
0.006,6,10,1547,5,764,1.0,496.0,496.0,5,783,1.0,515.0,515.0
0.005,6,10,1779,5,928,1.0,660.0,660.0,5,851,1.0,583.0,583.0
0.005,6,10,2006,5,927,1.0,659.0,659.0,5,1079,1.0,811.0,811.0
0.016,6,10,1989,5,910,3.0,642.0,642.0,5,1079,3.0,811.0,811.0
0.008,6,12,1698,6,863,1.0,327.0,271.0,6,835,1.0,515.0,515.0
0.006,17,2,230,1,68,0.0,40.0,40.0,1,162,0.0,134.0,134.0
1770.477,6,83,4368,42,2210,43181.0,26.0,26.0,41,2158,44260.0,26.0,26.0
0.005,6,10,2006,5,927,1.0,659.0,659.0,5,1079,1.0,811.0,811.0
0.001,17,2,136,1,60,0.0,32.0,32.0,1,76,0.0,48.0,48.0
0.005,6,10,1989,5,927,1.0,659.0,659.0,5,1062,1.0,794.0,794.0
0.014,6,10,1972,5,910,3.0,642.0,642.0,5,1062,3.0,794.0,794.0
0.013,6,10,1990,5,911,3.0,643.0,643.0,5,1079,3.0,811.0,811.0
0.005,6,10,2007,5,928,1.0,660.0,660.0,5,1079,1.0,811.0,811.0
0.079,6,10,1506,5,395,17.0,127.0,127.0,5,1111,19.0,843.0,843.0
9.037,17,6,376,5,280,2259.0,28.0,28.0,1,96,0.0,68.0,68.0
0.005,6,10,1989,5,927,1.0,659.0,659.0,5,1062,1.0,794.0,794.0
0.006,17,2,136,1,60,0.0,32.0,32.0,1,76,0.0,48.0,48.0
300.205,6,27,7436,16,1409,20013.0,217.0,142.0,11,6027,24017.0,1679.0,778.0
0.175,17,2,152,1,76,0.0,48.0,48.0,1,76,0.0,48.0,48.0
0.069,6,10,1506,5,395,15.0,127.0,127.0,5,1111,13.0,843.0,843.0
0.005,6,10,2007,5,928,1.0,660.0,660.0,5,1079,1.0,811.0,811.0
0.033,6,10,1989,5,910,8.0,642.0,642.0,5,1079,8.0,811.0,811.0
356.614,6,21,1794,16,1030,23774.0,190.0,190.0,5,764,60003.0,463.0,248.0
240.073,6,21,4926,11,941,24007.0,180.0,93.0,10,3985,26674.0,1593.0,576.0
0.112,6,10,1506,5,395,16.0,127.0,127.0,5,1111,25.0,843.0,843.0
0.01,6,10,1989,5,910,2.0,642.0,642.0,5,1079,2.0,811.0,811.0
40.053,17,10,676,5,460,10012.0,104.0,64.0,5,216,10012.0,20.0,15.0
0.092,6,10,1506,5,395,19.0,127.0,127.0,5,1111,22.0,843.0,843.0
0.005,6,10,2006,5,927,1.0,659.0,659.0,5,1079,1.0,811.0,811.0
0.013,6,10,1983,5,910,3.0,642.0,642.0,5,1073,3.0,805.0,805.0
0.004,6,10,2007,5,928,1.0,660.0,660.0,5,1079,1.0,811.0,811.0
0.066,6,10,1506,5,395,15.0,127.0,127.0,5,1111,13.0,843.0,843.0
0.281,17,4,596,2,122,149.0,33.0,33.0,2,474,242.0,323.0,209.0
0.02,6,10,1989,5,910,4.0,642.0,642.0,5,1079,5.0,811.0,811.0
0.005,6,10,1643,5,860,1.0,592.0,592.0,5,783,1.0,515.0,515.0
0.008,6,10,2007,5,928,1.0,660.0,660.0,5,1079,1.0,811.0,811.0
0.006,6,10,1547,5,764,1.0,496.0,496.0,5,783,1.0,515.0,515.0
40.021,17,10,676,5,460,10002.0,104.0,64.0,5,216,10004.0,20.0,15.0
0.008,17,2,162,1,65,0.0,37.0,37.0,1,97,0.0,69.0,69.0
0.003,17,2,136,1,60,0.0,32.0,32.0,1,76,0.0,48.0,48.0
0.012,6,10,1989,5,910,3.0,642.0,642.0,5,1079,2.0,811.0,811.0
0.004,6,10,2006,5,927,1.0,659.0,659.0,5,1079,1.0,811.0,811.0
0.001,17,2,144,1,64,0.0,36.0,36.0,1,80,0.0,52.0,52.0
0.175,17,2,152,1,76,0.0,48.0,48.0,1,76,0.0,48.0,48.0
0.004,17,2,186,1,61,0.0,33.0,33.0,1,125,0.0,97.0,97.0
0.02,6,10,1631,5,848,4.0,580.0,580.0,5,783,5.0,515.0,515.0
0.003,17,2,136,1,60,0.0,32.0,32.0,1,76,0.0,48.0,48.0
64.036,58,3,216,2,144,64036.0,24.0,24.0,1,72,0.0,24.0,24.0
0.004,17,2,136,1,60,0.0,32.0,32.0,1,76,0.0,48.0,48.0
0.089,6,10,1506,5,395,20.0,127.0,127.0,5,1111,20.0,843.0,843.0
0.02,6,10,1972,5,910,5.0,642.0,642.0,5,1062,5.0,794.0,794.0
0.053,17,2,152,1,76,0.0,48.0,48.0,1,76,0.0,48.0,48.0
0.006,6,10,1689,5,839,1.0,571.0,571.0,5,850,1.0,582.0,582.0
0.004,6,10,2006,5,927,1.0,659.0,659.0,5,1079,1.0,811.0,811.0
0.005,17,2,170,1,65,0.0,37.0,37.0,1,105,0.0,77.0,77.0
0.005,6,10,1989,5,927,1.0,659.0,659.0,5,1062,1.0,794.0,794.0
1729.257,6,60,4400,40,2740,44339.0,33.0,33.0,20,1660,91004.0,31.0,31.0
0.004,17,4,284,2,120,0.0,32.0,32.0,2,164,1.0,60.0,54.0
0.006,6,10,1547,5,764,1.0,496.0,496.0,5,783,1.0,515.0,515.0
40.045,17,10,676,5,460,10010.0,104.0,64.0,5,216,10010.0,20.0,15.0
0.005,17,2,257,1,59,0.0,31.0,31.0,1,198,0.0,170.0,170.0
0.006,17,2,230,1,68,0.0,40.0,40.0,1,162,0.0,134.0,134.0
0.017,6,10,1631,5,848,4.0,580.0,580.0,5,783,4.0,515.0,515.0
0.097,6,10,1506,5,395,19.0,127.0,127.0,5,1111,22.0,843.0,843.0
0.01,6,10,1989,5,910,2.0,642.0,642.0,5,1079,2.0,811.0,811.0
0.013,6,10,1989,5,910,3.0,642.0,642.0,5,1079,3.0,811.0,811.0
0.005,17,2,230,1,68,0.0,40.0,40.0,1,162,0.0,134.0,134.0
0.013,6,10,1983,5,910,3.0,642.0,642.0,5,1073,3.0,805.0,805.0
0.005,6,10,1989,5,927,1.0,659.0,659.0,5,1062,1.0,794.0,794.0
0.004,6,10,2006,5,927,1.0,659.0,659.0,5,1079,1.0,811.0,811.0
0.013,6,10,1762,5,911,3.0,643.0,643.0,5,851,3.0,583.0,583.0
0.025,6,10,1989,5,910,6.0,642.0,642.0,5,1079,6.0,811.0,811.0
0.005,6,10,1854,5,889,1.0,621.0,621.0,5,965,1.0,697.0,697.0
174.483,17,82,11496,41,2736,4361.0,44.0,38.0,41,8760,4362.0,260.0,185.0
240.334,6,30,12127,15,5818,17166.0,1732.0,1006.0,15,6309,17166.0,1657.0,788.0
0.119,6,10,1506,5,395,27.0,127.0,127.0,5,1111,23.0,843.0,843.0
40.066,17,10,676,5,460,10015.0,104.0,64.0,5,216,10015.0,20.0,15.0
0.814,6,10,2009,6,1655,162.0,1403.0,1403.0,4,354,194.0,182.0,182.0
0.005,17,2,180,1,58,0.0,30.0,30.0,1,122,0.0,94.0,94.0
0.004,6,10,2007,5,928,1.0,660.0,660.0,5,1079,1.0,811.0,811.0
0.082,6,10,1506,5,395,17.0,127.0,127.0,5,1111,16.0,843.0,843.0
0.005,17,2,144,1,64,0.0,36.0,36.0,1,80,0.0,52.0,52.0
0.011,17,2,148,1,60,0.0,32.0,32.0,1,88,0.0,60.0,60.0
0.017,6,10,1990,5,911,4.0,643.0,643.0,5,1079,4.0,811.0,811.0
0.004,17,2,168,1,76,0.0,48.0,48.0,1,92,0.0,64.0,64.0
0.009,6,10,1762,5,911,2.0,643.0,643.0,5,851,2.0,583.0,583.0
240.101,6,31,9554,15,7067,17150.0,2192.0,699.0,16,2487,16006.0,580.0,205.0
240.107,6,16,4480,9,963,30013.0,238.0,166.0,7,3517,40016.0,1402.0,786.0
0.009,6,10,1983,5,910,2.0,642.0,642.0,5,1073,2.0,805.0,805.0
0.005,6,10,2007,5,928,1.0,660.0,660.0,5,1079,1.0,811.0,811.0
0.007,17,2,140,1,62,0.0,34.0,34.0,1,78,0.0,50.0,50.0
0.087,6,10,1506,5,395,19.0,127.0,127.0,5,1111,18.0,843.0,843.0
0.001,17,2,180,1,66,0.0,38.0,38.0,1,114,0.0,86.0,86.0
0.006,17,2,170,1,65,0.0,37.0,37.0,1,105,0.0,77.0,77.0
0.016,6,10,1983,5,910,4.0,642.0,642.0,5,1073,3.0,805.0,805.0
0.006,6,10,1547,5,764,1.0,496.0,496.0,5,783,1.0,515.0,515.0
0.003,17,2,234,1,61,0.0,33.0,33.0,1,173,0.0,145.0,145.0
0.004,6,10,1774,5,923,1.0,655.0,655.0,5,851,1.0,583.0,583.0
0.005,6,10,2006,5,927,1.0,659.0,659.0,5,1079,1.0,811.0,811.0
0.006,6,10,1854,5,889,1.0,621.0,621.0,5,965,1.0,697.0,697.0
0.039,17,2,148,1,60,0.0,32.0,32.0,1,88,0.0,60.0,60.0
0.004,6,10,2007,5,928,1.0,660.0,660.0,5,1079,1.0,811.0,811.0
0.005,6,10,1547,5,764,1.0,496.0,496.0,5,783,1.0,515.0,515.0
40.052,17,10,676,5,460,10012.0,104.0,64.0,5,216,10012.0,20.0,15.0
0.004,6,13,3690,7,452,0.0,80.0,80.0,6,3238,0.0,1470.0,1459.0
0.004,17,2,136,1,60,0.0,32.0,32.0,1,76,0.0,48.0,48.0
0.005,17,2,212,1,74,0.0,46.0,46.0,1,138,0.0,110.0,110.0
0.102,6,10,1506,5,395,21.0,127.0,127.0,5,1111,21.0,843.0,843.0
0.083,6,10,1506,5,395,19.0,127.0,127.0,5,1111,16.0,843.0,843.0
0.011,6,10,1983,5,910,2.0,642.0,642.0,5,1073,2.0,805.0,805.0
352.824,6,20,2210,6,1308,12003.0,494.0,494.0,14,902,27140.0,83.0,83.0
0.005,6,10,1989,5,927,1.0,659.0,659.0,5,1062,1.0,794.0,794.0
0.005,6,10,1689,5,839,1.0,571.0,571.0,5,850,1.0,582.0,582.0
0.001,17,2,179,1,62,0.0,34.0,34.0,1,117,0.0,89.0,89.0
0.011,6,10,1989,5,910,2.0,642.0,642.0,5,1079,2.0,811.0,811.0
1769.062,17,92,8096,46,4048,39312.0,60.0,60.0,46,4048,39312.0,60.0,60.0
0.01,6,12,1926,6,1189,2.0,659.0,434.0,6,737,1.0,417.0,417.0
0.006,17,2,179,1,71,0.0,43.0,43.0,1,108,0.0,80.0,80.0
0.01,6,10,1689,5,839,2.0,571.0,571.0,5,850,2.0,582.0,582.0
0.006,6,13,3747,7,509,0.0,137.0,137.0,6,3238,1.0,1470.0,1459.0
0.115,6,10,1506,5,395,24.0,127.0,127.0,5,1111,23.0,843.0,843.0
0.005,6,10,2000,5,927,1.0,659.0,659.0,5,1073,1.0,805.0,805.0
0.09,6,10,1506,5,395,20.0,127.0,127.0,5,1111,18.0,843.0,843.0
0.071,17,8,3613,4,1874,23.0,1350.0,440.0,4,1739,12.0,1350.0,406.0
0.072,6,10,1506,5,395,16.0,127.0,127.0,5,1111,14.0,843.0,843.0
0.007,17,2,136,1,60,0.0,32.0,32.0,1,76,0.0,48.0,48.0
0.014,6,10,1677,5,827,3.0,559.0,559.0,5,850,3.0,582.0,582.0
0.006,6,10,1689,5,839,1.0,571.0,571.0,5,850,1.0,582.0,582.0
0.08,6,10,1506,5,395,19.0,127.0,127.0,5,1111,14.0,843.0,843.0
40.066,17,10,676,5,460,10015.0,104.0,64.0,5,216,10015.0,20.0,15.0
0.108,6,10,1506,5,395,24.0,127.0,127.0,5,1111,25.0,843.0,843.0
40.068,17,10,676,5,460,10013.0,104.0,64.0,5,216,10016.0,20.0,15.0
0.001,17,2,180,1,66,0.0,38.0,38.0,1,114,0.0,86.0,86.0
0.005,6,10,2000,5,927,1.0,659.0,659.0,5,1073,1.0,805.0,805.0
0.01,6,10,1989,5,910,2.0,642.0,642.0,5,1079,2.0,811.0,811.0
240.101,6,16,4481,9,963,30012.0,238.0,166.0,7,3518,40016.0,1402.0,786.0
0.009,6,13,3735,7,497,1.0,125.0,125.0,6,3238,1.0,1470.0,1459.0
0.012,6,10,1972,5,910,3.0,642.0,642.0,5,1062,2.0,794.0,794.0
0.002,17,2,136,1,60,0.0,32.0,32.0,1,76,0.0,48.0,48.0
0.07,6,10,1506,5,395,16.0,127.0,127.0,5,1111,14.0,843.0,843.0
0.108,6,10,1506,5,395,25.0,127.0,127.0,5,1111,22.0,843.0,843.0
0.006,6,10,1643,5,860,1.0,592.0,592.0,5,783,1.0,515.0,515.0
0.104,6,10,1506,5,395,21.0,127.0,127.0,5,1111,22.0,843.0,843.0
0.005,6,10,2006,5,927,1.0,659.0,659.0,5,1079,1.0,811.0,811.0
0.005,6,10,1689,5,839,1.0,571.0,571.0,5,850,1.0,582.0,582.0
0.005,6,10,2007,5,928,1.0,660.0,660.0,5,1079,1.0,811.0,811.0
0.014,6,10,1989,5,910,3.0,642.0,642.0,5,1079,3.0,811.0,811.0
0.005,17,2,154,1,69,0.0,41.0,41.0,1,85,0.0,57.0,57.0
0.005,6,10,1689,5,839,1.0,571.0,571.0,5,850,1.0,582.0,582.0
0.005,6,10,1689,5,839,1.0,571.0,571.0,5,850,1.0,582.0,582.0
0.006,6,10,1689,5,839,1.0,571.0,571.0,5,850,1.0,582.0,582.0
0.104,6,10,1506,5,395,22.0,127.0,127.0,5,1111,24.0,843.0,843.0
0.039,17,2,170,1,65,0.0,37.0,37.0,1,105,0.0,77.0,77.0
0.005,6,10,1702,5,863,1.0,595.0,595.0,5,839,1.0,571.0,571.0
0.005,6,10,2000,5,927,1.0,659.0,659.0,5,1073,1.0,805.0,805.0
0.004,6,10,1774,5,923,1.0,655.0,655.0,5,851,1.0,583.0,583.0
0.044,6,10,1605,5,388,10.0,120.0,120.0,5,1217,11.0,949.0,949.0
0.005,6,10,2007,5,928,1.0,660.0,660.0,5,1079,1.0,811.0,811.0
0.077,6,10,1506,5,395,14.0,127.0,127.0,5,1111,18.0,843.0,843.0
10.727,17,26,4102,13,1822,885.0,269.0,112.0,13,2280,884.0,587.0,147.0
0.004,6,10,2006,5,927,1.0,659.0,659.0,5,1079,1.0,811.0,811.0
0.01,6,10,1990,5,911,2.0,643.0,643.0,5,1079,2.0,811.0,811.0
0.014,6,10,1990,5,911,3.0,643.0,643.0,5,1079,3.0,811.0,811.0
0.018,6,10,1990,5,911,4.0,643.0,643.0,5,1079,4.0,811.0,811.0
40.053,17,10,676,5,460,10012.0,104.0,64.0,5,216,10012.0,20.0,15.0
0.013,6,10,1972,5,910,3.0,642.0,642.0,5,1062,3.0,794.0,794.0
0.005,17,2,140,1,62,0.0,34.0,34.0,1,78,0.0,50.0,50.0
0.066,6,10,1506,5,395,15.0,127.0,127.0,5,1111,14.0,843.0,843.0
0.078,6,10,1506,5,395,17.0,127.0,127.0,5,1111,17.0,843.0,843.0
0.067,6,10,1506,5,395,12.0,127.0,127.0,5,1111,16.0,843.0,843.0
0.015,6,10,1972,5,910,3.0,642.0,642.0,5,1062,3.0,794.0,794.0
0.04,17,2,412,1,61,0.0,33.0,33.0,1,351,0.0,323.0,323.0
0.01,6,10,1983,5,910,2.0,642.0,642.0,5,1073,2.0,805.0,805.0
0.004,6,10,1989,5,927,1.0,659.0,659.0,5,1062,1.0,794.0,794.0
0.019,6,10,1989,5,910,4.0,642.0,642.0,5,1079,4.0,811.0,811.0
0.117,6,10,1506,5,395,24.0,127.0,127.0,5,1111,23.0,843.0,843.0
0.005,6,10,1989,5,927,1.0,659.0,659.0,5,1062,1.0,794.0,794.0
0.006,17,2,166,1,75,0.0,47.0,47.0,1,91,0.0,63.0,63.0
0.104,6,10,1506,5,395,23.0,127.0,127.0,5,1111,23.0,843.0,843.0
366.846,6,22,2313,16,867,24456.0,195.0,195.0,6,1446,4763.0,419.0,398.0
0.007,17,2,179,1,71,0.0,43.0,43.0,1,108,0.0,80.0,80.0
0.065,6,10,1506,5,395,15.0,127.0,127.0,5,1111,14.0,843.0,843.0
0.009,6,10,1989,5,910,2.0,642.0,642.0,5,1079,2.0,811.0,811.0
0.004,6,10,2007,5,928,1.0,660.0,660.0,5,1079,1.0,811.0,811.0
176.203,17,76,10834,38,2544,4762.0,44.0,38.0,38,8290,4762.0,239.0,190.0
0.041,17,2,152,1,76,0.0,48.0,48.0,1,76,0.0,48.0,48.0
0.008,6,10,2006,5,927,2.0,659.0,659.0,5,1079,2.0,811.0,811.0
0.012,6,10,1989,5,910,3.0,642.0,642.0,5,1079,3.0,811.0,811.0
0.04,17,2,148,1,60,0.0,32.0,32.0,1,88,0.0,60.0,60.0
0.01,6,10,1989,5,910,2.0,642.0,642.0,5,1079,2.0,811.0,811.0
0.004,6,10,1702,5,863,0.0,595.0,595.0,5,839,1.0,571.0,571.0
0.005,6,10,2000,5,927,1.0,659.0,659.0,5,1073,1.0,805.0,805.0
0.005,17,2,170,1,65,0.0,37.0,37.0,1,105,0.0,77.0,77.0
240.124,6,20,4714,10,889,26680.0,180.0,93.0,10,3825,26677.0,1433.0,549.0
0.004,6,10,2007,5,928,1.0,660.0,660.0,5,1079,1.0,811.0,811.0
0.005,6,10,1689,5,839,1.0,571.0,571.0,5,850,1.0,582.0,582.0
0.077,6,10,1506,5,395,16.0,127.0,127.0,5,1111,18.0,843.0,843.0
9.036,17,6,376,5,280,2259.0,28.0,28.0,1,96,0.0,68.0,68.0
0.028,6,10,1631,5,848,7.0,580.0,580.0,5,783,7.0,515.0,515.0
0.173,6,3,453,2,321,173.0,241.0,241.0,1,132,0.0,92.0,92.0
173.464,17,82,11614,41,2736,4336.0,44.0,38.0,41,8878,4336.0,261.0,188.0
0.041,17,4,284,2,120,1.0,32.0,32.0,2,164,37.0,60.0,54.0
0.014,6,10,1990,5,911,3.0,643.0,643.0,5,1079,3.0,811.0,811.0
0.006,6,10,1547,5,764,1.0,496.0,496.0,5,783,1.0,515.0,515.0
0.12,6,10,1506,5,395,26.0,127.0,127.0,5,1111,24.0,843.0,843.0
0.009,6,10,1990,5,911,2.0,643.0,643.0,5,1079,2.0,811.0,811.0
0.005,6,10,2007,5,928,1.0,660.0,660.0,5,1079,1.0,811.0,811.0
0.006,6,10,1547,5,764,1.0,496.0,496.0,5,783,1.0,515.0,515.0
0.004,6,10,2006,5,927,1.0,659.0,659.0,5,1079,1.0,811.0,811.0
0.073,6,10,1506,5,395,17.0,127.0,127.0,5,1111,16.0,843.0,843.0
9.042,17,6,376,5,280,2260.0,28.0,28.0,1,96,0.0,68.0,68.0
0.006,6,10,1643,5,860,1.0,592.0,592.0,5,783,1.0,515.0,515.0
0.009,6,14,3787,7,497,1.0,125.0,125.0,7,3290,1.0,1448.0,972.0
120.983,6,58,19050,33,4804,3780.0,1052.0,221.0,25,14246,5040.0,2804.0,995.0
0.013,6,10,1972,5,910,3.0,642.0,642.0,5,1062,3.0,794.0,794.0
0.097,6,10,1506,5,395,15.0,127.0,127.0,5,1111,21.0,843.0,843.0
11.198,17,28,4423,14,1995,847.0,270.0,114.0,14,2428,848.0,587.0,145.0
0.011,6,10,1989,5,910,2.0,642.0,642.0,5,1079,2.0,811.0,811.0
0.01,6,12,1698,6,863,1.0,327.0,271.0,6,835,1.0,515.0,515.0
0.005,6,10,2006,5,927,1.0,659.0,659.0,5,1079,1.0,811.0,811.0
0.005,17,2,180,1,66,0.0,38.0,38.0,1,114,0.0,86.0,86.0
0.011,6,10,1989,5,910,2.0,642.0,642.0,5,1079,2.0,811.0,811.0
0.169,6,10,1506,5,395,40.0,127.0,127.0,5,1111,40.0,843.0,843.0
0.003,17,2,148,1,60,0.0,32.0,32.0,1,88,0.0,60.0,60.0
0.094,6,10,1506,5,395,21.0,127.0,127.0,5,1111,19.0,843.0,843.0
0.012,6,10,1677,5,827,3.0,559.0,559.0,5,850,3.0,582.0,582.0
0.016,6,10,1983,5,910,4.0,642.0,642.0,5,1073,3.0,805.0,805.0
180.962,6,33,6264,18,1338,10644.0,267.0,195.0,15,4926,603.0,1823.0,392.0
0.068,6,10,1506,5,395,12.0,127.0,127.0,5,1111,15.0,843.0,843.0
0.013,6,10,1989,5,910,3.0,642.0,642.0,5,1079,3.0,811.0,811.0
0.011,6,10,1990,5,911,2.0,643.0,643.0,5,1079,2.0,811.0,811.0
0.005,6,10,2000,5,927,1.0,659.0,659.0,5,1073,1.0,805.0,805.0
319.742,17,20,1124,10,716,35512.0,48.0,43.0,10,408,35512.0,20.0,12.0
0.004,6,10,1702,5,863,1.0,595.0,595.0,5,839,1.0,571.0,571.0
0.005,6,10,2006,5,927,1.0,659.0,659.0,5,1079,1.0,811.0,811.0
0.005,17,2,184,1,68,0.0,40.0,40.0,1,116,0.0,88.0,88.0
0.012,6,10,1989,5,910,2.0,642.0,642.0,5,1079,2.0,811.0,811.0
0.003,17,2,185,1,73,0.0,45.0,45.0,1,112,0.0,84.0,84.0
40.069,17,10,676,5,460,10016.0,104.0,64.0,5,216,10016.0,20.0,15.0
0.062,6,10,1506,5,395,13.0,127.0,127.0,5,1111,14.0,843.0,843.0
0.005,17,2,179,1,71,0.0,43.0,43.0,1,108,0.0,80.0,80.0
0.043,6,10,1972,5,910,10.0,642.0,642.0,5,1062,10.0,794.0,794.0
0.005,17,2,184,1,61,0.0,33.0,33.0,1,123,0.0,95.0,95.0
0.01,6,10,1989,5,910,2.0,642.0,642.0,5,1079,2.0,811.0,811.0
0.008,6,10,1689,5,839,1.0,571.0,571.0,5,850,1.0,582.0,582.0
0.004,6,10,2006,5,927,1.0,659.0,659.0,5,1079,1.0,811.0,811.0
0.019,6,10,1631,5,848,4.0,580.0,580.0,5,783,4.0,515.0,515.0
0.004,6,10,1774,5,923,1.0,655.0,655.0,5,851,1.0,583.0,583.0
0.001,17,2,179,1,62,0.0,34.0,34.0,1,117,0.0,89.0,89.0
0.005,17,2,144,1,64,0.0,36.0,36.0,1,80,0.0,52.0,52.0
0.006,6,10,2007,5,928,1.0,660.0,660.0,5,1079,1.0,811.0,811.0
0.001,17,2,179,1,62,0.0,34.0,34.0,1,117,0.0,89.0,89.0
0.011,6,10,1989,5,910,2.0,642.0,642.0,5,1079,2.0,811.0,811.0
0.003,17,4,420,2,122,0.0,33.0,33.0,2,298,0.0,145.0,121.0
0.107,6,10,1506,5,395,24.0,127.0,127.0,5,1111,22.0,843.0,843.0
0.009,6,10,1990,5,911,2.0,643.0,643.0,5,1079,2.0,811.0,811.0
0.171,6,3,453,2,321,171.0,241.0,241.0,1,132,0.0,92.0,92.0
0.006,6,10,1547,5,764,1.0,496.0,496.0,5,783,1.0,515.0,515.0
0.012,6,10,1631,5,848,3.0,580.0,580.0,5,783,2.0,515.0,515.0
0.015,17,2,180,1,66,0.0,38.0,38.0,1,114,0.0,86.0,86.0
0.012,6,10,1631,5,848,2.0,580.0,580.0,5,783,2.0,515.0,515.0
0.011,6,10,1990,5,911,2.0,643.0,643.0,5,1079,2.0,811.0,811.0
0.084,6,10,1506,5,395,19.0,127.0,127.0,5,1111,17.0,843.0,843.0
0.005,6,10,1989,5,927,1.0,659.0,659.0,5,1062,1.0,794.0,794.0
0.006,17,2,164,1,74,0.0,46.0,46.0,1,90,0.0,62.0,62.0
0.004,17,4,284,2,120,0.0,32.0,32.0,2,164,1.0,60.0,54.0
0.003,17,2,148,1,60,0.0,32.0,32.0,1,88,0.0,60.0,60.0
0.086,6,10,1506,5,395,19.0,127.0,127.0,5,1111,18.0,843.0,843.0
0.008,6,10,1631,5,848,2.0,580.0,580.0,5,783,2.0,515.0,515.0
0.005,6,10,1989,5,927,1.0,659.0,659.0,5,1062,1.0,794.0,794.0
354.036,6,21,1795,16,1030,23602.0,190.0,190.0,5,765,60001.0,464.0,248.0
0.011,6,10,1972,5,910,2.0,642.0,642.0,5,1062,2.0,794.0,794.0
0.001,17,2,142,1,63,0.0,35.0,35.0,1,79,0.0,51.0,51.0
40.054,17,10,676,5,460,10012.0,104.0,64.0,5,216,10012.0,20.0,15.0
0.006,6,10,1643,5,860,1.0,592.0,592.0,5,783,1.0,515.0,515.0
0.01,6,10,1989,5,910,2.0,642.0,642.0,5,1079,2.0,811.0,811.0
0.004,6,10,2006,5,927,1.0,659.0,659.0,5,1079,1.0,811.0,811.0
10.806,17,28,4421,14,1993,822.0,268.0,114.0,14,2428,822.0,587.0,145.0
0.005,6,10,2006,5,927,1.0,659.0,659.0,5,1079,1.0,811.0,811.0
292.039,6,387,348309,187,21290,1570.0,2736.0,889.0,200,327019,1467.0,3364.0,1702.0
0.003,17,2,136,1,60,0.0,32.0,32.0,1,76,0.0,48.0,48.0
0.005,17,2,140,1,62,0.0,34.0,34.0,1,78,0.0,50.0,50.0
0.02,6,10,1631,5,848,4.0,580.0,580.0,5,783,5.0,515.0,515.0
0.011,6,10,1972,5,910,2.0,642.0,642.0,5,1062,2.0,794.0,794.0
0.071,17,2,234,1,61,0.0,33.0,33.0,1,173,0.0,145.0,145.0
0.01,6,10,1989,5,910,2.0,642.0,642.0,5,1079,2.0,811.0,811.0
0.009,6,10,1972,5,910,2.0,642.0,642.0,5,1062,2.0,794.0,794.0
0.005,6,10,2000,5,927,1.0,659.0,659.0,5,1073,1.0,805.0,805.0
0.007,6,10,2006,5,927,1.0,659.0,659.0,5,1079,1.0,811.0,811.0
0.005,6,10,1989,5,927,1.0,659.0,659.0,5,1062,1.0,794.0,794.0
0.005,6,10,2006,5,927,1.0,659.0,659.0,5,1079,1.0,811.0,811.0
0.041,17,2,152,1,76,0.0,48.0,48.0,1,76,0.0,48.0,48.0
0.005,6,10,2006,5,927,1.0,659.0,659.0,5,1079,1.0,811.0,811.0
0.005,6,10,1989,5,927,1.0,659.0,659.0,5,1062,1.0,794.0,794.0
0.004,6,10,1989,5,927,1.0,659.0,659.0,5,1062,1.0,794.0,794.0
285.17,6,30,6571,16,1433,19011.0,517.0,290.0,14,5138,21935.0,2376.0,1103.0
0.007,6,10,2000,5,927,1.0,659.0,659.0,5,1073,1.0,805.0,805.0
0.212,6,10,1506,5,395,49.0,127.0,127.0,5,1111,49.0,843.0,843.0
0.005,6,10,1989,5,927,1.0,659.0,659.0,5,1062,1.0,794.0,794.0
0.011,6,10,1989,5,910,2.0,642.0,642.0,5,1079,2.0,811.0,811.0
0.013,6,10,1990,5,911,3.0,643.0,643.0,5,1079,3.0,811.0,811.0
0.041,6,10,1990,5,911,10.0,643.0,643.0,5,1079,10.0,811.0,811.0
0.009,6,10,1989,5,910,2.0,642.0,642.0,5,1079,2.0,811.0,811.0
1792.761,6,486,98773,245,87543,7346.0,421.0,368.0,241,11230,7469.0,53.0,53.0
10.813,17,28,4424,14,1995,822.0,270.0,114.0,14,2429,822.0,588.0,145.0
0.124,17,2,80,1,32,0.0,4.0,4.0,1,48,0.0,20.0,20.0
0.071,17,2,148,1,60,0.0,32.0,32.0,1,88,0.0,60.0,60.0
0.005,6,10,1689,5,839,1.0,571.0,571.0,5,850,1.0,582.0,582.0
0.128,6,10,1506,5,395,27.0,127.0,127.0,5,1111,28.0,843.0,843.0
0.056,6,10,1506,5,395,13.0,127.0,127.0,5,1111,10.0,843.0,843.0
0.005,6,10,2006,5,927,1.0,659.0,659.0,5,1079,1.0,811.0,811.0
172.094,17,80,11364,40,2673,4412.0,44.0,38.0,40,8691,4412.0,239.0,189.0
40.012,17,10,676,5,460,10001.0,104.0,64.0,5,216,10001.0,20.0,15.0
0.005,17,2,136,1,60,0.0,32.0,32.0,1,76,0.0,48.0,48.0
0.005,6,10,1989,5,927,1.0,659.0,659.0,5,1062,1.0,794.0,794.0
0.013,6,10,1989,5,910,3.0,642.0,642.0,5,1079,3.0,811.0,811.0
0.005,6,10,2006,5,927,1.0,659.0,659.0,5,1079,1.0,811.0,811.0
0.008,6,10,1989,5,910,1.0,642.0,642.0,5,1079,1.0,811.0,811.0
0.016,6,10,1972,5,910,4.0,642.0,642.0,5,1062,3.0,794.0,794.0
308.479,17,20,1124,10,716,34268.0,48.0,43.0,10,408,34268.0,20.0,12.0
0.112,6,10,1506,5,395,19.0,127.0,127.0,5,1111,23.0,843.0,843.0
0.005,6,10,1689,5,839,1.0,571.0,571.0,5,850,1.0,582.0,582.0
0.004,17,2,154,1,69,0.0,41.0,41.0,1,85,0.0,57.0,57.0
0.005,6,10,1989,5,927,1.0,659.0,659.0,5,1062,1.0,794.0,794.0
177.324,17,96,13792,48,3231,3772.0,44.0,39.0,48,10561,3772.0,239.0,192.0
0.006,17,2,166,1,75,0.0,47.0,47.0,1,91,0.0,63.0,63.0
0.005,6,10,2007,5,928,1.0,660.0,660.0,5,1079,1.0,811.0,811.0
0.114,6,10,1506,5,395,26.0,127.0,127.0,5,1111,22.0,843.0,843.0
0.016,6,10,1972,5,910,3.0,642.0,642.0,5,1062,4.0,794.0,794.0
1.029,6,12,3134,6,2099,155.0,1328.0,923.0,6,1035,154.0,791.0,791.0
0.12,6,10,1506,5,395,27.0,127.0,127.0,5,1111,26.0,843.0,843.0
0.006,6,10,1547,5,764,1.0,496.0,496.0,5,783,1.0,515.0,515.0
0.08,6,10,1506,5,395,17.0,127.0,127.0,5,1111,19.0,843.0,843.0
0.018,6,10,1631,5,848,4.0,580.0,580.0,5,783,4.0,515.0,515.0
0.086,6,10,1506,5,395,19.0,127.0,127.0,5,1111,20.0,843.0,843.0
1798.287,6,244,35804,152,26032,11909.0,302.0,302.0,92,9772,19761.0,83.0,83.0
0.009,6,13,3735,7,497,1.0,125.0,125.0,6,3238,1.0,1470.0,1459.0
0.012,6,10,1983,5,910,3.0,642.0,642.0,5,1073,3.0,805.0,805.0
0.011,6,10,1972,5,910,2.0,642.0,642.0,5,1062,2.0,794.0,794.0
0.006,6,10,2006,5,927,1.0,659.0,659.0,5,1079,1.0,811.0,811.0
0.027,6,10,1989,5,910,6.0,642.0,642.0,5,1079,6.0,811.0,811.0
309.386,17,20,1124,10,716,34362.0,48.0,43.0,10,408,34362.0,20.0,12.0
0.007,6,10,1989,5,927,1.0,659.0,659.0,5,1062,1.0,794.0,794.0
0.006,6,10,1643,5,860,1.0,592.0,592.0,5,783,1.0,515.0,515.0
0.009,6,12,1926,6,1189,1.0,659.0,434.0,6,737,1.0,417.0,417.0
0.005,6,10,2006,5,927,1.0,659.0,659.0,5,1079,1.0,811.0,811.0
0.01,6,10,1989,5,910,2.0,642.0,642.0,5,1079,2.0,811.0,811.0
0.006,6,10,1854,5,889,1.0,621.0,621.0,5,965,1.0,697.0,697.0
0.004,17,2,185,1,73,0.0,45.0,45.0,1,112,0.0,84.0,84.0
0.012,6,10,1990,5,911,3.0,643.0,643.0,5,1079,2.0,811.0,811.0
0.015,6,10,1972,5,910,3.0,642.0,642.0,5,1062,3.0,794.0,794.0
0.113,6,10,1506,5,395,27.0,127.0,127.0,5,1111,26.0,843.0,843.0
0.006,6,13,3747,7,509,0.0,137.0,137.0,6,3238,1.0,1470.0,1459.0
0.005,6,10,2007,5,928,1.0,660.0,660.0,5,1079,1.0,811.0,811.0
0.006,6,10,1547,5,764,1.0,496.0,496.0,5,783,1.0,515.0,515.0
0.183,6,10,1506,5,395,43.0,127.0,127.0,5,1111,39.0,843.0,843.0
0.004,6,10,2006,5,927,1.0,659.0,659.0,5,1079,1.0,811.0,811.0
0.021,6,10,1990,5,911,5.0,643.0,643.0,5,1079,5.0,811.0,811.0
0.01,6,14,3787,7,497,1.0,125.0,125.0,7,3290,1.0,1448.0,972.0
0.781,6,23,8440,13,2067,65.0,1140.0,378.0,10,6373,68.0,2720.0,851.0
0.016,6,10,1989,5,910,4.0,642.0,642.0,5,1079,4.0,811.0,811.0
0.006,17,2,230,1,68,0.0,40.0,40.0,1,162,0.0,134.0,134.0
40.085,17,10,676,5,460,10019.0,104.0,64.0,5,216,10020.0,20.0,15.0
0.005,6,10,1854,5,889,1.0,621.0,621.0,5,965,1.0,697.0,697.0
0.019,17,2,152,1,56,0.0,28.0,28.0,1,96,0.0,68.0,68.0
0.009,6,14,3787,7,497,1.0,125.0,125.0,7,3290,1.0,1448.0,972.0
10.99,17,28,4393,14,1993,836.0,268.0,114.0,14,2400,836.0,587.0,143.0
0.005,6,10,1689,5,839,1.0,571.0,571.0,5,850,1.0,582.0,582.0
1777.692,17,144,45504,72,22752,25037.0,288.0,288.0,72,22752,25037.0,288.0,288.0
60.541,6,339,635774,73,5390,840.0,1275.0,524.0,266,630384,228.0,4206.0,2344.0
0.081,6,10,1506,5,395,17.0,127.0,127.0,5,1111,18.0,843.0,843.0
0.027,17,4,284,2,120,0.0,32.0,32.0,2,164,0.0,60.0,54.0
0.093,6,10,1506,5,395,21.0,127.0,127.0,5,1111,21.0,843.0,843.0
0.004,6,10,2000,5,927,1.0,659.0,659.0,5,1073,1.0,805.0,805.0
0.024,6,10,1989,5,910,6.0,642.0,642.0,5,1079,6.0,811.0,811.0
0.071,17,8,3613,4,1874,23.0,1350.0,440.0,4,1739,12.0,1350.0,406.0
0.091,6,10,1506,5,395,20.0,127.0,127.0,5,1111,18.0,843.0,843.0
0.004,17,4,284,2,120,0.0,32.0,32.0,2,164,0.0,60.0,54.0
0.008,17,2,194,1,59,0.0,31.0,31.0,1,135,0.0,107.0,107.0
0.015,6,10,1989,5,910,3.0,642.0,642.0,5,1079,3.0,811.0,811.0
0.105,6,10,1506,5,395,23.0,127.0,127.0,5,1111,21.0,843.0,843.0
0.018,6,10,1631,5,848,4.0,580.0,580.0,5,783,4.0,515.0,515.0
0.097,6,10,1506,5,395,20.0,127.0,127.0,5,1111,20.0,843.0,843.0
0.012,6,10,1990,5,911,3.0,643.0,643.0,5,1079,2.0,811.0,811.0
0.327,17,43,23090,24,19834,14.0,1350.0,798.0,19,3256,14.0,1350.0,143.0
40.05,17,10,676,5,460,10011.0,104.0,64.0,5,216,10011.0,20.0,15.0
0.099,6,10,1506,5,395,20.0,127.0,127.0,5,1111,23.0,843.0,843.0
0.014,6,10,1989,5,910,3.0,642.0,642.0,5,1079,3.0,811.0,811.0
0.001,17,2,180,1,66,0.0,38.0,38.0,1,114,0.0,86.0,86.0
0.005,6,10,1774,5,923,1.0,655.0,655.0,5,851,1.0,583.0,583.0
0.004,6,10,2006,5,927,1.0,659.0,659.0,5,1079,1.0,811.0,811.0
0.014,6,10,1989,5,910,3.0,642.0,642.0,5,1079,3.0,811.0,811.0
0.003,17,2,148,1,60,0.0,32.0,32.0,1,88,0.0,60.0,60.0
0.005,6,10,2007,5,928,1.0,660.0,660.0,5,1079,1.0,811.0,811.0
65.943,6,22,8550,12,2328,5994.0,1002.0,424.0,10,6222,7308.0,2241.0,949.0
0.039,17,4,284,2,120,0.0,32.0,32.0,2,164,35.0,60.0,54.0
0.077,6,10,1506,5,395,15.0,127.0,127.0,5,1111,17.0,843.0,843.0
0.004,17,2,136,1,60,0.0,32.0,32.0,1,76,0.0,48.0,48.0
11.223,17,28,4421,14,1994,851.0,269.0,114.0,14,2427,850.0,586.0,145.0
0.073,17,2,152,1,76,0.0,48.0,48.0,1,76,0.0,48.0,48.0
0.099,6,10,1506,5,395,22.0,127.0,127.0,5,1111,23.0,843.0,843.0
0.005,17,2,222,1,65,0.0,37.0,37.0,1,157,0.0,129.0,129.0
0.013,6,10,1990,5,911,3.0,643.0,643.0,5,1079,3.0,811.0,811.0
0.003,17,2,148,1,60,0.0,32.0,32.0,1,88,0.0,60.0,60.0
0.087,6,10,1506,5,395,19.0,127.0,127.0,5,1111,19.0,843.0,843.0
0.005,6,10,1854,5,889,1.0,621.0,621.0,5,965,1.0,697.0,697.0
0.013,6,10,1989,5,910,3.0,642.0,642.0,5,1079,3.0,811.0,811.0
0.006,17,2,179,1,71,0.0,43.0,43.0,1,108,0.0,80.0,80.0
0.102,6,10,1506,5,395,23.0,127.0,127.0,5,1111,24.0,843.0,843.0
0.017,6,10,1983,5,910,4.0,642.0,642.0,5,1073,4.0,805.0,805.0
0.076,6,10,1506,5,395,17.0,127.0,127.0,5,1111,17.0,843.0,843.0
40.059,17,10,676,5,460,10011.0,104.0,64.0,5,216,10013.0,20.0,15.0
0.005,6,10,1989,5,927,1.0,659.0,659.0,5,1062,1.0,794.0,794.0
0.005,6,10,2000,5,927,1.0,659.0,659.0,5,1073,1.0,805.0,805.0
0.005,6,10,1689,5,839,1.0,571.0,571.0,5,850,1.0,582.0,582.0
15.071,17,15,9238,8,6902,2149.0,1350.0,834.0,7,2336,2506.0,1350.0,305.0
0.092,6,10,1506,5,395,20.0,127.0,127.0,5,1111,21.0,843.0,843.0
0.011,6,10,1990,5,911,2.0,643.0,643.0,5,1079,2.0,811.0,811.0
0.001,17,2,179,1,62,0.0,34.0,34.0,1,117,0.0,89.0,89.0
11.245,17,28,4421,14,1993,852.0,268.0,114.0,14,2428,852.0,587.0,145.0
0.005,6,10,2007,5,928,1.0,660.0,660.0,5,1079,1.0,811.0,811.0
351.989,6,20,2210,6,1308,12003.0,494.0,494.0,14,902,27075.0,83.0,83.0
110.181,6,22,7437,11,1305,124.0,530.0,277.0,11,6132,11002.0,2720.0,946.0
0.009,6,10,1989,5,910,2.0,642.0,642.0,5,1079,2.0,811.0,811.0
0.005,17,2,144,1,64,0.0,36.0,36.0,1,80,0.0,52.0,52.0
0.018,6,10,1972,5,910,4.0,642.0,642.0,5,1062,4.0,794.0,794.0
0.011,6,10,1631,5,848,2.0,580.0,580.0,5,783,2.0,515.0,515.0
1778.367,17,144,45504,72,22752,25047.0,288.0,288.0,72,22752,25047.0,288.0,288.0
0.067,6,10,1506,5,395,15.0,127.0,127.0,5,1111,14.0,843.0,843.0
0.053,17,2,152,1,76,0.0,48.0,48.0,1,76,0.0,48.0,48.0
0.14,17,2,182,1,65,0.0,37.0,37.0,1,117,0.0,89.0,89.0
0.005,6,10,1989,5,927,1.0,659.0,659.0,5,1062,1.0,794.0,794.0
0.004,17,2,136,1,60,0.0,32.0,32.0,1,76,0.0,48.0,48.0
0.02,6,10,1990,5,911,4.0,643.0,643.0,5,1079,4.0,811.0,811.0
1786.204,6,150,19350,90,13740,20069.0,302.0,302.0,60,5610,30274.0,83.0,83.0
1778.083,17,143,41496,72,22752,25043.0,288.0,288.0,71,18744,25401.0,236.0,236.0
0.008,6,10,1972,5,910,2.0,642.0,642.0,5,1062,2.0,794.0,794.0
0.004,6,10,1702,5,863,1.0,595.0,595.0,5,839,0.0,571.0,571.0
0.186,6,10,1506,5,395,42.0,127.0,127.0,5,1111,45.0,843.0,843.0
240.087,6,16,4481,9,963,30010.0,238.0,166.0,7,3518,40014.0,1402.0,786.0
40.055,17,10,676,5,460,10012.0,104.0,64.0,5,216,10012.0,20.0,15.0
0.008,6,10,1983,5,910,2.0,642.0,642.0,5,1073,2.0,805.0,805.0
0.005,6,10,2006,5,927,1.0,659.0,659.0,5,1079,1.0,811.0,811.0
40.078,17,10,676,5,460,10014.0,104.0,64.0,5,216,10018.0,20.0,15.0
0.004,6,10,1989,5,927,1.0,659.0,659.0,5,1062,1.0,794.0,794.0
0.014,6,10,1972,5,910,3.0,642.0,642.0,5,1062,3.0,794.0,794.0
0.07,17,8,3613,4,1874,23.0,1350.0,440.0,4,1739,12.0,1350.0,406.0
0.113,6,10,1506,5,395,24.0,127.0,127.0,5,1111,26.0,843.0,843.0
0.014,6,10,1631,5,848,3.0,580.0,580.0,5,783,3.0,515.0,515.0
0.006,17,2,214,1,75,0.0,47.0,47.0,1,139,0.0,111.0,111.0
0.005,6,10,1989,5,927,1.0,659.0,659.0,5,1062,1.0,794.0,794.0
0.036,6,10,1983,5,910,8.0,642.0,642.0,5,1073,9.0,805.0,805.0
0.006,6,10,1547,5,764,1.0,496.0,496.0,5,783,1.0,515.0,515.0
0.014,6,10,1972,5,910,3.0,642.0,642.0,5,1062,3.0,794.0,794.0
0.005,6,10,2007,5,928,1.0,660.0,660.0,5,1079,1.0,811.0,811.0
0.006,6,10,1689,5,839,1.0,571.0,571.0,5,850,1.0,582.0,582.0
10.851,17,28,4421,14,1994,826.0,269.0,114.0,14,2427,826.0,586.0,145.0
0.138,17,4,284,2,120,11.0,32.0,32.0,2,164,135.0,60.0,54.0
0.005,6,10,2007,5,928,1.0,660.0,660.0,5,1079,1.0,811.0,811.0
0.209,6,16,2777,8,1395,29.0,533.0,323.0,8,1382,19.0,529.0,239.0
0.012,6,10,1989,5,910,3.0,642.0,642.0,5,1079,3.0,811.0,811.0
0.003,17,2,148,1,60,0.0,32.0,32.0,1,88,0.0,60.0,60.0
11.427,17,28,4390,14,2312,866.0,587.0,137.0,14,2078,866.0,269.0,120.0
0.183,17,4,352,2,130,143.0,37.0,37.0,2,222,146.0,89.0,83.0
0.005,6,10,2007,5,928,1.0,660.0,660.0,5,1079,1.0,811.0,811.0
241.711,6,394,348285,192,21516,1265.0,2736.0,960.0,202,326769,1202.0,2804.0,1647.0
1769.239,17,92,8096,46,4048,39316.0,60.0,60.0,46,4048,39316.0,60.0,60.0
0.006,6,10,1547,5,764,1.0,496.0,496.0,5,783,1.0,515.0,515.0
0.006,6,10,1689,5,839,1.0,571.0,571.0,5,850,1.0,582.0,582.0
0.005,6,10,1989,5,927,1.0,659.0,659.0,5,1062,1.0,794.0,794.0
0.005,6,13,3747,7,509,0.0,137.0,137.0,6,3238,0.0,1470.0,1459.0
0.02,6,10,1631,5,848,5.0,580.0,580.0,5,783,5.0,515.0,515.0
0.017,6,10,1989,5,910,4.0,642.0,642.0,5,1079,4.0,811.0,811.0
0.089,6,10,1506,5,395,20.0,127.0,127.0,5,1111,19.0,843.0,843.0
0.069,6,10,1506,5,395,15.0,127.0,127.0,5,1111,16.0,843.0,843.0
0.096,6,10,1506,5,395,21.0,127.0,127.0,5,1111,21.0,843.0,843.0
40.069,17,10,676,5,460,10014.0,104.0,64.0,5,216,10016.0,20.0,15.0
0.007,6,10,2007,5,928,1.0,660.0,660.0,5,1079,1.0,811.0,811.0
0.006,17,2,214,1,75,0.0,47.0,47.0,1,139,0.0,111.0,111.0
0.07,6,10,1506,5,395,17.0,127.0,127.0,5,1111,15.0,843.0,843.0
0.012,6,10,1972,5,910,3.0,642.0,642.0,5,1062,3.0,794.0,794.0
0.001,17,2,174,1,72,0.0,44.0,44.0,1,102,0.0,74.0,74.0
0.005,6,10,2000,5,927,1.0,659.0,659.0,5,1073,1.0,805.0,805.0
1773.012,6,314,98976,191,87259,9331.0,2001.0,678.0,123,11717,14532.0,452.0,70.0
308.329,17,20,1124,10,716,34244.0,48.0,43.0,10,408,34244.0,20.0,12.0
0.013,6,10,1990,5,911,3.0,643.0,643.0,5,1079,3.0,811.0,811.0
0.013,6,6,716,3,458,5.0,302.0,302.0,3,258,5.0,102.0,102.0
0.004,6,10,2007,5,928,1.0,660.0,660.0,5,1079,1.0,811.0,811.0
0.193,17,4,596,2,122,151.0,33.0,33.0,2,474,153.0,323.0,209.0
0.025,6,10,1983,5,910,6.0,642.0,642.0,5,1073,6.0,805.0,805.0
0.006,6,10,1547,5,764,1.0,496.0,496.0,5,783,1.0,515.0,515.0
0.09,6,10,1506,5,395,19.0,127.0,127.0,5,1111,18.0,843.0,843.0
308.485,17,20,1124,10,716,34269.0,48.0,43.0,10,408,34269.0,20.0,12.0
0.081,6,10,1506,5,395,19.0,127.0,127.0,5,1111,18.0,843.0,843.0
0.071,17,2,148,1,60,0.0,32.0,32.0,1,88,0.0,60.0,60.0
0.109,6,10,1506,5,395,23.0,127.0,127.0,5,1111,22.0,843.0,843.0
0.078,6,10,1506,5,395,17.0,127.0,127.0,5,1111,15.0,843.0,843.0
0.01,6,10,1983,5,910,2.0,642.0,642.0,5,1073,2.0,805.0,805.0
0.116,6,10,1506,5,395,27.0,127.0,127.0,5,1111,17.0,843.0,843.0
0.004,17,2,144,1,64,0.0,36.0,36.0,1,80,0.0,52.0,52.0
0.082,6,10,1506,5,395,18.0,127.0,127.0,5,1111,18.0,843.0,843.0
0.125,6,10,1506,5,395,26.0,127.0,127.0,5,1111,30.0,843.0,843.0
0.011,6,10,1989,5,910,2.0,642.0,642.0,5,1079,2.0,811.0,811.0
0.005,17,2,169,1,62,0.0,34.0,34.0,1,107,0.0,79.0,79.0
0.012,6,10,1983,5,910,3.0,642.0,642.0,5,1073,2.0,805.0,805.0
0.001,17,2,180,1,66,0.0,38.0,38.0,1,114,0.0,86.0,86.0
0.004,17,2,166,1,75,0.0,47.0,47.0,1,91,0.0,63.0,63.0
0.008,6,10,1990,5,911,2.0,643.0,643.0,5,1079,2.0,811.0,811.0
0.005,6,10,1989,5,927,1.0,659.0,659.0,5,1062,1.0,794.0,794.0
335.648,17,20,1124,10,716,37282.0,48.0,43.0,10,408,37286.0,20.0,12.0
0.006,17,2,170,1,65,0.0,37.0,37.0,1,105,0.0,77.0,77.0
0.006,6,10,1643,5,860,1.0,592.0,592.0,5,783,1.0,515.0,515.0
292.32,6,375,346482,191,21496,1538.0,2736.0,888.0,184,324986,1597.0,2804.0,1855.0
0.001,17,2,180,1,66,0.0,38.0,38.0,1,114,0.0,86.0,86.0
1756.067,6,105,6270,60,3525,29763.0,27.0,27.0,45,2745,39909.0,27.0,27.0
0.006,6,10,1547,5,764,1.0,496.0,496.0,5,783,1.0,515.0,515.0
300.316,6,16,2170,9,684,37519.0,146.0,146.0,7,1486,50025.0,419.0,398.0
15.18,17,21,10886,12,8782,1379.0,1350.0,703.0,9,2104,1894.0,1350.0,205.0
0.008,6,10,1762,5,911,2.0,643.0,643.0,5,851,2.0,583.0,583.0
0.005,6,10,2007,5,928,1.0,660.0,660.0,5,1079,1.0,811.0,811.0
0.119,6,10,1506,5,395,28.0,127.0,127.0,5,1111,26.0,843.0,843.0
0.004,17,4,284,2,120,0.0,32.0,32.0,2,164,0.0,60.0,54.0
0.012,6,10,1972,5,910,3.0,642.0,642.0,5,1062,3.0,794.0,794.0
0.006,6,10,1689,5,839,1.0,571.0,571.0,5,850,1.0,582.0,582.0
0.009,6,10,1972,5,910,2.0,642.0,642.0,5,1062,2.0,794.0,794.0
0.005,6,10,2006,5,927,1.0,659.0,659.0,5,1079,1.0,811.0,811.0
15.072,17,15,9238,8,6902,2149.0,1350.0,834.0,7,2336,2507.0,1350.0,305.0
1.075,6,19,6138,11,1189,107.0,517.0,201.0,8,4949,152.0,1402.0,905.0
0.005,6,10,1989,5,927,1.0,659.0,659.0,5,1062,1.0,794.0,794.0
0.006,6,10,1547,5,764,1.0,496.0,496.0,5,783,1.0,515.0,515.0
0.014,6,10,1983,5,910,3.0,642.0,642.0,5,1073,3.0,805.0,805.0
0.007,6,10,1689,5,839,1.0,571.0,571.0,5,850,1.0,582.0,582.0
8.926,6,39,10499,20,4941,469.0,1360.0,682.0,19,5558,484.0,2667.0,435.0
40.083,17,10,676,5,460,10019.0,104.0,64.0,5,216,10020.0,20.0,15.0
0.002,17,2,166,1,75,0.0,47.0,47.0,1,91,0.0,63.0,63.0
0.005,17,2,180,1,58,0.0,30.0,30.0,1,122,0.0,94.0,94.0
0.005,6,10,1989,5,927,1.0,659.0,659.0,5,1062,1.0,794.0,794.0
0.01,6,10,1762,5,911,2.0,643.0,643.0,5,851,2.0,583.0,583.0
40.074,17,10,676,5,460,10014.0,104.0,64.0,5,216,10017.0,20.0,15.0
0.013,6,10,1989,5,910,3.0,642.0,642.0,5,1079,3.0,811.0,811.0
0.006,6,10,1547,5,764,1.0,496.0,496.0,5,783,1.0,515.0,515.0
0.011,6,10,1631,5,848,2.0,580.0,580.0,5,783,2.0,515.0,515.0
0.02,6,10,1983,5,910,4.0,642.0,642.0,5,1073,4.0,805.0,805.0
0.001,17,2,154,1,69,0.0,41.0,41.0,1,85,0.0,57.0,57.0
0.016,6,10,1990,5,911,4.0,643.0,643.0,5,1079,4.0,811.0,811.0
0.007,6,10,1547,5,764,1.0,496.0,496.0,5,783,1.0,515.0,515.0
0.041,17,2,146,1,65,0.0,37.0,37.0,1,81,0.0,53.0,53.0
0.065,17,2,152,1,76,0.0,48.0,48.0,1,76,0.0,48.0,48.0
0.006,6,10,1547,5,764,1.0,496.0,496.0,5,783,1.0,515.0,515.0
438.404,6,27,4305,12,3102,10911.0,494.0,494.0,15,1203,31314.0,83.0,83.0
15.071,17,15,9239,8,6902,2149.0,1350.0,834.0,7,2337,2507.0,1350.0,305.0
0.005,6,10,1702,5,863,1.0,595.0,595.0,5,839,1.0,571.0,571.0
0.011,6,10,1989,5,910,2.0,642.0,642.0,5,1079,2.0,811.0,811.0
40.094,17,10,676,5,460,10022.0,104.0,64.0,5,216,10022.0,20.0,15.0
0.023,17,2,136,1,60,0.0,32.0,32.0,1,76,0.0,48.0,48.0
0.005,6,10,2006,5,927,1.0,659.0,659.0,5,1079,1.0,811.0,811.0
0.006,6,10,1643,5,860,1.0,592.0,592.0,5,783,1.0,515.0,515.0
0.004,17,2,179,1,71,0.0,43.0,43.0,1,108,0.0,80.0,80.0
0.087,6,10,1506,5,395,19.0,127.0,127.0,5,1111,19.0,843.0,843.0
0.005,17,2,148,1,60,0.0,32.0,32.0,1,88,0.0,60.0,60.0
11.426,17,29,4565,15,2165,804.0,268.0,116.0,14,2400,866.0,587.0,143.0
0.005,6,10,2007,5,928,1.0,660.0,660.0,5,1079,1.0,811.0,811.0
0.091,6,10,1506,5,395,19.0,127.0,127.0,5,1111,20.0,843.0,843.0
40.091,17,10,676,5,460,10021.0,104.0,64.0,5,216,10021.0,20.0,15.0
11.114,17,28,4422,14,1994,842.0,269.0,114.0,14,2428,842.0,587.0,145.0
175.136,17,84,11868,42,2819,4271.0,44.0,39.0,42,9049,4271.0,239.0,187.0
0.006,6,10,2000,5,927,1.0,659.0,659.0,5,1073,1.0,805.0,805.0
11.011,17,28,4394,14,2312,838.0,587.0,137.0,14,2082,838.0,269.0,120.0
0.021,6,10,1972,5,910,5.0,642.0,642.0,5,1062,5.0,794.0,794.0
240.094,6,31,9227,15,6649,17149.0,1775.0,652.0,16,2578,16006.0,580.0,217.0
0.005,6,14,3799,7,509,0.0,137.0,137.0,7,3290,0.0,1448.0,972.0
0.006,17,2,230,1,68,0.0,40.0,40.0,1,162,0.0,134.0,134.0
10.713,17,28,4422,14,1995,816.0,270.0,114.0,14,2427,816.0,586.0,145.0
0.009,6,10,1631,5,848,2.0,580.0,580.0,5,783,2.0,515.0,515.0
0.005,6,10,1989,5,927,1.0,659.0,659.0,5,1062,1.0,794.0,794.0
0.005,17,2,214,1,75,0.0,47.0,47.0,1,139,0.0,111.0,111.0
11.177,17,28,4418,14,1994,847.0,269.0,114.0,14,2424,846.0,587.0,145.0
0.003,17,2,148,1,60,0.0,32.0,32.0,1,88,0.0,60.0,60.0
0.111,6,10,1506,5,395,26.0,127.0,127.0,5,1111,25.0,843.0,843.0
40.079,17,10,676,5,460,10018.0,104.0,64.0,5,216,10018.0,20.0,15.0
0.014,6,10,1983,5,910,3.0,642.0,642.0,5,1073,3.0,805.0,805.0
0.001,17,2,180,1,66,0.0,38.0,38.0,1,114,0.0,86.0,86.0
0.019,6,10,1983,5,910,4.0,642.0,642.0,5,1073,4.0,805.0,805.0
0.006,6,10,2006,5,927,1.0,659.0,659.0,5,1079,1.0,811.0,811.0
40.076,17,10,676,5,460,10015.0,104.0,64.0,5,216,10018.0,20.0,15.0
0.019,6,10,1677,5,827,4.0,559.0,559.0,5,850,4.0,582.0,582.0
0.08,6,10,1506,5,395,16.0,127.0,127.0,5,1111,18.0,843.0,843.0
0.009,6,10,1989,5,910,2.0,642.0,642.0,5,1079,2.0,811.0,811.0
0.006,6,10,1547,5,764,1.0,496.0,496.0,5,783,1.0,515.0,515.0
15.099,17,15,8481,8,6339,2153.0,1350.0,764.0,7,2142,2511.0,1350.0,278.0
0.086,6,10,1506,5,395,19.0,127.0,127.0,5,1111,19.0,843.0,843.0
0.005,6,10,1989,5,927,1.0,659.0,659.0,5,1062,1.0,794.0,794.0
0.009,17,2,148,1,60,0.0,32.0,32.0,1,88,0.0,60.0,60.0
0.004,17,4,284,2,120,1.0,32.0,32.0,2,164,0.0,60.0,54.0
0.091,6,10,1506,5,395,16.0,127.0,127.0,5,1111,18.0,843.0,843.0
0.013,6,10,1972,5,910,3.0,642.0,642.0,5,1062,3.0,794.0,794.0
0.004,6,10,1702,5,863,1.0,595.0,595.0,5,839,0.0,571.0,571.0
0.003,17,2,136,1,60,0.0,32.0,32.0,1,76,0.0,48.0,48.0
40.054,17,10,676,5,460,10012.0,104.0,64.0,5,216,10012.0,20.0,15.0
0.005,6,10,2000,5,927,1.0,659.0,659.0,5,1073,1.0,805.0,805.0
0.126,6,10,1506,5,395,30.0,127.0,127.0,5,1111,27.0,843.0,843.0
0.011,6,10,1677,5,827,2.0,559.0,559.0,5,850,2.0,582.0,582.0
143.737,6,35,9664,18,4186,8455.0,3113.0,1144.0,17,5478,537.0,2667.0,435.0
291.606,6,381,347576,195,21709,1503.0,2736.0,889.0,186,325867,1576.0,2804.0,1838.0
0.005,6,14,3742,7,452,0.0,80.0,80.0,7,3290,0.0,1448.0,972.0
40.072,17,10,676,5,460,10014.0,104.0,64.0,5,216,10017.0,20.0,15.0
15.116,17,16,8974,8,6708,2155.0,1350.0,810.0,8,2266,2153.0,1350.0,255.0
0.006,6,10,2006,5,927,1.0,659.0,659.0,5,1079,1.0,811.0,811.0
0.013,6,10,1989,5,910,3.0,642.0,642.0,5,1079,3.0,811.0,811.0
0.004,17,2,136,1,60,0.0,32.0,32.0,1,76,0.0,48.0,48.0
0.022,6,10,1677,5,827,5.0,559.0,559.0,5,850,5.0,582.0,582.0
0.004,17,4,284,2,120,0.0,32.0,32.0,2,164,0.0,60.0,54.0
0.039,17,2,136,1,60,0.0,32.0,32.0,1,76,0.0,48.0,48.0
0.013,17,2,168,1,76,0.0,48.0,48.0,1,92,0.0,64.0,64.0
0.088,6,10,1506,5,395,18.0,127.0,127.0,5,1111,19.0,843.0,843.0
0.229,6,16,2777,8,1395,32.0,533.0,323.0,8,1382,21.0,529.0,239.0
0.048,6,10,1506,5,395,10.0,127.0,127.0,5,1111,11.0,843.0,843.0
0.015,6,10,1972,5,910,3.0,642.0,642.0,5,1062,3.0,794.0,794.0
0.016,6,13,3735,7,497,2.0,125.0,125.0,6,3238,3.0,1470.0,1459.0
0.007,6,10,1689,5,839,1.0,571.0,571.0,5,850,1.0,582.0,582.0
0.006,17,2,179,1,71,0.0,43.0,43.0,1,108,0.0,80.0,80.0
0.009,6,12,1926,6,1189,1.0,659.0,434.0,6,737,1.0,417.0,417.0
0.008,6,10,1989,5,910,2.0,642.0,642.0,5,1079,2.0,811.0,811.0
0.008,6,10,1762,5,911,2.0,643.0,643.0,5,851,2.0,583.0,583.0
0.01,6,10,1972,5,910,2.0,642.0,642.0,5,1062,2.0,794.0,794.0
0.101,6,10,1989,5,910,25.0,642.0,642.0,5,1079,25.0,811.0,811.0
40.06,17,10,676,5,460,10014.0,104.0,64.0,5,216,10014.0,20.0,15.0
0.001,17,2,180,1,66,0.0,38.0,38.0,1,114,0.0,86.0,86.0
0.006,17,2,168,1,76,0.0,48.0,48.0,1,92,0.0,64.0,64.0
313.488,17,15,888,8,608,44768.0,48.0,48.0,7,280,52229.0,12.0,12.0
0.006,6,12,1698,6,863,1.0,327.0,271.0,6,835,1.0,515.0,515.0
40.056,17,10,676,5,460,10012.0,104.0,64.0,5,216,10013.0,20.0,15.0
0.106,6,10,1506,5,395,25.0,127.0,127.0,5,1111,24.0,843.0,843.0
0.011,6,10,1989,5,910,2.0,642.0,642.0,5,1079,2.0,811.0,811.0
0.02,6,10,1972,5,910,4.0,642.0,642.0,5,1062,4.0,794.0,794.0
240.202,6,37,5250,18,2324,14129.0,588.0,197.0,19,2926,13343.0,598.0,275.0
0.011,6,10,1677,5,827,2.0,559.0,559.0,5,850,2.0,582.0,582.0
0.069,17,8,3613,4,1874,23.0,1350.0,440.0,4,1739,12.0,1350.0,406.0
0.005,6,10,2007,5,928,1.0,660.0,660.0,5,1079,1.0,811.0,811.0
10.861,17,28,4418,14,1994,826.0,269.0,114.0,14,2424,826.0,587.0,145.0
0.014,6,10,1989,5,910,3.0,642.0,642.0,5,1079,3.0,811.0,811.0
0.009,6,12,1926,6,1189,1.0,659.0,434.0,6,737,1.0,417.0,417.0
0.101,6,10,1506,5,395,21.0,127.0,127.0,5,1111,20.0,843.0,843.0
0.019,6,10,1989,5,910,4.0,642.0,642.0,5,1079,4.0,811.0,811.0
0.005,6,10,1854,5,889,1.0,621.0,621.0,5,965,1.0,697.0,697.0
0.005,17,2,214,1,75,0.0,47.0,47.0,1,139,0.0,111.0,111.0
0.083,6,10,1506,5,395,18.0,127.0,127.0,5,1111,19.0,843.0,843.0
0.01,17,2,136,1,60,0.0,32.0,32.0,1,76,0.0,48.0,48.0
0.113,6,10,1506,5,395,25.0,127.0,127.0,5,1111,25.0,843.0,843.0
0.009,6,10,1972,5,910,2.0,642.0,642.0,5,1062,2.0,794.0,794.0
0.004,6,10,2007,5,928,1.0,660.0,660.0,5,1079,1.0,811.0,811.0
0.111,17,2,194,1,59,0.0,31.0,31.0,1,135,0.0,107.0,107.0
0.009,6,10,1983,5,910,2.0,642.0,642.0,5,1073,2.0,805.0,805.0
0.011,6,10,1631,5,848,2.0,580.0,580.0,5,783,2.0,515.0,515.0
300.352,6,16,2170,9,684,37523.0,146.0,146.0,7,1486,50031.0,419.0,398.0
0.005,17,2,179,1,71,0.0,43.0,43.0,1,108,0.0,80.0,80.0
0.006,6,10,1854,5,889,1.0,621.0,621.0,5,965,1.0,697.0,697.0
0.005,6,10,1989,5,927,1.0,659.0,659.0,5,1062,1.0,794.0,794.0
0.089,6,10,1506,5,395,20.0,127.0,127.0,5,1111,21.0,843.0,843.0
0.101,6,10,1506,5,395,21.0,127.0,127.0,5,1111,22.0,843.0,843.0
0.006,6,10,1547,5,764,1.0,496.0,496.0,5,783,1.0,515.0,515.0
0.595,6,26,8926,14,1587,37.0,517.0,211.0,12,7339,44.0,1288.0,839.0
10.766,17,28,4421,14,1993,819.0,268.0,114.0,14,2428,819.0,587.0,145.0
0.062,6,10,1506,5,395,13.0,127.0,127.0,5,1111,14.0,843.0,843.0
0.004,6,10,1774,5,923,1.0,655.0,655.0,5,851,1.0,583.0,583.0
40.049,17,10,676,5,460,10011.0,104.0,64.0,5,216,10011.0,20.0,15.0
0.008,17,2,299,1,65,0.0,37.0,37.0,1,234,0.0,206.0,206.0
0.091,6,10,1506,5,395,20.0,127.0,127.0,5,1111,20.0,843.0,843.0
0.005,6,10,1989,5,927,1.0,659.0,659.0,5,1062,1.0,794.0,794.0
0.007,6,10,1989,5,910,1.0,642.0,642.0,5,1079,1.0,811.0,811.0
0.004,6,10,1989,5,927,1.0,659.0,659.0,5,1062,1.0,794.0,794.0
0.015,6,10,1762,5,911,3.0,643.0,643.0,5,851,3.0,583.0,583.0
0.012,6,14,3965,7,495,2.0,123.0,123.0,7,3470,1.0,1448.0,1032.0
0.087,6,10,1506,5,395,19.0,127.0,127.0,5,1111,19.0,843.0,843.0
0.005,6,10,2000,5,927,1.0,659.0,659.0,5,1073,1.0,805.0,805.0
0.004,17,2,136,1,60,0.0,32.0,32.0,1,76,0.0,48.0,48.0
0.008,6,12,1926,6,1189,1.0,659.0,434.0,6,737,1.0,417.0,417.0
0.005,6,10,1779,5,928,1.0,660.0,660.0,5,851,1.0,583.0,583.0
0.006,6,10,1547,5,764,1.0,496.0,496.0,5,783,1.0,515.0,515.0
10.875,17,28,4396,14,1995,828.0,270.0,114.0,14,2401,828.0,588.0,143.0
0.004,6,10,1702,5,863,0.0,595.0,595.0,5,839,1.0,571.0,571.0
0.016,6,10,1989,5,910,4.0,642.0,642.0,5,1079,3.0,811.0,811.0
0.009,6,10,1989,5,910,2.0,642.0,642.0,5,1079,2.0,811.0,811.0
0.012,6,12,1926,6,1189,2.0,659.0,434.0,6,737,2.0,417.0,417.0
66.01,6,23,10192,12,3973,6000.0,1579.0,835.0,11,6219,6584.0,1402.0,805.0
0.005,6,10,1689,5,839,1.0,571.0,571.0,5,850,1.0,582.0,582.0
0.027,6,10,1990,5,911,6.0,643.0,643.0,5,1079,6.0,811.0,811.0
0.006,6,10,1854,5,889,1.0,621.0,621.0,5,965,1.0,697.0,697.0
0.005,6,10,1643,5,860,1.0,592.0,592.0,5,783,1.0,515.0,515.0
0.013,6,10,1989,5,910,3.0,642.0,642.0,5,1079,3.0,811.0,811.0
240.115,6,30,9516,15,7072,17151.0,2196.0,699.0,15,2444,17150.0,580.0,207.0
0.014,6,10,1677,5,827,3.0,559.0,559.0,5,850,3.0,582.0,582.0
0.114,6,10,1506,5,395,20.0,127.0,127.0,5,1111,23.0,843.0,843.0
0.014,6,10,1677,5,827,3.0,559.0,559.0,5,850,3.0,582.0,582.0
0.087,6,10,1506,5,395,20.0,127.0,127.0,5,1111,19.0,843.0,843.0
0.004,6,10,1702,5,863,1.0,595.0,595.0,5,839,0.0,571.0,571.0
0.004,6,10,2006,5,927,1.0,659.0,659.0,5,1079,1.0,811.0,811.0
0.017,6,10,1631,5,848,4.0,580.0,580.0,5,783,4.0,515.0,515.0
0.022,6,10,1989,5,910,5.0,642.0,642.0,5,1079,5.0,811.0,811.0
0.005,6,10,1774,5,923,1.0,655.0,655.0,5,851,1.0,583.0,583.0
0.005,6,10,2006,5,927,1.0,659.0,659.0,5,1079,1.0,811.0,811.0
0.039,17,2,136,1,60,0.0,32.0,32.0,1,76,0.0,48.0,48.0
0.005,6,10,2000,5,927,1.0,659.0,659.0,5,1073,1.0,805.0,805.0
0.069,6,10,1506,5,395,14.0,127.0,127.0,5,1111,14.0,843.0,843.0
0.009,6,10,1990,5,911,2.0,643.0,643.0,5,1079,2.0,811.0,811.0
0.004,6,10,2007,5,928,1.0,660.0,660.0,5,1079,1.0,811.0,811.0
0.01,6,10,1972,5,910,2.0,642.0,642.0,5,1062,2.0,794.0,794.0
0.005,6,10,2007,5,928,1.0,660.0,660.0,5,1079,1.0,811.0,811.0
0.015,6,10,1983,5,910,3.0,642.0,642.0,5,1073,3.0,805.0,805.0
15.223,17,19,10222,10,7963,1688.0,1350.0,768.0,9,2259,1899.0,1350.0,223.0
0.006,6,10,1547,5,764,1.0,496.0,496.0,5,783,1.0,515.0,515.0
40.063,17,10,676,5,460,10012.0,104.0,64.0,5,216,10015.0,20.0,15.0
0.001,17,2,180,1,66,0.0,38.0,38.0,1,114,0.0,86.0,86.0
0.005,6,10,2006,5,927,1.0,659.0,659.0,5,1079,1.0,811.0,811.0
0.013,6,10,1972,5,910,3.0,642.0,642.0,5,1062,3.0,794.0,794.0
0.005,6,10,2007,5,928,1.0,660.0,660.0,5,1079,1.0,811.0,811.0
10.775,17,28,4422,14,1995,820.0,270.0,114.0,14,2427,820.0,586.0,145.0
0.006,6,10,1547,5,764,1.0,496.0,496.0,5,783,1.0,515.0,515.0
0.015,6,13,3735,7,497,2.0,125.0,125.0,6,3238,3.0,1470.0,1459.0
8.96,6,39,12946,21,7428,448.0,1360.0,936.0,18,5518,514.0,2667.0,435.0
15.07,17,15,9238,8,6902,2148.0,1350.0,834.0,7,2336,2506.0,1350.0,305.0
0.086,6,10,1506,5,395,18.0,127.0,127.0,5,1111,18.0,843.0,843.0
0.014,6,10,1990,5,911,3.0,643.0,643.0,5,1079,3.0,811.0,811.0
0.061,6,10,1506,5,395,14.0,127.0,127.0,5,1111,13.0,843.0,843.0
0.009,6,10,1972,5,910,2.0,642.0,642.0,5,1062,2.0,794.0,794.0
0.008,6,10,1989,5,910,2.0,642.0,642.0,5,1079,1.0,811.0,811.0
0.105,6,10,1506,5,395,22.0,127.0,127.0,5,1111,22.0,843.0,843.0
0.005,6,10,2006,5,927,1.0,659.0,659.0,5,1079,1.0,811.0,811.0
0.001,17,2,180,1,66,0.0,38.0,38.0,1,114,0.0,86.0,86.0
0.073,6,10,1506,5,395,14.0,127.0,127.0,5,1111,15.0,843.0,843.0
0.005,6,10,2007,5,928,1.0,660.0,660.0,5,1079,1.0,811.0,811.0
0.005,6,10,2006,5,927,1.0,659.0,659.0,5,1079,1.0,811.0,811.0
0.218,17,4,352,2,130,147.0,37.0,37.0,2,222,179.0,89.0,83.0
0.005,17,2,170,1,65,0.0,37.0,37.0,1,105,0.0,77.0,77.0
0.004,6,10,2007,5,928,1.0,660.0,660.0,5,1079,1.0,811.0,811.0
0.01,6,10,1990,5,911,2.0,643.0,643.0,5,1079,2.0,811.0,811.0
0.001,17,2,180,1,66,0.0,38.0,38.0,1,114,0.0,86.0,86.0
0.006,6,10,1547,5,764,1.0,496.0,496.0,5,783,1.0,515.0,515.0
0.007,17,2,230,1,68,0.0,40.0,40.0,1,162,0.0,134.0,134.0
0.096,6,10,1506,5,395,21.0,127.0,127.0,5,1111,21.0,843.0,843.0
0.005,6,10,2006,5,927,1.0,659.0,659.0,5,1079,1.0,811.0,811.0
0.136,6,10,1506,5,395,29.0,127.0,127.0,5,1111,33.0,843.0,843.0
0.006,6,10,1547,5,764,1.0,496.0,496.0,5,783,1.0,515.0,515.0
0.005,6,10,2000,5,927,1.0,659.0,659.0,5,1073,1.0,805.0,805.0
0.011,6,10,1547,5,764,2.0,496.0,496.0,5,783,2.0,515.0,515.0
0.007,6,10,1547,5,764,1.0,496.0,496.0,5,783,1.0,515.0,515.0
0.013,6,10,1989,5,910,3.0,642.0,642.0,5,1079,3.0,811.0,811.0
0.004,6,10,2000,5,927,1.0,659.0,659.0,5,1073,1.0,805.0,805.0
0.012,6,10,1762,5,911,3.0,643.0,643.0,5,851,2.0,583.0,583.0
0.041,17,2,152,1,76,0.0,48.0,48.0,1,76,0.0,48.0,48.0
0.007,6,10,1547,5,764,1.0,496.0,496.0,5,783,1.0,515.0,515.0
0.004,6,10,1989,5,927,1.0,659.0,659.0,5,1062,1.0,794.0,794.0
294.388,6,414,350324,233,25354,1268.0,2736.0,870.0,181,324970,1635.0,4060.0,1912.0
1792.088,6,535,185831,268,161596,6711.0,2883.0,997.0,267,24235,6737.0,335.0,108.0
0.012,6,10,1990,5,911,2.0,643.0,643.0,5,1079,2.0,811.0,811.0
0.005,6,10,1643,5,860,1.0,592.0,592.0,5,783,1.0,515.0,515.0
0.019,6,10,1677,5,827,4.0,559.0,559.0,5,850,4.0,582.0,582.0
0.006,6,10,1643,5,860,1.0,592.0,592.0,5,783,1.0,515.0,515.0
0.01,6,10,1989,5,910,2.0,642.0,642.0,5,1079,2.0,811.0,811.0
0.012,6,10,1990,5,911,2.0,643.0,643.0,5,1079,2.0,811.0,811.0
0.004,17,2,136,1,60,0.0,32.0,32.0,1,76,0.0,48.0,48.0
1730.389,6,45,2790,30,1725,59668.0,35.0,35.0,15,1065,123592.0,31.0,31.0
0.129,17,2,80,1,32,0.0,4.0,4.0,1,48,0.0,20.0,20.0
0.005,6,13,3747,7,509,0.0,137.0,137.0,6,3238,1.0,1470.0,1459.0
0.007,6,10,2000,5,927,1.0,659.0,659.0,5,1073,1.0,805.0,805.0
0.006,6,10,2006,5,927,1.0,659.0,659.0,5,1079,1.0,811.0,811.0
40.058,17,10,676,5,460,10013.0,104.0,64.0,5,216,10013.0,20.0,15.0
0.013,6,10,1990,5,911,3.0,643.0,643.0,5,1079,3.0,811.0,811.0
0.005,17,2,164,1,74,0.0,46.0,46.0,1,90,0.0,62.0,62.0
0.031,17,2,179,1,71,0.0,43.0,43.0,1,108,0.0,80.0,80.0
0.04,17,2,186,1,61,0.0,33.0,33.0,1,125,0.0,97.0,97.0
240.085,6,16,4481,9,963,30010.0,238.0,166.0,7,3518,40013.0,1402.0,786.0
0.006,6,10,1689,5,839,1.0,571.0,571.0,5,850,1.0,582.0,582.0
0.005,6,10,2007,5,928,1.0,660.0,660.0,5,1079,1.0,811.0,811.0
0.011,6,10,1989,5,910,2.0,642.0,642.0,5,1079,2.0,811.0,811.0
0.003,17,2,136,1,60,0.0,32.0,32.0,1,76,0.0,48.0,48.0
0.006,6,10,2006,5,927,1.0,659.0,659.0,5,1079,1.0,811.0,811.0
0.005,17,2,275,1,67,0.0,39.0,39.0,1,208,0.0,180.0,180.0
0.004,17,2,136,1,60,0.0,32.0,32.0,1,76,0.0,48.0,48.0
0.001,17,2,180,1,66,0.0,38.0,38.0,1,114,0.0,86.0,86.0
0.006,17,2,169,1,62,0.0,34.0,34.0,1,107,0.0,79.0,79.0
0.015,6,10,1983,5,910,3.0,642.0,642.0,5,1073,3.0,805.0,805.0
0.045,17,2,148,1,60,0.0,32.0,32.0,1,88,0.0,60.0,60.0
0.005,6,10,2006,5,927,1.0,659.0,659.0,5,1079,1.0,811.0,811.0
15.362,17,40,20162,22,17087,730.0,1350.0,748.0,18,3075,901.0,1350.0,142.0
0.106,6,10,1506,5,395,24.0,127.0,127.0,5,1111,24.0,843.0,843.0
0.01,6,10,1989,5,910,2.0,642.0,642.0,5,1079,2.0,811.0,811.0
0.011,6,10,1990,5,911,2.0,643.0,643.0,5,1079,2.0,811.0,811.0
0.004,17,2,234,1,61,0.0,33.0,33.0,1,173,0.0,145.0,145.0
0.012,6,10,1989,5,910,2.0,642.0,642.0,5,1079,3.0,811.0,811.0
0.037,17,2,136,1,60,0.0,32.0,32.0,1,76,0.0,48.0,48.0
40.063,17,10,676,5,460,10015.0,104.0,64.0,5,216,10015.0,20.0,15.0
0.004,6,10,1702,5,863,1.0,595.0,595.0,5,839,0.0,571.0,571.0
0.017,6,10,1989,5,910,4.0,642.0,642.0,5,1079,4.0,811.0,811.0
419.538,6,32,11332,17,3692,26220.0,1073.0,466.0,15,7640,29966.0,1402.0,858.0
0.086,6,10,1506,5,395,19.0,127.0,127.0,5,1111,18.0,843.0,843.0
0.011,6,10,1989,5,910,2.0,642.0,642.0,5,1079,2.0,811.0,811.0
0.076,6,28,10159,15,8942,5.0,2883.0,1166.0,13,1217,5.0,263.0,90.0
0.005,6,10,1689,5,839,1.0,571.0,571.0,5,850,1.0,582.0,582.0
0.038,17,2,152,1,76,0.0,48.0,48.0,1,76,0.0,48.0,48.0
0.005,6,10,2006,5,927,1.0,659.0,659.0,5,1079,1.0,811.0,811.0
0.005,6,10,2006,5,927,1.0,659.0,659.0,5,1079,1.0,811.0,811.0
40.06,17,10,676,5,460,10014.0,104.0,64.0,5,216,10014.0,20.0,15.0
0.006,6,13,3747,7,509,1.0,137.0,137.0,6,3238,1.0,1470.0,1459.0
176.337,17,88,12724,44,2960,4100.0,44.0,39.0,44,9764,4100.0,239.0,193.0
0.006,6,10,1854,5,889,1.0,621.0,621.0,5,965,1.0,697.0,697.0
353.015,6,20,2210,6,1308,12004.0,494.0,494.0,14,902,27154.0,83.0,83.0
0.012,6,10,1972,5,910,3.0,642.0,642.0,5,1062,2.0,794.0,794.0
0.009,6,10,1990,5,911,2.0,643.0,643.0,5,1079,2.0,811.0,811.0
0.005,6,10,2000,5,927,1.0,659.0,659.0,5,1073,1.0,805.0,805.0
40.05,17,10,676,5,460,10011.0,104.0,64.0,5,216,10011.0,20.0,15.0
0.089,6,10,1506,5,395,19.0,127.0,127.0,5,1111,21.0,843.0,843.0
0.004,6,10,1989,5,927,1.0,659.0,659.0,5,1062,1.0,794.0,794.0
352.848,6,20,2210,6,1308,12003.0,494.0,494.0,14,902,27141.0,83.0,83.0
0.014,6,10,1990,5,911,3.0,643.0,643.0,5,1079,3.0,811.0,811.0
0.016,6,10,1983,5,910,4.0,642.0,642.0,5,1073,3.0,805.0,805.0
0.005,6,10,2007,5,928,1.0,660.0,660.0,5,1079,1.0,811.0,811.0
0.009,17,2,148,1,60,0.0,32.0,32.0,1,88,0.0,60.0,60.0
0.038,17,2,182,1,65,0.0,37.0,37.0,1,117,0.0,89.0,89.0
0.01,6,10,1989,5,910,2.0,642.0,642.0,5,1079,2.0,811.0,811.0
0.005,6,10,2007,5,928,1.0,660.0,660.0,5,1079,1.0,811.0,811.0
0.005,6,10,2007,5,928,1.0,660.0,660.0,5,1079,1.0,811.0,811.0
0.009,6,10,1983,5,910,2.0,642.0,642.0,5,1073,2.0,805.0,805.0
0.004,6,10,1779,5,928,1.0,660.0,660.0,5,851,1.0,583.0,583.0
0.006,17,2,170,1,65,0.0,37.0,37.0,1,105,0.0,77.0,77.0
0.005,6,10,1643,5,860,1.0,592.0,592.0,5,783,1.0,515.0,515.0
0.08,6,10,1506,5,395,15.0,127.0,127.0,5,1111,18.0,843.0,843.0
15.071,17,15,9238,8,6902,2149.0,1350.0,834.0,7,2336,2506.0,1350.0,305.0
0.11,6,10,1506,5,395,23.0,127.0,127.0,5,1111,23.0,843.0,843.0
0.004,17,2,169,1,62,0.0,34.0,34.0,1,107,0.0,79.0,79.0
0.039,17,4,284,2,120,0.0,32.0,32.0,2,164,37.0,60.0,54.0
0.006,6,13,3690,7,452,1.0,80.0,80.0,6,3238,1.0,1470.0,1459.0
0.01,6,10,1989,5,910,2.0,642.0,642.0,5,1079,2.0,811.0,811.0
0.016,6,10,1972,5,910,3.0,642.0,642.0,5,1062,4.0,794.0,794.0
1.854,6,31,7848,17,2784,115.0,1477.0,515.0,14,5064,128.0,1385.0,499.0
23.426,6,13,1953,7,507,3904.0,195.0,195.0,6,1446,4642.0,419.0,398.0
0.099,6,10,1506,5,395,21.0,127.0,127.0,5,1111,22.0,843.0,843.0
1.089,6,31,13352,17,5853,68.0,2720.0,854.0,14,7499,69.0,2720.0,769.0
0.006,6,10,1547,5,764,1.0,496.0,496.0,5,783,1.0,515.0,515.0
0.006,6,10,1547,5,764,1.0,496.0,496.0,5,783,1.0,515.0,515.0
0.015,6,10,1989,5,910,3.0,642.0,642.0,5,1079,3.0,811.0,811.0
323.999,17,20,1124,10,716,35993.0,48.0,43.0,10,408,35993.0,20.0,12.0
0.01,6,10,1989,5,910,2.0,642.0,642.0,5,1079,2.0,811.0,811.0
0.004,6,10,2007,5,928,1.0,660.0,660.0,5,1079,1.0,811.0,811.0
0.005,17,2,144,1,64,0.0,36.0,36.0,1,80,0.0,52.0,52.0
0.068,6,10,1506,5,395,14.0,127.0,127.0,5,1111,14.0,843.0,843.0
0.04,17,4,596,2,122,0.0,33.0,33.0,2,474,1.0,323.0,209.0
165.441,17,70,10063,35,2330,4865.0,44.0,38.0,35,7733,4865.0,239.0,192.0
0.02,6,10,1972,5,910,4.0,642.0,642.0,5,1062,4.0,794.0,794.0
0.034,17,2,179,1,71,0.0,43.0,43.0,1,108,0.0,80.0,80.0
0.013,6,10,1972,5,910,3.0,642.0,642.0,5,1062,3.0,794.0,794.0
0.011,6,10,1989,5,910,2.0,642.0,642.0,5,1079,2.0,811.0,811.0
0.09,6,10,1506,5,395,20.0,127.0,127.0,5,1111,20.0,843.0,843.0
240.09,6,16,4481,9,963,30011.0,238.0,166.0,7,3518,40014.0,1402.0,786.0
173.315,17,90,12999,45,3025,3938.0,44.0,39.0,45,9974,3938.0,239.0,193.0
0.089,6,10,1506,5,395,19.0,127.0,127.0,5,1111,21.0,843.0,843.0
0.006,6,10,1689,5,839,1.0,571.0,571.0,5,850,1.0,582.0,582.0
0.013,6,10,1677,5,827,3.0,559.0,559.0,5,850,3.0,582.0,582.0
0.111,6,10,1506,5,395,27.0,127.0,127.0,5,1111,24.0,843.0,843.0
0.006,6,10,2006,5,927,1.0,659.0,659.0,5,1079,1.0,811.0,811.0
264.524,17,18,1008,9,640,33047.0,48.0,43.0,9,368,33048.0,20.0,12.0
1.074,6,32,13392,18,5893,63.0,2720.0,854.0,14,7499,69.0,2720.0,769.0
0.014,6,10,1989,5,910,3.0,642.0,642.0,5,1079,3.0,811.0,811.0
0.015,6,10,1990,5,911,3.0,643.0,643.0,5,1079,3.0,811.0,811.0
0.007,6,10,1547,5,764,1.0,496.0,496.0,5,783,1.0,515.0,515.0
10.882,17,28,4423,14,1995,829.0,270.0,114.0,14,2428,828.0,587.0,145.0
0.011,6,10,1989,5,910,2.0,642.0,642.0,5,1079,2.0,811.0,811.0
0.119,6,10,1506,5,395,26.0,127.0,127.0,5,1111,28.0,843.0,843.0
0.005,6,10,1547,5,764,1.0,496.0,496.0,5,783,1.0,515.0,515.0
0.008,6,12,1926,6,1189,1.0,659.0,434.0,6,737,1.0,417.0,417.0
0.076,6,10,1506,5,395,15.0,127.0,127.0,5,1111,18.0,843.0,843.0
0.096,6,10,1506,5,395,19.0,127.0,127.0,5,1111,21.0,843.0,843.0
0.006,6,10,1547,5,764,1.0,496.0,496.0,5,783,1.0,515.0,515.0
0.075,6,10,1506,5,395,16.0,127.0,127.0,5,1111,16.0,843.0,843.0
0.017,6,10,1989,5,910,4.0,642.0,642.0,5,1079,4.0,811.0,811.0
551.521,6,53,18214,28,3855,20426.0,664.0,398.0,25,14359,20479.0,1402.0,725.0
0.005,6,10,1689,5,839,1.0,571.0,571.0,5,850,1.0,582.0,582.0
0.005,6,10,2006,5,927,1.0,659.0,659.0,5,1079,1.0,811.0,811.0
0.005,6,10,2007,5,928,1.0,660.0,660.0,5,1079,1.0,811.0,811.0
0.016,17,2,198,1,91,0.0,63.0,63.0,1,107,0.0,79.0,79.0
0.007,6,10,1989,5,910,1.0,642.0,642.0,5,1079,1.0,811.0,811.0
0.001,17,2,179,1,62,0.0,34.0,34.0,1,117,0.0,89.0,89.0
10.816,17,28,4423,14,1994,823.0,269.0,114.0,14,2429,823.0,588.0,145.0
0.009,6,10,1972,5,910,2.0,642.0,642.0,5,1062,2.0,794.0,794.0
0.004,6,10,2000,5,927,1.0,659.0,659.0,5,1073,1.0,805.0,805.0
0.018,6,10,1989,5,910,4.0,642.0,642.0,5,1079,4.0,811.0,811.0
240.089,6,30,9331,15,6994,17149.0,2120.0,690.0,15,2337,17149.0,580.0,221.0
0.004,17,4,284,2,120,0.0,32.0,32.0,2,164,0.0,60.0,54.0
11.002,17,28,4396,14,2311,837.0,586.0,137.0,14,2085,837.0,268.0,120.0
0.005,6,10,1989,5,927,1.0,659.0,659.0,5,1062,1.0,794.0,794.0
0.012,6,12,1926,6,1189,2.0,659.0,434.0,6,737,2.0,417.0,417.0
0.037,17,2,170,1,65,0.0,37.0,37.0,1,105,0.0,77.0,77.0
0.005,17,2,213,1,69,0.0,41.0,41.0,1,144,0.0,116.0,116.0
240.022,6,9,787,5,488,60005.0,232.0,232.0,4,299,80005.0,83.0,83.0
0.013,6,13,3735,7,497,2.0,125.0,125.0,6,3238,2.0,1470.0,1459.0
0.007,6,10,1689,5,839,1.0,571.0,571.0,5,850,1.0,582.0,582.0
1799.998,6,137,6590,76,3625,23996.0,39.0,39.0,61,2965,29995.0,35.0,35.0
0.016,6,10,1972,5,910,4.0,642.0,642.0,5,1062,3.0,794.0,794.0
0.012,17,2,138,1,61,0.0,33.0,33.0,1,77,0.0,49.0,49.0
0.005,17,2,144,1,64,0.0,36.0,36.0,1,80,0.0,52.0,52.0
0.006,17,2,230,1,68,0.0,40.0,40.0,1,162,0.0,134.0,134.0
0.041,17,2,412,1,61,0.0,33.0,33.0,1,351,0.0,323.0,323.0
0.005,6,10,1774,5,923,1.0,655.0,655.0,5,851,1.0,583.0,583.0
0.078,6,10,1506,5,395,17.0,127.0,127.0,5,1111,16.0,843.0,843.0
0.008,6,10,1989,5,910,2.0,642.0,642.0,5,1079,2.0,811.0,811.0
0.017,6,10,1989,5,910,4.0,642.0,642.0,5,1079,4.0,811.0,811.0
0.005,6,10,2000,5,927,1.0,659.0,659.0,5,1073,1.0,805.0,805.0
0.012,6,10,1677,5,827,2.0,559.0,559.0,5,850,2.0,582.0,582.0
0.016,6,10,1631,5,848,3.0,580.0,580.0,5,783,3.0,515.0,515.0
178.247,17,84,12341,42,2828,4347.0,44.0,39.0,42,9513,4347.0,261.0,198.0
0.006,17,2,170,1,65,0.0,37.0,37.0,1,105,0.0,77.0,77.0
177.135,17,84,11928,42,2803,4320.0,44.0,38.0,42,9125,4320.0,239.0,189.0
0.003,17,2,148,1,60,0.0,32.0,32.0,1,88,0.0,60.0,60.0
0.005,6,10,1689,5,839,1.0,571.0,571.0,5,850,1.0,582.0,582.0
0.005,6,10,2006,5,927,1.0,659.0,659.0,5,1079,1.0,811.0,811.0
291.639,6,397,348075,197,21801,1487.0,2736.0,888.0,200,326274,1465.0,2804.0,1698.0
0.076,6,10,1506,5,395,18.0,127.0,127.0,5,1111,16.0,843.0,843.0
0.039,17,4,284,2,120,0.0,32.0,32.0,2,164,36.0,60.0,54.0
0.005,6,10,2006,5,927,1.0,659.0,659.0,5,1079,1.0,811.0,811.0
172.102,17,90,12986,45,3033,3911.0,44.0,39.0,45,9953,3911.0,261.0,193.0
0.013,6,10,1972,5,910,3.0,642.0,642.0,5,1062,3.0,794.0,794.0
0.018,6,10,1762,5,911,4.0,643.0,643.0,5,851,4.0,583.0,583.0
0.001,17,2,166,1,75,0.0,47.0,47.0,1,91,0.0,63.0,63.0
0.02,6,10,1989,5,910,5.0,642.0,642.0,5,1079,4.0,811.0,811.0
0.017,17,4,284,2,120,0.0,32.0,32.0,2,164,0.0,60.0,54.0
0.006,6,10,1989,5,927,1.0,659.0,659.0,5,1062,1.0,794.0,794.0
95.798,6,22,7437,11,1305,116.0,530.0,277.0,11,6132,9562.0,2720.0,946.0
0.013,6,10,1989,5,910,3.0,642.0,642.0,5,1079,3.0,811.0,811.0
0.005,6,10,1989,5,927,1.0,659.0,659.0,5,1062,1.0,794.0,794.0
0.009,6,10,1779,5,928,2.0,660.0,660.0,5,851,2.0,583.0,583.0
0.039,17,2,144,1,64,0.0,36.0,36.0,1,80,0.0,52.0,52.0
0.011,6,10,1762,5,911,2.0,643.0,643.0,5,851,2.0,583.0,583.0
0.114,6,10,1506,5,395,26.0,127.0,127.0,5,1111,24.0,843.0,843.0
0.967,6,30,13736,17,7272,60.0,2720.0,937.0,13,6464,64.0,2720.0,988.0
0.017,6,10,1989,5,910,4.0,642.0,642.0,5,1079,4.0,811.0,811.0
0.013,6,10,1972,5,910,3.0,642.0,642.0,5,1062,3.0,794.0,794.0
240.48,6,43,8771,22,5738,11451.0,1368.0,458.0,21,3033,12023.0,580.0,241.0
0.008,6,13,3735,7,497,1.0,125.0,125.0,6,3238,1.0,1470.0,1459.0
0.813,6,10,937,6,427,162.0,107.0,107.0,4,510,181.0,294.0,294.0
0.116,6,10,1506,5,395,26.0,127.0,127.0,5,1111,26.0,843.0,843.0
0.014,6,10,1990,5,911,3.0,643.0,643.0,5,1079,3.0,811.0,811.0
0.014,6,10,1990,5,911,3.0,643.0,643.0,5,1079,3.0,811.0,811.0
0.013,6,10,1990,5,911,3.0,643.0,643.0,5,1079,3.0,811.0,811.0
0.005,6,10,1779,5,928,1.0,660.0,660.0,5,851,1.0,583.0,583.0
0.006,6,10,1547,5,764,1.0,496.0,496.0,5,783,1.0,515.0,515.0
0.016,6,10,1989,5,910,4.0,642.0,642.0,5,1079,3.0,811.0,811.0
0.015,6,10,1972,5,910,3.0,642.0,642.0,5,1062,3.0,794.0,794.0
0.001,17,2,136,1,60,0.0,32.0,32.0,1,76,0.0,48.0,48.0
0.074,6,10,1506,5,395,16.0,127.0,127.0,5,1111,16.0,843.0,843.0
0.081,6,10,1506,5,395,18.0,127.0,127.0,5,1111,18.0,843.0,843.0
0.005,6,10,2000,5,927,1.0,659.0,659.0,5,1073,1.0,805.0,805.0
10.825,17,28,4421,14,1994,823.0,269.0,114.0,14,2427,823.0,586.0,145.0
1778.978,17,142,44872,72,22752,25054.0,288.0,288.0,70,22120,25779.0,288.0,288.0
0.004,6,10,1702,5,863,1.0,595.0,595.0,5,839,1.0,571.0,571.0
0.003,17,2,148,1,60,0.0,32.0,32.0,1,88,0.0,60.0,60.0
0.004,6,10,2007,5,928,1.0,660.0,660.0,5,1079,1.0,811.0,811.0
0.079,6,10,1506,5,395,17.0,127.0,127.0,5,1111,17.0,843.0,843.0
0.005,17,2,178,1,65,0.0,37.0,37.0,1,113,0.0,85.0,85.0
11.076,17,28,4392,14,2311,843.0,586.0,137.0,14,2081,843.0,268.0,120.0
240.009,6,9,787,5,488,60002.0,232.0,232.0,4,299,80002.0,83.0,83.0
0.11,6,10,1506,5,395,24.0,127.0,127.0,5,1111,23.0,843.0,843.0
0.005,6,14,3742,7,452,0.0,80.0,80.0,7,3290,0.0,1448.0,972.0
0.041,17,2,170,1,65,0.0,37.0,37.0,1,105,0.0,77.0,77.0
240.089,6,16,4482,9,963,30011.0,238.0,166.0,7,3519,40013.0,1402.0,786.0
0.005,6,10,2006,5,927,1.0,659.0,659.0,5,1079,1.0,811.0,811.0
0.129,17,2,234,1,61,0.0,33.0,33.0,1,173,0.0,145.0,145.0
0.001,17,2,180,1,66,0.0,38.0,38.0,1,114,0.0,86.0,86.0
0.013,6,10,1972,5,910,3.0,642.0,642.0,5,1062,3.0,794.0,794.0
0.231,6,10,1506,5,395,57.0,127.0,127.0,5,1111,33.0,843.0,843.0
0.004,6,10,2007,5,928,1.0,660.0,660.0,5,1079,1.0,811.0,811.0
0.005,6,10,1689,5,839,1.0,571.0,571.0,5,850,1.0,582.0,582.0
0.107,6,10,1506,5,395,23.0,127.0,127.0,5,1111,22.0,843.0,843.0
0.013,6,10,1989,5,910,3.0,642.0,642.0,5,1079,3.0,811.0,811.0
0.097,6,10,1506,5,395,22.0,127.0,127.0,5,1111,14.0,843.0,843.0
0.012,6,10,1983,5,910,2.0,642.0,642.0,5,1073,2.0,805.0,805.0
0.059,17,2,152,1,76,0.0,48.0,48.0,1,76,0.0,48.0,48.0
0.084,6,10,1506,5,395,20.0,127.0,127.0,5,1111,17.0,843.0,843.0
0.01,17,2,194,1,59,0.0,31.0,31.0,1,135,0.0,107.0,107.0
10.945,17,28,4422,14,1994,833.0,269.0,114.0,14,2428,832.0,587.0,145.0
0.005,6,10,2006,5,927,1.0,659.0,659.0,5,1079,1.0,811.0,811.0
0.004,17,2,184,1,61,0.0,33.0,33.0,1,123,0.0,95.0,95.0
240.807,6,37,9607,19,2140,13376.0,712.0,228.0,18,7467,14163.0,1402.0,594.0
0.006,6,10,1547,5,764,1.0,496.0,496.0,5,783,1.0,515.0,515.0
0.013,6,10,1989,5,910,3.0,642.0,642.0,5,1079,3.0,811.0,811.0
0.17,6,10,1506,5,395,40.0,127.0,127.0,5,1111,40.0,843.0,843.0
0.006,6,10,1547,5,764,1.0,496.0,496.0,5,783,1.0,515.0,515.0
0.006,17,2,225,1,65,0.0,37.0,37.0,1,160,0.0,132.0,132.0
0.015,6,10,1990,5,911,3.0,643.0,643.0,5,1079,3.0,811.0,811.0
0.009,6,10,1989,5,910,2.0,642.0,642.0,5,1079,2.0,811.0,811.0
0.013,6,13,3735,7,497,2.0,125.0,125.0,6,3238,2.0,1470.0,1459.0
0.001,17,2,142,1,63,0.0,35.0,35.0,1,79,0.0,51.0,51.0
0.005,6,10,1702,5,863,1.0,595.0,595.0,5,839,1.0,571.0,571.0
0.005,6,10,1689,5,839,1.0,571.0,571.0,5,850,1.0,582.0,582.0
0.039,17,2,148,1,60,0.0,32.0,32.0,1,88,0.0,60.0,60.0
300.024,6,12,1782,7,1348,50004.0,494.0,494.0,5,434,75005.0,83.0,83.0
40.061,17,10,676,5,460,10012.0,104.0,64.0,5,216,10014.0,20.0,15.0
1792.27,6,542,188137,270,162442,6662.0,2883.0,957.0,272,25695,6613.0,388.0,115.0
0.096,6,10,1506,5,395,21.0,127.0,127.0,5,1111,17.0,843.0,843.0
0.006,6,10,1547,5,764,1.0,496.0,496.0,5,783,1.0,515.0,515.0
40.07,17,10,676,5,460,10015.0,104.0,64.0,5,216,10015.0,20.0,15.0
0.006,6,10,1989,5,927,1.0,659.0,659.0,5,1062,1.0,794.0,794.0
0.005,6,10,1989,5,927,1.0,659.0,659.0,5,1062,1.0,794.0,794.0
0.011,6,10,1990,5,911,2.0,643.0,643.0,5,1079,2.0,811.0,811.0
0.005,17,2,179,1,71,0.0,43.0,43.0,1,108,0.0,80.0,80.0
0.005,17,2,179,1,71,0.0,43.0,43.0,1,108,0.0,80.0,80.0
0.012,6,10,1989,5,910,3.0,642.0,642.0,5,1079,3.0,811.0,811.0
0.015,6,10,1983,5,910,3.0,642.0,642.0,5,1073,3.0,805.0,805.0
0.01,6,10,1983,5,910,2.0,642.0,642.0,5,1073,2.0,805.0,805.0
0.005,6,10,1774,5,923,1.0,655.0,655.0,5,851,1.0,583.0,583.0
0.027,6,10,1972,5,910,6.0,642.0,642.0,5,1062,6.0,794.0,794.0
0.005,6,13,3747,7,509,0.0,137.0,137.0,6,3238,1.0,1470.0,1459.0
525.976,6,32,10658,17,2710,32873.0,676.0,363.0,15,7948,33283.0,1402.0,795.0
0.074,6,10,1506,5,395,16.0,127.0,127.0,5,1111,17.0,843.0,843.0
0.006,6,10,1547,5,764,1.0,496.0,496.0,5,783,1.0,515.0,515.0
0.013,6,10,1989,5,910,3.0,642.0,642.0,5,1079,3.0,811.0,811.0
0.047,17,2,182,1,65,0.0,37.0,37.0,1,117,0.0,89.0,89.0
0.006,6,10,1689,5,839,1.0,571.0,571.0,5,850,1.0,582.0,582.0
0.01,6,10,1631,5,848,2.0,580.0,580.0,5,783,2.0,515.0,515.0
0.019,6,10,1762,5,911,4.0,643.0,643.0,5,851,4.0,583.0,583.0
0.005,6,10,2007,5,928,1.0,660.0,660.0,5,1079,1.0,811.0,811.0
0.006,17,2,144,1,64,0.0,36.0,36.0,1,80,0.0,52.0,52.0
0.097,6,10,1506,5,395,18.0,127.0,127.0,5,1111,21.0,843.0,843.0
0.105,6,10,1506,5,395,24.0,127.0,127.0,5,1111,23.0,843.0,843.0
10.775,17,28,4418,14,1993,819.0,268.0,114.0,14,2425,820.0,588.0,145.0
66.479,6,44,10148,22,4425,418.0,1498.0,875.0,22,5723,3157.0,1360.0,371.0
40.072,17,10,676,5,460,10015.0,104.0,64.0,5,216,10017.0,20.0,15.0
0.005,6,10,1643,5,860,1.0,592.0,592.0,5,783,1.0,515.0,515.0
0.015,6,10,1631,5,848,3.0,580.0,580.0,5,783,3.0,515.0,515.0
0.006,6,10,1689,5,839,1.0,571.0,571.0,5,850,1.0,582.0,582.0
0.004,17,2,152,1,76,0.0,48.0,48.0,1,76,0.0,48.0,48.0
0.005,6,10,2006,5,927,1.0,659.0,659.0,5,1079,1.0,811.0,811.0
0.006,6,10,1854,5,889,1.0,621.0,621.0,5,965,1.0,697.0,697.0
0.015,17,2,198,1,91,0.0,63.0,63.0,1,107,0.0,79.0,79.0
40.058,17,10,676,5,460,10013.0,104.0,64.0,5,216,10013.0,20.0,15.0
0.036,6,10,1605,5,388,9.0,120.0,120.0,5,1217,8.0,949.0,949.0
0.005,17,2,235,1,64,0.0,36.0,36.0,1,171,0.0,143.0,143.0
0.197,6,10,1506,5,395,43.0,127.0,127.0,5,1111,47.0,843.0,843.0
0.01,6,10,1989,5,910,2.0,642.0,642.0,5,1079,2.0,811.0,811.0
361.793,6,21,1793,16,1030,24119.0,190.0,190.0,5,763,60009.0,462.0,247.0
0.137,6,10,1506,5,395,32.0,127.0,127.0,5,1111,28.0,843.0,843.0
0.009,6,12,1926,6,1189,1.0,659.0,434.0,6,737,1.0,417.0,417.0
0.018,17,2,136,1,60,0.0,32.0,32.0,1,76,0.0,48.0,48.0
0.018,6,10,1677,5,827,4.0,559.0,559.0,5,850,4.0,582.0,582.0
0.04,17,2,234,1,61,0.0,33.0,33.0,1,173,0.0,145.0,145.0
0.097,6,10,1506,5,395,23.0,127.0,127.0,5,1111,18.0,843.0,843.0
40.063,17,10,676,5,460,10015.0,104.0,64.0,5,216,10014.0,20.0,15.0
0.006,17,2,148,1,66,0.0,38.0,38.0,1,82,0.0,54.0,54.0
0.006,17,2,213,1,69,0.0,41.0,41.0,1,144,0.0,116.0,116.0
300.376,6,16,2170,9,684,37526.0,146.0,146.0,7,1486,50034.0,419.0,398.0
0.009,6,12,1926,6,1189,1.0,659.0,434.0,6,737,1.0,417.0,417.0
300.242,6,27,7436,16,1409,20016.0,217.0,142.0,11,6027,24023.0,1679.0,778.0
0.039,17,4,364,2,160,0.0,52.0,52.0,2,204,2.0,80.0,74.0
0.004,17,2,148,1,60,0.0,32.0,32.0,1,88,0.0,60.0,60.0
0.007,6,10,2006,5,927,1.0,659.0,659.0,5,1079,1.0,811.0,811.0
0.079,6,10,1506,5,395,16.0,127.0,127.0,5,1111,17.0,843.0,843.0
1759.223,6,64,7344,42,4469,42907.0,1625.0,108.0,22,2875,83764.0,1111.0,82.0
0.01,6,10,1983,5,910,2.0,642.0,642.0,5,1073,2.0,805.0,805.0
0.084,6,10,1506,5,395,19.0,127.0,127.0,5,1111,20.0,843.0,843.0
0.012,6,10,1989,5,910,3.0,642.0,642.0,5,1079,2.0,811.0,811.0
0.113,6,10,1506,5,395,24.0,127.0,127.0,5,1111,25.0,843.0,843.0
0.109,6,10,1506,5,395,24.0,127.0,127.0,5,1111,22.0,843.0,843.0
0.008,6,10,2006,5,927,2.0,659.0,659.0,5,1079,2.0,811.0,811.0
0.276,17,47,30650,28,27529,10.0,1350.0,955.0,19,3121,12.0,1350.0,136.0
0.004,6,10,2007,5,928,1.0,660.0,660.0,5,1079,1.0,811.0,811.0
0.003,17,2,148,1,60,0.0,32.0,32.0,1,88,0.0,60.0,60.0
0.123,6,10,1506,5,395,25.0,127.0,127.0,5,1111,25.0,843.0,843.0
173.269,17,90,13354,45,3044,3937.0,44.0,39.0,45,10310,3937.0,261.0,201.0
0.072,17,2,396,1,61,0.0,33.0,33.0,1,335,0.0,307.0,307.0
0.005,6,10,2006,5,927,1.0,659.0,659.0,5,1079,1.0,811.0,811.0
0.001,17,2,180,1,66,0.0,38.0,38.0,1,114,0.0,86.0,86.0
0.112,6,10,1506,5,395,26.0,127.0,127.0,5,1111,21.0,843.0,843.0
0.012,6,13,3735,7,497,1.0,125.0,125.0,6,3238,2.0,1470.0,1459.0
0.1,6,10,1506,5,395,21.0,127.0,127.0,5,1111,21.0,843.0,843.0
0.001,17,2,180,1,66,0.0,38.0,38.0,1,114,0.0,86.0,86.0
0.006,6,10,1547,5,764,1.0,496.0,496.0,5,783,1.0,515.0,515.0
0.101,6,10,1506,5,395,19.0,127.0,127.0,5,1111,22.0,843.0,843.0
0.038,17,2,136,1,60,0.0,32.0,32.0,1,76,0.0,48.0,48.0
65.997,6,37,9811,19,4293,498.0,1360.0,700.0,18,5518,3872.0,2667.0,435.0
0.006,6,10,1547,5,764,1.0,496.0,496.0,5,783,1.0,515.0,515.0
0.061,17,2,152,1,76,0.0,48.0,48.0,1,76,0.0,48.0,48.0
0.037,6,10,1631,5,848,9.0,580.0,580.0,5,783,9.0,515.0,515.0
0.005,6,13,3690,7,452,0.0,80.0,80.0,6,3238,1.0,1470.0,1459.0
11.143,17,28,4418,14,1994,844.0,269.0,114.0,14,2424,844.0,587.0,145.0
0.006,6,10,1547,5,764,1.0,496.0,496.0,5,783,1.0,515.0,515.0
0.054,17,2,152,1,76,0.0,48.0,48.0,1,76,0.0,48.0,48.0
0.005,17,2,179,1,71,0.0,43.0,43.0,1,108,0.0,80.0,80.0
0.005,6,13,3747,7,509,0.0,137.0,137.0,6,3238,1.0,1470.0,1459.0
0.012,6,10,1990,5,911,3.0,643.0,643.0,5,1079,3.0,811.0,811.0
0.007,6,10,1762,5,911,1.0,643.0,643.0,5,851,1.0,583.0,583.0
0.135,6,10,1506,5,395,31.0,127.0,127.0,5,1111,29.0,843.0,843.0
0.005,6,10,2006,5,927,1.0,659.0,659.0,5,1079,1.0,811.0,811.0
240.096,6,16,4480,9,963,30012.0,238.0,166.0,7,3517,40015.0,1402.0,786.0
0.005,6,10,2007,5,928,1.0,660.0,660.0,5,1079,1.0,811.0,811.0
0.04,17,2,182,1,65,0.0,37.0,37.0,1,117,0.0,89.0,89.0
0.102,6,10,1506,5,395,22.0,127.0,127.0,5,1111,23.0,843.0,843.0
0.006,6,10,2007,5,928,1.0,660.0,660.0,5,1079,1.0,811.0,811.0
0.144,6,10,1506,5,395,34.0,127.0,127.0,5,1111,32.0,843.0,843.0
0.005,17,2,146,1,65,0.0,37.0,37.0,1,81,0.0,53.0,53.0
0.005,6,10,1689,5,839,1.0,571.0,571.0,5,850,1.0,582.0,582.0
0.011,6,12,1926,6,1189,2.0,659.0,434.0,6,737,2.0,417.0,417.0
0.005,6,13,3684,7,446,0.0,74.0,74.0,6,3238,1.0,1470.0,1459.0
15.074,17,15,9238,8,6902,2149.0,1350.0,834.0,7,2336,2507.0,1350.0,305.0
0.008,6,10,1762,5,911,1.0,643.0,643.0,5,851,1.0,583.0,583.0
0.011,6,10,1677,5,827,2.0,559.0,559.0,5,850,2.0,582.0,582.0
15.075,17,18,8617,9,6008,1880.0,1350.0,639.0,9,2609,1880.0,1350.0,261.0
40.058,17,10,676,5,460,10013.0,104.0,64.0,5,216,10013.0,20.0,15.0
0.009,6,10,1990,5,911,2.0,643.0,643.0,5,1079,2.0,811.0,811.0
0.09,6,10,1506,5,395,20.0,127.0,127.0,5,1111,18.0,843.0,843.0
0.004,6,10,1702,5,863,1.0,595.0,595.0,5,839,0.0,571.0,571.0
0.001,17,2,180,1,66,0.0,38.0,38.0,1,114,0.0,86.0,86.0
0.071,17,2,170,1,65,0.0,37.0,37.0,1,105,0.0,77.0,77.0
0.006,6,10,1689,5,839,1.0,571.0,571.0,5,850,1.0,582.0,582.0
308.716,17,18,1008,9,640,38572.0,48.0,43.0,9,368,38572.0,20.0,12.0
0.009,6,10,1972,5,910,2.0,642.0,642.0,5,1062,2.0,794.0,794.0
0.006,17,2,169,1,62,0.0,34.0,34.0,1,107,0.0,79.0,79.0
40.056,17,10,676,5,460,10012.0,104.0,64.0,5,216,10012.0,20.0,15.0
0.133,17,2,182,1,65,0.0,37.0,37.0,1,117,0.0,89.0,89.0
1770.549,6,87,4626,44,2340,41174.0,26.0,26.0,43,2286,42154.0,26.0,25.0
0.006,17,4,284,2,120,0.0,32.0,32.0,2,164,0.0,60.0,54.0
10.793,17,26,4101,13,1846,890.0,269.0,114.0,13,2255,890.0,586.0,145.0
240.078,6,19,4867,9,2305,30009.0,1102.0,613.0,10,2562,26675.0,1162.0,406.0
0.004,6,10,2006,5,927,1.0,659.0,659.0,5,1079,1.0,811.0,811.0
0.005,17,2,170,1,65,0.0,37.0,37.0,1,105,0.0,77.0,77.0
0.006,6,10,1547,5,764,1.0,496.0,496.0,5,783,1.0,515.0,515.0
174.102,17,86,12247,43,2871,4145.0,44.0,38.0,43,9376,4145.0,239.0,190.0
0.005,6,10,2006,5,927,1.0,659.0,659.0,5,1079,1.0,811.0,811.0
0.012,6,10,1972,5,910,2.0,642.0,642.0,5,1062,2.0,794.0,794.0
0.022,6,10,1983,5,910,5.0,642.0,642.0,5,1073,5.0,805.0,805.0
40.075,17,10,676,5,460,10016.0,104.0,64.0,5,216,10018.0,20.0,15.0
0.004,6,10,1774,5,923,1.0,655.0,655.0,5,851,1.0,583.0,583.0
0.128,17,2,184,1,61,0.0,33.0,33.0,1,123,0.0,95.0,95.0
0.005,6,10,2007,5,928,1.0,660.0,660.0,5,1079,1.0,811.0,811.0
0.004,17,2,182,1,65,0.0,37.0,37.0,1,117,0.0,89.0,89.0
0.015,6,10,1989,5,910,3.0,642.0,642.0,5,1079,3.0,811.0,811.0
40.062,17,10,676,5,460,10014.0,104.0,64.0,5,216,10014.0,20.0,15.0
0.007,6,10,2006,5,927,1.0,659.0,659.0,5,1079,1.0,811.0,811.0
0.003,17,2,148,1,60,0.0,32.0,32.0,1,88,0.0,60.0,60.0
0.101,6,10,1506,5,395,23.0,127.0,127.0,5,1111,22.0,843.0,843.0
0.041,17,2,152,1,76,0.0,48.0,48.0,1,76,0.0,48.0,48.0
0.005,6,10,1854,5,889,1.0,621.0,621.0,5,965,1.0,697.0,697.0
166.115,17,84,11675,43,2890,3955.0,44.0,39.0,41,8785,4152.0,239.0,186.0
15.03,17,39,20075,22,17083,714.0,1350.0,748.0,17,2992,936.0,1350.0,148.0
0.01,6,13,3735,7,497,1.0,125.0,125.0,6,3238,1.0,1470.0,1459.0
0.004,6,10,2000,5,927,1.0,659.0,659.0,5,1073,1.0,805.0,805.0
40.066,17,10,676,5,460,10013.0,104.0,64.0,5,216,10015.0,20.0,15.0
0.004,6,10,1779,5,928,1.0,660.0,660.0,5,851,1.0,583.0,583.0
0.014,6,10,1989,5,910,3.0,642.0,642.0,5,1079,3.0,811.0,811.0
0.015,6,10,1972,5,910,3.0,642.0,642.0,5,1062,3.0,794.0,794.0
0.134,17,2,80,1,32,0.0,4.0,4.0,1,48,0.0,20.0,20.0
40.068,17,10,676,5,460,10015.0,104.0,64.0,5,216,10015.0,20.0,15.0
0.014,6,10,1989,5,910,3.0,642.0,642.0,5,1079,3.0,811.0,811.0
0.005,6,14,3799,7,509,0.0,137.0,137.0,7,3290,0.0,1448.0,972.0
0.004,6,10,1774,5,923,1.0,655.0,655.0,5,851,1.0,583.0,583.0
0.088,6,10,1506,5,395,20.0,127.0,127.0,5,1111,20.0,843.0,843.0
300.054,6,12,1782,7,1348,50009.0,494.0,494.0,5,434,75008.0,83.0,83.0
0.005,17,2,169,1,62,0.0,34.0,34.0,1,107,0.0,79.0,79.0
0.009,6,10,1989,5,910,2.0,642.0,642.0,5,1079,2.0,811.0,811.0
0.016,6,10,1989,5,910,4.0,642.0,642.0,5,1079,4.0,811.0,811.0
0.04,17,4,284,2,120,0.0,32.0,32.0,2,164,37.0,60.0,54.0
0.006,17,2,164,1,74,0.0,46.0,46.0,1,90,0.0,62.0,62.0
0.041,17,2,152,1,76,0.0,48.0,48.0,1,76,0.0,48.0,48.0
300.654,6,25,7265,15,1593,21475.0,464.0,201.0,10,5672,7383.0,1402.0,734.0
0.066,6,10,1506,5,395,15.0,127.0,127.0,5,1111,16.0,843.0,843.0
0.094,6,10,1506,5,395,21.0,127.0,127.0,5,1111,19.0,843.0,843.0
0.005,17,2,170,1,65,0.0,37.0,37.0,1,105,0.0,77.0,77.0
0.016,6,10,1762,5,911,4.0,643.0,643.0,5,851,3.0,583.0,583.0
0.005,6,10,2006,5,927,1.0,659.0,659.0,5,1079,1.0,811.0,811.0
0.074,6,10,1506,5,395,14.0,127.0,127.0,5,1111,18.0,843.0,843.0
0.005,6,10,2007,5,928,1.0,660.0,660.0,5,1079,1.0,811.0,811.0
0.087,6,10,1506,5,395,18.0,127.0,127.0,5,1111,18.0,843.0,843.0
0.009,6,10,1762,5,911,2.0,643.0,643.0,5,851,2.0,583.0,583.0
30.934,6,26,5923,14,1888,2379.0,517.0,260.0,12,4035,2811.0,1330.0,590.0
40.055,17,10,676,5,460,10012.0,104.0,64.0,5,216,10013.0,20.0,15.0
0.004,17,4,284,2,120,0.0,32.0,32.0,2,164,0.0,60.0,54.0
0.006,6,10,2006,5,927,1.0,659.0,659.0,5,1079,1.0,811.0,811.0
0.008,6,10,1990,5,911,2.0,643.0,643.0,5,1079,2.0,811.0,811.0
0.233,17,14,8577,7,4012,38.0,1350.0,545.0,7,4565,29.0,1350.0,624.0
0.004,6,14,3799,7,509,0.0,137.0,137.0,7,3290,0.0,1448.0,972.0
0.095,6,10,1506,5,395,20.0,127.0,127.0,5,1111,21.0,843.0,843.0
0.004,17,2,148,1,60,0.0,32.0,32.0,1,88,0.0,60.0,60.0
1786.576,6,159,20243,94,14270,19210.0,302.0,302.0,65,5973,27915.0,83.0,83.0
0.006,17,2,179,1,71,0.0,43.0,43.0,1,108,0.0,80.0,80.0
0.008,6,10,1547,5,764,2.0,496.0,496.0,5,783,2.0,515.0,515.0
0.009,6,10,1989,5,910,2.0,642.0,642.0,5,1079,2.0,811.0,811.0
0.003,17,2,152,1,76,0.0,48.0,48.0,1,76,0.0,48.0,48.0
0.005,6,10,1643,5,860,1.0,592.0,592.0,5,783,1.0,515.0,515.0
15.23,17,17,8134,9,6075,1900.0,1350.0,647.0,8,2059,2171.0,1350.0,229.0
0.005,17,2,170,1,65,0.0,37.0,37.0,1,105,0.0,77.0,77.0
0.001,17,2,144,1,64,0.0,36.0,36.0,1,80,0.0,52.0,52.0
0.005,6,10,1774,5,923,1.0,655.0,655.0,5,851,1.0,583.0,583.0
40.057,17,10,676,5,460,10011.0,104.0,64.0,5,216,10013.0,20.0,15.0
0.005,17,2,148,1,60,0.0,32.0,32.0,1,88,0.0,60.0,60.0
308.471,17,20,1124,10,716,34259.0,48.0,43.0,10,408,34259.0,20.0,12.0
0.068,6,10,1506,5,395,13.0,127.0,127.0,5,1111,16.0,843.0,843.0
0.003,17,2,148,1,60,0.0,32.0,32.0,1,88,0.0,60.0,60.0
0.073,6,10,1506,5,395,16.0,127.0,127.0,5,1111,14.0,843.0,843.0
0.005,6,10,1854,5,889,1.0,621.0,621.0,5,965,1.0,697.0,697.0
40.063,17,10,676,5,460,10015.0,104.0,64.0,5,216,10015.0,20.0,15.0
0.005,6,14,3742,7,452,0.0,80.0,80.0,7,3290,0.0,1448.0,972.0
300.026,6,12,1782,7,1348,50004.0,494.0,494.0,5,434,75005.0,83.0,83.0
0.014,6,10,1677,5,827,3.0,559.0,559.0,5,850,3.0,582.0,582.0
0.11,6,10,1506,5,395,24.0,127.0,127.0,5,1111,23.0,843.0,843.0
10.925,17,26,4075,13,2140,901.0,587.0,136.0,13,1935,901.0,270.0,120.0
0.097,6,10,1506,5,395,19.0,127.0,127.0,5,1111,22.0,843.0,843.0
15.075,17,15,9238,8,6902,2149.0,1350.0,834.0,7,2336,2507.0,1350.0,305.0
0.033,6,10,1972,5,910,8.0,642.0,642.0,5,1062,8.0,794.0,794.0
0.091,6,10,1506,5,395,18.0,127.0,127.0,5,1111,17.0,843.0,843.0
0.009,6,10,1983,5,910,2.0,642.0,642.0,5,1073,2.0,805.0,805.0
0.005,17,2,170,1,65,0.0,37.0,37.0,1,105,0.0,77.0,77.0
0.043,17,2,136,1,60,0.0,32.0,32.0,1,76,0.0,48.0,48.0
0.014,6,10,1990,5,911,3.0,643.0,643.0,5,1079,3.0,811.0,811.0
0.007,6,10,2006,5,927,1.0,659.0,659.0,5,1079,1.0,811.0,811.0
0.012,6,10,1972,5,910,3.0,642.0,642.0,5,1062,2.0,794.0,794.0
0.005,6,14,3742,7,452,0.0,80.0,80.0,7,3290,0.0,1448.0,972.0
0.015,6,10,1990,5,911,3.0,643.0,643.0,5,1079,3.0,811.0,811.0
0.072,17,4,596,2,122,1.0,33.0,33.0,2,474,0.0,323.0,209.0
300.337,6,16,2170,9,684,37521.0,146.0,146.0,7,1486,50028.0,419.0,398.0
0.001,17,2,180,1,66,0.0,38.0,38.0,1,114,0.0,86.0,86.0
15.205,17,39,20154,21,17037,758.0,1350.0,783.0,18,3117,892.0,1350.0,145.0
0.112,6,10,1506,5,395,24.0,127.0,127.0,5,1111,25.0,843.0,843.0
0.014,6,10,1972,5,910,3.0,642.0,642.0,5,1062,3.0,794.0,794.0
307.283,6,23,4663,13,2427,25606.0,676.0,348.0,10,2236,27475.0,824.0,427.0
0.053,6,10,1506,5,395,11.0,127.0,127.0,5,1111,12.0,843.0,843.0
0.091,6,10,1506,5,395,21.0,127.0,127.0,5,1111,19.0,843.0,843.0
0.005,17,2,214,1,75,0.0,47.0,47.0,1,139,0.0,111.0,111.0
11.325,17,30,4740,15,2141,795.0,268.0,114.0,15,2599,793.0,586.0,145.0
177.236,17,82,11937,41,2755,4430.0,44.0,39.0,41,9182,4430.0,261.0,195.0
0.005,6,10,2000,5,927,1.0,659.0,659.0,5,1073,1.0,805.0,805.0
0.099,6,10,1506,5,395,21.0,127.0,127.0,5,1111,22.0,843.0,843.0
0.035,17,2,152,1,76,0.0,48.0,48.0,1,76,0.0,48.0,48.0
353.484,6,20,2210,6,1308,12006.0,494.0,494.0,14,902,27190.0,83.0,83.0
0.014,6,10,1989,5,910,3.0,642.0,642.0,5,1079,3.0,811.0,811.0
0.012,6,10,1677,5,827,3.0,559.0,559.0,5,850,3.0,582.0,582.0
0.004,17,4,284,2,120,1.0,32.0,32.0,2,164,0.0,60.0,54.0
0.011,6,10,1989,5,910,2.0,642.0,642.0,5,1079,2.0,811.0,811.0
0.006,6,10,1547,5,764,1.0,496.0,496.0,5,783,1.0,515.0,515.0
0.006,17,2,164,1,74,0.0,46.0,46.0,1,90,0.0,62.0,62.0
0.085,6,10,1506,5,395,19.0,127.0,127.0,5,1111,19.0,843.0,843.0
0.005,6,10,1702,5,863,1.0,595.0,595.0,5,839,1.0,571.0,571.0
0.043,17,2,412,1,61,0.0,33.0,33.0,1,351,0.0,323.0,323.0
0.005,6,10,2000,5,927,1.0,659.0,659.0,5,1073,1.0,805.0,805.0
0.005,6,10,2000,5,927,1.0,659.0,659.0,5,1073,1.0,805.0,805.0
0.071,6,10,1506,5,395,16.0,127.0,127.0,5,1111,17.0,843.0,843.0
0.006,6,10,2000,5,927,1.0,659.0,659.0,5,1073,1.0,805.0,805.0
1766.22,6,64,7344,42,4469,43078.0,1625.0,108.0,22,2875,84097.0,1111.0,82.0
0.015,6,10,1762,5,911,3.0,643.0,643.0,5,851,3.0,583.0,583.0
0.005,6,10,2007,5,928,1.0,660.0,660.0,5,1079,1.0,811.0,811.0
0.004,6,10,1989,5,927,1.0,659.0,659.0,5,1062,1.0,794.0,794.0
175.235,17,72,10420,36,2403,5006.0,44.0,38.0,36,8017,5006.0,239.0,194.0
0.006,17,2,179,1,71,0.0,43.0,43.0,1,108,0.0,80.0,80.0
15.076,17,15,8472,8,6302,2149.0,1350.0,759.0,7,2170,2507.0,1350.0,282.0
0.004,17,2,148,1,60,0.0,32.0,32.0,1,88,0.0,60.0,60.0
0.264,17,37,20162,21,17042,13.0,1350.0,783.0,16,3120,13.0,1350.0,167.0
0.015,6,10,1990,5,911,3.0,643.0,643.0,5,1079,3.0,811.0,811.0
40.068,17,10,676,5,460,10016.0,104.0,64.0,5,216,10016.0,20.0,15.0
834.076,6,44,8074,22,6092,25733.0,494.0,494.0,22,1982,39717.0,83.0,83.0
0.015,6,10,1631,5,848,3.0,580.0,580.0,5,783,3.0,515.0,515.0
0.085,6,10,1506,5,395,19.0,127.0,127.0,5,1111,19.0,843.0,843.0
308.609,17,19,1084,10,716,34277.0,48.0,43.0,9,368,38562.0,20.0,12.0
0.006,6,10,2006,5,927,1.0,659.0,659.0,5,1079,1.0,811.0,811.0
0.111,17,2,80,1,32,0.0,4.0,4.0,1,48,0.0,20.0,20.0
0.118,6,10,1506,5,395,27.0,127.0,127.0,5,1111,23.0,843.0,843.0
0.105,6,10,1506,5,395,23.0,127.0,127.0,5,1111,23.0,843.0,843.0
0.1,6,10,1506,5,395,19.0,127.0,127.0,5,1111,22.0,843.0,843.0
0.004,6,10,1779,5,928,1.0,660.0,660.0,5,851,1.0,583.0,583.0
0.053,6,10,1506,5,395,12.0,127.0,127.0,5,1111,12.0,843.0,843.0
0.001,17,2,180,1,66,0.0,38.0,38.0,1,114,0.0,86.0,86.0
0.006,6,10,1547,5,764,1.0,496.0,496.0,5,783,1.0,515.0,515.0
0.073,6,10,1506,5,395,17.0,127.0,127.0,5,1111,15.0,843.0,843.0
0.004,6,10,2007,5,928,1.0,660.0,660.0,5,1079,1.0,811.0,811.0
0.006,6,10,1547,5,764,1.0,496.0,496.0,5,783,1.0,515.0,515.0
0.006,6,10,1689,5,839,1.0,571.0,571.0,5,850,1.0,582.0,582.0
0.005,6,10,1702,5,863,1.0,595.0,595.0,5,839,1.0,571.0,571.0
1785.356,6,283,26889,143,9876,12572.0,747.0,270.0,140,17013,12844.0,1625.0,73.0
0.072,17,8,3613,4,1874,24.0,1350.0,440.0,4,1739,12.0,1350.0,406.0
0.02,6,10,1983,5,910,5.0,642.0,642.0,5,1073,4.0,805.0,805.0
40.061,17,10,676,5,460,10014.0,104.0,64.0,5,216,10014.0,20.0,15.0
0.005,6,10,2000,5,927,1.0,659.0,659.0,5,1073,1.0,805.0,805.0
0.005,6,10,2007,5,928,1.0,660.0,660.0,5,1079,1.0,811.0,811.0
0.009,6,12,1926,6,1189,1.0,659.0,434.0,6,737,1.0,417.0,417.0
0.066,6,10,1506,5,395,15.0,127.0,127.0,5,1111,14.0,843.0,843.0
0.01,6,10,1990,5,911,2.0,643.0,643.0,5,1079,2.0,811.0,811.0
40.063,17,10,676,5,460,10015.0,104.0,64.0,5,216,10013.0,20.0,15.0
0.053,17,2,152,1,76,0.0,48.0,48.0,1,76,0.0,48.0,48.0
0.093,6,10,1506,5,395,19.0,127.0,127.0,5,1111,21.0,843.0,843.0
40.074,17,10,676,5,460,10015.0,104.0,64.0,5,216,10015.0,20.0,15.0
0.001,17,2,180,1,66,0.0,38.0,38.0,1,114,0.0,86.0,86.0
0.015,6,10,1983,5,910,3.0,642.0,642.0,5,1073,3.0,805.0,805.0
0.005,6,10,1989,5,927,1.0,659.0,659.0,5,1062,1.0,794.0,794.0
0.014,6,10,1677,5,827,3.0,559.0,559.0,5,850,3.0,582.0,582.0
0.001,17,2,136,1,60,0.0,32.0,32.0,1,76,0.0,48.0,48.0
0.003,17,2,136,1,60,0.0,32.0,32.0,1,76,0.0,48.0,48.0
0.011,6,13,3735,7,497,1.0,125.0,125.0,6,3238,2.0,1470.0,1459.0
0.005,17,2,144,1,64,0.0,36.0,36.0,1,80,0.0,52.0,52.0
40.068,17,10,676,5,460,10013.0,104.0,64.0,5,216,10014.0,20.0,15.0
0.095,6,10,1506,5,395,21.0,127.0,127.0,5,1111,23.0,843.0,843.0
0.011,6,10,1972,5,910,2.0,642.0,642.0,5,1062,2.0,794.0,794.0
40.075,17,10,676,5,460,10016.0,104.0,64.0,5,216,10018.0,20.0,15.0
0.01,6,10,1972,5,910,2.0,642.0,642.0,5,1062,2.0,794.0,794.0
0.016,6,10,1972,5,910,3.0,642.0,642.0,5,1062,3.0,794.0,794.0
0.004,17,2,136,1,60,0.0,32.0,32.0,1,76,0.0,48.0,48.0
0.007,17,2,166,1,75,0.0,47.0,47.0,1,91,0.0,63.0,63.0
0.208,6,16,2669,8,1395,29.0,533.0,323.0,8,1274,18.0,529.0,212.0
0.016,6,10,1989,5,910,4.0,642.0,642.0,5,1079,3.0,811.0,811.0
0.158,6,10,1506,5,395,36.0,127.0,127.0,5,1111,35.0,843.0,843.0
0.066,6,10,1506,5,395,15.0,127.0,127.0,5,1111,14.0,843.0,843.0
0.01,6,10,1990,5,911,2.0,643.0,643.0,5,1079,2.0,811.0,811.0
0.071,6,10,1506,5,395,14.0,127.0,127.0,5,1111,15.0,843.0,843.0
0.063,6,10,1506,5,395,13.0,127.0,127.0,5,1111,14.0,843.0,843.0
0.391,17,42,20270,22,17085,18.0,1350.0,748.0,20,3185,16.0,1350.0,131.0
0.075,6,10,1506,5,395,15.0,127.0,127.0,5,1111,16.0,843.0,843.0
0.005,6,10,2006,5,927,1.0,659.0,659.0,5,1079,1.0,811.0,811.0
0.127,6,10,1506,5,395,23.0,127.0,127.0,5,1111,26.0,843.0,843.0
173.22,17,76,10943,38,2530,4681.0,44.0,38.0,38,8413,4681.0,260.0,193.0
0.005,6,10,2007,5,928,1.0,660.0,660.0,5,1079,1.0,811.0,811.0
0.006,17,2,170,1,65,0.0,37.0,37.0,1,105,0.0,77.0,77.0
0.015,6,10,1983,5,910,3.0,642.0,642.0,5,1073,3.0,805.0,805.0
0.016,6,10,1989,5,910,3.0,642.0,642.0,5,1079,4.0,811.0,811.0
0.013,6,10,1972,5,910,3.0,642.0,642.0,5,1062,3.0,794.0,794.0
0.009,6,10,1983,5,910,2.0,642.0,642.0,5,1073,2.0,805.0,805.0
0.012,6,10,1989,5,910,2.0,642.0,642.0,5,1079,2.0,811.0,811.0
0.01,6,13,3735,7,497,1.0,125.0,125.0,6,3238,2.0,1470.0,1459.0
0.006,17,2,225,1,65,0.0,37.0,37.0,1,160,0.0,132.0,132.0
0.02,6,10,1989,5,910,4.0,642.0,642.0,5,1079,4.0,811.0,811.0
0.001,17,2,180,1,66,0.0,38.0,38.0,1,114,0.0,86.0,86.0
0.008,6,10,1989,5,910,2.0,642.0,642.0,5,1079,1.0,811.0,811.0
0.103,6,10,1506,5,395,21.0,127.0,127.0,5,1111,24.0,843.0,843.0
0.005,6,10,1779,5,928,1.0,660.0,660.0,5,851,1.0,583.0,583.0
0.096,6,10,1506,5,395,19.0,127.0,127.0,5,1111,20.0,843.0,843.0
0.011,6,13,3735,7,497,1.0,125.0,125.0,6,3238,2.0,1470.0,1459.0
0.065,6,10,1506,5,395,15.0,127.0,127.0,5,1111,15.0,843.0,843.0
40.059,17,10,676,5,460,10014.0,104.0,64.0,5,216,10014.0,20.0,15.0
0.169,17,2,152,1,76,0.0,48.0,48.0,1,76,0.0,48.0,48.0
40.072,17,10,676,5,460,10016.0,104.0,64.0,5,216,10017.0,20.0,15.0
0.005,6,10,1989,5,927,1.0,659.0,659.0,5,1062,1.0,794.0,794.0
0.005,6,13,3747,7,509,0.0,137.0,137.0,6,3238,1.0,1470.0,1459.0
0.014,6,10,1990,5,911,3.0,643.0,643.0,5,1079,3.0,811.0,811.0
0.004,6,10,2000,5,927,1.0,659.0,659.0,5,1073,1.0,805.0,805.0
0.007,6,10,1989,5,927,1.0,659.0,659.0,5,1062,1.0,794.0,794.0
0.134,17,2,80,1,32,0.0,4.0,4.0,1,48,0.0,20.0,20.0
0.003,17,2,148,1,60,0.0,32.0,32.0,1,88,0.0,60.0,60.0
0.006,6,10,1547,5,764,1.0,496.0,496.0,5,783,1.0,515.0,515.0
0.001,17,2,180,1,66,0.0,38.0,38.0,1,114,0.0,86.0,86.0
0.01,6,13,3735,7,497,1.0,125.0,125.0,6,3238,1.0,1470.0,1459.0
0.084,6,10,1506,5,395,19.0,127.0,127.0,5,1111,19.0,843.0,843.0
0.008,6,10,1989,5,910,2.0,642.0,642.0,5,1079,1.0,811.0,811.0
0.094,6,10,1506,5,395,21.0,127.0,127.0,5,1111,19.0,843.0,843.0
0.001,17,2,180,1,66,0.0,38.0,38.0,1,114,0.0,86.0,86.0
0.018,6,10,1989,5,910,4.0,642.0,642.0,5,1079,4.0,811.0,811.0
0.242,17,39,20216,21,17053,12.0,1350.0,784.0,18,3163,10.0,1350.0,147.0
0.141,6,10,1506,5,395,30.0,127.0,127.0,5,1111,32.0,843.0,843.0
40.06,17,10,676,5,460,10014.0,104.0,64.0,5,216,10014.0,20.0,15.0
0.006,6,10,1547,5,764,1.0,496.0,496.0,5,783,1.0,515.0,515.0
0.071,17,2,182,1,65,0.0,37.0,37.0,1,117,0.0,89.0,89.0
0.081,6,10,1506,5,395,16.0,127.0,127.0,5,1111,15.0,843.0,843.0
0.014,6,10,1762,5,911,3.0,643.0,643.0,5,851,3.0,583.0,583.0
0.106,6,10,1506,5,395,24.0,127.0,127.0,5,1111,22.0,843.0,843.0
309.811,17,16,892,8,564,44239.0,48.0,42.0,8,328,44240.0,20.0,13.0
0.121,6,10,1506,5,395,25.0,127.0,127.0,5,1111,26.0,843.0,843.0
0.059,6,10,1506,5,395,14.0,127.0,127.0,5,1111,12.0,843.0,843.0
0.009,6,12,1926,6,1189,1.0,659.0,434.0,6,737,1.0,417.0,417.0
0.011,6,10,1989,5,910,2.0,642.0,642.0,5,1079,2.0,811.0,811.0
10.786,17,28,4417,14,1994,821.0,269.0,114.0,14,2423,821.0,586.0,145.0
0.01,6,10,1677,5,827,2.0,559.0,559.0,5,850,2.0,582.0,582.0
0.006,6,10,1547,5,764,1.0,496.0,496.0,5,783,1.0,515.0,515.0
0.012,6,13,3735,7,497,1.0,125.0,125.0,6,3238,2.0,1470.0,1459.0
0.001,17,2,180,1,66,0.0,38.0,38.0,1,114,0.0,86.0,86.0
0.005,6,10,2006,5,927,1.0,659.0,659.0,5,1079,1.0,811.0,811.0
0.012,6,10,1762,5,911,3.0,643.0,643.0,5,851,3.0,583.0,583.0
0.013,6,10,1990,5,911,3.0,643.0,643.0,5,1079,3.0,811.0,811.0
0.017,6,10,1989,5,910,4.0,642.0,642.0,5,1079,4.0,811.0,811.0
0.005,17,2,166,1,75,0.0,47.0,47.0,1,91,0.0,63.0,63.0
0.008,6,10,1631,5,848,2.0,580.0,580.0,5,783,1.0,515.0,515.0
0.001,17,2,180,1,66,0.0,38.0,38.0,1,114,0.0,86.0,86.0
0.004,6,10,1702,5,863,1.0,595.0,595.0,5,839,0.0,571.0,571.0
0.004,17,2,148,1,60,0.0,32.0,32.0,1,88,0.0,60.0,60.0
0.009,6,10,1762,5,911,2.0,643.0,643.0,5,851,2.0,583.0,583.0
0.013,17,2,152,1,56,0.0,28.0,28.0,1,96,0.0,68.0,68.0
40.06,17,10,676,5,460,10014.0,104.0,64.0,5,216,10014.0,20.0,15.0
0.009,6,10,1989,5,910,2.0,642.0,642.0,5,1079,2.0,811.0,811.0
0.142,6,10,1506,5,395,35.0,127.0,127.0,5,1111,32.0,843.0,843.0
0.016,6,10,1990,5,911,4.0,643.0,643.0,5,1079,4.0,811.0,811.0
0.005,6,10,1689,5,839,1.0,571.0,571.0,5,850,1.0,582.0,582.0
0.009,6,10,1972,5,910,2.0,642.0,642.0,5,1062,2.0,794.0,794.0
0.117,6,10,1506,5,395,20.0,127.0,127.0,5,1111,25.0,843.0,843.0
0.001,17,2,180,1,66,0.0,38.0,38.0,1,114,0.0,86.0,86.0
241.496,6,384,346903,193,21559,1257.0,2690.0,959.0,191,325344,1271.0,2804.0,1742.0
0.007,17,2,194,1,59,0.0,31.0,31.0,1,135,0.0,107.0,107.0
0.073,6,10,1506,5,395,16.0,127.0,127.0,5,1111,16.0,843.0,843.0
0.016,17,2,214,1,75,0.0,47.0,47.0,1,139,0.0,111.0,111.0
0.006,6,10,1689,5,839,1.0,571.0,571.0,5,850,1.0,582.0,582.0
0.01,6,10,1989,5,910,2.0,642.0,642.0,5,1079,2.0,811.0,811.0
0.005,6,10,2000,5,927,1.0,659.0,659.0,5,1073,1.0,805.0,805.0
0.075,6,10,1972,5,910,18.0,642.0,642.0,5,1062,18.0,794.0,794.0
178.096,17,96,13874,48,3235,3789.0,44.0,39.0,48,10639,3789.0,260.0,193.0
0.087,6,10,1506,5,395,19.0,127.0,127.0,5,1111,17.0,843.0,843.0
0.082,6,10,1506,5,395,16.0,127.0,127.0,5,1111,17.0,843.0,843.0
0.009,6,10,1990,5,911,2.0,643.0,643.0,5,1079,2.0,811.0,811.0
0.005,6,10,2006,5,927,1.0,659.0,659.0,5,1079,1.0,811.0,811.0
40.059,17,10,676,5,460,10013.0,104.0,64.0,5,216,10013.0,20.0,15.0
1794.28,6,491,99452,247,88102,7293.0,421.0,365.0,244,11350,7383.0,53.0,53.0
0.003,17,2,162,1,65,0.0,37.0,37.0,1,97,0.0,69.0,69.0
240.018,6,9,787,5,488,60004.0,232.0,232.0,4,299,80004.0,83.0,83.0
10.784,17,28,4422,14,1994,820.0,269.0,114.0,14,2428,820.0,587.0,145.0
40.116,17,10,676,5,460,10023.0,104.0,64.0,5,216,10028.0,20.0,15.0
308.978,17,20,1124,10,716,34316.0,48.0,43.0,10,408,34316.0,20.0,12.0
0.005,6,10,2000,5,927,1.0,659.0,659.0,5,1073,1.0,805.0,805.0
0.006,6,10,1547,5,764,1.0,496.0,496.0,5,783,1.0,515.0,515.0
0.126,6,10,1506,5,395,26.0,127.0,127.0,5,1111,27.0,843.0,843.0
0.135,6,10,1506,5,395,30.0,127.0,127.0,5,1111,22.0,843.0,843.0
334.185,17,20,1124,10,716,37123.0,48.0,43.0,10,408,37124.0,20.0,12.0
0.014,6,10,1983,5,910,3.0,642.0,642.0,5,1073,3.0,805.0,805.0
0.129,6,10,1506,5,395,30.0,127.0,127.0,5,1111,31.0,843.0,843.0
0.124,6,10,1506,5,395,30.0,127.0,127.0,5,1111,29.0,843.0,843.0
0.004,17,2,136,1,60,0.0,32.0,32.0,1,76,0.0,48.0,48.0
308.605,17,20,1124,10,716,34273.0,48.0,43.0,10,408,34275.0,20.0,12.0
0.006,6,10,1854,5,889,1.0,621.0,621.0,5,965,1.0,697.0,697.0
0.014,6,10,1989,5,910,3.0,642.0,642.0,5,1079,3.0,811.0,811.0
0.005,6,10,2007,5,928,1.0,660.0,660.0,5,1079,1.0,811.0,811.0
0.005,6,10,1989,5,927,1.0,659.0,659.0,5,1062,1.0,794.0,794.0
0.005,6,10,2007,5,928,1.0,660.0,660.0,5,1079,1.0,811.0,811.0
0.072,17,2,234,1,61,0.0,33.0,33.0,1,173,0.0,145.0,145.0
0.008,6,10,1983,5,910,1.0,642.0,642.0,5,1073,2.0,805.0,805.0
0.076,6,10,1506,5,395,16.0,127.0,127.0,5,1111,16.0,843.0,843.0
0.001,17,2,180,1,65,0.0,37.0,37.0,1,115,0.0,87.0,87.0
0.014,6,10,1972,5,910,3.0,642.0,642.0,5,1062,3.0,794.0,794.0
0.003,17,2,148,1,60,0.0,32.0,32.0,1,88,0.0,60.0,60.0
0.089,6,10,1506,5,395,20.0,127.0,127.0,5,1111,21.0,843.0,843.0
0.075,6,10,1506,5,395,16.0,127.0,127.0,5,1111,14.0,843.0,843.0
0.004,17,2,148,1,60,0.0,32.0,32.0,1,88,0.0,60.0,60.0
0.07,17,8,3613,4,1874,23.0,1350.0,440.0,4,1739,11.0,1350.0,406.0
0.07,6,10,1506,5,395,15.0,127.0,127.0,5,1111,16.0,843.0,843.0
0.111,6,10,1506,5,395,21.0,127.0,127.0,5,1111,21.0,843.0,843.0
0.009,6,10,1854,5,889,2.0,621.0,621.0,5,965,2.0,697.0,697.0
0.006,17,2,168,1,76,0.0,48.0,48.0,1,92,0.0,64.0,64.0
0.012,6,13,3735,7,497,2.0,125.0,125.0,6,3238,2.0,1470.0,1459.0
40.079,17,10,676,5,460,10019.0,104.0,64.0,5,216,10019.0,20.0,15.0
0.077,6,10,1506,5,395,17.0,127.0,127.0,5,1111,18.0,843.0,843.0
0.105,6,10,1506,5,395,25.0,127.0,127.0,5,1111,23.0,843.0,843.0
0.003,17,2,136,1,60,0.0,32.0,32.0,1,76,0.0,48.0,48.0
0.004,6,10,2006,5,927,1.0,659.0,659.0,5,1079,1.0,811.0,811.0
0.006,6,10,1547,5,764,1.0,496.0,496.0,5,783,1.0,515.0,515.0
0.004,6,10,2006,5,927,1.0,659.0,659.0,5,1079,1.0,811.0,811.0
178.052,17,82,11550,41,2731,4451.0,44.0,38.0,41,8819,4451.0,261.0,187.0
300.19,6,24,7516,13,2682,25015.0,1368.0,399.0,11,4834,30017.0,1655.0,1066.0
0.005,6,10,2006,5,927,1.0,659.0,659.0,5,1079,1.0,811.0,811.0
0.01,6,10,1990,5,911,2.0,643.0,643.0,5,1079,2.0,811.0,811.0
0.013,6,10,1972,5,910,3.0,642.0,642.0,5,1062,3.0,794.0,794.0
0.01,6,10,1989,5,910,2.0,642.0,642.0,5,1079,2.0,811.0,811.0
0.008,6,10,1990,5,911,2.0,643.0,643.0,5,1079,1.0,811.0,811.0
0.004,17,2,186,1,61,0.0,33.0,33.0,1,125,0.0,97.0,97.0
0.016,6,10,1989,5,910,3.0,642.0,642.0,5,1079,3.0,811.0,811.0
0.001,17,2,136,1,60,0.0,32.0,32.0,1,76,0.0,48.0,48.0
174.106,17,78,10899,39,2599,4581.0,44.0,38.0,39,8300,4581.0,249.0,184.0
0.037,17,4,284,2,120,0.0,32.0,32.0,2,164,34.0,60.0,54.0
0.072,17,2,182,1,65,0.0,37.0,37.0,1,117,0.0,89.0,89.0
0.004,6,10,2006,5,927,1.0,659.0,659.0,5,1079,1.0,811.0,811.0
0.006,6,10,1989,5,927,1.0,659.0,659.0,5,1062,1.0,794.0,794.0
0.004,6,13,3690,7,452,0.0,80.0,80.0,6,3238,0.0,1470.0,1459.0
0.038,17,2,148,1,60,0.0,32.0,32.0,1,88,0.0,60.0,60.0
309.514,17,20,1124,10,716,34376.0,48.0,43.0,10,408,34376.0,20.0,12.0
0.004,17,2,136,1,60,0.0,32.0,32.0,1,76,0.0,48.0,48.0
0.012,6,10,1989,5,910,2.0,642.0,642.0,5,1079,2.0,811.0,811.0
0.005,6,10,2007,5,928,1.0,660.0,660.0,5,1079,1.0,811.0,811.0
0.011,6,10,1983,5,910,2.0,642.0,642.0,5,1073,2.0,805.0,805.0
1770.813,6,135,6510,75,3585,23926.0,39.0,39.0,60,2925,30009.0,35.0,35.0
0.005,6,10,1989,5,927,1.0,659.0,659.0,5,1062,1.0,794.0,794.0
0.009,6,10,1983,5,910,2.0,642.0,642.0,5,1073,2.0,805.0,805.0
0.005,6,10,2006,5,927,1.0,659.0,659.0,5,1079,1.0,811.0,811.0
0.015,6,10,1989,5,910,3.0,642.0,642.0,5,1079,3.0,811.0,811.0
0.212,6,16,2670,8,1396,30.0,533.0,324.0,8,1274,19.0,529.0,212.0
0.004,6,10,1989,5,927,1.0,659.0,659.0,5,1062,1.0,794.0,794.0
0.005,6,10,2007,5,928,1.0,660.0,660.0,5,1079,1.0,811.0,811.0
40.061,17,10,676,5,460,10013.0,104.0,64.0,5,216,10014.0,20.0,15.0
0.012,6,10,1689,5,839,3.0,571.0,571.0,5,850,2.0,582.0,582.0
0.005,6,10,1989,5,927,1.0,659.0,659.0,5,1062,1.0,794.0,794.0
0.053,6,10,1990,5,911,13.0,643.0,643.0,5,1079,13.0,811.0,811.0
0.003,17,2,185,1,73,0.0,45.0,45.0,1,112,0.0,84.0,84.0
0.169,17,2,152,1,76,0.0,48.0,48.0,1,76,0.0,48.0,48.0
0.011,6,10,1990,5,911,2.0,643.0,643.0,5,1079,2.0,811.0,811.0
0.006,6,10,1547,5,764,1.0,496.0,496.0,5,783,1.0,515.0,515.0
0.073,17,2,182,1,65,0.0,37.0,37.0,1,117,0.0,89.0,89.0
0.007,17,2,299,1,65,0.0,37.0,37.0,1,234,0.0,206.0,206.0
0.004,6,10,2000,5,927,1.0,659.0,659.0,5,1073,1.0,805.0,805.0
0.198,6,10,1506,5,395,43.0,127.0,127.0,5,1111,48.0,843.0,843.0
0.085,6,10,1506,5,395,19.0,127.0,127.0,5,1111,18.0,843.0,843.0
0.022,6,10,1989,5,910,5.0,642.0,642.0,5,1079,5.0,811.0,811.0
0.135,6,10,1506,5,395,24.0,127.0,127.0,5,1111,31.0,843.0,843.0
0.013,6,10,1990,5,911,3.0,643.0,643.0,5,1079,3.0,811.0,811.0
0.014,6,10,1990,5,911,3.0,643.0,643.0,5,1079,3.0,811.0,811.0
0.001,17,2,180,1,65,0.0,37.0,37.0,1,115,0.0,87.0,87.0
0.005,17,2,170,1,65,0.0,37.0,37.0,1,105,0.0,77.0,77.0
0.003,17,2,148,1,60,0.0,32.0,32.0,1,88,0.0,60.0,60.0
0.001,17,2,136,1,60,0.0,32.0,32.0,1,76,0.0,48.0,48.0
0.005,6,10,1989,5,927,1.0,659.0,659.0,5,1062,1.0,794.0,794.0
0.01,6,11,2042,6,963,1.0,643.0,643.0,5,1079,2.0,811.0,811.0
0.01,6,10,1989,5,910,2.0,642.0,642.0,5,1079,2.0,811.0,811.0
0.006,6,10,2007,5,928,1.0,660.0,660.0,5,1079,1.0,811.0,811.0
0.013,6,10,1989,5,910,3.0,642.0,642.0,5,1079,3.0,811.0,811.0
0.134,6,10,1506,5,395,30.0,127.0,127.0,5,1111,30.0,843.0,843.0
0.005,6,10,2007,5,928,1.0,660.0,660.0,5,1079,1.0,811.0,811.0
0.105,6,10,1506,5,395,23.0,127.0,127.0,5,1111,23.0,843.0,843.0
0.006,6,10,1547,5,764,1.0,496.0,496.0,5,783,1.0,515.0,515.0
0.005,17,2,144,1,64,0.0,36.0,36.0,1,80,0.0,52.0,52.0
0.004,6,10,1989,5,927,1.0,659.0,659.0,5,1062,1.0,794.0,794.0
0.003,17,2,148,1,60,0.0,32.0,32.0,1,88,0.0,60.0,60.0
0.008,6,10,1989,5,910,2.0,642.0,642.0,5,1079,2.0,811.0,811.0
300.767,6,39,13566,21,8048,15038.0,2720.0,1196.0,18,5518,505.0,2667.0,435.0
0.005,6,13,3747,7,509,0.0,137.0,137.0,6,3238,1.0,1470.0,1459.0
0.02,6,10,1983,5,910,4.0,642.0,642.0,5,1073,4.0,805.0,805.0
40.071,17,10,676,5,460,10016.0,104.0,64.0,5,216,10017.0,20.0,15.0
0.131,6,10,1506,5,395,28.0,127.0,127.0,5,1111,28.0,843.0,843.0
0.137,6,10,1506,5,395,33.0,127.0,127.0,5,1111,28.0,843.0,843.0
0.014,6,10,1990,5,911,3.0,643.0,643.0,5,1079,3.0,811.0,811.0
240.139,6,43,6600,21,3176,12006.0,588.0,230.0,22,3424,11435.0,580.0,227.0
40.047,17,10,676,5,460,10010.0,104.0,64.0,5,216,10010.0,20.0,15.0
0.01,6,10,1972,5,910,2.0,642.0,642.0,5,1062,2.0,794.0,794.0
0.077,6,10,1506,5,395,17.0,127.0,127.0,5,1111,17.0,843.0,843.0
0.006,6,10,1547,5,764,1.0,496.0,496.0,5,783,1.0,515.0,515.0
1729.239,6,60,4400,40,2740,44339.0,33.0,33.0,20,1660,91002.0,31.0,31.0
0.004,17,2,148,1,60,0.0,32.0,32.0,1,88,0.0,60.0,60.0
0.005,17,2,180,1,66,0.0,38.0,38.0,1,114,0.0,86.0,86.0
9.035,17,6,376,5,280,2258.0,28.0,28.0,1,96,0.0,68.0,68.0
0.005,6,10,2006,5,927,1.0,659.0,659.0,5,1079,1.0,811.0,811.0
161.092,17,70,10069,35,2339,4737.0,44.0,38.0,35,7730,4737.0,239.0,192.0
0.228,6,16,2777,8,1395,32.0,533.0,323.0,8,1382,21.0,529.0,239.0
0.003,6,10,1702,5,863,0.0,595.0,595.0,5,839,0.0,571.0,571.0
0.005,6,10,2006,5,927,1.0,659.0,659.0,5,1079,1.0,811.0,811.0
0.01,6,13,3735,7,497,1.0,125.0,125.0,6,3238,1.0,1470.0,1459.0
0.116,6,10,1506,5,395,19.0,127.0,127.0,5,1111,28.0,843.0,843.0
0.005,6,10,2000,5,927,1.0,659.0,659.0,5,1073,1.0,805.0,805.0
0.005,6,14,3799,7,509,0.0,137.0,137.0,7,3290,0.0,1448.0,972.0
0.134,6,10,1506,5,395,29.0,127.0,127.0,5,1111,30.0,843.0,843.0
0.006,6,10,1689,5,839,1.0,571.0,571.0,5,850,1.0,582.0,582.0
0.009,6,12,1926,6,1189,1.0,659.0,434.0,6,737,1.0,417.0,417.0
0.005,6,10,2007,5,928,1.0,660.0,660.0,5,1079,1.0,811.0,811.0
0.006,17,2,180,1,66,0.0,38.0,38.0,1,114,0.0,86.0,86.0
0.093,6,10,1506,5,395,21.0,127.0,127.0,5,1111,20.0,843.0,843.0
0.005,17,2,170,1,65,0.0,37.0,37.0,1,105,0.0,77.0,77.0
0.004,6,10,1774,5,923,1.0,655.0,655.0,5,851,1.0,583.0,583.0
0.01,6,10,1631,5,848,2.0,580.0,580.0,5,783,2.0,515.0,515.0
0.011,6,10,1983,5,910,2.0,642.0,642.0,5,1073,2.0,805.0,805.0
0.005,6,10,2006,5,927,1.0,659.0,659.0,5,1079,1.0,811.0,811.0
0.006,6,10,1854,5,889,1.0,621.0,621.0,5,965,1.0,697.0,697.0
0.012,6,10,1990,5,911,3.0,643.0,643.0,5,1079,3.0,811.0,811.0
0.005,6,10,1643,5,860,1.0,592.0,592.0,5,783,1.0,515.0,515.0
0.0,17,2,136,1,60,0.0,32.0,32.0,1,76,0.0,48.0,48.0
0.132,17,2,148,1,60,0.0,32.0,32.0,1,88,0.0,60.0,60.0
15.078,17,15,8535,8,6290,2150.0,1350.0,758.0,7,2245,2508.0,1350.0,292.0
61.659,6,22,8497,12,2236,72.0,1345.0,574.0,10,6261,6832.0,2720.0,974.0
0.009,6,10,1677,5,827,2.0,559.0,559.0,5,850,2.0,582.0,582.0
0.053,17,2,144,1,64,0.0,36.0,36.0,1,80,0.0,52.0,52.0
10.831,17,28,4418,14,1994,824.0,269.0,114.0,14,2424,824.0,587.0,145.0
0.018,6,10,1989,5,910,4.0,642.0,642.0,5,1079,4.0,811.0,811.0
0.004,6,10,1989,5,927,1.0,659.0,659.0,5,1062,1.0,794.0,794.0
0.016,6,10,1677,5,827,3.0,559.0,559.0,5,850,3.0,582.0,582.0
0.004,17,2,148,1,60,0.0,32.0,32.0,1,88,0.0,60.0,60.0
0.001,17,2,180,1,66,0.0,38.0,38.0,1,114,0.0,86.0,86.0
0.087,6,10,1506,5,395,19.0,127.0,127.0,5,1111,21.0,843.0,843.0
0.287,17,38,20248,21,17047,14.0,1350.0,783.0,17,3201,14.0,1350.0,160.0
0.005,6,14,3736,7,446,0.0,74.0,74.0,7,3290,0.0,1448.0,972.0
0.005,17,2,178,1,81,0.0,53.0,53.0,1,97,0.0,69.0,69.0
0.072,17,4,420,2,122,0.0,33.0,33.0,2,298,35.0,145.0,121.0
40.064,17,10,676,5,460,10015.0,104.0,64.0,5,216,10015.0,20.0,15.0
0.006,6,10,1547,5,764,1.0,496.0,496.0,5,783,1.0,515.0,515.0
0.005,6,10,1689,5,839,1.0,571.0,571.0,5,850,1.0,582.0,582.0
0.005,6,10,1689,5,839,1.0,571.0,571.0,5,850,1.0,582.0,582.0
9.043,17,6,376,5,280,2260.0,28.0,28.0,1,96,0.0,68.0,68.0
174.482,17,91,12617,46,3070,3877.0,44.0,38.0,45,9547,3965.0,239.0,184.0
0.006,6,10,1689,5,839,1.0,571.0,571.0,5,850,1.0,582.0,582.0
0.013,6,13,3735,7,497,2.0,125.0,125.0,6,3238,2.0,1470.0,1459.0
0.006,6,10,1774,5,923,1.0,655.0,655.0,5,851,1.0,583.0,583.0
0.004,6,10,2006,5,927,1.0,659.0,659.0,5,1079,1.0,811.0,811.0
0.003,17,2,142,1,63,0.0,35.0,35.0,1,79,0.0,51.0,51.0
0.013,6,10,1972,5,910,3.0,642.0,642.0,5,1062,3.0,794.0,794.0
0.086,6,10,1506,5,395,19.0,127.0,127.0,5,1111,16.0,843.0,843.0
0.021,6,10,1989,5,910,5.0,642.0,642.0,5,1079,5.0,811.0,811.0
0.006,6,10,1774,5,923,1.0,655.0,655.0,5,851,1.0,583.0,583.0
0.004,6,10,2006,5,927,1.0,659.0,659.0,5,1079,1.0,811.0,811.0
0.021,6,10,1989,5,910,5.0,642.0,642.0,5,1079,5.0,811.0,811.0
0.005,17,2,230,1,68,0.0,40.0,40.0,1,162,0.0,134.0,134.0
0.006,17,2,170,1,65,0.0,37.0,37.0,1,105,0.0,77.0,77.0
0.041,17,2,148,1,60,0.0,32.0,32.0,1,88,0.0,60.0,60.0
0.012,6,10,1990,5,911,3.0,643.0,643.0,5,1079,2.0,811.0,811.0
0.111,6,10,1506,5,395,24.0,127.0,127.0,5,1111,24.0,843.0,843.0
0.006,6,10,1689,5,839,1.0,571.0,571.0,5,850,1.0,582.0,582.0
0.007,6,10,1989,5,910,1.0,642.0,642.0,5,1079,1.0,811.0,811.0
0.005,6,14,3799,7,509,0.0,137.0,137.0,7,3290,0.0,1448.0,972.0
0.004,6,10,1779,5,928,1.0,660.0,660.0,5,851,1.0,583.0,583.0
0.003,17,2,144,1,64,0.0,36.0,36.0,1,80,0.0,52.0,52.0
0.007,17,2,144,1,64,0.0,36.0,36.0,1,80,0.0,52.0,52.0
0.006,6,10,2006,5,927,1.0,659.0,659.0,5,1079,1.0,811.0,811.0
0.01,6,10,1989,5,910,2.0,642.0,642.0,5,1079,2.0,811.0,811.0
0.005,6,10,1989,5,927,1.0,659.0,659.0,5,1062,1.0,794.0,794.0
0.006,17,2,170,1,65,0.0,37.0,37.0,1,105,0.0,77.0,77.0
0.001,17,2,180,1,66,0.0,38.0,38.0,1,114,0.0,86.0,86.0
0.076,6,10,1506,5,395,17.0,127.0,127.0,5,1111,17.0,843.0,843.0
0.01,6,10,1983,5,910,2.0,642.0,642.0,5,1073,2.0,805.0,805.0
0.005,6,10,2000,5,927,1.0,659.0,659.0,5,1073,1.0,805.0,805.0
0.109,6,10,1506,5,395,25.0,127.0,127.0,5,1111,21.0,843.0,843.0
0.094,6,10,1506,5,395,20.0,127.0,127.0,5,1111,21.0,843.0,843.0
240.107,6,33,10402,16,7961,16007.0,2883.0,713.0,17,2441,15006.0,580.0,193.0
0.001,17,2,164,1,74,0.0,46.0,46.0,1,90,0.0,62.0,62.0
40.066,17,10,676,5,460,10014.0,104.0,64.0,5,216,10015.0,20.0,15.0
0.019,6,10,1762,5,911,4.0,643.0,643.0,5,851,4.0,583.0,583.0
0.005,6,10,1989,5,927,1.0,659.0,659.0,5,1062,1.0,794.0,794.0
0.014,6,10,1990,5,911,3.0,643.0,643.0,5,1079,3.0,811.0,811.0
0.005,6,10,1689,5,839,1.0,571.0,571.0,5,850,1.0,582.0,582.0
0.012,6,10,2007,5,928,3.0,660.0,660.0,5,1079,3.0,811.0,811.0
0.119,6,10,1506,5,395,28.0,127.0,127.0,5,1111,29.0,843.0,843.0
40.097,17,10,676,5,460,10017.0,104.0,64.0,5,216,10013.0,20.0,15.0
40.065,17,10,676,5,460,10013.0,104.0,64.0,5,216,10014.0,20.0,15.0
0.006,6,10,1689,5,839,1.0,571.0,571.0,5,850,1.0,582.0,582.0
0.041,17,2,170,1,65,0.0,37.0,37.0,1,105,0.0,77.0,77.0
40.06,17,10,676,5,460,10011.0,104.0,64.0,5,216,10014.0,20.0,15.0
0.014,6,10,1983,5,910,3.0,642.0,642.0,5,1073,3.0,805.0,805.0
0.004,17,2,148,1,60,0.0,32.0,32.0,1,88,0.0,60.0,60.0
240.087,6,16,4481,9,963,30010.0,238.0,166.0,7,3518,40012.0,1402.0,786.0
0.002,17,2,152,1,76,0.0,48.0,48.0,1,76,0.0,48.0,48.0
0.003,17,2,148,1,60,0.0,32.0,32.0,1,88,0.0,60.0,60.0
293.802,6,386,347195,197,21794,1498.0,2736.0,825.0,189,325401,1562.0,2804.0,1792.0
40.079,17,10,676,5,460,10018.0,104.0,64.0,5,216,10019.0,20.0,15.0
0.006,17,2,178,1,65,0.0,37.0,37.0,1,113,0.0,85.0,85.0
0.006,6,10,1854,5,889,1.0,621.0,621.0,5,965,1.0,697.0,697.0
0.004,6,10,1702,5,863,1.0,595.0,595.0,5,839,1.0,571.0,571.0
0.005,6,10,1689,5,839,1.0,571.0,571.0,5,850,1.0,582.0,582.0
0.141,6,28,9130,14,6918,10.0,2084.0,686.0,14,2212,10.0,580.0,210.0
0.015,6,10,1989,5,910,3.0,642.0,642.0,5,1079,3.0,811.0,811.0
0.038,17,2,412,1,61,0.0,33.0,33.0,1,351,0.0,323.0,323.0
0.004,6,10,1702,5,863,1.0,595.0,595.0,5,839,1.0,571.0,571.0
0.005,17,2,180,1,66,0.0,38.0,38.0,1,114,0.0,86.0,86.0
40.072,17,10,676,5,460,10016.0,104.0,64.0,5,216,10017.0,20.0,15.0
0.005,6,14,3742,8,504,0.0,80.0,80.0,6,3238,0.0,1470.0,1459.0
0.077,6,10,1506,5,395,16.0,127.0,127.0,5,1111,17.0,843.0,843.0
0.006,6,10,1547,5,764,1.0,496.0,496.0,5,783,1.0,515.0,515.0
40.088,17,10,676,5,460,10015.0,104.0,64.0,5,216,10021.0,20.0,15.0
0.114,6,10,1506,5,395,24.0,127.0,127.0,5,1111,25.0,843.0,843.0
0.004,17,4,284,2,120,0.0,32.0,32.0,2,164,0.0,60.0,54.0
0.015,6,10,1762,5,911,3.0,643.0,643.0,5,851,3.0,583.0,583.0
11.197,17,28,4424,14,1995,848.0,270.0,114.0,14,2429,848.0,588.0,145.0
0.013,6,10,1990,5,911,3.0,643.0,643.0,5,1079,3.0,811.0,811.0
0.005,6,10,1689,5,839,1.0,571.0,571.0,5,850,1.0,582.0,582.0
0.004,17,2,148,1,60,0.0,32.0,32.0,1,88,0.0,60.0,60.0
0.005,6,10,2006,5,927,1.0,659.0,659.0,5,1079,1.0,811.0,811.0
0.087,6,10,1506,5,395,19.0,127.0,127.0,5,1111,17.0,843.0,843.0
0.017,6,10,1989,5,910,4.0,642.0,642.0,5,1079,4.0,811.0,811.0
0.006,17,2,166,1,75,0.0,47.0,47.0,1,91,0.0,63.0,63.0
0.004,6,10,2007,5,928,1.0,660.0,660.0,5,1079,1.0,811.0,811.0
0.012,17,2,169,1,62,0.0,34.0,34.0,1,107,0.0,79.0,79.0
0.064,6,10,1506,5,395,13.0,127.0,127.0,5,1111,14.0,843.0,843.0
0.006,6,10,1547,5,764,1.0,496.0,496.0,5,783,1.0,515.0,515.0
300.341,6,16,2170,9,684,37522.0,146.0,146.0,7,1486,50028.0,419.0,398.0
0.004,17,4,284,2,120,0.0,32.0,32.0,2,164,1.0,60.0,54.0
0.01,17,4,284,2,120,6.0,32.0,32.0,2,164,6.0,60.0,54.0
0.004,6,10,2006,5,927,1.0,659.0,659.0,5,1079,1.0,811.0,811.0
240.094,6,16,4481,9,963,30011.0,238.0,166.0,7,3518,40015.0,1402.0,786.0
0.007,6,10,1989,5,910,1.0,642.0,642.0,5,1079,1.0,811.0,811.0
40.056,17,10,676,5,460,10013.0,104.0,64.0,5,216,10013.0,20.0,15.0
0.006,6,10,1547,5,764,1.0,496.0,496.0,5,783,1.0,515.0,515.0
0.017,6,10,1989,5,910,4.0,642.0,642.0,5,1079,4.0,811.0,811.0
0.009,6,10,1972,5,910,2.0,642.0,642.0,5,1062,2.0,794.0,794.0
240.01,6,9,787,5,488,60002.0,232.0,232.0,4,299,80002.0,83.0,83.0
0.011,6,10,1989,5,910,2.0,642.0,642.0,5,1079,2.0,811.0,811.0
0.072,6,10,1506,5,395,15.0,127.0,127.0,5,1111,14.0,843.0,843.0
0.005,17,2,166,1,75,0.0,47.0,47.0,1,91,0.0,63.0,63.0
0.089,6,10,1506,5,395,20.0,127.0,127.0,5,1111,18.0,843.0,843.0
0.025,6,13,3735,7,497,4.0,125.0,125.0,6,3238,5.0,1470.0,1459.0
0.039,17,2,148,1,60,0.0,32.0,32.0,1,88,0.0,60.0,60.0
0.013,6,10,1983,5,910,3.0,642.0,642.0,5,1073,3.0,805.0,805.0
0.112,6,10,1506,5,395,23.0,127.0,127.0,5,1111,25.0,843.0,843.0
0.003,17,4,284,2,120,0.0,32.0,32.0,2,164,0.0,60.0,54.0
0.016,6,10,1983,5,910,4.0,642.0,642.0,5,1073,3.0,805.0,805.0
0.213,6,16,2777,8,1395,30.0,533.0,323.0,8,1382,19.0,529.0,239.0
0.001,17,2,180,1,66,0.0,38.0,38.0,1,114,0.0,86.0,86.0
0.179,6,10,1506,5,395,40.0,127.0,127.0,5,1111,34.0,843.0,843.0
0.008,6,10,1989,5,910,2.0,642.0,642.0,5,1079,2.0,811.0,811.0
0.009,6,10,1989,5,910,2.0,642.0,642.0,5,1079,2.0,811.0,811.0
0.005,17,2,170,1,65,0.0,37.0,37.0,1,105,0.0,77.0,77.0
0.005,6,10,1702,5,863,1.0,595.0,595.0,5,839,1.0,571.0,571.0
0.001,17,2,136,1,60,0.0,32.0,32.0,1,76,0.0,48.0,48.0
0.019,6,10,1983,5,910,4.0,642.0,642.0,5,1073,4.0,805.0,805.0
0.023,6,10,1989,5,910,5.0,642.0,642.0,5,1079,5.0,811.0,811.0
0.021,6,10,1989,5,910,5.0,642.0,642.0,5,1079,5.0,811.0,811.0
0.093,6,10,1506,5,395,21.0,127.0,127.0,5,1111,21.0,843.0,843.0
0.009,6,10,1990,5,911,2.0,643.0,643.0,5,1079,2.0,811.0,811.0
0.001,17,2,136,1,60,0.0,32.0,32.0,1,76,0.0,48.0,48.0
11.008,17,28,4398,14,2311,837.0,586.0,137.0,14,2087,837.0,270.0,121.0
40.07,17,10,676,5,460,10014.0,104.0,64.0,5,216,10016.0,20.0,15.0
382.675,6,22,2313,16,867,25511.0,195.0,195.0,6,1446,4665.0,419.0,398.0
0.013,17,2,152,1,56,0.0,28.0,28.0,1,96,0.0,68.0,68.0
0.125,6,10,1506,5,395,30.0,127.0,127.0,5,1111,25.0,843.0,843.0
0.01,6,10,1989,5,910,2.0,642.0,642.0,5,1079,2.0,811.0,811.0
293.377,6,416,349452,200,21966,1474.0,2736.0,889.0,216,327486,1364.0,2804.0,1565.0
0.005,6,10,2007,5,928,1.0,660.0,660.0,5,1079,1.0,811.0,811.0
0.016,6,10,1972,5,910,4.0,642.0,642.0,5,1062,3.0,794.0,794.0
0.013,6,10,1677,5,827,3.0,559.0,559.0,5,850,3.0,582.0,582.0
0.005,17,2,180,1,58,0.0,30.0,30.0,1,122,0.0,94.0,94.0
300.726,6,46,13971,20,6225,15827.0,1241.0,739.0,26,7746,12028.0,1162.0,376.0
0.17,17,2,152,1,76,0.0,48.0,48.0,1,76,0.0,48.0,48.0
0.009,6,10,1983,5,910,2.0,642.0,642.0,5,1073,2.0,805.0,805.0
0.005,6,10,2000,5,927,1.0,659.0,659.0,5,1073,1.0,805.0,805.0
0.006,6,10,2006,5,927,1.0,659.0,659.0,5,1079,1.0,811.0,811.0
0.106,6,10,1506,5,395,25.0,127.0,127.0,5,1111,23.0,843.0,843.0
0.005,6,10,2006,5,927,1.0,659.0,659.0,5,1079,1.0,811.0,811.0
0.005,17,2,164,1,74,0.0,46.0,46.0,1,90,0.0,62.0,62.0
0.005,6,10,2000,5,927,1.0,659.0,659.0,5,1073,1.0,805.0,805.0
0.012,6,10,1983,5,910,3.0,642.0,642.0,5,1073,3.0,805.0,805.0
351.986,6,20,2210,6,1308,12003.0,494.0,494.0,14,902,27075.0,83.0,83.0
0.001,17,2,180,1,66,0.0,38.0,38.0,1,114,0.0,86.0,86.0
0.007,6,10,1689,5,839,1.0,571.0,571.0,5,850,1.0,582.0,582.0
1756.023,6,105,6240,60,3510,29762.0,26.0,26.0,45,2730,39908.0,26.0,26.0
0.02,6,11,2041,6,962,4.0,642.0,642.0,5,1079,4.0,811.0,811.0
0.132,6,10,1506,5,395,26.0,127.0,127.0,5,1111,27.0,843.0,843.0
0.08,6,10,1506,5,395,16.0,127.0,127.0,5,1111,18.0,843.0,843.0
40.076,17,10,676,5,460,10018.0,104.0,64.0,5,216,10017.0,20.0,15.0
0.005,6,13,3747,7,509,0.0,137.0,137.0,6,3238,0.0,1470.0,1459.0
0.12,6,10,1506,5,395,29.0,127.0,127.0,5,1111,27.0,843.0,843.0
0.081,6,10,1506,5,395,19.0,127.0,127.0,5,1111,19.0,843.0,843.0
0.015,6,10,1989,5,910,3.0,642.0,642.0,5,1079,3.0,811.0,811.0
0.127,6,10,1506,5,395,29.0,127.0,127.0,5,1111,28.0,843.0,843.0
11.505,17,28,4398,14,2312,872.0,587.0,137.0,14,2086,872.0,269.0,121.0
0.012,6,10,1990,5,911,3.0,643.0,643.0,5,1079,3.0,811.0,811.0
0.011,6,10,1677,5,827,2.0,559.0,559.0,5,850,2.0,582.0,582.0
0.004,6,10,2007,5,928,1.0,660.0,660.0,5,1079,1.0,811.0,811.0
240.029,6,9,787,5,488,60007.0,232.0,232.0,4,299,80008.0,83.0,83.0
0.005,6,10,2007,5,928,1.0,660.0,660.0,5,1079,1.0,811.0,811.0
0.012,6,7,768,4,510,3.0,302.0,302.0,3,258,5.0,102.0,102.0
40.058,17,10,676,5,460,10013.0,104.0,64.0,5,216,10013.0,20.0,15.0
0.004,17,2,136,1,60,0.0,32.0,32.0,1,76,0.0,48.0,48.0
0.006,6,10,1689,5,839,1.0,571.0,571.0,5,850,1.0,582.0,582.0
178.522,17,70,9815,35,2320,5250.0,44.0,38.0,35,7495,5250.0,239.0,186.0
0.006,6,10,1547,5,764,1.0,496.0,496.0,5,783,1.0,515.0,515.0
0.04,17,2,148,1,60,0.0,32.0,32.0,1,88,0.0,60.0,60.0
0.003,17,2,136,1,60,0.0,32.0,32.0,1,76,0.0,48.0,48.0
0.024,6,10,1989,5,910,5.0,642.0,642.0,5,1079,5.0,811.0,811.0
0.008,17,2,261,1,74,0.0,46.0,46.0,1,187,0.0,159.0,159.0
11.148,17,28,4418,14,1993,845.0,268.0,114.0,14,2425,845.0,588.0,145.0
0.01,6,10,1631,5,848,2.0,580.0,580.0,5,783,2.0,515.0,515.0
40.064,17,10,676,5,460,10015.0,104.0,64.0,5,216,10015.0,20.0,15.0
0.014,6,10,1972,5,910,3.0,642.0,642.0,5,1062,3.0,794.0,794.0
40.057,17,10,676,5,460,10013.0,104.0,64.0,5,216,10013.0,20.0,15.0
1799.84,6,136,6550,76,3625,23997.0,39.0,39.0,60,2925,29993.0,35.0,35.0
0.005,6,10,2006,5,927,1.0,659.0,659.0,5,1079,1.0,811.0,811.0
352.673,6,20,2210,6,1308,12003.0,494.0,494.0,14,902,27128.0,83.0,83.0
0.004,6,10,2006,5,927,1.0,659.0,659.0,5,1079,1.0,811.0,811.0
0.005,6,10,2000,5,927,1.0,659.0,659.0,5,1073,1.0,805.0,805.0
0.005,17,2,144,1,64,0.0,36.0,36.0,1,80,0.0,52.0,52.0
0.005,17,2,164,1,74,0.0,46.0,46.0,1,90,0.0,62.0,62.0
0.006,6,10,1689,5,839,1.0,571.0,571.0,5,850,1.0,582.0,582.0
40.035,17,10,676,5,460,10006.0,104.0,64.0,5,216,10007.0,20.0,15.0
0.012,6,10,1631,5,848,2.0,580.0,580.0,5,783,2.0,515.0,515.0
0.004,6,10,2007,5,928,1.0,660.0,660.0,5,1079,1.0,811.0,811.0
0.006,6,10,1547,5,764,1.0,496.0,496.0,5,783,1.0,515.0,515.0
0.006,17,2,169,1,62,0.0,34.0,34.0,1,107,0.0,79.0,79.0
0.081,6,10,1506,5,395,20.0,127.0,127.0,5,1111,18.0,843.0,843.0
0.004,17,2,179,1,71,0.0,43.0,43.0,1,108,0.0,80.0,80.0
0.003,6,10,1702,5,863,0.0,595.0,595.0,5,839,0.0,571.0,571.0
0.001,17,2,180,1,66,0.0,38.0,38.0,1,114,0.0,86.0,86.0
0.016,6,10,1990,5,911,3.0,643.0,643.0,5,1079,4.0,811.0,811.0
0.122,6,10,1506,5,395,30.0,127.0,127.0,5,1111,26.0,843.0,843.0
0.089,6,10,1506,5,395,20.0,127.0,127.0,5,1111,16.0,843.0,843.0
0.005,17,2,170,1,65,0.0,37.0,37.0,1,105,0.0,77.0,77.0
0.108,6,10,1506,5,395,23.0,127.0,127.0,5,1111,24.0,843.0,843.0
0.04,17,2,146,1,65,0.0,37.0,37.0,1,81,0.0,53.0,53.0
0.01,6,10,1631,5,848,2.0,580.0,580.0,5,783,2.0,515.0,515.0
40.054,17,10,676,5,460,10012.0,104.0,64.0,5,216,10012.0,20.0,15.0
0.018,6,10,1990,5,911,4.0,643.0,643.0,5,1079,4.0,811.0,811.0
0.005,17,2,170,1,65,0.0,37.0,37.0,1,105,0.0,77.0,77.0
0.019,6,10,1990,5,911,4.0,643.0,643.0,5,1079,4.0,811.0,811.0
0.008,6,10,1989,5,927,2.0,659.0,659.0,5,1062,1.0,794.0,794.0
0.097,6,10,1506,5,395,22.0,127.0,127.0,5,1111,22.0,843.0,843.0
0.059,17,2,152,1,76,0.0,48.0,48.0,1,76,0.0,48.0,48.0
0.008,6,10,1989,5,910,2.0,642.0,642.0,5,1079,2.0,811.0,811.0
0.004,6,10,2000,5,927,1.0,659.0,659.0,5,1073,1.0,805.0,805.0
0.004,6,10,1989,5,927,1.0,659.0,659.0,5,1062,1.0,794.0,794.0
0.214,6,16,2777,8,1395,30.0,533.0,323.0,8,1382,19.0,529.0,239.0
0.103,6,10,1506,5,395,23.0,127.0,127.0,5,1111,23.0,843.0,843.0
0.005,6,13,3690,7,452,0.0,80.0,80.0,6,3238,0.0,1470.0,1459.0
0.088,6,10,1506,5,395,19.0,127.0,127.0,5,1111,20.0,843.0,843.0
0.081,6,10,1506,5,395,19.0,127.0,127.0,5,1111,15.0,843.0,843.0
0.019,6,10,1989,5,910,4.0,642.0,642.0,5,1079,4.0,811.0,811.0
0.538,6,43,11498,24,3221,23.0,1021.0,197.0,19,8277,29.0,1402.0,606.0
0.079,6,10,1506,5,395,14.0,127.0,127.0,5,1111,17.0,843.0,843.0
0.122,6,10,1506,5,395,29.0,127.0,127.0,5,1111,29.0,843.0,843.0
0.099,6,10,1506,5,395,23.0,127.0,127.0,5,1111,22.0,843.0,843.0
10.801,17,28,4418,14,1993,822.0,268.0,114.0,14,2425,822.0,588.0,145.0
0.004,6,10,1774,5,923,1.0,655.0,655.0,5,851,1.0,583.0,583.0
0.006,17,2,214,1,75,0.0,47.0,47.0,1,139,0.0,111.0,111.0
0.005,17,2,169,1,62,0.0,34.0,34.0,1,107,0.0,79.0,79.0
0.009,6,10,1983,5,910,2.0,642.0,642.0,5,1073,2.0,805.0,805.0
0.012,6,10,1989,5,910,2.0,642.0,642.0,5,1079,3.0,811.0,811.0
0.137,6,10,1506,5,395,31.0,127.0,127.0,5,1111,29.0,843.0,843.0
0.005,6,10,1643,5,860,1.0,592.0,592.0,5,783,1.0,515.0,515.0
0.078,6,10,1506,5,395,18.0,127.0,127.0,5,1111,18.0,843.0,843.0
0.038,6,10,1762,5,911,9.0,643.0,643.0,5,851,9.0,583.0,583.0
0.005,6,10,2006,5,927,1.0,659.0,659.0,5,1079,1.0,811.0,811.0
0.005,6,10,1689,5,839,1.0,571.0,571.0,5,850,1.0,582.0,582.0
0.013,17,2,152,1,56,0.0,28.0,28.0,1,96,0.0,68.0,68.0
9.037,17,6,376,5,280,2259.0,28.0,28.0,1,96,0.0,68.0,68.0
0.209,6,3,453,2,321,209.0,241.0,241.0,1,132,0.0,92.0,92.0
0.056,6,10,1506,5,395,11.0,127.0,127.0,5,1111,13.0,843.0,843.0
9.037,17,6,376,5,280,2259.0,28.0,28.0,1,96,0.0,68.0,68.0
0.09,6,10,1506,5,395,19.0,127.0,127.0,5,1111,19.0,843.0,843.0
0.121,6,10,1506,5,395,29.0,127.0,127.0,5,1111,26.0,843.0,843.0
1.003,6,12,3142,6,2099,151.0,1328.0,923.0,6,1043,151.0,791.0,791.0
10.795,17,28,4422,14,1994,821.0,269.0,114.0,14,2428,821.0,587.0,145.0
0.042,17,2,170,1,65,0.0,37.0,37.0,1,105,0.0,77.0,77.0
0.014,6,10,1972,5,910,3.0,642.0,642.0,5,1062,3.0,794.0,794.0
0.009,6,12,1926,6,1189,1.0,659.0,434.0,6,737,1.0,417.0,417.0
0.112,6,10,1506,5,395,27.0,127.0,127.0,5,1111,24.0,843.0,843.0
0.111,6,10,1506,5,395,24.0,127.0,127.0,5,1111,23.0,843.0,843.0
0.005,6,10,1989,5,927,1.0,659.0,659.0,5,1062,1.0,794.0,794.0
1755.904,6,105,6240,60,3510,29760.0,26.0,26.0,45,2730,39906.0,26.0,26.0
0.012,6,10,1989,5,910,2.0,642.0,642.0,5,1079,2.0,811.0,811.0
0.005,6,10,2000,5,927,1.0,659.0,659.0,5,1073,1.0,805.0,805.0
0.008,6,10,1989,5,910,2.0,642.0,642.0,5,1079,2.0,811.0,811.0
0.001,17,2,180,1,66,0.0,38.0,38.0,1,114,0.0,86.0,86.0
0.039,17,2,148,1,60,0.0,32.0,32.0,1,88,0.0,60.0,60.0
0.038,17,4,284,2,120,0.0,32.0,32.0,2,164,35.0,60.0,54.0
0.104,6,10,1506,5,395,22.0,127.0,127.0,5,1111,23.0,843.0,843.0
0.005,6,10,1689,5,839,1.0,571.0,571.0,5,850,1.0,582.0,582.0
0.107,6,10,1506,5,395,24.0,127.0,127.0,5,1111,24.0,843.0,843.0
0.005,17,2,180,1,58,0.0,30.0,30.0,1,122,0.0,94.0,94.0
0.005,17,2,157,1,59,0.0,31.0,31.0,1,98,0.0,70.0,70.0
0.006,17,2,166,1,75,0.0,47.0,47.0,1,91,0.0,63.0,63.0
0.012,6,10,1989,5,910,2.0,642.0,642.0,5,1079,2.0,811.0,811.0
0.004,6,10,2000,5,927,1.0,659.0,659.0,5,1073,1.0,805.0,805.0
0.005,6,10,1989,5,927,1.0,659.0,659.0,5,1062,1.0,794.0,794.0
0.006,17,2,136,1,60,0.0,32.0,32.0,1,76,0.0,48.0,48.0
0.004,17,2,148,1,60,0.0,32.0,32.0,1,88,0.0,60.0,60.0
360.031,6,21,3981,13,3142,30002.0,494.0,494.0,8,839,51432.0,83.0,83.0
0.082,6,10,1506,5,395,18.0,127.0,127.0,5,1111,19.0,843.0,843.0
0.021,6,10,1677,5,827,5.0,559.0,559.0,5,850,5.0,582.0,582.0
40.086,17,10,676,5,460,10020.0,104.0,64.0,5,216,10020.0,20.0,15.0
0.005,6,10,2000,5,927,1.0,659.0,659.0,5,1073,1.0,805.0,805.0
0.013,6,10,1972,5,910,3.0,642.0,642.0,5,1062,3.0,794.0,794.0
0.001,17,2,179,1,62,0.0,34.0,34.0,1,117,0.0,89.0,89.0
0.014,6,10,1989,5,910,3.0,642.0,642.0,5,1079,3.0,811.0,811.0
0.016,6,14,3868,7,578,2.0,206.0,206.0,7,3290,2.0,1448.0,972.0
352.243,6,20,2210,6,1308,12003.0,494.0,494.0,14,902,27095.0,83.0,83.0
0.1,6,10,1506,5,395,22.0,127.0,127.0,5,1111,18.0,843.0,843.0
0.091,6,10,1506,5,395,20.0,127.0,127.0,5,1111,20.0,843.0,843.0
0.005,6,10,2006,5,927,1.0,659.0,659.0,5,1079,1.0,811.0,811.0
0.005,6,10,1643,5,860,1.0,592.0,592.0,5,783,1.0,515.0,515.0
0.007,6,10,1547,5,764,1.0,496.0,496.0,5,783,1.0,515.0,515.0
0.005,6,10,1689,5,839,1.0,571.0,571.0,5,850,1.0,582.0,582.0
0.01,6,10,1989,5,910,2.0,642.0,642.0,5,1079,2.0,811.0,811.0
0.017,6,10,1631,5,848,4.0,580.0,580.0,5,783,4.0,515.0,515.0
0.001,17,2,174,1,72,0.0,44.0,44.0,1,102,0.0,74.0,74.0
0.009,6,10,1989,5,927,2.0,659.0,659.0,5,1062,2.0,794.0,794.0
0.034,6,10,1972,5,910,8.0,642.0,642.0,5,1062,8.0,794.0,794.0
0.129,17,2,80,1,32,0.0,4.0,4.0,1,48,0.0,20.0,20.0
0.078,6,10,1506,5,395,18.0,127.0,127.0,5,1111,13.0,843.0,843.0
0.009,6,10,1990,5,911,2.0,643.0,643.0,5,1079,2.0,811.0,811.0
266.379,6,40,10144,16,6777,17758.0,1849.0,661.0,24,3367,11581.0,580.0,140.0
0.006,6,10,1643,5,860,1.0,592.0,592.0,5,783,1.0,515.0,515.0
0.011,6,10,1677,5,827,2.0,559.0,559.0,5,850,2.0,582.0,582.0
0.003,6,10,1702,5,863,0.0,595.0,595.0,5,839,0.0,571.0,571.0
0.007,6,10,1547,5,764,1.0,496.0,496.0,5,783,1.0,515.0,515.0
0.022,6,13,3735,7,497,3.0,125.0,125.0,6,3238,4.0,1470.0,1459.0
0.011,6,10,1989,5,910,2.0,642.0,642.0,5,1079,2.0,811.0,811.0
0.004,17,2,132,1,58,0.0,30.0,30.0,1,74,0.0,46.0,46.0
0.066,17,8,3613,4,1874,22.0,1350.0,440.0,4,1739,11.0,1350.0,406.0
0.04,17,2,136,1,60,0.0,32.0,32.0,1,76,0.0,48.0,48.0
0.092,6,10,1506,5,395,20.0,127.0,127.0,5,1111,18.0,843.0,843.0
0.001,17,2,140,1,62,0.0,34.0,34.0,1,78,0.0,50.0,50.0
0.006,6,10,1854,5,889,1.0,621.0,621.0,5,965,1.0,697.0,697.0
0.015,17,2,150,1,67,0.0,39.0,39.0,1,83,0.0,55.0,55.0
0.005,17,2,225,1,65,0.0,37.0,37.0,1,160,0.0,132.0,132.0
8.771,6,34,9691,17,4213,548.0,1498.0,875.0,17,5478,535.0,2667.0,435.0
0.008,6,10,2007,5,928,2.0,660.0,660.0,5,1079,1.0,811.0,811.0
0.008,6,10,1983,5,910,1.0,642.0,642.0,5,1073,2.0,805.0,805.0
0.041,17,2,152,1,76,0.0,48.0,48.0,1,76,0.0,48.0,48.0
0.005,6,10,1989,5,927,1.0,659.0,659.0,5,1062,1.0,794.0,794.0
15.079,17,16,8270,8,6051,2150.0,1350.0,728.0,8,2219,2149.0,1350.0,249.0
0.104,6,10,1506,5,395,24.0,127.0,127.0,5,1111,24.0,843.0,843.0
0.002,17,2,152,1,76,0.0,48.0,48.0,1,76,0.0,48.0,48.0
0.008,6,10,1990,5,911,1.0,643.0,643.0,5,1079,1.0,811.0,811.0
0.006,6,10,2007,5,928,1.0,660.0,660.0,5,1079,1.0,811.0,811.0
0.005,6,10,2006,5,927,1.0,659.0,659.0,5,1079,1.0,811.0,811.0
0.005,17,2,180,1,66,0.0,38.0,38.0,1,114,0.0,86.0,86.0
0.012,6,10,1989,5,910,2.0,642.0,642.0,5,1079,2.0,811.0,811.0
0.008,17,2,136,1,60,0.0,32.0,32.0,1,76,0.0,48.0,48.0
0.004,17,4,284,2,120,0.0,32.0,32.0,2,164,0.0,60.0,54.0
0.003,17,2,185,1,73,0.0,45.0,45.0,1,112,0.0,84.0,84.0
0.073,6,10,1506,5,395,16.0,127.0,127.0,5,1111,17.0,843.0,843.0
0.072,17,4,420,2,122,0.0,33.0,33.0,2,298,69.0,145.0,121.0
0.056,17,2,179,1,71,0.0,43.0,43.0,1,108,0.0,80.0,80.0
0.005,6,10,2007,5,928,1.0,660.0,660.0,5,1079,1.0,811.0,811.0
0.005,6,14,3736,7,446,0.0,74.0,74.0,7,3290,0.0,1448.0,972.0
0.172,17,2,152,1,76,0.0,48.0,48.0,1,76,0.0,48.0,48.0
0.016,6,13,3735,7,497,2.0,125.0,125.0,6,3238,3.0,1470.0,1459.0
354.103,6,21,1795,16,1030,23606.0,190.0,190.0,5,765,60004.0,464.0,248.0
0.734,6,22,5072,11,1250,62.0,325.0,133.0,11,3822,62.0,1414.0,563.0
0.012,6,14,3787,7,497,1.0,125.0,125.0,7,3290,1.0,1448.0,972.0
0.009,17,2,212,1,74,0.0,46.0,46.0,1,138,0.0,110.0,110.0
0.011,6,13,3735,7,497,1.0,125.0,125.0,6,3238,2.0,1470.0,1459.0
0.164,17,2,152,1,76,0.0,48.0,48.0,1,76,0.0,48.0,48.0
0.127,17,4,596,2,122,0.0,33.0,33.0,2,474,87.0,323.0,209.0
369.363,6,22,2313,16,867,24624.0,195.0,195.0,6,1446,4638.0,419.0,398.0
0.001,17,2,180,1,66,0.0,38.0,38.0,1,114,0.0,86.0,86.0
0.013,6,10,1989,5,910,3.0,642.0,642.0,5,1079,3.0,811.0,811.0
0.006,17,2,169,1,62,0.0,34.0,34.0,1,107,0.0,79.0,79.0
0.018,6,10,1989,5,910,4.0,642.0,642.0,5,1079,4.0,811.0,811.0
0.173,17,2,152,1,76,0.0,48.0,48.0,1,76,0.0,48.0,48.0
2.142,6,19,3180,11,1583,214.0,593.0,252.0,8,1597,305.0,644.0,293.0
40.055,17,10,676,5,460,10013.0,104.0,64.0,5,216,10012.0,20.0,15.0
0.005,6,10,1989,5,927,1.0,659.0,659.0,5,1062,1.0,794.0,794.0
0.092,6,10,1506,5,395,19.0,127.0,127.0,5,1111,20.0,843.0,843.0
0.008,6,14,3787,7,497,1.0,125.0,125.0,7,3290,1.0,1448.0,972.0
0.006,6,12,1698,6,863,1.0,327.0,271.0,6,835,1.0,515.0,515.0
0.084,6,10,1506,5,395,16.0,127.0,127.0,5,1111,18.0,843.0,843.0
240.014,6,9,787,5,488,60003.0,232.0,232.0,4,299,80003.0,83.0,83.0
0.067,6,10,1506,5,395,13.0,127.0,127.0,5,1111,15.0,843.0,843.0
0.003,17,2,170,1,65,0.0,37.0,37.0,1,105,0.0,77.0,77.0
0.005,17,2,136,1,60,0.0,32.0,32.0,1,76,0.0,48.0,48.0
0.012,6,10,1983,5,910,3.0,642.0,642.0,5,1073,3.0,805.0,805.0
0.0,17,2,154,1,69,0.0,41.0,41.0,1,85,0.0,57.0,57.0
15.326,17,18,8513,9,6347,1906.0,1350.0,677.0,9,2166,1909.0,1350.0,212.0
0.08,6,10,1506,5,395,19.0,127.0,127.0,5,1111,18.0,843.0,843.0
0.006,6,10,2000,5,927,1.0,659.0,659.0,5,1073,1.0,805.0,805.0
0.011,6,10,1989,5,910,2.0,642.0,642.0,5,1079,2.0,811.0,811.0
0.005,6,10,1689,5,839,1.0,571.0,571.0,5,850,1.0,582.0,582.0
40.056,17,10,676,5,460,10013.0,104.0,64.0,5,216,10013.0,20.0,15.0
40.06,17,10,676,5,460,10013.0,104.0,64.0,5,216,10014.0,20.0,15.0
0.041,17,2,234,1,61,0.0,33.0,33.0,1,173,0.0,145.0,145.0
0.004,17,2,148,1,60,0.0,32.0,32.0,1,88,0.0,60.0,60.0
0.005,6,10,2006,5,927,1.0,659.0,659.0,5,1079,1.0,811.0,811.0
0.073,6,10,1506,5,395,16.0,127.0,127.0,5,1111,14.0,843.0,843.0
0.005,6,10,2006,5,927,1.0,659.0,659.0,5,1079,1.0,811.0,811.0
0.004,17,2,144,1,64,0.0,36.0,36.0,1,80,0.0,52.0,52.0
0.075,6,10,1506,5,395,17.0,127.0,127.0,5,1111,17.0,843.0,843.0
0.005,17,2,164,1,74,0.0,46.0,46.0,1,90,0.0,62.0,62.0
0.103,6,10,1506,5,395,24.0,127.0,127.0,5,1111,23.0,843.0,843.0
0.017,6,13,3735,7,497,2.0,125.0,125.0,6,3238,3.0,1470.0,1459.0
0.009,6,10,1989,5,910,2.0,642.0,642.0,5,1079,2.0,811.0,811.0
0.001,17,2,136,1,60,0.0,32.0,32.0,1,76,0.0,48.0,48.0
0.01,6,10,1990,5,911,2.0,643.0,643.0,5,1079,2.0,811.0,811.0
0.005,6,10,2007,5,928,1.0,660.0,660.0,5,1079,1.0,811.0,811.0
0.007,17,2,214,1,75,0.0,47.0,47.0,1,139,0.0,111.0,111.0
0.008,6,10,1990,5,911,1.0,643.0,643.0,5,1079,2.0,811.0,811.0
0.019,6,10,1990,5,911,4.0,643.0,643.0,5,1079,4.0,811.0,811.0
0.003,17,2,148,1,60,0.0,32.0,32.0,1,88,0.0,60.0,60.0
0.005,6,10,1702,5,863,1.0,595.0,595.0,5,839,1.0,571.0,571.0
0.008,6,12,1926,6,1189,1.0,659.0,434.0,6,737,1.0,417.0,417.0
0.114,6,10,1506,5,395,25.0,127.0,127.0,5,1111,25.0,843.0,843.0
0.004,17,2,148,1,60,0.0,32.0,32.0,1,88,0.0,60.0,60.0
0.004,17,4,284,2,120,1.0,32.0,32.0,2,164,0.0,60.0,54.0
0.009,6,10,1990,5,911,2.0,643.0,643.0,5,1079,2.0,811.0,811.0
0.069,6,10,1506,5,395,15.0,127.0,127.0,5,1111,14.0,843.0,843.0
60.126,6,36,8600,18,2129,509.0,1021.0,459.0,18,6471,3529.0,2720.0,478.0
0.006,6,10,1989,5,927,1.0,659.0,659.0,5,1062,1.0,794.0,794.0
0.013,6,10,1972,5,910,3.0,642.0,642.0,5,1062,3.0,794.0,794.0
0.005,6,10,1779,5,928,1.0,660.0,660.0,5,851,1.0,583.0,583.0
0.004,6,10,2007,5,928,1.0,660.0,660.0,5,1079,1.0,811.0,811.0
0.139,6,10,1506,5,395,28.0,127.0,127.0,5,1111,30.0,843.0,843.0
0.006,6,10,1547,5,764,1.0,496.0,496.0,5,783,1.0,515.0,515.0
0.018,6,10,1990,5,911,4.0,643.0,643.0,5,1079,4.0,811.0,811.0
0.007,17,2,175,1,65,0.0,37.0,37.0,1,110,0.0,82.0,82.0
0.004,17,2,148,1,60,0.0,32.0,32.0,1,88,0.0,60.0,60.0
0.079,6,10,1506,5,395,14.0,127.0,127.0,5,1111,17.0,843.0,843.0
0.006,6,10,1689,5,839,1.0,571.0,571.0,5,850,1.0,582.0,582.0
0.031,6,14,3787,7,497,5.0,125.0,125.0,7,3290,5.0,1448.0,972.0
0.006,6,10,1689,5,839,1.0,571.0,571.0,5,850,1.0,582.0,582.0
0.016,6,10,1983,5,910,4.0,642.0,642.0,5,1073,4.0,805.0,805.0
0.014,6,10,1989,5,910,3.0,642.0,642.0,5,1079,3.0,811.0,811.0
0.125,6,10,1506,5,395,28.0,127.0,127.0,5,1111,27.0,843.0,843.0
0.006,6,10,1547,5,764,1.0,496.0,496.0,5,783,1.0,515.0,515.0
0.074,6,10,1506,5,395,16.0,127.0,127.0,5,1111,18.0,843.0,843.0
0.011,6,10,1990,5,911,2.0,643.0,643.0,5,1079,2.0,811.0,811.0
0.077,6,10,1506,5,395,17.0,127.0,127.0,5,1111,17.0,843.0,843.0
0.005,6,10,2006,5,927,1.0,659.0,659.0,5,1079,1.0,811.0,811.0
0.014,6,10,1983,5,910,3.0,642.0,642.0,5,1073,3.0,805.0,805.0
0.015,6,10,1972,5,910,3.0,642.0,642.0,5,1062,3.0,794.0,794.0
177.162,17,76,10890,38,2538,4787.0,44.0,38.0,38,8352,4787.0,249.0,191.0
40.077,17,10,676,5,460,10012.0,104.0,64.0,5,216,10018.0,20.0,15.0
0.094,6,10,1506,5,395,21.0,127.0,127.0,5,1111,21.0,843.0,843.0
0.007,6,10,1990,5,911,1.0,643.0,643.0,5,1079,1.0,811.0,811.0
0.011,6,10,1762,5,911,2.0,643.0,643.0,5,851,2.0,583.0,583.0
0.007,17,2,179,1,71,0.0,43.0,43.0,1,108,0.0,80.0,80.0
0.123,17,2,80,1,32,0.0,4.0,4.0,1,48,0.0,20.0,20.0
0.016,6,10,1972,5,910,4.0,642.0,642.0,5,1062,3.0,794.0,794.0
0.039,17,2,412,1,61,0.0,33.0,33.0,1,351,0.0,323.0,323.0
0.006,6,10,2006,5,927,1.0,659.0,659.0,5,1079,1.0,811.0,811.0
0.005,6,10,2000,5,927,1.0,659.0,659.0,5,1073,1.0,805.0,805.0
0.669,6,25,8874,14,1587,42.0,517.0,211.0,11,7287,55.0,2074.0,959.0
0.005,17,2,209,1,64,0.0,36.0,36.0,1,145,0.0,117.0,117.0
356.626,6,21,1795,16,1030,23775.0,190.0,190.0,5,765,60003.0,464.0,248.0
0.008,6,10,1677,5,827,2.0,559.0,559.0,5,850,1.0,582.0,582.0
0.085,6,10,1506,5,395,18.0,127.0,127.0,5,1111,16.0,843.0,843.0
0.089,6,10,1506,5,395,20.0,127.0,127.0,5,1111,18.0,843.0,843.0
0.006,6,10,1547,5,764,1.0,496.0,496.0,5,783,1.0,515.0,515.0
0.01,6,10,1989,5,910,2.0,642.0,642.0,5,1079,2.0,811.0,811.0
326.135,6,19,2158,6,1308,12003.0,494.0,494.0,13,850,27177.0,83.0,83.0
40.056,17,10,676,5,460,10013.0,104.0,64.0,5,216,10012.0,20.0,15.0
0.011,6,10,1972,5,910,2.0,642.0,642.0,5,1062,2.0,794.0,794.0
0.005,17,2,169,1,62,0.0,34.0,34.0,1,107,0.0,79.0,79.0
0.004,6,10,2006,5,927,1.0,659.0,659.0,5,1079,1.0,811.0,811.0
0.005,6,10,1774,5,923,1.0,655.0,655.0,5,851,1.0,583.0,583.0
0.015,6,10,1762,5,911,3.0,643.0,643.0,5,851,3.0,583.0,583.0
0.039,17,2,152,1,76,0.0,48.0,48.0,1,76,0.0,48.0,48.0
0.005,6,10,1989,5,927,1.0,659.0,659.0,5,1062,1.0,794.0,794.0
40.066,17,10,676,5,460,10014.0,104.0,64.0,5,216,10015.0,20.0,15.0
0.004,17,2,234,1,61,0.0,33.0,33.0,1,173,0.0,145.0,145.0
0.006,6,10,1854,5,889,1.0,621.0,621.0,5,965,1.0,697.0,697.0
40.075,17,10,676,5,460,10015.0,104.0,64.0,5,216,10018.0,20.0,15.0
0.003,17,2,148,1,60,0.0,32.0,32.0,1,88,0.0,60.0,60.0
0.004,6,15,3794,8,504,0.0,80.0,80.0,7,3290,0.0,1448.0,972.0
0.096,6,10,1506,5,395,21.0,127.0,127.0,5,1111,20.0,843.0,843.0
0.017,6,10,1989,5,910,4.0,642.0,642.0,5,1079,4.0,811.0,811.0
0.009,6,10,1983,5,910,2.0,642.0,642.0,5,1073,2.0,805.0,805.0
0.004,6,10,1989,5,927,1.0,659.0,659.0,5,1062,1.0,794.0,794.0
1778.369,17,144,45504,72,22752,25046.0,288.0,288.0,72,22752,25046.0,288.0,288.0
0.009,6,10,1989,5,910,2.0,642.0,642.0,5,1079,2.0,811.0,811.0
0.005,6,10,2007,5,928,1.0,660.0,660.0,5,1079,1.0,811.0,811.0
0.005,6,10,2006,5,927,1.0,659.0,659.0,5,1079,1.0,811.0,811.0
308.501,17,20,1124,10,716,34263.0,48.0,43.0,10,408,34263.0,20.0,12.0
0.011,6,10,1972,5,910,2.0,642.0,642.0,5,1062,2.0,794.0,794.0
0.004,6,10,2007,5,928,1.0,660.0,660.0,5,1079,1.0,811.0,811.0
1755.989,6,105,6258,60,3519,29761.0,27.0,26.0,45,2739,39907.0,27.0,26.0
0.04,17,2,186,1,61,0.0,33.0,33.0,1,125,0.0,97.0,97.0
0.214,6,16,2777,8,1395,30.0,533.0,323.0,8,1382,19.0,529.0,239.0
0.006,6,10,1989,5,927,1.0,659.0,659.0,5,1062,1.0,794.0,794.0
0.004,17,2,148,1,60,0.0,32.0,32.0,1,88,0.0,60.0,60.0
0.077,17,2,136,1,60,0.0,32.0,32.0,1,76,0.0,48.0,48.0
0.005,6,10,2006,5,927,1.0,659.0,659.0,5,1079,1.0,811.0,811.0
0.005,17,2,179,1,71,0.0,43.0,43.0,1,108,0.0,80.0,80.0
0.013,6,10,1972,5,910,3.0,642.0,642.0,5,1062,3.0,794.0,794.0
0.006,6,10,1547,5,764,1.0,496.0,496.0,5,783,1.0,515.0,515.0
0.003,17,2,136,1,60,0.0,32.0,32.0,1,76,0.0,48.0,48.0
0.009,6,10,1990,5,911,2.0,643.0,643.0,5,1079,2.0,811.0,811.0
300.425,6,16,2170,9,684,37533.0,146.0,146.0,7,1486,50043.0,419.0,398.0
0.021,6,10,1631,5,848,5.0,580.0,580.0,5,783,5.0,515.0,515.0
240.701,6,37,9656,19,2174,13370.0,746.0,235.0,18,7482,14156.0,1402.0,595.0
15.078,17,15,8006,8,5983,2150.0,1350.0,719.0,7,2023,2508.0,1350.0,261.0
0.005,6,10,1989,5,927,1.0,659.0,659.0,5,1062,1.0,794.0,794.0
0.021,6,10,1989,5,910,5.0,642.0,642.0,5,1079,5.0,811.0,811.0
11.18,17,28,4421,14,1993,847.0,268.0,114.0,14,2428,847.0,587.0,145.0
1723.238,6,61,7130,40,4333,44185.0,1626.0,112.0,21,2797,86153.0,1116.0,85.0
0.001,17,2,179,1,62,0.0,34.0,34.0,1,117,0.0,89.0,89.0
0.001,17,2,166,1,75,0.0,47.0,47.0,1,91,0.0,63.0,63.0
0.004,6,10,2000,5,927,1.0,659.0,659.0,5,1073,1.0,805.0,805.0
0.002,17,2,136,1,60,0.0,32.0,32.0,1,76,0.0,48.0,48.0
0.009,6,13,3735,7,497,1.0,125.0,125.0,6,3238,1.0,1470.0,1459.0
0.085,6,10,1506,5,395,18.0,127.0,127.0,5,1111,16.0,843.0,843.0
0.014,6,10,1762,5,911,3.0,643.0,643.0,5,851,3.0,583.0,583.0
0.001,17,2,180,1,66,0.0,38.0,38.0,1,114,0.0,86.0,86.0
0.006,6,10,1854,5,889,1.0,621.0,621.0,5,965,1.0,697.0,697.0
0.013,6,10,1762,5,911,3.0,643.0,643.0,5,851,3.0,583.0,583.0
0.009,6,10,1990,5,911,2.0,643.0,643.0,5,1079,2.0,811.0,811.0
0.001,17,2,180,1,66,0.0,38.0,38.0,1,114,0.0,86.0,86.0
290.57,6,372,346574,189,21398,1545.0,2736.0,825.0,183,325176,1596.0,4206.0,1867.0
40.072,17,10,676,5,460,10017.0,104.0,64.0,5,216,10017.0,20.0,15.0
0.005,6,10,2006,5,927,1.0,659.0,659.0,5,1079,1.0,811.0,811.0
0.024,6,10,1972,5,910,5.0,642.0,642.0,5,1062,6.0,794.0,794.0
0.217,6,16,2777,8,1395,31.0,533.0,323.0,8,1382,20.0,529.0,239.0
10.75,17,28,4422,14,1994,818.0,269.0,114.0,14,2428,817.0,587.0,145.0
0.014,6,10,1762,5,911,3.0,643.0,643.0,5,851,3.0,583.0,583.0
0.004,6,10,2007,5,928,1.0,660.0,660.0,5,1079,1.0,811.0,811.0
0.008,6,10,1989,5,910,2.0,642.0,642.0,5,1079,2.0,811.0,811.0
176.433,17,72,10042,36,2400,5040.0,44.0,38.0,36,7642,5040.0,261.0,184.0
0.009,6,10,1972,5,910,2.0,642.0,642.0,5,1062,2.0,794.0,794.0
0.066,17,8,3613,4,1874,22.0,1350.0,440.0,4,1739,10.0,1350.0,406.0
0.077,6,10,1506,5,395,18.0,127.0,127.0,5,1111,17.0,843.0,843.0
0.005,6,10,1989,5,927,1.0,659.0,659.0,5,1062,1.0,794.0,794.0
0.011,6,10,1762,5,911,2.0,643.0,643.0,5,851,2.0,583.0,583.0
15.076,17,15,9238,8,6902,2149.0,1350.0,834.0,7,2336,2507.0,1350.0,305.0
0.096,6,10,1506,5,395,16.0,127.0,127.0,5,1111,21.0,843.0,843.0
0.01,6,10,1972,5,910,2.0,642.0,642.0,5,1062,2.0,794.0,794.0
0.015,6,10,1972,5,910,3.0,642.0,642.0,5,1062,3.0,794.0,794.0
0.005,6,10,2006,5,927,1.0,659.0,659.0,5,1079,1.0,811.0,811.0
0.017,6,6,716,3,458,7.0,302.0,302.0,3,258,6.0,102.0,102.0
0.003,17,2,148,1,60,0.0,32.0,32.0,1,88,0.0,60.0,60.0
0.004,17,2,148,1,60,0.0,32.0,32.0,1,88,0.0,60.0,60.0
0.083,6,10,1506,5,395,19.0,127.0,127.0,5,1111,14.0,843.0,843.0
0.005,6,10,1774,5,923,1.0,655.0,655.0,5,851,1.0,583.0,583.0
0.006,6,10,1547,5,764,1.0,496.0,496.0,5,783,1.0,515.0,515.0
0.012,6,10,1990,5,911,2.0,643.0,643.0,5,1079,3.0,811.0,811.0
0.01,6,10,1677,5,827,2.0,559.0,559.0,5,850,2.0,582.0,582.0
0.004,6,10,1989,5,927,1.0,659.0,659.0,5,1062,1.0,794.0,794.0
0.07,17,2,156,1,64,0.0,36.0,36.0,1,92,0.0,64.0,64.0
0.005,6,10,1689,5,839,1.0,571.0,571.0,5,850,1.0,582.0,582.0
0.01,6,10,1989,5,910,2.0,642.0,642.0,5,1079,2.0,811.0,811.0
0.137,6,10,1506,5,395,31.0,127.0,127.0,5,1111,33.0,843.0,843.0
0.005,6,10,2000,5,927,1.0,659.0,659.0,5,1073,1.0,805.0,805.0
40.063,17,10,676,5,460,10012.0,104.0,64.0,5,216,10014.0,20.0,15.0
0.005,6,10,2007,5,928,1.0,660.0,660.0,5,1079,1.0,811.0,811.0
352.247,6,20,2210,6,1308,12004.0,494.0,494.0,14,902,27095.0,83.0,83.0
0.005,6,10,1643,5,860,1.0,592.0,592.0,5,783,1.0,515.0,515.0
0.117,6,10,1506,5,395,28.0,127.0,127.0,5,1111,27.0,843.0,843.0
0.003,17,2,136,1,60,0.0,32.0,32.0,1,76,0.0,48.0,48.0
40.07,17,10,676,5,460,10014.0,104.0,64.0,5,216,10016.0,20.0,15.0
40.091,17,10,676,5,460,10020.0,104.0,64.0,5,216,10022.0,20.0,15.0
0.004,6,10,2007,5,928,1.0,660.0,660.0,5,1079,1.0,811.0,811.0
0.008,6,10,1989,5,927,1.0,659.0,659.0,5,1062,2.0,794.0,794.0
0.005,6,10,2006,5,927,1.0,659.0,659.0,5,1079,1.0,811.0,811.0
240.09,6,16,4482,9,963,30011.0,238.0,166.0,7,3519,40014.0,1402.0,786.0
0.1,6,10,1506,5,395,19.0,127.0,127.0,5,1111,23.0,843.0,843.0
0.009,6,10,1972,5,910,2.0,642.0,642.0,5,1062,2.0,794.0,794.0
0.003,17,2,136,1,60,0.0,32.0,32.0,1,76,0.0,48.0,48.0
0.001,17,2,166,1,75,0.0,47.0,47.0,1,91,0.0,63.0,63.0
0.04,17,4,596,2,122,1.0,33.0,33.0,2,474,2.0,323.0,209.0
0.004,6,10,2007,5,928,1.0,660.0,660.0,5,1079,1.0,811.0,811.0
0.011,6,10,1989,5,910,2.0,642.0,642.0,5,1079,2.0,811.0,811.0
0.015,6,10,1990,5,911,3.0,643.0,643.0,5,1079,3.0,811.0,811.0
0.009,6,13,3735,7,497,1.0,125.0,125.0,6,3238,1.0,1470.0,1459.0
0.005,6,10,1779,5,928,1.0,660.0,660.0,5,851,1.0,583.0,583.0
318.722,6,33,10337,18,3193,18748.0,866.0,449.0,15,7144,22765.0,2369.0,796.0
40.065,17,10,676,5,460,10013.0,104.0,64.0,5,216,10015.0,20.0,15.0
0.005,6,10,2000,5,927,1.0,659.0,659.0,5,1073,1.0,805.0,805.0
240.089,6,16,4482,9,963,30011.0,238.0,166.0,7,3519,40014.0,1402.0,786.0
0.005,17,2,164,1,74,0.0,46.0,46.0,1,90,0.0,62.0,62.0
0.131,17,2,152,1,76,0.0,48.0,48.0,1,76,0.0,48.0,48.0
0.005,6,10,2007,5,928,1.0,660.0,660.0,5,1079,1.0,811.0,811.0
0.009,6,10,1983,5,910,2.0,642.0,642.0,5,1073,2.0,805.0,805.0
0.015,6,10,1983,5,910,3.0,642.0,642.0,5,1073,3.0,805.0,805.0
0.005,6,10,2006,5,927,1.0,659.0,659.0,5,1079,1.0,811.0,811.0
0.008,6,10,1689,5,839,2.0,571.0,571.0,5,850,2.0,582.0,582.0
0.003,17,4,284,2,120,0.0,32.0,32.0,2,164,0.0,60.0,54.0
0.011,6,10,1989,5,910,2.0,642.0,642.0,5,1079,2.0,811.0,811.0
0.013,17,2,213,1,69,0.0,41.0,41.0,1,144,0.0,116.0,116.0
0.01,6,6,716,3,458,4.0,302.0,302.0,3,258,3.0,102.0,102.0
0.005,6,10,1989,5,927,1.0,659.0,659.0,5,1062,1.0,794.0,794.0
0.018,6,10,1989,5,910,4.0,642.0,642.0,5,1079,4.0,811.0,811.0
0.014,6,14,3787,7,497,2.0,125.0,125.0,7,3290,2.0,1448.0,972.0
0.117,6,10,1506,5,395,21.0,127.0,127.0,5,1111,20.0,843.0,843.0
0.005,6,10,2006,5,927,1.0,659.0,659.0,5,1079,1.0,811.0,811.0
0.009,6,10,1779,5,928,2.0,660.0,660.0,5,851,2.0,583.0,583.0
40.078,17,10,676,5,460,10016.0,104.0,64.0,5,216,10018.0,20.0,15.0
0.006,6,10,2006,5,927,1.0,659.0,659.0,5,1079,1.0,811.0,811.0
1772.479,6,105,6270,60,3525,30041.0,27.0,27.0,45,2745,40282.0,27.0,27.0
0.008,6,10,1972,5,910,1.0,642.0,642.0,5,1062,1.0,794.0,794.0
0.005,6,10,2007,5,928,1.0,660.0,660.0,5,1079,1.0,811.0,811.0
40.075,17,10,676,5,460,10018.0,104.0,64.0,5,216,10017.0,20.0,15.0
0.121,6,10,1506,5,395,22.0,127.0,127.0,5,1111,29.0,843.0,843.0
0.087,6,10,1506,5,395,20.0,127.0,127.0,5,1111,20.0,843.0,843.0
0.006,6,10,1547,5,764,1.0,496.0,496.0,5,783,1.0,515.0,515.0
0.001,17,2,180,1,66,0.0,38.0,38.0,1,114,0.0,86.0,86.0
0.005,6,10,1989,5,927,1.0,659.0,659.0,5,1062,1.0,794.0,794.0
0.057,6,10,1506,5,395,13.0,127.0,127.0,5,1111,13.0,843.0,843.0
0.004,6,10,2000,5,927,1.0,659.0,659.0,5,1073,1.0,805.0,805.0
0.021,6,10,1972,5,910,5.0,642.0,642.0,5,1062,5.0,794.0,794.0
40.081,17,10,676,5,460,10017.0,104.0,64.0,5,216,10019.0,20.0,15.0
0.153,17,2,144,1,64,0.0,36.0,36.0,1,80,0.0,52.0,52.0
243.335,6,401,349060,193,21566,1267.0,2736.0,960.0,208,327494,1175.0,2948.0,1599.0
0.04,17,2,152,1,76,0.0,48.0,48.0,1,76,0.0,48.0,48.0
0.072,17,2,156,1,64,0.0,36.0,36.0,1,92,0.0,64.0,64.0
0.005,6,10,2007,5,928,1.0,660.0,660.0,5,1079,1.0,811.0,811.0
0.005,6,10,2007,5,928,1.0,660.0,660.0,5,1079,1.0,811.0,811.0
0.006,6,10,1547,5,764,1.0,496.0,496.0,5,783,1.0,515.0,515.0
0.006,6,10,1547,5,764,1.0,496.0,496.0,5,783,1.0,515.0,515.0
0.006,6,10,1547,5,764,1.0,496.0,496.0,5,783,1.0,515.0,515.0
0.014,6,10,1989,5,910,3.0,642.0,642.0,5,1079,3.0,811.0,811.0
0.068,6,43,13928,24,2503,2.0,517.0,139.0,19,11425,3.0,1402.0,802.0
0.01,6,10,1983,5,910,2.0,642.0,642.0,5,1073,2.0,805.0,805.0
0.005,6,10,1989,5,927,1.0,659.0,659.0,5,1062,1.0,794.0,794.0
300.808,6,39,10003,21,4440,15040.0,3172.0,889.0,18,5563,508.0,2667.0,402.0
0.011,6,10,1989,5,910,2.0,642.0,642.0,5,1079,2.0,811.0,811.0
95.659,6,24,9313,13,1655,7971.0,794.0,367.0,11,7658,9552.0,1360.0,1029.0
0.003,17,2,136,1,60,0.0,32.0,32.0,1,76,0.0,48.0,48.0
0.81,6,22,5168,11,1138,68.0,267.0,115.0,11,4030,68.0,1414.0,597.0
0.014,6,10,1989,5,910,3.0,642.0,642.0,5,1079,3.0,811.0,811.0
126.915,6,22,8496,12,2236,73.0,1345.0,574.0,10,6260,14082.0,2720.0,974.0
0.078,6,10,1506,5,395,18.0,127.0,127.0,5,1111,17.0,843.0,843.0
0.001,17,2,136,1,60,0.0,32.0,32.0,1,76,0.0,48.0,48.0
0.021,17,2,179,1,71,0.0,43.0,43.0,1,108,0.0,80.0,80.0
0.018,6,10,1972,5,910,4.0,642.0,642.0,5,1062,4.0,794.0,794.0
0.037,17,2,152,1,76,0.0,48.0,48.0,1,76,0.0,48.0,48.0
300.306,6,16,2170,9,684,37518.0,146.0,146.0,7,1486,50023.0,419.0,398.0
0.006,6,10,1547,5,764,1.0,496.0,496.0,5,783,1.0,515.0,515.0
379.225,6,22,2313,16,867,25281.0,195.0,195.0,6,1446,4634.0,419.0,398.0
171.087,17,70,9917,35,2322,5031.0,44.0,38.0,35,7595,5031.0,239.0,189.0
0.004,6,10,2006,5,927,1.0,659.0,659.0,5,1079,1.0,811.0,811.0
40.013,17,10,676,5,460,10002.0,104.0,64.0,5,216,10001.0,20.0,15.0
0.105,6,10,1506,5,395,18.0,127.0,127.0,5,1111,24.0,843.0,843.0
11.28,17,28,4417,14,1993,855.0,268.0,114.0,14,2424,855.0,587.0,145.0
0.001,17,2,180,1,66,0.0,38.0,38.0,1,114,0.0,86.0,86.0
0.011,17,2,136,1,60,0.0,32.0,32.0,1,76,0.0,48.0,48.0
0.005,6,10,2007,5,928,1.0,660.0,660.0,5,1079,1.0,811.0,811.0
0.105,6,10,1506,5,395,24.0,127.0,127.0,5,1111,22.0,843.0,843.0
0.006,6,10,1547,5,764,1.0,496.0,496.0,5,783,1.0,515.0,515.0
240.082,6,16,4482,9,963,30010.0,238.0,166.0,7,3519,40013.0,1402.0,786.0
1778.221,17,144,45504,72,22752,25045.0,288.0,288.0,72,22752,25045.0,288.0,288.0
0.001,17,2,180,1,66,0.0,38.0,38.0,1,114,0.0,86.0,86.0
0.006,6,10,2006,5,927,1.0,659.0,659.0,5,1079,1.0,811.0,811.0
0.005,17,2,213,1,69,0.0,41.0,41.0,1,144,0.0,116.0,116.0
10.767,17,28,4418,14,1994,819.0,269.0,114.0,14,2424,819.0,587.0,145.0
0.041,17,2,170,1,65,0.0,37.0,37.0,1,105,0.0,77.0,77.0
0.01,6,10,1983,5,910,2.0,642.0,642.0,5,1073,2.0,805.0,805.0
0.005,17,2,164,1,74,0.0,46.0,46.0,1,90,0.0,62.0,62.0
0.006,17,2,170,1,65,0.0,37.0,37.0,1,105,0.0,77.0,77.0
0.005,6,10,1689,5,839,1.0,571.0,571.0,5,850,1.0,582.0,582.0
0.01,6,10,1990,5,911,2.0,643.0,643.0,5,1079,2.0,811.0,811.0
0.004,6,10,2006,5,927,1.0,659.0,659.0,5,1079,1.0,811.0,811.0
0.113,6,10,1506,5,395,25.0,127.0,127.0,5,1111,23.0,843.0,843.0
0.003,17,2,148,1,60,0.0,32.0,32.0,1,88,0.0,60.0,60.0
0.008,6,10,1972,5,910,2.0,642.0,642.0,5,1062,1.0,794.0,794.0
0.015,6,10,1983,5,910,3.0,642.0,642.0,5,1073,3.0,805.0,805.0
177.499,17,86,12387,43,2888,4226.0,44.0,39.0,43,9499,4226.0,261.0,192.0
0.001,17,2,180,1,66,0.0,38.0,38.0,1,114,0.0,86.0,86.0
0.005,6,10,2006,5,927,1.0,659.0,659.0,5,1079,1.0,811.0,811.0
0.004,6,10,1702,5,863,1.0,595.0,595.0,5,839,1.0,571.0,571.0
10.784,17,28,4422,14,1993,820.0,268.0,114.0,14,2429,820.0,588.0,145.0
0.005,6,10,2006,5,927,1.0,659.0,659.0,5,1079,1.0,811.0,811.0
0.01,6,10,1989,5,910,2.0,642.0,642.0,5,1079,2.0,811.0,811.0
0.123,6,10,1506,5,395,26.0,127.0,127.0,5,1111,25.0,843.0,843.0
0.004,6,10,1702,5,863,1.0,595.0,595.0,5,839,0.0,571.0,571.0
0.004,6,10,1779,5,928,1.0,660.0,660.0,5,851,1.0,583.0,583.0
0.085,6,10,1506,5,395,18.0,127.0,127.0,5,1111,20.0,843.0,843.0
0.007,6,10,1990,5,911,1.0,643.0,643.0,5,1079,1.0,811.0,811.0
40.059,17,10,676,5,460,10013.0,104.0,64.0,5,216,10013.0,20.0,15.0
0.008,6,10,1779,5,928,2.0,660.0,660.0,5,851,2.0,583.0,583.0
0.004,6,10,2000,5,927,1.0,659.0,659.0,5,1073,1.0,805.0,805.0
0.007,6,10,1989,5,910,1.0,642.0,642.0,5,1079,1.0,811.0,811.0
0.013,6,13,3816,7,578,2.0,206.0,206.0,6,3238,2.0,1470.0,1459.0
0.042,17,2,144,1,64,0.0,36.0,36.0,1,80,0.0,52.0,52.0
0.088,6,10,1506,5,395,19.0,127.0,127.0,5,1111,20.0,843.0,843.0
0.041,17,2,148,1,60,0.0,32.0,32.0,1,88,0.0,60.0,60.0
0.018,6,13,3735,7,497,3.0,125.0,125.0,6,3238,3.0,1470.0,1459.0
0.009,6,10,1989,5,910,2.0,642.0,642.0,5,1079,2.0,811.0,811.0
0.005,6,10,1989,5,927,1.0,659.0,659.0,5,1062,1.0,794.0,794.0
0.006,6,10,1854,5,889,1.0,621.0,621.0,5,965,1.0,697.0,697.0
0.013,6,10,1972,5,910,3.0,642.0,642.0,5,1062,3.0,794.0,794.0
308.414,17,20,1124,10,716,34254.0,48.0,43.0,10,408,34254.0,20.0,12.0
0.014,6,13,3735,7,497,2.0,125.0,125.0,6,3238,2.0,1470.0,1459.0
0.099,6,10,1506,5,395,22.0,127.0,127.0,5,1111,23.0,843.0,843.0
0.017,6,10,1972,5,910,4.0,642.0,642.0,5,1062,4.0,794.0,794.0
0.014,17,2,164,1,74,0.0,46.0,46.0,1,90,0.0,62.0,62.0
0.005,17,2,169,1,62,0.0,34.0,34.0,1,107,0.0,79.0,79.0
0.008,6,10,1989,5,927,2.0,659.0,659.0,5,1062,2.0,794.0,794.0
0.01,6,10,1990,5,911,2.0,643.0,643.0,5,1079,2.0,811.0,811.0
0.163,17,2,152,1,76,0.0,48.0,48.0,1,76,0.0,48.0,48.0
0.004,17,4,284,2,120,0.0,32.0,32.0,2,164,0.0,60.0,54.0
0.005,17,2,169,1,62,0.0,34.0,34.0,1,107,0.0,79.0,79.0
0.013,6,10,1972,5,910,3.0,642.0,642.0,5,1062,3.0,794.0,794.0
0.004,6,10,1774,5,923,1.0,655.0,655.0,5,851,1.0,583.0,583.0
0.006,17,2,170,1,65,0.0,37.0,37.0,1,105,0.0,77.0,77.0
40.064,17,10,676,5,460,10015.0,104.0,64.0,5,216,10015.0,20.0,15.0
0.038,17,2,170,1,65,0.0,37.0,37.0,1,105,0.0,77.0,77.0
40.055,17,10,676,5,460,10011.0,104.0,64.0,5,216,10012.0,20.0,15.0
0.001,17,2,180,1,66,0.0,38.0,38.0,1,114,0.0,86.0,86.0
0.065,6,10,1506,5,395,15.0,127.0,127.0,5,1111,14.0,843.0,843.0
0.006,6,10,1854,5,889,1.0,621.0,621.0,5,965,1.0,697.0,697.0
0.005,6,10,2007,5,928,1.0,660.0,660.0,5,1079,1.0,811.0,811.0
0.005,6,14,3799,7,509,0.0,137.0,137.0,7,3290,0.0,1448.0,972.0
0.011,6,10,1989,5,910,2.0,642.0,642.0,5,1079,2.0,811.0,811.0
0.001,17,2,179,1,62,0.0,34.0,34.0,1,117,0.0,89.0,89.0
0.027,6,10,1989,5,910,6.0,642.0,642.0,5,1079,6.0,811.0,811.0
0.008,6,12,1926,6,1189,1.0,659.0,434.0,6,737,1.0,417.0,417.0
0.008,6,10,1643,5,860,2.0,592.0,592.0,5,783,2.0,515.0,515.0
0.005,17,2,214,1,75,0.0,47.0,47.0,1,139,0.0,111.0,111.0
0.071,6,10,1506,5,395,16.0,127.0,127.0,5,1111,15.0,843.0,843.0
0.006,6,10,1689,5,839,1.0,571.0,571.0,5,850,1.0,582.0,582.0
0.014,6,10,1983,5,910,3.0,642.0,642.0,5,1073,3.0,805.0,805.0
0.005,17,2,150,1,67,0.0,39.0,39.0,1,83,0.0,55.0,55.0
240.079,6,16,4480,9,963,30009.0,238.0,166.0,7,3517,40012.0,1402.0,786.0
0.025,6,10,1989,5,910,6.0,642.0,642.0,5,1079,6.0,811.0,811.0
0.01,6,10,1631,5,848,2.0,580.0,580.0,5,783,2.0,515.0,515.0
0.009,6,10,1702,5,863,2.0,595.0,595.0,5,839,2.0,571.0,571.0
0.001,17,2,179,1,62,0.0,34.0,34.0,1,117,0.0,89.0,89.0
0.014,6,10,1990,5,911,3.0,643.0,643.0,5,1079,3.0,811.0,811.0
0.009,6,10,1972,5,910,2.0,642.0,642.0,5,1062,2.0,794.0,794.0
40.073,17,10,676,5,460,10017.0,104.0,64.0,5,216,10017.0,20.0,15.0
0.005,6,10,1643,5,860,1.0,592.0,592.0,5,783,1.0,515.0,515.0
0.011,6,13,3735,7,497,1.0,125.0,125.0,6,3238,2.0,1470.0,1459.0
15.077,17,16,9302,8,6912,2149.0,1350.0,836.0,8,2390,2149.0,1350.0,270.0
0.005,6,10,1547,5,764,1.0,496.0,496.0,5,783,1.0,515.0,515.0
0.053,17,2,152,1,76,0.0,48.0,48.0,1,76,0.0,48.0,48.0
0.001,17,2,180,1,66,0.0,38.0,38.0,1,114,0.0,86.0,86.0
0.096,6,10,1506,5,395,19.0,127.0,127.0,5,1111,23.0,843.0,843.0
0.014,6,10,1989,5,910,3.0,642.0,642.0,5,1079,3.0,811.0,811.0
0.004,6,10,2006,5,927,1.0,659.0,659.0,5,1079,1.0,811.0,811.0
0.005,6,14,3736,7,446,0.0,74.0,74.0,7,3290,0.0,1448.0,972.0
0.005,17,2,170,1,65,0.0,37.0,37.0,1,105,0.0,77.0,77.0
0.017,6,10,1983,5,910,4.0,642.0,642.0,5,1073,4.0,805.0,805.0
0.008,17,2,170,1,65,0.0,37.0,37.0,1,105,0.0,77.0,77.0
0.016,6,10,1972,5,910,4.0,642.0,642.0,5,1062,3.0,794.0,794.0
0.01,6,10,1631,5,848,2.0,580.0,580.0,5,783,2.0,515.0,515.0
163.04,17,68,9707,34,2267,4940.0,44.0,38.0,34,7440,4940.0,261.0,190.0
0.131,6,10,1506,5,395,31.0,127.0,127.0,5,1111,29.0,843.0,843.0
0.009,6,10,1762,5,911,2.0,643.0,643.0,5,851,2.0,583.0,583.0
0.004,17,4,284,2,120,0.0,32.0,32.0,2,164,0.0,60.0,54.0
0.009,6,10,1990,5,911,2.0,643.0,643.0,5,1079,2.0,811.0,811.0
0.005,6,10,1989,5,927,1.0,659.0,659.0,5,1062,1.0,794.0,794.0
0.007,6,10,1547,5,764,1.0,496.0,496.0,5,783,1.0,515.0,515.0
0.006,6,10,1779,5,928,1.0,660.0,660.0,5,851,1.0,583.0,583.0
10.92,17,28,4420,14,1995,831.0,270.0,114.0,14,2425,831.0,588.0,145.0
0.004,17,2,148,1,60,0.0,32.0,32.0,1,88,0.0,60.0,60.0
83.389,58,5,360,4,288,27796.0,24.0,24.0,1,72,0.0,24.0,24.0
0.004,6,10,1774,5,923,1.0,655.0,655.0,5,851,1.0,583.0,583.0
0.005,6,10,2006,5,927,1.0,659.0,659.0,5,1079,1.0,811.0,811.0
0.14,6,10,1506,5,395,21.0,127.0,127.0,5,1111,31.0,843.0,843.0
0.005,6,14,3736,7,446,0.0,74.0,74.0,7,3290,0.0,1448.0,972.0
0.005,6,10,2006,5,927,1.0,659.0,659.0,5,1079,1.0,811.0,811.0
0.005,6,14,3742,7,452,0.0,80.0,80.0,7,3290,0.0,1448.0,972.0
0.006,17,2,170,1,65,0.0,37.0,37.0,1,105,0.0,77.0,77.0
0.024,6,10,1983,5,910,6.0,642.0,642.0,5,1073,5.0,805.0,805.0
0.001,17,2,166,1,75,0.0,47.0,47.0,1,91,0.0,63.0,63.0
0.043,6,19,9922,11,704,4.0,124.0,124.0,8,9218,6.0,2896.0,2198.0
0.072,17,4,284,2,120,0.0,32.0,32.0,2,164,68.0,60.0,54.0
0.005,6,10,1779,5,928,1.0,660.0,660.0,5,851,1.0,583.0,583.0
0.035,17,2,152,1,76,0.0,48.0,48.0,1,76,0.0,48.0,48.0
0.007,6,10,1989,5,927,1.0,659.0,659.0,5,1062,1.0,794.0,794.0
296.688,17,4,330,2,125,296649.0,37.0,34.0,2,205,296650.0,89.0,74.0
0.006,6,10,2006,5,927,1.0,659.0,659.0,5,1079,1.0,811.0,811.0
0.013,17,2,152,1,56,0.0,28.0,28.0,1,96,0.0,68.0,68.0
40.059,17,10,676,5,460,10013.0,104.0,64.0,5,216,10014.0,20.0,15.0
0.107,6,10,1506,5,395,23.0,127.0,127.0,5,1111,23.0,843.0,843.0
0.005,6,10,2006,5,927,1.0,659.0,659.0,5,1079,1.0,811.0,811.0
300.035,6,12,1782,7,1348,50005.0,494.0,494.0,5,434,75008.0,83.0,83.0
0.004,6,10,2007,5,928,1.0,660.0,660.0,5,1079,1.0,811.0,811.0
0.005,17,2,179,1,71,0.0,43.0,43.0,1,108,0.0,80.0,80.0
0.005,17,2,214,1,75,0.0,47.0,47.0,1,139,0.0,111.0,111.0
0.005,6,10,1774,5,923,1.0,655.0,655.0,5,851,1.0,583.0,583.0
0.063,6,10,1506,5,395,13.0,127.0,127.0,5,1111,15.0,843.0,843.0
0.005,6,10,2007,5,928,1.0,660.0,660.0,5,1079,1.0,811.0,811.0
0.124,6,10,1506,5,395,25.0,127.0,127.0,5,1111,29.0,843.0,843.0
300.31,6,16,2170,9,684,37517.0,146.0,146.0,7,1486,50023.0,419.0,398.0
294.494,6,316,343565,120,17787,2474.0,2736.0,888.0,196,325778,1510.0,2804.0,1733.0
40.054,17,10,676,5,460,10011.0,104.0,64.0,5,216,10012.0,20.0,15.0
0.015,6,10,1972,5,910,3.0,642.0,642.0,5,1062,3.0,794.0,794.0
0.085,6,10,1506,5,395,17.0,127.0,127.0,5,1111,19.0,843.0,843.0
0.018,6,10,1989,5,910,4.0,642.0,642.0,5,1079,4.0,811.0,811.0
0.011,6,14,3787,7,497,1.0,125.0,125.0,7,3290,1.0,1448.0,972.0
0.012,6,10,1972,5,910,3.0,642.0,642.0,5,1062,3.0,794.0,794.0
60.602,6,26,17477,14,9539,4661.0,2804.0,1469.0,12,7938,5497.0,2309.0,1043.0
0.005,17,2,144,1,64,0.0,36.0,36.0,1,80,0.0,52.0,52.0
240.081,6,16,4482,9,963,30010.0,238.0,166.0,7,3519,40013.0,1402.0,786.0
0.004,17,2,148,1,60,0.0,32.0,32.0,1,88,0.0,60.0,60.0
366.847,6,22,2313,16,867,24456.0,195.0,195.0,6,1446,4641.0,419.0,398.0
0.004,6,10,2000,5,927,1.0,659.0,659.0,5,1073,1.0,805.0,805.0
178.152,17,76,10894,38,2537,4814.0,44.0,38.0,38,8357,4814.0,239.0,191.0
0.006,17,2,179,1,71,0.0,43.0,43.0,1,108,0.0,80.0,80.0
0.007,6,10,1854,5,889,1.0,621.0,621.0,5,965,1.0,697.0,697.0
12.453,17,42,9464,21,5172,614.0,1337.0,218.0,21,4292,614.0,862.0,176.0
0.009,6,10,1677,5,827,2.0,559.0,559.0,5,850,2.0,582.0,582.0
0.005,6,10,2006,5,927,1.0,659.0,659.0,5,1079,1.0,811.0,811.0
11.154,17,28,4420,14,1993,847.0,268.0,114.0,14,2427,848.0,586.0,145.0
10.861,17,28,4423,14,1994,827.0,269.0,114.0,14,2429,827.0,588.0,145.0
0.004,6,10,2006,5,927,1.0,659.0,659.0,5,1079,1.0,811.0,811.0
0.006,6,10,1547,5,764,1.0,496.0,496.0,5,783,1.0,515.0,515.0
0.017,6,6,716,3,458,7.0,302.0,302.0,3,258,7.0,102.0,102.0
0.112,6,10,1506,5,395,24.0,127.0,127.0,5,1111,24.0,843.0,843.0
0.071,6,10,1506,5,395,16.0,127.0,127.0,5,1111,15.0,843.0,843.0
0.038,17,4,284,2,120,0.0,32.0,32.0,2,164,34.0,60.0,54.0
40.059,17,10,676,5,460,10014.0,104.0,64.0,5,216,10013.0,20.0,15.0
0.012,17,2,214,1,75,0.0,47.0,47.0,1,139,0.0,111.0,111.0
40.06,17,10,676,5,460,10013.0,104.0,64.0,5,216,10014.0,20.0,15.0
0.01,6,10,1677,5,827,2.0,559.0,559.0,5,850,2.0,582.0,582.0
164.323,17,80,11440,40,2664,4213.0,44.0,38.0,40,8776,4213.0,239.0,191.0
0.005,6,10,1689,5,839,1.0,571.0,571.0,5,850,1.0,582.0,582.0
0.005,6,10,2006,5,927,1.0,659.0,659.0,5,1079,1.0,811.0,811.0
40.048,17,10,676,5,460,10010.0,104.0,64.0,5,216,10011.0,20.0,15.0
0.005,6,13,3747,7,509,0.0,137.0,137.0,6,3238,0.0,1470.0,1459.0
0.005,6,10,1989,5,927,1.0,659.0,659.0,5,1062,1.0,794.0,794.0
0.005,6,13,3747,7,509,0.0,137.0,137.0,6,3238,0.0,1470.0,1459.0
0.011,6,10,1677,5,827,2.0,559.0,559.0,5,850,2.0,582.0,582.0
240.016,6,9,787,5,488,60004.0,232.0,232.0,4,299,80004.0,83.0,83.0
0.11,6,10,1506,5,395,25.0,127.0,127.0,5,1111,24.0,843.0,843.0
0.062,17,2,136,1,60,0.0,32.0,32.0,1,76,0.0,48.0,48.0
0.005,6,10,1689,5,839,1.0,571.0,571.0,5,850,1.0,582.0,582.0
0.005,17,2,164,1,74,0.0,46.0,46.0,1,90,0.0,62.0,62.0
0.079,6,10,1506,5,395,19.0,127.0,127.0,5,1111,16.0,843.0,843.0
0.024,6,13,3735,7,497,4.0,125.0,125.0,6,3238,4.0,1470.0,1459.0
0.013,6,10,1989,5,927,3.0,659.0,659.0,5,1062,3.0,794.0,794.0
0.038,17,2,152,1,76,0.0,48.0,48.0,1,76,0.0,48.0,48.0
0.011,6,10,1990,5,911,2.0,643.0,643.0,5,1079,2.0,811.0,811.0
0.012,6,10,1983,5,910,3.0,642.0,642.0,5,1073,2.0,805.0,805.0
0.008,6,12,1926,6,1189,1.0,659.0,434.0,6,737,1.0,417.0,417.0
0.011,6,10,1972,5,910,2.0,642.0,642.0,5,1062,2.0,794.0,794.0
0.006,6,10,1689,5,839,1.0,571.0,571.0,5,850,1.0,582.0,582.0
0.135,6,10,1506,5,395,33.0,127.0,127.0,5,1111,30.0,843.0,843.0
0.007,6,10,2006,5,927,1.0,659.0,659.0,5,1079,1.0,811.0,811.0
0.805,6,10,2009,6,1655,161.0,1403.0,1403.0,4,354,189.0,182.0,182.0
40.068,17,10,676,5,460,10016.0,104.0,64.0,5,216,10016.0,20.0,15.0
240.25,6,40,5446,20,2431,12644.0,581.0,195.0,20,3015,12644.0,649.0,281.0
0.004,17,2,136,1,60,0.0,32.0,32.0,1,76,0.0,48.0,48.0
0.009,17,2,194,1,59,0.0,31.0,31.0,1,135,0.0,107.0,107.0
0.144,6,10,1506,5,395,35.0,127.0,127.0,5,1111,33.0,843.0,843.0
0.005,6,10,1989,5,927,1.0,659.0,659.0,5,1062,1.0,794.0,794.0
0.038,17,4,284,2,120,0.0,32.0,32.0,2,164,34.0,60.0,54.0
40.073,17,10,676,5,460,10015.0,104.0,64.0,5,216,10017.0,20.0,15.0
0.004,17,2,148,1,60,0.0,32.0,32.0,1,88,0.0,60.0,60.0
0.003,17,2,148,1,60,0.0,32.0,32.0,1,88,0.0,60.0,60.0
0.006,6,10,1689,5,839,1.0,571.0,571.0,5,850,1.0,582.0,582.0
0.004,17,2,148,1,60,0.0,32.0,32.0,1,88,0.0,60.0,60.0
0.005,6,10,1989,5,927,1.0,659.0,659.0,5,1062,1.0,794.0,794.0
0.079,6,10,1506,5,395,14.0,127.0,127.0,5,1111,18.0,843.0,843.0
0.005,17,2,214,1,75,0.0,47.0,47.0,1,139,0.0,111.0,111.0
0.207,6,16,2669,8,1395,29.0,533.0,323.0,8,1274,18.0,529.0,212.0
0.005,6,10,2006,5,927,1.0,659.0,659.0,5,1079,1.0,811.0,811.0
0.001,17,2,180,1,66,0.0,38.0,38.0,1,114,0.0,86.0,86.0
0.095,6,10,1506,5,395,19.0,127.0,127.0,5,1111,22.0,843.0,843.0
0.082,6,10,1506,5,395,17.0,127.0,127.0,5,1111,17.0,843.0,843.0
40.058,17,10,676,5,460,10012.0,104.0,64.0,5,216,10013.0,20.0,15.0
0.005,17,2,166,1,75,0.0,47.0,47.0,1,91,0.0,63.0,63.0
0.004,17,2,136,1,60,0.0,32.0,32.0,1,76,0.0,48.0,48.0
0.129,17,4,284,2,120,0.0,32.0,32.0,2,164,126.0,60.0,54.0
0.006,6,10,1547,5,764,1.0,496.0,496.0,5,783,1.0,515.0,515.0
0.042,17,2,148,1,60,0.0,32.0,32.0,1,88,0.0,60.0,60.0
0.007,17,2,169,1,62,0.0,34.0,34.0,1,107,0.0,79.0,79.0
0.02,6,10,1989,5,910,5.0,642.0,642.0,5,1079,5.0,811.0,811.0
0.004,17,2,144,1,64,0.0,36.0,36.0,1,80,0.0,52.0,52.0
0.014,6,10,1972,5,910,3.0,642.0,642.0,5,1062,3.0,794.0,794.0
0.005,6,10,1989,5,927,1.0,659.0,659.0,5,1062,1.0,794.0,794.0
0.02,6,10,1989,5,910,5.0,642.0,642.0,5,1079,5.0,811.0,811.0
0.004,6,10,1989,5,927,1.0,659.0,659.0,5,1062,1.0,794.0,794.0
0.005,6,10,1989,5,927,1.0,659.0,659.0,5,1062,1.0,794.0,794.0
0.004,6,10,2006,5,927,1.0,659.0,659.0,5,1079,1.0,811.0,811.0
0.004,6,10,2006,5,927,1.0,659.0,659.0,5,1079,1.0,811.0,811.0
0.014,6,10,1989,5,910,3.0,642.0,642.0,5,1079,3.0,811.0,811.0
0.009,6,12,1926,6,1189,1.0,659.0,434.0,6,737,1.0,417.0,417.0
0.007,17,4,284,2,120,0.0,32.0,32.0,2,164,0.0,60.0,54.0
0.066,6,10,1506,5,395,14.0,127.0,127.0,5,1111,14.0,843.0,843.0
0.005,6,10,2007,5,928,1.0,660.0,660.0,5,1079,1.0,811.0,811.0
300.022,6,12,1782,7,1348,50003.0,494.0,494.0,5,434,75004.0,83.0,83.0
0.007,17,2,194,1,59,0.0,31.0,31.0,1,135,0.0,107.0,107.0
240.01,6,9,787,5,488,60002.0,232.0,232.0,4,299,80002.0,83.0,83.0
0.129,17,2,80,1,32,0.0,4.0,4.0,1,48,0.0,20.0,20.0
0.03,6,10,1990,5,911,7.0,643.0,643.0,5,1079,7.0,811.0,811.0
0.005,6,10,2006,5,927,1.0,659.0,659.0,5,1079,1.0,811.0,811.0
0.012,6,10,1990,5,911,2.0,643.0,643.0,5,1079,2.0,811.0,811.0
0.004,6,10,2006,5,927,1.0,659.0,659.0,5,1079,1.0,811.0,811.0
0.004,17,2,170,1,65,0.0,37.0,37.0,1,105,0.0,77.0,77.0
40.066,17,10,676,5,460,10015.0,104.0,64.0,5,216,10014.0,20.0,15.0
0.199,17,4,596,2,122,160.0,33.0,33.0,2,474,156.0,323.0,209.0
0.005,6,10,1643,5,860,1.0,592.0,592.0,5,783,1.0,515.0,515.0
0.005,6,10,2006,5,927,1.0,659.0,659.0,5,1079,1.0,811.0,811.0
0.005,6,10,2006,5,927,1.0,659.0,659.0,5,1079,1.0,811.0,811.0
40.059,17,10,676,5,460,10011.0,104.0,64.0,5,216,10014.0,20.0,15.0
0.098,6,10,1506,5,395,20.0,127.0,127.0,5,1111,21.0,843.0,843.0
0.084,6,10,1506,5,395,19.0,127.0,127.0,5,1111,18.0,843.0,843.0
0.005,6,14,3742,7,452,0.0,80.0,80.0,7,3290,0.0,1448.0,972.0
0.091,6,10,1506,5,395,19.0,127.0,127.0,5,1111,18.0,843.0,843.0
0.038,17,2,166,1,75,0.0,47.0,47.0,1,91,0.0,63.0,63.0
0.003,17,2,136,1,60,0.0,32.0,32.0,1,76,0.0,48.0,48.0
0.018,6,10,1972,5,910,4.0,642.0,642.0,5,1062,4.0,794.0,794.0
0.011,6,10,1989,5,910,2.0,642.0,642.0,5,1079,2.0,811.0,811.0
0.005,6,10,2006,5,927,1.0,659.0,659.0,5,1079,1.0,811.0,811.0
0.009,6,12,1926,6,1189,1.0,659.0,434.0,6,737,1.0,417.0,417.0
0.021,6,10,1989,5,910,5.0,642.0,642.0,5,1079,5.0,811.0,811.0
0.013,6,10,1983,5,910,3.0,642.0,642.0,5,1073,3.0,805.0,805.0
0.017,6,10,1989,5,910,4.0,642.0,642.0,5,1079,4.0,811.0,811.0
0.005,6,10,1547,5,764,1.0,496.0,496.0,5,783,1.0,515.0,515.0
0.004,17,2,184,1,61,0.0,33.0,33.0,1,123,0.0,95.0,95.0
0.004,6,10,1702,5,863,1.0,595.0,595.0,5,839,0.0,571.0,571.0
0.02,6,10,1990,5,911,4.0,643.0,643.0,5,1079,5.0,811.0,811.0
0.088,6,10,1506,5,395,18.0,127.0,127.0,5,1111,18.0,843.0,843.0
0.004,17,2,214,1,75,0.0,47.0,47.0,1,139,0.0,111.0,111.0
0.187,17,2,194,1,59,0.0,31.0,31.0,1,135,0.0,107.0,107.0
0.011,6,10,1983,5,910,2.0,642.0,642.0,5,1073,2.0,805.0,805.0
0.006,6,10,1854,5,889,1.0,621.0,621.0,5,965,1.0,697.0,697.0
1.8,6,41,7389,22,3619,85.0,1103.0,204.0,19,3770,94.0,1402.0,346.0
240.703,6,37,9658,19,2173,13370.0,745.0,235.0,18,7485,14157.0,1402.0,595.0
0.08,6,10,1506,5,395,17.0,127.0,127.0,5,1111,18.0,843.0,843.0
0.005,6,10,2006,5,927,1.0,659.0,659.0,5,1079,1.0,811.0,811.0
0.017,6,10,1677,5,827,4.0,559.0,559.0,5,850,4.0,582.0,582.0
0.011,6,10,1990,5,911,2.0,643.0,643.0,5,1079,2.0,811.0,811.0
0.004,17,2,169,1,62,0.0,34.0,34.0,1,107,0.0,79.0,79.0
0.078,6,10,1506,5,395,15.0,127.0,127.0,5,1111,15.0,843.0,843.0
0.004,6,10,2006,5,927,1.0,659.0,659.0,5,1079,1.0,811.0,811.0
0.118,6,10,1506,5,395,25.0,127.0,127.0,5,1111,23.0,843.0,843.0
40.065,17,10,676,5,460,10015.0,104.0,64.0,5,216,10015.0,20.0,15.0
40.068,17,10,676,5,460,10016.0,104.0,64.0,5,216,10016.0,20.0,15.0
0.013,6,10,1989,5,910,3.0,642.0,642.0,5,1079,3.0,811.0,811.0
11.168,17,28,4422,14,1994,846.0,269.0,114.0,14,2428,846.0,587.0,145.0
40.059,17,10,676,5,460,10013.0,104.0,64.0,5,216,10014.0,20.0,15.0
240.24,6,28,7401,14,5275,18480.0,2112.0,568.0,14,2126,18479.0,580.0,198.0
0.088,6,10,1506,5,395,19.0,127.0,127.0,5,1111,17.0,843.0,843.0
0.037,17,2,136,1,60,0.0,32.0,32.0,1,76,0.0,48.0,48.0
0.006,6,10,1547,5,764,1.0,496.0,496.0,5,783,1.0,515.0,515.0
0.006,17,2,169,1,62,0.0,34.0,34.0,1,107,0.0,79.0,79.0
0.013,6,10,1972,5,910,3.0,642.0,642.0,5,1062,3.0,794.0,794.0
317.296,17,20,1124,10,716,35240.0,48.0,43.0,10,408,35240.0,20.0,12.0
0.132,6,10,1506,5,395,24.0,127.0,127.0,5,1111,30.0,843.0,843.0
0.005,6,10,2006,5,927,1.0,659.0,659.0,5,1079,1.0,811.0,811.0
0.004,17,2,166,1,75,0.0,47.0,47.0,1,91,0.0,63.0,63.0
0.005,6,10,2007,5,928,1.0,660.0,660.0,5,1079,1.0,811.0,811.0
0.014,6,10,1983,5,910,3.0,642.0,642.0,5,1073,3.0,805.0,805.0
0.079,6,10,1506,5,395,17.0,127.0,127.0,5,1111,17.0,843.0,843.0
0.005,6,10,2000,5,927,1.0,659.0,659.0,5,1073,1.0,805.0,805.0
0.011,6,10,1989,5,927,2.0,659.0,659.0,5,1062,2.0,794.0,794.0
40.067,17,10,676,5,460,10016.0,104.0,64.0,5,216,10015.0,20.0,15.0
0.008,6,10,1989,5,910,2.0,642.0,642.0,5,1079,2.0,811.0,811.0
3.008,17,8,504,4,328,1001.0,104.0,54.0,4,176,1001.0,20.0,16.0
0.014,6,10,1990,5,911,3.0,643.0,643.0,5,1079,3.0,811.0,811.0
0.012,6,10,1631,5,848,2.0,580.0,580.0,5,783,3.0,515.0,515.0
0.005,6,10,1547,5,764,1.0,496.0,496.0,5,783,1.0,515.0,515.0
300.403,6,16,2170,9,684,37529.0,146.0,146.0,7,1486,50038.0,419.0,398.0
0.005,6,10,2007,5,928,1.0,660.0,660.0,5,1079,1.0,811.0,811.0
0.08,6,10,1506,5,395,19.0,127.0,127.0,5,1111,17.0,843.0,843.0
0.104,6,10,1506,5,395,24.0,127.0,127.0,5,1111,22.0,843.0,843.0
11.258,17,28,4422,14,1993,852.0,268.0,114.0,14,2429,853.0,588.0,145.0
0.001,17,2,268,1,70,0.0,42.0,42.0,1,198,0.0,170.0,170.0
0.012,6,10,1762,5,911,3.0,643.0,643.0,5,851,3.0,583.0,583.0
0.005,17,2,170,1,65,0.0,37.0,37.0,1,105,0.0,77.0,77.0
0.005,6,10,1689,5,839,1.0,571.0,571.0,5,850,1.0,582.0,582.0
0.005,6,10,2000,5,927,1.0,659.0,659.0,5,1073,1.0,805.0,805.0
0.013,6,10,1972,5,910,3.0,642.0,642.0,5,1062,3.0,794.0,794.0
0.006,6,10,2007,5,928,1.0,660.0,660.0,5,1079,1.0,811.0,811.0
0.008,6,10,1972,5,910,2.0,642.0,642.0,5,1062,2.0,794.0,794.0
0.005,6,10,1643,5,860,1.0,592.0,592.0,5,783,1.0,515.0,515.0
0.067,6,27,10114,14,8890,5.0,2261.0,1020.0,13,1224,4.0,222.0,91.0
0.192,6,3,453,2,321,192.0,241.0,241.0,1,132,0.0,92.0,92.0
0.008,6,10,1989,5,910,1.0,642.0,642.0,5,1079,1.0,811.0,811.0
0.184,6,46,11760,25,3367,7.0,1084.0,187.0,21,8393,8.0,1402.0,606.0
0.053,17,2,152,1,76,0.0,48.0,48.0,1,76,0.0,48.0,48.0
0.003,17,4,284,2,120,0.0,32.0,32.0,2,164,0.0,60.0,54.0
0.006,6,10,2006,5,927,1.0,659.0,659.0,5,1079,1.0,811.0,811.0
0.107,6,10,1506,5,395,23.0,127.0,127.0,5,1111,23.0,843.0,843.0
0.118,6,10,1506,5,395,20.0,127.0,127.0,5,1111,27.0,843.0,843.0
0.009,17,2,179,1,71,0.0,43.0,43.0,1,108,0.0,80.0,80.0
0.005,6,10,2006,5,927,1.0,659.0,659.0,5,1079,1.0,811.0,811.0
11.185,17,28,4419,14,1994,848.0,269.0,114.0,14,2425,848.0,588.0,145.0
0.003,17,2,148,1,60,0.0,32.0,32.0,1,88,0.0,60.0,60.0
0.006,6,10,2000,5,927,1.0,659.0,659.0,5,1073,1.0,805.0,805.0
0.011,6,10,1989,5,910,2.0,642.0,642.0,5,1079,2.0,811.0,811.0
0.246,6,22,7134,11,1609,24.0,746.0,257.0,11,5525,24.0,2334.0,989.0
0.129,6,10,1506,5,395,29.0,127.0,127.0,5,1111,26.0,843.0,843.0
10.809,17,28,4418,14,1994,823.0,269.0,114.0,14,2424,823.0,587.0,145.0
0.008,6,10,1990,5,911,2.0,643.0,643.0,5,1079,2.0,811.0,811.0
0.106,6,10,1506,5,395,22.0,127.0,127.0,5,1111,24.0,843.0,843.0
0.073,6,10,1506,5,395,17.0,127.0,127.0,5,1111,16.0,843.0,843.0
0.012,6,10,1983,5,910,3.0,642.0,642.0,5,1073,2.0,805.0,805.0
40.058,17,10,676,5,460,10012.0,104.0,64.0,5,216,10013.0,20.0,15.0
0.005,6,10,2007,5,928,1.0,660.0,660.0,5,1079,1.0,811.0,811.0
0.006,17,2,194,1,59,0.0,31.0,31.0,1,135,0.0,107.0,107.0
0.014,6,10,1989,5,910,3.0,642.0,642.0,5,1079,3.0,811.0,811.0
0.008,6,10,1972,5,910,2.0,642.0,642.0,5,1062,2.0,794.0,794.0
0.257,17,48,30574,28,27116,9.0,1350.0,940.0,20,3458,11.0,1350.0,144.0
0.087,6,10,1506,5,395,20.0,127.0,127.0,5,1111,17.0,843.0,843.0
308.523,17,20,1124,10,716,34273.0,48.0,43.0,10,408,34273.0,20.0,12.0
0.085,6,10,1506,5,395,19.0,127.0,127.0,5,1111,17.0,843.0,843.0
0.123,17,2,148,1,60,0.0,32.0,32.0,1,88,0.0,60.0,60.0
0.001,17,2,180,1,66,0.0,38.0,38.0,1,114,0.0,86.0,86.0
0.039,17,2,156,1,64,0.0,36.0,36.0,1,92,0.0,64.0,64.0
0.006,6,10,1547,5,764,1.0,496.0,496.0,5,783,1.0,515.0,515.0
0.001,17,2,180,1,66,0.0,38.0,38.0,1,114,0.0,86.0,86.0
0.114,6,10,1506,5,395,25.0,127.0,127.0,5,1111,20.0,843.0,843.0
0.006,6,10,1547,5,764,1.0,496.0,496.0,5,783,1.0,515.0,515.0
0.006,6,10,1854,5,889,1.0,621.0,621.0,5,965,1.0,697.0,697.0
0.011,6,10,1983,5,910,2.0,642.0,642.0,5,1073,2.0,805.0,805.0
0.023,6,10,1990,5,911,5.0,643.0,643.0,5,1079,5.0,811.0,811.0
0.021,6,10,1677,5,827,5.0,559.0,559.0,5,850,5.0,582.0,582.0
173.314,17,72,10330,36,2395,4951.0,44.0,38.0,36,7935,4951.0,239.0,192.0
15.118,17,19,13436,9,8280,1886.0,1350.0,892.0,10,5156,1676.0,1350.0,487.0
0.004,17,2,148,1,60,0.0,32.0,32.0,1,88,0.0,60.0,60.0
310.358,17,20,1124,10,716,34472.0,48.0,43.0,10,408,34475.0,20.0,12.0
0.015,6,10,1990,5,911,3.0,643.0,643.0,5,1079,3.0,811.0,811.0
366.113,6,22,2313,16,867,24407.0,195.0,195.0,6,1446,4637.0,419.0,398.0
240.173,6,23,7663,12,2783,21833.0,1368.0,537.0,11,4880,24017.0,1655.0,860.0
0.068,6,10,1506,5,395,15.0,127.0,127.0,5,1111,15.0,843.0,843.0
0.118,6,10,1506,5,395,28.0,127.0,127.0,5,1111,19.0,843.0,843.0
0.005,17,2,214,1,75,0.0,47.0,47.0,1,139,0.0,111.0,111.0
0.009,6,10,1989,5,910,2.0,642.0,642.0,5,1079,2.0,811.0,811.0
0.093,6,10,1506,5,395,20.0,127.0,127.0,5,1111,21.0,843.0,843.0
0.012,6,10,1972,5,910,3.0,642.0,642.0,5,1062,2.0,794.0,794.0
0.146,6,10,1506,5,395,35.0,127.0,127.0,5,1111,32.0,843.0,843.0
0.004,6,10,1774,5,923,1.0,655.0,655.0,5,851,1.0,583.0,583.0
0.115,6,10,1506,5,395,26.0,127.0,127.0,5,1111,23.0,843.0,843.0
0.005,6,10,2006,5,927,1.0,659.0,659.0,5,1079,1.0,811.0,811.0
0.038,17,2,184,1,61,0.0,33.0,33.0,1,123,0.0,95.0,95.0
40.059,17,10,676,5,460,10011.0,104.0,64.0,5,216,10014.0,20.0,15.0
0.015,6,10,1990,5,911,3.0,643.0,643.0,5,1079,3.0,811.0,811.0
0.005,6,14,3742,8,504,0.0,80.0,80.0,6,3238,0.0,1470.0,1459.0
0.01,6,10,1972,5,910,2.0,642.0,642.0,5,1062,2.0,794.0,794.0
0.011,6,10,1643,5,860,2.0,592.0,592.0,5,783,2.0,515.0,515.0
0.005,6,10,2000,5,927,1.0,659.0,659.0,5,1073,1.0,805.0,805.0
240.016,6,9,787,5,488,60004.0,232.0,232.0,4,299,80004.0,83.0,83.0
0.004,6,10,2006,5,927,1.0,659.0,659.0,5,1079,1.0,811.0,811.0
0.01,6,10,1972,5,910,2.0,642.0,642.0,5,1062,2.0,794.0,794.0
0.122,6,10,1506,5,395,26.0,127.0,127.0,5,1111,26.0,843.0,843.0
0.014,6,10,1989,5,910,3.0,642.0,642.0,5,1079,3.0,811.0,811.0
40.084,17,10,676,5,460,10020.0,104.0,64.0,5,216,10020.0,20.0,15.0
0.006,6,10,1547,5,764,1.0,496.0,496.0,5,783,1.0,515.0,515.0
0.008,17,2,299,1,65,0.0,37.0,37.0,1,234,0.0,206.0,206.0
0.005,6,10,2006,5,927,1.0,659.0,659.0,5,1079,1.0,811.0,811.0
0.081,6,10,1506,5,395,18.0,127.0,127.0,5,1111,16.0,843.0,843.0
0.006,6,10,1643,5,860,1.0,592.0,592.0,5,783,1.0,515.0,515.0
0.004,17,2,148,1,60,0.0,32.0,32.0,1,88,0.0,60.0,60.0
0.003,6,10,1702,5,863,0.0,595.0,595.0,5,839,0.0,571.0,571.0
0.009,17,2,152,1,76,0.0,48.0,48.0,1,76,0.0,48.0,48.0
40.059,17,10,676,5,460,10011.0,104.0,64.0,5,216,10013.0,20.0,15.0
0.001,17,2,180,1,66,0.0,38.0,38.0,1,114,0.0,86.0,86.0
0.005,17,2,170,1,65,0.0,37.0,37.0,1,105,0.0,77.0,77.0
308.719,17,20,1124,10,716,34289.0,48.0,43.0,10,408,34289.0,20.0,12.0
0.005,6,13,3747,7,509,0.0,137.0,137.0,6,3238,0.0,1470.0,1459.0
0.007,6,10,2000,5,927,1.0,659.0,659.0,5,1073,1.0,805.0,805.0
747.665,6,47,15869,25,4387,31152.0,676.0,439.0,22,11482,32744.0,1402.0,737.0
0.061,17,2,152,1,76,0.0,48.0,48.0,1,76,0.0,48.0,48.0
0.004,6,14,3742,7,452,0.0,80.0,80.0,7,3290,0.0,1448.0,972.0
0.01,6,6,716,3,458,4.0,302.0,302.0,3,258,3.0,102.0,102.0
0.009,6,10,1631,5,848,2.0,580.0,580.0,5,783,2.0,515.0,515.0
0.004,6,10,2006,5,927,1.0,659.0,659.0,5,1079,1.0,811.0,811.0
0.084,6,10,1506,5,395,16.0,127.0,127.0,5,1111,19.0,843.0,843.0
0.001,17,2,180,1,66,0.0,38.0,38.0,1,114,0.0,86.0,86.0
0.121,6,10,1506,5,395,27.0,127.0,127.0,5,1111,29.0,843.0,843.0
0.007,6,10,1983,5,910,1.0,642.0,642.0,5,1073,1.0,805.0,805.0
0.015,6,10,1762,5,911,3.0,643.0,643.0,5,851,3.0,583.0,583.0
0.04,17,2,170,1,65,0.0,37.0,37.0,1,105,0.0,77.0,77.0
0.005,6,10,1643,5,860,1.0,592.0,592.0,5,783,1.0,515.0,515.0
0.016,6,10,1631,5,848,4.0,580.0,580.0,5,783,4.0,515.0,515.0
240.148,6,46,6675,22,3225,11435.0,588.0,230.0,24,3450,10441.0,580.0,199.0
0.005,6,13,3747,7,509,0.0,137.0,137.0,6,3238,1.0,1470.0,1459.0
15.079,17,16,10616,9,8280,1881.0,1350.0,892.0,7,2336,2507.0,1350.0,305.0
40.064,17,10,676,5,460,10013.0,104.0,64.0,5,216,10015.0,20.0,15.0
294.574,6,402,348706,198,21862,1495.0,2736.0,890.0,204,326844,1451.0,2804.0,1664.0
0.111,6,10,1506,5,395,25.0,127.0,127.0,5,1111,25.0,843.0,843.0
0.003,17,2,152,1,76,0.0,48.0,48.0,1,76,0.0,48.0,48.0
0.006,6,10,1854,5,889,1.0,621.0,621.0,5,965,1.0,697.0,697.0
0.005,6,10,2006,5,927,1.0,659.0,659.0,5,1079,1.0,811.0,811.0
0.015,6,10,1983,5,910,3.0,642.0,642.0,5,1073,3.0,805.0,805.0
0.005,6,10,2007,5,928,1.0,660.0,660.0,5,1079,1.0,811.0,811.0
0.041,17,2,412,1,61,0.0,33.0,33.0,1,351,0.0,323.0,323.0
0.001,17,2,180,1,65,0.0,37.0,37.0,1,115,0.0,87.0,87.0
0.008,6,10,1989,5,910,2.0,642.0,642.0,5,1079,2.0,811.0,811.0
0.003,17,2,136,1,60,0.0,32.0,32.0,1,76,0.0,48.0,48.0
0.009,17,4,284,2,120,6.0,32.0,32.0,2,164,6.0,60.0,54.0
0.075,6,10,1506,5,395,16.0,127.0,127.0,5,1111,16.0,843.0,843.0
0.01,6,10,1989,5,910,2.0,642.0,642.0,5,1079,2.0,811.0,811.0
0.005,6,10,2006,5,927,1.0,659.0,659.0,5,1079,1.0,811.0,811.0
0.04,17,2,136,1,60,0.0,32.0,32.0,1,76,0.0,48.0,48.0
0.005,6,10,2007,5,928,1.0,660.0,660.0,5,1079,1.0,811.0,811.0
40.072,17,10,676,5,460,10015.0,104.0,64.0,5,216,10015.0,20.0,15.0
0.005,6,10,2007,5,928,1.0,660.0,660.0,5,1079,1.0,811.0,811.0
0.001,17,2,180,1,65,0.0,37.0,37.0,1,115,0.0,87.0,87.0
0.001,17,2,180,1,66,0.0,38.0,38.0,1,114,0.0,86.0,86.0
0.015,6,10,1983,5,910,3.0,642.0,642.0,5,1073,3.0,805.0,805.0
0.007,6,10,1547,5,764,1.0,496.0,496.0,5,783,1.0,515.0,515.0
0.015,6,10,1989,5,910,3.0,642.0,642.0,5,1079,3.0,811.0,811.0
0.004,6,10,2006,5,927,1.0,659.0,659.0,5,1079,1.0,811.0,811.0
287.9,6,386,347892,198,22495,1461.0,2736.0,870.0,188,325397,1539.0,2804.0,1824.0
0.006,6,10,1547,5,764,1.0,496.0,496.0,5,783,1.0,515.0,515.0
0.004,6,10,2006,5,927,1.0,659.0,659.0,5,1079,1.0,811.0,811.0
0.167,17,2,152,1,76,0.0,48.0,48.0,1,76,0.0,48.0,48.0
0.004,6,10,2000,5,927,1.0,659.0,659.0,5,1073,1.0,805.0,805.0
0.005,6,10,1989,5,927,1.0,659.0,659.0,5,1062,1.0,794.0,794.0
0.146,6,10,1506,5,395,33.0,127.0,127.0,5,1111,32.0,843.0,843.0
0.006,17,2,164,1,74,0.0,46.0,46.0,1,90,0.0,62.0,62.0
0.001,17,2,180,1,66,0.0,38.0,38.0,1,114,0.0,86.0,86.0
0.006,6,10,2007,5,928,1.0,660.0,660.0,5,1079,1.0,811.0,811.0
0.005,6,10,1989,5,927,1.0,659.0,659.0,5,1062,1.0,794.0,794.0
0.037,17,2,152,1,76,0.0,48.0,48.0,1,76,0.0,48.0,48.0
0.068,6,10,1506,5,395,14.0,127.0,127.0,5,1111,15.0,843.0,843.0
0.009,6,10,1989,5,910,2.0,642.0,642.0,5,1079,2.0,811.0,811.0
40.063,17,10,676,5,460,10014.0,104.0,64.0,5,216,10014.0,20.0,15.0
0.1,6,10,1506,5,395,21.0,127.0,127.0,5,1111,20.0,843.0,843.0
0.1,6,10,1506,5,395,18.0,127.0,127.0,5,1111,22.0,843.0,843.0
0.017,6,10,1989,5,910,4.0,642.0,642.0,5,1079,4.0,811.0,811.0
0.161,6,10,1506,5,395,38.0,127.0,127.0,5,1111,34.0,843.0,843.0
1778.423,17,144,45504,72,22752,25048.0,288.0,288.0,72,22752,25048.0,288.0,288.0
0.057,17,2,179,1,71,0.0,43.0,43.0,1,108,0.0,80.0,80.0
0.005,6,10,2000,5,927,1.0,659.0,659.0,5,1073,1.0,805.0,805.0
0.138,6,10,1506,5,395,29.0,127.0,127.0,5,1111,30.0,843.0,843.0
0.015,6,14,3787,7,497,2.0,125.0,125.0,7,3290,2.0,1448.0,972.0
0.005,6,10,1689,5,839,1.0,571.0,571.0,5,850,1.0,582.0,582.0
0.005,6,10,1989,5,927,1.0,659.0,659.0,5,1062,1.0,794.0,794.0
0.008,6,10,1677,5,827,2.0,559.0,559.0,5,850,2.0,582.0,582.0
0.09,6,10,1506,5,395,19.0,127.0,127.0,5,1111,19.0,843.0,843.0
0.026,6,10,1990,5,911,6.0,643.0,643.0,5,1079,6.0,811.0,811.0
0.006,6,10,1547,5,764,1.0,496.0,496.0,5,783,1.0,515.0,515.0
0.137,6,10,1506,5,395,32.0,127.0,127.0,5,1111,32.0,843.0,843.0
0.009,6,10,1990,5,911,2.0,643.0,643.0,5,1079,2.0,811.0,811.0
0.005,6,10,2006,5,927,1.0,659.0,659.0,5,1079,1.0,811.0,811.0
240.101,6,16,4482,9,963,30012.0,238.0,166.0,7,3519,40016.0,1402.0,786.0
1792.481,6,490,99412,246,88062,7315.0,421.0,365.0,244,11350,7376.0,53.0,53.0
0.004,6,10,1702,5,863,1.0,595.0,595.0,5,839,1.0,571.0,571.0
0.043,17,2,412,1,61,0.0,33.0,33.0,1,351,0.0,323.0,323.0
280.29,58,3,216,2,144,280290.0,24.0,24.0,1,72,0.0,24.0,24.0
0.006,6,13,3690,7,452,1.0,80.0,80.0,6,3238,1.0,1470.0,1459.0
0.005,6,10,2000,5,927,1.0,659.0,659.0,5,1073,1.0,805.0,805.0
0.071,17,2,146,1,65,0.0,37.0,37.0,1,81,0.0,53.0,53.0
0.013,6,10,1983,5,910,3.0,642.0,642.0,5,1073,3.0,805.0,805.0
37.624,6,36,8190,18,1719,510.0,651.0,322.0,18,6471,2206.0,2720.0,478.0
0.014,6,10,1989,5,910,3.0,642.0,642.0,5,1079,3.0,811.0,811.0
0.009,6,10,1989,5,910,2.0,642.0,642.0,5,1079,2.0,811.0,811.0
0.011,6,10,1631,5,848,2.0,580.0,580.0,5,783,2.0,515.0,515.0
0.004,17,2,148,1,60,0.0,32.0,32.0,1,88,0.0,60.0,60.0
0.005,17,2,148,1,60,0.0,32.0,32.0,1,88,0.0,60.0,60.0
11.025,17,28,4423,14,1995,839.0,270.0,114.0,14,2428,839.0,587.0,145.0
0.005,17,2,166,1,75,0.0,47.0,47.0,1,91,0.0,63.0,63.0
1769.319,17,92,8096,46,4048,39318.0,60.0,60.0,46,4048,39318.0,60.0,60.0
0.004,17,2,148,1,60,0.0,32.0,32.0,1,88,0.0,60.0,60.0
0.006,6,10,1547,5,764,1.0,496.0,496.0,5,783,1.0,515.0,515.0
0.142,6,10,1506,5,395,34.0,127.0,127.0,5,1111,30.0,843.0,843.0
0.004,6,10,1774,5,923,1.0,655.0,655.0,5,851,0.0,583.0,583.0
0.005,6,10,1689,5,839,1.0,571.0,571.0,5,850,1.0,582.0,582.0
0.121,6,10,1506,5,395,25.0,127.0,127.0,5,1111,27.0,843.0,843.0
361.79,6,19,1689,15,978,25842.0,190.0,190.0,4,711,80013.0,495.0,495.0
328.862,17,20,1124,10,716,36528.0,48.0,43.0,10,408,36530.0,20.0,12.0
0.005,6,10,1854,5,889,1.0,621.0,621.0,5,965,1.0,697.0,697.0
0.003,17,2,148,1,60,0.0,32.0,32.0,1,88,0.0,60.0,60.0
0.04,17,2,186,1,61,0.0,33.0,33.0,1,125,0.0,97.0,97.0
0.005,6,10,2000,5,927,1.0,659.0,659.0,5,1073,1.0,805.0,805.0
0.005,6,13,3747,7,509,0.0,137.0,137.0,6,3238,1.0,1470.0,1459.0
0.015,6,10,1983,5,910,3.0,642.0,642.0,5,1073,3.0,805.0,805.0
0.005,6,10,1989,5,927,1.0,659.0,659.0,5,1062,1.0,794.0,794.0
0.066,6,10,1506,5,395,15.0,127.0,127.0,5,1111,14.0,843.0,843.0
0.005,6,10,2006,5,927,1.0,659.0,659.0,5,1079,1.0,811.0,811.0
0.041,17,2,152,1,76,0.0,48.0,48.0,1,76,0.0,48.0,48.0
0.008,6,10,1972,5,910,2.0,642.0,642.0,5,1062,2.0,794.0,794.0
241.633,6,387,348340,190,21409,1278.0,2736.0,960.0,197,326931,1232.0,2804.0,1693.0
0.007,17,2,194,1,59,0.0,31.0,31.0,1,135,0.0,107.0,107.0
0.005,6,10,2006,5,927,1.0,659.0,659.0,5,1079,1.0,811.0,811.0
0.012,6,10,1989,5,910,3.0,642.0,642.0,5,1079,2.0,811.0,811.0
0.005,6,10,2006,5,927,1.0,659.0,659.0,5,1079,1.0,811.0,811.0
0.014,6,10,1983,5,910,3.0,642.0,642.0,5,1073,3.0,805.0,805.0
0.098,6,10,1506,5,395,22.0,127.0,127.0,5,1111,22.0,843.0,843.0
0.241,6,10,1506,5,395,59.0,127.0,127.0,5,1111,40.0,843.0,843.0
0.12,6,10,1506,5,395,20.0,127.0,127.0,5,1111,28.0,843.0,843.0
0.005,6,10,2006,5,927,1.0,659.0,659.0,5,1079,1.0,811.0,811.0
1770.167,6,83,4370,42,2211,43173.0,27.0,27.0,41,2159,44253.0,27.0,27.0
240.025,6,9,787,5,488,60006.0,232.0,232.0,4,299,80003.0,83.0,83.0
0.141,6,10,1506,5,395,31.0,127.0,127.0,5,1111,33.0,843.0,843.0
0.004,6,10,2006,5,927,1.0,659.0,659.0,5,1079,1.0,811.0,811.0
0.005,17,2,293,1,73,0.0,45.0,45.0,1,220,0.0,192.0,192.0
0.129,6,10,1506,5,395,31.0,127.0,127.0,5,1111,26.0,843.0,843.0
0.015,6,10,1762,5,911,3.0,643.0,643.0,5,851,3.0,583.0,583.0
0.005,6,10,2007,5,928,1.0,660.0,660.0,5,1079,1.0,811.0,811.0
0.003,17,2,136,1,60,0.0,32.0,32.0,1,76,0.0,48.0,48.0
0.001,17,2,136,1,60,0.0,32.0,32.0,1,76,0.0,48.0,48.0
40.082,17,10,676,5,460,10018.0,104.0,64.0,5,216,10019.0,20.0,15.0
0.305,17,43,25806,24,21168,13.0,1350.0,854.0,19,4638,13.0,1350.0,216.0
0.124,17,2,80,1,32,0.0,4.0,4.0,1,48,0.0,20.0,20.0
112.385,6,16,1227,4,450,89.0,234.0,234.0,12,777,10205.0,145.0,145.0
0.002,17,2,166,1,75,0.0,47.0,47.0,1,91,0.0,63.0,63.0
40.06,17,10,676,5,460,10013.0,104.0,64.0,5,216,10013.0,20.0,15.0
0.075,6,10,1506,5,395,16.0,127.0,127.0,5,1111,16.0,843.0,843.0
0.019,6,10,1972,5,910,4.0,642.0,642.0,5,1062,4.0,794.0,794.0
0.016,17,2,180,1,66,0.0,38.0,38.0,1,114,0.0,86.0,86.0
0.012,6,6,716,3,458,4.0,302.0,302.0,3,258,4.0,102.0,102.0
0.015,6,10,1631,5,848,3.0,580.0,580.0,5,783,3.0,515.0,515.0
0.175,17,2,152,1,76,0.0,48.0,48.0,1,76,0.0,48.0,48.0
0.005,6,10,1989,5,927,1.0,659.0,659.0,5,1062,1.0,794.0,794.0
0.13,6,10,1506,5,395,24.0,127.0,127.0,5,1111,29.0,843.0,843.0
0.007,6,10,1547,5,764,1.0,496.0,496.0,5,783,1.0,515.0,515.0
0.001,17,2,179,1,62,0.0,34.0,34.0,1,117,0.0,89.0,89.0
300.344,6,16,2170,9,684,37521.0,146.0,146.0,7,1486,50028.0,419.0,398.0
0.006,6,10,1689,5,839,1.0,571.0,571.0,5,850,1.0,582.0,582.0
11.318,17,30,4738,16,2338,746.0,269.0,118.0,14,2400,861.0,587.0,143.0
0.005,6,10,2000,5,927,1.0,659.0,659.0,5,1073,1.0,805.0,805.0
0.013,6,10,1972,5,910,3.0,642.0,642.0,5,1062,3.0,794.0,794.0
0.013,6,10,1983,5,910,3.0,642.0,642.0,5,1073,3.0,805.0,805.0
0.012,6,10,1972,5,910,3.0,642.0,642.0,5,1062,3.0,794.0,794.0
0.128,6,10,1506,5,395,29.0,127.0,127.0,5,1111,30.0,843.0,843.0
240.299,6,28,10395,14,4778,18484.0,1368.0,675.0,14,5617,18484.0,1656.0,813.0
11.014,17,28,4423,14,1995,839.0,270.0,114.0,14,2428,839.0,587.0,145.0
0.043,6,10,1605,5,388,10.0,120.0,120.0,5,1217,10.0,949.0,949.0
0.008,6,10,1972,5,910,2.0,642.0,642.0,5,1062,2.0,794.0,794.0
0.008,6,10,1547,5,764,1.0,496.0,496.0,5,783,1.0,515.0,515.0
0.09,6,10,1506,5,395,19.0,127.0,127.0,5,1111,19.0,843.0,843.0
0.008,17,2,194,1,59,0.0,31.0,31.0,1,135,0.0,107.0,107.0
0.004,17,4,284,2,120,0.0,32.0,32.0,2,164,1.0,60.0,54.0
0.004,17,4,284,2,120,0.0,32.0,32.0,2,164,0.0,60.0,54.0
0.079,6,10,1506,5,395,18.0,127.0,127.0,5,1111,16.0,843.0,843.0
0.071,17,4,284,2,120,0.0,32.0,32.0,2,164,68.0,60.0,54.0
0.004,6,10,1779,5,928,1.0,660.0,660.0,5,851,1.0,583.0,583.0
0.091,6,10,1506,5,395,22.0,127.0,127.0,5,1111,22.0,843.0,843.0
0.006,17,2,170,1,65,0.0,37.0,37.0,1,105,0.0,77.0,77.0
0.005,6,10,1779,5,928,1.0,660.0,660.0,5,851,1.0,583.0,583.0
0.013,6,14,3787,7,497,2.0,125.0,125.0,7,3290,2.0,1448.0,972.0
415.138,6,50,3380,19,1450,23063.0,46.0,46.0,31,1930,13833.0,46.0,46.0
0.11,6,10,1506,5,395,26.0,127.0,127.0,5,1111,24.0,843.0,843.0
0.004,6,10,2007,5,928,1.0,660.0,660.0,5,1079,1.0,811.0,811.0
0.01,6,10,1990,5,911,2.0,643.0,643.0,5,1079,2.0,811.0,811.0
0.116,6,10,1506,5,395,27.0,127.0,127.0,5,1111,24.0,843.0,843.0
0.095,6,10,1506,5,395,19.0,127.0,127.0,5,1111,22.0,843.0,843.0
0.009,6,10,1972,5,910,2.0,642.0,642.0,5,1062,2.0,794.0,794.0
0.006,6,10,1547,5,764,1.0,496.0,496.0,5,783,1.0,515.0,515.0
0.011,6,10,1762,5,911,2.0,643.0,643.0,5,851,2.0,583.0,583.0
40.07,17,10,676,5,460,10014.0,104.0,64.0,5,216,10016.0,20.0,15.0
0.005,6,10,2006,5,927,1.0,659.0,659.0,5,1079,1.0,811.0,811.0
40.079,17,10,676,5,460,10018.0,104.0,64.0,5,216,10019.0,20.0,15.0
0.005,6,10,2006,5,927,1.0,659.0,659.0,5,1079,1.0,811.0,811.0
40.059,17,10,676,5,460,10013.0,104.0,64.0,5,216,10013.0,20.0,15.0
0.006,6,10,1547,5,764,1.0,496.0,496.0,5,783,1.0,515.0,515.0
0.173,6,10,1506,5,395,42.0,127.0,127.0,5,1111,39.0,843.0,843.0
0.155,6,10,1506,5,395,37.0,127.0,127.0,5,1111,24.0,843.0,843.0
0.004,6,10,1989,5,927,1.0,659.0,659.0,5,1062,1.0,794.0,794.0
0.009,6,10,1989,5,910,2.0,642.0,642.0,5,1079,2.0,811.0,811.0
0.01,6,13,3735,7,497,1.0,125.0,125.0,6,3238,2.0,1470.0,1459.0
0.016,6,10,1983,5,910,3.0,642.0,642.0,5,1073,4.0,805.0,805.0
0.006,6,10,1547,5,764,1.0,496.0,496.0,5,783,1.0,515.0,515.0
0.018,6,10,1677,5,827,4.0,559.0,559.0,5,850,4.0,582.0,582.0
0.107,6,10,1506,5,395,24.0,127.0,127.0,5,1111,21.0,843.0,843.0
0.017,6,10,1983,5,910,4.0,642.0,642.0,5,1073,4.0,805.0,805.0
0.016,6,10,1631,5,848,3.0,580.0,580.0,5,783,3.0,515.0,515.0
0.001,17,2,180,1,66,0.0,38.0,38.0,1,114,0.0,86.0,86.0
0.009,6,12,1926,6,1189,1.0,659.0,434.0,6,737,1.0,417.0,417.0
0.099,6,10,1506,5,395,23.0,127.0,127.0,5,1111,22.0,843.0,843.0
334.598,17,20,1124,10,716,37163.0,48.0,43.0,10,408,37163.0,20.0,12.0
40.058,17,10,676,5,460,10011.0,104.0,64.0,5,216,10013.0,20.0,15.0
0.006,17,2,170,1,65,0.0,37.0,37.0,1,105,0.0,77.0,77.0
0.038,17,4,284,2,120,0.0,32.0,32.0,2,164,35.0,60.0,54.0
0.064,6,10,1506,5,395,14.0,127.0,127.0,5,1111,15.0,843.0,843.0
0.005,6,10,1854,5,889,1.0,621.0,621.0,5,965,1.0,697.0,697.0
0.133,17,2,152,1,76,0.0,48.0,48.0,1,76,0.0,48.0,48.0
0.005,6,10,2006,5,927,1.0,659.0,659.0,5,1079,1.0,811.0,811.0
0.01,6,10,1989,5,910,2.0,642.0,642.0,5,1079,2.0,811.0,811.0
0.01,6,10,1989,5,910,2.0,642.0,642.0,5,1079,2.0,811.0,811.0
0.006,6,10,1547,5,764,1.0,496.0,496.0,5,783,1.0,515.0,515.0
0.003,17,2,148,1,60,0.0,32.0,32.0,1,88,0.0,60.0,60.0
0.005,6,10,1989,5,927,1.0,659.0,659.0,5,1062,1.0,794.0,794.0
0.003,17,2,148,1,60,0.0,32.0,32.0,1,88,0.0,60.0,60.0
0.005,17,2,144,1,64,0.0,36.0,36.0,1,80,0.0,52.0,52.0
361.771,6,21,1792,16,1030,24118.0,190.0,190.0,5,762,60010.0,461.0,247.0
0.114,6,10,1506,5,395,27.0,127.0,127.0,5,1111,23.0,843.0,843.0
0.07,6,10,1506,5,395,16.0,127.0,127.0,5,1111,13.0,843.0,843.0
0.005,6,14,3799,7,509,0.0,137.0,137.0,7,3290,0.0,1448.0,972.0
0.095,6,10,1506,5,395,20.0,127.0,127.0,5,1111,20.0,843.0,843.0
300.348,6,16,2170,9,684,37521.0,146.0,146.0,7,1486,50028.0,419.0,398.0
0.006,6,10,1547,5,764,1.0,496.0,496.0,5,783,1.0,515.0,515.0
293.213,17,116,16515,58,3862,5143.0,44.0,38.0,58,12653,5144.0,261.0,190.0
0.014,6,10,1983,5,910,3.0,642.0,642.0,5,1073,3.0,805.0,805.0
0.006,6,10,2006,5,927,1.0,659.0,659.0,5,1079,1.0,811.0,811.0
0.011,6,10,1989,5,910,2.0,642.0,642.0,5,1079,2.0,811.0,811.0
0.053,17,2,152,1,76,0.0,48.0,48.0,1,76,0.0,48.0,48.0
0.015,6,10,1983,5,910,3.0,642.0,642.0,5,1073,3.0,805.0,805.0
0.015,6,10,1983,5,910,3.0,642.0,642.0,5,1073,3.0,805.0,805.0
0.072,6,10,1506,5,395,16.0,127.0,127.0,5,1111,15.0,843.0,843.0
40.068,17,10,676,5,460,10014.0,104.0,64.0,5,216,10016.0,20.0,15.0
0.134,17,2,80,1,32,0.0,4.0,4.0,1,48,0.0,20.0,20.0
0.098,6,10,1506,5,395,22.0,127.0,127.0,5,1111,24.0,843.0,843.0
0.004,6,10,1989,5,927,1.0,659.0,659.0,5,1062,1.0,794.0,794.0
0.005,6,10,2006,5,927,1.0,659.0,659.0,5,1079,1.0,811.0,811.0
0.006,6,10,1547,5,764,1.0,496.0,496.0,5,783,1.0,515.0,515.0
0.017,6,10,1972,5,910,4.0,642.0,642.0,5,1062,4.0,794.0,794.0
0.084,6,10,1506,5,395,15.0,127.0,127.0,5,1111,19.0,843.0,843.0
0.005,6,10,2007,5,928,1.0,660.0,660.0,5,1079,1.0,811.0,811.0
10.898,17,28,4422,14,1994,830.0,269.0,114.0,14,2428,830.0,587.0,145.0
0.006,17,2,178,1,65,0.0,37.0,37.0,1,113,0.0,85.0,85.0
308.613,17,20,1124,10,716,34276.0,48.0,43.0,10,408,34276.0,20.0,12.0
351.995,6,20,2210,6,1308,12003.0,494.0,494.0,14,902,27076.0,83.0,83.0
0.04,17,2,136,1,60,0.0,32.0,32.0,1,76,0.0,48.0,48.0
0.015,6,10,1990,5,911,3.0,643.0,643.0,5,1079,3.0,811.0,811.0
0.009,6,10,1989,5,910,2.0,642.0,642.0,5,1079,2.0,811.0,811.0
0.04,17,2,136,1,60,0.0,32.0,32.0,1,76,0.0,48.0,48.0
382.477,6,22,2313,16,867,25498.0,195.0,195.0,6,1446,4643.0,419.0,398.0
0.021,6,10,1972,5,910,5.0,642.0,642.0,5,1062,5.0,794.0,794.0
0.085,6,10,1506,5,395,18.0,127.0,127.0,5,1111,20.0,843.0,843.0
0.009,6,10,1990,5,911,2.0,643.0,643.0,5,1079,2.0,811.0,811.0
0.015,6,10,1983,5,910,3.0,642.0,642.0,5,1073,3.0,805.0,805.0
0.004,6,10,2006,5,927,1.0,659.0,659.0,5,1079,1.0,811.0,811.0
0.007,17,2,194,1,59,0.0,31.0,31.0,1,135,0.0,107.0,107.0
0.011,6,13,3735,7,497,1.0,125.0,125.0,6,3238,2.0,1470.0,1459.0
0.004,6,10,2006,5,927,1.0,659.0,659.0,5,1079,1.0,811.0,811.0
0.012,6,10,1631,5,848,3.0,580.0,580.0,5,783,3.0,515.0,515.0
0.004,6,10,1774,5,923,0.0,655.0,655.0,5,851,1.0,583.0,583.0
0.011,6,10,1605,5,388,2.0,120.0,120.0,5,1217,2.0,949.0,949.0
40.059,17,10,676,5,460,10012.0,104.0,64.0,5,216,10013.0,20.0,15.0
0.005,6,10,2006,5,927,1.0,659.0,659.0,5,1079,1.0,811.0,811.0
308.472,17,20,1124,10,716,34260.0,48.0,43.0,10,408,34261.0,20.0,12.0
0.009,6,10,1983,5,910,2.0,642.0,642.0,5,1073,2.0,805.0,805.0
0.009,6,12,1926,6,1189,1.0,659.0,434.0,6,737,1.0,417.0,417.0
0.091,6,10,1506,5,395,19.0,127.0,127.0,5,1111,21.0,843.0,843.0
1787.426,6,154,19574,92,13852,19641.0,302.0,302.0,62,5722,29302.0,83.0,83.0
0.005,6,10,2006,5,927,1.0,659.0,659.0,5,1079,1.0,811.0,811.0
0.001,17,2,142,1,63,0.0,35.0,35.0,1,79,0.0,51.0,51.0
11.026,17,28,4416,14,1993,839.0,268.0,114.0,14,2423,839.0,586.0,145.0
0.005,6,13,3747,7,509,0.0,137.0,137.0,6,3238,1.0,1470.0,1459.0
0.014,6,10,1983,5,910,3.0,642.0,642.0,5,1073,3.0,805.0,805.0
0.115,6,10,1506,5,395,26.0,127.0,127.0,5,1111,23.0,843.0,843.0
0.012,6,10,1983,5,910,3.0,642.0,642.0,5,1073,3.0,805.0,805.0
0.004,6,10,2006,5,927,1.0,659.0,659.0,5,1079,1.0,811.0,811.0
11.199,17,28,4421,14,1993,849.0,268.0,114.0,14,2428,848.0,587.0,145.0
0.006,6,10,1689,5,839,1.0,571.0,571.0,5,850,1.0,582.0,582.0
0.005,17,2,144,1,64,0.0,36.0,36.0,1,80,0.0,52.0,52.0
0.005,17,2,180,1,58,0.0,30.0,30.0,1,122,0.0,94.0,94.0
0.008,17,2,179,1,71,0.0,43.0,43.0,1,108,0.0,80.0,80.0
0.074,6,10,1506,5,395,14.0,127.0,127.0,5,1111,16.0,843.0,843.0
0.08,6,10,1506,5,395,18.0,127.0,127.0,5,1111,18.0,843.0,843.0
0.005,6,10,2007,5,928,1.0,660.0,660.0,5,1079,1.0,811.0,811.0
0.071,17,4,284,2,120,0.0,32.0,32.0,2,164,67.0,60.0,54.0
0.016,6,10,1983,5,910,3.0,642.0,642.0,5,1073,3.0,805.0,805.0
0.005,6,10,1989,5,927,1.0,659.0,659.0,5,1062,1.0,794.0,794.0
0.077,6,10,1506,5,395,16.0,127.0,127.0,5,1111,18.0,843.0,843.0
0.004,6,10,1989,5,927,1.0,659.0,659.0,5,1062,1.0,794.0,794.0
0.004,6,10,2000,5,927,1.0,659.0,659.0,5,1073,1.0,805.0,805.0
0.013,17,2,179,1,71,0.0,43.0,43.0,1,108,0.0,80.0,80.0
0.006,17,2,230,1,68,0.0,40.0,40.0,1,162,0.0,134.0,134.0
0.005,6,10,2007,5,928,1.0,660.0,660.0,5,1079,1.0,811.0,811.0
0.005,6,13,3747,7,509,0.0,137.0,137.0,6,3238,1.0,1470.0,1459.0
1780.835,6,324,51522,138,31137,12997.0,1939.0,236.0,186,20385,9625.0,1360.0,150.0
40.051,17,10,676,5,460,10011.0,104.0,64.0,5,216,10010.0,20.0,15.0
0.093,6,10,1506,5,395,20.0,127.0,127.0,5,1111,20.0,843.0,843.0
0.005,6,10,1643,5,860,1.0,592.0,592.0,5,783,1.0,515.0,515.0
0.013,6,10,1990,5,911,3.0,643.0,643.0,5,1079,3.0,811.0,811.0
0.004,17,4,284,2,120,1.0,32.0,32.0,2,164,0.0,60.0,54.0
0.011,6,10,1972,5,910,2.0,642.0,642.0,5,1062,2.0,794.0,794.0
0.004,6,10,1774,5,923,1.0,655.0,655.0,5,851,1.0,583.0,583.0
0.088,6,10,1506,5,395,20.0,127.0,127.0,5,1111,18.0,843.0,843.0
1792.595,6,496,99865,251,88475,7169.0,421.0,364.0,245,11390,7346.0,53.0,53.0
0.086,6,10,1506,5,395,18.0,127.0,127.0,5,1111,17.0,843.0,843.0
0.001,17,2,136,1,60,0.0,32.0,32.0,1,76,0.0,48.0,48.0
0.064,6,10,1506,5,395,15.0,127.0,127.0,5,1111,13.0,843.0,843.0
0.089,6,10,1506,5,395,18.0,127.0,127.0,5,1111,19.0,843.0,843.0
0.01,6,10,1989,5,910,2.0,642.0,642.0,5,1079,2.0,811.0,811.0
300.818,6,38,12812,20,7294,15832.0,4080.0,1292.0,18,5518,508.0,2667.0,435.0
0.006,17,2,140,1,62,0.0,34.0,34.0,1,78,0.0,50.0,50.0
0.011,6,10,1983,5,910,2.0,642.0,642.0,5,1073,2.0,805.0,805.0
11.109,17,28,4418,14,1994,842.0,269.0,114.0,14,2424,842.0,587.0,145.0
0.015,6,10,1989,5,910,3.0,642.0,642.0,5,1079,3.0,811.0,811.0
0.117,6,10,1506,5,395,25.0,127.0,127.0,5,1111,16.0,843.0,843.0
0.005,6,10,1779,5,928,1.0,660.0,660.0,5,851,1.0,583.0,583.0
0.005,6,10,2006,5,927,1.0,659.0,659.0,5,1079,1.0,811.0,811.0
0.001,17,2,140,1,62,0.0,34.0,34.0,1,78,0.0,50.0,50.0
0.07,17,8,3613,4,1874,23.0,1350.0,440.0,4,1739,11.0,1350.0,406.0
0.006,6,10,1547,5,764,1.0,496.0,496.0,5,783,1.0,515.0,515.0
0.013,6,10,1983,5,910,3.0,642.0,642.0,5,1073,3.0,805.0,805.0
0.008,6,10,1989,5,927,2.0,659.0,659.0,5,1062,2.0,794.0,794.0
0.004,6,10,1779,5,928,1.0,660.0,660.0,5,851,0.0,583.0,583.0
0.102,6,10,1506,5,395,21.0,127.0,127.0,5,1111,21.0,843.0,843.0
0.012,6,10,1990,5,911,3.0,643.0,643.0,5,1079,3.0,811.0,811.0
0.005,6,10,2006,5,927,1.0,659.0,659.0,5,1079,1.0,811.0,811.0
0.116,6,10,1506,5,395,25.0,127.0,127.0,5,1111,24.0,843.0,843.0
0.061,6,10,1506,5,395,13.0,127.0,127.0,5,1111,13.0,843.0,843.0
0.005,6,10,2006,5,927,1.0,659.0,659.0,5,1079,1.0,811.0,811.0
0.006,6,10,1989,5,927,1.0,659.0,659.0,5,1062,1.0,794.0,794.0
0.11,6,10,1506,5,395,19.0,127.0,127.0,5,1111,26.0,843.0,843.0
0.004,6,10,2000,5,927,1.0,659.0,659.0,5,1073,1.0,805.0,805.0
318.468,17,20,1124,10,716,35373.0,48.0,43.0,10,408,35372.0,20.0,12.0
0.014,6,10,1983,5,910,3.0,642.0,642.0,5,1073,3.0,805.0,805.0
0.005,17,2,170,1,65,0.0,37.0,37.0,1,105,0.0,77.0,77.0
0.092,6,10,1506,5,395,21.0,127.0,127.0,5,1111,18.0,843.0,843.0
240.078,6,16,4481,9,963,30009.0,238.0,166.0,7,3518,40012.0,1402.0,786.0
0.098,6,10,1506,5,395,22.0,127.0,127.0,5,1111,20.0,843.0,843.0
0.006,6,10,1547,5,764,1.0,496.0,496.0,5,783,1.0,515.0,515.0
0.02,6,10,1972,5,910,5.0,642.0,642.0,5,1062,5.0,794.0,794.0
0.005,17,2,152,1,68,0.0,40.0,40.0,1,84,0.0,56.0,56.0
0.009,6,10,1983,5,910,2.0,642.0,642.0,5,1073,2.0,805.0,805.0
0.005,6,10,1989,5,927,1.0,659.0,659.0,5,1062,1.0,794.0,794.0
0.001,17,2,154,1,69,0.0,41.0,41.0,1,85,0.0,57.0,57.0
0.001,17,2,180,1,66,0.0,38.0,38.0,1,114,0.0,86.0,86.0
0.099,6,10,1506,5,395,21.0,127.0,127.0,5,1111,20.0,843.0,843.0
0.035,6,10,1677,5,827,8.0,559.0,559.0,5,850,8.0,582.0,582.0
0.094,6,10,1506,5,395,21.0,127.0,127.0,5,1111,21.0,843.0,843.0
0.108,6,10,1506,5,395,24.0,127.0,127.0,5,1111,25.0,843.0,843.0
0.126,6,10,1506,5,395,28.0,127.0,127.0,5,1111,29.0,843.0,843.0
0.009,6,10,1677,5,827,2.0,559.0,559.0,5,850,2.0,582.0,582.0
40.071,17,10,676,5,460,10014.0,104.0,64.0,5,216,10017.0,20.0,15.0
0.09,6,10,1506,5,395,20.0,127.0,127.0,5,1111,19.0,843.0,843.0
0.01,6,10,1762,5,911,2.0,643.0,643.0,5,851,2.0,583.0,583.0
0.005,17,2,230,1,68,0.0,40.0,40.0,1,162,0.0,134.0,134.0
40.069,17,10,676,5,460,10014.0,104.0,64.0,5,216,10016.0,20.0,15.0
0.005,6,10,2006,5,927,1.0,659.0,659.0,5,1079,1.0,811.0,811.0
0.004,6,10,2006,5,927,1.0,659.0,659.0,5,1079,1.0,811.0,811.0
0.122,6,10,1506,5,395,27.0,127.0,127.0,5,1111,25.0,843.0,843.0
0.08,6,10,1506,5,395,17.0,127.0,127.0,5,1111,17.0,843.0,843.0
240.106,6,16,4480,9,963,30013.0,238.0,166.0,7,3517,40017.0,1402.0,786.0
0.112,6,10,1506,5,395,25.0,127.0,127.0,5,1111,24.0,843.0,843.0
10.808,17,28,4422,14,1994,822.0,269.0,114.0,14,2428,822.0,587.0,145.0
0.006,17,2,179,1,71,0.0,43.0,43.0,1,108,0.0,80.0,80.0
0.004,6,10,1989,5,927,1.0,659.0,659.0,5,1062,1.0,794.0,794.0
40.064,17,10,676,5,460,10015.0,104.0,64.0,5,216,10015.0,20.0,15.0
0.039,17,2,136,1,60,0.0,32.0,32.0,1,76,0.0,48.0,48.0
0.005,17,2,169,1,62,0.0,34.0,34.0,1,107,0.0,79.0,79.0
0.005,6,10,1689,5,839,1.0,571.0,571.0,5,850,1.0,582.0,582.0
240.087,6,16,4481,9,963,30010.0,238.0,166.0,7,3518,40014.0,1402.0,786.0
0.004,6,10,1989,5,927,1.0,659.0,659.0,5,1062,1.0,794.0,794.0
0.009,6,10,1972,5,910,2.0,642.0,642.0,5,1062,2.0,794.0,794.0
170.19,17,90,12913,45,3032,3867.0,44.0,39.0,45,9881,3867.0,239.0,191.0
0.005,17,2,193,1,71,0.0,43.0,43.0,1,122,0.0,94.0,94.0
0.081,6,10,1506,5,395,18.0,127.0,127.0,5,1111,14.0,843.0,843.0
0.095,6,10,1506,5,395,21.0,127.0,127.0,5,1111,19.0,843.0,843.0
0.011,6,13,3735,7,497,1.0,125.0,125.0,6,3238,2.0,1470.0,1459.0
0.04,17,2,166,1,75,0.0,47.0,47.0,1,91,0.0,63.0,63.0
0.01,6,10,2007,5,928,2.0,660.0,660.0,5,1079,2.0,811.0,811.0
0.117,17,2,80,1,32,0.0,4.0,4.0,1,48,0.0,20.0,20.0
0.005,6,10,1774,5,923,1.0,655.0,655.0,5,851,1.0,583.0,583.0
0.103,6,10,1506,5,395,23.0,127.0,127.0,5,1111,20.0,843.0,843.0
0.038,17,4,284,2,120,0.0,32.0,32.0,2,164,35.0,60.0,54.0
0.019,6,10,1983,5,910,4.0,642.0,642.0,5,1073,4.0,805.0,805.0
0.005,6,13,3690,7,452,0.0,80.0,80.0,6,3238,1.0,1470.0,1459.0
0.004,17,2,180,1,58,0.0,30.0,30.0,1,122,0.0,94.0,94.0
0.22,6,16,2778,8,1396,31.0,533.0,324.0,8,1382,20.0,529.0,239.0
0.013,6,10,1990,5,911,3.0,643.0,643.0,5,1079,3.0,811.0,811.0
0.039,6,10,1983,5,910,9.0,642.0,642.0,5,1073,9.0,805.0,805.0
0.001,17,2,180,1,66,0.0,38.0,38.0,1,114,0.0,86.0,86.0
0.02,6,13,3735,7,497,3.0,125.0,125.0,6,3238,3.0,1470.0,1459.0
0.005,6,10,2006,5,927,1.0,659.0,659.0,5,1079,1.0,811.0,811.0
0.005,6,13,3690,7,452,0.0,80.0,80.0,6,3238,1.0,1470.0,1459.0
0.005,6,13,3690,7,452,0.0,80.0,80.0,6,3238,0.0,1470.0,1459.0
0.012,6,10,1989,5,910,3.0,642.0,642.0,5,1079,2.0,811.0,811.0
0.004,17,4,284,2,120,0.0,32.0,32.0,2,164,1.0,60.0,54.0
0.018,6,10,1677,5,827,4.0,559.0,559.0,5,850,4.0,582.0,582.0
0.088,6,10,1506,5,395,16.0,127.0,127.0,5,1111,19.0,843.0,843.0
0.013,6,10,1990,5,911,3.0,643.0,643.0,5,1079,3.0,811.0,811.0
0.005,6,10,1547,5,764,1.0,496.0,496.0,5,783,1.0,515.0,515.0
0.015,6,10,1990,5,911,3.0,643.0,643.0,5,1079,3.0,811.0,811.0
0.008,6,10,1989,5,910,1.0,642.0,642.0,5,1079,2.0,811.0,811.0
166.116,17,76,10726,38,2531,4489.0,44.0,38.0,38,8195,4489.0,239.0,187.0
0.005,6,10,2006,5,927,1.0,659.0,659.0,5,1079,1.0,811.0,811.0
15.072,17,14,9191,8,6902,2149.0,1350.0,834.0,6,2289,3008.0,1350.0,353.0
240.012,6,9,787,5,488,60003.0,232.0,232.0,4,299,80003.0,83.0,83.0
0.015,6,10,1972,5,910,3.0,642.0,642.0,5,1062,3.0,794.0,794.0
1783.811,6,273,38997,113,22351,15925.0,2720.0,199.0,160,16646,11218.0,1360.0,129.0
0.129,6,10,1506,5,395,27.0,127.0,127.0,5,1111,30.0,843.0,843.0
0.004,6,10,2007,5,928,1.0,660.0,660.0,5,1079,1.0,811.0,811.0
0.005,17,2,170,1,65,0.0,37.0,37.0,1,105,0.0,77.0,77.0
0.124,6,10,1506,5,395,28.0,127.0,127.0,5,1111,18.0,843.0,843.0
0.003,17,4,284,2,120,0.0,32.0,32.0,2,164,0.0,60.0,54.0
0.05,6,10,1762,5,911,12.0,643.0,643.0,5,851,12.0,583.0,583.0
0.012,6,10,1762,5,911,3.0,643.0,643.0,5,851,2.0,583.0,583.0
0.006,6,10,1643,5,860,1.0,592.0,592.0,5,783,1.0,515.0,515.0
0.016,6,10,1762,5,911,3.0,643.0,643.0,5,851,4.0,583.0,583.0
0.006,6,10,1689,5,839,1.0,571.0,571.0,5,850,1.0,582.0,582.0
0.008,6,10,2007,5,928,2.0,660.0,660.0,5,1079,2.0,811.0,811.0
0.014,6,10,1990,5,911,3.0,643.0,643.0,5,1079,3.0,811.0,811.0
353.233,6,20,2210,6,1308,12003.0,494.0,494.0,14,902,27171.0,83.0,83.0
0.078,6,10,1506,5,395,16.0,127.0,127.0,5,1111,18.0,843.0,843.0
0.014,6,10,1990,5,911,3.0,643.0,643.0,5,1079,3.0,811.0,811.0
0.007,6,10,1989,5,910,1.0,642.0,642.0,5,1079,1.0,811.0,811.0
240.011,6,9,787,5,488,60002.0,232.0,232.0,4,299,80002.0,83.0,83.0
0.004,6,10,2007,5,928,1.0,660.0,660.0,5,1079,1.0,811.0,811.0
0.005,6,10,2006,5,927,1.0,659.0,659.0,5,1079,1.0,811.0,811.0
0.586,6,26,9367,14,1587,36.0,517.0,211.0,12,7780,43.0,1402.0,895.0
0.008,6,10,1989,5,910,2.0,642.0,642.0,5,1079,2.0,811.0,811.0
0.004,6,10,1989,5,927,1.0,659.0,659.0,5,1062,1.0,794.0,794.0
0.058,6,10,1506,5,395,13.0,127.0,127.0,5,1111,13.0,843.0,843.0
0.003,17,2,636,1,308,0.0,280.0,280.0,1,328,0.0,300.0,300.0
0.013,6,10,1677,5,827,3.0,559.0,559.0,5,850,3.0,582.0,582.0
0.147,6,10,1506,5,395,26.0,127.0,127.0,5,1111,34.0,843.0,843.0
0.004,17,2,148,1,60,0.0,32.0,32.0,1,88,0.0,60.0,60.0
0.004,6,10,2007,5,928,1.0,660.0,660.0,5,1079,1.0,811.0,811.0
0.004,6,10,2007,5,928,1.0,660.0,660.0,5,1079,1.0,811.0,811.0
40.024,17,10,676,5,460,10003.0,104.0,64.0,5,216,10005.0,20.0,15.0
11.16,17,28,4421,14,1993,845.0,268.0,114.0,14,2428,845.0,587.0,145.0
0.204,6,16,2670,8,1396,29.0,533.0,324.0,8,1274,18.0,529.0,212.0
0.077,6,10,1506,5,395,17.0,127.0,127.0,5,1111,14.0,843.0,843.0
0.008,6,10,1547,5,764,2.0,496.0,496.0,5,783,1.0,515.0,515.0
0.014,6,10,1972,5,910,3.0,642.0,642.0,5,1062,3.0,794.0,794.0
0.013,6,10,1972,5,910,3.0,642.0,642.0,5,1062,3.0,794.0,794.0
0.017,6,10,1762,5,911,4.0,643.0,643.0,5,851,4.0,583.0,583.0
0.017,6,10,1983,5,910,4.0,642.0,642.0,5,1073,4.0,805.0,805.0
0.005,17,2,170,1,65,0.0,37.0,37.0,1,105,0.0,77.0,77.0
0.004,6,10,1774,5,923,1.0,655.0,655.0,5,851,1.0,583.0,583.0
308.716,17,20,1124,10,716,34285.0,48.0,43.0,10,408,34286.0,20.0,12.0
0.067,6,10,1506,5,395,12.0,127.0,127.0,5,1111,16.0,843.0,843.0
0.006,6,12,1698,6,863,1.0,327.0,271.0,6,835,1.0,515.0,515.0
0.072,17,2,148,1,60,0.0,32.0,32.0,1,88,0.0,60.0,60.0
0.005,17,2,164,1,74,0.0,46.0,46.0,1,90,0.0,62.0,62.0
40.056,17,10,676,5,460,10013.0,104.0,64.0,5,216,10013.0,20.0,15.0
0.006,6,10,1547,5,764,1.0,496.0,496.0,5,783,1.0,515.0,515.0
240.009,6,9,787,5,488,60002.0,232.0,232.0,4,299,80002.0,83.0,83.0
0.087,6,10,1506,5,395,19.0,127.0,127.0,5,1111,20.0,843.0,843.0
0.005,6,10,1989,5,927,1.0,659.0,659.0,5,1062,1.0,794.0,794.0
0.041,17,2,152,1,76,0.0,48.0,48.0,1,76,0.0,48.0,48.0
0.014,6,10,1990,5,911,3.0,643.0,643.0,5,1079,3.0,811.0,811.0
0.012,6,10,1989,5,910,2.0,642.0,642.0,5,1079,3.0,811.0,811.0
0.006,6,10,1547,5,764,1.0,496.0,496.0,5,783,1.0,515.0,515.0
0.001,17,2,180,1,66,0.0,38.0,38.0,1,114,0.0,86.0,86.0
0.072,17,2,136,1,60,0.0,32.0,32.0,1,76,0.0,48.0,48.0
0.003,17,4,284,2,120,0.0,32.0,32.0,2,164,0.0,60.0,54.0
0.004,17,4,284,2,120,0.0,32.0,32.0,2,164,0.0,60.0,54.0
0.006,17,2,170,1,65,0.0,37.0,37.0,1,105,0.0,77.0,77.0
0.066,17,8,3613,4,1874,22.0,1350.0,440.0,4,1739,11.0,1350.0,406.0
0.005,6,10,1689,5,839,1.0,571.0,571.0,5,850,1.0,582.0,582.0
0.005,6,10,2007,5,928,1.0,660.0,660.0,5,1079,1.0,811.0,811.0
0.013,6,10,1989,5,910,3.0,642.0,642.0,5,1079,3.0,811.0,811.0
0.007,17,2,132,1,58,0.0,30.0,30.0,1,74,0.0,46.0,46.0
0.091,6,10,1506,5,395,22.0,127.0,127.0,5,1111,19.0,843.0,843.0
0.004,17,4,284,2,120,0.0,32.0,32.0,2,164,0.0,60.0,54.0
0.01,6,10,1643,5,860,2.0,592.0,592.0,5,783,2.0,515.0,515.0
0.005,6,13,3747,7,509,0.0,137.0,137.0,6,3238,0.0,1470.0,1459.0
0.005,6,10,2006,5,927,1.0,659.0,659.0,5,1079,1.0,811.0,811.0
0.037,6,10,1631,5,848,9.0,580.0,580.0,5,783,9.0,515.0,515.0
0.088,6,10,1506,5,395,21.0,127.0,127.0,5,1111,16.0,843.0,843.0
300.8,6,39,9763,21,4200,15040.0,2932.0,829.0,18,5563,506.0,2667.0,402.0
0.168,6,3,453,2,321,168.0,241.0,241.0,1,132,0.0,92.0,92.0
0.005,6,10,1643,5,860,1.0,592.0,592.0,5,783,1.0,515.0,515.0
10.794,17,28,4422,14,1995,822.0,270.0,114.0,14,2427,822.0,586.0,145.0
0.067,6,10,1506,5,395,14.0,127.0,127.0,5,1111,14.0,843.0,843.0
0.006,6,10,1547,5,764,1.0,496.0,496.0,5,783,1.0,515.0,515.0
0.009,6,10,1983,5,910,2.0,642.0,642.0,5,1073,2.0,805.0,805.0
0.019,6,10,1990,5,911,4.0,643.0,643.0,5,1079,4.0,811.0,811.0
40.072,17,10,676,5,460,10015.0,104.0,64.0,5,216,10017.0,20.0,15.0
0.006,6,10,1689,5,839,1.0,571.0,571.0,5,850,1.0,582.0,582.0
72.615,6,24,7517,13,1385,6051.0,530.0,277.0,11,6132,7243.0,2720.0,946.0
0.005,6,10,2000,5,927,1.0,659.0,659.0,5,1073,1.0,805.0,805.0
40.082,17,10,676,5,460,10017.0,104.0,64.0,5,216,10014.0,20.0,15.0
57.42,58,5,360,4,288,19140.0,24.0,24.0,1,72,0.0,24.0,24.0
0.005,6,10,1854,5,889,1.0,621.0,621.0,5,965,1.0,697.0,697.0
300.372,6,25,7300,15,1357,21455.0,217.0,142.0,10,5943,26725.0,1679.0,902.0
0.078,17,2,80,1,32,0.0,4.0,4.0,1,48,0.0,20.0,20.0
0.009,6,10,1989,5,910,2.0,642.0,642.0,5,1079,2.0,811.0,811.0
1771.89,6,304,97685,186,86361,9577.0,2001.0,696.0,118,11324,15144.0,452.0,70.0
0.112,6,10,1506,5,395,24.0,127.0,127.0,5,1111,26.0,843.0,843.0
0.014,6,10,1983,5,910,3.0,642.0,642.0,5,1073,3.0,805.0,805.0
0.099,6,10,1506,5,395,23.0,127.0,127.0,5,1111,23.0,843.0,843.0
240.115,6,35,9784,16,7097,16007.0,2169.0,696.0,19,2687,13339.0,580.0,211.0
0.014,6,14,3787,7,497,2.0,125.0,125.0,7,3290,2.0,1448.0,972.0
0.13,17,2,80,1,32,0.0,4.0,4.0,1,48,0.0,20.0,20.0
0.009,6,10,1990,5,911,2.0,643.0,643.0,5,1079,2.0,811.0,811.0
361.733,6,21,1793,16,1030,24115.0,190.0,190.0,5,763,60009.0,462.0,247.0
0.004,17,2,148,1,60,0.0,32.0,32.0,1,88,0.0,60.0,60.0
0.038,17,2,144,1,64,0.0,36.0,36.0,1,80,0.0,52.0,52.0
0.118,6,10,1506,5,395,25.0,127.0,127.0,5,1111,23.0,843.0,843.0
0.006,6,10,1547,5,764,1.0,496.0,496.0,5,783,1.0,515.0,515.0
0.006,6,10,1547,5,764,1.0,496.0,496.0,5,783,1.0,515.0,515.0
0.003,17,2,148,1,60,0.0,32.0,32.0,1,88,0.0,60.0,60.0
0.071,6,10,1506,5,395,15.0,127.0,127.0,5,1111,14.0,843.0,843.0
0.004,6,10,2007,5,928,1.0,660.0,660.0,5,1079,1.0,811.0,811.0
40.057,17,10,676,5,460,10012.0,104.0,64.0,5,216,10013.0,20.0,15.0
0.005,6,10,2006,5,927,1.0,659.0,659.0,5,1079,1.0,811.0,811.0
0.019,6,10,1983,5,910,4.0,642.0,642.0,5,1073,4.0,805.0,805.0
0.068,17,8,3613,4,1874,22.0,1350.0,440.0,4,1739,12.0,1350.0,406.0
10.851,17,28,4423,14,1994,826.0,269.0,114.0,14,2429,826.0,588.0,145.0
0.005,6,10,2006,5,927,1.0,659.0,659.0,5,1079,1.0,811.0,811.0
0.092,6,10,1506,5,395,20.0,127.0,127.0,5,1111,18.0,843.0,843.0
0.004,17,2,132,1,58,0.0,30.0,30.0,1,74,0.0,46.0,46.0
0.009,6,10,1677,5,827,2.0,559.0,559.0,5,850,2.0,582.0,582.0
0.017,6,10,1677,5,827,4.0,559.0,559.0,5,850,4.0,582.0,582.0
40.07,17,10,676,5,460,10016.0,104.0,64.0,5,216,10016.0,20.0,15.0
0.004,17,2,136,1,60,0.0,32.0,32.0,1,76,0.0,48.0,48.0
0.095,6,10,1506,5,395,20.0,127.0,127.0,5,1111,21.0,843.0,843.0
0.008,6,10,1983,5,910,2.0,642.0,642.0,5,1073,2.0,805.0,805.0
0.094,6,10,1506,5,395,21.0,127.0,127.0,5,1111,20.0,843.0,843.0
0.015,6,10,1972,5,910,3.0,642.0,642.0,5,1062,3.0,794.0,794.0
0.006,6,10,2007,5,928,1.0,660.0,660.0,5,1079,1.0,811.0,811.0
40.076,17,10,676,5,460,10012.0,104.0,64.0,5,216,10018.0,20.0,15.0
40.072,17,10,676,5,460,10017.0,104.0,64.0,5,216,10017.0,20.0,15.0
0.005,17,2,214,1,75,0.0,47.0,47.0,1,139,0.0,111.0,111.0
0.086,6,10,1506,5,395,18.0,127.0,127.0,5,1111,18.0,843.0,843.0
0.017,6,10,1983,5,910,4.0,642.0,642.0,5,1073,4.0,805.0,805.0
0.005,6,10,2006,5,927,1.0,659.0,659.0,5,1079,1.0,811.0,811.0
0.008,6,10,1990,5,911,2.0,643.0,643.0,5,1079,2.0,811.0,811.0
0.003,17,4,284,2,120,0.0,32.0,32.0,2,164,0.0,60.0,54.0
0.075,6,10,1506,5,395,16.0,127.0,127.0,5,1111,15.0,843.0,843.0
0.086,6,10,1506,5,395,18.0,127.0,127.0,5,1111,19.0,843.0,843.0
1797.179,17,2938,224797,1462,118431,1230.0,84.0,53.0,1476,106366,1218.0,227.0,44.0
0.005,6,10,2006,5,927,1.0,659.0,659.0,5,1079,1.0,811.0,811.0
0.045,17,2,144,1,64,0.0,36.0,36.0,1,80,0.0,52.0,52.0
0.158,6,10,1506,5,395,29.0,127.0,127.0,5,1111,33.0,843.0,843.0
0.017,6,10,1989,5,910,4.0,642.0,642.0,5,1079,4.0,811.0,811.0
0.007,6,10,1972,5,910,1.0,642.0,642.0,5,1062,1.0,794.0,794.0
0.009,6,10,1972,5,910,2.0,642.0,642.0,5,1062,2.0,794.0,794.0
285.104,6,29,6510,16,1421,19006.0,517.0,290.0,13,5089,23758.0,2379.0,1104.0
0.018,6,10,1762,5,911,4.0,643.0,643.0,5,851,4.0,583.0,583.0
40.052,17,10,676,5,460,10012.0,104.0,64.0,5,216,10012.0,20.0,15.0
0.005,6,10,2007,5,928,1.0,660.0,660.0,5,1079,1.0,811.0,811.0
0.004,17,2,148,1,60,0.0,32.0,32.0,1,88,0.0,60.0,60.0
0.011,6,10,1689,5,839,2.0,571.0,571.0,5,850,2.0,582.0,582.0
0.004,6,10,2006,5,927,1.0,659.0,659.0,5,1079,1.0,811.0,811.0
0.042,17,2,144,1,64,0.0,36.0,36.0,1,80,0.0,52.0,52.0
40.064,17,10,676,5,460,10015.0,104.0,64.0,5,216,10015.0,20.0,15.0
0.13,6,10,1506,5,395,30.0,127.0,127.0,5,1111,31.0,843.0,843.0
0.001,17,2,180,1,66,0.0,38.0,38.0,1,114,0.0,86.0,86.0
0.141,6,12,2996,7,549,23.0,177.0,177.0,5,2447,33.0,1402.0,1089.0
2.287,6,40,6976,22,3652,108.0,1103.0,192.0,18,3324,128.0,1402.0,340.0
0.019,6,10,1854,5,889,4.0,621.0,621.0,5,965,4.0,697.0,697.0
0.01,6,10,1983,5,910,2.0,642.0,642.0,5,1073,2.0,805.0,805.0
0.072,6,10,1506,5,395,15.0,127.0,127.0,5,1111,15.0,843.0,843.0
0.073,6,10,1989,5,910,18.0,642.0,642.0,5,1079,18.0,811.0,811.0
300.825,6,39,12664,21,7146,15041.0,2720.0,1045.0,18,5518,508.0,2667.0,435.0
0.014,6,10,1631,5,848,3.0,580.0,580.0,5,783,3.0,515.0,515.0
0.023,6,10,1989,5,910,5.0,642.0,642.0,5,1079,5.0,811.0,811.0
0.013,6,10,1677,5,827,3.0,559.0,559.0,5,850,3.0,582.0,582.0
0.005,6,10,1689,5,839,1.0,571.0,571.0,5,850,1.0,582.0,582.0
0.005,6,10,2000,5,927,1.0,659.0,659.0,5,1073,1.0,805.0,805.0
0.074,6,10,1506,5,395,14.0,127.0,127.0,5,1111,18.0,843.0,843.0
0.007,6,10,1972,5,910,1.0,642.0,642.0,5,1062,1.0,794.0,794.0
0.004,6,10,2006,5,927,1.0,659.0,659.0,5,1079,1.0,811.0,811.0
0.005,6,10,1702,5,863,1.0,595.0,595.0,5,839,1.0,571.0,571.0
0.004,6,10,1774,5,923,1.0,655.0,655.0,5,851,1.0,583.0,583.0
0.084,6,10,1506,5,395,18.0,127.0,127.0,5,1111,18.0,843.0,843.0
352.775,6,20,2210,6,1308,12003.0,494.0,494.0,14,902,27136.0,83.0,83.0
0.006,17,2,230,1,68,0.0,40.0,40.0,1,162,0.0,134.0,134.0
0.006,6,10,1547,5,764,1.0,496.0,496.0,5,783,1.0,515.0,515.0
0.011,6,10,1989,5,910,2.0,642.0,642.0,5,1079,2.0,811.0,811.0
0.011,6,13,3735,7,497,1.0,125.0,125.0,6,3238,2.0,1470.0,1459.0
0.005,6,10,1689,5,839,1.0,571.0,571.0,5,850,1.0,582.0,582.0
0.078,6,10,1506,5,395,17.0,127.0,127.0,5,1111,18.0,843.0,843.0
1777.882,17,144,41760,72,22752,25040.0,288.0,288.0,72,19008,25040.0,236.0,236.0
0.013,6,10,1972,5,910,3.0,642.0,642.0,5,1062,3.0,794.0,794.0
11.493,17,28,4391,14,2313,871.0,588.0,137.0,14,2078,871.0,269.0,120.0
0.004,17,2,132,1,58,0.0,30.0,30.0,1,74,0.0,46.0,46.0
0.003,17,2,148,1,60,0.0,32.0,32.0,1,88,0.0,60.0,60.0
40.078,17,10,676,5,460,10018.0,104.0,64.0,5,216,10018.0,20.0,15.0
308.459,17,20,1124,10,716,34258.0,48.0,43.0,10,408,34258.0,20.0,12.0
0.01,6,10,1972,5,910,2.0,642.0,642.0,5,1062,2.0,794.0,794.0
0.146,6,10,1506,5,395,25.0,127.0,127.0,5,1111,34.0,843.0,843.0
0.005,6,10,2007,5,928,1.0,660.0,660.0,5,1079,1.0,811.0,811.0
0.01,6,10,1677,5,827,2.0,559.0,559.0,5,850,2.0,582.0,582.0
0.005,6,10,2006,5,927,1.0,659.0,659.0,5,1079,1.0,811.0,811.0
0.038,17,2,152,1,76,0.0,48.0,48.0,1,76,0.0,48.0,48.0
0.015,6,10,1989,5,910,3.0,642.0,642.0,5,1079,3.0,811.0,811.0
0.095,6,10,1506,5,395,21.0,127.0,127.0,5,1111,22.0,843.0,843.0
0.086,6,10,1506,5,395,20.0,127.0,127.0,5,1111,16.0,843.0,843.0
0.012,6,10,1677,5,827,2.0,559.0,559.0,5,850,2.0,582.0,582.0
0.005,6,10,2007,5,928,1.0,660.0,660.0,5,1079,1.0,811.0,811.0
0.01,6,10,1762,5,911,2.0,643.0,643.0,5,851,2.0,583.0,583.0
0.225,6,16,2670,8,1396,32.0,533.0,324.0,8,1274,20.0,529.0,212.0
0.019,17,2,152,1,56,0.0,28.0,28.0,1,96,0.0,68.0,68.0
364.265,6,22,2313,16,867,24284.0,195.0,195.0,6,1446,4640.0,419.0,398.0
0.005,6,10,1989,5,927,1.0,659.0,659.0,5,1062,1.0,794.0,794.0
0.006,17,2,230,1,68,0.0,40.0,40.0,1,162,0.0,134.0,134.0
0.005,17,2,164,1,74,0.0,46.0,46.0,1,90,0.0,62.0,62.0
0.004,6,10,2007,5,928,1.0,660.0,660.0,5,1079,1.0,811.0,811.0
0.018,6,10,1989,5,910,4.0,642.0,642.0,5,1079,4.0,811.0,811.0
0.003,17,4,284,2,120,0.0,32.0,32.0,2,164,0.0,60.0,54.0
0.136,6,10,1506,5,395,18.0,127.0,127.0,5,1111,31.0,843.0,843.0
0.005,17,2,175,1,65,0.0,37.0,37.0,1,110,0.0,82.0,82.0
0.005,6,10,1643,5,860,1.0,592.0,592.0,5,783,1.0,515.0,515.0
0.005,6,10,1774,5,923,1.0,655.0,655.0,5,851,1.0,583.0,583.0
0.011,6,10,1972,5,910,2.0,642.0,642.0,5,1062,2.0,794.0,794.0
0.006,6,10,1547,5,764,1.0,496.0,496.0,5,783,1.0,515.0,515.0
0.001,17,2,180,1,66,0.0,38.0,38.0,1,114,0.0,86.0,86.0
0.003,17,2,136,1,60,0.0,32.0,32.0,1,76,0.0,48.0,48.0
0.012,6,10,1990,5,911,2.0,643.0,643.0,5,1079,3.0,811.0,811.0
0.019,6,10,1990,5,911,4.0,643.0,643.0,5,1079,4.0,811.0,811.0
0.004,17,4,284,2,120,0.0,32.0,32.0,2,164,1.0,60.0,54.0
40.07,17,10,676,5,460,10016.0,104.0,64.0,5,216,10016.0,20.0,15.0
0.211,6,16,2669,8,1395,30.0,533.0,323.0,8,1274,19.0,529.0,212.0
0.099,6,10,1506,5,395,22.0,127.0,127.0,5,1111,19.0,843.0,843.0
0.013,6,10,1972,5,910,3.0,642.0,642.0,5,1062,3.0,794.0,794.0
0.087,6,10,1506,5,395,20.0,127.0,127.0,5,1111,18.0,843.0,843.0
0.001,17,2,180,1,65,0.0,37.0,37.0,1,115,0.0,87.0,87.0
0.034,6,10,1989,5,910,8.0,642.0,642.0,5,1079,8.0,811.0,811.0
0.004,17,2,148,1,60,0.0,32.0,32.0,1,88,0.0,60.0,60.0
0.102,6,10,1506,5,395,21.0,127.0,127.0,5,1111,23.0,843.0,843.0
0.014,6,10,1677,5,827,3.0,559.0,559.0,5,850,3.0,582.0,582.0
0.762,6,22,5072,11,1250,64.0,325.0,133.0,11,3822,64.0,1414.0,563.0
0.001,17,2,180,1,66,0.0,38.0,38.0,1,114,0.0,86.0,86.0
0.009,6,10,1989,5,910,2.0,642.0,642.0,5,1079,2.0,811.0,811.0
240.093,6,19,4871,9,2210,30011.0,1007.0,582.0,10,2661,26676.0,1162.0,426.0
40.063,17,10,676,5,460,10014.0,104.0,64.0,5,216,10014.0,20.0,15.0
0.008,6,10,1983,5,910,1.0,642.0,642.0,5,1073,1.0,805.0,805.0
0.015,6,10,1989,5,910,3.0,642.0,642.0,5,1079,3.0,811.0,811.0
0.005,6,10,2007,5,928,1.0,660.0,660.0,5,1079,1.0,811.0,811.0
0.078,6,10,1506,5,395,19.0,127.0,127.0,5,1111,16.0,843.0,843.0
0.107,6,10,1506,5,395,26.0,127.0,127.0,5,1111,25.0,843.0,843.0
0.005,6,10,2006,5,927,1.0,659.0,659.0,5,1079,1.0,811.0,811.0
0.315,17,40,22909,22,18418,15.0,1350.0,809.0,18,4491,15.0,1350.0,221.0
0.005,6,10,1774,5,923,1.0,655.0,655.0,5,851,1.0,583.0,583.0
241.182,6,404,349060,200,21923,1211.0,2736.0,885.0,204,327137,1188.0,2865.0,1631.0
0.153,6,10,1506,5,395,29.0,127.0,127.0,5,1111,36.0,843.0,843.0
0.018,17,4,284,2,120,14.0,32.0,32.0,2,164,14.0,60.0,54.0
0.015,6,10,1677,5,827,3.0,559.0,559.0,5,850,3.0,582.0,582.0
0.005,6,10,2006,5,927,1.0,659.0,659.0,5,1079,1.0,811.0,811.0
0.005,6,10,1774,5,923,1.0,655.0,655.0,5,851,1.0,583.0,583.0
0.005,17,2,249,1,64,0.0,36.0,36.0,1,185,0.0,157.0,157.0
0.004,6,10,2006,5,927,1.0,659.0,659.0,5,1079,1.0,811.0,811.0
0.121,6,10,1506,5,395,28.0,127.0,127.0,5,1111,26.0,843.0,843.0
0.057,17,2,152,1,76,0.0,48.0,48.0,1,76,0.0,48.0,48.0
0.063,6,10,1506,5,395,15.0,127.0,127.0,5,1111,14.0,843.0,843.0
0.041,17,4,352,2,130,1.0,37.0,37.0,2,222,37.0,89.0,83.0
588.54,6,48,18814,25,4984,24522.0,1273.0,525.0,23,13830,26751.0,1402.0,842.0
0.013,6,10,1972,5,910,3.0,642.0,642.0,5,1062,3.0,794.0,794.0
0.005,17,2,140,1,62,0.0,34.0,34.0,1,78,0.0,50.0,50.0
0.005,6,10,2007,5,928,1.0,660.0,660.0,5,1079,1.0,811.0,811.0
0.005,6,10,1643,5,860,1.0,592.0,592.0,5,783,1.0,515.0,515.0
0.005,6,10,1854,5,889,1.0,621.0,621.0,5,965,1.0,697.0,697.0
0.102,6,10,1506,5,395,22.0,127.0,127.0,5,1111,23.0,843.0,843.0
0.041,17,2,170,1,65,0.0,37.0,37.0,1,105,0.0,77.0,77.0
0.005,6,10,1547,5,764,1.0,496.0,496.0,5,783,1.0,515.0,515.0
0.008,6,10,1989,5,910,2.0,642.0,642.0,5,1079,1.0,811.0,811.0
40.083,17,10,676,5,460,10019.0,104.0,64.0,5,216,10020.0,20.0,15.0
0.008,6,10,1972,5,910,2.0,642.0,642.0,5,1062,2.0,794.0,794.0
0.004,6,10,2006,5,927,1.0,659.0,659.0,5,1079,1.0,811.0,811.0
0.009,6,10,2006,5,927,2.0,659.0,659.0,5,1079,2.0,811.0,811.0
240.088,6,16,4480,9,963,30011.0,238.0,166.0,7,3517,40014.0,1402.0,786.0
0.005,6,10,1989,5,927,1.0,659.0,659.0,5,1062,1.0,794.0,794.0
0.008,6,10,1989,5,910,1.0,642.0,642.0,5,1079,2.0,811.0,811.0
294.69,6,399,348552,199,21916,1488.0,2736.0,825.0,200,326636,1480.0,2804.0,1691.0
0.003,17,2,136,1,60,0.0,32.0,32.0,1,76,0.0,48.0,48.0
240.09,6,16,4481,9,963,30011.0,238.0,166.0,7,3518,40014.0,1402.0,786.0
0.001,17,2,180,1,66,0.0,38.0,38.0,1,114,0.0,86.0,86.0
0.011,6,10,1989,5,910,2.0,642.0,642.0,5,1079,2.0,811.0,811.0
0.01,6,10,1983,5,910,2.0,642.0,642.0,5,1073,2.0,805.0,805.0
0.014,6,10,1989,5,910,3.0,642.0,642.0,5,1079,3.0,811.0,811.0
0.115,6,10,1506,5,395,26.0,127.0,127.0,5,1111,27.0,843.0,843.0
66.113,6,22,10141,12,3973,6010.0,1579.0,835.0,10,6168,7326.0,2111.0,940.0
0.004,17,2,136,1,60,0.0,32.0,32.0,1,76,0.0,48.0,48.0
285.249,6,30,6573,16,1433,19016.0,517.0,290.0,14,5140,21942.0,2378.0,1104.0
0.068,6,10,1506,5,395,15.0,127.0,127.0,5,1111,14.0,843.0,843.0
0.011,6,10,1990,5,911,2.0,643.0,643.0,5,1079,2.0,811.0,811.0
0.101,6,10,1506,5,395,23.0,127.0,127.0,5,1111,21.0,843.0,843.0
0.004,6,10,1702,5,863,1.0,595.0,595.0,5,839,1.0,571.0,571.0
0.087,6,10,1506,5,395,18.0,127.0,127.0,5,1111,18.0,843.0,843.0
0.007,6,10,1547,5,764,1.0,496.0,496.0,5,783,1.0,515.0,515.0
0.009,6,13,3735,7,497,1.0,125.0,125.0,6,3238,1.0,1470.0,1459.0
0.006,6,10,1547,5,764,1.0,496.0,496.0,5,783,1.0,515.0,515.0
0.006,6,10,1643,5,860,1.0,592.0,592.0,5,783,1.0,515.0,515.0
0.001,17,2,136,1,60,0.0,32.0,32.0,1,76,0.0,48.0,48.0
0.01,6,10,1762,5,911,2.0,643.0,643.0,5,851,2.0,583.0,583.0
0.005,17,2,144,1,64,0.0,36.0,36.0,1,80,0.0,52.0,52.0
0.004,6,10,1989,5,927,1.0,659.0,659.0,5,1062,1.0,794.0,794.0
0.005,6,14,3736,7,446,0.0,74.0,74.0,7,3290,0.0,1448.0,972.0
0.009,6,10,1990,5,911,2.0,643.0,643.0,5,1079,2.0,811.0,811.0
0.008,6,10,1990,5,911,2.0,643.0,643.0,5,1079,1.0,811.0,811.0
369.938,6,22,2313,16,867,24662.0,195.0,195.0,6,1446,4641.0,419.0,398.0
324.239,6,780,865398,398,842572,816.0,4080.0,2228.0,382,22826,84.0,2667.0,215.0
0.009,6,13,3747,7,509,1.0,137.0,137.0,6,3238,1.0,1470.0,1459.0
0.006,6,10,1689,5,839,1.0,571.0,571.0,5,850,1.0,582.0,582.0
0.039,17,2,136,1,60,0.0,32.0,32.0,1,76,0.0,48.0,48.0
0.004,17,4,284,2,120,0.0,32.0,32.0,2,164,1.0,60.0,54.0
0.011,6,10,1989,5,910,2.0,642.0,642.0,5,1079,2.0,811.0,811.0
0.006,6,10,1689,5,839,1.0,571.0,571.0,5,850,1.0,582.0,582.0
0.128,6,10,1506,5,395,28.0,127.0,127.0,5,1111,26.0,843.0,843.0
0.12,6,10,1506,5,395,25.0,127.0,127.0,5,1111,23.0,843.0,843.0
0.015,6,10,1989,5,910,3.0,642.0,642.0,5,1079,3.0,811.0,811.0
0.009,6,10,1972,5,910,2.0,642.0,642.0,5,1062,2.0,794.0,794.0
0.014,6,10,1677,5,827,3.0,559.0,559.0,5,850,3.0,582.0,582.0
0.089,6,10,1506,5,395,21.0,127.0,127.0,5,1111,19.0,843.0,843.0
0.095,6,10,1506,5,395,22.0,127.0,127.0,5,1111,20.0,843.0,843.0
0.011,6,10,1983,5,910,2.0,642.0,642.0,5,1073,2.0,805.0,805.0
0.015,6,10,1972,5,910,3.0,642.0,642.0,5,1062,3.0,794.0,794.0
0.005,6,13,3747,7,509,0.0,137.0,137.0,6,3238,0.0,1470.0,1459.0
292.034,6,387,347213,187,21286,1570.0,2736.0,825.0,200,325927,1467.0,2804.0,1696.0
0.108,6,10,1506,5,395,25.0,127.0,127.0,5,1111,25.0,843.0,843.0
0.023,6,10,1983,5,910,5.0,642.0,642.0,5,1073,5.0,805.0,805.0
0.003,17,2,148,1,60,0.0,32.0,32.0,1,88,0.0,60.0,60.0
0.003,17,2,412,1,61,0.0,33.0,33.0,1,351,0.0,323.0,323.0
0.004,6,10,2006,5,927,1.0,659.0,659.0,5,1079,1.0,811.0,811.0
10.826,17,28,4422,14,1995,824.0,270.0,114.0,14,2427,823.0,586.0,145.0
0.005,6,10,2000,5,927,1.0,659.0,659.0,5,1073,1.0,805.0,805.0
0.004,6,10,2000,5,927,1.0,659.0,659.0,5,1073,1.0,805.0,805.0
0.113,6,10,1506,5,395,25.0,127.0,127.0,5,1111,25.0,843.0,843.0
0.01,6,13,3735,7,497,1.0,125.0,125.0,6,3238,1.0,1470.0,1459.0
0.016,6,10,1983,5,910,4.0,642.0,642.0,5,1073,4.0,805.0,805.0
0.082,6,10,1506,5,395,19.0,127.0,127.0,5,1111,16.0,843.0,843.0
0.005,6,10,2000,5,927,1.0,659.0,659.0,5,1073,1.0,805.0,805.0
0.005,6,14,3736,7,446,0.0,74.0,74.0,7,3290,0.0,1448.0,972.0
0.006,6,10,1989,5,927,1.0,659.0,659.0,5,1062,1.0,794.0,794.0
0.001,17,2,180,1,66,0.0,38.0,38.0,1,114,0.0,86.0,86.0
0.014,6,10,1983,5,910,3.0,642.0,642.0,5,1073,3.0,805.0,805.0
371.057,6,24,2405,17,919,23191.0,195.0,195.0,7,1486,3973.0,419.0,398.0
0.004,17,2,136,1,60,0.0,32.0,32.0,1,76,0.0,48.0,48.0
0.004,6,10,2006,5,927,1.0,659.0,659.0,5,1079,1.0,811.0,811.0
0.015,6,10,1972,5,910,3.0,642.0,642.0,5,1062,3.0,794.0,794.0
0.011,17,2,136,1,60,0.0,32.0,32.0,1,76,0.0,48.0,48.0
40.06,17,10,676,5,460,10014.0,104.0,64.0,5,216,10014.0,20.0,15.0
0.01,6,10,1989,5,910,2.0,642.0,642.0,5,1079,2.0,811.0,811.0
40.063,17,10,676,5,460,10014.0,104.0,64.0,5,216,10014.0,20.0,15.0
0.011,17,4,284,2,120,0.0,32.0,32.0,2,164,0.0,60.0,54.0
0.005,6,10,2000,5,927,1.0,659.0,659.0,5,1073,1.0,805.0,805.0
0.019,6,10,1990,5,911,4.0,643.0,643.0,5,1079,4.0,811.0,811.0
0.015,6,10,1972,5,910,3.0,642.0,642.0,5,1062,3.0,794.0,794.0
0.005,6,10,2006,5,927,1.0,659.0,659.0,5,1079,1.0,811.0,811.0
0.014,6,10,1972,5,910,3.0,642.0,642.0,5,1062,3.0,794.0,794.0
0.089,6,10,1506,5,395,19.0,127.0,127.0,5,1111,20.0,843.0,843.0
40.056,17,10,676,5,460,10013.0,104.0,64.0,5,216,10012.0,20.0,15.0
40.071,17,10,676,5,460,10017.0,104.0,64.0,5,216,10016.0,20.0,15.0
240.091,6,31,9571,15,7005,17149.0,2129.0,692.0,16,2566,16005.0,580.0,215.0
0.013,6,10,1990,5,911,3.0,643.0,643.0,5,1079,3.0,811.0,811.0
0.009,6,10,1972,5,910,2.0,642.0,642.0,5,1062,2.0,794.0,794.0
0.008,6,13,3747,7,509,1.0,137.0,137.0,6,3238,1.0,1470.0,1459.0
0.072,17,2,136,1,60,0.0,32.0,32.0,1,76,0.0,48.0,48.0
0.082,6,10,1506,5,395,17.0,127.0,127.0,5,1111,18.0,843.0,843.0
11.116,17,28,4423,14,1994,842.0,269.0,114.0,14,2429,842.0,588.0,145.0
0.004,6,10,1779,5,928,1.0,660.0,660.0,5,851,1.0,583.0,583.0
0.163,6,10,1506,5,395,39.0,127.0,127.0,5,1111,35.0,843.0,843.0
308.696,17,20,1124,10,716,34285.0,48.0,43.0,10,408,34288.0,20.0,12.0
0.134,6,10,1506,5,395,32.0,127.0,127.0,5,1111,33.0,843.0,843.0
0.004,6,10,2000,5,927,1.0,659.0,659.0,5,1073,1.0,805.0,805.0
0.204,6,16,2777,8,1395,29.0,533.0,323.0,8,1382,18.0,529.0,239.0
0.005,6,10,1989,5,927,1.0,659.0,659.0,5,1062,1.0,794.0,794.0
0.005,6,10,1989,5,927,1.0,659.0,659.0,5,1062,1.0,794.0,794.0
0.005,17,2,140,1,62,0.0,34.0,34.0,1,78,0.0,50.0,50.0
40.061,17,10,676,5,460,10013.0,104.0,64.0,5,216,10014.0,20.0,15.0
0.066,6,10,1506,5,395,15.0,127.0,127.0,5,1111,14.0,843.0,843.0
0.157,6,10,1506,5,395,35.0,127.0,127.0,5,1111,36.0,843.0,843.0
0.006,6,10,2000,5,927,1.0,659.0,659.0,5,1073,1.0,805.0,805.0
0.068,17,8,3613,4,1874,22.0,1350.0,440.0,4,1739,11.0,1350.0,406.0
0.008,6,10,1989,5,910,2.0,642.0,642.0,5,1079,2.0,811.0,811.0
0.006,17,2,136,1,60,0.0,32.0,32.0,1,76,0.0,48.0,48.0
0.115,6,10,1506,5,395,25.0,127.0,127.0,5,1111,25.0,843.0,843.0
0.001,17,2,166,1,75,0.0,47.0,47.0,1,91,0.0,63.0,63.0
0.104,6,10,1506,5,395,25.0,127.0,127.0,5,1111,23.0,843.0,843.0
40.069,17,10,676,5,460,10016.0,104.0,64.0,5,216,10016.0,20.0,15.0
0.093,6,10,1506,5,395,20.0,127.0,127.0,5,1111,21.0,843.0,843.0
0.006,6,10,1989,5,927,1.0,659.0,659.0,5,1062,1.0,794.0,794.0
0.127,6,10,1506,5,395,28.0,127.0,127.0,5,1111,25.0,843.0,843.0
0.014,6,13,3735,7,497,2.0,125.0,125.0,6,3238,2.0,1470.0,1459.0
1766.326,6,630,203726,311,168041,5697.0,2883.0,825.0,319,35685,5554.0,1665.0,151.0
0.111,6,10,1506,5,395,24.0,127.0,127.0,5,1111,24.0,843.0,843.0
0.005,6,10,1689,5,839,1.0,571.0,571.0,5,850,1.0,582.0,582.0
309.893,17,20,1124,10,716,34418.0,48.0,43.0,10,408,34418.0,20.0,12.0
0.014,6,10,1990,5,911,3.0,643.0,643.0,5,1079,3.0,811.0,811.0
0.11,6,10,1506,5,395,23.0,127.0,127.0,5,1111,22.0,843.0,843.0
0.009,6,12,1926,6,1189,1.0,659.0,434.0,6,737,1.0,417.0,417.0
0.01,6,13,3735,7,497,1.0,125.0,125.0,6,3238,1.0,1470.0,1459.0
0.013,6,10,1983,5,910,3.0,642.0,642.0,5,1073,3.0,805.0,805.0
0.134,17,2,80,1,32,0.0,4.0,4.0,1,48,0.0,20.0,20.0
0.006,6,10,1989,5,927,1.0,659.0,659.0,5,1062,1.0,794.0,794.0
0.017,6,10,1989,5,910,4.0,642.0,642.0,5,1079,4.0,811.0,811.0
0.064,6,10,1506,5,395,14.0,127.0,127.0,5,1111,14.0,843.0,843.0
0.08,6,10,1506,5,395,18.0,127.0,127.0,5,1111,17.0,843.0,843.0
0.009,6,12,1926,6,1189,1.0,659.0,434.0,6,737,1.0,417.0,417.0
0.004,6,10,1702,5,863,1.0,595.0,595.0,5,839,0.0,571.0,571.0
0.001,17,2,180,1,66,0.0,38.0,38.0,1,114,0.0,86.0,86.0
0.001,17,2,180,1,66,0.0,38.0,38.0,1,114,0.0,86.0,86.0
0.012,6,10,1983,5,910,3.0,642.0,642.0,5,1073,3.0,805.0,805.0
0.005,17,4,284,2,120,0.0,32.0,32.0,2,164,0.0,60.0,54.0
0.085,6,10,1506,5,395,20.0,127.0,127.0,5,1111,19.0,843.0,843.0
0.008,6,10,1989,5,910,2.0,642.0,642.0,5,1079,2.0,811.0,811.0
0.003,17,4,284,2,120,0.0,32.0,32.0,2,164,0.0,60.0,54.0
0.005,17,2,166,1,75,0.0,47.0,47.0,1,91,0.0,63.0,63.0
0.078,6,10,1506,5,395,17.0,127.0,127.0,5,1111,18.0,843.0,843.0
0.004,6,10,2007,5,928,1.0,660.0,660.0,5,1079,1.0,811.0,811.0
0.02,6,10,1972,5,910,4.0,642.0,642.0,5,1062,4.0,794.0,794.0
0.008,6,12,1926,6,1189,1.0,659.0,434.0,6,737,1.0,417.0,417.0
0.034,17,2,152,1,76,0.0,48.0,48.0,1,76,0.0,48.0,48.0
0.006,6,10,1547,5,764,1.0,496.0,496.0,5,783,1.0,515.0,515.0
0.091,6,10,1506,5,395,18.0,127.0,127.0,5,1111,21.0,843.0,843.0
0.005,6,14,3742,7,452,0.0,80.0,80.0,7,3290,0.0,1448.0,972.0
0.005,6,10,1689,5,839,1.0,571.0,571.0,5,850,1.0,582.0,582.0
0.081,6,10,1506,5,395,18.0,127.0,127.0,5,1111,17.0,843.0,843.0
0.005,6,10,1989,5,927,1.0,659.0,659.0,5,1062,1.0,794.0,794.0
0.004,17,2,136,1,60,0.0,32.0,32.0,1,76,0.0,48.0,48.0
0.005,17,2,180,1,66,0.0,38.0,38.0,1,114,0.0,86.0,86.0
0.006,17,2,140,1,62,0.0,34.0,34.0,1,78,0.0,50.0,50.0
0.005,17,2,179,1,71,0.0,43.0,43.0,1,108,0.0,80.0,80.0
0.11,6,10,1506,5,395,24.0,127.0,127.0,5,1111,20.0,843.0,843.0
0.078,6,10,1506,5,395,15.0,127.0,127.0,5,1111,16.0,843.0,843.0
0.005,6,10,1643,5,860,1.0,592.0,592.0,5,783,1.0,515.0,515.0
0.004,17,2,234,1,61,0.0,33.0,33.0,1,173,0.0,145.0,145.0
0.006,6,10,1689,5,839,1.0,571.0,571.0,5,850,1.0,582.0,582.0
0.004,6,10,1774,5,923,1.0,655.0,655.0,5,851,1.0,583.0,583.0
0.029,6,13,3913,7,495,4.0,123.0,123.0,6,3418,5.0,1650.0,1549.0
0.005,6,10,2006,5,927,1.0,659.0,659.0,5,1079,1.0,811.0,811.0
0.003,6,10,1702,5,863,0.0,595.0,595.0,5,839,0.0,571.0,571.0
0.01,6,11,2041,6,962,2.0,642.0,642.0,5,1079,2.0,811.0,811.0
0.015,6,10,1989,5,910,3.0,642.0,642.0,5,1079,3.0,811.0,811.0
240.096,6,16,4481,9,963,30012.0,238.0,166.0,7,3518,40013.0,1402.0,786.0
0.092,6,10,1506,5,395,20.0,127.0,127.0,5,1111,20.0,843.0,843.0
11.151,17,28,4424,14,1995,845.0,270.0,114.0,14,2429,845.0,588.0,145.0
0.008,6,12,1926,6,1189,1.0,659.0,434.0,6,737,1.0,417.0,417.0
0.16,6,10,1506,5,395,38.0,127.0,127.0,5,1111,33.0,843.0,843.0
0.108,6,10,1506,5,395,23.0,127.0,127.0,5,1111,24.0,843.0,843.0
1732.224,6,64,7344,42,4469,42249.0,1625.0,108.0,22,2875,82479.0,1111.0,82.0
0.071,17,2,156,1,64,0.0,36.0,36.0,1,92,0.0,64.0,64.0
0.005,6,14,3742,7,452,0.0,80.0,80.0,7,3290,0.0,1448.0,972.0
40.061,17,10,676,5,460,10014.0,104.0,64.0,5,216,10014.0,20.0,15.0
40.103,17,10,676,5,460,10020.0,104.0,64.0,5,216,10025.0,20.0,15.0
176.309,17,74,10665,37,2469,4897.0,44.0,38.0,37,8196,4897.0,239.0,193.0
0.015,6,10,1990,5,911,3.0,643.0,643.0,5,1079,3.0,811.0,811.0
0.005,6,10,1547,5,764,1.0,496.0,496.0,5,783,1.0,515.0,515.0
0.011,6,10,1983,5,910,2.0,642.0,642.0,5,1073,2.0,805.0,805.0
40.053,17,10,676,5,460,10012.0,104.0,64.0,5,216,10012.0,20.0,15.0
0.004,6,10,1702,5,863,1.0,595.0,595.0,5,839,1.0,571.0,571.0
0.016,17,2,198,1,91,0.0,63.0,63.0,1,107,0.0,79.0,79.0
0.013,6,10,1989,5,910,3.0,642.0,642.0,5,1079,3.0,811.0,811.0
0.016,6,10,1989,5,910,4.0,642.0,642.0,5,1079,4.0,811.0,811.0
0.004,17,2,148,1,60,0.0,32.0,32.0,1,88,0.0,60.0,60.0
0.011,6,10,1972,5,910,2.0,642.0,642.0,5,1062,2.0,794.0,794.0
0.003,17,2,136,1,60,0.0,32.0,32.0,1,76,0.0,48.0,48.0
0.015,6,10,1983,5,910,3.0,642.0,642.0,5,1073,3.0,805.0,805.0
0.005,6,10,2006,5,927,1.0,659.0,659.0,5,1079,1.0,811.0,811.0
11.031,17,28,4393,14,2311,840.0,586.0,137.0,14,2082,840.0,269.0,120.0
40.082,17,10,676,5,460,10013.0,104.0,64.0,5,216,10015.0,20.0,15.0
0.005,6,10,2000,5,927,1.0,659.0,659.0,5,1073,1.0,805.0,805.0
0.103,6,10,1506,5,395,21.0,127.0,127.0,5,1111,19.0,843.0,843.0
0.005,6,10,2007,5,928,1.0,660.0,660.0,5,1079,1.0,811.0,811.0
0.004,6,10,2000,5,927,1.0,659.0,659.0,5,1073,1.0,805.0,805.0
1770.307,6,83,4368,42,2210,43177.0,26.0,26.0,41,2158,44256.0,26.0,26.0
240.012,6,9,787,5,488,60003.0,232.0,232.0,4,299,80003.0,83.0,83.0
40.072,17,10,676,5,460,10016.0,104.0,64.0,5,216,10017.0,20.0,15.0
0.013,6,10,1983,5,910,3.0,642.0,642.0,5,1073,3.0,805.0,805.0
0.005,6,10,1989,5,927,1.0,659.0,659.0,5,1062,1.0,794.0,794.0
0.001,17,2,166,1,75,0.0,47.0,47.0,1,91,0.0,63.0,63.0
294.212,6,331,345542,123,17943,2411.0,2736.0,888.0,208,327599,1421.0,2804.0,1632.0
0.006,6,10,2007,5,928,1.0,660.0,660.0,5,1079,1.0,811.0,811.0
0.041,17,2,182,1,65,0.0,37.0,37.0,1,117,0.0,89.0,89.0
0.003,17,2,148,1,60,0.0,32.0,32.0,1,88,0.0,60.0,60.0
0.012,6,10,1972,5,910,2.0,642.0,642.0,5,1062,2.0,794.0,794.0
0.005,6,10,2006,5,927,1.0,659.0,659.0,5,1079,1.0,811.0,811.0
0.005,17,4,495,2,132,3.0,38.0,38.0,2,363,0.0,176.0,153.0
0.015,6,10,1990,5,911,3.0,643.0,643.0,5,1079,3.0,811.0,811.0
0.01,6,10,1990,5,911,2.0,643.0,643.0,5,1079,2.0,811.0,811.0
0.005,6,10,2006,5,927,1.0,659.0,659.0,5,1079,1.0,811.0,811.0
40.061,17,10,676,5,460,10013.0,104.0,64.0,5,216,10014.0,20.0,15.0
0.006,6,10,1547,5,764,1.0,496.0,496.0,5,783,1.0,515.0,515.0
0.147,6,10,1506,5,395,32.0,127.0,127.0,5,1111,34.0,843.0,843.0
40.065,17,10,676,5,460,10015.0,104.0,64.0,5,216,10015.0,20.0,15.0
0.105,17,2,179,1,71,0.0,43.0,43.0,1,108,0.0,80.0,80.0
0.005,6,10,2006,5,927,1.0,659.0,659.0,5,1079,1.0,811.0,811.0
0.004,17,2,170,1,65,0.0,37.0,37.0,1,105,0.0,77.0,77.0
0.004,6,10,1779,5,928,1.0,660.0,660.0,5,851,1.0,583.0,583.0
0.039,17,2,170,1,65,0.0,37.0,37.0,1,105,0.0,77.0,77.0
0.005,6,10,1989,5,927,1.0,659.0,659.0,5,1062,1.0,794.0,794.0
0.018,6,10,1972,5,910,4.0,642.0,642.0,5,1062,4.0,794.0,794.0
0.009,6,10,1989,5,910,2.0,642.0,642.0,5,1079,2.0,811.0,811.0
0.004,6,10,2007,5,928,1.0,660.0,660.0,5,1079,1.0,811.0,811.0
0.08,6,10,1506,5,395,16.0,127.0,127.0,5,1111,19.0,843.0,843.0
173.39,17,74,10484,37,2468,4816.0,44.0,38.0,37,8016,4816.0,261.0,188.0
0.005,6,10,2007,5,928,1.0,660.0,660.0,5,1079,1.0,811.0,811.0
0.01,6,10,1972,5,910,2.0,642.0,642.0,5,1062,2.0,794.0,794.0
0.006,6,10,1547,5,764,1.0,496.0,496.0,5,783,1.0,515.0,515.0
300.024,6,12,1782,7,1348,50004.0,494.0,494.0,5,434,75004.0,83.0,83.0
0.011,6,10,1990,5,911,2.0,643.0,643.0,5,1079,2.0,811.0,811.0
0.012,6,10,2006,5,927,3.0,659.0,659.0,5,1079,3.0,811.0,811.0
0.097,6,10,1506,5,395,20.0,127.0,127.0,5,1111,22.0,843.0,843.0
0.1,6,10,1506,5,395,21.0,127.0,127.0,5,1111,22.0,843.0,843.0
0.004,17,4,284,2,120,0.0,32.0,32.0,2,164,1.0,60.0,54.0
40.071,17,10,676,5,460,10016.0,104.0,64.0,5,216,10017.0,20.0,15.0
0.005,6,10,1547,5,764,1.0,496.0,496.0,5,783,1.0,515.0,515.0
0.006,6,10,1547,5,764,1.0,496.0,496.0,5,783,1.0,515.0,515.0
0.053,17,2,152,1,76,0.0,48.0,48.0,1,76,0.0,48.0,48.0
0.077,6,10,1506,5,395,18.0,127.0,127.0,5,1111,14.0,843.0,843.0
0.087,6,10,1506,5,395,19.0,127.0,127.0,5,1111,19.0,843.0,843.0
0.015,6,10,1972,5,910,3.0,642.0,642.0,5,1062,3.0,794.0,794.0
15.216,17,18,8443,9,6217,1898.0,1350.0,662.0,9,2226,1898.0,1350.0,219.0
0.005,6,10,2006,5,927,1.0,659.0,659.0,5,1079,1.0,811.0,811.0
0.015,6,10,1631,5,848,3.0,580.0,580.0,5,783,3.0,515.0,515.0
0.006,6,10,1547,5,764,1.0,496.0,496.0,5,783,1.0,515.0,515.0
0.153,6,10,1506,5,395,34.0,127.0,127.0,5,1111,35.0,843.0,843.0
40.051,17,10,676,5,460,10011.0,104.0,64.0,5,216,10012.0,20.0,15.0
0.117,6,10,1506,5,395,27.0,127.0,127.0,5,1111,27.0,843.0,843.0
0.08,6,10,1506,5,395,18.0,127.0,127.0,5,1111,15.0,843.0,843.0
0.005,17,2,170,1,65,0.0,37.0,37.0,1,105,0.0,77.0,77.0
40.058,17,10,676,5,460,10013.0,104.0,64.0,5,216,10013.0,20.0,15.0
0.091,6,10,1506,5,395,20.0,127.0,127.0,5,1111,22.0,843.0,843.0
0.17,6,3,453,2,321,170.0,241.0,241.0,1,132,0.0,92.0,92.0
0.011,6,10,1990,5,911,2.0,643.0,643.0,5,1079,2.0,811.0,811.0
11.109,17,28,4398,14,2313,845.0,588.0,137.0,14,2085,845.0,268.0,120.0
0.017,6,10,1989,5,910,4.0,642.0,642.0,5,1079,4.0,811.0,811.0
0.006,17,2,169,1,62,0.0,34.0,34.0,1,107,0.0,79.0,79.0
240.264,6,40,5201,19,2387,13347.0,588.0,197.0,21,2814,12013.0,580.0,214.0
0.004,6,10,2006,5,927,1.0,659.0,659.0,5,1079,1.0,811.0,811.0
40.056,17,10,676,5,460,10012.0,104.0,64.0,5,216,10013.0,20.0,15.0
308.749,17,20,1124,10,716,34291.0,48.0,43.0,10,408,34290.0,20.0,12.0
40.097,17,10,676,5,460,10022.0,104.0,64.0,5,216,10023.0,20.0,15.0
0.005,6,10,2006,5,927,1.0,659.0,659.0,5,1079,1.0,811.0,811.0
0.092,6,10,1506,5,395,18.0,127.0,127.0,5,1111,21.0,843.0,843.0
0.173,17,2,152,1,76,0.0,48.0,48.0,1,76,0.0,48.0,48.0
0.008,17,2,194,1,59,0.0,31.0,31.0,1,135,0.0,107.0,107.0
0.02,6,10,1972,5,910,4.0,642.0,642.0,5,1062,5.0,794.0,794.0
0.011,6,10,1762,5,911,2.0,643.0,643.0,5,851,2.0,583.0,583.0
0.102,6,10,1506,5,395,19.0,127.0,127.0,5,1111,22.0,843.0,843.0
300.999,6,43,12662,23,6835,13681.0,1567.0,840.0,20,5827,464.0,2667.0,385.0
0.021,6,10,1989,5,910,5.0,642.0,642.0,5,1079,5.0,811.0,811.0
0.07,6,10,1506,5,395,17.0,127.0,127.0,5,1111,16.0,843.0,843.0
0.001,17,2,180,1,66,0.0,38.0,38.0,1,114,0.0,86.0,86.0
0.006,6,13,3690,7,452,1.0,80.0,80.0,6,3238,1.0,1470.0,1459.0
0.006,6,10,1689,5,839,1.0,571.0,571.0,5,850,1.0,582.0,582.0
0.012,6,10,1677,5,827,3.0,559.0,559.0,5,850,2.0,582.0,582.0
0.04,17,2,152,1,76,0.0,48.0,48.0,1,76,0.0,48.0,48.0
0.004,6,10,1779,5,928,1.0,660.0,660.0,5,851,1.0,583.0,583.0
0.053,17,2,152,1,76,0.0,48.0,48.0,1,76,0.0,48.0,48.0
0.101,6,10,1506,5,395,20.0,127.0,127.0,5,1111,23.0,843.0,843.0
0.005,6,10,1854,5,889,1.0,621.0,621.0,5,965,1.0,697.0,697.0
40.054,17,10,676,5,460,10012.0,104.0,64.0,5,216,10012.0,20.0,15.0
0.003,17,2,136,1,60,0.0,32.0,32.0,1,76,0.0,48.0,48.0
0.098,6,10,1506,5,395,22.0,127.0,127.0,5,1111,21.0,843.0,843.0
0.098,6,10,1506,5,395,18.0,127.0,127.0,5,1111,21.0,843.0,843.0
0.001,17,2,166,1,75,0.0,47.0,47.0,1,91,0.0,63.0,63.0
240.096,6,16,4482,9,963,30012.0,238.0,166.0,7,3519,40015.0,1402.0,786.0
0.008,6,10,1989,5,927,2.0,659.0,659.0,5,1062,1.0,794.0,794.0
0.006,6,12,1698,6,863,1.0,327.0,271.0,6,835,1.0,515.0,515.0
0.072,17,2,148,1,60,0.0,32.0,32.0,1,88,0.0,60.0,60.0
309.494,17,20,1124,10,716,34381.0,48.0,43.0,10,408,34381.0,20.0,12.0
0.006,6,10,2006,5,927,1.0,659.0,659.0,5,1079,1.0,811.0,811.0
0.005,17,2,230,1,68,0.0,40.0,40.0,1,162,0.0,134.0,134.0
0.005,6,10,1989,5,927,1.0,659.0,659.0,5,1062,1.0,794.0,794.0
15.076,17,16,8219,8,6074,2149.0,1350.0,731.0,8,2145,2149.0,1350.0,240.0
0.085,6,10,1506,5,395,18.0,127.0,127.0,5,1111,17.0,843.0,843.0
0.005,17,2,230,1,68,0.0,40.0,40.0,1,162,0.0,134.0,134.0
0.092,6,10,1506,5,395,21.0,127.0,127.0,5,1111,22.0,843.0,843.0
309.84,17,20,1124,10,716,34419.0,48.0,43.0,10,408,34419.0,20.0,12.0
0.003,17,4,284,2,120,0.0,32.0,32.0,2,164,0.0,60.0,54.0
1729.868,6,76,13872,48,5192,36805.0,1640.0,122.0,28,8680,64063.0,1402.0,288.0
0.005,6,10,1689,5,839,1.0,571.0,571.0,5,850,1.0,582.0,582.0
0.164,17,2,152,1,76,0.0,48.0,48.0,1,76,0.0,48.0,48.0
0.058,17,2,179,1,71,0.0,43.0,43.0,1,108,0.0,80.0,80.0
0.012,6,10,1983,5,910,2.0,642.0,642.0,5,1073,3.0,805.0,805.0
40.085,17,10,676,5,460,10019.0,104.0,64.0,5,216,10020.0,20.0,15.0
0.003,17,2,148,1,60,0.0,32.0,32.0,1,88,0.0,60.0,60.0
0.005,17,2,164,1,74,0.0,46.0,46.0,1,90,0.0,62.0,62.0
40.081,17,10,676,5,460,10019.0,104.0,64.0,5,216,10019.0,20.0,15.0
300.324,6,16,2170,9,684,37520.0,146.0,146.0,7,1486,50026.0,419.0,398.0
0.005,6,10,1643,5,860,1.0,592.0,592.0,5,783,1.0,515.0,515.0
0.012,6,13,3735,7,497,1.0,125.0,125.0,6,3238,2.0,1470.0,1459.0
0.02,6,10,1990,5,911,5.0,643.0,643.0,5,1079,5.0,811.0,811.0
15.171,17,20,11012,10,7391,1682.0,1350.0,711.0,10,3621,1682.0,1350.0,334.0
0.004,17,2,132,1,58,0.0,30.0,30.0,1,74,0.0,46.0,46.0
0.038,17,2,412,1,61,0.0,33.0,33.0,1,351,0.0,323.0,323.0
40.052,17,10,676,5,460,10011.0,104.0,64.0,5,216,10011.0,20.0,15.0
1774.805,6,276,39118,112,22312,15987.0,2720.0,202.0,164,16806,10887.0,1360.0,129.0
40.053,17,10,676,5,460,10012.0,104.0,64.0,5,216,10012.0,20.0,15.0
0.005,6,10,2000,5,927,1.0,659.0,659.0,5,1073,1.0,805.0,805.0
0.004,6,10,1702,5,863,1.0,595.0,595.0,5,839,1.0,571.0,571.0
40.075,17,10,676,5,460,10016.0,104.0,64.0,5,216,10017.0,20.0,15.0
0.035,6,10,1983,5,910,8.0,642.0,642.0,5,1073,8.0,805.0,805.0
0.107,6,10,1506,5,395,25.0,127.0,127.0,5,1111,21.0,843.0,843.0
0.005,6,10,2007,5,928,1.0,660.0,660.0,5,1079,1.0,811.0,811.0
40.063,17,10,676,5,460,10014.0,104.0,64.0,5,216,10014.0,20.0,15.0
0.005,6,10,2007,5,928,1.0,660.0,660.0,5,1079,1.0,811.0,811.0
0.018,6,10,1989,5,910,4.0,642.0,642.0,5,1079,4.0,811.0,811.0
0.122,6,10,1506,5,395,27.0,127.0,127.0,5,1111,28.0,843.0,843.0
0.008,6,10,1989,5,910,2.0,642.0,642.0,5,1079,1.0,811.0,811.0
361.777,6,21,1793,16,1030,24118.0,190.0,190.0,5,763,60009.0,462.0,247.0
0.001,17,2,180,1,66,0.0,38.0,38.0,1,114,0.0,86.0,86.0
0.013,6,10,1983,5,910,3.0,642.0,642.0,5,1073,3.0,805.0,805.0
40.083,17,10,676,5,460,10019.0,104.0,64.0,5,216,10019.0,20.0,15.0
374.61,6,22,2313,16,867,24974.0,195.0,195.0,6,1446,4641.0,419.0,398.0
364.384,6,21,1793,16,1030,24292.0,190.0,190.0,5,763,60011.0,462.0,247.0
0.137,6,10,1506,5,395,30.0,127.0,127.0,5,1111,28.0,843.0,843.0
0.09,6,10,1506,5,395,21.0,127.0,127.0,5,1111,19.0,843.0,843.0
0.922,6,10,1905,6,1551,184.0,1299.0,1299.0,4,354,229.0,182.0,182.0
0.172,6,10,1506,5,395,40.0,127.0,127.0,5,1111,39.0,843.0,843.0
0.005,6,13,3747,7,509,0.0,137.0,137.0,6,3238,0.0,1470.0,1459.0
0.001,17,2,180,1,66,0.0,38.0,38.0,1,114,0.0,86.0,86.0
0.005,17,2,170,1,65,0.0,37.0,37.0,1,105,0.0,77.0,77.0
0.124,6,10,1506,5,395,24.0,127.0,127.0,5,1111,26.0,843.0,843.0
0.014,6,10,1972,5,910,3.0,642.0,642.0,5,1062,3.0,794.0,794.0
0.006,17,2,136,1,60,0.0,32.0,32.0,1,76,0.0,48.0,48.0
0.138,6,10,1506,5,395,30.0,127.0,127.0,5,1111,31.0,843.0,843.0
0.006,6,10,1689,5,839,1.0,571.0,571.0,5,850,1.0,582.0,582.0
40.06,17,10,676,5,460,10012.0,104.0,64.0,5,216,10013.0,20.0,15.0
0.014,6,10,1989,5,910,3.0,642.0,642.0,5,1079,3.0,811.0,811.0
0.088,6,10,1506,5,395,16.0,127.0,127.0,5,1111,18.0,843.0,843.0
0.005,17,2,169,1,62,0.0,34.0,34.0,1,107,0.0,79.0,79.0
0.03,17,2,140,1,62,0.0,34.0,34.0,1,78,0.0,50.0,50.0
0.005,6,10,1779,5,928,1.0,660.0,660.0,5,851,1.0,583.0,583.0
0.012,6,10,1989,5,910,2.0,642.0,642.0,5,1079,3.0,811.0,811.0
0.007,6,10,1989,5,927,1.0,659.0,659.0,5,1062,1.0,794.0,794.0
0.08,6,10,1506,5,395,17.0,127.0,127.0,5,1111,16.0,843.0,843.0
0.012,6,10,1972,5,910,3.0,642.0,642.0,5,1062,2.0,794.0,794.0
0.006,6,12,1698,6,863,1.0,327.0,271.0,6,835,1.0,515.0,515.0
0.014,6,10,1989,5,910,3.0,642.0,642.0,5,1079,3.0,811.0,811.0
0.008,6,10,1989,5,910,2.0,642.0,642.0,5,1079,1.0,811.0,811.0
0.038,17,2,152,1,76,0.0,48.0,48.0,1,76,0.0,48.0,48.0
0.016,17,2,198,1,91,0.0,63.0,63.0,1,107,0.0,79.0,79.0
15.071,17,15,9238,8,6902,2149.0,1350.0,834.0,7,2336,2507.0,1350.0,305.0
40.083,17,10,676,5,460,10019.0,104.0,64.0,5,216,10019.0,20.0,15.0
0.121,6,10,1506,5,395,29.0,127.0,127.0,5,1111,27.0,843.0,843.0
0.037,17,2,148,1,60,0.0,32.0,32.0,1,88,0.0,60.0,60.0
40.073,17,10,676,5,460,10016.0,104.0,64.0,5,216,10017.0,20.0,15.0
0.003,17,2,187,1,74,0.0,46.0,46.0,1,113,0.0,85.0,85.0
0.005,6,10,2006,5,927,1.0,659.0,659.0,5,1079,1.0,811.0,811.0
0.003,17,2,144,1,64,0.0,36.0,36.0,1,80,0.0,52.0,52.0
0.001,17,2,166,1,75,0.0,47.0,47.0,1,91,0.0,63.0,63.0
0.005,6,10,1989,5,927,1.0,659.0,659.0,5,1062,1.0,794.0,794.0
0.012,6,10,1989,5,910,3.0,642.0,642.0,5,1079,3.0,811.0,811.0
0.038,6,10,1677,5,827,9.0,559.0,559.0,5,850,9.0,582.0,582.0
0.005,6,10,1989,5,927,1.0,659.0,659.0,5,1062,1.0,794.0,794.0
0.005,6,10,1989,5,927,1.0,659.0,659.0,5,1062,1.0,794.0,794.0
0.005,6,10,1547,5,764,1.0,496.0,496.0,5,783,1.0,515.0,515.0
289.6,6,389,347907,195,21705,1492.0,2736.0,889.0,194,326202,1500.0,2804.0,1765.0
0.005,6,10,1689,5,839,1.0,571.0,571.0,5,850,1.0,582.0,582.0
0.005,17,2,144,1,64,0.0,36.0,36.0,1,80,0.0,52.0,52.0
0.005,6,14,3736,7,446,0.0,74.0,74.0,7,3290,0.0,1448.0,972.0
0.012,6,10,1989,5,910,3.0,642.0,642.0,5,1079,3.0,811.0,811.0
0.008,6,12,1926,6,1189,1.0,659.0,434.0,6,737,1.0,417.0,417.0
0.071,6,10,1506,5,395,15.0,127.0,127.0,5,1111,17.0,843.0,843.0
0.015,6,10,1677,5,827,3.0,559.0,559.0,5,850,3.0,582.0,582.0
0.212,17,4,596,2,122,175.0,33.0,33.0,2,474,140.0,323.0,209.0
0.009,6,10,1989,5,927,2.0,659.0,659.0,5,1062,2.0,794.0,794.0
40.069,17,10,676,5,460,10016.0,104.0,64.0,5,216,10016.0,20.0,15.0
0.003,17,2,148,1,60,0.0,32.0,32.0,1,88,0.0,60.0,60.0
0.081,6,10,1506,5,395,17.0,127.0,127.0,5,1111,16.0,843.0,843.0
0.095,6,10,1506,5,395,23.0,127.0,127.0,5,1111,21.0,843.0,843.0
174.22,17,82,11885,41,2737,4355.0,44.0,38.0,41,9148,4355.0,261.0,195.0
0.005,6,10,1547,5,764,1.0,496.0,496.0,5,783,1.0,515.0,515.0
0.007,6,10,1989,5,927,1.0,659.0,659.0,5,1062,1.0,794.0,794.0
1799.981,6,138,6704,77,3704,23683.0,39.0,39.0,61,3000,29995.0,35.0,35.0
8.996,6,39,10487,20,4929,473.0,1360.0,682.0,19,5558,488.0,2667.0,435.0
0.005,6,10,2006,5,927,1.0,659.0,659.0,5,1079,1.0,811.0,811.0
0.005,17,2,170,1,65,0.0,37.0,37.0,1,105,0.0,77.0,77.0
0.006,6,10,1689,5,839,1.0,571.0,571.0,5,850,1.0,582.0,582.0
0.005,6,10,2007,5,928,1.0,660.0,660.0,5,1079,1.0,811.0,811.0
0.013,6,10,1972,5,910,3.0,642.0,642.0,5,1062,3.0,794.0,794.0
0.008,6,10,1990,5,911,2.0,643.0,643.0,5,1079,1.0,811.0,811.0
0.011,6,10,1990,5,911,2.0,643.0,643.0,5,1079,2.0,811.0,811.0
0.007,6,12,1698,6,863,1.0,327.0,271.0,6,835,1.0,515.0,515.0
0.001,17,2,136,1,60,0.0,32.0,32.0,1,76,0.0,48.0,48.0
10.873,17,28,4420,14,1993,828.0,268.0,114.0,14,2427,828.0,586.0,145.0
0.069,6,10,1506,5,395,14.0,127.0,127.0,5,1111,16.0,843.0,843.0
0.012,6,10,1983,5,910,2.0,642.0,642.0,5,1073,3.0,805.0,805.0
0.006,6,10,2000,5,927,1.0,659.0,659.0,5,1073,1.0,805.0,805.0
452.088,6,48,19552,26,3748,18083.0,661.0,398.0,22,15804,18668.0,1405.0,976.0
0.007,17,2,179,1,71,0.0,43.0,43.0,1,108,0.0,80.0,80.0
0.015,6,10,1972,5,910,3.0,642.0,642.0,5,1062,3.0,794.0,794.0
0.046,17,4,284,2,120,0.0,32.0,32.0,2,164,36.0,60.0,54.0
0.019,6,10,1972,5,910,4.0,642.0,642.0,5,1062,4.0,794.0,794.0
0.073,17,2,144,1,64,0.0,36.0,36.0,1,80,0.0,52.0,52.0
0.081,6,10,1506,5,395,18.0,127.0,127.0,5,1111,17.0,843.0,843.0
0.005,6,14,3736,7,446,0.0,74.0,74.0,7,3290,0.0,1448.0,972.0
0.006,6,10,2007,5,928,1.0,660.0,660.0,5,1079,1.0,811.0,811.0
0.13,6,10,1506,5,395,21.0,127.0,127.0,5,1111,29.0,843.0,843.0
0.005,6,10,1689,5,839,1.0,571.0,571.0,5,850,1.0,582.0,582.0
0.064,6,10,1506,5,395,15.0,127.0,127.0,5,1111,13.0,843.0,843.0
0.005,6,10,2006,5,927,1.0,659.0,659.0,5,1079,1.0,811.0,811.0
301.182,6,50,21223,27,15276,11583.0,2720.0,1287.0,23,5947,409.0,2667.0,385.0
0.005,6,10,1779,5,928,1.0,660.0,660.0,5,851,1.0,583.0,583.0
0.005,6,10,1989,5,927,1.0,659.0,659.0,5,1062,1.0,794.0,794.0
0.005,6,10,1989,5,927,1.0,659.0,659.0,5,1062,1.0,794.0,794.0
0.004,6,10,1774,5,923,1.0,655.0,655.0,5,851,1.0,583.0,583.0
0.004,6,10,1779,5,928,1.0,660.0,660.0,5,851,1.0,583.0,583.0
165.103,17,88,12844,44,2962,3839.0,44.0,39.0,44,9882,3839.0,252.0,196.0
0.004,6,10,1702,5,863,1.0,595.0,595.0,5,839,0.0,571.0,571.0
0.194,6,10,1506,5,395,47.0,127.0,127.0,5,1111,38.0,843.0,843.0
0.021,17,2,154,1,69,0.0,41.0,41.0,1,85,0.0,57.0,57.0
0.004,6,14,3742,7,452,0.0,80.0,80.0,7,3290,0.0,1448.0,972.0
40.061,17,10,676,5,460,10012.0,104.0,64.0,5,216,10014.0,20.0,15.0
0.001,17,2,180,1,66,0.0,38.0,38.0,1,114,0.0,86.0,86.0
40.072,17,10,676,5,460,10016.0,104.0,64.0,5,216,10017.0,20.0,15.0
0.005,6,10,1779,5,928,1.0,660.0,660.0,5,851,1.0,583.0,583.0
0.008,6,10,1972,5,910,2.0,642.0,642.0,5,1062,1.0,794.0,794.0
1768.528,6,290,92951,181,82621,9825.0,1402.0,665.0,109,10330,16375.0,93.0,65.0
240.102,6,16,4481,9,963,30012.0,238.0,166.0,7,3518,40015.0,1402.0,786.0
0.005,6,10,2007,5,928,1.0,660.0,660.0,5,1079,1.0,811.0,811.0
0.004,6,10,2007,5,928,1.0,660.0,660.0,5,1079,1.0,811.0,811.0
0.053,17,2,152,1,76,0.0,48.0,48.0,1,76,0.0,48.0,48.0
0.011,6,10,1983,5,910,2.0,642.0,642.0,5,1073,2.0,805.0,805.0
0.013,6,10,1972,5,910,3.0,642.0,642.0,5,1062,3.0,794.0,794.0
0.005,6,10,1643,5,860,1.0,592.0,592.0,5,783,1.0,515.0,515.0
0.005,6,10,2006,5,927,1.0,659.0,659.0,5,1079,1.0,811.0,811.0
0.012,6,10,1989,5,910,3.0,642.0,642.0,5,1079,3.0,811.0,811.0
0.008,6,10,2000,5,927,2.0,659.0,659.0,5,1073,2.0,805.0,805.0
0.015,6,10,1631,5,848,3.0,580.0,580.0,5,783,3.0,515.0,515.0
0.004,6,14,3742,7,452,0.0,80.0,80.0,7,3290,0.0,1448.0,972.0
1721.217,6,63,7244,40,4347,44133.0,1640.0,113.0,23,2897,78229.0,1112.0,85.0
0.004,6,10,1702,5,863,1.0,595.0,595.0,5,839,1.0,571.0,571.0
0.229,6,16,2777,8,1395,32.0,533.0,323.0,8,1382,21.0,529.0,239.0
0.009,6,12,1926,6,1189,1.0,659.0,434.0,6,737,1.0,417.0,417.0
0.006,6,10,1854,5,889,1.0,621.0,621.0,5,965,1.0,697.0,697.0
0.078,6,10,1506,5,395,19.0,127.0,127.0,5,1111,16.0,843.0,843.0
0.009,17,2,148,1,60,0.0,32.0,32.0,1,88,0.0,60.0,60.0
0.007,17,2,132,1,58,0.0,30.0,30.0,1,74,0.0,46.0,46.0
0.005,17,2,225,1,65,0.0,37.0,37.0,1,160,0.0,132.0,132.0
0.011,6,10,1989,5,910,2.0,642.0,642.0,5,1079,2.0,811.0,811.0
0.005,6,10,2000,5,927,1.0,659.0,659.0,5,1073,1.0,805.0,805.0
0.135,6,10,1506,5,395,30.0,127.0,127.0,5,1111,32.0,843.0,843.0
0.005,17,2,164,1,74,0.0,46.0,46.0,1,90,0.0,62.0,62.0
66.765,6,108,86954,63,12368,1076.0,2824.0,1297.0,45,74586,1513.0,3398.0,1901.0
0.005,17,2,169,1,62,0.0,34.0,34.0,1,107,0.0,79.0,79.0
0.096,6,10,1506,5,395,23.0,127.0,127.0,5,1111,21.0,843.0,843.0
10.919,17,28,4418,14,1994,831.0,269.0,114.0,14,2424,831.0,587.0,145.0
0.014,6,10,1989,5,910,3.0,642.0,642.0,5,1079,3.0,811.0,811.0
40.062,17,10,676,5,460,10014.0,104.0,64.0,5,216,10014.0,20.0,15.0
0.001,17,2,179,1,62,0.0,34.0,34.0,1,117,0.0,89.0,89.0
1799.024,17,3031,231906,1506,122101,1195.0,84.0,53.0,1525,109805,1180.0,227.0,44.0
0.005,6,10,1689,5,839,1.0,571.0,571.0,5,850,1.0,582.0,582.0
0.082,6,10,1506,5,395,18.0,127.0,127.0,5,1111,16.0,843.0,843.0
0.004,17,2,136,1,60,0.0,32.0,32.0,1,76,0.0,48.0,48.0
15.075,17,15,9238,8,6902,2149.0,1350.0,834.0,7,2336,2507.0,1350.0,305.0
0.1,6,10,1506,5,395,21.0,127.0,127.0,5,1111,22.0,843.0,843.0
167.32,17,66,9419,33,2201,5228.0,44.0,38.0,33,7218,5228.0,261.0,190.0
0.005,6,10,1689,5,839,1.0,571.0,571.0,5,850,1.0,582.0,582.0
0.006,6,10,2000,5,927,1.0,659.0,659.0,5,1073,1.0,805.0,805.0
0.003,17,2,136,1,60,0.0,32.0,32.0,1,76,0.0,48.0,48.0
0.005,6,10,2006,5,927,1.0,659.0,659.0,5,1079,1.0,811.0,811.0
0.164,6,10,1506,5,395,36.0,127.0,127.0,5,1111,20.0,843.0,843.0
0.06,17,2,152,1,76,0.0,48.0,48.0,1,76,0.0,48.0,48.0
0.007,6,10,1854,5,889,1.0,621.0,621.0,5,965,1.0,697.0,697.0
241.814,6,389,348508,185,21143,1314.0,2736.0,959.0,204,327365,1191.0,3138.0,1632.0
0.018,6,10,1989,5,910,4.0,642.0,642.0,5,1079,4.0,811.0,811.0
0.004,6,10,1702,5,863,1.0,595.0,595.0,5,839,1.0,571.0,571.0
0.095,6,10,1506,5,395,21.0,127.0,127.0,5,1111,21.0,843.0,843.0
0.006,6,10,1547,5,764,1.0,496.0,496.0,5,783,1.0,515.0,515.0
0.003,17,2,136,1,60,0.0,32.0,32.0,1,76,0.0,48.0,48.0
0.006,17,2,214,1,75,0.0,47.0,47.0,1,139,0.0,111.0,111.0
0.005,17,2,194,1,59,0.0,31.0,31.0,1,135,0.0,107.0,107.0
0.025,6,10,1983,5,910,6.0,642.0,642.0,5,1073,6.0,805.0,805.0
40.058,17,10,676,5,460,10013.0,104.0,64.0,5,216,10013.0,20.0,15.0
0.018,6,10,1990,5,911,4.0,643.0,643.0,5,1079,4.0,811.0,811.0
40.061,17,10,676,5,460,10014.0,104.0,64.0,5,216,10014.0,20.0,15.0
0.006,6,14,3799,7,509,1.0,137.0,137.0,7,3290,0.0,1448.0,972.0
0.004,6,10,1774,5,923,1.0,655.0,655.0,5,851,1.0,583.0,583.0
240.095,6,16,4481,9,963,30011.0,238.0,166.0,7,3518,40015.0,1402.0,786.0
1770.404,6,83,4392,41,2159,44259.0,27.0,27.0,42,2233,43179.0,26.0,24.0
0.006,17,2,148,1,60,0.0,32.0,32.0,1,88,0.0,60.0,60.0
309.054,17,20,1124,10,716,34325.0,48.0,43.0,10,408,34325.0,20.0,12.0
289.35,6,312,344051,120,17791,2431.0,2736.0,888.0,192,326260,1514.0,2804.0,1776.0
0.006,17,2,170,1,65,0.0,37.0,37.0,1,105,0.0,77.0,77.0
0.018,6,10,1972,5,910,4.0,642.0,642.0,5,1062,4.0,794.0,794.0
0.013,6,10,1983,5,910,3.0,642.0,642.0,5,1073,3.0,805.0,805.0
0.011,6,10,1990,5,911,2.0,643.0,643.0,5,1079,2.0,811.0,811.0
0.005,6,10,1854,5,889,1.0,621.0,621.0,5,965,1.0,697.0,697.0
0.012,6,10,1972,5,910,2.0,642.0,642.0,5,1062,3.0,794.0,794.0
0.074,6,10,1506,5,395,16.0,127.0,127.0,5,1111,16.0,843.0,843.0
40.075,17,10,676,5,460,10015.0,104.0,64.0,5,216,10018.0,20.0,15.0
0.015,6,10,1990,5,911,3.0,643.0,643.0,5,1079,3.0,811.0,811.0
0.018,6,10,1989,5,910,4.0,642.0,642.0,5,1079,4.0,811.0,811.0
361.86,6,21,1804,16,1042,24124.0,190.0,190.0,5,762,60009.0,461.0,247.0
0.013,6,10,1983,5,910,3.0,642.0,642.0,5,1073,3.0,805.0,805.0
0.008,6,10,1972,5,910,2.0,642.0,642.0,5,1062,2.0,794.0,794.0
0.005,6,10,2006,5,927,1.0,659.0,659.0,5,1079,1.0,811.0,811.0
0.001,17,2,136,1,60,0.0,32.0,32.0,1,76,0.0,48.0,48.0
0.027,6,10,1631,5,848,6.0,580.0,580.0,5,783,6.0,515.0,515.0
0.013,6,10,1990,5,911,3.0,643.0,643.0,5,1079,3.0,811.0,811.0
0.015,6,10,1972,5,910,3.0,642.0,642.0,5,1062,3.0,794.0,794.0
0.007,17,2,194,1,59,0.0,31.0,31.0,1,135,0.0,107.0,107.0
0.105,6,10,1506,5,395,25.0,127.0,127.0,5,1111,25.0,843.0,843.0
0.008,6,10,2006,5,927,2.0,659.0,659.0,5,1079,2.0,811.0,811.0
0.106,6,10,1506,5,395,23.0,127.0,127.0,5,1111,26.0,843.0,843.0
0.005,6,10,1989,5,927,1.0,659.0,659.0,5,1062,1.0,794.0,794.0
0.005,6,10,2007,5,928,1.0,660.0,660.0,5,1079,1.0,811.0,811.0
0.078,6,10,1506,5,395,18.0,127.0,127.0,5,1111,18.0,843.0,843.0
0.01,6,10,1972,5,910,2.0,642.0,642.0,5,1062,2.0,794.0,794.0
176.281,17,70,9955,35,2331,5184.0,44.0,38.0,35,7624,5184.0,239.0,189.0
0.006,6,10,1547,5,764,1.0,496.0,496.0,5,783,1.0,515.0,515.0
0.007,6,10,1989,5,910,1.0,642.0,642.0,5,1079,1.0,811.0,811.0
0.006,6,10,1547,5,764,1.0,496.0,496.0,5,783,1.0,515.0,515.0
0.004,6,10,1774,5,923,1.0,655.0,655.0,5,851,1.0,583.0,583.0
0.008,6,12,1926,6,1189,1.0,659.0,434.0,6,737,1.0,417.0,417.0
1787.506,6,154,19574,92,13852,19642.0,302.0,302.0,62,5722,29303.0,83.0,83.0
0.007,6,10,1689,5,839,1.0,571.0,571.0,5,850,1.0,582.0,582.0
0.113,6,10,1506,5,395,27.0,127.0,127.0,5,1111,24.0,843.0,843.0
0.005,6,10,1854,5,889,1.0,621.0,621.0,5,965,1.0,697.0,697.0
0.083,6,10,1506,5,395,13.0,127.0,127.0,5,1111,19.0,843.0,843.0
0.008,6,12,1926,6,1189,1.0,659.0,434.0,6,737,1.0,417.0,417.0
0.108,6,10,1506,5,395,25.0,127.0,127.0,5,1111,24.0,843.0,843.0
0.003,17,2,148,1,60,0.0,32.0,32.0,1,88,0.0,60.0,60.0
0.112,6,10,1506,5,395,22.0,127.0,127.0,5,1111,25.0,843.0,843.0
1791.26,6,240,46315,116,33912,15576.0,2472.0,995.0,124,12403,14563.0,580.0,61.0
0.005,17,4,284,2,120,0.0,32.0,32.0,2,164,0.0,60.0,54.0
0.005,6,10,1643,5,860,1.0,592.0,592.0,5,783,1.0,515.0,515.0
0.005,6,10,1989,5,927,1.0,659.0,659.0,5,1062,1.0,794.0,794.0
0.019,6,10,1762,5,911,4.0,643.0,643.0,5,851,4.0,583.0,583.0
0.006,17,2,170,1,65,0.0,37.0,37.0,1,105,0.0,77.0,77.0
0.159,6,10,1506,5,395,31.0,127.0,127.0,5,1111,37.0,843.0,843.0
0.007,17,2,194,1,59,0.0,31.0,31.0,1,135,0.0,107.0,107.0
0.006,17,2,230,1,68,0.0,40.0,40.0,1,162,0.0,134.0,134.0
0.001,17,2,248,1,68,0.0,40.0,40.0,1,180,0.0,152.0,152.0
1777.32,17,144,45504,72,22752,25032.0,288.0,288.0,72,22752,25032.0,288.0,288.0
0.089,6,10,1506,5,395,20.0,127.0,127.0,5,1111,21.0,843.0,843.0
0.113,6,10,1506,5,395,26.0,127.0,127.0,5,1111,23.0,843.0,843.0
0.07,6,10,1506,5,395,15.0,127.0,127.0,5,1111,16.0,843.0,843.0
0.001,17,2,136,1,60,0.0,32.0,32.0,1,76,0.0,48.0,48.0
0.008,6,10,1989,5,910,2.0,642.0,642.0,5,1079,2.0,811.0,811.0
0.04,17,4,284,2,120,1.0,32.0,32.0,2,164,36.0,60.0,54.0
0.006,6,10,1547,5,764,1.0,496.0,496.0,5,783,1.0,515.0,515.0
0.041,17,2,136,1,60,0.0,32.0,32.0,1,76,0.0,48.0,48.0
209.68,58,3,216,2,144,209680.0,24.0,24.0,1,72,0.0,24.0,24.0
0.001,17,2,180,1,66,0.0,38.0,38.0,1,114,0.0,86.0,86.0
0.011,6,10,1989,5,910,2.0,642.0,642.0,5,1079,2.0,811.0,811.0
0.005,6,10,1854,5,889,1.0,621.0,621.0,5,965,1.0,697.0,697.0
10.776,17,28,4423,14,1994,820.0,269.0,114.0,14,2429,820.0,588.0,145.0
401.155,58,8,576,5,360,93525.0,24.0,24.0,3,216,165240.0,24.0,24.0
0.009,6,10,1990,5,911,2.0,643.0,643.0,5,1079,2.0,811.0,811.0
0.014,6,10,1983,5,910,3.0,642.0,642.0,5,1073,3.0,805.0,805.0
0.014,6,10,1972,5,910,3.0,642.0,642.0,5,1062,3.0,794.0,794.0
0.077,6,10,1506,5,395,16.0,127.0,127.0,5,1111,16.0,843.0,843.0
0.001,17,2,180,1,66,0.0,38.0,38.0,1,114,0.0,86.0,86.0
11.148,17,28,4422,14,1993,845.0,268.0,114.0,14,2429,845.0,588.0,145.0
0.011,6,13,3735,7,497,1.0,125.0,125.0,6,3238,2.0,1470.0,1459.0
0.006,6,10,1643,5,860,1.0,592.0,592.0,5,783,1.0,515.0,515.0
0.01,6,10,1989,5,910,2.0,642.0,642.0,5,1079,2.0,811.0,811.0
0.005,17,2,247,1,68,0.0,40.0,40.0,1,179,0.0,151.0,151.0
0.018,6,13,3735,7,497,2.0,125.0,125.0,6,3238,3.0,1470.0,1459.0
0.005,17,2,180,1,66,0.0,38.0,38.0,1,114,0.0,86.0,86.0
0.096,6,10,1506,5,395,21.0,127.0,127.0,5,1111,20.0,843.0,843.0
0.006,6,10,1547,5,764,1.0,496.0,496.0,5,783,1.0,515.0,515.0
0.005,6,10,1989,5,927,1.0,659.0,659.0,5,1062,1.0,794.0,794.0
0.021,6,10,1989,5,910,5.0,642.0,642.0,5,1079,5.0,811.0,811.0
0.001,17,2,180,1,66,0.0,38.0,38.0,1,114,0.0,86.0,86.0
0.045,17,2,148,1,60,0.0,32.0,32.0,1,88,0.0,60.0,60.0
0.006,6,10,1547,5,764,1.0,496.0,496.0,5,783,1.0,515.0,515.0
0.004,6,10,2007,5,928,1.0,660.0,660.0,5,1079,1.0,811.0,811.0
0.009,6,12,1926,6,1189,1.0,659.0,434.0,6,737,1.0,417.0,417.0
0.165,17,2,152,1,76,0.0,48.0,48.0,1,76,0.0,48.0,48.0
0.01,17,2,136,1,60,0.0,32.0,32.0,1,76,0.0,48.0,48.0
0.005,17,2,230,1,68,0.0,40.0,40.0,1,162,0.0,134.0,134.0
40.065,17,10,676,5,460,10015.0,104.0,64.0,5,216,10015.0,20.0,15.0
300.313,6,16,2170,9,684,37518.0,146.0,146.0,7,1486,50024.0,419.0,398.0
0.006,6,10,1547,5,764,1.0,496.0,496.0,5,783,1.0,515.0,515.0
0.098,6,10,1506,5,395,22.0,127.0,127.0,5,1111,21.0,843.0,843.0
0.098,6,10,1506,5,395,21.0,127.0,127.0,5,1111,18.0,843.0,843.0
0.005,6,10,1989,5,927,1.0,659.0,659.0,5,1062,1.0,794.0,794.0
300.036,6,12,1782,7,1348,50006.0,494.0,494.0,5,434,75008.0,83.0,83.0
0.004,17,2,136,1,60,0.0,32.0,32.0,1,76,0.0,48.0,48.0
0.005,6,10,2007,5,928,1.0,660.0,660.0,5,1079,1.0,811.0,811.0
0.126,6,10,1506,5,395,29.0,127.0,127.0,5,1111,19.0,843.0,843.0
240.036,6,9,787,5,488,60009.0,232.0,232.0,4,299,80011.0,83.0,83.0
0.001,17,2,180,1,66,0.0,38.0,38.0,1,114,0.0,86.0,86.0
0.005,6,10,2006,5,927,1.0,659.0,659.0,5,1079,1.0,811.0,811.0
0.007,6,10,1547,5,764,1.0,496.0,496.0,5,783,1.0,515.0,515.0
0.005,17,2,144,1,64,0.0,36.0,36.0,1,80,0.0,52.0,52.0
0.075,6,10,1506,5,395,16.0,127.0,127.0,5,1111,16.0,843.0,843.0
0.005,6,10,2006,5,927,1.0,659.0,659.0,5,1079,1.0,811.0,811.0
0.005,6,10,2000,5,927,1.0,659.0,659.0,5,1073,1.0,805.0,805.0
0.013,6,10,1989,5,910,3.0,642.0,642.0,5,1079,3.0,811.0,811.0
0.005,6,10,1854,5,889,1.0,621.0,621.0,5,965,1.0,697.0,697.0
0.011,6,10,1989,5,910,2.0,642.0,642.0,5,1079,2.0,811.0,811.0
0.064,6,10,1506,5,395,13.0,127.0,127.0,5,1111,13.0,843.0,843.0
0.012,6,12,1926,6,1189,2.0,659.0,434.0,6,737,2.0,417.0,417.0
0.004,17,2,148,1,60,0.0,32.0,32.0,1,88,0.0,60.0,60.0
0.171,6,3,453,2,321,171.0,241.0,241.0,1,132,0.0,92.0,92.0
0.009,6,13,3735,7,497,1.0,125.0,125.0,6,3238,1.0,1470.0,1459.0
0.02,6,10,1989,5,910,5.0,642.0,642.0,5,1079,5.0,811.0,811.0
0.004,6,10,2007,5,928,1.0,660.0,660.0,5,1079,1.0,811.0,811.0
0.005,6,10,2006,5,927,1.0,659.0,659.0,5,1079,1.0,811.0,811.0
0.04,17,2,170,1,65,0.0,37.0,37.0,1,105,0.0,77.0,77.0
40.052,17,10,676,5,460,10011.0,104.0,64.0,5,216,10012.0,20.0,15.0
188.739,6,361,370851,190,14578,998.0,994.0,235.0,171,356273,1110.0,4206.0,2212.0
300.315,6,19,4792,10,1712,33368.0,585.0,296.0,9,3080,30034.0,1402.0,651.0
0.162,6,10,1506,5,395,38.0,127.0,127.0,5,1111,39.0,843.0,843.0
0.005,17,2,230,1,68,0.0,40.0,40.0,1,162,0.0,134.0,134.0
0.004,6,10,1989,5,927,1.0,659.0,659.0,5,1062,1.0,794.0,794.0
0.005,17,2,169,1,62,0.0,34.0,34.0,1,107,0.0,79.0,79.0
240.15,6,40,5231,20,2416,12639.0,580.0,195.0,20,2815,12639.0,564.0,220.0
0.049,6,10,1972,5,910,12.0,642.0,642.0,5,1062,12.0,794.0,794.0
0.005,6,10,2006,5,927,1.0,659.0,659.0,5,1079,1.0,811.0,811.0
0.006,17,2,170,1,65,0.0,37.0,37.0,1,105,0.0,77.0,77.0
0.014,6,10,1762,5,911,3.0,643.0,643.0,5,851,3.0,583.0,583.0
0.009,6,10,1989,5,910,2.0,642.0,642.0,5,1079,2.0,811.0,811.0
0.1,6,10,1506,5,395,21.0,127.0,127.0,5,1111,22.0,843.0,843.0
0.072,17,2,170,1,65,0.0,37.0,37.0,1,105,0.0,77.0,77.0
0.011,6,10,1989,5,910,2.0,642.0,642.0,5,1079,2.0,811.0,811.0
444.242,6,47,8795,25,6730,18510.0,494.0,494.0,22,2065,21154.0,83.0,83.0
335.629,17,20,1124,10,716,37277.0,48.0,43.0,10,408,37277.0,20.0,12.0
0.006,6,10,2000,5,927,1.0,659.0,659.0,5,1073,1.0,805.0,805.0
0.011,6,10,1762,5,911,2.0,643.0,643.0,5,851,2.0,583.0,583.0
0.01,6,10,1972,5,910,2.0,642.0,642.0,5,1062,2.0,794.0,794.0
0.005,6,10,1989,5,927,1.0,659.0,659.0,5,1062,1.0,794.0,794.0
392.778,6,26,7305,14,2400,30213.0,585.0,330.0,12,4905,30251.0,1402.0,712.0
368.744,6,22,2313,16,867,24582.0,195.0,195.0,6,1446,4645.0,419.0,398.0
0.072,17,2,170,1,65,0.0,37.0,37.0,1,105,0.0,77.0,77.0
0.076,6,10,1506,5,395,16.0,127.0,127.0,5,1111,16.0,843.0,843.0
240.116,6,19,4666,9,2169,30014.0,966.0,568.0,10,2497,26679.0,1162.0,393.0
0.004,17,2,136,1,60,0.0,32.0,32.0,1,76,0.0,48.0,48.0
0.004,6,10,1774,5,923,1.0,655.0,655.0,5,851,1.0,583.0,583.0
0.0,17,2,179,1,62,0.0,34.0,34.0,1,117,0.0,89.0,89.0
0.08,6,10,1506,5,395,16.0,127.0,127.0,5,1111,19.0,843.0,843.0
0.005,6,10,2000,5,927,1.0,659.0,659.0,5,1073,1.0,805.0,805.0
40.062,17,10,676,5,460,10014.0,104.0,64.0,5,216,10014.0,20.0,15.0
0.004,6,10,1702,5,863,1.0,595.0,595.0,5,839,0.0,571.0,571.0
40.093,17,10,676,5,460,10022.0,104.0,64.0,5,216,10022.0,20.0,15.0
0.007,6,10,1854,5,889,1.0,621.0,621.0,5,965,1.0,697.0,697.0
0.016,6,10,1631,5,848,3.0,580.0,580.0,5,783,3.0,515.0,515.0
0.221,6,16,2670,8,1396,31.0,533.0,324.0,8,1274,20.0,529.0,212.0
0.007,6,10,1643,5,860,1.0,592.0,592.0,5,783,1.0,515.0,515.0
0.071,6,10,1506,5,395,15.0,127.0,127.0,5,1111,16.0,843.0,843.0
0.005,17,2,169,1,62,0.0,34.0,34.0,1,107,0.0,79.0,79.0
0.07,6,10,1506,5,395,15.0,127.0,127.0,5,1111,14.0,843.0,843.0
0.009,6,10,1677,5,827,2.0,559.0,559.0,5,850,2.0,582.0,582.0
0.168,6,3,453,2,321,168.0,241.0,241.0,1,132,0.0,92.0,92.0
40.08,17,10,676,5,460,10016.0,104.0,64.0,5,216,10019.0,20.0,15.0
0.006,6,10,1774,5,923,1.0,655.0,655.0,5,851,1.0,583.0,583.0
0.084,6,10,1506,5,395,19.0,127.0,127.0,5,1111,18.0,843.0,843.0
240.09,6,16,4481,9,963,30011.0,238.0,166.0,7,3518,40014.0,1402.0,786.0
0.099,6,10,1506,5,395,22.0,127.0,127.0,5,1111,23.0,843.0,843.0
0.009,6,10,1989,5,910,2.0,642.0,642.0,5,1079,2.0,811.0,811.0
0.013,6,10,1990,5,911,3.0,643.0,643.0,5,1079,3.0,811.0,811.0
309.02,17,20,1124,10,716,34321.0,48.0,43.0,10,408,34321.0,20.0,12.0
0.004,6,10,2007,5,928,1.0,660.0,660.0,5,1079,1.0,811.0,811.0
0.079,6,10,1506,5,395,19.0,127.0,127.0,5,1111,16.0,843.0,843.0
0.005,6,10,1989,5,927,1.0,659.0,659.0,5,1062,1.0,794.0,794.0
240.021,6,9,787,5,488,60005.0,232.0,232.0,4,299,80006.0,83.0,83.0
0.087,6,10,1506,5,395,19.0,127.0,127.0,5,1111,19.0,843.0,843.0
1756.843,6,437,64736,252,35168,6999.0,613.0,197.0,185,29568,9547.0,453.0,142.0
15.074,17,15,8117,8,5969,2149.0,1350.0,718.0,7,2148,2507.0,1350.0,278.0
0.008,6,10,1972,5,910,1.0,642.0,642.0,5,1062,2.0,794.0,794.0
0.004,6,10,2006,5,927,1.0,659.0,659.0,5,1079,1.0,811.0,811.0
0.005,6,10,1689,5,839,1.0,571.0,571.0,5,850,1.0,582.0,582.0
0.066,17,8,3613,4,1874,22.0,1350.0,440.0,4,1739,11.0,1350.0,406.0
1770.49,6,81,4264,41,2158,44260.0,26.0,26.0,40,2106,45396.0,26.0,26.0
0.083,6,10,1506,5,395,19.0,127.0,127.0,5,1111,19.0,843.0,843.0
0.095,6,10,1506,5,395,22.0,127.0,127.0,5,1111,21.0,843.0,843.0
0.076,6,10,1506,5,395,14.0,127.0,127.0,5,1111,18.0,843.0,843.0
0.006,17,2,136,1,60,0.0,32.0,32.0,1,76,0.0,48.0,48.0
0.04,17,2,380,1,61,0.0,33.0,33.0,1,319,0.0,291.0,291.0
0.011,6,10,1762,5,911,2.0,643.0,643.0,5,851,2.0,583.0,583.0
0.079,6,10,1506,5,395,17.0,127.0,127.0,5,1111,16.0,843.0,843.0
0.005,17,2,166,1,75,0.0,47.0,47.0,1,91,0.0,63.0,63.0
0.012,6,10,1989,5,910,3.0,642.0,642.0,5,1079,3.0,811.0,811.0
0.005,6,10,1854,5,889,1.0,621.0,621.0,5,965,1.0,697.0,697.0
0.004,6,10,1779,5,928,1.0,660.0,660.0,5,851,1.0,583.0,583.0
0.732,6,10,2009,6,1655,146.0,1403.0,1403.0,4,354,166.0,182.0,182.0
0.006,6,10,1689,5,839,1.0,571.0,571.0,5,850,1.0,582.0,582.0
15.086,17,15,9238,8,6902,2150.0,1350.0,834.0,7,2336,2507.0,1350.0,305.0
0.053,17,2,148,1,60,0.0,32.0,32.0,1,88,0.0,60.0,60.0
0.005,6,10,2007,5,928,1.0,660.0,660.0,5,1079,1.0,811.0,811.0
0.021,6,10,1762,5,911,5.0,643.0,643.0,5,851,5.0,583.0,583.0
0.119,6,10,1506,5,395,27.0,127.0,127.0,5,1111,24.0,843.0,843.0
0.04,17,2,182,1,65,0.0,37.0,37.0,1,117,0.0,89.0,89.0
0.008,6,10,1989,5,910,2.0,642.0,642.0,5,1079,1.0,811.0,811.0
0.004,6,10,1989,5,927,1.0,659.0,659.0,5,1062,1.0,794.0,794.0
0.005,6,10,2007,5,928,1.0,660.0,660.0,5,1079,1.0,811.0,811.0
56.925,6,36,9526,18,4008,521.0,1543.0,814.0,18,5518,3338.0,2667.0,435.0
240.481,6,37,9654,19,2171,13359.0,743.0,235.0,18,7483,14145.0,1402.0,595.0
0.079,6,10,1506,5,395,17.0,127.0,127.0,5,1111,18.0,843.0,843.0
0.009,6,10,1989,5,910,2.0,642.0,642.0,5,1079,2.0,811.0,811.0
0.069,6,10,1506,5,395,15.0,127.0,127.0,5,1111,14.0,843.0,843.0
0.013,6,10,1989,5,910,3.0,642.0,642.0,5,1079,3.0,811.0,811.0
0.016,6,10,1990,5,911,4.0,643.0,643.0,5,1079,3.0,811.0,811.0
301.207,6,60,29564,30,23337,10386.0,2720.0,1578.0,30,6227,311.0,2667.0,385.0
0.011,6,13,3735,7,497,1.0,125.0,125.0,6,3238,2.0,1470.0,1459.0
0.005,6,10,1643,5,860,1.0,592.0,592.0,5,783,1.0,515.0,515.0
0.006,6,10,1547,5,764,1.0,496.0,496.0,5,783,1.0,515.0,515.0
0.03,6,10,1972,5,910,7.0,642.0,642.0,5,1062,7.0,794.0,794.0
0.009,6,12,1926,6,1189,1.0,659.0,434.0,6,737,1.0,417.0,417.0
0.013,6,10,1972,5,910,3.0,642.0,642.0,5,1062,3.0,794.0,794.0
40.069,17,10,676,5,460,10015.0,104.0,64.0,5,216,10016.0,20.0,15.0
0.009,6,10,1972,5,910,2.0,642.0,642.0,5,1062,2.0,794.0,794.0
0.006,6,10,1547,5,764,1.0,496.0,496.0,5,783,1.0,515.0,515.0
0.013,6,10,1989,5,910,3.0,642.0,642.0,5,1079,3.0,811.0,811.0
40.072,17,10,676,5,460,10017.0,104.0,64.0,5,216,10016.0,20.0,15.0
0.111,6,10,1506,5,395,24.0,127.0,127.0,5,1111,19.0,843.0,843.0
0.007,17,2,179,1,71,0.0,43.0,43.0,1,108,0.0,80.0,80.0
0.003,17,2,148,1,60,0.0,32.0,32.0,1,88,0.0,60.0,60.0
0.085,6,10,1506,5,395,16.0,127.0,127.0,5,1111,18.0,843.0,843.0
0.005,6,10,1774,5,923,1.0,655.0,655.0,5,851,1.0,583.0,583.0
0.01,6,10,1990,5,911,2.0,643.0,643.0,5,1079,2.0,811.0,811.0
0.005,6,10,1689,5,839,1.0,571.0,571.0,5,850,1.0,582.0,582.0
0.005,6,10,1989,5,927,1.0,659.0,659.0,5,1062,1.0,794.0,794.0
120.897,6,54,18875,31,4733,4029.0,1055.0,222.0,23,14142,5495.0,2804.0,995.0
0.007,6,10,1689,5,839,1.0,571.0,571.0,5,850,1.0,582.0,582.0
0.095,6,10,1506,5,395,21.0,127.0,127.0,5,1111,20.0,843.0,843.0
0.005,17,2,170,1,65,0.0,37.0,37.0,1,105,0.0,77.0,77.0
0.006,6,10,1643,5,860,1.0,592.0,592.0,5,783,1.0,515.0,515.0
0.008,6,10,1774,5,923,1.0,655.0,655.0,5,851,2.0,583.0,583.0
0.012,6,10,1989,5,910,2.0,642.0,642.0,5,1079,2.0,811.0,811.0
0.08,6,10,1506,5,395,17.0,127.0,127.0,5,1111,17.0,843.0,843.0
40.049,17,10,676,5,460,10011.0,104.0,64.0,5,216,10011.0,20.0,15.0
361.831,6,21,1792,16,1030,24122.0,190.0,190.0,5,762,60009.0,461.0,247.0
0.009,6,10,1989,5,910,2.0,642.0,642.0,5,1079,2.0,811.0,811.0
40.066,17,10,676,5,460,10015.0,104.0,64.0,5,216,10015.0,20.0,15.0
165.22,58,4,288,3,216,82610.0,24.0,24.0,1,72,0.0,24.0,24.0
0.012,6,10,1983,5,910,2.0,642.0,642.0,5,1073,2.0,805.0,805.0
240.454,6,35,8924,18,2071,14144.0,692.0,225.0,17,6853,15028.0,1402.0,597.0
40.063,17,10,676,5,460,10015.0,104.0,64.0,5,216,10015.0,20.0,15.0
0.012,6,10,1677,5,827,3.0,559.0,559.0,5,850,3.0,582.0,582.0
0.013,6,10,1762,5,911,3.0,643.0,643.0,5,851,3.0,583.0,583.0
240.132,6,16,4482,9,963,30016.0,238.0,166.0,7,3519,40018.0,1402.0,786.0
0.076,6,10,1506,5,395,16.0,127.0,127.0,5,1111,16.0,843.0,843.0
0.005,17,2,230,1,68,0.0,40.0,40.0,1,162,0.0,134.0,134.0
0.005,6,10,1689,5,839,1.0,571.0,571.0,5,850,1.0,582.0,582.0
0.124,17,2,182,1,65,0.0,37.0,37.0,1,117,0.0,89.0,89.0
0.006,6,10,1779,5,928,1.0,660.0,660.0,5,851,1.0,583.0,583.0
0.013,6,10,1983,5,910,3.0,642.0,642.0,5,1073,3.0,805.0,805.0
0.004,6,10,2006,5,927,1.0,659.0,659.0,5,1079,1.0,811.0,811.0
0.029,6,11,1729,6,879,5.0,559.0,559.0,5,850,7.0,582.0,582.0
0.006,6,10,1547,5,764,1.0,496.0,496.0,5,783,1.0,515.0,515.0
0.005,17,2,179,1,71,0.0,43.0,43.0,1,108,0.0,80.0,80.0
0.072,6,10,1506,5,395,14.0,127.0,127.0,5,1111,16.0,843.0,843.0
0.017,6,13,3735,7,497,2.0,125.0,125.0,6,3238,3.0,1470.0,1459.0
0.001,17,2,180,1,66,0.0,38.0,38.0,1,114,0.0,86.0,86.0
40.065,17,10,676,5,460,10015.0,104.0,64.0,5,216,10015.0,20.0,15.0
0.006,6,10,1854,5,889,1.0,621.0,621.0,5,965,1.0,697.0,697.0
0.008,6,10,1762,5,911,1.0,643.0,643.0,5,851,1.0,583.0,583.0
6.092,6,26,12356,14,1040,468.0,304.0,304.0,12,11316,553.0,1402.0,1187.0
0.132,17,2,136,1,60,0.0,32.0,32.0,1,76,0.0,48.0,48.0
0.004,6,10,1702,5,863,0.0,595.0,595.0,5,839,1.0,571.0,571.0
0.009,6,10,1989,5,910,2.0,642.0,642.0,5,1079,2.0,811.0,811.0
0.027,6,10,1989,5,910,6.0,642.0,642.0,5,1079,6.0,811.0,811.0
0.017,6,10,1631,5,848,4.0,580.0,580.0,5,783,4.0,515.0,515.0
0.018,6,13,3735,7,497,3.0,125.0,125.0,6,3238,3.0,1470.0,1459.0
40.1,17,10,676,5,460,10022.0,104.0,64.0,5,216,10024.0,20.0,15.0
0.006,6,10,1854,5,889,1.0,621.0,621.0,5,965,1.0,697.0,697.0
0.005,6,10,1989,5,927,1.0,659.0,659.0,5,1062,1.0,794.0,794.0
0.005,6,10,2006,5,927,1.0,659.0,659.0,5,1079,1.0,811.0,811.0
10.847,17,28,4421,14,1994,825.0,269.0,114.0,14,2427,825.0,586.0,145.0
0.014,6,10,1983,5,910,3.0,642.0,642.0,5,1073,3.0,805.0,805.0
0.006,17,2,170,1,65,0.0,37.0,37.0,1,105,0.0,77.0,77.0
0.006,6,10,1547,5,764,1.0,496.0,496.0,5,783,1.0,515.0,515.0
0.245,17,17,8781,8,6105,35.0,1350.0,735.0,9,2676,18.0,1350.0,269.0
0.005,6,10,1547,5,764,1.0,496.0,496.0,5,783,1.0,515.0,515.0
0.016,6,10,1990,5,911,4.0,643.0,643.0,5,1079,3.0,811.0,811.0
0.004,6,10,1989,5,927,1.0,659.0,659.0,5,1062,1.0,794.0,794.0
0.029,6,10,1972,5,910,7.0,642.0,642.0,5,1062,7.0,794.0,794.0
0.013,6,10,1990,5,911,3.0,643.0,643.0,5,1079,3.0,811.0,811.0
0.005,6,10,1989,5,927,1.0,659.0,659.0,5,1062,1.0,794.0,794.0
1768.959,17,92,8096,46,4048,39310.0,60.0,60.0,46,4048,39310.0,60.0,60.0
0.005,17,2,199,1,68,0.0,40.0,40.0,1,131,0.0,103.0,103.0
0.005,6,10,2000,5,927,1.0,659.0,659.0,5,1073,1.0,805.0,805.0
0.004,6,10,1779,5,928,1.0,660.0,660.0,5,851,1.0,583.0,583.0
0.006,6,13,3690,7,452,1.0,80.0,80.0,6,3238,1.0,1470.0,1459.0
0.082,6,10,1506,5,395,18.0,127.0,127.0,5,1111,17.0,843.0,843.0
0.009,6,12,1926,6,1189,1.0,659.0,434.0,6,737,1.0,417.0,417.0
0.005,17,2,214,1,75,0.0,47.0,47.0,1,139,0.0,111.0,111.0
0.005,6,10,2007,5,928,1.0,660.0,660.0,5,1079,1.0,811.0,811.0
0.013,17,2,152,1,56,0.0,28.0,28.0,1,96,0.0,68.0,68.0
240.122,6,31,9157,15,6798,17151.0,1922.0,669.0,16,2359,16008.0,580.0,189.0
0.113,6,10,1506,5,395,25.0,127.0,127.0,5,1111,24.0,843.0,843.0
0.004,6,10,1989,5,927,1.0,659.0,659.0,5,1062,1.0,794.0,794.0
0.006,6,10,2007,5,928,1.0,660.0,660.0,5,1079,1.0,811.0,811.0
0.082,6,10,1506,5,395,18.0,127.0,127.0,5,1111,18.0,843.0,843.0
240.522,6,37,9657,19,2173,13362.0,745.0,235.0,18,7484,14148.0,1402.0,595.0
0.006,6,10,1547,5,764,1.0,496.0,496.0,5,783,1.0,515.0,515.0
0.007,17,2,157,1,59,0.0,31.0,31.0,1,98,0.0,70.0,70.0
354.004,6,21,1795,16,1030,23600.0,190.0,190.0,5,765,60002.0,464.0,248.0
0.121,6,10,1506,5,395,29.0,127.0,127.0,5,1111,28.0,843.0,843.0
0.089,6,10,1506,5,395,20.0,127.0,127.0,5,1111,21.0,843.0,843.0
0.004,17,2,136,1,60,0.0,32.0,32.0,1,76,0.0,48.0,48.0
0.004,6,10,2007,5,928,1.0,660.0,660.0,5,1079,1.0,811.0,811.0
0.014,6,10,1989,5,910,3.0,642.0,642.0,5,1079,3.0,811.0,811.0
300.088,6,19,4660,11,1102,30008.0,238.0,130.0,8,3558,42869.0,1402.0,786.0
0.009,6,10,1547,5,764,2.0,496.0,496.0,5,783,2.0,515.0,515.0
40.047,17,10,676,5,460,10010.0,104.0,64.0,5,216,10011.0,20.0,15.0
0.006,6,10,1989,5,927,1.0,659.0,659.0,5,1062,1.0,794.0,794.0
0.013,6,13,3735,7,497,2.0,125.0,125.0,6,3238,2.0,1470.0,1459.0
0.008,6,10,2000,5,927,2.0,659.0,659.0,5,1073,2.0,805.0,805.0
0.067,6,10,1506,5,395,14.0,127.0,127.0,5,1111,14.0,843.0,843.0
10.904,17,28,4421,14,1994,830.0,269.0,114.0,14,2427,830.0,586.0,145.0
0.008,17,2,194,1,59,0.0,31.0,31.0,1,135,0.0,107.0,107.0
0.014,17,4,352,2,130,9.0,37.0,37.0,2,222,9.0,89.0,83.0
0.105,6,10,1506,5,395,25.0,127.0,127.0,5,1111,24.0,843.0,843.0
240.784,6,29,9673,14,3236,18521.0,757.0,502.0,15,6437,17198.0,1592.0,627.0
0.126,17,2,80,1,32,0.0,4.0,4.0,1,48,0.0,20.0,20.0
308.55,17,20,1124,10,716,34268.0,48.0,43.0,10,408,34268.0,20.0,12.0
0.009,6,13,3735,7,497,1.0,125.0,125.0,6,3238,1.0,1470.0,1459.0
0.039,17,2,148,1,60,0.0,32.0,32.0,1,88,0.0,60.0,60.0
0.004,6,10,2000,5,927,1.0,659.0,659.0,5,1073,1.0,805.0,805.0
240.034,6,9,787,5,488,60008.0,232.0,232.0,4,299,80010.0,83.0,83.0
0.003,17,2,208,1,72,0.0,44.0,44.0,1,136,0.0,108.0,108.0
30.142,6,88,74395,43,3296,717.0,517.0,262.0,45,71099,684.0,2804.0,1636.0
0.004,17,2,136,1,60,0.0,32.0,32.0,1,76,0.0,48.0,48.0
0.085,6,10,1506,5,395,18.0,127.0,127.0,5,1111,17.0,843.0,843.0
0.005,6,10,2000,5,927,1.0,659.0,659.0,5,1073,1.0,805.0,805.0
0.004,6,10,2006,5,927,1.0,659.0,659.0,5,1079,1.0,811.0,811.0
0.005,6,10,1779,5,928,1.0,660.0,660.0,5,851,1.0,583.0,583.0
0.066,6,10,1972,5,910,16.0,642.0,642.0,5,1062,16.0,794.0,794.0
0.007,6,12,1698,6,863,1.0,327.0,271.0,6,835,1.0,515.0,515.0
1770.305,6,83,4368,42,2210,43177.0,26.0,26.0,41,2158,44256.0,26.0,26.0
0.095,6,10,1506,5,395,20.0,127.0,127.0,5,1111,21.0,843.0,843.0
0.005,6,10,1547,5,764,1.0,496.0,496.0,5,783,1.0,515.0,515.0
0.012,6,13,3735,7,497,2.0,125.0,125.0,6,3238,2.0,1470.0,1459.0
996.531,6,287,56499,145,49865,6919.0,421.0,352.0,142,6634,7066.0,53.0,53.0
0.011,6,10,1990,5,911,2.0,643.0,643.0,5,1079,2.0,811.0,811.0
0.095,6,10,1506,5,395,21.0,127.0,127.0,5,1111,21.0,843.0,843.0
0.104,6,10,1506,5,395,22.0,127.0,127.0,5,1111,25.0,843.0,843.0
240.07,6,22,4978,12,993,21824.0,180.0,93.0,10,3985,26674.0,1593.0,576.0
0.015,17,2,367,1,99,0.0,71.0,71.0,1,268,0.0,240.0,240.0
0.005,17,2,194,1,59,0.0,31.0,31.0,1,135,0.0,107.0,107.0
0.001,17,2,180,1,66,0.0,38.0,38.0,1,114,0.0,86.0,86.0
0.009,6,10,1972,5,910,2.0,642.0,642.0,5,1062,2.0,794.0,794.0
0.069,17,8,3613,4,1874,23.0,1350.0,440.0,4,1739,11.0,1350.0,406.0
0.089,6,10,1506,5,395,17.0,127.0,127.0,5,1111,20.0,843.0,843.0
300.312,6,16,2170,9,684,37517.0,146.0,146.0,7,1486,50023.0,419.0,398.0
0.018,6,10,1631,5,848,4.0,580.0,580.0,5,783,4.0,515.0,515.0
0.008,6,10,1972,5,910,2.0,642.0,642.0,5,1062,2.0,794.0,794.0
0.011,6,10,1762,5,911,2.0,643.0,643.0,5,851,2.0,583.0,583.0
0.004,17,2,148,1,60,0.0,32.0,32.0,1,88,0.0,60.0,60.0
0.123,17,2,80,1,32,0.0,4.0,4.0,1,48,0.0,20.0,20.0
0.124,17,2,80,1,32,0.0,4.0,4.0,1,48,0.0,20.0,20.0
171.176,17,84,11744,42,2801,4174.0,44.0,38.0,42,8943,4174.0,239.0,184.0
0.006,17,2,169,1,62,0.0,34.0,34.0,1,107,0.0,79.0,79.0
0.003,17,2,148,1,60,0.0,32.0,32.0,1,88,0.0,60.0,60.0
0.014,6,10,1972,5,910,3.0,642.0,642.0,5,1062,3.0,794.0,794.0
0.005,17,2,170,1,65,0.0,37.0,37.0,1,105,0.0,77.0,77.0
15.08,17,15,9238,8,6902,2150.0,1350.0,834.0,7,2336,2507.0,1350.0,305.0
0.005,6,13,3747,7,509,0.0,137.0,137.0,6,3238,0.0,1470.0,1459.0
0.006,6,10,1547,5,764,1.0,496.0,496.0,5,783,1.0,515.0,515.0
0.006,6,10,1854,5,889,1.0,621.0,621.0,5,965,1.0,697.0,697.0
0.005,6,10,1774,5,923,1.0,655.0,655.0,5,851,1.0,583.0,583.0
0.078,6,10,1506,5,395,13.0,127.0,127.0,5,1111,18.0,843.0,843.0
0.01,6,10,1989,5,910,2.0,642.0,642.0,5,1079,2.0,811.0,811.0
0.005,6,10,1702,5,863,1.0,595.0,595.0,5,839,1.0,571.0,571.0
0.043,17,2,412,1,61,0.0,33.0,33.0,1,351,0.0,323.0,323.0
15.071,17,15,9239,8,6902,2149.0,1350.0,834.0,7,2337,2506.0,1350.0,305.0
0.004,6,10,1702,5,863,1.0,595.0,595.0,5,839,0.0,571.0,571.0
0.001,17,2,180,1,66,0.0,38.0,38.0,1,114,0.0,86.0,86.0
0.006,17,2,230,1,68,0.0,40.0,40.0,1,162,0.0,134.0,134.0
0.01,6,10,1989,5,910,2.0,642.0,642.0,5,1079,2.0,811.0,811.0
0.004,6,10,2006,5,927,1.0,659.0,659.0,5,1079,1.0,811.0,811.0
0.232,6,10,1506,5,395,45.0,127.0,127.0,5,1111,32.0,843.0,843.0
0.001,17,2,180,1,66,0.0,38.0,38.0,1,114,0.0,86.0,86.0
0.006,6,10,1854,5,889,1.0,621.0,621.0,5,965,1.0,697.0,697.0
0.006,6,10,1689,5,839,1.0,571.0,571.0,5,850,1.0,582.0,582.0
0.011,6,10,1972,5,910,2.0,642.0,642.0,5,1062,2.0,794.0,794.0
0.117,6,10,1506,5,395,25.0,127.0,127.0,5,1111,25.0,843.0,843.0
0.013,6,10,1989,5,910,3.0,642.0,642.0,5,1079,3.0,811.0,811.0
0.006,17,2,144,1,64,0.0,36.0,36.0,1,80,0.0,52.0,52.0
0.004,6,10,2006,5,927,1.0,659.0,659.0,5,1079,1.0,811.0,811.0
0.082,6,10,1506,5,395,18.0,127.0,127.0,5,1111,17.0,843.0,843.0
0.005,6,10,2006,5,927,1.0,659.0,659.0,5,1079,1.0,811.0,811.0
0.004,6,10,2006,5,927,1.0,659.0,659.0,5,1079,1.0,811.0,811.0
0.006,6,10,1547,5,764,1.0,496.0,496.0,5,783,1.0,515.0,515.0
0.004,17,2,148,1,60,0.0,32.0,32.0,1,88,0.0,60.0,60.0
0.046,17,4,352,2,130,6.0,37.0,37.0,2,222,42.0,89.0,83.0
0.005,6,10,2006,5,927,1.0,659.0,659.0,5,1079,1.0,811.0,811.0
0.011,6,10,1989,5,910,2.0,642.0,642.0,5,1079,2.0,811.0,811.0
0.012,6,10,1972,5,910,2.0,642.0,642.0,5,1062,3.0,794.0,794.0
10.847,17,26,4098,13,1846,895.0,269.0,114.0,13,2252,895.0,587.0,145.0
15.074,17,14,9190,8,6902,2149.0,1350.0,834.0,6,2288,3008.0,1350.0,353.0
0.008,6,10,1989,5,910,2.0,642.0,642.0,5,1079,2.0,811.0,811.0
0.042,17,4,420,2,122,1.0,33.0,33.0,2,298,37.0,145.0,121.0
0.008,6,12,1926,6,1189,1.0,659.0,434.0,6,737,1.0,417.0,417.0
0.008,6,10,1989,5,910,2.0,642.0,642.0,5,1079,1.0,811.0,811.0
0.008,6,10,1547,5,764,2.0,496.0,496.0,5,783,1.0,515.0,515.0
0.011,6,10,1990,5,911,2.0,643.0,643.0,5,1079,2.0,811.0,811.0
0.008,6,10,2007,5,928,2.0,660.0,660.0,5,1079,2.0,811.0,811.0
40.055,17,10,676,5,460,10013.0,104.0,64.0,5,216,10013.0,20.0,15.0
15.076,17,14,9190,8,6902,2149.0,1350.0,834.0,6,2288,3009.0,1350.0,353.0
308.807,17,20,1124,10,716,34305.0,48.0,43.0,10,408,34305.0,20.0,12.0
0.012,6,10,1983,5,910,2.0,642.0,642.0,5,1073,3.0,805.0,805.0
0.001,17,2,136,1,60,0.0,32.0,32.0,1,76,0.0,48.0,48.0
0.012,6,13,3735,7,497,2.0,125.0,125.0,6,3238,2.0,1470.0,1459.0
291.769,6,393,348160,206,22255,1423.0,2736.0,824.0,187,325905,1568.0,2804.0,1827.0
0.017,6,10,1972,5,910,4.0,642.0,642.0,5,1062,4.0,794.0,794.0
0.08,6,10,1506,5,395,16.0,127.0,127.0,5,1111,17.0,843.0,843.0
0.006,6,10,1547,5,764,1.0,496.0,496.0,5,783,1.0,515.0,515.0
0.091,6,10,1506,5,395,20.0,127.0,127.0,5,1111,19.0,843.0,843.0
0.043,17,4,596,2,122,0.0,33.0,33.0,2,474,39.0,323.0,209.0
0.02,6,10,1972,5,910,5.0,642.0,642.0,5,1062,4.0,794.0,794.0
0.122,6,10,1506,5,395,29.0,127.0,127.0,5,1111,25.0,843.0,843.0
438.762,6,29,4409,12,3102,10912.0,494.0,494.0,17,1307,27422.0,83.0,83.0
0.006,17,2,225,1,65,0.0,37.0,37.0,1,160,0.0,132.0,132.0
0.006,6,10,1547,5,764,1.0,496.0,496.0,5,783,1.0,515.0,515.0
0.005,6,10,1689,5,839,1.0,571.0,571.0,5,850,1.0,582.0,582.0
0.011,6,10,1983,5,910,2.0,642.0,642.0,5,1073,2.0,805.0,805.0
0.005,6,10,1689,5,839,1.0,571.0,571.0,5,850,1.0,582.0,582.0
0.005,17,2,144,1,64,0.0,36.0,36.0,1,80,0.0,52.0,52.0
0.158,6,10,1506,5,395,37.0,127.0,127.0,5,1111,35.0,843.0,843.0
0.111,6,10,1506,5,395,25.0,127.0,127.0,5,1111,18.0,843.0,843.0
0.006,6,10,1547,5,764,1.0,496.0,496.0,5,783,1.0,515.0,515.0
0.04,17,4,420,2,122,0.0,33.0,33.0,2,298,37.0,145.0,121.0
0.039,17,2,184,1,61,0.0,33.0,33.0,1,123,0.0,95.0,95.0
0.007,6,10,1547,5,764,1.0,496.0,496.0,5,783,1.0,515.0,515.0
15.072,17,14,9191,8,6902,2149.0,1350.0,834.0,6,2289,3008.0,1350.0,353.0
0.009,6,10,1989,5,910,2.0,642.0,642.0,5,1079,2.0,811.0,811.0
0.004,6,10,2006,5,927,1.0,659.0,659.0,5,1079,1.0,811.0,811.0
0.011,6,10,1990,5,911,2.0,643.0,643.0,5,1079,2.0,811.0,811.0
0.022,6,10,1990,5,911,5.0,643.0,643.0,5,1079,5.0,811.0,811.0
0.012,6,10,1989,5,910,3.0,642.0,642.0,5,1079,2.0,811.0,811.0
40.094,17,10,676,5,460,10020.0,104.0,64.0,5,216,10022.0,20.0,15.0
0.005,6,10,1989,5,927,1.0,659.0,659.0,5,1062,1.0,794.0,794.0
240.045,6,12,1315,6,510,48008.0,190.0,190.0,6,805,48008.0,464.0,248.0
0.012,6,10,1989,5,910,3.0,642.0,642.0,5,1079,2.0,811.0,811.0
0.006,6,10,1547,5,764,1.0,496.0,496.0,5,783,1.0,515.0,515.0
0.102,6,10,1506,5,395,22.0,127.0,127.0,5,1111,22.0,843.0,843.0
0.004,6,10,2000,5,927,1.0,659.0,659.0,5,1073,1.0,805.0,805.0
309.766,17,20,1124,10,716,34404.0,48.0,43.0,10,408,34404.0,20.0,12.0
0.007,17,2,194,1,59,0.0,31.0,31.0,1,135,0.0,107.0,107.0
0.016,6,10,1631,5,848,4.0,580.0,580.0,5,783,4.0,515.0,515.0
0.008,6,10,1990,5,911,2.0,643.0,643.0,5,1079,2.0,811.0,811.0
40.073,17,10,676,5,460,10013.0,104.0,64.0,5,216,10017.0,20.0,15.0
0.005,6,10,1774,5,923,1.0,655.0,655.0,5,851,1.0,583.0,583.0
0.039,17,2,136,1,60,0.0,32.0,32.0,1,76,0.0,48.0,48.0
0.005,6,10,2006,5,927,1.0,659.0,659.0,5,1079,1.0,811.0,811.0
0.005,6,10,1689,5,839,1.0,571.0,571.0,5,850,1.0,582.0,582.0
0.005,6,10,2006,5,927,1.0,659.0,659.0,5,1079,1.0,811.0,811.0
0.09,6,10,1506,5,395,19.0,127.0,127.0,5,1111,19.0,843.0,843.0
0.067,6,10,1506,5,395,14.0,127.0,127.0,5,1111,12.0,843.0,843.0
368.723,6,22,2313,16,867,24581.0,195.0,195.0,6,1446,4648.0,419.0,398.0
65.21,6,131,118384,75,6775,881.0,923.0,475.0,56,111609,1185.0,3673.0,2131.0
0.003,17,2,148,1,60,0.0,32.0,32.0,1,88,0.0,60.0,60.0
0.007,17,2,166,1,75,0.0,47.0,47.0,1,91,0.0,63.0,63.0
0.004,6,10,2007,5,928,1.0,660.0,660.0,5,1079,1.0,811.0,811.0
0.006,6,10,1643,5,860,1.0,592.0,592.0,5,783,1.0,515.0,515.0
0.006,17,2,293,1,73,0.0,45.0,45.0,1,220,0.0,192.0,192.0
0.007,6,10,1854,5,889,1.0,621.0,621.0,5,965,1.0,697.0,697.0
0.005,17,2,140,1,62,0.0,34.0,34.0,1,78,0.0,50.0,50.0
0.001,17,2,180,1,66,0.0,38.0,38.0,1,114,0.0,86.0,86.0
0.007,17,2,194,1,59,0.0,31.0,31.0,1,135,0.0,107.0,107.0
0.077,6,10,1506,5,395,17.0,127.0,127.0,5,1111,18.0,843.0,843.0
0.039,17,2,136,1,60,0.0,32.0,32.0,1,76,0.0,48.0,48.0
177.103,17,80,11496,40,2674,4540.0,44.0,38.0,40,8822,4541.0,258.0,192.0
0.005,6,10,1989,5,927,1.0,659.0,659.0,5,1062,1.0,794.0,794.0
351.986,6,20,2210,6,1308,12003.0,494.0,494.0,14,902,27075.0,83.0,83.0
0.006,17,4,284,2,120,0.0,32.0,32.0,2,164,1.0,60.0,54.0
0.005,6,10,1989,5,927,1.0,659.0,659.0,5,1062,1.0,794.0,794.0
0.004,6,13,3690,7,452,0.0,80.0,80.0,6,3238,0.0,1470.0,1459.0
0.02,6,10,1990,5,911,4.0,643.0,643.0,5,1079,5.0,811.0,811.0
0.008,6,10,1989,5,927,2.0,659.0,659.0,5,1062,1.0,794.0,794.0
0.082,6,10,1506,5,395,16.0,127.0,127.0,5,1111,18.0,843.0,843.0
145.667,6,26,9525,12,1627,74.0,794.0,367.0,14,7898,11194.0,1360.0,732.0
0.003,17,4,284,2,120,0.0,32.0,32.0,2,164,0.0,60.0,54.0
0.004,17,2,136,1,60,0.0,32.0,32.0,1,76,0.0,48.0,48.0
0.004,6,10,2006,5,927,1.0,659.0,659.0,5,1079,1.0,811.0,811.0
308.385,17,20,1124,10,716,34250.0,48.0,43.0,10,408,34250.0,20.0,12.0
0.009,6,10,1990,5,911,2.0,643.0,643.0,5,1079,2.0,811.0,811.0
0.005,6,10,2006,5,927,1.0,659.0,659.0,5,1079,1.0,811.0,811.0
301.21,6,53,20964,28,14937,11155.0,2720.0,1148.0,25,6027,377.0,2667.0,385.0
40.059,17,10,676,5,460,10014.0,104.0,64.0,5,216,10013.0,20.0,15.0
0.007,17,18,2523,9,606,0.0,44.0,39.0,9,1917,0.0,239.0,185.0
300.348,6,27,7433,16,1409,20023.0,217.0,142.0,11,6024,24029.0,1679.0,777.0
1786.334,6,150,19350,90,13740,20071.0,302.0,302.0,60,5610,30276.0,83.0,83.0
0.252,17,2,152,1,76,0.0,48.0,48.0,1,76,0.0,48.0,48.0
0.022,17,2,230,1,68,0.0,40.0,40.0,1,162,0.0,134.0,134.0
0.018,6,10,1972,5,910,4.0,642.0,642.0,5,1062,4.0,794.0,794.0
0.004,6,10,2006,5,927,1.0,659.0,659.0,5,1079,1.0,811.0,811.0
28.965,6,40,10527,20,4929,470.0,1360.0,682.0,20,5598,1515.0,2667.0,435.0
0.014,6,10,1989,5,910,3.0,642.0,642.0,5,1079,3.0,811.0,811.0
0.01,6,10,1989,5,910,2.0,642.0,642.0,5,1079,2.0,811.0,811.0
241.965,6,382,347953,193,21563,1260.0,2736.0,886.0,189,326390,1287.0,3720.0,1768.0
300.025,6,12,1782,7,1348,50004.0,494.0,494.0,5,434,75005.0,83.0,83.0
0.213,6,19,6496,9,1441,26.0,533.0,321.0,10,5055,17.0,1402.0,754.0
1757.271,6,106,6322,58,3421,30828.0,27.0,27.0,48,2901,37387.0,27.0,27.0
0.117,6,10,1506,5,395,28.0,127.0,127.0,5,1111,23.0,843.0,843.0
0.006,6,12,1698,6,863,1.0,327.0,271.0,6,835,1.0,515.0,515.0
0.109,6,10,1506,5,395,25.0,127.0,127.0,5,1111,25.0,843.0,843.0
0.013,6,14,3787,7,497,2.0,125.0,125.0,7,3290,2.0,1448.0,972.0
0.124,6,10,1506,5,395,28.0,127.0,127.0,5,1111,28.0,843.0,843.0
0.005,6,10,2006,5,927,1.0,659.0,659.0,5,1079,1.0,811.0,811.0
301.044,6,44,13872,23,8005,13683.0,2720.0,1007.0,21,5867,443.0,2667.0,385.0
0.015,6,10,1989,5,910,3.0,642.0,642.0,5,1079,3.0,811.0,811.0
240.025,6,9,787,5,488,60006.0,232.0,232.0,4,299,80007.0,83.0,83.0
0.006,6,10,1689,5,839,1.0,571.0,571.0,5,850,1.0,582.0,582.0
0.091,6,10,1506,5,395,19.0,127.0,127.0,5,1111,19.0,843.0,843.0
126.043,6,14,2938,8,2504,17971.0,1414.0,1086.0,6,434,25160.0,182.0,182.0
0.009,6,10,1989,5,910,2.0,642.0,642.0,5,1079,2.0,811.0,811.0
0.803,6,22,5072,11,1250,69.0,325.0,133.0,11,3822,69.0,1414.0,563.0
0.097,6,10,1506,5,395,23.0,127.0,127.0,5,1111,22.0,843.0,843.0
0.15,6,10,1506,5,395,36.0,127.0,127.0,5,1111,13.0,843.0,843.0
0.011,6,10,1983,5,910,2.0,642.0,642.0,5,1073,2.0,805.0,805.0
240.091,6,16,4480,9,963,30011.0,238.0,166.0,7,3517,40014.0,1402.0,786.0
0.014,6,10,1990,5,911,3.0,643.0,643.0,5,1079,3.0,811.0,811.0
0.005,17,2,136,1,60,0.0,32.0,32.0,1,76,0.0,48.0,48.0
0.008,6,10,1989,5,910,1.0,642.0,642.0,5,1079,2.0,811.0,811.0
354.043,6,21,1795,16,1030,23602.0,190.0,190.0,5,765,60003.0,464.0,248.0
10.835,17,28,4420,14,1993,825.0,268.0,114.0,14,2427,824.0,586.0,145.0
0.005,6,10,2007,5,928,1.0,660.0,660.0,5,1079,1.0,811.0,811.0
0.014,6,10,1631,5,848,3.0,580.0,580.0,5,783,3.0,515.0,515.0
10.769,17,28,4423,14,1995,820.0,270.0,114.0,14,2428,820.0,587.0,145.0
40.061,17,10,676,5,460,10013.0,104.0,64.0,5,216,10014.0,20.0,15.0
0.007,6,13,3747,7,509,1.0,137.0,137.0,6,3238,1.0,1470.0,1459.0
0.097,6,10,1506,5,395,17.0,127.0,127.0,5,1111,23.0,843.0,843.0
0.075,6,10,1506,5,395,16.0,127.0,127.0,5,1111,16.0,843.0,843.0
0.003,17,2,136,1,60,0.0,32.0,32.0,1,76,0.0,48.0,48.0
0.006,17,2,164,1,74,0.0,46.0,46.0,1,90,0.0,62.0,62.0
0.005,17,2,169,1,62,0.0,34.0,34.0,1,107,0.0,79.0,79.0
0.005,6,10,1989,5,927,1.0,659.0,659.0,5,1062,1.0,794.0,794.0
0.001,17,2,180,1,66,0.0,38.0,38.0,1,114,0.0,86.0,86.0
0.005,6,10,2000,5,927,1.0,659.0,659.0,5,1073,1.0,805.0,805.0
0.082,6,10,1506,5,395,17.0,127.0,127.0,5,1111,19.0,843.0,843.0
0.005,6,10,2006,5,927,1.0,659.0,659.0,5,1079,1.0,811.0,811.0
40.076,17,10,676,5,460,10017.0,104.0,64.0,5,216,10018.0,20.0,15.0
0.014,6,13,3735,7,497,2.0,125.0,125.0,6,3238,2.0,1470.0,1459.0
0.006,17,2,209,1,64,0.0,36.0,36.0,1,145,0.0,117.0,117.0
0.006,6,10,1547,5,764,1.0,496.0,496.0,5,783,1.0,515.0,515.0
0.008,6,10,1989,5,910,2.0,642.0,642.0,5,1079,2.0,811.0,811.0
0.003,17,2,148,1,60,0.0,32.0,32.0,1,88,0.0,60.0,60.0
0.093,6,10,1506,5,395,21.0,127.0,127.0,5,1111,19.0,843.0,843.0
0.007,17,2,179,1,71,0.0,43.0,43.0,1,108,0.0,80.0,80.0
0.008,6,10,2006,5,927,1.0,659.0,659.0,5,1079,2.0,811.0,811.0
0.09,6,10,1506,5,395,20.0,127.0,127.0,5,1111,17.0,843.0,843.0
0.005,6,10,2000,5,927,1.0,659.0,659.0,5,1073,1.0,805.0,805.0
0.013,6,10,1983,5,910,3.0,642.0,642.0,5,1073,3.0,805.0,805.0
0.005,6,10,2007,5,928,1.0,660.0,660.0,5,1079,1.0,811.0,811.0
0.013,6,10,1990,5,911,3.0,643.0,643.0,5,1079,3.0,811.0,811.0
0.005,6,10,2007,5,928,1.0,660.0,660.0,5,1079,1.0,811.0,811.0
0.152,6,10,1506,5,395,35.0,127.0,127.0,5,1111,35.0,843.0,843.0
0.003,17,2,185,1,73,0.0,45.0,45.0,1,112,0.0,84.0,84.0
5.154,6,24,6519,14,1879,395.0,801.0,282.0,10,4640,572.0,1925.0,824.0
0.006,6,10,1547,5,764,1.0,496.0,496.0,5,783,1.0,515.0,515.0
0.042,17,2,152,1,76,0.0,48.0,48.0,1,76,0.0,48.0,48.0
0.006,6,10,1547,5,764,1.0,496.0,496.0,5,783,1.0,515.0,515.0
0.098,6,10,1506,5,395,23.0,127.0,127.0,5,1111,22.0,843.0,843.0
40.058,17,10,676,5,460,10012.0,104.0,64.0,5,216,10013.0,20.0,15.0
240.175,6,30,10688,13,4090,20014.0,1549.0,681.0,17,6598,15010.0,1593.0,570.0
0.005,6,10,2000,5,927,1.0,659.0,659.0,5,1073,1.0,805.0,805.0
0.005,6,10,2007,5,928,1.0,660.0,660.0,5,1079,1.0,811.0,811.0
0.074,6,10,1506,5,395,15.0,127.0,127.0,5,1111,16.0,843.0,843.0
0.004,17,4,284,2,120,1.0,32.0,32.0,2,164,1.0,60.0,54.0
361.834,6,19,1688,15,978,25845.0,190.0,190.0,4,710,80012.0,494.0,494.0
0.021,6,10,1989,5,910,5.0,642.0,642.0,5,1079,5.0,811.0,811.0
0.069,6,10,1506,5,395,15.0,127.0,127.0,5,1111,16.0,843.0,843.0
0.001,17,2,166,1,75,0.0,47.0,47.0,1,91,0.0,63.0,63.0
0.009,6,10,1972,5,910,2.0,642.0,642.0,5,1062,2.0,794.0,794.0
0.006,6,10,1689,5,839,1.0,571.0,571.0,5,850,1.0,582.0,582.0
0.016,17,2,198,1,91,0.0,63.0,63.0,1,107,0.0,79.0,79.0
240.015,6,9,787,5,488,60003.0,232.0,232.0,4,299,80003.0,83.0,83.0
0.014,6,10,1972,5,910,3.0,642.0,642.0,5,1062,3.0,794.0,794.0
0.005,17,2,170,1,65,0.0,37.0,37.0,1,105,0.0,77.0,77.0
0.009,6,10,1983,5,910,2.0,642.0,642.0,5,1073,2.0,805.0,805.0
0.005,6,10,1779,5,928,1.0,660.0,660.0,5,851,1.0,583.0,583.0
1770.643,17,120,11460,60,5460,30010.0,63.0,63.0,60,6000,30010.0,72.0,72.0
0.005,6,10,1547,5,764,1.0,496.0,496.0,5,783,1.0,515.0,515.0
15.074,17,14,9190,8,6902,2149.0,1350.0,834.0,6,2288,3009.0,1350.0,353.0
0.004,6,14,3742,8,504,0.0,80.0,80.0,6,3238,0.0,1470.0,1459.0
0.173,17,2,152,1,76,0.0,48.0,48.0,1,76,0.0,48.0,48.0
0.005,6,10,2000,5,927,1.0,659.0,659.0,5,1073,1.0,805.0,805.0
0.005,6,10,2007,5,928,1.0,660.0,660.0,5,1079,1.0,811.0,811.0
0.004,17,2,148,1,60,0.0,32.0,32.0,1,88,0.0,60.0,60.0
0.001,17,2,180,1,65,0.0,37.0,37.0,1,115,0.0,87.0,87.0
0.078,6,10,1506,5,395,17.0,127.0,127.0,5,1111,17.0,843.0,843.0
0.006,6,10,1643,5,860,1.0,592.0,592.0,5,783,1.0,515.0,515.0
0.072,6,44,14059,24,2503,3.0,517.0,139.0,20,11556,3.0,1402.0,808.0
0.004,17,2,136,1,60,0.0,32.0,32.0,1,76,0.0,48.0,48.0
40.058,17,10,676,5,460,10013.0,104.0,64.0,5,216,10013.0,20.0,15.0
0.004,6,10,1774,5,923,1.0,655.0,655.0,5,851,1.0,583.0,583.0
0.008,6,12,1926,6,1189,1.0,659.0,434.0,6,737,1.0,417.0,417.0
0.071,6,10,1506,5,395,16.0,127.0,127.0,5,1111,16.0,843.0,843.0
361.856,6,19,1689,15,978,25846.0,190.0,190.0,4,711,80016.0,495.0,495.0
0.005,6,10,1989,5,927,1.0,659.0,659.0,5,1062,1.0,794.0,794.0
0.206,6,16,2669,8,1395,29.0,533.0,323.0,8,1274,18.0,529.0,212.0
309.06,17,20,1124,10,716,34326.0,48.0,43.0,10,408,34325.0,20.0,12.0
0.006,6,10,1547,5,764,1.0,496.0,496.0,5,783,1.0,515.0,515.0
0.006,6,10,1854,5,889,1.0,621.0,621.0,5,965,1.0,697.0,697.0
0.006,6,10,1547,5,764,1.0,496.0,496.0,5,783,1.0,515.0,515.0
0.189,6,10,1506,5,395,38.0,127.0,127.0,5,1111,33.0,843.0,843.0
0.017,6,10,1972,5,910,4.0,642.0,642.0,5,1062,4.0,794.0,794.0
0.02,6,10,1972,5,910,5.0,642.0,642.0,5,1062,4.0,794.0,794.0
40.058,17,10,676,5,460,10013.0,104.0,64.0,5,216,10013.0,20.0,15.0
0.043,17,4,352,2,130,2.0,37.0,37.0,2,222,3.0,89.0,83.0
0.103,17,8,3613,4,1874,34.0,1350.0,440.0,4,1739,12.0,1350.0,406.0
310.471,17,20,1124,10,716,34482.0,48.0,43.0,10,408,34482.0,20.0,12.0
0.005,6,10,2000,5,927,1.0,659.0,659.0,5,1073,1.0,805.0,805.0
0.006,6,10,1689,5,839,1.0,571.0,571.0,5,850,1.0,582.0,582.0
0.071,6,10,1506,5,395,14.0,127.0,127.0,5,1111,14.0,843.0,843.0
0.061,6,10,1506,5,395,13.0,127.0,127.0,5,1111,13.0,843.0,843.0
0.004,6,10,1702,5,863,1.0,595.0,595.0,5,839,0.0,571.0,571.0
0.006,6,10,1547,5,764,1.0,496.0,496.0,5,783,1.0,515.0,515.0
0.168,17,2,152,1,76,0.0,48.0,48.0,1,76,0.0,48.0,48.0
0.014,6,10,1989,5,910,3.0,642.0,642.0,5,1079,3.0,811.0,811.0
40.064,17,10,676,5,460,10015.0,104.0,64.0,5,216,10015.0,20.0,15.0
0.006,17,2,170,1,65,0.0,37.0,37.0,1,105,0.0,77.0,77.0
0.017,6,14,3787,7,497,2.0,125.0,125.0,7,3290,2.0,1448.0,972.0
0.005,6,14,3736,7,446,0.0,74.0,74.0,7,3290,0.0,1448.0,972.0
40.062,17,10,676,5,460,10013.0,104.0,64.0,5,216,10014.0,20.0,15.0
0.015,6,10,1983,5,910,3.0,642.0,642.0,5,1073,3.0,805.0,805.0
0.007,6,10,1990,5,911,1.0,643.0,643.0,5,1079,1.0,811.0,811.0
0.006,17,2,230,1,68,0.0,40.0,40.0,1,162,0.0,134.0,134.0
0.001,17,2,180,1,66,0.0,38.0,38.0,1,114,0.0,86.0,86.0
10.843,17,24,3778,12,1674,976.0,269.0,111.0,12,2104,976.0,587.0,147.0
0.015,6,10,1983,5,910,3.0,642.0,642.0,5,1073,3.0,805.0,805.0
0.005,6,10,1774,5,923,1.0,655.0,655.0,5,851,1.0,583.0,583.0
40.077,17,10,676,5,460,10016.0,104.0,64.0,5,216,10018.0,20.0,15.0
0.004,6,10,1779,5,928,1.0,660.0,660.0,5,851,1.0,583.0,583.0
309.083,17,20,1124,10,716,34328.0,48.0,43.0,10,408,34328.0,20.0,12.0
0.112,6,10,1506,5,395,24.0,127.0,127.0,5,1111,26.0,843.0,843.0
240.015,6,9,787,5,488,60003.0,232.0,232.0,4,299,80004.0,83.0,83.0
0.006,6,10,1547,5,764,1.0,496.0,496.0,5,783,1.0,515.0,515.0
0.012,6,10,1972,5,910,2.0,642.0,642.0,5,1062,2.0,794.0,794.0
0.008,6,12,1926,6,1189,1.0,659.0,434.0,6,737,1.0,417.0,417.0
0.007,6,10,1643,5,860,1.0,592.0,592.0,5,783,1.0,515.0,515.0
0.004,6,10,1989,5,927,1.0,659.0,659.0,5,1062,1.0,794.0,794.0
0.005,6,10,2006,5,927,1.0,659.0,659.0,5,1079,1.0,811.0,811.0
0.075,6,10,1506,5,395,15.0,127.0,127.0,5,1111,15.0,843.0,843.0
11.179,17,28,4422,14,1994,847.0,269.0,114.0,14,2428,847.0,587.0,145.0
0.004,6,10,2006,5,927,1.0,659.0,659.0,5,1079,1.0,811.0,811.0
0.014,17,2,152,1,56,0.0,28.0,28.0,1,96,0.0,68.0,68.0
0.008,6,10,1989,5,910,1.0,642.0,642.0,5,1079,1.0,811.0,811.0
0.006,6,10,1643,5,860,1.0,592.0,592.0,5,783,1.0,515.0,515.0
0.006,6,10,1643,5,860,1.0,592.0,592.0,5,783,1.0,515.0,515.0
0.073,6,10,1506,5,395,15.0,127.0,127.0,5,1111,16.0,843.0,843.0
0.005,17,2,144,1,64,0.0,36.0,36.0,1,80,0.0,52.0,52.0
0.016,6,10,1677,5,827,4.0,559.0,559.0,5,850,3.0,582.0,582.0
0.012,6,10,1972,5,910,3.0,642.0,642.0,5,1062,3.0,794.0,794.0
0.013,6,10,1677,5,827,3.0,559.0,559.0,5,850,3.0,582.0,582.0
0.107,6,10,1506,5,395,21.0,127.0,127.0,5,1111,25.0,843.0,843.0
0.01,17,2,179,1,71,0.0,43.0,43.0,1,108,0.0,80.0,80.0
0.041,17,2,136,1,60,0.0,32.0,32.0,1,76,0.0,48.0,48.0
0.005,6,10,1989,5,927,1.0,659.0,659.0,5,1062,1.0,794.0,794.0
0.106,6,10,1506,5,395,24.0,127.0,127.0,5,1111,22.0,843.0,843.0
0.003,6,10,1702,5,863,0.0,595.0,595.0,5,839,0.0,571.0,571.0
0.072,17,2,182,1,65,0.0,37.0,37.0,1,117,0.0,89.0,89.0
240.022,6,9,787,5,488,60005.0,232.0,232.0,4,299,80002.0,83.0,83.0
0.015,6,10,1989,5,910,3.0,642.0,642.0,5,1079,3.0,811.0,811.0
0.001,17,2,136,1,60,0.0,32.0,32.0,1,76,0.0,48.0,48.0
354.019,6,21,1795,16,1030,23601.0,190.0,190.0,5,765,60001.0,464.0,248.0
0.009,6,10,1972,5,910,2.0,642.0,642.0,5,1062,2.0,794.0,794.0
0.044,17,2,182,1,65,0.0,37.0,37.0,1,117,0.0,89.0,89.0
0.011,6,10,1989,5,910,2.0,642.0,642.0,5,1079,2.0,811.0,811.0
0.266,6,10,1506,5,395,53.0,127.0,127.0,5,1111,63.0,843.0,843.0
0.004,17,2,148,1,60,0.0,32.0,32.0,1,88,0.0,60.0,60.0
0.041,17,2,152,1,76,0.0,48.0,48.0,1,76,0.0,48.0,48.0
0.008,6,10,1972,5,910,2.0,642.0,642.0,5,1062,2.0,794.0,794.0
40.074,17,10,676,5,460,10016.0,104.0,64.0,5,216,10017.0,20.0,15.0
0.006,17,2,164,1,74,0.0,46.0,46.0,1,90,0.0,62.0,62.0
0.006,17,2,175,1,65,0.0,37.0,37.0,1,110,0.0,82.0,82.0
0.134,6,10,1506,5,395,29.0,127.0,127.0,5,1111,30.0,843.0,843.0
9.037,17,6,376,5,280,2259.0,28.0,28.0,1,96,0.0,68.0,68.0
0.005,6,10,2007,5,928,1.0,660.0,660.0,5,1079,1.0,811.0,811.0
0.101,6,10,1506,5,395,17.0,127.0,127.0,5,1111,23.0,843.0,843.0
1770.415,17,92,8096,46,4048,39342.0,60.0,60.0,46,4048,39342.0,60.0,60.0
240.014,6,9,787,5,488,60003.0,232.0,232.0,4,299,80003.0,83.0,83.0
2.526,6,26,6081,15,2140,180.0,517.0,303.0,11,3941,241.0,1360.0,697.0
0.038,17,2,148,1,60,0.0,32.0,32.0,1,88,0.0,60.0,60.0
0.126,6,10,1506,5,395,30.0,127.0,127.0,5,1111,26.0,843.0,843.0
0.005,6,10,1989,5,927,1.0,659.0,659.0,5,1062,1.0,794.0,794.0
0.074,6,10,1506,5,395,16.0,127.0,127.0,5,1111,14.0,843.0,843.0
0.005,6,10,2007,5,928,1.0,660.0,660.0,5,1079,1.0,811.0,811.0
0.004,6,10,2000,5,927,1.0,659.0,659.0,5,1073,1.0,805.0,805.0
0.005,6,13,3747,7,509,0.0,137.0,137.0,6,3238,1.0,1470.0,1459.0
0.006,6,10,1854,5,889,1.0,621.0,621.0,5,965,1.0,697.0,697.0
0.004,17,2,148,1,60,0.0,32.0,32.0,1,88,0.0,60.0,60.0
0.067,17,8,3613,4,1874,22.0,1350.0,440.0,4,1739,11.0,1350.0,406.0
0.041,17,2,148,1,60,0.0,32.0,32.0,1,88,0.0,60.0,60.0
0.014,17,2,152,1,56,0.0,28.0,28.0,1,96,0.0,68.0,68.0
0.078,6,10,1506,5,395,17.0,127.0,127.0,5,1111,17.0,843.0,843.0
0.02,17,2,194,1,59,0.0,31.0,31.0,1,135,0.0,107.0,107.0
0.022,6,10,1762,5,911,5.0,643.0,643.0,5,851,5.0,583.0,583.0
0.014,6,10,1972,5,910,3.0,642.0,642.0,5,1062,3.0,794.0,794.0
0.005,17,2,166,1,75,0.0,47.0,47.0,1,91,0.0,63.0,63.0
0.104,6,10,1506,5,395,22.0,127.0,127.0,5,1111,23.0,843.0,843.0
0.012,6,10,1677,5,827,2.0,559.0,559.0,5,850,3.0,582.0,582.0
0.005,6,10,1689,5,839,1.0,571.0,571.0,5,850,1.0,582.0,582.0
0.006,6,10,2000,5,927,1.0,659.0,659.0,5,1073,1.0,805.0,805.0
0.042,17,2,148,1,60,0.0,32.0,32.0,1,88,0.0,60.0,60.0
0.005,17,2,179,1,71,0.0,43.0,43.0,1,108,0.0,80.0,80.0
0.001,17,2,152,1,68,0.0,40.0,40.0,1,84,0.0,56.0,56.0
11.176,17,28,4421,14,1993,847.0,268.0,114.0,14,2428,847.0,587.0,145.0
0.279,17,4,596,2,122,147.0,33.0,33.0,2,474,239.0,323.0,209.0
60.023,6,10,1690,6,1308,12004.0,494.0,494.0,4,382,20006.0,83.0,83.0
0.001,17,2,180,1,66,0.0,38.0,38.0,1,114,0.0,86.0,86.0
0.005,6,10,2000,5,927,1.0,659.0,659.0,5,1073,1.0,805.0,805.0
40.062,17,10,676,5,460,10012.0,104.0,64.0,5,216,10014.0,20.0,15.0
0.005,6,10,1689,5,839,1.0,571.0,571.0,5,850,1.0,582.0,582.0
0.013,6,14,3787,7,497,2.0,125.0,125.0,7,3290,2.0,1448.0,972.0
354.038,6,21,1795,16,1030,23602.0,190.0,190.0,5,765,60001.0,464.0,248.0
0.006,6,10,1689,5,839,1.0,571.0,571.0,5,850,1.0,582.0,582.0
0.005,6,10,1779,5,928,1.0,660.0,660.0,5,851,1.0,583.0,583.0
0.069,6,10,1506,5,395,14.0,127.0,127.0,5,1111,15.0,843.0,843.0
0.003,17,2,148,1,60,0.0,32.0,32.0,1,88,0.0,60.0,60.0
0.004,6,10,2006,5,927,1.0,659.0,659.0,5,1079,1.0,811.0,811.0
15.088,17,16,8217,8,6137,2151.0,1350.0,739.0,8,2080,2151.0,1350.0,232.0
0.009,6,12,1926,6,1189,1.0,659.0,434.0,6,737,1.0,417.0,417.0
0.005,6,10,2006,5,927,1.0,659.0,659.0,5,1079,1.0,811.0,811.0
0.064,6,10,1506,5,395,13.0,127.0,127.0,5,1111,15.0,843.0,843.0
0.005,6,10,2000,5,927,1.0,659.0,659.0,5,1073,1.0,805.0,805.0
0.008,6,10,1989,5,910,2.0,642.0,642.0,5,1079,2.0,811.0,811.0
0.007,6,10,1972,5,910,1.0,642.0,642.0,5,1062,1.0,794.0,794.0
1787.108,6,154,19574,92,13852,19638.0,302.0,302.0,62,5722,29296.0,83.0,83.0
1769.215,17,92,8096,46,4048,39315.0,60.0,60.0,46,4048,39315.0,60.0,60.0
0.001,17,2,179,1,62,0.0,34.0,34.0,1,117,0.0,89.0,89.0
0.015,6,10,1990,5,911,3.0,643.0,643.0,5,1079,3.0,811.0,811.0
164.095,17,84,12288,42,2826,4002.0,44.0,39.0,42,9462,4002.0,239.0,197.0
0.005,6,10,1989,5,927,1.0,659.0,659.0,5,1062,1.0,794.0,794.0
0.101,6,10,1506,5,395,21.0,127.0,127.0,5,1111,24.0,843.0,843.0
0.118,6,10,1506,5,395,28.0,127.0,127.0,5,1111,27.0,843.0,843.0
0.005,17,2,222,1,65,0.0,37.0,37.0,1,157,0.0,129.0,129.0
0.009,6,12,1926,6,1189,1.0,659.0,434.0,6,737,1.0,417.0,417.0
0.019,6,10,1972,5,910,4.0,642.0,642.0,5,1062,4.0,794.0,794.0
0.014,6,10,1631,5,848,3.0,580.0,580.0,5,783,3.0,515.0,515.0
0.016,6,10,1990,5,911,4.0,643.0,643.0,5,1079,3.0,811.0,811.0
0.093,6,10,1506,5,395,21.0,127.0,127.0,5,1111,19.0,843.0,843.0
0.007,6,10,1989,5,910,1.0,642.0,642.0,5,1079,1.0,811.0,811.0
356.589,6,21,1795,16,1030,23772.0,190.0,190.0,5,765,60004.0,464.0,248.0
40.064,17,10,676,5,460,10015.0,104.0,64.0,5,216,10015.0,20.0,15.0
240.098,6,16,4481,9,963,30012.0,238.0,166.0,7,3518,40015.0,1402.0,786.0
0.015,6,10,1989,5,910,3.0,642.0,642.0,5,1079,3.0,811.0,811.0
0.09,6,10,1506,5,395,20.0,127.0,127.0,5,1111,18.0,843.0,843.0
0.126,17,2,144,1,64,0.0,36.0,36.0,1,80,0.0,52.0,52.0
0.007,6,10,2000,5,927,1.0,659.0,659.0,5,1073,1.0,805.0,805.0
0.062,6,10,1506,5,395,14.0,127.0,127.0,5,1111,15.0,843.0,843.0
40.063,17,10,676,5,460,10014.0,104.0,64.0,5,216,10014.0,20.0,15.0
0.105,6,10,1506,5,395,24.0,127.0,127.0,5,1111,25.0,843.0,843.0
10.99,17,28,4395,14,2312,836.0,587.0,137.0,14,2083,836.0,270.0,120.0
0.007,17,2,194,1,59,0.0,31.0,31.0,1,135,0.0,107.0,107.0
40.068,17,10,676,5,460,10015.0,104.0,64.0,5,216,10016.0,20.0,15.0
0.005,6,10,1989,5,927,1.0,659.0,659.0,5,1062,1.0,794.0,794.0
0.085,6,10,1506,5,395,19.0,127.0,127.0,5,1111,16.0,843.0,843.0
0.066,6,10,1506,5,395,15.0,127.0,127.0,5,1111,12.0,843.0,843.0
1731.195,6,67,7517,43,4537,41218.0,1402.0,104.0,24,2980,75261.0,1112.0,82.0
0.004,6,10,2007,5,928,1.0,660.0,660.0,5,1079,1.0,811.0,811.0
0.003,17,2,136,1,60,0.0,32.0,32.0,1,76,0.0,48.0,48.0
300.032,6,12,1782,7,1348,50005.0,494.0,494.0,5,434,75005.0,83.0,83.0
240.08,6,16,4481,9,963,30010.0,238.0,166.0,7,3518,40013.0,1402.0,786.0
0.004,6,10,2006,5,927,1.0,659.0,659.0,5,1079,1.0,811.0,811.0
0.001,17,2,154,1,69,0.0,41.0,41.0,1,85,0.0,57.0,57.0
0.005,6,10,1989,5,927,1.0,659.0,659.0,5,1062,1.0,794.0,794.0
240.019,6,9,787,5,488,60004.0,232.0,232.0,4,299,80005.0,83.0,83.0
0.076,6,10,1506,5,395,17.0,127.0,127.0,5,1111,14.0,843.0,843.0
0.026,6,10,1983,5,910,6.0,642.0,642.0,5,1073,6.0,805.0,805.0
0.004,6,10,1702,5,863,1.0,595.0,595.0,5,839,0.0,571.0,571.0
0.006,17,2,179,1,71,0.0,43.0,43.0,1,108,0.0,80.0,80.0
0.006,6,10,1547,5,764,1.0,496.0,496.0,5,783,1.0,515.0,515.0
0.107,6,10,1506,5,395,25.0,127.0,127.0,5,1111,23.0,843.0,843.0
0.107,6,10,1506,5,395,24.0,127.0,127.0,5,1111,23.0,843.0,843.0
0.01,6,14,3787,7,497,1.0,125.0,125.0,7,3290,1.0,1448.0,972.0
0.079,6,10,1506,5,395,16.0,127.0,127.0,5,1111,17.0,843.0,843.0
0.007,6,10,2007,5,928,1.0,660.0,660.0,5,1079,1.0,811.0,811.0
0.118,6,10,1506,5,395,28.0,127.0,127.0,5,1111,25.0,843.0,843.0
0.102,6,10,1506,5,395,19.0,127.0,127.0,5,1111,24.0,843.0,843.0
0.006,6,10,1689,5,839,1.0,571.0,571.0,5,850,1.0,582.0,582.0
0.005,6,10,2006,5,927,1.0,659.0,659.0,5,1079,1.0,811.0,811.0
0.009,6,12,1926,6,1189,1.0,659.0,434.0,6,737,1.0,417.0,417.0
0.007,6,10,1547,5,764,1.0,496.0,496.0,5,783,1.0,515.0,515.0
0.003,17,2,148,1,60,0.0,32.0,32.0,1,88,0.0,60.0,60.0
0.135,6,10,1506,5,395,29.0,127.0,127.0,5,1111,31.0,843.0,843.0
0.012,6,10,1983,5,910,3.0,642.0,642.0,5,1073,3.0,805.0,805.0
0.025,6,10,1989,5,910,6.0,642.0,642.0,5,1079,6.0,811.0,811.0
0.01,6,10,1989,5,910,2.0,642.0,642.0,5,1079,2.0,811.0,811.0
0.007,6,10,1854,5,889,1.0,621.0,621.0,5,965,1.0,697.0,697.0
0.005,6,10,2006,5,927,1.0,659.0,659.0,5,1079,1.0,811.0,811.0
309.474,17,20,1124,10,716,34372.0,48.0,43.0,10,408,34371.0,20.0,12.0
9.037,17,6,376,5,280,2259.0,28.0,28.0,1,96,0.0,68.0,68.0
40.06,17,10,676,5,460,10012.0,104.0,64.0,5,216,10013.0,20.0,15.0
0.01,6,10,1972,5,910,2.0,642.0,642.0,5,1062,2.0,794.0,794.0
0.005,6,10,2006,5,927,1.0,659.0,659.0,5,1079,1.0,811.0,811.0
0.013,6,10,1989,5,910,3.0,642.0,642.0,5,1079,3.0,811.0,811.0
0.004,6,10,2006,5,927,1.0,659.0,659.0,5,1079,1.0,811.0,811.0
0.006,17,2,170,1,65,0.0,37.0,37.0,1,105,0.0,77.0,77.0
10.991,17,28,4421,14,1993,837.0,268.0,114.0,14,2428,836.0,587.0,145.0
0.004,6,10,2007,5,928,1.0,660.0,660.0,5,1079,1.0,811.0,811.0
0.042,17,2,412,1,61,0.0,33.0,33.0,1,351,0.0,323.0,323.0
0.008,17,2,194,1,59,0.0,31.0,31.0,1,135,0.0,107.0,107.0
0.005,6,10,2006,5,927,1.0,659.0,659.0,5,1079,1.0,811.0,811.0
0.012,6,10,1989,5,910,2.0,642.0,642.0,5,1079,3.0,811.0,811.0
0.072,6,10,1506,5,395,15.0,127.0,127.0,5,1111,16.0,843.0,843.0
0.013,6,10,1677,5,827,3.0,559.0,559.0,5,850,3.0,582.0,582.0
0.006,6,10,1689,5,839,1.0,571.0,571.0,5,850,1.0,582.0,582.0
0.102,6,10,1506,5,395,22.0,127.0,127.0,5,1111,23.0,843.0,843.0
0.014,6,10,1762,5,911,3.0,643.0,643.0,5,851,3.0,583.0,583.0
0.01,6,10,1989,5,910,2.0,642.0,642.0,5,1079,2.0,811.0,811.0
0.006,6,10,1547,5,764,1.0,496.0,496.0,5,783,1.0,515.0,515.0
167.091,17,74,10826,37,2476,4641.0,44.0,38.0,37,8350,4641.0,261.0,197.0
0.018,6,10,1990,5,911,4.0,643.0,643.0,5,1079,4.0,811.0,811.0
0.005,6,10,2006,5,927,1.0,659.0,659.0,5,1079,1.0,811.0,811.0
0.111,6,10,1506,5,395,26.0,127.0,127.0,5,1111,24.0,843.0,843.0
0.085,6,10,1506,5,395,21.0,127.0,127.0,5,1111,19.0,843.0,843.0
0.005,6,10,1779,5,928,1.0,660.0,660.0,5,851,1.0,583.0,583.0
0.001,17,2,180,1,66,0.0,38.0,38.0,1,114,0.0,86.0,86.0
0.004,6,10,1989,5,927,1.0,659.0,659.0,5,1062,1.0,794.0,794.0
40.077,17,10,676,5,460,10016.0,104.0,64.0,5,216,10018.0,20.0,15.0
178.5,17,72,10188,36,2394,5099.0,44.0,38.0,36,7794,5099.0,239.0,188.0
40.102,17,10,676,5,460,10018.0,104.0,64.0,5,216,10023.0,20.0,15.0
0.005,6,10,2006,5,927,1.0,659.0,659.0,5,1079,1.0,811.0,811.0
0.005,6,14,3799,7,509,0.0,137.0,137.0,7,3290,0.0,1448.0,972.0
240.009,6,9,787,5,488,60002.0,232.0,232.0,4,299,80002.0,83.0,83.0
15.448,17,56,37337,34,32665,467.0,1350.0,932.0,22,4672,734.0,1350.0,184.0
11.236,17,28,4390,14,2312,855.0,587.0,137.0,14,2078,855.0,269.0,120.0
55.918,6,42,17669,21,12031,449.0,4080.0,1594.0,21,5638,2787.0,2667.0,435.0
0.011,6,12,1698,6,863,2.0,327.0,271.0,6,835,2.0,515.0,515.0
0.012,6,10,1972,5,910,3.0,642.0,642.0,5,1062,2.0,794.0,794.0
0.076,6,10,1506,5,395,16.0,127.0,127.0,5,1111,16.0,843.0,843.0
0.005,17,2,213,1,69,0.0,41.0,41.0,1,144,0.0,116.0,116.0
0.129,17,2,80,1,32,0.0,4.0,4.0,1,48,0.0,20.0,20.0
40.055,17,10,676,5,460,10012.0,104.0,64.0,5,216,10013.0,20.0,15.0
0.005,17,2,170,1,65,0.0,37.0,37.0,1,105,0.0,77.0,77.0
0.006,6,10,1689,5,839,1.0,571.0,571.0,5,850,1.0,582.0,582.0
0.022,17,2,286,1,64,0.0,36.0,36.0,1,222,0.0,194.0,194.0
308.729,17,18,1008,9,640,38583.0,48.0,43.0,9,368,38581.0,20.0,12.0
0.166,17,2,152,1,76,0.0,48.0,48.0,1,76,0.0,48.0,48.0
0.005,6,10,2006,5,927,1.0,659.0,659.0,5,1079,1.0,811.0,811.0
0.072,6,10,1506,5,395,15.0,127.0,127.0,5,1111,16.0,843.0,843.0
0.169,6,10,1989,5,910,42.0,642.0,642.0,5,1079,42.0,811.0,811.0
0.004,6,10,2000,5,927,1.0,659.0,659.0,5,1073,1.0,805.0,805.0
0.039,17,2,412,1,61,0.0,33.0,33.0,1,351,0.0,323.0,323.0
0.019,6,10,1989,5,910,4.0,642.0,642.0,5,1079,4.0,811.0,811.0
0.015,6,10,1762,5,911,3.0,643.0,643.0,5,851,3.0,583.0,583.0
0.015,6,10,1983,5,910,3.0,642.0,642.0,5,1073,3.0,805.0,805.0
0.226,6,16,2782,8,1400,32.0,533.0,325.0,8,1382,20.0,529.0,239.0
0.006,6,10,1547,5,764,1.0,496.0,496.0,5,783,1.0,515.0,515.0
0.005,6,10,1643,5,860,1.0,592.0,592.0,5,783,1.0,515.0,515.0
0.089,6,10,1506,5,395,20.0,127.0,127.0,5,1111,18.0,843.0,843.0
0.004,6,10,2007,5,928,1.0,660.0,660.0,5,1079,1.0,811.0,811.0
0.005,6,10,2000,5,927,1.0,659.0,659.0,5,1073,1.0,805.0,805.0
0.013,6,10,1989,5,910,3.0,642.0,642.0,5,1079,3.0,811.0,811.0
0.039,17,4,596,2,122,1.0,33.0,33.0,2,474,0.0,323.0,209.0
0.005,17,2,187,1,71,0.0,43.0,43.0,1,116,0.0,88.0,88.0
0.009,6,10,1677,5,827,2.0,559.0,559.0,5,850,2.0,582.0,582.0
0.018,6,10,1983,5,910,4.0,642.0,642.0,5,1073,4.0,805.0,805.0
40.059,17,10,676,5,460,10013.0,104.0,64.0,5,216,10014.0,20.0,15.0
0.004,6,10,2006,5,927,1.0,659.0,659.0,5,1079,1.0,811.0,811.0
0.037,17,2,152,1,76,0.0,48.0,48.0,1,76,0.0,48.0,48.0
0.005,6,10,2006,5,927,1.0,659.0,659.0,5,1079,1.0,811.0,811.0
40.068,17,10,676,5,460,10015.0,104.0,64.0,5,216,10016.0,20.0,15.0
0.005,17,2,162,1,73,0.0,45.0,45.0,1,89,0.0,61.0,61.0
0.055,6,10,1506,5,395,13.0,127.0,127.0,5,1111,13.0,843.0,843.0
0.071,17,4,284,2,120,0.0,32.0,32.0,2,164,31.0,60.0,54.0
380.016,6,24,2405,17,919,23751.0,195.0,195.0,7,1486,3913.0,419.0,398.0
0.011,6,10,1677,5,827,2.0,559.0,559.0,5,850,2.0,582.0,582.0
0.008,6,12,1926,6,1189,1.0,659.0,434.0,6,737,1.0,417.0,417.0
40.052,17,10,676,5,460,10012.0,104.0,64.0,5,216,10012.0,20.0,15.0
40.439,6,37,10002,19,4484,500.0,1360.0,738.0,18,5518,2368.0,2667.0,435.0
0.017,6,10,1989,5,910,4.0,642.0,642.0,5,1079,4.0,811.0,811.0
0.114,6,10,1506,5,395,26.0,127.0,127.0,5,1111,24.0,843.0,843.0
0.007,6,10,1989,5,910,1.0,642.0,642.0,5,1079,1.0,811.0,811.0
0.109,6,10,1506,5,395,24.0,127.0,127.0,5,1111,22.0,843.0,843.0
0.07,6,10,1506,5,395,17.0,127.0,127.0,5,1111,12.0,843.0,843.0
0.004,17,2,170,1,65,0.0,37.0,37.0,1,105,0.0,77.0,77.0
0.013,6,10,1990,5,911,3.0,643.0,643.0,5,1079,3.0,811.0,811.0
0.037,17,2,152,1,76,0.0,48.0,48.0,1,76,0.0,48.0,48.0
0.081,6,10,1506,5,395,16.0,127.0,127.0,5,1111,18.0,843.0,843.0
0.018,17,2,194,1,59,0.0,31.0,31.0,1,135,0.0,107.0,107.0
9.036,6,36,9974,19,4496,502.0,1360.0,738.0,17,5478,551.0,2667.0,435.0
0.016,6,10,1990,5,911,4.0,643.0,643.0,5,1079,4.0,811.0,811.0
0.001,17,2,180,1,65,0.0,37.0,37.0,1,115,0.0,87.0,87.0
0.079,6,10,1506,5,395,18.0,127.0,127.0,5,1111,17.0,843.0,843.0
0.001,17,2,180,1,66,0.0,38.0,38.0,1,114,0.0,86.0,86.0
0.011,6,13,3735,7,497,1.0,125.0,125.0,6,3238,2.0,1470.0,1459.0
0.005,6,10,2007,5,928,1.0,660.0,660.0,5,1079,1.0,811.0,811.0
0.006,6,10,1689,5,839,1.0,571.0,571.0,5,850,1.0,582.0,582.0
369.794,6,22,2313,16,867,24652.0,195.0,195.0,6,1446,4649.0,419.0,398.0
309.991,17,20,1124,10,716,34436.0,48.0,43.0,10,408,34436.0,20.0,12.0
0.005,6,10,1989,5,927,1.0,659.0,659.0,5,1062,1.0,794.0,794.0
0.003,17,2,136,1,60,0.0,32.0,32.0,1,76,0.0,48.0,48.0
15.073,17,15,9238,8,6902,2149.0,1350.0,834.0,7,2336,2507.0,1350.0,305.0
0.005,6,10,2000,5,927,1.0,659.0,659.0,5,1073,1.0,805.0,805.0
0.005,6,10,2006,5,927,1.0,659.0,659.0,5,1079,1.0,811.0,811.0
15.078,17,15,8339,8,6283,2150.0,1350.0,757.0,7,2056,2508.0,1350.0,265.0
0.006,6,10,1547,5,764,1.0,496.0,496.0,5,783,1.0,515.0,515.0
0.039,17,4,284,2,120,0.0,32.0,32.0,2,164,36.0,60.0,54.0
0.026,6,10,1989,5,910,6.0,642.0,642.0,5,1079,6.0,811.0,811.0
0.119,6,10,1506,5,395,27.0,127.0,127.0,5,1111,26.0,843.0,843.0
0.081,6,10,1506,5,395,15.0,127.0,127.0,5,1111,19.0,843.0,843.0
0.014,6,10,1990,5,911,3.0,643.0,643.0,5,1079,3.0,811.0,811.0
0.004,6,10,2006,5,927,1.0,659.0,659.0,5,1079,1.0,811.0,811.0
11.396,17,28,4391,14,2312,864.0,587.0,137.0,14,2079,864.0,270.0,120.0
0.006,6,10,1643,5,860,1.0,592.0,592.0,5,783,1.0,515.0,515.0
0.039,17,2,234,1,61,0.0,33.0,33.0,1,173,0.0,145.0,145.0
40.063,17,10,676,5,460,10012.0,104.0,64.0,5,216,10014.0,20.0,15.0
0.004,6,10,1779,5,928,1.0,660.0,660.0,5,851,1.0,583.0,583.0
0.005,6,13,3690,7,452,0.0,80.0,80.0,6,3238,1.0,1470.0,1459.0
0.005,6,10,1643,5,860,1.0,592.0,592.0,5,783,1.0,515.0,515.0
0.003,17,2,148,1,60,0.0,32.0,32.0,1,88,0.0,60.0,60.0
40.066,17,10,676,5,460,10015.0,104.0,64.0,5,216,10015.0,20.0,15.0
0.005,6,10,1689,5,839,1.0,571.0,571.0,5,850,1.0,582.0,582.0
0.006,6,10,2006,5,927,1.0,659.0,659.0,5,1079,1.0,811.0,811.0
0.024,17,2,136,1,60,0.0,32.0,32.0,1,76,0.0,48.0,48.0
0.004,6,10,1702,5,863,1.0,595.0,595.0,5,839,1.0,571.0,571.0
0.046,17,2,166,1,75,0.0,47.0,47.0,1,91,0.0,63.0,63.0
0.004,17,4,284,2,120,0.0,32.0,32.0,2,164,1.0,60.0,54.0
0.013,6,10,1990,5,911,3.0,643.0,643.0,5,1079,3.0,811.0,811.0
0.008,6,10,1990,5,911,1.0,643.0,643.0,5,1079,1.0,811.0,811.0
0.003,17,4,284,2,120,0.0,32.0,32.0,2,164,0.0,60.0,54.0
0.01,6,10,1972,5,910,2.0,642.0,642.0,5,1062,2.0,794.0,794.0
10.771,17,26,4101,13,1822,888.0,269.0,112.0,13,2279,888.0,586.0,147.0
0.02,6,10,1989,5,910,5.0,642.0,642.0,5,1079,5.0,811.0,811.0
0.093,6,10,1506,5,395,20.0,127.0,127.0,5,1111,20.0,843.0,843.0
0.091,6,10,1506,5,395,19.0,127.0,127.0,5,1111,22.0,843.0,843.0
0.004,6,10,2006,5,927,1.0,659.0,659.0,5,1079,1.0,811.0,811.0
0.014,6,10,1677,5,827,3.0,559.0,559.0,5,850,3.0,582.0,582.0
0.005,17,2,214,1,75,0.0,47.0,47.0,1,139,0.0,111.0,111.0
0.006,6,10,1702,5,863,1.0,595.0,595.0,5,839,1.0,571.0,571.0
0.082,6,10,1506,5,395,20.0,127.0,127.0,5,1111,17.0,843.0,843.0
0.105,6,10,1506,5,395,22.0,127.0,127.0,5,1111,22.0,843.0,843.0
0.012,6,10,1989,5,910,3.0,642.0,642.0,5,1079,2.0,811.0,811.0
0.043,6,10,1972,5,910,10.0,642.0,642.0,5,1062,10.0,794.0,794.0
0.083,6,10,1506,5,395,20.0,127.0,127.0,5,1111,18.0,843.0,843.0
0.008,6,12,1926,6,1189,1.0,659.0,434.0,6,737,1.0,417.0,417.0
0.004,17,2,136,1,60,0.0,32.0,32.0,1,76,0.0,48.0,48.0
0.093,6,10,1506,5,395,19.0,127.0,127.0,5,1111,22.0,843.0,843.0
0.004,6,10,2006,5,927,1.0,659.0,659.0,5,1079,1.0,811.0,811.0
0.014,6,10,1972,5,910,3.0,642.0,642.0,5,1062,3.0,794.0,794.0
315.904,17,19,1076,10,716,35089.0,48.0,43.0,9,360,39469.0,12.0,12.0
0.135,17,2,152,1,76,0.0,48.0,48.0,1,76,0.0,48.0,48.0
0.074,6,10,1506,5,395,15.0,127.0,127.0,5,1111,15.0,843.0,843.0
0.003,17,2,136,1,60,0.0,32.0,32.0,1,76,0.0,48.0,48.0
40.055,17,10,676,5,460,10012.0,104.0,64.0,5,216,10013.0,20.0,15.0
0.036,6,10,1605,5,388,9.0,120.0,120.0,5,1217,9.0,949.0,949.0
0.019,6,10,1989,5,910,4.0,642.0,642.0,5,1079,4.0,811.0,811.0
0.02,6,10,1990,5,911,5.0,643.0,643.0,5,1079,4.0,811.0,811.0
0.003,17,2,136,1,60,0.0,32.0,32.0,1,76,0.0,48.0,48.0
40.066,17,10,676,5,460,10014.0,104.0,64.0,5,216,10015.0,20.0,15.0
0.004,17,2,132,1,58,0.0,30.0,30.0,1,74,0.0,46.0,46.0
0.061,17,2,152,1,76,0.0,48.0,48.0,1,76,0.0,48.0,48.0
0.07,6,10,1506,5,395,16.0,127.0,127.0,5,1111,15.0,843.0,843.0
0.005,6,10,2006,5,927,1.0,659.0,659.0,5,1079,1.0,811.0,811.0
0.008,17,2,170,1,65,0.0,37.0,37.0,1,105,0.0,77.0,77.0
0.006,6,10,1854,5,889,1.0,621.0,621.0,5,965,1.0,697.0,697.0
0.012,6,10,1990,5,911,3.0,643.0,643.0,5,1079,2.0,811.0,811.0
1785.94,6,65,7413,43,4537,42522.0,1402.0,104.0,22,2876,85036.0,1112.0,82.0
0.004,6,10,2000,5,927,1.0,659.0,659.0,5,1073,1.0,805.0,805.0
0.005,17,4,284,2,120,1.0,32.0,32.0,2,164,2.0,60.0,54.0
0.005,6,10,2000,5,927,1.0,659.0,659.0,5,1073,1.0,805.0,805.0
0.001,17,2,180,1,66,0.0,38.0,38.0,1,114,0.0,86.0,86.0
177.241,17,74,10529,37,2459,4923.0,44.0,38.0,37,8070,4923.0,261.0,190.0
0.006,6,10,1547,5,764,1.0,496.0,496.0,5,783,1.0,515.0,515.0
0.005,6,10,2007,5,928,1.0,660.0,660.0,5,1079,1.0,811.0,811.0
367.368,6,22,2313,16,867,24491.0,195.0,195.0,6,1446,4641.0,419.0,398.0
0.004,6,10,1989,5,927,1.0,659.0,659.0,5,1062,1.0,794.0,794.0
0.004,6,10,1779,5,928,1.0,660.0,660.0,5,851,1.0,583.0,583.0
240.633,6,19,6300,10,1819,26737.0,1038.0,434.0,9,4481,30078.0,1593.0,801.0
0.005,6,10,2007,5,928,1.0,660.0,660.0,5,1079,1.0,811.0,811.0
240.099,6,16,4481,9,963,30012.0,238.0,166.0,7,3518,40016.0,1402.0,786.0
0.005,6,10,1779,5,928,1.0,660.0,660.0,5,851,1.0,583.0,583.0
40.071,17,10,676,5,460,10014.0,104.0,64.0,5,216,10016.0,20.0,15.0
0.007,6,10,1689,5,839,1.0,571.0,571.0,5,850,1.0,582.0,582.0
0.005,6,13,3747,7,509,0.0,137.0,137.0,6,3238,0.0,1470.0,1459.0
0.013,6,10,1762,5,911,3.0,643.0,643.0,5,851,3.0,583.0,583.0
0.187,17,4,352,2,130,150.0,37.0,37.0,2,222,147.0,89.0,83.0
240.015,6,9,787,5,488,60003.0,232.0,232.0,4,299,80004.0,83.0,83.0
0.216,6,16,2674,8,1400,30.0,533.0,325.0,8,1274,20.0,529.0,212.0
0.005,6,13,3690,7,452,0.0,80.0,80.0,6,3238,0.0,1470.0,1459.0
0.005,6,10,2007,5,928,1.0,660.0,660.0,5,1079,1.0,811.0,811.0
0.001,17,2,180,1,66,0.0,38.0,38.0,1,114,0.0,86.0,86.0
0.009,6,10,1990,5,911,2.0,643.0,643.0,5,1079,2.0,811.0,811.0
0.075,6,10,1506,5,395,17.0,127.0,127.0,5,1111,16.0,843.0,843.0
0.004,17,2,148,1,60,0.0,32.0,32.0,1,88,0.0,60.0,60.0
0.107,6,10,1506,5,395,24.0,127.0,127.0,5,1111,25.0,843.0,843.0
0.15,17,4,352,2,130,110.0,37.0,37.0,2,222,147.0,89.0,83.0
0.014,6,10,1990,5,911,3.0,643.0,643.0,5,1079,3.0,811.0,811.0
0.129,17,2,80,1,32,0.0,4.0,4.0,1,48,0.0,20.0,20.0
0.077,6,10,1506,5,395,16.0,127.0,127.0,5,1111,16.0,843.0,843.0
0.045,17,4,284,2,120,5.0,32.0,32.0,2,164,42.0,60.0,54.0
10.841,17,26,4098,13,1846,894.0,269.0,114.0,13,2252,894.0,587.0,145.0
0.004,6,10,2000,5,927,1.0,659.0,659.0,5,1073,1.0,805.0,805.0
310.78,17,18,1008,9,640,38832.0,48.0,43.0,9,368,38832.0,20.0,12.0
0.005,6,10,1689,5,839,1.0,571.0,571.0,5,850,1.0,582.0,582.0
0.214,6,16,2669,8,1395,30.0,533.0,323.0,8,1274,19.0,529.0,212.0
0.017,6,10,1989,5,910,4.0,642.0,642.0,5,1079,4.0,811.0,811.0
40.064,17,10,676,5,460,10015.0,104.0,64.0,5,216,10013.0,20.0,15.0
0.014,6,10,1990,5,911,3.0,643.0,643.0,5,1079,3.0,811.0,811.0
0.006,6,10,1547,5,764,1.0,496.0,496.0,5,783,1.0,515.0,515.0
40.054,17,10,676,5,460,10012.0,104.0,64.0,5,216,10012.0,20.0,15.0
0.09,6,10,1506,5,395,20.0,127.0,127.0,5,1111,19.0,843.0,843.0
0.008,6,10,1989,5,910,2.0,642.0,642.0,5,1079,2.0,811.0,811.0
0.004,17,2,136,1,60,0.0,32.0,32.0,1,76,0.0,48.0,48.0
312.899,17,20,1124,10,716,34752.0,48.0,43.0,10,408,34752.0,20.0,12.0
0.015,6,10,1631,5,848,3.0,580.0,580.0,5,783,3.0,515.0,515.0
0.119,6,10,1506,5,395,27.0,127.0,127.0,5,1111,24.0,843.0,843.0
0.006,6,10,1547,5,764,1.0,496.0,496.0,5,783,1.0,515.0,515.0
0.087,6,10,1506,5,395,19.0,127.0,127.0,5,1111,19.0,843.0,843.0
308.552,17,20,1124,10,716,34268.0,48.0,43.0,10,408,34269.0,20.0,12.0
40.065,17,10,676,5,460,10015.0,104.0,64.0,5,216,10015.0,20.0,15.0
40.074,17,10,676,5,460,10015.0,104.0,64.0,5,216,10017.0,20.0,15.0
42.634,6,44,16896,22,10989,431.0,4080.0,1439.0,22,5907,2021.0,2667.0,385.0
0.004,6,10,1702,5,863,1.0,595.0,595.0,5,839,0.0,571.0,571.0
0.004,17,2,136,1,60,0.0,32.0,32.0,1,76,0.0,48.0,48.0
15.071,17,15,9238,8,6902,2148.0,1350.0,834.0,7,2336,2506.0,1350.0,305.0
0.015,6,10,1972,5,910,3.0,642.0,642.0,5,1062,3.0,794.0,794.0
0.009,6,13,3735,7,497,1.0,125.0,125.0,6,3238,1.0,1470.0,1459.0
0.02,6,10,1989,5,910,4.0,642.0,642.0,5,1079,5.0,811.0,811.0
172.408,17,78,11003,39,2599,4536.0,44.0,38.0,39,8404,4536.0,239.0,187.0
0.013,6,10,1983,5,910,3.0,642.0,642.0,5,1073,3.0,805.0,805.0
0.016,6,10,1989,5,910,4.0,642.0,642.0,5,1079,3.0,811.0,811.0
40.065,17,10,676,5,460,10013.0,104.0,64.0,5,216,10015.0,20.0,15.0
0.039,17,4,284,2,120,0.0,32.0,32.0,2,164,36.0,60.0,54.0
0.016,6,10,1990,5,911,3.0,643.0,643.0,5,1079,4.0,811.0,811.0
0.012,17,2,230,1,68,0.0,40.0,40.0,1,162,0.0,134.0,134.0
0.091,6,10,1506,5,395,20.0,127.0,127.0,5,1111,19.0,843.0,843.0
0.009,17,2,214,1,75,0.0,47.0,47.0,1,139,0.0,111.0,111.0
0.006,6,10,1774,5,923,1.0,655.0,655.0,5,851,1.0,583.0,583.0
0.004,17,4,284,2,120,0.0,32.0,32.0,2,164,0.0,60.0,54.0
0.001,17,2,180,1,66,0.0,38.0,38.0,1,114,0.0,86.0,86.0
0.008,17,2,170,1,65,0.0,37.0,37.0,1,105,0.0,77.0,77.0
0.012,6,10,1983,5,910,2.0,642.0,642.0,5,1073,3.0,805.0,805.0
0.005,17,2,194,1,59,0.0,31.0,31.0,1,135,0.0,107.0,107.0
0.006,6,10,2006,5,927,1.0,659.0,659.0,5,1079,1.0,811.0,811.0
0.005,6,14,3742,8,504,0.0,80.0,80.0,6,3238,0.0,1470.0,1459.0
0.005,6,10,1989,5,927,1.0,659.0,659.0,5,1062,1.0,794.0,794.0
40.057,17,10,676,5,460,10013.0,104.0,64.0,5,216,10011.0,20.0,15.0
0.01,6,10,1989,5,910,2.0,642.0,642.0,5,1079,2.0,811.0,811.0
0.006,6,10,1643,5,860,1.0,592.0,592.0,5,783,1.0,515.0,515.0
240.016,6,9,787,5,488,60004.0,232.0,232.0,4,299,80004.0,83.0,83.0
0.112,6,10,1506,5,395,25.0,127.0,127.0,5,1111,25.0,843.0,843.0
0.005,6,10,2007,5,928,1.0,660.0,660.0,5,1079,1.0,811.0,811.0
0.005,17,2,170,1,65,0.0,37.0,37.0,1,105,0.0,77.0,77.0
0.009,6,10,1989,5,910,2.0,642.0,642.0,5,1079,2.0,811.0,811.0
0.001,17,2,166,1,75,0.0,47.0,47.0,1,91,0.0,63.0,63.0
0.096,6,10,1506,5,395,21.0,127.0,127.0,5,1111,20.0,843.0,843.0
15.226,17,17,8228,9,6007,1899.0,1350.0,639.0,8,2221,2170.0,1350.0,249.0
0.006,17,2,136,1,60,0.0,32.0,32.0,1,76,0.0,48.0,48.0
0.041,6,13,3735,7,497,6.0,125.0,125.0,6,3238,8.0,1470.0,1459.0
1.542,6,36,6723,19,3451,85.0,1103.0,204.0,17,3272,92.0,1402.0,340.0
0.005,6,10,1689,5,839,1.0,571.0,571.0,5,850,1.0,582.0,582.0
0.006,6,10,1854,5,889,1.0,621.0,621.0,5,965,1.0,697.0,697.0
40.059,17,10,676,5,460,10014.0,104.0,64.0,5,216,10013.0,20.0,15.0
429.604,6,38,6608,18,4896,7992.0,494.0,494.0,20,1712,22610.0,83.0,83.0
40.067,17,10,676,5,460,10013.0,104.0,64.0,5,216,10015.0,20.0,15.0
0.009,6,10,1989,5,910,2.0,642.0,642.0,5,1079,2.0,811.0,811.0
0.085,6,10,1506,5,395,16.0,127.0,127.0,5,1111,19.0,843.0,843.0
0.075,6,10,1506,5,395,16.0,127.0,127.0,5,1111,14.0,843.0,843.0
1729.211,6,60,4400,40,2740,44338.0,33.0,33.0,20,1660,91002.0,31.0,31.0
300.024,6,12,1782,7,1348,50004.0,494.0,494.0,5,434,75005.0,83.0,83.0
0.007,17,2,179,1,71,0.0,43.0,43.0,1,108,0.0,80.0,80.0
0.012,6,10,1983,5,910,3.0,642.0,642.0,5,1073,2.0,805.0,805.0
10.718,17,28,4421,14,1994,816.0,269.0,114.0,14,2427,816.0,586.0,145.0
0.027,6,10,1989,5,910,6.0,642.0,642.0,5,1079,6.0,811.0,811.0
0.093,6,10,1506,5,395,20.0,127.0,127.0,5,1111,21.0,843.0,843.0
0.006,6,10,1689,5,839,1.0,571.0,571.0,5,850,1.0,582.0,582.0
0.005,6,10,1689,5,839,1.0,571.0,571.0,5,850,1.0,582.0,582.0
0.059,6,10,1506,5,395,14.0,127.0,127.0,5,1111,12.0,843.0,843.0
0.004,17,2,136,1,60,0.0,32.0,32.0,1,76,0.0,48.0,48.0
0.058,6,10,1506,5,395,11.0,127.0,127.0,5,1111,13.0,843.0,843.0
0.007,6,10,1547,5,764,1.0,496.0,496.0,5,783,1.0,515.0,515.0
0.004,6,10,2006,5,927,1.0,659.0,659.0,5,1079,1.0,811.0,811.0
0.005,6,10,2000,5,927,1.0,659.0,659.0,5,1073,1.0,805.0,805.0
0.1,6,10,1506,5,395,23.0,127.0,127.0,5,1111,18.0,843.0,843.0
0.004,6,10,2006,5,927,1.0,659.0,659.0,5,1079,1.0,811.0,811.0
0.004,6,10,2006,5,927,1.0,659.0,659.0,5,1079,1.0,811.0,811.0
0.006,6,10,1547,5,764,1.0,496.0,496.0,5,783,1.0,515.0,515.0
0.004,6,10,2006,5,927,1.0,659.0,659.0,5,1079,1.0,811.0,811.0
0.01,6,10,1989,5,910,2.0,642.0,642.0,5,1079,2.0,811.0,811.0
11.103,17,28,4419,14,1994,841.0,269.0,114.0,14,2425,841.0,588.0,145.0
266.916,17,16,892,8,564,38112.0,48.0,42.0,8,328,38112.0,20.0,13.0
0.036,6,10,1989,5,910,9.0,642.0,642.0,5,1079,9.0,811.0,811.0
0.005,17,2,194,1,59,0.0,31.0,31.0,1,135,0.0,107.0,107.0
0.01,6,10,1989,5,910,2.0,642.0,642.0,5,1079,2.0,811.0,811.0
0.023,6,10,1972,5,910,5.0,642.0,642.0,5,1062,5.0,794.0,794.0
0.001,17,2,180,1,66,0.0,38.0,38.0,1,114,0.0,86.0,86.0
0.008,6,10,2007,5,928,2.0,660.0,660.0,5,1079,2.0,811.0,811.0
0.005,6,10,2000,5,927,1.0,659.0,659.0,5,1073,1.0,805.0,805.0
0.098,6,10,1506,5,395,22.0,127.0,127.0,5,1111,20.0,843.0,843.0
0.215,6,16,2669,8,1395,30.0,533.0,323.0,8,1274,19.0,529.0,212.0
0.067,17,8,3613,4,1874,22.0,1350.0,440.0,4,1739,11.0,1350.0,406.0
169.451,17,76,10883,38,2545,4579.0,44.0,38.0,38,8338,4579.0,261.0,191.0
0.031,6,10,1990,5,911,7.0,643.0,643.0,5,1079,7.0,811.0,811.0
0.009,17,2,170,1,65,0.0,37.0,37.0,1,105,0.0,77.0,77.0
240.02,6,9,787,5,488,60005.0,232.0,232.0,4,299,80005.0,83.0,83.0
0.005,6,10,1547,5,764,1.0,496.0,496.0,5,783,1.0,515.0,515.0
0.109,6,10,1506,5,395,25.0,127.0,127.0,5,1111,22.0,843.0,843.0
240.022,6,9,787,5,488,60005.0,232.0,232.0,4,299,80006.0,83.0,83.0
0.005,6,10,2007,5,928,1.0,660.0,660.0,5,1079,1.0,811.0,811.0
0.006,6,10,2007,5,928,1.0,660.0,660.0,5,1079,1.0,811.0,811.0
0.005,6,10,2006,5,927,1.0,659.0,659.0,5,1079,1.0,811.0,811.0
0.01,6,10,1989,5,910,2.0,642.0,642.0,5,1079,2.0,811.0,811.0
0.07,6,10,1506,5,395,15.0,127.0,127.0,5,1111,15.0,843.0,843.0
0.009,6,10,1989,5,910,2.0,642.0,642.0,5,1079,2.0,811.0,811.0
0.005,6,13,3690,7,452,0.0,80.0,80.0,6,3238,0.0,1470.0,1459.0
11.183,17,28,4418,14,1993,847.0,268.0,114.0,14,2425,847.0,588.0,145.0
0.101,6,10,1506,5,395,22.0,127.0,127.0,5,1111,23.0,843.0,843.0
0.019,6,10,1989,5,910,4.0,642.0,642.0,5,1079,4.0,811.0,811.0
0.005,17,2,136,1,60,0.0,32.0,32.0,1,76,0.0,48.0,48.0
0.001,17,2,180,1,66,0.0,38.0,38.0,1,114,0.0,86.0,86.0
0.015,6,13,3735,7,497,2.0,125.0,125.0,6,3238,2.0,1470.0,1459.0
240.094,6,16,4481,9,963,30011.0,238.0,166.0,7,3518,40014.0,1402.0,786.0
0.011,6,10,1983,5,910,2.0,642.0,642.0,5,1073,2.0,805.0,805.0
0.006,17,2,170,1,65,0.0,37.0,37.0,1,105,0.0,77.0,77.0
0.006,6,10,1779,5,928,1.0,660.0,660.0,5,851,1.0,583.0,583.0
5.079,6,21,5923,12,1436,461.0,474.0,201.0,9,4487,634.0,1925.0,804.0
0.013,6,10,1972,5,910,3.0,642.0,642.0,5,1062,3.0,794.0,794.0
0.022,6,10,1983,5,910,5.0,642.0,642.0,5,1073,5.0,805.0,805.0
0.013,6,10,1983,5,910,3.0,642.0,642.0,5,1073,3.0,805.0,805.0
0.005,6,10,2007,5,928,1.0,660.0,660.0,5,1079,1.0,811.0,811.0
240.077,6,16,4481,9,963,30009.0,238.0,166.0,7,3518,40012.0,1402.0,786.0
0.006,6,10,1689,5,839,1.0,571.0,571.0,5,850,1.0,582.0,582.0
10.833,17,28,4417,14,1993,824.0,268.0,114.0,14,2424,824.0,587.0,145.0
241.271,6,310,343164,113,17384,2154.0,2736.0,959.0,197,325780,1230.0,2804.0,1687.0
0.006,6,10,1547,5,764,1.0,496.0,496.0,5,783,1.0,515.0,515.0
0.005,6,10,2006,5,927,1.0,659.0,659.0,5,1079,1.0,811.0,811.0
240.1,6,16,4481,9,963,30012.0,238.0,166.0,7,3518,40016.0,1402.0,786.0
0.005,6,10,2000,5,927,1.0,659.0,659.0,5,1073,1.0,805.0,805.0
0.005,6,10,1989,5,927,1.0,659.0,659.0,5,1062,1.0,794.0,794.0
0.009,6,10,1990,5,911,2.0,643.0,643.0,5,1079,2.0,811.0,811.0
0.073,6,10,1506,5,395,16.0,127.0,127.0,5,1111,16.0,843.0,843.0
0.008,6,10,1990,5,911,1.0,643.0,643.0,5,1079,2.0,811.0,811.0
0.01,6,10,1989,5,910,2.0,642.0,642.0,5,1079,2.0,811.0,811.0
0.005,6,10,1989,5,927,1.0,659.0,659.0,5,1062,1.0,794.0,794.0
0.033,6,10,1972,5,910,8.0,642.0,642.0,5,1062,8.0,794.0,794.0
0.006,6,10,1547,5,764,1.0,496.0,496.0,5,783,1.0,515.0,515.0
0.005,6,14,3742,7,452,0.0,80.0,80.0,7,3290,0.0,1448.0,972.0
40.07,17,10,676,5,460,10014.0,104.0,64.0,5,216,10015.0,20.0,15.0
0.003,17,2,148,1,60,0.0,32.0,32.0,1,88,0.0,60.0,60.0
166.303,17,68,9529,34,2274,5039.0,44.0,38.0,34,7255,5039.0,239.0,185.0
0.004,6,15,3794,8,504,0.0,80.0,80.0,7,3290,0.0,1448.0,972.0
0.01,6,10,1989,5,910,2.0,642.0,642.0,5,1079,2.0,811.0,811.0
0.013,6,10,1762,5,911,3.0,643.0,643.0,5,851,3.0,583.0,583.0
0.004,6,10,1702,5,863,0.0,595.0,595.0,5,839,1.0,571.0,571.0
0.013,6,10,1631,5,848,3.0,580.0,580.0,5,783,3.0,515.0,515.0
0.005,6,10,1989,5,927,1.0,659.0,659.0,5,1062,1.0,794.0,794.0
0.099,6,10,1506,5,395,23.0,127.0,127.0,5,1111,21.0,843.0,843.0
0.075,17,8,3613,4,1874,25.0,1350.0,440.0,4,1739,12.0,1350.0,406.0
0.004,6,10,1779,5,928,1.0,660.0,660.0,5,851,1.0,583.0,583.0
0.005,6,10,2000,5,927,1.0,659.0,659.0,5,1073,1.0,805.0,805.0
0.016,6,10,1762,5,911,4.0,643.0,643.0,5,851,3.0,583.0,583.0
0.005,6,10,2007,5,928,1.0,660.0,660.0,5,1079,1.0,811.0,811.0
0.013,6,10,1983,5,910,3.0,642.0,642.0,5,1073,3.0,805.0,805.0
0.005,6,10,2006,5,927,1.0,659.0,659.0,5,1079,1.0,811.0,811.0
0.006,6,10,1689,5,839,1.0,571.0,571.0,5,850,1.0,582.0,582.0
40.061,17,10,676,5,460,10014.0,104.0,64.0,5,216,10012.0,20.0,15.0
0.114,6,10,1506,5,395,24.0,127.0,127.0,5,1111,26.0,843.0,843.0
0.061,17,2,80,1,32,0.0,4.0,4.0,1,48,0.0,20.0,20.0
0.012,6,13,3735,7,497,1.0,125.0,125.0,6,3238,2.0,1470.0,1459.0
0.114,6,10,1506,5,395,24.0,127.0,127.0,5,1111,25.0,843.0,843.0
0.071,6,45,14035,25,2555,2.0,517.0,139.0,20,11480,3.0,1402.0,745.0
0.005,17,2,169,1,62,0.0,34.0,34.0,1,107,0.0,79.0,79.0
11.35,17,28,4398,14,2312,864.0,587.0,137.0,14,2086,864.0,269.0,121.0
1742.132,6,152,19470,91,13800,19357.0,302.0,302.0,61,5670,29035.0,83.0,83.0
0.005,6,10,1989,5,927,1.0,659.0,659.0,5,1062,1.0,794.0,794.0
0.01,6,10,1990,5,911,2.0,643.0,643.0,5,1079,2.0,811.0,811.0
0.801,6,10,2009,6,1655,160.0,1403.0,1403.0,4,354,189.0,182.0,182.0
10.958,17,26,4102,13,1846,904.0,269.0,114.0,13,2256,904.0,587.0,145.0
0.005,6,10,1989,5,927,1.0,659.0,659.0,5,1062,1.0,794.0,794.0
0.004,6,10,2007,5,928,1.0,660.0,660.0,5,1079,1.0,811.0,811.0
0.009,6,12,1926,6,1189,1.0,659.0,434.0,6,737,1.0,417.0,417.0
0.006,6,10,1547,5,764,1.0,496.0,496.0,5,783,1.0,515.0,515.0
0.08,6,10,1506,5,395,19.0,127.0,127.0,5,1111,17.0,843.0,843.0
0.011,6,10,1989,5,910,2.0,642.0,642.0,5,1079,2.0,811.0,811.0
0.078,6,10,1506,5,395,19.0,127.0,127.0,5,1111,18.0,843.0,843.0
0.006,6,10,1689,5,839,1.0,571.0,571.0,5,850,1.0,582.0,582.0
0.003,17,2,148,1,60,0.0,32.0,32.0,1,88,0.0,60.0,60.0
0.005,6,10,1547,5,764,1.0,496.0,496.0,5,783,1.0,515.0,515.0
0.006,6,10,1547,5,764,1.0,496.0,496.0,5,783,1.0,515.0,515.0
0.076,6,10,1506,5,395,16.0,127.0,127.0,5,1111,16.0,843.0,843.0
0.01,6,10,1983,5,910,2.0,642.0,642.0,5,1073,2.0,805.0,805.0
0.073,17,8,3613,4,1874,24.0,1350.0,440.0,4,1739,11.0,1350.0,406.0
0.005,6,10,1689,5,839,1.0,571.0,571.0,5,850,1.0,582.0,582.0
15.073,17,15,9239,8,6902,2149.0,1350.0,834.0,7,2337,2507.0,1350.0,305.0
0.169,6,10,1506,5,395,39.0,127.0,127.0,5,1111,38.0,843.0,843.0
0.006,6,10,1547,5,764,1.0,496.0,496.0,5,783,1.0,515.0,515.0
0.008,6,10,1631,5,848,2.0,580.0,580.0,5,783,2.0,515.0,515.0
0.019,6,10,1983,5,910,4.0,642.0,642.0,5,1073,4.0,805.0,805.0
0.001,17,2,180,1,65,0.0,37.0,37.0,1,115,0.0,87.0,87.0
0.007,17,2,194,1,59,0.0,31.0,31.0,1,135,0.0,107.0,107.0
10.877,17,28,4423,14,1994,827.0,269.0,114.0,14,2429,827.0,588.0,145.0
0.01,6,10,1972,5,910,2.0,642.0,642.0,5,1062,2.0,794.0,794.0
0.01,6,10,1989,5,910,2.0,642.0,642.0,5,1079,2.0,811.0,811.0
0.058,17,2,152,1,76,0.0,48.0,48.0,1,76,0.0,48.0,48.0
0.006,6,10,1547,5,764,1.0,496.0,496.0,5,783,1.0,515.0,515.0
0.014,6,10,1972,5,910,3.0,642.0,642.0,5,1062,3.0,794.0,794.0
40.077,17,10,676,5,460,10017.0,104.0,64.0,5,216,10018.0,20.0,15.0
0.117,6,10,1506,5,395,25.0,127.0,127.0,5,1111,25.0,843.0,843.0
0.07,17,8,3613,4,1874,23.0,1350.0,440.0,4,1739,12.0,1350.0,406.0
0.003,17,2,148,1,60,0.0,32.0,32.0,1,88,0.0,60.0,60.0
0.008,6,10,1990,5,911,2.0,643.0,643.0,5,1079,2.0,811.0,811.0
0.005,6,10,1547,5,764,1.0,496.0,496.0,5,783,1.0,515.0,515.0
294.445,6,298,342534,114,17490,2605.0,2736.0,889.0,184,325044,1608.0,2804.0,1855.0
0.005,6,10,2000,5,927,1.0,659.0,659.0,5,1073,1.0,805.0,805.0
0.005,17,2,214,1,75,0.0,47.0,47.0,1,139,0.0,111.0,111.0
0.004,6,10,1989,5,927,1.0,659.0,659.0,5,1062,1.0,794.0,794.0
0.006,6,12,1698,6,863,1.0,327.0,271.0,6,835,1.0,515.0,515.0
300.025,6,12,1782,7,1348,50004.0,494.0,494.0,5,434,75005.0,83.0,83.0
0.011,6,10,1983,5,910,2.0,642.0,642.0,5,1073,2.0,805.0,805.0
15.291,17,26,17471,11,4339,1526.0,1350.0,366.0,15,13132,1090.0,1350.0,847.0
0.008,6,10,1989,5,910,2.0,642.0,642.0,5,1079,1.0,811.0,811.0
0.07,6,10,1506,5,395,16.0,127.0,127.0,5,1111,14.0,843.0,843.0
0.006,6,10,1547,5,764,1.0,496.0,496.0,5,783,1.0,515.0,515.0
0.004,17,2,148,1,60,0.0,32.0,32.0,1,88,0.0,60.0,60.0
0.009,6,10,1972,5,910,2.0,642.0,642.0,5,1062,2.0,794.0,794.0
0.087,6,10,1506,5,395,17.0,127.0,127.0,5,1111,18.0,843.0,843.0
0.004,6,10,1702,5,863,1.0,595.0,595.0,5,839,0.0,571.0,571.0
0.005,6,10,1989,5,927,1.0,659.0,659.0,5,1062,1.0,794.0,794.0
15.032,17,41,20669,23,17149,682.0,1350.0,717.0,18,3520,882.0,1350.0,167.0
0.005,17,2,178,1,65,0.0,37.0,37.0,1,113,0.0,85.0,85.0
0.011,6,10,1972,5,910,2.0,642.0,642.0,5,1062,2.0,794.0,794.0
0.11,6,10,1506,5,395,21.0,127.0,127.0,5,1111,26.0,843.0,843.0
169.372,17,76,10886,38,2529,4577.0,44.0,38.0,38,8357,4577.0,239.0,191.0
43.817,6,46,17690,23,11743,412.0,2720.0,1348.0,23,5947,1983.0,2667.0,385.0
0.009,6,10,1631,5,848,2.0,580.0,580.0,5,783,2.0,515.0,515.0
0.005,6,10,2006,5,927,1.0,659.0,659.0,5,1079,1.0,811.0,811.0
0.009,6,10,1989,5,910,2.0,642.0,642.0,5,1079,2.0,811.0,811.0
178.366,17,90,12948,45,3005,4053.0,44.0,38.0,45,9943,4053.0,261.0,192.0
0.005,6,10,1689,5,839,1.0,571.0,571.0,5,850,1.0,582.0,582.0
0.005,17,2,178,1,81,0.0,53.0,53.0,1,97,0.0,69.0,69.0
361.829,6,21,1793,16,1030,24121.0,190.0,190.0,5,763,60010.0,462.0,247.0
0.013,6,10,1989,5,910,3.0,642.0,642.0,5,1079,3.0,811.0,811.0
0.005,6,13,3747,7,509,0.0,137.0,137.0,6,3238,1.0,1470.0,1459.0
0.016,6,10,1762,5,911,4.0,643.0,643.0,5,851,4.0,583.0,583.0
40.094,17,10,676,5,460,10021.0,104.0,64.0,5,216,10022.0,20.0,15.0
0.017,17,2,136,1,60,0.0,32.0,32.0,1,76,0.0,48.0,48.0
0.039,17,2,152,1,76,0.0,48.0,48.0,1,76,0.0,48.0,48.0
0.005,17,2,293,1,73,0.0,45.0,45.0,1,220,0.0,192.0,192.0
0.071,17,8,3613,4,1874,23.0,1350.0,440.0,4,1739,12.0,1350.0,406.0
0.125,17,2,80,1,32,0.0,4.0,4.0,1,48,0.0,20.0,20.0
0.015,17,2,180,1,66,0.0,38.0,38.0,1,114,0.0,86.0,86.0
0.012,6,10,1972,5,910,3.0,642.0,642.0,5,1062,3.0,794.0,794.0
1786.978,6,150,19350,90,13740,20078.0,302.0,302.0,60,5610,30287.0,83.0,83.0
63.356,6,11,2033,7,1025,10559.0,589.0,326.0,4,1008,3.0,580.0,396.0
0.005,6,10,2006,5,927,1.0,659.0,659.0,5,1079,1.0,811.0,811.0
0.01,6,12,1926,6,1189,2.0,659.0,434.0,6,737,2.0,417.0,417.0
0.152,6,10,1506,5,395,36.0,127.0,127.0,5,1111,36.0,843.0,843.0
0.005,6,10,1989,5,927,1.0,659.0,659.0,5,1062,1.0,794.0,794.0
0.015,6,10,1990,5,911,3.0,643.0,643.0,5,1079,3.0,811.0,811.0
0.007,6,10,1989,5,927,1.0,659.0,659.0,5,1062,1.0,794.0,794.0
0.006,17,2,179,1,71,0.0,43.0,43.0,1,108,0.0,80.0,80.0
10.928,17,28,4422,14,1994,832.0,269.0,114.0,14,2428,832.0,587.0,145.0
0.012,6,10,1989,5,910,2.0,642.0,642.0,5,1079,3.0,811.0,811.0
10.695,17,28,4420,14,1995,814.0,270.0,114.0,14,2425,814.0,588.0,145.0
0.011,6,10,1972,5,910,2.0,642.0,642.0,5,1062,2.0,794.0,794.0
0.007,17,2,148,1,60,0.0,32.0,32.0,1,88,0.0,60.0,60.0
0.0,17,2,154,1,69,0.0,41.0,41.0,1,85,0.0,57.0,57.0
0.01,17,2,214,1,75,0.0,47.0,47.0,1,139,0.0,111.0,111.0
367.387,6,22,2313,16,867,24492.0,195.0,195.0,6,1446,4639.0,419.0,398.0
0.004,17,2,148,1,60,0.0,32.0,32.0,1,88,0.0,60.0,60.0
0.005,6,10,1989,5,927,1.0,659.0,659.0,5,1062,1.0,794.0,794.0
40.056,17,10,676,5,460,10012.0,104.0,64.0,5,216,10013.0,20.0,15.0
0.004,6,10,1774,5,923,1.0,655.0,655.0,5,851,1.0,583.0,583.0
0.005,6,10,2006,5,927,1.0,659.0,659.0,5,1079,1.0,811.0,811.0
0.003,17,2,148,1,60,0.0,32.0,32.0,1,88,0.0,60.0,60.0
0.013,6,10,1972,5,910,3.0,642.0,642.0,5,1062,3.0,794.0,794.0
0.005,17,2,164,1,74,0.0,46.0,46.0,1,90,0.0,62.0,62.0
0.097,6,10,1506,5,395,23.0,127.0,127.0,5,1111,19.0,843.0,843.0
0.005,6,10,1989,5,927,1.0,659.0,659.0,5,1062,1.0,794.0,794.0
308.461,17,20,1124,10,716,34261.0,48.0,43.0,10,408,34260.0,20.0,12.0
0.005,6,10,2000,5,927,1.0,659.0,659.0,5,1073,1.0,805.0,805.0
0.004,6,10,2007,5,928,1.0,660.0,660.0,5,1079,1.0,811.0,811.0
0.007,17,2,194,1,59,0.0,31.0,31.0,1,135,0.0,107.0,107.0
0.003,6,10,1702,5,863,0.0,595.0,595.0,5,839,0.0,571.0,571.0
0.005,6,10,1689,5,839,1.0,571.0,571.0,5,850,1.0,582.0,582.0
0.004,6,10,1702,5,863,1.0,595.0,595.0,5,839,1.0,571.0,571.0
0.012,6,10,1989,5,910,3.0,642.0,642.0,5,1079,3.0,811.0,811.0
0.008,6,10,1983,5,910,2.0,642.0,642.0,5,1073,1.0,805.0,805.0
0.089,6,10,1506,5,395,20.0,127.0,127.0,5,1111,21.0,843.0,843.0
0.005,6,10,2007,5,928,1.0,660.0,660.0,5,1079,1.0,811.0,811.0
0.126,6,10,1506,5,395,29.0,127.0,127.0,5,1111,26.0,843.0,843.0
67.087,6,21,8146,11,1985,86.0,1174.0,504.0,10,6161,7435.0,1791.0,958.0
0.004,6,10,2000,5,927,1.0,659.0,659.0,5,1073,1.0,805.0,805.0
0.006,6,10,1547,5,764,1.0,496.0,496.0,5,783,1.0,515.0,515.0
309.343,17,18,1008,9,640,38652.0,48.0,43.0,9,368,38652.0,20.0,12.0
15.072,17,14,9190,8,6902,2149.0,1350.0,834.0,6,2288,3008.0,1350.0,353.0
0.067,17,8,3613,4,1874,22.0,1350.0,440.0,4,1739,11.0,1350.0,406.0
0.018,6,10,1990,5,911,4.0,643.0,643.0,5,1079,4.0,811.0,811.0
0.001,17,2,136,1,60,0.0,32.0,32.0,1,76,0.0,48.0,48.0
0.013,6,10,1972,5,910,3.0,642.0,642.0,5,1062,3.0,794.0,794.0
0.037,17,2,184,1,61,0.0,33.0,33.0,1,123,0.0,95.0,95.0
0.048,17,2,170,1,65,0.0,37.0,37.0,1,105,0.0,77.0,77.0
0.032,6,10,1677,5,827,7.0,559.0,559.0,5,850,8.0,582.0,582.0
0.07,17,8,3613,4,1874,23.0,1350.0,440.0,4,1739,12.0,1350.0,406.0
0.009,17,2,230,1,68,0.0,40.0,40.0,1,162,0.0,134.0,134.0
0.01,6,10,1631,5,848,2.0,580.0,580.0,5,783,2.0,515.0,515.0
0.005,6,10,2007,5,928,1.0,660.0,660.0,5,1079,1.0,811.0,811.0
0.005,6,10,1547,5,764,1.0,496.0,496.0,5,783,1.0,515.0,515.0
0.017,6,10,1631,5,848,4.0,580.0,580.0,5,783,4.0,515.0,515.0
300.327,6,16,2170,9,684,37519.0,146.0,146.0,7,1486,50026.0,419.0,398.0
240.337,6,29,12380,14,6521,18487.0,1724.0,966.0,15,5859,17166.0,1657.0,845.0
0.08,6,10,1506,5,395,17.0,127.0,127.0,5,1111,16.0,843.0,843.0
40.07,17,10,676,5,460,10016.0,104.0,64.0,5,216,10012.0,20.0,15.0
0.076,6,10,1506,5,395,15.0,127.0,127.0,5,1111,17.0,843.0,843.0
0.005,6,10,2006,5,927,1.0,659.0,659.0,5,1079,1.0,811.0,811.0
0.005,6,10,2000,5,927,1.0,659.0,659.0,5,1073,1.0,805.0,805.0
0.004,17,4,284,2,120,0.0,32.0,32.0,2,164,0.0,60.0,54.0
0.005,6,10,1774,5,923,1.0,655.0,655.0,5,851,1.0,583.0,583.0
0.004,17,2,132,1,58,0.0,30.0,30.0,1,74,0.0,46.0,46.0
0.083,17,9,4994,5,3252,20.0,1350.0,622.0,4,1742,9.0,1350.0,407.0
0.102,6,10,1506,5,395,24.0,127.0,127.0,5,1111,22.0,843.0,843.0
40.064,17,10,676,5,460,10014.0,104.0,64.0,5,216,10014.0,20.0,15.0
0.005,6,14,3736,7,446,0.0,74.0,74.0,7,3290,0.0,1448.0,972.0
1727.923,6,45,2790,30,1725,59583.0,35.0,35.0,15,1065,123415.0,31.0,31.0
0.01,6,10,1990,5,911,2.0,643.0,643.0,5,1079,2.0,811.0,811.0
0.081,6,10,1506,5,395,16.0,127.0,127.0,5,1111,18.0,843.0,843.0
0.043,17,2,148,1,60,0.0,32.0,32.0,1,88,0.0,60.0,60.0
11.181,17,28,4422,14,1994,847.0,269.0,114.0,14,2428,847.0,587.0,145.0
0.074,6,10,1506,5,395,14.0,127.0,127.0,5,1111,16.0,843.0,843.0
11.109,17,28,4423,14,1995,842.0,270.0,114.0,14,2428,842.0,587.0,145.0
40.069,17,10,676,5,460,10016.0,104.0,64.0,5,216,10016.0,20.0,15.0
0.004,17,2,148,1,60,0.0,32.0,32.0,1,88,0.0,60.0,60.0
0.004,17,2,136,1,60,0.0,32.0,32.0,1,76,0.0,48.0,48.0
0.005,6,10,2006,5,927,1.0,659.0,659.0,5,1079,1.0,811.0,811.0
0.006,6,10,1643,5,860,1.0,592.0,592.0,5,783,1.0,515.0,515.0
0.116,6,10,1506,5,395,24.0,127.0,127.0,5,1111,20.0,843.0,843.0
0.006,6,13,3747,7,509,0.0,137.0,137.0,6,3238,1.0,1470.0,1459.0
0.007,6,10,1989,5,910,1.0,642.0,642.0,5,1079,1.0,811.0,811.0
0.011,6,10,1983,5,910,2.0,642.0,642.0,5,1073,2.0,805.0,805.0
0.01,6,10,1990,5,911,2.0,643.0,643.0,5,1079,2.0,811.0,811.0
0.01,6,10,1989,5,910,2.0,642.0,642.0,5,1079,2.0,811.0,811.0
0.106,6,10,1506,5,395,25.0,127.0,127.0,5,1111,16.0,843.0,843.0
0.076,6,10,1506,5,395,14.0,127.0,127.0,5,1111,16.0,843.0,843.0
0.074,6,10,1506,5,395,16.0,127.0,127.0,5,1111,15.0,843.0,843.0
0.005,17,2,136,1,60,0.0,32.0,32.0,1,76,0.0,48.0,48.0
0.005,17,2,214,1,75,0.0,47.0,47.0,1,139,0.0,111.0,111.0
0.01,6,10,1989,5,910,2.0,642.0,642.0,5,1079,2.0,811.0,811.0
0.014,6,10,1972,5,910,3.0,642.0,642.0,5,1062,3.0,794.0,794.0
0.062,6,10,1506,5,395,14.0,127.0,127.0,5,1111,14.0,843.0,843.0
0.154,6,10,1506,5,395,38.0,127.0,127.0,5,1111,35.0,843.0,843.0
0.003,17,2,148,1,60,0.0,32.0,32.0,1,88,0.0,60.0,60.0
240.011,6,9,787,5,488,60002.0,232.0,232.0,4,299,80002.0,83.0,83.0
240.962,6,395,348518,192,21508,1261.0,2736.0,959.0,203,327010,1192.0,3053.0,1639.0
0.005,6,13,3690,7,452,0.0,80.0,80.0,6,3238,0.0,1470.0,1459.0
0.113,6,10,1506,5,395,23.0,127.0,127.0,5,1111,25.0,843.0,843.0
0.005,6,10,1774,5,923,1.0,655.0,655.0,5,851,1.0,583.0,583.0
0.082,6,10,1506,5,395,17.0,127.0,127.0,5,1111,18.0,843.0,843.0
172.572,6,21,8145,11,1985,84.0,1174.0,504.0,10,6160,19156.0,2720.0,958.0
11.178,17,28,4393,14,2312,850.0,587.0,137.0,14,2081,851.0,268.0,120.0
0.001,17,2,136,1,60,0.0,32.0,32.0,1,76,0.0,48.0,48.0
0.004,17,2,136,1,60,0.0,32.0,32.0,1,76,0.0,48.0,48.0
0.011,6,10,1989,5,910,2.0,642.0,642.0,5,1079,2.0,811.0,811.0
0.133,6,10,1506,5,395,30.0,127.0,127.0,5,1111,23.0,843.0,843.0
0.005,6,10,2007,5,928,1.0,660.0,660.0,5,1079,1.0,811.0,811.0
280.434,6,27,6480,12,1511,25494.0,267.0,171.0,15,4969,20030.0,1400.0,873.0
0.207,6,16,2777,8,1395,29.0,533.0,323.0,8,1382,18.0,529.0,239.0
0.008,6,12,1926,6,1189,1.0,659.0,434.0,6,737,1.0,417.0,417.0
0.006,6,10,1547,5,764,1.0,496.0,496.0,5,783,1.0,515.0,515.0
0.007,17,2,179,1,71,0.0,43.0,43.0,1,108,0.0,80.0,80.0
9.036,17,6,376,5,280,2259.0,28.0,28.0,1,96,0.0,68.0,68.0
0.004,6,10,1779,5,928,1.0,660.0,660.0,5,851,1.0,583.0,583.0
0.009,6,10,1762,5,911,2.0,643.0,643.0,5,851,2.0,583.0,583.0
0.08,6,10,1506,5,395,16.0,127.0,127.0,5,1111,18.0,843.0,843.0
0.005,6,10,1854,5,889,1.0,621.0,621.0,5,965,1.0,697.0,697.0
0.011,6,10,1972,5,910,2.0,642.0,642.0,5,1062,2.0,794.0,794.0
40.05,17,10,676,5,460,10011.0,104.0,64.0,5,216,10011.0,20.0,15.0
0.021,6,10,1990,5,911,5.0,643.0,643.0,5,1079,5.0,811.0,811.0
0.112,6,10,1506,5,395,23.0,127.0,127.0,5,1111,26.0,843.0,843.0
0.001,17,2,136,1,60,0.0,32.0,32.0,1,76,0.0,48.0,48.0
0.131,6,10,1506,5,395,23.0,127.0,127.0,5,1111,28.0,843.0,843.0
0.004,6,10,2006,5,927,1.0,659.0,659.0,5,1079,1.0,811.0,811.0
0.013,17,2,152,1,56,0.0,28.0,28.0,1,96,0.0,68.0,68.0
0.09,6,10,1506,5,395,20.0,127.0,127.0,5,1111,16.0,843.0,843.0
0.003,17,2,136,1,60,0.0,32.0,32.0,1,76,0.0,48.0,48.0
0.005,6,10,2006,5,927,1.0,659.0,659.0,5,1079,1.0,811.0,811.0
0.088,6,10,1506,5,395,21.0,127.0,127.0,5,1111,16.0,843.0,843.0
0.005,6,10,2007,5,928,1.0,660.0,660.0,5,1079,1.0,811.0,811.0
0.006,17,2,164,1,74,0.0,46.0,46.0,1,90,0.0,62.0,62.0
0.073,6,10,1506,5,395,15.0,127.0,127.0,5,1111,14.0,843.0,843.0
0.039,17,2,184,1,61,0.0,33.0,33.0,1,123,0.0,95.0,95.0
0.011,6,10,1989,5,910,2.0,642.0,642.0,5,1079,2.0,811.0,811.0
0.016,6,10,1631,5,848,4.0,580.0,580.0,5,783,3.0,515.0,515.0
0.13,17,2,136,1,60,0.0,32.0,32.0,1,76,0.0,48.0,48.0
0.071,17,4,284,2,120,0.0,32.0,32.0,2,164,68.0,60.0,54.0
0.003,6,10,1702,5,863,0.0,595.0,595.0,5,839,0.0,571.0,571.0
0.008,6,10,1990,5,911,2.0,643.0,643.0,5,1079,1.0,811.0,811.0
0.105,6,10,1506,5,395,24.0,127.0,127.0,5,1111,22.0,843.0,843.0
0.109,6,10,1506,5,395,22.0,127.0,127.0,5,1111,23.0,843.0,843.0
0.005,6,14,3736,7,446,0.0,74.0,74.0,7,3290,0.0,1448.0,972.0
0.012,6,12,1926,6,1189,2.0,659.0,434.0,6,737,2.0,417.0,417.0
0.04,17,2,184,1,61,0.0,33.0,33.0,1,123,0.0,95.0,95.0
0.003,17,2,136,1,60,0.0,32.0,32.0,1,76,0.0,48.0,48.0
0.163,6,10,1506,5,395,38.0,127.0,127.0,5,1111,37.0,843.0,843.0
0.006,6,10,1643,5,860,1.0,592.0,592.0,5,783,1.0,515.0,515.0
0.016,6,10,1989,5,910,4.0,642.0,642.0,5,1079,3.0,811.0,811.0
0.04,17,4,284,2,120,0.0,32.0,32.0,2,164,1.0,60.0,54.0
0.097,6,10,1506,5,395,18.0,127.0,127.0,5,1111,23.0,843.0,843.0
0.005,6,10,2006,5,927,1.0,659.0,659.0,5,1079,1.0,811.0,811.0
0.004,17,2,179,1,71,0.0,43.0,43.0,1,108,0.0,80.0,80.0
0.018,6,10,1990,5,911,4.0,643.0,643.0,5,1079,4.0,811.0,811.0
11.149,17,28,4422,14,1995,845.0,270.0,114.0,14,2427,845.0,586.0,145.0
0.1,6,10,1506,5,395,21.0,127.0,127.0,5,1111,21.0,843.0,843.0
0.005,6,10,2006,5,927,1.0,659.0,659.0,5,1079,1.0,811.0,811.0
40.081,17,10,676,5,460,10019.0,104.0,64.0,5,216,10019.0,20.0,15.0
0.024,6,10,1972,5,910,5.0,642.0,642.0,5,1062,5.0,794.0,794.0
0.006,6,10,2006,5,927,1.0,659.0,659.0,5,1079,1.0,811.0,811.0
0.005,6,10,2006,5,927,1.0,659.0,659.0,5,1079,1.0,811.0,811.0
0.042,17,4,284,2,120,39.0,32.0,32.0,2,164,5.0,60.0,54.0
0.004,6,10,2000,5,927,1.0,659.0,659.0,5,1073,1.0,805.0,805.0
0.001,17,2,180,1,66,0.0,38.0,38.0,1,114,0.0,86.0,86.0
0.008,6,13,3735,7,497,1.0,125.0,125.0,6,3238,1.0,1470.0,1459.0
0.006,6,10,1689,5,839,1.0,571.0,571.0,5,850,1.0,582.0,582.0
0.005,6,10,2007,5,928,1.0,660.0,660.0,5,1079,1.0,811.0,811.0
0.011,6,10,1972,5,910,2.0,642.0,642.0,5,1062,2.0,794.0,794.0
0.012,6,13,3735,7,497,1.0,125.0,125.0,6,3238,2.0,1470.0,1459.0
0.01,6,10,1989,5,910,2.0,642.0,642.0,5,1079,2.0,811.0,811.0
0.018,6,10,1677,5,827,4.0,559.0,559.0,5,850,4.0,582.0,582.0
0.089,6,10,1506,5,395,19.0,127.0,127.0,5,1111,17.0,843.0,843.0
40.056,17,10,676,5,460,10013.0,104.0,64.0,5,216,10013.0,20.0,15.0
0.006,6,10,1547,5,764,1.0,496.0,496.0,5,783,1.0,515.0,515.0
0.005,6,10,2007,5,928,1.0,660.0,660.0,5,1079,1.0,811.0,811.0
0.032,6,10,1989,5,910,7.0,642.0,642.0,5,1079,8.0,811.0,811.0
0.006,17,2,168,1,76,0.0,48.0,48.0,1,92,0.0,64.0,64.0
0.012,6,10,1677,5,827,3.0,559.0,559.0,5,850,2.0,582.0,582.0
0.004,6,10,2006,5,927,1.0,659.0,659.0,5,1079,1.0,811.0,811.0
0.042,17,2,186,1,61,0.0,33.0,33.0,1,125,0.0,97.0,97.0
0.005,6,14,3736,7,446,0.0,74.0,74.0,7,3290,0.0,1448.0,972.0
0.013,17,2,152,1,56,0.0,28.0,28.0,1,96,0.0,68.0,68.0
0.016,6,10,1989,5,910,4.0,642.0,642.0,5,1079,4.0,811.0,811.0
178.5,17,78,10951,39,2600,4697.0,44.0,38.0,39,8351,4697.0,239.0,186.0
0.006,6,10,1854,5,889,1.0,621.0,621.0,5,965,1.0,697.0,697.0
0.014,6,10,1677,5,827,3.0,559.0,559.0,5,850,3.0,582.0,582.0
0.121,6,10,1506,5,395,23.0,127.0,127.0,5,1111,27.0,843.0,843.0
893.676,6,38,12366,20,5793,47033.0,1273.0,527.0,18,6573,52567.0,1402.0,705.0
1787.337,6,157,20044,93,14206,19427.0,302.0,302.0,64,5838,28370.0,83.0,83.0
0.052,17,2,152,1,76,0.0,48.0,48.0,1,76,0.0,48.0,48.0
0.005,6,10,1547,5,764,1.0,496.0,496.0,5,783,1.0,515.0,515.0
178.344,17,88,12668,44,2954,4146.0,44.0,39.0,44,9714,4146.0,239.0,192.0
0.008,6,10,2000,5,927,2.0,659.0,659.0,5,1073,2.0,805.0,805.0
300.339,6,16,2170,9,684,37520.0,146.0,146.0,7,1486,50027.0,419.0,398.0
0.001,17,2,166,1,75,0.0,47.0,47.0,1,91,0.0,63.0,63.0
0.005,17,2,170,1,65,0.0,37.0,37.0,1,105,0.0,77.0,77.0
0.004,6,10,2000,5,927,1.0,659.0,659.0,5,1073,1.0,805.0,805.0
0.006,6,10,2006,5,927,1.0,659.0,659.0,5,1079,1.0,811.0,811.0
0.011,6,10,1983,5,910,2.0,642.0,642.0,5,1073,2.0,805.0,805.0
0.01,6,12,1926,6,1189,1.0,659.0,434.0,6,737,1.0,417.0,417.0
0.005,17,2,214,1,75,0.0,47.0,47.0,1,139,0.0,111.0,111.0
0.011,6,10,1990,5,911,2.0,643.0,643.0,5,1079,2.0,811.0,811.0
0.006,6,10,1643,5,860,1.0,592.0,592.0,5,783,1.0,515.0,515.0
0.01,6,10,1972,5,910,2.0,642.0,642.0,5,1062,2.0,794.0,794.0
0.012,6,14,3787,7,497,2.0,125.0,125.0,7,3290,2.0,1448.0,972.0
0.004,6,10,2000,5,927,1.0,659.0,659.0,5,1073,1.0,805.0,805.0
0.068,6,10,1506,5,395,13.0,127.0,127.0,5,1111,15.0,843.0,843.0
0.005,17,2,144,1,64,0.0,36.0,36.0,1,80,0.0,52.0,52.0
0.009,6,10,1972,5,910,2.0,642.0,642.0,5,1062,2.0,794.0,794.0
0.016,6,10,1989,5,910,4.0,642.0,642.0,5,1079,4.0,811.0,811.0
0.007,6,10,1990,5,911,1.0,643.0,643.0,5,1079,1.0,811.0,811.0
0.061,6,10,1506,5,395,12.0,127.0,127.0,5,1111,14.0,843.0,843.0
0.017,6,10,1983,5,910,4.0,642.0,642.0,5,1073,4.0,805.0,805.0
0.071,17,4,284,2,120,0.0,32.0,32.0,2,164,67.0,60.0,54.0
0.016,6,10,1631,5,848,4.0,580.0,580.0,5,783,4.0,515.0,515.0
0.005,6,10,1779,5,928,1.0,660.0,660.0,5,851,1.0,583.0,583.0
0.004,6,10,2006,5,927,1.0,659.0,659.0,5,1079,1.0,811.0,811.0
0.005,6,10,1989,5,927,1.0,659.0,659.0,5,1062,1.0,794.0,794.0
354.023,6,21,1795,16,1030,23601.0,190.0,190.0,5,765,60002.0,464.0,248.0
0.005,6,10,1689,5,839,1.0,571.0,571.0,5,850,1.0,582.0,582.0
0.016,17,2,198,1,91,0.0,63.0,63.0,1,107,0.0,79.0,79.0
0.007,17,2,179,1,71,0.0,43.0,43.0,1,108,0.0,80.0,80.0
0.085,17,2,178,1,75,0.0,47.0,47.0,1,103,0.0,75.0,75.0
0.005,6,10,2007,5,928,1.0,660.0,660.0,5,1079,1.0,811.0,811.0
0.014,6,10,1989,5,910,3.0,642.0,642.0,5,1079,3.0,811.0,811.0
0.005,6,10,1774,5,923,1.0,655.0,655.0,5,851,1.0,583.0,583.0
0.058,6,10,1506,5,395,13.0,127.0,127.0,5,1111,11.0,843.0,843.0
628.0,17,126,18103,63,4207,10128.0,44.0,38.0,63,13896,10129.0,260.0,192.0
0.025,6,10,1983,5,910,6.0,642.0,642.0,5,1073,6.0,805.0,805.0
240.107,6,32,9628,16,7091,16007.0,2163.0,695.0,16,2537,16007.0,580.0,212.0
0.005,6,14,3736,7,446,0.0,74.0,74.0,7,3290,0.0,1448.0,972.0
0.005,17,2,140,1,62,0.0,34.0,34.0,1,78,0.0,50.0,50.0
0.004,6,10,1989,5,927,1.0,659.0,659.0,5,1062,1.0,794.0,794.0
308.496,17,18,1008,9,640,38548.0,48.0,43.0,9,368,38547.0,20.0,12.0
0.099,6,10,1506,5,395,22.0,127.0,127.0,5,1111,22.0,843.0,843.0
0.01,6,10,1989,5,910,2.0,642.0,642.0,5,1079,2.0,811.0,811.0
0.006,6,10,1547,5,764,1.0,496.0,496.0,5,783,1.0,515.0,515.0
0.092,6,10,1506,5,395,20.0,127.0,127.0,5,1111,19.0,843.0,843.0
40.059,17,10,676,5,460,10013.0,104.0,64.0,5,216,10014.0,20.0,15.0
0.011,6,10,1989,5,910,2.0,642.0,642.0,5,1079,2.0,811.0,811.0
0.061,6,10,1506,5,395,14.0,127.0,127.0,5,1111,13.0,843.0,843.0
0.015,6,10,1989,5,910,3.0,642.0,642.0,5,1079,3.0,811.0,811.0
0.004,6,10,2007,5,928,1.0,660.0,660.0,5,1079,1.0,811.0,811.0
0.005,6,10,2007,5,928,1.0,660.0,660.0,5,1079,1.0,811.0,811.0
0.081,6,10,1506,5,395,19.0,127.0,127.0,5,1111,12.0,843.0,843.0
40.069,17,10,676,5,460,10014.0,104.0,64.0,5,216,10016.0,20.0,15.0
300.364,6,16,2170,9,684,37523.0,146.0,146.0,7,1486,50031.0,419.0,398.0
0.003,17,2,136,1,60,0.0,32.0,32.0,1,76,0.0,48.0,48.0
0.005,17,2,179,1,71,0.0,43.0,43.0,1,108,0.0,80.0,80.0
241.97,6,332,344343,112,17329,2179.0,2736.0,885.0,220,327014,1104.0,4206.0,1502.0
0.017,6,10,1631,5,848,4.0,580.0,580.0,5,783,4.0,515.0,515.0
300.398,6,16,2170,9,684,37528.0,146.0,146.0,7,1486,50037.0,419.0,398.0
0.007,17,2,179,1,71,0.0,43.0,43.0,1,108,0.0,80.0,80.0
0.003,17,4,284,2,120,0.0,32.0,32.0,2,164,0.0,60.0,54.0
0.083,6,10,1506,5,395,18.0,127.0,127.0,5,1111,19.0,843.0,843.0
0.004,17,2,136,1,60,0.0,32.0,32.0,1,76,0.0,48.0,48.0
0.013,6,10,1990,5,911,3.0,643.0,643.0,5,1079,3.0,811.0,811.0
0.014,6,10,1989,5,910,3.0,642.0,642.0,5,1079,3.0,811.0,811.0
240.34,6,33,8637,17,1837,15021.0,570.0,189.0,16,6800,16022.0,1402.0,597.0
0.004,6,10,2006,5,927,1.0,659.0,659.0,5,1079,1.0,811.0,811.0
0.07,6,10,1506,5,395,15.0,127.0,127.0,5,1111,15.0,843.0,843.0
55.519,6,36,9704,18,4186,517.0,1753.0,858.0,18,5518,3256.0,2667.0,435.0
0.126,17,2,136,1,60,0.0,32.0,32.0,1,76,0.0,48.0,48.0
0.013,6,10,1989,5,910,3.0,642.0,642.0,5,1079,3.0,811.0,811.0
0.085,6,10,1506,5,395,19.0,127.0,127.0,5,1111,15.0,843.0,843.0
0.004,6,10,2007,5,928,1.0,660.0,660.0,5,1079,1.0,811.0,811.0
0.069,6,10,1506,5,395,16.0,127.0,127.0,5,1111,15.0,843.0,843.0
0.004,6,10,2006,5,927,1.0,659.0,659.0,5,1079,1.0,811.0,811.0
0.007,6,10,2006,5,927,1.0,659.0,659.0,5,1079,1.0,811.0,811.0
0.103,6,10,1506,5,395,19.0,127.0,127.0,5,1111,24.0,843.0,843.0
0.005,6,10,1989,5,927,1.0,659.0,659.0,5,1062,1.0,794.0,794.0
0.072,6,10,1506,5,395,16.0,127.0,127.0,5,1111,15.0,843.0,843.0
0.126,6,14,4390,8,923,18.0,238.0,166.0,6,3467,17.0,1402.0,786.0
0.041,17,2,170,1,65,0.0,37.0,37.0,1,105,0.0,77.0,77.0
0.016,6,10,1983,5,910,4.0,642.0,642.0,5,1073,3.0,805.0,805.0
0.223,6,16,2779,8,1397,31.0,533.0,324.0,8,1382,20.0,529.0,239.0
413.598,6,29,4409,12,3102,10911.0,494.0,494.0,17,1307,25849.0,83.0,83.0
0.011,6,10,1972,5,910,2.0,642.0,642.0,5,1062,2.0,794.0,794.0
0.013,6,10,1983,5,910,3.0,642.0,642.0,5,1073,3.0,805.0,805.0
40.054,17,10,676,5,460,10012.0,104.0,64.0,5,216,10012.0,20.0,15.0
0.085,6,10,1506,5,395,19.0,127.0,127.0,5,1111,19.0,843.0,843.0
66.628,6,27,17544,15,9602,4759.0,2804.0,1469.0,12,7942,6042.0,2313.0,1218.0
0.005,17,2,144,1,64,0.0,36.0,36.0,1,80,0.0,52.0,52.0
0.009,6,12,1926,6,1189,1.0,659.0,434.0,6,737,1.0,417.0,417.0
10.882,17,29,4550,14,1995,828.0,270.0,114.0,15,2555,769.0,586.0,142.0
0.008,6,10,1983,5,910,2.0,642.0,642.0,5,1073,2.0,805.0,805.0
0.219,6,16,2675,8,1401,31.0,533.0,325.0,8,1274,20.0,529.0,212.0
0.069,6,10,1506,5,395,15.0,127.0,127.0,5,1111,14.0,843.0,843.0
0.029,6,19,9922,11,704,2.0,124.0,124.0,8,9218,4.0,2896.0,2198.0
0.075,6,10,1506,5,395,17.0,127.0,127.0,5,1111,17.0,843.0,843.0
0.012,6,10,1972,5,910,2.0,642.0,642.0,5,1062,2.0,794.0,794.0
366.197,6,22,2313,16,867,24413.0,195.0,195.0,6,1446,4634.0,419.0,398.0
0.376,17,41,20602,22,17091,17.0,1350.0,748.0,19,3511,16.0,1350.0,156.0
0.098,6,10,1506,5,395,23.0,127.0,127.0,5,1111,20.0,843.0,843.0
176.087,17,80,11496,40,2682,4514.0,44.0,39.0,40,8814,4514.0,239.0,192.0
40.064,17,10,676,5,460,10013.0,104.0,64.0,5,216,10015.0,20.0,15.0
0.005,6,10,1989,5,927,1.0,659.0,659.0,5,1062,1.0,794.0,794.0
0.003,17,4,284,2,120,0.0,32.0,32.0,2,164,0.0,60.0,54.0
0.005,6,10,2007,5,928,1.0,660.0,660.0,5,1079,1.0,811.0,811.0
0.116,6,10,1506,5,395,27.0,127.0,127.0,5,1111,25.0,843.0,843.0
0.039,17,4,284,2,120,0.0,32.0,32.0,2,164,2.0,60.0,54.0
0.008,6,10,1972,5,910,2.0,642.0,642.0,5,1062,2.0,794.0,794.0
0.06,6,10,1506,5,395,12.0,127.0,127.0,5,1111,14.0,843.0,843.0
0.008,6,10,1547,5,764,1.0,496.0,496.0,5,783,1.0,515.0,515.0
0.006,6,10,1854,5,889,1.0,621.0,621.0,5,965,1.0,697.0,697.0
0.005,6,14,3799,7,509,0.0,137.0,137.0,7,3290,0.0,1448.0,972.0
0.065,6,10,1506,5,395,15.0,127.0,127.0,5,1111,14.0,843.0,843.0
0.008,6,10,1989,5,910,2.0,642.0,642.0,5,1079,1.0,811.0,811.0
0.006,6,10,1547,5,764,1.0,496.0,496.0,5,783,1.0,515.0,515.0
0.015,17,2,230,1,68,0.0,40.0,40.0,1,162,0.0,134.0,134.0
0.014,6,10,1972,5,910,3.0,642.0,642.0,5,1062,3.0,794.0,794.0
0.012,6,10,2006,5,927,3.0,659.0,659.0,5,1079,3.0,811.0,811.0
0.014,6,10,1989,5,910,3.0,642.0,642.0,5,1079,3.0,811.0,811.0
240.02,6,9,787,5,488,60005.0,232.0,232.0,4,299,80005.0,83.0,83.0
0.042,17,2,148,1,60,0.0,32.0,32.0,1,88,0.0,60.0,60.0
0.115,6,10,1506,5,395,27.0,127.0,127.0,5,1111,25.0,843.0,843.0
0.096,6,10,1506,5,395,19.0,127.0,127.0,5,1111,20.0,843.0,843.0
0.22,6,16,2674,8,1400,31.0,533.0,325.0,8,1274,20.0,529.0,212.0
0.011,6,14,3787,7,497,1.0,125.0,125.0,7,3290,1.0,1448.0,972.0
0.005,6,10,1989,5,927,1.0,659.0,659.0,5,1062,1.0,794.0,794.0
0.006,6,10,1547,5,764,1.0,496.0,496.0,5,783,1.0,515.0,515.0
0.005,6,10,2006,5,927,1.0,659.0,659.0,5,1079,1.0,811.0,811.0
169.085,17,80,11270,40,2664,4335.0,44.0,38.0,40,8606,4335.0,239.0,187.0
0.071,6,10,1506,5,395,16.0,127.0,127.0,5,1111,14.0,843.0,843.0
0.07,6,10,1506,5,395,15.0,127.0,127.0,5,1111,16.0,843.0,843.0
0.005,6,10,2007,5,928,1.0,660.0,660.0,5,1079,1.0,811.0,811.0
1786.449,6,151,19402,90,13740,20072.0,302.0,302.0,61,5662,29774.0,83.0,83.0
0.101,6,10,1983,5,910,25.0,642.0,642.0,5,1073,25.0,805.0,805.0
0.008,6,13,3735,7,497,1.0,125.0,125.0,6,3238,1.0,1470.0,1459.0
0.018,6,10,1989,5,910,4.0,642.0,642.0,5,1079,4.0,811.0,811.0
0.013,6,10,1989,5,910,3.0,642.0,642.0,5,1079,3.0,811.0,811.0
40.07,17,10,676,5,460,10014.0,104.0,64.0,5,216,10016.0,20.0,15.0
0.004,17,2,179,1,71,0.0,43.0,43.0,1,108,0.0,80.0,80.0
0.091,6,10,1506,5,395,21.0,127.0,127.0,5,1111,20.0,843.0,843.0
15.073,17,15,9238,8,6902,2149.0,1350.0,834.0,7,2336,2507.0,1350.0,305.0
0.094,6,10,1506,5,395,20.0,127.0,127.0,5,1111,20.0,843.0,843.0
0.022,6,10,1989,5,910,5.0,642.0,642.0,5,1079,5.0,811.0,811.0
0.003,17,2,136,1,60,0.0,32.0,32.0,1,76,0.0,48.0,48.0
300.324,6,16,2170,9,684,37520.0,146.0,146.0,7,1486,50027.0,419.0,398.0
0.005,6,10,1989,5,927,1.0,659.0,659.0,5,1062,1.0,794.0,794.0
0.005,17,2,136,1,60,0.0,32.0,32.0,1,76,0.0,48.0,48.0
11.461,17,28,4395,14,2312,869.0,587.0,137.0,14,2083,869.0,270.0,120.0
0.008,6,10,1631,5,848,2.0,580.0,580.0,5,783,2.0,515.0,515.0
0.01,6,10,1677,5,827,2.0,559.0,559.0,5,850,2.0,582.0,582.0
11.547,17,28,4391,14,2313,875.0,588.0,137.0,14,2078,875.0,269.0,120.0
0.004,17,2,148,1,60,0.0,32.0,32.0,1,88,0.0,60.0,60.0
0.082,6,10,1506,5,395,17.0,127.0,127.0,5,1111,18.0,843.0,843.0
0.031,6,20,9974,11,704,3.0,124.0,124.0,9,9270,3.0,2896.0,1758.0
40.138,17,10,676,5,460,10033.0,104.0,64.0,5,216,10033.0,20.0,15.0
365.979,6,22,2313,16,867,24398.0,195.0,195.0,6,1446,4653.0,419.0,398.0
0.006,6,10,1643,5,860,1.0,592.0,592.0,5,783,1.0,515.0,515.0
0.001,17,2,180,1,66,0.0,38.0,38.0,1,114,0.0,86.0,86.0
0.004,17,2,136,1,60,0.0,32.0,32.0,1,76,0.0,48.0,48.0
0.006,17,2,164,1,74,0.0,46.0,46.0,1,90,0.0,62.0,62.0
0.005,6,10,1689,5,839,1.0,571.0,571.0,5,850,1.0,582.0,582.0
0.098,6,10,1506,5,395,22.0,127.0,127.0,5,1111,17.0,843.0,843.0
0.001,17,2,166,1,75,0.0,47.0,47.0,1,91,0.0,63.0,63.0
0.014,6,10,1989,5,910,3.0,642.0,642.0,5,1079,3.0,811.0,811.0
40.071,17,10,676,5,460,10015.0,104.0,64.0,5,216,10016.0,20.0,15.0
0.004,17,4,284,2,120,0.0,32.0,32.0,2,164,1.0,60.0,54.0
0.07,6,10,1506,5,395,14.0,127.0,127.0,5,1111,16.0,843.0,843.0
0.024,6,10,1989,5,910,5.0,642.0,642.0,5,1079,5.0,811.0,811.0
0.011,6,10,1762,5,911,2.0,643.0,643.0,5,851,2.0,583.0,583.0
5.086,6,21,5923,12,1436,462.0,474.0,201.0,9,4487,635.0,1925.0,804.0
0.008,6,10,1989,5,927,2.0,659.0,659.0,5,1062,1.0,794.0,794.0
0.005,6,10,1774,5,923,1.0,655.0,655.0,5,851,1.0,583.0,583.0
0.018,6,10,1989,5,910,4.0,642.0,642.0,5,1079,4.0,811.0,811.0
0.017,6,10,1990,5,911,4.0,643.0,643.0,5,1079,4.0,811.0,811.0
0.11,6,10,1506,5,395,26.0,127.0,127.0,5,1111,23.0,843.0,843.0
0.114,6,10,1506,5,395,27.0,127.0,127.0,5,1111,23.0,843.0,843.0
0.001,17,2,136,1,60,0.0,32.0,32.0,1,76,0.0,48.0,48.0
0.099,6,10,1506,5,395,23.0,127.0,127.0,5,1111,23.0,843.0,843.0
240.259,6,39,5159,18,2313,14132.0,581.0,195.0,21,2846,12012.0,566.0,218.0
0.005,6,10,1854,5,889,1.0,621.0,621.0,5,965,1.0,697.0,697.0
0.016,17,2,198,1,91,0.0,63.0,63.0,1,107,0.0,79.0,79.0
0.006,6,10,1689,5,839,1.0,571.0,571.0,5,850,1.0,582.0,582.0
0.089,6,10,1506,5,395,19.0,127.0,127.0,5,1111,18.0,843.0,843.0
0.009,6,12,1926,6,1189,1.0,659.0,434.0,6,737,1.0,417.0,417.0
0.005,6,10,2000,5,927,1.0,659.0,659.0,5,1073,1.0,805.0,805.0
0.097,6,10,1506,5,395,21.0,127.0,127.0,5,1111,24.0,843.0,843.0
0.038,17,2,152,1,76,0.0,48.0,48.0,1,76,0.0,48.0,48.0
40.071,17,10,676,5,460,10016.0,104.0,64.0,5,216,10017.0,20.0,15.0
0.005,6,10,2000,5,927,1.0,659.0,659.0,5,1073,1.0,805.0,805.0
0.005,6,10,2007,5,928,1.0,660.0,660.0,5,1079,1.0,811.0,811.0
0.005,6,10,2006,5,927,1.0,659.0,659.0,5,1079,1.0,811.0,811.0
0.022,6,10,1983,5,910,5.0,642.0,642.0,5,1073,5.0,805.0,805.0
0.129,17,4,352,2,130,0.0,37.0,37.0,2,222,91.0,89.0,83.0
0.08,6,10,1506,5,395,16.0,127.0,127.0,5,1111,17.0,843.0,843.0
0.013,6,10,1631,5,848,3.0,580.0,580.0,5,783,3.0,515.0,515.0
40.072,17,10,676,5,460,10015.0,104.0,64.0,5,216,10016.0,20.0,15.0
15.203,17,18,9617,10,7404,1685.0,1350.0,712.0,8,2213,2168.0,1350.0,248.0
15.234,17,18,8265,9,6160,1900.0,1350.0,656.0,9,2105,1900.0,1350.0,205.0
0.012,6,10,1989,5,910,3.0,642.0,642.0,5,1079,3.0,811.0,811.0
0.008,6,10,1983,5,910,2.0,642.0,642.0,5,1073,2.0,805.0,805.0
0.005,6,10,2007,5,928,1.0,660.0,660.0,5,1079,1.0,811.0,811.0
0.005,6,10,2007,5,928,1.0,660.0,660.0,5,1079,1.0,811.0,811.0
0.012,6,10,1989,5,910,3.0,642.0,642.0,5,1079,2.0,811.0,811.0
300.019,6,12,1782,7,1348,50003.0,494.0,494.0,5,434,75003.0,83.0,83.0
0.007,6,10,1762,5,911,1.0,643.0,643.0,5,851,1.0,583.0,583.0
0.01,17,4,284,2,120,7.0,32.0,32.0,2,164,6.0,60.0,54.0
310.689,17,20,1124,10,716,34507.0,48.0,43.0,10,408,34507.0,20.0,12.0
314.87,17,20,1124,10,716,34971.0,48.0,43.0,10,408,34971.0,20.0,12.0
0.005,17,2,170,1,65,0.0,37.0,37.0,1,105,0.0,77.0,77.0
300.318,6,16,2170,9,684,37518.0,146.0,146.0,7,1486,50024.0,419.0,398.0
0.007,17,2,230,1,68,0.0,40.0,40.0,1,162,0.0,134.0,134.0
0.007,17,2,238,1,66,0.0,38.0,38.0,1,172,0.0,144.0,144.0
0.001,17,2,180,1,66,0.0,38.0,38.0,1,114,0.0,86.0,86.0
0.01,6,13,3735,7,497,1.0,125.0,125.0,6,3238,1.0,1470.0,1459.0
0.004,17,2,132,1,58,0.0,30.0,30.0,1,74,0.0,46.0,46.0
0.004,6,10,1702,5,863,1.0,595.0,595.0,5,839,0.0,571.0,571.0
0.001,17,2,180,1,66,0.0,38.0,38.0,1,114,0.0,86.0,86.0
0.001,17,2,142,1,63,0.0,35.0,35.0,1,79,0.0,51.0,51.0
0.007,17,2,179,1,71,0.0,43.0,43.0,1,108,0.0,80.0,80.0
0.007,6,10,1972,5,910,1.0,642.0,642.0,5,1062,1.0,794.0,794.0
0.014,6,10,1972,5,910,3.0,642.0,642.0,5,1062,3.0,794.0,794.0
0.005,6,10,2006,5,927,1.0,659.0,659.0,5,1079,1.0,811.0,811.0
240.092,6,16,4481,9,963,30011.0,238.0,166.0,7,3518,40015.0,1402.0,786.0
1742.888,6,297,97176,183,86180,9576.0,2001.0,690.0,114,10996,15423.0,452.0,70.0
0.014,6,10,1989,5,910,3.0,642.0,642.0,5,1079,3.0,811.0,811.0
0.006,6,10,1547,5,764,1.0,496.0,496.0,5,783,1.0,515.0,515.0
0.093,6,10,1506,5,395,20.0,127.0,127.0,5,1111,19.0,843.0,843.0
0.079,6,10,1506,5,395,17.0,127.0,127.0,5,1111,18.0,843.0,843.0
0.013,17,2,152,1,76,0.0,48.0,48.0,1,76,0.0,48.0,48.0
0.069,17,8,3613,4,1874,23.0,1350.0,440.0,4,1739,11.0,1350.0,406.0
0.129,17,2,170,1,65,0.0,37.0,37.0,1,105,0.0,77.0,77.0
40.069,17,10,676,5,460,10016.0,104.0,64.0,5,216,10016.0,20.0,15.0
0.005,17,2,230,1,68,0.0,40.0,40.0,1,162,0.0,134.0,134.0
0.005,17,2,230,1,68,0.0,40.0,40.0,1,162,0.0,134.0,134.0
0.04,17,4,596,2,122,0.0,33.0,33.0,2,474,36.0,323.0,209.0
0.005,6,10,1689,5,839,1.0,571.0,571.0,5,850,1.0,582.0,582.0
9.001,6,36,9771,19,4293,500.0,1360.0,700.0,17,5478,548.0,2667.0,435.0
0.016,6,10,1677,5,827,3.0,559.0,559.0,5,850,4.0,582.0,582.0
0.131,6,10,1506,5,395,22.0,127.0,127.0,5,1111,29.0,843.0,843.0
11.921,17,33,5253,19,2853,656.0,268.0,122.0,14,2400,907.0,587.0,143.0
0.005,6,10,2007,5,928,1.0,660.0,660.0,5,1079,1.0,811.0,811.0
0.011,6,10,1989,5,910,2.0,642.0,642.0,5,1079,2.0,811.0,811.0
0.098,6,10,1506,5,395,21.0,127.0,127.0,5,1111,22.0,843.0,843.0
0.005,6,10,1989,5,927,1.0,659.0,659.0,5,1062,1.0,794.0,794.0
0.04,17,2,148,1,60,0.0,32.0,32.0,1,88,0.0,60.0,60.0
0.08,6,10,1506,5,395,18.0,127.0,127.0,5,1111,14.0,843.0,843.0
0.131,6,10,1506,5,395,30.0,127.0,127.0,5,1111,27.0,843.0,843.0
0.014,6,13,3735,7,497,2.0,125.0,125.0,6,3238,2.0,1470.0,1459.0
368.524,6,22,2313,16,867,24568.0,195.0,195.0,6,1446,4655.0,419.0,398.0
0.004,6,10,2006,5,927,1.0,659.0,659.0,5,1079,1.0,811.0,811.0
0.097,6,10,1506,5,395,21.0,127.0,127.0,5,1111,22.0,843.0,843.0
0.008,6,12,1926,6,1189,1.0,659.0,434.0,6,737,1.0,417.0,417.0
0.007,6,10,1547,5,764,1.0,496.0,496.0,5,783,1.0,515.0,515.0
0.012,6,10,1989,5,910,3.0,642.0,642.0,5,1079,3.0,811.0,811.0
0.006,6,12,1698,6,863,1.0,327.0,271.0,6,835,1.0,515.0,515.0
413.608,6,29,4409,12,3102,10911.0,494.0,494.0,17,1307,25850.0,83.0,83.0
0.006,6,10,1689,5,839,1.0,571.0,571.0,5,850,1.0,582.0,582.0
0.005,6,10,2007,5,928,1.0,660.0,660.0,5,1079,1.0,811.0,811.0
0.004,17,2,186,1,61,0.0,33.0,33.0,1,125,0.0,97.0,97.0
0.004,17,2,148,1,60,0.0,32.0,32.0,1,88,0.0,60.0,60.0
40.054,17,10,676,5,460,10011.0,104.0,64.0,5,216,10012.0,20.0,15.0
0.005,6,10,1689,5,839,1.0,571.0,571.0,5,850,1.0,582.0,582.0
0.078,6,10,1506,5,395,18.0,127.0,127.0,5,1111,15.0,843.0,843.0
0.005,6,10,1989,5,927,1.0,659.0,659.0,5,1062,1.0,794.0,794.0
0.004,6,10,2006,5,927,1.0,659.0,659.0,5,1079,1.0,811.0,811.0
0.007,17,2,132,1,58,0.0,30.0,30.0,1,74,0.0,46.0,46.0
0.015,6,10,1989,5,910,3.0,642.0,642.0,5,1079,3.0,811.0,811.0
0.016,6,10,1989,5,910,4.0,642.0,642.0,5,1079,4.0,811.0,811.0
0.286,17,39,20250,22,17094,13.0,1350.0,749.0,17,3156,14.0,1350.0,157.0
0.006,6,10,2000,5,927,1.0,659.0,659.0,5,1073,1.0,805.0,805.0
0.01,6,10,1677,5,827,2.0,559.0,559.0,5,850,2.0,582.0,582.0
174.165,17,84,12207,42,2825,4247.0,44.0,39.0,42,9382,4247.0,261.0,195.0
0.011,6,10,1762,5,911,2.0,643.0,643.0,5,851,2.0,583.0,583.0
0.006,6,10,1547,5,764,1.0,496.0,496.0,5,783,1.0,515.0,515.0
0.006,6,10,1547,5,764,1.0,496.0,496.0,5,783,1.0,515.0,515.0
0.014,6,10,1972,5,910,3.0,642.0,642.0,5,1062,3.0,794.0,794.0
0.017,6,10,1677,5,827,4.0,559.0,559.0,5,850,4.0,582.0,582.0
0.09,6,10,1506,5,395,21.0,127.0,127.0,5,1111,19.0,843.0,843.0
0.006,6,10,1547,5,764,1.0,496.0,496.0,5,783,1.0,515.0,515.0
40.064,17,10,676,5,460,10013.0,104.0,64.0,5,216,10015.0,20.0,15.0
0.004,6,10,1702,5,863,1.0,595.0,595.0,5,839,0.0,571.0,571.0
0.005,6,10,2007,5,928,1.0,660.0,660.0,5,1079,1.0,811.0,811.0
0.027,6,10,1989,5,910,6.0,642.0,642.0,5,1079,6.0,811.0,811.0
0.004,6,10,1702,5,863,1.0,595.0,595.0,5,839,0.0,571.0,571.0
0.037,17,4,284,2,120,0.0,32.0,32.0,2,164,34.0,60.0,54.0
0.155,6,10,1506,5,395,35.0,127.0,127.0,5,1111,34.0,843.0,843.0
0.004,17,2,136,1,60,0.0,32.0,32.0,1,76,0.0,48.0,48.0
0.004,6,10,1779,5,928,1.0,660.0,660.0,5,851,1.0,583.0,583.0
308.85,17,20,1124,10,716,34303.0,48.0,43.0,10,408,34303.0,20.0,12.0
0.01,6,10,1989,5,910,2.0,642.0,642.0,5,1079,2.0,811.0,811.0
0.107,6,10,1506,5,395,24.0,127.0,127.0,5,1111,23.0,843.0,843.0
0.01,6,10,1989,5,910,2.0,642.0,642.0,5,1079,2.0,811.0,811.0
0.121,6,10,1506,5,395,24.0,127.0,127.0,5,1111,25.0,843.0,843.0
0.18,17,16,9180,8,6731,25.0,1350.0,813.0,8,2449,17.0,1350.0,278.0
0.006,17,2,193,1,71,0.0,43.0,43.0,1,122,0.0,94.0,94.0
0.008,6,10,1989,5,910,2.0,642.0,642.0,5,1079,2.0,811.0,811.0
0.006,6,10,1689,5,839,1.0,571.0,571.0,5,850,1.0,582.0,582.0
0.09,6,10,1506,5,395,20.0,127.0,127.0,5,1111,21.0,843.0,843.0
282.292,6,24,6115,11,1226,28228.0,267.0,156.0,13,4889,23523.0,1400.0,873.0
0.009,6,10,1990,5,911,2.0,643.0,643.0,5,1079,2.0,811.0,811.0
0.005,6,10,2007,5,928,1.0,660.0,660.0,5,1079,1.0,811.0,811.0
0.005,17,2,160,1,72,0.0,44.0,44.0,1,88,0.0,60.0,60.0
0.013,6,10,1989,5,910,3.0,642.0,642.0,5,1079,3.0,811.0,811.0
0.007,17,2,148,1,60,0.0,32.0,32.0,1,88,0.0,60.0,60.0
0.006,17,2,179,1,71,0.0,43.0,43.0,1,108,0.0,80.0,80.0
0.022,6,10,1762,5,911,5.0,643.0,643.0,5,851,5.0,583.0,583.0
0.017,6,10,1972,5,910,4.0,642.0,642.0,5,1062,4.0,794.0,794.0
11.122,17,28,4420,14,1993,842.0,268.0,114.0,14,2427,842.0,586.0,145.0
0.1,6,10,1506,5,395,24.0,127.0,127.0,5,1111,21.0,843.0,843.0
0.046,6,10,1989,5,910,11.0,642.0,642.0,5,1079,11.0,811.0,811.0
0.005,17,2,169,1,62,0.0,34.0,34.0,1,107,0.0,79.0,79.0
0.006,6,10,2000,5,927,1.0,659.0,659.0,5,1073,1.0,805.0,805.0
0.009,6,10,1989,5,910,2.0,642.0,642.0,5,1079,2.0,811.0,811.0
0.005,17,2,169,1,62,0.0,34.0,34.0,1,107,0.0,79.0,79.0
0.005,6,10,2006,5,927,1.0,659.0,659.0,5,1079,1.0,811.0,811.0
0.038,17,2,148,1,60,0.0,32.0,32.0,1,88,0.0,60.0,60.0
443.77,6,37,13736,20,3451,23356.0,676.0,400.0,17,10285,23982.0,1402.0,939.0
0.068,6,10,1506,5,395,13.0,127.0,127.0,5,1111,15.0,843.0,843.0
0.005,17,2,157,1,59,0.0,31.0,31.0,1,98,0.0,70.0,70.0
10.817,17,28,4423,14,1995,823.0,270.0,114.0,14,2428,823.0,587.0,145.0
0.005,6,13,3690,7,452,0.0,80.0,80.0,6,3238,1.0,1470.0,1459.0
0.005,17,2,222,1,65,0.0,37.0,37.0,1,157,0.0,129.0,129.0
0.005,6,10,1774,5,923,1.0,655.0,655.0,5,851,1.0,583.0,583.0
0.017,6,10,1990,5,911,4.0,643.0,643.0,5,1079,4.0,811.0,811.0
0.003,17,2,148,1,60,0.0,32.0,32.0,1,88,0.0,60.0,60.0
0.003,17,2,136,1,60,0.0,32.0,32.0,1,76,0.0,48.0,48.0
40.06,17,10,676,5,460,10012.0,104.0,64.0,5,216,10014.0,20.0,15.0
0.011,6,10,1989,5,910,2.0,642.0,642.0,5,1079,2.0,811.0,811.0
241.092,6,365,345939,184,21091,1317.0,2736.0,959.0,181,324848,1339.0,2804.0,1844.0
0.017,6,10,1990,5,911,4.0,643.0,643.0,5,1079,4.0,811.0,811.0
0.004,17,2,136,1,60,0.0,32.0,32.0,1,76,0.0,48.0,48.0
0.09,6,10,1506,5,395,19.0,127.0,127.0,5,1111,19.0,843.0,843.0
0.065,6,10,1506,5,395,14.0,127.0,127.0,5,1111,14.0,843.0,843.0
0.02,6,10,1972,5,910,4.0,642.0,642.0,5,1062,5.0,794.0,794.0
300.386,6,16,2170,9,684,37527.0,146.0,146.0,7,1486,50036.0,419.0,398.0
0.092,6,10,1506,5,395,21.0,127.0,127.0,5,1111,18.0,843.0,843.0
0.29,17,43,24297,23,21119,13.0,1350.0,890.0,20,3178,11.0,1350.0,130.0
289.807,6,413,349667,197,21810,1478.0,2736.0,889.0,216,327857,1347.0,2804.0,1567.0
0.013,6,10,1989,5,910,3.0,642.0,642.0,5,1079,3.0,811.0,811.0
0.119,6,10,1506,5,395,28.0,127.0,127.0,5,1111,25.0,843.0,843.0
15.083,17,18,8493,9,6018,1881.0,1350.0,640.0,9,2475,1881.0,1350.0,247.0
0.005,6,10,1689,5,839,1.0,571.0,571.0,5,850,1.0,582.0,582.0
0.013,6,10,1983,5,910,3.0,642.0,642.0,5,1073,3.0,805.0,805.0
1.004,6,13,3922,7,2139,125.0,1328.0,923.0,6,1783,151.0,1539.0,1539.0
0.006,6,10,1547,5,764,1.0,496.0,496.0,5,783,1.0,515.0,515.0
0.004,6,15,3794,8,504,0.0,80.0,80.0,7,3290,0.0,1448.0,972.0
0.003,17,2,904,1,576,0.0,548.0,548.0,1,328,0.0,300.0,300.0
0.01,6,10,1990,5,911,2.0,643.0,643.0,5,1079,2.0,811.0,811.0
0.092,6,10,1506,5,395,20.0,127.0,127.0,5,1111,21.0,843.0,843.0
0.005,6,10,2007,5,928,1.0,660.0,660.0,5,1079,1.0,811.0,811.0
0.014,6,10,1677,5,827,3.0,559.0,559.0,5,850,3.0,582.0,582.0
0.005,6,10,1774,5,923,1.0,655.0,655.0,5,851,1.0,583.0,583.0
9.037,17,6,376,5,280,2259.0,28.0,28.0,1,96,0.0,68.0,68.0
0.005,17,2,170,1,65,0.0,37.0,37.0,1,105,0.0,77.0,77.0
0.006,6,10,1547,5,764,1.0,496.0,496.0,5,783,1.0,515.0,515.0
0.023,6,10,1989,5,910,5.0,642.0,642.0,5,1079,5.0,811.0,811.0
0.004,6,10,2007,5,928,1.0,660.0,660.0,5,1079,1.0,811.0,811.0
0.005,6,10,2007,5,928,1.0,660.0,660.0,5,1079,1.0,811.0,811.0
0.076,6,10,1506,5,395,17.0,127.0,127.0,5,1111,17.0,843.0,843.0
0.005,6,10,2007,5,928,1.0,660.0,660.0,5,1079,1.0,811.0,811.0
0.005,6,10,1989,5,927,1.0,659.0,659.0,5,1062,1.0,794.0,794.0
0.011,6,10,1989,5,910,2.0,642.0,642.0,5,1079,2.0,811.0,811.0
0.168,17,2,152,1,76,0.0,48.0,48.0,1,76,0.0,48.0,48.0
0.005,6,10,2006,5,927,1.0,659.0,659.0,5,1079,1.0,811.0,811.0
0.005,6,10,2006,5,927,1.0,659.0,659.0,5,1079,1.0,811.0,811.0
0.007,17,2,164,1,74,0.0,46.0,46.0,1,90,0.0,62.0,62.0
0.107,6,10,1506,5,395,25.0,127.0,127.0,5,1111,25.0,843.0,843.0
40.063,17,10,676,5,460,10013.0,104.0,64.0,5,216,10014.0,20.0,15.0
10.831,17,28,4423,14,1994,824.0,269.0,114.0,14,2429,824.0,588.0,145.0
0.012,6,10,1989,5,910,3.0,642.0,642.0,5,1079,2.0,811.0,811.0
0.002,17,2,185,1,73,0.0,45.0,45.0,1,112,0.0,84.0,84.0
0.004,6,10,2000,5,927,1.0,659.0,659.0,5,1073,1.0,805.0,805.0
0.097,6,10,1506,5,395,20.0,127.0,127.0,5,1111,21.0,843.0,843.0
0.209,6,16,2779,8,1397,29.0,533.0,324.0,8,1382,18.0,529.0,239.0
0.005,6,10,2006,5,927,1.0,659.0,659.0,5,1079,1.0,811.0,811.0
0.004,6,10,1989,5,927,1.0,659.0,659.0,5,1062,1.0,794.0,794.0
308.741,17,20,1124,10,716,34290.0,48.0,43.0,10,408,34290.0,20.0,12.0
0.005,6,10,1702,5,863,1.0,595.0,595.0,5,839,1.0,571.0,571.0
0.02,6,10,1972,5,910,5.0,642.0,642.0,5,1062,4.0,794.0,794.0
364.531,6,22,2313,16,867,24302.0,195.0,195.0,6,1446,4634.0,419.0,398.0
309.576,17,20,1124,10,716,34383.0,48.0,43.0,10,408,34383.0,20.0,12.0
0.011,6,10,1990,5,911,2.0,643.0,643.0,5,1079,2.0,811.0,811.0
0.454,17,2,144,1,64,0.0,36.0,36.0,1,80,0.0,52.0,52.0
0.009,6,10,1983,5,910,2.0,642.0,642.0,5,1073,2.0,805.0,805.0
0.008,6,10,1990,5,911,2.0,643.0,643.0,5,1079,1.0,811.0,811.0
162.085,17,82,11939,41,2770,4052.0,44.0,39.0,41,9169,4051.0,239.0,195.0
0.117,6,10,1506,5,395,24.0,127.0,127.0,5,1111,25.0,843.0,843.0
1793.162,6,572,190879,292,164911,6162.0,2883.0,924.0,280,25968,6427.0,580.0,110.0
0.097,6,10,1506,5,395,21.0,127.0,127.0,5,1111,21.0,843.0,843.0
40.075,17,10,676,5,460,10015.0,104.0,64.0,5,216,10018.0,20.0,15.0
0.004,17,2,136,1,60,0.0,32.0,32.0,1,76,0.0,48.0,48.0
0.072,6,10,1506,5,395,16.0,127.0,127.0,5,1111,13.0,843.0,843.0
0.031,6,10,1990,5,911,7.0,643.0,643.0,5,1079,7.0,811.0,811.0
0.005,6,10,2006,5,927,1.0,659.0,659.0,5,1079,1.0,811.0,811.0
0.005,6,10,1547,5,764,1.0,496.0,496.0,5,783,1.0,515.0,515.0
0.004,6,10,1989,5,927,1.0,659.0,659.0,5,1062,1.0,794.0,794.0
0.011,6,10,1989,5,910,2.0,642.0,642.0,5,1079,2.0,811.0,811.0
0.004,6,13,3690,7,452,0.0,80.0,80.0,6,3238,0.0,1470.0,1459.0
0.696,6,22,5072,11,1250,58.0,325.0,133.0,11,3822,58.0,1414.0,563.0
0.017,6,13,3735,7,497,2.0,125.0,125.0,6,3238,3.0,1470.0,1459.0
0.005,6,10,1989,5,927,1.0,659.0,659.0,5,1062,1.0,794.0,794.0
0.087,6,10,1506,5,395,16.0,127.0,127.0,5,1111,18.0,843.0,843.0
0.006,6,10,1689,5,839,1.0,571.0,571.0,5,850,1.0,582.0,582.0
0.006,6,10,1689,5,839,1.0,571.0,571.0,5,850,1.0,582.0,582.0
0.005,6,10,2006,5,927,1.0,659.0,659.0,5,1079,1.0,811.0,811.0
0.008,17,2,179,1,71,0.0,43.0,43.0,1,108,0.0,80.0,80.0
0.013,6,10,1990,5,911,3.0,643.0,643.0,5,1079,3.0,811.0,811.0
0.004,17,2,148,1,60,0.0,32.0,32.0,1,88,0.0,60.0,60.0
0.005,6,14,3799,7,509,0.0,137.0,137.0,7,3290,0.0,1448.0,972.0
0.005,6,10,2006,5,927,1.0,659.0,659.0,5,1079,1.0,811.0,811.0
0.014,6,10,1972,5,910,3.0,642.0,642.0,5,1062,3.0,794.0,794.0
0.021,6,10,1990,5,911,5.0,643.0,643.0,5,1079,5.0,811.0,811.0
0.025,6,10,1762,5,911,6.0,643.0,643.0,5,851,6.0,583.0,583.0
15.254,17,48,28081,26,24770,608.0,1350.0,924.0,22,3311,725.0,1350.0,122.0
0.012,6,10,1989,5,910,2.0,642.0,642.0,5,1079,2.0,811.0,811.0
0.014,6,10,1972,5,910,3.0,642.0,642.0,5,1062,3.0,794.0,794.0
0.006,6,10,2006,5,927,1.0,659.0,659.0,5,1079,1.0,811.0,811.0
0.005,17,2,170,1,65,0.0,37.0,37.0,1,105,0.0,77.0,77.0
0.059,6,10,1506,5,395,13.0,127.0,127.0,5,1111,13.0,843.0,843.0
0.004,6,10,1989,5,927,1.0,659.0,659.0,5,1062,1.0,794.0,794.0
11.555,17,28,4397,14,2312,876.0,587.0,137.0,14,2085,876.0,268.0,120.0
0.011,6,10,1990,5,911,2.0,643.0,643.0,5,1079,2.0,811.0,811.0
0.02,6,10,1990,5,911,5.0,643.0,643.0,5,1079,4.0,811.0,811.0
0.004,17,2,164,1,74,0.0,46.0,46.0,1,90,0.0,62.0,62.0
0.005,6,10,1779,5,928,1.0,660.0,660.0,5,851,1.0,583.0,583.0
240.398,6,36,10521,18,2215,14139.0,559.0,254.0,18,8306,14139.0,1402.0,614.0
240.09,6,16,4481,9,963,30011.0,238.0,166.0,7,3518,40014.0,1402.0,786.0
0.005,6,10,1702,5,863,1.0,595.0,595.0,5,839,1.0,571.0,571.0
0.006,17,2,144,1,64,0.0,36.0,36.0,1,80,0.0,52.0,52.0
0.008,6,10,1677,5,827,2.0,559.0,559.0,5,850,2.0,582.0,582.0
0.005,6,10,2007,5,928,1.0,660.0,660.0,5,1079,1.0,811.0,811.0
0.006,17,2,170,1,65,0.0,37.0,37.0,1,105,0.0,77.0,77.0
0.012,6,10,1983,5,910,2.0,642.0,642.0,5,1073,3.0,805.0,805.0
0.039,17,4,420,2,122,0.0,33.0,33.0,2,298,34.0,145.0,121.0
11.192,17,28,4422,14,1994,848.0,269.0,114.0,14,2428,848.0,587.0,145.0
0.115,6,10,1506,5,395,25.0,127.0,127.0,5,1111,24.0,843.0,843.0
0.009,17,2,194,1,59,0.0,31.0,31.0,1,135,0.0,107.0,107.0
0.123,6,10,1506,5,395,24.0,127.0,127.0,5,1111,27.0,843.0,843.0
0.005,6,10,2006,5,927,1.0,659.0,659.0,5,1079,1.0,811.0,811.0
288.495,6,31,7260,16,2330,5.0,567.0,333.0,15,4930,20606.0,1330.0,479.0
240.116,6,31,9360,16,6910,16007.0,1982.0,675.0,15,2450,17150.0,580.0,207.0
0.005,6,10,2006,5,927,1.0,659.0,659.0,5,1079,1.0,811.0,811.0
0.009,6,10,1989,5,910,2.0,642.0,642.0,5,1079,2.0,811.0,811.0
40.063,17,10,676,5,460,10015.0,104.0,64.0,5,216,10014.0,20.0,15.0
1796.452,17,2671,204621,1331,107842,1350.0,84.0,53.0,1340,96779,1341.0,227.0,44.0
40.058,17,10,676,5,460,10013.0,104.0,64.0,5,216,10013.0,20.0,15.0
0.041,17,2,152,1,76,0.0,48.0,48.0,1,76,0.0,48.0,48.0
0.245,17,39,20145,21,17052,12.0,1350.0,784.0,18,3093,10.0,1350.0,143.0
0.008,6,10,1677,5,827,2.0,559.0,559.0,5,850,2.0,582.0,582.0
0.007,6,10,1547,5,764,1.0,496.0,496.0,5,783,1.0,515.0,515.0
308.651,17,20,1124,10,716,34279.0,48.0,43.0,10,408,34279.0,20.0,12.0
0.004,6,10,2006,5,927,1.0,659.0,659.0,5,1079,1.0,811.0,811.0
0.01,6,12,1926,6,1189,2.0,659.0,434.0,6,737,1.0,417.0,417.0
0.004,17,2,136,1,60,0.0,32.0,32.0,1,76,0.0,48.0,48.0
0.011,6,10,1989,5,910,2.0,642.0,642.0,5,1079,2.0,811.0,811.0
0.015,6,10,1972,5,910,3.0,642.0,642.0,5,1062,3.0,794.0,794.0
0.003,17,2,136,1,60,0.0,32.0,32.0,1,76,0.0,48.0,48.0
0.004,6,10,1779,5,928,1.0,660.0,660.0,5,851,1.0,583.0,583.0
0.005,17,2,140,1,62,0.0,34.0,34.0,1,78,0.0,50.0,50.0
0.112,6,10,1506,5,395,26.0,127.0,127.0,5,1111,25.0,843.0,843.0
0.001,17,2,136,1,60,0.0,32.0,32.0,1,76,0.0,48.0,48.0
40.079,17,10,676,5,460,10018.0,104.0,64.0,5,216,10017.0,20.0,15.0
0.005,6,10,1989,5,927,1.0,659.0,659.0,5,1062,1.0,794.0,794.0
0.088,6,10,1506,5,395,19.0,127.0,127.0,5,1111,18.0,843.0,843.0
0.01,6,10,1689,5,839,2.0,571.0,571.0,5,850,2.0,582.0,582.0
0.012,6,13,3735,7,497,2.0,125.0,125.0,6,3238,2.0,1470.0,1459.0
0.006,6,10,1547,5,764,1.0,496.0,496.0,5,783,1.0,515.0,515.0
0.011,6,10,1983,5,910,2.0,642.0,642.0,5,1073,2.0,805.0,805.0
0.009,6,10,1972,5,910,2.0,642.0,642.0,5,1062,2.0,794.0,794.0
0.013,6,10,1983,5,910,3.0,642.0,642.0,5,1073,3.0,805.0,805.0
0.037,17,2,148,1,60,0.0,32.0,32.0,1,88,0.0,60.0,60.0
0.006,6,10,2000,5,927,1.0,659.0,659.0,5,1073,1.0,805.0,805.0
0.001,17,2,136,1,60,0.0,32.0,32.0,1,76,0.0,48.0,48.0
0.005,17,2,144,1,64,0.0,36.0,36.0,1,80,0.0,52.0,52.0
1797.102,6,282,40349,114,27620,15902.0,2058.0,253.0,168,12729,10760.0,1062.0,78.0
0.095,6,10,1506,5,395,22.0,127.0,127.0,5,1111,19.0,843.0,843.0
0.005,6,10,1689,5,839,1.0,571.0,571.0,5,850,1.0,582.0,582.0
0.121,6,10,1506,5,395,28.0,127.0,127.0,5,1111,23.0,843.0,843.0
240.094,6,32,9260,16,6869,16006.0,1515.0,604.0,16,2391,16006.0,580.0,193.0
0.003,17,2,148,1,60,0.0,32.0,32.0,1,88,0.0,60.0,60.0
0.006,6,10,1643,5,860,1.0,592.0,592.0,5,783,1.0,515.0,515.0
0.005,6,10,1779,5,928,1.0,660.0,660.0,5,851,1.0,583.0,583.0
0.128,6,10,1506,5,395,23.0,127.0,127.0,5,1111,30.0,843.0,843.0
0.005,17,2,166,1,75,0.0,47.0,47.0,1,91,0.0,63.0,63.0
0.064,6,10,1506,5,395,14.0,127.0,127.0,5,1111,15.0,843.0,843.0
0.009,6,12,1926,6,1189,1.0,659.0,434.0,6,737,1.0,417.0,417.0
0.046,17,2,170,1,65,0.0,37.0,37.0,1,105,0.0,77.0,77.0
0.088,6,10,1506,5,395,20.0,127.0,127.0,5,1111,19.0,843.0,843.0
0.009,6,10,1990,5,911,2.0,643.0,643.0,5,1079,2.0,811.0,811.0
0.014,6,10,1983,5,910,3.0,642.0,642.0,5,1073,3.0,805.0,805.0
0.006,6,10,1547,5,764,1.0,496.0,496.0,5,783,1.0,515.0,515.0
0.005,6,10,2007,5,928,1.0,660.0,660.0,5,1079,1.0,811.0,811.0
40.064,17,10,676,5,460,10014.0,104.0,64.0,5,216,10015.0,20.0,15.0
1786.533,6,150,19350,90,13740,20073.0,302.0,302.0,60,5610,30280.0,83.0,83.0
0.108,6,10,1506,5,395,23.0,127.0,127.0,5,1111,22.0,843.0,843.0
0.019,6,10,1990,5,911,4.0,643.0,643.0,5,1079,4.0,811.0,811.0
0.005,6,13,3747,7,509,0.0,137.0,137.0,6,3238,1.0,1470.0,1459.0
0.121,6,10,1506,5,395,27.0,127.0,127.0,5,1111,26.0,843.0,843.0
0.01,6,10,1983,5,910,2.0,642.0,642.0,5,1073,2.0,805.0,805.0
63.512,6,51,24611,26,18584,369.0,2720.0,1592.0,25,6027,2639.0,2667.0,385.0
0.126,6,10,1506,5,395,30.0,127.0,127.0,5,1111,30.0,843.0,843.0
0.01,6,10,1677,5,827,2.0,559.0,559.0,5,850,2.0,582.0,582.0
0.004,6,10,1702,5,863,1.0,595.0,595.0,5,839,0.0,571.0,571.0
0.005,6,10,1989,5,927,1.0,659.0,659.0,5,1062,1.0,794.0,794.0
309.84,17,20,1124,10,716,34411.0,48.0,43.0,10,408,34411.0,20.0,12.0
0.005,17,2,166,1,75,0.0,47.0,47.0,1,91,0.0,63.0,63.0
40.061,17,10,676,5,460,10013.0,104.0,64.0,5,216,10014.0,20.0,15.0
15.072,17,15,9238,8,6902,2149.0,1350.0,834.0,7,2336,2507.0,1350.0,305.0
0.062,6,10,1506,5,395,12.0,127.0,127.0,5,1111,15.0,843.0,843.0
0.005,6,10,2007,5,928,1.0,660.0,660.0,5,1079,1.0,811.0,811.0
412.25,6,29,4409,12,3102,10911.0,494.0,494.0,17,1307,25765.0,83.0,83.0
0.011,6,10,1989,5,910,2.0,642.0,642.0,5,1079,2.0,811.0,811.0
0.009,6,10,1631,5,848,2.0,580.0,580.0,5,783,2.0,515.0,515.0
0.08,6,10,1506,5,395,16.0,127.0,127.0,5,1111,17.0,843.0,843.0
0.005,6,10,2006,5,927,1.0,659.0,659.0,5,1079,1.0,811.0,811.0
0.004,6,14,3742,7,452,0.0,80.0,80.0,7,3290,0.0,1448.0,972.0
0.057,17,2,179,1,71,0.0,43.0,43.0,1,108,0.0,80.0,80.0
0.005,17,2,214,1,75,0.0,47.0,47.0,1,139,0.0,111.0,111.0
11.135,17,28,4422,14,1994,844.0,269.0,114.0,14,2428,844.0,587.0,145.0
0.006,6,10,1547,5,764,1.0,496.0,496.0,5,783,1.0,515.0,515.0
40.058,17,10,676,5,460,10013.0,104.0,64.0,5,216,10013.0,20.0,15.0
0.006,6,10,2007,5,928,1.0,660.0,660.0,5,1079,1.0,811.0,811.0
0.004,17,2,136,1,60,0.0,32.0,32.0,1,76,0.0,48.0,48.0
0.005,6,10,2006,5,927,1.0,659.0,659.0,5,1079,1.0,811.0,811.0
0.005,6,10,2007,5,928,1.0,660.0,660.0,5,1079,1.0,811.0,811.0
0.008,6,10,1689,5,839,1.0,571.0,571.0,5,850,1.0,582.0,582.0
0.015,6,10,1983,5,910,3.0,642.0,642.0,5,1073,3.0,805.0,805.0
1770.456,6,84,4418,42,2210,43180.0,26.0,26.0,42,2208,43180.0,24.0,24.0
0.001,17,2,136,1,60,0.0,32.0,32.0,1,76,0.0,48.0,48.0
0.011,6,10,1990,5,911,2.0,643.0,643.0,5,1079,2.0,811.0,811.0
0.021,6,10,1989,5,910,5.0,642.0,642.0,5,1079,5.0,811.0,811.0
0.004,17,2,222,1,65,0.0,37.0,37.0,1,157,0.0,129.0,129.0
0.006,6,10,1547,5,764,1.0,496.0,496.0,5,783,1.0,515.0,515.0
0.08,6,10,1506,5,395,17.0,127.0,127.0,5,1111,16.0,843.0,843.0
0.017,6,10,1989,5,910,4.0,642.0,642.0,5,1079,4.0,811.0,811.0
0.09,6,10,1506,5,395,19.0,127.0,127.0,5,1111,21.0,843.0,843.0
0.009,6,10,1631,5,848,2.0,580.0,580.0,5,783,2.0,515.0,515.0
0.003,17,2,148,1,60,0.0,32.0,32.0,1,88,0.0,60.0,60.0
0.005,6,14,3736,7,446,0.0,74.0,74.0,7,3290,0.0,1448.0,972.0
0.003,17,4,284,2,120,0.0,32.0,32.0,2,164,0.0,60.0,54.0
0.005,6,10,2007,5,928,1.0,660.0,660.0,5,1079,1.0,811.0,811.0
240.09,6,16,4481,9,963,30011.0,238.0,166.0,7,3518,40014.0,1402.0,786.0
0.168,17,2,152,1,76,0.0,48.0,48.0,1,76,0.0,48.0,48.0
0.014,6,10,1972,5,910,3.0,642.0,642.0,5,1062,3.0,794.0,794.0
0.006,6,10,1774,5,923,1.0,655.0,655.0,5,851,1.0,583.0,583.0
0.102,6,10,1506,5,395,21.0,127.0,127.0,5,1111,23.0,843.0,843.0
0.015,6,10,1989,5,910,3.0,642.0,642.0,5,1079,3.0,811.0,811.0
0.07,6,10,1506,5,395,16.0,127.0,127.0,5,1111,16.0,843.0,843.0
0.13,6,10,1506,5,395,31.0,127.0,127.0,5,1111,17.0,843.0,843.0
40.059,17,10,676,5,460,10014.0,104.0,64.0,5,216,10013.0,20.0,15.0
0.003,17,2,136,1,60,0.0,32.0,32.0,1,76,0.0,48.0,48.0
0.005,17,2,179,1,71,0.0,43.0,43.0,1,108,0.0,80.0,80.0
0.079,6,10,1506,5,395,18.0,127.0,127.0,5,1111,17.0,843.0,843.0
0.008,6,10,1989,5,910,2.0,642.0,642.0,5,1079,2.0,811.0,811.0
0.012,6,10,1989,5,910,3.0,642.0,642.0,5,1079,2.0,811.0,811.0
40.054,17,10,676,5,460,10012.0,104.0,64.0,5,216,10012.0,20.0,15.0
0.072,17,2,170,1,65,0.0,37.0,37.0,1,105,0.0,77.0,77.0
0.005,6,10,1854,5,889,1.0,621.0,621.0,5,965,1.0,697.0,697.0
0.017,6,13,3735,7,497,2.0,125.0,125.0,6,3238,3.0,1470.0,1459.0
0.017,6,10,1983,5,910,4.0,642.0,642.0,5,1073,4.0,805.0,805.0
0.015,6,10,1677,5,827,3.0,559.0,559.0,5,850,3.0,582.0,582.0
1.9,6,23,7757,13,1537,158.0,517.0,287.0,10,6220,17.0,1402.0,813.0
0.012,6,12,1926,6,1189,2.0,659.0,434.0,6,737,2.0,417.0,417.0
0.003,6,10,1702,5,863,0.0,595.0,595.0,5,839,0.0,571.0,571.0
0.004,17,2,136,1,60,0.0,32.0,32.0,1,76,0.0,48.0,48.0
0.013,6,10,1989,5,910,3.0,642.0,642.0,5,1079,3.0,811.0,811.0
40.061,17,10,676,5,460,10014.0,104.0,64.0,5,216,10014.0,20.0,15.0
0.005,6,10,2006,5,927,1.0,659.0,659.0,5,1079,1.0,811.0,811.0
0.101,6,10,1506,5,395,23.0,127.0,127.0,5,1111,23.0,843.0,843.0
0.083,6,10,1506,5,395,20.0,127.0,127.0,5,1111,19.0,843.0,843.0
240.152,6,45,6674,22,3222,11435.0,588.0,230.0,23,3452,10915.0,580.0,224.0
240.09,6,16,4481,9,963,30011.0,238.0,166.0,7,3518,40014.0,1402.0,786.0
0.003,17,2,148,1,60,0.0,32.0,32.0,1,88,0.0,60.0,60.0
0.005,6,10,1689,5,839,1.0,571.0,571.0,5,850,1.0,582.0,582.0
0.006,6,10,1702,5,863,1.0,595.0,595.0,5,839,1.0,571.0,571.0
0.004,17,2,203,1,61,0.0,33.0,33.0,1,142,0.0,114.0,114.0
0.005,6,10,2006,5,927,1.0,659.0,659.0,5,1079,1.0,811.0,811.0
0.006,6,10,1854,5,889,1.0,621.0,621.0,5,965,1.0,697.0,697.0
0.083,6,10,1506,5,395,18.0,127.0,127.0,5,1111,16.0,843.0,843.0
0.085,6,10,1506,5,395,20.0,127.0,127.0,5,1111,17.0,843.0,843.0
0.005,6,10,2007,5,928,1.0,660.0,660.0,5,1079,1.0,811.0,811.0
0.04,17,2,136,1,60,0.0,32.0,32.0,1,76,0.0,48.0,48.0
0.006,6,10,1854,5,889,1.0,621.0,621.0,5,965,1.0,697.0,697.0
0.091,6,10,1506,5,395,21.0,127.0,127.0,5,1111,20.0,843.0,843.0
0.004,6,10,2006,5,927,1.0,659.0,659.0,5,1079,1.0,811.0,811.0
0.092,6,10,1506,5,395,21.0,127.0,127.0,5,1111,18.0,843.0,843.0
0.005,6,10,1989,5,927,1.0,659.0,659.0,5,1062,1.0,794.0,794.0
0.021,6,10,1989,5,910,5.0,642.0,642.0,5,1079,5.0,811.0,811.0
0.169,17,2,152,1,76,0.0,48.0,48.0,1,76,0.0,48.0,48.0
0.005,6,10,1989,5,927,1.0,659.0,659.0,5,1062,1.0,794.0,794.0
0.006,6,10,1547,5,764,1.0,496.0,496.0,5,783,1.0,515.0,515.0
0.119,6,10,1506,5,395,26.0,127.0,127.0,5,1111,24.0,843.0,843.0
0.076,6,10,1506,5,395,17.0,127.0,127.0,5,1111,17.0,843.0,843.0
0.011,6,10,1983,5,910,2.0,642.0,642.0,5,1073,2.0,805.0,805.0
0.005,6,10,2006,5,927,1.0,659.0,659.0,5,1079,1.0,811.0,811.0
0.01,6,10,1762,5,911,2.0,643.0,643.0,5,851,2.0,583.0,583.0
0.104,6,10,1506,5,395,19.0,127.0,127.0,5,1111,25.0,843.0,843.0
0.004,6,10,1989,5,927,1.0,659.0,659.0,5,1062,1.0,794.0,794.0
0.07,6,10,1506,5,395,16.0,127.0,127.0,5,1111,15.0,843.0,843.0
0.005,6,10,1643,5,860,1.0,592.0,592.0,5,783,1.0,515.0,515.0
0.001,17,2,166,1,75,0.0,47.0,47.0,1,91,0.0,63.0,63.0
0.038,17,2,152,1,76,0.0,48.0,48.0,1,76,0.0,48.0,48.0
0.009,6,10,1989,5,910,2.0,642.0,642.0,5,1079,2.0,811.0,811.0
0.085,6,10,1506,5,395,19.0,127.0,127.0,5,1111,18.0,843.0,843.0
11.11,17,28,4423,14,1994,842.0,269.0,114.0,14,2429,842.0,588.0,145.0
0.011,6,10,1990,5,911,2.0,643.0,643.0,5,1079,2.0,811.0,811.0
0.005,6,10,1989,5,927,1.0,659.0,659.0,5,1062,1.0,794.0,794.0
353.544,6,20,2210,6,1308,12011.0,494.0,494.0,14,902,27195.0,83.0,83.0
0.006,6,10,1689,5,839,1.0,571.0,571.0,5,850,1.0,582.0,582.0
0.005,17,2,179,1,71,0.0,43.0,43.0,1,108,0.0,80.0,80.0
0.005,6,10,2007,5,928,1.0,660.0,660.0,5,1079,1.0,811.0,811.0
0.005,6,10,1989,5,927,1.0,659.0,659.0,5,1062,1.0,794.0,794.0
40.064,17,10,676,5,460,10015.0,104.0,64.0,5,216,10015.0,20.0,15.0
301.007,6,47,17598,25,11691,12541.0,2720.0,1184.0,22,5907,420.0,2667.0,385.0
0.017,6,10,1989,5,910,4.0,642.0,642.0,5,1079,4.0,811.0,811.0
0.021,6,13,3735,7,497,3.0,125.0,125.0,6,3238,4.0,1470.0,1459.0
0.016,6,10,1972,5,910,3.0,642.0,642.0,5,1062,3.0,794.0,794.0
0.006,6,10,1689,5,839,1.0,571.0,571.0,5,850,1.0,582.0,582.0
0.005,17,2,164,1,74,0.0,46.0,46.0,1,90,0.0,62.0,62.0
0.009,6,10,1972,5,910,2.0,642.0,642.0,5,1062,2.0,794.0,794.0
0.006,6,10,1779,5,928,1.0,660.0,660.0,5,851,1.0,583.0,583.0
0.015,6,10,1990,5,911,3.0,643.0,643.0,5,1079,3.0,811.0,811.0
0.005,6,10,2000,5,927,1.0,659.0,659.0,5,1073,1.0,805.0,805.0
0.006,6,10,1547,5,764,1.0,496.0,496.0,5,783,1.0,515.0,515.0
0.009,17,2,230,1,68,0.0,40.0,40.0,1,162,0.0,134.0,134.0
40.056,17,10,676,5,460,10012.0,104.0,64.0,5,216,10013.0,20.0,15.0
0.012,6,10,1972,5,910,3.0,642.0,642.0,5,1062,3.0,794.0,794.0
0.022,6,10,1983,5,910,5.0,642.0,642.0,5,1073,5.0,805.0,805.0
0.005,6,10,2006,5,927,1.0,659.0,659.0,5,1079,1.0,811.0,811.0
0.004,6,10,1779,5,928,1.0,660.0,660.0,5,851,1.0,583.0,583.0
172.422,17,74,10447,37,2471,4789.0,44.0,38.0,37,7976,4789.0,261.0,187.0
0.386,17,47,25781,25,21226,16.0,1350.0,821.0,22,4555,16.0,1350.0,179.0
0.102,6,10,1506,5,395,24.0,127.0,127.0,5,1111,25.0,843.0,843.0
0.006,6,10,1643,5,860,1.0,592.0,592.0,5,783,1.0,515.0,515.0
0.001,17,2,164,1,74,0.0,46.0,46.0,1,90,0.0,62.0,62.0
0.012,6,10,1972,5,910,2.0,642.0,642.0,5,1062,3.0,794.0,794.0
40.063,17,10,676,5,460,10013.0,104.0,64.0,5,216,10015.0,20.0,15.0
0.234,17,4,596,2,122,230.0,33.0,33.0,2,474,110.0,323.0,209.0
40.07,17,10,676,5,460,10016.0,104.0,64.0,5,216,10016.0,20.0,15.0
0.015,6,10,1677,5,827,3.0,559.0,559.0,5,850,3.0,582.0,582.0
0.016,17,2,198,1,91,0.0,63.0,63.0,1,107,0.0,79.0,79.0
0.005,6,13,3690,7,452,0.0,80.0,80.0,6,3238,0.0,1470.0,1459.0
0.091,6,10,1506,5,395,21.0,127.0,127.0,5,1111,20.0,843.0,843.0
0.058,6,10,1506,5,395,13.0,127.0,127.0,5,1111,13.0,843.0,843.0
240.371,6,25,4158,12,1808,21848.0,539.0,235.0,13,2350,20027.0,1304.0,239.0
0.068,6,10,1506,5,395,14.0,127.0,127.0,5,1111,14.0,843.0,843.0
0.001,17,2,154,1,69,0.0,41.0,41.0,1,85,0.0,57.0,57.0
0.105,6,10,1506,5,395,25.0,127.0,127.0,5,1111,23.0,843.0,843.0
0.016,6,10,1990,5,911,4.0,643.0,643.0,5,1079,3.0,811.0,811.0
0.043,17,2,136,1,60,0.0,32.0,32.0,1,76,0.0,48.0,48.0
0.003,17,2,148,1,60,0.0,32.0,32.0,1,88,0.0,60.0,60.0
0.01,6,10,1989,5,910,2.0,642.0,642.0,5,1079,2.0,811.0,811.0
0.1,6,10,1506,5,395,16.0,127.0,127.0,5,1111,24.0,843.0,843.0
0.098,6,10,1506,5,395,20.0,127.0,127.0,5,1111,22.0,843.0,843.0
0.006,6,10,1854,5,889,1.0,621.0,621.0,5,965,1.0,697.0,697.0
0.031,6,10,1972,5,910,7.0,642.0,642.0,5,1062,7.0,794.0,794.0
0.222,6,16,2706,8,1432,31.0,533.0,336.0,8,1274,20.0,529.0,212.0
0.107,6,10,1506,5,395,25.0,127.0,127.0,5,1111,19.0,843.0,843.0
0.091,6,10,1506,5,395,20.0,127.0,127.0,5,1111,17.0,843.0,843.0
0.004,6,10,2000,5,927,1.0,659.0,659.0,5,1073,1.0,805.0,805.0
0.004,17,2,148,1,60,0.0,32.0,32.0,1,88,0.0,60.0,60.0
0.084,6,10,1506,5,395,18.0,127.0,127.0,5,1111,18.0,843.0,843.0
0.005,6,10,1989,5,927,1.0,659.0,659.0,5,1062,1.0,794.0,794.0
0.006,6,10,1989,5,927,1.0,659.0,659.0,5,1062,1.0,794.0,794.0
0.015,6,10,1990,5,911,3.0,643.0,643.0,5,1079,3.0,811.0,811.0
0.005,6,10,2006,5,927,1.0,659.0,659.0,5,1079,1.0,811.0,811.0
0.004,17,2,136,1,60,0.0,32.0,32.0,1,76,0.0,48.0,48.0
0.075,6,10,1506,5,395,14.0,127.0,127.0,5,1111,17.0,843.0,843.0
0.006,6,10,1547,5,764,1.0,496.0,496.0,5,783,1.0,515.0,515.0
0.005,6,10,1547,5,764,1.0,496.0,496.0,5,783,1.0,515.0,515.0
0.01,6,10,1990,5,911,2.0,643.0,643.0,5,1079,2.0,811.0,811.0
0.014,6,10,1989,5,910,3.0,642.0,642.0,5,1079,3.0,811.0,811.0
0.005,17,2,214,1,75,0.0,47.0,47.0,1,139,0.0,111.0,111.0
0.004,17,2,164,1,74,0.0,46.0,46.0,1,90,0.0,62.0,62.0
97.416,6,100,82356,55,53029,1804.0,2804.0,1791.0,45,29327,2210.0,2804.0,1284.0
0.004,6,10,1702,5,863,1.0,595.0,595.0,5,839,1.0,571.0,571.0
40.093,17,10,676,5,460,10021.0,104.0,64.0,5,216,10022.0,20.0,15.0
0.13,17,2,170,1,65,0.0,37.0,37.0,1,105,0.0,77.0,77.0
0.008,17,4,284,2,120,5.0,32.0,32.0,2,164,5.0,60.0,54.0
0.004,6,10,2007,5,928,1.0,660.0,660.0,5,1079,1.0,811.0,811.0
0.014,6,10,1989,5,910,3.0,642.0,642.0,5,1079,3.0,811.0,811.0
0.07,6,10,1506,5,395,15.0,127.0,127.0,5,1111,16.0,843.0,843.0
0.01,6,10,1989,5,927,2.0,659.0,659.0,5,1062,2.0,794.0,794.0
0.006,6,10,1547,5,764,1.0,496.0,496.0,5,783,1.0,515.0,515.0
0.102,6,10,1506,5,395,23.0,127.0,127.0,5,1111,23.0,843.0,843.0
0.009,6,10,1989,5,910,2.0,642.0,642.0,5,1079,2.0,811.0,811.0
0.006,6,10,1689,5,839,1.0,571.0,571.0,5,850,1.0,582.0,582.0
0.007,17,2,234,1,61,0.0,33.0,33.0,1,173,0.0,145.0,145.0
0.006,6,13,3747,7,509,1.0,137.0,137.0,6,3238,1.0,1470.0,1459.0
0.009,6,10,1989,5,910,2.0,642.0,642.0,5,1079,2.0,811.0,811.0
240.219,6,33,9572,17,7033,15013.0,1515.0,615.0,16,2539,16014.0,580.0,212.0
0.135,6,10,1506,5,395,32.0,127.0,127.0,5,1111,30.0,843.0,843.0
0.129,17,2,80,1,32,0.0,4.0,4.0,1,48,0.0,20.0,20.0
0.101,6,10,1506,5,395,21.0,127.0,127.0,5,1111,22.0,843.0,843.0
0.005,6,13,3747,7,509,0.0,137.0,137.0,6,3238,0.0,1470.0,1459.0
0.017,6,10,1983,5,910,4.0,642.0,642.0,5,1073,4.0,805.0,805.0
0.005,6,10,1643,5,860,1.0,592.0,592.0,5,783,1.0,515.0,515.0
0.011,6,10,1989,5,910,2.0,642.0,642.0,5,1079,2.0,811.0,811.0
40.043,17,10,676,5,460,10010.0,104.0,64.0,5,216,10008.0,20.0,15.0
0.09,6,10,1506,5,395,18.0,127.0,127.0,5,1111,20.0,843.0,843.0
0.149,6,10,1506,5,395,32.0,127.0,127.0,5,1111,33.0,843.0,843.0
0.014,6,10,1989,5,910,3.0,642.0,642.0,5,1079,3.0,811.0,811.0
0.128,17,2,144,1,64,0.0,36.0,36.0,1,80,0.0,52.0,52.0
0.075,6,10,1506,5,395,16.0,127.0,127.0,5,1111,15.0,843.0,843.0
0.001,17,2,154,1,69,0.0,41.0,41.0,1,85,0.0,57.0,57.0
0.008,17,2,162,1,65,0.0,37.0,37.0,1,97,0.0,69.0,69.0
0.001,17,2,180,1,66,0.0,38.0,38.0,1,114,0.0,86.0,86.0
0.01,6,10,1989,5,910,2.0,642.0,642.0,5,1079,2.0,811.0,811.0
0.072,6,10,1506,5,395,16.0,127.0,127.0,5,1111,14.0,843.0,843.0
0.003,17,2,148,1,60,0.0,32.0,32.0,1,88,0.0,60.0,60.0
0.005,6,10,2007,5,928,1.0,660.0,660.0,5,1079,1.0,811.0,811.0
0.013,6,10,1989,5,910,3.0,642.0,642.0,5,1079,3.0,811.0,811.0
0.06,6,10,1506,5,395,14.0,127.0,127.0,5,1111,11.0,843.0,843.0
1794.246,17,2852,218638,1421,115200,1263.0,84.0,53.0,1431,103438,1254.0,227.0,44.0
0.006,17,2,144,1,64,0.0,36.0,36.0,1,80,0.0,52.0,52.0
0.109,6,10,1506,5,395,26.0,127.0,127.0,5,1111,25.0,843.0,843.0
0.013,6,10,1990,5,911,3.0,643.0,643.0,5,1079,3.0,811.0,811.0
0.04,17,4,284,2,120,0.0,32.0,32.0,2,164,36.0,60.0,54.0
11.018,17,28,4421,14,1994,839.0,269.0,114.0,14,2427,838.0,586.0,145.0
40.056,17,10,676,5,460,10012.0,104.0,64.0,5,216,10013.0,20.0,15.0
0.019,6,10,1983,5,910,4.0,642.0,642.0,5,1073,4.0,805.0,805.0
0.004,17,2,148,1,60,0.0,32.0,32.0,1,88,0.0,60.0,60.0
240.1,6,32,9474,16,6994,16006.0,2067.0,685.0,16,2480,16006.0,580.0,205.0
0.12,6,10,1506,5,395,26.0,127.0,127.0,5,1111,24.0,843.0,843.0
0.004,6,10,1779,5,928,1.0,660.0,660.0,5,851,1.0,583.0,583.0
40.077,17,10,676,5,460,10017.0,104.0,64.0,5,216,10018.0,20.0,15.0
0.074,6,10,1506,5,395,17.0,127.0,127.0,5,1111,18.0,843.0,843.0
0.005,17,4,284,2,120,1.0,32.0,32.0,2,164,1.0,60.0,54.0
0.012,6,10,1972,5,910,3.0,642.0,642.0,5,1062,2.0,794.0,794.0
0.09,6,10,1506,5,395,21.0,127.0,127.0,5,1111,19.0,843.0,843.0
0.004,6,10,1989,5,927,1.0,659.0,659.0,5,1062,1.0,794.0,794.0
0.005,6,10,1779,5,928,1.0,660.0,660.0,5,851,1.0,583.0,583.0
0.045,6,10,1990,5,911,11.0,643.0,643.0,5,1079,11.0,811.0,811.0
0.07,17,8,3613,4,1874,23.0,1350.0,440.0,4,1739,12.0,1350.0,406.0
40.054,17,10,676,5,460,10012.0,104.0,64.0,5,216,10013.0,20.0,15.0
0.007,6,10,1989,5,910,1.0,642.0,642.0,5,1079,1.0,811.0,811.0
0.092,6,10,1506,5,395,21.0,127.0,127.0,5,1111,20.0,843.0,843.0
0.012,17,2,160,1,72,0.0,44.0,44.0,1,88,0.0,60.0,60.0
0.042,17,4,284,2,120,39.0,32.0,32.0,2,164,5.0,60.0,54.0
0.004,6,10,2006,5,927,1.0,659.0,659.0,5,1079,1.0,811.0,811.0
0.08,6,10,1506,5,395,18.0,127.0,127.0,5,1111,18.0,843.0,843.0
0.005,6,10,1643,5,860,1.0,592.0,592.0,5,783,1.0,515.0,515.0
0.006,6,10,1989,5,927,1.0,659.0,659.0,5,1062,1.0,794.0,794.0
0.016,17,2,198,1,91,0.0,63.0,63.0,1,107,0.0,79.0,79.0
1770.477,6,83,4368,42,2210,43181.0,26.0,26.0,41,2158,44260.0,26.0,26.0
240.088,6,16,4480,9,963,30011.0,238.0,166.0,7,3517,40014.0,1402.0,786.0
0.015,6,10,1631,5,848,3.0,580.0,580.0,5,783,3.0,515.0,515.0
0.004,6,10,2000,5,927,1.0,659.0,659.0,5,1073,1.0,805.0,805.0
0.076,6,10,1506,5,395,16.0,127.0,127.0,5,1111,17.0,843.0,843.0
0.001,17,2,180,1,66,0.0,38.0,38.0,1,114,0.0,86.0,86.0
0.151,6,10,1506,5,395,35.0,127.0,127.0,5,1111,34.0,843.0,843.0
0.006,6,10,1689,5,839,1.0,571.0,571.0,5,850,1.0,582.0,582.0
0.091,6,10,1506,5,395,21.0,127.0,127.0,5,1111,20.0,843.0,843.0
0.007,17,2,194,1,59,0.0,31.0,31.0,1,135,0.0,107.0,107.0
0.057,17,2,152,1,76,0.0,48.0,48.0,1,76,0.0,48.0,48.0
40.056,17,10,676,5,460,10013.0,104.0,64.0,5,216,10013.0,20.0,15.0
240.276,6,44,8825,22,5738,11441.0,1368.0,458.0,22,3087,11441.0,580.0,241.0
0.114,6,10,1506,5,395,26.0,127.0,127.0,5,1111,22.0,843.0,843.0
0.004,6,10,1779,5,928,1.0,660.0,660.0,5,851,1.0,583.0,583.0
0.004,6,10,2006,5,927,1.0,659.0,659.0,5,1079,1.0,811.0,811.0
40.056,17,10,676,5,460,10011.0,104.0,64.0,5,216,10013.0,20.0,15.0
0.098,6,10,1506,5,395,22.0,127.0,127.0,5,1111,22.0,843.0,843.0
0.021,6,10,1972,5,910,5.0,642.0,642.0,5,1062,5.0,794.0,794.0
0.005,6,10,1689,5,839,1.0,571.0,571.0,5,850,1.0,582.0,582.0
0.017,6,10,1990,5,911,4.0,643.0,643.0,5,1079,4.0,811.0,811.0
0.004,6,10,2000,5,927,1.0,659.0,659.0,5,1073,1.0,805.0,805.0
0.006,6,10,1854,5,889,1.0,621.0,621.0,5,965,1.0,697.0,697.0
0.004,6,10,1774,5,923,1.0,655.0,655.0,5,851,1.0,583.0,583.0
335.78,17,156,21476,78,5280,4360.0,44.0,39.0,78,16196,4360.0,261.0,179.0
0.011,6,13,3735,7,497,1.0,125.0,125.0,6,3238,2.0,1470.0,1459.0
0.009,6,10,1972,5,910,2.0,642.0,642.0,5,1062,2.0,794.0,794.0
0.005,17,2,170,1,65,0.0,37.0,37.0,1,105,0.0,77.0,77.0
0.013,6,10,1990,5,911,3.0,643.0,643.0,5,1079,3.0,811.0,811.0
0.007,6,10,1547,5,764,1.0,496.0,496.0,5,783,1.0,515.0,515.0
0.005,6,10,1854,5,889,1.0,621.0,621.0,5,965,1.0,697.0,697.0
40.052,17,10,676,5,460,10012.0,104.0,64.0,5,216,10012.0,20.0,15.0
308.436,17,20,1124,10,716,34256.0,48.0,43.0,10,408,34256.0,20.0,12.0
0.001,17,2,180,1,66,0.0,38.0,38.0,1,114,0.0,86.0,86.0
240.45,6,35,8926,18,2074,14143.0,695.0,226.0,17,6852,15027.0,1402.0,597.0
0.034,17,2,154,1,69,0.0,41.0,41.0,1,85,0.0,57.0,57.0
0.006,6,10,1689,5,839,1.0,571.0,571.0,5,850,1.0,582.0,582.0
0.004,6,10,1774,5,923,1.0,655.0,655.0,5,851,1.0,583.0,583.0
0.012,6,10,1972,5,910,2.0,642.0,642.0,5,1062,2.0,794.0,794.0
0.006,17,2,164,1,74,0.0,46.0,46.0,1,90,0.0,62.0,62.0
0.005,6,10,2007,5,928,1.0,660.0,660.0,5,1079,1.0,811.0,811.0
40.069,17,10,676,5,460,10012.0,104.0,64.0,5,216,10015.0,20.0,15.0
0.006,6,10,1854,5,889,1.0,621.0,621.0,5,965,1.0,697.0,697.0
300.391,6,16,2170,9,684,37527.0,146.0,146.0,7,1486,50036.0,419.0,398.0
0.004,6,10,2006,5,927,1.0,659.0,659.0,5,1079,1.0,811.0,811.0
0.005,6,10,2006,5,927,1.0,659.0,659.0,5,1079,1.0,811.0,811.0
289.378,6,394,347847,183,21076,1589.0,2736.0,888.0,211,326771,1377.0,2804.0,1603.0
0.002,17,2,180,1,66,0.0,38.0,38.0,1,114,0.0,86.0,86.0
413.66,6,29,4409,12,3102,10912.0,494.0,494.0,17,1307,25853.0,83.0,83.0
1790.821,6,251,25410,102,9433,17729.0,586.0,66.0,149,15977,12099.0,1360.0,131.0
0.005,6,10,2007,5,928,1.0,660.0,660.0,5,1079,1.0,811.0,811.0
0.009,6,10,1989,5,910,2.0,642.0,642.0,5,1079,2.0,811.0,811.0
0.007,6,10,1547,5,764,1.0,496.0,496.0,5,783,1.0,515.0,515.0
0.004,6,10,2007,5,928,1.0,660.0,660.0,5,1079,1.0,811.0,811.0
0.006,6,10,2007,5,928,1.0,660.0,660.0,5,1079,1.0,811.0,811.0
165.147,17,84,12192,42,2823,4027.0,44.0,39.0,42,9369,4027.0,260.0,195.0
0.094,6,10,1506,5,395,21.0,127.0,127.0,5,1111,22.0,843.0,843.0
0.017,6,10,1989,5,910,4.0,642.0,642.0,5,1079,4.0,811.0,811.0
0.013,6,10,1990,5,911,3.0,643.0,643.0,5,1079,3.0,811.0,811.0
0.005,6,10,1643,5,860,1.0,592.0,592.0,5,783,1.0,515.0,515.0
361.837,6,19,1689,15,978,25845.0,190.0,190.0,4,711,80015.0,495.0,495.0
15.176,17,21,12459,11,8965,1514.0,1350.0,787.0,10,3494,1683.0,1350.0,321.0
0.005,6,10,2000,5,927,1.0,659.0,659.0,5,1073,1.0,805.0,805.0
0.005,17,2,164,1,74,0.0,46.0,46.0,1,90,0.0,62.0,62.0
0.199,6,10,1506,5,395,48.0,127.0,127.0,5,1111,43.0,843.0,843.0
0.071,17,2,136,1,60,0.0,32.0,32.0,1,76,0.0,48.0,48.0
40.026,17,10,676,5,460,10005.0,104.0,64.0,5,216,10005.0,20.0,15.0
0.003,17,2,148,1,60,0.0,32.0,32.0,1,88,0.0,60.0,60.0
0.118,6,10,1506,5,395,22.0,127.0,127.0,5,1111,25.0,843.0,843.0
0.005,6,10,1989,5,927,1.0,659.0,659.0,5,1062,1.0,794.0,794.0
0.004,17,2,136,1,60,0.0,32.0,32.0,1,76,0.0,48.0,48.0
0.006,6,10,1854,5,889,1.0,621.0,621.0,5,965,1.0,697.0,697.0
0.079,6,10,1506,5,395,17.0,127.0,127.0,5,1111,17.0,843.0,843.0
0.013,6,13,3735,7,497,2.0,125.0,125.0,6,3238,2.0,1470.0,1459.0
0.012,17,2,194,1,59,0.0,31.0,31.0,1,135,0.0,107.0,107.0
40.07,17,10,676,5,460,10015.0,104.0,64.0,5,216,10016.0,20.0,15.0
0.005,6,10,2007,5,928,1.0,660.0,660.0,5,1079,1.0,811.0,811.0
0.087,6,10,1506,5,395,20.0,127.0,127.0,5,1111,17.0,843.0,843.0
0.004,6,10,2006,5,927,1.0,659.0,659.0,5,1079,1.0,811.0,811.0
0.126,6,10,1506,5,395,28.0,127.0,127.0,5,1111,28.0,843.0,843.0
175.175,17,86,12610,43,2903,4170.0,44.0,39.0,43,9707,4170.0,261.0,197.0
0.016,17,2,198,1,91,0.0,63.0,63.0,1,107,0.0,79.0,79.0
40.066,17,10,676,5,460,10013.0,104.0,64.0,5,216,10012.0,20.0,15.0
0.011,6,10,1989,5,910,2.0,642.0,642.0,5,1079,2.0,811.0,811.0
15.073,17,15,9238,8,6902,2149.0,1350.0,834.0,7,2336,2507.0,1350.0,305.0
0.005,6,10,1547,5,764,1.0,496.0,496.0,5,783,1.0,515.0,515.0
0.009,6,10,1989,5,910,2.0,642.0,642.0,5,1079,2.0,811.0,811.0
0.005,6,10,1779,5,928,1.0,660.0,660.0,5,851,1.0,583.0,583.0
173.291,17,76,10642,38,2529,4683.0,44.0,38.0,38,8113,4683.0,261.0,185.0
0.005,6,10,1989,5,927,1.0,659.0,659.0,5,1062,1.0,794.0,794.0
0.135,6,10,1506,5,395,33.0,127.0,127.0,5,1111,29.0,843.0,843.0
126.081,6,14,2938,8,2504,17978.0,1414.0,1086.0,6,434,25166.0,182.0,182.0
0.005,6,13,3690,7,452,0.0,80.0,80.0,6,3238,1.0,1470.0,1459.0
0.005,6,10,2007,5,928,1.0,660.0,660.0,5,1079,1.0,811.0,811.0
0.17,17,2,152,1,76,0.0,48.0,48.0,1,76,0.0,48.0,48.0
0.005,6,10,2006,5,927,1.0,659.0,659.0,5,1079,1.0,811.0,811.0
0.013,6,10,1983,5,910,3.0,642.0,642.0,5,1073,3.0,805.0,805.0
0.094,6,10,1506,5,395,23.0,127.0,127.0,5,1111,20.0,843.0,843.0
0.015,6,10,1677,5,827,3.0,559.0,559.0,5,850,3.0,582.0,582.0
0.015,6,10,1762,5,911,3.0,643.0,643.0,5,851,3.0,583.0,583.0
0.118,6,10,1506,5,395,21.0,127.0,127.0,5,1111,25.0,843.0,843.0
0.01,6,10,1990,5,911,2.0,643.0,643.0,5,1079,2.0,811.0,811.0
0.001,17,2,180,1,65,0.0,37.0,37.0,1,115,0.0,87.0,87.0
0.004,6,10,2006,5,927,1.0,659.0,659.0,5,1079,1.0,811.0,811.0
0.013,6,10,1990,5,911,3.0,643.0,643.0,5,1079,3.0,811.0,811.0
0.022,6,10,1990,5,911,5.0,643.0,643.0,5,1079,5.0,811.0,811.0
0.005,6,10,1643,5,860,1.0,592.0,592.0,5,783,1.0,515.0,515.0
0.303,17,43,25550,25,22547,12.0,1350.0,873.0,18,3003,12.0,1350.0,138.0
0.008,6,10,1547,5,764,2.0,496.0,496.0,5,783,1.0,515.0,515.0
0.019,6,10,1983,5,910,4.0,642.0,642.0,5,1073,4.0,805.0,805.0
0.006,17,2,164,1,74,0.0,46.0,46.0,1,90,0.0,62.0,62.0
0.005,17,2,148,1,60,0.0,32.0,32.0,1,88,0.0,60.0,60.0
0.074,6,10,1506,5,395,16.0,127.0,127.0,5,1111,16.0,843.0,843.0
71.171,6,22,7416,11,1284,106.0,509.0,270.0,11,6132,7100.0,1823.0,946.0
300.096,6,19,4661,11,1102,30009.0,238.0,130.0,8,3559,42870.0,1402.0,786.0
177.166,17,68,9564,34,2261,5368.0,44.0,38.0,34,7303,5368.0,239.0,186.0
0.02,6,10,1983,5,910,4.0,642.0,642.0,5,1073,4.0,805.0,805.0
0.004,17,4,284,2,120,0.0,32.0,32.0,2,164,0.0,60.0,54.0
40.067,17,10,676,5,460,10016.0,104.0,64.0,5,216,10015.0,20.0,15.0
0.01,6,10,1631,5,848,2.0,580.0,580.0,5,783,2.0,515.0,515.0
0.231,17,13,4057,6,2011,40.0,1350.0,307.0,7,2046,33.0,1350.0,264.0
0.004,17,2,148,1,60,0.0,32.0,32.0,1,88,0.0,60.0,60.0
0.103,6,10,1506,5,395,22.0,127.0,127.0,5,1111,25.0,843.0,843.0
10.933,17,28,4389,14,2312,832.0,587.0,137.0,14,2077,832.0,268.0,120.0
0.081,6,10,1506,5,395,18.0,127.0,127.0,5,1111,15.0,843.0,843.0
0.136,6,10,1506,5,395,33.0,127.0,127.0,5,1111,29.0,843.0,843.0
0.081,6,10,1506,5,395,16.0,127.0,127.0,5,1111,19.0,843.0,843.0
0.001,17,2,180,1,66,0.0,38.0,38.0,1,114,0.0,86.0,86.0
0.022,6,10,1762,5,911,5.0,643.0,643.0,5,851,5.0,583.0,583.0
1792.45,6,578,192287,293,164404,6138.0,2883.0,932.0,285,27883,6311.0,403.0,120.0
0.07,6,10,1506,5,395,16.0,127.0,127.0,5,1111,16.0,843.0,843.0
40.1,17,10,676,5,460,10022.0,104.0,64.0,5,216,10024.0,20.0,15.0
0.009,6,10,1990,5,911,2.0,643.0,643.0,5,1079,2.0,811.0,811.0
0.012,6,10,1989,5,910,3.0,642.0,642.0,5,1079,2.0,811.0,811.0
0.004,17,4,420,2,122,0.0,33.0,33.0,2,298,0.0,145.0,121.0
0.371,17,43,20617,23,17154,16.0,1350.0,717.0,20,3463,16.0,1350.0,145.0
0.039,17,2,412,1,61,0.0,33.0,33.0,1,351,0.0,323.0,323.0
240.011,6,9,787,5,488,60002.0,232.0,232.0,4,299,80002.0,83.0,83.0
0.004,6,10,1779,5,928,1.0,660.0,660.0,5,851,1.0,583.0,583.0
48.73,6,39,12422,19,6824,492.0,2720.0,1206.0,20,5598,2556.0,1360.0,398.0
0.03,6,10,1762,5,911,7.0,643.0,643.0,5,851,7.0,583.0,583.0
0.052,6,10,1983,5,910,12.0,642.0,642.0,5,1073,13.0,805.0,805.0
0.004,6,10,1779,5,928,1.0,660.0,660.0,5,851,1.0,583.0,583.0
0.005,6,13,3747,7,509,0.0,137.0,137.0,6,3238,1.0,1470.0,1459.0
0.049,6,10,1983,5,910,12.0,642.0,642.0,5,1073,12.0,805.0,805.0
0.01,6,10,1989,5,910,2.0,642.0,642.0,5,1079,2.0,811.0,811.0
10.814,17,28,4419,14,1995,823.0,270.0,114.0,14,2424,823.0,587.0,145.0
0.021,6,10,1631,5,848,5.0,580.0,580.0,5,783,5.0,515.0,515.0
0.015,6,10,1990,5,911,3.0,643.0,643.0,5,1079,3.0,811.0,811.0
0.012,17,2,152,1,76,0.0,48.0,48.0,1,76,0.0,48.0,48.0
0.015,6,10,1972,5,910,3.0,642.0,642.0,5,1062,3.0,794.0,794.0
0.004,6,10,1779,5,928,1.0,660.0,660.0,5,851,1.0,583.0,583.0
0.01,6,10,1989,5,910,2.0,642.0,642.0,5,1079,2.0,811.0,811.0
0.096,6,10,1506,5,395,20.0,127.0,127.0,5,1111,23.0,843.0,843.0
0.004,17,4,284,2,120,0.0,32.0,32.0,2,164,0.0,60.0,54.0
0.004,6,10,2006,5,927,1.0,659.0,659.0,5,1079,1.0,811.0,811.0
0.006,6,10,1547,5,764,1.0,496.0,496.0,5,783,1.0,515.0,515.0
0.005,6,10,2000,5,927,1.0,659.0,659.0,5,1073,1.0,805.0,805.0
0.001,17,2,179,1,62,0.0,34.0,34.0,1,117,0.0,89.0,89.0
0.013,6,10,1989,5,910,3.0,642.0,642.0,5,1079,3.0,811.0,811.0
0.128,6,10,1506,5,395,28.0,127.0,127.0,5,1111,28.0,843.0,843.0
0.006,6,10,1547,5,764,1.0,496.0,496.0,5,783,1.0,515.0,515.0
0.004,6,10,2000,5,927,1.0,659.0,659.0,5,1073,1.0,805.0,805.0
0.006,6,10,1547,5,764,1.0,496.0,496.0,5,783,1.0,515.0,515.0
0.005,6,10,2006,5,927,1.0,659.0,659.0,5,1079,1.0,811.0,811.0
0.005,6,10,1689,5,839,1.0,571.0,571.0,5,850,1.0,582.0,582.0
0.013,6,10,1990,5,911,3.0,643.0,643.0,5,1079,3.0,811.0,811.0
0.013,6,10,1990,5,911,3.0,643.0,643.0,5,1079,3.0,811.0,811.0
0.014,6,10,1990,5,911,3.0,643.0,643.0,5,1079,3.0,811.0,811.0
0.082,6,10,1506,5,395,19.0,127.0,127.0,5,1111,16.0,843.0,843.0
0.015,6,10,1972,5,910,3.0,642.0,642.0,5,1062,3.0,794.0,794.0
0.004,17,2,148,1,60,0.0,32.0,32.0,1,88,0.0,60.0,60.0
0.142,6,10,1506,5,395,34.0,127.0,127.0,5,1111,31.0,843.0,843.0
0.001,17,2,180,1,66,0.0,38.0,38.0,1,114,0.0,86.0,86.0
0.079,6,10,1506,5,395,17.0,127.0,127.0,5,1111,17.0,843.0,843.0
0.005,6,10,1989,5,927,1.0,659.0,659.0,5,1062,1.0,794.0,794.0
0.005,6,10,2000,5,927,1.0,659.0,659.0,5,1073,1.0,805.0,805.0
0.001,17,2,180,1,66,0.0,38.0,38.0,1,114,0.0,86.0,86.0
0.004,17,4,284,2,120,0.0,32.0,32.0,2,164,0.0,60.0,54.0
1759.959,6,557,190331,280,164096,6308.0,2883.0,958.0,277,26235,6376.0,580.0,115.0
0.496,17,58,35300,33,28645,15.0,1350.0,840.0,25,6655,17.0,1350.0,238.0
0.052,17,2,152,1,76,0.0,48.0,48.0,1,76,0.0,48.0,48.0
0.005,6,10,1774,5,923,1.0,655.0,655.0,5,851,1.0,583.0,583.0
0.004,6,10,2006,5,927,1.0,659.0,659.0,5,1079,1.0,811.0,811.0
0.076,6,10,1506,5,395,17.0,127.0,127.0,5,1111,16.0,843.0,843.0
0.016,6,10,1989,5,910,4.0,642.0,642.0,5,1079,4.0,811.0,811.0
0.008,6,10,1989,5,910,1.0,642.0,642.0,5,1079,2.0,811.0,811.0
0.005,6,10,2006,5,927,1.0,659.0,659.0,5,1079,1.0,811.0,811.0
240.326,6,30,11893,15,6013,17166.0,1368.0,870.0,15,5880,17165.0,1656.0,727.0
0.002,17,2,185,1,73,0.0,45.0,45.0,1,112,0.0,84.0,84.0
15.078,17,16,8758,8,6494,2150.0,1350.0,783.0,8,2264,2149.0,1350.0,255.0
40.064,17,10,676,5,460,10015.0,104.0,64.0,5,216,10015.0,20.0,15.0
0.005,17,2,180,1,66,0.0,38.0,38.0,1,114,0.0,86.0,86.0
0.013,6,10,1989,5,910,3.0,642.0,642.0,5,1079,3.0,811.0,811.0
0.005,6,10,1643,5,860,1.0,592.0,592.0,5,783,1.0,515.0,515.0
0.039,17,2,234,1,61,0.0,33.0,33.0,1,173,0.0,145.0,145.0
0.086,6,10,1506,5,395,20.0,127.0,127.0,5,1111,19.0,843.0,843.0
0.124,6,10,1506,5,395,29.0,127.0,127.0,5,1111,27.0,843.0,843.0
0.134,6,10,1506,5,395,19.0,127.0,127.0,5,1111,32.0,843.0,843.0
0.038,17,4,284,2,120,0.0,32.0,32.0,2,164,1.0,60.0,54.0
0.004,6,10,2000,5,927,1.0,659.0,659.0,5,1073,1.0,805.0,805.0
0.089,6,10,1506,5,395,20.0,127.0,127.0,5,1111,20.0,843.0,843.0
0.072,6,10,1506,5,395,16.0,127.0,127.0,5,1111,14.0,843.0,843.0
0.041,17,4,284,2,120,0.0,32.0,32.0,2,164,38.0,60.0,54.0
292.216,6,394,347523,202,22078,1453.0,2736.0,889.0,192,325445,1529.0,2804.0,1772.0
0.09,6,10,1506,5,395,19.0,127.0,127.0,5,1111,20.0,843.0,843.0
0.013,6,10,1983,5,910,3.0,642.0,642.0,5,1073,3.0,805.0,805.0
0.001,17,2,180,1,66,0.0,38.0,38.0,1,114,0.0,86.0,86.0
0.132,17,2,412,1,61,0.0,33.0,33.0,1,351,0.0,323.0,323.0
0.113,6,10,1506,5,395,25.0,127.0,127.0,5,1111,26.0,843.0,843.0
0.005,6,10,2006,5,927,1.0,659.0,659.0,5,1079,1.0,811.0,811.0
0.004,6,10,2007,5,928,1.0,660.0,660.0,5,1079,1.0,811.0,811.0
0.006,6,10,1689,5,839,1.0,571.0,571.0,5,850,1.0,582.0,582.0
1798.3,17,2618,200572,1301,105453,1383.0,75.0,53.0,1317,95119,1366.0,227.0,44.0
0.001,17,2,166,1,75,0.0,47.0,47.0,1,91,0.0,63.0,63.0
0.177,6,10,1506,5,395,38.0,127.0,127.0,5,1111,37.0,843.0,843.0
40.053,17,10,676,5,460,10012.0,104.0,64.0,5,216,10012.0,20.0,15.0
0.004,17,4,284,2,120,0.0,32.0,32.0,2,164,1.0,60.0,54.0
0.005,6,10,1989,5,927,1.0,659.0,659.0,5,1062,1.0,794.0,794.0
0.047,6,14,3868,7,578,7.0,206.0,206.0,7,3290,7.0,1448.0,972.0
0.062,6,10,1506,5,395,13.0,127.0,127.0,5,1111,14.0,843.0,843.0
240.012,6,9,787,5,488,60003.0,232.0,232.0,4,299,80003.0,83.0,83.0
0.004,17,2,169,1,62,0.0,34.0,34.0,1,107,0.0,79.0,79.0
0.037,17,2,182,1,65,0.0,37.0,37.0,1,117,0.0,89.0,89.0
0.088,6,10,1506,5,395,19.0,127.0,127.0,5,1111,18.0,843.0,843.0
0.014,6,10,1989,5,910,3.0,642.0,642.0,5,1079,3.0,811.0,811.0
0.013,6,10,1972,5,910,3.0,642.0,642.0,5,1062,3.0,794.0,794.0
40.076,17,10,676,5,460,10017.0,104.0,64.0,5,216,10018.0,20.0,15.0
0.01,6,10,1972,5,910,2.0,642.0,642.0,5,1062,2.0,794.0,794.0
0.017,6,10,1983,5,910,4.0,642.0,642.0,5,1073,4.0,805.0,805.0
0.005,6,10,2006,5,927,1.0,659.0,659.0,5,1079,1.0,811.0,811.0
0.127,17,4,284,2,120,0.0,32.0,32.0,2,164,123.0,60.0,54.0
0.003,17,2,136,1,60,0.0,32.0,32.0,1,76,0.0,48.0,48.0
0.066,17,2,156,1,64,0.0,36.0,36.0,1,92,0.0,64.0,64.0
0.006,6,10,1547,5,764,1.0,496.0,496.0,5,783,1.0,515.0,515.0
240.373,6,33,8636,17,1836,15023.0,569.0,188.0,16,6800,16024.0,1402.0,597.0
0.004,17,4,284,2,120,0.0,32.0,32.0,2,164,0.0,60.0,54.0
40.061,17,10,676,5,460,10014.0,104.0,64.0,5,216,10014.0,20.0,15.0
0.117,6,10,1506,5,395,27.0,127.0,127.0,5,1111,25.0,843.0,843.0
0.006,6,10,1854,5,889,1.0,621.0,621.0,5,965,1.0,697.0,697.0
0.006,6,10,1689,5,839,1.0,571.0,571.0,5,850,1.0,582.0,582.0
0.004,17,4,284,2,120,0.0,32.0,32.0,2,164,0.0,60.0,54.0
0.01,17,2,152,1,76,0.0,48.0,48.0,1,76,0.0,48.0,48.0
0.004,6,10,1774,5,923,1.0,655.0,655.0,5,851,1.0,583.0,583.0
0.005,6,10,1989,5,927,1.0,659.0,659.0,5,1062,1.0,794.0,794.0
0.006,17,2,170,1,65,0.0,37.0,37.0,1,105,0.0,77.0,77.0
0.082,6,10,1506,5,395,17.0,127.0,127.0,5,1111,17.0,843.0,843.0
0.004,6,10,2006,5,927,1.0,659.0,659.0,5,1079,1.0,811.0,811.0
0.005,17,2,214,1,75,0.0,47.0,47.0,1,139,0.0,111.0,111.0
0.006,6,10,1547,5,764,1.0,496.0,496.0,5,783,1.0,515.0,515.0
0.005,6,10,2000,5,927,1.0,659.0,659.0,5,1073,1.0,805.0,805.0
0.005,6,10,2006,5,927,1.0,659.0,659.0,5,1079,1.0,811.0,811.0
10.899,17,28,4422,14,1994,829.0,269.0,114.0,14,2428,829.0,587.0,145.0
0.005,6,10,1689,5,839,1.0,571.0,571.0,5,850,1.0,582.0,582.0
0.018,6,10,1990,5,911,4.0,643.0,643.0,5,1079,4.0,811.0,811.0
0.012,6,10,1990,5,911,2.0,643.0,643.0,5,1079,3.0,811.0,811.0
0.005,6,10,1989,5,927,1.0,659.0,659.0,5,1062,1.0,794.0,794.0
1799.492,17,2880,220858,1432,116058,1257.0,84.0,53.0,1448,104800,1243.0,240.0,44.0
0.006,6,10,1854,5,889,1.0,621.0,621.0,5,965,1.0,697.0,697.0
0.088,6,10,1506,5,395,19.0,127.0,127.0,5,1111,20.0,843.0,843.0
0.005,6,10,2006,5,927,1.0,659.0,659.0,5,1079,1.0,811.0,811.0
0.041,17,2,412,1,61,0.0,33.0,33.0,1,351,0.0,323.0,323.0
0.068,17,8,3613,4,1874,22.0,1350.0,440.0,4,1739,11.0,1350.0,406.0
0.01,6,10,1972,5,910,2.0,642.0,642.0,5,1062,2.0,794.0,794.0
0.005,6,10,1702,5,863,1.0,595.0,595.0,5,839,1.0,571.0,571.0
0.026,6,13,3735,7,497,4.0,125.0,125.0,6,3238,5.0,1470.0,1459.0
0.012,6,10,1990,5,911,3.0,643.0,643.0,5,1079,2.0,811.0,811.0
0.083,6,10,1506,5,395,19.0,127.0,127.0,5,1111,17.0,843.0,843.0
0.005,6,10,2007,5,928,1.0,660.0,660.0,5,1079,1.0,811.0,811.0
0.004,17,4,284,2,120,1.0,32.0,32.0,2,164,0.0,60.0,54.0
354.067,6,21,1795,16,1030,23604.0,190.0,190.0,5,765,60002.0,464.0,248.0
0.005,6,10,2007,5,928,1.0,660.0,660.0,5,1079,1.0,811.0,811.0
0.011,6,10,1990,5,911,2.0,643.0,643.0,5,1079,2.0,811.0,811.0
0.041,17,2,170,1,65,0.0,37.0,37.0,1,105,0.0,77.0,77.0
0.132,6,10,1506,5,395,30.0,127.0,127.0,5,1111,30.0,843.0,843.0
0.006,17,2,164,1,74,0.0,46.0,46.0,1,90,0.0,62.0,62.0
0.037,17,2,144,1,64,0.0,36.0,36.0,1,80,0.0,52.0,52.0
0.081,6,10,1506,5,395,15.0,127.0,127.0,5,1111,16.0,843.0,843.0
0.005,17,2,169,1,62,0.0,34.0,34.0,1,107,0.0,79.0,79.0
0.044,17,4,596,2,122,0.0,33.0,33.0,2,474,7.0,323.0,209.0
0.001,17,2,179,1,62,0.0,34.0,34.0,1,117,0.0,89.0,89.0
351.99,6,20,2210,6,1308,12003.0,494.0,494.0,14,902,27075.0,83.0,83.0
0.014,6,10,1990,5,911,3.0,643.0,643.0,5,1079,3.0,811.0,811.0
0.006,6,10,1547,5,764,1.0,496.0,496.0,5,783,1.0,515.0,515.0
0.01,6,13,3735,7,497,1.0,125.0,125.0,6,3238,2.0,1470.0,1459.0
0.01,6,10,1989,5,910,2.0,642.0,642.0,5,1079,2.0,811.0,811.0
0.006,6,10,1689,5,839,1.0,571.0,571.0,5,850,1.0,582.0,582.0
0.005,6,10,2006,5,927,1.0,659.0,659.0,5,1079,1.0,811.0,811.0
0.063,6,10,1506,5,395,14.0,127.0,127.0,5,1111,14.0,843.0,843.0
40.066,17,10,676,5,460,10014.0,104.0,64.0,5,216,10015.0,20.0,15.0
0.006,17,2,179,1,71,0.0,43.0,43.0,1,108,0.0,80.0,80.0
0.085,6,10,1506,5,395,20.0,127.0,127.0,5,1111,17.0,843.0,843.0
0.07,6,10,1506,5,395,15.0,127.0,127.0,5,1111,13.0,843.0,843.0
0.076,6,10,1506,5,395,17.0,127.0,127.0,5,1111,16.0,843.0,843.0
40.062,17,10,676,5,460,10013.0,104.0,64.0,5,216,10014.0,20.0,15.0
0.027,6,10,1989,5,910,6.0,642.0,642.0,5,1079,6.0,811.0,811.0
0.011,6,10,1983,5,910,2.0,642.0,642.0,5,1073,2.0,805.0,805.0
0.005,17,2,140,1,62,0.0,34.0,34.0,1,78,0.0,50.0,50.0
0.005,6,10,2006,5,927,1.0,659.0,659.0,5,1079,1.0,811.0,811.0
0.008,6,10,1762,5,911,1.0,643.0,643.0,5,851,1.0,583.0,583.0
0.076,6,10,1506,5,395,17.0,127.0,127.0,5,1111,18.0,843.0,843.0
0.005,17,2,187,1,71,0.0,43.0,43.0,1,116,0.0,88.0,88.0
0.013,6,10,1983,5,910,3.0,642.0,642.0,5,1073,3.0,805.0,805.0
0.001,17,2,180,1,66,0.0,38.0,38.0,1,114,0.0,86.0,86.0
0.005,6,10,2006,5,927,1.0,659.0,659.0,5,1079,1.0,811.0,811.0
0.007,6,10,1989,5,910,1.0,642.0,642.0,5,1079,1.0,811.0,811.0
0.005,17,2,152,1,68,0.0,40.0,40.0,1,84,0.0,56.0,56.0
0.006,6,10,1643,5,860,1.0,592.0,592.0,5,783,1.0,515.0,515.0
0.004,17,2,136,1,60,0.0,32.0,32.0,1,76,0.0,48.0,48.0
0.005,6,10,1989,5,927,1.0,659.0,659.0,5,1062,1.0,794.0,794.0
0.007,6,10,1547,5,764,1.0,496.0,496.0,5,783,1.0,515.0,515.0
0.138,6,10,1506,5,395,31.0,127.0,127.0,5,1111,30.0,843.0,843.0
0.013,6,10,1990,5,911,3.0,643.0,643.0,5,1079,3.0,811.0,811.0
0.007,6,10,1972,5,910,1.0,642.0,642.0,5,1062,1.0,794.0,794.0
0.005,6,10,1989,5,927,1.0,659.0,659.0,5,1062,1.0,794.0,794.0
0.167,17,2,152,1,76,0.0,48.0,48.0,1,76,0.0,48.0,48.0
0.007,6,10,1989,5,910,1.0,642.0,642.0,5,1079,1.0,811.0,811.0
0.001,17,2,179,1,62,0.0,34.0,34.0,1,117,0.0,89.0,89.0
0.005,6,10,2006,5,927,1.0,659.0,659.0,5,1079,1.0,811.0,811.0
0.004,6,10,1774,5,923,1.0,655.0,655.0,5,851,1.0,583.0,583.0
0.11,6,10,1506,5,395,26.0,127.0,127.0,5,1111,25.0,843.0,843.0
0.005,6,10,2007,5,928,1.0,660.0,660.0,5,1079,1.0,811.0,811.0
0.069,17,8,3613,4,1874,23.0,1350.0,440.0,4,1739,11.0,1350.0,406.0
1770.513,6,86,4599,43,2290,42154.0,27.0,27.0,43,2309,42154.0,26.0,24.0
0.192,6,43,11559,23,3230,8.0,1082.0,203.0,20,8329,9.0,1402.0,606.0
0.085,6,10,1506,5,395,20.0,127.0,127.0,5,1111,15.0,843.0,843.0
0.019,6,10,1762,5,911,4.0,643.0,643.0,5,851,4.0,583.0,583.0
250.264,6,32,9853,17,2710,15639.0,676.0,363.0,15,7143,17873.0,1402.0,707.0
0.005,6,10,2006,5,927,1.0,659.0,659.0,5,1079,1.0,811.0,811.0
0.005,6,10,1547,5,764,1.0,496.0,496.0,5,783,1.0,515.0,515.0
0.012,6,10,1972,5,910,3.0,642.0,642.0,5,1062,2.0,794.0,794.0
0.012,6,10,1972,5,910,2.0,642.0,642.0,5,1062,2.0,794.0,794.0
0.004,6,10,2007,5,928,1.0,660.0,660.0,5,1079,1.0,811.0,811.0
0.006,6,10,1854,5,889,1.0,621.0,621.0,5,965,1.0,697.0,697.0
0.009,6,10,1990,5,911,2.0,643.0,643.0,5,1079,2.0,811.0,811.0
0.005,6,10,1774,5,923,1.0,655.0,655.0,5,851,1.0,583.0,583.0
0.01,6,10,1989,5,910,2.0,642.0,642.0,5,1079,2.0,811.0,811.0
0.168,17,2,152,1,76,0.0,48.0,48.0,1,76,0.0,48.0,48.0
0.07,17,8,3613,4,1874,23.0,1350.0,440.0,4,1739,12.0,1350.0,406.0
0.011,6,10,1983,5,910,2.0,642.0,642.0,5,1073,2.0,805.0,805.0
0.008,17,2,194,1,59,0.0,31.0,31.0,1,135,0.0,107.0,107.0
0.063,6,10,1506,5,395,14.0,127.0,127.0,5,1111,12.0,843.0,843.0
0.009,6,10,1972,5,910,2.0,642.0,642.0,5,1062,2.0,794.0,794.0
0.062,6,10,1506,5,395,13.0,127.0,127.0,5,1111,13.0,843.0,843.0
0.009,6,10,1989,5,910,2.0,642.0,642.0,5,1079,2.0,811.0,811.0
0.07,6,10,1506,5,395,15.0,127.0,127.0,5,1111,15.0,843.0,843.0
0.1,6,10,1506,5,395,20.0,127.0,127.0,5,1111,24.0,843.0,843.0
0.009,6,10,1989,5,910,2.0,642.0,642.0,5,1079,2.0,811.0,811.0
0.017,6,13,3735,7,497,2.0,125.0,125.0,6,3238,3.0,1470.0,1459.0
0.004,6,10,1774,5,923,1.0,655.0,655.0,5,851,1.0,583.0,583.0
0.001,17,2,194,1,57,0.0,29.0,29.0,1,137,0.0,109.0,109.0
0.012,6,10,1983,5,910,3.0,642.0,642.0,5,1073,3.0,805.0,805.0
0.005,6,10,1989,5,927,1.0,659.0,659.0,5,1062,1.0,794.0,794.0
0.12,6,10,1506,5,395,27.0,127.0,127.0,5,1111,26.0,843.0,843.0
0.005,6,10,1774,5,923,1.0,655.0,655.0,5,851,1.0,583.0,583.0
0.136,6,10,1506,5,395,32.0,127.0,127.0,5,1111,30.0,843.0,843.0
0.014,6,10,1972,5,910,3.0,642.0,642.0,5,1062,3.0,794.0,794.0
0.005,6,10,1854,5,889,1.0,621.0,621.0,5,965,1.0,697.0,697.0
280.434,6,22,6035,9,1146,35053.0,267.0,156.0,13,4889,23369.0,1400.0,873.0
0.005,6,10,1779,5,928,1.0,660.0,660.0,5,851,1.0,583.0,583.0
0.221,17,14,8577,7,4012,36.0,1350.0,545.0,7,4565,27.0,1350.0,624.0
0.098,6,10,1506,5,395,17.0,127.0,127.0,5,1111,18.0,843.0,843.0
0.006,6,10,2007,5,928,1.0,660.0,660.0,5,1079,1.0,811.0,811.0
0.019,6,10,1762,5,911,4.0,643.0,643.0,5,851,4.0,583.0,583.0
0.008,6,10,1990,5,911,2.0,643.0,643.0,5,1079,2.0,811.0,811.0
0.005,17,2,148,1,60,0.0,32.0,32.0,1,88,0.0,60.0,60.0
0.015,6,10,1989,5,910,3.0,642.0,642.0,5,1079,3.0,811.0,811.0
300.295,6,16,2170,9,684,37516.0,146.0,146.0,7,1486,50022.0,419.0,398.0
0.472,17,48,21123,26,17329,18.0,1350.0,638.0,22,3794,18.0,1350.0,144.0
0.039,17,4,284,2,120,0.0,32.0,32.0,2,164,36.0,60.0,54.0
0.005,6,10,2006,5,927,1.0,659.0,659.0,5,1079,1.0,811.0,811.0
0.006,6,10,1689,5,839,1.0,571.0,571.0,5,850,1.0,582.0,582.0
0.001,17,2,179,1,62,0.0,34.0,34.0,1,117,0.0,89.0,89.0
0.015,6,10,1983,5,910,3.0,642.0,642.0,5,1073,3.0,805.0,805.0
175.324,17,88,12116,44,2941,4077.0,44.0,38.0,44,9175,4077.0,239.0,180.0
0.009,6,10,1689,5,839,2.0,571.0,571.0,5,850,2.0,582.0,582.0
0.102,6,10,1506,5,395,24.0,127.0,127.0,5,1111,24.0,843.0,843.0
389.06,58,8,576,6,432,77812.0,24.0,24.0,2,144,362275.0,24.0,24.0
40.061,17,10,676,5,460,10012.0,104.0,64.0,5,216,10014.0,20.0,15.0
0.04,17,2,182,1,65,0.0,37.0,37.0,1,117,0.0,89.0,89.0
0.01,6,10,1990,5,911,2.0,643.0,643.0,5,1079,2.0,811.0,811.0
0.116,6,10,1506,5,395,26.0,127.0,127.0,5,1111,27.0,843.0,843.0
0.095,6,10,1506,5,395,22.0,127.0,127.0,5,1111,21.0,843.0,843.0
0.174,17,2,152,1,76,0.0,48.0,48.0,1,76,0.0,48.0,48.0
0.012,6,10,1972,5,910,2.0,642.0,642.0,5,1062,2.0,794.0,794.0
9.037,17,6,376,5,280,2259.0,28.0,28.0,1,96,0.0,68.0,68.0
0.001,17,2,180,1,66,0.0,38.0,38.0,1,114,0.0,86.0,86.0
0.018,6,10,1677,5,827,4.0,559.0,559.0,5,850,4.0,582.0,582.0
0.015,6,10,1989,5,910,3.0,642.0,642.0,5,1079,3.0,811.0,811.0
0.037,17,2,170,1,65,0.0,37.0,37.0,1,105,0.0,77.0,77.0
0.004,6,10,2006,5,927,1.0,659.0,659.0,5,1079,1.0,811.0,811.0
0.012,6,10,1983,5,910,3.0,642.0,642.0,5,1073,3.0,805.0,805.0
0.005,6,10,1779,5,928,1.0,660.0,660.0,5,851,1.0,583.0,583.0
40.053,17,10,676,5,460,10012.0,104.0,64.0,5,216,10012.0,20.0,15.0
0.001,17,2,180,1,66,0.0,38.0,38.0,1,114,0.0,86.0,86.0
0.095,6,10,1506,5,395,20.0,127.0,127.0,5,1111,21.0,843.0,843.0
0.005,6,10,1643,5,860,1.0,592.0,592.0,5,783,1.0,515.0,515.0
0.005,6,10,1774,5,923,1.0,655.0,655.0,5,851,1.0,583.0,583.0
0.005,6,10,2006,5,927,1.0,659.0,659.0,5,1079,1.0,811.0,811.0
0.021,6,10,1990,5,911,5.0,643.0,643.0,5,1079,5.0,811.0,811.0
40.065,17,10,676,5,460,10012.0,104.0,64.0,5,216,10015.0,20.0,15.0
0.119,6,10,1506,5,395,28.0,127.0,127.0,5,1111,24.0,843.0,843.0
0.008,6,10,1989,5,910,2.0,642.0,642.0,5,1079,1.0,811.0,811.0
261.718,6,24,7991,9,2024,32714.0,1496.0,780.0,15,5967,18692.0,2803.0,517.0
0.012,6,10,1631,5,848,3.0,580.0,580.0,5,783,3.0,515.0,515.0
0.004,6,10,2006,5,927,1.0,659.0,659.0,5,1079,1.0,811.0,811.0
15.482,17,59,38862,34,32670,468.0,1350.0,932.0,25,6192,643.0,1350.0,219.0
0.013,6,10,1989,5,910,3.0,642.0,642.0,5,1079,3.0,811.0,811.0
0.005,6,14,3742,8,504,0.0,80.0,80.0,6,3238,0.0,1470.0,1459.0
0.111,6,10,1506,5,395,22.0,127.0,127.0,5,1111,24.0,843.0,843.0
0.043,17,2,148,1,60,0.0,32.0,32.0,1,88,0.0,60.0,60.0
240.87,6,43,8771,22,5738,11469.0,1368.0,458.0,21,3033,12043.0,580.0,241.0
0.168,6,3,453,2,321,168.0,241.0,241.0,1,132,0.0,92.0,92.0
0.007,6,10,2006,5,927,1.0,659.0,659.0,5,1079,1.0,811.0,811.0
0.039,17,2,412,1,61,0.0,33.0,33.0,1,351,0.0,323.0,323.0
0.005,6,10,2006,5,927,1.0,659.0,659.0,5,1079,1.0,811.0,811.0
0.133,6,10,1506,5,395,30.0,127.0,127.0,5,1111,31.0,843.0,843.0
177.061,17,84,11744,42,2791,4318.0,44.0,38.0,42,8953,4318.0,279.0,185.0
0.014,6,10,1990,5,911,3.0,643.0,643.0,5,1079,3.0,811.0,811.0
0.054,17,2,152,1,76,0.0,48.0,48.0,1,76,0.0,48.0,48.0
0.038,17,2,152,1,76,0.0,48.0,48.0,1,76,0.0,48.0,48.0
0.005,6,10,1989,5,927,1.0,659.0,659.0,5,1062,1.0,794.0,794.0
0.026,6,10,1983,5,910,6.0,642.0,642.0,5,1073,6.0,805.0,805.0
0.34,17,41,21581,23,18469,15.0,1350.0,775.0,18,3112,16.0,1350.0,144.0
0.005,6,14,3736,7,446,0.0,74.0,74.0,7,3290,0.0,1448.0,972.0
0.009,6,10,1972,5,910,2.0,642.0,642.0,5,1062,2.0,794.0,794.0
0.006,6,10,1547,5,764,1.0,496.0,496.0,5,783,1.0,515.0,515.0
0.005,6,10,1779,5,928,1.0,660.0,660.0,5,851,1.0,583.0,583.0
0.004,6,10,2006,5,927,1.0,659.0,659.0,5,1079,1.0,811.0,811.0
0.108,6,10,1506,5,395,26.0,127.0,127.0,5,1111,18.0,843.0,843.0
0.005,6,10,1689,5,839,1.0,571.0,571.0,5,850,1.0,582.0,582.0
0.006,6,10,1547,5,764,1.0,496.0,496.0,5,783,1.0,515.0,515.0
0.123,6,10,1506,5,395,27.0,127.0,127.0,5,1111,26.0,843.0,843.0
0.174,6,10,1506,5,395,38.0,127.0,127.0,5,1111,37.0,843.0,843.0
0.097,6,10,1506,5,395,22.0,127.0,127.0,5,1111,18.0,843.0,843.0
10.748,17,28,4422,14,1993,818.0,268.0,114.0,14,2429,818.0,588.0,145.0
0.003,17,2,136,1,60,0.0,32.0,32.0,1,76,0.0,48.0,48.0
0.012,6,10,1972,5,910,2.0,642.0,642.0,5,1062,2.0,794.0,794.0
180.486,6,57,19038,31,4683,6016.0,1054.0,236.0,26,14355,7219.0,2804.0,867.0
0.024,6,10,1983,5,910,6.0,642.0,642.0,5,1073,5.0,805.0,805.0
0.013,6,10,1631,5,848,3.0,580.0,580.0,5,783,3.0,515.0,515.0
0.003,17,2,148,1,60,0.0,32.0,32.0,1,88,0.0,60.0,60.0
0.001,17,2,180,1,66,0.0,38.0,38.0,1,114,0.0,86.0,86.0
0.027,6,10,1989,5,910,6.0,642.0,642.0,5,1079,6.0,811.0,811.0
0.181,17,2,152,1,76,0.0,48.0,48.0,1,76,0.0,48.0,48.0
0.006,6,10,1643,5,860,1.0,592.0,592.0,5,783,1.0,515.0,515.0
300.022,6,12,1782,7,1348,50003.0,494.0,494.0,5,434,75004.0,83.0,83.0
0.133,17,2,80,1,32,0.0,4.0,4.0,1,48,0.0,20.0,20.0
0.015,6,10,1989,5,910,3.0,642.0,642.0,5,1079,3.0,811.0,811.0
0.013,6,11,2042,6,963,2.0,643.0,643.0,5,1079,3.0,811.0,811.0
0.113,6,10,1506,5,395,22.0,127.0,127.0,5,1111,24.0,843.0,843.0
40.055,17,10,676,5,460,10012.0,104.0,64.0,5,216,10011.0,20.0,15.0
0.004,17,2,136,1,60,0.0,32.0,32.0,1,76,0.0,48.0,48.0
0.073,6,10,1506,5,395,17.0,127.0,127.0,5,1111,15.0,843.0,843.0
0.017,6,10,1990,5,911,4.0,643.0,643.0,5,1079,4.0,811.0,811.0
371.34,6,22,2313,16,867,24756.0,195.0,195.0,6,1446,4637.0,419.0,398.0
0.02,6,10,1677,5,827,4.0,559.0,559.0,5,850,5.0,582.0,582.0
0.02,6,10,1990,5,911,4.0,643.0,643.0,5,1079,4.0,811.0,811.0
1799.555,17,3203,245316,1586,128675,1135.0,84.0,53.0,1617,116641,1113.0,227.0,44.0
0.008,6,10,1677,5,827,2.0,559.0,559.0,5,850,1.0,582.0,582.0
0.004,6,10,1774,5,923,1.0,655.0,655.0,5,851,1.0,583.0,583.0
0.086,6,10,1506,5,395,19.0,127.0,127.0,5,1111,19.0,843.0,843.0
11.166,17,28,4424,14,1995,846.0,270.0,114.0,14,2429,846.0,588.0,145.0
0.005,17,2,144,1,64,0.0,36.0,36.0,1,80,0.0,52.0,52.0
0.006,6,10,1689,5,839,1.0,571.0,571.0,5,850,1.0,582.0,582.0
0.006,17,2,238,1,66,0.0,38.0,38.0,1,172,0.0,144.0,144.0
0.006,17,2,179,1,71,0.0,43.0,43.0,1,108,0.0,80.0,80.0
11.178,17,28,4419,14,1994,847.0,269.0,114.0,14,2425,847.0,588.0,145.0
0.01,6,10,1983,5,910,2.0,642.0,642.0,5,1073,2.0,805.0,805.0
61.349,6,20,10024,11,3909,6134.0,1579.0,835.0,9,6115,7652.0,2111.0,939.0
0.016,6,10,1990,5,911,3.0,643.0,643.0,5,1079,4.0,811.0,811.0
42.465,6,37,9811,19,4293,492.0,1360.0,700.0,18,5518,2487.0,2667.0,435.0
0.06,17,2,152,1,76,0.0,48.0,48.0,1,76,0.0,48.0,48.0
240.685,6,35,8924,18,2073,14156.0,694.0,225.0,17,6851,15040.0,1402.0,597.0
0.014,6,10,1990,5,911,3.0,643.0,643.0,5,1079,3.0,811.0,811.0
0.006,6,10,1547,5,764,1.0,496.0,496.0,5,783,1.0,515.0,515.0
0.078,6,10,1506,5,395,18.0,127.0,127.0,5,1111,17.0,843.0,843.0
0.004,6,10,2006,5,927,1.0,659.0,659.0,5,1079,1.0,811.0,811.0
0.004,6,10,2006,5,927,1.0,659.0,659.0,5,1079,1.0,811.0,811.0
0.115,6,10,1506,5,395,22.0,127.0,127.0,5,1111,24.0,843.0,843.0
0.017,6,10,1989,5,910,4.0,642.0,642.0,5,1079,4.0,811.0,811.0
0.009,6,12,1926,6,1189,1.0,659.0,434.0,6,737,1.0,417.0,417.0
15.072,17,15,9238,8,6902,2149.0,1350.0,834.0,7,2336,2507.0,1350.0,305.0
15.072,17,14,9190,8,6902,2149.0,1350.0,834.0,6,2288,3008.0,1350.0,353.0
0.005,6,10,2006,5,927,1.0,659.0,659.0,5,1079,1.0,811.0,811.0
0.008,6,10,1972,5,910,2.0,642.0,642.0,5,1062,2.0,794.0,794.0
0.011,17,2,144,1,64,0.0,36.0,36.0,1,80,0.0,52.0,52.0
0.005,6,10,1989,5,927,1.0,659.0,659.0,5,1062,1.0,794.0,794.0
0.006,6,10,1689,5,839,1.0,571.0,571.0,5,850,1.0,582.0,582.0
0.004,6,10,1989,5,927,1.0,659.0,659.0,5,1062,1.0,794.0,794.0
240.02,6,9,787,5,488,60005.0,232.0,232.0,4,299,80005.0,83.0,83.0
0.134,17,2,80,1,32,0.0,4.0,4.0,1,48,0.0,20.0,20.0
0.005,6,10,2006,5,927,1.0,659.0,659.0,5,1079,1.0,811.0,811.0
0.008,6,10,1972,5,910,2.0,642.0,642.0,5,1062,2.0,794.0,794.0
0.004,17,2,136,1,60,0.0,32.0,32.0,1,76,0.0,48.0,48.0
0.004,6,10,1779,5,928,1.0,660.0,660.0,5,851,0.0,583.0,583.0
0.008,6,10,1983,5,910,2.0,642.0,642.0,5,1073,1.0,805.0,805.0
0.004,6,10,2000,5,927,1.0,659.0,659.0,5,1073,1.0,805.0,805.0
0.08,6,10,1506,5,395,18.0,127.0,127.0,5,1111,18.0,843.0,843.0
0.014,6,10,1990,5,911,3.0,643.0,643.0,5,1079,3.0,811.0,811.0
0.017,6,10,1631,5,848,4.0,580.0,580.0,5,783,4.0,515.0,515.0
0.017,6,10,1972,5,910,4.0,642.0,642.0,5,1062,4.0,794.0,794.0
177.437,17,74,10567,37,2465,4928.0,44.0,38.0,37,8102,4928.0,239.0,190.0
0.006,6,10,1689,5,839,1.0,571.0,571.0,5,850,1.0,582.0,582.0
0.004,6,10,1989,5,927,1.0,659.0,659.0,5,1062,1.0,794.0,794.0
40.054,17,10,676,5,460,10012.0,104.0,64.0,5,216,10012.0,20.0,15.0
0.005,17,2,214,1,75,0.0,47.0,47.0,1,139,0.0,111.0,111.0
0.008,6,10,1972,5,910,1.0,642.0,642.0,5,1062,1.0,794.0,794.0
0.005,6,10,1989,5,927,1.0,659.0,659.0,5,1062,1.0,794.0,794.0
0.005,6,10,2000,5,927,1.0,659.0,659.0,5,1073,1.0,805.0,805.0
0.009,6,10,1983,5,910,2.0,642.0,642.0,5,1073,2.0,805.0,805.0
10.746,17,28,4422,14,1994,818.0,269.0,114.0,14,2428,818.0,587.0,145.0
240.015,6,9,787,5,488,60003.0,232.0,232.0,4,299,80004.0,83.0,83.0
0.011,6,10,1677,5,827,2.0,559.0,559.0,5,850,2.0,582.0,582.0
608.482,6,44,12189,23,3520,27658.0,664.0,386.0,21,8669,27421.0,1402.0,540.0
0.004,6,10,2006,5,927,1.0,659.0,659.0,5,1079,1.0,811.0,811.0
0.005,6,14,3799,7,509,0.0,137.0,137.0,7,3290,0.0,1448.0,972.0
0.008,6,10,1972,5,910,2.0,642.0,642.0,5,1062,2.0,794.0,794.0
0.009,6,10,1990,5,911,2.0,643.0,643.0,5,1079,2.0,811.0,811.0
0.006,6,10,1989,5,927,1.0,659.0,659.0,5,1062,1.0,794.0,794.0
0.005,17,2,148,1,60,0.0,32.0,32.0,1,88,0.0,60.0,60.0
0.129,17,2,80,1,32,0.0,4.0,4.0,1,48,0.0,20.0,20.0
0.069,6,10,1506,5,395,16.0,127.0,127.0,5,1111,13.0,843.0,843.0
0.111,6,10,1506,5,395,25.0,127.0,127.0,5,1111,23.0,843.0,843.0
0.065,6,10,1506,5,395,14.0,127.0,127.0,5,1111,14.0,843.0,843.0
0.025,6,10,1677,5,827,6.0,559.0,559.0,5,850,6.0,582.0,582.0
0.006,6,10,1689,5,839,1.0,571.0,571.0,5,850,1.0,582.0,582.0
0.039,17,2,152,1,76,0.0,48.0,48.0,1,76,0.0,48.0,48.0
0.018,6,10,1990,5,911,4.0,643.0,643.0,5,1079,4.0,811.0,811.0
0.04,17,2,136,1,60,0.0,32.0,32.0,1,76,0.0,48.0,48.0
0.089,6,10,1506,5,395,19.0,127.0,127.0,5,1111,17.0,843.0,843.0
0.016,6,10,1990,5,911,3.0,643.0,643.0,5,1079,3.0,811.0,811.0
0.133,6,10,1506,5,395,31.0,127.0,127.0,5,1111,31.0,843.0,843.0
0.11,6,10,1506,5,395,25.0,127.0,127.0,5,1111,25.0,843.0,843.0
0.005,6,10,1989,5,927,1.0,659.0,659.0,5,1062,1.0,794.0,794.0
0.02,6,10,1990,5,911,5.0,643.0,643.0,5,1079,4.0,811.0,811.0
0.005,6,10,1779,5,928,1.0,660.0,660.0,5,851,1.0,583.0,583.0
0.004,17,2,136,1,60,0.0,32.0,32.0,1,76,0.0,48.0,48.0
0.003,17,4,284,2,120,0.0,32.0,32.0,2,164,0.0,60.0,54.0
0.12,6,10,1506,5,395,27.0,127.0,127.0,5,1111,26.0,843.0,843.0
0.006,6,10,1547,5,764,1.0,496.0,496.0,5,783,1.0,515.0,515.0
313.346,17,20,1124,10,716,34801.0,48.0,43.0,10,408,34802.0,20.0,12.0
0.014,6,10,1972,5,910,3.0,642.0,642.0,5,1062,3.0,794.0,794.0
0.005,6,10,1989,5,927,1.0,659.0,659.0,5,1062,1.0,794.0,794.0
95.705,6,26,9479,13,1655,7975.0,794.0,367.0,13,7824,7964.0,1360.0,810.0
0.01,6,10,1677,5,827,2.0,559.0,559.0,5,850,2.0,582.0,582.0
0.011,6,10,1972,5,910,2.0,642.0,642.0,5,1062,2.0,794.0,794.0
0.009,6,12,1926,6,1189,1.0,659.0,434.0,6,737,1.0,417.0,417.0
0.077,6,10,1506,5,395,17.0,127.0,127.0,5,1111,16.0,843.0,843.0
0.005,6,10,1779,5,928,1.0,660.0,660.0,5,851,1.0,583.0,583.0
0.007,6,10,1547,5,764,1.0,496.0,496.0,5,783,1.0,515.0,515.0
0.013,17,2,152,1,56,0.0,28.0,28.0,1,96,0.0,68.0,68.0
0.011,6,10,1989,5,910,2.0,642.0,642.0,5,1079,2.0,811.0,811.0
0.084,6,10,1506,5,395,20.0,127.0,127.0,5,1111,18.0,843.0,843.0
0.005,17,2,273,1,66,0.0,38.0,38.0,1,207,0.0,179.0,179.0
0.001,17,2,140,1,62,0.0,34.0,34.0,1,78,0.0,50.0,50.0
0.007,17,2,194,1,59,0.0,31.0,31.0,1,135,0.0,107.0,107.0
0.006,6,10,1547,5,764,1.0,496.0,496.0,5,783,1.0,515.0,515.0
0.005,6,10,2000,5,927,1.0,659.0,659.0,5,1073,1.0,805.0,805.0
0.016,6,10,1972,5,910,4.0,642.0,642.0,5,1062,3.0,794.0,794.0
0.006,17,2,194,1,59,0.0,31.0,31.0,1,135,0.0,107.0,107.0
0.04,17,4,284,2,120,0.0,32.0,32.0,2,164,36.0,60.0,54.0
0.011,6,10,1990,5,911,2.0,643.0,643.0,5,1079,2.0,811.0,811.0
0.006,6,10,1643,5,860,1.0,592.0,592.0,5,783,1.0,515.0,515.0
300.02,6,12,1782,7,1348,50003.0,494.0,494.0,5,434,75004.0,83.0,83.0
0.005,17,2,214,1,75,0.0,47.0,47.0,1,139,0.0,111.0,111.0
0.006,6,10,1643,5,860,1.0,592.0,592.0,5,783,1.0,515.0,515.0
0.001,17,2,180,1,66,0.0,38.0,38.0,1,114,0.0,86.0,86.0
0.014,6,10,1762,5,911,3.0,643.0,643.0,5,851,3.0,583.0,583.0
0.004,6,10,2007,5,928,1.0,660.0,660.0,5,1079,1.0,811.0,811.0
0.013,6,10,1972,5,910,3.0,642.0,642.0,5,1062,3.0,794.0,794.0
0.126,6,10,1506,5,395,25.0,127.0,127.0,5,1111,27.0,843.0,843.0
0.07,6,10,1506,5,395,13.0,127.0,127.0,5,1111,16.0,843.0,843.0
0.001,17,2,136,1,60,0.0,32.0,32.0,1,76,0.0,48.0,48.0
0.005,6,10,2000,5,927,1.0,659.0,659.0,5,1073,1.0,805.0,805.0
0.008,6,10,1989,5,910,1.0,642.0,642.0,5,1079,2.0,811.0,811.0
0.001,17,2,180,1,66,0.0,38.0,38.0,1,114,0.0,86.0,86.0
1792.619,6,493,100374,247,88944,7286.0,421.0,366.0,246,11430,7316.0,53.0,53.0
0.005,17,2,178,1,66,0.0,38.0,38.0,1,112,0.0,84.0,84.0
0.006,17,2,169,1,62,0.0,34.0,34.0,1,107,0.0,79.0,79.0
0.005,6,10,1854,5,889,1.0,621.0,621.0,5,965,1.0,697.0,697.0
40.074,17,10,676,5,460,10015.0,104.0,64.0,5,216,10017.0,20.0,15.0
0.009,6,10,1989,5,910,2.0,642.0,642.0,5,1079,2.0,811.0,811.0
0.004,17,4,284,2,120,0.0,32.0,32.0,2,164,0.0,60.0,54.0
0.073,6,10,1506,5,395,15.0,127.0,127.0,5,1111,17.0,843.0,843.0
0.013,6,10,1972,5,910,3.0,642.0,642.0,5,1062,3.0,794.0,794.0
0.016,6,10,1990,5,911,3.0,643.0,643.0,5,1079,3.0,811.0,811.0
0.012,17,4,284,2,120,8.0,32.0,32.0,2,164,8.0,60.0,54.0
0.013,6,10,1983,5,910,3.0,642.0,642.0,5,1073,3.0,805.0,805.0
0.015,6,10,1989,5,910,3.0,642.0,642.0,5,1079,3.0,811.0,811.0
0.008,17,2,140,1,62,0.0,34.0,34.0,1,78,0.0,50.0,50.0
0.004,6,10,2006,5,927,1.0,659.0,659.0,5,1079,1.0,811.0,811.0
0.004,17,2,136,1,60,0.0,32.0,32.0,1,76,0.0,48.0,48.0
0.005,6,13,3747,7,509,0.0,137.0,137.0,6,3238,1.0,1470.0,1459.0
0.005,17,2,170,1,65,0.0,37.0,37.0,1,105,0.0,77.0,77.0
361.829,6,19,1689,15,978,25844.0,190.0,190.0,4,711,80012.0,495.0,495.0
0.008,6,10,1989,5,910,2.0,642.0,642.0,5,1079,2.0,811.0,811.0
15.224,17,17,8171,9,5992,1899.0,1350.0,637.0,8,2179,2170.0,1350.0,244.0
0.648,17,45,20921,23,17141,29.0,1350.0,717.0,22,3780,28.0,1350.0,143.0
0.04,17,2,148,1,60,0.0,32.0,32.0,1,88,0.0,60.0,60.0
0.005,6,10,2006,5,927,1.0,659.0,659.0,5,1079,1.0,811.0,811.0
0.01,6,10,1631,5,848,2.0,580.0,580.0,5,783,2.0,515.0,515.0
0.005,17,2,148,1,60,0.0,32.0,32.0,1,88,0.0,60.0,60.0
0.005,6,10,2006,5,927,1.0,659.0,659.0,5,1079,1.0,811.0,811.0
40.053,17,10,676,5,460,10011.0,104.0,64.0,5,216,10012.0,20.0,15.0
240.574,6,27,7691,12,3525,21870.0,1211.0,726.0,15,4166,17183.0,1162.0,375.0
0.071,17,8,3613,4,1874,23.0,1350.0,440.0,4,1739,12.0,1350.0,406.0
0.006,6,10,1547,5,764,1.0,496.0,496.0,5,783,1.0,515.0,515.0
0.098,6,10,1506,5,395,20.0,127.0,127.0,5,1111,21.0,843.0,843.0
0.006,6,10,1547,5,764,1.0,496.0,496.0,5,783,1.0,515.0,515.0
240.096,6,31,9333,16,6809,16006.0,1881.0,664.0,15,2524,17149.0,580.0,217.0
240.104,6,16,4482,9,963,30013.0,238.0,166.0,7,3519,40017.0,1402.0,786.0
0.075,6,10,1506,5,395,16.0,127.0,127.0,5,1111,17.0,843.0,843.0
0.004,17,4,284,2,120,0.0,32.0,32.0,2,164,0.0,60.0,54.0
0.013,6,10,1983,5,910,3.0,642.0,642.0,5,1073,3.0,805.0,805.0
0.018,6,10,1677,5,827,4.0,559.0,559.0,5,850,4.0,582.0,582.0
0.004,17,2,186,1,61,0.0,33.0,33.0,1,125,0.0,97.0,97.0
0.007,6,10,1547,5,764,1.0,496.0,496.0,5,783,1.0,515.0,515.0
0.005,6,10,2006,5,927,1.0,659.0,659.0,5,1079,1.0,811.0,811.0
0.005,6,10,1989,5,927,1.0,659.0,659.0,5,1062,1.0,794.0,794.0
0.011,6,10,1677,5,827,2.0,559.0,559.0,5,850,2.0,582.0,582.0
0.017,6,10,1972,5,910,4.0,642.0,642.0,5,1062,4.0,794.0,794.0
0.011,6,10,1990,5,911,2.0,643.0,643.0,5,1079,2.0,811.0,811.0
0.206,6,16,2777,8,1395,29.0,533.0,323.0,8,1382,18.0,529.0,239.0
0.004,6,10,2007,5,928,1.0,660.0,660.0,5,1079,1.0,811.0,811.0
0.01,6,10,1990,5,911,2.0,643.0,643.0,5,1079,2.0,811.0,811.0
164.123,17,78,11374,39,2623,4318.0,44.0,39.0,39,8751,4318.0,260.0,196.0
9.037,17,6,376,5,280,2259.0,28.0,28.0,1,96,0.0,68.0,68.0
0.004,6,10,1702,5,863,1.0,595.0,595.0,5,839,0.0,571.0,571.0
0.005,17,2,164,1,74,0.0,46.0,46.0,1,90,0.0,62.0,62.0
0.001,17,2,180,1,66,0.0,38.0,38.0,1,114,0.0,86.0,86.0
0.001,17,2,180,1,66,0.0,38.0,38.0,1,114,0.0,86.0,86.0
0.11,6,10,1506,5,395,21.0,127.0,127.0,5,1111,24.0,843.0,843.0
0.005,6,10,1547,5,764,1.0,496.0,496.0,5,783,1.0,515.0,515.0
0.005,6,10,2006,5,927,1.0,659.0,659.0,5,1079,1.0,811.0,811.0
0.012,6,10,1990,5,911,3.0,643.0,643.0,5,1079,2.0,811.0,811.0
0.001,17,2,179,1,62,0.0,34.0,34.0,1,117,0.0,89.0,89.0
0.008,6,10,1990,5,911,2.0,643.0,643.0,5,1079,2.0,811.0,811.0
0.008,6,10,1989,5,910,2.0,642.0,642.0,5,1079,1.0,811.0,811.0
0.005,6,10,1989,5,927,1.0,659.0,659.0,5,1062,1.0,794.0,794.0
0.005,6,10,1989,5,927,1.0,659.0,659.0,5,1062,1.0,794.0,794.0
0.006,6,14,3799,7,509,0.0,137.0,137.0,7,3290,0.0,1448.0,972.0
0.009,6,10,1689,5,839,2.0,571.0,571.0,5,850,2.0,582.0,582.0
0.008,6,10,1989,5,927,1.0,659.0,659.0,5,1062,2.0,794.0,794.0
0.004,6,10,2007,5,928,1.0,660.0,660.0,5,1079,1.0,811.0,811.0
0.019,6,10,1989,5,910,4.0,642.0,642.0,5,1079,4.0,811.0,811.0
0.008,6,10,1989,5,910,2.0,642.0,642.0,5,1079,1.0,811.0,811.0
0.001,17,2,180,1,66,0.0,38.0,38.0,1,114,0.0,86.0,86.0
40.052,17,10,676,5,460,10012.0,104.0,64.0,5,216,10012.0,20.0,15.0
0.002,17,2,357,1,68,0.0,40.0,40.0,1,289,0.0,261.0,261.0
0.105,6,10,1506,5,395,21.0,127.0,127.0,5,1111,24.0,843.0,843.0
0.117,17,4,352,2,130,45.0,37.0,37.0,2,222,77.0,89.0,83.0
0.007,6,10,1983,5,910,1.0,642.0,642.0,5,1073,1.0,805.0,805.0
0.116,6,10,1506,5,395,26.0,127.0,127.0,5,1111,26.0,843.0,843.0
0.115,6,10,1506,5,395,27.0,127.0,127.0,5,1111,26.0,843.0,843.0
40.069,17,10,676,5,460,10016.0,104.0,64.0,5,216,10016.0,20.0,15.0
0.008,6,10,1989,5,910,1.0,642.0,642.0,5,1079,2.0,811.0,811.0
66.297,6,27,17592,15,9656,4735.0,2804.0,1478.0,12,7936,6012.0,2307.0,1217.0
0.0,17,2,166,1,75,0.0,47.0,47.0,1,91,0.0,63.0,63.0
0.006,6,10,1854,5,889,1.0,621.0,621.0,5,965,1.0,697.0,697.0
0.003,6,10,1702,5,863,0.0,595.0,595.0,5,839,0.0,571.0,571.0
0.004,6,10,1989,5,927,1.0,659.0,659.0,5,1062,1.0,794.0,794.0
10.865,17,28,4423,14,1994,827.0,269.0,114.0,14,2429,827.0,588.0,145.0
40.053,17,10,676,5,460,10011.0,104.0,64.0,5,216,10012.0,20.0,15.0
0.061,6,10,1506,5,395,13.0,127.0,127.0,5,1111,14.0,843.0,843.0
0.005,6,10,1779,5,928,1.0,660.0,660.0,5,851,1.0,583.0,583.0
0.013,6,10,1983,5,910,3.0,642.0,642.0,5,1073,3.0,805.0,805.0
40.06,17,10,676,5,460,10014.0,104.0,64.0,5,216,10013.0,20.0,15.0
0.064,6,10,1506,5,395,15.0,127.0,127.0,5,1111,13.0,843.0,843.0
0.016,6,13,3735,7,497,2.0,125.0,125.0,6,3238,3.0,1470.0,1459.0
0.007,6,10,1989,5,910,1.0,642.0,642.0,5,1079,1.0,811.0,811.0
0.008,6,10,1689,5,839,2.0,571.0,571.0,5,850,2.0,582.0,582.0
0.002,17,2,180,1,66,0.0,38.0,38.0,1,114,0.0,86.0,86.0
0.046,6,10,1762,5,911,11.0,643.0,643.0,5,851,11.0,583.0,583.0
0.004,6,10,2000,5,927,1.0,659.0,659.0,5,1073,1.0,805.0,805.0
0.005,6,10,2006,5,927,1.0,659.0,659.0,5,1079,1.0,811.0,811.0
0.006,17,2,214,1,75,0.0,47.0,47.0,1,139,0.0,111.0,111.0
1772.656,17,120,11460,60,5460,30044.0,63.0,63.0,60,6000,30044.0,72.0,72.0
0.071,6,10,1506,5,395,16.0,127.0,127.0,5,1111,16.0,843.0,843.0
0.009,6,10,1972,5,910,2.0,642.0,642.0,5,1062,2.0,794.0,794.0
0.001,17,2,180,1,66,0.0,38.0,38.0,1,114,0.0,86.0,86.0
0.207,6,16,2777,8,1395,29.0,533.0,323.0,8,1382,18.0,529.0,239.0
40.062,17,10,676,5,460,10014.0,104.0,64.0,5,216,10014.0,20.0,15.0
0.013,6,10,1631,5,848,3.0,580.0,580.0,5,783,3.0,515.0,515.0
300.397,6,16,2170,9,684,37528.0,146.0,146.0,7,1486,50036.0,419.0,398.0
0.01,6,10,1631,5,848,2.0,580.0,580.0,5,783,2.0,515.0,515.0
0.113,6,10,1506,5,395,24.0,127.0,127.0,5,1111,25.0,843.0,843.0
11.266,17,28,4421,14,1994,854.0,269.0,114.0,14,2427,854.0,586.0,145.0
0.014,6,10,1990,5,911,3.0,643.0,643.0,5,1079,3.0,811.0,811.0
0.124,6,10,1506,5,395,27.0,127.0,127.0,5,1111,28.0,843.0,843.0
0.01,17,2,152,1,76,0.0,48.0,48.0,1,76,0.0,48.0,48.0
240.012,6,9,787,5,488,60003.0,232.0,232.0,4,299,80002.0,83.0,83.0
0.005,6,10,2000,5,927,1.0,659.0,659.0,5,1073,1.0,805.0,805.0
0.016,17,2,148,1,60,0.0,32.0,32.0,1,88,0.0,60.0,60.0
0.066,17,8,3613,4,1874,22.0,1350.0,440.0,4,1739,11.0,1350.0,406.0
177.104,17,80,11394,40,2665,4540.0,44.0,38.0,40,8729,4541.0,239.0,190.0
0.021,6,10,1989,5,910,5.0,642.0,642.0,5,1079,5.0,811.0,811.0
0.012,6,10,1983,5,910,3.0,642.0,642.0,5,1073,2.0,805.0,805.0
39.984,17,10,676,5,460,9995.0,104.0,64.0,5,216,9995.0,20.0,15.0
0.011,6,10,1990,5,911,2.0,643.0,643.0,5,1079,2.0,811.0,811.0
0.007,17,2,194,1,59,0.0,31.0,31.0,1,135,0.0,107.0,107.0
0.077,6,10,1506,5,395,17.0,127.0,127.0,5,1111,16.0,843.0,843.0
0.001,17,2,180,1,65,0.0,37.0,37.0,1,115,0.0,87.0,87.0
0.005,6,13,3690,7,452,0.0,80.0,80.0,6,3238,1.0,1470.0,1459.0
0.142,6,10,1506,5,395,33.0,127.0,127.0,5,1111,33.0,843.0,843.0
0.005,6,10,2007,5,928,1.0,660.0,660.0,5,1079,1.0,811.0,811.0
0.013,6,10,1677,5,827,3.0,559.0,559.0,5,850,3.0,582.0,582.0
0.013,6,10,1631,5,848,3.0,580.0,580.0,5,783,3.0,515.0,515.0
0.005,6,10,2006,5,927,1.0,659.0,659.0,5,1079,1.0,811.0,811.0
0.008,6,12,1926,6,1189,1.0,659.0,434.0,6,737,1.0,417.0,417.0
0.013,6,10,1989,5,910,3.0,642.0,642.0,5,1079,3.0,811.0,811.0
0.005,6,10,2000,5,927,1.0,659.0,659.0,5,1073,1.0,805.0,805.0
40.071,17,10,676,5,460,10017.0,104.0,64.0,5,216,10017.0,20.0,15.0
0.099,6,10,1506,5,395,21.0,127.0,127.0,5,1111,22.0,843.0,843.0
0.082,6,10,1506,5,395,20.0,127.0,127.0,5,1111,18.0,843.0,843.0
0.008,6,12,1926,6,1189,1.0,659.0,434.0,6,737,1.0,417.0,417.0
0.003,17,2,136,1,60,0.0,32.0,32.0,1,76,0.0,48.0,48.0
0.008,6,10,1762,5,911,2.0,643.0,643.0,5,851,2.0,583.0,583.0
0.005,6,13,3747,7,509,0.0,137.0,137.0,6,3238,1.0,1470.0,1459.0
40.067,17,10,676,5,460,10014.0,104.0,64.0,5,216,10016.0,20.0,15.0
0.004,6,10,2007,5,928,1.0,660.0,660.0,5,1079,1.0,811.0,811.0
0.065,6,10,1506,5,395,14.0,127.0,127.0,5,1111,13.0,843.0,843.0
0.012,6,10,1972,5,910,2.0,642.0,642.0,5,1062,3.0,794.0,794.0
40.082,17,10,676,5,460,10019.0,104.0,64.0,5,216,10019.0,20.0,15.0
0.005,6,10,2007,5,928,1.0,660.0,660.0,5,1079,1.0,811.0,811.0
0.012,6,10,1990,5,911,3.0,643.0,643.0,5,1079,2.0,811.0,811.0
0.084,6,10,1506,5,395,17.0,127.0,127.0,5,1111,15.0,843.0,843.0
0.008,6,12,1926,6,1189,1.0,659.0,434.0,6,737,1.0,417.0,417.0
0.011,6,10,1631,5,848,2.0,580.0,580.0,5,783,2.0,515.0,515.0
40.064,17,10,676,5,460,10015.0,104.0,64.0,5,216,10015.0,20.0,15.0
0.008,6,12,1926,6,1189,1.0,659.0,434.0,6,737,1.0,417.0,417.0
0.092,6,10,1506,5,395,19.0,127.0,127.0,5,1111,20.0,843.0,843.0
40.057,17,10,676,5,460,10013.0,104.0,64.0,5,216,10013.0,20.0,15.0
246.929,6,89,25263,39,14193,6498.0,2883.0,578.0,50,11070,5039.0,2379.0,384.0
0.005,17,2,213,1,69,0.0,41.0,41.0,1,144,0.0,116.0,116.0
0.005,6,10,2000,5,927,1.0,659.0,659.0,5,1073,1.0,805.0,805.0
0.011,6,10,1989,5,910,2.0,642.0,642.0,5,1079,2.0,811.0,811.0
0.05,17,2,152,1,76,0.0,48.0,48.0,1,76,0.0,48.0,48.0
0.007,17,2,179,1,71,0.0,43.0,43.0,1,108,0.0,80.0,80.0
0.004,6,13,3690,7,452,0.0,80.0,80.0,6,3238,0.0,1470.0,1459.0
0.086,6,10,1506,5,395,19.0,127.0,127.0,5,1111,19.0,843.0,843.0
0.103,6,10,1506,5,395,23.0,127.0,127.0,5,1111,22.0,843.0,843.0
0.006,6,10,1547,5,764,1.0,496.0,496.0,5,783,1.0,515.0,515.0
0.009,6,12,1926,6,1189,1.0,659.0,434.0,6,737,1.0,417.0,417.0
0.006,6,10,1547,5,764,1.0,496.0,496.0,5,783,1.0,515.0,515.0
0.04,17,2,182,1,65,0.0,37.0,37.0,1,117,0.0,89.0,89.0
0.005,6,10,1774,5,923,1.0,655.0,655.0,5,851,1.0,583.0,583.0
0.011,6,10,1989,5,910,2.0,642.0,642.0,5,1079,2.0,811.0,811.0
0.01,6,10,1989,5,910,2.0,642.0,642.0,5,1079,2.0,811.0,811.0
0.005,6,10,1989,5,927,1.0,659.0,659.0,5,1062,1.0,794.0,794.0
40.057,17,10,676,5,460,10013.0,104.0,64.0,5,216,10013.0,20.0,15.0
240.104,6,32,9304,16,6928,16006.0,1999.0,677.0,16,2376,16006.0,580.0,192.0
0.065,6,10,1506,5,395,14.0,127.0,127.0,5,1111,13.0,843.0,843.0
0.004,6,10,1702,5,863,1.0,595.0,595.0,5,839,0.0,571.0,571.0
0.038,6,10,1983,5,910,9.0,642.0,642.0,5,1073,9.0,805.0,805.0
0.06,17,2,80,1,32,0.0,4.0,4.0,1,48,0.0,20.0,20.0
0.004,6,10,1989,5,927,1.0,659.0,659.0,5,1062,1.0,794.0,794.0
240.1,6,16,4481,9,963,30012.0,238.0,166.0,7,3518,40016.0,1402.0,786.0
0.008,6,12,1926,6,1189,1.0,659.0,434.0,6,737,1.0,417.0,417.0
0.851,17,32,10189,16,5410,54.0,1350.0,310.0,16,4779,54.0,1350.0,270.0
0.123,6,10,1506,5,395,29.0,127.0,127.0,5,1111,29.0,843.0,843.0
0.004,6,10,1779,5,928,1.0,660.0,660.0,5,851,1.0,583.0,583.0
308.382,17,16,892,8,564,44037.0,48.0,42.0,8,328,44037.0,20.0,13.0
1748.219,6,64,7344,42,4469,42639.0,1625.0,108.0,22,2875,83240.0,1111.0,82.0
11.257,17,28,4422,14,1994,851.0,269.0,114.0,14,2428,853.0,587.0,145.0
0.01,6,10,1972,5,910,2.0,642.0,642.0,5,1062,2.0,794.0,794.0
0.005,6,10,2006,5,927,1.0,659.0,659.0,5,1079,1.0,811.0,811.0
0.11,6,10,1506,5,395,24.0,127.0,127.0,5,1111,23.0,843.0,843.0
0.005,6,13,3747,7,509,0.0,137.0,137.0,6,3238,0.0,1470.0,1459.0
0.043,17,2,412,1,61,0.0,33.0,33.0,1,351,0.0,323.0,323.0
240.418,6,33,9740,16,2091,16025.0,539.0,250.0,17,7649,15024.0,1402.0,615.0
0.005,6,13,3747,7,509,0.0,137.0,137.0,6,3238,1.0,1470.0,1459.0
0.093,6,10,1506,5,395,21.0,127.0,127.0,5,1111,20.0,843.0,843.0
0.018,6,10,1990,5,911,4.0,643.0,643.0,5,1079,4.0,811.0,811.0
1799.702,17,3109,234411,1541,123430,1168.0,82.0,52.0,1568,110981,1148.0,226.0,42.0
0.007,6,13,3735,7,497,1.0,125.0,125.0,6,3238,1.0,1470.0,1459.0
0.013,6,10,1972,5,910,3.0,642.0,642.0,5,1062,3.0,794.0,794.0
11.212,17,28,4418,14,1994,849.0,269.0,114.0,14,2424,849.0,587.0,145.0
0.043,17,2,152,1,76,0.0,48.0,48.0,1,76,0.0,48.0,48.0
0.075,6,10,1506,5,395,17.0,127.0,127.0,5,1111,14.0,843.0,843.0
0.02,6,10,1631,5,848,5.0,580.0,580.0,5,783,5.0,515.0,515.0
0.108,6,10,1506,5,395,24.0,127.0,127.0,5,1111,26.0,843.0,843.0
0.011,6,10,1990,5,911,2.0,643.0,643.0,5,1079,2.0,811.0,811.0
0.004,6,10,1774,5,923,1.0,655.0,655.0,5,851,1.0,583.0,583.0
0.103,6,10,1506,5,395,21.0,127.0,127.0,5,1111,24.0,843.0,843.0
0.22,6,16,2669,8,1395,31.0,533.0,323.0,8,1274,19.0,529.0,212.0
0.011,6,10,1990,5,911,2.0,643.0,643.0,5,1079,2.0,811.0,811.0
0.004,6,10,2007,5,928,1.0,660.0,660.0,5,1079,1.0,811.0,811.0
0.005,6,10,1547,5,764,1.0,496.0,496.0,5,783,1.0,515.0,515.0
0.006,17,2,140,1,62,0.0,34.0,34.0,1,78,0.0,50.0,50.0
40.071,17,10,676,5,460,10013.0,104.0,64.0,5,216,10017.0,20.0,15.0
0.001,17,2,180,1,66,0.0,38.0,38.0,1,114,0.0,86.0,86.0
0.124,6,10,1506,5,395,26.0,127.0,127.0,5,1111,25.0,843.0,843.0
0.005,17,2,214,1,75,0.0,47.0,47.0,1,139,0.0,111.0,111.0
0.127,17,4,596,2,122,0.0,33.0,33.0,2,474,89.0,323.0,209.0
0.106,6,10,1506,5,395,23.0,127.0,127.0,5,1111,25.0,843.0,843.0
10.916,17,28,4424,14,1995,831.0,270.0,114.0,14,2429,831.0,588.0,145.0
0.512,6,22,7253,11,1684,50.0,797.0,276.0,11,5569,51.0,2333.0,997.0
0.01,6,10,1762,5,911,2.0,643.0,643.0,5,851,2.0,583.0,583.0
0.036,6,10,1990,5,911,9.0,643.0,643.0,5,1079,9.0,811.0,811.0
0.005,17,2,144,1,64,0.0,36.0,36.0,1,80,0.0,52.0,52.0
0.005,6,10,1989,5,927,1.0,659.0,659.0,5,1062,1.0,794.0,794.0
0.006,6,10,1547,5,764,1.0,496.0,496.0,5,783,1.0,515.0,515.0
0.001,17,2,180,1,66,0.0,38.0,38.0,1,114,0.0,86.0,86.0
0.006,6,10,1854,5,889,1.0,621.0,621.0,5,965,1.0,697.0,697.0
0.04,17,4,284,2,120,1.0,32.0,32.0,2,164,36.0,60.0,54.0
0.015,6,10,1990,5,911,3.0,643.0,643.0,5,1079,3.0,811.0,811.0
0.133,6,10,1506,5,395,30.0,127.0,127.0,5,1111,25.0,843.0,843.0
0.006,6,10,2006,5,927,1.0,659.0,659.0,5,1079,1.0,811.0,811.0
0.005,6,10,2000,5,927,1.0,659.0,659.0,5,1073,1.0,805.0,805.0
1.16,17,6,534,3,195,560.0,37.0,37.0,3,339,544.0,89.0,85.0
0.005,17,2,164,1,74,0.0,46.0,46.0,1,90,0.0,62.0,62.0
0.005,6,10,1689,5,839,1.0,571.0,571.0,5,850,1.0,582.0,582.0
240.087,6,20,4715,10,889,26676.0,180.0,93.0,10,3826,26675.0,1434.0,549.0
0.169,6,3,453,2,321,169.0,241.0,241.0,1,132,0.0,92.0,92.0
0.006,6,10,1689,5,839,1.0,571.0,571.0,5,850,1.0,582.0,582.0
0.011,6,10,1983,5,910,2.0,642.0,642.0,5,1073,2.0,805.0,805.0
0.086,6,10,1506,5,395,20.0,127.0,127.0,5,1111,20.0,843.0,843.0
0.004,6,10,1774,5,923,1.0,655.0,655.0,5,851,1.0,583.0,583.0
0.005,6,10,2006,5,927,1.0,659.0,659.0,5,1079,1.0,811.0,811.0
0.116,6,10,1506,5,395,27.0,127.0,127.0,5,1111,27.0,843.0,843.0
0.004,17,4,284,2,120,0.0,32.0,32.0,2,164,1.0,60.0,54.0
0.004,6,10,1702,5,863,1.0,595.0,595.0,5,839,1.0,571.0,571.0
0.134,17,2,80,1,32,0.0,4.0,4.0,1,48,0.0,20.0,20.0
0.005,6,10,1643,5,860,1.0,592.0,592.0,5,783,1.0,515.0,515.0
0.005,6,10,1989,5,927,1.0,659.0,659.0,5,1062,1.0,794.0,794.0
308.429,17,20,1124,10,716,34255.0,48.0,43.0,10,408,34255.0,20.0,12.0
0.215,6,16,2779,8,1397,30.0,533.0,324.0,8,1382,19.0,529.0,239.0
0.006,6,10,1547,5,764,1.0,496.0,496.0,5,783,1.0,515.0,515.0
40.085,17,10,676,5,460,10018.0,104.0,64.0,5,216,10020.0,20.0,15.0
40.055,17,10,676,5,460,10012.0,104.0,64.0,5,216,10012.0,20.0,15.0
0.015,6,10,1983,5,910,3.0,642.0,642.0,5,1073,3.0,805.0,805.0
0.005,17,2,179,1,71,0.0,43.0,43.0,1,108,0.0,80.0,80.0
0.006,6,10,1547,5,764,1.0,496.0,496.0,5,783,1.0,515.0,515.0
0.014,6,10,1972,5,910,3.0,642.0,642.0,5,1062,3.0,794.0,794.0
0.005,6,10,1989,5,927,1.0,659.0,659.0,5,1062,1.0,794.0,794.0
0.011,6,10,1972,5,910,2.0,642.0,642.0,5,1062,2.0,794.0,794.0
10.758,17,28,4422,14,1994,819.0,269.0,114.0,14,2428,819.0,587.0,145.0
0.005,17,2,179,1,71,0.0,43.0,43.0,1,108,0.0,80.0,80.0
0.008,6,10,1972,5,910,2.0,642.0,642.0,5,1062,2.0,794.0,794.0
0.008,6,10,1762,5,911,2.0,643.0,643.0,5,851,1.0,583.0,583.0
0.004,6,10,1774,5,923,1.0,655.0,655.0,5,851,1.0,583.0,583.0
0.005,6,10,2006,5,927,1.0,659.0,659.0,5,1079,1.0,811.0,811.0
0.005,6,10,1689,5,839,1.0,571.0,571.0,5,850,1.0,582.0,582.0
0.009,6,10,1990,5,911,2.0,643.0,643.0,5,1079,2.0,811.0,811.0
0.011,6,10,1989,5,910,2.0,642.0,642.0,5,1079,2.0,811.0,811.0
0.012,6,10,1983,5,910,2.0,642.0,642.0,5,1073,3.0,805.0,805.0
10.889,17,26,4101,13,1821,898.0,268.0,112.0,13,2280,898.0,587.0,147.0
352.251,6,20,2210,6,1308,12003.0,494.0,494.0,14,902,27095.0,83.0,83.0
0.013,6,10,1972,5,910,3.0,642.0,642.0,5,1062,3.0,794.0,794.0
0.005,17,2,230,1,68,0.0,40.0,40.0,1,162,0.0,134.0,134.0
0.007,6,10,1854,5,889,1.0,621.0,621.0,5,965,1.0,697.0,697.0
0.013,6,10,1972,5,910,3.0,642.0,642.0,5,1062,3.0,794.0,794.0
0.001,17,2,180,1,66,0.0,38.0,38.0,1,114,0.0,86.0,86.0
0.004,6,10,2006,5,927,1.0,659.0,659.0,5,1079,1.0,811.0,811.0
240.076,6,21,4924,11,941,24007.0,180.0,93.0,10,3983,26674.0,1591.0,575.0
0.005,6,10,1989,5,927,1.0,659.0,659.0,5,1062,1.0,794.0,794.0
0.001,17,2,166,1,75,0.0,47.0,47.0,1,91,0.0,63.0,63.0
0.005,6,10,1689,5,839,1.0,571.0,571.0,5,850,1.0,582.0,582.0
301.437,6,65,34786,34,28519,9134.0,2720.0,1507.0,31,6267,308.0,2667.0,385.0
0.001,17,2,180,1,66,0.0,38.0,38.0,1,114,0.0,86.0,86.0
0.005,6,10,2007,5,928,1.0,660.0,660.0,5,1079,1.0,811.0,811.0
0.041,17,2,184,1,61,0.0,33.0,33.0,1,123,0.0,95.0,95.0
0.005,6,10,1854,5,889,1.0,621.0,621.0,5,965,1.0,697.0,697.0
0.052,17,2,152,1,76,0.0,48.0,48.0,1,76,0.0,48.0,48.0
0.006,6,10,1547,5,764,1.0,496.0,496.0,5,783,1.0,515.0,515.0
0.003,17,2,148,1,60,0.0,32.0,32.0,1,88,0.0,60.0,60.0
0.005,6,10,1689,5,839,1.0,571.0,571.0,5,850,1.0,582.0,582.0
172.303,17,78,11067,39,2593,4534.0,44.0,38.0,39,8474,4534.0,239.0,189.0
0.012,6,10,1990,5,911,2.0,643.0,643.0,5,1079,3.0,811.0,811.0
240.023,6,9,787,5,488,60005.0,232.0,232.0,4,299,80007.0,83.0,83.0
0.08,6,10,1506,5,395,15.0,127.0,127.0,5,1111,17.0,843.0,843.0
0.095,6,10,1506,5,395,20.0,127.0,127.0,5,1111,20.0,843.0,843.0
0.008,6,10,1762,5,911,2.0,643.0,643.0,5,851,2.0,583.0,583.0
0.009,6,10,1972,5,910,2.0,642.0,642.0,5,1062,2.0,794.0,794.0
291.038,6,402,348064,195,21714,1500.0,2736.0,888.0,207,326350,1412.0,2804.0,1643.0
0.034,6,10,1972,5,910,8.0,642.0,642.0,5,1062,8.0,794.0,794.0
0.043,17,2,234,1,61,0.0,33.0,33.0,1,173,0.0,145.0,145.0
0.074,6,10,1506,5,395,18.0,127.0,127.0,5,1111,18.0,843.0,843.0
0.025,6,10,1990,5,911,6.0,643.0,643.0,5,1079,6.0,811.0,811.0
0.005,6,10,2007,5,928,1.0,660.0,660.0,5,1079,1.0,811.0,811.0
0.09,6,10,1506,5,395,19.0,127.0,127.0,5,1111,17.0,843.0,843.0
0.149,6,10,1506,5,395,34.0,127.0,127.0,5,1111,31.0,843.0,843.0
0.005,6,10,1547,5,764,1.0,496.0,496.0,5,783,1.0,515.0,515.0
40.062,17,10,676,5,460,10014.0,104.0,64.0,5,216,10014.0,20.0,15.0
0.012,6,10,1677,5,827,3.0,559.0,559.0,5,850,3.0,582.0,582.0
0.136,6,10,1506,5,395,31.0,127.0,127.0,5,1111,33.0,843.0,843.0
40.053,17,10,676,5,460,10012.0,104.0,64.0,5,216,10012.0,20.0,15.0
0.004,17,2,136,1,60,0.0,32.0,32.0,1,76,0.0,48.0,48.0
0.004,17,4,284,2,120,0.0,32.0,32.0,2,164,1.0,60.0,54.0
0.017,6,13,3735,7,497,2.0,125.0,125.0,6,3238,3.0,1470.0,1459.0
0.007,6,10,1702,5,863,1.0,595.0,595.0,5,839,1.0,571.0,571.0
0.01,6,10,1677,5,827,2.0,559.0,559.0,5,850,2.0,582.0,582.0
0.008,6,10,1762,5,911,2.0,643.0,643.0,5,851,2.0,583.0,583.0
0.006,6,10,2006,5,927,1.0,659.0,659.0,5,1079,1.0,811.0,811.0
9.037,17,6,376,5,280,2259.0,28.0,28.0,1,96,0.0,68.0,68.0
0.004,6,10,2006,5,927,1.0,659.0,659.0,5,1079,1.0,811.0,811.0
0.012,6,10,1972,5,910,2.0,642.0,642.0,5,1062,3.0,794.0,794.0
0.012,6,10,1989,5,910,2.0,642.0,642.0,5,1079,2.0,811.0,811.0
0.005,17,2,222,1,65,0.0,37.0,37.0,1,157,0.0,129.0,129.0
0.008,6,10,1972,5,910,2.0,642.0,642.0,5,1062,2.0,794.0,794.0
0.003,17,4,284,2,120,0.0,32.0,32.0,2,164,0.0,60.0,54.0
0.005,6,10,2007,5,928,1.0,660.0,660.0,5,1079,1.0,811.0,811.0
0.008,17,2,132,1,58,0.0,30.0,30.0,1,74,0.0,46.0,46.0
0.041,17,2,128,1,56,0.0,28.0,28.0,1,72,0.0,44.0,44.0
0.005,6,10,2006,5,927,1.0,659.0,659.0,5,1079,1.0,811.0,811.0
0.013,6,10,1989,5,910,3.0,642.0,642.0,5,1079,3.0,811.0,811.0
314.751,17,20,1124,10,716,34958.0,48.0,43.0,10,408,34957.0,20.0,12.0
0.006,6,10,1547,5,764,1.0,496.0,496.0,5,783,1.0,515.0,515.0
0.004,6,10,1774,5,923,1.0,655.0,655.0,5,851,1.0,583.0,583.0
0.005,17,2,148,1,60,0.0,32.0,32.0,1,88,0.0,60.0,60.0
0.003,17,2,148,1,60,0.0,32.0,32.0,1,88,0.0,60.0,60.0
0.001,17,2,136,1,60,0.0,32.0,32.0,1,76,0.0,48.0,48.0
0.167,17,2,152,1,76,0.0,48.0,48.0,1,76,0.0,48.0,48.0
66.183,6,27,17578,15,9627,4727.0,2804.0,1473.0,12,7951,6001.0,2322.0,1219.0
0.011,6,10,1990,5,911,2.0,643.0,643.0,5,1079,2.0,811.0,811.0
0.005,6,14,3742,7,452,0.0,80.0,80.0,7,3290,0.0,1448.0,972.0
0.004,17,2,148,1,60,0.0,32.0,32.0,1,88,0.0,60.0,60.0
0.012,6,10,1990,5,911,3.0,643.0,643.0,5,1079,3.0,811.0,811.0
40.08,17,10,676,5,460,10017.0,104.0,64.0,5,216,10019.0,20.0,15.0
177.065,17,78,11236,39,2618,4659.0,44.0,39.0,39,8618,4659.0,260.0,192.0
0.12,6,10,1506,5,395,27.0,127.0,127.0,5,1111,27.0,843.0,843.0
0.009,6,12,1926,6,1189,1.0,659.0,434.0,6,737,1.0,417.0,417.0
240.038,6,9,787,5,488,60009.0,232.0,232.0,4,299,80012.0,83.0,83.0
0.004,6,10,2006,5,927,1.0,659.0,659.0,5,1079,1.0,811.0,811.0
0.015,6,10,1989,5,910,3.0,642.0,642.0,5,1079,3.0,811.0,811.0
0.005,17,2,214,1,75,0.0,47.0,47.0,1,139,0.0,111.0,111.0
0.013,6,10,1989,5,910,3.0,642.0,642.0,5,1079,3.0,811.0,811.0
0.005,6,10,1779,5,928,1.0,660.0,660.0,5,851,1.0,583.0,583.0
0.07,6,10,1506,5,395,15.0,127.0,127.0,5,1111,15.0,843.0,843.0
0.014,6,10,1972,5,910,3.0,642.0,642.0,5,1062,3.0,794.0,794.0
0.09,6,10,1506,5,395,20.0,127.0,127.0,5,1111,19.0,843.0,843.0
0.006,6,10,2006,5,927,1.0,659.0,659.0,5,1079,1.0,811.0,811.0
0.01,6,10,1989,5,910,2.0,642.0,642.0,5,1079,2.0,811.0,811.0
0.005,6,10,2006,5,927,1.0,659.0,659.0,5,1079,1.0,811.0,811.0
300.703,6,31,10166,17,2173,18793.0,468.0,256.0,14,7993,18512.0,1402.0,907.0
159.575,17,74,10872,37,2487,4432.0,44.0,39.0,37,8385,4432.0,260.0,198.0
326.001,17,20,1124,10,716,36215.0,48.0,43.0,10,408,36215.0,20.0,12.0
0.029,6,10,1990,5,911,7.0,643.0,643.0,5,1079,7.0,811.0,811.0
0.019,6,10,1972,5,910,4.0,642.0,642.0,5,1062,4.0,794.0,794.0
0.004,6,10,1702,5,863,0.0,595.0,595.0,5,839,1.0,571.0,571.0
0.129,6,10,1506,5,395,30.0,127.0,127.0,5,1111,29.0,843.0,843.0
240.085,6,16,4482,9,963,30010.0,238.0,166.0,7,3519,40013.0,1402.0,786.0
0.004,6,10,2007,5,928,1.0,660.0,660.0,5,1079,1.0,811.0,811.0
0.078,6,10,1506,5,395,17.0,127.0,127.0,5,1111,17.0,843.0,843.0
0.004,6,10,2006,5,927,1.0,659.0,659.0,5,1079,1.0,811.0,811.0
183.643,6,8,747,5,500,45910.0,232.0,232.0,3,247,8.0,83.0,83.0
0.005,6,10,1989,5,927,1.0,659.0,659.0,5,1062,1.0,794.0,794.0
0.039,17,2,148,1,60,0.0,32.0,32.0,1,88,0.0,60.0,60.0
0.001,17,2,180,1,66,0.0,38.0,38.0,1,114,0.0,86.0,86.0
0.013,6,10,1989,5,910,3.0,642.0,642.0,5,1079,3.0,811.0,811.0
0.008,6,10,1983,5,910,2.0,642.0,642.0,5,1073,2.0,805.0,805.0
0.071,6,10,1506,5,395,17.0,127.0,127.0,5,1111,11.0,843.0,843.0
0.097,6,10,1506,5,395,21.0,127.0,127.0,5,1111,20.0,843.0,843.0
0.091,6,10,1506,5,395,21.0,127.0,127.0,5,1111,15.0,843.0,843.0
1770.488,6,83,4368,42,2210,43181.0,26.0,26.0,41,2158,44261.0,26.0,26.0
0.003,17,4,284,2,120,0.0,32.0,32.0,2,164,0.0,60.0,54.0
0.004,6,10,2000,5,927,1.0,659.0,659.0,5,1073,1.0,805.0,805.0
0.114,6,10,1506,5,395,26.0,127.0,127.0,5,1111,26.0,843.0,843.0
0.023,6,10,1989,5,910,5.0,642.0,642.0,5,1079,5.0,811.0,811.0
0.007,17,2,194,1,59,0.0,31.0,31.0,1,135,0.0,107.0,107.0
371.048,6,22,2313,16,867,24736.0,195.0,195.0,6,1446,4646.0,419.0,398.0
361.833,6,21,1793,16,1030,24122.0,190.0,190.0,5,763,60009.0,462.0,247.0
15.071,17,15,9239,8,6902,2149.0,1350.0,834.0,7,2337,2507.0,1350.0,305.0
0.017,6,10,1972,5,910,4.0,642.0,642.0,5,1062,4.0,794.0,794.0
0.009,6,10,1989,5,910,2.0,642.0,642.0,5,1079,2.0,811.0,811.0
0.014,6,10,1989,5,910,3.0,642.0,642.0,5,1079,3.0,811.0,811.0
0.02,6,10,1762,5,911,4.0,643.0,643.0,5,851,5.0,583.0,583.0
0.006,6,10,1547,5,764,1.0,496.0,496.0,5,783,1.0,515.0,515.0
40.12,6,68,31716,35,3421,1179.0,798.0,198.0,33,28295,1253.0,1736.0,984.0
0.011,6,10,1631,5,848,2.0,580.0,580.0,5,783,2.0,515.0,515.0
0.007,6,10,1989,5,910,1.0,642.0,642.0,5,1079,1.0,811.0,811.0
0.005,6,10,1689,5,839,1.0,571.0,571.0,5,850,1.0,582.0,582.0
0.014,6,10,1990,5,911,3.0,643.0,643.0,5,1079,3.0,811.0,811.0
0.011,6,10,1631,5,848,2.0,580.0,580.0,5,783,2.0,515.0,515.0
0.007,6,14,3787,7,497,1.0,125.0,125.0,7,3290,1.0,1448.0,972.0
0.008,6,12,1926,6,1189,1.0,659.0,434.0,6,737,1.0,417.0,417.0
0.019,6,10,1983,5,910,4.0,642.0,642.0,5,1073,4.0,805.0,805.0
0.186,6,43,11499,23,3170,8.0,1022.0,197.0,20,8329,9.0,1402.0,606.0
240.1,6,16,4481,9,963,30012.0,238.0,166.0,7,3518,40016.0,1402.0,786.0
0.158,6,10,1506,5,395,36.0,127.0,127.0,5,1111,36.0,843.0,843.0
0.013,6,10,1989,5,910,3.0,642.0,642.0,5,1079,3.0,811.0,811.0
0.005,6,10,1989,5,927,1.0,659.0,659.0,5,1062,1.0,794.0,794.0
0.006,6,10,1547,5,764,1.0,496.0,496.0,5,783,1.0,515.0,515.0
0.006,6,10,2006,5,927,1.0,659.0,659.0,5,1079,1.0,811.0,811.0
0.004,6,10,2000,5,927,1.0,659.0,659.0,5,1073,1.0,805.0,805.0
0.076,6,10,1506,5,395,16.0,127.0,127.0,5,1111,17.0,843.0,843.0
0.072,17,2,136,1,60,0.0,32.0,32.0,1,76,0.0,48.0,48.0
0.009,6,10,1989,5,910,2.0,642.0,642.0,5,1079,2.0,811.0,811.0
0.007,6,10,1990,5,911,1.0,643.0,643.0,5,1079,1.0,811.0,811.0
0.001,17,2,154,1,69,0.0,41.0,41.0,1,85,0.0,57.0,57.0
0.147,6,10,1506,5,395,33.0,127.0,127.0,5,1111,32.0,843.0,843.0
0.004,6,10,1702,5,863,1.0,595.0,595.0,5,839,0.0,571.0,571.0
0.006,6,10,2006,5,927,1.0,659.0,659.0,5,1079,1.0,811.0,811.0
40.061,17,10,676,5,460,10014.0,104.0,64.0,5,216,10014.0,20.0,15.0
0.083,6,10,1506,5,395,17.0,127.0,127.0,5,1111,18.0,843.0,843.0
0.116,6,10,1506,5,395,27.0,127.0,127.0,5,1111,26.0,843.0,843.0
0.009,6,10,1972,5,910,2.0,642.0,642.0,5,1062,2.0,794.0,794.0
0.133,17,2,136,1,60,0.0,32.0,32.0,1,76,0.0,48.0,48.0
15.072,17,15,9238,8,6902,2149.0,1350.0,834.0,7,2336,2506.0,1350.0,305.0
0.008,6,10,1762,5,911,2.0,643.0,643.0,5,851,1.0,583.0,583.0
0.006,6,10,1547,5,764,1.0,496.0,496.0,5,783,1.0,515.0,515.0
0.005,17,2,293,1,73,0.0,45.0,45.0,1,220,0.0,192.0,192.0
0.005,6,10,2006,5,927,1.0,659.0,659.0,5,1079,1.0,811.0,811.0
0.146,6,10,1506,5,395,31.0,127.0,127.0,5,1111,32.0,843.0,843.0
0.016,6,10,1983,5,910,4.0,642.0,642.0,5,1073,3.0,805.0,805.0
0.005,6,10,2000,5,927,1.0,659.0,659.0,5,1073,1.0,805.0,805.0
0.001,17,2,180,1,66,0.0,38.0,38.0,1,114,0.0,86.0,86.0
0.047,6,10,1990,5,911,11.0,643.0,643.0,5,1079,11.0,811.0,811.0
0.006,6,10,1643,5,860,1.0,592.0,592.0,5,783,1.0,515.0,515.0
0.004,6,13,3747,7,509,0.0,137.0,137.0,6,3238,0.0,1470.0,1459.0
40.065,17,10,676,5,460,10015.0,104.0,64.0,5,216,10015.0,20.0,15.0
0.188,6,43,11538,23,3231,8.0,1083.0,203.0,20,8307,9.0,1402.0,659.0
0.005,6,10,2006,5,927,1.0,659.0,659.0,5,1079,1.0,811.0,811.0
0.008,17,2,194,1,59,0.0,31.0,31.0,1,135,0.0,107.0,107.0
0.006,6,10,1547,5,764,1.0,496.0,496.0,5,783,1.0,515.0,515.0
0.038,17,2,182,1,65,0.0,37.0,37.0,1,117,0.0,89.0,89.0
361.808,6,21,1793,16,1030,24120.0,190.0,190.0,5,763,60011.0,462.0,247.0
40.079,17,10,676,5,460,10016.0,104.0,64.0,5,216,10018.0,20.0,15.0
0.758,6,25,5459,12,1557,59.0,325.0,152.0,13,3902,53.0,1414.0,563.0
0.012,17,2,138,1,61,0.0,33.0,33.0,1,77,0.0,49.0,49.0
0.099,6,10,1506,5,395,19.0,127.0,127.0,5,1111,23.0,843.0,843.0
0.005,17,2,170,1,65,0.0,37.0,37.0,1,105,0.0,77.0,77.0
241.443,6,302,342847,125,18010,1947.0,2736.0,959.0,177,324837,1371.0,4206.0,1889.0
0.005,6,10,1702,5,863,1.0,595.0,595.0,5,839,1.0,571.0,571.0
0.009,6,10,1990,5,911,2.0,643.0,643.0,5,1079,2.0,811.0,811.0
0.167,6,10,1506,5,395,39.0,127.0,127.0,5,1111,38.0,843.0,843.0
0.072,6,10,1506,5,395,13.0,127.0,127.0,5,1111,15.0,843.0,843.0
0.006,6,10,1854,5,889,1.0,621.0,621.0,5,965,1.0,697.0,697.0
0.005,6,10,2006,5,927,1.0,659.0,659.0,5,1079,1.0,811.0,811.0
0.004,17,4,284,2,120,1.0,32.0,32.0,2,164,1.0,60.0,54.0
40.08,17,10,676,5,460,10019.0,104.0,64.0,5,216,10018.0,20.0,15.0
294.059,6,375,347608,202,22051,1462.0,2736.0,888.0,173,325557,1709.0,2804.0,1990.0
0.154,6,10,1506,5,395,34.0,127.0,127.0,5,1111,35.0,843.0,843.0
1778.55,17,142,44872,72,22752,25048.0,288.0,288.0,70,22120,25774.0,288.0,288.0
10.96,17,28,4418,14,1995,834.0,270.0,114.0,14,2423,834.0,586.0,145.0
0.02,6,10,1989,5,910,4.0,642.0,642.0,5,1079,5.0,811.0,811.0
0.004,6,10,2006,5,927,1.0,659.0,659.0,5,1079,1.0,811.0,811.0
0.28,17,4,352,2,130,241.0,37.0,37.0,2,222,148.0,89.0,83.0
0.003,17,2,136,1,60,0.0,32.0,32.0,1,76,0.0,48.0,48.0
0.078,6,10,1506,5,395,16.0,127.0,127.0,5,1111,19.0,843.0,843.0
0.082,6,10,1506,5,395,19.0,127.0,127.0,5,1111,19.0,843.0,843.0
0.009,6,12,1926,6,1189,1.0,659.0,434.0,6,737,1.0,417.0,417.0
0.004,17,2,136,1,60,0.0,32.0,32.0,1,76,0.0,48.0,48.0
0.009,6,10,1762,5,911,2.0,643.0,643.0,5,851,2.0,583.0,583.0
0.004,6,13,3747,7,509,0.0,137.0,137.0,6,3238,0.0,1470.0,1459.0
0.008,6,12,1698,6,863,1.0,327.0,271.0,6,835,1.0,515.0,515.0
0.105,6,10,1506,5,395,25.0,127.0,127.0,5,1111,23.0,843.0,843.0
0.004,17,2,136,1,60,0.0,32.0,32.0,1,76,0.0,48.0,48.0
0.005,6,10,2007,5,928,1.0,660.0,660.0,5,1079,1.0,811.0,811.0
0.015,6,10,1989,5,910,3.0,642.0,642.0,5,1079,3.0,811.0,811.0
0.006,6,10,1643,5,860,1.0,592.0,592.0,5,783,1.0,515.0,515.0
0.004,6,10,2006,5,927,1.0,659.0,659.0,5,1079,1.0,811.0,811.0
0.014,6,10,1989,5,910,3.0,642.0,642.0,5,1079,3.0,811.0,811.0
0.005,6,10,1779,5,928,1.0,660.0,660.0,5,851,1.0,583.0,583.0
177.324,17,92,13062,46,3052,3940.0,44.0,38.0,46,10010,3940.0,239.0,189.0
0.005,6,10,2006,5,927,1.0,659.0,659.0,5,1079,1.0,811.0,811.0
309.197,17,20,1124,10,716,34342.0,48.0,43.0,10,408,34343.0,20.0,12.0
0.005,6,10,2007,5,928,1.0,660.0,660.0,5,1079,1.0,811.0,811.0
0.159,6,10,1506,5,395,37.0,127.0,127.0,5,1111,35.0,843.0,843.0
0.005,17,2,136,1,60,0.0,32.0,32.0,1,76,0.0,48.0,48.0
0.006,6,10,1854,5,889,1.0,621.0,621.0,5,965,1.0,697.0,697.0
0.014,6,10,1989,5,910,3.0,642.0,642.0,5,1079,3.0,811.0,811.0
0.04,17,2,144,1,64,0.0,36.0,36.0,1,80,0.0,52.0,52.0
0.006,6,10,2006,5,927,1.0,659.0,659.0,5,1079,1.0,811.0,811.0
0.006,6,13,3747,7,509,0.0,137.0,137.0,6,3238,1.0,1470.0,1459.0
0.005,6,10,2007,5,928,1.0,660.0,660.0,5,1079,1.0,811.0,811.0
0.006,6,10,1547,5,764,1.0,496.0,496.0,5,783,1.0,515.0,515.0
0.004,6,10,1774,5,923,1.0,655.0,655.0,5,851,1.0,583.0,583.0
0.004,6,10,2000,5,927,1.0,659.0,659.0,5,1073,1.0,805.0,805.0
0.02,6,13,3735,7,497,3.0,125.0,125.0,6,3238,4.0,1470.0,1459.0
0.009,6,10,1774,5,923,2.0,655.0,655.0,5,851,2.0,583.0,583.0
0.073,6,10,1506,5,395,16.0,127.0,127.0,5,1111,16.0,843.0,843.0
0.012,6,10,1990,5,911,3.0,643.0,643.0,5,1079,2.0,811.0,811.0
0.125,6,10,1506,5,395,22.0,127.0,127.0,5,1111,30.0,843.0,843.0
0.005,17,4,284,2,120,0.0,32.0,32.0,2,164,0.0,60.0,54.0
40.068,17,10,676,5,460,10016.0,104.0,64.0,5,216,10016.0,20.0,15.0
0.011,6,14,3787,7,497,1.0,125.0,125.0,7,3290,1.0,1448.0,972.0
0.013,6,10,1631,5,848,3.0,580.0,580.0,5,783,3.0,515.0,515.0
0.105,6,10,1506,5,395,23.0,127.0,127.0,5,1111,23.0,843.0,843.0
0.005,6,10,1989,5,927,1.0,659.0,659.0,5,1062,1.0,794.0,794.0
40.069,17,10,676,5,460,10014.0,104.0,64.0,5,216,10016.0,20.0,15.0
0.089,6,10,1506,5,395,17.0,127.0,127.0,5,1111,20.0,843.0,843.0
0.005,6,10,2006,5,927,1.0,659.0,659.0,5,1079,1.0,811.0,811.0
0.004,6,10,1989,5,927,1.0,659.0,659.0,5,1062,1.0,794.0,794.0
0.027,6,10,1989,5,910,6.0,642.0,642.0,5,1079,6.0,811.0,811.0
0.011,6,10,1762,5,911,2.0,643.0,643.0,5,851,2.0,583.0,583.0
0.018,6,10,1989,5,910,4.0,642.0,642.0,5,1079,4.0,811.0,811.0
0.013,6,10,1989,5,910,3.0,642.0,642.0,5,1079,3.0,811.0,811.0
0.073,6,10,1506,5,395,15.0,127.0,127.0,5,1111,15.0,843.0,843.0
360.033,6,21,3981,13,3142,30002.0,494.0,494.0,8,839,51433.0,83.0,83.0
0.081,6,10,1506,5,395,15.0,127.0,127.0,5,1111,17.0,843.0,843.0
0.005,6,10,1989,5,927,1.0,659.0,659.0,5,1062,1.0,794.0,794.0
0.17,6,3,453,2,321,170.0,241.0,241.0,1,132,0.0,92.0,92.0
0.005,6,10,1547,5,764,1.0,496.0,496.0,5,783,1.0,515.0,515.0
0.087,6,10,1506,5,395,19.0,127.0,127.0,5,1111,20.0,843.0,843.0
0.006,6,10,1547,5,764,1.0,496.0,496.0,5,783,1.0,515.0,515.0
0.096,6,10,1506,5,395,19.0,127.0,127.0,5,1111,22.0,843.0,843.0
0.006,17,2,164,1,74,0.0,46.0,46.0,1,90,0.0,62.0,62.0
0.005,6,10,2006,5,927,1.0,659.0,659.0,5,1079,1.0,811.0,811.0
0.041,17,4,284,2,120,0.0,32.0,32.0,2,164,36.0,60.0,54.0
0.215,17,16,9374,8,6918,30.0,1350.0,836.0,8,2456,20.0,1350.0,279.0
0.005,6,10,2006,5,927,1.0,659.0,659.0,5,1079,1.0,811.0,811.0
0.006,6,10,1989,5,927,1.0,659.0,659.0,5,1062,1.0,794.0,794.0
40.074,17,10,676,5,460,10016.0,104.0,64.0,5,216,10017.0,20.0,15.0
0.006,6,10,1854,5,889,1.0,621.0,621.0,5,965,1.0,697.0,697.0
0.095,6,10,1506,5,395,21.0,127.0,127.0,5,1111,22.0,843.0,843.0
0.009,6,12,1926,6,1189,1.0,659.0,434.0,6,737,1.0,417.0,417.0
0.018,17,2,198,1,91,0.0,63.0,63.0,1,107,0.0,79.0,79.0
0.041,17,4,596,2,122,1.0,33.0,33.0,2,474,3.0,323.0,209.0
0.004,6,14,3742,7,452,0.0,80.0,80.0,7,3290,0.0,1448.0,972.0
0.131,17,2,148,1,60,0.0,32.0,32.0,1,88,0.0,60.0,60.0
308.539,17,20,1124,10,716,34267.0,48.0,43.0,10,408,34267.0,20.0,12.0
0.09,6,10,1506,5,395,20.0,127.0,127.0,5,1111,21.0,843.0,843.0
0.118,6,10,1506,5,395,25.0,127.0,127.0,5,1111,25.0,843.0,843.0
0.016,6,10,1989,5,910,4.0,642.0,642.0,5,1079,4.0,811.0,811.0
0.001,17,2,166,1,75,0.0,47.0,47.0,1,91,0.0,63.0,63.0
0.006,6,13,3747,7,509,0.0,137.0,137.0,6,3238,1.0,1470.0,1459.0
0.008,6,12,1926,6,1189,1.0,659.0,434.0,6,737,1.0,417.0,417.0
0.005,6,10,1702,5,863,1.0,595.0,595.0,5,839,1.0,571.0,571.0
0.037,17,2,184,1,61,0.0,33.0,33.0,1,123,0.0,95.0,95.0
0.008,6,12,1926,6,1189,1.0,659.0,434.0,6,737,1.0,417.0,417.0
295.303,6,390,348026,200,21965,1483.0,2736.0,889.0,190,326061,1562.0,2804.0,1796.0
0.01,6,10,1989,5,910,2.0,642.0,642.0,5,1079,2.0,811.0,811.0
0.006,6,10,1547,5,764,1.0,496.0,496.0,5,783,1.0,515.0,515.0
0.005,6,10,1854,5,889,1.0,621.0,621.0,5,965,1.0,697.0,697.0
0.07,6,10,1506,5,395,15.0,127.0,127.0,5,1111,15.0,843.0,843.0
0.113,6,10,1506,5,395,25.0,127.0,127.0,5,1111,26.0,843.0,843.0
0.005,6,10,1643,5,860,1.0,592.0,592.0,5,783,1.0,515.0,515.0
0.112,6,10,1506,5,395,16.0,127.0,127.0,5,1111,27.0,843.0,843.0
0.005,6,10,1854,5,889,1.0,621.0,621.0,5,965,1.0,697.0,697.0
0.011,6,10,1989,5,910,2.0,642.0,642.0,5,1079,2.0,811.0,811.0
0.004,6,10,1702,5,863,1.0,595.0,595.0,5,839,1.0,571.0,571.0
0.322,17,42,20383,23,17163,14.0,1350.0,718.0,19,3220,13.0,1350.0,141.0
0.111,6,10,1506,5,395,26.0,127.0,127.0,5,1111,23.0,843.0,843.0
0.006,6,10,1547,5,764,1.0,496.0,496.0,5,783,1.0,515.0,515.0
0.014,6,10,1677,5,827,3.0,559.0,559.0,5,850,3.0,582.0,582.0
0.104,6,10,1506,5,395,22.0,127.0,127.0,5,1111,20.0,843.0,843.0
0.005,6,10,2006,5,927,1.0,659.0,659.0,5,1079,1.0,811.0,811.0
0.005,6,10,2007,5,928,1.0,660.0,660.0,5,1079,1.0,811.0,811.0
0.079,6,10,1506,5,395,14.0,127.0,127.0,5,1111,18.0,843.0,843.0
0.011,6,13,3735,7,497,1.0,125.0,125.0,6,3238,2.0,1470.0,1459.0
0.005,6,10,1989,5,927,1.0,659.0,659.0,5,1062,1.0,794.0,794.0
0.053,17,2,152,1,76,0.0,48.0,48.0,1,76,0.0,48.0,48.0
40.076,17,10,676,5,460,10013.0,104.0,64.0,5,216,10018.0,20.0,15.0
0.013,6,10,1983,5,910,3.0,642.0,642.0,5,1073,3.0,805.0,805.0
0.017,6,10,1762,5,911,4.0,643.0,643.0,5,851,4.0,583.0,583.0
0.001,17,2,180,1,66,0.0,38.0,38.0,1,114,0.0,86.0,86.0
0.07,6,10,1506,5,395,16.0,127.0,127.0,5,1111,16.0,843.0,843.0
0.005,17,2,166,1,75,0.0,47.0,47.0,1,91,0.0,63.0,63.0
0.008,6,10,1989,5,910,2.0,642.0,642.0,5,1079,1.0,811.0,811.0
0.006,17,2,169,1,62,0.0,34.0,34.0,1,107,0.0,79.0,79.0
0.132,17,4,420,2,122,3.0,33.0,33.0,2,298,128.0,145.0,121.0
0.001,17,2,180,1,66,0.0,38.0,38.0,1,114,0.0,86.0,86.0
0.005,6,10,1689,5,839,1.0,571.0,571.0,5,850,1.0,582.0,582.0
0.005,6,10,2000,5,927,1.0,659.0,659.0,5,1073,1.0,805.0,805.0
0.006,6,10,1989,5,927,1.0,659.0,659.0,5,1062,1.0,794.0,794.0
0.061,17,2,152,1,76,0.0,48.0,48.0,1,76,0.0,48.0,48.0
301.029,6,47,17535,25,11628,12542.0,2720.0,1177.0,22,5907,421.0,2667.0,385.0
0.006,6,10,1643,5,860,1.0,592.0,592.0,5,783,1.0,515.0,515.0
0.016,6,10,1972,5,910,3.0,642.0,642.0,5,1062,3.0,794.0,794.0
10.929,17,28,4422,14,1994,831.0,269.0,114.0,14,2428,831.0,587.0,145.0
0.012,6,10,1990,5,911,3.0,643.0,643.0,5,1079,2.0,811.0,811.0
0.006,6,10,2006,5,927,1.0,659.0,659.0,5,1079,1.0,811.0,811.0
0.009,6,10,1983,5,910,2.0,642.0,642.0,5,1073,2.0,805.0,805.0
0.006,17,2,194,1,59,0.0,31.0,31.0,1,135,0.0,107.0,107.0
1787.695,6,154,19574,92,13852,19644.0,302.0,302.0,62,5722,29306.0,83.0,83.0
0.039,17,2,148,1,60,0.0,32.0,32.0,1,88,0.0,60.0,60.0
0.005,6,10,1643,5,860,1.0,592.0,592.0,5,783,1.0,515.0,515.0
0.005,17,2,148,1,60,0.0,32.0,32.0,1,88,0.0,60.0,60.0
0.065,17,8,3613,4,1874,21.0,1350.0,440.0,4,1739,11.0,1350.0,406.0
0.006,6,10,1547,5,764,1.0,496.0,496.0,5,783,1.0,515.0,515.0
0.019,6,10,1983,5,910,4.0,642.0,642.0,5,1073,4.0,805.0,805.0
11.177,17,28,4421,14,1993,847.0,268.0,114.0,14,2428,847.0,587.0,145.0
0.065,6,10,1506,5,395,14.0,127.0,127.0,5,1111,13.0,843.0,843.0
0.128,17,4,352,2,130,0.0,37.0,37.0,2,222,4.0,89.0,83.0
0.005,6,10,2006,5,927,1.0,659.0,659.0,5,1079,1.0,811.0,811.0
0.11,6,10,1506,5,395,24.0,127.0,127.0,5,1111,24.0,843.0,843.0
0.111,6,10,1506,5,395,25.0,127.0,127.0,5,1111,24.0,843.0,843.0
0.003,17,2,148,1,60,0.0,32.0,32.0,1,88,0.0,60.0,60.0
175.019,17,90,12905,45,3024,3977.0,44.0,39.0,45,9881,3977.0,239.0,191.0
0.005,6,10,1547,5,764,1.0,496.0,496.0,5,783,1.0,515.0,515.0
0.013,6,10,1983,5,910,3.0,642.0,642.0,5,1073,3.0,805.0,805.0
0.008,6,10,1972,5,910,2.0,642.0,642.0,5,1062,1.0,794.0,794.0
0.018,6,10,1972,5,910,4.0,642.0,642.0,5,1062,4.0,794.0,794.0
0.078,6,10,1506,5,395,16.0,127.0,127.0,5,1111,18.0,843.0,843.0
0.007,6,10,2000,5,927,1.0,659.0,659.0,5,1073,1.0,805.0,805.0
0.013,6,10,1989,5,910,3.0,642.0,642.0,5,1079,3.0,811.0,811.0
0.001,17,2,180,1,66,0.0,38.0,38.0,1,114,0.0,86.0,86.0
0.176,6,3,453,2,321,176.0,241.0,241.0,1,132,0.0,92.0,92.0
0.005,6,10,2007,5,928,1.0,660.0,660.0,5,1079,1.0,811.0,811.0
0.005,17,2,140,1,62,0.0,34.0,34.0,1,78,0.0,50.0,50.0
0.109,6,10,1506,5,395,25.0,127.0,127.0,5,1111,23.0,843.0,843.0
0.017,17,2,198,1,91,0.0,63.0,63.0,1,107,0.0,79.0,79.0
0.014,17,2,144,1,64,0.0,36.0,36.0,1,80,0.0,52.0,52.0
0.008,6,10,1972,5,910,2.0,642.0,642.0,5,1062,2.0,794.0,794.0
0.001,17,2,180,1,66,0.0,38.0,38.0,1,114,0.0,86.0,86.0
10.992,17,28,4389,14,2311,837.0,586.0,137.0,14,2078,837.0,269.0,120.0
0.005,6,10,2006,5,927,1.0,659.0,659.0,5,1079,1.0,811.0,811.0
0.014,6,10,1762,5,911,3.0,643.0,643.0,5,851,3.0,583.0,583.0
40.061,17,10,676,5,460,10014.0,104.0,64.0,5,216,10014.0,20.0,15.0
0.116,6,10,1506,5,395,25.0,127.0,127.0,5,1111,26.0,843.0,843.0
301.52,6,37,8537,20,2105,15869.0,886.0,318.0,17,6432,527.0,2126.0,478.0
0.004,6,10,1989,5,927,1.0,659.0,659.0,5,1062,1.0,794.0,794.0
0.223,6,16,2778,8,1396,31.0,533.0,324.0,8,1382,20.0,529.0,239.0
0.004,17,2,148,1,60,0.0,32.0,32.0,1,88,0.0,60.0,60.0
0.005,6,10,1689,5,839,1.0,571.0,571.0,5,850,1.0,582.0,582.0
0.005,6,10,2007,5,928,1.0,660.0,660.0,5,1079,1.0,811.0,811.0
0.005,6,10,1989,5,927,1.0,659.0,659.0,5,1062,1.0,794.0,794.0
40.083,17,10,676,5,460,10019.0,104.0,64.0,5,216,10019.0,20.0,15.0
0.004,6,14,3736,7,446,0.0,74.0,74.0,7,3290,0.0,1448.0,972.0
0.127,17,2,148,1,60,0.0,32.0,32.0,1,88,0.0,60.0,60.0
0.004,6,10,2007,5,928,1.0,660.0,660.0,5,1079,1.0,811.0,811.0
40.07,17,10,676,5,460,10014.0,104.0,64.0,5,216,10016.0,20.0,15.0
177.4,17,72,10305,36,2401,5068.0,44.0,38.0,36,7904,5068.0,261.0,191.0
0.012,17,2,136,1,60,0.0,32.0,32.0,1,76,0.0,48.0,48.0
0.004,6,10,2006,5,927,1.0,659.0,659.0,5,1079,1.0,811.0,811.0
40.062,17,10,676,5,460,10014.0,104.0,64.0,5,216,10010.0,20.0,15.0
0.052,6,10,1631,5,848,13.0,580.0,580.0,5,783,12.0,515.0,515.0
40.053,17,10,676,5,460,10012.0,104.0,64.0,5,216,10012.0,20.0,15.0
0.005,6,10,2006,5,927,1.0,659.0,659.0,5,1079,1.0,811.0,811.0
0.015,6,10,1972,5,910,3.0,642.0,642.0,5,1062,3.0,794.0,794.0
0.014,6,10,1989,5,910,3.0,642.0,642.0,5,1079,3.0,811.0,811.0
0.013,6,10,1990,5,911,3.0,643.0,643.0,5,1079,3.0,811.0,811.0
0.006,6,10,2007,5,928,1.0,660.0,660.0,5,1079,1.0,811.0,811.0
0.01,6,10,1990,5,911,2.0,643.0,643.0,5,1079,2.0,811.0,811.0
0.007,6,10,2006,5,927,1.0,659.0,659.0,5,1079,1.0,811.0,811.0
11.148,17,28,4421,14,1993,844.0,268.0,114.0,14,2428,844.0,587.0,145.0
0.012,6,10,1989,5,910,2.0,642.0,642.0,5,1079,3.0,811.0,811.0
0.005,6,10,1989,5,927,1.0,659.0,659.0,5,1062,1.0,794.0,794.0
0.123,6,10,1506,5,395,27.0,127.0,127.0,5,1111,25.0,843.0,843.0
0.089,6,10,1506,5,395,18.0,127.0,127.0,5,1111,18.0,843.0,843.0
0.008,6,10,1972,5,910,2.0,642.0,642.0,5,1062,2.0,794.0,794.0
0.005,6,14,3742,7,452,0.0,80.0,80.0,7,3290,0.0,1448.0,972.0
0.005,17,2,213,1,69,0.0,41.0,41.0,1,144,0.0,116.0,116.0
0.007,6,10,1774,5,923,1.0,655.0,655.0,5,851,1.0,583.0,583.0
15.073,17,15,9238,8,6902,2149.0,1350.0,834.0,7,2336,2507.0,1350.0,305.0
0.005,17,2,169,1,62,0.0,34.0,34.0,1,107,0.0,79.0,79.0
0.025,6,10,1631,5,848,6.0,580.0,580.0,5,783,6.0,515.0,515.0
0.009,6,10,1989,5,910,2.0,642.0,642.0,5,1079,2.0,811.0,811.0
0.005,6,10,2006,5,927,1.0,659.0,659.0,5,1079,1.0,811.0,811.0
0.005,6,14,3799,7,509,0.0,137.0,137.0,7,3290,0.0,1448.0,972.0
0.008,6,10,1689,5,839,2.0,571.0,571.0,5,850,2.0,582.0,582.0
0.004,17,2,148,1,60,0.0,32.0,32.0,1,88,0.0,60.0,60.0
0.012,6,10,1631,5,848,3.0,580.0,580.0,5,783,2.0,515.0,515.0
0.153,6,24,5991,13,1521,11.0,326.0,165.0,11,4470,14.0,1324.0,778.0
0.04,17,4,352,2,130,0.0,37.0,37.0,2,222,37.0,89.0,83.0
0.008,6,10,1854,5,889,2.0,621.0,621.0,5,965,1.0,697.0,697.0
308.419,17,20,1124,10,716,34261.0,48.0,43.0,10,408,34261.0,20.0,12.0
2.565,6,26,6081,15,2140,183.0,517.0,303.0,11,3941,245.0,1360.0,697.0
0.013,6,10,1989,5,910,3.0,642.0,642.0,5,1079,3.0,811.0,811.0
0.08,6,10,1506,5,395,17.0,127.0,127.0,5,1111,18.0,843.0,843.0
24.073,6,36,12916,16,4741,1604.0,1618.0,648.0,20,8175,1266.0,2371.0,647.0
0.084,6,10,1506,5,395,19.0,127.0,127.0,5,1111,18.0,843.0,843.0
0.101,6,10,1506,5,395,20.0,127.0,127.0,5,1111,22.0,843.0,843.0
0.017,6,10,1983,5,910,4.0,642.0,642.0,5,1073,4.0,805.0,805.0
0.008,6,10,1983,5,910,2.0,642.0,642.0,5,1073,2.0,805.0,805.0
0.105,6,10,1506,5,395,23.0,127.0,127.0,5,1111,21.0,843.0,843.0
0.006,6,10,1547,5,764,1.0,496.0,496.0,5,783,1.0,515.0,515.0
0.067,17,8,3613,4,1874,22.0,1350.0,440.0,4,1739,11.0,1350.0,406.0
0.006,17,2,168,1,76,0.0,48.0,48.0,1,92,0.0,64.0,64.0
0.113,6,10,1506,5,395,25.0,127.0,127.0,5,1111,24.0,843.0,843.0
0.039,17,4,284,2,120,0.0,32.0,32.0,2,164,35.0,60.0,54.0
0.087,6,10,1506,5,395,20.0,127.0,127.0,5,1111,17.0,843.0,843.0
0.014,6,10,1972,5,910,3.0,642.0,642.0,5,1062,3.0,794.0,794.0
0.001,17,2,180,1,66,0.0,38.0,38.0,1,114,0.0,86.0,86.0
0.022,6,10,1989,5,910,5.0,642.0,642.0,5,1079,5.0,811.0,811.0
0.0,17,2,179,1,62,0.0,34.0,34.0,1,117,0.0,89.0,89.0
0.015,6,10,1972,5,910,3.0,642.0,642.0,5,1062,3.0,794.0,794.0
0.004,6,10,2007,5,928,1.0,660.0,660.0,5,1079,1.0,811.0,811.0
0.001,17,2,136,1,60,0.0,32.0,32.0,1,76,0.0,48.0,48.0
0.005,6,10,1989,5,927,1.0,659.0,659.0,5,1062,1.0,794.0,794.0
310.071,17,18,1008,9,640,38747.0,48.0,43.0,9,368,38749.0,20.0,12.0
58.969,6,45,16563,22,10604,430.0,2720.0,1384.0,23,5959,2673.0,2667.0,385.0
10.823,17,28,4421,14,1993,823.0,268.0,114.0,14,2428,823.0,587.0,145.0
0.008,6,10,1547,5,764,2.0,496.0,496.0,5,783,1.0,515.0,515.0
0.104,6,10,1506,5,395,24.0,127.0,127.0,5,1111,23.0,843.0,843.0
0.004,6,10,2007,5,928,1.0,660.0,660.0,5,1079,1.0,811.0,811.0
0.094,6,10,1506,5,395,21.0,127.0,127.0,5,1111,19.0,843.0,843.0
0.014,6,10,1972,5,910,3.0,642.0,642.0,5,1062,3.0,794.0,794.0
0.001,17,2,180,1,66,0.0,38.0,38.0,1,114,0.0,86.0,86.0
0.003,17,2,144,1,64,0.0,36.0,36.0,1,80,0.0,52.0,52.0
0.008,17,2,194,1,59,0.0,31.0,31.0,1,135,0.0,107.0,107.0
0.005,6,10,2007,5,928,1.0,660.0,660.0,5,1079,1.0,811.0,811.0
40.058,17,10,676,5,460,10013.0,104.0,64.0,5,216,10013.0,20.0,15.0
0.114,17,2,194,1,59,0.0,31.0,31.0,1,135,0.0,107.0,107.0
0.082,6,10,1506,5,395,16.0,127.0,127.0,5,1111,17.0,843.0,843.0
0.013,6,10,1631,5,848,3.0,580.0,580.0,5,783,3.0,515.0,515.0
0.164,6,10,1506,5,395,37.0,127.0,127.0,5,1111,39.0,843.0,843.0
0.012,6,10,1989,5,910,3.0,642.0,642.0,5,1079,3.0,811.0,811.0
0.042,17,4,284,2,120,0.0,32.0,32.0,2,164,39.0,60.0,54.0
1778.568,17,144,45504,72,22752,25050.0,288.0,288.0,72,22752,25050.0,288.0,288.0
0.008,6,10,1972,5,910,2.0,642.0,642.0,5,1062,2.0,794.0,794.0
0.116,6,10,1506,5,395,25.0,127.0,127.0,5,1111,25.0,843.0,843.0
0.103,6,10,1506,5,395,20.0,127.0,127.0,5,1111,25.0,843.0,843.0
0.014,6,10,1990,5,911,3.0,643.0,643.0,5,1079,3.0,811.0,811.0
0.083,6,10,1506,5,395,17.0,127.0,127.0,5,1111,19.0,843.0,843.0
0.102,6,10,1506,5,395,23.0,127.0,127.0,5,1111,20.0,843.0,843.0
240.076,6,16,4480,9,963,30009.0,238.0,166.0,7,3517,40012.0,1402.0,786.0
0.006,6,10,1547,5,764,1.0,496.0,496.0,5,783,1.0,515.0,515.0
240.669,6,37,9054,20,2203,12664.0,696.0,226.0,17,6851,15039.0,1402.0,597.0
0.011,6,10,1989,5,910,2.0,642.0,642.0,5,1079,2.0,811.0,811.0
0.021,6,10,1631,5,848,5.0,580.0,580.0,5,783,5.0,515.0,515.0
0.005,6,14,3736,7,446,0.0,74.0,74.0,7,3290,0.0,1448.0,972.0
0.004,17,2,136,1,60,0.0,32.0,32.0,1,76,0.0,48.0,48.0
0.011,6,10,1983,5,910,2.0,642.0,642.0,5,1073,2.0,805.0,805.0
0.006,6,10,1689,5,839,1.0,571.0,571.0,5,850,1.0,582.0,582.0
0.012,6,10,1762,5,911,2.0,643.0,643.0,5,851,2.0,583.0,583.0
1730.349,6,45,2790,30,1725,59667.0,35.0,35.0,15,1065,123591.0,31.0,31.0
11.604,17,28,4390,14,2312,880.0,587.0,137.0,14,2078,880.0,269.0,120.0
15.077,17,16,8872,8,6685,2149.0,1350.0,807.0,8,2187,2149.0,1350.0,245.0
0.005,6,10,2000,5,927,1.0,659.0,659.0,5,1073,1.0,805.0,805.0
0.007,6,10,1989,5,910,1.0,642.0,642.0,5,1079,1.0,811.0,811.0
0.095,6,10,1506,5,395,18.0,127.0,127.0,5,1111,22.0,843.0,843.0
0.005,6,10,2006,5,927,1.0,659.0,659.0,5,1079,1.0,811.0,811.0
0.004,6,10,1774,5,923,1.0,655.0,655.0,5,851,1.0,583.0,583.0
0.011,6,10,1990,5,911,2.0,643.0,643.0,5,1079,2.0,811.0,811.0
0.005,17,2,212,1,74,0.0,46.0,46.0,1,138,0.0,110.0,110.0
0.014,6,10,1677,5,827,3.0,559.0,559.0,5,850,3.0,582.0,582.0
0.105,6,10,1506,5,395,23.0,127.0,127.0,5,1111,22.0,843.0,843.0
0.001,17,2,142,1,63,0.0,35.0,35.0,1,79,0.0,51.0,51.0
0.081,6,10,1506,5,395,17.0,127.0,127.0,5,1111,18.0,843.0,843.0
0.006,6,10,1547,5,764,1.0,496.0,496.0,5,783,1.0,515.0,515.0
0.108,6,10,1506,5,395,22.0,127.0,127.0,5,1111,25.0,843.0,843.0
0.095,6,10,1506,5,395,22.0,127.0,127.0,5,1111,21.0,843.0,843.0
0.005,6,10,2006,5,927,1.0,659.0,659.0,5,1079,1.0,811.0,811.0
0.082,6,10,1506,5,395,17.0,127.0,127.0,5,1111,18.0,843.0,843.0
0.065,6,10,1506,5,395,14.0,127.0,127.0,5,1111,14.0,843.0,843.0
0.005,6,10,2007,5,928,1.0,660.0,660.0,5,1079,1.0,811.0,811.0
0.007,6,10,1547,5,764,1.0,496.0,496.0,5,783,1.0,515.0,515.0
0.129,17,2,136,1,60,0.0,32.0,32.0,1,76,0.0,48.0,48.0
0.03,17,2,148,1,60,0.0,32.0,32.0,1,88,0.0,60.0,60.0
0.006,17,2,136,1,60,0.0,32.0,32.0,1,76,0.0,48.0,48.0
0.018,6,10,1989,5,910,4.0,642.0,642.0,5,1079,4.0,811.0,811.0
0.005,6,10,2006,5,927,1.0,659.0,659.0,5,1079,1.0,811.0,811.0
0.083,6,10,1506,5,395,19.0,127.0,127.0,5,1111,17.0,843.0,843.0
15.07,17,15,9238,8,6902,2148.0,1350.0,834.0,7,2336,2506.0,1350.0,305.0
0.07,6,10,1506,5,395,15.0,127.0,127.0,5,1111,16.0,843.0,843.0
0.005,6,10,1774,5,923,1.0,655.0,655.0,5,851,1.0,583.0,583.0
0.183,17,4,580,2,122,110.0,33.0,33.0,2,458,179.0,307.0,201.0
0.017,6,10,1972,5,910,4.0,642.0,642.0,5,1062,4.0,794.0,794.0
61.106,6,43,18125,22,12487,428.0,2720.0,1446.0,21,5638,3047.0,2667.0,435.0
0.006,6,10,1547,5,764,1.0,496.0,496.0,5,783,1.0,515.0,515.0
0.068,6,10,1506,5,395,14.0,127.0,127.0,5,1111,14.0,843.0,843.0
0.103,6,10,1506,5,395,24.0,127.0,127.0,5,1111,20.0,843.0,843.0
0.009,6,10,1689,5,839,2.0,571.0,571.0,5,850,2.0,582.0,582.0
0.005,6,10,1989,5,927,1.0,659.0,659.0,5,1062,1.0,794.0,794.0
0.127,6,10,1506,5,395,30.0,127.0,127.0,5,1111,31.0,843.0,843.0
0.016,6,10,1983,5,910,4.0,642.0,642.0,5,1073,4.0,805.0,805.0
0.005,6,10,2007,5,928,1.0,660.0,660.0,5,1079,1.0,811.0,811.0
0.008,17,2,179,1,71,0.0,43.0,43.0,1,108,0.0,80.0,80.0
0.06,17,2,152,1,76,0.0,48.0,48.0,1,76,0.0,48.0,48.0
0.005,6,10,1643,5,860,1.0,592.0,592.0,5,783,1.0,515.0,515.0
0.006,6,10,2006,5,927,1.0,659.0,659.0,5,1079,1.0,811.0,811.0
0.008,6,13,3735,7,497,1.0,125.0,125.0,6,3238,1.0,1470.0,1459.0
0.011,6,10,1972,5,910,2.0,642.0,642.0,5,1062,2.0,794.0,794.0
0.004,17,2,148,1,60,0.0,32.0,32.0,1,88,0.0,60.0,60.0
240.15,6,30,9230,15,6806,17153.0,1930.0,670.0,15,2424,17153.0,580.0,233.0
0.077,6,10,1506,5,395,18.0,127.0,127.0,5,1111,14.0,843.0,843.0
0.007,6,10,1983,5,910,1.0,642.0,642.0,5,1073,1.0,805.0,805.0
0.103,17,2,144,1,64,0.0,36.0,36.0,1,80,0.0,52.0,52.0
11.098,17,28,4398,14,2312,844.0,587.0,137.0,14,2086,844.0,269.0,121.0
0.009,6,10,1989,5,910,2.0,642.0,642.0,5,1079,2.0,811.0,811.0
40.057,17,10,676,5,460,10013.0,104.0,64.0,5,216,10012.0,20.0,15.0
0.013,6,10,1990,5,911,3.0,643.0,643.0,5,1079,3.0,811.0,811.0
0.017,6,13,3735,7,497,2.0,125.0,125.0,6,3238,3.0,1470.0,1459.0
0.067,17,8,3613,4,1874,22.0,1350.0,440.0,4,1739,11.0,1350.0,406.0
0.004,6,10,2006,5,927,1.0,659.0,659.0,5,1079,1.0,811.0,811.0
0.006,6,10,1547,5,764,1.0,496.0,496.0,5,783,1.0,515.0,515.0
0.012,6,13,3735,7,497,2.0,125.0,125.0,6,3238,2.0,1470.0,1459.0
0.006,6,10,2007,5,928,1.0,660.0,660.0,5,1079,1.0,811.0,811.0
0.016,6,13,3735,7,497,2.0,125.0,125.0,6,3238,3.0,1470.0,1459.0
0.005,6,10,1774,5,923,1.0,655.0,655.0,5,851,1.0,583.0,583.0
1771.622,17,120,11460,60,5460,30027.0,63.0,63.0,60,6000,30027.0,72.0,72.0
0.001,17,2,180,1,66,0.0,38.0,38.0,1,114,0.0,86.0,86.0
0.35,17,43,23065,24,19853,15.0,1350.0,799.0,19,3212,16.0,1350.0,141.0
0.016,6,20,9974,11,704,1.0,124.0,124.0,9,9270,2.0,2896.0,1758.0
40.058,17,10,676,5,460,10013.0,104.0,64.0,5,216,10013.0,20.0,15.0
0.014,6,10,1983,5,910,3.0,642.0,642.0,5,1073,3.0,805.0,805.0
0.005,6,10,2006,5,927,1.0,659.0,659.0,5,1079,1.0,811.0,811.0
0.014,6,10,1989,5,910,3.0,642.0,642.0,5,1079,3.0,811.0,811.0
0.015,6,10,1983,5,910,3.0,642.0,642.0,5,1073,3.0,805.0,805.0
0.001,17,2,180,1,66,0.0,38.0,38.0,1,114,0.0,86.0,86.0
0.005,6,10,1989,5,927,1.0,659.0,659.0,5,1062,1.0,794.0,794.0
0.005,6,10,2006,5,927,1.0,659.0,659.0,5,1079,1.0,811.0,811.0
0.005,6,10,1689,5,839,1.0,571.0,571.0,5,850,1.0,582.0,582.0
0.115,6,10,1506,5,395,24.0,127.0,127.0,5,1111,24.0,843.0,843.0
0.007,17,2,194,1,59,0.0,31.0,31.0,1,135,0.0,107.0,107.0
0.012,6,10,1983,5,910,3.0,642.0,642.0,5,1073,2.0,805.0,805.0
0.068,6,10,1506,5,395,14.0,127.0,127.0,5,1111,15.0,843.0,843.0
0.005,6,10,1779,5,928,1.0,660.0,660.0,5,851,1.0,583.0,583.0
0.006,17,2,170,1,65,0.0,37.0,37.0,1,105,0.0,77.0,77.0
0.001,17,2,180,1,66,0.0,38.0,38.0,1,114,0.0,86.0,86.0
240.019,6,9,787,5,488,60004.0,232.0,232.0,4,299,80005.0,83.0,83.0
0.012,6,10,1989,5,910,2.0,642.0,642.0,5,1079,3.0,811.0,811.0
0.001,17,2,180,1,66,0.0,38.0,38.0,1,114,0.0,86.0,86.0
0.009,6,10,1972,5,910,2.0,642.0,642.0,5,1062,2.0,794.0,794.0
0.007,6,10,1762,5,911,1.0,643.0,643.0,5,851,1.0,583.0,583.0
0.006,17,2,248,1,58,0.0,30.0,30.0,1,190,0.0,162.0,162.0
309.426,17,20,1124,10,716,34365.0,48.0,43.0,10,408,34365.0,20.0,12.0
40.051,17,10,676,5,460,10011.0,104.0,64.0,5,216,10011.0,20.0,15.0
0.053,17,2,152,1,76,0.0,48.0,48.0,1,76,0.0,48.0,48.0
0.024,6,10,1990,5,911,6.0,643.0,643.0,5,1079,6.0,811.0,811.0
0.003,17,2,148,1,60,0.0,32.0,32.0,1,88,0.0,60.0,60.0
0.007,17,2,222,1,65,0.0,37.0,37.0,1,157,0.0,129.0,129.0
0.005,6,10,1547,5,764,1.0,496.0,496.0,5,783,1.0,515.0,515.0
0.008,6,10,1779,5,928,1.0,660.0,660.0,5,851,2.0,583.0,583.0
0.038,17,2,152,1,76,0.0,48.0,48.0,1,76,0.0,48.0,48.0
0.184,17,4,352,2,130,144.0,37.0,37.0,2,222,144.0,89.0,83.0
11.247,17,28,4421,14,1993,852.0,268.0,114.0,14,2428,852.0,587.0,145.0
0.012,6,10,1990,5,911,3.0,643.0,643.0,5,1079,3.0,811.0,811.0
0.014,6,10,1677,5,827,3.0,559.0,559.0,5,850,3.0,582.0,582.0
0.005,17,2,212,1,74,0.0,46.0,46.0,1,138,0.0,110.0,110.0
0.006,17,2,146,1,65,0.0,37.0,37.0,1,81,0.0,53.0,53.0
0.019,6,10,1990,5,911,4.0,643.0,643.0,5,1079,4.0,811.0,811.0
0.005,17,2,166,1,75,0.0,47.0,47.0,1,91,0.0,63.0,63.0
0.067,6,10,1506,5,395,16.0,127.0,127.0,5,1111,14.0,843.0,843.0
40.07,17,10,676,5,460,10014.0,104.0,64.0,5,216,10016.0,20.0,15.0
0.08,6,10,1506,5,395,16.0,127.0,127.0,5,1111,17.0,843.0,843.0
160.59,17,76,10718,38,2537,4340.0,44.0,38.0,38,8181,4340.0,239.0,187.0
0.01,6,10,1989,5,910,2.0,642.0,642.0,5,1079,2.0,811.0,811.0
0.004,6,10,1779,5,928,1.0,660.0,660.0,5,851,1.0,583.0,583.0
40.064,17,10,676,5,460,10012.0,104.0,64.0,5,216,10015.0,20.0,15.0
0.005,17,2,164,1,74,0.0,46.0,46.0,1,90,0.0,62.0,62.0
0.003,17,4,284,2,120,0.0,32.0,32.0,2,164,0.0,60.0,54.0
0.08,6,10,1506,5,395,15.0,127.0,127.0,5,1111,19.0,843.0,843.0
0.005,6,10,1689,5,839,1.0,571.0,571.0,5,850,1.0,582.0,582.0
9.038,17,6,376,5,280,2259.0,28.0,28.0,1,96,0.0,68.0,68.0
0.002,17,2,136,1,60,0.0,32.0,32.0,1,76,0.0,48.0,48.0
0.005,17,2,140,1,62,0.0,34.0,34.0,1,78,0.0,50.0,50.0
0.074,6,10,1506,5,395,16.0,127.0,127.0,5,1111,16.0,843.0,843.0
0.006,6,10,1547,5,764,1.0,496.0,496.0,5,783,1.0,515.0,515.0
0.029,6,10,1972,5,910,7.0,642.0,642.0,5,1062,7.0,794.0,794.0
0.137,17,2,152,1,76,0.0,48.0,48.0,1,76,0.0,48.0,48.0
0.083,6,10,1506,5,395,17.0,127.0,127.0,5,1111,18.0,843.0,843.0
40.061,17,10,676,5,460,10014.0,104.0,64.0,5,216,10013.0,20.0,15.0
0.006,17,2,225,1,65,0.0,37.0,37.0,1,160,0.0,132.0,132.0
0.005,6,10,2000,5,927,1.0,659.0,659.0,5,1073,1.0,805.0,805.0
0.005,6,10,2007,5,928,1.0,660.0,660.0,5,1079,1.0,811.0,811.0
0.006,6,10,1774,5,923,1.0,655.0,655.0,5,851,1.0,583.0,583.0
0.092,6,10,1506,5,395,20.0,127.0,127.0,5,1111,20.0,843.0,843.0
0.168,17,2,152,1,76,0.0,48.0,48.0,1,76,0.0,48.0,48.0
0.008,17,2,132,1,58,0.0,30.0,30.0,1,74,0.0,46.0,46.0
0.038,17,2,148,1,60,0.0,32.0,32.0,1,88,0.0,60.0,60.0
240.142,6,31,9242,15,6817,17153.0,1942.0,671.0,16,2425,16009.0,580.0,198.0
0.005,6,10,2007,5,928,1.0,660.0,660.0,5,1079,1.0,811.0,811.0
0.005,6,10,1689,5,839,1.0,571.0,571.0,5,850,1.0,582.0,582.0
0.005,6,10,1689,5,839,1.0,571.0,571.0,5,850,1.0,582.0,582.0
0.004,17,2,175,1,65,0.0,37.0,37.0,1,110,0.0,82.0,82.0
0.132,17,4,284,2,120,1.0,32.0,32.0,2,164,128.0,60.0,54.0
0.004,6,10,2000,5,927,1.0,659.0,659.0,5,1073,1.0,805.0,805.0
0.016,6,10,1989,5,910,4.0,642.0,642.0,5,1079,3.0,811.0,811.0
0.112,6,10,1506,5,395,24.0,127.0,127.0,5,1111,24.0,843.0,843.0
40.061,17,10,676,5,460,10012.0,104.0,64.0,5,216,10014.0,20.0,15.0
0.01,6,10,1989,5,910,2.0,642.0,642.0,5,1079,2.0,811.0,811.0
0.01,6,10,1983,5,910,2.0,642.0,642.0,5,1073,2.0,805.0,805.0
0.162,6,10,1506,5,395,36.0,127.0,127.0,5,1111,33.0,843.0,843.0
0.071,6,10,1506,5,395,17.0,127.0,127.0,5,1111,14.0,843.0,843.0
0.004,17,4,284,2,120,0.0,32.0,32.0,2,164,0.0,60.0,54.0
0.004,17,2,136,1,60,0.0,32.0,32.0,1,76,0.0,48.0,48.0
0.114,6,10,1506,5,395,27.0,127.0,127.0,5,1111,28.0,843.0,843.0
0.084,6,10,1506,5,395,16.0,127.0,127.0,5,1111,18.0,843.0,843.0
0.011,6,10,1989,5,910,2.0,642.0,642.0,5,1079,2.0,811.0,811.0
0.006,17,2,179,1,71,0.0,43.0,43.0,1,108,0.0,80.0,80.0
10.927,17,28,4423,14,1995,832.0,270.0,114.0,14,2428,832.0,587.0,145.0
0.08,6,10,1506,5,395,17.0,127.0,127.0,5,1111,16.0,843.0,843.0
0.012,6,10,1990,5,911,3.0,643.0,643.0,5,1079,2.0,811.0,811.0
15.213,17,23,13644,13,11158,1265.0,1350.0,830.0,10,2486,1689.0,1350.0,220.0
0.068,6,10,1506,5,395,15.0,127.0,127.0,5,1111,15.0,843.0,843.0
0.005,6,13,3690,7,452,0.0,80.0,80.0,6,3238,1.0,1470.0,1459.0
0.008,6,12,1926,6,1189,1.0,659.0,434.0,6,737,1.0,417.0,417.0
0.004,6,10,1774,5,923,1.0,655.0,655.0,5,851,1.0,583.0,583.0
0.01,6,12,1926,6,1189,2.0,659.0,434.0,6,737,2.0,417.0,417.0
0.031,6,10,1989,5,910,7.0,642.0,642.0,5,1079,7.0,811.0,811.0
178.313,17,84,11928,42,2826,4349.0,44.0,39.0,42,9102,4349.0,239.0,188.0
172.152,17,80,11489,40,2673,4414.0,44.0,38.0,40,8816,4414.0,261.0,192.0
0.096,6,10,1506,5,395,21.0,127.0,127.0,5,1111,22.0,843.0,843.0
0.013,6,10,1989,5,910,3.0,642.0,642.0,5,1079,3.0,811.0,811.0
0.005,17,2,164,1,74,0.0,46.0,46.0,1,90,0.0,62.0,62.0
0.017,6,10,1989,5,910,4.0,642.0,642.0,5,1079,4.0,811.0,811.0
15.162,17,16,8370,8,6289,2155.0,1350.0,758.0,8,2081,2156.0,1350.0,232.0
0.026,6,10,1989,5,910,6.0,642.0,642.0,5,1079,6.0,811.0,811.0
0.053,17,2,152,1,76,0.0,48.0,48.0,1,76,0.0,48.0,48.0
0.005,6,10,2006,5,927,1.0,659.0,659.0,5,1079,1.0,811.0,811.0
0.005,6,10,1774,5,923,1.0,655.0,655.0,5,851,1.0,583.0,583.0
0.04,17,2,170,1,65,0.0,37.0,37.0,1,105,0.0,77.0,77.0
0.004,6,10,1774,5,923,1.0,655.0,655.0,5,851,1.0,583.0,583.0
40.056,17,10,676,5,460,10013.0,104.0,64.0,5,216,10013.0,20.0,15.0
0.01,6,10,1989,5,910,2.0,642.0,642.0,5,1079,2.0,811.0,811.0
0.005,6,10,1689,5,839,1.0,571.0,571.0,5,850,1.0,582.0,582.0
0.006,17,2,170,1,65,0.0,37.0,37.0,1,105,0.0,77.0,77.0
0.005,6,10,1547,5,764,1.0,496.0,496.0,5,783,1.0,515.0,515.0
300.361,6,17,2222,10,736,33354.0,146.0,146.0,7,1486,50032.0,419.0,398.0
0.073,6,10,1506,5,395,15.0,127.0,127.0,5,1111,17.0,843.0,843.0
0.081,6,10,1506,5,395,19.0,127.0,127.0,5,1111,17.0,843.0,843.0
0.246,6,16,2778,8,1396,35.0,533.0,324.0,8,1382,23.0,529.0,239.0
0.075,6,10,1506,5,395,16.0,127.0,127.0,5,1111,16.0,843.0,843.0
0.037,17,2,146,1,65,0.0,37.0,37.0,1,81,0.0,53.0,53.0
0.006,6,10,1689,5,839,1.0,571.0,571.0,5,850,1.0,582.0,582.0
308.52,17,20,1124,10,716,34266.0,48.0,43.0,10,408,34266.0,20.0,12.0
240.094,6,16,4482,9,963,30011.0,238.0,166.0,7,3519,40015.0,1402.0,786.0
0.005,6,10,2006,5,927,1.0,659.0,659.0,5,1079,1.0,811.0,811.0
0.005,6,10,2006,5,927,1.0,659.0,659.0,5,1079,1.0,811.0,811.0
0.001,17,2,180,1,66,0.0,38.0,38.0,1,114,0.0,86.0,86.0
0.038,17,2,148,1,60,0.0,32.0,32.0,1,88,0.0,60.0,60.0
0.016,6,10,1972,5,910,4.0,642.0,642.0,5,1062,3.0,794.0,794.0
0.006,6,10,1547,5,764,1.0,496.0,496.0,5,783,1.0,515.0,515.0
40.062,17,10,676,5,460,10013.0,104.0,64.0,5,216,10014.0,20.0,15.0
0.042,17,2,144,1,64,0.0,36.0,36.0,1,80,0.0,52.0,52.0
0.007,17,2,136,1,60,0.0,32.0,32.0,1,76,0.0,48.0,48.0
0.01,6,10,1989,5,910,2.0,642.0,642.0,5,1079,2.0,811.0,811.0
0.003,17,2,142,1,63,0.0,35.0,35.0,1,79,0.0,51.0,51.0
0.109,6,10,1506,5,395,26.0,127.0,127.0,5,1111,24.0,843.0,843.0
0.008,6,12,1926,6,1189,1.0,659.0,434.0,6,737,1.0,417.0,417.0
300.44,6,16,2170,9,684,37534.0,146.0,146.0,7,1486,50045.0,419.0,398.0
0.004,17,2,148,1,60,0.0,32.0,32.0,1,88,0.0,60.0,60.0
0.009,6,10,1677,5,827,2.0,559.0,559.0,5,850,2.0,582.0,582.0
0.097,6,10,1506,5,395,22.0,127.0,127.0,5,1111,18.0,843.0,843.0
0.075,6,10,1506,5,395,16.0,127.0,127.0,5,1111,18.0,843.0,843.0
0.005,17,2,247,1,72,0.0,44.0,44.0,1,175,0.0,147.0,147.0
10.734,17,28,4422,14,1994,817.0,269.0,114.0,14,2428,817.0,587.0,145.0
0.124,6,10,1506,5,395,29.0,127.0,127.0,5,1111,27.0,843.0,843.0
417.119,6,47,8807,24,6690,5409.0,494.0,494.0,23,2117,18959.0,83.0,83.0
0.005,17,2,160,1,72,0.0,44.0,44.0,1,88,0.0,60.0,60.0
0.005,6,10,1989,5,927,1.0,659.0,659.0,5,1062,1.0,794.0,794.0
0.006,6,10,1547,5,764,1.0,496.0,496.0,5,783,1.0,515.0,515.0
300.332,6,16,2170,9,684,37521.0,146.0,146.0,7,1486,50028.0,419.0,398.0
0.019,6,10,1990,5,911,4.0,643.0,643.0,5,1079,4.0,811.0,811.0
240.073,6,22,4977,12,993,21824.0,180.0,93.0,10,3984,26674.0,1592.0,576.0
0.005,6,10,1989,5,927,1.0,659.0,659.0,5,1062,1.0,794.0,794.0
0.015,6,10,1972,5,910,3.0,642.0,642.0,5,1062,3.0,794.0,794.0
0.096,6,10,1506,5,395,20.0,127.0,127.0,5,1111,22.0,843.0,843.0
0.008,17,2,179,1,71,0.0,43.0,43.0,1,108,0.0,80.0,80.0
0.001,17,2,180,1,66,0.0,38.0,38.0,1,114,0.0,86.0,86.0
0.018,6,10,1983,5,910,4.0,642.0,642.0,5,1073,4.0,805.0,805.0
0.004,6,10,2006,5,927,1.0,659.0,659.0,5,1079,1.0,811.0,811.0
0.074,6,10,1506,5,395,17.0,127.0,127.0,5,1111,15.0,843.0,843.0
0.006,17,2,170,1,65,0.0,37.0,37.0,1,105,0.0,77.0,77.0
0.033,6,10,1677,5,827,8.0,559.0,559.0,5,850,8.0,582.0,582.0
0.006,17,2,179,1,71,0.0,43.0,43.0,1,108,0.0,80.0,80.0
0.005,6,10,2000,5,927,1.0,659.0,659.0,5,1073,1.0,805.0,805.0
15.076,17,15,9239,8,6902,2149.0,1350.0,834.0,7,2337,2507.0,1350.0,305.0
0.004,6,10,1702,5,863,1.0,595.0,595.0,5,839,0.0,571.0,571.0
0.076,6,10,1506,5,395,16.0,127.0,127.0,5,1111,17.0,843.0,843.0
0.001,17,2,136,1,60,0.0,32.0,32.0,1,76,0.0,48.0,48.0
0.106,6,10,1506,5,395,21.0,127.0,127.0,5,1111,21.0,843.0,843.0
0.022,6,10,1983,5,910,5.0,642.0,642.0,5,1073,5.0,805.0,805.0
0.077,17,2,136,1,60,0.0,32.0,32.0,1,76,0.0,48.0,48.0
0.008,6,10,1762,5,911,1.0,643.0,643.0,5,851,1.0,583.0,583.0
40.062,17,10,676,5,460,10014.0,104.0,64.0,5,216,10014.0,20.0,15.0
0.005,6,10,1989,5,927,1.0,659.0,659.0,5,1062,1.0,794.0,794.0
0.001,17,2,166,1,75,0.0,47.0,47.0,1,91,0.0,63.0,63.0
0.002,17,2,148,1,60,0.0,32.0,32.0,1,88,0.0,60.0,60.0
0.001,17,2,166,1,75,0.0,47.0,47.0,1,91,0.0,63.0,63.0
0.09,6,10,1506,5,395,20.0,127.0,127.0,5,1111,18.0,843.0,843.0
240.485,6,37,9697,19,2175,13359.0,747.0,235.0,18,7522,14146.0,1402.0,599.0
0.008,6,10,1779,5,928,1.0,660.0,660.0,5,851,2.0,583.0,583.0
0.123,6,10,1506,5,395,28.0,127.0,127.0,5,1111,25.0,843.0,843.0
0.099,6,10,1506,5,395,20.0,127.0,127.0,5,1111,21.0,843.0,843.0
0.005,6,10,2007,5,928,1.0,660.0,660.0,5,1079,1.0,811.0,811.0
0.03,17,2,136,1,60,0.0,32.0,32.0,1,76,0.0,48.0,48.0
0.014,6,10,1989,5,910,3.0,642.0,642.0,5,1079,3.0,811.0,811.0
0.004,6,10,2006,5,927,1.0,659.0,659.0,5,1079,1.0,811.0,811.0
0.073,6,10,1506,5,395,14.0,127.0,127.0,5,1111,17.0,843.0,843.0
0.1,6,10,1506,5,395,20.0,127.0,127.0,5,1111,21.0,843.0,843.0
0.017,6,10,1631,5,848,4.0,580.0,580.0,5,783,4.0,515.0,515.0
0.01,6,10,1677,5,827,2.0,559.0,559.0,5,850,2.0,582.0,582.0
0.058,6,10,1506,5,395,13.0,127.0,127.0,5,1111,13.0,843.0,843.0
0.006,6,10,1854,5,889,1.0,621.0,621.0,5,965,1.0,697.0,697.0
0.011,6,10,1990,5,911,2.0,643.0,643.0,5,1079,2.0,811.0,811.0
0.005,6,10,1689,5,839,1.0,571.0,571.0,5,850,1.0,582.0,582.0
178.065,17,78,11111,39,2609,4685.0,44.0,38.0,39,8502,4685.0,260.0,190.0
0.008,6,14,3965,7,495,1.0,123.0,123.0,7,3470,1.0,1448.0,1032.0
0.087,6,10,1506,5,395,20.0,127.0,127.0,5,1111,17.0,843.0,843.0
0.005,6,13,3690,7,452,0.0,80.0,80.0,6,3238,1.0,1470.0,1459.0
167.277,17,78,11104,39,2602,4401.0,44.0,38.0,39,8502,4402.0,261.0,190.0
0.099,6,10,1506,5,395,24.0,127.0,127.0,5,1111,21.0,843.0,843.0
0.005,17,2,164,1,74,0.0,46.0,46.0,1,90,0.0,62.0,62.0
0.079,6,10,1506,5,395,18.0,127.0,127.0,5,1111,17.0,843.0,843.0
0.068,6,10,1506,5,395,16.0,127.0,127.0,5,1111,14.0,843.0,843.0
0.147,6,10,1506,5,395,32.0,127.0,127.0,5,1111,30.0,843.0,843.0
0.042,17,2,152,1,76,0.0,48.0,48.0,1,76,0.0,48.0,48.0
0.008,6,10,1989,5,910,1.0,642.0,642.0,5,1079,1.0,811.0,811.0
0.005,6,13,3747,7,509,0.0,137.0,137.0,6,3238,0.0,1470.0,1459.0
0.005,6,10,2000,5,927,1.0,659.0,659.0,5,1073,1.0,805.0,805.0
0.015,6,10,1972,5,910,3.0,642.0,642.0,5,1062,3.0,794.0,794.0
0.004,17,2,136,1,60,0.0,32.0,32.0,1,76,0.0,48.0,48.0
0.001,17,2,180,1,66,0.0,38.0,38.0,1,114,0.0,86.0,86.0
0.005,6,10,1989,5,927,1.0,659.0,659.0,5,1062,1.0,794.0,794.0
0.071,6,10,1506,5,395,16.0,127.0,127.0,5,1111,16.0,843.0,843.0
8.925,6,38,10447,19,4889,495.0,1360.0,682.0,19,5558,484.0,2667.0,435.0
5.121,6,23,6467,13,1827,426.0,801.0,282.0,10,4640,568.0,1925.0,824.0
0.01,6,14,3787,7,497,1.0,125.0,125.0,7,3290,1.0,1448.0,972.0
0.038,17,2,148,1,60,0.0,32.0,32.0,1,88,0.0,60.0,60.0
9.132,17,6,376,5,280,2283.0,28.0,28.0,1,96,0.0,68.0,68.0
0.098,6,10,1506,5,395,21.0,127.0,127.0,5,1111,23.0,843.0,843.0
0.017,6,10,1631,5,848,4.0,580.0,580.0,5,783,4.0,515.0,515.0
0.084,6,10,1506,5,395,18.0,127.0,127.0,5,1111,19.0,843.0,843.0
0.007,6,10,1643,5,860,1.0,592.0,592.0,5,783,1.0,515.0,515.0
0.005,6,10,2007,5,928,1.0,660.0,660.0,5,1079,1.0,811.0,811.0
0.004,6,10,1779,5,928,1.0,660.0,660.0,5,851,1.0,583.0,583.0
165.353,17,78,11202,39,2609,4351.0,44.0,38.0,39,8593,4351.0,261.0,192.0
0.003,17,2,136,1,60,0.0,32.0,32.0,1,76,0.0,48.0,48.0
0.005,6,10,2006,5,927,1.0,659.0,659.0,5,1079,1.0,811.0,811.0
0.006,17,2,179,1,71,0.0,43.0,43.0,1,108,0.0,80.0,80.0
0.005,6,10,1989,5,927,1.0,659.0,659.0,5,1062,1.0,794.0,794.0
0.023,6,10,1989,5,910,5.0,642.0,642.0,5,1079,5.0,811.0,811.0
0.005,6,10,1689,5,839,1.0,571.0,571.0,5,850,1.0,582.0,582.0
0.005,6,10,2000,5,927,1.0,659.0,659.0,5,1073,1.0,805.0,805.0
0.015,6,10,1989,5,910,3.0,642.0,642.0,5,1079,3.0,811.0,811.0
0.005,6,10,1689,5,839,1.0,571.0,571.0,5,850,1.0,582.0,582.0
0.004,17,2,148,1,60,0.0,32.0,32.0,1,88,0.0,60.0,60.0
0.008,6,10,1990,5,911,2.0,643.0,643.0,5,1079,1.0,811.0,811.0
15.078,17,14,7459,7,5403,2508.0,1350.0,743.0,7,2056,2508.0,1350.0,265.0
0.005,6,10,1989,5,927,1.0,659.0,659.0,5,1062,1.0,794.0,794.0
300.993,6,44,14787,23,8920,13681.0,3259.0,1138.0,21,5867,441.0,2667.0,385.0
0.015,6,10,1989,5,910,3.0,642.0,642.0,5,1079,3.0,811.0,811.0
40.056,17,10,676,5,460,10013.0,104.0,64.0,5,216,10012.0,20.0,15.0
0.004,6,10,1702,5,863,1.0,595.0,595.0,5,839,1.0,571.0,571.0
0.003,17,4,284,2,120,0.0,32.0,32.0,2,164,0.0,60.0,54.0
0.006,6,10,1854,5,889,1.0,621.0,621.0,5,965,1.0,697.0,697.0
0.004,17,4,284,2,120,0.0,32.0,32.0,2,164,0.0,60.0,54.0
0.025,6,10,1990,5,911,6.0,643.0,643.0,5,1079,6.0,811.0,811.0
0.005,6,10,2007,5,928,1.0,660.0,660.0,5,1079,1.0,811.0,811.0
0.015,6,10,1631,5,848,3.0,580.0,580.0,5,783,3.0,515.0,515.0
0.006,6,10,1547,5,764,1.0,496.0,496.0,5,783,1.0,515.0,515.0
0.015,6,10,1990,5,911,3.0,643.0,643.0,5,1079,3.0,811.0,811.0
0.004,6,10,1774,5,923,1.0,655.0,655.0,5,851,1.0,583.0,583.0
0.013,17,2,152,1,56,0.0,28.0,28.0,1,96,0.0,68.0,68.0
0.005,6,10,1989,5,927,1.0,659.0,659.0,5,1062,1.0,794.0,794.0
0.005,17,2,170,1,65,0.0,37.0,37.0,1,105,0.0,77.0,77.0
293.087,6,378,347370,192,21549,1534.0,2736.0,889.0,186,325821,1584.0,2804.0,1838.0
240.012,6,9,787,5,488,60003.0,232.0,232.0,4,299,80003.0,83.0,83.0
0.105,6,10,690,6,391,21.0,71.0,71.0,4,299,33.0,83.0,83.0
0.006,6,12,1698,6,863,1.0,327.0,271.0,6,835,1.0,515.0,515.0
0.005,6,10,1547,5,764,1.0,496.0,496.0,5,783,1.0,515.0,515.0
0.103,6,10,1506,5,395,22.0,127.0,127.0,5,1111,23.0,843.0,843.0
0.005,6,10,2006,5,927,1.0,659.0,659.0,5,1079,1.0,811.0,811.0
0.005,6,10,1989,5,927,1.0,659.0,659.0,5,1062,1.0,794.0,794.0
0.007,17,2,179,1,71,0.0,43.0,43.0,1,108,0.0,80.0,80.0
0.335,17,52,30914,30,27649,11.0,1350.0,893.0,22,3265,13.0,1350.0,120.0
0.093,6,10,1506,5,395,20.0,127.0,127.0,5,1111,19.0,843.0,843.0
0.005,6,10,1854,5,889,1.0,621.0,621.0,5,965,1.0,697.0,697.0
1730.372,6,45,2790,30,1725,59668.0,35.0,35.0,15,1065,123592.0,31.0,31.0
0.011,6,10,1677,5,827,2.0,559.0,559.0,5,850,2.0,582.0,582.0
0.006,6,10,1989,5,927,1.0,659.0,659.0,5,1062,1.0,794.0,794.0
0.006,6,10,1547,5,764,1.0,496.0,496.0,5,783,1.0,515.0,515.0
0.005,6,10,2006,5,927,1.0,659.0,659.0,5,1079,1.0,811.0,811.0
0.006,6,10,1989,5,927,1.0,659.0,659.0,5,1062,1.0,794.0,794.0
0.013,6,10,1983,5,910,3.0,642.0,642.0,5,1073,3.0,805.0,805.0
0.001,17,2,154,1,69,0.0,41.0,41.0,1,85,0.0,57.0,57.0
0.004,6,10,2007,5,928,1.0,660.0,660.0,5,1079,1.0,811.0,811.0
0.012,6,10,1989,5,910,3.0,642.0,642.0,5,1079,3.0,811.0,811.0
353.545,6,20,2210,6,1308,12004.0,494.0,494.0,14,902,27195.0,83.0,83.0
354.007,6,21,1795,16,1030,23600.0,190.0,190.0,5,765,60002.0,464.0,248.0
0.004,6,10,2007,5,928,1.0,660.0,660.0,5,1079,1.0,811.0,811.0
0.005,6,10,1774,5,923,1.0,655.0,655.0,5,851,1.0,583.0,583.0
0.004,6,10,2007,5,928,1.0,660.0,660.0,5,1079,1.0,811.0,811.0
0.004,17,2,148,1,60,0.0,32.0,32.0,1,88,0.0,60.0,60.0
0.075,6,10,1506,5,395,16.0,127.0,127.0,5,1111,15.0,843.0,843.0
0.005,6,10,2000,5,927,1.0,659.0,659.0,5,1073,1.0,805.0,805.0
0.006,6,10,1689,5,839,1.0,571.0,571.0,5,850,1.0,582.0,582.0
0.125,6,10,1506,5,395,28.0,127.0,127.0,5,1111,27.0,843.0,843.0
11.207,17,28,4391,14,2313,853.0,588.0,137.0,14,2078,853.0,269.0,120.0
40.058,17,10,676,5,460,10013.0,104.0,64.0,5,216,10014.0,20.0,15.0
281.112,6,27,8344,10,2204,31234.0,1496.0,562.0,17,6140,17568.0,2804.0,476.0
0.009,6,10,2006,5,927,2.0,659.0,659.0,5,1079,2.0,811.0,811.0
240.088,6,33,9529,17,7156,15005.0,1515.0,627.0,16,2373,16005.0,580.0,191.0
0.01,6,10,1972,5,910,2.0,642.0,642.0,5,1062,2.0,794.0,794.0
0.01,6,10,1972,5,910,2.0,642.0,642.0,5,1062,2.0,794.0,794.0
11.043,17,28,4399,14,2313,840.0,588.0,137.0,14,2086,840.0,269.0,121.0
0.01,6,10,1762,5,911,2.0,643.0,643.0,5,851,2.0,583.0,583.0
0.015,17,2,180,1,66,0.0,38.0,38.0,1,114,0.0,86.0,86.0
308.378,17,20,1124,10,716,34255.0,48.0,43.0,10,408,34257.0,20.0,12.0
40.088,17,10,676,5,460,10015.0,104.0,64.0,5,216,10020.0,20.0,15.0
0.018,6,10,1983,5,910,4.0,642.0,642.0,5,1073,4.0,805.0,805.0
0.095,6,10,1506,5,395,22.0,127.0,127.0,5,1111,20.0,843.0,843.0
40.069,17,10,676,5,460,10014.0,104.0,64.0,5,216,10009.0,20.0,15.0
0.004,17,2,148,1,60,0.0,32.0,32.0,1,88,0.0,60.0,60.0
0.001,17,2,136,1,60,0.0,32.0,32.0,1,76,0.0,48.0,48.0
0.005,6,10,1779,5,928,1.0,660.0,660.0,5,851,1.0,583.0,583.0
0.012,6,10,1972,5,910,3.0,642.0,642.0,5,1062,2.0,794.0,794.0
0.092,6,10,1506,5,395,20.0,127.0,127.0,5,1111,20.0,843.0,843.0
0.005,6,10,2007,5,928,1.0,660.0,660.0,5,1079,1.0,811.0,811.0
0.12,6,10,1506,5,395,28.0,127.0,127.0,5,1111,28.0,843.0,843.0
0.013,6,10,1989,5,910,3.0,642.0,642.0,5,1079,3.0,811.0,811.0
0.061,6,10,1506,5,395,13.0,127.0,127.0,5,1111,14.0,843.0,843.0
40.095,17,10,676,5,460,10016.0,104.0,64.0,5,216,10022.0,20.0,15.0
0.006,6,10,1547,5,764,1.0,496.0,496.0,5,783,1.0,515.0,515.0
0.003,17,2,136,1,60,0.0,32.0,32.0,1,76,0.0,48.0,48.0
0.005,6,10,2006,5,927,1.0,659.0,659.0,5,1079,1.0,811.0,811.0
0.005,6,10,1643,5,860,1.0,592.0,592.0,5,783,1.0,515.0,515.0
0.008,6,12,1926,6,1189,1.0,659.0,434.0,6,737,1.0,417.0,417.0
240.012,6,9,787,5,488,60003.0,232.0,232.0,4,299,80003.0,83.0,83.0
0.083,6,10,1506,5,395,20.0,127.0,127.0,5,1111,17.0,843.0,843.0
0.2,6,10,1506,5,395,45.0,127.0,127.0,5,1111,47.0,843.0,843.0
0.005,6,10,2006,5,927,1.0,659.0,659.0,5,1079,1.0,811.0,811.0
0.09,6,10,1506,5,395,17.0,127.0,127.0,5,1111,21.0,843.0,843.0
0.004,17,2,136,1,60,0.0,32.0,32.0,1,76,0.0,48.0,48.0
0.012,6,10,1990,5,911,3.0,643.0,643.0,5,1079,3.0,811.0,811.0
1778.601,17,144,41760,72,22752,25050.0,288.0,288.0,72,19008,25050.0,236.0,236.0
0.007,6,10,1689,5,839,1.0,571.0,571.0,5,850,1.0,582.0,582.0
0.011,17,2,148,1,60,0.0,32.0,32.0,1,88,0.0,60.0,60.0
0.004,6,10,2006,5,927,1.0,659.0,659.0,5,1079,1.0,811.0,811.0
0.004,6,10,2000,5,927,1.0,659.0,659.0,5,1073,1.0,805.0,805.0
413.054,6,29,4409,12,3102,10914.0,494.0,494.0,17,1307,25815.0,83.0,83.0
0.002,17,2,166,1,75,0.0,47.0,47.0,1,91,0.0,63.0,63.0
0.003,17,2,136,1,60,0.0,32.0,32.0,1,76,0.0,48.0,48.0
0.056,6,10,1983,5,910,14.0,642.0,642.0,5,1073,14.0,805.0,805.0
0.005,6,10,2000,5,927,1.0,659.0,659.0,5,1073,1.0,805.0,805.0
0.013,6,10,1677,5,827,3.0,559.0,559.0,5,850,3.0,582.0,582.0
0.005,17,2,166,1,75,0.0,47.0,47.0,1,91,0.0,63.0,63.0
0.01,6,10,1972,5,910,2.0,642.0,642.0,5,1062,2.0,794.0,794.0
0.009,6,10,1989,5,910,2.0,642.0,642.0,5,1079,2.0,811.0,811.0
0.005,6,10,1774,5,923,1.0,655.0,655.0,5,851,1.0,583.0,583.0
0.077,6,10,1506,5,395,16.0,127.0,127.0,5,1111,17.0,843.0,843.0
0.128,6,10,1506,5,395,30.0,127.0,127.0,5,1111,25.0,843.0,843.0
0.006,6,10,1547,5,764,1.0,496.0,496.0,5,783,1.0,515.0,515.0
0.011,6,10,1972,5,910,2.0,642.0,642.0,5,1062,2.0,794.0,794.0
0.243,17,47,29372,27,23506,9.0,1350.0,842.0,20,5866,9.0,1350.0,265.0
0.122,6,10,1506,5,395,26.0,127.0,127.0,5,1111,25.0,843.0,843.0
11.048,17,28,4398,14,2312,841.0,587.0,137.0,14,2086,840.0,269.0,121.0
0.015,6,10,1990,5,911,3.0,643.0,643.0,5,1079,3.0,811.0,811.0
0.004,17,2,152,1,76,0.0,48.0,48.0,1,76,0.0,48.0,48.0
0.006,17,2,238,1,66,0.0,38.0,38.0,1,172,0.0,144.0,144.0
368.802,6,22,2313,16,867,24586.0,195.0,195.0,6,1446,4689.0,419.0,398.0
0.069,17,8,3613,4,1874,23.0,1350.0,440.0,4,1739,12.0,1350.0,406.0
0.005,6,14,3736,7,446,0.0,74.0,74.0,7,3290,0.0,1448.0,972.0
0.008,6,10,1989,5,910,1.0,642.0,642.0,5,1079,2.0,811.0,811.0
0.005,6,10,2007,5,928,1.0,660.0,660.0,5,1079,1.0,811.0,811.0
154.741,6,22,8496,12,2236,74.0,1345.0,574.0,10,6260,17174.0,1776.0,974.0
0.005,6,14,3799,7,509,0.0,137.0,137.0,7,3290,0.0,1448.0,972.0
0.005,6,10,2007,5,928,1.0,660.0,660.0,5,1079,1.0,811.0,811.0
0.008,6,10,1989,5,910,2.0,642.0,642.0,5,1079,2.0,811.0,811.0
0.018,6,13,3816,7,578,3.0,206.0,206.0,6,3238,3.0,1470.0,1459.0
40.062,17,10,676,5,460,10014.0,104.0,64.0,5,216,10014.0,20.0,15.0
0.127,6,10,1506,5,395,16.0,127.0,127.0,5,1111,30.0,843.0,843.0
0.009,6,10,1983,5,910,2.0,642.0,642.0,5,1073,2.0,805.0,805.0
0.009,6,10,1989,5,910,2.0,642.0,642.0,5,1079,2.0,811.0,811.0
0.012,6,10,1989,5,910,3.0,642.0,642.0,5,1079,2.0,811.0,811.0
0.001,17,2,180,1,66,0.0,38.0,38.0,1,114,0.0,86.0,86.0
240.011,6,9,787,5,488,60002.0,232.0,232.0,4,299,80002.0,83.0,83.0
0.083,6,10,1506,5,395,18.0,127.0,127.0,5,1111,18.0,843.0,843.0
0.037,17,2,136,1,60,0.0,32.0,32.0,1,76,0.0,48.0,48.0
0.079,6,10,1506,5,395,15.0,127.0,127.0,5,1111,18.0,843.0,843.0
0.063,6,10,1506,5,395,13.0,127.0,127.0,5,1111,14.0,843.0,843.0
0.768,6,25,5459,12,1557,60.0,325.0,152.0,13,3902,54.0,1414.0,563.0
0.012,6,10,1983,5,910,3.0,642.0,642.0,5,1073,2.0,805.0,805.0
15.349,17,44,20724,23,17131,696.0,1350.0,716.0,21,3593,766.0,1350.0,143.0
0.004,6,10,1989,5,927,1.0,659.0,659.0,5,1062,1.0,794.0,794.0
0.005,6,13,3747,7,509,0.0,137.0,137.0,6,3238,0.0,1470.0,1459.0
0.004,6,10,1702,5,863,1.0,595.0,595.0,5,839,0.0,571.0,571.0
0.006,6,10,1547,5,764,1.0,496.0,496.0,5,783,1.0,515.0,515.0
34.773,6,36,8190,18,1719,516.0,651.0,322.0,18,6471,2037.0,2720.0,478.0
0.006,6,10,1547,5,764,1.0,496.0,496.0,5,783,1.0,515.0,515.0
0.078,6,10,1506,5,395,17.0,127.0,127.0,5,1111,17.0,843.0,843.0
0.235,17,16,8452,8,5955,33.0,1350.0,716.0,8,2497,25.0,1350.0,284.0
0.005,17,2,230,1,68,0.0,40.0,40.0,1,162,0.0,134.0,134.0
0.004,6,10,1702,5,863,1.0,595.0,595.0,5,839,0.0,571.0,571.0
0.009,6,10,1677,5,827,2.0,559.0,559.0,5,850,2.0,582.0,582.0
0.004,17,2,136,1,60,0.0,32.0,32.0,1,76,0.0,48.0,48.0
9.036,17,6,376,5,280,2259.0,28.0,28.0,1,96,0.0,68.0,68.0
0.006,17,2,140,1,62,0.0,34.0,34.0,1,78,0.0,50.0,50.0
0.069,17,8,3613,4,1874,23.0,1350.0,440.0,4,1739,12.0,1350.0,406.0
0.005,6,10,1989,5,927,1.0,659.0,659.0,5,1062,1.0,794.0,794.0
0.012,6,10,1762,5,911,2.0,643.0,643.0,5,851,2.0,583.0,583.0
0.119,6,10,1506,5,395,28.0,127.0,127.0,5,1111,28.0,843.0,843.0
0.009,6,10,1989,5,910,2.0,642.0,642.0,5,1079,2.0,811.0,811.0
0.005,6,10,2006,5,927,1.0,659.0,659.0,5,1079,1.0,811.0,811.0
240.015,6,9,787,5,488,60003.0,232.0,232.0,4,299,80004.0,83.0,83.0
0.008,17,2,253,1,65,0.0,37.0,37.0,1,188,0.0,160.0,160.0
0.009,6,10,1989,5,910,2.0,642.0,642.0,5,1079,2.0,811.0,811.0
0.089,6,10,1506,5,395,21.0,127.0,127.0,5,1111,20.0,843.0,843.0
396.385,6,39,14828,20,4039,20862.0,676.0,427.0,19,10789,18685.0,1402.0,890.0
0.015,17,2,136,1,60,0.0,32.0,32.0,1,76,0.0,48.0,48.0
10.782,17,28,4422,14,1993,820.0,268.0,114.0,14,2429,820.0,588.0,145.0
40.059,17,10,676,5,460,10013.0,104.0,64.0,5,216,10014.0,20.0,15.0
0.011,6,10,1989,5,910,2.0,642.0,642.0,5,1079,2.0,811.0,811.0
40.075,17,10,676,5,460,10016.0,104.0,64.0,5,216,10014.0,20.0,15.0
0.007,6,10,1547,5,764,1.0,496.0,496.0,5,783,1.0,515.0,515.0
0.111,6,10,1506,5,395,24.0,127.0,127.0,5,1111,24.0,843.0,843.0
0.004,6,10,2007,5,928,1.0,660.0,660.0,5,1079,1.0,811.0,811.0
0.095,6,10,1506,5,395,22.0,127.0,127.0,5,1111,23.0,843.0,843.0
308.957,17,20,1124,10,716,34313.0,48.0,43.0,10,408,34314.0,20.0,12.0
0.08,6,18,8119,10,808,8.0,280.0,280.0,8,7311,10.0,1402.0,1377.0
0.041,17,2,184,1,61,0.0,33.0,33.0,1,123,0.0,95.0,95.0
0.226,6,16,2777,8,1395,32.0,533.0,323.0,8,1382,20.0,529.0,239.0
0.006,6,10,1547,5,764,1.0,496.0,496.0,5,783,1.0,515.0,515.0
0.039,17,4,284,2,120,1.0,32.0,32.0,2,164,0.0,60.0,54.0
0.004,6,14,3742,8,504,0.0,80.0,80.0,6,3238,0.0,1470.0,1459.0
0.015,6,10,1989,5,910,3.0,642.0,642.0,5,1079,3.0,811.0,811.0
0.013,6,10,1989,5,910,3.0,642.0,642.0,5,1079,3.0,811.0,811.0
0.004,17,2,136,1,60,0.0,32.0,32.0,1,76,0.0,48.0,48.0
0.017,6,10,1762,5,911,4.0,643.0,643.0,5,851,4.0,583.0,583.0
0.008,6,12,1926,6,1189,1.0,659.0,434.0,6,737,1.0,417.0,417.0
0.008,6,10,1972,5,910,2.0,642.0,642.0,5,1062,2.0,794.0,794.0
9.038,17,6,376,5,280,2259.0,28.0,28.0,1,96,0.0,68.0,68.0
0.107,6,10,1506,5,395,22.0,127.0,127.0,5,1111,19.0,843.0,843.0
0.006,6,10,1547,5,764,1.0,496.0,496.0,5,783,1.0,515.0,515.0
0.004,6,10,1702,5,863,1.0,595.0,595.0,5,839,0.0,571.0,571.0
0.004,6,10,2006,5,927,1.0,659.0,659.0,5,1079,1.0,811.0,811.0
40.064,17,10,676,5,460,10014.0,104.0,64.0,5,216,10015.0,20.0,15.0
40.074,17,10,676,5,460,10015.0,104.0,64.0,5,216,10017.0,20.0,15.0
0.016,6,13,3735,7,497,2.0,125.0,125.0,6,3238,3.0,1470.0,1459.0
0.103,6,10,1506,5,395,22.0,127.0,127.0,5,1111,24.0,843.0,843.0
0.112,6,10,1506,5,395,26.0,127.0,127.0,5,1111,25.0,843.0,843.0
0.011,6,10,1989,5,910,2.0,642.0,642.0,5,1079,2.0,811.0,811.0
0.003,17,2,148,1,60,0.0,32.0,32.0,1,88,0.0,60.0,60.0
0.004,6,10,2006,5,927,1.0,659.0,659.0,5,1079,1.0,811.0,811.0
0.12,6,14,4390,8,923,17.0,238.0,166.0,6,3467,16.0,1402.0,786.0
0.098,6,10,1506,5,395,22.0,127.0,127.0,5,1111,23.0,843.0,843.0
0.011,6,10,1972,5,910,2.0,642.0,642.0,5,1062,2.0,794.0,794.0
0.004,6,10,1779,5,928,1.0,660.0,660.0,5,851,1.0,583.0,583.0
40.063,17,10,676,5,460,10013.0,104.0,64.0,5,216,10015.0,20.0,15.0
0.006,17,2,144,1,64,0.0,36.0,36.0,1,80,0.0,52.0,52.0
0.165,6,10,1506,5,395,36.0,127.0,127.0,5,1111,35.0,843.0,843.0
0.034,6,10,1983,5,910,8.0,642.0,642.0,5,1073,8.0,805.0,805.0
0.006,6,10,1547,5,764,1.0,496.0,496.0,5,783,1.0,515.0,515.0
0.152,6,10,1506,5,395,31.0,127.0,127.0,5,1111,37.0,843.0,843.0
11.109,17,28,4422,14,1994,842.0,269.0,114.0,14,2428,842.0,587.0,145.0
0.078,6,10,1506,5,395,17.0,127.0,127.0,5,1111,15.0,843.0,843.0
0.009,6,10,1990,5,911,2.0,643.0,643.0,5,1079,2.0,811.0,811.0
295.779,6,404,348267,194,21653,1532.0,2736.0,889.0,210,326614,1415.0,2804.0,1610.0
0.016,6,10,1972,5,910,4.0,642.0,642.0,5,1062,4.0,794.0,794.0
0.005,6,10,2007,5,928,1.0,660.0,660.0,5,1079,1.0,811.0,811.0
0.119,6,10,1506,5,395,27.0,127.0,127.0,5,1111,26.0,843.0,843.0
0.005,6,10,1643,5,860,1.0,592.0,592.0,5,783,1.0,515.0,515.0
0.001,17,2,136,1,60,0.0,32.0,32.0,1,76,0.0,48.0,48.0
0.155,6,10,1506,5,395,37.0,127.0,127.0,5,1111,37.0,843.0,843.0
0.02,6,10,1762,5,911,4.0,643.0,643.0,5,851,5.0,583.0,583.0
240.031,6,9,787,5,488,60007.0,232.0,232.0,4,299,80009.0,83.0,83.0
0.005,6,10,1854,5,889,1.0,621.0,621.0,5,965,1.0,697.0,697.0
40.047,17,10,676,5,460,10005.0,104.0,64.0,5,216,10009.0,20.0,15.0
0.012,6,10,1989,5,910,3.0,642.0,642.0,5,1079,3.0,811.0,811.0
0.024,6,10,1972,5,910,5.0,642.0,642.0,5,1062,6.0,794.0,794.0
0.001,17,2,166,1,75,0.0,47.0,47.0,1,91,0.0,63.0,63.0
0.008,6,10,1989,5,910,2.0,642.0,642.0,5,1079,1.0,811.0,811.0
0.004,17,2,148,1,60,0.0,32.0,32.0,1,88,0.0,60.0,60.0
0.083,6,10,1506,5,395,19.0,127.0,127.0,5,1111,18.0,843.0,843.0
0.005,6,10,2006,5,927,1.0,659.0,659.0,5,1079,1.0,811.0,811.0
0.004,6,10,1702,5,863,1.0,595.0,595.0,5,839,0.0,571.0,571.0
0.006,6,10,1547,5,764,1.0,496.0,496.0,5,783,1.0,515.0,515.0
0.005,6,10,2000,5,927,1.0,659.0,659.0,5,1073,1.0,805.0,805.0
0.107,6,10,1506,5,395,24.0,127.0,127.0,5,1111,25.0,843.0,843.0
0.161,6,10,1506,5,395,37.0,127.0,127.0,5,1111,31.0,843.0,843.0
0.013,6,10,1983,5,910,3.0,642.0,642.0,5,1073,3.0,805.0,805.0
0.072,17,2,184,1,61,0.0,33.0,33.0,1,123,0.0,95.0,95.0
0.004,6,10,2007,5,928,1.0,660.0,660.0,5,1079,1.0,811.0,811.0
0.003,17,4,284,2,120,0.0,32.0,32.0,2,164,0.0,60.0,54.0
0.091,6,10,1506,5,395,18.0,127.0,127.0,5,1111,20.0,843.0,843.0
0.004,6,10,2000,5,927,1.0,659.0,659.0,5,1073,1.0,805.0,805.0
11.152,17,28,4422,14,1994,845.0,269.0,114.0,14,2428,845.0,587.0,145.0
0.04,17,4,420,2,122,0.0,33.0,33.0,2,298,33.0,145.0,121.0
0.005,6,10,2007,5,928,1.0,660.0,660.0,5,1079,1.0,811.0,811.0
368.791,6,22,2313,16,867,24586.0,195.0,195.0,6,1446,4635.0,419.0,398.0
11.145,17,28,4397,14,2311,848.0,586.0,137.0,14,2086,848.0,269.0,121.0
40.062,17,10,676,5,460,10014.0,104.0,64.0,5,216,10014.0,20.0,15.0
0.042,17,4,352,2,130,1.0,37.0,37.0,2,222,38.0,89.0,83.0
0.005,6,10,1547,5,764,1.0,496.0,496.0,5,783,1.0,515.0,515.0
352.744,6,20,2210,6,1308,12003.0,494.0,494.0,14,902,27133.0,83.0,83.0
0.091,6,10,1506,5,395,19.0,127.0,127.0,5,1111,20.0,843.0,843.0
0.014,6,10,1989,5,910,3.0,642.0,642.0,5,1079,3.0,811.0,811.0
0.007,17,2,179,1,71,0.0,43.0,43.0,1,108,0.0,80.0,80.0
0.017,6,10,1631,5,848,4.0,580.0,580.0,5,783,4.0,515.0,515.0
0.005,6,10,2006,5,927,1.0,659.0,659.0,5,1079,1.0,811.0,811.0
0.017,6,10,1989,5,910,4.0,642.0,642.0,5,1079,4.0,811.0,811.0
0.009,6,10,1972,5,910,2.0,642.0,642.0,5,1062,2.0,794.0,794.0
0.11,6,10,1506,5,395,26.0,127.0,127.0,5,1111,23.0,843.0,843.0
0.005,17,2,170,1,65,0.0,37.0,37.0,1,105,0.0,77.0,77.0
0.005,17,2,170,1,65,0.0,37.0,37.0,1,105,0.0,77.0,77.0
0.005,6,10,1774,5,923,1.0,655.0,655.0,5,851,1.0,583.0,583.0
0.006,17,2,166,1,75,0.0,47.0,47.0,1,91,0.0,63.0,63.0
0.001,17,2,166,1,75,0.0,47.0,47.0,1,91,0.0,63.0,63.0
0.042,17,2,148,1,60,0.0,32.0,32.0,1,88,0.0,60.0,60.0
0.005,6,10,2007,5,928,1.0,660.0,660.0,5,1079,1.0,811.0,811.0
0.081,6,10,1506,5,395,17.0,127.0,127.0,5,1111,19.0,843.0,843.0
309.333,17,20,1124,10,716,34356.0,48.0,43.0,10,408,34356.0,20.0,12.0
0.004,17,4,284,2,120,1.0,32.0,32.0,2,164,0.0,60.0,54.0
0.001,17,2,180,1,66,0.0,38.0,38.0,1,114,0.0,86.0,86.0
0.013,6,10,1989,5,910,3.0,642.0,642.0,5,1079,3.0,811.0,811.0
0.006,6,13,3747,7,509,0.0,137.0,137.0,6,3238,1.0,1470.0,1459.0
0.118,6,10,1506,5,395,28.0,127.0,127.0,5,1111,28.0,843.0,843.0
176.405,17,78,11041,39,2593,4642.0,44.0,38.0,39,8448,4642.0,261.0,188.0
0.013,6,14,3787,7,497,2.0,125.0,125.0,7,3290,2.0,1448.0,972.0
0.014,6,10,2006,5,927,3.0,659.0,659.0,5,1079,3.0,811.0,811.0
0.005,6,10,2007,5,928,1.0,660.0,660.0,5,1079,1.0,811.0,811.0
300.2,6,47,18398,26,12760,12001.0,2720.0,1062.0,21,5638,15001.0,2667.0,435.0
0.009,17,2,136,1,60,0.0,32.0,32.0,1,76,0.0,48.0,48.0
240.462,6,35,8926,18,2073,14144.0,694.0,225.0,17,6853,15028.0,1402.0,597.0
0.006,6,10,1854,5,889,1.0,621.0,621.0,5,965,1.0,697.0,697.0
0.001,17,2,180,1,66,0.0,38.0,38.0,1,114,0.0,86.0,86.0
331.74,17,20,1124,10,716,36845.0,48.0,43.0,10,408,36846.0,20.0,12.0
374.837,6,22,2313,16,867,24989.0,195.0,195.0,6,1446,4636.0,419.0,398.0
0.005,6,10,2007,5,928,1.0,660.0,660.0,5,1079,1.0,811.0,811.0
0.011,6,10,1677,5,827,2.0,559.0,559.0,5,850,2.0,582.0,582.0
0.128,17,2,80,1,32,0.0,4.0,4.0,1,48,0.0,20.0,20.0
0.01,6,12,1926,6,1189,2.0,659.0,434.0,6,737,1.0,417.0,417.0
290.96,6,314,344582,130,18307,2255.0,2736.0,888.0,184,326275,1589.0,2804.0,1862.0
0.012,6,10,1774,5,923,3.0,655.0,655.0,5,851,2.0,583.0,583.0
0.07,6,10,1506,5,395,15.0,127.0,127.0,5,1111,15.0,843.0,843.0
0.007,6,10,1854,5,889,1.0,621.0,621.0,5,965,1.0,697.0,697.0
0.005,6,10,1689,5,839,1.0,571.0,571.0,5,850,1.0,582.0,582.0
0.005,6,10,2000,5,927,1.0,659.0,659.0,5,1073,1.0,805.0,805.0
0.073,6,10,1506,5,395,16.0,127.0,127.0,5,1111,15.0,843.0,843.0
0.004,6,10,2000,5,927,1.0,659.0,659.0,5,1073,1.0,805.0,805.0
0.005,6,10,1689,5,839,1.0,571.0,571.0,5,850,1.0,582.0,582.0
0.01,6,10,1989,5,910,2.0,642.0,642.0,5,1079,2.0,811.0,811.0
0.001,17,2,136,1,60,0.0,32.0,32.0,1,76,0.0,48.0,48.0
11.832,17,30,4602,15,2099,837.0,270.0,111.0,15,2503,837.0,586.0,138.0
0.124,6,10,1506,5,395,27.0,127.0,127.0,5,1111,27.0,843.0,843.0
40.06,17,10,676,5,460,10014.0,104.0,64.0,5,216,10014.0,20.0,15.0
361.86,6,21,1792,16,1030,24124.0,190.0,190.0,5,762,60009.0,461.0,247.0
0.001,17,2,180,1,66,0.0,38.0,38.0,1,114,0.0,86.0,86.0
0.005,6,10,1643,5,860,1.0,592.0,592.0,5,783,1.0,515.0,515.0
15.079,17,15,9238,8,6902,2149.0,1350.0,834.0,7,2336,2508.0,1350.0,305.0
0.078,6,10,1506,5,395,18.0,127.0,127.0,5,1111,16.0,843.0,843.0
0.085,6,10,1506,5,395,18.0,127.0,127.0,5,1111,19.0,843.0,843.0
0.004,6,10,1779,5,928,1.0,660.0,660.0,5,851,1.0,583.0,583.0
15.072,17,15,9239,8,6902,2149.0,1350.0,834.0,7,2337,2507.0,1350.0,305.0
0.005,6,10,1774,5,923,1.0,655.0,655.0,5,851,1.0,583.0,583.0
0.016,17,2,198,1,91,0.0,63.0,63.0,1,107,0.0,79.0,79.0
0.207,6,16,2777,8,1395,29.0,533.0,323.0,8,1382,18.0,529.0,239.0
0.038,17,2,152,1,76,0.0,48.0,48.0,1,76,0.0,48.0,48.0
0.001,17,2,136,1,60,0.0,32.0,32.0,1,76,0.0,48.0,48.0
0.012,6,10,1990,5,911,3.0,643.0,643.0,5,1079,3.0,811.0,811.0
0.021,6,10,1989,5,910,5.0,642.0,642.0,5,1079,5.0,811.0,811.0
0.011,6,10,1989,5,910,2.0,642.0,642.0,5,1079,2.0,811.0,811.0
0.017,6,10,1990,5,911,4.0,643.0,643.0,5,1079,4.0,811.0,811.0
0.007,17,2,166,1,75,0.0,47.0,47.0,1,91,0.0,63.0,63.0
0.009,6,10,1989,5,910,2.0,642.0,642.0,5,1079,2.0,811.0,811.0
0.003,17,2,148,1,60,0.0,32.0,32.0,1,88,0.0,60.0,60.0
0.009,6,10,1631,5,848,2.0,580.0,580.0,5,783,2.0,515.0,515.0
178.147,17,72,10102,36,2401,5089.0,44.0,38.0,36,7701,5089.0,252.0,185.0
0.016,6,10,1605,5,388,4.0,120.0,120.0,5,1217,4.0,949.0,949.0
0.007,6,10,1989,5,910,1.0,642.0,642.0,5,1079,1.0,811.0,811.0
0.012,6,10,1989,5,910,3.0,642.0,642.0,5,1079,3.0,811.0,811.0
9.038,17,6,376,5,280,2259.0,28.0,28.0,1,96,0.0,68.0,68.0
0.133,6,10,1506,5,395,32.0,127.0,127.0,5,1111,30.0,843.0,843.0
0.005,6,10,2007,5,928,1.0,660.0,660.0,5,1079,1.0,811.0,811.0
0.004,6,10,2006,5,927,1.0,659.0,659.0,5,1079,1.0,811.0,811.0
0.009,6,10,1989,5,910,2.0,642.0,642.0,5,1079,2.0,811.0,811.0
0.004,6,10,2006,5,927,1.0,659.0,659.0,5,1079,1.0,811.0,811.0
15.071,17,15,9238,8,6902,2149.0,1350.0,834.0,7,2336,2507.0,1350.0,305.0
0.005,6,10,1989,5,927,1.0,659.0,659.0,5,1062,1.0,794.0,794.0
0.008,6,12,1926,6,1189,1.0,659.0,434.0,6,737,1.0,417.0,417.0
0.014,6,10,1972,5,910,3.0,642.0,642.0,5,1062,3.0,794.0,794.0
0.076,6,10,1506,5,395,16.0,127.0,127.0,5,1111,18.0,843.0,843.0
0.001,17,2,180,1,66,0.0,38.0,38.0,1,114,0.0,86.0,86.0
0.008,17,2,179,1,71,0.0,43.0,43.0,1,108,0.0,80.0,80.0
0.011,6,10,1989,5,910,2.0,642.0,642.0,5,1079,2.0,811.0,811.0
0.117,6,10,1506,5,395,25.0,127.0,127.0,5,1111,28.0,843.0,843.0
0.006,6,10,1689,5,839,1.0,571.0,571.0,5,850,1.0,582.0,582.0
0.007,6,10,1547,5,764,1.0,496.0,496.0,5,783,1.0,515.0,515.0
240.154,6,51,7097,24,3378,10441.0,588.0,211.0,27,3719,9236.0,580.0,177.0
0.005,6,10,1774,5,923,1.0,655.0,655.0,5,851,1.0,583.0,583.0
0.006,6,13,3690,7,452,1.0,80.0,80.0,6,3238,1.0,1470.0,1459.0
15.073,17,14,9190,8,6902,2149.0,1350.0,834.0,6,2288,3008.0,1350.0,353.0
0.005,6,10,2006,5,927,1.0,659.0,659.0,5,1079,1.0,811.0,811.0
0.011,6,10,1972,5,910,2.0,642.0,642.0,5,1062,2.0,794.0,794.0
0.004,6,10,2006,5,927,1.0,659.0,659.0,5,1079,1.0,811.0,811.0
361.798,6,21,1792,16,1030,24119.0,190.0,190.0,5,762,60010.0,461.0,247.0
0.017,6,10,1762,5,911,4.0,643.0,643.0,5,851,4.0,583.0,583.0
0.005,6,14,3742,7,452,0.0,80.0,80.0,7,3290,0.0,1448.0,972.0
0.003,17,2,136,1,60,0.0,32.0,32.0,1,76,0.0,48.0,48.0
0.006,6,10,1989,5,927,1.0,659.0,659.0,5,1062,1.0,794.0,794.0
0.012,6,10,1983,5,910,3.0,642.0,642.0,5,1073,2.0,805.0,805.0
0.017,6,10,1989,5,910,4.0,642.0,642.0,5,1079,4.0,811.0,811.0
0.015,6,10,1762,5,911,3.0,643.0,643.0,5,851,3.0,583.0,583.0
0.012,6,10,1989,5,910,2.0,642.0,642.0,5,1079,2.0,811.0,811.0
0.012,17,2,148,1,60,0.0,32.0,32.0,1,88,0.0,60.0,60.0
0.011,6,10,1989,5,910,2.0,642.0,642.0,5,1079,2.0,811.0,811.0
0.005,6,10,1643,5,860,1.0,592.0,592.0,5,783,1.0,515.0,515.0
0.005,6,10,1547,5,764,1.0,496.0,496.0,5,783,1.0,515.0,515.0
0.005,6,10,2007,5,928,1.0,660.0,660.0,5,1079,1.0,811.0,811.0
0.116,6,10,1506,5,395,26.0,127.0,127.0,5,1111,23.0,843.0,843.0
1.049,6,13,3930,7,2139,131.0,1328.0,923.0,6,1791,157.0,1539.0,1539.0
0.001,17,2,180,1,66,0.0,38.0,38.0,1,114,0.0,86.0,86.0
0.001,17,2,180,1,66,0.0,38.0,38.0,1,114,0.0,86.0,86.0
0.215,6,16,2670,8,1396,30.0,533.0,324.0,8,1274,19.0,529.0,212.0
0.115,6,10,1506,5,395,27.0,127.0,127.0,5,1111,24.0,843.0,843.0
0.04,17,2,170,1,65,0.0,37.0,37.0,1,105,0.0,77.0,77.0
0.008,17,2,179,1,71,0.0,43.0,43.0,1,108,0.0,80.0,80.0
0.064,6,10,1506,5,395,14.0,127.0,127.0,5,1111,14.0,843.0,843.0
0.005,6,10,2006,5,927,1.0,659.0,659.0,5,1079,1.0,811.0,811.0
0.009,6,10,1762,5,911,2.0,643.0,643.0,5,851,2.0,583.0,583.0
0.003,17,2,136,1,60,0.0,32.0,32.0,1,76,0.0,48.0,48.0
0.012,6,10,1989,5,910,3.0,642.0,642.0,5,1079,3.0,811.0,811.0
0.173,17,2,152,1,76,0.0,48.0,48.0,1,76,0.0,48.0,48.0
0.014,6,10,1972,5,910,3.0,642.0,642.0,5,1062,3.0,794.0,794.0
0.134,6,10,1506,5,395,30.0,127.0,127.0,5,1111,31.0,843.0,843.0
0.004,6,10,2006,5,927,1.0,659.0,659.0,5,1079,1.0,811.0,811.0
0.005,6,10,2006,5,927,1.0,659.0,659.0,5,1079,1.0,811.0,811.0
0.005,17,4,284,2,120,1.0,32.0,32.0,2,164,1.0,60.0,54.0
11.601,17,28,4394,14,2312,879.0,587.0,137.0,14,2082,879.0,269.0,120.0
0.073,6,10,1506,5,395,17.0,127.0,127.0,5,1111,16.0,843.0,843.0
0.144,6,10,1506,5,395,33.0,127.0,127.0,5,1111,29.0,843.0,843.0
0.011,6,10,1990,5,911,2.0,643.0,643.0,5,1079,2.0,811.0,811.0
0.016,6,10,1631,5,848,3.0,580.0,580.0,5,783,3.0,515.0,515.0
0.068,6,10,1506,5,395,15.0,127.0,127.0,5,1111,15.0,843.0,843.0
334.083,17,20,1124,10,716,37106.0,48.0,43.0,10,408,37106.0,20.0,12.0
0.008,17,2,136,1,60,0.0,32.0,32.0,1,76,0.0,48.0,48.0
0.085,6,10,1506,5,395,19.0,127.0,127.0,5,1111,20.0,843.0,843.0
0.005,6,14,3742,7,452,0.0,80.0,80.0,7,3290,0.0,1448.0,972.0
0.084,6,10,1506,5,395,18.0,127.0,127.0,5,1111,19.0,843.0,843.0
0.01,6,10,1762,5,911,2.0,643.0,643.0,5,851,2.0,583.0,583.0
40.059,17,10,676,5,460,10013.0,104.0,64.0,5,216,10013.0,20.0,15.0
0.039,6,10,1972,5,910,9.0,642.0,642.0,5,1062,9.0,794.0,794.0
0.009,6,10,1983,5,910,2.0,642.0,642.0,5,1073,2.0,805.0,805.0
0.005,17,2,180,1,66,0.0,38.0,38.0,1,114,0.0,86.0,86.0
0.004,6,10,1779,5,928,1.0,660.0,660.0,5,851,1.0,583.0,583.0
0.006,6,10,2006,5,927,1.0,659.0,659.0,5,1079,1.0,811.0,811.0
0.005,6,10,2000,5,927,1.0,659.0,659.0,5,1073,1.0,805.0,805.0
0.007,6,10,2006,5,927,1.0,659.0,659.0,5,1079,1.0,811.0,811.0
0.016,6,10,1972,5,910,4.0,642.0,642.0,5,1062,4.0,794.0,794.0
0.006,17,2,262,1,66,0.0,38.0,38.0,1,196,0.0,168.0,168.0
0.009,6,10,1677,5,827,2.0,559.0,559.0,5,850,2.0,582.0,582.0
0.012,6,10,1989,5,910,2.0,642.0,642.0,5,1079,2.0,811.0,811.0
1772.035,6,104,6257,59,3485,30551.0,27.0,27.0,45,2772,40272.0,27.0,27.0
0.005,6,10,1779,5,928,1.0,660.0,660.0,5,851,1.0,583.0,583.0
0.108,6,10,1506,5,395,23.0,127.0,127.0,5,1111,24.0,843.0,843.0
0.008,6,10,1983,5,910,1.0,642.0,642.0,5,1073,2.0,805.0,805.0
40.083,17,10,676,5,460,10019.0,104.0,64.0,5,216,10020.0,20.0,15.0
10.828,17,28,4421,14,1994,824.0,269.0,114.0,14,2427,824.0,586.0,145.0
0.09,6,10,1506,5,395,20.0,127.0,127.0,5,1111,19.0,843.0,843.0
0.004,6,10,2007,5,928,1.0,660.0,660.0,5,1079,1.0,811.0,811.0
0.011,6,10,1989,5,910,2.0,642.0,642.0,5,1079,2.0,811.0,811.0
0.019,6,10,1983,5,910,4.0,642.0,642.0,5,1073,4.0,805.0,805.0
0.015,6,10,1762,5,911,3.0,643.0,643.0,5,851,3.0,583.0,583.0
0.129,17,2,80,1,32,0.0,4.0,4.0,1,48,0.0,20.0,20.0
0.003,17,2,170,1,65,0.0,37.0,37.0,1,105,0.0,77.0,77.0
180.893,6,22,7437,11,1305,129.0,530.0,277.0,11,6132,18073.0,2720.0,946.0
0.07,6,10,1506,5,395,15.0,127.0,127.0,5,1111,15.0,843.0,843.0
40.066,17,10,676,5,460,10015.0,104.0,64.0,5,216,10015.0,20.0,15.0
0.005,17,2,214,1,75,0.0,47.0,47.0,1,139,0.0,111.0,111.0
0.041,17,2,222,1,65,0.0,37.0,37.0,1,157,0.0,129.0,129.0
0.124,6,10,1506,5,395,28.0,127.0,127.0,5,1111,27.0,843.0,843.0
240.463,6,35,8923,18,2070,14144.0,691.0,225.0,17,6853,15028.0,1402.0,597.0
1.81,6,38,6827,21,3555,90.0,1103.0,204.0,17,3272,104.0,1796.0,396.0
0.052,17,2,152,1,76,0.0,48.0,48.0,1,76,0.0,48.0,48.0
366.977,6,21,1793,16,1030,24465.0,190.0,190.0,5,763,60016.0,462.0,247.0
0.022,6,10,1677,5,827,5.0,559.0,559.0,5,850,5.0,582.0,582.0
0.004,6,10,1774,5,923,1.0,655.0,655.0,5,851,1.0,583.0,583.0
0.006,6,10,1689,5,839,1.0,571.0,571.0,5,850,1.0,582.0,582.0
0.004,6,10,1774,5,923,1.0,655.0,655.0,5,851,1.0,583.0,583.0
0.01,6,10,1972,5,910,2.0,642.0,642.0,5,1062,2.0,794.0,794.0
0.074,6,10,1506,5,395,16.0,127.0,127.0,5,1111,16.0,843.0,843.0
0.011,6,10,1989,5,910,2.0,642.0,642.0,5,1079,2.0,811.0,811.0
0.006,6,10,1643,5,860,1.0,592.0,592.0,5,783,1.0,515.0,515.0
0.012,6,10,1990,5,911,3.0,643.0,643.0,5,1079,3.0,811.0,811.0
0.003,17,2,148,1,60,0.0,32.0,32.0,1,88,0.0,60.0,60.0
0.08,6,10,1506,5,395,18.0,127.0,127.0,5,1111,19.0,843.0,843.0
0.008,6,12,1926,6,1189,1.0,659.0,434.0,6,737,1.0,417.0,417.0
0.005,6,10,1989,5,927,1.0,659.0,659.0,5,1062,1.0,794.0,794.0
40.09,17,10,676,5,460,10021.0,104.0,64.0,5,216,10021.0,20.0,15.0
0.112,6,10,1506,5,395,24.0,127.0,127.0,5,1111,24.0,843.0,843.0
0.08,6,10,1506,5,395,16.0,127.0,127.0,5,1111,18.0,843.0,843.0
0.004,6,10,1702,5,863,1.0,595.0,595.0,5,839,0.0,571.0,571.0
0.006,6,10,1547,5,764,1.0,496.0,496.0,5,783,1.0,515.0,515.0
0.168,6,3,453,2,321,168.0,241.0,241.0,1,132,0.0,92.0,92.0
0.001,17,2,180,1,66,0.0,38.0,38.0,1,114,0.0,86.0,86.0
0.085,6,10,1506,5,395,19.0,127.0,127.0,5,1111,16.0,843.0,843.0
0.073,17,2,148,1,60,0.0,32.0,32.0,1,88,0.0,60.0,60.0
166.274,17,82,11593,41,2743,4156.0,44.0,38.0,41,8850,4156.0,260.0,187.0
0.074,6,10,1506,5,395,17.0,127.0,127.0,5,1111,14.0,843.0,843.0
0.025,6,10,1677,5,827,6.0,559.0,559.0,5,850,6.0,582.0,582.0
0.005,6,10,2007,5,928,1.0,660.0,660.0,5,1079,1.0,811.0,811.0
0.041,17,2,148,1,60,0.0,32.0,32.0,1,88,0.0,60.0,60.0
0.003,17,2,132,1,58,0.0,30.0,30.0,1,74,0.0,46.0,46.0
0.064,6,10,1506,5,395,15.0,127.0,127.0,5,1111,13.0,843.0,843.0
0.229,6,10,1506,5,395,53.0,127.0,127.0,5,1111,51.0,843.0,843.0
0.005,6,10,2006,5,927,1.0,659.0,659.0,5,1079,1.0,811.0,811.0
40.055,17,10,676,5,460,10012.0,104.0,64.0,5,216,10013.0,20.0,15.0
0.007,6,10,2006,5,927,1.0,659.0,659.0,5,1079,1.0,811.0,811.0
40.076,17,10,676,5,460,10018.0,104.0,64.0,5,216,10018.0,20.0,15.0
0.004,6,10,2007,5,928,1.0,660.0,660.0,5,1079,1.0,811.0,811.0
0.006,6,10,1547,5,764,1.0,496.0,496.0,5,783,1.0,515.0,515.0
0.007,6,10,1689,5,839,1.0,571.0,571.0,5,850,1.0,582.0,582.0
0.005,6,10,1989,5,927,1.0,659.0,659.0,5,1062,1.0,794.0,794.0
0.005,17,2,214,1,75,0.0,47.0,47.0,1,139,0.0,111.0,111.0
0.008,6,12,1926,6,1189,1.0,659.0,434.0,6,737,1.0,417.0,417.0
0.005,6,10,1854,5,889,1.0,621.0,621.0,5,965,1.0,697.0,697.0
0.017,6,10,1990,5,911,4.0,643.0,643.0,5,1079,4.0,811.0,811.0
0.005,6,10,2000,5,927,1.0,659.0,659.0,5,1073,1.0,805.0,805.0
0.001,17,2,180,1,66,0.0,38.0,38.0,1,114,0.0,86.0,86.0
0.007,6,10,1989,5,910,1.0,642.0,642.0,5,1079,1.0,811.0,811.0
11.038,17,28,4389,14,2311,840.0,586.0,137.0,14,2078,840.0,269.0,120.0
0.004,6,10,2000,5,927,1.0,659.0,659.0,5,1073,1.0,805.0,805.0
0.004,6,10,1702,5,863,1.0,595.0,595.0,5,839,1.0,571.0,571.0
240.48,6,37,9659,19,2175,13359.0,747.0,235.0,18,7484,14145.0,1402.0,595.0
0.013,6,10,1989,5,910,3.0,642.0,642.0,5,1079,3.0,811.0,811.0
0.011,6,10,1989,5,910,2.0,642.0,642.0,5,1079,2.0,811.0,811.0
0.004,17,2,136,1,60,0.0,32.0,32.0,1,76,0.0,48.0,48.0
0.005,6,10,1989,5,927,1.0,659.0,659.0,5,1062,1.0,794.0,794.0
0.005,6,10,2000,5,927,1.0,659.0,659.0,5,1073,1.0,805.0,805.0
0.08,6,10,1506,5,395,18.0,127.0,127.0,5,1111,16.0,843.0,843.0
0.005,17,2,170,1,65,0.0,37.0,37.0,1,105,0.0,77.0,77.0
0.077,6,10,1506,5,395,17.0,127.0,127.0,5,1111,18.0,843.0,843.0
0.016,6,10,1972,5,910,3.0,642.0,642.0,5,1062,3.0,794.0,794.0
0.001,17,2,180,1,66,0.0,38.0,38.0,1,114,0.0,86.0,86.0
0.007,6,10,1547,5,764,1.0,496.0,496.0,5,783,1.0,515.0,515.0
0.013,6,10,1989,5,910,3.0,642.0,642.0,5,1079,3.0,811.0,811.0
0.005,6,10,1547,5,764,1.0,496.0,496.0,5,783,1.0,515.0,515.0
0.005,6,10,1689,5,839,1.0,571.0,571.0,5,850,1.0,582.0,582.0
0.006,6,10,1854,5,889,1.0,621.0,621.0,5,965,1.0,697.0,697.0
0.08,6,10,1506,5,395,16.0,127.0,127.0,5,1111,17.0,843.0,843.0
0.138,6,10,1506,5,395,30.0,127.0,127.0,5,1111,32.0,843.0,843.0
0.236,6,16,2782,8,1400,33.0,533.0,325.0,8,1382,21.0,529.0,239.0
300.335,6,16,2170,9,684,37520.0,146.0,146.0,7,1486,50028.0,419.0,398.0
0.018,6,10,1762,5,911,4.0,643.0,643.0,5,851,4.0,583.0,583.0
0.012,6,10,1972,5,910,3.0,642.0,642.0,5,1062,3.0,794.0,794.0
0.004,6,10,2006,5,927,1.0,659.0,659.0,5,1079,1.0,811.0,811.0
1778.903,17,142,44872,72,22752,25053.0,288.0,288.0,70,22120,25781.0,288.0,288.0
0.017,6,10,1983,5,910,4.0,642.0,642.0,5,1073,4.0,805.0,805.0
0.015,6,10,1990,5,911,3.0,643.0,643.0,5,1079,3.0,811.0,811.0
0.089,6,10,1506,5,395,20.0,127.0,127.0,5,1111,20.0,843.0,843.0
0.005,6,10,2007,5,928,1.0,660.0,660.0,5,1079,1.0,811.0,811.0
0.114,6,10,1506,5,395,26.0,127.0,127.0,5,1111,26.0,843.0,843.0
0.096,6,10,1506,5,395,23.0,127.0,127.0,5,1111,20.0,843.0,843.0
0.006,6,10,1689,5,839,1.0,571.0,571.0,5,850,1.0,582.0,582.0
0.012,6,10,1677,5,827,3.0,559.0,559.0,5,850,3.0,582.0,582.0
0.005,17,2,214,1,75,0.0,47.0,47.0,1,139,0.0,111.0,111.0
280.607,6,24,7264,10,1186,31178.0,267.0,156.0,14,6078,21584.0,1400.0,919.0
0.001,17,2,180,1,66,0.0,38.0,38.0,1,114,0.0,86.0,86.0
0.005,17,2,166,1,75,0.0,47.0,47.0,1,91,0.0,63.0,63.0
0.015,6,10,1989,5,910,3.0,642.0,642.0,5,1079,3.0,811.0,811.0
0.004,17,2,136,1,60,0.0,32.0,32.0,1,76,0.0,48.0,48.0
0.022,6,10,1990,5,911,5.0,643.0,643.0,5,1079,5.0,811.0,811.0
0.013,6,10,1972,5,910,3.0,642.0,642.0,5,1062,3.0,794.0,794.0
0.006,6,10,1547,5,764,1.0,496.0,496.0,5,783,1.0,515.0,515.0
0.005,6,10,2006,5,927,1.0,659.0,659.0,5,1079,1.0,811.0,811.0
0.008,6,10,1972,5,910,2.0,642.0,642.0,5,1062,2.0,794.0,794.0
309.994,17,20,1124,10,716,34437.0,48.0,43.0,10,408,34436.0,20.0,12.0
301.649,6,31,10170,17,2382,18853.0,676.0,298.0,14,7788,18585.0,1402.0,881.0
0.006,6,10,1547,5,764,1.0,496.0,496.0,5,783,1.0,515.0,515.0
10.963,17,28,4420,14,1993,834.0,268.0,114.0,14,2427,834.0,586.0,145.0
0.096,6,10,1506,5,395,17.0,127.0,127.0,5,1111,23.0,843.0,843.0
0.005,6,10,2006,5,927,1.0,659.0,659.0,5,1079,1.0,811.0,811.0
0.005,6,10,1689,5,839,1.0,571.0,571.0,5,850,1.0,582.0,582.0
0.004,17,2,148,1,60,0.0,32.0,32.0,1,88,0.0,60.0,60.0
0.017,6,10,1989,5,910,4.0,642.0,642.0,5,1079,4.0,811.0,811.0
0.004,17,2,148,1,60,0.0,32.0,32.0,1,88,0.0,60.0,60.0
0.005,6,10,1689,5,839,1.0,571.0,571.0,5,850,1.0,582.0,582.0
0.025,6,10,1989,5,910,6.0,642.0,642.0,5,1079,6.0,811.0,811.0
0.007,6,12,1698,6,863,1.0,327.0,271.0,6,835,1.0,515.0,515.0
60.749,6,20,10036,11,3921,6074.0,1591.0,838.0,9,6115,7578.0,2111.0,939.0
0.017,6,10,1972,5,910,4.0,642.0,642.0,5,1062,4.0,794.0,794.0
0.144,6,10,1506,5,395,23.0,127.0,127.0,5,1111,33.0,843.0,843.0
0.018,6,10,1983,5,910,4.0,642.0,642.0,5,1073,4.0,805.0,805.0
0.076,6,10,1506,5,395,17.0,127.0,127.0,5,1111,15.0,843.0,843.0
0.103,6,10,1506,5,395,22.0,127.0,127.0,5,1111,25.0,843.0,843.0
0.012,6,10,1972,5,910,2.0,642.0,642.0,5,1062,2.0,794.0,794.0
0.037,17,2,152,1,76,0.0,48.0,48.0,1,76,0.0,48.0,48.0
0.005,6,10,2000,5,927,1.0,659.0,659.0,5,1073,1.0,805.0,805.0
0.017,6,10,1990,5,911,4.0,643.0,643.0,5,1079,4.0,811.0,811.0
0.009,6,10,1990,5,911,2.0,643.0,643.0,5,1079,2.0,811.0,811.0
0.006,6,10,2007,5,928,1.0,660.0,660.0,5,1079,1.0,811.0,811.0
0.091,6,10,1506,5,395,17.0,127.0,127.0,5,1111,21.0,843.0,843.0
0.164,17,2,152,1,76,0.0,48.0,48.0,1,76,0.0,48.0,48.0
0.129,6,10,1506,5,395,31.0,127.0,127.0,5,1111,26.0,843.0,843.0
0.007,6,10,1643,5,860,1.0,592.0,592.0,5,783,1.0,515.0,515.0
0.006,6,10,1689,5,839,1.0,571.0,571.0,5,850,1.0,582.0,582.0
0.005,6,10,1774,5,923,1.0,655.0,655.0,5,851,1.0,583.0,583.0
0.005,17,2,249,1,64,0.0,36.0,36.0,1,185,0.0,157.0,157.0
0.001,17,2,166,1,75,0.0,47.0,47.0,1,91,0.0,63.0,63.0
0.006,6,10,1774,5,923,1.0,655.0,655.0,5,851,1.0,583.0,583.0
0.025,6,10,1990,5,911,6.0,643.0,643.0,5,1079,6.0,811.0,811.0
0.016,6,10,1972,5,910,3.0,642.0,642.0,5,1062,4.0,794.0,794.0
1792.484,6,484,99066,242,87849,7437.0,421.0,366.0,242,11217,7437.0,53.0,53.0
40.065,17,10,676,5,460,10015.0,104.0,64.0,5,216,10015.0,20.0,15.0
0.008,6,10,2006,5,927,2.0,659.0,659.0,5,1079,2.0,811.0,811.0
321.535,17,20,1124,10,716,35712.0,48.0,43.0,10,408,35712.0,20.0,12.0
0.014,6,10,1972,5,910,3.0,642.0,642.0,5,1062,3.0,794.0,794.0
0.014,6,10,1990,5,911,3.0,643.0,643.0,5,1079,3.0,811.0,811.0
0.007,6,10,1547,5,764,1.0,496.0,496.0,5,783,1.0,515.0,515.0
0.007,17,2,170,1,65,0.0,37.0,37.0,1,105,0.0,77.0,77.0
0.015,6,10,1677,5,827,3.0,559.0,559.0,5,850,3.0,582.0,582.0
0.018,6,10,1989,5,910,4.0,642.0,642.0,5,1079,4.0,811.0,811.0
0.092,6,10,1506,5,395,22.0,127.0,127.0,5,1111,19.0,843.0,843.0
0.005,6,10,1779,5,928,1.0,660.0,660.0,5,851,1.0,583.0,583.0
0.006,6,10,1547,5,764,1.0,496.0,496.0,5,783,1.0,515.0,515.0
0.012,6,10,1990,5,911,2.0,643.0,643.0,5,1079,3.0,811.0,811.0
0.006,6,10,1689,5,839,1.0,571.0,571.0,5,850,1.0,582.0,582.0
73.007,6,22,8497,12,2236,72.0,1345.0,574.0,10,6261,8092.0,1776.0,974.0
0.009,6,10,1631,5,848,2.0,580.0,580.0,5,783,2.0,515.0,515.0
0.216,6,16,2669,8,1395,30.0,533.0,323.0,8,1274,19.0,529.0,212.0
0.009,6,12,1926,6,1189,1.0,659.0,434.0,6,737,1.0,417.0,417.0
0.04,17,4,284,2,120,0.0,32.0,32.0,2,164,36.0,60.0,54.0
0.008,6,10,1989,5,910,1.0,642.0,642.0,5,1079,2.0,811.0,811.0
0.005,6,10,1989,5,927,1.0,659.0,659.0,5,1062,1.0,794.0,794.0
15.121,17,15,7568,7,3706,2515.0,1350.0,501.0,8,3862,2155.0,1350.0,454.0
332.489,6,35,10849,19,2814,18471.0,676.0,363.0,16,8035,18165.0,1402.0,719.0
0.037,17,2,136,1,60,0.0,32.0,32.0,1,76,0.0,48.0,48.0
0.077,6,10,1506,5,395,16.0,127.0,127.0,5,1111,16.0,843.0,843.0
240.111,6,34,9516,18,7146,14124.0,2114.0,690.0,16,2370,16007.0,580.0,191.0
0.006,17,2,230,1,68,0.0,40.0,40.0,1,162,0.0,134.0,134.0
0.088,6,10,1506,5,395,21.0,127.0,127.0,5,1111,18.0,843.0,843.0
10.734,17,28,4423,14,1994,817.0,269.0,114.0,14,2429,817.0,588.0,145.0
0.129,17,2,80,1,32,0.0,4.0,4.0,1,48,0.0,20.0,20.0
0.079,6,10,1506,5,395,17.0,127.0,127.0,5,1111,18.0,843.0,843.0
40.078,17,10,676,5,460,10016.0,104.0,64.0,5,216,10018.0,20.0,15.0
367.399,6,22,2313,16,867,24493.0,195.0,195.0,6,1446,4656.0,419.0,398.0
411.766,6,43,15160,23,3619,18716.0,676.0,400.0,20,11541,18513.0,1402.0,807.0
0.007,6,10,1689,5,839,1.0,571.0,571.0,5,850,1.0,582.0,582.0
11.078,17,28,4394,14,2312,843.0,587.0,137.0,14,2082,842.0,269.0,120.0
0.009,6,10,1972,5,910,2.0,642.0,642.0,5,1062,2.0,794.0,794.0
0.005,6,10,2007,5,928,1.0,660.0,660.0,5,1079,1.0,811.0,811.0
178.045,17,80,11646,40,2697,4565.0,44.0,39.0,40,8949,4565.0,239.0,195.0
0.003,17,4,420,2,122,0.0,33.0,33.0,2,298,0.0,145.0,121.0
0.039,17,2,128,1,56,0.0,28.0,28.0,1,72,0.0,44.0,44.0
10.991,17,28,4398,14,2313,837.0,588.0,137.0,14,2085,837.0,268.0,120.0
0.004,6,10,2006,5,927,1.0,659.0,659.0,5,1079,1.0,811.0,811.0
0.005,6,10,1989,5,927,1.0,659.0,659.0,5,1062,1.0,794.0,794.0
1778.253,17,144,41760,72,22752,25045.0,288.0,288.0,72,19008,25045.0,236.0,236.0
0.087,6,10,1506,5,395,19.0,127.0,127.0,5,1111,19.0,843.0,843.0
300.272,6,27,7436,16,1409,20018.0,217.0,142.0,11,6027,24025.0,1679.0,778.0
0.001,17,2,136,1,60,0.0,32.0,32.0,1,76,0.0,48.0,48.0
0.001,17,2,142,1,63,0.0,35.0,35.0,1,79,0.0,51.0,51.0
40.06,17,10,676,5,460,10012.0,104.0,64.0,5,216,10014.0,20.0,15.0
0.013,6,10,1989,5,910,3.0,642.0,642.0,5,1079,3.0,811.0,811.0
0.005,6,10,1989,5,927,1.0,659.0,659.0,5,1062,1.0,794.0,794.0
0.005,6,10,1774,5,923,1.0,655.0,655.0,5,851,1.0,583.0,583.0
308.343,17,20,1124,10,716,34245.0,48.0,43.0,10,408,34246.0,20.0,12.0
300.407,6,16,2170,9,684,37529.0,146.0,146.0,7,1486,50039.0,419.0,398.0
0.006,6,10,1989,5,927,1.0,659.0,659.0,5,1062,1.0,794.0,794.0
0.013,6,10,1990,5,911,3.0,643.0,643.0,5,1079,3.0,811.0,811.0
0.075,6,10,1506,5,395,17.0,127.0,127.0,5,1111,15.0,843.0,843.0
0.089,6,10,1506,5,395,20.0,127.0,127.0,5,1111,19.0,843.0,843.0
0.004,6,10,2006,5,927,1.0,659.0,659.0,5,1079,1.0,811.0,811.0
0.01,6,12,1926,6,1189,2.0,659.0,434.0,6,737,2.0,417.0,417.0
0.011,6,10,1989,5,910,2.0,642.0,642.0,5,1079,2.0,811.0,811.0
0.12,6,10,1506,5,395,28.0,127.0,127.0,5,1111,28.0,843.0,843.0
0.005,17,2,214,1,75,0.0,47.0,47.0,1,139,0.0,111.0,111.0
0.001,17,2,180,1,66,0.0,38.0,38.0,1,114,0.0,86.0,86.0
0.001,17,2,180,1,66,0.0,38.0,38.0,1,114,0.0,86.0,86.0
0.013,6,10,1989,5,910,3.0,642.0,642.0,5,1079,3.0,811.0,811.0
0.001,17,2,140,1,62,0.0,34.0,34.0,1,78,0.0,50.0,50.0
0.115,6,10,1506,5,395,28.0,127.0,127.0,5,1111,23.0,843.0,843.0
0.076,6,10,1506,5,395,17.0,127.0,127.0,5,1111,16.0,843.0,843.0
0.087,6,10,1506,5,395,20.0,127.0,127.0,5,1111,21.0,843.0,843.0
0.006,6,10,1547,5,764,1.0,496.0,496.0,5,783,1.0,515.0,515.0
10.941,17,28,4422,14,1994,832.0,269.0,114.0,14,2428,832.0,587.0,145.0
0.009,6,12,1926,6,1189,1.0,659.0,434.0,6,737,1.0,417.0,417.0
0.052,17,2,152,1,76,0.0,48.0,48.0,1,76,0.0,48.0,48.0
0.009,6,10,1972,5,910,2.0,642.0,642.0,5,1062,2.0,794.0,794.0
177.203,17,72,10178,36,2401,5062.0,44.0,38.0,36,7777,5062.0,261.0,188.0
0.017,6,13,3816,7,578,2.0,206.0,206.0,6,3238,3.0,1470.0,1459.0
0.013,6,13,3735,7,497,2.0,125.0,125.0,6,3238,2.0,1470.0,1459.0
0.01,6,10,1677,5,827,2.0,559.0,559.0,5,850,2.0,582.0,582.0
0.001,17,2,142,1,63,0.0,35.0,35.0,1,79,0.0,51.0,51.0
0.006,6,10,1547,5,764,1.0,496.0,496.0,5,783,1.0,515.0,515.0
0.041,17,2,186,1,61,0.0,33.0,33.0,1,125,0.0,97.0,97.0
300.767,6,39,11330,21,5812,15038.0,1836.0,823.0,18,5518,505.0,2667.0,435.0
0.118,6,10,1506,5,395,26.0,127.0,127.0,5,1111,19.0,843.0,843.0
0.068,6,10,1506,5,395,16.0,127.0,127.0,5,1111,13.0,843.0,843.0
0.011,17,4,284,2,120,0.0,32.0,32.0,2,164,1.0,60.0,54.0
369.709,6,24,2405,17,919,23106.0,195.0,195.0,7,1486,3902.0,419.0,398.0
10.869,17,28,4421,14,1994,828.0,269.0,114.0,14,2427,828.0,586.0,145.0
0.005,17,2,212,1,74,0.0,46.0,46.0,1,138,0.0,110.0,110.0
0.071,6,10,1506,5,395,14.0,127.0,127.0,5,1111,16.0,843.0,843.0
0.009,6,10,1983,5,910,2.0,642.0,642.0,5,1073,2.0,805.0,805.0
0.005,6,10,2006,5,927,1.0,659.0,659.0,5,1079,1.0,811.0,811.0
0.004,6,10,1774,5,923,1.0,655.0,655.0,5,851,1.0,583.0,583.0
300.323,6,31,9643,17,2203,18770.0,819.0,259.0,14,7440,23101.0,2529.0,957.0
0.004,6,10,2000,5,927,1.0,659.0,659.0,5,1073,1.0,805.0,805.0
0.115,6,10,1506,5,395,23.0,127.0,127.0,5,1111,22.0,843.0,843.0
0.168,17,2,152,1,76,0.0,48.0,48.0,1,76,0.0,48.0,48.0
0.005,6,10,2007,5,928,1.0,660.0,660.0,5,1079,1.0,811.0,811.0
0.005,6,14,3799,7,509,0.0,137.0,137.0,7,3290,0.0,1448.0,972.0
0.005,6,10,1854,5,889,1.0,621.0,621.0,5,965,1.0,697.0,697.0
0.011,6,10,1983,5,910,2.0,642.0,642.0,5,1073,2.0,805.0,805.0
0.001,17,2,180,1,66,0.0,38.0,38.0,1,114,0.0,86.0,86.0
0.005,17,2,164,1,74,0.0,46.0,46.0,1,90,0.0,62.0,62.0
0.004,17,4,284,2,120,0.0,32.0,32.0,2,164,1.0,60.0,54.0
0.005,17,2,148,1,60,0.0,32.0,32.0,1,88,0.0,60.0,60.0
0.018,6,10,1990,5,911,4.0,643.0,643.0,5,1079,4.0,811.0,811.0
0.108,6,10,1506,5,395,25.0,127.0,127.0,5,1111,25.0,843.0,843.0
0.061,6,10,1972,5,910,15.0,642.0,642.0,5,1062,15.0,794.0,794.0
0.083,6,10,1506,5,395,18.0,127.0,127.0,5,1111,17.0,843.0,843.0
10.848,17,28,4416,14,1993,825.0,268.0,114.0,14,2423,826.0,586.0,145.0
0.004,6,10,2006,5,927,1.0,659.0,659.0,5,1079,1.0,811.0,811.0
0.078,6,10,1506,5,395,15.0,127.0,127.0,5,1111,17.0,843.0,843.0
0.01,6,10,1972,5,910,2.0,642.0,642.0,5,1062,2.0,794.0,794.0
0.108,6,10,1506,5,395,24.0,127.0,127.0,5,1111,24.0,843.0,843.0
0.007,17,2,175,1,65,0.0,37.0,37.0,1,110,0.0,82.0,82.0
0.006,6,10,1547,5,764,1.0,496.0,496.0,5,783,1.0,515.0,515.0
0.003,17,2,136,1,60,0.0,32.0,32.0,1,76,0.0,48.0,48.0
0.005,6,10,2007,5,928,1.0,660.0,660.0,5,1079,1.0,811.0,811.0
0.886,6,10,1690,6,1336,177.0,1084.0,1084.0,4,354,210.0,182.0,182.0
1777.91,17,144,45504,72,22752,25040.0,288.0,288.0,72,22752,25040.0,288.0,288.0
0.876,6,10,1873,6,1519,175.0,1267.0,1267.0,4,354,207.0,182.0,182.0
0.006,6,10,2007,5,928,1.0,660.0,660.0,5,1079,1.0,811.0,811.0
0.014,6,10,1989,5,910,3.0,642.0,642.0,5,1079,3.0,811.0,811.0
0.005,6,13,3747,7,509,0.0,137.0,137.0,6,3238,0.0,1470.0,1459.0
0.073,6,10,1506,5,395,17.0,127.0,127.0,5,1111,16.0,843.0,843.0
0.004,6,10,2000,5,927,1.0,659.0,659.0,5,1073,1.0,805.0,805.0
40.069,17,10,676,5,460,10016.0,104.0,64.0,5,216,10016.0,20.0,15.0
0.005,6,10,1689,5,839,1.0,571.0,571.0,5,850,1.0,582.0,582.0
0.004,6,10,1989,5,927,1.0,659.0,659.0,5,1062,1.0,794.0,794.0
0.004,17,4,284,2,120,0.0,32.0,32.0,2,164,1.0,60.0,54.0
0.101,6,10,1506,5,395,22.0,127.0,127.0,5,1111,22.0,843.0,843.0
10.982,17,28,4397,14,2312,836.0,587.0,137.0,14,2085,836.0,268.0,120.0
0.094,6,10,1506,5,395,20.0,127.0,127.0,5,1111,18.0,843.0,843.0
0.004,6,10,1989,5,927,1.0,659.0,659.0,5,1062,1.0,794.0,794.0
0.001,17,2,180,1,66,0.0,38.0,38.0,1,114,0.0,86.0,86.0
0.115,6,10,1506,5,395,26.0,127.0,127.0,5,1111,27.0,843.0,843.0
0.009,6,10,1990,5,911,2.0,643.0,643.0,5,1079,2.0,811.0,811.0
0.004,17,2,148,1,60,0.0,32.0,32.0,1,88,0.0,60.0,60.0
0.004,6,10,2000,5,927,1.0,659.0,659.0,5,1073,1.0,805.0,805.0
0.003,17,2,136,1,60,0.0,32.0,32.0,1,76,0.0,48.0,48.0
0.005,6,10,1779,5,928,1.0,660.0,660.0,5,851,1.0,583.0,583.0
1770.554,17,92,8096,46,4048,39345.0,60.0,60.0,46,4048,39345.0,60.0,60.0
0.005,6,10,1779,5,928,1.0,660.0,660.0,5,851,1.0,583.0,583.0
0.005,6,10,1774,5,923,1.0,655.0,655.0,5,851,1.0,583.0,583.0
0.015,6,10,1972,5,910,3.0,642.0,642.0,5,1062,3.0,794.0,794.0
0.057,17,2,179,1,71,0.0,43.0,43.0,1,108,0.0,80.0,80.0
1798.676,17,3395,259833,1686,136637,1067.0,84.0,53.0,1709,123196,1053.0,227.0,44.0
730.216,6,41,15398,22,4231,34772.0,676.0,439.0,19,11167,37233.0,1402.0,924.0
0.393,17,42,20348,22,17095,18.0,1350.0,749.0,20,3253,17.0,1350.0,134.0
0.006,6,10,1854,5,889,1.0,621.0,621.0,5,965,1.0,697.0,697.0
178.191,17,88,12614,44,2961,4143.0,44.0,39.0,44,9653,4143.0,261.0,191.0
0.082,6,10,1506,5,395,17.0,127.0,127.0,5,1111,18.0,843.0,843.0
1778.141,17,144,45504,72,22752,25044.0,288.0,288.0,72,22752,25044.0,288.0,288.0
0.01,6,14,3787,7,497,1.0,125.0,125.0,7,3290,1.0,1448.0,972.0
0.006,6,10,2007,5,928,1.0,660.0,660.0,5,1079,1.0,811.0,811.0
0.004,6,10,1774,5,923,1.0,655.0,655.0,5,851,0.0,583.0,583.0
0.003,17,4,284,2,120,0.0,32.0,32.0,2,164,0.0,60.0,54.0
0.005,17,2,170,1,65,0.0,37.0,37.0,1,105,0.0,77.0,77.0
0.085,6,10,1506,5,395,19.0,127.0,127.0,5,1111,19.0,843.0,843.0
0.074,6,10,1506,5,395,17.0,127.0,127.0,5,1111,16.0,843.0,843.0
0.004,6,10,1702,5,863,1.0,595.0,595.0,5,839,0.0,571.0,571.0
0.011,6,10,1989,5,910,2.0,642.0,642.0,5,1079,2.0,811.0,811.0
0.092,6,10,1506,5,395,21.0,127.0,127.0,5,1111,16.0,843.0,843.0
0.004,6,10,2007,5,928,1.0,660.0,660.0,5,1079,1.0,811.0,811.0
290.413,6,379,347133,196,21759,1489.0,2736.0,825.0,183,325374,1595.0,2804.0,1857.0
0.006,6,10,1689,5,839,1.0,571.0,571.0,5,850,1.0,582.0,582.0
0.005,6,10,1689,5,839,1.0,571.0,571.0,5,850,1.0,582.0,582.0
0.073,6,10,1506,5,395,16.0,127.0,127.0,5,1111,14.0,843.0,843.0
0.015,6,10,1989,5,910,3.0,642.0,642.0,5,1079,3.0,811.0,811.0
0.01,6,10,1989,5,910,2.0,642.0,642.0,5,1079,2.0,811.0,811.0
240.104,6,16,4481,9,963,30013.0,238.0,166.0,7,3518,40016.0,1402.0,786.0
0.072,17,2,148,1,60,0.0,32.0,32.0,1,88,0.0,60.0,60.0
0.005,6,10,2000,5,927,1.0,659.0,659.0,5,1073,1.0,805.0,805.0
0.005,6,10,1854,5,889,1.0,621.0,621.0,5,965,1.0,697.0,697.0
240.297,6,45,8877,23,5790,10922.0,1368.0,458.0,22,3087,11442.0,580.0,241.0
11.18,17,28,4421,14,1994,847.0,269.0,114.0,14,2427,847.0,586.0,145.0
0.006,6,10,1689,5,839,1.0,571.0,571.0,5,850,1.0,582.0,582.0
0.086,6,10,1506,5,395,19.0,127.0,127.0,5,1111,15.0,843.0,843.0
0.114,6,10,1506,5,395,27.0,127.0,127.0,5,1111,21.0,843.0,843.0
0.017,6,10,1677,5,827,4.0,559.0,559.0,5,850,4.0,582.0,582.0
15.122,17,15,7292,7,3796,2515.0,1350.0,514.0,8,3496,2155.0,1350.0,409.0
0.066,17,8,3613,4,1874,22.0,1350.0,440.0,4,1739,10.0,1350.0,406.0
0.072,17,2,412,1,61,0.0,33.0,33.0,1,351,0.0,323.0,323.0
0.008,6,10,1972,5,910,2.0,642.0,642.0,5,1062,1.0,794.0,794.0
0.093,6,10,1506,5,395,19.0,127.0,127.0,5,1111,19.0,843.0,843.0
0.039,17,2,128,1,56,0.0,28.0,28.0,1,72,0.0,44.0,44.0
0.091,6,10,1506,5,395,21.0,127.0,127.0,5,1111,20.0,843.0,843.0
0.091,6,10,1506,5,395,20.0,127.0,127.0,5,1111,19.0,843.0,843.0
0.005,6,10,1689,5,839,1.0,571.0,571.0,5,850,1.0,582.0,582.0
0.005,6,10,1643,5,860,1.0,592.0,592.0,5,783,1.0,515.0,515.0
0.144,6,10,1506,5,395,31.0,127.0,127.0,5,1111,33.0,843.0,843.0
40.057,17,10,676,5,460,10013.0,104.0,64.0,5,216,10013.0,20.0,15.0
0.013,6,10,1990,5,911,3.0,643.0,643.0,5,1079,3.0,811.0,811.0
0.065,6,10,1506,5,395,14.0,127.0,127.0,5,1111,15.0,843.0,843.0
1778.729,17,143,41496,72,22752,25052.0,288.0,288.0,71,18744,25410.0,236.0,236.0
0.012,6,12,1926,6,1189,2.0,659.0,434.0,6,737,2.0,417.0,417.0
0.088,6,10,1506,5,395,20.0,127.0,127.0,5,1111,19.0,843.0,843.0
0.099,6,10,1506,5,395,20.0,127.0,127.0,5,1111,23.0,843.0,843.0
0.005,17,2,168,1,76,0.0,48.0,48.0,1,92,0.0,64.0,64.0
0.019,17,2,186,1,61,0.0,33.0,33.0,1,125,0.0,97.0,97.0
0.06,17,2,152,1,76,0.0,48.0,48.0,1,76,0.0,48.0,48.0
0.082,6,10,1506,5,395,19.0,127.0,127.0,5,1111,18.0,843.0,843.0
0.094,6,10,1506,5,395,22.0,127.0,127.0,5,1111,22.0,843.0,843.0
0.005,6,10,2007,5,928,1.0,660.0,660.0,5,1079,1.0,811.0,811.0
0.08,6,10,1506,5,395,15.0,127.0,127.0,5,1111,17.0,843.0,843.0
0.012,6,10,1972,5,910,3.0,642.0,642.0,5,1062,3.0,794.0,794.0
0.091,6,10,1506,5,395,21.0,127.0,127.0,5,1111,22.0,843.0,843.0
333.209,6,31,10504,17,2710,20825.0,676.0,363.0,14,7794,21015.0,1402.0,882.0
0.005,6,10,1689,5,839,1.0,571.0,571.0,5,850,1.0,582.0,582.0
0.005,6,10,2006,5,927,1.0,659.0,659.0,5,1079,1.0,811.0,811.0
0.004,6,10,2007,5,928,1.0,660.0,660.0,5,1079,1.0,811.0,811.0
1761.244,6,64,7344,42,4469,42957.0,1625.0,108.0,22,2875,83860.0,1111.0,82.0
0.004,6,10,1779,5,928,1.0,660.0,660.0,5,851,1.0,583.0,583.0
0.014,6,10,1677,5,827,3.0,559.0,559.0,5,850,3.0,582.0,582.0
0.221,17,2,152,1,76,0.0,48.0,48.0,1,76,0.0,48.0,48.0
0.004,6,10,2000,5,927,1.0,659.0,659.0,5,1073,1.0,805.0,805.0
0.022,6,10,1762,5,911,5.0,643.0,643.0,5,851,5.0,583.0,583.0
10.813,17,28,4421,14,1994,823.0,269.0,114.0,14,2427,823.0,586.0,145.0
240.122,6,37,27391,20,18242,12638.0,2736.0,1564.0,17,9149,15007.0,2725.0,1179.0
0.005,6,10,2006,5,927,1.0,659.0,659.0,5,1079,1.0,811.0,811.0
0.006,6,10,1547,5,764,1.0,496.0,496.0,5,783,1.0,515.0,515.0
40.053,17,10,676,5,460,10011.0,104.0,64.0,5,216,10012.0,20.0,15.0
0.005,17,2,148,1,60,0.0,32.0,32.0,1,88,0.0,60.0,60.0
0.005,6,10,1989,5,927,1.0,659.0,659.0,5,1062,1.0,794.0,794.0
0.006,6,10,1643,5,860,1.0,592.0,592.0,5,783,1.0,515.0,515.0
0.005,17,2,193,1,71,0.0,43.0,43.0,1,122,0.0,94.0,94.0
0.091,6,10,1506,5,395,18.0,127.0,127.0,5,1111,19.0,843.0,843.0
0.005,6,10,2007,5,928,1.0,660.0,660.0,5,1079,1.0,811.0,811.0
0.013,6,10,1631,5,848,3.0,580.0,580.0,5,783,3.0,515.0,515.0
0.015,6,10,1983,5,910,3.0,642.0,642.0,5,1073,3.0,805.0,805.0
0.094,6,10,1506,5,395,20.0,127.0,127.0,5,1111,20.0,843.0,843.0
0.004,6,10,2006,5,927,1.0,659.0,659.0,5,1079,1.0,811.0,811.0
0.097,6,10,1506,5,395,21.0,127.0,127.0,5,1111,20.0,843.0,843.0
9.037,17,6,376,5,280,2259.0,28.0,28.0,1,96,0.0,68.0,68.0
308.579,17,20,1124,10,716,34272.0,48.0,43.0,10,408,34272.0,20.0,12.0
0.073,6,10,1506,5,395,15.0,127.0,127.0,5,1111,15.0,843.0,843.0
1771.716,6,307,97832,190,86619,9374.0,1963.0,673.0,117,11213,15273.0,452.0,69.0
0.005,6,10,1689,5,839,1.0,571.0,571.0,5,850,1.0,582.0,582.0
0.126,17,2,136,1,60,0.0,32.0,32.0,1,76,0.0,48.0,48.0
0.073,6,10,1506,5,395,16.0,127.0,127.0,5,1111,16.0,843.0,843.0
241.32,6,399,347990,197,21763,1231.0,2736.0,959.0,202,326227,1200.0,2804.0,1644.0
0.093,6,10,1506,5,395,22.0,127.0,127.0,5,1111,15.0,843.0,843.0
0.015,17,2,198,1,91,0.0,63.0,63.0,1,107,0.0,79.0,79.0
0.012,6,10,1631,5,848,2.0,580.0,580.0,5,783,3.0,515.0,515.0
0.026,6,10,1972,5,910,6.0,642.0,642.0,5,1062,6.0,794.0,794.0
0.005,6,10,2007,5,928,1.0,660.0,660.0,5,1079,1.0,811.0,811.0
0.051,17,2,136,1,60,0.0,32.0,32.0,1,76,0.0,48.0,48.0
0.005,17,4,596,2,122,1.0,33.0,33.0,2,474,1.0,323.0,209.0
0.038,17,2,184,1,61,0.0,33.0,33.0,1,123,0.0,95.0,95.0
0.013,6,13,3735,7,497,2.0,125.0,125.0,6,3238,2.0,1470.0,1459.0
0.004,6,10,1702,5,863,1.0,595.0,595.0,5,839,0.0,571.0,571.0
0.008,6,12,1926,6,1189,1.0,659.0,434.0,6,737,1.0,417.0,417.0
40.071,17,10,676,5,460,10015.0,104.0,64.0,5,216,10015.0,20.0,15.0
40.076,17,10,676,5,460,10016.0,104.0,64.0,5,216,10015.0,20.0,15.0
0.004,6,10,2000,5,927,1.0,659.0,659.0,5,1073,1.0,805.0,805.0
0.011,6,10,1972,5,910,2.0,642.0,642.0,5,1062,2.0,794.0,794.0
1743.213,6,64,7361,42,4485,42517.0,1641.0,109.0,22,2876,83001.0,1112.0,82.0
0.016,6,10,1631,5,848,4.0,580.0,580.0,5,783,4.0,515.0,515.0
240.105,6,31,9476,16,7086,16007.0,2157.0,695.0,15,2390,17150.0,580.0,200.0
0.012,6,10,1989,5,910,3.0,642.0,642.0,5,1079,2.0,811.0,811.0
0.127,6,10,1506,5,395,22.0,127.0,127.0,5,1111,27.0,843.0,843.0
0.077,6,10,1506,5,395,16.0,127.0,127.0,5,1111,18.0,843.0,843.0
40.085,17,10,676,5,460,10020.0,104.0,64.0,5,216,10020.0,20.0,15.0
0.097,6,10,1506,5,395,21.0,127.0,127.0,5,1111,21.0,843.0,843.0
0.006,17,2,170,1,65,0.0,37.0,37.0,1,105,0.0,77.0,77.0
0.005,17,2,170,1,65,0.0,37.0,37.0,1,105,0.0,77.0,77.0
40.053,17,10,676,5,460,10011.0,104.0,64.0,5,216,10012.0,20.0,15.0
0.089,6,10,1506,5,395,20.0,127.0,127.0,5,1111,19.0,843.0,843.0
0.009,6,10,1990,5,911,2.0,643.0,643.0,5,1079,2.0,811.0,811.0
0.075,6,10,1506,5,395,17.0,127.0,127.0,5,1111,17.0,843.0,843.0
0.004,6,10,2006,5,927,1.0,659.0,659.0,5,1079,1.0,811.0,811.0
0.009,6,10,1989,5,910,2.0,642.0,642.0,5,1079,2.0,811.0,811.0
0.077,6,10,1506,5,395,16.0,127.0,127.0,5,1111,17.0,843.0,843.0
0.04,17,2,148,1,60,0.0,32.0,32.0,1,88,0.0,60.0,60.0
0.004,17,4,284,2,120,0.0,32.0,32.0,2,164,0.0,60.0,54.0
0.041,17,2,152,1,76,0.0,48.0,48.0,1,76,0.0,48.0,48.0
0.111,6,10,1506,5,395,25.0,127.0,127.0,5,1111,18.0,843.0,843.0
0.012,6,10,1631,5,848,3.0,580.0,580.0,5,783,3.0,515.0,515.0
0.011,6,13,3735,7,497,1.0,125.0,125.0,6,3238,2.0,1470.0,1459.0
241.841,6,391,348103,187,21249,1300.0,2736.0,959.0,204,326854,1191.0,2804.0,1630.0
0.005,6,10,1989,5,927,1.0,659.0,659.0,5,1062,1.0,794.0,794.0
0.175,6,10,1506,5,395,37.0,127.0,127.0,5,1111,42.0,843.0,843.0
0.009,6,10,1989,5,910,2.0,642.0,642.0,5,1079,2.0,811.0,811.0
0.007,17,2,194,1,59,0.0,31.0,31.0,1,135,0.0,107.0,107.0
0.003,17,2,136,1,60,0.0,32.0,32.0,1,76,0.0,48.0,48.0
0.006,17,2,179,1,71,0.0,43.0,43.0,1,108,0.0,80.0,80.0
0.006,6,10,1547,5,764,1.0,496.0,496.0,5,783,1.0,515.0,515.0
40.1,17,10,676,5,460,10021.0,104.0,64.0,5,216,10024.0,20.0,15.0
0.006,17,2,140,1,62,0.0,34.0,34.0,1,78,0.0,50.0,50.0
1770.719,6,135,6510,75,3585,23928.0,39.0,39.0,60,2925,30008.0,35.0,35.0
0.004,6,10,2000,5,927,1.0,659.0,659.0,5,1073,1.0,805.0,805.0
0.006,6,10,1547,5,764,1.0,496.0,496.0,5,783,1.0,515.0,515.0
300.026,6,12,1782,7,1348,50004.0,494.0,494.0,5,434,75005.0,83.0,83.0
0.018,6,10,1972,5,910,4.0,642.0,642.0,5,1062,4.0,794.0,794.0
0.004,6,10,1702,5,863,1.0,595.0,595.0,5,839,0.0,571.0,571.0
240.663,6,35,8938,18,2087,14154.0,696.0,226.0,17,6851,15039.0,1402.0,597.0
0.118,6,10,1506,5,395,27.0,127.0,127.0,5,1111,23.0,843.0,843.0
0.005,6,10,1547,5,764,1.0,496.0,496.0,5,783,1.0,515.0,515.0
0.158,6,10,1506,5,395,37.0,127.0,127.0,5,1111,24.0,843.0,843.0
40.06,17,10,676,5,460,10014.0,104.0,64.0,5,216,10014.0,20.0,15.0
0.016,17,2,198,1,91,0.0,63.0,63.0,1,107,0.0,79.0,79.0
0.079,6,10,1506,5,395,15.0,127.0,127.0,5,1111,18.0,843.0,843.0
0.005,17,2,144,1,64,0.0,36.0,36.0,1,80,0.0,52.0,52.0
0.006,6,10,1643,5,860,1.0,592.0,592.0,5,783,1.0,515.0,515.0
354.061,6,21,1795,16,1030,23604.0,190.0,190.0,5,765,60003.0,464.0,248.0
0.004,6,10,2007,5,928,1.0,660.0,660.0,5,1079,1.0,811.0,811.0
0.11,6,10,1506,5,395,25.0,127.0,127.0,5,1111,22.0,843.0,843.0
0.068,6,10,1506,5,395,14.0,127.0,127.0,5,1111,14.0,843.0,843.0
0.004,6,10,1774,5,923,1.0,655.0,655.0,5,851,1.0,583.0,583.0
0.004,17,2,136,1,60,0.0,32.0,32.0,1,76,0.0,48.0,48.0
0.001,17,2,180,1,66,0.0,38.0,38.0,1,114,0.0,86.0,86.0
0.006,6,10,1547,5,764,1.0,496.0,496.0,5,783,1.0,515.0,515.0
0.096,6,10,1506,5,395,22.0,127.0,127.0,5,1111,20.0,843.0,843.0
0.01,6,10,1762,5,911,2.0,643.0,643.0,5,851,2.0,583.0,583.0
0.004,17,2,180,1,58,0.0,30.0,30.0,1,122,0.0,94.0,94.0
0.143,6,10,1506,5,395,28.0,127.0,127.0,5,1111,30.0,843.0,843.0
0.04,17,2,184,1,61,0.0,33.0,33.0,1,123,0.0,95.0,95.0
0.01,6,10,1989,5,910,2.0,642.0,642.0,5,1079,2.0,811.0,811.0
0.006,6,14,3799,7,509,1.0,137.0,137.0,7,3290,0.0,1448.0,972.0
0.005,6,10,1779,5,928,1.0,660.0,660.0,5,851,1.0,583.0,583.0
0.004,6,10,1702,5,863,1.0,595.0,595.0,5,839,1.0,571.0,571.0
0.005,6,10,2007,5,928,1.0,660.0,660.0,5,1079,1.0,811.0,811.0
0.136,6,10,1506,5,395,25.0,127.0,127.0,5,1111,32.0,843.0,843.0
40.061,17,10,676,5,460,10014.0,104.0,64.0,5,216,10014.0,20.0,15.0
0.004,17,2,140,1,62,0.0,34.0,34.0,1,78,0.0,50.0,50.0
0.01,6,10,1990,5,911,2.0,643.0,643.0,5,1079,2.0,811.0,811.0
0.005,6,10,2000,5,927,1.0,659.0,659.0,5,1073,1.0,805.0,805.0
0.121,6,10,1506,5,395,25.0,127.0,127.0,5,1111,25.0,843.0,843.0
0.01,6,10,1989,5,910,2.0,642.0,642.0,5,1079,2.0,811.0,811.0
0.007,6,10,1689,5,839,1.0,571.0,571.0,5,850,1.0,582.0,582.0
0.014,6,10,1989,5,910,3.0,642.0,642.0,5,1079,3.0,811.0,811.0
0.005,17,2,222,1,65,0.0,37.0,37.0,1,157,0.0,129.0,129.0
0.01,6,10,1972,5,910,2.0,642.0,642.0,5,1062,2.0,794.0,794.0
0.004,6,10,1774,5,923,1.0,655.0,655.0,5,851,1.0,583.0,583.0
0.006,17,2,214,1,75,0.0,47.0,47.0,1,139,0.0,111.0,111.0
0.001,17,2,180,1,66,0.0,38.0,38.0,1,114,0.0,86.0,86.0
0.005,6,10,2007,5,928,1.0,660.0,660.0,5,1079,1.0,811.0,811.0
0.017,6,10,1631,5,848,4.0,580.0,580.0,5,783,4.0,515.0,515.0
0.001,17,2,180,1,66,0.0,38.0,38.0,1,114,0.0,86.0,86.0
0.01,6,10,1990,5,911,2.0,643.0,643.0,5,1079,2.0,811.0,811.0
0.012,17,2,136,1,60,0.0,32.0,32.0,1,76,0.0,48.0,48.0
0.012,6,10,1983,5,910,2.0,642.0,642.0,5,1073,3.0,805.0,805.0
0.016,6,10,1989,5,910,4.0,642.0,642.0,5,1079,4.0,811.0,811.0
0.102,6,10,1506,5,395,23.0,127.0,127.0,5,1111,23.0,843.0,843.0
0.066,6,10,1506,5,395,15.0,127.0,127.0,5,1111,15.0,843.0,843.0
0.005,6,10,1989,5,927,1.0,659.0,659.0,5,1062,1.0,794.0,794.0
352.25,6,20,2210,6,1308,12004.0,494.0,494.0,14,902,27095.0,83.0,83.0
0.006,17,2,225,1,65,0.0,37.0,37.0,1,160,0.0,132.0,132.0
0.032,6,10,1631,5,848,7.0,580.0,580.0,5,783,8.0,515.0,515.0
0.11,6,10,1506,5,395,20.0,127.0,127.0,5,1111,21.0,843.0,843.0
0.012,6,10,1677,5,827,3.0,559.0,559.0,5,850,2.0,582.0,582.0
0.012,6,10,1990,5,911,3.0,643.0,643.0,5,1079,3.0,811.0,811.0
0.01,6,10,1989,5,910,2.0,642.0,642.0,5,1079,2.0,811.0,811.0
0.009,6,10,2000,5,927,2.0,659.0,659.0,5,1073,2.0,805.0,805.0
240.123,6,16,4481,9,963,30015.0,238.0,166.0,7,3518,40020.0,1402.0,786.0
0.001,17,2,194,1,57,0.0,29.0,29.0,1,137,0.0,109.0,109.0
0.168,17,2,152,1,76,0.0,48.0,48.0,1,76,0.0,48.0,48.0
0.083,6,10,1506,5,395,18.0,127.0,127.0,5,1111,17.0,843.0,843.0
0.011,6,10,1990,5,911,2.0,643.0,643.0,5,1079,2.0,811.0,811.0
0.005,6,10,2006,5,927,1.0,659.0,659.0,5,1079,1.0,811.0,811.0
0.019,6,10,1762,5,911,4.0,643.0,643.0,5,851,4.0,583.0,583.0
0.082,6,10,1506,5,395,15.0,127.0,127.0,5,1111,19.0,843.0,843.0
0.006,17,2,169,1,62,0.0,34.0,34.0,1,107,0.0,79.0,79.0
300.016,6,11,891,6,552,60002.0,232.0,232.0,5,339,75003.0,83.0,83.0
0.004,6,10,2007,5,928,1.0,660.0,660.0,5,1079,1.0,811.0,811.0
0.115,6,10,1506,5,395,20.0,127.0,127.0,5,1111,25.0,843.0,843.0
0.004,6,10,2006,5,927,1.0,659.0,659.0,5,1079,1.0,811.0,811.0
0.004,17,2,136,1,60,0.0,32.0,32.0,1,76,0.0,48.0,48.0
0.14,6,10,1506,5,395,32.0,127.0,127.0,5,1111,28.0,843.0,843.0
0.068,6,10,1506,5,395,13.0,127.0,127.0,5,1111,16.0,843.0,843.0
0.012,6,10,1631,5,848,2.0,580.0,580.0,5,783,3.0,515.0,515.0
0.078,6,10,1506,5,395,16.0,127.0,127.0,5,1111,17.0,843.0,843.0
0.004,6,10,1702,5,863,1.0,595.0,595.0,5,839,0.0,571.0,571.0
0.006,6,10,1547,5,764,1.0,496.0,496.0,5,783,1.0,515.0,515.0
175.488,17,84,11718,42,2795,4280.0,44.0,38.0,42,8923,4280.0,239.0,184.0
0.012,6,10,1989,5,910,3.0,642.0,642.0,5,1079,2.0,811.0,811.0
0.013,17,2,152,1,56,0.0,28.0,28.0,1,96,0.0,68.0,68.0
0.006,17,2,214,1,75,0.0,47.0,47.0,1,139,0.0,111.0,111.0
0.011,6,10,1990,5,911,2.0,643.0,643.0,5,1079,2.0,811.0,811.0
0.005,6,10,2006,5,927,1.0,659.0,659.0,5,1079,1.0,811.0,811.0
0.041,17,2,396,1,61,0.0,33.0,33.0,1,335,0.0,307.0,307.0
0.004,6,10,1702,5,863,1.0,595.0,595.0,5,839,1.0,571.0,571.0
0.001,17,2,179,1,62,0.0,34.0,34.0,1,117,0.0,89.0,89.0
0.001,17,2,180,1,66,0.0,38.0,38.0,1,114,0.0,86.0,86.0
0.01,6,10,1972,5,910,2.0,642.0,642.0,5,1062,2.0,794.0,794.0
0.016,6,10,1972,5,910,4.0,642.0,642.0,5,1062,3.0,794.0,794.0
0.083,6,10,1506,5,395,19.0,127.0,127.0,5,1111,17.0,843.0,843.0
0.013,6,10,1989,5,910,3.0,642.0,642.0,5,1079,3.0,811.0,811.0
0.011,6,10,1989,5,910,2.0,642.0,642.0,5,1079,2.0,811.0,811.0
281.786,6,27,6235,12,1266,25616.0,267.0,156.0,15,4969,20114.0,1400.0,873.0
0.005,6,10,1989,5,927,1.0,659.0,659.0,5,1062,1.0,794.0,794.0
0.089,6,10,1506,5,395,20.0,127.0,127.0,5,1111,20.0,843.0,843.0
0.005,6,10,2006,5,927,1.0,659.0,659.0,5,1079,1.0,811.0,811.0
1756.066,6,105,6270,60,3525,29763.0,27.0,27.0,45,2745,39909.0,27.0,27.0
378.778,6,20,2210,6,1308,12003.0,494.0,494.0,14,902,29136.0,83.0,83.0
0.005,6,10,2006,5,927,1.0,659.0,659.0,5,1079,1.0,811.0,811.0
0.01,6,10,1983,5,910,2.0,642.0,642.0,5,1073,2.0,805.0,805.0
0.128,17,2,80,1,32,0.0,4.0,4.0,1,48,0.0,20.0,20.0
0.007,17,2,194,1,59,0.0,31.0,31.0,1,135,0.0,107.0,107.0
40.072,17,10,676,5,460,10016.0,104.0,64.0,5,216,10017.0,20.0,15.0
0.009,6,13,3735,7,497,1.0,125.0,125.0,6,3238,1.0,1470.0,1459.0
0.015,6,10,1989,5,910,3.0,642.0,642.0,5,1079,3.0,811.0,811.0
0.004,17,2,136,1,60,0.0,32.0,32.0,1,76,0.0,48.0,48.0
0.004,6,10,2007,5,928,1.0,660.0,660.0,5,1079,1.0,811.0,811.0
0.062,6,10,1506,5,395,14.0,127.0,127.0,5,1111,13.0,843.0,843.0
0.005,6,10,2007,5,928,1.0,660.0,660.0,5,1079,1.0,811.0,811.0
0.016,6,10,1972,5,910,4.0,642.0,642.0,5,1062,3.0,794.0,794.0
0.005,6,10,2007,5,928,1.0,660.0,660.0,5,1079,1.0,811.0,811.0
0.005,6,10,1689,5,839,1.0,571.0,571.0,5,850,1.0,582.0,582.0
0.009,6,13,3735,7,497,1.0,125.0,125.0,6,3238,1.0,1470.0,1459.0
0.013,6,10,1990,5,911,3.0,643.0,643.0,5,1079,3.0,811.0,811.0
0.012,6,10,1990,5,911,3.0,643.0,643.0,5,1079,3.0,811.0,811.0
0.006,6,10,1547,5,764,1.0,496.0,496.0,5,783,1.0,515.0,515.0
0.001,17,2,166,1,75,0.0,47.0,47.0,1,91,0.0,63.0,63.0
0.013,17,2,225,1,65,0.0,37.0,37.0,1,160,0.0,132.0,132.0
0.11,6,10,1506,5,395,25.0,127.0,127.0,5,1111,25.0,843.0,843.0
0.005,6,10,2006,5,927,1.0,659.0,659.0,5,1079,1.0,811.0,811.0
0.082,17,2,80,1,32,0.0,4.0,4.0,1,48,0.0,20.0,20.0
0.248,17,39,20219,21,17038,12.0,1350.0,783.0,18,3181,10.0,1350.0,148.0
0.007,6,10,2000,5,927,1.0,659.0,659.0,5,1073,1.0,805.0,805.0
0.01,6,10,1631,5,848,2.0,580.0,580.0,5,783,2.0,515.0,515.0
0.004,17,2,188,1,62,0.0,34.0,34.0,1,126,0.0,98.0,98.0
308.38,17,20,1124,10,716,34250.0,48.0,43.0,10,408,34250.0,20.0,12.0
0.066,6,10,1506,5,395,15.0,127.0,127.0,5,1111,13.0,843.0,843.0
0.074,6,10,1506,5,395,16.0,127.0,127.0,5,1111,16.0,843.0,843.0
0.006,6,10,1689,5,839,1.0,571.0,571.0,5,850,1.0,582.0,582.0
0.005,6,14,3742,7,452,0.0,80.0,80.0,7,3290,0.0,1448.0,972.0
0.006,17,2,152,1,68,0.0,40.0,40.0,1,84,0.0,56.0,56.0
0.006,6,10,2006,5,927,1.0,659.0,659.0,5,1079,1.0,811.0,811.0
0.008,6,12,1926,6,1189,1.0,659.0,434.0,6,737,1.0,417.0,417.0
0.068,6,10,1506,5,395,16.0,127.0,127.0,5,1111,14.0,843.0,843.0
0.011,6,10,2007,5,928,2.0,660.0,660.0,5,1079,2.0,811.0,811.0
308.397,17,20,1124,10,716,34252.0,48.0,43.0,10,408,34252.0,20.0,12.0
0.019,6,10,1972,5,910,4.0,642.0,642.0,5,1062,4.0,794.0,794.0
0.103,6,10,1506,5,395,24.0,127.0,127.0,5,1111,22.0,843.0,843.0
10.822,17,28,4422,14,1994,823.0,269.0,114.0,14,2428,823.0,587.0,145.0
0.114,6,10,1506,5,395,26.0,127.0,127.0,5,1111,25.0,843.0,843.0
0.004,17,2,136,1,60,0.0,32.0,32.0,1,76,0.0,48.0,48.0
0.009,6,10,1972,5,910,2.0,642.0,642.0,5,1062,2.0,794.0,794.0
0.005,6,10,1854,5,889,1.0,621.0,621.0,5,965,1.0,697.0,697.0
0.04,17,2,412,1,61,0.0,33.0,33.0,1,351,0.0,323.0,323.0
0.063,6,10,1506,5,395,15.0,127.0,127.0,5,1111,14.0,843.0,843.0
0.14,6,10,1506,5,395,31.0,127.0,127.0,5,1111,31.0,843.0,843.0
0.012,6,10,1990,5,911,3.0,643.0,643.0,5,1079,3.0,811.0,811.0
167.129,17,78,11136,39,2601,4397.0,44.0,38.0,39,8535,4398.0,261.0,190.0
0.008,6,10,1990,5,911,2.0,643.0,643.0,5,1079,1.0,811.0,811.0
0.009,17,2,338,1,74,0.0,46.0,46.0,1,264,0.0,236.0,236.0
0.091,6,10,1506,5,395,19.0,127.0,127.0,5,1111,21.0,843.0,843.0
0.004,6,10,2006,5,927,1.0,659.0,659.0,5,1079,1.0,811.0,811.0
0.007,17,2,179,1,71,0.0,43.0,43.0,1,108,0.0,80.0,80.0
0.001,17,2,180,1,66,0.0,38.0,38.0,1,114,0.0,86.0,86.0
0.01,6,10,1631,5,848,2.0,580.0,580.0,5,783,2.0,515.0,515.0
0.013,17,2,152,1,76,0.0,48.0,48.0,1,76,0.0,48.0,48.0
0.012,6,10,1972,5,910,2.0,642.0,642.0,5,1062,3.0,794.0,794.0
0.007,6,10,1689,5,839,1.0,571.0,571.0,5,850,1.0,582.0,582.0
0.012,6,10,1989,5,910,2.0,642.0,642.0,5,1079,3.0,811.0,811.0
0.013,6,10,1989,5,910,3.0,642.0,642.0,5,1079,3.0,811.0,811.0
0.005,6,10,2006,5,927,1.0,659.0,659.0,5,1079,1.0,811.0,811.0
0.07,17,8,3613,4,1874,23.0,1350.0,440.0,4,1739,12.0,1350.0,406.0
0.01,6,10,1972,5,910,2.0,642.0,642.0,5,1062,2.0,794.0,794.0
0.006,6,10,1854,5,889,1.0,621.0,621.0,5,965,1.0,697.0,697.0
40.06,17,10,676,5,460,10013.0,104.0,64.0,5,216,10014.0,20.0,15.0
0.005,6,10,2006,5,927,1.0,659.0,659.0,5,1079,1.0,811.0,811.0
0.042,6,10,1972,5,910,10.0,642.0,642.0,5,1062,10.0,794.0,794.0
0.004,17,2,136,1,60,0.0,32.0,32.0,1,76,0.0,48.0,48.0
40.058,17,10,676,5,460,10013.0,104.0,64.0,5,216,10012.0,20.0,15.0
0.018,6,10,1990,5,911,4.0,643.0,643.0,5,1079,4.0,811.0,811.0
0.011,6,10,1983,5,910,2.0,642.0,642.0,5,1073,2.0,805.0,805.0
0.004,6,10,1702,5,863,0.0,595.0,595.0,5,839,1.0,571.0,571.0
0.005,6,10,1989,5,927,1.0,659.0,659.0,5,1062,1.0,794.0,794.0
308.969,17,18,1008,9,640,38604.0,48.0,43.0,9,368,38604.0,20.0,12.0
0.005,6,10,2007,5,928,1.0,660.0,660.0,5,1079,1.0,811.0,811.0
0.008,6,10,1983,5,910,2.0,642.0,642.0,5,1073,2.0,805.0,805.0
0.006,6,10,1854,5,889,1.0,621.0,621.0,5,965,1.0,697.0,697.0
0.012,6,10,1631,5,848,3.0,580.0,580.0,5,783,2.0,515.0,515.0
11.643,17,28,4398,14,2313,882.0,588.0,137.0,14,2085,883.0,268.0,120.0
0.004,6,10,2006,5,927,1.0,659.0,659.0,5,1079,1.0,811.0,811.0
0.016,6,10,1983,5,910,3.0,642.0,642.0,5,1073,3.0,805.0,805.0
0.005,6,10,2000,5,927,1.0,659.0,659.0,5,1073,1.0,805.0,805.0
0.005,6,10,2006,5,927,1.0,659.0,659.0,5,1079,1.0,811.0,811.0
0.002,17,2,180,1,66,0.0,38.0,38.0,1,114,0.0,86.0,86.0
0.005,6,10,1989,5,927,1.0,659.0,659.0,5,1062,1.0,794.0,794.0
0.128,17,2,80,1,32,0.0,4.0,4.0,1,48,0.0,20.0,20.0
0.005,6,10,2000,5,927,1.0,659.0,659.0,5,1073,1.0,805.0,805.0
0.037,17,2,152,1,76,0.0,48.0,48.0,1,76,0.0,48.0,48.0
0.106,6,10,1506,5,395,24.0,127.0,127.0,5,1111,25.0,843.0,843.0
0.01,6,12,1926,6,1189,2.0,659.0,434.0,6,737,1.0,417.0,417.0
0.005,6,10,2000,5,927,1.0,659.0,659.0,5,1073,1.0,805.0,805.0
0.004,6,10,2006,5,927,1.0,659.0,659.0,5,1079,1.0,811.0,811.0
0.133,17,4,284,2,120,0.0,32.0,32.0,2,164,62.0,60.0,54.0
0.043,17,2,182,1,65,0.0,37.0,37.0,1,117,0.0,89.0,89.0
0.013,6,10,1989,5,910,3.0,642.0,642.0,5,1079,3.0,811.0,811.0
0.006,6,10,1547,5,764,1.0,496.0,496.0,5,783,1.0,515.0,515.0
0.005,6,10,1989,5,927,1.0,659.0,659.0,5,1062,1.0,794.0,794.0
0.004,6,10,2007,5,928,1.0,660.0,660.0,5,1079,1.0,811.0,811.0
0.064,6,10,1506,5,395,13.0,127.0,127.0,5,1111,15.0,843.0,843.0
0.006,17,2,230,1,68,0.0,40.0,40.0,1,162,0.0,134.0,134.0
0.054,6,10,1972,5,910,13.0,642.0,642.0,5,1062,13.0,794.0,794.0
240.092,6,16,4481,9,963,30011.0,238.0,166.0,7,3518,40014.0,1402.0,786.0
0.001,17,2,136,1,60,0.0,32.0,32.0,1,76,0.0,48.0,48.0
241.032,6,27,9388,14,2736,18540.0,990.0,503.0,13,6652,20085.0,1593.0,746.0
0.014,6,14,3787,7,497,2.0,125.0,125.0,7,3290,2.0,1448.0,972.0
0.005,17,2,170,1,65,0.0,37.0,37.0,1,105,0.0,77.0,77.0
0.013,6,10,1989,5,910,3.0,642.0,642.0,5,1079,3.0,811.0,811.0
0.005,6,13,3690,7,452,0.0,80.0,80.0,6,3238,1.0,1470.0,1459.0
0.005,6,10,1774,5,923,1.0,655.0,655.0,5,851,1.0,583.0,583.0
40.073,17,10,676,5,460,10017.0,104.0,64.0,5,216,10017.0,20.0,15.0
40.054,17,10,676,5,460,10012.0,104.0,64.0,5,216,10012.0,20.0,15.0
0.001,17,2,136,1,60,0.0,32.0,32.0,1,76,0.0,48.0,48.0
0.124,6,14,4388,8,923,17.0,238.0,166.0,6,3465,16.0,1402.0,786.0
0.09,6,10,1506,5,395,19.0,127.0,127.0,5,1111,21.0,843.0,843.0
0.077,6,10,1506,5,395,17.0,127.0,127.0,5,1111,16.0,843.0,843.0
0.028,6,13,3747,7,509,4.0,137.0,137.0,6,3238,5.0,1470.0,1459.0
0.004,6,10,2007,5,928,1.0,660.0,660.0,5,1079,1.0,811.0,811.0
0.005,6,10,1689,5,839,1.0,571.0,571.0,5,850,1.0,582.0,582.0
0.08,6,10,1506,5,395,17.0,127.0,127.0,5,1111,18.0,843.0,843.0
0.018,6,10,2006,5,927,4.0,659.0,659.0,5,1079,4.0,811.0,811.0
0.004,17,2,234,1,61,0.0,33.0,33.0,1,173,0.0,145.0,145.0
0.087,6,10,1506,5,395,17.0,127.0,127.0,5,1111,20.0,843.0,843.0
0.121,6,10,1506,5,395,26.0,127.0,127.0,5,1111,26.0,843.0,843.0
240.07,6,20,4874,10,889,26674.0,180.0,93.0,10,3985,26674.0,1593.0,576.0
40.077,17,10,676,5,460,10017.0,104.0,64.0,5,216,10018.0,20.0,15.0
0.01,6,10,1972,5,910,2.0,642.0,642.0,5,1062,2.0,794.0,794.0
0.006,6,10,1547,5,764,1.0,496.0,496.0,5,783,1.0,515.0,515.0
0.015,17,2,198,1,91,0.0,63.0,63.0,1,107,0.0,79.0,79.0
0.005,6,10,2006,5,927,1.0,659.0,659.0,5,1079,1.0,811.0,811.0
0.008,6,10,1762,5,911,2.0,643.0,643.0,5,851,2.0,583.0,583.0
0.005,6,10,2000,5,927,1.0,659.0,659.0,5,1073,1.0,805.0,805.0
0.005,6,10,1774,5,923,1.0,655.0,655.0,5,851,1.0,583.0,583.0
0.008,6,10,1990,5,911,1.0,643.0,643.0,5,1079,2.0,811.0,811.0
0.013,6,10,1972,5,910,3.0,642.0,642.0,5,1062,3.0,794.0,794.0
0.004,6,10,1779,5,928,1.0,660.0,660.0,5,851,1.0,583.0,583.0
0.004,6,10,2000,5,927,1.0,659.0,659.0,5,1073,1.0,805.0,805.0
353.403,6,20,2210,6,1308,12004.0,494.0,494.0,14,902,27184.0,83.0,83.0
0.01,6,10,1972,5,910,2.0,642.0,642.0,5,1062,2.0,794.0,794.0
0.005,6,10,1689,5,839,1.0,571.0,571.0,5,850,1.0,582.0,582.0
0.005,6,10,2006,5,927,1.0,659.0,659.0,5,1079,1.0,811.0,811.0
0.005,17,2,140,1,62,0.0,34.0,34.0,1,78,0.0,50.0,50.0
0.009,6,10,1989,5,910,2.0,642.0,642.0,5,1079,2.0,811.0,811.0
0.008,6,10,2000,5,927,1.0,659.0,659.0,5,1073,2.0,805.0,805.0
1756.015,6,105,6270,60,3525,29762.0,27.0,27.0,45,2745,39908.0,27.0,27.0
40.07,17,10,676,5,460,10016.0,104.0,64.0,5,216,10016.0,20.0,15.0
0.015,6,10,1983,5,910,3.0,642.0,642.0,5,1073,3.0,805.0,805.0
0.038,17,2,144,1,64,0.0,36.0,36.0,1,80,0.0,52.0,52.0
361.81,6,19,1689,15,978,25843.0,190.0,190.0,4,711,80013.0,495.0,495.0
0.006,6,10,1689,5,839,1.0,571.0,571.0,5,850,1.0,582.0,582.0
9.037,17,6,376,5,280,2259.0,28.0,28.0,1,96,0.0,68.0,68.0
0.014,6,10,1989,5,910,3.0,642.0,642.0,5,1079,3.0,811.0,811.0
0.001,17,2,136,1,60,0.0,32.0,32.0,1,76,0.0,48.0,48.0
0.131,6,10,1506,5,395,29.0,127.0,127.0,5,1111,29.0,843.0,843.0
0.009,6,13,3735,7,497,1.0,125.0,125.0,6,3238,1.0,1470.0,1459.0
0.003,17,2,148,1,60,0.0,32.0,32.0,1,88,0.0,60.0,60.0
291.633,6,413,349323,203,22115,1443.0,2736.0,825.0,210,327208,1395.0,2804.0,1613.0
0.119,6,10,1506,5,395,29.0,127.0,127.0,5,1111,28.0,843.0,843.0
300.402,6,16,2170,9,684,37529.0,146.0,146.0,7,1486,50038.0,419.0,398.0
1757.661,6,108,6426,60,3525,29790.0,27.0,27.0,48,2901,37396.0,27.0,27.0
0.011,6,10,1972,5,910,2.0,642.0,642.0,5,1062,2.0,794.0,794.0
175.136,17,74,10391,37,2465,4864.0,44.0,38.0,37,7926,4864.0,239.0,186.0
0.041,17,2,152,1,76,0.0,48.0,48.0,1,76,0.0,48.0,48.0
1761.183,6,434,65358,258,35614,6852.0,613.0,194.0,176,29744,10063.0,453.0,143.0
0.003,17,4,284,2,120,0.0,32.0,32.0,2,164,0.0,60.0,54.0
0.006,6,10,1547,5,764,1.0,496.0,496.0,5,783,1.0,515.0,515.0
0.005,6,10,1989,5,927,1.0,659.0,659.0,5,1062,1.0,794.0,794.0
0.006,6,10,1643,5,860,1.0,592.0,592.0,5,783,1.0,515.0,515.0
0.009,6,10,1989,5,910,2.0,642.0,642.0,5,1079,2.0,811.0,811.0
0.007,17,2,179,1,71,0.0,43.0,43.0,1,108,0.0,80.0,80.0
0.005,6,10,1774,5,923,1.0,655.0,655.0,5,851,1.0,583.0,583.0
0.14,6,10,1506,5,395,33.0,127.0,127.0,5,1111,31.0,843.0,843.0
0.009,6,12,1926,6,1189,1.0,659.0,434.0,6,737,1.0,417.0,417.0
0.013,6,13,3735,7,497,2.0,125.0,125.0,6,3238,2.0,1470.0,1459.0
0.003,17,4,284,2,120,0.0,32.0,32.0,2,164,0.0,60.0,54.0
0.005,17,2,146,1,65,0.0,37.0,37.0,1,81,0.0,53.0,53.0
0.005,17,2,136,1,60,0.0,32.0,32.0,1,76,0.0,48.0,48.0
0.038,17,2,152,1,76,0.0,48.0,48.0,1,76,0.0,48.0,48.0
0.004,17,2,136,1,60,0.0,32.0,32.0,1,76,0.0,48.0,48.0
0.004,17,4,284,2,120,0.0,32.0,32.0,2,164,0.0,60.0,54.0
0.013,6,10,1972,5,910,3.0,642.0,642.0,5,1062,3.0,794.0,794.0
0.084,6,10,1506,5,395,18.0,127.0,127.0,5,1111,19.0,843.0,843.0
0.005,17,2,214,1,75,0.0,47.0,47.0,1,139,0.0,111.0,111.0
0.004,6,10,1702,5,863,1.0,595.0,595.0,5,839,0.0,571.0,571.0
0.091,6,10,1506,5,395,20.0,127.0,127.0,5,1111,20.0,843.0,843.0
10.938,17,28,4421,14,1994,832.0,269.0,114.0,14,2427,832.0,586.0,145.0
0.005,6,10,2006,5,927,1.0,659.0,659.0,5,1079,1.0,811.0,811.0
0.005,6,10,2006,5,927,1.0,659.0,659.0,5,1079,1.0,811.0,811.0
0.005,17,2,230,1,68,0.0,40.0,40.0,1,162,0.0,134.0,134.0
9.035,17,6,376,5,280,2258.0,28.0,28.0,1,96,0.0,68.0,68.0
0.052,17,2,152,1,76,0.0,48.0,48.0,1,76,0.0,48.0,48.0
40.053,17,10,676,5,460,10012.0,104.0,64.0,5,216,10012.0,20.0,15.0
0.022,6,10,1989,5,910,5.0,642.0,642.0,5,1079,5.0,811.0,811.0
0.001,17,2,180,1,66,0.0,38.0,38.0,1,114,0.0,86.0,86.0
0.039,17,4,284,2,120,0.0,32.0,32.0,2,164,36.0,60.0,54.0
178.577,17,80,11244,40,2664,4578.0,44.0,38.0,40,8580,4578.0,261.0,186.0
0.006,6,10,1547,5,764,1.0,496.0,496.0,5,783,1.0,515.0,515.0
0.006,6,10,1689,5,839,1.0,571.0,571.0,5,850,1.0,582.0,582.0
0.01,6,10,1762,5,911,2.0,643.0,643.0,5,851,2.0,583.0,583.0
0.111,6,10,1506,5,395,27.0,127.0,127.0,5,1111,26.0,843.0,843.0
356.316,6,19,2158,6,1308,12005.0,494.0,494.0,13,850,29692.0,83.0,83.0
0.121,6,10,1506,5,395,24.0,127.0,127.0,5,1111,26.0,843.0,843.0
0.011,6,10,1989,5,910,2.0,642.0,642.0,5,1079,2.0,811.0,811.0
0.068,6,10,1506,5,395,14.0,127.0,127.0,5,1111,15.0,843.0,843.0
15.08,17,16,8660,8,6575,2150.0,1350.0,793.0,8,2085,2150.0,1350.0,232.0
0.005,6,10,2007,5,928,1.0,660.0,660.0,5,1079,1.0,811.0,811.0
0.019,6,10,1631,5,848,4.0,580.0,580.0,5,783,4.0,515.0,515.0
40.072,17,10,676,5,460,10017.0,104.0,64.0,5,216,10016.0,20.0,15.0
0.005,17,2,293,1,73,0.0,45.0,45.0,1,220,0.0,192.0,192.0
0.004,17,2,148,1,60,0.0,32.0,32.0,1,88,0.0,60.0,60.0
0.008,6,10,1989,5,910,2.0,642.0,642.0,5,1079,2.0,811.0,811.0
0.051,17,4,284,2,120,1.0,32.0,32.0,2,164,44.0,60.0,54.0
0.005,6,10,1774,5,923,1.0,655.0,655.0,5,851,1.0,583.0,583.0
0.034,17,4,284,2,120,0.0,32.0,32.0,2,164,1.0,60.0,54.0
0.071,6,10,1506,5,395,15.0,127.0,127.0,5,1111,16.0,843.0,843.0
0.005,6,10,1989,5,927,1.0,659.0,659.0,5,1062,1.0,794.0,794.0
0.006,6,10,1547,5,764,1.0,496.0,496.0,5,783,1.0,515.0,515.0
0.009,6,10,1989,5,910,2.0,642.0,642.0,5,1079,2.0,811.0,811.0
0.168,6,10,1506,5,395,37.0,127.0,127.0,5,1111,38.0,843.0,843.0
240.091,6,32,9264,16,6660,16006.0,1733.0,648.0,16,2604,16005.0,580.0,220.0
0.004,17,2,148,1,60,0.0,32.0,32.0,1,88,0.0,60.0,60.0
93.224,6,30,18564,16,12547,63.0,4080.0,1484.0,14,6017,7158.0,2720.0,907.0
0.11,6,10,1506,5,395,27.0,127.0,127.0,5,1111,23.0,843.0,843.0
0.013,6,10,1973,5,911,3.0,643.0,643.0,5,1062,3.0,794.0,794.0
0.006,6,10,1547,5,764,1.0,496.0,496.0,5,783,1.0,515.0,515.0
0.006,6,10,1547,5,764,1.0,496.0,496.0,5,783,1.0,515.0,515.0
0.014,17,2,136,1,60,0.0,32.0,32.0,1,76,0.0,48.0,48.0
0.005,6,10,2006,5,927,1.0,659.0,659.0,5,1079,1.0,811.0,811.0
0.005,6,10,1989,5,927,1.0,659.0,659.0,5,1062,1.0,794.0,794.0
11.02,17,28,4417,14,1993,839.0,268.0,114.0,14,2424,839.0,587.0,145.0
0.007,6,10,1989,5,910,1.0,642.0,642.0,5,1079,1.0,811.0,811.0
0.088,6,10,1506,5,395,19.0,127.0,127.0,5,1111,18.0,843.0,843.0
0.005,6,10,1689,5,839,1.0,571.0,571.0,5,850,1.0,582.0,582.0
1772.733,6,272,31957,112,15282,15969.0,2059.0,126.0,160,16675,11148.0,1360.0,128.0
0.004,17,2,136,1,60,0.0,32.0,32.0,1,76,0.0,48.0,48.0
0.041,17,4,284,2,120,1.0,32.0,32.0,2,164,37.0,60.0,54.0
0.038,17,4,284,2,120,0.0,32.0,32.0,2,164,34.0,60.0,54.0
0.134,6,10,1506,5,395,31.0,127.0,127.0,5,1111,30.0,843.0,843.0
0.011,6,10,1972,5,910,2.0,642.0,642.0,5,1062,2.0,794.0,794.0
0.214,6,16,2777,8,1395,30.0,533.0,323.0,8,1382,19.0,529.0,239.0
0.006,6,10,1547,5,764,1.0,496.0,496.0,5,783,1.0,515.0,515.0
0.006,6,10,1989,5,927,1.0,659.0,659.0,5,1062,1.0,794.0,794.0
0.006,6,10,1689,5,839,1.0,571.0,571.0,5,850,1.0,582.0,582.0
40.054,17,10,676,5,460,10012.0,104.0,64.0,5,216,10012.0,20.0,15.0
0.006,6,10,1989,5,927,1.0,659.0,659.0,5,1062,1.0,794.0,794.0
0.074,6,10,1506,5,395,15.0,127.0,127.0,5,1111,16.0,843.0,843.0
0.012,6,10,1677,5,827,3.0,559.0,559.0,5,850,2.0,582.0,582.0
0.007,17,2,179,1,71,0.0,43.0,43.0,1,108,0.0,80.0,80.0
0.171,6,3,453,2,321,171.0,241.0,241.0,1,132,0.0,92.0,92.0
0.005,6,10,1689,5,839,1.0,571.0,571.0,5,850,1.0,582.0,582.0
0.005,17,2,214,1,75,0.0,47.0,47.0,1,139,0.0,111.0,111.0
0.106,6,10,1506,5,395,25.0,127.0,127.0,5,1111,25.0,843.0,843.0
0.004,17,4,284,2,120,0.0,32.0,32.0,2,164,0.0,60.0,54.0
0.039,17,2,184,1,61,0.0,33.0,33.0,1,123,0.0,95.0,95.0
0.005,6,10,2006,5,927,1.0,659.0,659.0,5,1079,1.0,811.0,811.0
0.005,6,10,1643,5,860,1.0,592.0,592.0,5,783,1.0,515.0,515.0
0.009,6,10,1989,5,910,2.0,642.0,642.0,5,1079,2.0,811.0,811.0
178.553,17,84,11776,42,2794,4354.0,44.0,38.0,42,8982,4354.0,261.0,185.0
240.265,6,47,9024,25,5906,10010.0,1368.0,458.0,22,3118,11441.0,580.0,218.0
0.075,6,10,1506,5,395,17.0,127.0,127.0,5,1111,14.0,843.0,843.0
0.005,6,10,2006,5,927,1.0,659.0,659.0,5,1079,1.0,811.0,811.0
0.005,17,2,166,1,75,0.0,47.0,47.0,1,91,0.0,63.0,63.0
240.104,6,16,4481,9,963,30013.0,238.0,166.0,7,3518,40016.0,1402.0,786.0
0.102,6,10,1506,5,395,15.0,127.0,127.0,5,1111,22.0,843.0,843.0
0.006,6,10,1547,5,764,1.0,496.0,496.0,5,783,1.0,515.0,515.0
0.004,6,10,1989,5,927,1.0,659.0,659.0,5,1062,1.0,794.0,794.0
0.006,6,10,1989,5,927,1.0,659.0,659.0,5,1062,1.0,794.0,794.0
0.014,6,10,1983,5,910,3.0,642.0,642.0,5,1073,3.0,805.0,805.0
0.17,17,2,152,1,76,0.0,48.0,48.0,1,76,0.0,48.0,48.0
0.01,6,10,1989,5,910,2.0,642.0,642.0,5,1079,2.0,811.0,811.0
0.013,6,10,1677,5,827,3.0,559.0,559.0,5,850,3.0,582.0,582.0
240.669,6,35,8925,18,2073,14155.0,694.0,225.0,17,6852,15039.0,1402.0,597.0
0.114,6,10,1506,5,395,26.0,127.0,127.0,5,1111,27.0,843.0,843.0
0.011,6,10,1990,5,911,2.0,643.0,643.0,5,1079,2.0,811.0,811.0
0.005,6,10,1854,5,889,1.0,621.0,621.0,5,965,1.0,697.0,697.0
0.011,6,10,1972,5,910,2.0,642.0,642.0,5,1062,2.0,794.0,794.0
0.013,6,10,1989,5,910,3.0,642.0,642.0,5,1079,3.0,811.0,811.0
0.009,6,10,1990,5,911,2.0,643.0,643.0,5,1079,2.0,811.0,811.0
0.006,6,10,1547,5,764,1.0,496.0,496.0,5,783,1.0,515.0,515.0
0.04,17,4,284,2,120,0.0,32.0,32.0,2,164,37.0,60.0,54.0
240.115,6,31,9307,15,6958,17151.0,2082.0,686.0,16,2349,16007.0,580.0,188.0
0.004,6,10,1989,5,927,1.0,659.0,659.0,5,1062,1.0,794.0,794.0
0.005,6,10,1989,5,927,1.0,659.0,659.0,5,1062,1.0,794.0,794.0
1770.043,6,301,97474,187,86390,9516.0,1402.0,672.0,114,11084,15664.0,452.0,70.0
0.006,17,2,222,1,65,0.0,37.0,37.0,1,157,0.0,129.0,129.0
0.011,6,10,1983,5,910,2.0,642.0,642.0,5,1073,2.0,805.0,805.0
0.006,6,10,1547,5,764,1.0,496.0,496.0,5,783,1.0,515.0,515.0
0.005,6,10,2006,5,927,1.0,659.0,659.0,5,1079,1.0,811.0,811.0
0.026,6,10,1990,5,911,6.0,643.0,643.0,5,1079,6.0,811.0,811.0
0.011,6,10,1989,5,910,2.0,642.0,642.0,5,1079,2.0,811.0,811.0
0.077,6,10,1506,5,395,17.0,127.0,127.0,5,1111,16.0,843.0,843.0
0.101,6,10,1506,5,395,22.0,127.0,127.0,5,1111,24.0,843.0,843.0
0.011,6,10,1989,5,910,2.0,642.0,642.0,5,1079,2.0,811.0,811.0
0.028,6,10,1972,5,910,6.0,642.0,642.0,5,1062,6.0,794.0,794.0
0.004,17,4,284,2,120,0.0,32.0,32.0,2,164,0.0,60.0,54.0
0.042,17,2,144,1,64,0.0,36.0,36.0,1,80,0.0,52.0,52.0
0.004,17,4,284,2,120,0.0,32.0,32.0,2,164,1.0,60.0,54.0
163.193,17,86,12498,43,2875,3885.0,44.0,38.0,43,9623,3885.0,260.0,195.0
0.012,6,10,1972,5,910,2.0,642.0,642.0,5,1062,3.0,794.0,794.0
0.002,17,2,152,1,76,0.0,48.0,48.0,1,76,0.0,48.0,48.0
1108.185,6,156,24649,59,16615,19106.0,2720.0,290.0,97,8034,11542.0,1062.0,92.0
0.005,6,10,1989,5,927,1.0,659.0,659.0,5,1062,1.0,794.0,794.0
0.017,17,2,136,1,60,0.0,32.0,32.0,1,76,0.0,48.0,48.0
0.013,6,10,1762,5,911,3.0,643.0,643.0,5,851,3.0,583.0,583.0
0.005,6,10,2006,5,927,1.0,659.0,659.0,5,1079,1.0,811.0,811.0
0.124,6,10,1506,5,395,25.0,127.0,127.0,5,1111,22.0,843.0,843.0
0.006,17,2,179,1,71,0.0,43.0,43.0,1,108,0.0,80.0,80.0
160.066,17,82,11475,41,2726,4001.0,44.0,38.0,41,8749,4001.0,252.0,185.0
0.003,17,2,136,1,60,0.0,32.0,32.0,1,76,0.0,48.0,48.0
0.003,17,2,148,1,60,0.0,32.0,32.0,1,88,0.0,60.0,60.0
0.193,6,10,1506,5,395,45.0,127.0,127.0,5,1111,41.0,843.0,843.0
0.001,17,2,248,1,68,0.0,40.0,40.0,1,180,0.0,152.0,152.0
0.043,17,2,152,1,76,0.0,48.0,48.0,1,76,0.0,48.0,48.0
0.091,6,10,1506,5,395,14.0,127.0,127.0,5,1111,21.0,843.0,843.0
0.09,6,10,1506,5,395,20.0,127.0,127.0,5,1111,20.0,843.0,843.0
0.014,6,10,1989,5,910,3.0,642.0,642.0,5,1079,3.0,811.0,811.0
0.122,6,10,1506,5,395,27.0,127.0,127.0,5,1111,24.0,843.0,843.0
0.081,6,10,1506,5,395,18.0,127.0,127.0,5,1111,18.0,843.0,843.0
0.005,6,10,2006,5,927,1.0,659.0,659.0,5,1079,1.0,811.0,811.0
0.039,17,2,148,1,60,0.0,32.0,32.0,1,88,0.0,60.0,60.0
0.006,6,10,1547,5,764,1.0,496.0,496.0,5,783,1.0,515.0,515.0
40.049,17,10,676,5,460,10010.0,104.0,64.0,5,216,10011.0,20.0,15.0
0.007,17,2,194,1,59,0.0,31.0,31.0,1,135,0.0,107.0,107.0
0.004,6,10,2007,5,928,1.0,660.0,660.0,5,1079,1.0,811.0,811.0
0.012,6,10,1972,5,910,2.0,642.0,642.0,5,1062,3.0,794.0,794.0
15.07,17,15,9238,8,6902,2148.0,1350.0,834.0,7,2336,2506.0,1350.0,305.0
0.004,6,10,1774,5,923,1.0,655.0,655.0,5,851,1.0,583.0,583.0
0.005,6,10,1547,5,764,1.0,496.0,496.0,5,783,1.0,515.0,515.0
0.053,17,2,152,1,76,0.0,48.0,48.0,1,76,0.0,48.0,48.0
0.081,6,10,1506,5,395,19.0,127.0,127.0,5,1111,18.0,843.0,843.0
0.001,17,2,180,1,66,0.0,38.0,38.0,1,114,0.0,86.0,86.0
0.007,6,10,1547,5,764,1.0,496.0,496.0,5,783,1.0,515.0,515.0
0.441,17,2,144,1,64,0.0,36.0,36.0,1,80,0.0,52.0,52.0
240.028,6,9,787,5,488,60007.0,232.0,232.0,4,299,80008.0,83.0,83.0
0.004,6,10,1779,5,928,1.0,660.0,660.0,5,851,1.0,583.0,583.0
0.009,6,10,1972,5,910,2.0,642.0,642.0,5,1062,2.0,794.0,794.0
1628.204,6,220,26095,85,17703,19383.0,2790.0,207.0,135,8392,12149.0,148.0,47.0
0.003,17,2,148,1,60,0.0,32.0,32.0,1,88,0.0,60.0,60.0
0.005,6,10,2006,5,927,1.0,659.0,659.0,5,1079,1.0,811.0,811.0
0.076,6,10,1506,5,395,16.0,127.0,127.0,5,1111,17.0,843.0,843.0
0.005,6,10,1689,5,839,1.0,571.0,571.0,5,850,1.0,582.0,582.0
60.999,6,46,16622,24,10715,395.0,2720.0,1080.0,22,5907,2896.0,2667.0,385.0
0.007,6,10,1972,5,910,1.0,642.0,642.0,5,1062,1.0,794.0,794.0
0.101,6,10,1506,5,395,23.0,127.0,127.0,5,1111,22.0,843.0,843.0
0.004,17,4,284,2,120,0.0,32.0,32.0,2,164,0.0,60.0,54.0
0.003,17,4,284,2,120,0.0,32.0,32.0,2,164,0.0,60.0,54.0
0.042,17,2,148,1,60,0.0,32.0,32.0,1,88,0.0,60.0,60.0
0.005,6,10,1643,5,860,1.0,592.0,592.0,5,783,1.0,515.0,515.0
10.81,17,28,4418,14,1994,823.0,269.0,114.0,14,2424,823.0,587.0,145.0
0.004,6,10,1989,5,927,1.0,659.0,659.0,5,1062,1.0,794.0,794.0
0.011,6,10,1677,5,827,2.0,559.0,559.0,5,850,2.0,582.0,582.0
169.184,17,82,11619,41,2737,4229.0,44.0,38.0,41,8882,4229.0,239.0,188.0
0.012,6,10,1972,5,910,3.0,642.0,642.0,5,1062,2.0,794.0,794.0
0.117,6,10,1506,5,395,25.0,127.0,127.0,5,1111,27.0,843.0,843.0
0.004,17,2,136,1,60,0.0,32.0,32.0,1,76,0.0,48.0,48.0
0.001,17,2,142,1,63,0.0,35.0,35.0,1,79,0.0,51.0,51.0
0.006,6,14,3799,7,509,0.0,137.0,137.0,7,3290,0.0,1448.0,972.0
0.014,6,14,3787,7,497,2.0,125.0,125.0,7,3290,2.0,1448.0,972.0
0.006,6,10,1854,5,889,1.0,621.0,621.0,5,965,1.0,697.0,697.0
0.024,6,20,9974,11,704,2.0,124.0,124.0,9,9270,3.0,2896.0,1758.0
0.005,6,10,1643,5,860,1.0,592.0,592.0,5,783,1.0,515.0,515.0
40.065,17,10,676,5,460,10014.0,104.0,64.0,5,216,10015.0,20.0,15.0
0.09,6,10,1506,5,395,21.0,127.0,127.0,5,1111,20.0,843.0,843.0
0.005,17,2,170,1,65,0.0,37.0,37.0,1,105,0.0,77.0,77.0
280.448,6,23,6075,10,1186,31160.0,267.0,156.0,13,4889,23368.0,1400.0,873.0
0.072,17,2,148,1,60,0.0,32.0,32.0,1,88,0.0,60.0,60.0
0.006,6,10,1547,5,764,1.0,496.0,496.0,5,783,1.0,515.0,515.0
0.011,6,10,1989,5,910,2.0,642.0,642.0,5,1079,2.0,811.0,811.0
61.422,6,27,18381,16,10482,4094.0,2804.0,1206.0,11,7899,6130.0,2322.0,1219.0
0.005,6,10,2007,5,928,1.0,660.0,660.0,5,1079,1.0,811.0,811.0
0.005,17,2,166,1,75,0.0,47.0,47.0,1,91,0.0,63.0,63.0
0.042,17,2,184,1,61,0.0,33.0,33.0,1,123,0.0,95.0,95.0
0.013,6,10,1983,5,910,3.0,642.0,642.0,5,1073,3.0,805.0,805.0
0.111,6,10,1506,5,395,25.0,127.0,127.0,5,1111,25.0,843.0,843.0
0.005,6,10,2007,5,928,1.0,660.0,660.0,5,1079,1.0,811.0,811.0
0.005,6,10,2007,5,928,1.0,660.0,660.0,5,1079,1.0,811.0,811.0
300.338,6,16,2170,9,684,37521.0,146.0,146.0,7,1486,50029.0,419.0,398.0
0.009,17,2,214,1,75,0.0,47.0,47.0,1,139,0.0,111.0,111.0
0.012,6,10,1972,5,910,2.0,642.0,642.0,5,1062,3.0,794.0,794.0
0.004,6,10,1989,5,927,1.0,659.0,659.0,5,1062,1.0,794.0,794.0
0.009,6,10,2006,5,927,2.0,659.0,659.0,5,1079,2.0,811.0,811.0
0.071,6,10,1506,5,395,14.0,127.0,127.0,5,1111,16.0,843.0,843.0
0.095,6,10,1506,5,395,21.0,127.0,127.0,5,1111,22.0,843.0,843.0
0.001,17,2,178,1,81,0.0,53.0,53.0,1,97,0.0,69.0,69.0
0.022,6,10,1990,5,911,5.0,643.0,643.0,5,1079,5.0,811.0,811.0
0.007,6,10,1989,5,910,1.0,642.0,642.0,5,1079,1.0,811.0,811.0
0.005,6,14,3799,7,509,0.0,137.0,137.0,7,3290,0.0,1448.0,972.0
300.336,6,16,2170,9,684,37521.0,146.0,146.0,7,1486,50028.0,419.0,398.0
0.004,6,10,1779,5,928,1.0,660.0,660.0,5,851,1.0,583.0,583.0
0.004,6,10,2007,5,928,1.0,660.0,660.0,5,1079,1.0,811.0,811.0
0.004,17,2,152,1,76,0.0,48.0,48.0,1,76,0.0,48.0,48.0
0.06,17,2,152,1,76,0.0,48.0,48.0,1,76,0.0,48.0,48.0
0.039,17,4,284,2,120,0.0,32.0,32.0,2,164,36.0,60.0,54.0
0.006,17,2,170,1,65,0.0,37.0,37.0,1,105,0.0,77.0,77.0
0.007,6,10,2006,5,927,1.0,659.0,659.0,5,1079,1.0,811.0,811.0
0.114,6,10,1506,5,395,25.0,127.0,127.0,5,1111,22.0,843.0,843.0
0.005,6,10,1689,5,839,1.0,571.0,571.0,5,850,1.0,582.0,582.0
0.006,6,10,2006,5,927,1.0,659.0,659.0,5,1079,1.0,811.0,811.0
0.005,17,2,169,1,62,0.0,34.0,34.0,1,107,0.0,79.0,79.0
0.005,6,10,2000,5,927,1.0,659.0,659.0,5,1073,1.0,805.0,805.0
0.081,6,43,13921,24,2503,3.0,517.0,139.0,19,11418,4.0,1402.0,801.0
15.078,17,15,8133,8,6042,2150.0,1350.0,727.0,7,2091,2508.0,1350.0,270.0
0.01,6,12,1926,6,1189,2.0,659.0,434.0,6,737,1.0,417.0,417.0
0.089,6,10,1506,5,395,19.0,127.0,127.0,5,1111,19.0,843.0,843.0
0.124,6,10,1506,5,395,29.0,127.0,127.0,5,1111,27.0,843.0,843.0
0.003,17,2,148,1,60,0.0,32.0,32.0,1,88,0.0,60.0,60.0
15.334,17,46,27891,27,24817,588.0,1350.0,891.0,19,3074,850.0,1350.0,133.0
40.075,17,10,676,5,460,10015.0,104.0,64.0,5,216,10017.0,20.0,15.0
293.111,6,384,348103,185,21176,1592.0,2736.0,888.0,199,326927,1480.0,2881.0,1711.0
0.004,17,2,148,1,60,0.0,32.0,32.0,1,88,0.0,60.0,60.0
240.09,6,18,5748,10,1027,26676.0,238.0,166.0,8,4721,34298.0,1402.0,859.0
0.011,6,10,1989,5,910,2.0,642.0,642.0,5,1079,2.0,811.0,811.0
0.003,17,2,148,1,60,0.0,32.0,32.0,1,88,0.0,60.0,60.0
0.082,6,10,1506,5,395,19.0,127.0,127.0,5,1111,18.0,843.0,843.0
0.026,6,10,1989,5,910,6.0,642.0,642.0,5,1079,6.0,811.0,811.0
0.006,17,2,179,1,71,0.0,43.0,43.0,1,108,0.0,80.0,80.0
0.011,6,10,1989,5,910,2.0,642.0,642.0,5,1079,2.0,811.0,811.0
0.085,6,10,1506,5,395,18.0,127.0,127.0,5,1111,20.0,843.0,843.0
0.102,6,10,1506,5,395,22.0,127.0,127.0,5,1111,21.0,843.0,843.0
0.001,17,2,136,1,60,0.0,32.0,32.0,1,76,0.0,48.0,48.0
40.062,17,10,676,5,460,10014.0,104.0,64.0,5,216,10014.0,20.0,15.0
0.008,17,2,213,1,69,0.0,41.0,41.0,1,144,0.0,116.0,116.0
0.072,17,2,166,1,75,0.0,47.0,47.0,1,91,0.0,63.0,63.0
354.008,6,21,1795,16,1030,23600.0,190.0,190.0,5,765,60002.0,464.0,248.0
0.021,6,10,1972,5,910,5.0,642.0,642.0,5,1062,5.0,794.0,794.0
0.076,6,10,1506,5,395,16.0,127.0,127.0,5,1111,16.0,843.0,843.0
0.027,6,10,1989,5,910,6.0,642.0,642.0,5,1079,6.0,811.0,811.0
0.005,17,2,170,1,65,0.0,37.0,37.0,1,105,0.0,77.0,77.0
0.013,6,10,1983,5,910,3.0,642.0,642.0,5,1073,3.0,805.0,805.0
0.004,17,2,186,1,61,0.0,33.0,33.0,1,125,0.0,97.0,97.0
0.005,17,2,170,1,65,0.0,37.0,37.0,1,105,0.0,77.0,77.0
0.005,6,10,2006,5,927,1.0,659.0,659.0,5,1079,1.0,811.0,811.0
0.006,6,10,1643,5,860,1.0,592.0,592.0,5,783,1.0,515.0,515.0
0.003,17,2,186,1,61,0.0,33.0,33.0,1,125,0.0,97.0,97.0
246.588,6,38,10061,16,6922,16439.0,1993.0,677.0,22,3139,11742.0,580.0,152.0
0.098,6,10,1506,5,395,21.0,127.0,127.0,5,1111,20.0,843.0,843.0
0.003,17,2,148,1,60,0.0,32.0,32.0,1,88,0.0,60.0,60.0
40.059,17,10,676,5,460,10013.0,104.0,64.0,5,216,10014.0,20.0,15.0
319.036,17,20,1124,10,716,35437.0,48.0,43.0,10,408,35436.0,20.0,12.0
0.107,6,10,1506,5,395,25.0,127.0,127.0,5,1111,25.0,843.0,843.0
11.127,17,28,4423,14,1994,843.0,269.0,114.0,14,2429,843.0,588.0,145.0
0.094,6,10,1506,5,395,23.0,127.0,127.0,5,1111,21.0,843.0,843.0
0.016,6,10,1990,5,911,3.0,643.0,643.0,5,1079,4.0,811.0,811.0
0.012,6,10,1677,5,827,3.0,559.0,559.0,5,850,3.0,582.0,582.0
40.058,17,10,676,5,460,10011.0,104.0,64.0,5,216,10013.0,20.0,15.0
240.12,6,20,7458,11,2637,24012.0,1368.0,517.0,9,4821,30014.0,1657.0,1086.0
0.059,17,2,80,1,32,0.0,4.0,4.0,1,48,0.0,20.0,20.0
0.011,6,10,1989,5,910,2.0,642.0,642.0,5,1079,2.0,811.0,811.0
0.075,6,10,1506,5,395,15.0,127.0,127.0,5,1111,17.0,843.0,843.0
0.015,6,10,1972,5,910,3.0,642.0,642.0,5,1062,3.0,794.0,794.0
0.005,6,10,1547,5,764,1.0,496.0,496.0,5,783,1.0,515.0,515.0
0.01,6,10,1983,5,910,2.0,642.0,642.0,5,1073,2.0,805.0,805.0
0.097,6,10,1506,5,395,14.0,127.0,127.0,5,1111,22.0,843.0,843.0
240.181,6,23,9267,12,4494,21834.0,1368.0,774.0,11,4773,24017.0,1497.0,1048.0
0.004,6,10,2007,5,928,1.0,660.0,660.0,5,1079,1.0,811.0,811.0
0.005,6,10,2006,5,927,1.0,659.0,659.0,5,1079,1.0,811.0,811.0
0.01,6,10,1989,5,910,2.0,642.0,642.0,5,1079,2.0,811.0,811.0
240.71,6,37,9658,19,2175,13370.0,747.0,235.0,18,7483,14157.0,1402.0,595.0
0.109,6,10,1506,5,395,25.0,127.0,127.0,5,1111,24.0,843.0,843.0
0.005,6,10,2000,5,927,1.0,659.0,659.0,5,1073,1.0,805.0,805.0
1798.115,6,439,66916,259,35690,6969.0,613.0,194.0,180,31226,10044.0,453.0,149.0
0.006,6,10,1989,5,927,1.0,659.0,659.0,5,1062,1.0,794.0,794.0
412.284,6,29,4409,12,3102,10914.0,494.0,494.0,17,1307,25767.0,83.0,83.0
0.005,6,10,2006,5,927,1.0,659.0,659.0,5,1079,1.0,811.0,811.0
0.051,17,2,182,1,65,0.0,37.0,37.0,1,117,0.0,89.0,89.0
40.071,17,10,676,5,460,10016.0,104.0,64.0,5,216,10017.0,20.0,15.0
0.006,6,10,2000,5,927,1.0,659.0,659.0,5,1073,1.0,805.0,805.0
0.011,6,10,1631,5,848,2.0,580.0,580.0,5,783,2.0,515.0,515.0
178.105,17,70,10007,35,2330,5238.0,44.0,38.0,35,7677,5238.0,239.0,191.0
0.027,6,10,1990,5,911,6.0,643.0,643.0,5,1079,6.0,811.0,811.0
0.004,6,10,2006,5,927,1.0,659.0,659.0,5,1079,1.0,811.0,811.0
240.022,6,9,787,5,488,60005.0,232.0,232.0,4,299,80006.0,83.0,83.0
0.01,6,10,1972,5,910,2.0,642.0,642.0,5,1062,2.0,794.0,794.0
0.117,6,10,1506,5,395,27.0,127.0,127.0,5,1111,27.0,843.0,843.0
0.096,6,10,1506,5,395,21.0,127.0,127.0,5,1111,22.0,843.0,843.0
0.014,6,13,3735,7,497,2.0,125.0,125.0,6,3238,2.0,1470.0,1459.0
0.009,6,12,1926,6,1189,1.0,659.0,434.0,6,737,1.0,417.0,417.0
0.004,6,10,2006,5,927,1.0,659.0,659.0,5,1079,1.0,811.0,811.0
0.053,17,2,152,1,76,0.0,48.0,48.0,1,76,0.0,48.0,48.0
0.449,17,19,12129,10,8351,49.0,1350.0,807.0,9,3778,39.0,1350.0,391.0
0.009,6,10,1631,5,848,2.0,580.0,580.0,5,783,2.0,515.0,515.0
0.005,6,10,2007,5,928,1.0,660.0,660.0,5,1079,1.0,811.0,811.0
0.089,6,10,1506,5,395,19.0,127.0,127.0,5,1111,20.0,843.0,843.0
240.118,6,32,9306,16,6955,16007.0,2027.0,680.0,16,2351,16007.0,580.0,188.0
0.009,6,10,1972,5,910,2.0,642.0,642.0,5,1062,2.0,794.0,794.0
0.39,6,45,12109,24,3738,16.0,1021.0,226.0,21,8371,19.0,2694.0,725.0
0.006,6,10,1989,5,927,1.0,659.0,659.0,5,1062,1.0,794.0,794.0
312.389,17,20,1124,10,716,34696.0,48.0,43.0,10,408,34696.0,20.0,12.0
0.011,6,10,1983,5,910,2.0,642.0,642.0,5,1073,2.0,805.0,805.0
0.093,6,10,1506,5,395,17.0,127.0,127.0,5,1111,23.0,843.0,843.0
40.055,17,10,676,5,460,10012.0,104.0,64.0,5,216,10013.0,20.0,15.0
1.418,6,30,13240,17,5841,88.0,2720.0,854.0,13,7399,101.0,2720.0,858.0
0.006,6,10,1989,5,927,1.0,659.0,659.0,5,1062,1.0,794.0,794.0
1776.026,6,233,46051,111,33724,16145.0,3840.0,1073.0,122,12327,14677.0,580.0,64.0
0.102,6,10,1506,5,395,22.0,127.0,127.0,5,1111,23.0,843.0,843.0
0.006,17,2,170,1,65,0.0,37.0,37.0,1,105,0.0,77.0,77.0
15.076,17,18,9651,9,7072,1880.0,1350.0,757.0,9,2579,1880.0,1350.0,258.0
0.014,6,10,1762,5,911,3.0,643.0,643.0,5,851,3.0,583.0,583.0
0.006,6,10,1547,5,764,1.0,496.0,496.0,5,783,1.0,515.0,515.0
177.139,17,92,13344,46,3100,3936.0,44.0,39.0,46,10244,3936.0,260.0,194.0
0.017,6,10,1990,5,911,4.0,643.0,643.0,5,1079,4.0,811.0,811.0
40.06,17,10,676,5,460,10013.0,104.0,64.0,5,216,10014.0,20.0,15.0
0.005,6,10,2007,5,928,1.0,660.0,660.0,5,1079,1.0,811.0,811.0
0.014,6,10,1990,5,911,3.0,643.0,643.0,5,1079,3.0,811.0,811.0
0.01,6,10,1972,5,910,2.0,642.0,642.0,5,1062,2.0,794.0,794.0
0.099,6,10,1506,5,395,22.0,127.0,127.0,5,1111,21.0,843.0,843.0
0.003,17,4,284,2,120,0.0,32.0,32.0,2,164,0.0,60.0,54.0
0.012,6,10,1989,5,910,3.0,642.0,642.0,5,1079,2.0,811.0,811.0
0.013,6,10,1972,5,910,3.0,642.0,642.0,5,1062,3.0,794.0,794.0
0.012,6,10,1972,5,910,3.0,642.0,642.0,5,1062,2.0,794.0,794.0
0.084,17,2,184,1,61,0.0,33.0,33.0,1,123,0.0,95.0,95.0
0.009,17,2,148,1,60,0.0,32.0,32.0,1,88,0.0,60.0,60.0
0.04,17,4,284,2,120,1.0,32.0,32.0,2,164,36.0,60.0,54.0
0.014,6,10,1631,5,848,3.0,580.0,580.0,5,783,3.0,515.0,515.0
0.004,17,2,148,1,60,0.0,32.0,32.0,1,88,0.0,60.0,60.0
15.072,17,15,9238,8,6902,2149.0,1350.0,834.0,7,2336,2507.0,1350.0,305.0
0.006,17,2,170,1,65,0.0,37.0,37.0,1,105,0.0,77.0,77.0
1780.22,6,64,7361,42,4485,43420.0,1641.0,109.0,22,2876,84764.0,1112.0,82.0
0.013,6,10,1989,5,910,3.0,642.0,642.0,5,1079,3.0,811.0,811.0
40.054,17,10,676,5,460,10012.0,104.0,64.0,5,216,10012.0,20.0,15.0
280.508,6,23,6075,10,1186,31167.0,267.0,156.0,13,4889,23375.0,1400.0,873.0
0.009,6,10,1989,5,910,2.0,642.0,642.0,5,1079,2.0,811.0,811.0
0.083,6,10,1506,5,395,18.0,127.0,127.0,5,1111,17.0,843.0,843.0
0.005,6,13,3690,7,452,0.0,80.0,80.0,6,3238,1.0,1470.0,1459.0
15.079,17,16,8889,8,6625,2150.0,1350.0,800.0,8,2264,2149.0,1350.0,255.0
0.001,17,2,179,1,62,0.0,34.0,34.0,1,117,0.0,89.0,89.0
0.005,17,2,170,1,65,0.0,37.0,37.0,1,105,0.0,77.0,77.0
40.083,17,10,676,5,460,10017.0,104.0,64.0,5,216,10017.0,20.0,15.0
0.103,6,10,1506,5,395,23.0,127.0,127.0,5,1111,24.0,843.0,843.0
0.08,6,10,1506,5,395,18.0,127.0,127.0,5,1111,16.0,843.0,843.0
308.569,17,20,1124,10,716,34271.0,48.0,43.0,10,408,34270.0,20.0,12.0
0.005,6,10,1774,5,923,1.0,655.0,655.0,5,851,1.0,583.0,583.0
0.135,17,2,80,1,32,0.0,4.0,4.0,1,48,0.0,20.0,20.0
0.005,6,10,1989,5,927,1.0,659.0,659.0,5,1062,1.0,794.0,794.0
0.078,6,10,1506,5,395,16.0,127.0,127.0,5,1111,18.0,843.0,843.0
0.001,17,2,136,1,60,0.0,32.0,32.0,1,76,0.0,48.0,48.0
0.101,6,10,1506,5,395,15.0,127.0,127.0,5,1111,22.0,843.0,843.0
0.008,6,10,1972,5,910,2.0,642.0,642.0,5,1062,1.0,794.0,794.0
0.012,6,10,1972,5,910,2.0,642.0,642.0,5,1062,2.0,794.0,794.0
0.012,6,10,1990,5,911,3.0,643.0,643.0,5,1079,3.0,811.0,811.0
0.011,6,10,1989,5,910,2.0,642.0,642.0,5,1079,2.0,811.0,811.0
0.005,6,10,1854,5,889,1.0,621.0,621.0,5,965,1.0,697.0,697.0
0.009,6,10,1989,5,927,2.0,659.0,659.0,5,1062,2.0,794.0,794.0
0.001,17,2,180,1,66,0.0,38.0,38.0,1,114,0.0,86.0,86.0
0.014,6,10,1990,5,911,3.0,643.0,643.0,5,1079,3.0,811.0,811.0
0.001,17,2,180,1,66,0.0,38.0,38.0,1,114,0.0,86.0,86.0
0.213,6,16,2669,8,1395,30.0,533.0,323.0,8,1274,19.0,529.0,212.0
10.773,17,28,4423,14,1994,820.0,269.0,114.0,14,2429,819.0,588.0,145.0
0.014,6,10,1990,5,911,3.0,643.0,643.0,5,1079,3.0,811.0,811.0
0.006,6,10,1547,5,764,1.0,496.0,496.0,5,783,1.0,515.0,515.0
0.104,6,10,1506,5,395,22.0,127.0,127.0,5,1111,25.0,843.0,843.0
0.005,6,10,2007,5,928,1.0,660.0,660.0,5,1079,1.0,811.0,811.0
0.051,6,10,1990,5,911,12.0,643.0,643.0,5,1079,12.0,811.0,811.0
0.105,6,10,1506,5,395,24.0,127.0,127.0,5,1111,24.0,843.0,843.0
0.003,17,2,136,1,60,0.0,32.0,32.0,1,76,0.0,48.0,48.0
0.009,6,10,1631,5,848,2.0,580.0,580.0,5,783,2.0,515.0,515.0
0.005,6,10,2000,5,927,1.0,659.0,659.0,5,1073,1.0,805.0,805.0
0.011,6,10,1677,5,827,2.0,559.0,559.0,5,850,2.0,582.0,582.0
0.005,17,2,144,1,64,0.0,36.0,36.0,1,80,0.0,52.0,52.0
0.014,6,10,1989,5,910,3.0,642.0,642.0,5,1079,3.0,811.0,811.0
0.004,6,10,2006,5,927,1.0,659.0,659.0,5,1079,1.0,811.0,811.0
0.006,6,10,1989,5,927,1.0,659.0,659.0,5,1062,1.0,794.0,794.0
0.008,6,10,1990,5,911,1.0,643.0,643.0,5,1079,2.0,811.0,811.0
0.006,17,2,170,1,65,0.0,37.0,37.0,1,105,0.0,77.0,77.0
0.053,17,2,152,1,76,0.0,48.0,48.0,1,76,0.0,48.0,48.0
0.017,6,10,1983,5,910,4.0,642.0,642.0,5,1073,4.0,805.0,805.0
0.008,17,2,179,1,71,0.0,43.0,43.0,1,108,0.0,80.0,80.0
0.008,17,2,194,1,59,0.0,31.0,31.0,1,135,0.0,107.0,107.0
0.12,6,10,1506,5,395,27.0,127.0,127.0,5,1111,29.0,843.0,843.0
240.024,6,9,787,5,488,60006.0,232.0,232.0,4,299,80007.0,83.0,83.0
0.064,6,10,1506,5,395,14.0,127.0,127.0,5,1111,14.0,843.0,843.0
0.011,6,10,1631,5,848,2.0,580.0,580.0,5,783,2.0,515.0,515.0
0.013,6,10,1972,5,910,3.0,642.0,642.0,5,1062,3.0,794.0,794.0
0.051,17,2,136,1,60,0.0,32.0,32.0,1,76,0.0,48.0,48.0
0.002,17,2,136,1,60,0.0,32.0,32.0,1,76,0.0,48.0,48.0
0.005,17,2,148,1,60,0.0,32.0,32.0,1,88,0.0,60.0,60.0
0.012,6,10,1989,5,910,2.0,642.0,642.0,5,1079,2.0,811.0,811.0
0.004,6,10,2007,5,928,1.0,660.0,660.0,5,1079,1.0,811.0,811.0
0.009,6,10,1762,5,911,2.0,643.0,643.0,5,851,2.0,583.0,583.0
65.597,6,22,10140,12,3973,5963.0,1579.0,835.0,10,6167,7270.0,2111.0,939.0
240.098,6,16,4481,9,963,30012.0,238.0,166.0,7,3518,40015.0,1402.0,786.0
0.005,6,10,2000,5,927,1.0,659.0,659.0,5,1073,1.0,805.0,805.0
0.012,6,10,1989,5,910,3.0,642.0,642.0,5,1079,3.0,811.0,811.0
0.009,17,2,213,1,69,0.0,41.0,41.0,1,144,0.0,116.0,116.0
0.065,6,10,1506,5,395,13.0,127.0,127.0,5,1111,12.0,843.0,843.0
0.009,6,10,1989,5,910,2.0,642.0,642.0,5,1079,2.0,811.0,811.0
0.013,6,10,1972,5,910,3.0,642.0,642.0,5,1062,3.0,794.0,794.0
0.01,6,10,1972,5,910,2.0,642.0,642.0,5,1062,2.0,794.0,794.0
0.012,6,10,1677,5,827,2.0,559.0,559.0,5,850,3.0,582.0,582.0
0.071,6,10,1506,5,395,13.0,127.0,127.0,5,1111,16.0,843.0,843.0
0.183,6,11,1558,6,447,35.0,127.0,127.0,5,1111,41.0,843.0,843.0
40.029,17,10,676,5,460,10006.0,104.0,64.0,5,216,10006.0,20.0,15.0
0.078,6,10,1506,5,395,18.0,127.0,127.0,5,1111,17.0,843.0,843.0
0.001,17,2,180,1,66,0.0,38.0,38.0,1,114,0.0,86.0,86.0
0.004,17,2,136,1,60,0.0,32.0,32.0,1,76,0.0,48.0,48.0
8.636,6,35,8429,18,1997,508.0,889.0,415.0,17,6432,529.0,2720.0,478.0
0.016,6,10,1983,5,910,4.0,642.0,642.0,5,1073,3.0,805.0,805.0
0.011,6,10,1983,5,910,2.0,642.0,642.0,5,1073,2.0,805.0,805.0
0.062,6,10,1506,5,395,13.0,127.0,127.0,5,1111,14.0,843.0,843.0
240.328,6,32,9219,15,1785,17166.0,625.0,199.0,17,7434,15020.0,1402.0,595.0
0.005,6,10,1779,5,928,1.0,660.0,660.0,5,851,1.0,583.0,583.0
0.006,6,10,1547,5,764,1.0,496.0,496.0,5,783,1.0,515.0,515.0
0.01,6,10,1762,5,911,2.0,643.0,643.0,5,851,2.0,583.0,583.0
0.005,6,14,3742,7,452,0.0,80.0,80.0,7,3290,0.0,1448.0,972.0
301.459,6,37,8537,20,2105,15866.0,886.0,318.0,17,6432,528.0,2126.0,478.0
0.014,6,12,1926,6,1189,2.0,659.0,434.0,6,737,2.0,417.0,417.0
0.019,6,10,1990,5,911,4.0,643.0,643.0,5,1079,4.0,811.0,811.0
0.142,6,10,1506,5,395,33.0,127.0,127.0,5,1111,33.0,843.0,843.0
0.071,17,8,3613,4,1874,23.0,1350.0,440.0,4,1739,12.0,1350.0,406.0
0.005,6,10,2006,5,927,1.0,659.0,659.0,5,1079,1.0,811.0,811.0
0.004,6,10,2000,5,927,1.0,659.0,659.0,5,1073,1.0,805.0,805.0
240.478,6,35,8925,18,2073,14145.0,694.0,225.0,17,6852,15029.0,1402.0,597.0
5.132,6,23,6562,13,1500,427.0,474.0,201.0,10,5062,569.0,1925.0,757.0
0.012,6,10,1989,5,910,3.0,642.0,642.0,5,1079,2.0,811.0,811.0
240.103,6,16,4481,9,963,30012.0,238.0,166.0,7,3518,40016.0,1402.0,786.0
0.001,17,2,180,1,66,0.0,38.0,38.0,1,114,0.0,86.0,86.0
0.003,17,2,148,1,60,0.0,32.0,32.0,1,88,0.0,60.0,60.0
0.006,17,2,170,1,65,0.0,37.0,37.0,1,105,0.0,77.0,77.0
0.005,6,10,2007,5,928,1.0,660.0,660.0,5,1079,1.0,811.0,811.0
0.005,17,2,179,1,71,0.0,43.0,43.0,1,108,0.0,80.0,80.0
0.013,6,14,3787,7,497,2.0,125.0,125.0,7,3290,2.0,1448.0,972.0
0.003,6,10,1702,5,863,0.0,595.0,595.0,5,839,0.0,571.0,571.0
0.005,6,10,1689,5,839,1.0,571.0,571.0,5,850,1.0,582.0,582.0
0.015,6,10,1989,5,910,3.0,642.0,642.0,5,1079,3.0,811.0,811.0
11.631,17,28,4366,14,2312,882.0,587.0,137.0,14,2054,882.0,269.0,118.0
0.001,17,2,180,1,66,0.0,38.0,38.0,1,114,0.0,86.0,86.0
0.005,17,2,193,1,71,0.0,43.0,43.0,1,122,0.0,94.0,94.0
0.011,6,10,1972,5,910,2.0,642.0,642.0,5,1062,2.0,794.0,794.0
129.642,6,22,8498,12,2236,72.0,1345.0,574.0,10,6262,14386.0,2720.0,975.0
0.12,6,10,1506,5,395,26.0,127.0,127.0,5,1111,24.0,843.0,843.0
0.009,6,10,1972,5,910,2.0,642.0,642.0,5,1062,2.0,794.0,794.0
0.14,6,10,1506,5,395,33.0,127.0,127.0,5,1111,31.0,843.0,843.0
0.052,17,2,152,1,76,0.0,48.0,48.0,1,76,0.0,48.0,48.0
0.007,6,10,1854,5,889,1.0,621.0,621.0,5,965,1.0,697.0,697.0
240.015,6,9,787,5,488,60003.0,232.0,232.0,4,299,80003.0,83.0,83.0
0.014,6,10,1989,5,910,3.0,642.0,642.0,5,1079,3.0,811.0,811.0
0.086,6,10,1506,5,395,19.0,127.0,127.0,5,1111,18.0,843.0,843.0
40.056,17,10,676,5,460,10013.0,104.0,64.0,5,216,10013.0,20.0,15.0
0.006,6,10,1689,5,839,1.0,571.0,571.0,5,850,1.0,582.0,582.0
0.005,17,2,170,1,65,0.0,37.0,37.0,1,105,0.0,77.0,77.0
0.174,17,2,152,1,76,0.0,48.0,48.0,1,76,0.0,48.0,48.0
0.013,17,2,152,1,56,0.0,28.0,28.0,1,96,0.0,68.0,68.0
0.042,17,2,148,1,60,0.0,32.0,32.0,1,88,0.0,60.0,60.0
1778.35,17,144,45504,72,22752,25047.0,288.0,288.0,72,22752,25047.0,288.0,288.0
0.009,6,10,1990,5,911,2.0,643.0,643.0,5,1079,2.0,811.0,811.0
0.006,6,10,2006,5,927,1.0,659.0,659.0,5,1079,1.0,811.0,811.0
0.007,17,2,179,1,71,0.0,43.0,43.0,1,108,0.0,80.0,80.0
240.018,6,9,787,5,488,60004.0,232.0,232.0,4,299,80004.0,83.0,83.0
0.004,6,10,2000,5,927,1.0,659.0,659.0,5,1073,1.0,805.0,805.0
0.005,6,10,2007,5,928,1.0,660.0,660.0,5,1079,1.0,811.0,811.0
0.008,6,10,1972,5,910,2.0,642.0,642.0,5,1062,2.0,794.0,794.0
0.011,6,10,1983,5,910,2.0,642.0,642.0,5,1073,2.0,805.0,805.0
0.005,17,2,214,1,75,0.0,47.0,47.0,1,139,0.0,111.0,111.0
0.012,6,10,1989,5,910,2.0,642.0,642.0,5,1079,3.0,811.0,811.0
0.005,6,10,2006,5,927,1.0,659.0,659.0,5,1079,1.0,811.0,811.0
0.005,6,10,2006,5,927,1.0,659.0,659.0,5,1079,1.0,811.0,811.0
176.09,17,86,12314,43,2896,4192.0,44.0,39.0,43,9418,4192.0,261.0,191.0
0.004,6,14,3742,8,504,0.0,80.0,80.0,6,3238,0.0,1470.0,1459.0
0.04,17,2,152,1,76,0.0,48.0,48.0,1,76,0.0,48.0,48.0
0.004,6,10,2006,5,927,1.0,659.0,659.0,5,1079,1.0,811.0,811.0
0.005,6,10,2007,5,928,1.0,660.0,660.0,5,1079,1.0,811.0,811.0
0.104,6,10,1506,5,395,18.0,127.0,127.0,5,1111,24.0,843.0,843.0
0.126,6,10,1506,5,395,29.0,127.0,127.0,5,1111,25.0,843.0,843.0
0.009,6,10,1762,5,911,2.0,643.0,643.0,5,851,2.0,583.0,583.0
10.811,17,28,4420,14,1993,823.0,268.0,114.0,14,2427,823.0,586.0,145.0
0.004,6,10,2006,5,927,1.0,659.0,659.0,5,1079,1.0,811.0,811.0
0.015,6,10,1972,5,910,3.0,642.0,642.0,5,1062,3.0,794.0,794.0
0.014,6,10,1990,5,911,3.0,643.0,643.0,5,1079,3.0,811.0,811.0
0.088,6,10,1506,5,395,19.0,127.0,127.0,5,1111,19.0,843.0,843.0
0.023,6,10,1983,5,910,5.0,642.0,642.0,5,1073,5.0,805.0,805.0
241.194,6,379,347814,195,21658,1243.0,2736.0,885.0,184,326156,1317.0,2804.0,1819.0
0.008,6,10,1989,5,910,2.0,642.0,642.0,5,1079,1.0,811.0,811.0
0.005,6,10,1689,5,839,1.0,571.0,571.0,5,850,1.0,582.0,582.0
178.036,17,86,12023,43,2875,4238.0,44.0,38.0,43,9148,4238.0,239.0,184.0
0.005,6,13,3690,7,452,0.0,80.0,80.0,6,3238,0.0,1470.0,1459.0
0.006,17,2,180,1,66,0.0,38.0,38.0,1,114,0.0,86.0,86.0
0.111,6,10,1506,5,395,25.0,127.0,127.0,5,1111,23.0,843.0,843.0
0.023,6,10,1990,5,911,5.0,643.0,643.0,5,1079,5.0,811.0,811.0
0.017,6,10,1677,5,827,4.0,559.0,559.0,5,850,4.0,582.0,582.0
0.216,6,16,2669,8,1395,30.0,533.0,323.0,8,1274,20.0,529.0,212.0
0.005,6,13,3747,7,509,0.0,137.0,137.0,6,3238,0.0,1470.0,1459.0
0.006,6,10,1547,5,764,1.0,496.0,496.0,5,783,1.0,515.0,515.0
0.004,6,10,1702,5,863,1.0,595.0,595.0,5,839,0.0,571.0,571.0
0.004,17,2,136,1,60,0.0,32.0,32.0,1,76,0.0,48.0,48.0
241.618,6,35,9729,15,7081,17258.0,2205.0,700.0,20,2648,12716.0,580.0,145.0
0.135,17,4,284,2,120,0.0,32.0,32.0,2,164,94.0,60.0,54.0
0.005,6,10,1774,5,923,1.0,655.0,655.0,5,851,1.0,583.0,583.0
354.02,6,19,1691,15,978,25287.0,190.0,190.0,4,713,80003.0,497.0,497.0
15.223,17,18,9401,9,6963,1899.0,1350.0,745.0,9,2438,1899.0,1350.0,242.0
0.009,6,10,1989,5,910,2.0,642.0,642.0,5,1079,2.0,811.0,811.0
0.005,6,10,1779,5,928,1.0,660.0,660.0,5,851,1.0,583.0,583.0
0.005,17,2,164,1,74,0.0,46.0,46.0,1,90,0.0,62.0,62.0
0.017,6,10,1677,5,827,4.0,559.0,559.0,5,850,4.0,582.0,582.0
0.005,6,10,2006,5,927,1.0,659.0,659.0,5,1079,1.0,811.0,811.0
40.069,17,10,676,5,460,10015.0,104.0,64.0,5,216,10016.0,20.0,15.0
0.079,6,10,1506,5,395,18.0,127.0,127.0,5,1111,15.0,843.0,843.0
40.069,17,10,676,5,460,10014.0,104.0,64.0,5,216,10016.0,20.0,15.0
0.013,6,10,1990,5,911,3.0,643.0,643.0,5,1079,3.0,811.0,811.0
0.005,17,2,170,1,65,0.0,37.0,37.0,1,105,0.0,77.0,77.0
0.007,6,10,1547,5,764,1.0,496.0,496.0,5,783,1.0,515.0,515.0
0.063,6,10,1506,5,395,13.0,127.0,127.0,5,1111,13.0,843.0,843.0
1787.588,6,150,19350,90,13740,20085.0,302.0,302.0,60,5610,30298.0,83.0,83.0
0.012,6,6,716,3,458,4.0,302.0,302.0,3,258,4.0,102.0,102.0
0.006,6,10,1547,5,764,1.0,496.0,496.0,5,783,1.0,515.0,515.0
0.067,6,10,1506,5,395,15.0,127.0,127.0,5,1111,15.0,843.0,843.0
40.057,17,10,676,5,460,10013.0,104.0,64.0,5,216,10013.0,20.0,15.0
0.006,6,10,1854,5,889,1.0,621.0,621.0,5,965,1.0,697.0,697.0
0.022,6,14,3787,7,497,3.0,125.0,125.0,7,3290,3.0,1448.0,972.0
0.004,17,2,214,1,75,0.0,47.0,47.0,1,139,0.0,111.0,111.0
0.103,6,10,1506,5,395,22.0,127.0,127.0,5,1111,20.0,843.0,843.0
1730.392,6,45,2790,30,1725,59668.0,35.0,35.0,15,1065,123591.0,31.0,31.0
1751.578,6,445,65633,253,35232,6950.0,613.0,197.0,192,30401,9170.0,453.0,144.0
0.005,17,2,158,1,63,0.0,35.0,35.0,1,95,0.0,67.0,67.0
0.004,6,10,2007,5,928,1.0,660.0,660.0,5,1079,1.0,811.0,811.0
0.066,6,10,1506,5,395,14.0,127.0,127.0,5,1111,15.0,843.0,843.0
40.065,17,10,676,5,460,10014.0,104.0,64.0,5,216,10015.0,20.0,15.0
0.005,6,10,2006,5,927,1.0,659.0,659.0,5,1079,1.0,811.0,811.0
330.5,17,16,928,8,608,47196.0,48.0,48.0,8,320,47196.0,12.0,12.0
0.014,6,10,1983,5,910,3.0,642.0,642.0,5,1073,3.0,805.0,805.0
0.004,6,10,2007,5,928,1.0,660.0,660.0,5,1079,1.0,811.0,811.0
0.016,6,10,1989,5,910,4.0,642.0,642.0,5,1079,4.0,811.0,811.0
0.003,17,2,148,1,60,0.0,32.0,32.0,1,88,0.0,60.0,60.0
0.005,6,10,2006,5,927,1.0,659.0,659.0,5,1079,1.0,811.0,811.0
0.016,6,10,1983,5,910,3.0,642.0,642.0,5,1073,3.0,805.0,805.0
11.177,17,28,4420,14,1995,847.0,270.0,114.0,14,2425,847.0,588.0,145.0
0.007,6,10,1547,5,764,1.0,496.0,496.0,5,783,1.0,515.0,515.0
0.014,6,10,1762,5,911,3.0,643.0,643.0,5,851,3.0,583.0,583.0
0.11,6,10,1506,5,395,26.0,127.0,127.0,5,1111,23.0,843.0,843.0
0.215,6,16,2669,8,1395,30.0,533.0,323.0,8,1274,19.0,529.0,212.0
0.001,17,2,180,1,66,0.0,38.0,38.0,1,114,0.0,86.0,86.0
0.006,17,2,166,1,75,0.0,47.0,47.0,1,91,0.0,63.0,63.0
40.057,17,10,676,5,460,10013.0,104.0,64.0,5,216,10013.0,20.0,15.0
240.217,6,22,11448,13,6869,20018.0,2736.0,1032.0,9,4579,30026.0,1657.0,1367.0
0.006,17,2,166,1,75,0.0,47.0,47.0,1,91,0.0,63.0,63.0
0.008,6,10,1989,5,910,2.0,642.0,642.0,5,1079,2.0,811.0,811.0
0.004,6,10,2006,5,927,1.0,659.0,659.0,5,1079,1.0,811.0,811.0
0.004,17,2,136,1,60,0.0,32.0,32.0,1,76,0.0,48.0,48.0
0.071,17,2,136,1,60,0.0,32.0,32.0,1,76,0.0,48.0,48.0
0.039,17,4,284,2,120,0.0,32.0,32.0,2,164,35.0,60.0,54.0
0.006,6,10,1547,5,764,1.0,496.0,496.0,5,783,1.0,515.0,515.0
0.013,6,10,1983,5,910,3.0,642.0,642.0,5,1073,3.0,805.0,805.0
0.078,6,10,1506,5,395,16.0,127.0,127.0,5,1111,16.0,843.0,843.0
40.061,17,10,676,5,460,10014.0,104.0,64.0,5,216,10014.0,20.0,15.0
0.025,6,10,1989,5,910,6.0,642.0,642.0,5,1079,6.0,811.0,811.0
0.109,6,10,1506,5,395,24.0,127.0,127.0,5,1111,24.0,843.0,843.0
0.006,6,10,1774,5,923,1.0,655.0,655.0,5,851,1.0,583.0,583.0
0.091,6,10,1506,5,395,20.0,127.0,127.0,5,1111,19.0,843.0,843.0
0.251,17,43,26565,25,23390,10.0,1350.0,907.0,18,3175,10.0,1350.0,148.0
0.006,6,10,2006,5,927,1.0,659.0,659.0,5,1079,1.0,811.0,811.0
0.003,17,2,152,1,76,0.0,48.0,48.0,1,76,0.0,48.0,48.0
351.992,6,20,2210,6,1308,12004.0,494.0,494.0,14,902,27076.0,83.0,83.0
0.005,6,14,3742,7,452,0.0,80.0,80.0,7,3290,0.0,1448.0,972.0
0.005,6,10,1689,5,839,1.0,571.0,571.0,5,850,1.0,582.0,582.0
11.495,17,28,4390,14,2312,872.0,587.0,137.0,14,2078,872.0,269.0,120.0
0.019,6,13,3913,7,495,3.0,123.0,123.0,6,3418,3.0,1650.0,1549.0
0.226,6,16,2669,8,1395,32.0,533.0,323.0,8,1274,20.0,529.0,212.0
0.01,6,10,1762,5,911,2.0,643.0,643.0,5,851,2.0,583.0,583.0
0.013,6,10,1983,5,910,3.0,642.0,642.0,5,1073,3.0,805.0,805.0
15.072,17,15,9238,8,6902,2148.0,1350.0,834.0,7,2336,2507.0,1350.0,305.0
0.021,6,10,1989,5,910,5.0,642.0,642.0,5,1079,5.0,811.0,811.0
11.286,17,28,4417,14,1993,855.0,268.0,114.0,14,2424,855.0,587.0,145.0
0.005,6,13,3690,7,452,0.0,80.0,80.0,6,3238,0.0,1470.0,1459.0
0.011,6,13,3735,7,497,1.0,125.0,125.0,6,3238,2.0,1470.0,1459.0
0.004,17,2,164,1,74,0.0,46.0,46.0,1,90,0.0,62.0,62.0
0.003,17,2,136,1,60,0.0,32.0,32.0,1,76,0.0,48.0,48.0
40.055,17,10,676,5,460,10012.0,104.0,64.0,5,216,10012.0,20.0,15.0
0.007,6,10,1547,5,764,1.0,496.0,496.0,5,783,1.0,515.0,515.0
0.013,6,10,1972,5,910,3.0,642.0,642.0,5,1062,3.0,794.0,794.0
0.011,6,10,1972,5,910,2.0,642.0,642.0,5,1062,2.0,794.0,794.0
0.148,17,4,352,2,130,111.0,37.0,37.0,2,222,143.0,89.0,83.0
0.001,17,2,180,1,66,0.0,38.0,38.0,1,114,0.0,86.0,86.0
0.01,6,10,1990,5,911,2.0,643.0,643.0,5,1079,2.0,811.0,811.0
0.007,6,10,1547,5,764,1.0,496.0,496.0,5,783,1.0,515.0,515.0
10.87,17,26,4102,13,1846,897.0,269.0,114.0,13,2256,897.0,587.0,145.0
0.004,6,10,2007,5,928,1.0,660.0,660.0,5,1079,1.0,811.0,811.0
0.116,6,10,1506,5,395,23.0,127.0,127.0,5,1111,26.0,843.0,843.0
0.001,17,2,180,1,66,0.0,38.0,38.0,1,114,0.0,86.0,86.0
0.221,17,4,596,2,122,178.0,33.0,33.0,2,474,179.0,323.0,209.0
0.004,17,4,284,2,120,0.0,32.0,32.0,2,164,0.0,60.0,54.0
300.343,6,16,2170,9,684,37522.0,146.0,146.0,7,1486,50029.0,419.0,398.0
0.091,6,10,1506,5,395,21.0,127.0,127.0,5,1111,20.0,843.0,843.0
40.059,17,10,676,5,460,10013.0,104.0,64.0,5,216,10013.0,20.0,15.0
0.004,6,10,1989,5,927,1.0,659.0,659.0,5,1062,1.0,794.0,794.0
0.012,6,10,1983,5,910,3.0,642.0,642.0,5,1073,3.0,805.0,805.0
0.007,6,10,1990,5,911,1.0,643.0,643.0,5,1079,1.0,811.0,811.0
0.004,6,10,1702,5,863,1.0,595.0,595.0,5,839,1.0,571.0,571.0
0.106,6,10,1506,5,395,25.0,127.0,127.0,5,1111,24.0,843.0,843.0
10.783,17,28,4421,14,1993,821.0,268.0,114.0,14,2428,821.0,587.0,145.0
293.694,6,389,347208,181,20977,1631.0,2736.0,889.0,208,326231,1418.0,2804.0,1625.0
0.005,6,10,2006,5,927,1.0,659.0,659.0,5,1079,1.0,811.0,811.0
0.004,17,4,284,2,120,0.0,32.0,32.0,2,164,1.0,60.0,54.0
0.0,17,2,154,1,69,0.0,41.0,41.0,1,85,0.0,57.0,57.0
0.042,17,2,170,1,65,0.0,37.0,37.0,1,105,0.0,77.0,77.0
0.11,6,10,1506,5,395,25.0,127.0,127.0,5,1111,23.0,843.0,843.0
0.018,6,10,1989,5,910,4.0,642.0,642.0,5,1079,4.0,811.0,811.0
0.003,17,2,136,1,60,0.0,32.0,32.0,1,76,0.0,48.0,48.0
40.073,17,10,676,5,460,10017.0,104.0,64.0,5,216,10017.0,20.0,15.0
240.09,6,16,4480,9,963,30011.0,238.0,166.0,7,3517,40014.0,1402.0,786.0
0.011,6,10,1989,5,910,2.0,642.0,642.0,5,1079,2.0,811.0,811.0
0.012,6,10,1677,5,827,3.0,559.0,559.0,5,850,3.0,582.0,582.0
0.138,6,10,1506,5,395,32.0,127.0,127.0,5,1111,33.0,843.0,843.0
0.072,17,4,564,2,122,1.0,33.0,33.0,2,442,33.0,291.0,193.0
176.554,17,78,11187,39,2604,4646.0,44.0,38.0,39,8583,4646.0,239.0,192.0
0.041,17,2,152,1,76,0.0,48.0,48.0,1,76,0.0,48.0,48.0
0.005,6,10,1989,5,927,1.0,659.0,659.0,5,1062,1.0,794.0,794.0
0.1,6,10,1506,5,395,20.0,127.0,127.0,5,1111,20.0,843.0,843.0
0.019,6,14,3787,7,497,3.0,125.0,125.0,7,3290,3.0,1448.0,972.0
0.118,6,10,1506,5,395,28.0,127.0,127.0,5,1111,28.0,843.0,843.0
0.006,6,10,1547,5,764,1.0,496.0,496.0,5,783,1.0,515.0,515.0
0.013,6,10,1677,5,827,3.0,559.0,559.0,5,850,3.0,582.0,582.0
0.005,6,10,2007,5,928,1.0,660.0,660.0,5,1079,1.0,811.0,811.0
0.136,6,10,1506,5,395,32.0,127.0,127.0,5,1111,29.0,843.0,843.0
0.072,17,4,352,2,130,0.0,37.0,37.0,2,222,34.0,89.0,83.0
0.012,6,10,1972,5,910,2.0,642.0,642.0,5,1062,2.0,794.0,794.0
369.422,6,22,2313,16,867,24628.0,195.0,195.0,6,1446,4638.0,419.0,398.0
221.775,17,16,892,8,564,31663.0,48.0,42.0,8,328,31663.0,20.0,13.0
0.005,6,10,2006,5,927,1.0,659.0,659.0,5,1079,1.0,811.0,811.0
0.008,6,10,1972,5,910,2.0,642.0,642.0,5,1062,2.0,794.0,794.0
0.078,17,2,156,1,64,0.0,36.0,36.0,1,92,0.0,64.0,64.0
0.001,17,2,180,1,66,0.0,38.0,38.0,1,114,0.0,86.0,86.0
0.038,17,2,152,1,76,0.0,48.0,48.0,1,76,0.0,48.0,48.0
0.021,6,10,1989,5,910,5.0,642.0,642.0,5,1079,5.0,811.0,811.0
0.012,6,10,1989,5,910,3.0,642.0,642.0,5,1079,3.0,811.0,811.0
308.432,17,20,1124,10,716,34256.0,48.0,43.0,10,408,34256.0,20.0,12.0
289.311,6,322,345140,132,18414,2208.0,2736.0,888.0,190,326726,1530.0,2804.0,1800.0
0.006,6,10,1689,5,839,1.0,571.0,571.0,5,850,1.0,582.0,582.0
0.011,6,10,1989,5,910,2.0,642.0,642.0,5,1079,2.0,811.0,811.0
0.005,17,2,222,1,65,0.0,37.0,37.0,1,157,0.0,129.0,129.0
308.42,17,20,1124,10,716,34254.0,48.0,43.0,10,408,34254.0,20.0,12.0
40.073,17,10,676,5,460,10017.0,104.0,64.0,5,216,10017.0,20.0,15.0
0.016,6,10,1990,5,911,4.0,643.0,643.0,5,1079,4.0,811.0,811.0
0.014,6,10,1990,5,911,3.0,643.0,643.0,5,1079,3.0,811.0,811.0
0.019,6,10,1631,5,848,4.0,580.0,580.0,5,783,4.0,515.0,515.0
0.041,17,2,136,1,60,0.0,32.0,32.0,1,76,0.0,48.0,48.0
0.003,17,2,136,1,60,0.0,32.0,32.0,1,76,0.0,48.0,48.0
0.006,6,10,1547,5,764,1.0,496.0,496.0,5,783,1.0,515.0,515.0
0.003,6,10,1702,5,863,0.0,595.0,595.0,5,839,0.0,571.0,571.0
0.004,17,2,136,1,60,0.0,32.0,32.0,1,76,0.0,48.0,48.0
0.098,6,10,1506,5,395,21.0,127.0,127.0,5,1111,23.0,843.0,843.0
10.877,17,28,4417,14,1993,828.0,268.0,114.0,14,2424,828.0,587.0,145.0
0.012,6,10,1631,5,848,3.0,580.0,580.0,5,783,3.0,515.0,515.0
0.08,6,10,1506,5,395,19.0,127.0,127.0,5,1111,16.0,843.0,843.0
0.015,6,10,1677,5,827,3.0,559.0,559.0,5,850,3.0,582.0,582.0
0.074,6,10,1506,5,395,16.0,127.0,127.0,5,1111,15.0,843.0,843.0
0.041,17,2,148,1,60,0.0,32.0,32.0,1,88,0.0,60.0,60.0
0.021,6,10,1762,5,911,5.0,643.0,643.0,5,851,5.0,583.0,583.0
0.001,17,2,180,1,66,0.0,38.0,38.0,1,114,0.0,86.0,86.0
0.005,6,10,2000,5,927,1.0,659.0,659.0,5,1073,1.0,805.0,805.0
0.163,6,10,1506,5,395,39.0,127.0,127.0,5,1111,37.0,843.0,843.0
351.987,6,20,2210,6,1308,12003.0,494.0,494.0,14,902,27075.0,83.0,83.0
0.007,6,10,1689,5,839,1.0,571.0,571.0,5,850,1.0,582.0,582.0
0.004,6,10,2006,5,927,1.0,659.0,659.0,5,1079,1.0,811.0,811.0
0.007,6,10,1547,5,764,1.0,496.0,496.0,5,783,1.0,515.0,515.0
0.162,17,2,152,1,76,0.0,48.0,48.0,1,76,0.0,48.0,48.0
0.013,17,4,284,2,120,10.0,32.0,32.0,2,164,9.0,60.0,54.0
0.03,6,10,1972,5,910,7.0,642.0,642.0,5,1062,7.0,794.0,794.0
0.005,6,10,1854,5,889,1.0,621.0,621.0,5,965,1.0,697.0,697.0
0.006,17,2,194,1,59,0.0,31.0,31.0,1,135,0.0,107.0,107.0
0.014,6,10,1989,5,910,3.0,642.0,642.0,5,1079,3.0,811.0,811.0
0.038,17,4,284,2,120,0.0,32.0,32.0,2,164,34.0,60.0,54.0
0.005,6,10,2007,5,928,1.0,660.0,660.0,5,1079,1.0,811.0,811.0
0.012,6,14,3787,7,497,1.0,125.0,125.0,7,3290,1.0,1448.0,972.0
0.005,6,13,3747,7,509,0.0,137.0,137.0,6,3238,1.0,1470.0,1459.0
0.004,6,10,2006,5,927,1.0,659.0,659.0,5,1079,1.0,811.0,811.0
0.009,17,2,132,1,58,0.0,30.0,30.0,1,74,0.0,46.0,46.0
0.005,17,2,164,1,74,0.0,46.0,46.0,1,90,0.0,62.0,62.0
40.061,17,10,676,5,460,10014.0,104.0,64.0,5,216,10014.0,20.0,15.0
0.005,17,2,164,1,74,0.0,46.0,46.0,1,90,0.0,62.0,62.0
0.01,6,10,1989,5,910,2.0,642.0,642.0,5,1079,2.0,811.0,811.0
15.211,17,41,20289,22,17085,723.0,1350.0,748.0,19,3204,843.0,1350.0,140.0
0.01,6,10,1989,5,910,2.0,642.0,642.0,5,1079,2.0,811.0,811.0
0.074,6,10,1506,5,395,16.0,127.0,127.0,5,1111,16.0,843.0,843.0
411.991,6,29,4409,12,3102,10911.0,494.0,494.0,17,1307,25749.0,83.0,83.0
0.001,17,2,136,1,60,0.0,32.0,32.0,1,76,0.0,48.0,48.0
412.022,6,29,4409,12,3102,10913.0,494.0,494.0,17,1307,25751.0,83.0,83.0
0.005,6,10,1689,5,839,1.0,571.0,571.0,5,850,1.0,582.0,582.0
0.735,6,10,2009,6,1655,147.0,1403.0,1403.0,4,354,167.0,182.0,182.0
0.006,6,10,1547,5,764,1.0,496.0,496.0,5,783,1.0,515.0,515.0
0.004,6,10,1702,5,863,1.0,595.0,595.0,5,839,0.0,571.0,571.0
0.008,6,10,1762,5,911,2.0,643.0,643.0,5,851,2.0,583.0,583.0
0.001,17,2,180,1,66,0.0,38.0,38.0,1,114,0.0,86.0,86.0
40.068,17,10,676,5,460,10016.0,104.0,64.0,5,216,10016.0,20.0,15.0
0.004,6,10,1702,5,863,1.0,595.0,595.0,5,839,1.0,571.0,571.0
0.005,6,10,2007,5,928,1.0,660.0,660.0,5,1079,1.0,811.0,811.0
0.101,6,10,1506,5,395,22.0,127.0,127.0,5,1111,23.0,843.0,843.0
0.018,6,10,1989,5,910,4.0,642.0,642.0,5,1079,4.0,811.0,811.0
308.388,17,20,1124,10,716,34251.0,48.0,43.0,10,408,34251.0,20.0,12.0
0.305,17,19,12674,8,4407,43.0,1350.0,522.0,11,8267,27.0,1350.0,723.0
0.003,17,2,148,1,60,0.0,32.0,32.0,1,88,0.0,60.0,60.0
0.004,6,10,2006,5,927,1.0,659.0,659.0,5,1079,1.0,811.0,811.0
60.984,6,25,17450,14,9539,4691.0,2804.0,1469.0,11,7911,6086.0,2334.0,1221.0
0.001,17,2,136,1,60,0.0,32.0,32.0,1,76,0.0,48.0,48.0
361.783,6,19,1689,15,978,25841.0,190.0,190.0,4,711,80014.0,495.0,495.0
0.185,17,4,596,2,122,146.0,33.0,33.0,2,474,143.0,323.0,209.0
0.071,17,8,3613,4,1874,23.0,1350.0,440.0,4,1739,12.0,1350.0,406.0
0.005,6,10,1689,5,839,1.0,571.0,571.0,5,850,1.0,582.0,582.0
15.072,17,15,9239,8,6902,2149.0,1350.0,834.0,7,2337,2507.0,1350.0,305.0
40.069,17,10,676,5,460,10016.0,104.0,64.0,5,216,10016.0,20.0,15.0
0.006,6,10,1643,5,860,1.0,592.0,592.0,5,783,1.0,515.0,515.0
0.004,6,10,1989,5,927,1.0,659.0,659.0,5,1062,1.0,794.0,794.0
0.117,6,10,1506,5,395,27.0,127.0,127.0,5,1111,27.0,843.0,843.0
0.008,6,12,1926,6,1189,1.0,659.0,434.0,6,737,1.0,417.0,417.0
40.083,17,10,676,5,460,10018.0,104.0,64.0,5,216,10019.0,20.0,15.0
10.713,17,26,4099,13,1823,883.0,270.0,112.0,13,2276,883.0,587.0,147.0
0.005,6,10,2006,5,927,1.0,659.0,659.0,5,1079,1.0,811.0,811.0
0.01,6,10,1983,5,910,2.0,642.0,642.0,5,1073,2.0,805.0,805.0
0.071,17,4,284,2,120,0.0,32.0,32.0,2,164,32.0,60.0,54.0
0.013,6,10,1631,5,848,3.0,580.0,580.0,5,783,3.0,515.0,515.0
40.052,17,10,676,5,460,10012.0,104.0,64.0,5,216,10012.0,20.0,15.0
0.005,6,10,2007,5,928,1.0,660.0,660.0,5,1079,1.0,811.0,811.0
0.07,6,10,1506,5,395,13.0,127.0,127.0,5,1111,16.0,843.0,843.0
0.006,6,10,1854,5,889,1.0,621.0,621.0,5,965,1.0,697.0,697.0
0.009,6,10,1989,5,910,2.0,642.0,642.0,5,1079,2.0,811.0,811.0
0.099,6,10,1506,5,395,23.0,127.0,127.0,5,1111,23.0,843.0,843.0
0.004,6,10,1702,5,863,1.0,595.0,595.0,5,839,1.0,571.0,571.0
0.081,6,10,1506,5,395,16.0,127.0,127.0,5,1111,16.0,843.0,843.0
0.006,17,2,166,1,75,0.0,47.0,47.0,1,91,0.0,63.0,63.0
0.014,6,13,3735,7,497,2.0,125.0,125.0,6,3238,2.0,1470.0,1459.0
0.009,6,10,1972,5,910,2.0,642.0,642.0,5,1062,2.0,794.0,794.0
0.005,6,10,2006,5,927,1.0,659.0,659.0,5,1079,1.0,811.0,811.0
0.011,6,10,1631,5,848,2.0,580.0,580.0,5,783,2.0,515.0,515.0
0.004,6,10,2006,5,927,1.0,659.0,659.0,5,1079,1.0,811.0,811.0
240.112,6,16,4481,9,963,30014.0,238.0,166.0,7,3518,40018.0,1402.0,786.0
0.081,6,10,1506,5,395,18.0,127.0,127.0,5,1111,17.0,843.0,843.0
0.043,6,10,1989,5,910,10.0,642.0,642.0,5,1079,10.0,811.0,811.0
101.144,6,15,968,6,424,20228.0,46.0,46.0,9,544,12626.0,46.0,46.0
285.117,6,27,6406,15,1369,20365.0,517.0,290.0,12,5037,25919.0,2379.0,1104.0
308.798,17,20,1124,10,716,34297.0,48.0,43.0,10,408,34297.0,20.0,12.0
0.005,6,10,2007,5,928,1.0,660.0,660.0,5,1079,1.0,811.0,811.0
0.006,6,10,1547,5,764,1.0,496.0,496.0,5,783,1.0,515.0,515.0
0.088,6,10,1506,5,395,19.0,127.0,127.0,5,1111,19.0,843.0,843.0
308.343,17,20,1124,10,716,34249.0,48.0,43.0,10,408,34250.0,20.0,12.0
0.017,6,13,3735,7,497,2.0,125.0,125.0,6,3238,3.0,1470.0,1459.0
0.085,6,10,1506,5,395,18.0,127.0,127.0,5,1111,19.0,843.0,843.0
0.071,17,8,3613,4,1874,23.0,1350.0,440.0,4,1739,12.0,1350.0,406.0
0.011,6,10,1983,5,910,2.0,642.0,642.0,5,1073,2.0,805.0,805.0
0.096,6,10,1506,5,395,22.0,127.0,127.0,5,1111,18.0,843.0,843.0
300.185,6,27,7436,16,1409,20012.0,217.0,142.0,11,6027,24017.0,1679.0,778.0
361.794,6,21,1793,16,1030,24119.0,190.0,190.0,5,763,60009.0,462.0,247.0
0.008,6,10,1990,5,911,2.0,643.0,643.0,5,1079,2.0,811.0,811.0
0.014,6,10,1990,5,911,3.0,643.0,643.0,5,1079,3.0,811.0,811.0
0.008,6,12,1698,6,863,1.0,327.0,271.0,6,835,1.0,515.0,515.0
0.009,6,10,1989,5,910,2.0,642.0,642.0,5,1079,2.0,811.0,811.0
0.007,17,2,179,1,71,0.0,43.0,43.0,1,108,0.0,80.0,80.0
0.006,6,10,1547,5,764,1.0,496.0,496.0,5,783,1.0,515.0,515.0
0.005,6,13,3747,7,509,0.0,137.0,137.0,6,3238,1.0,1470.0,1459.0
0.006,6,10,2006,5,927,1.0,659.0,659.0,5,1079,1.0,811.0,811.0
170.244,17,90,13167,45,3025,3869.0,44.0,39.0,45,10142,3869.0,239.0,197.0
0.007,6,10,1547,5,764,1.0,496.0,496.0,5,783,1.0,515.0,515.0
0.009,6,10,1990,5,911,2.0,643.0,643.0,5,1079,2.0,811.0,811.0
0.001,17,2,179,1,62,0.0,34.0,34.0,1,117,0.0,89.0,89.0
40.064,17,10,676,5,460,10013.0,104.0,64.0,5,216,10015.0,20.0,15.0
0.009,6,10,1677,5,827,2.0,559.0,559.0,5,850,2.0,582.0,582.0
0.041,17,2,184,1,61,0.0,33.0,33.0,1,123,0.0,95.0,95.0
10.865,17,28,4419,14,1994,826.0,269.0,114.0,14,2425,826.0,588.0,145.0
0.013,6,10,2000,5,927,3.0,659.0,659.0,5,1073,3.0,805.0,805.0
0.006,6,10,1547,5,764,1.0,496.0,496.0,5,783,1.0,515.0,515.0
0.012,6,10,1989,5,910,3.0,642.0,642.0,5,1079,2.0,811.0,811.0
0.011,6,10,1989,5,910,2.0,642.0,642.0,5,1079,2.0,811.0,811.0
0.008,6,10,1989,5,910,2.0,642.0,642.0,5,1079,2.0,811.0,811.0
0.001,17,2,180,1,66,0.0,38.0,38.0,1,114,0.0,86.0,86.0
0.005,6,10,2006,5,927,1.0,659.0,659.0,5,1079,1.0,811.0,811.0
0.01,6,10,1990,5,911,2.0,643.0,643.0,5,1079,2.0,811.0,811.0
1768.901,17,92,8096,46,4048,39308.0,60.0,60.0,46,4048,39308.0,60.0,60.0
0.041,17,2,182,1,65,0.0,37.0,37.0,1,117,0.0,89.0,89.0
0.003,17,2,185,1,73,0.0,45.0,45.0,1,112,0.0,84.0,84.0
0.069,17,8,3613,4,1874,23.0,1350.0,440.0,4,1739,11.0,1350.0,406.0
0.04,6,10,1990,5,911,10.0,643.0,643.0,5,1079,10.0,811.0,811.0
10.791,17,28,4421,14,1993,821.0,268.0,114.0,14,2428,821.0,587.0,145.0
0.071,17,4,284,2,120,0.0,32.0,32.0,2,164,68.0,60.0,54.0
0.005,17,2,230,1,68,0.0,40.0,40.0,1,162,0.0,134.0,134.0
0.084,6,10,1506,5,395,14.0,127.0,127.0,5,1111,19.0,843.0,843.0
0.106,6,10,1506,5,395,25.0,127.0,127.0,5,1111,23.0,843.0,843.0
0.014,6,10,1989,5,910,3.0,642.0,642.0,5,1079,3.0,811.0,811.0
0.012,6,10,1990,5,911,2.0,643.0,643.0,5,1079,3.0,811.0,811.0
0.005,6,10,2007,5,928,1.0,660.0,660.0,5,1079,1.0,811.0,811.0
0.006,6,10,2006,5,927,1.0,659.0,659.0,5,1079,1.0,811.0,811.0
0.012,6,10,1990,5,911,3.0,643.0,643.0,5,1079,3.0,811.0,811.0
2.034,6,29,7768,17,2784,127.0,1477.0,515.0,12,4984,167.0,2745.0,561.0
0.005,17,2,169,1,62,0.0,34.0,34.0,1,107,0.0,79.0,79.0
9.036,17,6,376,5,280,2259.0,28.0,28.0,1,96,0.0,68.0,68.0
0.069,6,10,1506,5,395,15.0,127.0,127.0,5,1111,15.0,843.0,843.0
0.005,17,2,170,1,65,0.0,37.0,37.0,1,105,0.0,77.0,77.0
0.012,6,10,1972,5,910,3.0,642.0,642.0,5,1062,2.0,794.0,794.0
0.005,6,10,2007,5,928,1.0,660.0,660.0,5,1079,1.0,811.0,811.0
0.005,17,2,164,1,74,0.0,46.0,46.0,1,90,0.0,62.0,62.0
0.004,17,2,148,1,60,0.0,32.0,32.0,1,88,0.0,60.0,60.0
0.038,17,4,284,2,120,1.0,32.0,32.0,2,164,34.0,60.0,54.0
0.008,6,10,1989,5,910,2.0,642.0,642.0,5,1079,2.0,811.0,811.0
11.14,17,28,4422,14,1993,844.0,268.0,114.0,14,2429,844.0,588.0,145.0
0.004,6,10,1702,5,863,1.0,595.0,595.0,5,839,0.0,571.0,571.0
0.003,17,4,284,2,120,0.0,32.0,32.0,2,164,0.0,60.0,54.0
240.09,6,16,4480,9,963,30011.0,238.0,166.0,7,3517,40014.0,1402.0,786.0
0.006,6,10,1547,5,764,1.0,496.0,496.0,5,783,1.0,515.0,515.0
0.004,6,10,1774,5,923,1.0,655.0,655.0,5,851,1.0,583.0,583.0
0.001,17,2,180,1,66,0.0,38.0,38.0,1,114,0.0,86.0,86.0
0.109,6,10,1506,5,395,23.0,127.0,127.0,5,1111,24.0,843.0,843.0
0.005,6,10,2006,5,927,1.0,659.0,659.0,5,1079,1.0,811.0,811.0
0.095,6,10,1506,5,395,20.0,127.0,127.0,5,1111,18.0,843.0,843.0
0.005,6,10,1779,5,928,1.0,660.0,660.0,5,851,1.0,583.0,583.0
0.006,6,10,2006,5,927,1.0,659.0,659.0,5,1079,1.0,811.0,811.0
0.126,6,10,1506,5,395,28.0,127.0,127.0,5,1111,29.0,843.0,843.0
0.072,6,10,1506,5,395,15.0,127.0,127.0,5,1111,16.0,843.0,843.0
0.003,17,2,148,1,60,0.0,32.0,32.0,1,88,0.0,60.0,60.0
0.006,17,2,230,1,68,0.0,40.0,40.0,1,162,0.0,134.0,134.0
295.675,6,315,344581,122,17890,2443.0,2736.0,770.0,193,326691,1539.0,2804.0,1768.0
0.015,6,10,1989,5,910,3.0,642.0,642.0,5,1079,3.0,811.0,811.0
10.987,17,28,4422,14,1993,836.0,268.0,114.0,14,2429,836.0,588.0,145.0
0.018,6,10,1983,5,910,4.0,642.0,642.0,5,1073,4.0,805.0,805.0
0.041,17,2,152,1,76,0.0,48.0,48.0,1,76,0.0,48.0,48.0
0.009,6,10,1989,5,910,2.0,642.0,642.0,5,1079,2.0,811.0,811.0
0.016,6,10,1989,5,910,4.0,642.0,642.0,5,1079,3.0,811.0,811.0
0.036,17,2,152,1,76,0.0,48.0,48.0,1,76,0.0,48.0,48.0
0.004,17,2,136,1,60,0.0,32.0,32.0,1,76,0.0,48.0,48.0
0.165,6,10,1506,5,395,39.0,127.0,127.0,5,1111,35.0,843.0,843.0
0.006,6,10,1854,5,889,1.0,621.0,621.0,5,965,1.0,697.0,697.0
0.009,17,4,284,2,120,0.0,32.0,32.0,2,164,0.0,60.0,54.0
0.083,6,10,1506,5,395,19.0,127.0,127.0,5,1111,19.0,843.0,843.0
0.008,6,14,3787,7,497,1.0,125.0,125.0,7,3290,1.0,1448.0,972.0
0.102,6,10,1506,5,395,23.0,127.0,127.0,5,1111,24.0,843.0,843.0
240.019,6,9,787,5,488,60004.0,232.0,232.0,4,299,80005.0,83.0,83.0
241.569,6,371,347438,192,21507,1264.0,2736.0,959.0,179,325931,1357.0,2916.0,1873.0
0.121,6,10,1506,5,395,28.0,127.0,127.0,5,1111,26.0,843.0,843.0
0.02,6,10,1972,5,910,5.0,642.0,642.0,5,1062,5.0,794.0,794.0
0.012,6,10,1972,5,910,3.0,642.0,642.0,5,1062,3.0,794.0,794.0
293.774,6,393,347639,195,21698,1514.0,2736.0,888.0,198,325941,1491.0,3449.0,1724.0
0.013,6,10,1762,5,911,3.0,643.0,643.0,5,851,3.0,583.0,583.0
0.014,6,10,1983,5,910,3.0,642.0,642.0,5,1073,3.0,805.0,805.0
172.151,17,78,11265,39,2627,4530.0,44.0,39.0,39,8638,4530.0,239.0,193.0
0.086,6,10,1506,5,395,15.0,127.0,127.0,5,1111,19.0,843.0,843.0
0.001,17,2,136,1,60,0.0,32.0,32.0,1,76,0.0,48.0,48.0
0.005,17,2,144,1,64,0.0,36.0,36.0,1,80,0.0,52.0,52.0
0.075,6,10,1506,5,395,18.0,127.0,127.0,5,1111,17.0,843.0,843.0
0.016,6,10,1989,5,910,4.0,642.0,642.0,5,1079,3.0,811.0,811.0
301.011,6,49,19734,26,13971,12040.0,2720.0,1431.0,23,5763,400.0,2667.0,402.0
600.529,6,52,19521,27,4709,23095.0,676.0,412.0,25,14812,25020.0,1402.0,844.0
0.005,6,14,3799,7,509,0.0,137.0,137.0,7,3290,0.0,1448.0,972.0
244.08,6,390,348524,188,21298,1305.0,2736.0,959.0,202,327226,1214.0,3053.0,1649.0
0.005,6,10,2000,5,927,1.0,659.0,659.0,5,1073,1.0,805.0,805.0
0.085,6,10,1506,5,395,15.0,127.0,127.0,5,1111,17.0,843.0,843.0
1778.28,17,143,45188,72,22752,25042.0,288.0,288.0,71,22436,25401.0,288.0,288.0
0.004,6,10,1774,5,923,1.0,655.0,655.0,5,851,1.0,583.0,583.0
40.065,17,10,676,5,460,10013.0,104.0,64.0,5,216,10015.0,20.0,15.0
0.004,6,10,1774,5,923,1.0,655.0,655.0,5,851,1.0,583.0,583.0
0.006,6,10,1547,5,764,1.0,496.0,496.0,5,783,1.0,515.0,515.0
0.009,6,10,1990,5,911,2.0,643.0,643.0,5,1079,2.0,811.0,811.0
0.072,17,4,420,2,122,0.0,33.0,33.0,2,298,32.0,145.0,121.0
0.005,6,10,1989,5,927,1.0,659.0,659.0,5,1062,1.0,794.0,794.0
0.004,6,10,1774,5,923,1.0,655.0,655.0,5,851,1.0,583.0,583.0
0.004,6,10,2000,5,927,1.0,659.0,659.0,5,1073,1.0,805.0,805.0
0.009,6,10,2006,5,927,2.0,659.0,659.0,5,1079,2.0,811.0,811.0
0.005,6,10,2006,5,927,1.0,659.0,659.0,5,1079,1.0,811.0,811.0
0.004,6,10,2007,5,928,1.0,660.0,660.0,5,1079,1.0,811.0,811.0
1768.95,17,92,8096,46,4048,39309.0,60.0,60.0,46,4048,39309.0,60.0,60.0
40.057,17,10,676,5,460,10013.0,104.0,64.0,5,216,10013.0,20.0,15.0
0.011,6,10,1989,5,910,2.0,642.0,642.0,5,1079,2.0,811.0,811.0
0.006,17,2,179,1,71,0.0,43.0,43.0,1,108,0.0,80.0,80.0
0.006,6,10,1689,5,839,1.0,571.0,571.0,5,850,1.0,582.0,582.0
300.365,6,16,2170,9,684,37525.0,146.0,146.0,7,1486,50032.0,419.0,398.0
0.005,6,10,1989,5,927,1.0,659.0,659.0,5,1062,1.0,794.0,794.0
0.358,17,58,38811,34,32668,10.0,1350.0,932.0,24,6143,13.0,1350.0,227.0
0.009,6,10,1989,5,910,2.0,642.0,642.0,5,1079,2.0,811.0,811.0
0.012,6,10,1989,5,910,3.0,642.0,642.0,5,1079,2.0,811.0,811.0
0.01,6,10,1989,5,910,2.0,642.0,642.0,5,1079,2.0,811.0,811.0
11.163,17,28,4421,14,1993,846.0,268.0,114.0,14,2428,845.0,587.0,145.0
0.004,6,10,2000,5,927,1.0,659.0,659.0,5,1073,1.0,805.0,805.0
0.077,6,10,1506,5,395,15.0,127.0,127.0,5,1111,17.0,843.0,843.0
11.157,17,28,4422,14,1994,845.0,269.0,114.0,14,2428,845.0,587.0,145.0
40.058,17,10,676,5,460,10013.0,104.0,64.0,5,216,10013.0,20.0,15.0
0.006,6,10,1547,5,764,1.0,496.0,496.0,5,783,1.0,515.0,515.0
0.01,6,10,1762,5,911,2.0,643.0,643.0,5,851,2.0,583.0,583.0
0.014,6,10,1983,5,910,3.0,642.0,642.0,5,1073,3.0,805.0,805.0
0.081,6,10,1506,5,395,19.0,127.0,127.0,5,1111,16.0,843.0,843.0
0.009,6,10,1989,5,910,2.0,642.0,642.0,5,1079,2.0,811.0,811.0
0.006,6,10,1547,5,764,1.0,496.0,496.0,5,783,1.0,515.0,515.0
0.001,17,2,180,1,66,0.0,38.0,38.0,1,114,0.0,86.0,86.0
413.593,6,29,4409,12,3102,10914.0,494.0,494.0,17,1307,25849.0,83.0,83.0
0.089,6,10,1506,5,395,19.0,127.0,127.0,5,1111,21.0,843.0,843.0
0.016,6,10,1677,5,827,3.0,559.0,559.0,5,850,3.0,582.0,582.0
0.005,17,2,136,1,60,0.0,32.0,32.0,1,76,0.0,48.0,48.0
0.005,17,2,179,1,71,0.0,43.0,43.0,1,108,0.0,80.0,80.0
175.465,17,70,10015,35,2338,5160.0,44.0,38.0,35,7677,5160.0,239.0,191.0
0.006,17,2,164,1,74,0.0,46.0,46.0,1,90,0.0,62.0,62.0
0.005,6,10,1779,5,928,1.0,660.0,660.0,5,851,1.0,583.0,583.0
0.086,6,10,1506,5,395,19.0,127.0,127.0,5,1111,16.0,843.0,843.0
324.066,17,20,1124,10,716,35993.0,48.0,43.0,10,408,35993.0,20.0,12.0
0.013,6,10,1972,5,910,3.0,642.0,642.0,5,1062,3.0,794.0,794.0
0.006,17,2,157,1,59,0.0,31.0,31.0,1,98,0.0,70.0,70.0
40.055,17,10,676,5,460,10013.0,104.0,64.0,5,216,10013.0,20.0,15.0
0.114,6,10,1506,5,395,26.0,127.0,127.0,5,1111,23.0,843.0,843.0
0.006,17,2,255,1,82,0.0,54.0,54.0,1,173,0.0,145.0,145.0
0.113,6,10,1506,5,395,25.0,127.0,127.0,5,1111,25.0,843.0,843.0
0.01,6,10,1990,5,911,2.0,643.0,643.0,5,1079,2.0,811.0,811.0
0.004,6,13,3747,7,509,0.0,137.0,137.0,6,3238,0.0,1470.0,1459.0
0.013,6,10,1631,5,848,3.0,580.0,580.0,5,783,3.0,515.0,515.0
0.006,6,10,1643,5,860,1.0,592.0,592.0,5,783,1.0,515.0,515.0
0.005,6,10,1989,5,927,1.0,659.0,659.0,5,1062,1.0,794.0,794.0
300.399,6,16,2170,9,684,37529.0,146.0,146.0,7,1486,50039.0,419.0,398.0
0.004,6,10,2007,5,928,1.0,660.0,660.0,5,1079,1.0,811.0,811.0
40.073,17,10,676,5,460,10017.0,104.0,64.0,5,216,10017.0,20.0,15.0
308.499,17,20,1124,10,716,34264.0,48.0,43.0,10,408,34264.0,20.0,12.0
0.005,6,14,3736,7,446,0.0,74.0,74.0,7,3290,0.0,1448.0,972.0
40.06,17,10,676,5,460,10014.0,104.0,64.0,5,216,10014.0,20.0,15.0
0.085,6,10,1506,5,395,19.0,127.0,127.0,5,1111,17.0,843.0,843.0
0.064,6,10,1506,5,395,13.0,127.0,127.0,5,1111,15.0,843.0,843.0
10.753,17,28,4416,14,1993,818.0,268.0,114.0,14,2423,818.0,586.0,145.0
0.004,6,10,1989,5,927,1.0,659.0,659.0,5,1062,1.0,794.0,794.0
0.011,6,10,1677,5,827,2.0,559.0,559.0,5,850,2.0,582.0,582.0
0.004,6,10,2006,5,927,1.0,659.0,659.0,5,1079,1.0,811.0,811.0
0.005,17,2,136,1,60,0.0,32.0,32.0,1,76,0.0,48.0,48.0
0.008,6,10,1989,5,910,2.0,642.0,642.0,5,1079,2.0,811.0,811.0
0.021,6,10,2007,5,928,5.0,660.0,660.0,5,1079,5.0,811.0,811.0
0.009,6,10,1972,5,910,2.0,642.0,642.0,5,1062,2.0,794.0,794.0
0.12,6,10,1506,5,395,28.0,127.0,127.0,5,1111,25.0,843.0,843.0
0.091,6,10,1506,5,395,20.0,127.0,127.0,5,1111,20.0,843.0,843.0
0.043,17,2,170,1,65,0.0,37.0,37.0,1,105,0.0,77.0,77.0
0.013,17,2,170,1,65,0.0,37.0,37.0,1,105,0.0,77.0,77.0
0.017,6,14,3787,7,497,2.0,125.0,125.0,7,3290,2.0,1448.0,972.0
0.109,6,10,1506,5,395,24.0,127.0,127.0,5,1111,24.0,843.0,843.0
0.037,17,2,148,1,60,0.0,32.0,32.0,1,88,0.0,60.0,60.0
0.04,17,2,152,1,76,0.0,48.0,48.0,1,76,0.0,48.0,48.0
10.757,17,28,4422,14,1994,818.0,269.0,114.0,14,2428,818.0,587.0,145.0
0.005,6,10,2006,5,927,1.0,659.0,659.0,5,1079,1.0,811.0,811.0
0.005,6,10,2006,5,927,1.0,659.0,659.0,5,1079,1.0,811.0,811.0
0.043,17,2,148,1,60,0.0,32.0,32.0,1,88,0.0,60.0,60.0
0.01,6,10,1989,5,910,2.0,642.0,642.0,5,1079,2.0,811.0,811.0
0.005,6,10,2000,5,927,1.0,659.0,659.0,5,1073,1.0,805.0,805.0
0.08,6,10,1506,5,395,16.0,127.0,127.0,5,1111,15.0,843.0,843.0
0.01,6,12,1926,6,1189,2.0,659.0,434.0,6,737,1.0,417.0,417.0
0.005,6,13,3747,7,509,0.0,137.0,137.0,6,3238,0.0,1470.0,1459.0
0.078,6,10,1506,5,395,17.0,127.0,127.0,5,1111,17.0,843.0,843.0
0.005,17,2,166,1,75,0.0,47.0,47.0,1,91,0.0,63.0,63.0
0.091,6,10,1506,5,395,16.0,127.0,127.0,5,1111,21.0,843.0,843.0
0.038,17,2,136,1,60,0.0,32.0,32.0,1,76,0.0,48.0,48.0
0.004,17,2,148,1,60,0.0,32.0,32.0,1,88,0.0,60.0,60.0
0.003,17,2,148,1,60,0.0,32.0,32.0,1,88,0.0,60.0,60.0
0.164,17,2,152,1,76,0.0,48.0,48.0,1,76,0.0,48.0,48.0
0.004,17,2,148,1,60,0.0,32.0,32.0,1,88,0.0,60.0,60.0
0.074,6,10,1506,5,395,14.0,127.0,127.0,5,1111,17.0,843.0,843.0
0.003,17,2,148,1,60,0.0,32.0,32.0,1,88,0.0,60.0,60.0
250.324,6,31,8975,15,6533,17880.0,1656.0,639.0,16,2442,16688.0,580.0,178.0
0.004,17,2,144,1,64,0.0,36.0,36.0,1,80,0.0,52.0,52.0
0.005,6,10,1774,5,923,1.0,655.0,655.0,5,851,1.0,583.0,583.0
301.237,6,47,18622,25,12715,12551.0,2720.0,1298.0,22,5907,430.0,2667.0,385.0
0.101,6,10,1506,5,395,22.0,127.0,127.0,5,1111,23.0,843.0,843.0
0.003,17,2,152,1,76,0.0,48.0,48.0,1,76,0.0,48.0,48.0
0.005,6,10,2006,5,927,1.0,659.0,659.0,5,1079,1.0,811.0,811.0
0.012,6,10,1989,5,910,2.0,642.0,642.0,5,1079,3.0,811.0,811.0
0.005,6,10,2007,5,928,1.0,660.0,660.0,5,1079,1.0,811.0,811.0
0.006,6,10,1689,5,839,1.0,571.0,571.0,5,850,1.0,582.0,582.0
0.011,17,2,152,1,76,0.0,48.0,48.0,1,76,0.0,48.0,48.0
40.067,17,10,676,5,460,10015.0,104.0,64.0,5,216,10015.0,20.0,15.0
0.042,17,2,170,1,65,0.0,37.0,37.0,1,105,0.0,77.0,77.0
0.008,17,2,194,1,59,0.0,31.0,31.0,1,135,0.0,107.0,107.0
0.004,17,2,136,1,60,0.0,32.0,32.0,1,76,0.0,48.0,48.0
0.006,17,2,214,1,75,0.0,47.0,47.0,1,139,0.0,111.0,111.0
0.078,17,4,580,2,122,41.0,33.0,33.0,2,458,39.0,307.0,201.0
0.012,6,10,1989,5,910,2.0,642.0,642.0,5,1079,3.0,811.0,811.0
0.012,6,10,1631,5,848,2.0,580.0,580.0,5,783,2.0,515.0,515.0
0.009,6,10,1989,5,910,2.0,642.0,642.0,5,1079,2.0,811.0,811.0
0.005,17,2,140,1,62,0.0,34.0,34.0,1,78,0.0,50.0,50.0
0.005,17,2,164,1,74,0.0,46.0,46.0,1,90,0.0,62.0,62.0
0.004,6,10,2000,5,927,1.0,659.0,659.0,5,1073,1.0,805.0,805.0
0.039,17,2,148,1,60,0.0,32.0,32.0,1,88,0.0,60.0,60.0
0.079,6,10,1506,5,395,17.0,127.0,127.0,5,1111,18.0,843.0,843.0
40.06,17,10,676,5,460,10014.0,104.0,64.0,5,216,10012.0,20.0,15.0
0.006,6,10,1547,5,764,1.0,496.0,496.0,5,783,1.0,515.0,515.0
0.006,6,10,1547,5,764,1.0,496.0,496.0,5,783,1.0,515.0,515.0
0.062,17,2,152,1,76,0.0,48.0,48.0,1,76,0.0,48.0,48.0
40.07,17,10,676,5,460,10014.0,104.0,64.0,5,216,10016.0,20.0,15.0
0.004,17,4,284,2,120,1.0,32.0,32.0,2,164,1.0,60.0,54.0
0.169,17,2,152,1,76,0.0,48.0,48.0,1,76,0.0,48.0,48.0
0.005,6,10,2007,5,928,1.0,660.0,660.0,5,1079,1.0,811.0,811.0
0.004,6,10,2007,5,928,1.0,660.0,660.0,5,1079,1.0,811.0,811.0
0.01,6,10,1989,5,910,2.0,642.0,642.0,5,1079,2.0,811.0,811.0
0.005,6,10,1989,5,927,1.0,659.0,659.0,5,1062,1.0,794.0,794.0
0.09,6,10,1506,5,395,19.0,127.0,127.0,5,1111,18.0,843.0,843.0
175.398,17,96,13718,48,3226,3731.0,44.0,39.0,48,10492,3731.0,261.0,190.0
0.005,6,10,2007,5,928,1.0,660.0,660.0,5,1079,1.0,811.0,811.0
0.005,6,13,3690,7,452,0.0,80.0,80.0,6,3238,1.0,1470.0,1459.0
0.005,6,10,2006,5,927,1.0,659.0,659.0,5,1079,1.0,811.0,811.0
0.089,6,10,1506,5,395,21.0,127.0,127.0,5,1111,20.0,843.0,843.0
0.004,6,10,1774,5,923,1.0,655.0,655.0,5,851,1.0,583.0,583.0
43.228,6,39,11781,20,6223,464.0,1360.0,898.0,19,5558,2392.0,2667.0,435.0
0.006,6,10,1547,5,764,1.0,496.0,496.0,5,783,1.0,515.0,515.0
0.004,6,10,1774,5,923,1.0,655.0,655.0,5,851,1.0,583.0,583.0
0.005,17,2,164,1,74,0.0,46.0,46.0,1,90,0.0,62.0,62.0
40.077,17,10,676,5,460,10015.0,104.0,64.0,5,216,10014.0,20.0,15.0
0.02,6,10,1989,5,910,4.0,642.0,642.0,5,1079,5.0,811.0,811.0
0.001,17,2,180,1,65,0.0,37.0,37.0,1,115,0.0,87.0,87.0
0.005,6,10,2000,5,927,1.0,659.0,659.0,5,1073,1.0,805.0,805.0
0.005,6,10,2007,5,928,1.0,660.0,660.0,5,1079,1.0,811.0,811.0
0.005,17,2,169,1,62,0.0,34.0,34.0,1,107,0.0,79.0,79.0
0.008,17,2,208,1,72,0.0,44.0,44.0,1,136,0.0,108.0,108.0
0.004,6,10,2000,5,927,1.0,659.0,659.0,5,1073,1.0,805.0,805.0
0.005,6,13,3690,7,452,0.0,80.0,80.0,6,3238,1.0,1470.0,1459.0
0.073,17,2,148,1,60,0.0,32.0,32.0,1,88,0.0,60.0,60.0
10.845,17,28,4422,14,1993,825.0,268.0,114.0,14,2429,825.0,588.0,145.0
1800.0,6,211,14558,79,6242,23076.0,46.0,46.0,132,8316,13739.0,46.0,46.0
64.038,6,6,1464,3,1229,32018.0,982.0,506.0,3,235,31966.0,31.0,31.0
0.104,6,10,1506,5,395,17.0,127.0,127.0,5,1111,25.0,843.0,843.0
0.005,17,2,148,1,60,0.0,32.0,32.0,1,88,0.0,60.0,60.0
0.004,6,10,1779,5,928,1.0,660.0,660.0,5,851,1.0,583.0,583.0
0.006,6,10,1779,5,928,1.0,660.0,660.0,5,851,1.0,583.0,583.0
0.005,17,2,175,1,65,0.0,37.0,37.0,1,110,0.0,82.0,82.0
1.079,6,31,12755,18,3352,63.0,1360.0,517.0,13,9403,76.0,2720.0,985.0
0.008,6,10,1972,5,910,2.0,642.0,642.0,5,1062,2.0,794.0,794.0
0.005,17,2,170,1,65,0.0,37.0,37.0,1,105,0.0,77.0,77.0
0.004,6,10,1702,5,863,1.0,595.0,595.0,5,839,1.0,571.0,571.0
240.03,6,9,787,5,488,60007.0,232.0,232.0,4,299,80006.0,83.0,83.0
0.039,17,2,136,1,60,0.0,32.0,32.0,1,76,0.0,48.0,48.0
0.087,17,4,596,2,122,45.0,33.0,33.0,2,474,45.0,323.0,209.0
0.109,6,10,1506,5,395,26.0,127.0,127.0,5,1111,25.0,843.0,843.0
40.016,17,10,676,5,460,10002.0,104.0,64.0,5,216,10003.0,20.0,15.0
0.004,6,10,1702,5,863,1.0,595.0,595.0,5,839,0.0,571.0,571.0
0.004,6,10,1774,5,923,1.0,655.0,655.0,5,851,1.0,583.0,583.0
0.015,6,10,1989,5,910,3.0,642.0,642.0,5,1079,3.0,811.0,811.0
0.102,6,10,1506,5,395,23.0,127.0,127.0,5,1111,20.0,843.0,843.0
0.011,6,10,1989,5,910,2.0,642.0,642.0,5,1079,2.0,811.0,811.0
0.003,17,2,136,1,60,0.0,32.0,32.0,1,76,0.0,48.0,48.0
0.005,6,10,1989,5,927,1.0,659.0,659.0,5,1062,1.0,794.0,794.0
300.442,6,16,2170,9,684,37534.0,146.0,146.0,7,1486,50044.0,419.0,398.0
0.018,6,10,1990,5,911,4.0,643.0,643.0,5,1079,4.0,811.0,811.0
0.006,6,10,1547,5,764,1.0,496.0,496.0,5,783,1.0,515.0,515.0
289.274,6,401,348679,196,21774,1483.0,2736.0,890.0,205,326905,1418.0,2804.0,1655.0
0.057,17,2,179,1,71,0.0,43.0,43.0,1,108,0.0,80.0,80.0
0.001,17,2,136,1,60,0.0,32.0,32.0,1,76,0.0,48.0,48.0
0.006,6,10,1689,5,839,1.0,571.0,571.0,5,850,1.0,582.0,582.0
0.005,6,10,1547,5,764,1.0,496.0,496.0,5,783,1.0,515.0,515.0
0.005,17,2,170,1,65,0.0,37.0,37.0,1,105,0.0,77.0,77.0
0.002,17,2,180,1,66,0.0,38.0,38.0,1,114,0.0,86.0,86.0
0.016,6,10,1983,5,910,4.0,642.0,642.0,5,1073,3.0,805.0,805.0
0.001,17,2,180,1,66,0.0,38.0,38.0,1,114,0.0,86.0,86.0
0.082,6,10,1506,5,395,16.0,127.0,127.0,5,1111,17.0,843.0,843.0
308.246,17,20,1124,10,716,34235.0,48.0,43.0,10,408,34235.0,20.0,12.0
0.005,6,13,3747,7,509,0.0,137.0,137.0,6,3238,1.0,1470.0,1459.0
0.005,6,10,1689,5,839,1.0,571.0,571.0,5,850,1.0,582.0,582.0
0.019,6,6,716,3,458,8.0,302.0,302.0,3,258,7.0,102.0,102.0
0.111,6,10,1506,5,395,23.0,127.0,127.0,5,1111,24.0,843.0,843.0
0.007,6,10,1702,5,863,1.0,595.0,595.0,5,839,1.0,571.0,571.0
0.004,17,2,148,1,60,0.0,32.0,32.0,1,88,0.0,60.0,60.0
0.006,6,10,1989,5,927,1.0,659.0,659.0,5,1062,1.0,794.0,794.0
0.008,6,10,1989,5,910,2.0,642.0,642.0,5,1079,2.0,811.0,811.0
0.133,17,4,420,2,122,0.0,33.0,33.0,2,298,91.0,145.0,121.0
0.005,6,14,3799,7,509,0.0,137.0,137.0,7,3290,0.0,1448.0,972.0
0.006,6,10,1547,5,764,1.0,496.0,496.0,5,783,1.0,515.0,515.0
0.006,6,10,2006,5,927,1.0,659.0,659.0,5,1079,1.0,811.0,811.0
0.005,6,13,3747,7,509,0.0,137.0,137.0,6,3238,0.0,1470.0,1459.0
0.134,6,10,1506,5,395,28.0,127.0,127.0,5,1111,30.0,843.0,843.0
0.006,6,10,1547,5,764,1.0,496.0,496.0,5,783,1.0,515.0,515.0
0.012,6,10,1983,5,910,3.0,642.0,642.0,5,1073,2.0,805.0,805.0
0.01,6,10,1983,5,910,2.0,642.0,642.0,5,1073,2.0,805.0,805.0
0.009,6,13,3735,7,497,1.0,125.0,125.0,6,3238,1.0,1470.0,1459.0
0.009,6,10,1972,5,910,2.0,642.0,642.0,5,1062,2.0,794.0,794.0
11.182,17,28,4422,14,1994,847.0,269.0,114.0,14,2428,847.0,587.0,145.0
40.051,17,10,676,5,460,10012.0,104.0,64.0,5,216,10012.0,20.0,15.0
0.005,6,10,1689,5,839,1.0,571.0,571.0,5,850,1.0,582.0,582.0
0.015,6,10,1762,5,911,3.0,643.0,643.0,5,851,3.0,583.0,583.0
40.06,17,10,676,5,460,10013.0,104.0,64.0,5,216,10014.0,20.0,15.0
0.006,6,10,1547,5,764,1.0,496.0,496.0,5,783,1.0,515.0,515.0
0.206,6,16,2674,8,1400,29.0,533.0,325.0,8,1274,19.0,529.0,212.0
0.005,6,10,2007,5,928,1.0,660.0,660.0,5,1079,1.0,811.0,811.0
0.004,6,10,1774,5,923,1.0,655.0,655.0,5,851,1.0,583.0,583.0
0.073,6,10,1506,5,395,15.0,127.0,127.0,5,1111,16.0,843.0,843.0
0.008,6,10,1989,5,910,2.0,642.0,642.0,5,1079,1.0,811.0,811.0
0.088,6,10,1506,5,395,17.0,127.0,127.0,5,1111,17.0,843.0,843.0
0.009,6,10,1762,5,911,2.0,643.0,643.0,5,851,2.0,583.0,583.0
0.007,6,10,1547,5,764,1.0,496.0,496.0,5,783,1.0,515.0,515.0
0.006,17,2,225,1,65,0.0,37.0,37.0,1,160,0.0,132.0,132.0
0.079,6,10,1506,5,395,17.0,127.0,127.0,5,1111,18.0,843.0,843.0
0.005,6,10,1854,5,889,1.0,621.0,621.0,5,965,1.0,697.0,697.0
0.119,6,10,1506,5,395,27.0,127.0,127.0,5,1111,27.0,843.0,843.0
0.006,17,2,180,1,66,0.0,38.0,38.0,1,114,0.0,86.0,86.0
1777.621,17,144,41760,72,22752,25036.0,288.0,288.0,72,19008,25036.0,236.0,236.0
0.075,6,10,1506,5,395,16.0,127.0,127.0,5,1111,15.0,843.0,843.0
0.088,6,10,1506,5,395,20.0,127.0,127.0,5,1111,17.0,843.0,843.0
1729.236,6,60,4400,40,2740,44339.0,33.0,33.0,20,1660,91003.0,31.0,31.0
240.455,6,25,8622,15,3632,17175.0,923.0,476.0,10,4990,26716.0,1605.0,892.0
0.091,6,10,1506,5,395,20.0,127.0,127.0,5,1111,19.0,843.0,843.0
0.013,6,10,1677,5,827,3.0,559.0,559.0,5,850,3.0,582.0,582.0
0.11,6,10,1506,5,395,20.0,127.0,127.0,5,1111,24.0,843.0,843.0
0.006,6,10,1547,5,764,1.0,496.0,496.0,5,783,1.0,515.0,515.0
0.004,6,10,1774,5,923,1.0,655.0,655.0,5,851,1.0,583.0,583.0
171.366,17,84,11824,42,2795,4179.0,44.0,38.0,42,9029,4179.0,261.0,186.0
0.004,6,10,1702,5,863,0.0,595.0,595.0,5,839,1.0,571.0,571.0
0.001,17,2,180,1,66,0.0,38.0,38.0,1,114,0.0,86.0,86.0
0.005,6,10,1689,5,839,1.0,571.0,571.0,5,850,1.0,582.0,582.0
0.013,6,10,1983,5,910,3.0,642.0,642.0,5,1073,3.0,805.0,805.0
0.053,6,10,1506,5,395,12.0,127.0,127.0,5,1111,11.0,843.0,843.0
0.058,6,10,1506,5,395,12.0,127.0,127.0,5,1111,12.0,843.0,843.0
0.082,6,10,1506,5,395,17.0,127.0,127.0,5,1111,18.0,843.0,843.0
0.01,6,10,1983,5,910,2.0,642.0,642.0,5,1073,2.0,805.0,805.0
40.062,17,10,676,5,460,10013.0,104.0,64.0,5,216,10014.0,20.0,15.0
310.722,17,20,1124,10,716,34510.0,48.0,43.0,10,408,34509.0,20.0,12.0
0.007,6,12,1698,6,863,1.0,327.0,271.0,6,835,1.0,515.0,515.0
0.13,6,10,1506,5,395,30.0,127.0,127.0,5,1111,30.0,843.0,843.0
0.01,6,10,1990,5,911,2.0,643.0,643.0,5,1079,2.0,811.0,811.0
0.12,6,10,1506,5,395,24.0,127.0,127.0,5,1111,26.0,843.0,843.0
0.005,6,10,2006,5,927,1.0,659.0,659.0,5,1079,1.0,811.0,811.0
11.173,17,28,4420,14,1993,846.0,268.0,114.0,14,2427,846.0,586.0,145.0
0.005,6,10,1989,5,927,1.0,659.0,659.0,5,1062,1.0,794.0,794.0
0.005,6,10,2006,5,927,1.0,659.0,659.0,5,1079,1.0,811.0,811.0
0.019,6,10,1762,5,911,4.0,643.0,643.0,5,851,4.0,583.0,583.0
1730.415,6,45,2790,30,1725,59669.0,35.0,35.0,15,1065,123595.0,31.0,31.0
0.714,6,22,5072,11,1250,60.0,325.0,133.0,11,3822,59.0,1414.0,563.0
0.005,17,2,170,1,65,0.0,37.0,37.0,1,105,0.0,77.0,77.0
0.005,17,2,164,1,74,0.0,46.0,46.0,1,90,0.0,62.0,62.0
0.004,6,10,2006,5,927,1.0,659.0,659.0,5,1079,1.0,811.0,811.0
0.004,6,10,1989,5,927,1.0,659.0,659.0,5,1062,1.0,794.0,794.0
0.005,17,2,214,1,75,0.0,47.0,47.0,1,139,0.0,111.0,111.0
0.005,17,2,154,1,69,0.0,41.0,41.0,1,85,0.0,57.0,57.0
0.005,6,10,2006,5,927,1.0,659.0,659.0,5,1079,1.0,811.0,811.0
0.006,6,10,1547,5,764,1.0,496.0,496.0,5,783,1.0,515.0,515.0
0.077,6,10,1506,5,395,16.0,127.0,127.0,5,1111,18.0,843.0,843.0
11.199,17,28,4396,14,2311,852.0,586.0,137.0,14,2085,852.0,268.0,120.0
11.148,17,28,4417,14,1993,845.0,268.0,114.0,14,2424,845.0,587.0,145.0
0.085,6,10,1506,5,395,19.0,127.0,127.0,5,1111,18.0,843.0,843.0
174.273,17,76,10770,38,2536,4710.0,44.0,38.0,38,8234,4709.0,239.0,188.0
0.003,17,2,148,1,60,0.0,32.0,32.0,1,88,0.0,60.0,60.0
330.903,17,20,1124,10,716,36752.0,48.0,43.0,10,408,36752.0,20.0,12.0
15.07,17,23,14784,13,12037,1253.0,1350.0,897.0,10,2747,1671.0,1350.0,246.0
0.072,6,10,1506,5,395,16.0,127.0,127.0,5,1111,16.0,843.0,843.0
40.079,17,10,676,5,460,10019.0,104.0,64.0,5,216,10018.0,20.0,15.0
0.006,6,10,2006,5,927,1.0,659.0,659.0,5,1079,1.0,811.0,811.0
0.009,6,10,1989,5,910,2.0,642.0,642.0,5,1079,2.0,811.0,811.0
0.005,6,10,2000,5,927,1.0,659.0,659.0,5,1073,1.0,805.0,805.0
0.006,17,2,262,1,66,0.0,38.0,38.0,1,196,0.0,168.0,168.0
0.006,6,10,1643,5,860,1.0,592.0,592.0,5,783,1.0,515.0,515.0
0.005,6,10,1989,5,927,1.0,659.0,659.0,5,1062,1.0,794.0,794.0
0.008,6,10,1989,5,910,2.0,642.0,642.0,5,1079,1.0,811.0,811.0
40.06,17,10,676,5,460,10014.0,104.0,64.0,5,216,10014.0,20.0,15.0
0.004,6,10,1702,5,863,1.0,595.0,595.0,5,839,0.0,571.0,571.0
0.005,6,10,2006,5,927,1.0,659.0,659.0,5,1079,1.0,811.0,811.0
0.006,17,2,164,1,74,0.0,46.0,46.0,1,90,0.0,62.0,62.0
0.004,6,10,1779,5,928,1.0,660.0,660.0,5,851,1.0,583.0,583.0
0.014,6,10,1990,5,911,3.0,643.0,643.0,5,1079,3.0,811.0,811.0
0.147,6,10,1506,5,395,35.0,127.0,127.0,5,1111,32.0,843.0,843.0
0.012,6,10,1990,5,911,2.0,643.0,643.0,5,1079,3.0,811.0,811.0
15.075,17,16,9086,8,6909,2149.0,1350.0,835.0,8,2177,2149.0,1350.0,244.0
0.005,17,2,170,1,65,0.0,37.0,37.0,1,105,0.0,77.0,77.0
0.005,6,10,1989,5,927,1.0,659.0,659.0,5,1062,1.0,794.0,794.0
0.103,6,10,1506,5,395,22.0,127.0,127.0,5,1111,21.0,843.0,843.0
0.013,6,10,1631,5,848,3.0,580.0,580.0,5,783,3.0,515.0,515.0
0.006,6,10,2000,5,927,1.0,659.0,659.0,5,1073,1.0,805.0,805.0
0.009,17,2,179,1,71,0.0,43.0,43.0,1,108,0.0,80.0,80.0
0.011,6,10,1762,5,911,2.0,643.0,643.0,5,851,2.0,583.0,583.0
5.062,58,2,144,1,72,0.0,24.0,24.0,1,72,0.0,24.0,24.0
0.013,6,10,1631,5,848,3.0,580.0,580.0,5,783,3.0,515.0,515.0
0.064,6,10,1506,5,395,14.0,127.0,127.0,5,1111,15.0,843.0,843.0
0.005,17,2,166,1,75,0.0,47.0,47.0,1,91,0.0,63.0,63.0
15.1,17,19,9767,9,7393,1884.0,1350.0,793.0,10,2374,1674.0,1350.0,209.0
0.005,6,10,2000,5,927,1.0,659.0,659.0,5,1073,1.0,805.0,805.0
0.005,17,2,169,1,62,0.0,34.0,34.0,1,107,0.0,79.0,79.0
0.047,17,4,284,2,120,6.0,32.0,32.0,2,164,44.0,60.0,54.0
0.1,6,10,1506,5,395,19.0,127.0,127.0,5,1111,22.0,843.0,843.0
0.013,6,10,1989,5,910,3.0,642.0,642.0,5,1079,3.0,811.0,811.0
0.01,6,10,1990,5,911,2.0,643.0,643.0,5,1079,2.0,811.0,811.0
0.005,6,10,1689,5,839,1.0,571.0,571.0,5,850,1.0,582.0,582.0
0.006,6,10,1989,5,927,1.0,659.0,659.0,5,1062,1.0,794.0,794.0
0.005,6,10,1547,5,764,1.0,496.0,496.0,5,783,1.0,515.0,515.0
0.006,6,10,1643,5,860,1.0,592.0,592.0,5,783,1.0,515.0,515.0
0.005,6,13,3747,7,509,0.0,137.0,137.0,6,3238,1.0,1470.0,1459.0
15.077,17,16,8376,8,6234,2149.0,1350.0,751.0,8,2142,2149.0,1350.0,239.0
0.057,6,10,1506,5,395,13.0,127.0,127.0,5,1111,13.0,843.0,843.0
703.109,17,160,23374,80,5386,8900.0,44.0,39.0,80,17988,8900.0,261.0,196.0
0.088,6,10,1506,5,395,21.0,127.0,127.0,5,1111,14.0,843.0,843.0
0.004,6,10,1779,5,928,1.0,660.0,660.0,5,851,1.0,583.0,583.0
0.02,6,10,1989,5,910,5.0,642.0,642.0,5,1079,4.0,811.0,811.0
0.005,6,10,2000,5,927,1.0,659.0,659.0,5,1073,1.0,805.0,805.0
0.017,6,10,1989,5,910,4.0,642.0,642.0,5,1079,4.0,811.0,811.0
0.009,6,10,1989,5,910,2.0,642.0,642.0,5,1079,2.0,811.0,811.0
0.008,6,10,1989,5,910,2.0,642.0,642.0,5,1079,2.0,811.0,811.0
0.077,6,10,1506,5,395,16.0,127.0,127.0,5,1111,17.0,843.0,843.0
0.006,6,10,1689,5,839,1.0,571.0,571.0,5,850,1.0,582.0,582.0
0.005,6,10,1989,5,927,1.0,659.0,659.0,5,1062,1.0,794.0,794.0
0.017,17,2,136,1,60,0.0,32.0,32.0,1,76,0.0,48.0,48.0
0.005,6,10,2007,5,928,1.0,660.0,660.0,5,1079,1.0,811.0,811.0
0.006,6,10,1643,5,860,1.0,592.0,592.0,5,783,1.0,515.0,515.0
0.091,6,10,1506,5,395,21.0,127.0,127.0,5,1111,21.0,843.0,843.0
0.005,6,13,3747,7,509,0.0,137.0,137.0,6,3238,0.0,1470.0,1459.0
0.085,6,10,1506,5,395,18.0,127.0,127.0,5,1111,18.0,843.0,843.0
0.005,6,10,2006,5,927,1.0,659.0,659.0,5,1079,1.0,811.0,811.0
0.019,6,14,3787,7,497,3.0,125.0,125.0,7,3290,3.0,1448.0,972.0
0.17,6,3,453,2,321,170.0,241.0,241.0,1,132,0.0,92.0,92.0
9.038,17,6,376,5,280,2259.0,28.0,28.0,1,96,0.0,68.0,68.0
40.09,17,10,676,5,460,10021.0,104.0,64.0,5,216,10021.0,20.0,15.0
240.093,6,32,9650,16,7043,16006.0,2115.0,690.0,16,2607,16006.0,580.0,220.0
300.379,6,16,2170,9,684,37526.0,146.0,146.0,7,1486,50035.0,419.0,398.0
0.28,17,45,27894,26,24789,11.0,1350.0,925.0,19,3105,13.0,1350.0,135.0
0.007,17,2,179,1,71,0.0,43.0,43.0,1,108,0.0,80.0,80.0
1.135,6,32,13391,18,5892,66.0,2720.0,854.0,14,7499,73.0,2720.0,769.0
0.005,6,10,1779,5,928,1.0,660.0,660.0,5,851,1.0,583.0,583.0
0.175,17,2,152,1,76,0.0,48.0,48.0,1,76,0.0,48.0,48.0
0.011,6,10,1983,5,910,2.0,642.0,642.0,5,1073,2.0,805.0,805.0
15.117,17,18,9646,9,7485,1884.0,1350.0,803.0,9,2161,1883.0,1350.0,212.0
0.015,6,10,1990,5,911,3.0,643.0,643.0,5,1079,3.0,811.0,811.0
300.028,6,12,1782,7,1348,50004.0,494.0,494.0,5,434,75006.0,83.0,83.0
0.004,6,10,1702,5,863,1.0,595.0,595.0,5,839,0.0,571.0,571.0
0.074,6,10,1506,5,395,16.0,127.0,127.0,5,1111,13.0,843.0,843.0
0.135,6,10,1506,5,395,31.0,127.0,127.0,5,1111,31.0,843.0,843.0
0.012,6,13,3735,7,497,1.0,125.0,125.0,6,3238,2.0,1470.0,1459.0
29.604,6,42,13469,22,7642,1409.0,1936.0,1121.0,20,5827,466.0,2667.0,385.0
0.012,6,10,1989,5,910,3.0,642.0,642.0,5,1079,2.0,811.0,811.0
0.004,17,2,148,1,60,0.0,32.0,32.0,1,88,0.0,60.0,60.0
10.777,17,28,4419,14,1994,820.0,269.0,114.0,14,2425,820.0,588.0,145.0
0.004,6,10,2006,5,927,1.0,659.0,659.0,5,1079,1.0,811.0,811.0
354.058,6,19,1691,15,978,25289.0,190.0,190.0,4,713,80002.0,497.0,497.0
0.007,6,10,1547,5,764,1.0,496.0,496.0,5,783,1.0,515.0,515.0
0.01,17,2,169,1,62,0.0,34.0,34.0,1,107,0.0,79.0,79.0
0.018,6,10,1762,5,911,4.0,643.0,643.0,5,851,4.0,583.0,583.0
0.004,6,10,2006,5,927,1.0,659.0,659.0,5,1079,1.0,811.0,811.0
0.005,6,10,2006,5,927,1.0,659.0,659.0,5,1079,1.0,811.0,811.0
0.015,6,10,1989,5,910,3.0,642.0,642.0,5,1079,3.0,811.0,811.0
0.004,17,2,160,1,72,0.0,44.0,44.0,1,88,0.0,60.0,60.0
0.004,17,2,148,1,60,0.0,32.0,32.0,1,88,0.0,60.0,60.0
0.007,6,10,1972,5,910,1.0,642.0,642.0,5,1062,1.0,794.0,794.0
0.104,6,10,1506,5,395,22.0,127.0,127.0,5,1111,25.0,843.0,843.0
0.056,6,10,1506,5,395,12.0,127.0,127.0,5,1111,13.0,843.0,843.0
0.005,6,10,2007,5,928,1.0,660.0,660.0,5,1079,1.0,811.0,811.0
0.077,6,10,1506,5,395,16.0,127.0,127.0,5,1111,16.0,843.0,843.0
0.04,17,2,152,1,76,0.0,48.0,48.0,1,76,0.0,48.0,48.0
240.094,6,16,4481,9,963,30011.0,238.0,166.0,7,3518,40014.0,1402.0,786.0
0.008,6,10,1989,5,910,2.0,642.0,642.0,5,1079,2.0,811.0,811.0
63.656,6,40,12519,20,6876,468.0,4080.0,1508.0,20,5643,3341.0,2667.0,402.0
40.078,17,10,676,5,460,10017.0,104.0,64.0,5,216,10018.0,20.0,15.0
0.013,6,10,1972,5,910,3.0,642.0,642.0,5,1062,3.0,794.0,794.0
40.059,17,10,676,5,460,10013.0,104.0,64.0,5,216,10013.0,20.0,15.0
0.015,6,10,1677,5,827,3.0,559.0,559.0,5,850,3.0,582.0,582.0
0.032,17,2,136,1,60,0.0,32.0,32.0,1,76,0.0,48.0,48.0
0.011,6,10,1990,5,911,2.0,643.0,643.0,5,1079,2.0,811.0,811.0
0.142,6,12,2996,7,549,23.0,177.0,177.0,5,2447,34.0,1402.0,1089.0
324.939,17,20,1124,10,716,36090.0,48.0,43.0,10,408,36090.0,20.0,12.0
0.005,17,2,164,1,74,0.0,46.0,46.0,1,90,0.0,62.0,62.0
0.006,6,10,1547,5,764,1.0,496.0,496.0,5,783,1.0,515.0,515.0
0.0,17,2,180,1,66,0.0,38.0,38.0,1,114,0.0,86.0,86.0
0.112,6,10,1506,5,395,21.0,127.0,127.0,5,1111,25.0,843.0,843.0
0.006,6,13,3747,7,509,1.0,137.0,137.0,6,3238,1.0,1470.0,1459.0
0.003,17,4,284,2,120,0.0,32.0,32.0,2,164,0.0,60.0,54.0
0.015,6,10,1983,5,910,3.0,642.0,642.0,5,1073,3.0,805.0,805.0
0.006,6,10,1779,5,928,1.0,660.0,660.0,5,851,1.0,583.0,583.0
0.005,6,10,1989,5,927,1.0,659.0,659.0,5,1062,1.0,794.0,794.0
1799.997,6,137,6590,76,3625,23996.0,39.0,39.0,61,2965,29996.0,35.0,35.0
0.006,6,10,1547,5,764,1.0,496.0,496.0,5,783,1.0,515.0,515.0
353.808,6,20,2210,6,1308,12011.0,494.0,494.0,14,902,27215.0,83.0,83.0
0.072,17,2,184,1,61,0.0,33.0,33.0,1,123,0.0,95.0,95.0
0.012,6,10,1983,5,910,2.0,642.0,642.0,5,1073,3.0,805.0,805.0
0.01,6,10,1989,5,910,2.0,642.0,642.0,5,1079,2.0,811.0,811.0
0.101,6,10,1506,5,395,22.0,127.0,127.0,5,1111,23.0,843.0,843.0
0.006,17,2,140,1,62,0.0,34.0,34.0,1,78,0.0,50.0,50.0
0.069,6,10,1506,5,395,16.0,127.0,127.0,5,1111,14.0,843.0,843.0
15.125,17,19,13436,9,8280,1887.0,1350.0,892.0,10,5156,1676.0,1350.0,487.0
0.005,6,10,2006,5,927,1.0,659.0,659.0,5,1079,1.0,811.0,811.0
0.001,17,2,180,1,66,0.0,38.0,38.0,1,114,0.0,86.0,86.0
0.006,6,10,1547,5,764,1.0,496.0,496.0,5,783,1.0,515.0,515.0
0.005,6,10,2007,5,928,1.0,660.0,660.0,5,1079,1.0,811.0,811.0
0.008,6,10,1989,5,910,2.0,642.0,642.0,5,1079,2.0,811.0,811.0
0.007,6,10,1689,5,839,1.0,571.0,571.0,5,850,1.0,582.0,582.0
0.144,6,10,1506,5,395,34.0,127.0,127.0,5,1111,28.0,843.0,843.0
0.01,6,10,1972,5,910,2.0,642.0,642.0,5,1062,2.0,794.0,794.0
0.005,6,10,2006,5,927,1.0,659.0,659.0,5,1079,1.0,811.0,811.0
0.003,17,2,148,1,60,0.0,32.0,32.0,1,88,0.0,60.0,60.0
0.006,6,10,1547,5,764,1.0,496.0,496.0,5,783,1.0,515.0,515.0
0.006,6,10,1547,5,764,1.0,496.0,496.0,5,783,1.0,515.0,515.0
0.009,6,10,1677,5,827,2.0,559.0,559.0,5,850,2.0,582.0,582.0
0.022,6,10,1983,5,910,5.0,642.0,642.0,5,1073,5.0,805.0,805.0
0.129,17,2,148,1,60,0.0,32.0,32.0,1,88,0.0,60.0,60.0
40.076,17,10,676,5,460,10016.0,104.0,64.0,5,216,10018.0,20.0,15.0
0.012,6,10,1972,5,910,2.0,642.0,642.0,5,1062,3.0,794.0,794.0
66.137,6,22,10152,12,3985,6012.0,1591.0,838.0,10,6167,7329.0,2225.0,939.0
0.043,17,4,284,2,120,0.0,32.0,32.0,2,164,40.0,60.0,54.0
0.012,6,10,1990,5,911,2.0,643.0,643.0,5,1079,3.0,811.0,811.0
0.005,6,10,1774,5,923,1.0,655.0,655.0,5,851,1.0,583.0,583.0
10.851,17,28,4419,14,1994,826.0,269.0,114.0,14,2425,826.0,588.0,145.0
0.013,6,10,1989,5,910,3.0,642.0,642.0,5,1079,3.0,811.0,811.0
0.083,6,10,1506,5,395,18.0,127.0,127.0,5,1111,17.0,843.0,843.0
0.017,6,10,1631,5,848,4.0,580.0,580.0,5,783,4.0,515.0,515.0
0.006,17,2,164,1,74,0.0,46.0,46.0,1,90,0.0,62.0,62.0
0.005,6,10,1854,5,889,1.0,621.0,621.0,5,965,1.0,697.0,697.0
0.006,6,10,1689,5,839,1.0,571.0,571.0,5,850,1.0,582.0,582.0
0.082,6,10,1506,5,395,19.0,127.0,127.0,5,1111,18.0,843.0,843.0
0.075,6,10,1506,5,395,16.0,127.0,127.0,5,1111,17.0,843.0,843.0
0.007,6,12,1698,6,863,1.0,327.0,271.0,6,835,1.0,515.0,515.0
0.068,6,10,1506,5,395,15.0,127.0,127.0,5,1111,13.0,843.0,843.0
0.065,6,10,1506,5,395,15.0,127.0,127.0,5,1111,13.0,843.0,843.0
0.004,6,10,2007,5,928,1.0,660.0,660.0,5,1079,1.0,811.0,811.0
0.014,6,13,3735,7,497,2.0,125.0,125.0,6,3238,2.0,1470.0,1459.0
0.005,6,10,1643,5,860,1.0,592.0,592.0,5,783,1.0,515.0,515.0
0.015,6,10,1989,5,910,3.0,642.0,642.0,5,1079,3.0,811.0,811.0
0.07,6,10,1506,5,395,16.0,127.0,127.0,5,1111,16.0,843.0,843.0
0.007,6,10,1989,5,927,1.0,659.0,659.0,5,1062,1.0,794.0,794.0
0.212,6,16,2783,8,1401,30.0,533.0,325.0,8,1382,19.0,529.0,239.0
0.088,6,10,1506,5,395,20.0,127.0,127.0,5,1111,18.0,843.0,843.0
40.075,17,10,676,5,460,10017.0,104.0,64.0,5,216,10017.0,20.0,15.0
0.016,6,10,1972,5,910,3.0,642.0,642.0,5,1062,3.0,794.0,794.0
0.004,17,2,148,1,60,0.0,32.0,32.0,1,88,0.0,60.0,60.0
0.053,17,2,152,1,76,0.0,48.0,48.0,1,76,0.0,48.0,48.0
0.018,6,10,1989,5,910,4.0,642.0,642.0,5,1079,4.0,811.0,811.0
0.006,6,10,2006,5,927,1.0,659.0,659.0,5,1079,1.0,811.0,811.0
1797.086,6,260,41235,101,31425,17969.0,2720.0,326.0,159,9810,11373.0,148.0,48.0
0.101,6,10,1506,5,395,23.0,127.0,127.0,5,1111,24.0,843.0,843.0
0.006,6,10,1643,5,860,1.0,592.0,592.0,5,783,1.0,515.0,515.0
0.128,6,10,1506,5,395,29.0,127.0,127.0,5,1111,29.0,843.0,843.0
0.107,6,10,1506,5,395,25.0,127.0,127.0,5,1111,25.0,843.0,843.0
110.21,6,22,8496,12,2236,72.0,1345.0,574.0,10,6260,12226.0,2720.0,974.0
0.088,6,10,1506,5,395,18.0,127.0,127.0,5,1111,18.0,843.0,843.0
0.004,6,10,1774,5,923,1.0,655.0,655.0,5,851,1.0,583.0,583.0
0.005,6,10,1989,5,927,1.0,659.0,659.0,5,1062,1.0,794.0,794.0
0.008,17,2,194,1,59,0.0,31.0,31.0,1,135,0.0,107.0,107.0
0.081,6,10,1506,5,395,17.0,127.0,127.0,5,1111,18.0,843.0,843.0
300.201,6,33,12412,17,6430,18762.0,1368.0,789.0,16,5982,20013.0,1657.0,736.0
0.004,6,10,2007,5,928,1.0,660.0,660.0,5,1079,1.0,811.0,811.0
0.005,6,10,2006,5,927,1.0,659.0,659.0,5,1079,1.0,811.0,811.0
325.727,17,20,1124,10,716,36177.0,48.0,43.0,10,408,36177.0,20.0,12.0
0.003,17,2,234,1,61,0.0,33.0,33.0,1,173,0.0,145.0,145.0
0.002,17,2,180,1,66,0.0,38.0,38.0,1,114,0.0,86.0,86.0
0.01,6,10,1989,5,910,2.0,642.0,642.0,5,1079,2.0,811.0,811.0
0.005,6,10,1989,5,927,1.0,659.0,659.0,5,1062,1.0,794.0,794.0
0.005,6,10,1689,5,839,1.0,571.0,571.0,5,850,1.0,582.0,582.0
0.049,17,2,152,1,76,0.0,48.0,48.0,1,76,0.0,48.0,48.0
0.016,6,10,1972,5,910,4.0,642.0,642.0,5,1062,4.0,794.0,794.0
0.004,6,10,2007,5,928,1.0,660.0,660.0,5,1079,1.0,811.0,811.0
0.006,6,10,1547,5,764,1.0,496.0,496.0,5,783,1.0,515.0,515.0
0.1,6,10,1506,5,395,22.0,127.0,127.0,5,1111,22.0,843.0,843.0
0.01,6,10,1990,5,911,2.0,643.0,643.0,5,1079,2.0,811.0,811.0
0.008,6,10,1972,5,910,2.0,642.0,642.0,5,1062,2.0,794.0,794.0
0.006,6,10,1547,5,764,1.0,496.0,496.0,5,783,1.0,515.0,515.0
0.005,17,2,170,1,65,0.0,37.0,37.0,1,105,0.0,77.0,77.0
0.006,6,10,1689,5,839,1.0,571.0,571.0,5,850,1.0,582.0,582.0
0.086,6,10,1506,5,395,19.0,127.0,127.0,5,1111,15.0,843.0,843.0
0.1,6,10,1506,5,395,23.0,127.0,127.0,5,1111,20.0,843.0,843.0
0.005,6,10,2007,5,928,1.0,660.0,660.0,5,1079,1.0,811.0,811.0
0.003,17,2,132,1,58,0.0,30.0,30.0,1,74,0.0,46.0,46.0
0.016,6,10,1990,5,911,3.0,643.0,643.0,5,1079,4.0,811.0,811.0
0.006,6,13,3690,7,452,1.0,80.0,80.0,6,3238,1.0,1470.0,1459.0
308.635,17,20,1124,10,716,34268.0,48.0,43.0,10,408,34280.0,20.0,12.0
0.013,6,10,1972,5,910,3.0,642.0,642.0,5,1062,3.0,794.0,794.0
0.003,17,2,136,1,60,0.0,32.0,32.0,1,76,0.0,48.0,48.0
0.089,6,10,1506,5,395,20.0,127.0,127.0,5,1111,19.0,843.0,843.0
178.373,17,94,13233,47,3147,3877.0,44.0,38.0,47,10086,3877.0,239.0,186.0
0.007,6,10,1989,5,910,1.0,642.0,642.0,5,1079,1.0,811.0,811.0
15.075,17,15,9238,8,6902,2149.0,1350.0,834.0,7,2336,2507.0,1350.0,305.0
0.012,6,10,1972,5,910,2.0,642.0,642.0,5,1062,2.0,794.0,794.0
0.006,6,13,3747,7,509,1.0,137.0,137.0,6,3238,1.0,1470.0,1459.0
0.009,6,10,1989,5,910,2.0,642.0,642.0,5,1079,2.0,811.0,811.0
285.232,6,30,6575,16,1433,19015.0,517.0,290.0,14,5142,21940.0,2380.0,1104.0
0.013,6,10,1989,5,910,3.0,642.0,642.0,5,1079,3.0,811.0,811.0
0.174,6,3,453,2,321,174.0,241.0,241.0,1,132,0.0,92.0,92.0
0.004,17,2,148,1,60,0.0,32.0,32.0,1,88,0.0,60.0,60.0
0.003,17,2,148,1,60,0.0,32.0,32.0,1,88,0.0,60.0,60.0
15.072,17,15,9238,8,6902,2149.0,1350.0,834.0,7,2336,2507.0,1350.0,305.0
0.012,6,10,1989,5,910,3.0,642.0,642.0,5,1079,2.0,811.0,811.0
0.019,6,10,1972,5,910,4.0,642.0,642.0,5,1062,4.0,794.0,794.0
177.235,17,76,10961,38,2544,4789.0,44.0,38.0,38,8417,4789.0,249.0,193.0
0.019,6,10,1989,5,910,4.0,642.0,642.0,5,1079,4.0,811.0,811.0
0.005,6,10,2006,5,927,1.0,659.0,659.0,5,1079,1.0,811.0,811.0
360.03,6,21,3981,13,3142,30002.0,494.0,494.0,8,839,51432.0,83.0,83.0
0.08,6,10,1506,5,395,18.0,127.0,127.0,5,1111,17.0,843.0,843.0
0.003,17,2,148,1,60,0.0,32.0,32.0,1,88,0.0,60.0,60.0
0.006,6,10,1547,5,764,1.0,496.0,496.0,5,783,1.0,515.0,515.0
0.222,6,16,2777,8,1395,31.0,533.0,323.0,8,1382,20.0,529.0,239.0
0.006,17,2,170,1,65,0.0,37.0,37.0,1,105,0.0,77.0,77.0
0.009,6,10,1989,5,910,2.0,642.0,642.0,5,1079,2.0,811.0,811.0
0.008,6,10,1972,5,910,2.0,642.0,642.0,5,1062,1.0,794.0,794.0
40.067,17,10,676,5,460,10014.0,104.0,64.0,5,216,10014.0,20.0,15.0
0.004,17,2,170,1,65,0.0,37.0,37.0,1,105,0.0,77.0,77.0
0.017,6,13,3735,7,497,2.0,125.0,125.0,6,3238,3.0,1470.0,1459.0
0.006,6,10,1547,5,764,1.0,496.0,496.0,5,783,1.0,515.0,515.0
0.004,6,10,1702,5,863,0.0,595.0,595.0,5,839,1.0,571.0,571.0
0.103,6,10,1506,5,395,22.0,127.0,127.0,5,1111,21.0,843.0,843.0
0.005,6,10,2007,5,928,1.0,660.0,660.0,5,1079,1.0,811.0,811.0
0.004,6,10,1702,5,863,1.0,595.0,595.0,5,839,1.0,571.0,571.0
176.288,17,70,9914,35,2331,5184.0,44.0,38.0,35,7583,5184.0,261.0,188.0
0.111,6,10,1506,5,395,25.0,127.0,127.0,5,1111,24.0,843.0,843.0
0.001,17,2,164,1,74,0.0,46.0,46.0,1,90,0.0,62.0,62.0
0.0,17,2,136,1,60,0.0,32.0,32.0,1,76,0.0,48.0,48.0
0.005,6,10,1989,5,927,1.0,659.0,659.0,5,1062,1.0,794.0,794.0
0.004,6,13,3690,7,452,0.0,80.0,80.0,6,3238,0.0,1470.0,1459.0
0.004,6,10,1779,5,928,1.0,660.0,660.0,5,851,1.0,583.0,583.0
0.017,6,10,2006,5,927,4.0,659.0,659.0,5,1079,4.0,811.0,811.0
0.143,6,10,1506,5,395,33.0,127.0,127.0,5,1111,30.0,843.0,843.0
40.055,17,10,676,5,460,10013.0,104.0,64.0,5,216,10012.0,20.0,15.0
0.012,6,10,1990,5,911,3.0,643.0,643.0,5,1079,3.0,811.0,811.0
0.005,6,10,2006,5,927,1.0,659.0,659.0,5,1079,1.0,811.0,811.0
0.039,17,2,136,1,60,0.0,32.0,32.0,1,76,0.0,48.0,48.0
0.005,6,10,1689,5,839,1.0,571.0,571.0,5,850,1.0,582.0,582.0
0.005,6,10,2000,5,927,1.0,659.0,659.0,5,1073,1.0,805.0,805.0
0.006,17,2,179,1,71,0.0,43.0,43.0,1,108,0.0,80.0,80.0
0.004,6,10,2007,5,928,1.0,660.0,660.0,5,1079,1.0,811.0,811.0
0.082,6,10,1506,5,395,17.0,127.0,127.0,5,1111,16.0,843.0,843.0
0.007,17,2,179,1,71,0.0,43.0,43.0,1,108,0.0,80.0,80.0
0.098,6,10,1506,5,395,22.0,127.0,127.0,5,1111,21.0,843.0,843.0
0.005,6,10,2006,5,927,1.0,659.0,659.0,5,1079,1.0,811.0,811.0
0.001,17,2,180,1,66,0.0,38.0,38.0,1,114,0.0,86.0,86.0
0.014,6,10,1983,5,910,3.0,642.0,642.0,5,1073,3.0,805.0,805.0
0.005,17,2,170,1,65,0.0,37.0,37.0,1,105,0.0,77.0,77.0
0.103,6,10,1506,5,395,24.0,127.0,127.0,5,1111,19.0,843.0,843.0
0.005,6,10,1989,5,927,1.0,659.0,659.0,5,1062,1.0,794.0,794.0
0.001,17,2,140,1,62,0.0,34.0,34.0,1,78,0.0,50.0,50.0
0.006,6,10,1547,5,764,1.0,496.0,496.0,5,783,1.0,515.0,515.0
0.13,17,2,80,1,32,0.0,4.0,4.0,1,48,0.0,20.0,20.0
0.015,6,10,1677,5,827,3.0,559.0,559.0,5,850,3.0,582.0,582.0
0.005,17,2,169,1,62,0.0,34.0,34.0,1,107,0.0,79.0,79.0
0.113,6,10,1506,5,395,26.0,127.0,127.0,5,1111,25.0,843.0,843.0
0.005,17,2,170,1,65,0.0,37.0,37.0,1,105,0.0,77.0,77.0
308.538,17,20,1124,10,716,34267.0,48.0,43.0,10,408,34267.0,20.0,12.0
0.01,6,10,1983,5,910,2.0,642.0,642.0,5,1073,2.0,805.0,805.0
0.013,6,10,1990,5,911,3.0,643.0,643.0,5,1079,3.0,811.0,811.0
0.036,17,2,144,1,64,0.0,36.0,36.0,1,80,0.0,52.0,52.0
0.009,6,10,1983,5,910,2.0,642.0,642.0,5,1073,2.0,805.0,805.0
0.005,6,10,1854,5,889,1.0,621.0,621.0,5,965,1.0,697.0,697.0
0.005,6,10,1689,5,839,1.0,571.0,571.0,5,850,1.0,582.0,582.0
40.052,17,10,676,5,460,10012.0,104.0,64.0,5,216,10012.0,20.0,15.0
0.036,6,13,3816,7,578,5.0,206.0,206.0,6,3238,7.0,1470.0,1459.0
0.129,17,4,352,2,130,0.0,37.0,37.0,2,222,126.0,89.0,83.0
0.013,6,10,1990,5,911,3.0,643.0,643.0,5,1079,3.0,811.0,811.0
40.061,17,10,676,5,460,10013.0,104.0,64.0,5,216,10014.0,20.0,15.0
0.007,6,10,1854,5,889,1.0,621.0,621.0,5,965,1.0,697.0,697.0
0.089,6,10,1506,5,395,18.0,127.0,127.0,5,1111,18.0,843.0,843.0
0.016,6,10,1762,5,911,4.0,643.0,643.0,5,851,4.0,583.0,583.0
0.01,6,10,2006,5,927,2.0,659.0,659.0,5,1079,2.0,811.0,811.0
0.107,17,2,80,1,32,0.0,4.0,4.0,1,48,0.0,20.0,20.0
0.074,6,10,1506,5,395,16.0,127.0,127.0,5,1111,16.0,843.0,843.0
0.004,17,2,148,1,60,0.0,32.0,32.0,1,88,0.0,60.0,60.0
0.218,17,4,352,2,130,178.0,37.0,37.0,2,222,146.0,89.0,83.0
0.005,17,2,144,1,64,0.0,36.0,36.0,1,80,0.0,52.0,52.0
0.019,6,10,1989,5,910,4.0,642.0,642.0,5,1079,4.0,811.0,811.0
0.093,6,10,1506,5,395,20.0,127.0,127.0,5,1111,20.0,843.0,843.0
0.005,17,2,164,1,74,0.0,46.0,46.0,1,90,0.0,62.0,62.0
0.039,17,2,234,1,61,0.0,33.0,33.0,1,173,0.0,145.0,145.0
310.492,17,20,1124,10,716,34484.0,48.0,43.0,10,408,34484.0,20.0,12.0
0.01,6,10,1779,5,928,2.0,660.0,660.0,5,851,2.0,583.0,583.0
40.082,17,10,676,5,460,10015.0,104.0,64.0,5,216,10014.0,20.0,15.0
0.006,6,10,1547,5,764,1.0,496.0,496.0,5,783,1.0,515.0,515.0
0.123,6,10,1506,5,395,24.0,127.0,127.0,5,1111,24.0,843.0,843.0
0.001,17,2,179,1,62,0.0,34.0,34.0,1,117,0.0,89.0,89.0
0.004,17,2,148,1,60,0.0,32.0,32.0,1,88,0.0,60.0,60.0
0.005,17,2,180,1,66,0.0,38.0,38.0,1,114,0.0,86.0,86.0
54.704,6,310,343453,120,17797,459.0,2736.0,824.0,190,325656,289.0,2804.0,1784.0
1.066,17,2,144,1,64,0.0,36.0,36.0,1,80,0.0,52.0,52.0
0.005,17,2,180,1,58,0.0,30.0,30.0,1,122,0.0,94.0,94.0
0.009,6,10,1762,5,911,2.0,643.0,643.0,5,851,2.0,583.0,583.0
0.014,17,2,152,1,56,0.0,28.0,28.0,1,96,0.0,68.0,68.0
0.005,6,10,2006,5,927,1.0,659.0,659.0,5,1079,1.0,811.0,811.0
0.005,6,10,2006,5,927,1.0,659.0,659.0,5,1079,1.0,811.0,811.0
0.017,6,10,1989,5,910,4.0,642.0,642.0,5,1079,4.0,811.0,811.0
377.375,6,18,1639,14,926,29028.0,190.0,190.0,4,713,80067.0,497.0,497.0
0.004,6,10,2006,5,927,1.0,659.0,659.0,5,1079,1.0,811.0,811.0
0.008,6,10,1990,5,911,2.0,643.0,643.0,5,1079,2.0,811.0,811.0
0.032,6,10,1983,5,910,8.0,642.0,642.0,5,1073,8.0,805.0,805.0
0.003,17,2,148,1,60,0.0,32.0,32.0,1,88,0.0,60.0,60.0
0.071,6,10,1506,5,395,15.0,127.0,127.0,5,1111,16.0,843.0,843.0
0.009,6,13,3735,7,497,1.0,125.0,125.0,6,3238,1.0,1470.0,1459.0
0.085,6,10,1506,5,395,18.0,127.0,127.0,5,1111,17.0,843.0,843.0
0.014,6,10,1989,5,910,3.0,642.0,642.0,5,1079,3.0,811.0,811.0
0.003,17,2,170,1,65,0.0,37.0,37.0,1,105,0.0,77.0,77.0
0.016,6,10,1972,5,910,4.0,642.0,642.0,5,1062,4.0,794.0,794.0
0.005,6,10,1989,5,927,1.0,659.0,659.0,5,1062,1.0,794.0,794.0
0.005,6,10,1643,5,860,1.0,592.0,592.0,5,783,1.0,515.0,515.0
0.135,6,10,1506,5,395,22.0,127.0,127.0,5,1111,28.0,843.0,843.0
0.041,17,2,136,1,60,0.0,32.0,32.0,1,76,0.0,48.0,48.0
0.009,6,10,1762,5,911,2.0,643.0,643.0,5,851,2.0,583.0,583.0
0.008,6,10,1989,5,910,2.0,642.0,642.0,5,1079,1.0,811.0,811.0
0.014,6,10,1990,5,911,3.0,643.0,643.0,5,1079,3.0,811.0,811.0
0.201,6,10,1506,5,395,45.0,127.0,127.0,5,1111,47.0,843.0,843.0
0.012,6,10,1989,5,910,2.0,642.0,642.0,5,1079,3.0,811.0,811.0
0.006,6,10,1547,5,764,1.0,496.0,496.0,5,783,1.0,515.0,515.0
0.009,6,14,3787,7,497,1.0,125.0,125.0,7,3290,1.0,1448.0,972.0
0.01,6,10,1989,5,910,2.0,642.0,642.0,5,1079,2.0,811.0,811.0
178.247,17,80,11309,40,2664,4570.0,44.0,38.0,40,8645,4570.0,261.0,188.0
0.081,6,10,1506,5,395,18.0,127.0,127.0,5,1111,17.0,843.0,843.0
0.006,17,2,136,1,60,0.0,32.0,32.0,1,76,0.0,48.0,48.0
0.003,17,4,284,2,120,0.0,32.0,32.0,2,164,0.0,60.0,54.0
0.008,6,10,1989,5,910,1.0,642.0,642.0,5,1079,2.0,811.0,811.0
0.005,6,10,2007,5,928,1.0,660.0,660.0,5,1079,1.0,811.0,811.0
0.011,6,10,1989,5,910,2.0,642.0,642.0,5,1079,2.0,811.0,811.0
0.006,6,10,1547,5,764,1.0,496.0,496.0,5,783,1.0,515.0,515.0
0.006,6,10,2006,5,927,1.0,659.0,659.0,5,1079,1.0,811.0,811.0
0.005,17,2,164,1,74,0.0,46.0,46.0,1,90,0.0,62.0,62.0
0.006,6,10,1854,5,889,1.0,621.0,621.0,5,965,1.0,697.0,697.0
40.056,17,10,676,5,460,10013.0,104.0,64.0,5,216,10013.0,20.0,15.0
0.004,6,10,1779,5,928,1.0,660.0,660.0,5,851,1.0,583.0,583.0
172.125,17,86,12417,43,2879,4098.0,44.0,38.0,43,9538,4098.0,239.0,193.0
40.056,17,10,676,5,460,10012.0,104.0,64.0,5,216,10013.0,20.0,15.0
0.005,6,10,2006,5,927,1.0,659.0,659.0,5,1079,1.0,811.0,811.0
0.004,6,10,2006,5,927,1.0,659.0,659.0,5,1079,1.0,811.0,811.0
0.005,6,10,1854,5,889,1.0,621.0,621.0,5,965,1.0,697.0,697.0
0.037,17,2,152,1,76,0.0,48.0,48.0,1,76,0.0,48.0,48.0
0.005,6,10,2000,5,927,1.0,659.0,659.0,5,1073,1.0,805.0,805.0
10.764,17,28,4423,14,1995,819.0,270.0,114.0,14,2428,819.0,587.0,145.0
0.009,6,10,1983,5,910,2.0,642.0,642.0,5,1073,2.0,805.0,805.0
0.001,17,2,180,1,66,0.0,38.0,38.0,1,114,0.0,86.0,86.0
0.006,6,10,1547,5,764,1.0,496.0,496.0,5,783,1.0,515.0,515.0
0.085,6,10,1506,5,395,20.0,127.0,127.0,5,1111,16.0,843.0,843.0
0.005,6,10,2006,5,927,1.0,659.0,659.0,5,1079,1.0,811.0,811.0
326.655,17,20,1124,10,716,36280.0,48.0,43.0,10,408,36280.0,20.0,12.0
0.005,6,10,2006,5,927,1.0,659.0,659.0,5,1079,1.0,811.0,811.0
0.008,6,10,1989,5,910,2.0,642.0,642.0,5,1079,2.0,811.0,811.0
0.01,6,10,1972,5,910,2.0,642.0,642.0,5,1062,2.0,794.0,794.0
0.09,6,10,1506,5,395,19.0,127.0,127.0,5,1111,18.0,843.0,843.0
0.007,6,10,1702,5,863,1.0,595.0,595.0,5,839,1.0,571.0,571.0
240.012,6,9,787,5,488,60003.0,232.0,232.0,4,299,80002.0,83.0,83.0
11.504,17,28,4397,14,2311,872.0,586.0,137.0,14,2086,872.0,269.0,121.0
0.139,6,10,1506,5,395,33.0,127.0,127.0,5,1111,34.0,843.0,843.0
0.006,17,2,213,1,69,0.0,41.0,41.0,1,144,0.0,116.0,116.0
0.061,6,10,1506,5,395,14.0,127.0,127.0,5,1111,12.0,843.0,843.0
0.037,17,4,284,2,120,0.0,32.0,32.0,2,164,34.0,60.0,54.0
0.011,6,14,3787,7,497,1.0,125.0,125.0,7,3290,1.0,1448.0,972.0
0.039,17,2,412,1,61,0.0,33.0,33.0,1,351,0.0,323.0,323.0
0.134,17,2,80,1,32,0.0,4.0,4.0,1,48,0.0,20.0,20.0
0.002,17,2,148,1,60,0.0,32.0,32.0,1,88,0.0,60.0,60.0
291.567,6,396,348415,195,21697,1502.0,2736.0,824.0,201,326718,1457.0,2804.0,1691.0
0.142,6,10,1506,5,395,32.0,127.0,127.0,5,1111,30.0,843.0,843.0
0.006,6,10,1689,5,839,1.0,571.0,571.0,5,850,1.0,582.0,582.0
0.011,6,10,1983,5,910,2.0,642.0,642.0,5,1073,2.0,805.0,805.0
0.106,6,10,1506,5,395,23.0,127.0,127.0,5,1111,21.0,843.0,843.0
0.005,6,10,2007,5,928,1.0,660.0,660.0,5,1079,1.0,811.0,811.0
0.115,6,10,1506,5,395,26.0,127.0,127.0,5,1111,24.0,843.0,843.0
0.008,6,10,1989,5,910,2.0,642.0,642.0,5,1079,2.0,811.0,811.0
0.034,6,10,1989,5,910,8.0,642.0,642.0,5,1079,8.0,811.0,811.0
0.004,6,10,2006,5,927,1.0,659.0,659.0,5,1079,1.0,811.0,811.0
0.005,6,10,2007,5,928,1.0,660.0,660.0,5,1079,1.0,811.0,811.0
0.005,6,10,2006,5,927,1.0,659.0,659.0,5,1079,1.0,811.0,811.0
40.073,17,10,676,5,460,10017.0,104.0,64.0,5,216,10017.0,20.0,15.0
0.005,17,2,170,1,65,0.0,37.0,37.0,1,105,0.0,77.0,77.0
0.012,6,10,1989,5,910,2.0,642.0,642.0,5,1079,3.0,811.0,811.0
0.111,6,10,1506,5,395,23.0,127.0,127.0,5,1111,26.0,843.0,843.0
0.014,17,2,152,1,56,0.0,28.0,28.0,1,96,0.0,68.0,68.0
0.014,6,10,1972,5,910,3.0,642.0,642.0,5,1062,3.0,794.0,794.0
0.072,6,10,1506,5,395,16.0,127.0,127.0,5,1111,16.0,843.0,843.0
0.007,17,2,194,1,59,0.0,31.0,31.0,1,135,0.0,107.0,107.0
0.003,17,2,136,1,60,0.0,32.0,32.0,1,76,0.0,48.0,48.0
11.09,17,28,4370,14,2313,844.0,588.0,137.0,14,2057,844.0,268.0,118.0
0.005,6,10,2006,5,927,1.0,659.0,659.0,5,1079,1.0,811.0,811.0
0.052,17,2,152,1,76,0.0,48.0,48.0,1,76,0.0,48.0,48.0
0.088,6,10,1506,5,395,21.0,127.0,127.0,5,1111,18.0,843.0,843.0
351.988,6,20,2210,6,1308,12004.0,494.0,494.0,14,902,27075.0,83.0,83.0
40.056,17,10,676,5,460,10012.0,104.0,64.0,5,216,10013.0,20.0,15.0
0.004,17,2,230,1,68,0.0,40.0,40.0,1,162,0.0,134.0,134.0
0.004,17,4,284,2,120,1.0,32.0,32.0,2,164,0.0,60.0,54.0
0.092,6,10,1506,5,395,21.0,127.0,127.0,5,1111,19.0,843.0,843.0
0.053,17,2,152,1,76,0.0,48.0,48.0,1,76,0.0,48.0,48.0
0.082,6,10,1506,5,395,18.0,127.0,127.0,5,1111,16.0,843.0,843.0
0.086,6,10,1506,5,395,16.0,127.0,127.0,5,1111,18.0,843.0,843.0
0.005,6,13,3747,7,509,0.0,137.0,137.0,6,3238,1.0,1470.0,1459.0
15.072,17,15,9238,8,6902,2149.0,1350.0,834.0,7,2336,2507.0,1350.0,305.0
0.015,6,10,1762,5,911,3.0,643.0,643.0,5,851,3.0,583.0,583.0
0.005,17,2,184,1,68,0.0,40.0,40.0,1,116,0.0,88.0,88.0
0.004,6,10,1779,5,928,1.0,660.0,660.0,5,851,1.0,583.0,583.0
0.07,6,10,1506,5,395,16.0,127.0,127.0,5,1111,16.0,843.0,843.0
0.005,17,2,144,1,64,0.0,36.0,36.0,1,80,0.0,52.0,52.0
0.005,6,13,3690,7,452,0.0,80.0,80.0,6,3238,1.0,1470.0,1459.0
0.005,17,2,148,1,60,0.0,32.0,32.0,1,88,0.0,60.0,60.0
0.214,6,16,2777,8,1395,30.0,533.0,323.0,8,1382,19.0,529.0,239.0
240.02,6,9,787,5,488,60005.0,232.0,232.0,4,299,80005.0,83.0,83.0
0.133,6,10,1506,5,395,31.0,127.0,127.0,5,1111,32.0,843.0,843.0
0.006,6,10,1547,5,764,1.0,496.0,496.0,5,783,1.0,515.0,515.0
0.011,17,2,180,1,58,0.0,30.0,30.0,1,122,0.0,94.0,94.0
0.116,6,10,1506,5,395,21.0,127.0,127.0,5,1111,26.0,843.0,843.0
0.009,6,10,1972,5,910,2.0,642.0,642.0,5,1062,2.0,794.0,794.0
0.012,6,10,1990,5,911,3.0,643.0,643.0,5,1079,3.0,811.0,811.0
0.004,17,2,136,1,60,0.0,32.0,32.0,1,76,0.0,48.0,48.0
0.005,6,10,1779,5,928,1.0,660.0,660.0,5,851,1.0,583.0,583.0
0.023,6,10,1983,5,910,5.0,642.0,642.0,5,1073,5.0,805.0,805.0
0.092,6,10,1506,5,395,18.0,127.0,127.0,5,1111,20.0,843.0,843.0
321.143,6,41,2744,16,1192,21409.0,46.0,46.0,25,1552,13375.0,46.0,46.0
164.338,17,76,11203,38,2554,4441.0,44.0,39.0,38,8649,4441.0,260.0,199.0
0.012,6,10,1989,5,910,3.0,642.0,642.0,5,1079,3.0,811.0,811.0
40.081,17,10,676,5,460,10018.0,104.0,64.0,5,216,10019.0,20.0,15.0
0.005,17,2,273,1,66,0.0,38.0,38.0,1,207,0.0,179.0,179.0
240.088,6,19,4819,9,2305,30011.0,1102.0,613.0,10,2514,26676.0,1162.0,397.0
0.063,6,10,1506,5,395,14.0,127.0,127.0,5,1111,14.0,843.0,843.0
240.134,6,47,7032,24,3330,10440.0,588.0,230.0,23,3702,10915.0,580.0,249.0
0.005,6,10,2007,5,928,1.0,660.0,660.0,5,1079,1.0,811.0,811.0
0.006,6,10,1547,5,764,1.0,496.0,496.0,5,783,1.0,515.0,515.0
0.004,17,2,136,1,60,0.0,32.0,32.0,1,76,0.0,48.0,48.0
0.006,6,10,2000,5,927,1.0,659.0,659.0,5,1073,1.0,805.0,805.0
0.151,6,10,1506,5,395,36.0,127.0,127.0,5,1111,34.0,843.0,843.0
0.005,6,10,2007,5,928,1.0,660.0,660.0,5,1079,1.0,811.0,811.0
0.006,6,10,1689,5,839,1.0,571.0,571.0,5,850,1.0,582.0,582.0
0.009,6,10,1972,5,910,2.0,642.0,642.0,5,1062,2.0,794.0,794.0
0.001,17,2,180,1,66,0.0,38.0,38.0,1,114,0.0,86.0,86.0
0.013,6,10,1972,5,910,3.0,642.0,642.0,5,1062,3.0,794.0,794.0
0.006,6,10,1689,5,839,1.0,571.0,571.0,5,850,1.0,582.0,582.0
1792.593,6,560,190817,283,164243,6356.0,2883.0,934.0,277,26574,6494.0,580.0,119.0
0.168,17,2,152,1,76,0.0,48.0,48.0,1,76,0.0,48.0,48.0
0.004,6,10,2006,5,927,1.0,659.0,659.0,5,1079,1.0,811.0,811.0
0.063,6,10,1506,5,395,15.0,127.0,127.0,5,1111,12.0,843.0,843.0
0.17,17,2,152,1,76,0.0,48.0,48.0,1,76,0.0,48.0,48.0
0.072,17,4,364,2,160,0.0,52.0,52.0,2,204,30.0,80.0,74.0
9.036,17,6,376,5,280,2259.0,28.0,28.0,1,96,0.0,68.0,68.0
0.006,6,10,1547,5,764,1.0,496.0,496.0,5,783,1.0,515.0,515.0
0.005,17,2,142,1,63,0.0,35.0,35.0,1,79,0.0,51.0,51.0
0.113,6,10,1506,5,395,24.0,127.0,127.0,5,1111,24.0,843.0,843.0
0.013,6,10,1983,5,910,3.0,642.0,642.0,5,1073,3.0,805.0,805.0
10.814,17,28,4423,14,1994,823.0,269.0,114.0,14,2429,822.0,588.0,145.0
0.059,17,2,152,1,76,0.0,48.0,48.0,1,76,0.0,48.0,48.0
0.005,17,2,144,1,64,0.0,36.0,36.0,1,80,0.0,52.0,52.0
9.037,17,6,376,5,280,2259.0,28.0,28.0,1,96,0.0,68.0,68.0
0.005,6,10,1689,5,839,1.0,571.0,571.0,5,850,1.0,582.0,582.0
0.004,17,2,148,1,60,0.0,32.0,32.0,1,88,0.0,60.0,60.0
10.759,17,26,4101,13,1846,887.0,269.0,114.0,13,2255,887.0,586.0,145.0
0.04,17,2,184,1,61,0.0,33.0,33.0,1,123,0.0,95.0,95.0
0.019,6,10,1631,5,848,4.0,580.0,580.0,5,783,4.0,515.0,515.0
0.147,6,10,1506,5,395,33.0,127.0,127.0,5,1111,32.0,843.0,843.0
0.012,6,10,1983,5,910,3.0,642.0,642.0,5,1073,2.0,805.0,805.0
0.005,6,10,2000,5,927,1.0,659.0,659.0,5,1073,1.0,805.0,805.0
0.004,6,10,1779,5,928,1.0,660.0,660.0,5,851,1.0,583.0,583.0
0.024,6,13,3735,7,497,4.0,125.0,125.0,6,3238,4.0,1470.0,1459.0
0.004,6,10,2007,5,928,1.0,660.0,660.0,5,1079,1.0,811.0,811.0
40.059,17,10,676,5,460,10012.0,104.0,64.0,5,216,10013.0,20.0,15.0
1785.735,6,287,27142,145,9980,12400.0,747.0,270.0,142,17162,12664.0,1624.0,72.0
0.005,6,13,3747,7,509,0.0,137.0,137.0,6,3238,0.0,1470.0,1459.0
0.003,17,2,148,1,60,0.0,32.0,32.0,1,88,0.0,60.0,60.0
0.007,6,10,1989,5,910,1.0,642.0,642.0,5,1079,1.0,811.0,811.0
0.13,17,2,80,1,32,0.0,4.0,4.0,1,48,0.0,20.0,20.0
0.074,6,10,1506,5,395,15.0,127.0,127.0,5,1111,17.0,843.0,843.0
366.367,6,22,2313,16,867,24424.0,195.0,195.0,6,1446,4649.0,419.0,398.0
301.02,6,46,15650,24,9743,13087.0,2720.0,1093.0,22,5907,421.0,2667.0,385.0
15.076,17,15,8726,8,6544,2149.0,1350.0,790.0,7,2182,2507.0,1350.0,283.0
293.261,6,388,347494,191,21486,1543.0,2736.0,888.0,197,326008,1496.0,2804.0,1734.0
0.006,6,10,1547,5,764,1.0,496.0,496.0,5,783,1.0,515.0,515.0
0.075,6,10,1506,5,395,16.0,127.0,127.0,5,1111,16.0,843.0,843.0
40.047,17,10,676,5,460,10011.0,104.0,64.0,5,216,10011.0,20.0,15.0
40.062,17,10,676,5,460,10014.0,104.0,64.0,5,216,10014.0,20.0,15.0
0.01,6,10,1631,5,848,2.0,580.0,580.0,5,783,2.0,515.0,515.0
0.004,6,10,2007,5,928,1.0,660.0,660.0,5,1079,1.0,811.0,811.0
15.075,17,14,9191,8,6902,2149.0,1350.0,834.0,6,2289,3009.0,1350.0,353.0
0.005,6,10,2000,5,927,1.0,659.0,659.0,5,1073,1.0,805.0,805.0
0.016,6,10,1983,5,910,3.0,642.0,642.0,5,1073,4.0,805.0,805.0
0.001,17,2,179,1,62,0.0,34.0,34.0,1,117,0.0,89.0,89.0
0.01,6,10,1990,5,911,2.0,643.0,643.0,5,1079,2.0,811.0,811.0
0.039,17,2,152,1,76,0.0,48.0,48.0,1,76,0.0,48.0,48.0
0.074,6,10,1506,5,395,16.0,127.0,127.0,5,1111,16.0,843.0,843.0
1756.9,6,107,6434,59,3470,30290.0,26.0,26.0,48,2964,37380.0,26.0,26.0
0.107,6,10,1506,5,395,19.0,127.0,127.0,5,1111,25.0,843.0,843.0
0.011,6,10,1972,5,910,2.0,642.0,642.0,5,1062,2.0,794.0,794.0
0.004,6,10,1702,5,863,1.0,595.0,595.0,5,839,1.0,571.0,571.0
0.01,6,10,1990,5,911,2.0,643.0,643.0,5,1079,2.0,811.0,811.0
1110.47,6,68,4076,39,2298,29222.0,27.0,27.0,29,1778,39658.0,27.0,27.0
240.607,6,27,10364,14,3965,18508.0,1445.0,810.0,13,6399,20050.0,1714.0,952.0
0.083,6,10,1506,5,395,19.0,127.0,127.0,5,1111,17.0,843.0,843.0
0.006,6,10,1547,5,764,1.0,496.0,496.0,5,783,1.0,515.0,515.0
0.005,17,2,179,1,71,0.0,43.0,43.0,1,108,0.0,80.0,80.0
0.081,6,10,1506,5,395,19.0,127.0,127.0,5,1111,17.0,843.0,843.0
0.025,6,10,1631,5,848,6.0,580.0,580.0,5,783,6.0,515.0,515.0
0.007,6,10,1972,5,910,1.0,642.0,642.0,5,1062,1.0,794.0,794.0
0.084,6,10,1506,5,395,18.0,127.0,127.0,5,1111,18.0,843.0,843.0
0.008,6,10,1989,5,910,2.0,642.0,642.0,5,1079,2.0,811.0,811.0
2.225,6,35,8391,18,1960,130.0,892.0,402.0,17,6431,130.0,2720.0,478.0
0.004,6,10,2006,5,927,1.0,659.0,659.0,5,1079,1.0,811.0,811.0
0.005,6,10,2007,5,928,1.0,660.0,660.0,5,1079,1.0,811.0,811.0
0.039,17,4,284,2,120,1.0,32.0,32.0,2,164,35.0,60.0,54.0
10.787,17,28,4423,14,1995,821.0,270.0,114.0,14,2428,821.0,587.0,145.0
0.009,6,10,1983,5,910,2.0,642.0,642.0,5,1073,2.0,805.0,805.0
0.073,6,10,1506,5,395,15.0,127.0,127.0,5,1111,16.0,843.0,843.0
0.017,6,10,1762,5,911,4.0,643.0,643.0,5,851,4.0,583.0,583.0
309.085,17,20,1124,10,716,34327.0,48.0,43.0,10,408,34327.0,20.0,12.0
0.005,17,2,164,1,74,0.0,46.0,46.0,1,90,0.0,62.0,62.0
0.005,6,10,1774,5,923,1.0,655.0,655.0,5,851,1.0,583.0,583.0
1777.471,17,143,45188,72,22752,25033.0,288.0,288.0,71,22436,25391.0,288.0,288.0
0.006,6,10,1689,5,839,1.0,571.0,571.0,5,850,1.0,582.0,582.0
0.062,6,10,1506,5,395,13.0,127.0,127.0,5,1111,14.0,843.0,843.0
0.013,6,10,1972,5,910,3.0,642.0,642.0,5,1062,3.0,794.0,794.0
0.006,6,10,1689,5,839,1.0,571.0,571.0,5,850,1.0,582.0,582.0
0.007,6,10,1762,5,911,1.0,643.0,643.0,5,851,1.0,583.0,583.0
0.007,6,10,1972,5,910,1.0,642.0,642.0,5,1062,1.0,794.0,794.0
369.019,6,22,2313,16,867,24601.0,195.0,195.0,6,1446,4637.0,419.0,398.0
0.038,17,2,152,1,76,0.0,48.0,48.0,1,76,0.0,48.0,48.0
0.013,6,10,1989,5,910,3.0,642.0,642.0,5,1079,3.0,811.0,811.0
0.019,6,10,1762,5,911,4.0,643.0,643.0,5,851,4.0,583.0,583.0
0.105,6,10,1506,5,395,22.0,127.0,127.0,5,1111,25.0,843.0,843.0
0.004,17,2,148,1,60,0.0,32.0,32.0,1,88,0.0,60.0,60.0
0.071,6,10,1506,5,395,13.0,127.0,127.0,5,1111,15.0,843.0,843.0
0.002,17,2,140,1,62,0.0,34.0,34.0,1,78,0.0,50.0,50.0
0.005,6,10,1989,5,927,1.0,659.0,659.0,5,1062,1.0,794.0,794.0
0.041,17,4,284,2,120,0.0,32.0,32.0,2,164,38.0,60.0,54.0
0.004,6,10,1702,5,863,1.0,595.0,595.0,5,839,1.0,571.0,571.0
240.515,6,33,8635,17,1836,15030.0,569.0,188.0,16,6799,16032.0,1402.0,597.0
0.158,6,10,1506,5,395,27.0,127.0,127.0,5,1111,35.0,843.0,843.0
0.764,6,10,2009,6,1655,152.0,1403.0,1403.0,4,354,175.0,182.0,182.0
0.005,6,10,2007,5,928,1.0,660.0,660.0,5,1079,1.0,811.0,811.0
0.008,6,10,2007,5,928,2.0,660.0,660.0,5,1079,2.0,811.0,811.0
120.538,6,53,18712,31,4669,4017.0,1054.0,236.0,22,14043,5739.0,2804.0,1074.0
0.016,6,10,1631,5,848,3.0,580.0,580.0,5,783,3.0,515.0,515.0
0.123,17,2,80,1,32,0.0,4.0,4.0,1,48,0.0,20.0,20.0
0.005,17,2,179,1,71,0.0,43.0,43.0,1,108,0.0,80.0,80.0
0.141,6,10,1506,5,395,28.0,127.0,127.0,5,1111,31.0,843.0,843.0
0.013,6,10,1983,5,910,3.0,642.0,642.0,5,1073,3.0,805.0,805.0
0.04,17,2,182,1,65,0.0,37.0,37.0,1,117,0.0,89.0,89.0
40.067,17,10,676,5,460,10015.0,104.0,64.0,5,216,10016.0,20.0,15.0
0.005,6,10,1854,5,889,1.0,621.0,621.0,5,965,1.0,697.0,697.0
0.004,17,2,136,1,60,0.0,32.0,32.0,1,76,0.0,48.0,48.0
0.006,6,10,1547,5,764,1.0,496.0,496.0,5,783,1.0,515.0,515.0
0.073,6,10,1506,5,395,15.0,127.0,127.0,5,1111,16.0,843.0,843.0
0.127,6,10,1506,5,395,29.0,127.0,127.0,5,1111,30.0,843.0,843.0
0.005,6,10,1989,5,927,1.0,659.0,659.0,5,1062,1.0,794.0,794.0
0.015,6,10,1762,5,911,3.0,643.0,643.0,5,851,3.0,583.0,583.0
0.005,6,10,1774,5,923,1.0,655.0,655.0,5,851,1.0,583.0,583.0
0.075,6,10,1506,5,395,16.0,127.0,127.0,5,1111,15.0,843.0,843.0
240.124,6,30,9247,15,6914,17151.0,2039.0,682.0,15,2333,17151.0,580.0,220.0
0.004,6,10,1774,5,923,1.0,655.0,655.0,5,851,1.0,583.0,583.0
0.007,6,10,1547,5,764,1.0,496.0,496.0,5,783,1.0,515.0,515.0
0.125,6,10,1506,5,395,29.0,127.0,127.0,5,1111,29.0,843.0,843.0
0.013,6,10,1989,5,910,3.0,642.0,642.0,5,1079,3.0,811.0,811.0
0.003,17,2,136,1,60,0.0,32.0,32.0,1,76,0.0,48.0,48.0
122.557,6,21,8148,11,1985,83.0,1174.0,504.0,10,6163,13599.0,2720.0,958.0
0.042,17,4,420,2,122,0.0,33.0,33.0,2,298,34.0,145.0,121.0
0.008,6,12,1926,6,1189,1.0,659.0,434.0,6,737,1.0,417.0,417.0
0.004,17,4,284,2,120,0.0,32.0,32.0,2,164,1.0,60.0,54.0
300.287,6,27,9917,15,1387,21449.0,260.0,149.0,12,8530,21841.0,1561.0,987.0
0.005,6,10,2000,5,927,1.0,659.0,659.0,5,1073,1.0,805.0,805.0
0.116,6,10,1506,5,395,26.0,127.0,127.0,5,1111,28.0,843.0,843.0
0.013,6,10,1989,5,910,3.0,642.0,642.0,5,1079,3.0,811.0,811.0
0.024,6,10,1631,5,848,6.0,580.0,580.0,5,783,5.0,515.0,515.0
0.009,6,10,1631,5,848,2.0,580.0,580.0,5,783,2.0,515.0,515.0
0.001,17,2,180,1,66,0.0,38.0,38.0,1,114,0.0,86.0,86.0
0.017,6,10,1989,5,910,4.0,642.0,642.0,5,1079,4.0,811.0,811.0
0.077,6,10,1506,5,395,16.0,127.0,127.0,5,1111,16.0,843.0,843.0
3.257,6,24,7517,13,1385,271.0,530.0,277.0,11,6132,308.0,2720.0,946.0
415.91,6,29,4409,12,3102,10917.0,494.0,494.0,17,1307,25993.0,83.0,83.0
0.007,6,10,1989,5,927,1.0,659.0,659.0,5,1062,1.0,794.0,794.0
0.004,6,10,2007,5,928,1.0,660.0,660.0,5,1079,1.0,811.0,811.0
241.14,6,312,343982,121,17804,2009.0,2736.0,959.0,191,326178,1269.0,2769.0,1747.0
0.003,17,2,148,1,60,0.0,32.0,32.0,1,88,0.0,60.0,60.0
0.011,6,10,1990,5,911,2.0,643.0,643.0,5,1079,2.0,811.0,811.0
0.012,6,10,1762,5,911,3.0,643.0,643.0,5,851,3.0,583.0,583.0
0.037,17,4,284,2,120,0.0,32.0,32.0,2,164,33.0,60.0,54.0
0.984,6,13,3930,7,2139,123.0,1328.0,923.0,6,1791,147.0,1539.0,1539.0
310.196,17,20,1124,10,716,34458.0,48.0,43.0,10,408,34458.0,20.0,12.0
0.085,6,10,1506,5,395,19.0,127.0,127.0,5,1111,20.0,843.0,843.0
0.016,6,10,1983,5,910,4.0,642.0,642.0,5,1073,4.0,805.0,805.0
0.006,17,2,170,1,65,0.0,37.0,37.0,1,105,0.0,77.0,77.0
0.009,6,10,1972,5,910,2.0,642.0,642.0,5,1062,2.0,794.0,794.0
0.012,6,10,1989,5,910,3.0,642.0,642.0,5,1079,2.0,811.0,811.0
369.483,6,24,2405,17,919,23092.0,195.0,195.0,7,1486,3902.0,419.0,398.0
15.07,17,15,9238,8,6902,2148.0,1350.0,834.0,7,2336,2506.0,1350.0,305.0
40.059,17,10,676,5,460,10013.0,104.0,64.0,5,216,10013.0,20.0,15.0
0.019,6,10,1631,5,848,4.0,580.0,580.0,5,783,4.0,515.0,515.0
0.018,17,2,166,1,75,0.0,47.0,47.0,1,91,0.0,63.0,63.0
0.001,17,2,180,1,66,0.0,38.0,38.0,1,114,0.0,86.0,86.0
0.089,6,10,1506,5,395,20.0,127.0,127.0,5,1111,19.0,843.0,843.0
0.074,6,10,1506,5,395,16.0,127.0,127.0,5,1111,16.0,843.0,843.0
0.005,17,2,170,1,65,0.0,37.0,37.0,1,105,0.0,77.0,77.0
0.0,17,2,136,1,60,0.0,32.0,32.0,1,76,0.0,48.0,48.0
0.005,6,10,2000,5,927,1.0,659.0,659.0,5,1073,1.0,805.0,805.0
40.054,17,10,676,5,460,10012.0,104.0,64.0,5,216,10012.0,20.0,15.0
0.126,17,2,144,1,64,0.0,36.0,36.0,1,80,0.0,52.0,52.0
0.008,6,10,1990,5,911,2.0,643.0,643.0,5,1079,2.0,811.0,811.0
0.001,17,2,180,1,66,0.0,38.0,38.0,1,114,0.0,86.0,86.0
309.412,17,20,1124,10,716,34364.0,48.0,43.0,10,408,34364.0,20.0,12.0
0.005,6,10,1854,5,889,1.0,621.0,621.0,5,965,1.0,697.0,697.0
0.005,6,14,3742,7,452,0.0,80.0,80.0,7,3290,0.0,1448.0,972.0
0.005,6,10,2006,5,927,1.0,659.0,659.0,5,1079,1.0,811.0,811.0
0.006,6,10,2006,5,927,1.0,659.0,659.0,5,1079,1.0,811.0,811.0
0.089,6,10,1506,5,395,18.0,127.0,127.0,5,1111,19.0,843.0,843.0
0.014,6,10,1972,5,910,3.0,642.0,642.0,5,1062,3.0,794.0,794.0
0.006,6,10,1547,5,764,1.0,496.0,496.0,5,783,1.0,515.0,515.0
0.001,17,2,180,1,66,0.0,38.0,38.0,1,114,0.0,86.0,86.0
0.005,6,10,1547,5,764,1.0,496.0,496.0,5,783,1.0,515.0,515.0
0.005,17,2,144,1,64,0.0,36.0,36.0,1,80,0.0,52.0,52.0
0.018,6,10,1989,5,910,4.0,642.0,642.0,5,1079,4.0,811.0,811.0
0.005,17,2,170,1,65,0.0,37.0,37.0,1,105,0.0,77.0,77.0
0.182,6,10,1506,5,395,33.0,127.0,127.0,5,1111,43.0,843.0,843.0
0.006,6,10,1689,5,839,1.0,571.0,571.0,5,850,1.0,582.0,582.0
308.208,17,20,1124,10,716,34231.0,48.0,43.0,10,408,34231.0,20.0,12.0
0.004,6,10,1702,5,863,0.0,595.0,595.0,5,839,1.0,571.0,571.0
0.005,6,10,1689,5,839,1.0,571.0,571.0,5,850,1.0,582.0,582.0
178.45,17,82,11529,41,2728,4461.0,44.0,38.0,41,8801,4461.0,261.0,186.0
0.003,6,10,1702,5,863,0.0,595.0,595.0,5,839,0.0,571.0,571.0
0.009,6,10,1990,5,911,2.0,643.0,643.0,5,1079,2.0,811.0,811.0
40.073,17,10,676,5,460,10017.0,104.0,64.0,5,216,10017.0,20.0,15.0
0.013,6,10,1983,5,910,3.0,642.0,642.0,5,1073,3.0,805.0,805.0
5.117,6,23,6467,13,1827,426.0,801.0,282.0,10,4640,568.0,1925.0,824.0
0.113,6,10,1506,5,395,24.0,127.0,127.0,5,1111,25.0,843.0,843.0
0.038,17,2,186,1,61,0.0,33.0,33.0,1,125,0.0,97.0,97.0
0.018,6,10,1990,5,911,4.0,643.0,643.0,5,1079,4.0,811.0,811.0
0.041,17,2,152,1,76,0.0,48.0,48.0,1,76,0.0,48.0,48.0
0.005,6,10,2006,5,927,1.0,659.0,659.0,5,1079,1.0,811.0,811.0
10.763,17,28,4420,14,1995,819.0,270.0,114.0,14,2425,819.0,588.0,145.0
308.623,17,20,1124,10,716,34276.0,48.0,43.0,10,408,34276.0,20.0,12.0
0.005,6,10,1774,5,923,1.0,655.0,655.0,5,851,1.0,583.0,583.0
0.005,6,10,2006,5,927,1.0,659.0,659.0,5,1079,1.0,811.0,811.0
0.005,6,15,3794,8,504,0.0,80.0,80.0,7,3290,0.0,1448.0,972.0
0.001,17,2,180,1,66,0.0,38.0,38.0,1,114,0.0,86.0,86.0
412.639,6,29,4409,12,3102,10911.0,494.0,494.0,17,1307,25789.0,83.0,83.0
0.003,17,2,148,1,60,0.0,32.0,32.0,1,88,0.0,60.0,60.0
0.004,6,10,2007,5,928,1.0,660.0,660.0,5,1079,1.0,811.0,811.0
0.004,6,10,2000,5,927,1.0,659.0,659.0,5,1073,1.0,805.0,805.0
0.124,17,2,80,1,32,0.0,4.0,4.0,1,48,0.0,20.0,20.0
0.004,6,10,1774,5,923,1.0,655.0,655.0,5,851,1.0,583.0,583.0
0.004,6,10,2007,5,928,1.0,660.0,660.0,5,1079,1.0,811.0,811.0
0.017,6,10,1990,5,911,4.0,643.0,643.0,5,1079,4.0,811.0,811.0
0.004,6,10,1779,5,928,1.0,660.0,660.0,5,851,1.0,583.0,583.0
0.143,6,10,1506,5,395,34.0,127.0,127.0,5,1111,31.0,843.0,843.0
0.077,6,10,1506,5,395,17.0,127.0,127.0,5,1111,18.0,843.0,843.0
0.102,6,10,1506,5,395,23.0,127.0,127.0,5,1111,21.0,843.0,843.0
0.058,6,10,1506,5,395,12.0,127.0,127.0,5,1111,14.0,843.0,843.0
0.083,6,10,1506,5,395,19.0,127.0,127.0,5,1111,18.0,843.0,843.0
15.117,17,15,8349,8,6098,2151.0,1350.0,734.0,7,2251,2512.0,1350.0,293.0
0.015,6,10,1677,5,827,3.0,559.0,559.0,5,850,3.0,582.0,582.0
0.092,6,10,1506,5,395,18.0,127.0,127.0,5,1111,19.0,843.0,843.0
40.067,17,10,676,5,460,10014.0,104.0,64.0,5,216,10015.0,20.0,15.0
240.098,6,16,4482,9,963,30012.0,238.0,166.0,7,3519,40013.0,1402.0,786.0
0.004,17,2,148,1,60,0.0,32.0,32.0,1,88,0.0,60.0,60.0
0.003,17,2,148,1,60,0.0,32.0,32.0,1,88,0.0,60.0,60.0
0.005,6,13,3747,7,509,0.0,137.0,137.0,6,3238,1.0,1470.0,1459.0
0.013,6,10,1989,5,910,3.0,642.0,642.0,5,1079,3.0,811.0,811.0
0.138,6,10,1506,5,395,23.0,127.0,127.0,5,1111,31.0,843.0,843.0
240.012,6,9,787,5,488,60003.0,232.0,232.0,4,299,80002.0,83.0,83.0
376.277,6,22,2313,16,867,25085.0,195.0,195.0,6,1446,4636.0,419.0,398.0
0.015,17,2,198,1,91,0.0,63.0,63.0,1,107,0.0,79.0,79.0
0.112,6,10,1506,5,395,25.0,127.0,127.0,5,1111,23.0,843.0,843.0
0.011,6,10,1983,5,910,2.0,642.0,642.0,5,1073,2.0,805.0,805.0
0.009,6,10,1990,5,911,2.0,643.0,643.0,5,1079,2.0,811.0,811.0
0.005,17,2,164,1,74,0.0,46.0,46.0,1,90,0.0,62.0,62.0
40.062,17,10,676,5,460,10014.0,104.0,64.0,5,216,10014.0,20.0,15.0
0.005,17,2,170,1,65,0.0,37.0,37.0,1,105,0.0,77.0,77.0
0.013,6,13,3735,7,497,2.0,125.0,125.0,6,3238,2.0,1470.0,1459.0
0.004,17,2,136,1,60,0.0,32.0,32.0,1,76,0.0,48.0,48.0
0.043,17,2,182,1,65,0.0,37.0,37.0,1,117,0.0,89.0,89.0
0.005,6,10,2000,5,927,1.0,659.0,659.0,5,1073,1.0,805.0,805.0
0.005,6,10,1547,5,764,1.0,496.0,496.0,5,783,1.0,515.0,515.0
0.014,6,13,3735,7,497,2.0,125.0,125.0,6,3238,2.0,1470.0,1459.0
0.072,6,10,1506,5,395,16.0,127.0,127.0,5,1111,16.0,843.0,843.0
40.069,17,10,676,5,460,10016.0,104.0,64.0,5,216,10016.0,20.0,15.0
0.012,6,10,1972,5,910,2.0,642.0,642.0,5,1062,3.0,794.0,794.0
0.136,6,10,1506,5,395,21.0,127.0,127.0,5,1111,29.0,843.0,843.0
0.314,17,14,9851,8,6907,44.0,1350.0,835.0,6,2944,51.0,1350.0,462.0
0.068,6,10,1506,5,395,15.0,127.0,127.0,5,1111,15.0,843.0,843.0
10.971,17,28,4509,14,2311,835.0,586.0,137.0,14,2198,835.0,270.0,129.0
169.176,17,80,11434,40,2673,4337.0,44.0,38.0,40,8761,4337.0,261.0,191.0
0.012,6,10,1990,5,911,3.0,643.0,643.0,5,1079,3.0,811.0,811.0
0.076,6,10,1506,5,395,15.0,127.0,127.0,5,1111,17.0,843.0,843.0
40.062,17,10,676,5,460,10014.0,104.0,64.0,5,216,10014.0,20.0,15.0
0.005,6,10,2006,5,927,1.0,659.0,659.0,5,1079,1.0,811.0,811.0
0.066,6,10,1506,5,395,14.0,127.0,127.0,5,1111,15.0,843.0,843.0
11.491,17,34,6375,17,2659,707.0,270.0,128.0,17,3716,707.0,1145.0,190.0
0.005,17,2,136,1,60,0.0,32.0,32.0,1,76,0.0,48.0,48.0
0.006,6,10,1989,5,927,1.0,659.0,659.0,5,1062,1.0,794.0,794.0
0.172,6,3,453,2,321,172.0,241.0,241.0,1,132,0.0,92.0,92.0
1.025,6,10,1242,5,751,256.0,495.0,495.0,5,491,254.0,223.0,223.0
0.012,17,2,138,1,61,0.0,33.0,33.0,1,77,0.0,49.0,49.0
0.006,6,10,1547,5,764,1.0,496.0,496.0,5,783,1.0,515.0,515.0
0.004,6,10,1989,5,927,1.0,659.0,659.0,5,1062,1.0,794.0,794.0
0.057,6,10,1506,5,395,13.0,127.0,127.0,5,1111,11.0,843.0,843.0
0.276,17,39,20145,21,17044,13.0,1350.0,783.0,18,3101,12.0,1350.0,144.0
0.005,6,10,2006,5,927,1.0,659.0,659.0,5,1079,1.0,811.0,811.0
0.014,6,10,1990,5,911,3.0,643.0,643.0,5,1079,3.0,811.0,811.0
0.017,6,10,1989,5,910,4.0,642.0,642.0,5,1079,4.0,811.0,811.0
171.691,17,70,10007,35,2330,5048.0,44.0,38.0,35,7677,5048.0,239.0,191.0
0.005,6,10,1989,5,927,1.0,659.0,659.0,5,1062,1.0,794.0,794.0
0.011,6,10,1989,5,910,2.0,642.0,642.0,5,1079,2.0,811.0,811.0
0.004,6,10,2007,5,928,1.0,660.0,660.0,5,1079,1.0,811.0,811.0
0.005,6,13,3747,7,509,0.0,137.0,137.0,6,3238,0.0,1470.0,1459.0
0.005,6,13,3747,7,509,0.0,137.0,137.0,6,3238,0.0,1470.0,1459.0
314.431,17,20,1124,10,716,34922.0,48.0,43.0,10,408,34922.0,20.0,12.0
0.016,6,10,1983,5,910,4.0,642.0,642.0,5,1073,4.0,805.0,805.0
0.006,6,10,1547,5,764,1.0,496.0,496.0,5,783,1.0,515.0,515.0
0.1,6,10,1506,5,395,21.0,127.0,127.0,5,1111,24.0,843.0,843.0
0.124,6,10,1506,5,395,28.0,127.0,127.0,5,1111,29.0,843.0,843.0
0.075,6,10,1506,5,395,16.0,127.0,127.0,5,1111,14.0,843.0,843.0
0.005,6,14,3736,7,446,0.0,74.0,74.0,7,3290,0.0,1448.0,972.0
0.013,6,10,1990,5,911,3.0,643.0,643.0,5,1079,3.0,811.0,811.0
0.009,6,10,1972,5,910,2.0,642.0,642.0,5,1062,2.0,794.0,794.0
0.141,6,10,1506,5,395,33.0,127.0,127.0,5,1111,30.0,843.0,843.0
0.014,6,10,1989,5,910,3.0,642.0,642.0,5,1079,3.0,811.0,811.0
0.005,6,10,2006,5,927,1.0,659.0,659.0,5,1079,1.0,811.0,811.0
0.074,6,10,1506,5,395,15.0,127.0,127.0,5,1111,16.0,843.0,843.0
0.005,6,10,1774,5,923,1.0,655.0,655.0,5,851,1.0,583.0,583.0
0.005,6,10,2006,5,927,1.0,659.0,659.0,5,1079,1.0,811.0,811.0
0.113,6,10,1506,5,395,24.0,127.0,127.0,5,1111,25.0,843.0,843.0
15.077,17,15,8445,8,6354,2149.0,1350.0,766.0,7,2091,2508.0,1350.0,270.0
0.202,6,16,2777,8,1395,28.0,533.0,323.0,8,1382,18.0,529.0,239.0
0.001,17,2,180,1,66,0.0,38.0,38.0,1,114,0.0,86.0,86.0
0.011,6,10,1762,5,911,2.0,643.0,643.0,5,851,2.0,583.0,583.0
0.219,6,16,2777,8,1395,31.0,533.0,323.0,8,1382,19.0,529.0,239.0
0.008,6,10,1989,5,910,1.0,642.0,642.0,5,1079,1.0,811.0,811.0
0.011,6,10,1972,5,910,2.0,642.0,642.0,5,1062,2.0,794.0,794.0
0.014,6,10,1972,5,910,3.0,642.0,642.0,5,1062,3.0,794.0,794.0
300.382,6,16,2170,9,684,37527.0,146.0,146.0,7,1486,50036.0,419.0,398.0
176.343,17,82,11473,41,2735,4408.0,44.0,38.0,41,8738,4408.0,239.0,185.0
0.015,6,10,1972,5,910,3.0,642.0,642.0,5,1062,3.0,794.0,794.0
0.1,6,10,1506,5,395,21.0,127.0,127.0,5,1111,21.0,843.0,843.0
0.058,6,10,1506,5,395,13.0,127.0,127.0,5,1111,13.0,843.0,843.0
0.005,6,10,1989,5,927,1.0,659.0,659.0,5,1062,1.0,794.0,794.0
0.018,6,10,1972,5,910,4.0,642.0,642.0,5,1062,4.0,794.0,794.0
0.004,17,4,284,2,120,0.0,32.0,32.0,2,164,0.0,60.0,54.0
0.084,6,10,1506,5,395,18.0,127.0,127.0,5,1111,19.0,843.0,843.0
0.005,6,10,2006,5,927,1.0,659.0,659.0,5,1079,1.0,811.0,811.0
0.004,6,10,1702,5,863,1.0,595.0,595.0,5,839,0.0,571.0,571.0
0.015,6,10,1983,5,910,3.0,642.0,642.0,5,1073,3.0,805.0,805.0
0.011,6,10,1990,5,911,2.0,643.0,643.0,5,1079,2.0,811.0,811.0
0.005,6,10,1547,5,764,1.0,496.0,496.0,5,783,1.0,515.0,515.0
0.005,6,14,3742,7,452,0.0,80.0,80.0,7,3290,0.0,1448.0,972.0
0.014,6,10,1605,5,388,3.0,120.0,120.0,5,1217,3.0,949.0,949.0
0.038,6,10,1990,5,911,9.0,643.0,643.0,5,1079,9.0,811.0,811.0
0.001,17,2,180,1,66,0.0,38.0,38.0,1,114,0.0,86.0,86.0
0.006,6,10,2007,5,928,1.0,660.0,660.0,5,1079,1.0,811.0,811.0
0.005,17,2,164,1,74,0.0,46.0,46.0,1,90,0.0,62.0,62.0
0.088,6,10,1506,5,395,18.0,127.0,127.0,5,1111,21.0,843.0,843.0
0.004,6,10,2007,5,928,1.0,660.0,660.0,5,1079,1.0,811.0,811.0
0.005,17,2,169,1,62,0.0,34.0,34.0,1,107,0.0,79.0,79.0
0.012,6,10,1983,5,910,2.0,642.0,642.0,5,1073,3.0,805.0,805.0
0.017,6,10,1989,5,910,4.0,642.0,642.0,5,1079,4.0,811.0,811.0
0.051,17,4,284,2,120,0.0,32.0,32.0,2,164,1.0,60.0,54.0
0.006,17,2,214,1,75,0.0,47.0,47.0,1,139,0.0,111.0,111.0
0.089,6,10,1506,5,395,20.0,127.0,127.0,5,1111,18.0,843.0,843.0
0.013,6,10,1990,5,911,3.0,643.0,643.0,5,1079,3.0,811.0,811.0
0.014,6,10,1989,5,910,3.0,642.0,642.0,5,1079,3.0,811.0,811.0
0.006,17,2,179,1,71,0.0,43.0,43.0,1,108,0.0,80.0,80.0
0.004,17,2,136,1,60,0.0,32.0,32.0,1,76,0.0,48.0,48.0
0.088,6,10,1506,5,395,19.0,127.0,127.0,5,1111,19.0,843.0,843.0
0.088,6,10,1506,5,395,18.0,127.0,127.0,5,1111,20.0,843.0,843.0
0.788,6,22,5072,11,1250,67.0,325.0,133.0,11,3822,67.0,1414.0,563.0
308.481,17,20,1124,10,716,34261.0,48.0,43.0,10,408,34261.0,20.0,12.0
0.103,6,10,1506,5,395,23.0,127.0,127.0,5,1111,22.0,843.0,843.0
0.013,6,10,1983,5,910,3.0,642.0,642.0,5,1073,3.0,805.0,805.0
40.064,17,10,676,5,460,10012.0,104.0,64.0,5,216,10015.0,20.0,15.0
0.004,17,2,136,1,60,0.0,32.0,32.0,1,76,0.0,48.0,48.0
0.07,6,10,1506,5,395,15.0,127.0,127.0,5,1111,14.0,843.0,843.0
0.004,6,10,2000,5,927,1.0,659.0,659.0,5,1073,1.0,805.0,805.0
0.006,6,10,1547,5,764,1.0,496.0,496.0,5,783,1.0,515.0,515.0
0.001,17,2,180,1,66,0.0,38.0,38.0,1,114,0.0,86.0,86.0
0.006,6,10,2007,5,928,1.0,660.0,660.0,5,1079,1.0,811.0,811.0
0.011,6,10,1989,5,910,2.0,642.0,642.0,5,1079,2.0,811.0,811.0
0.009,6,10,1989,5,910,2.0,642.0,642.0,5,1079,2.0,811.0,811.0
1792.621,6,492,99913,247,88523,7286.0,421.0,365.0,245,11390,7346.0,53.0,53.0
0.004,17,2,148,1,60,0.0,32.0,32.0,1,88,0.0,60.0,60.0
0.072,17,4,352,2,130,0.0,37.0,37.0,2,222,32.0,89.0,83.0
0.004,17,2,148,1,60,0.0,32.0,32.0,1,88,0.0,60.0,60.0
0.013,6,10,1989,5,910,3.0,642.0,642.0,5,1079,3.0,811.0,811.0
0.004,6,10,2006,5,927,1.0,659.0,659.0,5,1079,1.0,811.0,811.0
0.005,17,2,179,1,71,0.0,43.0,43.0,1,108,0.0,80.0,80.0
0.094,6,10,1506,5,395,20.0,127.0,127.0,5,1111,22.0,843.0,843.0
361.815,6,21,1792,16,1030,24121.0,190.0,190.0,5,762,60009.0,461.0,247.0
0.006,6,10,1547,5,764,1.0,496.0,496.0,5,783,1.0,515.0,515.0
0.041,17,2,412,1,61,0.0,33.0,33.0,1,351,0.0,323.0,323.0
719.737,6,58,23230,28,5597,26655.0,676.0,459.0,30,17633,24817.0,1402.0,803.0
0.006,6,10,2006,5,927,1.0,659.0,659.0,5,1079,1.0,811.0,811.0
0.86,6,25,5555,12,1445,66.0,267.0,136.0,13,4110,60.0,1414.0,597.0
0.005,6,13,3747,7,509,0.0,137.0,137.0,6,3238,0.0,1470.0,1459.0
0.017,6,10,1631,5,848,4.0,580.0,580.0,5,783,4.0,515.0,515.0
0.005,6,10,1643,5,860,1.0,592.0,592.0,5,783,1.0,515.0,515.0
0.082,6,10,1506,5,395,18.0,127.0,127.0,5,1111,17.0,843.0,843.0
9.036,17,6,376,5,280,2259.0,28.0,28.0,1,96,0.0,68.0,68.0
0.015,6,12,1926,6,1189,2.0,659.0,434.0,6,737,2.0,417.0,417.0
0.008,6,10,1983,5,910,2.0,642.0,642.0,5,1073,2.0,805.0,805.0
0.006,6,10,1854,5,889,1.0,621.0,621.0,5,965,1.0,697.0,697.0
0.011,6,10,1990,5,911,2.0,643.0,643.0,5,1079,2.0,811.0,811.0
0.083,6,10,1506,5,395,17.0,127.0,127.0,5,1111,19.0,843.0,843.0
0.006,6,10,1547,5,764,1.0,496.0,496.0,5,783,1.0,515.0,515.0
0.072,17,4,284,2,120,1.0,32.0,32.0,2,164,68.0,60.0,54.0
0.005,6,14,3736,7,446,0.0,74.0,74.0,7,3290,0.0,1448.0,972.0
0.006,17,2,169,1,62,0.0,34.0,34.0,1,107,0.0,79.0,79.0
0.01,6,10,1972,5,910,2.0,642.0,642.0,5,1062,2.0,794.0,794.0
0.008,6,12,1926,6,1189,1.0,659.0,434.0,6,737,1.0,417.0,417.0
0.063,6,10,1506,5,395,15.0,127.0,127.0,5,1111,14.0,843.0,843.0
0.009,6,10,1983,5,910,2.0,642.0,642.0,5,1073,2.0,805.0,805.0
0.005,6,10,1989,5,927,1.0,659.0,659.0,5,1062,1.0,794.0,794.0
0.038,6,10,1990,5,911,9.0,643.0,643.0,5,1079,9.0,811.0,811.0
0.004,6,10,2007,5,928,1.0,660.0,660.0,5,1079,1.0,811.0,811.0
240.078,6,16,4482,9,963,30009.0,238.0,166.0,7,3519,40012.0,1402.0,786.0
0.009,6,10,1972,5,910,2.0,642.0,642.0,5,1062,2.0,794.0,794.0
0.011,6,10,1762,5,911,2.0,643.0,643.0,5,851,2.0,583.0,583.0
300.176,6,27,7436,16,1409,20011.0,217.0,142.0,11,6027,24016.0,1679.0,778.0
357.624,6,19,2158,6,1308,12019.0,494.0,494.0,13,850,29800.0,83.0,83.0
0.017,6,10,1983,5,910,4.0,642.0,642.0,5,1073,4.0,805.0,805.0
0.012,6,10,1990,5,911,3.0,643.0,643.0,5,1079,3.0,811.0,811.0
0.004,6,10,1774,5,923,1.0,655.0,655.0,5,851,1.0,583.0,583.0
0.009,6,10,1990,5,911,2.0,643.0,643.0,5,1079,2.0,811.0,811.0
0.118,6,10,1506,5,395,25.0,127.0,127.0,5,1111,25.0,843.0,843.0
0.136,6,10,1506,5,395,24.0,127.0,127.0,5,1111,30.0,843.0,843.0
0.082,6,10,1506,5,395,17.0,127.0,127.0,5,1111,18.0,843.0,843.0
0.012,6,10,1972,5,910,3.0,642.0,642.0,5,1062,3.0,794.0,794.0
0.004,6,10,1989,5,927,1.0,659.0,659.0,5,1062,1.0,794.0,794.0
0.004,17,2,140,1,62,0.0,34.0,34.0,1,78,0.0,50.0,50.0
0.004,17,2,148,1,60,0.0,32.0,32.0,1,88,0.0,60.0,60.0
0.005,6,10,1989,5,927,1.0,659.0,659.0,5,1062,1.0,794.0,794.0
0.005,6,10,2007,5,928,1.0,660.0,660.0,5,1079,1.0,811.0,811.0
299.188,6,11,891,5,488,74797.0,232.0,232.0,6,403,59837.0,83.0,83.0
0.004,6,10,1702,5,863,1.0,595.0,595.0,5,839,1.0,571.0,571.0
0.037,17,4,284,2,120,0.0,32.0,32.0,2,164,34.0,60.0,54.0
0.005,6,10,1854,5,889,1.0,621.0,621.0,5,965,1.0,697.0,697.0
0.007,6,10,1547,5,764,1.0,496.0,496.0,5,783,1.0,515.0,515.0
10.791,17,28,4420,14,1993,821.0,268.0,114.0,14,2427,821.0,586.0,145.0
0.005,6,13,3747,7,509,0.0,137.0,137.0,6,3238,1.0,1470.0,1459.0
0.145,6,10,1506,5,395,33.0,127.0,127.0,5,1111,32.0,843.0,843.0
0.914,6,24,8538,14,2194,70.0,1259.0,400.0,10,6344,82.0,2720.0,988.0
0.003,17,2,148,1,60,0.0,32.0,32.0,1,88,0.0,60.0,60.0
1.294,17,4,352,2,130,1.0,37.0,37.0,2,222,30.0,89.0,83.0
40.063,17,10,676,5,460,10013.0,104.0,64.0,5,216,10014.0,20.0,15.0
0.005,17,4,284,2,120,0.0,32.0,32.0,2,164,0.0,60.0,54.0
0.009,6,10,1689,5,839,2.0,571.0,571.0,5,850,2.0,582.0,582.0
0.005,6,10,1774,5,923,1.0,655.0,655.0,5,851,1.0,583.0,583.0
0.006,6,10,1643,5,860,1.0,592.0,592.0,5,783,1.0,515.0,515.0
0.003,17,4,284,2,120,0.0,32.0,32.0,2,164,1.0,60.0,54.0
0.083,6,10,1506,5,395,18.0,127.0,127.0,5,1111,20.0,843.0,843.0
0.005,6,10,2006,5,927,1.0,659.0,659.0,5,1079,1.0,811.0,811.0
0.014,6,10,1989,5,910,3.0,642.0,642.0,5,1079,3.0,811.0,811.0
0.095,17,2,152,1,76,0.0,48.0,48.0,1,76,0.0,48.0,48.0
0.07,6,10,1506,5,395,16.0,127.0,127.0,5,1111,16.0,843.0,843.0
0.01,6,10,1972,5,910,2.0,642.0,642.0,5,1062,2.0,794.0,794.0
40.074,17,10,676,5,460,10017.0,104.0,64.0,5,216,10017.0,20.0,15.0
0.016,6,10,1972,5,910,4.0,642.0,642.0,5,1062,4.0,794.0,794.0
66.181,6,27,17577,15,9628,4727.0,2804.0,1473.0,12,7949,6001.0,2320.0,1219.0
0.13,17,2,80,1,32,0.0,4.0,4.0,1,48,0.0,20.0,20.0
0.011,6,10,1677,5,827,2.0,559.0,559.0,5,850,2.0,582.0,582.0
11.178,17,28,4422,14,1994,847.0,269.0,114.0,14,2428,847.0,587.0,145.0
0.01,6,10,1990,5,911,2.0,643.0,643.0,5,1079,2.0,811.0,811.0
0.006,6,10,1689,5,839,1.0,571.0,571.0,5,850,1.0,582.0,582.0
0.017,6,10,1972,5,910,4.0,642.0,642.0,5,1062,4.0,794.0,794.0
0.039,17,4,284,2,120,1.0,32.0,32.0,2,164,35.0,60.0,54.0
0.017,6,10,1972,5,910,4.0,642.0,642.0,5,1062,4.0,794.0,794.0
0.003,17,4,284,2,120,0.0,32.0,32.0,2,164,0.0,60.0,54.0
0.039,17,2,136,1,60,0.0,32.0,32.0,1,76,0.0,48.0,48.0
0.004,6,10,1989,5,927,1.0,659.0,659.0,5,1062,1.0,794.0,794.0
0.057,17,2,179,1,71,0.0,43.0,43.0,1,108,0.0,80.0,80.0
0.006,6,10,1547,5,764,1.0,496.0,496.0,5,783,1.0,515.0,515.0
40.071,17,10,676,5,460,10015.0,104.0,64.0,5,216,10017.0,20.0,15.0
0.005,6,10,1774,5,923,1.0,655.0,655.0,5,851,1.0,583.0,583.0
0.004,6,10,1702,5,863,1.0,595.0,595.0,5,839,1.0,571.0,571.0
0.008,6,10,1989,5,910,2.0,642.0,642.0,5,1079,1.0,811.0,811.0
0.005,6,10,2007,5,928,1.0,660.0,660.0,5,1079,1.0,811.0,811.0
0.005,6,10,1989,5,927,1.0,659.0,659.0,5,1062,1.0,794.0,794.0
364.351,6,19,1689,15,978,26025.0,190.0,190.0,4,711,80014.0,495.0,495.0
0.011,6,10,1989,5,910,2.0,642.0,642.0,5,1079,2.0,811.0,811.0
309.01,17,20,1124,10,716,34320.0,48.0,43.0,10,408,34320.0,20.0,12.0
0.003,17,2,136,1,60,0.0,32.0,32.0,1,76,0.0,48.0,48.0
0.13,17,4,284,2,120,1.0,32.0,32.0,2,164,126.0,60.0,54.0
0.001,17,2,180,1,66,0.0,38.0,38.0,1,114,0.0,86.0,86.0
308.566,17,20,1124,10,716,34271.0,48.0,43.0,10,408,34269.0,20.0,12.0
0.042,17,4,284,2,120,1.0,32.0,32.0,2,164,2.0,60.0,54.0
0.005,17,2,164,1,74,0.0,46.0,46.0,1,90,0.0,62.0,62.0
0.004,6,10,2006,5,927,1.0,659.0,659.0,5,1079,1.0,811.0,811.0
174.313,17,86,12592,43,2889,4150.0,44.0,39.0,43,9703,4150.0,261.0,197.0
0.016,6,10,1990,5,911,4.0,643.0,643.0,5,1079,4.0,811.0,811.0
177.484,17,78,11201,39,2604,4670.0,44.0,38.0,39,8597,4670.0,260.0,192.0
0.006,6,10,1547,5,764,1.0,496.0,496.0,5,783,1.0,515.0,515.0
11.169,17,28,4424,14,1995,846.0,270.0,114.0,14,2429,846.0,588.0,145.0
0.004,6,10,2007,5,928,1.0,660.0,660.0,5,1079,1.0,811.0,811.0
0.01,6,10,1989,5,910,2.0,642.0,642.0,5,1079,2.0,811.0,811.0
166.372,17,66,9383,33,2199,5198.0,44.0,38.0,33,7184,5199.0,239.0,189.0
0.066,6,10,1506,5,395,14.0,127.0,127.0,5,1111,15.0,843.0,843.0
0.004,6,10,2006,5,927,1.0,659.0,659.0,5,1079,1.0,811.0,811.0
40.06,17,10,676,5,460,10012.0,104.0,64.0,5,216,10014.0,20.0,15.0
0.088,6,10,1506,5,395,19.0,127.0,127.0,5,1111,20.0,843.0,843.0
0.017,6,10,1990,5,911,4.0,643.0,643.0,5,1079,4.0,811.0,811.0
240.076,6,20,4874,10,889,26675.0,180.0,93.0,10,3985,26674.0,1593.0,576.0
0.104,6,10,1506,5,395,23.0,127.0,127.0,5,1111,22.0,843.0,843.0
0.067,6,10,1506,5,395,16.0,127.0,127.0,5,1111,16.0,843.0,843.0
0.011,6,10,1990,5,911,2.0,643.0,643.0,5,1079,2.0,811.0,811.0
0.003,17,2,148,1,60,0.0,32.0,32.0,1,88,0.0,60.0,60.0
0.012,6,10,1972,5,910,3.0,642.0,642.0,5,1062,3.0,794.0,794.0
0.005,6,10,1547,5,764,1.0,496.0,496.0,5,783,1.0,515.0,515.0
240.574,6,33,8636,17,1837,15033.0,570.0,189.0,16,6799,16036.0,1402.0,597.0
0.004,6,10,1989,5,927,1.0,659.0,659.0,5,1062,1.0,794.0,794.0
0.005,6,10,2007,5,928,1.0,660.0,660.0,5,1079,1.0,811.0,811.0
0.085,6,10,1506,5,395,17.0,127.0,127.0,5,1111,20.0,843.0,843.0
0.003,17,2,148,1,60,0.0,32.0,32.0,1,88,0.0,60.0,60.0
0.107,6,10,1506,5,395,24.0,127.0,127.0,5,1111,25.0,843.0,843.0
0.017,6,10,1989,5,910,4.0,642.0,642.0,5,1079,4.0,811.0,811.0
308.289,17,20,1124,10,716,34246.0,48.0,43.0,10,408,34246.0,20.0,12.0
0.005,6,10,2007,5,928,1.0,660.0,660.0,5,1079,1.0,811.0,811.0
0.005,6,13,3690,7,452,0.0,80.0,80.0,6,3238,0.0,1470.0,1459.0
0.006,6,10,1854,5,889,1.0,621.0,621.0,5,965,1.0,697.0,697.0
0.007,6,10,1972,5,910,1.0,642.0,642.0,5,1062,1.0,794.0,794.0
0.004,6,10,2000,5,927,1.0,659.0,659.0,5,1073,1.0,805.0,805.0
10.764,17,28,4424,14,1995,819.0,270.0,114.0,14,2429,819.0,588.0,145.0
367.183,6,22,2313,16,867,24478.0,195.0,195.0,6,1446,4636.0,419.0,398.0
0.089,6,10,1506,5,395,18.0,127.0,127.0,5,1111,18.0,843.0,843.0
0.004,6,10,1774,5,923,1.0,655.0,655.0,5,851,1.0,583.0,583.0
40.077,17,10,676,5,460,10016.0,104.0,64.0,5,216,10018.0,20.0,15.0
0.004,6,10,2007,5,928,1.0,660.0,660.0,5,1079,1.0,811.0,811.0
0.113,6,10,1506,5,395,22.0,127.0,127.0,5,1111,25.0,843.0,843.0
0.009,6,10,1990,5,911,2.0,643.0,643.0,5,1079,2.0,811.0,811.0
0.039,17,2,166,1,75,0.0,47.0,47.0,1,91,0.0,63.0,63.0
0.011,6,10,1989,5,910,2.0,642.0,642.0,5,1079,2.0,811.0,811.0
351.999,6,20,2210,6,1308,12006.0,494.0,494.0,14,902,27076.0,83.0,83.0
0.082,6,10,1506,5,395,18.0,127.0,127.0,5,1111,19.0,843.0,843.0
0.04,17,2,152,1,76,0.0,48.0,48.0,1,76,0.0,48.0,48.0
0.004,6,10,1989,5,927,1.0,659.0,659.0,5,1062,1.0,794.0,794.0
0.001,17,2,136,1,60,0.0,32.0,32.0,1,76,0.0,48.0,48.0
0.11,6,10,1506,5,395,25.0,127.0,127.0,5,1111,25.0,843.0,843.0
0.109,6,10,1506,5,395,23.0,127.0,127.0,5,1111,24.0,843.0,843.0
0.092,6,10,1506,5,395,20.0,127.0,127.0,5,1111,20.0,843.0,843.0
0.005,6,10,1989,5,927,1.0,659.0,659.0,5,1062,1.0,794.0,794.0
0.014,6,10,1989,5,910,3.0,642.0,642.0,5,1079,3.0,811.0,811.0
0.089,6,10,1506,5,395,18.0,127.0,127.0,5,1111,20.0,843.0,843.0
240.012,6,9,787,5,488,60003.0,232.0,232.0,4,299,80002.0,83.0,83.0
40.061,17,10,676,5,460,10014.0,104.0,64.0,5,216,10014.0,20.0,15.0
0.001,17,2,136,1,60,0.0,32.0,32.0,1,76,0.0,48.0,48.0
0.005,17,2,179,1,71,0.0,43.0,43.0,1,108,0.0,80.0,80.0
0.076,6,10,1506,5,395,17.0,127.0,127.0,5,1111,16.0,843.0,843.0
40.069,17,10,676,5,460,10016.0,104.0,64.0,5,216,10016.0,20.0,15.0
0.009,6,10,1990,5,911,2.0,643.0,643.0,5,1079,2.0,811.0,811.0
0.005,6,10,2006,5,927,1.0,659.0,659.0,5,1079,1.0,811.0,811.0
0.005,6,10,1989,5,927,1.0,659.0,659.0,5,1062,1.0,794.0,794.0
0.038,17,2,170,1,65,0.0,37.0,37.0,1,105,0.0,77.0,77.0
0.095,6,10,1506,5,395,21.0,127.0,127.0,5,1111,21.0,843.0,843.0
0.185,6,43,11475,23,3169,8.0,1021.0,197.0,20,8306,9.0,1402.0,659.0
0.001,17,2,180,1,66,0.0,38.0,38.0,1,114,0.0,86.0,86.0
0.013,6,10,1989,5,910,3.0,642.0,642.0,5,1079,3.0,811.0,811.0
10.855,17,28,4423,14,1995,826.0,270.0,114.0,14,2428,826.0,587.0,145.0
294.66,6,387,347504,195,21692,1518.0,2736.0,888.0,192,325812,1542.0,2804.0,1774.0
40.053,17,10,676,5,460,10012.0,104.0,64.0,5,216,10012.0,20.0,15.0
0.038,17,2,152,1,76,0.0,48.0,48.0,1,76,0.0,48.0,48.0
0.006,17,2,150,1,67,0.0,39.0,39.0,1,83,0.0,55.0,55.0
1756.701,6,105,6270,60,3525,29773.0,27.0,27.0,45,2745,39924.0,27.0,27.0
0.004,6,10,2006,5,927,1.0,659.0,659.0,5,1079,1.0,811.0,811.0
0.006,6,10,1643,5,860,1.0,592.0,592.0,5,783,1.0,515.0,515.0
9.037,17,6,376,5,280,2259.0,28.0,28.0,1,96,0.0,68.0,68.0
0.092,6,10,1506,5,395,19.0,127.0,127.0,5,1111,19.0,843.0,843.0
0.105,6,10,1506,5,395,24.0,127.0,127.0,5,1111,25.0,843.0,843.0
0.095,6,10,1506,5,395,22.0,127.0,127.0,5,1111,21.0,843.0,843.0
0.012,6,12,1926,6,1189,2.0,659.0,434.0,6,737,2.0,417.0,417.0
0.005,17,2,166,1,75,0.0,47.0,47.0,1,91,0.0,63.0,63.0
0.006,6,10,2006,5,927,1.0,659.0,659.0,5,1079,1.0,811.0,811.0
0.009,6,10,1990,5,911,2.0,643.0,643.0,5,1079,2.0,811.0,811.0
0.006,6,10,1854,5,889,1.0,621.0,621.0,5,965,1.0,697.0,697.0
351.994,6,20,2210,6,1308,12003.0,494.0,494.0,14,902,27076.0,83.0,83.0
0.015,6,10,1983,5,910,3.0,642.0,642.0,5,1073,3.0,805.0,805.0
40.054,17,10,676,5,460,10012.0,104.0,64.0,5,216,10012.0,20.0,15.0
0.015,17,2,198,1,91,0.0,63.0,63.0,1,107,0.0,79.0,79.0
0.005,6,10,1689,5,839,1.0,571.0,571.0,5,850,1.0,582.0,582.0
1770.521,17,92,8096,46,4048,39344.0,60.0,60.0,46,4048,39344.0,60.0,60.0
0.005,6,10,1989,5,927,1.0,659.0,659.0,5,1062,1.0,794.0,794.0
0.004,6,10,2007,5,928,1.0,660.0,660.0,5,1079,1.0,811.0,811.0
40.053,17,10,676,5,460,10012.0,104.0,64.0,5,216,10012.0,20.0,15.0
0.004,6,10,1702,5,863,1.0,595.0,595.0,5,839,0.0,571.0,571.0
0.871,6,25,5555,12,1445,67.0,267.0,136.0,13,4110,62.0,1414.0,597.0
0.045,6,10,1972,5,910,11.0,642.0,642.0,5,1062,11.0,794.0,794.0
0.071,17,8,3613,4,1874,23.0,1350.0,440.0,4,1739,12.0,1350.0,406.0
0.005,6,10,1689,5,839,1.0,571.0,571.0,5,850,1.0,582.0,582.0
0.005,6,10,1989,5,927,1.0,659.0,659.0,5,1062,1.0,794.0,794.0
0.005,6,10,1702,5,863,1.0,595.0,595.0,5,839,1.0,571.0,571.0
0.006,6,10,1689,5,839,1.0,571.0,571.0,5,850,1.0,582.0,582.0
1770.806,6,135,6510,75,3585,23926.0,39.0,39.0,60,2925,30009.0,35.0,35.0
0.084,6,10,1506,5,395,18.0,127.0,127.0,5,1111,19.0,843.0,843.0
0.004,17,2,136,1,60,0.0,32.0,32.0,1,76,0.0,48.0,48.0
351.988,6,20,2210,6,1308,12003.0,494.0,494.0,14,902,27075.0,83.0,83.0
0.004,17,4,284,2,120,0.0,32.0,32.0,2,164,0.0,60.0,54.0
0.006,17,2,169,1,62,0.0,34.0,34.0,1,107,0.0,79.0,79.0
0.01,6,10,1983,5,910,2.0,642.0,642.0,5,1073,2.0,805.0,805.0
0.004,17,2,152,1,76,0.0,48.0,48.0,1,76,0.0,48.0,48.0
0.094,6,10,1506,5,395,21.0,127.0,127.0,5,1111,21.0,843.0,843.0
0.003,6,10,1702,5,863,0.0,595.0,595.0,5,839,0.0,571.0,571.0
0.009,6,10,1989,5,910,2.0,642.0,642.0,5,1079,2.0,811.0,811.0
0.016,6,10,1983,5,910,4.0,642.0,642.0,5,1073,3.0,805.0,805.0
0.01,6,13,3747,7,509,1.0,137.0,137.0,6,3238,1.0,1470.0,1459.0
0.01,6,10,1983,5,910,2.0,642.0,642.0,5,1073,2.0,805.0,805.0
0.004,6,10,1779,5,928,1.0,660.0,660.0,5,851,1.0,583.0,583.0
1799.768,6,136,6589,76,3664,23996.0,39.0,39.0,60,2925,30004.0,35.0,35.0
0.009,6,10,1972,5,910,2.0,642.0,642.0,5,1062,2.0,794.0,794.0
0.022,6,10,1972,5,910,5.0,642.0,642.0,5,1062,5.0,794.0,794.0
0.015,6,10,1990,5,911,3.0,643.0,643.0,5,1079,3.0,811.0,811.0
0.013,6,10,1631,5,848,3.0,580.0,580.0,5,783,3.0,515.0,515.0
0.005,17,4,284,2,120,1.0,32.0,32.0,2,164,1.0,60.0,54.0
0.104,6,10,1506,5,395,21.0,127.0,127.0,5,1111,24.0,843.0,843.0
0.004,6,10,1702,5,863,1.0,595.0,595.0,5,839,1.0,571.0,571.0
0.004,17,4,284,2,120,0.0,32.0,32.0,2,164,0.0,60.0,54.0
0.127,17,4,420,2,122,0.0,33.0,33.0,2,298,89.0,145.0,121.0
0.007,17,2,179,1,71,0.0,43.0,43.0,1,108,0.0,80.0,80.0
0.038,17,2,152,1,76,0.0,48.0,48.0,1,76,0.0,48.0,48.0
0.018,6,10,1990,5,911,4.0,643.0,643.0,5,1079,4.0,811.0,811.0
0.025,6,10,1972,5,910,6.0,642.0,642.0,5,1062,6.0,794.0,794.0
0.04,17,2,152,1,76,0.0,48.0,48.0,1,76,0.0,48.0,48.0
0.006,6,10,1547,5,764,1.0,496.0,496.0,5,783,1.0,515.0,515.0
0.09,6,10,1506,5,395,20.0,127.0,127.0,5,1111,19.0,843.0,843.0
0.001,17,2,136,1,60,0.0,32.0,32.0,1,76,0.0,48.0,48.0
0.0,17,2,136,1,60,0.0,32.0,32.0,1,76,0.0,48.0,48.0
0.001,17,2,136,1,60,0.0,32.0,32.0,1,76,0.0,48.0,48.0
0.722,6,22,5072,11,1250,62.0,325.0,133.0,11,3822,60.0,1414.0,563.0
0.009,6,11,2024,6,962,1.0,642.0,642.0,5,1062,2.0,794.0,794.0
352.505,6,20,2210,6,1308,12004.0,494.0,494.0,14,902,27115.0,83.0,83.0
40.035,17,10,676,5,460,10007.0,104.0,64.0,5,216,10007.0,20.0,15.0
33.97,6,37,10407,19,4889,491.0,1360.0,819.0,18,5518,1988.0,2667.0,435.0
0.02,6,10,1990,5,911,5.0,643.0,643.0,5,1079,5.0,811.0,811.0
0.221,6,16,2778,8,1396,31.0,533.0,324.0,8,1382,20.0,529.0,239.0
0.005,6,10,2006,5,927,1.0,659.0,659.0,5,1079,1.0,811.0,811.0
0.096,6,10,1506,5,395,22.0,127.0,127.0,5,1111,19.0,843.0,843.0
0.005,6,10,2000,5,927,1.0,659.0,659.0,5,1073,1.0,805.0,805.0
0.005,6,10,1854,5,889,1.0,621.0,621.0,5,965,1.0,697.0,697.0
0.008,6,13,3735,7,497,1.0,125.0,125.0,6,3238,1.0,1470.0,1459.0
0.004,6,10,2006,5,927,1.0,659.0,659.0,5,1079,1.0,811.0,811.0
0.025,6,10,1631,5,848,6.0,580.0,580.0,5,783,6.0,515.0,515.0
0.012,6,10,1677,5,827,3.0,559.0,559.0,5,850,2.0,582.0,582.0
0.005,6,10,1643,5,860,1.0,592.0,592.0,5,783,1.0,515.0,515.0
40.058,17,10,676,5,460,10012.0,104.0,64.0,5,216,10013.0,20.0,15.0
0.17,17,2,152,1,76,0.0,48.0,48.0,1,76,0.0,48.0,48.0
0.009,6,10,2006,5,927,2.0,659.0,659.0,5,1079,2.0,811.0,811.0
0.009,6,10,1983,5,910,2.0,642.0,642.0,5,1073,2.0,805.0,805.0
0.005,17,2,170,1,65,0.0,37.0,37.0,1,105,0.0,77.0,77.0
0.013,6,10,1677,5,827,3.0,559.0,559.0,5,850,3.0,582.0,582.0
0.012,6,10,1989,5,910,3.0,642.0,642.0,5,1079,2.0,811.0,811.0
1744.24,6,64,7344,42,4469,42542.0,1625.0,108.0,22,2875,83051.0,1111.0,82.0
0.078,6,10,1506,5,395,17.0,127.0,127.0,5,1111,17.0,843.0,843.0
0.023,6,10,1762,5,911,5.0,643.0,643.0,5,851,5.0,583.0,583.0
0.004,17,2,170,1,65,0.0,37.0,37.0,1,105,0.0,77.0,77.0
0.009,6,13,3735,7,497,1.0,125.0,125.0,6,3238,1.0,1470.0,1459.0
0.011,6,10,1972,5,910,2.0,642.0,642.0,5,1062,2.0,794.0,794.0
0.006,6,10,1547,5,764,1.0,496.0,496.0,5,783,1.0,515.0,515.0
0.006,6,10,1643,5,860,1.0,592.0,592.0,5,783,1.0,515.0,515.0
0.009,6,13,3735,7,497,1.0,125.0,125.0,6,3238,1.0,1470.0,1459.0
0.007,17,2,179,1,71,0.0,43.0,43.0,1,108,0.0,80.0,80.0
0.789,6,10,937,6,427,157.0,107.0,107.0,4,510,175.0,294.0,294.0
0.124,6,10,1506,5,395,29.0,127.0,127.0,5,1111,29.0,843.0,843.0
0.116,6,10,1242,5,751,29.0,495.0,495.0,5,491,26.0,223.0,223.0
0.006,6,10,1547,5,764,1.0,496.0,496.0,5,783,1.0,515.0,515.0
0.005,6,10,1989,5,927,1.0,659.0,659.0,5,1062,1.0,794.0,794.0
0.015,6,10,1972,5,910,3.0,642.0,642.0,5,1062,3.0,794.0,794.0
0.005,6,10,2007,5,928,1.0,660.0,660.0,5,1079,1.0,811.0,811.0
0.006,17,2,230,1,68,0.0,40.0,40.0,1,162,0.0,134.0,134.0
0.02,6,13,3913,7,495,3.0,123.0,123.0,6,3418,3.0,1650.0,1549.0
0.013,6,10,1983,5,910,3.0,642.0,642.0,5,1073,3.0,805.0,805.0
0.003,17,2,148,1,60,0.0,32.0,32.0,1,88,0.0,60.0,60.0
0.005,6,10,2006,5,927,1.0,659.0,659.0,5,1079,1.0,811.0,811.0
0.073,6,10,1506,5,395,17.0,127.0,127.0,5,1111,16.0,843.0,843.0
0.112,6,10,1506,5,395,24.0,127.0,127.0,5,1111,23.0,843.0,843.0
0.005,6,10,2007,5,928,1.0,660.0,660.0,5,1079,1.0,811.0,811.0
0.003,17,2,148,1,60,0.0,32.0,32.0,1,88,0.0,60.0,60.0
0.056,17,2,144,1,64,0.0,36.0,36.0,1,80,0.0,52.0,52.0
0.007,6,10,1762,5,911,1.0,643.0,643.0,5,851,1.0,583.0,583.0
0.001,17,2,180,1,66,0.0,38.0,38.0,1,114,0.0,86.0,86.0
0.005,6,10,2006,5,927,1.0,659.0,659.0,5,1079,1.0,811.0,811.0
0.005,6,10,1989,5,927,1.0,659.0,659.0,5,1062,1.0,794.0,794.0
0.07,17,8,3613,4,1874,23.0,1350.0,440.0,4,1739,11.0,1350.0,406.0
0.004,6,10,1702,5,863,1.0,595.0,595.0,5,839,1.0,571.0,571.0
0.004,6,10,2007,5,928,1.0,660.0,660.0,5,1079,1.0,811.0,811.0
0.005,6,10,2006,5,927,1.0,659.0,659.0,5,1079,1.0,811.0,811.0
0.08,6,10,1506,5,395,16.0,127.0,127.0,5,1111,18.0,843.0,843.0
40.065,17,10,676,5,460,10015.0,104.0,64.0,5,216,10015.0,20.0,15.0
9.037,17,6,376,5,280,2259.0,28.0,28.0,1,96,0.0,68.0,68.0
0.004,6,10,2000,5,927,1.0,659.0,659.0,5,1073,1.0,805.0,805.0
0.693,6,22,5072,11,1250,58.0,325.0,133.0,11,3822,58.0,1414.0,563.0
40.056,17,10,676,5,460,10013.0,104.0,64.0,5,216,10013.0,20.0,15.0
0.116,6,10,1506,5,395,27.0,127.0,127.0,5,1111,27.0,843.0,843.0
40.061,17,10,676,5,460,10012.0,104.0,64.0,5,216,10014.0,20.0,15.0
0.005,17,2,164,1,74,0.0,46.0,46.0,1,90,0.0,62.0,62.0
240.008,6,9,787,5,488,60002.0,232.0,232.0,4,299,80001.0,83.0,83.0
0.018,6,10,1972,5,910,4.0,642.0,642.0,5,1062,4.0,794.0,794.0
0.004,17,2,136,1,60,0.0,32.0,32.0,1,76,0.0,48.0,48.0
0.076,6,10,1506,5,395,15.0,127.0,127.0,5,1111,17.0,843.0,843.0
0.093,6,10,1506,5,395,20.0,127.0,127.0,5,1111,19.0,843.0,843.0
0.014,6,10,1990,5,911,3.0,643.0,643.0,5,1079,3.0,811.0,811.0
0.004,6,10,1989,5,927,1.0,659.0,659.0,5,1062,1.0,794.0,794.0
0.005,6,10,2007,5,928,1.0,660.0,660.0,5,1079,1.0,811.0,811.0
0.005,6,10,1643,5,860,1.0,592.0,592.0,5,783,1.0,515.0,515.0
0.005,6,10,2006,5,927,1.0,659.0,659.0,5,1079,1.0,811.0,811.0
0.105,6,10,1506,5,395,23.0,127.0,127.0,5,1111,24.0,843.0,843.0
0.006,6,10,2006,5,927,1.0,659.0,659.0,5,1079,1.0,811.0,811.0
0.005,6,10,2007,5,928,1.0,660.0,660.0,5,1079,1.0,811.0,811.0
0.003,17,4,284,2,120,0.0,32.0,32.0,2,164,0.0,60.0,54.0
0.015,6,10,1989,5,910,3.0,642.0,642.0,5,1079,3.0,811.0,811.0
0.004,17,2,136,1,60,0.0,32.0,32.0,1,76,0.0,48.0,48.0
0.064,6,10,1506,5,395,13.0,127.0,127.0,5,1111,14.0,843.0,843.0
240.114,6,32,9647,16,7091,16007.0,2164.0,695.0,16,2556,16007.0,580.0,214.0
0.06,17,2,152,1,76,0.0,48.0,48.0,1,76,0.0,48.0,48.0
0.015,6,10,1983,5,910,3.0,642.0,642.0,5,1073,3.0,805.0,805.0
0.094,6,10,1506,5,395,18.0,127.0,127.0,5,1111,21.0,843.0,843.0
0.007,6,10,1547,5,764,1.0,496.0,496.0,5,783,1.0,515.0,515.0
40.063,17,10,676,5,460,10015.0,104.0,64.0,5,216,10014.0,20.0,15.0
1787.455,6,150,19350,90,13740,20083.0,302.0,302.0,60,5610,30295.0,83.0,83.0
0.093,6,10,1506,5,395,21.0,127.0,127.0,5,1111,21.0,843.0,843.0
15.069,17,14,9190,8,6902,2148.0,1350.0,834.0,6,2288,3007.0,1350.0,353.0
0.005,6,10,2000,5,927,1.0,659.0,659.0,5,1073,1.0,805.0,805.0
1799.548,6,241,46560,116,34105,15648.0,2498.0,967.0,125,12455,14512.0,580.0,61.0
40.093,17,10,676,5,460,10020.0,104.0,64.0,5,216,10022.0,20.0,15.0
0.015,6,10,1989,5,910,3.0,642.0,642.0,5,1079,3.0,811.0,811.0
0.018,6,10,1631,5,848,4.0,580.0,580.0,5,783,4.0,515.0,515.0
0.008,6,10,2000,5,927,1.0,659.0,659.0,5,1073,2.0,805.0,805.0
0.005,17,2,154,1,69,0.0,41.0,41.0,1,85,0.0,57.0,57.0
0.008,6,10,1989,5,910,1.0,642.0,642.0,5,1079,2.0,811.0,811.0
0.006,6,10,1547,5,764,1.0,496.0,496.0,5,783,1.0,515.0,515.0
0.003,17,2,904,1,576,0.0,548.0,548.0,1,328,0.0,300.0,300.0
0.072,6,10,1506,5,395,15.0,127.0,127.0,5,1111,16.0,843.0,843.0
0.097,6,10,1506,5,395,20.0,127.0,127.0,5,1111,19.0,843.0,843.0
0.037,17,2,396,1,61,0.0,33.0,33.0,1,335,0.0,307.0,307.0
0.033,6,10,2006,5,927,8.0,659.0,659.0,5,1079,8.0,811.0,811.0
0.099,6,10,1506,5,395,22.0,127.0,127.0,5,1111,20.0,843.0,843.0
0.008,6,10,1983,5,910,2.0,642.0,642.0,5,1073,1.0,805.0,805.0
0.013,6,10,1989,5,910,3.0,642.0,642.0,5,1079,3.0,811.0,811.0
0.107,6,10,1506,5,395,21.0,127.0,127.0,5,1111,24.0,843.0,843.0
0.051,17,2,136,1,60,0.0,32.0,32.0,1,76,0.0,48.0,48.0
0.004,17,4,284,2,120,0.0,32.0,32.0,2,164,0.0,60.0,54.0
0.005,6,10,2007,5,928,1.0,660.0,660.0,5,1079,1.0,811.0,811.0
0.114,17,2,164,1,74,0.0,46.0,46.0,1,90,0.0,62.0,62.0
308.572,17,18,1008,9,640,38555.0,48.0,43.0,9,368,38555.0,20.0,12.0
0.281,17,44,20720,23,17161,12.0,1350.0,718.0,21,3559,12.0,1350.0,141.0
0.131,6,10,1506,5,395,28.0,127.0,127.0,5,1111,27.0,843.0,843.0
15.082,17,15,8260,8,6157,2150.0,1350.0,741.0,7,2103,2508.0,1350.0,272.0
0.006,6,13,3684,7,446,1.0,74.0,74.0,6,3238,1.0,1470.0,1459.0
0.006,17,2,148,1,60,0.0,32.0,32.0,1,88,0.0,60.0,60.0
0.004,6,10,2006,5,927,1.0,659.0,659.0,5,1079,1.0,811.0,811.0
0.004,6,10,2007,5,928,1.0,660.0,660.0,5,1079,1.0,811.0,811.0
0.005,17,2,148,1,60,0.0,32.0,32.0,1,88,0.0,60.0,60.0
178.046,17,74,10579,37,2468,4945.0,44.0,38.0,37,8111,4945.0,239.0,191.0
0.001,17,2,180,1,66,0.0,38.0,38.0,1,114,0.0,86.0,86.0
0.005,6,10,1989,5,927,1.0,659.0,659.0,5,1062,1.0,794.0,794.0
0.014,6,10,1972,5,910,3.0,642.0,642.0,5,1062,3.0,794.0,794.0
0.255,17,42,21673,24,18526,11.0,1350.0,743.0,18,3147,11.0,1350.0,146.0
0.001,17,2,136,1,60,0.0,32.0,32.0,1,76,0.0,48.0,48.0
0.006,6,10,1547,5,764,1.0,496.0,496.0,5,783,1.0,515.0,515.0
0.016,6,10,1983,5,910,4.0,642.0,642.0,5,1073,4.0,805.0,805.0
0.013,17,2,166,1,75,0.0,47.0,47.0,1,91,0.0,63.0,63.0
0.12,6,10,1506,5,395,29.0,127.0,127.0,5,1111,26.0,843.0,843.0
0.008,6,10,1762,5,911,2.0,643.0,643.0,5,851,1.0,583.0,583.0
1792.672,6,483,98653,242,87423,7437.0,421.0,368.0,241,11230,7468.0,53.0,53.0
0.01,6,10,1983,5,910,2.0,642.0,642.0,5,1073,2.0,805.0,805.0
0.072,17,8,3613,4,1874,24.0,1350.0,440.0,4,1739,12.0,1350.0,406.0
0.071,17,8,3613,4,1874,23.0,1350.0,440.0,4,1739,12.0,1350.0,406.0
0.006,6,10,1547,5,764,1.0,496.0,496.0,5,783,1.0,515.0,515.0
0.004,6,10,2006,5,927,1.0,659.0,659.0,5,1079,1.0,811.0,811.0
0.005,6,10,1547,5,764,1.0,496.0,496.0,5,783,1.0,515.0,515.0
0.006,6,10,1989,5,927,1.0,659.0,659.0,5,1062,1.0,794.0,794.0
240.094,6,16,4480,9,963,30011.0,238.0,166.0,7,3517,40015.0,1402.0,786.0
10.899,17,26,4097,13,1821,899.0,268.0,112.0,13,2276,899.0,587.0,147.0
0.061,17,2,152,1,76,0.0,48.0,48.0,1,76,0.0,48.0,48.0
0.005,6,10,1854,5,889,1.0,621.0,621.0,5,965,1.0,697.0,697.0
0.085,6,10,1506,5,395,20.0,127.0,127.0,5,1111,19.0,843.0,843.0
0.002,17,2,180,1,66,0.0,38.0,38.0,1,114,0.0,86.0,86.0
0.148,6,10,1506,5,395,35.0,127.0,127.0,5,1111,34.0,843.0,843.0
0.006,17,2,136,1,60,0.0,32.0,32.0,1,76,0.0,48.0,48.0
0.096,6,10,1506,5,395,18.0,127.0,127.0,5,1111,22.0,843.0,843.0
10.816,17,28,4421,14,1994,823.0,269.0,114.0,14,2427,823.0,586.0,145.0
240.156,6,46,6947,22,3226,11435.0,588.0,230.0,24,3721,10441.0,580.0,224.0
0.034,6,10,1972,5,910,8.0,642.0,642.0,5,1062,8.0,794.0,794.0
0.082,6,10,1506,5,395,18.0,127.0,127.0,5,1111,17.0,843.0,843.0
0.01,6,10,1972,5,910,2.0,642.0,642.0,5,1062,2.0,794.0,794.0
10.966,17,28,4391,14,2313,835.0,588.0,137.0,14,2078,835.0,269.0,120.0
10.759,17,28,4423,14,1994,819.0,269.0,114.0,14,2429,818.0,588.0,145.0
0.091,6,10,1506,5,395,22.0,127.0,127.0,5,1111,19.0,843.0,843.0
0.014,6,10,1677,5,827,3.0,559.0,559.0,5,850,3.0,582.0,582.0
0.006,6,10,1854,5,889,1.0,621.0,621.0,5,965,1.0,697.0,697.0
240.098,6,31,9269,15,6790,17149.0,1914.0,668.0,16,2479,16006.0,580.0,204.0
300.298,6,27,7434,16,1409,20019.0,217.0,142.0,11,6025,24025.0,1679.0,777.0
0.001,17,2,180,1,66,0.0,38.0,38.0,1,114,0.0,86.0,86.0
0.005,17,2,180,1,66,0.0,38.0,38.0,1,114,0.0,86.0,86.0
0.012,6,10,1983,5,910,3.0,642.0,642.0,5,1073,3.0,805.0,805.0
0.005,6,10,2006,5,927,1.0,659.0,659.0,5,1079,1.0,811.0,811.0
0.068,17,8,3613,4,1874,22.0,1350.0,440.0,4,1739,12.0,1350.0,406.0
0.016,6,10,1983,5,910,4.0,642.0,642.0,5,1073,3.0,805.0,805.0
0.078,6,10,1506,5,395,16.0,127.0,127.0,5,1111,19.0,843.0,843.0
0.01,6,10,1990,5,911,2.0,643.0,643.0,5,1079,2.0,811.0,811.0
0.006,6,10,1989,5,927,1.0,659.0,659.0,5,1062,1.0,794.0,794.0
0.069,17,8,3613,4,1874,23.0,1350.0,440.0,4,1739,11.0,1350.0,406.0
0.082,6,10,1506,5,395,18.0,127.0,127.0,5,1111,19.0,843.0,843.0
15.083,17,15,8282,8,6233,2150.0,1350.0,751.0,7,2049,2507.0,1350.0,264.0
0.113,6,10,1506,5,395,25.0,127.0,127.0,5,1111,23.0,843.0,843.0
0.006,6,10,2006,5,927,1.0,659.0,659.0,5,1079,1.0,811.0,811.0
0.012,6,10,1989,5,910,3.0,642.0,642.0,5,1079,3.0,811.0,811.0
240.698,6,46,36167,24,4098,10465.0,923.0,475.0,22,32069,11461.0,2804.0,1818.0
0.085,6,10,1506,5,395,19.0,127.0,127.0,5,1111,16.0,843.0,843.0
0.004,17,4,284,2,120,0.0,32.0,32.0,2,164,1.0,60.0,54.0
0.019,6,10,1762,5,911,4.0,643.0,643.0,5,851,4.0,583.0,583.0
0.024,17,2,198,1,91,0.0,63.0,63.0,1,107,0.0,79.0,79.0
0.005,17,2,179,1,71,0.0,43.0,43.0,1,108,0.0,80.0,80.0
0.004,17,2,136,1,60,0.0,32.0,32.0,1,76,0.0,48.0,48.0
0.006,6,10,1547,5,764,1.0,496.0,496.0,5,783,1.0,515.0,515.0
0.016,6,14,3787,7,497,2.0,125.0,125.0,7,3290,2.0,1448.0,972.0
1756.654,6,106,6292,60,3510,29773.0,26.0,26.0,46,2782,39035.0,26.0,26.0
0.272,17,4,352,2,130,143.0,37.0,37.0,2,222,233.0,89.0,83.0
10.86,17,28,4421,14,1993,826.0,268.0,114.0,14,2428,826.0,587.0,145.0
308.575,17,19,1084,10,716,34273.0,48.0,43.0,9,368,38557.0,20.0,12.0
0.005,17,2,164,1,74,0.0,46.0,46.0,1,90,0.0,62.0,62.0
0.006,6,10,2000,5,927,1.0,659.0,659.0,5,1073,1.0,805.0,805.0
0.005,6,10,1689,5,839,1.0,571.0,571.0,5,850,1.0,582.0,582.0
0.005,6,10,2006,5,927,1.0,659.0,659.0,5,1079,1.0,811.0,811.0
0.14,6,10,1506,5,395,27.0,127.0,127.0,5,1111,31.0,843.0,843.0
0.004,17,2,170,1,65,0.0,37.0,37.0,1,105,0.0,77.0,77.0
40.062,17,10,676,5,460,10014.0,104.0,64.0,5,216,10014.0,20.0,15.0
0.002,17,2,174,1,72,0.0,44.0,44.0,1,102,0.0,74.0,74.0
0.012,6,10,1990,5,911,3.0,643.0,643.0,5,1079,2.0,811.0,811.0
0.011,6,10,1989,5,910,2.0,642.0,642.0,5,1079,2.0,811.0,811.0
0.096,6,10,1506,5,395,21.0,127.0,127.0,5,1111,22.0,843.0,843.0
0.008,6,10,1990,5,911,2.0,643.0,643.0,5,1079,2.0,811.0,811.0
0.02,6,10,1762,5,911,4.0,643.0,643.0,5,851,4.0,583.0,583.0
366.978,6,19,1689,15,978,26212.0,190.0,190.0,4,711,80020.0,495.0,495.0
0.021,6,10,1762,5,911,5.0,643.0,643.0,5,851,5.0,583.0,583.0
0.004,6,10,1702,5,863,1.0,595.0,595.0,5,839,0.0,571.0,571.0
0.006,6,10,1547,5,764,1.0,496.0,496.0,5,783,1.0,515.0,515.0
171.053,17,78,10797,39,2607,4501.0,44.0,38.0,39,8190,4501.0,239.0,182.0
11.023,17,25,3925,13,1845,909.0,268.0,113.0,12,2080,992.0,587.0,145.0
40.066,17,10,676,5,460,10015.0,104.0,64.0,5,216,10015.0,20.0,15.0
0.014,6,10,1989,5,910,3.0,642.0,642.0,5,1079,3.0,811.0,811.0
0.004,17,2,132,1,58,0.0,30.0,30.0,1,74,0.0,46.0,46.0
176.275,17,70,10064,35,2321,5179.0,44.0,38.0,35,7743,5184.0,261.0,193.0
0.011,6,10,1989,5,910,2.0,642.0,642.0,5,1079,2.0,811.0,811.0
0.004,6,10,2000,5,927,1.0,659.0,659.0,5,1073,1.0,805.0,805.0
0.037,17,2,184,1,61,0.0,33.0,33.0,1,123,0.0,95.0,95.0
0.108,6,10,1506,5,395,19.0,127.0,127.0,5,1111,25.0,843.0,843.0
0.068,17,8,3613,4,1874,22.0,1350.0,440.0,4,1739,11.0,1350.0,406.0
0.021,6,10,1631,5,848,5.0,580.0,580.0,5,783,5.0,515.0,515.0
0.018,6,10,1989,5,910,4.0,642.0,642.0,5,1079,4.0,811.0,811.0
9.061,17,6,376,5,280,2265.0,28.0,28.0,1,96,0.0,68.0,68.0
0.01,6,10,2000,5,927,2.0,659.0,659.0,5,1073,2.0,805.0,805.0
0.02,6,10,1631,5,848,5.0,580.0,580.0,5,783,4.0,515.0,515.0
0.01,6,10,1972,5,910,2.0,642.0,642.0,5,1062,2.0,794.0,794.0
0.004,17,2,136,1,60,0.0,32.0,32.0,1,76,0.0,48.0,48.0
0.006,6,10,1547,5,764,1.0,496.0,496.0,5,783,1.0,515.0,515.0
308.694,17,20,1124,10,716,34285.0,48.0,43.0,10,408,34285.0,20.0,12.0
0.006,17,2,179,1,71,0.0,43.0,43.0,1,108,0.0,80.0,80.0
0.005,6,10,2007,5,928,1.0,660.0,660.0,5,1079,1.0,811.0,811.0
0.006,6,10,2006,5,927,1.0,659.0,659.0,5,1079,1.0,811.0,811.0
0.006,17,2,214,1,75,0.0,47.0,47.0,1,139,0.0,111.0,111.0
1768.918,17,92,8096,46,4048,39309.0,60.0,60.0,46,4048,39309.0,60.0,60.0
0.019,6,13,3735,7,497,3.0,125.0,125.0,6,3238,3.0,1470.0,1459.0
0.104,6,10,1506,5,395,24.0,127.0,127.0,5,1111,24.0,843.0,843.0
0.009,6,10,1989,5,910,2.0,642.0,642.0,5,1079,2.0,811.0,811.0
0.178,17,2,152,1,76,0.0,48.0,48.0,1,76,0.0,48.0,48.0
0.005,6,10,1689,5,839,1.0,571.0,571.0,5,850,1.0,582.0,582.0
0.015,6,10,1990,5,911,3.0,643.0,643.0,5,1079,3.0,811.0,811.0
0.089,6,10,1506,5,395,20.0,127.0,127.0,5,1111,21.0,843.0,843.0
0.005,6,10,1643,5,860,1.0,592.0,592.0,5,783,1.0,515.0,515.0
0.005,6,10,1779,5,928,1.0,660.0,660.0,5,851,1.0,583.0,583.0
300.371,6,16,2170,9,684,37525.0,146.0,146.0,7,1486,50033.0,419.0,398.0
0.054,17,2,152,1,76,0.0,48.0,48.0,1,76,0.0,48.0,48.0
0.009,17,2,179,1,71,0.0,43.0,43.0,1,108,0.0,80.0,80.0
0.025,6,10,1983,5,910,6.0,642.0,642.0,5,1073,6.0,805.0,805.0
0.005,6,10,1989,5,927,1.0,659.0,659.0,5,1062,1.0,794.0,794.0
0.009,6,12,1926,6,1189,1.0,659.0,434.0,6,737,1.0,417.0,417.0
0.012,6,10,1762,5,911,3.0,643.0,643.0,5,851,2.0,583.0,583.0
0.004,17,2,144,1,64,0.0,36.0,36.0,1,80,0.0,52.0,52.0
0.005,6,10,1547,5,764,1.0,496.0,496.0,5,783,1.0,515.0,515.0
0.005,17,2,166,1,75,0.0,47.0,47.0,1,91,0.0,63.0,63.0
0.006,6,13,3747,7,509,0.0,137.0,137.0,6,3238,1.0,1470.0,1459.0
0.09,6,10,1506,5,395,19.0,127.0,127.0,5,1111,18.0,843.0,843.0
0.005,6,10,2007,5,928,1.0,660.0,660.0,5,1079,1.0,811.0,811.0
300.32,6,37,14520,20,2398,15806.0,676.0,337.0,17,12122,15016.0,1402.0,935.0
0.04,17,2,182,1,65,0.0,37.0,37.0,1,117,0.0,89.0,89.0
0.014,6,10,1983,5,910,3.0,642.0,642.0,5,1073,3.0,805.0,805.0
300.024,6,12,1782,7,1348,50004.0,494.0,494.0,5,434,75005.0,83.0,83.0
0.082,6,10,1506,5,395,20.0,127.0,127.0,5,1111,18.0,843.0,843.0
0.004,17,4,284,2,120,0.0,32.0,32.0,2,164,0.0,60.0,54.0
0.069,17,2,152,1,76,0.0,48.0,48.0,1,76,0.0,48.0,48.0
0.004,17,4,284,2,120,1.0,32.0,32.0,2,164,0.0,60.0,54.0
0.007,6,10,1989,5,927,1.0,659.0,659.0,5,1062,1.0,794.0,794.0
0.005,6,10,2006,5,927,1.0,659.0,659.0,5,1079,1.0,811.0,811.0
0.004,17,4,284,2,120,1.0,32.0,32.0,2,164,1.0,60.0,54.0
40.067,17,10,676,5,460,10016.0,104.0,64.0,5,216,10014.0,20.0,15.0
0.006,6,10,1689,5,839,1.0,571.0,571.0,5,850,1.0,582.0,582.0
0.005,6,13,3747,7,509,0.0,137.0,137.0,6,3238,0.0,1470.0,1459.0
0.005,6,10,2000,5,927,1.0,659.0,659.0,5,1073,1.0,805.0,805.0
0.011,6,10,1677,5,827,2.0,559.0,559.0,5,850,2.0,582.0,582.0
0.004,17,2,184,1,61,0.0,33.0,33.0,1,123,0.0,95.0,95.0
0.016,6,10,1677,5,827,4.0,559.0,559.0,5,850,4.0,582.0,582.0
0.005,6,10,1989,5,927,1.0,659.0,659.0,5,1062,1.0,794.0,794.0
0.068,6,10,1506,5,395,15.0,127.0,127.0,5,1111,15.0,843.0,843.0
0.013,6,10,1989,5,910,3.0,642.0,642.0,5,1079,3.0,811.0,811.0
0.086,6,10,1506,5,395,20.0,127.0,127.0,5,1111,16.0,843.0,843.0
0.001,17,2,166,1,75,0.0,47.0,47.0,1,91,0.0,63.0,63.0
0.004,6,10,2000,5,927,1.0,659.0,659.0,5,1073,1.0,805.0,805.0
0.099,6,10,1506,5,395,23.0,127.0,127.0,5,1111,20.0,843.0,843.0
24.52,6,35,8425,17,1954,538.0,886.0,414.0,18,6471,1434.0,2720.0,478.0
0.004,17,2,203,1,61,0.0,33.0,33.0,1,142,0.0,114.0,114.0
0.003,17,2,148,1,60,0.0,32.0,32.0,1,88,0.0,60.0,60.0
0.075,6,10,1506,5,395,17.0,127.0,127.0,5,1111,15.0,843.0,843.0
0.094,6,10,1506,5,395,19.0,127.0,127.0,5,1111,21.0,843.0,843.0
0.124,6,10,1506,5,395,29.0,127.0,127.0,5,1111,20.0,843.0,843.0
0.008,17,2,136,1,60,0.0,32.0,32.0,1,76,0.0,48.0,48.0
0.012,6,10,1762,5,911,3.0,643.0,643.0,5,851,2.0,583.0,583.0
0.013,6,10,1989,5,910,3.0,642.0,642.0,5,1079,3.0,811.0,811.0
0.005,17,2,175,1,65,0.0,37.0,37.0,1,110,0.0,82.0,82.0
0.175,6,10,1506,5,395,41.0,127.0,127.0,5,1111,41.0,843.0,843.0
0.019,6,10,1983,5,910,4.0,642.0,642.0,5,1073,4.0,805.0,805.0
0.004,6,10,2007,5,928,1.0,660.0,660.0,5,1079,1.0,811.0,811.0
0.004,6,10,1779,5,928,1.0,660.0,660.0,5,851,1.0,583.0,583.0
0.039,17,4,284,2,120,0.0,32.0,32.0,2,164,36.0,60.0,54.0
0.011,6,10,1972,5,910,2.0,642.0,642.0,5,1062,2.0,794.0,794.0
0.003,17,2,148,1,60,0.0,32.0,32.0,1,88,0.0,60.0,60.0
0.006,6,10,1547,5,764,1.0,496.0,496.0,5,783,1.0,515.0,515.0
1755.99,6,106,6322,60,3525,29761.0,27.0,27.0,46,2797,39021.0,27.0,27.0
0.003,6,10,1702,5,863,0.0,595.0,595.0,5,839,0.0,571.0,571.0
0.013,6,10,1990,5,911,3.0,643.0,643.0,5,1079,3.0,811.0,811.0
0.171,17,2,152,1,76,0.0,48.0,48.0,1,76,0.0,48.0,48.0
0.007,6,10,1547,5,764,1.0,496.0,496.0,5,783,1.0,515.0,515.0
0.005,17,2,136,1,60,0.0,32.0,32.0,1,76,0.0,48.0,48.0
0.001,17,2,180,1,66,0.0,38.0,38.0,1,114,0.0,86.0,86.0
0.009,6,12,1926,6,1189,1.0,659.0,434.0,6,737,1.0,417.0,417.0
0.005,6,10,1643,5,860,1.0,592.0,592.0,5,783,1.0,515.0,515.0
15.087,17,16,9178,8,6934,2151.0,1350.0,838.0,8,2244,2151.0,1350.0,252.0
0.007,6,10,1547,5,764,1.0,496.0,496.0,5,783,1.0,515.0,515.0
0.005,6,13,3690,7,452,0.0,80.0,80.0,6,3238,1.0,1470.0,1459.0
240.026,6,9,787,5,488,60006.0,232.0,232.0,4,299,80007.0,83.0,83.0
0.011,6,10,1972,5,910,2.0,642.0,642.0,5,1062,2.0,794.0,794.0
0.083,6,10,1506,5,395,19.0,127.0,127.0,5,1111,17.0,843.0,843.0
0.043,17,2,152,1,76,0.0,48.0,48.0,1,76,0.0,48.0,48.0
0.004,6,10,2006,5,927,1.0,659.0,659.0,5,1079,1.0,811.0,811.0
0.09,6,10,1506,5,395,22.0,127.0,127.0,5,1111,20.0,843.0,843.0
0.009,6,10,1989,5,910,2.0,642.0,642.0,5,1079,2.0,811.0,811.0
0.003,17,2,136,1,60,0.0,32.0,32.0,1,76,0.0,48.0,48.0
0.009,6,10,1989,5,910,2.0,642.0,642.0,5,1079,2.0,811.0,811.0
309.714,17,20,1124,10,716,34397.0,48.0,43.0,10,408,34398.0,20.0,12.0
308.826,17,20,1124,10,716,34299.0,48.0,43.0,10,408,34299.0,20.0,12.0
0.041,17,2,152,1,76,0.0,48.0,48.0,1,76,0.0,48.0,48.0
0.013,6,10,1762,5,911,3.0,643.0,643.0,5,851,3.0,583.0,583.0
0.01,6,10,1989,5,910,2.0,642.0,642.0,5,1079,2.0,811.0,811.0
0.004,17,2,148,1,60,0.0,32.0,32.0,1,88,0.0,60.0,60.0
0.006,6,10,1547,5,764,1.0,496.0,496.0,5,783,1.0,515.0,515.0
0.13,6,10,1506,5,395,25.0,127.0,127.0,5,1111,28.0,843.0,843.0
0.841,6,10,2009,6,1655,168.0,1403.0,1403.0,4,354,197.0,182.0,182.0
40.063,17,10,676,5,460,10015.0,104.0,64.0,5,216,10014.0,20.0,15.0
0.006,6,10,1643,5,860,1.0,592.0,592.0,5,783,1.0,515.0,515.0
0.005,17,2,154,1,69,0.0,41.0,41.0,1,85,0.0,57.0,57.0
0.114,6,10,1506,5,395,24.0,127.0,127.0,5,1111,23.0,843.0,843.0
352.276,6,20,2210,6,1308,12003.0,494.0,494.0,14,902,27097.0,83.0,83.0
0.005,6,10,2006,5,927,1.0,659.0,659.0,5,1079,1.0,811.0,811.0
0.022,6,10,1989,5,910,5.0,642.0,642.0,5,1079,5.0,811.0,811.0
0.005,6,10,1643,5,860,1.0,592.0,592.0,5,783,1.0,515.0,515.0
0.014,6,10,1972,5,910,3.0,642.0,642.0,5,1062,3.0,794.0,794.0
0.009,6,10,1972,5,910,2.0,642.0,642.0,5,1062,2.0,794.0,794.0
0.007,17,2,186,1,61,0.0,33.0,33.0,1,125,0.0,97.0,97.0
0.006,6,10,2007,5,928,1.0,660.0,660.0,5,1079,1.0,811.0,811.0
40.084,17,10,676,5,460,10016.0,104.0,64.0,5,216,10019.0,20.0,15.0
0.005,6,10,2000,5,927,1.0,659.0,659.0,5,1073,1.0,805.0,805.0
0.129,17,2,80,1,32,0.0,4.0,4.0,1,48,0.0,20.0,20.0
0.006,6,10,1547,5,764,1.0,496.0,496.0,5,783,1.0,515.0,515.0
0.073,6,10,1506,5,395,15.0,127.0,127.0,5,1111,16.0,843.0,843.0
0.088,6,10,1506,5,395,21.0,127.0,127.0,5,1111,17.0,843.0,843.0
0.013,6,10,1762,5,911,3.0,643.0,643.0,5,851,3.0,583.0,583.0
0.096,6,10,1506,5,395,21.0,127.0,127.0,5,1111,20.0,843.0,843.0
10.876,17,28,4423,14,1994,827.0,269.0,114.0,14,2429,827.0,588.0,145.0
0.005,6,10,1779,5,928,1.0,660.0,660.0,5,851,1.0,583.0,583.0
0.001,17,2,180,1,66,0.0,38.0,38.0,1,114,0.0,86.0,86.0
0.006,6,10,1547,5,764,1.0,496.0,496.0,5,783,1.0,515.0,515.0
0.011,6,10,1989,5,910,2.0,642.0,642.0,5,1079,2.0,811.0,811.0
0.017,6,10,1989,5,910,4.0,642.0,642.0,5,1079,4.0,811.0,811.0
0.009,17,2,144,1,64,0.0,36.0,36.0,1,80,0.0,52.0,52.0
0.01,6,10,1972,5,910,2.0,642.0,642.0,5,1062,2.0,794.0,794.0
0.01,6,10,1972,5,910,2.0,642.0,642.0,5,1062,2.0,794.0,794.0
0.102,6,10,1506,5,395,22.0,127.0,127.0,5,1111,23.0,843.0,843.0
176.288,17,74,10653,37,2466,4896.0,44.0,38.0,37,8187,4896.0,239.0,193.0
0.102,6,10,1506,5,395,25.0,127.0,127.0,5,1111,22.0,843.0,843.0
0.077,6,10,1506,5,395,18.0,127.0,127.0,5,1111,16.0,843.0,843.0
10.825,17,28,4424,14,1995,823.0,270.0,114.0,14,2429,823.0,588.0,145.0
0.084,6,10,1506,5,395,18.0,127.0,127.0,5,1111,19.0,843.0,843.0
0.006,6,10,1547,5,764,1.0,496.0,496.0,5,783,1.0,515.0,515.0
0.004,6,10,1774,5,923,1.0,655.0,655.0,5,851,1.0,583.0,583.0
0.005,6,10,2006,5,927,1.0,659.0,659.0,5,1079,1.0,811.0,811.0
40.11,17,10,676,5,460,10025.0,104.0,64.0,5,216,10026.0,20.0,15.0
240.015,6,9,787,5,488,60003.0,232.0,232.0,4,299,80004.0,83.0,83.0
0.005,6,13,3747,7,509,0.0,137.0,137.0,6,3238,0.0,1470.0,1459.0
0.005,6,10,2006,5,927,1.0,659.0,659.0,5,1079,1.0,811.0,811.0
0.006,6,10,1547,5,764,1.0,496.0,496.0,5,783,1.0,515.0,515.0
0.006,17,2,144,1,64,0.0,36.0,36.0,1,80,0.0,52.0,52.0
0.006,6,10,1547,5,764,1.0,496.0,496.0,5,783,1.0,515.0,515.0
0.012,17,2,299,1,65,0.0,37.0,37.0,1,234,0.0,206.0,206.0
0.013,6,10,2000,5,927,3.0,659.0,659.0,5,1073,3.0,805.0,805.0
0.071,6,10,1506,5,395,16.0,127.0,127.0,5,1111,14.0,843.0,843.0
40.055,17,10,676,5,460,10011.0,104.0,64.0,5,216,10013.0,20.0,15.0
177.198,17,70,9805,35,2322,5211.0,44.0,38.0,35,7483,5211.0,239.0,185.0
0.006,6,10,1689,5,839,1.0,571.0,571.0,5,850,1.0,582.0,582.0
0.116,6,10,1506,5,395,27.0,127.0,127.0,5,1111,23.0,843.0,843.0
0.04,17,2,412,1,61,0.0,33.0,33.0,1,351,0.0,323.0,323.0
0.012,6,10,1972,5,910,3.0,642.0,642.0,5,1062,3.0,794.0,794.0
0.018,6,10,1972,5,910,4.0,642.0,642.0,5,1062,4.0,794.0,794.0
0.004,17,4,284,2,120,0.0,32.0,32.0,2,164,0.0,60.0,54.0
353.597,6,20,2210,6,1308,12003.0,494.0,494.0,14,902,27199.0,83.0,83.0
0.005,6,10,2006,5,927,1.0,659.0,659.0,5,1079,1.0,811.0,811.0
0.005,6,10,1702,5,863,1.0,595.0,595.0,5,839,1.0,571.0,571.0
0.008,17,2,194,1,59,0.0,31.0,31.0,1,135,0.0,107.0,107.0
0.03,6,10,1972,5,910,7.0,642.0,642.0,5,1062,7.0,794.0,794.0
0.006,6,10,1689,5,839,1.0,571.0,571.0,5,850,1.0,582.0,582.0
0.001,17,2,180,1,66,0.0,38.0,38.0,1,114,0.0,86.0,86.0
48.712,6,37,10002,19,4484,498.0,1360.0,738.0,18,5518,2855.0,2667.0,435.0
0.277,17,45,27556,26,24370,11.0,1350.0,909.0,19,3186,12.0,1350.0,139.0
0.005,6,10,2007,5,928,1.0,660.0,660.0,5,1079,1.0,811.0,811.0
0.008,6,12,1926,6,1189,1.0,659.0,434.0,6,737,1.0,417.0,417.0
240.018,6,9,787,5,488,60004.0,232.0,232.0,4,299,80005.0,83.0,83.0
0.004,6,10,2006,5,927,1.0,659.0,659.0,5,1079,1.0,811.0,811.0
0.015,6,10,1989,5,910,3.0,642.0,642.0,5,1079,3.0,811.0,811.0
0.005,17,2,166,1,75,0.0,47.0,47.0,1,91,0.0,63.0,63.0
0.008,6,12,1926,6,1189,1.0,659.0,434.0,6,737,1.0,417.0,417.0
0.008,6,10,1983,5,910,2.0,642.0,642.0,5,1073,2.0,805.0,805.0
65.629,6,36,6441,20,1430,3454.0,267.0,195.0,16,5011,575.0,1823.0,363.0
0.009,6,10,1972,5,910,2.0,642.0,642.0,5,1062,2.0,794.0,794.0
0.004,17,2,136,1,60,0.0,32.0,32.0,1,76,0.0,48.0,48.0
40.06,17,10,676,5,460,10012.0,104.0,64.0,5,216,10012.0,20.0,15.0
0.15,6,10,1506,5,395,35.0,127.0,127.0,5,1111,36.0,843.0,843.0
0.001,17,2,180,1,66,0.0,38.0,38.0,1,114,0.0,86.0,86.0
0.032,6,10,1677,5,827,7.0,559.0,559.0,5,850,7.0,582.0,582.0
0.011,6,10,1983,5,910,2.0,642.0,642.0,5,1073,2.0,805.0,805.0
240.098,6,16,4480,9,963,30012.0,238.0,166.0,7,3517,40015.0,1402.0,786.0
0.004,6,10,2006,5,927,1.0,659.0,659.0,5,1079,1.0,811.0,811.0
0.119,6,10,1506,5,395,27.0,127.0,127.0,5,1111,25.0,843.0,843.0
0.009,6,10,1689,5,839,2.0,571.0,571.0,5,850,2.0,582.0,582.0
0.075,6,10,1506,5,395,16.0,127.0,127.0,5,1111,16.0,843.0,843.0
0.005,6,13,3690,7,452,0.0,80.0,80.0,6,3238,1.0,1470.0,1459.0
0.008,6,10,1972,5,910,2.0,642.0,642.0,5,1062,2.0,794.0,794.0
306.136,6,16,1986,4,1196,4636.0,494.0,494.0,12,790,27830.0,83.0,83.0
0.322,17,17,11353,9,8295,40.0,1350.0,893.0,8,3058,39.0,1350.0,354.0
0.032,6,10,1677,5,827,8.0,559.0,559.0,5,850,7.0,582.0,582.0
0.006,6,10,1689,5,839,1.0,571.0,571.0,5,850,1.0,582.0,582.0
0.017,6,10,1989,5,910,4.0,642.0,642.0,5,1079,4.0,811.0,811.0
0.005,6,10,2000,5,927,1.0,659.0,659.0,5,1073,1.0,805.0,805.0
0.017,6,10,1989,5,910,4.0,642.0,642.0,5,1079,4.0,811.0,811.0
0.089,6,10,1506,5,395,18.0,127.0,127.0,5,1111,19.0,843.0,843.0
0.012,6,10,1989,5,910,3.0,642.0,642.0,5,1079,3.0,811.0,811.0
0.005,6,10,2000,5,927,1.0,659.0,659.0,5,1073,1.0,805.0,805.0
0.005,6,10,2006,5,927,1.0,659.0,659.0,5,1079,1.0,811.0,811.0
0.004,17,2,170,1,65,0.0,37.0,37.0,1,105,0.0,77.0,77.0
0.044,17,2,169,1,62,0.0,34.0,34.0,1,107,0.0,79.0,79.0
0.013,6,10,1972,5,910,3.0,642.0,642.0,5,1062,3.0,794.0,794.0
361.763,6,21,1793,16,1030,24117.0,190.0,190.0,5,763,60009.0,462.0,247.0
0.777,6,25,5555,12,1445,59.0,267.0,136.0,13,4110,54.0,1414.0,597.0
0.094,6,10,1506,5,395,21.0,127.0,127.0,5,1111,17.0,843.0,843.0
0.001,17,2,174,1,72,0.0,44.0,44.0,1,102,0.0,74.0,74.0
0.009,6,13,3735,7,497,1.0,125.0,125.0,6,3238,1.0,1470.0,1459.0
291.811,6,373,346752,194,21649,1511.0,2736.0,888.0,179,325103,1639.0,4206.0,1902.0
0.004,17,4,420,2,122,0.0,33.0,33.0,2,298,1.0,145.0,121.0
0.263,17,17,9190,8,6527,37.0,1350.0,787.0,9,2663,22.0,1350.0,267.0
0.005,6,10,2007,5,928,1.0,660.0,660.0,5,1079,1.0,811.0,811.0
0.011,6,13,3735,7,497,1.0,125.0,125.0,6,3238,2.0,1470.0,1459.0
0.072,17,4,284,2,120,0.0,32.0,32.0,2,164,68.0,60.0,54.0
308.381,17,20,1124,10,716,34257.0,48.0,43.0,10,408,34257.0,20.0,12.0
0.008,6,10,1972,5,910,2.0,642.0,642.0,5,1062,2.0,794.0,794.0
0.005,6,10,2006,5,927,1.0,659.0,659.0,5,1079,1.0,811.0,811.0
0.027,6,10,1990,5,911,6.0,643.0,643.0,5,1079,6.0,811.0,811.0
0.005,6,10,2000,5,927,1.0,659.0,659.0,5,1073,1.0,805.0,805.0
0.007,6,10,1689,5,839,1.0,571.0,571.0,5,850,1.0,582.0,582.0
0.009,6,12,1926,6,1189,1.0,659.0,434.0,6,737,1.0,417.0,417.0
15.526,17,62,38916,35,32716,455.0,1350.0,906.0,27,6200,596.0,1350.0,201.0
0.005,6,10,2006,5,927,1.0,659.0,659.0,5,1079,1.0,811.0,811.0
0.004,6,10,2000,5,927,1.0,659.0,659.0,5,1073,1.0,805.0,805.0
0.013,6,10,1972,5,910,3.0,642.0,642.0,5,1062,3.0,794.0,794.0
0.011,6,10,1972,5,910,2.0,642.0,642.0,5,1062,2.0,794.0,794.0
0.005,6,10,1774,5,923,1.0,655.0,655.0,5,851,1.0,583.0,583.0
0.006,6,10,1547,5,764,1.0,496.0,496.0,5,783,1.0,515.0,515.0
0.009,6,12,1926,6,1189,1.0,659.0,434.0,6,737,1.0,417.0,417.0
0.019,6,10,1990,5,911,4.0,643.0,643.0,5,1079,4.0,811.0,811.0
0.004,6,10,1702,5,863,1.0,595.0,595.0,5,839,0.0,571.0,571.0
11.09,17,28,4398,14,2311,844.0,586.0,137.0,14,2087,844.0,270.0,121.0
0.099,6,10,1506,5,395,23.0,127.0,127.0,5,1111,19.0,843.0,843.0
0.014,6,10,1983,5,910,3.0,642.0,642.0,5,1073,3.0,805.0,805.0
0.016,6,10,1989,5,910,3.0,642.0,642.0,5,1079,4.0,811.0,811.0
300.39,6,16,2170,9,684,37528.0,146.0,146.0,7,1486,50038.0,419.0,398.0
0.092,6,10,1506,5,395,19.0,127.0,127.0,5,1111,21.0,843.0,843.0
0.011,6,10,1631,5,848,2.0,580.0,580.0,5,783,2.0,515.0,515.0
0.013,6,10,1762,5,911,3.0,643.0,643.0,5,851,3.0,583.0,583.0
0.147,6,10,1506,5,395,33.0,127.0,127.0,5,1111,33.0,843.0,843.0
0.071,6,10,1506,5,395,15.0,127.0,127.0,5,1111,16.0,843.0,843.0
0.006,6,10,1689,5,839,1.0,571.0,571.0,5,850,1.0,582.0,582.0
0.006,6,10,2000,5,927,1.0,659.0,659.0,5,1073,1.0,805.0,805.0
0.004,17,2,152,1,76,0.0,48.0,48.0,1,76,0.0,48.0,48.0
0.09,6,10,1506,5,395,18.0,127.0,127.0,5,1111,20.0,843.0,843.0
0.005,6,10,1779,5,928,1.0,660.0,660.0,5,851,1.0,583.0,583.0
0.005,17,2,170,1,65,0.0,37.0,37.0,1,105,0.0,77.0,77.0
0.001,17,2,180,1,66,0.0,38.0,38.0,1,114,0.0,86.0,86.0
0.124,17,2,148,1,60,0.0,32.0,32.0,1,88,0.0,60.0,60.0
0.063,6,10,1506,5,395,15.0,127.0,127.0,5,1111,14.0,843.0,843.0
0.162,17,2,152,1,76,0.0,48.0,48.0,1,76,0.0,48.0,48.0
0.011,6,10,1972,5,910,2.0,642.0,642.0,5,1062,2.0,794.0,794.0
0.005,17,2,140,1,62,0.0,34.0,34.0,1,78,0.0,50.0,50.0
0.004,17,2,136,1,60,0.0,32.0,32.0,1,76,0.0,48.0,48.0
0.055,6,10,1506,5,395,13.0,127.0,127.0,5,1111,13.0,843.0,843.0
0.004,6,10,2006,5,927,1.0,659.0,659.0,5,1079,1.0,811.0,811.0
0.013,6,10,1989,5,910,3.0,642.0,642.0,5,1079,3.0,811.0,811.0
0.013,6,10,1983,5,910,3.0,642.0,642.0,5,1073,3.0,805.0,805.0
0.005,6,10,2000,5,927,1.0,659.0,659.0,5,1073,1.0,805.0,805.0
0.005,17,2,166,1,75,0.0,47.0,47.0,1,91,0.0,63.0,63.0
178.188,17,74,10411,37,2464,4949.0,44.0,38.0,37,7947,4949.0,261.0,186.0
0.002,17,2,136,1,60,0.0,32.0,32.0,1,76,0.0,48.0,48.0
0.006,6,10,2006,5,927,1.0,659.0,659.0,5,1079,1.0,811.0,811.0
0.149,6,10,1506,5,395,31.0,127.0,127.0,5,1111,36.0,843.0,843.0
0.011,6,10,1989,5,910,2.0,642.0,642.0,5,1079,2.0,811.0,811.0
0.071,17,4,284,2,120,0.0,32.0,32.0,2,164,30.0,60.0,54.0
0.005,6,10,2000,5,927,1.0,659.0,659.0,5,1073,1.0,805.0,805.0
0.086,6,10,1506,5,395,18.0,127.0,127.0,5,1111,17.0,843.0,843.0
0.008,6,12,1926,6,1189,1.0,659.0,434.0,6,737,1.0,417.0,417.0
0.016,6,10,1989,5,910,4.0,642.0,642.0,5,1079,3.0,811.0,811.0
10.821,17,28,4423,14,1994,823.0,269.0,114.0,14,2429,823.0,588.0,145.0
0.003,17,2,136,1,60,0.0,32.0,32.0,1,76,0.0,48.0,48.0
0.005,6,10,2000,5,927,1.0,659.0,659.0,5,1073,1.0,805.0,805.0
0.013,6,10,1972,5,910,3.0,642.0,642.0,5,1062,3.0,794.0,794.0
0.004,6,10,2006,5,927,1.0,659.0,659.0,5,1079,1.0,811.0,811.0
0.001,17,2,180,1,66,0.0,38.0,38.0,1,114,0.0,86.0,86.0
0.018,6,10,1762,5,911,4.0,643.0,643.0,5,851,4.0,583.0,583.0
0.005,17,2,187,1,71,0.0,43.0,43.0,1,116,0.0,88.0,88.0
0.077,6,10,1506,5,395,17.0,127.0,127.0,5,1111,17.0,843.0,843.0
0.008,6,10,1972,5,910,2.0,642.0,642.0,5,1062,1.0,794.0,794.0
0.004,17,4,284,2,120,0.0,32.0,32.0,2,164,0.0,60.0,54.0
0.01,6,10,1972,5,910,2.0,642.0,642.0,5,1062,2.0,794.0,794.0
0.004,6,10,1702,5,863,1.0,595.0,595.0,5,839,1.0,571.0,571.0
369.511,6,22,2313,16,867,24634.0,195.0,195.0,6,1446,4636.0,419.0,398.0
367.007,6,22,2313,16,867,24467.0,195.0,195.0,6,1446,4636.0,419.0,398.0
0.073,17,4,284,2,120,0.0,32.0,32.0,2,164,70.0,60.0,54.0
0.023,6,10,1989,5,910,5.0,642.0,642.0,5,1079,5.0,811.0,811.0
0.178,6,43,13634,20,8535,9.0,2885.0,747.0,23,5099,7.0,1586.0,432.0
0.004,17,4,284,2,120,0.0,32.0,32.0,2,164,1.0,60.0,54.0
0.068,17,8,3613,4,1874,22.0,1350.0,440.0,4,1739,11.0,1350.0,406.0
0.01,17,2,162,1,65,0.0,37.0,37.0,1,97,0.0,69.0,69.0
0.001,17,2,180,1,66,0.0,38.0,38.0,1,114,0.0,86.0,86.0
0.005,6,10,1989,5,927,1.0,659.0,659.0,5,1062,1.0,794.0,794.0
5.085,6,22,5975,13,1488,423.0,474.0,201.0,9,4487,635.0,1925.0,804.0
0.005,6,10,2007,5,928,1.0,660.0,660.0,5,1079,1.0,811.0,811.0
0.017,6,10,1989,5,910,4.0,642.0,642.0,5,1079,4.0,811.0,811.0
0.001,17,2,180,1,66,0.0,38.0,38.0,1,114,0.0,86.0,86.0
0.001,17,2,180,1,66,0.0,38.0,38.0,1,114,0.0,86.0,86.0
0.074,17,2,184,1,61,0.0,33.0,33.0,1,123,0.0,95.0,95.0
0.004,6,10,1774,5,923,1.0,655.0,655.0,5,851,1.0,583.0,583.0
11.081,17,28,4423,14,1995,840.0,270.0,114.0,14,2428,840.0,587.0,145.0
0.007,17,2,170,1,65,0.0,37.0,37.0,1,105,0.0,77.0,77.0
0.004,6,10,2007,5,928,1.0,660.0,660.0,5,1079,1.0,811.0,811.0
0.008,6,10,1989,5,927,2.0,659.0,659.0,5,1062,2.0,794.0,794.0
0.009,6,10,1990,5,911,2.0,643.0,643.0,5,1079,2.0,811.0,811.0
0.005,17,2,170,1,65,0.0,37.0,37.0,1,105,0.0,77.0,77.0
0.005,6,10,1779,5,928,1.0,660.0,660.0,5,851,1.0,583.0,583.0
0.002,17,2,136,1,60,0.0,32.0,32.0,1,76,0.0,48.0,48.0
0.04,17,4,284,2,120,0.0,32.0,32.0,2,164,37.0,60.0,54.0
0.009,6,10,2006,5,927,2.0,659.0,659.0,5,1079,2.0,811.0,811.0
0.115,6,10,1506,5,395,27.0,127.0,127.0,5,1111,27.0,843.0,843.0
0.042,17,2,184,1,61,0.0,33.0,33.0,1,123,0.0,95.0,95.0
0.017,6,10,1972,5,910,4.0,642.0,642.0,5,1062,4.0,794.0,794.0
0.011,6,10,1762,5,911,2.0,643.0,643.0,5,851,2.0,583.0,583.0
0.1,6,10,1506,5,395,22.0,127.0,127.0,5,1111,22.0,843.0,843.0
0.012,6,10,1989,5,910,3.0,642.0,642.0,5,1079,3.0,811.0,811.0
40.054,17,10,676,5,460,10012.0,104.0,64.0,5,216,10012.0,20.0,15.0
0.005,6,10,2006,5,927,1.0,659.0,659.0,5,1079,1.0,811.0,811.0
0.005,17,2,179,1,71,0.0,43.0,43.0,1,108,0.0,80.0,80.0
240.086,6,16,4482,9,963,30010.0,238.0,166.0,7,3519,40013.0,1402.0,786.0
0.013,6,13,3735,7,497,2.0,125.0,125.0,6,3238,2.0,1470.0,1459.0
0.087,6,10,1506,5,395,19.0,127.0,127.0,5,1111,19.0,843.0,843.0
0.005,6,10,2006,5,927,1.0,659.0,659.0,5,1079,1.0,811.0,811.0
0.005,6,10,2007,5,928,1.0,660.0,660.0,5,1079,1.0,811.0,811.0
0.177,17,2,152,1,76,0.0,48.0,48.0,1,76,0.0,48.0,48.0
0.104,6,10,1506,5,395,22.0,127.0,127.0,5,1111,23.0,843.0,843.0
0.01,6,10,1631,5,848,2.0,580.0,580.0,5,783,2.0,515.0,515.0
0.103,6,10,1506,5,395,24.0,127.0,127.0,5,1111,24.0,843.0,843.0
0.005,6,10,1547,5,764,1.0,496.0,496.0,5,783,1.0,515.0,515.0
0.005,17,2,169,1,62,0.0,34.0,34.0,1,107,0.0,79.0,79.0
0.005,6,10,2006,5,927,1.0,659.0,659.0,5,1079,1.0,811.0,811.0
0.001,17,2,166,1,75,0.0,47.0,47.0,1,91,0.0,63.0,63.0
0.047,17,4,284,2,120,0.0,32.0,32.0,2,164,36.0,60.0,54.0
0.003,6,10,1702,5,863,0.0,595.0,595.0,5,839,0.0,571.0,571.0
0.013,17,2,152,1,56,0.0,28.0,28.0,1,96,0.0,68.0,68.0
0.005,6,10,2006,5,927,1.0,659.0,659.0,5,1079,1.0,811.0,811.0
0.003,17,2,136,1,60,0.0,32.0,32.0,1,76,0.0,48.0,48.0
0.006,6,10,1779,5,928,1.0,660.0,660.0,5,851,1.0,583.0,583.0
240.088,6,31,9274,15,6896,17149.0,2021.0,680.0,16,2378,16005.0,580.0,192.0
0.041,17,2,412,1,61,0.0,33.0,33.0,1,351,0.0,323.0,323.0
0.004,6,10,2007,5,928,1.0,660.0,660.0,5,1079,1.0,811.0,811.0
0.012,6,10,1762,5,911,3.0,643.0,643.0,5,851,3.0,583.0,583.0
0.005,6,10,2000,5,927,1.0,659.0,659.0,5,1073,1.0,805.0,805.0
0.106,6,10,1506,5,395,24.0,127.0,127.0,5,1111,24.0,843.0,843.0
40.057,17,10,676,5,460,10012.0,104.0,64.0,5,216,10013.0,20.0,15.0
0.097,6,10,1506,5,395,20.0,127.0,127.0,5,1111,21.0,843.0,843.0
0.008,17,2,194,1,59,0.0,31.0,31.0,1,135,0.0,107.0,107.0
0.005,6,10,2007,5,928,1.0,660.0,660.0,5,1079,1.0,811.0,811.0
0.036,17,2,152,1,76,0.0,48.0,48.0,1,76,0.0,48.0,48.0
0.005,6,10,1779,5,928,1.0,660.0,660.0,5,851,1.0,583.0,583.0
0.004,17,2,222,1,65,0.0,37.0,37.0,1,157,0.0,129.0,129.0
240.092,6,16,4482,9,963,30011.0,238.0,166.0,7,3519,40014.0,1402.0,786.0
40.07,17,10,676,5,460,10015.0,104.0,64.0,5,216,10016.0,20.0,15.0
0.015,6,10,1990,5,911,3.0,643.0,643.0,5,1079,3.0,811.0,811.0
0.114,6,10,1506,5,395,26.0,127.0,127.0,5,1111,25.0,843.0,843.0
0.692,6,22,5072,11,1250,58.0,325.0,133.0,11,3822,58.0,1414.0,563.0
31.374,6,28,9605,14,1707,2413.0,794.0,367.0,14,7898,2403.0,1360.0,732.0
0.006,6,10,2007,5,928,1.0,660.0,660.0,5,1079,1.0,811.0,811.0
0.005,6,10,1779,5,928,1.0,660.0,660.0,5,851,1.0,583.0,583.0
1749.212,6,65,7408,43,4533,41647.0,1625.0,108.0,22,2875,83287.0,1111.0,82.0
0.013,6,10,1972,5,910,3.0,642.0,642.0,5,1062,3.0,794.0,794.0
0.019,6,10,1989,5,910,4.0,642.0,642.0,5,1079,4.0,811.0,811.0
0.005,6,10,1702,5,863,1.0,595.0,595.0,5,839,1.0,571.0,571.0
0.005,6,10,2006,5,927,1.0,659.0,659.0,5,1079,1.0,811.0,811.0
0.016,6,10,1989,5,910,4.0,642.0,642.0,5,1079,3.0,811.0,811.0
173.337,17,78,11005,39,2600,4561.0,44.0,38.0,39,8405,4561.0,252.0,187.0
0.021,6,10,1677,5,827,5.0,559.0,559.0,5,850,5.0,582.0,582.0
0.175,17,2,152,1,76,0.0,48.0,48.0,1,76,0.0,48.0,48.0
0.011,6,10,1972,5,910,2.0,642.0,642.0,5,1062,2.0,794.0,794.0
1.54,6,37,6775,19,3451,85.0,1103.0,204.0,18,3324,86.0,1402.0,340.0
0.005,6,10,2006,5,927,1.0,659.0,659.0,5,1079,1.0,811.0,811.0
0.005,6,10,2000,5,927,1.0,659.0,659.0,5,1073,1.0,805.0,805.0
0.006,6,10,1689,5,839,1.0,571.0,571.0,5,850,1.0,582.0,582.0
0.089,6,10,1506,5,395,19.0,127.0,127.0,5,1111,19.0,843.0,843.0
0.011,6,10,1989,5,910,2.0,642.0,642.0,5,1079,2.0,811.0,811.0
0.005,17,2,169,1,62,0.0,34.0,34.0,1,107,0.0,79.0,79.0
0.07,6,10,1506,5,395,15.0,127.0,127.0,5,1111,13.0,843.0,843.0
0.008,6,10,1972,5,910,2.0,642.0,642.0,5,1062,1.0,794.0,794.0
10.823,17,28,4420,14,1993,824.0,268.0,114.0,14,2427,824.0,586.0,145.0
0.079,6,10,1506,5,395,18.0,127.0,127.0,5,1111,16.0,843.0,843.0
0.018,6,10,1972,5,910,4.0,642.0,642.0,5,1062,4.0,794.0,794.0
0.017,6,10,1989,5,910,4.0,642.0,642.0,5,1079,4.0,811.0,811.0
0.007,6,10,1689,5,839,1.0,571.0,571.0,5,850,1.0,582.0,582.0
0.001,17,2,180,1,66,0.0,38.0,38.0,1,114,0.0,86.0,86.0
0.009,6,10,1989,5,910,2.0,642.0,642.0,5,1079,2.0,811.0,811.0
11.426,17,28,4398,14,2312,866.0,587.0,137.0,14,2086,866.0,269.0,121.0
0.005,6,14,3736,7,446,0.0,74.0,74.0,7,3290,0.0,1448.0,972.0
0.001,17,2,180,1,66,0.0,38.0,38.0,1,114,0.0,86.0,86.0
0.017,6,10,1989,5,910,4.0,642.0,642.0,5,1079,4.0,811.0,811.0
0.003,17,2,136,1,60,0.0,32.0,32.0,1,76,0.0,48.0,48.0
240.013,6,9,787,5,488,60003.0,232.0,232.0,4,299,80003.0,83.0,83.0
0.005,17,2,170,1,65,0.0,37.0,37.0,1,105,0.0,77.0,77.0
0.074,6,10,1506,5,395,18.0,127.0,127.0,5,1111,17.0,843.0,843.0
0.005,6,10,1643,5,860,1.0,592.0,592.0,5,783,1.0,515.0,515.0
30.809,6,17,6879,9,689,3851.0,209.0,209.0,8,6190,4400.0,1402.0,1153.0
0.098,6,10,1506,5,395,20.0,127.0,127.0,5,1111,20.0,843.0,843.0
0.013,6,10,1983,5,910,3.0,642.0,642.0,5,1073,3.0,805.0,805.0
0.114,6,10,1506,5,395,25.0,127.0,127.0,5,1111,27.0,843.0,843.0
0.012,6,10,1972,5,910,2.0,642.0,642.0,5,1062,3.0,794.0,794.0
0.694,6,22,5072,11,1250,61.0,325.0,133.0,11,3822,58.0,1414.0,563.0
0.015,6,10,1990,5,911,3.0,643.0,643.0,5,1079,3.0,811.0,811.0
0.004,17,2,148,1,60,0.0,32.0,32.0,1,88,0.0,60.0,60.0
40.073,17,10,676,5,460,10014.0,104.0,64.0,5,216,10017.0,20.0,15.0
0.014,6,10,1689,5,839,3.0,571.0,571.0,5,850,3.0,582.0,582.0
0.009,6,10,1983,5,910,2.0,642.0,642.0,5,1073,2.0,805.0,805.0
0.005,6,10,1989,5,927,1.0,659.0,659.0,5,1062,1.0,794.0,794.0
0.073,6,10,1506,5,395,14.0,127.0,127.0,5,1111,16.0,843.0,843.0
0.006,6,10,2007,5,928,1.0,660.0,660.0,5,1079,1.0,811.0,811.0
0.007,17,2,179,1,71,0.0,43.0,43.0,1,108,0.0,80.0,80.0
0.01,6,10,1677,5,827,2.0,559.0,559.0,5,850,2.0,582.0,582.0
0.002,17,2,136,1,60,0.0,32.0,32.0,1,76,0.0,48.0,48.0
0.005,6,10,2006,5,927,1.0,659.0,659.0,5,1079,1.0,811.0,811.0
0.005,6,10,2007,5,928,1.0,660.0,660.0,5,1079,1.0,811.0,811.0
0.011,6,10,1989,5,910,2.0,642.0,642.0,5,1079,2.0,811.0,811.0
0.006,6,10,1643,5,860,1.0,592.0,592.0,5,783,1.0,515.0,515.0
0.005,17,2,168,1,76,0.0,48.0,48.0,1,92,0.0,64.0,64.0
0.011,6,10,1989,5,910,2.0,642.0,642.0,5,1079,2.0,811.0,811.0
0.001,17,2,180,1,66,0.0,38.0,38.0,1,114,0.0,86.0,86.0
319.659,17,20,1124,10,716,35504.0,48.0,43.0,10,408,35504.0,20.0,12.0
0.009,6,10,1983,5,910,2.0,642.0,642.0,5,1073,2.0,805.0,805.0
0.005,6,10,2006,5,927,1.0,659.0,659.0,5,1079,1.0,811.0,811.0
0.012,6,10,1990,5,911,3.0,643.0,643.0,5,1079,3.0,811.0,811.0
0.179,6,10,1506,5,395,42.0,127.0,127.0,5,1111,42.0,843.0,843.0
40.071,17,10,676,5,460,10016.0,104.0,64.0,5,216,10016.0,20.0,15.0
0.005,6,10,2007,5,928,1.0,660.0,660.0,5,1079,1.0,811.0,811.0
0.015,6,10,1990,5,911,3.0,643.0,643.0,5,1079,3.0,811.0,811.0
0.01,6,10,1989,5,927,2.0,659.0,659.0,5,1062,2.0,794.0,794.0
0.005,6,13,3690,7,452,0.0,80.0,80.0,6,3238,1.0,1470.0,1459.0
0.753,6,22,5072,11,1250,64.0,325.0,133.0,11,3822,64.0,1414.0,563.0
291.451,6,315,343514,114,17489,2579.0,2736.0,889.0,201,326025,1457.0,2804.0,1687.0
0.005,6,10,2006,5,927,1.0,659.0,659.0,5,1079,1.0,811.0,811.0
0.016,6,10,1989,5,910,4.0,642.0,642.0,5,1079,3.0,811.0,811.0
0.014,6,10,1989,5,910,3.0,642.0,642.0,5,1079,3.0,811.0,811.0
0.015,6,10,1972,5,910,3.0,642.0,642.0,5,1062,3.0,794.0,794.0
0.037,17,4,284,2,120,0.0,32.0,32.0,2,164,34.0,60.0,54.0
0.006,17,2,293,1,73,0.0,45.0,45.0,1,220,0.0,192.0,192.0
0.004,6,10,2007,5,928,1.0,660.0,660.0,5,1079,1.0,811.0,811.0
0.015,6,10,1990,5,911,3.0,643.0,643.0,5,1079,3.0,811.0,811.0
0.005,6,10,2000,5,927,1.0,659.0,659.0,5,1073,1.0,805.0,805.0
0.145,6,10,1506,5,395,33.0,127.0,127.0,5,1111,35.0,843.0,843.0
0.006,6,10,1643,5,860,1.0,592.0,592.0,5,783,1.0,515.0,515.0
0.015,6,10,1631,5,848,3.0,580.0,580.0,5,783,3.0,515.0,515.0
0.004,6,10,1702,5,863,1.0,595.0,595.0,5,839,0.0,571.0,571.0
0.006,6,10,1854,5,889,1.0,621.0,621.0,5,965,1.0,697.0,697.0
0.164,17,2,152,1,76,0.0,48.0,48.0,1,76,0.0,48.0,48.0
0.078,6,10,1506,5,395,17.0,127.0,127.0,5,1111,16.0,843.0,843.0
0.003,17,4,284,2,120,0.0,32.0,32.0,2,164,0.0,60.0,54.0
0.004,17,2,136,1,60,0.0,32.0,32.0,1,76,0.0,48.0,48.0
0.006,6,10,1547,5,764,1.0,496.0,496.0,5,783,1.0,515.0,515.0
40.067,17,10,676,5,460,10014.0,104.0,64.0,5,216,10014.0,20.0,15.0
0.0,17,2,142,1,63,0.0,35.0,35.0,1,79,0.0,51.0,51.0
0.104,6,10,1506,5,395,22.0,127.0,127.0,5,1111,22.0,843.0,843.0
0.108,6,10,1506,5,395,21.0,127.0,127.0,5,1111,23.0,843.0,843.0
40.059,17,10,676,5,460,10013.0,104.0,64.0,5,216,10011.0,20.0,15.0
0.005,17,2,157,1,59,0.0,31.0,31.0,1,98,0.0,70.0,70.0
0.005,17,2,166,1,75,0.0,47.0,47.0,1,91,0.0,63.0,63.0
0.005,17,2,214,1,75,0.0,47.0,47.0,1,139,0.0,111.0,111.0
0.012,6,10,1990,5,911,3.0,643.0,643.0,5,1079,2.0,811.0,811.0
0.005,17,2,214,1,75,0.0,47.0,47.0,1,139,0.0,111.0,111.0
0.008,6,10,1689,5,839,1.0,571.0,571.0,5,850,2.0,582.0,582.0
0.027,17,2,166,1,75,0.0,47.0,47.0,1,91,0.0,63.0,63.0
0.006,6,10,1989,5,927,1.0,659.0,659.0,5,1062,1.0,794.0,794.0
0.103,6,10,1506,5,395,22.0,127.0,127.0,5,1111,22.0,843.0,843.0
240.21,6,24,4126,11,1756,24020.0,539.0,235.0,13,2370,20017.0,1324.0,242.0
0.005,6,10,1779,5,928,1.0,660.0,660.0,5,851,1.0,583.0,583.0
0.004,6,10,1989,5,927,1.0,659.0,659.0,5,1062,1.0,794.0,794.0
0.005,6,10,1689,5,839,1.0,571.0,571.0,5,850,1.0,582.0,582.0
0.005,17,2,180,1,58,0.0,30.0,30.0,1,122,0.0,94.0,94.0
40.06,17,10,676,5,460,10013.0,104.0,64.0,5,216,10014.0,20.0,15.0
0.005,6,10,1989,5,927,1.0,659.0,659.0,5,1062,1.0,794.0,794.0
0.067,6,10,1506,5,395,15.0,127.0,127.0,5,1111,14.0,843.0,843.0
0.006,17,2,170,1,65,0.0,37.0,37.0,1,105,0.0,77.0,77.0
0.005,17,2,170,1,65,0.0,37.0,37.0,1,105,0.0,77.0,77.0
0.004,6,10,2007,5,928,1.0,660.0,660.0,5,1079,1.0,811.0,811.0
0.005,6,10,1779,5,928,1.0,660.0,660.0,5,851,1.0,583.0,583.0
240.091,6,16,4482,9,963,30011.0,238.0,166.0,7,3519,40014.0,1402.0,786.0
0.011,6,13,3735,7,497,1.0,125.0,125.0,6,3238,2.0,1470.0,1459.0
0.013,6,20,9974,11,704,1.0,124.0,124.0,9,9270,1.0,2896.0,1758.0
0.018,6,10,1677,5,827,4.0,559.0,559.0,5,850,4.0,582.0,582.0
40.065,17,10,676,5,460,10014.0,104.0,64.0,5,216,10015.0,20.0,15.0
0.012,6,10,1972,5,910,3.0,642.0,642.0,5,1062,2.0,794.0,794.0
15.073,17,15,9238,8,6902,2149.0,1350.0,834.0,7,2336,2507.0,1350.0,305.0
0.009,6,10,1972,5,910,2.0,642.0,642.0,5,1062,2.0,794.0,794.0
0.005,6,14,3799,7,509,0.0,137.0,137.0,7,3290,0.0,1448.0,972.0
0.006,6,10,1689,5,839,1.0,571.0,571.0,5,850,1.0,582.0,582.0
0.001,17,2,136,1,60,0.0,32.0,32.0,1,76,0.0,48.0,48.0
0.08,6,10,1506,5,395,16.0,127.0,127.0,5,1111,16.0,843.0,843.0
291.665,6,383,347832,193,21608,1519.0,2736.0,889.0,190,326224,1543.0,4171.0,1797.0
0.11,6,10,1506,5,395,25.0,127.0,127.0,5,1111,24.0,843.0,843.0
40.073,17,10,676,5,460,10016.0,104.0,64.0,5,216,10015.0,20.0,15.0
0.01,6,10,1631,5,848,2.0,580.0,580.0,5,783,2.0,515.0,515.0
0.01,6,10,1989,5,910,2.0,642.0,642.0,5,1079,2.0,811.0,811.0
0.205,6,16,2782,8,1400,29.0,533.0,325.0,8,1382,18.0,529.0,239.0
0.013,6,10,1990,5,911,3.0,643.0,643.0,5,1079,3.0,811.0,811.0
0.023,6,10,1677,5,827,5.0,559.0,559.0,5,850,5.0,582.0,582.0
0.004,17,4,284,2,120,0.0,32.0,32.0,2,164,0.0,60.0,54.0
0.006,6,10,1547,5,764,1.0,496.0,496.0,5,783,1.0,515.0,515.0
0.001,17,2,180,1,66,0.0,38.0,38.0,1,114,0.0,86.0,86.0
0.005,17,2,170,1,65,0.0,37.0,37.0,1,105,0.0,77.0,77.0
0.006,6,10,1547,5,764,1.0,496.0,496.0,5,783,1.0,515.0,515.0
240.273,6,44,8825,23,5790,10921.0,1515.0,509.0,21,3035,12013.0,580.0,241.0
1778.735,17,142,44872,72,22752,25050.0,288.0,288.0,70,22120,25776.0,288.0,288.0
0.069,6,10,1506,5,395,15.0,127.0,127.0,5,1111,15.0,843.0,843.0
0.009,6,10,1989,5,910,2.0,642.0,642.0,5,1079,2.0,811.0,811.0
0.007,6,10,1547,5,764,1.0,496.0,496.0,5,783,1.0,515.0,515.0
0.013,6,10,1972,5,910,3.0,642.0,642.0,5,1062,3.0,794.0,794.0
0.062,6,10,1506,5,395,14.0,127.0,127.0,5,1111,14.0,843.0,843.0
0.142,6,10,1506,5,395,32.0,127.0,127.0,5,1111,32.0,843.0,843.0
0.006,6,10,1547,5,764,1.0,496.0,496.0,5,783,1.0,515.0,515.0
0.108,6,10,1506,5,395,26.0,127.0,127.0,5,1111,25.0,843.0,843.0
246.596,6,37,9653,15,6644,17614.0,1770.0,652.0,22,3009,11742.0,580.0,142.0
0.02,6,10,1972,5,910,5.0,642.0,642.0,5,1062,4.0,794.0,794.0
0.004,17,4,284,2,120,0.0,32.0,32.0,2,164,1.0,60.0,54.0
0.013,6,10,1990,5,911,3.0,643.0,643.0,5,1079,3.0,811.0,811.0
0.004,17,2,148,1,60,0.0,32.0,32.0,1,88,0.0,60.0,60.0
0.004,17,4,284,2,120,0.0,32.0,32.0,2,164,1.0,60.0,54.0
1762.153,6,454,66750,258,35614,6856.0,613.0,194.0,196,31136,9036.0,453.0,145.0
0.1,6,10,1506,5,395,23.0,127.0,127.0,5,1111,20.0,843.0,843.0
0.004,6,10,2006,5,927,1.0,659.0,659.0,5,1079,1.0,811.0,811.0
0.011,17,2,169,1,62,0.0,34.0,34.0,1,107,0.0,79.0,79.0
0.014,6,10,1631,5,848,3.0,580.0,580.0,5,783,3.0,515.0,515.0
0.007,17,2,179,1,71,0.0,43.0,43.0,1,108,0.0,80.0,80.0
0.09,6,10,1506,5,395,20.0,127.0,127.0,5,1111,19.0,843.0,843.0
0.13,17,2,80,1,32,0.0,4.0,4.0,1,48,0.0,20.0,20.0
62.795,6,318,274750,175,261026,115.0,2928.0,1716.0,143,13724,440.0,2667.0,204.0
0.109,6,10,1506,5,395,20.0,127.0,127.0,5,1111,21.0,843.0,843.0
0.001,17,2,136,1,60,0.0,32.0,32.0,1,76,0.0,48.0,48.0
0.015,6,10,1990,5,911,3.0,643.0,643.0,5,1079,3.0,811.0,811.0
0.015,6,13,3735,7,497,2.0,125.0,125.0,6,3238,2.0,1470.0,1459.0
0.006,17,2,238,1,66,0.0,38.0,38.0,1,172,0.0,144.0,144.0
10.995,17,28,4398,14,2312,836.0,587.0,137.0,14,2086,836.0,269.0,121.0
300.352,6,16,2170,9,684,37523.0,146.0,146.0,7,1486,50028.0,419.0,398.0
0.005,6,10,2007,5,928,1.0,660.0,660.0,5,1079,1.0,811.0,811.0
0.014,6,10,1972,5,910,3.0,642.0,642.0,5,1062,3.0,794.0,794.0
241.39,6,383,347651,185,21149,1311.0,2736.0,960.0,198,326502,1225.0,2804.0,1681.0
0.003,17,2,136,1,60,0.0,32.0,32.0,1,76,0.0,48.0,48.0
1799.997,6,137,6590,76,3625,23996.0,39.0,39.0,61,2965,29996.0,35.0,35.0
0.006,17,2,178,1,81,0.0,53.0,53.0,1,97,0.0,69.0,69.0
0.214,6,16,2669,8,1395,30.0,533.0,323.0,8,1274,19.0,529.0,212.0
0.004,17,2,222,1,65,0.0,37.0,37.0,1,157,0.0,129.0,129.0
0.004,6,10,2007,5,928,1.0,660.0,660.0,5,1079,1.0,811.0,811.0
0.01,6,10,1989,5,910,2.0,642.0,642.0,5,1079,2.0,811.0,811.0
0.006,6,10,1547,5,764,1.0,496.0,496.0,5,783,1.0,515.0,515.0
0.067,6,10,1506,5,395,13.0,127.0,127.0,5,1111,16.0,843.0,843.0
0.015,6,10,1631,5,848,3.0,580.0,580.0,5,783,3.0,515.0,515.0
0.011,6,10,1762,5,911,2.0,643.0,643.0,5,851,2.0,583.0,583.0
0.005,17,2,136,1,60,0.0,32.0,32.0,1,76,0.0,48.0,48.0
0.211,17,2,213,1,69,0.0,41.0,41.0,1,144,0.0,116.0,116.0
40.074,17,10,676,5,460,10015.0,104.0,64.0,5,216,10017.0,20.0,15.0
0.014,6,10,1972,5,910,3.0,642.0,642.0,5,1062,3.0,794.0,794.0
176.252,17,70,9958,35,2330,5183.0,44.0,38.0,35,7628,5183.0,261.0,189.0
0.085,6,10,1506,5,395,19.0,127.0,127.0,5,1111,18.0,843.0,843.0
0.005,6,10,1989,5,927,1.0,659.0,659.0,5,1062,1.0,794.0,794.0
0.015,6,10,1990,5,911,3.0,643.0,643.0,5,1079,3.0,811.0,811.0
0.011,6,10,1989,5,910,2.0,642.0,642.0,5,1079,2.0,811.0,811.0
308.477,17,20,1124,10,716,34261.0,48.0,43.0,10,408,34261.0,20.0,12.0
0.005,6,10,2006,5,927,1.0,659.0,659.0,5,1079,1.0,811.0,811.0
0.001,17,2,166,1,75,0.0,47.0,47.0,1,91,0.0,63.0,63.0
0.005,6,10,1989,5,927,1.0,659.0,659.0,5,1062,1.0,794.0,794.0
0.015,6,10,1989,5,910,3.0,642.0,642.0,5,1079,3.0,811.0,811.0
0.026,6,10,1989,5,910,6.0,642.0,642.0,5,1079,6.0,811.0,811.0
0.222,6,16,2777,8,1395,31.0,533.0,323.0,8,1382,20.0,529.0,239.0
0.019,6,10,1972,5,910,4.0,642.0,642.0,5,1062,4.0,794.0,794.0
0.004,17,4,284,2,120,0.0,32.0,32.0,2,164,0.0,60.0,54.0
0.005,6,10,1774,5,923,1.0,655.0,655.0,5,851,1.0,583.0,583.0
0.008,6,10,1989,5,910,1.0,642.0,642.0,5,1079,1.0,811.0,811.0
0.016,6,10,1989,5,910,4.0,642.0,642.0,5,1079,3.0,811.0,811.0
0.017,6,10,1990,5,911,4.0,643.0,643.0,5,1079,4.0,811.0,811.0
300.192,6,27,7436,16,1409,20012.0,217.0,142.0,11,6027,24017.0,1679.0,778.0
0.005,6,13,3684,7,446,0.0,74.0,74.0,6,3238,1.0,1470.0,1459.0
0.008,6,10,1774,5,923,2.0,655.0,655.0,5,851,2.0,583.0,583.0
0.018,6,10,1972,5,910,4.0,642.0,642.0,5,1062,4.0,794.0,794.0
0.007,6,10,1854,5,889,1.0,621.0,621.0,5,965,1.0,697.0,697.0
0.005,6,10,2006,5,927,1.0,659.0,659.0,5,1079,1.0,811.0,811.0
0.128,6,10,1506,5,395,26.0,127.0,127.0,5,1111,27.0,843.0,843.0
0.011,6,10,1972,5,910,2.0,642.0,642.0,5,1062,2.0,794.0,794.0
0.092,6,10,1506,5,395,20.0,127.0,127.0,5,1111,20.0,843.0,843.0
0.006,6,10,1547,5,764,1.0,496.0,496.0,5,783,1.0,515.0,515.0
0.005,6,10,2006,5,927,1.0,659.0,659.0,5,1079,1.0,811.0,811.0
0.008,6,12,1926,6,1189,1.0,659.0,434.0,6,737,1.0,417.0,417.0
0.01,6,10,1989,5,910,2.0,642.0,642.0,5,1079,2.0,811.0,811.0
0.005,6,10,1774,5,923,1.0,655.0,655.0,5,851,1.0,583.0,583.0
0.006,6,10,1547,5,764,1.0,496.0,496.0,5,783,1.0,515.0,515.0
0.007,6,10,1547,5,764,1.0,496.0,496.0,5,783,1.0,515.0,515.0
240.111,6,16,4482,9,963,30013.0,238.0,166.0,7,3519,40018.0,1402.0,786.0
0.188,17,4,352,2,130,146.0,37.0,37.0,2,222,148.0,89.0,83.0
0.005,6,10,2000,5,927,1.0,659.0,659.0,5,1073,1.0,805.0,805.0
0.005,6,10,1989,5,927,1.0,659.0,659.0,5,1062,1.0,794.0,794.0
240.091,6,31,9049,15,6780,17149.0,1904.0,667.0,16,2269,16005.0,580.0,178.0
0.039,17,2,170,1,65,0.0,37.0,37.0,1,105,0.0,77.0,77.0
1792.808,6,252,25667,101,9610,17926.0,972.0,69.0,151,16057,11951.0,1360.0,131.0
0.093,6,10,1506,5,395,18.0,127.0,127.0,5,1111,19.0,843.0,843.0
1772.068,6,108,6465,60,3537,30034.0,27.0,27.0,48,2928,37702.0,27.0,27.0
0.048,6,10,1989,5,910,11.0,642.0,642.0,5,1079,11.0,811.0,811.0
0.005,17,2,169,1,62,0.0,34.0,34.0,1,107,0.0,79.0,79.0
0.065,6,10,1506,5,395,14.0,127.0,127.0,5,1111,13.0,843.0,843.0
0.013,17,2,152,1,56,0.0,28.0,28.0,1,96,0.0,68.0,68.0
0.004,6,10,2006,5,927,1.0,659.0,659.0,5,1079,1.0,811.0,811.0
0.07,6,10,1506,5,395,15.0,127.0,127.0,5,1111,16.0,843.0,843.0
0.015,6,10,1989,5,910,3.0,642.0,642.0,5,1079,3.0,811.0,811.0
0.014,6,10,1983,5,910,3.0,642.0,642.0,5,1073,3.0,805.0,805.0
0.081,6,10,1506,5,395,17.0,127.0,127.0,5,1111,18.0,843.0,843.0
0.005,17,2,140,1,62,0.0,34.0,34.0,1,78,0.0,50.0,50.0
0.088,6,10,1506,5,395,19.0,127.0,127.0,5,1111,17.0,843.0,843.0
0.001,17,2,180,1,66,0.0,38.0,38.0,1,114,0.0,86.0,86.0
0.005,17,2,225,1,65,0.0,37.0,37.0,1,160,0.0,132.0,132.0
0.014,6,10,1990,5,911,3.0,643.0,643.0,5,1079,3.0,811.0,811.0
0.005,6,10,2006,5,927,1.0,659.0,659.0,5,1079,1.0,811.0,811.0
0.01,6,10,1972,5,910,2.0,642.0,642.0,5,1062,2.0,794.0,794.0
0.014,6,10,1983,5,910,3.0,642.0,642.0,5,1073,3.0,805.0,805.0
0.172,6,3,453,2,321,172.0,241.0,241.0,1,132,0.0,92.0,92.0
0.083,6,10,1506,5,395,18.0,127.0,127.0,5,1111,19.0,843.0,843.0
0.026,6,10,1631,5,848,6.0,580.0,580.0,5,783,6.0,515.0,515.0
0.006,6,10,1547,5,764,1.0,496.0,496.0,5,783,1.0,515.0,515.0
0.01,6,10,1972,5,910,2.0,642.0,642.0,5,1062,2.0,794.0,794.0
0.013,6,10,1972,5,910,3.0,642.0,642.0,5,1062,3.0,794.0,794.0
0.004,17,4,284,2,120,0.0,32.0,32.0,2,164,1.0,60.0,54.0
0.005,17,2,156,1,64,0.0,36.0,36.0,1,92,0.0,64.0,64.0
177.156,17,70,9785,35,2333,5210.0,44.0,38.0,35,7452,5210.0,249.0,184.0
40.064,17,10,676,5,460,10013.0,104.0,64.0,5,216,10015.0,20.0,15.0
0.011,6,10,1972,5,910,2.0,642.0,642.0,5,1062,2.0,794.0,794.0
0.005,6,10,2000,5,927,1.0,659.0,659.0,5,1073,1.0,805.0,805.0
0.015,6,10,1990,5,911,3.0,643.0,643.0,5,1079,3.0,811.0,811.0
0.01,6,10,1631,5,848,2.0,580.0,580.0,5,783,2.0,515.0,515.0
40.059,17,10,676,5,460,10013.0,104.0,64.0,5,216,10014.0,20.0,15.0
0.007,17,2,299,1,65,0.0,37.0,37.0,1,234,0.0,206.0,206.0
0.09,6,10,1506,5,395,18.0,127.0,127.0,5,1111,21.0,843.0,843.0
0.011,6,10,1677,5,827,2.0,559.0,559.0,5,850,2.0,582.0,582.0
0.005,17,2,136,1,60,0.0,32.0,32.0,1,76,0.0,48.0,48.0
0.004,17,2,144,1,64,0.0,36.0,36.0,1,80,0.0,52.0,52.0
177.359,17,98,14307,49,3298,3694.0,44.0,39.0,49,11009,3694.0,261.0,196.0
0.005,6,10,1547,5,764,1.0,496.0,496.0,5,783,1.0,515.0,515.0
309.792,17,18,1008,9,640,38708.0,48.0,43.0,9,368,38707.0,20.0,12.0
0.06,17,2,152,1,76,0.0,48.0,48.0,1,76,0.0,48.0,48.0
10.826,17,28,4422,14,1994,824.0,269.0,114.0,14,2428,824.0,587.0,145.0
0.007,6,12,1698,6,863,1.0,327.0,271.0,6,835,1.0,515.0,515.0
0.004,6,10,1989,5,927,1.0,659.0,659.0,5,1062,1.0,794.0,794.0
0.053,17,2,152,1,76,0.0,48.0,48.0,1,76,0.0,48.0,48.0
0.004,6,10,2006,5,927,1.0,659.0,659.0,5,1079,1.0,811.0,811.0
0.003,17,2,148,1,60,0.0,32.0,32.0,1,88,0.0,60.0,60.0
0.002,17,2,136,1,60,0.0,32.0,32.0,1,76,0.0,48.0,48.0
0.001,17,2,179,1,62,0.0,34.0,34.0,1,117,0.0,89.0,89.0
0.004,17,2,136,1,60,0.0,32.0,32.0,1,76,0.0,48.0,48.0
0.005,6,10,1689,5,839,1.0,571.0,571.0,5,850,1.0,582.0,582.0
0.005,6,10,1989,5,927,1.0,659.0,659.0,5,1062,1.0,794.0,794.0
0.191,17,2,152,1,76,0.0,48.0,48.0,1,76,0.0,48.0,48.0
0.001,17,2,166,1,75,0.0,47.0,47.0,1,91,0.0,63.0,63.0
333.602,17,20,1124,10,716,37052.0,48.0,43.0,10,408,37052.0,20.0,12.0
0.004,6,10,2007,5,928,1.0,660.0,660.0,5,1079,1.0,811.0,811.0
0.175,6,10,1506,5,395,36.0,127.0,127.0,5,1111,34.0,843.0,843.0
0.013,6,10,1983,5,910,3.0,642.0,642.0,5,1073,3.0,805.0,805.0
0.108,17,2,80,1,32,0.0,4.0,4.0,1,48,0.0,20.0,20.0
40.094,17,10,676,5,460,10021.0,104.0,64.0,5,216,10022.0,20.0,15.0
0.005,6,10,2007,5,928,1.0,660.0,660.0,5,1079,1.0,811.0,811.0
0.037,17,2,148,1,60,0.0,32.0,32.0,1,88,0.0,60.0,60.0
40.078,17,10,676,5,460,10015.0,104.0,64.0,5,216,10018.0,20.0,15.0
0.053,17,2,152,1,76,0.0,48.0,48.0,1,76,0.0,48.0,48.0
0.011,6,13,3735,7,497,1.0,125.0,125.0,6,3238,2.0,1470.0,1459.0
0.004,6,10,2007,5,928,1.0,660.0,660.0,5,1079,1.0,811.0,811.0
0.016,6,10,1989,5,910,3.0,642.0,642.0,5,1079,3.0,811.0,811.0
1777.668,17,142,44872,72,22752,25036.0,288.0,288.0,70,22120,25761.0,288.0,288.0
0.009,6,10,1989,5,910,2.0,642.0,642.0,5,1079,2.0,811.0,811.0
0.013,6,10,1762,5,911,3.0,643.0,643.0,5,851,3.0,583.0,583.0
366.329,6,22,2313,16,867,24421.0,195.0,195.0,6,1446,4634.0,419.0,398.0
0.005,17,2,214,1,75,0.0,47.0,47.0,1,139,0.0,111.0,111.0
0.012,6,10,1989,5,910,2.0,642.0,642.0,5,1079,2.0,811.0,811.0
0.067,6,10,1506,5,395,15.0,127.0,127.0,5,1111,14.0,843.0,843.0
0.006,17,2,170,1,65,0.0,37.0,37.0,1,105,0.0,77.0,77.0
0.003,17,2,136,1,60,0.0,32.0,32.0,1,76,0.0,48.0,48.0
0.008,6,10,1762,5,911,2.0,643.0,643.0,5,851,2.0,583.0,583.0
0.006,6,10,1689,5,839,1.0,571.0,571.0,5,850,1.0,582.0,582.0
0.016,6,10,1983,5,910,3.0,642.0,642.0,5,1073,3.0,805.0,805.0
0.013,6,10,1990,5,911,3.0,643.0,643.0,5,1079,3.0,811.0,811.0
0.06,17,2,152,1,76,0.0,48.0,48.0,1,76,0.0,48.0,48.0
0.009,6,10,1972,5,910,2.0,642.0,642.0,5,1062,2.0,794.0,794.0
0.007,6,10,1643,5,860,1.0,592.0,592.0,5,783,1.0,515.0,515.0
0.004,6,10,2007,5,928,1.0,660.0,660.0,5,1079,1.0,811.0,811.0
0.04,17,2,170,1,65,0.0,37.0,37.0,1,105,0.0,77.0,77.0
0.006,6,10,1547,5,764,1.0,496.0,496.0,5,783,1.0,515.0,515.0
0.011,6,10,1989,5,910,2.0,642.0,642.0,5,1079,2.0,811.0,811.0
0.005,6,10,2007,5,928,1.0,660.0,660.0,5,1079,1.0,811.0,811.0
0.01,6,10,1989,5,910,2.0,642.0,642.0,5,1079,2.0,811.0,811.0
0.009,6,13,3735,7,497,1.0,125.0,125.0,6,3238,1.0,1470.0,1459.0
0.005,6,10,2006,5,927,1.0,659.0,659.0,5,1079,1.0,811.0,811.0
0.005,6,10,1643,5,860,1.0,592.0,592.0,5,783,1.0,515.0,515.0
0.009,6,12,1926,6,1189,1.0,659.0,434.0,6,737,1.0,417.0,417.0
0.083,6,10,1506,5,395,17.0,127.0,127.0,5,1111,17.0,843.0,843.0
0.005,6,10,2000,5,927,1.0,659.0,659.0,5,1073,1.0,805.0,805.0
0.004,6,10,2000,5,927,1.0,659.0,659.0,5,1073,1.0,805.0,805.0
175.139,17,90,12913,45,3027,3980.0,44.0,39.0,45,9886,3980.0,261.0,191.0
240.022,6,9,787,5,488,60005.0,232.0,232.0,4,299,80006.0,83.0,83.0
0.004,6,10,2000,5,927,1.0,659.0,659.0,5,1073,1.0,805.0,805.0
0.011,6,10,2000,5,927,2.0,659.0,659.0,5,1073,2.0,805.0,805.0
0.009,6,14,3787,7,497,1.0,125.0,125.0,7,3290,1.0,1448.0,972.0
0.124,6,10,1506,5,395,19.0,127.0,127.0,5,1111,27.0,843.0,843.0
0.013,6,10,1983,5,910,3.0,642.0,642.0,5,1073,3.0,805.0,805.0
0.007,6,14,3742,8,504,1.0,80.0,80.0,6,3238,1.0,1470.0,1459.0
0.008,6,10,1972,5,910,2.0,642.0,642.0,5,1062,2.0,794.0,794.0
40.056,17,10,676,5,460,10013.0,104.0,64.0,5,216,10013.0,20.0,15.0
175.088,17,78,11023,39,2590,4607.0,44.0,38.0,39,8433,4607.0,239.0,188.0
40.063,17,10,676,5,460,10014.0,104.0,64.0,5,216,10015.0,20.0,15.0
0.043,17,4,284,2,120,0.0,32.0,32.0,2,164,3.0,60.0,54.0
0.005,6,10,2000,5,927,1.0,659.0,659.0,5,1073,1.0,805.0,805.0
40.066,17,10,676,5,460,10015.0,104.0,64.0,5,216,10015.0,20.0,15.0
0.002,17,2,180,1,66,0.0,38.0,38.0,1,114,0.0,86.0,86.0
412.253,6,29,4409,12,3102,10911.0,494.0,494.0,17,1307,25765.0,83.0,83.0
0.015,6,13,3735,7,497,2.0,125.0,125.0,6,3238,3.0,1470.0,1459.0
0.006,6,12,1698,6,863,1.0,327.0,271.0,6,835,1.0,515.0,515.0
0.005,6,10,2006,5,927,1.0,659.0,659.0,5,1079,1.0,811.0,811.0
0.004,6,10,2000,5,927,1.0,659.0,659.0,5,1073,1.0,805.0,805.0
0.006,6,10,2006,5,927,1.0,659.0,659.0,5,1079,1.0,811.0,811.0
0.005,6,10,1989,5,927,1.0,659.0,659.0,5,1062,1.0,794.0,794.0
0.005,6,10,2007,5,928,1.0,660.0,660.0,5,1079,1.0,811.0,811.0
0.006,6,10,1689,5,839,1.0,571.0,571.0,5,850,1.0,582.0,582.0
5.084,6,21,5923,12,1436,461.0,474.0,201.0,9,4487,635.0,1925.0,804.0
0.011,6,10,1631,5,848,2.0,580.0,580.0,5,783,2.0,515.0,515.0
0.006,6,10,1547,5,764,1.0,496.0,496.0,5,783,1.0,515.0,515.0
0.071,6,10,1506,5,395,16.0,127.0,127.0,5,1111,15.0,843.0,843.0
0.081,6,10,1506,5,395,15.0,127.0,127.0,5,1111,17.0,843.0,843.0
0.004,6,10,1779,5,928,1.0,660.0,660.0,5,851,1.0,583.0,583.0
11.18,17,28,4422,14,1994,847.0,269.0,114.0,14,2428,847.0,587.0,145.0
0.015,6,10,1989,5,910,3.0,642.0,642.0,5,1079,3.0,811.0,811.0
0.005,17,2,179,1,71,0.0,43.0,43.0,1,108,0.0,80.0,80.0
0.046,17,2,144,1,64,0.0,36.0,36.0,1,80,0.0,52.0,52.0
0.039,17,2,170,1,65,0.0,37.0,37.0,1,105,0.0,77.0,77.0
0.091,6,10,1506,5,395,18.0,127.0,127.0,5,1111,18.0,843.0,843.0
0.037,17,4,284,2,120,0.0,32.0,32.0,2,164,33.0,60.0,54.0
0.005,6,10,1989,5,927,1.0,659.0,659.0,5,1062,1.0,794.0,794.0
0.092,6,10,1506,5,395,21.0,127.0,127.0,5,1111,16.0,843.0,843.0
0.006,6,14,3799,7,509,1.0,137.0,137.0,7,3290,1.0,1448.0,972.0
0.01,6,10,1989,5,910,2.0,642.0,642.0,5,1079,2.0,811.0,811.0
1778.902,17,143,41496,72,22752,25054.0,288.0,288.0,71,18744,25412.0,236.0,236.0
0.008,17,2,179,1,71,0.0,43.0,43.0,1,108,0.0,80.0,80.0
0.016,17,2,180,1,66,0.0,38.0,38.0,1,114,0.0,86.0,86.0
66.159,6,29,19810,16,11815,4410.0,2804.0,1567.0,13,7995,5498.0,2314.0,1218.0
0.016,17,2,198,1,91,0.0,63.0,63.0,1,107,0.0,79.0,79.0
354.115,6,21,1795,16,1030,23607.0,190.0,190.0,5,765,60004.0,464.0,248.0
0.003,17,2,148,1,60,0.0,32.0,32.0,1,88,0.0,60.0,60.0
0.02,6,10,1677,5,827,5.0,559.0,559.0,5,850,4.0,582.0,582.0
0.103,6,10,1506,5,395,22.0,127.0,127.0,5,1111,23.0,843.0,843.0
0.019,6,10,1972,5,910,4.0,642.0,642.0,5,1062,4.0,794.0,794.0
0.092,6,10,1506,5,395,19.0,127.0,127.0,5,1111,21.0,843.0,843.0
354.011,6,21,1795,16,1030,23600.0,190.0,190.0,5,765,60001.0,464.0,248.0
0.163,17,2,152,1,76,0.0,48.0,48.0,1,76,0.0,48.0,48.0
0.113,6,10,1506,5,395,26.0,127.0,127.0,5,1111,25.0,843.0,843.0
0.011,6,10,1983,5,910,2.0,642.0,642.0,5,1073,2.0,805.0,805.0
0.009,6,12,1926,6,1189,1.0,659.0,434.0,6,737,1.0,417.0,417.0
0.163,17,2,152,1,76,0.0,48.0,48.0,1,76,0.0,48.0,48.0
0.099,6,10,1506,5,395,20.0,127.0,127.0,5,1111,22.0,843.0,843.0
10.949,17,28,4395,14,2312,833.0,587.0,137.0,14,2083,833.0,270.0,120.0
0.009,6,10,1989,5,910,2.0,642.0,642.0,5,1079,2.0,811.0,811.0
0.09,6,10,1506,5,395,21.0,127.0,127.0,5,1111,21.0,843.0,843.0
0.006,6,10,1547,5,764,1.0,496.0,496.0,5,783,1.0,515.0,515.0
0.017,6,10,1983,5,910,4.0,642.0,642.0,5,1073,4.0,805.0,805.0
0.005,6,10,2007,5,928,1.0,660.0,660.0,5,1079,1.0,811.0,811.0
0.094,6,10,1506,5,395,18.0,127.0,127.0,5,1111,21.0,843.0,843.0
0.008,6,10,1972,5,910,2.0,642.0,642.0,5,1062,1.0,794.0,794.0
0.012,6,10,1762,5,911,2.0,643.0,643.0,5,851,2.0,583.0,583.0
0.011,6,10,1989,5,910,2.0,642.0,642.0,5,1079,2.0,811.0,811.0
0.22,17,14,8577,7,4012,36.0,1350.0,545.0,7,4565,27.0,1350.0,624.0
0.017,6,10,1990,5,911,4.0,643.0,643.0,5,1079,4.0,811.0,811.0
0.006,6,10,1989,5,927,1.0,659.0,659.0,5,1062,1.0,794.0,794.0
0.005,6,10,1643,5,860,1.0,592.0,592.0,5,783,1.0,515.0,515.0
0.009,6,10,1990,5,911,2.0,643.0,643.0,5,1079,2.0,811.0,811.0
0.014,6,10,1677,5,827,3.0,559.0,559.0,5,850,3.0,582.0,582.0
300.38,6,16,2170,9,684,37527.0,146.0,146.0,7,1486,50036.0,419.0,398.0
0.164,6,10,1506,5,395,39.0,127.0,127.0,5,1111,35.0,843.0,843.0
0.105,6,10,1506,5,395,20.0,127.0,127.0,5,1111,22.0,843.0,843.0
0.007,6,10,1547,5,764,1.0,496.0,496.0,5,783,1.0,515.0,515.0
0.013,6,10,1972,5,910,3.0,642.0,642.0,5,1062,3.0,794.0,794.0
0.004,17,2,136,1,60,0.0,32.0,32.0,1,76,0.0,48.0,48.0
0.006,6,10,1854,5,889,1.0,621.0,621.0,5,965,1.0,697.0,697.0
0.008,17,2,299,1,65,0.0,37.0,37.0,1,234,0.0,206.0,206.0
0.005,6,10,1989,5,927,1.0,659.0,659.0,5,1062,1.0,794.0,794.0
0.006,6,10,1547,5,764,1.0,496.0,496.0,5,783,1.0,515.0,515.0
246.523,6,14,1059,4,448,2.0,232.0,232.0,10,611,27391.0,83.0,83.0
0.006,6,10,1547,5,764,1.0,496.0,496.0,5,783,1.0,515.0,515.0
0.005,6,10,2006,5,927,1.0,659.0,659.0,5,1079,1.0,811.0,811.0
1768.547,6,290,92774,181,82536,9825.0,1402.0,664.0,109,10238,16375.0,93.0,65.0
0.02,6,10,1972,5,910,5.0,642.0,642.0,5,1062,5.0,794.0,794.0
0.006,6,10,1643,5,860,1.0,592.0,592.0,5,783,1.0,515.0,515.0
0.001,17,2,179,1,62,0.0,34.0,34.0,1,117,0.0,89.0,89.0
0.005,6,10,1989,5,927,1.0,659.0,659.0,5,1062,1.0,794.0,794.0
0.005,6,13,3747,7,509,0.0,137.0,137.0,6,3238,0.0,1470.0,1459.0
0.076,6,10,1506,5,395,18.0,127.0,127.0,5,1111,15.0,843.0,843.0
40.068,17,10,676,5,460,10016.0,104.0,64.0,5,216,10016.0,20.0,15.0
293.785,6,329,345470,122,17914,2427.0,2736.0,889.0,207,327556,1426.0,2804.0,1649.0
0.016,6,10,1989,5,910,3.0,642.0,642.0,5,1079,4.0,811.0,811.0
15.169,17,20,11139,10,7477,1682.0,1350.0,719.0,10,3662,1682.0,1350.0,338.0
1777.722,17,144,45504,72,22752,25038.0,288.0,288.0,72,22752,25038.0,288.0,288.0
0.004,6,10,2006,5,927,1.0,659.0,659.0,5,1079,1.0,811.0,811.0
0.004,6,10,2007,5,928,1.0,660.0,660.0,5,1079,1.0,811.0,811.0
0.117,6,10,1506,5,395,28.0,127.0,127.0,5,1111,27.0,843.0,843.0
0.003,17,2,148,1,60,0.0,32.0,32.0,1,88,0.0,60.0,60.0
0.013,6,10,1972,5,910,3.0,642.0,642.0,5,1062,3.0,794.0,794.0
0.004,17,2,140,1,62,0.0,34.0,34.0,1,78,0.0,50.0,50.0
0.001,17,2,268,1,70,0.0,42.0,42.0,1,198,0.0,170.0,170.0
0.005,6,10,1774,5,923,1.0,655.0,655.0,5,851,1.0,583.0,583.0
0.142,6,10,1506,5,395,33.0,127.0,127.0,5,1111,29.0,843.0,843.0
0.005,6,10,2006,5,927,1.0,659.0,659.0,5,1079,1.0,811.0,811.0
0.004,6,10,1774,5,923,1.0,655.0,655.0,5,851,1.0,583.0,583.0
0.173,6,10,1506,5,395,40.0,127.0,127.0,5,1111,37.0,843.0,843.0
240.03,6,9,787,5,488,60007.0,232.0,232.0,4,299,80008.0,83.0,83.0
1770.285,17,92,8096,46,4048,39339.0,60.0,60.0,46,4048,39339.0,60.0,60.0
0.007,17,2,307,1,61,0.0,33.0,33.0,1,246,0.0,218.0,218.0
0.005,6,10,1689,5,839,1.0,571.0,571.0,5,850,1.0,582.0,582.0
0.241,17,43,24448,24,21168,10.0,1350.0,854.0,19,3280,9.0,1350.0,144.0
0.123,6,10,1506,5,395,26.0,127.0,127.0,5,1111,26.0,843.0,843.0
0.005,17,2,170,1,65,0.0,37.0,37.0,1,105,0.0,77.0,77.0
0.006,17,2,166,1,75,0.0,47.0,47.0,1,91,0.0,63.0,63.0
0.009,6,12,1926,6,1189,1.0,659.0,434.0,6,737,1.0,417.0,417.0
0.006,17,2,230,1,68,0.0,40.0,40.0,1,162,0.0,134.0,134.0
0.004,17,2,148,1,60,0.0,32.0,32.0,1,88,0.0,60.0,60.0
40.093,17,10,676,5,460,10022.0,104.0,64.0,5,216,10022.0,20.0,15.0
0.04,17,2,136,1,60,0.0,32.0,32.0,1,76,0.0,48.0,48.0
0.013,6,10,1990,5,911,3.0,643.0,643.0,5,1079,3.0,811.0,811.0
11.457,17,28,4399,14,2312,869.0,587.0,137.0,14,2087,869.0,270.0,121.0
0.001,17,2,180,1,66,0.0,38.0,38.0,1,114,0.0,86.0,86.0
10.774,17,28,4422,14,1994,820.0,269.0,114.0,14,2428,820.0,587.0,145.0
0.006,6,10,2006,5,927,1.0,659.0,659.0,5,1079,1.0,811.0,811.0
0.009,6,12,1926,6,1189,1.0,659.0,434.0,6,737,1.0,417.0,417.0
0.001,17,2,166,1,75,0.0,47.0,47.0,1,91,0.0,63.0,63.0
0.011,6,10,1989,5,910,2.0,642.0,642.0,5,1079,2.0,811.0,811.0
240.341,6,33,8636,17,1836,15021.0,569.0,188.0,16,6800,16022.0,1402.0,597.0
0.095,6,10,1506,5,395,21.0,127.0,127.0,5,1111,22.0,843.0,843.0
0.005,17,2,170,1,65,0.0,37.0,37.0,1,105,0.0,77.0,77.0
0.005,6,10,1989,5,927,1.0,659.0,659.0,5,1062,1.0,794.0,794.0
0.004,17,2,136,1,60,0.0,32.0,32.0,1,76,0.0,48.0,48.0
11.027,17,28,4422,14,1994,839.0,269.0,114.0,14,2428,839.0,587.0,145.0
0.013,17,2,152,1,56,0.0,28.0,28.0,1,96,0.0,68.0,68.0
0.103,6,10,1506,5,395,23.0,127.0,127.0,5,1111,24.0,843.0,843.0
0.089,17,2,80,1,32,0.0,4.0,4.0,1,48,0.0,20.0,20.0
0.004,6,10,2006,5,927,1.0,659.0,659.0,5,1079,1.0,811.0,811.0
0.005,6,10,1689,5,839,1.0,571.0,571.0,5,850,1.0,582.0,582.0
0.075,6,10,1506,5,395,15.0,127.0,127.0,5,1111,17.0,843.0,843.0
0.001,17,2,180,1,66,0.0,38.0,38.0,1,114,0.0,86.0,86.0
0.006,6,10,1689,5,839,1.0,571.0,571.0,5,850,1.0,582.0,582.0
0.111,6,10,1506,5,395,25.0,127.0,127.0,5,1111,25.0,843.0,843.0
0.009,6,10,1972,5,910,2.0,642.0,642.0,5,1062,2.0,794.0,794.0
0.071,6,10,1506,5,395,14.0,127.0,127.0,5,1111,15.0,843.0,843.0
0.073,6,10,1506,5,395,16.0,127.0,127.0,5,1111,16.0,843.0,843.0
0.096,6,10,1506,5,395,21.0,127.0,127.0,5,1111,19.0,843.0,843.0
0.09,6,10,1506,5,395,21.0,127.0,127.0,5,1111,19.0,843.0,843.0
0.011,17,2,179,1,71,0.0,43.0,43.0,1,108,0.0,80.0,80.0
40.063,17,10,676,5,460,10014.0,104.0,64.0,5,216,10014.0,20.0,15.0
0.004,6,10,1702,5,863,1.0,595.0,595.0,5,839,0.0,571.0,571.0
0.005,6,10,1989,5,927,1.0,659.0,659.0,5,1062,1.0,794.0,794.0
0.006,6,10,1547,5,764,1.0,496.0,496.0,5,783,1.0,515.0,515.0
240.116,6,29,7142,15,4725,17151.0,1368.0,493.0,14,2417,18470.0,580.0,210.0
0.011,6,10,1990,5,911,2.0,643.0,643.0,5,1079,2.0,811.0,811.0
0.008,6,10,1972,5,910,1.0,642.0,642.0,5,1062,1.0,794.0,794.0
0.076,6,10,1506,5,395,16.0,127.0,127.0,5,1111,16.0,843.0,843.0
0.065,17,8,3613,4,1874,21.0,1350.0,440.0,4,1739,11.0,1350.0,406.0
0.016,6,10,1972,5,910,3.0,642.0,642.0,5,1062,4.0,794.0,794.0
0.012,6,10,1990,5,911,3.0,643.0,643.0,5,1079,2.0,811.0,811.0
0.137,6,10,1506,5,395,32.0,127.0,127.0,5,1111,32.0,843.0,843.0
0.005,17,2,170,1,65,0.0,37.0,37.0,1,105,0.0,77.0,77.0
0.009,6,10,1972,5,910,2.0,642.0,642.0,5,1062,2.0,794.0,794.0
0.004,17,4,284,2,120,0.0,32.0,32.0,2,164,1.0,60.0,54.0
0.011,6,10,1989,5,910,2.0,642.0,642.0,5,1079,2.0,811.0,811.0
0.004,6,10,1702,5,863,1.0,595.0,595.0,5,839,0.0,571.0,571.0
2.085,6,27,10462,14,1575,160.0,517.0,211.0,13,8887,173.0,1402.0,911.0
15.071,17,15,9238,8,6902,2149.0,1350.0,834.0,7,2336,2507.0,1350.0,305.0
0.083,6,10,1506,5,395,19.0,127.0,127.0,5,1111,17.0,843.0,843.0
0.005,17,2,186,1,61,0.0,33.0,33.0,1,125,0.0,97.0,97.0
0.04,17,2,182,1,65,0.0,37.0,37.0,1,117,0.0,89.0,89.0
300.773,6,37,9597,20,4119,15830.0,1543.0,657.0,17,5478,538.0,2667.0,435.0
0.116,6,10,1506,5,395,25.0,127.0,127.0,5,1111,23.0,843.0,843.0
313.027,17,20,1124,10,716,34766.0,48.0,43.0,10,408,34766.0,20.0,12.0
0.006,6,10,1689,5,839,1.0,571.0,571.0,5,850,1.0,582.0,582.0
0.007,6,10,1643,5,860,1.0,592.0,592.0,5,783,1.0,515.0,515.0
0.009,6,10,1983,5,910,2.0,642.0,642.0,5,1073,2.0,805.0,805.0
0.018,6,10,1983,5,910,4.0,642.0,642.0,5,1073,4.0,805.0,805.0
0.004,6,10,2006,5,927,1.0,659.0,659.0,5,1079,1.0,811.0,811.0
0.001,17,2,180,1,66,0.0,38.0,38.0,1,114,0.0,86.0,86.0
0.014,6,14,3787,7,497,2.0,125.0,125.0,7,3290,2.0,1448.0,972.0
359.183,6,21,1795,16,1030,23945.0,190.0,190.0,5,765,60003.0,464.0,248.0
0.041,17,2,152,1,76,0.0,48.0,48.0,1,76,0.0,48.0,48.0
0.004,6,10,2006,5,927,1.0,659.0,659.0,5,1079,1.0,811.0,811.0
0.053,17,2,152,1,76,0.0,48.0,48.0,1,76,0.0,48.0,48.0
0.014,6,10,1983,5,910,3.0,642.0,642.0,5,1073,3.0,805.0,805.0
15.22,17,38,20153,21,17030,759.0,1350.0,782.0,17,3123,949.0,1350.0,155.0
0.006,6,10,2007,5,928,1.0,660.0,660.0,5,1079,1.0,811.0,811.0
240.074,6,21,4926,11,941,24007.0,180.0,93.0,10,3985,26674.0,1593.0,576.0
240.019,6,9,787,5,488,60004.0,232.0,232.0,4,299,80004.0,83.0,83.0
0.006,6,10,1989,5,927,1.0,659.0,659.0,5,1062,1.0,794.0,794.0
0.072,17,4,284,2,120,1.0,32.0,32.0,2,164,68.0,60.0,54.0
0.123,6,10,1506,5,395,28.0,127.0,127.0,5,1111,26.0,843.0,843.0
0.001,17,2,180,1,66,0.0,38.0,38.0,1,114,0.0,86.0,86.0
40.049,17,10,676,5,460,10011.0,104.0,64.0,5,216,10011.0,20.0,15.0
0.068,17,8,3613,4,1874,22.0,1350.0,440.0,4,1739,11.0,1350.0,406.0
0.031,6,10,1983,5,910,7.0,642.0,642.0,5,1073,7.0,805.0,805.0
0.071,6,10,1506,5,395,16.0,127.0,127.0,5,1111,13.0,843.0,843.0
0.013,6,10,1989,5,910,3.0,642.0,642.0,5,1079,3.0,811.0,811.0
0.095,6,10,1506,5,395,21.0,127.0,127.0,5,1111,21.0,843.0,843.0
0.006,6,10,1689,5,839,1.0,571.0,571.0,5,850,1.0,582.0,582.0
0.005,6,10,2000,5,927,1.0,659.0,659.0,5,1073,1.0,805.0,805.0
0.01,6,10,1972,5,910,2.0,642.0,642.0,5,1062,2.0,794.0,794.0
0.023,6,10,1972,5,910,5.0,642.0,642.0,5,1062,5.0,794.0,794.0
0.005,6,10,2007,5,928,1.0,660.0,660.0,5,1079,1.0,811.0,811.0
0.45,17,19,14121,10,9673,50.0,1350.0,939.0,9,4448,49.0,1350.0,466.0
0.005,6,10,2000,5,927,1.0,659.0,659.0,5,1073,1.0,805.0,805.0
0.001,17,2,180,1,66,0.0,38.0,38.0,1,114,0.0,86.0,86.0
0.009,6,10,1989,5,910,2.0,642.0,642.0,5,1079,2.0,811.0,811.0
0.005,17,2,166,1,75,0.0,47.0,47.0,1,91,0.0,63.0,63.0
0.043,17,2,152,1,76,0.0,48.0,48.0,1,76,0.0,48.0,48.0
0.001,17,2,180,1,66,0.0,38.0,38.0,1,114,0.0,86.0,86.0
0.005,6,10,2007,5,928,1.0,660.0,660.0,5,1079,1.0,811.0,811.0
175.292,17,76,10770,38,2536,4737.0,44.0,38.0,38,8234,4737.0,239.0,188.0
0.014,6,10,1989,5,910,3.0,642.0,642.0,5,1079,3.0,811.0,811.0
0.002,17,2,180,1,66,0.0,38.0,38.0,1,114,0.0,86.0,86.0
0.001,17,2,136,1,60,0.0,32.0,32.0,1,76,0.0,48.0,48.0
11.155,17,28,4419,14,1995,845.0,270.0,114.0,14,2424,845.0,587.0,145.0
0.005,17,2,170,1,65,0.0,37.0,37.0,1,105,0.0,77.0,77.0
0.04,17,4,352,2,130,1.0,37.0,37.0,2,222,0.0,89.0,83.0
0.007,6,10,1547,5,764,1.0,496.0,496.0,5,783,1.0,515.0,515.0
0.025,6,10,1989,5,910,6.0,642.0,642.0,5,1079,6.0,811.0,811.0
0.005,6,10,1547,5,764,1.0,496.0,496.0,5,783,1.0,515.0,515.0
0.007,6,10,1689,5,839,1.0,571.0,571.0,5,850,1.0,582.0,582.0
0.005,17,2,144,1,64,0.0,36.0,36.0,1,80,0.0,52.0,52.0
0.015,6,10,1631,5,848,3.0,580.0,580.0,5,783,3.0,515.0,515.0
0.119,6,10,1506,5,395,18.0,127.0,127.0,5,1111,28.0,843.0,843.0
0.114,6,10,1506,5,395,25.0,127.0,127.0,5,1111,23.0,843.0,843.0
0.006,6,10,1989,5,927,1.0,659.0,659.0,5,1062,1.0,794.0,794.0
0.012,6,10,1972,5,910,3.0,642.0,642.0,5,1062,2.0,794.0,794.0
0.005,6,10,2000,5,927,1.0,659.0,659.0,5,1073,1.0,805.0,805.0
0.077,6,10,1506,5,395,17.0,127.0,127.0,5,1111,17.0,843.0,843.0
0.093,6,10,1506,5,395,20.0,127.0,127.0,5,1111,21.0,843.0,843.0
0.217,17,4,596,2,122,176.0,33.0,33.0,2,474,144.0,323.0,209.0
0.005,6,10,1989,5,927,1.0,659.0,659.0,5,1062,1.0,794.0,794.0
0.127,6,10,1506,5,395,29.0,127.0,127.0,5,1111,25.0,843.0,843.0
0.072,17,2,136,1,60,0.0,32.0,32.0,1,76,0.0,48.0,48.0
0.366,17,42,26976,24,23341,15.0,1350.0,944.0,18,3635,17.0,1350.0,173.0
0.011,6,10,1989,5,910,2.0,642.0,642.0,5,1079,2.0,811.0,811.0
0.013,6,10,1631,5,848,3.0,580.0,580.0,5,783,3.0,515.0,515.0
0.005,17,2,164,1,74,0.0,46.0,46.0,1,90,0.0,62.0,62.0
0.083,6,10,1506,5,395,17.0,127.0,127.0,5,1111,18.0,843.0,843.0
0.003,17,2,136,1,60,0.0,32.0,32.0,1,76,0.0,48.0,48.0
10.808,17,28,4421,14,1993,823.0,268.0,114.0,14,2428,823.0,587.0,145.0
0.004,6,14,3742,7,452,0.0,80.0,80.0,7,3290,0.0,1448.0,972.0
0.006,6,10,1547,5,764,1.0,496.0,496.0,5,783,1.0,515.0,515.0
0.014,6,10,1983,5,910,3.0,642.0,642.0,5,1073,3.0,805.0,805.0
0.107,6,10,1506,5,395,24.0,127.0,127.0,5,1111,25.0,843.0,843.0
353.995,6,21,1795,16,1030,23599.0,190.0,190.0,5,765,60001.0,464.0,248.0
0.006,17,2,180,1,66,0.0,38.0,38.0,1,114,0.0,86.0,86.0
393.512,6,35,12086,19,3687,21861.0,873.0,448.0,16,8399,22233.0,1402.0,839.0
0.07,6,10,1506,5,395,15.0,127.0,127.0,5,1111,15.0,843.0,843.0
0.013,6,10,1983,5,910,3.0,642.0,642.0,5,1073,3.0,805.0,805.0
0.005,17,4,284,2,120,1.0,32.0,32.0,2,164,0.0,60.0,54.0
0.001,17,2,180,1,66,0.0,38.0,38.0,1,114,0.0,86.0,86.0
0.088,6,10,1506,5,395,18.0,127.0,127.0,5,1111,20.0,843.0,843.0
0.027,6,10,1989,5,910,6.0,642.0,642.0,5,1079,6.0,811.0,811.0
0.106,6,10,1506,5,395,24.0,127.0,127.0,5,1111,22.0,843.0,843.0
328.92,17,20,1124,10,716,36533.0,48.0,43.0,10,408,36532.0,20.0,12.0
0.093,6,10,1506,5,395,20.0,127.0,127.0,5,1111,19.0,843.0,843.0
0.027,6,10,1989,5,910,6.0,642.0,642.0,5,1079,6.0,811.0,811.0
0.012,6,10,1762,5,911,3.0,643.0,643.0,5,851,3.0,583.0,583.0
0.018,6,10,1990,5,911,4.0,643.0,643.0,5,1079,4.0,811.0,811.0
0.123,6,10,1506,5,395,28.0,127.0,127.0,5,1111,29.0,843.0,843.0
0.017,6,10,1989,5,910,4.0,642.0,642.0,5,1079,4.0,811.0,811.0
0.005,6,10,2007,5,928,1.0,660.0,660.0,5,1079,1.0,811.0,811.0
15.083,17,15,8087,8,6054,2150.0,1350.0,728.0,7,2033,2509.0,1350.0,262.0
240.011,6,9,787,5,488,60002.0,232.0,232.0,4,299,80003.0,83.0,83.0
0.008,6,10,1989,5,910,2.0,642.0,642.0,5,1079,2.0,811.0,811.0
0.005,6,10,1989,5,927,1.0,659.0,659.0,5,1062,1.0,794.0,794.0
227.09,58,5,360,4,288,75696.0,24.0,24.0,1,72,0.0,24.0,24.0
0.254,17,2,152,1,76,0.0,48.0,48.0,1,76,0.0,48.0,48.0
0.005,6,10,2006,5,927,1.0,659.0,659.0,5,1079,1.0,811.0,811.0
0.241,6,16,2778,8,1396,34.0,533.0,324.0,8,1382,21.0,529.0,239.0
0.083,6,10,1506,5,395,20.0,127.0,127.0,5,1111,18.0,843.0,843.0
0.005,6,10,2007,5,928,1.0,660.0,660.0,5,1079,1.0,811.0,811.0
1787.119,6,154,19574,92,13852,19638.0,302.0,302.0,62,5722,29296.0,83.0,83.0
0.006,6,10,1547,5,764,1.0,496.0,496.0,5,783,1.0,515.0,515.0
0.009,6,10,1989,5,910,2.0,642.0,642.0,5,1079,2.0,811.0,811.0
0.006,17,2,214,1,75,0.0,47.0,47.0,1,139,0.0,111.0,111.0
0.017,6,10,1983,5,910,4.0,642.0,642.0,5,1073,4.0,805.0,805.0
40.062,17,10,676,5,460,10012.0,104.0,64.0,5,216,10014.0,20.0,15.0
40.065,17,10,676,5,460,10015.0,104.0,64.0,5,216,10015.0,20.0,15.0
0.019,6,10,1605,5,388,4.0,120.0,120.0,5,1217,4.0,949.0,949.0
0.067,17,8,3613,4,1874,22.0,1350.0,440.0,4,1739,11.0,1350.0,406.0
40.057,17,10,676,5,460,10013.0,104.0,64.0,5,216,10012.0,20.0,15.0
0.008,6,12,1926,6,1189,1.0,659.0,434.0,6,737,1.0,417.0,417.0
0.021,6,10,1989,5,910,5.0,642.0,642.0,5,1079,5.0,811.0,811.0
0.005,6,14,3742,8,504,0.0,80.0,80.0,6,3238,0.0,1470.0,1459.0
0.01,6,10,1762,5,911,2.0,643.0,643.0,5,851,2.0,583.0,583.0
0.003,17,2,148,1,60,0.0,32.0,32.0,1,88,0.0,60.0,60.0
0.106,6,10,1506,5,395,24.0,127.0,127.0,5,1111,24.0,843.0,843.0
0.012,6,10,1989,5,910,2.0,642.0,642.0,5,1079,2.0,811.0,811.0
0.001,17,2,179,1,62,0.0,34.0,34.0,1,117,0.0,89.0,89.0
0.131,6,10,1506,5,395,28.0,127.0,127.0,5,1111,31.0,843.0,843.0
0.049,17,2,152,1,76,0.0,48.0,48.0,1,76,0.0,48.0,48.0
0.009,6,10,1990,5,911,2.0,643.0,643.0,5,1079,2.0,811.0,811.0
0.01,6,10,1990,5,911,2.0,643.0,643.0,5,1079,2.0,811.0,811.0
0.042,17,2,136,1,60,0.0,32.0,32.0,1,76,0.0,48.0,48.0
0.007,17,2,179,1,71,0.0,43.0,43.0,1,108,0.0,80.0,80.0
10.739,17,28,4421,14,1993,817.0,268.0,114.0,14,2428,817.0,587.0,145.0
0.007,6,13,3690,7,452,1.0,80.0,80.0,6,3238,1.0,1470.0,1459.0
0.004,6,10,1774,5,923,1.0,655.0,655.0,5,851,1.0,583.0,583.0
0.12,6,10,1506,5,395,23.0,127.0,127.0,5,1111,26.0,843.0,843.0
0.015,6,10,1989,5,910,3.0,642.0,642.0,5,1079,3.0,811.0,811.0
164.125,17,72,10358,36,2406,4689.0,44.0,38.0,36,7952,4689.0,261.0,192.0
0.014,6,10,1983,5,910,3.0,642.0,642.0,5,1073,3.0,805.0,805.0
0.006,6,10,1774,5,923,1.0,655.0,655.0,5,851,1.0,583.0,583.0
0.014,6,10,1631,5,848,3.0,580.0,580.0,5,783,3.0,515.0,515.0
240.088,6,16,4481,9,963,30011.0,238.0,166.0,7,3518,40014.0,1402.0,786.0
0.012,6,10,1990,5,911,3.0,643.0,643.0,5,1079,2.0,811.0,811.0
300.306,6,16,2170,9,684,37517.0,146.0,146.0,7,1486,50023.0,419.0,398.0
0.006,17,2,140,1,62,0.0,34.0,34.0,1,78,0.0,50.0,50.0
15.079,17,16,8525,8,6328,2150.0,1350.0,763.0,8,2197,2149.0,1350.0,246.0
0.015,6,10,1972,5,910,3.0,642.0,642.0,5,1062,3.0,794.0,794.0
0.008,6,10,1762,5,911,1.0,643.0,643.0,5,851,2.0,583.0,583.0
0.005,6,10,2006,5,927,1.0,659.0,659.0,5,1079,1.0,811.0,811.0
0.99,6,29,14194,17,7770,61.0,2720.0,1008.0,12,6424,75.0,2720.0,988.0
0.019,6,10,1677,5,827,4.0,559.0,559.0,5,850,4.0,582.0,582.0
0.005,17,2,148,1,60,0.0,32.0,32.0,1,88,0.0,60.0,60.0
0.04,17,4,364,2,160,0.0,52.0,52.0,2,204,0.0,80.0,74.0
240.103,6,16,4482,9,963,30012.0,238.0,166.0,7,3519,40016.0,1402.0,786.0
0.076,6,10,1506,5,395,18.0,127.0,127.0,5,1111,15.0,843.0,843.0
0.101,6,10,1506,5,395,23.0,127.0,127.0,5,1111,21.0,843.0,843.0
0.005,6,10,2007,5,928,1.0,660.0,660.0,5,1079,1.0,811.0,811.0
0.04,17,4,284,2,120,0.0,32.0,32.0,2,164,36.0,60.0,54.0
174.141,17,80,11338,40,2667,4465.0,44.0,38.0,40,8671,4464.0,239.0,188.0
0.003,17,2,148,1,60,0.0,32.0,32.0,1,88,0.0,60.0,60.0
0.07,6,10,1506,5,395,16.0,127.0,127.0,5,1111,14.0,843.0,843.0
0.052,17,2,152,1,76,0.0,48.0,48.0,1,76,0.0,48.0,48.0
0.006,6,10,1643,5,860,1.0,592.0,592.0,5,783,1.0,515.0,515.0
0.018,6,10,1972,5,910,4.0,642.0,642.0,5,1062,4.0,794.0,794.0
0.016,6,10,1989,5,910,4.0,642.0,642.0,5,1079,3.0,811.0,811.0
0.013,6,10,1677,5,827,3.0,559.0,559.0,5,850,3.0,582.0,582.0
0.009,6,10,1989,5,910,2.0,642.0,642.0,5,1079,2.0,811.0,811.0
333.869,17,20,1124,10,716,37082.0,48.0,43.0,10,408,37082.0,20.0,12.0
40.065,17,10,676,5,460,10015.0,104.0,64.0,5,216,10012.0,20.0,15.0
240.112,6,30,7538,15,5100,17150.0,1515.0,480.0,15,2438,17150.0,580.0,206.0
0.006,6,10,1547,5,764,1.0,496.0,496.0,5,783,1.0,515.0,515.0
0.007,6,10,1989,5,910,1.0,642.0,642.0,5,1079,1.0,811.0,811.0
0.008,6,10,1989,5,910,2.0,642.0,642.0,5,1079,2.0,811.0,811.0
0.145,6,10,1506,5,395,22.0,127.0,127.0,5,1111,30.0,843.0,843.0
0.038,17,2,152,1,76,0.0,48.0,48.0,1,76,0.0,48.0,48.0
0.001,17,2,180,1,66,0.0,38.0,38.0,1,114,0.0,86.0,86.0
0.041,17,2,182,1,65,0.0,37.0,37.0,1,117,0.0,89.0,89.0
0.003,17,2,136,1,60,0.0,32.0,32.0,1,76,0.0,48.0,48.0
173.34,17,90,12570,45,3038,3939.0,44.0,39.0,45,9532,3939.0,261.0,183.0
0.005,17,2,140,1,62,0.0,34.0,34.0,1,78,0.0,50.0,50.0
0.005,6,10,2007,5,928,1.0,660.0,660.0,5,1079,1.0,811.0,811.0
0.123,6,10,1506,5,395,28.0,127.0,127.0,5,1111,26.0,843.0,843.0
0.082,6,10,1506,5,395,18.0,127.0,127.0,5,1111,17.0,843.0,843.0
0.004,6,10,2007,5,928,1.0,660.0,660.0,5,1079,1.0,811.0,811.0
0.006,17,2,170,1,65,0.0,37.0,37.0,1,105,0.0,77.0,77.0
0.011,6,10,1989,5,910,2.0,642.0,642.0,5,1079,2.0,811.0,811.0
0.089,6,10,1506,5,395,19.0,127.0,127.0,5,1111,18.0,843.0,843.0
0.002,17,2,166,1,75,0.0,47.0,47.0,1,91,0.0,63.0,63.0
0.007,6,10,1972,5,910,1.0,642.0,642.0,5,1062,1.0,794.0,794.0
0.107,6,10,1506,5,395,24.0,127.0,127.0,5,1111,20.0,843.0,843.0
120.534,6,60,19239,35,4950,3545.0,1054.0,209.0,25,14289,5022.0,2804.0,927.0
1799.887,17,3067,235119,1529,123889,1177.0,84.0,53.0,1538,111230,1169.0,227.0,44.0
0.013,6,10,1677,5,827,3.0,559.0,559.0,5,850,3.0,582.0,582.0
0.004,17,2,148,1,60,0.0,32.0,32.0,1,88,0.0,60.0,60.0
0.005,6,10,1989,5,927,1.0,659.0,659.0,5,1062,1.0,794.0,794.0
0.008,6,10,1989,5,910,1.0,642.0,642.0,5,1079,2.0,811.0,811.0
0.087,6,10,1506,5,395,20.0,127.0,127.0,5,1111,17.0,843.0,843.0
0.078,6,10,1506,5,395,16.0,127.0,127.0,5,1111,17.0,843.0,843.0
0.014,6,10,1677,5,827,3.0,559.0,559.0,5,850,3.0,582.0,582.0
0.012,6,10,1990,5,911,2.0,643.0,643.0,5,1079,3.0,811.0,811.0
0.117,6,10,1506,5,395,21.0,127.0,127.0,5,1111,25.0,843.0,843.0
0.009,6,10,1989,5,910,2.0,642.0,642.0,5,1079,2.0,811.0,811.0
0.009,6,10,1983,5,910,2.0,642.0,642.0,5,1073,2.0,805.0,805.0
0.015,6,10,1989,5,910,3.0,642.0,642.0,5,1079,3.0,811.0,811.0
0.013,6,10,1989,5,910,3.0,642.0,642.0,5,1079,3.0,811.0,811.0
0.1,6,10,1506,5,395,23.0,127.0,127.0,5,1111,24.0,843.0,843.0
11.038,17,28,4397,14,2312,840.0,587.0,137.0,14,2085,840.0,268.0,120.0
0.027,6,13,3735,7,497,4.0,125.0,125.0,6,3238,5.0,1470.0,1459.0
0.087,6,10,1506,5,395,18.0,127.0,127.0,5,1111,16.0,843.0,843.0
0.01,6,10,1990,5,911,2.0,643.0,643.0,5,1079,2.0,811.0,811.0
0.005,6,10,2006,5,927,1.0,659.0,659.0,5,1079,1.0,811.0,811.0
0.006,6,11,1906,6,941,1.0,621.0,621.0,5,965,1.0,697.0,697.0
0.012,6,6,716,3,458,4.0,302.0,302.0,3,258,4.0,102.0,102.0
0.009,6,10,1990,5,911,2.0,643.0,643.0,5,1079,2.0,811.0,811.0
0.012,6,10,1972,5,910,3.0,642.0,642.0,5,1062,2.0,794.0,794.0
0.009,6,10,2006,5,927,2.0,659.0,659.0,5,1079,2.0,811.0,811.0
0.153,6,10,1506,5,395,36.0,127.0,127.0,5,1111,32.0,843.0,843.0
0.009,6,10,1989,5,910,2.0,642.0,642.0,5,1079,2.0,811.0,811.0
0.005,6,10,1989,5,927,1.0,659.0,659.0,5,1062,1.0,794.0,794.0
0.003,17,2,152,1,76,0.0,48.0,48.0,1,76,0.0,48.0,48.0
0.078,6,10,1506,5,395,16.0,127.0,127.0,5,1111,17.0,843.0,843.0
0.009,6,12,1926,6,1189,1.0,659.0,434.0,6,737,1.0,417.0,417.0
0.003,17,2,234,1,61,0.0,33.0,33.0,1,173,0.0,145.0,145.0
0.004,6,10,1774,5,923,1.0,655.0,655.0,5,851,1.0,583.0,583.0
0.009,6,10,1983,5,910,2.0,642.0,642.0,5,1073,2.0,805.0,805.0
0.006,6,10,1547,5,764,1.0,496.0,496.0,5,783,1.0,515.0,515.0
0.041,17,2,152,1,76,0.0,48.0,48.0,1,76,0.0,48.0,48.0
0.06,17,2,152,1,76,0.0,48.0,48.0,1,76,0.0,48.0,48.0
0.006,6,10,1547,5,764,1.0,496.0,496.0,5,783,1.0,515.0,515.0
0.013,17,2,148,1,60,0.0,32.0,32.0,1,88,0.0,60.0,60.0
0.007,6,12,1698,6,863,1.0,327.0,271.0,6,835,1.0,515.0,515.0
0.01,6,10,1972,5,910,2.0,642.0,642.0,5,1062,2.0,794.0,794.0
0.066,17,8,3613,4,1874,22.0,1350.0,440.0,4,1739,11.0,1350.0,406.0
0.005,6,13,3690,7,452,0.0,80.0,80.0,6,3238,1.0,1470.0,1459.0
0.026,6,10,1972,5,910,6.0,642.0,642.0,5,1062,6.0,794.0,794.0
0.265,17,39,20429,21,17035,13.0,1350.0,783.0,18,3394,11.0,1350.0,160.0
0.326,17,40,22917,22,18423,15.0,1350.0,809.0,18,4494,15.0,1350.0,221.0
0.01,6,10,1983,5,910,2.0,642.0,642.0,5,1073,2.0,805.0,805.0
30.56,6,23,7962,13,2924,2546.0,1191.0,449.0,10,5038,3378.0,1402.0,751.0
0.006,6,10,1854,5,889,1.0,621.0,621.0,5,965,1.0,697.0,697.0
0.001,17,2,136,1,60,0.0,32.0,32.0,1,76,0.0,48.0,48.0
40.07,17,10,676,5,460,10016.0,104.0,64.0,5,216,10016.0,20.0,15.0
0.109,6,10,1506,5,395,25.0,127.0,127.0,5,1111,21.0,843.0,843.0
40.061,17,10,676,5,460,10014.0,104.0,64.0,5,216,10014.0,20.0,15.0
0.004,6,10,1989,5,927,1.0,659.0,659.0,5,1062,1.0,794.0,794.0
0.005,6,14,3742,7,452,0.0,80.0,80.0,7,3290,0.0,1448.0,972.0
311.304,17,20,1124,10,716,34575.0,48.0,43.0,10,408,34575.0,20.0,12.0
0.04,6,10,1989,5,910,10.0,642.0,642.0,5,1079,10.0,811.0,811.0
0.005,17,2,169,1,62,0.0,34.0,34.0,1,107,0.0,79.0,79.0
0.0,17,2,154,1,69,0.0,41.0,41.0,1,85,0.0,57.0,57.0
0.015,6,10,1972,5,910,3.0,642.0,642.0,5,1062,3.0,794.0,794.0
40.065,17,10,676,5,460,10014.0,104.0,64.0,5,216,10015.0,20.0,15.0
0.004,6,10,1774,5,923,1.0,655.0,655.0,5,851,1.0,583.0,583.0
0.227,6,16,2670,8,1396,32.0,533.0,324.0,8,1274,20.0,529.0,212.0
0.006,6,10,1547,5,764,1.0,496.0,496.0,5,783,1.0,515.0,515.0
0.005,17,2,140,1,62,0.0,34.0,34.0,1,78,0.0,50.0,50.0
0.084,6,10,1506,5,395,20.0,127.0,127.0,5,1111,17.0,843.0,843.0
0.008,6,10,2006,5,927,2.0,659.0,659.0,5,1079,2.0,811.0,811.0
300.019,6,12,1782,7,1348,50003.0,494.0,494.0,5,434,75004.0,83.0,83.0
0.102,6,10,1506,5,395,21.0,127.0,127.0,5,1111,21.0,843.0,843.0
8.983,6,39,10753,20,5195,472.0,1360.0,727.0,19,5558,487.0,2667.0,435.0
0.001,17,2,180,1,66,0.0,38.0,38.0,1,114,0.0,86.0,86.0
0.009,6,10,1989,5,910,2.0,642.0,642.0,5,1079,2.0,811.0,811.0
0.308,17,15,9899,8,6907,44.0,1350.0,835.0,7,2992,42.0,1350.0,399.0
0.106,6,10,1506,5,395,25.0,127.0,127.0,5,1111,24.0,843.0,843.0
0.013,6,10,1989,5,910,3.0,642.0,642.0,5,1079,3.0,811.0,811.0
0.005,6,10,2000,5,927,1.0,659.0,659.0,5,1073,1.0,805.0,805.0
0.017,6,10,1972,5,910,4.0,642.0,642.0,5,1062,4.0,794.0,794.0
0.094,6,10,1506,5,395,21.0,127.0,127.0,5,1111,20.0,843.0,843.0
40.063,17,10,676,5,460,10012.0,104.0,64.0,5,216,10015.0,20.0,15.0
0.009,6,10,1762,5,911,2.0,643.0,643.0,5,851,2.0,583.0,583.0
0.168,17,2,152,1,76,0.0,48.0,48.0,1,76,0.0,48.0,48.0
0.01,6,10,1990,5,911,2.0,643.0,643.0,5,1079,2.0,811.0,811.0
0.006,6,10,1689,5,839,1.0,571.0,571.0,5,850,1.0,582.0,582.0
0.005,6,10,1854,5,889,1.0,621.0,621.0,5,965,1.0,697.0,697.0
0.165,17,2,213,1,69,0.0,41.0,41.0,1,144,0.0,116.0,116.0
0.132,6,10,1506,5,395,30.0,127.0,127.0,5,1111,30.0,843.0,843.0
240.033,6,9,787,5,488,60008.0,232.0,232.0,4,299,80010.0,83.0,83.0
0.019,6,10,1972,5,910,4.0,642.0,642.0,5,1062,4.0,794.0,794.0
0.005,6,10,1689,5,839,1.0,571.0,571.0,5,850,1.0,582.0,582.0
264.878,17,18,1008,9,640,33095.0,48.0,43.0,9,368,33096.0,20.0,12.0
0.125,6,10,1506,5,395,26.0,127.0,127.0,5,1111,27.0,843.0,843.0
0.015,17,2,136,1,60,0.0,32.0,32.0,1,76,0.0,48.0,48.0
0.109,6,10,1506,5,395,25.0,127.0,127.0,5,1111,20.0,843.0,843.0
0.162,6,10,1506,5,395,30.0,127.0,127.0,5,1111,37.0,843.0,843.0
0.018,6,10,1989,5,910,4.0,642.0,642.0,5,1079,4.0,811.0,811.0
0.005,17,2,214,1,75,0.0,47.0,47.0,1,139,0.0,111.0,111.0
0.132,6,10,1506,5,395,27.0,127.0,127.0,5,1111,28.0,843.0,843.0
0.001,17,2,180,1,66,0.0,38.0,38.0,1,114,0.0,86.0,86.0
0.005,6,10,2000,5,927,1.0,659.0,659.0,5,1073,1.0,805.0,805.0
0.089,6,10,1506,5,395,19.0,127.0,127.0,5,1111,17.0,843.0,843.0
0.005,6,10,1689,5,839,1.0,571.0,571.0,5,850,1.0,582.0,582.0
0.042,17,2,148,1,60,0.0,32.0,32.0,1,88,0.0,60.0,60.0
0.133,6,10,1506,5,395,31.0,127.0,127.0,5,1111,28.0,843.0,843.0
0.005,17,2,230,1,68,0.0,40.0,40.0,1,162,0.0,134.0,134.0
0.071,6,10,1506,5,395,16.0,127.0,127.0,5,1111,15.0,843.0,843.0
0.005,6,10,2000,5,927,1.0,659.0,659.0,5,1073,1.0,805.0,805.0
0.005,6,10,1643,5,860,1.0,592.0,592.0,5,783,1.0,515.0,515.0
0.005,6,10,2000,5,927,1.0,659.0,659.0,5,1073,1.0,805.0,805.0
0.126,6,10,1506,5,395,28.0,127.0,127.0,5,1111,30.0,843.0,843.0
0.004,17,2,148,1,60,0.0,32.0,32.0,1,88,0.0,60.0,60.0
0.012,6,10,1990,5,911,3.0,643.0,643.0,5,1079,3.0,811.0,811.0
0.006,6,10,2007,5,928,1.0,660.0,660.0,5,1079,1.0,811.0,811.0
0.041,6,10,1990,5,911,10.0,643.0,643.0,5,1079,10.0,811.0,811.0
0.008,6,10,1631,5,848,2.0,580.0,580.0,5,783,2.0,515.0,515.0
0.004,6,10,1989,5,927,1.0,659.0,659.0,5,1062,1.0,794.0,794.0
0.119,6,10,1506,5,395,23.0,127.0,127.0,5,1111,26.0,843.0,843.0
0.019,6,10,1631,5,848,4.0,580.0,580.0,5,783,4.0,515.0,515.0
0.006,6,10,1689,5,839,1.0,571.0,571.0,5,850,1.0,582.0,582.0
0.005,6,14,3742,7,452,0.0,80.0,80.0,7,3290,0.0,1448.0,972.0
0.018,6,10,1762,5,911,4.0,643.0,643.0,5,851,4.0,583.0,583.0
0.012,6,10,1989,5,910,3.0,642.0,642.0,5,1079,3.0,811.0,811.0
0.013,6,10,1762,5,911,3.0,643.0,643.0,5,851,3.0,583.0,583.0
309.87,17,20,1124,10,716,34415.0,48.0,43.0,10,408,34415.0,20.0,12.0
0.006,6,10,1689,5,839,1.0,571.0,571.0,5,850,1.0,582.0,582.0
0.005,17,2,195,1,60,0.0,32.0,32.0,1,135,0.0,107.0,107.0
0.005,6,10,2007,5,928,1.0,660.0,660.0,5,1079,1.0,811.0,811.0
0.005,17,2,140,1,62,0.0,34.0,34.0,1,78,0.0,50.0,50.0
40.064,17,10,676,5,460,10014.0,104.0,64.0,5,216,10015.0,20.0,15.0
0.136,6,10,1506,5,395,31.0,127.0,127.0,5,1111,29.0,843.0,843.0
0.012,6,10,1983,5,910,3.0,642.0,642.0,5,1073,2.0,805.0,805.0
0.004,6,10,1774,5,923,1.0,655.0,655.0,5,851,1.0,583.0,583.0
0.005,6,10,2006,5,927,1.0,659.0,659.0,5,1079,1.0,811.0,811.0
0.006,6,10,1854,5,889,1.0,621.0,621.0,5,965,1.0,697.0,697.0
0.006,17,4,284,2,120,0.0,32.0,32.0,2,164,0.0,60.0,54.0
0.013,6,10,1762,5,911,3.0,643.0,643.0,5,851,3.0,583.0,583.0
0.005,17,2,164,1,74,0.0,46.0,46.0,1,90,0.0,62.0,62.0
0.015,6,10,1677,5,827,3.0,559.0,559.0,5,850,3.0,582.0,582.0
15.071,17,15,9238,8,6902,2148.0,1350.0,834.0,7,2336,2506.0,1350.0,305.0
0.02,6,10,1762,5,911,4.0,643.0,643.0,5,851,4.0,583.0,583.0
300.019,6,12,1782,7,1348,50003.0,494.0,494.0,5,434,75004.0,83.0,83.0
0.011,6,10,1989,5,910,2.0,642.0,642.0,5,1079,2.0,811.0,811.0
0.008,6,10,1972,5,910,2.0,642.0,642.0,5,1062,1.0,794.0,794.0
0.004,17,2,166,1,75,0.0,47.0,47.0,1,91,0.0,63.0,63.0
0.096,6,10,1506,5,395,19.0,127.0,127.0,5,1111,22.0,843.0,843.0
40.058,17,10,676,5,460,10013.0,104.0,64.0,5,216,10013.0,20.0,15.0
0.005,6,10,2006,5,927,1.0,659.0,659.0,5,1079,1.0,811.0,811.0
0.014,6,10,1983,5,910,3.0,642.0,642.0,5,1073,3.0,805.0,805.0
0.04,17,4,284,2,120,0.0,32.0,32.0,2,164,37.0,60.0,54.0
0.005,6,10,1547,5,764,1.0,496.0,496.0,5,783,1.0,515.0,515.0
0.022,6,10,1989,5,910,5.0,642.0,642.0,5,1079,5.0,811.0,811.0
0.006,17,2,166,1,75,0.0,47.0,47.0,1,91,0.0,63.0,63.0
0.01,6,10,1989,5,910,2.0,642.0,642.0,5,1079,2.0,811.0,811.0
0.105,6,10,1506,5,395,24.0,127.0,127.0,5,1111,16.0,843.0,843.0
0.011,6,10,1990,5,911,2.0,643.0,643.0,5,1079,2.0,811.0,811.0
0.127,6,10,1506,5,395,25.0,127.0,127.0,5,1111,28.0,843.0,843.0
0.006,6,10,1643,5,860,1.0,592.0,592.0,5,783,1.0,515.0,515.0
0.006,6,10,1547,5,764,1.0,496.0,496.0,5,783,1.0,515.0,515.0
0.005,6,10,2000,5,927,1.0,659.0,659.0,5,1073,1.0,805.0,805.0
300.411,6,16,2170,9,684,37531.0,146.0,146.0,7,1486,50041.0,419.0,398.0
0.003,17,2,136,1,60,0.0,32.0,32.0,1,76,0.0,48.0,48.0
0.007,6,10,1972,5,910,1.0,642.0,642.0,5,1062,1.0,794.0,794.0
0.017,6,10,1631,5,848,4.0,580.0,580.0,5,783,4.0,515.0,515.0
0.004,6,10,2000,5,927,1.0,659.0,659.0,5,1073,1.0,805.0,805.0
0.009,17,2,194,1,59,0.0,31.0,31.0,1,135,0.0,107.0,107.0
0.005,6,10,2000,5,927,1.0,659.0,659.0,5,1073,1.0,805.0,805.0
0.004,6,10,1989,5,927,1.0,659.0,659.0,5,1062,1.0,794.0,794.0
0.006,6,10,1547,5,764,1.0,496.0,496.0,5,783,1.0,515.0,515.0
40.082,17,10,676,5,460,10017.0,104.0,64.0,5,216,10019.0,20.0,15.0
0.006,6,10,1689,5,839,1.0,571.0,571.0,5,850,1.0,582.0,582.0
0.004,17,4,284,2,120,0.0,32.0,32.0,2,164,1.0,60.0,54.0
0.096,6,10,1506,5,395,22.0,127.0,127.0,5,1111,21.0,843.0,843.0
0.006,6,10,1689,5,839,1.0,571.0,571.0,5,850,1.0,582.0,582.0
0.004,6,10,1702,5,863,1.0,595.0,595.0,5,839,1.0,571.0,571.0
240.057,6,9,787,5,488,60014.0,232.0,232.0,4,299,80016.0,83.0,83.0
0.013,6,10,1972,5,910,3.0,642.0,642.0,5,1062,3.0,794.0,794.0
0.005,6,10,2007,5,928,1.0,660.0,660.0,5,1079,1.0,811.0,811.0
0.124,6,10,1506,5,395,26.0,127.0,127.0,5,1111,26.0,843.0,843.0
40.061,17,10,676,5,460,10014.0,104.0,64.0,5,216,10014.0,20.0,15.0
0.006,6,10,1547,5,764,1.0,496.0,496.0,5,783,1.0,515.0,515.0
0.014,6,10,1631,5,848,3.0,580.0,580.0,5,783,3.0,515.0,515.0
11.276,17,28,4421,14,1993,854.0,268.0,114.0,14,2428,854.0,587.0,145.0
0.01,6,10,1989,5,910,2.0,642.0,642.0,5,1079,2.0,811.0,811.0
0.008,6,10,1989,5,910,2.0,642.0,642.0,5,1079,2.0,811.0,811.0
0.09,6,10,1506,5,395,20.0,127.0,127.0,5,1111,19.0,843.0,843.0
0.008,6,10,1989,5,910,2.0,642.0,642.0,5,1079,1.0,811.0,811.0
0.004,6,10,2006,5,927,1.0,659.0,659.0,5,1079,1.0,811.0,811.0
0.008,6,10,1983,5,910,2.0,642.0,642.0,5,1073,1.0,805.0,805.0
1778.95,17,144,45504,72,22752,25054.0,288.0,288.0,72,22752,25051.0,288.0,288.0
0.09,6,10,1506,5,395,20.0,127.0,127.0,5,1111,19.0,843.0,843.0
0.007,17,2,179,1,71,0.0,43.0,43.0,1,108,0.0,80.0,80.0
241.524,6,296,342727,119,17697,2046.0,2736.0,822.0,177,325030,1372.0,2804.0,1914.0
0.009,6,10,1677,5,827,2.0,559.0,559.0,5,850,2.0,582.0,582.0
0.008,17,2,194,1,59,0.0,31.0,31.0,1,135,0.0,107.0,107.0
0.087,6,10,1506,5,395,21.0,127.0,127.0,5,1111,19.0,843.0,843.0
15.082,17,16,8549,8,6440,2150.0,1350.0,777.0,8,2109,2150.0,1350.0,235.0
0.111,6,10,1506,5,395,23.0,127.0,127.0,5,1111,26.0,843.0,843.0
0.013,6,10,1983,5,910,3.0,642.0,642.0,5,1073,3.0,805.0,805.0
255.547,6,36,9720,15,6811,18253.0,1934.0,670.0,21,2909,12777.0,580.0,150.0
0.006,6,10,1989,5,927,1.0,659.0,659.0,5,1062,1.0,794.0,794.0
0.005,6,10,1547,5,764,1.0,496.0,496.0,5,783,1.0,515.0,515.0
0.006,6,13,3747,7,509,0.0,137.0,137.0,6,3238,1.0,1470.0,1459.0
0.006,17,2,209,1,64,0.0,36.0,36.0,1,145,0.0,117.0,117.0
0.005,6,10,2000,5,927,1.0,659.0,659.0,5,1073,1.0,805.0,805.0
0.006,6,10,1547,5,764,1.0,496.0,496.0,5,783,1.0,515.0,515.0
0.009,6,10,1989,5,910,2.0,642.0,642.0,5,1079,2.0,811.0,811.0
0.005,6,10,1689,5,839,1.0,571.0,571.0,5,850,1.0,582.0,582.0
0.104,6,10,1506,5,395,24.0,127.0,127.0,5,1111,25.0,843.0,843.0
40.06,17,10,676,5,460,10011.0,104.0,64.0,5,216,10014.0,20.0,15.0
0.092,6,10,1506,5,395,18.0,127.0,127.0,5,1111,21.0,843.0,843.0
11.091,17,28,4423,14,1995,840.0,270.0,114.0,14,2428,840.0,587.0,145.0
0.094,6,10,1506,5,395,21.0,127.0,127.0,5,1111,17.0,843.0,843.0
66.115,6,27,17745,15,9799,4722.0,2804.0,1501.0,12,7946,5995.0,2431.0,1219.0
301.151,6,57,29041,31,22974,10038.0,2720.0,1446.0,26,6067,359.0,2667.0,385.0
0.077,17,4,352,2,130,39.0,37.0,37.0,2,222,40.0,89.0,83.0
0.004,17,2,136,1,60,0.0,32.0,32.0,1,76,0.0,48.0,48.0
0.041,17,4,284,2,120,0.0,32.0,32.0,2,164,38.0,60.0,54.0
0.085,6,10,1506,5,395,20.0,127.0,127.0,5,1111,20.0,843.0,843.0
0.102,6,10,1506,5,395,22.0,127.0,127.0,5,1111,23.0,843.0,843.0
0.006,17,2,136,1,60,0.0,32.0,32.0,1,76,0.0,48.0,48.0
0.123,6,10,1506,5,395,27.0,127.0,127.0,5,1111,24.0,843.0,843.0
0.024,6,10,1989,5,910,5.0,642.0,642.0,5,1079,6.0,811.0,811.0
1.113,6,32,13392,18,5893,65.0,2720.0,854.0,14,7499,72.0,2720.0,769.0
40.087,17,10,676,5,460,10019.0,104.0,64.0,5,216,10021.0,20.0,15.0
1793.809,6,294,44934,120,25215,15072.0,2076.0,221.0,174,19719,10368.0,1360.0,151.0
0.007,6,10,1854,5,889,1.0,621.0,621.0,5,965,1.0,697.0,697.0
0.004,17,2,136,1,60,0.0,32.0,32.0,1,76,0.0,48.0,48.0
10.825,17,28,4417,14,1993,823.0,268.0,114.0,14,2424,823.0,587.0,145.0
0.012,6,10,1972,5,910,2.0,642.0,642.0,5,1062,3.0,794.0,794.0
0.004,6,10,1989,5,927,1.0,659.0,659.0,5,1062,1.0,794.0,794.0
0.005,6,14,3799,7,509,0.0,137.0,137.0,7,3290,0.0,1448.0,972.0
0.009,6,10,1677,5,827,2.0,559.0,559.0,5,850,2.0,582.0,582.0
0.074,6,10,1506,5,395,17.0,127.0,127.0,5,1111,16.0,843.0,843.0
0.004,6,10,1702,5,863,0.0,595.0,595.0,5,839,1.0,571.0,571.0
0.012,6,10,1990,5,911,3.0,643.0,643.0,5,1079,2.0,811.0,811.0
0.006,6,10,1643,5,860,1.0,592.0,592.0,5,783,1.0,515.0,515.0
0.005,6,10,2007,5,928,1.0,660.0,660.0,5,1079,1.0,811.0,811.0
0.022,6,10,1989,5,910,5.0,642.0,642.0,5,1079,5.0,811.0,811.0
0.095,6,10,1506,5,395,20.0,127.0,127.0,5,1111,21.0,843.0,843.0
282.492,6,24,7264,10,1186,31388.0,267.0,156.0,14,6078,21729.0,1400.0,919.0
0.013,6,10,1972,5,910,3.0,642.0,642.0,5,1062,3.0,794.0,794.0
0.005,6,10,2006,5,927,1.0,659.0,659.0,5,1079,1.0,811.0,811.0
0.158,6,10,1506,5,395,33.0,127.0,127.0,5,1111,35.0,843.0,843.0
300.427,6,27,8904,15,1909,21459.0,517.0,280.0,12,6995,21850.0,1402.0,909.0
0.017,6,10,1989,5,910,4.0,642.0,642.0,5,1079,4.0,811.0,811.0
0.054,17,2,152,1,76,0.0,48.0,48.0,1,76,0.0,48.0,48.0
0.004,17,2,136,1,60,0.0,32.0,32.0,1,76,0.0,48.0,48.0
0.005,17,2,166,1,75,0.0,47.0,47.0,1,91,0.0,63.0,63.0
0.004,6,10,1702,5,863,1.0,595.0,595.0,5,839,1.0,571.0,571.0
0.005,17,2,166,1,75,0.0,47.0,47.0,1,91,0.0,63.0,63.0
0.1,6,10,1506,5,395,18.0,127.0,127.0,5,1111,22.0,843.0,843.0
0.107,6,10,1506,5,395,25.0,127.0,127.0,5,1111,25.0,843.0,843.0
0.008,6,10,2006,5,927,1.0,659.0,659.0,5,1079,2.0,811.0,811.0
371.56,6,22,2313,16,867,24770.0,195.0,195.0,6,1446,4640.0,419.0,398.0
173.337,17,90,12617,45,3038,3939.0,44.0,39.0,45,9579,3939.0,239.0,184.0
175.17,17,78,11163,39,2611,4609.0,44.0,38.0,39,8552,4609.0,261.0,191.0
0.005,6,10,2006,5,927,1.0,659.0,659.0,5,1079,1.0,811.0,811.0
0.014,6,10,1972,5,910,3.0,642.0,642.0,5,1062,3.0,794.0,794.0
0.026,6,10,1972,5,910,6.0,642.0,642.0,5,1062,6.0,794.0,794.0
0.008,6,10,2006,5,927,2.0,659.0,659.0,5,1079,1.0,811.0,811.0
11.196,17,28,4423,14,1995,849.0,270.0,114.0,14,2428,849.0,587.0,145.0
40.063,17,10,676,5,460,10012.0,104.0,64.0,5,216,10015.0,20.0,15.0
0.005,6,10,2006,5,927,1.0,659.0,659.0,5,1079,1.0,811.0,811.0
0.001,17,2,142,1,63,0.0,35.0,35.0,1,79,0.0,51.0,51.0
0.004,17,4,284,2,120,0.0,32.0,32.0,2,164,1.0,60.0,54.0
0.001,17,2,180,1,66,0.0,38.0,38.0,1,114,0.0,86.0,86.0
40.061,17,10,676,5,460,10012.0,104.0,64.0,5,216,10014.0,20.0,15.0
0.013,6,10,1983,5,910,3.0,642.0,642.0,5,1073,3.0,805.0,805.0
0.009,6,10,1989,5,910,2.0,642.0,642.0,5,1079,2.0,811.0,811.0
0.004,6,10,2006,5,927,1.0,659.0,659.0,5,1079,1.0,811.0,811.0
0.013,6,10,1990,5,911,3.0,643.0,643.0,5,1079,3.0,811.0,811.0
0.012,6,10,1972,5,910,3.0,642.0,642.0,5,1062,3.0,794.0,794.0
0.072,17,2,412,1,61,0.0,33.0,33.0,1,351,0.0,323.0,323.0
11.233,17,28,4422,14,1994,851.0,269.0,114.0,14,2428,851.0,587.0,145.0
0.005,6,10,1854,5,889,1.0,621.0,621.0,5,965,1.0,697.0,697.0
0.253,17,44,24320,24,21172,11.0,1350.0,854.0,20,3148,10.0,1350.0,129.0
0.126,6,10,1506,5,395,24.0,127.0,127.0,5,1111,29.0,843.0,843.0
0.006,6,10,1689,5,839,1.0,571.0,571.0,5,850,1.0,582.0,582.0
0.107,6,10,1506,5,395,23.0,127.0,127.0,5,1111,25.0,843.0,843.0
0.008,6,12,1926,6,1189,1.0,659.0,434.0,6,737,1.0,417.0,417.0
0.005,6,10,1989,5,927,1.0,659.0,659.0,5,1062,1.0,794.0,794.0
0.004,6,10,1989,5,927,1.0,659.0,659.0,5,1062,1.0,794.0,794.0
15.071,17,15,9238,8,6902,2148.0,1350.0,834.0,7,2336,2507.0,1350.0,305.0
0.005,6,10,1989,5,927,1.0,659.0,659.0,5,1062,1.0,794.0,794.0
0.005,17,2,166,1,75,0.0,47.0,47.0,1,91,0.0,63.0,63.0
0.005,6,14,3799,7,509,0.0,137.0,137.0,7,3290,0.0,1448.0,972.0
40.075,17,10,676,5,460,10017.0,104.0,64.0,5,216,10017.0,20.0,15.0
0.015,6,10,1631,5,848,3.0,580.0,580.0,5,783,3.0,515.0,515.0
0.241,17,4,596,2,122,167.0,33.0,33.0,2,474,204.0,323.0,209.0
0.005,6,10,1689,5,839,1.0,571.0,571.0,5,850,1.0,582.0,582.0
240.093,6,16,4481,9,963,30011.0,238.0,166.0,7,3518,40015.0,1402.0,786.0
0.005,6,10,2000,5,927,1.0,659.0,659.0,5,1073,1.0,805.0,805.0
0.839,6,10,2009,6,1655,167.0,1403.0,1403.0,4,354,200.0,182.0,182.0
0.005,6,10,1989,5,927,1.0,659.0,659.0,5,1062,1.0,794.0,794.0
0.017,17,2,144,1,64,0.0,36.0,36.0,1,80,0.0,52.0,52.0
0.007,17,2,136,1,60,0.0,32.0,32.0,1,76,0.0,48.0,48.0
0.005,6,10,1989,5,927,1.0,659.0,659.0,5,1062,1.0,794.0,794.0
0.008,6,12,1926,6,1189,1.0,659.0,434.0,6,737,1.0,417.0,417.0
0.112,6,10,1506,5,395,23.0,127.0,127.0,5,1111,22.0,843.0,843.0
0.006,6,10,1547,5,764,1.0,496.0,496.0,5,783,1.0,515.0,515.0
0.006,6,10,1547,5,764,1.0,496.0,496.0,5,783,1.0,515.0,515.0
0.001,17,2,180,1,66,0.0,38.0,38.0,1,114,0.0,86.0,86.0
0.018,6,10,1990,5,911,4.0,643.0,643.0,5,1079,4.0,811.0,811.0
0.038,17,2,148,1,60,0.0,32.0,32.0,1,88,0.0,60.0,60.0
0.004,17,2,160,1,72,0.0,44.0,44.0,1,88,0.0,60.0,60.0
0.015,6,10,1990,5,911,3.0,643.0,643.0,5,1079,3.0,811.0,811.0
1792.66,6,308,98654,189,87116,9535.0,2001.0,683.0,119,11538,15191.0,452.0,71.0
0.003,17,4,284,2,120,0.0,32.0,32.0,2,164,0.0,60.0,54.0
240.108,6,32,9277,16,6867,16007.0,1515.0,603.0,16,2410,16006.0,580.0,196.0
0.006,6,10,1854,5,889,1.0,621.0,621.0,5,965,1.0,697.0,697.0
15.08,17,15,8231,8,6005,2150.0,1350.0,722.0,7,2226,2508.0,1350.0,290.0
0.005,6,10,1547,5,764,1.0,496.0,496.0,5,783,1.0,515.0,515.0
0.014,6,10,1990,5,911,3.0,643.0,643.0,5,1079,3.0,811.0,811.0
40.056,17,10,676,5,460,10013.0,104.0,64.0,5,216,10012.0,20.0,15.0
40.073,17,10,676,5,460,10017.0,104.0,64.0,5,216,10017.0,20.0,15.0
0.004,6,10,1702,5,863,1.0,595.0,595.0,5,839,1.0,571.0,571.0
0.012,6,10,1989,5,910,2.0,642.0,642.0,5,1079,2.0,811.0,811.0
0.044,17,2,166,1,75,0.0,47.0,47.0,1,91,0.0,63.0,63.0
0.045,17,4,284,2,120,0.0,32.0,32.0,2,164,41.0,60.0,54.0
0.005,6,14,3742,7,452,0.0,80.0,80.0,7,3290,0.0,1448.0,972.0
0.001,17,2,180,1,66,0.0,38.0,38.0,1,114,0.0,86.0,86.0
0.685,6,22,5072,11,1250,58.0,325.0,133.0,11,3822,57.0,1414.0,563.0
0.122,6,10,1506,5,395,19.0,127.0,127.0,5,1111,28.0,843.0,843.0
0.005,17,2,179,1,71,0.0,43.0,43.0,1,108,0.0,80.0,80.0
0.006,6,10,1643,5,860,1.0,592.0,592.0,5,783,1.0,515.0,515.0
0.104,6,10,1506,5,395,22.0,127.0,127.0,5,1111,24.0,843.0,843.0
0.009,17,2,148,1,60,0.0,32.0,32.0,1,88,0.0,60.0,60.0
11.032,17,28,4393,14,2311,840.0,586.0,137.0,14,2082,840.0,269.0,120.0
0.12,6,10,1506,5,395,25.0,127.0,127.0,5,1111,25.0,843.0,843.0
0.005,6,10,1989,5,927,1.0,659.0,659.0,5,1062,1.0,794.0,794.0
0.098,6,10,1506,5,395,21.0,127.0,127.0,5,1111,22.0,843.0,843.0
0.079,6,10,1506,5,395,19.0,127.0,127.0,5,1111,15.0,843.0,843.0
0.005,6,10,1989,5,927,1.0,659.0,659.0,5,1062,1.0,794.0,794.0
0.008,6,10,1989,5,910,2.0,642.0,642.0,5,1079,2.0,811.0,811.0
0.017,6,10,1990,5,911,4.0,643.0,643.0,5,1079,4.0,811.0,811.0
0.0,17,2,136,1,60,0.0,32.0,32.0,1,76,0.0,48.0,48.0
40.072,17,10,676,5,460,10014.0,104.0,64.0,5,216,10017.0,20.0,15.0
0.04,17,2,170,1,65,0.0,37.0,37.0,1,105,0.0,77.0,77.0
0.134,17,2,186,1,61,0.0,33.0,33.0,1,125,0.0,97.0,97.0
0.005,6,10,1989,5,927,1.0,659.0,659.0,5,1062,1.0,794.0,794.0
0.005,6,10,2006,5,927,1.0,659.0,659.0,5,1079,1.0,811.0,811.0
300.341,6,16,2170,9,684,37522.0,146.0,146.0,7,1486,50029.0,419.0,398.0
40.064,17,10,676,5,460,10014.0,104.0,64.0,5,216,10014.0,20.0,15.0
0.127,17,2,148,1,60,0.0,32.0,32.0,1,88,0.0,60.0,60.0
0.013,6,10,1989,5,910,3.0,642.0,642.0,5,1079,3.0,811.0,811.0
0.01,6,14,3787,7,497,1.0,125.0,125.0,7,3290,1.0,1448.0,972.0
0.005,6,10,1779,5,928,1.0,660.0,660.0,5,851,1.0,583.0,583.0
0.008,6,10,1762,5,911,2.0,643.0,643.0,5,851,1.0,583.0,583.0
0.001,17,2,180,1,66,0.0,38.0,38.0,1,114,0.0,86.0,86.0
0.08,6,10,1506,5,395,13.0,127.0,127.0,5,1111,18.0,843.0,843.0
0.015,6,10,1762,5,911,3.0,643.0,643.0,5,851,3.0,583.0,583.0
0.12,6,10,1506,5,395,24.0,127.0,127.0,5,1111,21.0,843.0,843.0
0.005,6,10,1643,5,860,1.0,592.0,592.0,5,783,1.0,515.0,515.0
0.004,6,10,1989,5,927,1.0,659.0,659.0,5,1062,1.0,794.0,794.0
0.008,6,10,1990,5,911,1.0,643.0,643.0,5,1079,1.0,811.0,811.0
0.005,17,2,144,1,64,0.0,36.0,36.0,1,80,0.0,52.0,52.0
10.931,17,28,4418,14,1994,831.0,269.0,114.0,14,2424,830.0,587.0,145.0
0.008,6,10,1989,5,910,2.0,642.0,642.0,5,1079,1.0,811.0,811.0
0.005,6,13,3747,7,509,0.0,137.0,137.0,6,3238,1.0,1470.0,1459.0
0.008,6,10,1972,5,910,2.0,642.0,642.0,5,1062,2.0,794.0,794.0
0.008,6,10,2006,5,927,2.0,659.0,659.0,5,1079,1.0,811.0,811.0
40.055,17,10,676,5,460,10012.0,104.0,64.0,5,216,10013.0,20.0,15.0
0.005,6,10,2006,5,927,1.0,659.0,659.0,5,1079,1.0,811.0,811.0
0.018,6,14,3787,7,497,2.0,125.0,125.0,7,3290,3.0,1448.0,972.0
1729.193,6,60,4400,40,2740,44338.0,33.0,33.0,20,1660,91001.0,31.0,31.0
0.086,6,10,1506,5,395,19.0,127.0,127.0,5,1111,19.0,843.0,843.0
0.013,6,10,1972,5,910,3.0,642.0,642.0,5,1062,3.0,794.0,794.0
0.007,17,2,132,1,58,0.0,30.0,30.0,1,74,0.0,46.0,46.0
0.021,6,10,1989,5,910,5.0,642.0,642.0,5,1079,5.0,811.0,811.0
0.004,6,10,2007,5,928,1.0,660.0,660.0,5,1079,1.0,811.0,811.0
0.005,6,10,2006,5,927,1.0,659.0,659.0,5,1079,1.0,811.0,811.0
0.005,17,2,166,1,75,0.0,47.0,47.0,1,91,0.0,63.0,63.0
0.011,6,10,1989,5,910,2.0,642.0,642.0,5,1079,2.0,811.0,811.0
0.077,6,10,1506,5,395,15.0,127.0,127.0,5,1111,18.0,843.0,843.0
0.011,6,14,3787,7,497,1.0,125.0,125.0,7,3290,1.0,1448.0,972.0
0.082,6,10,1506,5,395,17.0,127.0,127.0,5,1111,18.0,843.0,843.0
240.141,6,47,6919,22,3265,11435.0,588.0,211.0,25,3654,10005.0,580.0,213.0
0.009,6,10,1989,5,910,2.0,642.0,642.0,5,1079,2.0,811.0,811.0
0.005,6,10,2006,5,927,1.0,659.0,659.0,5,1079,1.0,811.0,811.0
0.006,6,10,1547,5,764,1.0,496.0,496.0,5,783,1.0,515.0,515.0
0.011,6,10,1990,5,911,2.0,643.0,643.0,5,1079,2.0,811.0,811.0
0.003,17,2,148,1,60,0.0,32.0,32.0,1,88,0.0,60.0,60.0
0.004,6,10,1702,5,863,1.0,595.0,595.0,5,839,1.0,571.0,571.0
0.005,6,10,2006,5,927,1.0,659.0,659.0,5,1079,1.0,811.0,811.0
0.08,6,10,1506,5,395,19.0,127.0,127.0,5,1111,16.0,843.0,843.0
0.006,6,10,1779,5,928,1.0,660.0,660.0,5,851,1.0,583.0,583.0
0.04,17,2,148,1,60,0.0,32.0,32.0,1,88,0.0,60.0,60.0
0.004,6,10,2006,5,927,1.0,659.0,659.0,5,1079,1.0,811.0,811.0
0.144,6,10,1506,5,395,29.0,127.0,127.0,5,1111,33.0,843.0,843.0
0.018,6,10,1677,5,827,4.0,559.0,559.0,5,850,4.0,582.0,582.0
0.07,17,8,3613,4,1874,23.0,1350.0,440.0,4,1739,11.0,1350.0,406.0
40.064,17,10,676,5,460,10015.0,104.0,64.0,5,216,10015.0,20.0,15.0
40.07,17,10,676,5,460,10014.0,104.0,64.0,5,216,10016.0,20.0,15.0
0.012,6,10,1989,5,910,2.0,642.0,642.0,5,1079,2.0,811.0,811.0
0.194,6,10,1506,5,395,47.0,127.0,127.0,5,1111,46.0,843.0,843.0
0.016,6,10,1762,5,911,3.0,643.0,643.0,5,851,4.0,583.0,583.0
240.015,6,9,787,5,488,60003.0,232.0,232.0,4,299,80004.0,83.0,83.0
15.075,17,15,8040,8,5945,2149.0,1350.0,715.0,7,2095,2507.0,1350.0,271.0
0.009,6,10,1989,5,910,2.0,642.0,642.0,5,1079,2.0,811.0,811.0
40.063,17,10,676,5,460,10014.0,104.0,64.0,5,216,10014.0,20.0,15.0
240.023,6,9,787,5,488,60005.0,232.0,232.0,4,299,80006.0,83.0,83.0
0.005,6,13,3747,7,509,0.0,137.0,137.0,6,3238,0.0,1470.0,1459.0
0.004,6,10,2000,5,927,1.0,659.0,659.0,5,1073,1.0,805.0,805.0
0.006,6,10,1547,5,764,1.0,496.0,496.0,5,783,1.0,515.0,515.0
0.005,17,2,170,1,65,0.0,37.0,37.0,1,105,0.0,77.0,77.0
0.004,6,10,2006,5,927,1.0,659.0,659.0,5,1079,1.0,811.0,811.0
40.049,17,10,676,5,460,10011.0,104.0,64.0,5,216,10011.0,20.0,15.0
241.525,6,386,348168,191,21451,1271.0,2736.0,959.0,195,326717,1244.0,2948.0,1711.0
0.006,6,10,1689,5,839,1.0,571.0,571.0,5,850,1.0,582.0,582.0
0.021,6,10,1983,5,910,5.0,642.0,642.0,5,1073,5.0,805.0,805.0
293.254,6,399,347798,192,21544,1535.0,2736.0,888.0,207,326254,1423.0,2804.0,1634.0
0.006,6,10,1547,5,764,1.0,496.0,496.0,5,783,1.0,515.0,515.0
0.051,17,2,152,1,76,0.0,48.0,48.0,1,76,0.0,48.0,48.0
0.004,6,10,1702,5,863,0.0,595.0,595.0,5,839,1.0,571.0,571.0
0.137,6,10,1506,5,395,32.0,127.0,127.0,5,1111,31.0,843.0,843.0
0.005,6,10,2000,5,927,1.0,659.0,659.0,5,1073,1.0,805.0,805.0
0.082,6,10,1506,5,395,17.0,127.0,127.0,5,1111,18.0,843.0,843.0
0.006,17,2,230,1,68,0.0,40.0,40.0,1,162,0.0,134.0,134.0
240.095,6,16,4482,9,963,30011.0,238.0,166.0,7,3519,40015.0,1402.0,786.0
0.1,6,10,1506,5,395,24.0,127.0,127.0,5,1111,22.0,843.0,843.0
0.003,17,2,136,1,60,0.0,32.0,32.0,1,76,0.0,48.0,48.0
0.004,6,10,1989,5,927,1.0,659.0,659.0,5,1062,1.0,794.0,794.0
0.661,17,22,10537,11,7839,66.0,1350.0,684.0,11,2698,45.0,1350.0,217.0
0.006,6,10,1689,5,839,1.0,571.0,571.0,5,850,1.0,582.0,582.0
0.001,17,2,180,1,66,0.0,38.0,38.0,1,114,0.0,86.0,86.0
0.005,6,10,2000,5,927,1.0,659.0,659.0,5,1073,1.0,805.0,805.0
0.009,6,13,3735,7,497,1.0,125.0,125.0,6,3238,1.0,1470.0,1459.0
0.12,6,10,1506,5,395,27.0,127.0,127.0,5,1111,27.0,843.0,843.0
0.098,6,10,1506,5,395,21.0,127.0,127.0,5,1111,17.0,843.0,843.0
0.088,6,10,1506,5,395,20.0,127.0,127.0,5,1111,17.0,843.0,843.0
0.006,6,10,1547,5,764,1.0,496.0,496.0,5,783,1.0,515.0,515.0
0.01,17,2,148,1,60,0.0,32.0,32.0,1,88,0.0,60.0,60.0
0.005,17,2,237,1,65,0.0,37.0,37.0,1,172,0.0,144.0,144.0
0.003,17,2,148,1,60,0.0,32.0,32.0,1,88,0.0,60.0,60.0
0.006,6,10,1547,5,764,1.0,496.0,496.0,5,783,1.0,515.0,515.0
1777.483,17,144,41760,72,22752,25034.0,288.0,288.0,72,19008,25034.0,236.0,236.0
0.004,17,2,136,1,60,0.0,32.0,32.0,1,76,0.0,48.0,48.0
0.147,6,10,1506,5,395,35.0,127.0,127.0,5,1111,32.0,843.0,843.0
0.058,17,2,152,1,76,0.0,48.0,48.0,1,76,0.0,48.0,48.0
0.097,6,10,1506,5,395,20.0,127.0,127.0,5,1111,21.0,843.0,843.0
0.006,6,10,1854,5,889,1.0,621.0,621.0,5,965,1.0,697.0,697.0
0.012,6,13,3735,7,497,2.0,125.0,125.0,6,3238,2.0,1470.0,1459.0
9.038,17,6,376,5,280,2259.0,28.0,28.0,1,96,0.0,68.0,68.0
0.014,6,10,1631,5,848,3.0,580.0,580.0,5,783,3.0,515.0,515.0
0.012,6,10,1990,5,911,2.0,643.0,643.0,5,1079,2.0,811.0,811.0
0.011,6,10,1972,5,910,2.0,642.0,642.0,5,1062,2.0,794.0,794.0
0.006,6,12,1698,6,863,1.0,327.0,271.0,6,835,1.0,515.0,515.0
0.075,6,10,1506,5,395,14.0,127.0,127.0,5,1111,17.0,843.0,843.0
0.005,6,10,1989,5,927,1.0,659.0,659.0,5,1062,1.0,794.0,794.0
0.005,6,10,1989,5,927,1.0,659.0,659.0,5,1062,1.0,794.0,794.0
0.014,6,10,1989,5,910,3.0,642.0,642.0,5,1079,3.0,811.0,811.0
11.12,17,28,4420,14,1993,842.0,268.0,114.0,14,2427,842.0,586.0,145.0
285.841,6,41,9784,17,6661,17865.0,1681.0,578.0,24,3123,12427.0,580.0,124.0
0.005,6,10,2006,5,927,1.0,659.0,659.0,5,1079,1.0,811.0,811.0
0.01,6,10,1989,5,910,2.0,642.0,642.0,5,1079,2.0,811.0,811.0
0.094,6,10,1506,5,395,19.0,127.0,127.0,5,1111,22.0,843.0,843.0
0.012,6,10,1762,5,911,3.0,643.0,643.0,5,851,2.0,583.0,583.0
0.009,6,12,1926,6,1189,1.0,659.0,434.0,6,737,1.0,417.0,417.0
0.041,17,2,152,1,76,0.0,48.0,48.0,1,76,0.0,48.0,48.0
1795.499,6,582,192302,301,165380,5984.0,2883.0,870.0,281,26922,6412.0,580.0,119.0
0.092,6,10,1506,5,395,21.0,127.0,127.0,5,1111,22.0,843.0,843.0
0.092,6,10,1506,5,395,20.0,127.0,127.0,5,1111,19.0,843.0,843.0
0.065,6,10,1506,5,395,14.0,127.0,127.0,5,1111,14.0,843.0,843.0
240.091,6,31,9490,15,7005,17149.0,2129.0,692.0,16,2485,16005.0,580.0,205.0
40.065,17,10,676,5,460,10013.0,104.0,64.0,5,216,10015.0,20.0,15.0
0.004,17,2,136,1,60,0.0,32.0,32.0,1,76,0.0,48.0,48.0
0.007,6,10,1774,5,923,1.0,655.0,655.0,5,851,1.0,583.0,583.0
0.12,6,10,1506,5,395,25.0,127.0,127.0,5,1111,26.0,843.0,843.0
0.001,17,2,180,1,66,0.0,38.0,38.0,1,114,0.0,86.0,86.0
0.075,6,10,1506,5,395,16.0,127.0,127.0,5,1111,16.0,843.0,843.0
0.011,6,10,1972,5,910,2.0,642.0,642.0,5,1062,2.0,794.0,794.0
0.001,17,2,136,1,60,0.0,32.0,32.0,1,76,0.0,48.0,48.0
0.004,6,10,1989,5,927,1.0,659.0,659.0,5,1062,1.0,794.0,794.0
40.054,17,10,676,5,460,10012.0,104.0,64.0,5,216,10011.0,20.0,15.0
0.131,6,10,1506,5,395,30.0,127.0,127.0,5,1111,29.0,843.0,843.0
0.011,6,10,1983,5,910,2.0,642.0,642.0,5,1073,2.0,805.0,805.0
0.006,6,10,1547,5,764,1.0,496.0,496.0,5,783,1.0,515.0,515.0
0.006,17,2,169,1,62,0.0,34.0,34.0,1,107,0.0,79.0,79.0
0.042,17,2,136,1,60,0.0,32.0,32.0,1,76,0.0,48.0,48.0
0.018,6,10,1990,5,911,4.0,643.0,643.0,5,1079,4.0,811.0,811.0
0.129,17,2,80,1,32,0.0,4.0,4.0,1,48,0.0,20.0,20.0
0.001,17,2,166,1,75,0.0,47.0,47.0,1,91,0.0,63.0,63.0
0.005,6,14,3799,7,509,0.0,137.0,137.0,7,3290,0.0,1448.0,972.0
0.005,17,2,166,1,75,0.0,47.0,47.0,1,91,0.0,63.0,63.0
0.089,6,10,1506,5,395,19.0,127.0,127.0,5,1111,19.0,843.0,843.0
0.003,17,2,132,1,58,0.0,30.0,30.0,1,74,0.0,46.0,46.0
22.084,6,36,9526,18,4008,525.0,1543.0,814.0,18,5518,1289.0,2667.0,435.0
0.005,6,10,1989,5,927,1.0,659.0,659.0,5,1062,1.0,794.0,794.0
361.816,6,19,1688,15,978,25844.0,190.0,190.0,4,710,80014.0,494.0,494.0
0.012,6,10,1631,5,848,3.0,580.0,580.0,5,783,2.0,515.0,515.0
0.038,17,4,284,2,120,0.0,32.0,32.0,2,164,35.0,60.0,54.0
0.078,6,10,1506,5,395,17.0,127.0,127.0,5,1111,18.0,843.0,843.0
0.007,6,10,1983,5,910,1.0,642.0,642.0,5,1073,1.0,805.0,805.0
0.005,6,10,2006,5,927,1.0,659.0,659.0,5,1079,1.0,811.0,811.0
0.133,17,2,152,1,76,0.0,48.0,48.0,1,76,0.0,48.0,48.0
0.006,6,10,1547,5,764,1.0,496.0,496.0,5,783,1.0,515.0,515.0
0.126,6,10,1506,5,395,28.0,127.0,127.0,5,1111,29.0,843.0,843.0
40.071,17,10,676,5,460,10016.0,104.0,64.0,5,216,10016.0,20.0,15.0
0.005,17,2,144,1,64,0.0,36.0,36.0,1,80,0.0,52.0,52.0
0.005,6,10,1989,5,927,1.0,659.0,659.0,5,1062,1.0,794.0,794.0
300.164,6,20,4712,12,1154,27287.0,238.0,130.0,8,3558,42878.0,1402.0,786.0
0.008,6,10,1702,5,863,1.0,595.0,595.0,5,839,1.0,571.0,571.0
0.004,6,10,1702,5,863,1.0,595.0,595.0,5,839,0.0,571.0,571.0
0.008,6,10,1779,5,928,2.0,660.0,660.0,5,851,1.0,583.0,583.0
0.094,6,10,1506,5,395,21.0,127.0,127.0,5,1111,20.0,843.0,843.0
0.005,6,10,1989,5,927,1.0,659.0,659.0,5,1062,1.0,794.0,794.0
0.091,6,10,1506,5,395,17.0,127.0,127.0,5,1111,21.0,843.0,843.0
40.061,17,10,676,5,460,10014.0,104.0,64.0,5,216,10014.0,20.0,15.0
0.082,6,10,1506,5,395,17.0,127.0,127.0,5,1111,19.0,843.0,843.0
412.054,6,23,2943,8,1906,17154.0,494.0,494.0,15,1037,29432.0,83.0,83.0
0.004,17,4,284,2,120,0.0,32.0,32.0,2,164,0.0,60.0,54.0
0.006,6,10,1689,5,839,1.0,571.0,571.0,5,850,1.0,582.0,582.0
0.131,6,10,1506,5,395,29.0,127.0,127.0,5,1111,28.0,843.0,843.0
10.728,17,28,4423,14,1994,816.0,269.0,114.0,14,2429,816.0,588.0,145.0
0.082,6,10,1506,5,395,16.0,127.0,127.0,5,1111,17.0,843.0,843.0
1794.972,6,538,188584,279,162855,6456.0,2883.0,956.0,259,25729,6957.0,388.0,123.0
0.005,17,2,170,1,65,0.0,37.0,37.0,1,105,0.0,77.0,77.0
353.401,6,20,2210,6,1308,12003.0,494.0,494.0,14,902,27184.0,83.0,83.0
0.006,6,13,3747,7,509,0.0,137.0,137.0,6,3238,1.0,1470.0,1459.0
0.012,6,10,1989,5,910,2.0,642.0,642.0,5,1079,2.0,811.0,811.0
0.066,6,10,1506,5,395,15.0,127.0,127.0,5,1111,13.0,843.0,843.0
0.006,6,10,1547,5,764,1.0,496.0,496.0,5,783,1.0,515.0,515.0
0.043,17,2,144,1,64,0.0,36.0,36.0,1,80,0.0,52.0,52.0
0.013,6,10,1989,5,910,3.0,642.0,642.0,5,1079,3.0,811.0,811.0
0.009,6,10,1989,5,910,2.0,642.0,642.0,5,1079,2.0,811.0,811.0
0.011,6,13,3735,7,497,1.0,125.0,125.0,6,3238,2.0,1470.0,1459.0
371.45,6,22,2313,16,867,24763.0,195.0,195.0,6,1446,4636.0,419.0,398.0
0.003,17,2,136,1,60,0.0,32.0,32.0,1,76,0.0,48.0,48.0
0.007,6,10,2006,5,927,1.0,659.0,659.0,5,1079,1.0,811.0,811.0
0.089,6,10,1506,5,395,21.0,127.0,127.0,5,1111,20.0,843.0,843.0
0.004,6,10,2006,5,927,1.0,659.0,659.0,5,1079,1.0,811.0,811.0
0.001,17,2,180,1,66,0.0,38.0,38.0,1,114,0.0,86.0,86.0
0.005,6,10,2006,5,927,1.0,659.0,659.0,5,1079,1.0,811.0,811.0
28.528,6,44,15939,22,10261,430.0,2720.0,1168.0,22,5678,1350.0,2667.0,435.0
0.005,17,2,214,1,75,0.0,47.0,47.0,1,139,0.0,111.0,111.0
0.005,6,10,2007,5,928,1.0,660.0,660.0,5,1079,1.0,811.0,811.0
0.003,17,2,148,1,60,0.0,32.0,32.0,1,88,0.0,60.0,60.0
0.001,17,2,180,1,66,0.0,38.0,38.0,1,114,0.0,86.0,86.0
0.001,17,2,180,1,66,0.0,38.0,38.0,1,114,0.0,86.0,86.0
0.005,6,10,2006,5,927,1.0,659.0,659.0,5,1079,1.0,811.0,811.0
0.005,6,10,1547,5,764,1.0,496.0,496.0,5,783,1.0,515.0,515.0
0.012,6,10,1762,5,911,3.0,643.0,643.0,5,851,3.0,583.0,583.0
40.052,17,10,676,5,460,10012.0,104.0,64.0,5,216,10012.0,20.0,15.0
0.005,6,10,1989,5,927,1.0,659.0,659.0,5,1062,1.0,794.0,794.0
240.371,6,41,8667,20,5634,12650.0,2883.0,573.0,21,3033,12018.0,580.0,241.0
94.372,6,31,14287,16,6885,126.0,1577.0,887.0,15,7402,6726.0,1791.0,970.0
0.095,6,10,1506,5,395,21.0,127.0,127.0,5,1111,21.0,843.0,843.0
0.005,6,10,2000,5,927,1.0,659.0,659.0,5,1073,1.0,805.0,805.0
0.004,6,10,1774,5,923,1.0,655.0,655.0,5,851,1.0,583.0,583.0
0.088,6,10,1506,5,395,19.0,127.0,127.0,5,1111,20.0,843.0,843.0
0.015,6,10,1983,5,910,3.0,642.0,642.0,5,1073,3.0,805.0,805.0
0.005,6,13,3747,7,509,0.0,137.0,137.0,6,3238,0.0,1470.0,1459.0
0.013,6,10,1989,5,910,3.0,642.0,642.0,5,1079,3.0,811.0,811.0
0.095,6,10,1506,5,395,21.0,127.0,127.0,5,1111,22.0,843.0,843.0
0.013,6,10,1983,5,910,3.0,642.0,642.0,5,1073,3.0,805.0,805.0
0.005,6,10,2006,5,927,1.0,659.0,659.0,5,1079,1.0,811.0,811.0
0.07,6,10,1506,5,395,15.0,127.0,127.0,5,1111,17.0,843.0,843.0
0.005,17,2,214,1,75,0.0,47.0,47.0,1,139,0.0,111.0,111.0
0.094,6,10,1506,5,395,20.0,127.0,127.0,5,1111,21.0,843.0,843.0
0.007,6,10,2006,5,927,1.0,659.0,659.0,5,1079,1.0,811.0,811.0
0.086,6,10,1506,5,395,20.0,127.0,127.0,5,1111,19.0,843.0,843.0
0.077,6,10,1506,5,395,15.0,127.0,127.0,5,1111,17.0,843.0,843.0
0.011,6,10,1989,5,910,2.0,642.0,642.0,5,1079,2.0,811.0,811.0
0.014,17,2,152,1,56,0.0,28.0,28.0,1,96,0.0,68.0,68.0
168.369,17,78,11037,39,2601,4430.0,44.0,38.0,39,8436,4430.0,239.0,188.0
0.005,6,10,2006,5,927,1.0,659.0,659.0,5,1079,1.0,811.0,811.0
0.005,6,10,2006,5,927,1.0,659.0,659.0,5,1079,1.0,811.0,811.0
0.006,6,14,3799,7,509,0.0,137.0,137.0,7,3290,0.0,1448.0,972.0
0.011,6,10,1631,5,848,2.0,580.0,580.0,5,783,2.0,515.0,515.0
178.107,17,76,10620,38,2529,4813.0,44.0,38.0,38,8091,4813.0,261.0,184.0
314.605,17,18,1008,9,640,39309.0,48.0,43.0,9,368,39308.0,20.0,12.0
0.084,6,10,1506,5,395,12.0,127.0,127.0,5,1111,20.0,843.0,843.0
0.073,17,4,364,2,160,0.0,52.0,52.0,2,204,34.0,80.0,74.0
0.005,6,10,1989,5,927,1.0,659.0,659.0,5,1062,1.0,794.0,794.0
0.005,6,10,2006,5,927,1.0,659.0,659.0,5,1079,1.0,811.0,811.0
0.135,17,2,80,1,32,0.0,4.0,4.0,1,48,0.0,20.0,20.0
0.005,6,10,1689,5,839,1.0,571.0,571.0,5,850,1.0,582.0,582.0
0.008,6,10,1983,5,910,2.0,642.0,642.0,5,1073,2.0,805.0,805.0
240.312,6,28,11733,14,6001,18485.0,1368.0,879.0,14,5732,18485.0,1657.0,832.0
0.08,6,10,1506,5,395,19.0,127.0,127.0,5,1111,18.0,843.0,843.0
0.005,6,10,2007,5,928,1.0,660.0,660.0,5,1079,1.0,811.0,811.0
0.018,6,10,1972,5,910,4.0,642.0,642.0,5,1062,4.0,794.0,794.0
0.011,6,10,1762,5,911,2.0,643.0,643.0,5,851,2.0,583.0,583.0
178.487,17,92,13232,46,3096,3966.0,44.0,39.0,46,10136,3966.0,239.0,192.0
0.011,6,10,1989,5,910,2.0,642.0,642.0,5,1079,2.0,811.0,811.0
241.275,6,304,342763,120,17759,2027.0,2736.0,960.0,184,325004,1318.0,2804.0,1812.0
1770.35,6,87,4629,44,2342,41169.0,27.0,27.0,43,2287,42150.0,27.0,25.0
0.093,6,10,1506,5,395,19.0,127.0,127.0,5,1111,19.0,843.0,843.0
0.006,6,10,2007,5,928,1.0,660.0,660.0,5,1079,1.0,811.0,811.0
0.004,6,10,1779,5,928,1.0,660.0,660.0,5,851,1.0,583.0,583.0
0.072,6,10,1506,5,395,15.0,127.0,127.0,5,1111,16.0,843.0,843.0
0.005,6,10,1702,5,863,1.0,595.0,595.0,5,839,1.0,571.0,571.0
9.037,17,6,376,5,280,2259.0,28.0,28.0,1,96,0.0,68.0,68.0
0.08,6,10,1506,5,395,17.0,127.0,127.0,5,1111,17.0,843.0,843.0
0.009,6,12,1926,6,1189,1.0,659.0,434.0,6,737,1.0,417.0,417.0
40.072,17,10,676,5,460,10017.0,104.0,64.0,5,216,10017.0,20.0,15.0
0.003,17,4,284,2,120,0.0,32.0,32.0,2,164,0.0,60.0,54.0
0.009,6,10,1990,5,911,2.0,643.0,643.0,5,1079,2.0,811.0,811.0
0.005,6,10,1689,5,839,1.0,571.0,571.0,5,850,1.0,582.0,582.0
0.005,6,10,2006,5,927,1.0,659.0,659.0,5,1079,1.0,811.0,811.0
0.005,17,2,152,1,68,0.0,40.0,40.0,1,84,0.0,56.0,56.0
0.001,17,2,180,1,66,0.0,38.0,38.0,1,114,0.0,86.0,86.0
0.074,6,10,1506,5,395,17.0,127.0,127.0,5,1111,17.0,843.0,843.0
0.005,6,10,2007,5,928,1.0,660.0,660.0,5,1079,1.0,811.0,811.0
0.004,17,2,148,1,60,0.0,32.0,32.0,1,88,0.0,60.0,60.0
0.006,6,10,1854,5,889,1.0,621.0,621.0,5,965,1.0,697.0,697.0
0.014,6,10,1677,5,827,3.0,559.0,559.0,5,850,3.0,582.0,582.0
0.124,17,2,148,1,60,0.0,32.0,32.0,1,88,0.0,60.0,60.0
0.005,6,10,2007,5,928,1.0,660.0,660.0,5,1079,1.0,811.0,811.0
40.068,17,10,676,5,460,10015.0,104.0,64.0,5,216,10016.0,20.0,15.0
0.006,17,2,144,1,64,0.0,36.0,36.0,1,80,0.0,52.0,52.0
174.595,17,82,11946,41,2744,4364.0,44.0,38.0,41,9202,4364.0,260.0,196.0
0.009,6,10,1990,5,911,2.0,643.0,643.0,5,1079,2.0,811.0,811.0
0.001,17,2,180,1,66,0.0,38.0,38.0,1,114,0.0,86.0,86.0
0.006,6,10,1547,5,764,1.0,496.0,496.0,5,783,1.0,515.0,515.0
0.018,6,10,1989,5,910,4.0,642.0,642.0,5,1079,4.0,811.0,811.0
240.443,6,29,11698,15,5912,17174.0,1840.0,1027.0,14,5786,18495.0,1656.0,841.0
0.009,6,10,1972,5,910,2.0,642.0,642.0,5,1062,2.0,794.0,794.0
0.005,6,10,1989,5,927,1.0,659.0,659.0,5,1062,1.0,794.0,794.0
0.006,6,10,1854,5,889,1.0,621.0,621.0,5,965,1.0,697.0,697.0
0.08,6,10,1506,5,395,19.0,127.0,127.0,5,1111,15.0,843.0,843.0
0.115,6,10,1506,5,395,27.0,127.0,127.0,5,1111,26.0,843.0,843.0
0.064,6,10,1506,5,395,13.0,127.0,127.0,5,1111,14.0,843.0,843.0
0.024,6,10,1983,5,910,6.0,642.0,642.0,5,1073,6.0,805.0,805.0
0.006,6,10,1547,5,764,1.0,496.0,496.0,5,783,1.0,515.0,515.0
0.098,6,10,1506,5,395,22.0,127.0,127.0,5,1111,20.0,843.0,843.0
0.008,6,10,1677,5,827,2.0,559.0,559.0,5,850,2.0,582.0,582.0
0.008,6,10,1989,5,910,2.0,642.0,642.0,5,1079,2.0,811.0,811.0
0.09,6,10,1506,5,395,17.0,127.0,127.0,5,1111,20.0,843.0,843.0
0.01,6,10,1631,5,848,2.0,580.0,580.0,5,783,2.0,515.0,515.0
0.004,6,10,1989,5,927,1.0,659.0,659.0,5,1062,1.0,794.0,794.0
291.469,6,378,347901,194,21647,1510.0,2736.0,888.0,184,326254,1592.0,3175.0,1862.0
0.006,17,2,170,1,65,0.0,37.0,37.0,1,105,0.0,77.0,77.0
0.138,17,4,284,2,120,0.0,32.0,32.0,2,164,135.0,60.0,54.0
0.005,17,2,166,1,75,0.0,47.0,47.0,1,91,0.0,63.0,63.0
0.007,6,10,1854,5,889,1.0,621.0,621.0,5,965,1.0,697.0,697.0
0.005,6,10,1779,5,928,1.0,660.0,660.0,5,851,1.0,583.0,583.0
308.83,17,20,1124,10,716,34300.0,48.0,43.0,10,408,34300.0,20.0,12.0
11.017,17,28,4418,14,1993,838.0,268.0,114.0,14,2425,838.0,588.0,145.0
0.012,6,10,1983,5,910,3.0,642.0,642.0,5,1073,2.0,805.0,805.0
0.003,17,2,142,1,63,0.0,35.0,35.0,1,79,0.0,51.0,51.0
0.016,6,10,2006,5,927,4.0,659.0,659.0,5,1079,4.0,811.0,811.0
0.012,6,10,1972,5,910,3.0,642.0,642.0,5,1062,2.0,794.0,794.0
0.005,6,10,1854,5,889,1.0,621.0,621.0,5,965,1.0,697.0,697.0
0.005,6,10,2006,5,927,1.0,659.0,659.0,5,1079,1.0,811.0,811.0
65.844,6,24,11975,13,5359,5487.0,2804.0,935.0,11,6616,6568.0,2111.0,1006.0
0.001,17,2,180,1,66,0.0,38.0,38.0,1,114,0.0,86.0,86.0
311.778,17,20,1124,10,716,34625.0,48.0,43.0,10,408,34625.0,20.0,12.0
0.071,6,10,1506,5,395,15.0,127.0,127.0,5,1111,16.0,843.0,843.0
0.016,6,10,1989,5,910,4.0,642.0,642.0,5,1079,4.0,811.0,811.0
0.005,6,10,2006,5,927,1.0,659.0,659.0,5,1079,1.0,811.0,811.0
0.121,6,10,1506,5,395,28.0,127.0,127.0,5,1111,28.0,843.0,843.0
0.001,17,2,180,1,66,0.0,38.0,38.0,1,114,0.0,86.0,86.0
0.012,6,10,1983,5,910,3.0,642.0,642.0,5,1073,2.0,805.0,805.0
0.005,6,10,2007,5,928,1.0,660.0,660.0,5,1079,1.0,811.0,811.0
0.101,6,10,1506,5,395,21.0,127.0,127.0,5,1111,22.0,843.0,843.0
0.001,17,2,180,1,66,0.0,38.0,38.0,1,114,0.0,86.0,86.0
0.007,17,4,420,2,122,3.0,33.0,33.0,2,298,3.0,145.0,121.0
0.014,6,10,1990,5,911,3.0,643.0,643.0,5,1079,3.0,811.0,811.0
64.13,6,24,10356,11,3909,6413.0,1579.0,835.0,13,6447,5333.0,2111.0,576.0
0.006,6,10,1689,5,839,1.0,571.0,571.0,5,850,1.0,582.0,582.0
0.013,17,2,169,1,62,0.0,34.0,34.0,1,107,0.0,79.0,79.0
0.08,6,10,1506,5,395,19.0,127.0,127.0,5,1111,19.0,843.0,843.0
0.005,6,10,2006,5,927,1.0,659.0,659.0,5,1079,1.0,811.0,811.0
171.17,17,86,11993,43,2877,4075.0,44.0,38.0,43,9116,4075.0,239.0,184.0
0.086,6,10,1506,5,395,19.0,127.0,127.0,5,1111,18.0,843.0,843.0
300.015,6,11,891,6,552,60002.0,232.0,232.0,5,339,75003.0,83.0,83.0
0.06,17,2,152,1,76,0.0,48.0,48.0,1,76,0.0,48.0,48.0
0.015,6,10,1990,5,911,3.0,643.0,643.0,5,1079,3.0,811.0,811.0
0.016,6,10,1989,5,910,4.0,642.0,642.0,5,1079,3.0,811.0,811.0
0.204,6,16,2674,8,1400,29.0,533.0,325.0,8,1274,18.0,529.0,212.0
0.04,17,2,152,1,76,0.0,48.0,48.0,1,76,0.0,48.0,48.0
0.008,6,10,1989,5,910,2.0,642.0,642.0,5,1079,2.0,811.0,811.0
0.071,17,8,3613,4,1874,23.0,1350.0,440.0,4,1739,12.0,1350.0,406.0
0.007,6,10,1547,5,764,1.0,496.0,496.0,5,783,1.0,515.0,515.0
0.005,6,10,1547,5,764,1.0,496.0,496.0,5,783,1.0,515.0,515.0
0.089,6,10,1506,5,395,20.0,127.0,127.0,5,1111,19.0,843.0,843.0
240.013,6,9,787,5,488,60003.0,232.0,232.0,4,299,80003.0,83.0,83.0
0.005,17,2,144,1,64,0.0,36.0,36.0,1,80,0.0,52.0,52.0
0.07,6,10,1506,5,395,14.0,127.0,127.0,5,1111,15.0,843.0,843.0
0.009,6,10,1990,5,911,2.0,643.0,643.0,5,1079,2.0,811.0,811.0
0.012,6,10,1989,5,910,3.0,642.0,642.0,5,1079,2.0,811.0,811.0
0.01,6,10,1983,5,910,2.0,642.0,642.0,5,1073,2.0,805.0,805.0
0.04,17,2,144,1,64,0.0,36.0,36.0,1,80,0.0,52.0,52.0
0.119,6,31,10415,18,9098,7.0,2261.0,816.0,13,1317,9.0,304.0,106.0
1729.211,6,60,4400,40,2740,44338.0,33.0,33.0,20,1660,91002.0,31.0,31.0
40.059,17,10,676,5,460,10013.0,104.0,64.0,5,216,10013.0,20.0,15.0
0.006,17,2,247,1,68,0.0,40.0,40.0,1,179,0.0,151.0,151.0
0.006,6,10,2006,5,927,1.0,659.0,659.0,5,1079,1.0,811.0,811.0
40.06,17,10,676,5,460,10011.0,104.0,64.0,5,216,10014.0,20.0,15.0
0.004,6,10,1702,5,863,0.0,595.0,595.0,5,839,1.0,571.0,571.0
0.001,17,2,180,1,66,0.0,38.0,38.0,1,114,0.0,86.0,86.0
0.013,6,10,1990,5,911,3.0,643.0,643.0,5,1079,3.0,811.0,811.0
0.101,6,10,1506,5,395,24.0,127.0,127.0,5,1111,19.0,843.0,843.0
0.004,6,10,2006,5,927,1.0,659.0,659.0,5,1079,1.0,811.0,811.0
0.013,6,10,1989,5,910,3.0,642.0,642.0,5,1079,3.0,811.0,811.0
0.005,6,10,2007,5,928,1.0,660.0,660.0,5,1079,1.0,811.0,811.0
171.432,17,78,11191,39,2600,4511.0,44.0,38.0,39,8591,4511.0,261.0,192.0
412.252,6,29,4409,12,3102,10911.0,494.0,494.0,17,1307,25765.0,83.0,83.0
0.132,6,10,1506,5,395,30.0,127.0,127.0,5,1111,26.0,843.0,843.0
0.117,17,2,179,1,71,0.0,43.0,43.0,1,108,0.0,80.0,80.0
1.042,17,2,144,1,64,0.0,36.0,36.0,1,80,0.0,52.0,52.0
0.004,6,10,1774,5,923,1.0,655.0,655.0,5,851,1.0,583.0,583.0
0.066,6,10,1506,5,395,13.0,127.0,127.0,5,1111,14.0,843.0,843.0
0.017,6,10,1990,5,911,4.0,643.0,643.0,5,1079,4.0,811.0,811.0
0.005,6,14,3799,7,509,0.0,137.0,137.0,7,3290,0.0,1448.0,972.0
0.005,6,10,1702,5,863,1.0,595.0,595.0,5,839,1.0,571.0,571.0
0.004,6,10,2006,5,927,1.0,659.0,659.0,5,1079,1.0,811.0,811.0
0.005,6,14,3799,7,509,0.0,137.0,137.0,7,3290,0.0,1448.0,972.0
0.015,6,14,3787,7,497,2.0,125.0,125.0,7,3290,2.0,1448.0,972.0
300.042,6,12,1782,7,1348,50007.0,494.0,494.0,5,434,75009.0,83.0,83.0
0.005,6,13,3684,7,446,0.0,74.0,74.0,6,3238,1.0,1470.0,1459.0
0.006,6,10,1547,5,764,1.0,496.0,496.0,5,783,1.0,515.0,515.0
0.011,6,10,1990,5,911,2.0,643.0,643.0,5,1079,2.0,811.0,811.0
0.01,6,10,1989,5,910,2.0,642.0,642.0,5,1079,2.0,811.0,811.0
0.102,6,10,1506,5,395,23.0,127.0,127.0,5,1111,23.0,843.0,843.0
0.005,6,13,3747,7,509,0.0,137.0,137.0,6,3238,1.0,1470.0,1459.0
0.012,6,14,3787,7,497,2.0,125.0,125.0,7,3290,2.0,1448.0,972.0
40.071,17,10,676,5,460,10015.0,104.0,64.0,5,216,10016.0,20.0,15.0
0.013,6,13,3816,7,578,2.0,206.0,206.0,6,3238,2.0,1470.0,1459.0
0.094,6,10,1506,5,395,19.0,127.0,127.0,5,1111,22.0,843.0,843.0
0.014,6,10,1990,5,911,3.0,643.0,643.0,5,1079,3.0,811.0,811.0
15.075,17,15,9238,8,6902,2149.0,1350.0,834.0,7,2336,2507.0,1350.0,305.0
0.006,17,2,222,1,65,0.0,37.0,37.0,1,157,0.0,129.0,129.0
0.014,6,10,1989,5,910,3.0,642.0,642.0,5,1079,3.0,811.0,811.0
0.136,6,10,1506,5,395,28.0,127.0,127.0,5,1111,32.0,843.0,843.0
459.126,6,38,13301,19,3310,25507.0,662.0,385.0,19,9991,22173.0,1402.0,749.0
0.002,17,2,180,1,66,0.0,38.0,38.0,1,114,0.0,86.0,86.0
0.018,6,10,1989,5,910,4.0,642.0,642.0,5,1079,4.0,811.0,811.0
0.014,17,2,214,1,75,0.0,47.0,47.0,1,139,0.0,111.0,111.0
0.005,6,10,2006,5,927,1.0,659.0,659.0,5,1079,1.0,811.0,811.0
0.004,6,10,2007,5,928,1.0,660.0,660.0,5,1079,1.0,811.0,811.0
40.062,17,10,676,5,460,10014.0,104.0,64.0,5,216,10014.0,20.0,15.0
0.07,6,10,1506,5,395,16.0,127.0,127.0,5,1111,14.0,843.0,843.0
300.384,6,16,2170,9,684,37527.0,146.0,146.0,7,1486,50036.0,419.0,398.0
0.07,6,10,1506,5,395,16.0,127.0,127.0,5,1111,16.0,843.0,843.0
0.004,17,4,284,2,120,0.0,32.0,32.0,2,164,0.0,60.0,54.0
0.001,17,2,166,1,75,0.0,47.0,47.0,1,91,0.0,63.0,63.0
0.087,6,10,1506,5,395,20.0,127.0,127.0,5,1111,17.0,843.0,843.0
0.027,6,13,3735,7,497,4.0,125.0,125.0,6,3238,5.0,1470.0,1459.0
0.004,17,4,284,2,120,0.0,32.0,32.0,2,164,1.0,60.0,54.0
0.005,17,2,170,1,65,0.0,37.0,37.0,1,105,0.0,77.0,77.0
0.009,6,10,1677,5,827,2.0,559.0,559.0,5,850,2.0,582.0,582.0
1798.103,6,210,14472,78,6156,23350.0,46.0,46.0,132,8316,13725.0,46.0,46.0
0.005,6,10,2000,5,927,1.0,659.0,659.0,5,1073,1.0,805.0,805.0
0.014,6,10,1990,5,911,3.0,643.0,643.0,5,1079,3.0,811.0,811.0
0.005,6,10,2006,5,927,1.0,659.0,659.0,5,1079,1.0,811.0,811.0
0.004,6,10,2006,5,927,1.0,659.0,659.0,5,1079,1.0,811.0,811.0
0.009,6,10,1972,5,910,2.0,642.0,642.0,5,1062,2.0,794.0,794.0
0.006,6,10,2007,5,928,1.0,660.0,660.0,5,1079,1.0,811.0,811.0
0.13,6,10,1506,5,395,31.0,127.0,127.0,5,1111,29.0,843.0,843.0
0.009,6,10,1983,5,910,2.0,642.0,642.0,5,1073,2.0,805.0,805.0
0.007,6,10,1547,5,764,1.0,496.0,496.0,5,783,1.0,515.0,515.0
0.085,6,10,1506,5,395,18.0,127.0,127.0,5,1111,18.0,843.0,843.0
0.009,6,10,1989,5,910,2.0,642.0,642.0,5,1079,2.0,811.0,811.0
0.009,6,10,1989,5,910,2.0,642.0,642.0,5,1079,2.0,811.0,811.0
0.091,17,2,148,1,60,0.0,32.0,32.0,1,88,0.0,60.0,60.0
0.011,6,10,1989,5,910,2.0,642.0,642.0,5,1079,2.0,811.0,811.0
0.012,6,10,1989,5,910,2.0,642.0,642.0,5,1079,2.0,811.0,811.0
0.008,6,10,1677,5,827,2.0,559.0,559.0,5,850,1.0,582.0,582.0
1784.792,6,300,53824,122,34189,14749.0,2720.0,301.0,178,19635,10082.0,1360.0,150.0
0.012,6,10,1677,5,827,3.0,559.0,559.0,5,850,2.0,582.0,582.0
175.349,17,76,10769,38,2540,4739.0,44.0,38.0,38,8229,4739.0,261.0,188.0
0.013,6,10,1983,5,910,3.0,642.0,642.0,5,1073,3.0,805.0,805.0
0.005,6,10,1989,5,927,1.0,659.0,659.0,5,1062,1.0,794.0,794.0
0.006,6,10,2006,5,927,1.0,659.0,659.0,5,1079,1.0,811.0,811.0
0.018,6,10,1762,5,911,4.0,643.0,643.0,5,851,4.0,583.0,583.0
0.008,6,10,1689,5,839,1.0,571.0,571.0,5,850,2.0,582.0,582.0
0.143,6,10,1506,5,395,25.0,127.0,127.0,5,1111,33.0,843.0,843.0
0.004,17,2,136,1,60,0.0,32.0,32.0,1,76,0.0,48.0,48.0
40.052,17,10,676,5,460,10012.0,104.0,64.0,5,216,10012.0,20.0,15.0
0.035,17,2,152,1,76,0.0,48.0,48.0,1,76,0.0,48.0,48.0
0.006,6,10,2006,5,927,1.0,659.0,659.0,5,1079,1.0,811.0,811.0
0.066,17,2,144,1,64,0.0,36.0,36.0,1,80,0.0,52.0,52.0
0.001,17,2,180,1,66,0.0,38.0,38.0,1,114,0.0,86.0,86.0
0.005,6,10,2007,5,928,1.0,660.0,660.0,5,1079,1.0,811.0,811.0
0.134,17,2,412,1,61,0.0,33.0,33.0,1,351,0.0,323.0,323.0
0.005,6,14,3742,8,504,0.0,80.0,80.0,6,3238,0.0,1470.0,1459.0
0.005,17,2,237,1,65,0.0,37.0,37.0,1,172,0.0,144.0,144.0
0.097,17,2,136,1,60,0.0,32.0,32.0,1,76,0.0,48.0,48.0
0.01,6,6,716,3,458,3.0,302.0,302.0,3,258,3.0,102.0,102.0
308.483,17,20,1124,10,716,34262.0,48.0,43.0,10,408,34261.0,20.0,12.0
0.016,6,10,1631,5,848,4.0,580.0,580.0,5,783,3.0,515.0,515.0
0.006,6,10,1689,5,839,1.0,571.0,571.0,5,850,1.0,582.0,582.0
0.041,6,10,1972,5,910,10.0,642.0,642.0,5,1062,10.0,794.0,794.0
0.014,6,13,3735,7,497,2.0,125.0,125.0,6,3238,2.0,1470.0,1459.0
0.092,6,10,1506,5,395,20.0,127.0,127.0,5,1111,20.0,843.0,843.0
0.037,17,4,284,2,120,0.0,32.0,32.0,2,164,33.0,60.0,54.0
0.004,6,10,2000,5,927,1.0,659.0,659.0,5,1073,1.0,805.0,805.0
0.005,17,2,154,1,69,0.0,41.0,41.0,1,85,0.0,57.0,57.0
0.003,17,2,156,1,64,0.0,36.0,36.0,1,92,0.0,64.0,64.0
0.009,6,10,1983,5,910,2.0,642.0,642.0,5,1073,2.0,805.0,805.0
0.02,6,10,1677,5,827,4.0,559.0,559.0,5,850,5.0,582.0,582.0
240.09,6,16,4481,9,963,30011.0,238.0,166.0,7,3518,40014.0,1402.0,786.0
0.007,17,2,194,1,59,0.0,31.0,31.0,1,135,0.0,107.0,107.0
56.843,6,37,9566,19,4048,491.0,1360.0,651.0,18,5518,3333.0,2667.0,435.0
40.062,17,10,676,5,460,10014.0,104.0,64.0,5,216,10014.0,20.0,15.0
0.003,17,2,156,1,64,0.0,36.0,36.0,1,92,0.0,64.0,64.0
0.088,6,10,1506,5,395,20.0,127.0,127.0,5,1111,20.0,843.0,843.0
0.116,6,10,1506,5,395,26.0,127.0,127.0,5,1111,22.0,843.0,843.0
240.087,6,16,4482,9,963,30010.0,238.0,166.0,7,3519,40014.0,1402.0,786.0
0.005,6,10,1989,5,927,1.0,659.0,659.0,5,1062,1.0,794.0,794.0
0.016,6,10,1762,5,911,4.0,643.0,643.0,5,851,3.0,583.0,583.0
0.018,6,10,1990,5,911,4.0,643.0,643.0,5,1079,4.0,811.0,811.0
0.078,6,10,1506,5,395,16.0,127.0,127.0,5,1111,16.0,843.0,843.0
0.013,6,10,1989,5,910,3.0,642.0,642.0,5,1079,3.0,811.0,811.0
0.119,6,10,1506,5,395,28.0,127.0,127.0,5,1111,15.0,843.0,843.0
0.005,17,2,152,1,68,0.0,40.0,40.0,1,84,0.0,56.0,56.0
0.004,6,10,1702,5,863,1.0,595.0,595.0,5,839,0.0,571.0,571.0
0.004,6,10,2006,5,927,1.0,659.0,659.0,5,1079,1.0,811.0,811.0
0.016,6,10,1990,5,911,4.0,643.0,643.0,5,1079,4.0,811.0,811.0
0.062,17,2,144,1,64,0.0,36.0,36.0,1,80,0.0,52.0,52.0
0.005,6,10,1989,5,927,1.0,659.0,659.0,5,1062,1.0,794.0,794.0
0.015,6,10,1762,5,911,3.0,643.0,643.0,5,851,3.0,583.0,583.0
0.069,6,10,1506,5,395,16.0,127.0,127.0,5,1111,13.0,843.0,843.0
0.004,6,10,1774,5,923,1.0,655.0,655.0,5,851,1.0,583.0,583.0
0.014,6,10,1990,5,911,3.0,643.0,643.0,5,1079,3.0,811.0,811.0
0.073,6,10,1506,5,395,16.0,127.0,127.0,5,1111,16.0,843.0,843.0
0.006,6,10,1547,5,764,1.0,496.0,496.0,5,783,1.0,515.0,515.0
0.092,6,10,1506,5,395,20.0,127.0,127.0,5,1111,19.0,843.0,843.0
10.878,17,28,4420,14,1993,828.0,268.0,114.0,14,2427,828.0,586.0,145.0
0.004,6,10,2000,5,927,1.0,659.0,659.0,5,1073,1.0,805.0,805.0
0.001,17,2,180,1,66,0.0,38.0,38.0,1,114,0.0,86.0,86.0
0.004,6,10,2006,5,927,1.0,659.0,659.0,5,1079,1.0,811.0,811.0
0.009,6,10,1983,5,910,2.0,642.0,642.0,5,1073,2.0,805.0,805.0
0.008,6,10,1989,5,910,2.0,642.0,642.0,5,1079,2.0,811.0,811.0
0.116,6,10,1506,5,395,27.0,127.0,127.0,5,1111,24.0,843.0,843.0
0.004,17,2,148,1,60,0.0,32.0,32.0,1,88,0.0,60.0,60.0
0.012,6,10,1989,5,910,2.0,642.0,642.0,5,1079,2.0,811.0,811.0
0.143,6,10,1506,5,395,30.0,127.0,127.0,5,1111,34.0,843.0,843.0
0.007,6,10,1854,5,889,1.0,621.0,621.0,5,965,1.0,697.0,697.0
0.005,6,10,2000,5,927,1.0,659.0,659.0,5,1073,1.0,805.0,805.0
0.01,6,10,1762,5,911,2.0,643.0,643.0,5,851,2.0,583.0,583.0
0.003,17,2,136,1,60,0.0,32.0,32.0,1,76,0.0,48.0,48.0
240.102,6,16,4481,9,963,30012.0,238.0,166.0,7,3518,40016.0,1402.0,786.0
0.006,6,10,1547,5,764,1.0,496.0,496.0,5,783,1.0,515.0,515.0
11.109,17,28,4423,14,1994,842.0,269.0,114.0,14,2429,842.0,588.0,145.0
1796.484,6,272,25424,137,8904,13209.0,747.0,295.0,135,16520,13406.0,1626.0,73.0
11.035,17,28,4398,14,2312,840.0,587.0,137.0,14,2086,840.0,269.0,121.0
0.011,6,13,3735,7,497,1.0,125.0,125.0,6,3238,2.0,1470.0,1459.0
0.006,6,10,1689,5,839,1.0,571.0,571.0,5,850,1.0,582.0,582.0
0.069,6,10,1506,5,395,13.0,127.0,127.0,5,1111,15.0,843.0,843.0
0.097,6,10,1506,5,395,21.0,127.0,127.0,5,1111,23.0,843.0,843.0
0.01,6,10,1972,5,910,2.0,642.0,642.0,5,1062,2.0,794.0,794.0
0.004,6,10,1989,5,927,1.0,659.0,659.0,5,1062,1.0,794.0,794.0
0.124,17,2,182,1,65,0.0,37.0,37.0,1,117,0.0,89.0,89.0
0.008,6,12,1926,6,1189,1.0,659.0,434.0,6,737,1.0,417.0,417.0
0.072,17,2,80,1,32,0.0,4.0,4.0,1,48,0.0,20.0,20.0
169.409,17,72,10184,36,2393,4840.0,44.0,38.0,36,7791,4840.0,239.0,188.0
0.005,6,10,2007,5,928,1.0,660.0,660.0,5,1079,1.0,811.0,811.0
0.063,6,10,1506,5,395,13.0,127.0,127.0,5,1111,12.0,843.0,843.0
0.004,17,2,168,1,76,0.0,48.0,48.0,1,92,0.0,64.0,64.0
0.039,17,4,284,2,120,0.0,32.0,32.0,2,164,35.0,60.0,54.0
0.014,6,10,1631,5,848,3.0,580.0,580.0,5,783,3.0,515.0,515.0
0.004,6,10,2007,5,928,1.0,660.0,660.0,5,1079,1.0,811.0,811.0
0.014,6,10,1972,5,910,3.0,642.0,642.0,5,1062,3.0,794.0,794.0
0.016,6,10,1989,5,910,4.0,642.0,642.0,5,1079,4.0,811.0,811.0
0.01,6,10,1989,5,910,2.0,642.0,642.0,5,1079,2.0,811.0,811.0
0.005,6,10,1989,5,927,1.0,659.0,659.0,5,1062,1.0,794.0,794.0
0.212,6,16,2778,8,1396,30.0,533.0,324.0,8,1382,19.0,529.0,239.0
0.04,17,2,152,1,76,0.0,48.0,48.0,1,76,0.0,48.0,48.0
0.013,6,10,1972,5,910,3.0,642.0,642.0,5,1062,3.0,794.0,794.0
0.001,17,2,136,1,60,0.0,32.0,32.0,1,76,0.0,48.0,48.0
0.038,17,2,148,1,60,0.0,32.0,32.0,1,88,0.0,60.0,60.0
15.138,17,14,9190,8,6902,2155.0,1350.0,834.0,6,2288,3013.0,1350.0,353.0
0.003,17,2,148,1,60,0.0,32.0,32.0,1,88,0.0,60.0,60.0
0.001,17,2,180,1,66,0.0,38.0,38.0,1,114,0.0,86.0,86.0
0.005,6,10,2006,5,927,1.0,659.0,659.0,5,1079,1.0,811.0,811.0
0.02,6,10,1631,5,848,4.0,580.0,580.0,5,783,5.0,515.0,515.0
0.008,6,10,1989,5,910,2.0,642.0,642.0,5,1079,2.0,811.0,811.0
0.004,6,10,2007,5,928,1.0,660.0,660.0,5,1079,1.0,811.0,811.0
0.261,6,16,2674,8,1400,37.0,533.0,325.0,8,1274,24.0,529.0,212.0
0.038,17,2,152,1,76,0.0,48.0,48.0,1,76,0.0,48.0,48.0
0.005,6,10,2007,5,928,1.0,660.0,660.0,5,1079,1.0,811.0,811.0
0.17,17,2,152,1,76,0.0,48.0,48.0,1,76,0.0,48.0,48.0
0.014,6,10,1990,5,911,3.0,643.0,643.0,5,1079,3.0,811.0,811.0
0.004,17,4,284,2,120,0.0,32.0,32.0,2,164,0.0,60.0,54.0
0.001,17,2,180,1,66,0.0,38.0,38.0,1,114,0.0,86.0,86.0
0.003,17,4,284,2,120,0.0,32.0,32.0,2,164,0.0,60.0,54.0
300.505,6,19,3081,11,1647,30050.0,517.0,266.0,8,1434,34350.0,821.0,336.0
0.015,6,10,1983,5,910,3.0,642.0,642.0,5,1073,3.0,805.0,805.0
0.012,6,10,1972,5,910,2.0,642.0,642.0,5,1062,3.0,794.0,794.0
0.005,6,10,1774,5,923,1.0,655.0,655.0,5,851,1.0,583.0,583.0
0.068,6,10,1506,5,395,15.0,127.0,127.0,5,1111,13.0,843.0,843.0
0.02,6,10,1677,5,827,5.0,559.0,559.0,5,850,4.0,582.0,582.0
15.119,17,19,13436,9,8280,1886.0,1350.0,892.0,10,5156,1676.0,1350.0,487.0
0.004,6,10,2000,5,927,1.0,659.0,659.0,5,1073,1.0,805.0,805.0
300.375,6,16,2170,9,684,37526.0,146.0,146.0,7,1486,50035.0,419.0,398.0
0.01,6,10,1643,5,860,2.0,592.0,592.0,5,783,2.0,515.0,515.0
11.03,17,28,4421,14,1994,839.0,269.0,114.0,14,2427,839.0,586.0,145.0
0.005,6,13,3747,7,509,0.0,137.0,137.0,6,3238,1.0,1470.0,1459.0
0.0,17,2,154,1,69,0.0,41.0,41.0,1,85,0.0,57.0,57.0
0.089,6,10,1506,5,395,20.0,127.0,127.0,5,1111,21.0,843.0,843.0
0.08,6,10,1506,5,395,18.0,127.0,127.0,5,1111,18.0,843.0,843.0
0.005,17,2,148,1,60,0.0,32.0,32.0,1,88,0.0,60.0,60.0
0.004,17,4,284,2,120,1.0,32.0,32.0,2,164,0.0,60.0,54.0
40.054,17,10,676,5,460,10012.0,104.0,64.0,5,216,10012.0,20.0,15.0
11.071,17,28,4420,14,1993,839.0,268.0,114.0,14,2427,839.0,586.0,145.0
0.005,17,2,212,1,74,0.0,46.0,46.0,1,138,0.0,110.0,110.0
0.009,6,12,1926,6,1189,1.0,659.0,434.0,6,737,1.0,417.0,417.0
0.005,6,10,1643,5,860,1.0,592.0,592.0,5,783,1.0,515.0,515.0
0.035,6,10,1972,5,910,8.0,642.0,642.0,5,1062,8.0,794.0,794.0
0.015,6,10,1983,5,910,3.0,642.0,642.0,5,1073,3.0,805.0,805.0
0.115,6,10,1506,5,395,27.0,127.0,127.0,5,1111,27.0,843.0,843.0
0.005,6,10,2006,5,927,1.0,659.0,659.0,5,1079,1.0,811.0,811.0
0.177,6,3,453,2,321,177.0,241.0,241.0,1,132,0.0,92.0,92.0
0.005,17,2,170,1,65,0.0,37.0,37.0,1,105,0.0,77.0,77.0
11.536,17,28,4396,14,2313,874.0,588.0,137.0,14,2083,874.0,270.0,120.0
0.007,6,10,1854,5,889,1.0,621.0,621.0,5,965,1.0,697.0,697.0
0.022,6,10,1989,5,910,5.0,642.0,642.0,5,1079,5.0,811.0,811.0
0.073,17,2,148,1,60,0.0,32.0,32.0,1,88,0.0,60.0,60.0
314.274,17,20,1124,10,716,34905.0,48.0,43.0,10,408,34905.0,20.0,12.0
0.012,6,10,1972,5,910,2.0,642.0,642.0,5,1062,3.0,794.0,794.0
310.623,17,18,1008,9,640,38811.0,48.0,43.0,9,368,38811.0,20.0,12.0
0.075,6,10,1506,5,395,16.0,127.0,127.0,5,1111,16.0,843.0,843.0
0.079,6,10,1506,5,395,18.0,127.0,127.0,5,1111,19.0,843.0,843.0
0.016,6,10,1990,5,911,3.0,643.0,643.0,5,1079,3.0,811.0,811.0
40.068,17,10,676,5,460,10014.0,104.0,64.0,5,216,10016.0,20.0,15.0
0.097,6,10,1506,5,395,17.0,127.0,127.0,5,1111,22.0,843.0,843.0
0.004,17,2,142,1,63,0.0,35.0,35.0,1,79,0.0,51.0,51.0
0.107,6,10,1506,5,395,24.0,127.0,127.0,5,1111,21.0,843.0,843.0
0.005,6,10,2006,5,927,1.0,659.0,659.0,5,1079,1.0,811.0,811.0
0.009,6,10,1989,5,910,2.0,642.0,642.0,5,1079,2.0,811.0,811.0
0.006,6,10,1854,5,889,1.0,621.0,621.0,5,965,1.0,697.0,697.0
0.013,6,10,1762,5,911,3.0,643.0,643.0,5,851,3.0,583.0,583.0
240.338,6,39,10350,20,1991,12649.0,544.0,188.0,19,8359,13351.0,1402.0,614.0
15.072,17,15,9239,8,6902,2149.0,1350.0,834.0,7,2337,2507.0,1350.0,305.0
0.057,6,10,1506,5,395,13.0,127.0,127.0,5,1111,12.0,843.0,843.0
0.336,6,22,7137,11,1609,33.0,746.0,257.0,11,5528,33.0,2335.0,989.0
0.039,17,4,284,2,120,0.0,32.0,32.0,2,164,36.0,60.0,54.0
0.006,6,10,2000,5,927,1.0,659.0,659.0,5,1073,1.0,805.0,805.0
40.054,17,10,676,5,460,10012.0,104.0,64.0,5,216,10012.0,20.0,15.0
0.004,6,10,2000,5,927,1.0,659.0,659.0,5,1073,1.0,805.0,805.0
0.084,6,10,1506,5,395,19.0,127.0,127.0,5,1111,19.0,843.0,843.0
0.0,17,2,166,1,75,0.0,47.0,47.0,1,91,0.0,63.0,63.0
0.016,17,2,198,1,91,0.0,63.0,63.0,1,107,0.0,79.0,79.0
0.003,17,4,420,2,122,0.0,33.0,33.0,2,298,0.0,145.0,121.0
175.511,17,74,10541,37,2466,4875.0,44.0,38.0,37,8075,4875.0,239.0,190.0
0.003,17,2,148,1,60,0.0,32.0,32.0,1,88,0.0,60.0,60.0
0.005,17,4,284,2,120,1.0,32.0,32.0,2,164,2.0,60.0,54.0
0.009,6,10,1989,5,910,2.0,642.0,642.0,5,1079,2.0,811.0,811.0
0.005,6,10,2006,5,927,1.0,659.0,659.0,5,1079,1.0,811.0,811.0
15.074,17,15,9238,8,6902,2149.0,1350.0,834.0,7,2336,2507.0,1350.0,305.0
0.005,17,2,170,1,65,0.0,37.0,37.0,1,105,0.0,77.0,77.0
1787.145,6,154,19574,92,13852,19638.0,302.0,302.0,62,5722,29297.0,83.0,83.0
0.008,6,10,1762,5,911,2.0,643.0,643.0,5,851,1.0,583.0,583.0
0.007,6,10,1972,5,910,1.0,642.0,642.0,5,1062,1.0,794.0,794.0
240.013,6,9,787,5,488,60003.0,232.0,232.0,4,299,80003.0,83.0,83.0
0.004,17,2,148,1,60,0.0,32.0,32.0,1,88,0.0,60.0,60.0
0.005,17,2,154,1,69,0.0,41.0,41.0,1,85,0.0,57.0,57.0
0.004,6,10,2007,5,928,1.0,660.0,660.0,5,1079,1.0,811.0,811.0
0.005,6,14,3742,7,452,0.0,80.0,80.0,7,3290,0.0,1448.0,972.0
0.041,17,2,412,1,61,0.0,33.0,33.0,1,351,0.0,323.0,323.0
0.011,6,10,1989,5,910,2.0,642.0,642.0,5,1079,2.0,811.0,811.0
0.082,6,10,1506,5,395,18.0,127.0,127.0,5,1111,16.0,843.0,843.0
0.01,6,10,1989,5,910,2.0,642.0,642.0,5,1079,2.0,811.0,811.0
15.074,17,14,9191,8,6902,2149.0,1350.0,834.0,6,2289,3008.0,1350.0,353.0
0.042,17,4,284,2,120,0.0,32.0,32.0,2,164,38.0,60.0,54.0
15.077,17,16,9302,8,6912,2149.0,1350.0,836.0,8,2390,2149.0,1350.0,270.0
0.005,17,2,154,1,69,0.0,41.0,41.0,1,85,0.0,57.0,57.0
0.003,17,2,148,1,60,0.0,32.0,32.0,1,88,0.0,60.0,60.0
0.016,6,10,1631,5,848,4.0,580.0,580.0,5,783,4.0,515.0,515.0
0.004,6,10,1702,5,863,1.0,595.0,595.0,5,839,0.0,571.0,571.0
0.013,6,10,1989,5,910,3.0,642.0,642.0,5,1079,3.0,811.0,811.0
0.009,6,14,3787,7,497,1.0,125.0,125.0,7,3290,1.0,1448.0,972.0
240.288,6,41,8667,20,5634,12646.0,2883.0,573.0,21,3033,12014.0,580.0,241.0
15.069,17,15,9239,8,6902,2148.0,1350.0,834.0,7,2337,2506.0,1350.0,305.0
0.091,6,10,1506,5,395,20.0,127.0,127.0,5,1111,19.0,843.0,843.0
0.211,6,16,2670,8,1396,30.0,533.0,324.0,8,1274,19.0,529.0,212.0
0.004,6,10,2007,5,928,1.0,660.0,660.0,5,1079,1.0,811.0,811.0
0.001,17,2,136,1,60,0.0,32.0,32.0,1,76,0.0,48.0,48.0
0.005,17,2,140,1,62,0.0,34.0,34.0,1,78,0.0,50.0,50.0
0.005,6,10,1689,5,839,1.0,571.0,571.0,5,850,1.0,582.0,582.0
0.005,6,14,3742,7,452,0.0,80.0,80.0,7,3290,0.0,1448.0,972.0
55.36,6,44,13454,22,7547,431.0,2720.0,947.0,22,5907,2628.0,2667.0,385.0
10.899,17,28,4420,14,1995,830.0,270.0,114.0,14,2425,830.0,588.0,145.0
40.052,17,10,676,5,460,10010.0,104.0,64.0,5,216,10012.0,20.0,15.0
0.005,6,10,1779,5,928,1.0,660.0,660.0,5,851,1.0,583.0,583.0
0.086,6,10,1506,5,395,19.0,127.0,127.0,5,1111,16.0,843.0,843.0
240.013,6,9,787,5,488,60003.0,232.0,232.0,4,299,80003.0,83.0,83.0
0.04,17,2,136,1,60,0.0,32.0,32.0,1,76,0.0,48.0,48.0
0.01,6,10,1972,5,910,2.0,642.0,642.0,5,1062,2.0,794.0,794.0
0.011,6,10,1762,5,911,2.0,643.0,643.0,5,851,2.0,583.0,583.0
0.007,6,10,1643,5,860,1.0,592.0,592.0,5,783,1.0,515.0,515.0
0.005,17,2,255,1,82,0.0,54.0,54.0,1,173,0.0,145.0,145.0
0.072,6,10,1506,5,395,15.0,127.0,127.0,5,1111,16.0,843.0,843.0
0.015,17,2,230,1,68,0.0,40.0,40.0,1,162,0.0,134.0,134.0
0.015,6,10,1989,5,910,3.0,642.0,642.0,5,1079,3.0,811.0,811.0
0.004,17,2,169,1,62,0.0,34.0,34.0,1,107,0.0,79.0,79.0
40.063,17,10,676,5,460,10012.0,104.0,64.0,5,216,10014.0,20.0,15.0
0.015,6,13,3735,7,497,2.0,125.0,125.0,6,3238,2.0,1470.0,1459.0
1730.413,6,45,2790,30,1725,59669.0,35.0,35.0,15,1065,123595.0,31.0,31.0
0.01,6,10,1989,5,910,2.0,642.0,642.0,5,1079,2.0,811.0,811.0
0.009,6,10,1989,5,910,2.0,642.0,642.0,5,1079,2.0,811.0,811.0
40.061,17,10,676,5,460,10013.0,104.0,64.0,5,216,10014.0,20.0,15.0
11.172,17,28,4424,14,1995,847.0,270.0,114.0,14,2429,847.0,588.0,145.0
175.215,17,70,10174,35,2326,5153.0,44.0,38.0,35,7848,5153.0,261.0,196.0
0.006,6,10,1547,5,764,1.0,496.0,496.0,5,783,1.0,515.0,515.0
0.169,17,2,152,1,76,0.0,48.0,48.0,1,76,0.0,48.0,48.0
241.461,6,299,343244,120,17740,2029.0,2736.0,884.0,179,325504,1356.0,2804.0,1870.0
0.005,6,10,2007,5,928,1.0,660.0,660.0,5,1079,1.0,811.0,811.0
40.053,17,10,676,5,460,10012.0,104.0,64.0,5,216,10012.0,20.0,15.0
0.004,6,10,1702,5,863,1.0,595.0,595.0,5,839,1.0,571.0,571.0
0.1,6,10,1506,5,395,20.0,127.0,127.0,5,1111,20.0,843.0,843.0
0.15,6,10,1506,5,395,29.0,127.0,127.0,5,1111,36.0,843.0,843.0
0.069,6,10,1506,5,395,15.0,127.0,127.0,5,1111,16.0,843.0,843.0
0.09,6,10,1506,5,395,17.0,127.0,127.0,5,1111,21.0,843.0,843.0
0.118,6,10,1506,5,395,26.0,127.0,127.0,5,1111,23.0,843.0,843.0
0.005,6,10,2006,5,927,1.0,659.0,659.0,5,1079,1.0,811.0,811.0
0.071,6,10,1506,5,395,17.0,127.0,127.0,5,1111,13.0,843.0,843.0
0.008,6,10,1972,5,910,2.0,642.0,642.0,5,1062,2.0,794.0,794.0
0.005,6,10,2006,5,927,1.0,659.0,659.0,5,1079,1.0,811.0,811.0
0.11,6,10,1506,5,395,24.0,127.0,127.0,5,1111,24.0,843.0,843.0
0.006,6,10,1854,5,889,1.0,621.0,621.0,5,965,1.0,697.0,697.0
0.005,6,10,1854,5,889,1.0,621.0,621.0,5,965,1.0,697.0,697.0
0.005,6,10,1779,5,928,1.0,660.0,660.0,5,851,1.0,583.0,583.0
0.04,17,2,136,1,60,0.0,32.0,32.0,1,76,0.0,48.0,48.0
240.025,6,9,787,5,488,60006.0,232.0,232.0,4,299,80007.0,83.0,83.0
0.005,6,10,1643,5,860,1.0,592.0,592.0,5,783,1.0,515.0,515.0
0.005,17,2,191,1,70,0.0,42.0,42.0,1,121,0.0,93.0,93.0
0.006,6,13,3690,7,452,0.0,80.0,80.0,6,3238,1.0,1470.0,1459.0
0.006,6,10,1547,5,764,1.0,496.0,496.0,5,783,1.0,515.0,515.0
0.012,6,10,1972,5,910,3.0,642.0,642.0,5,1062,3.0,794.0,794.0
0.091,6,10,1506,5,395,21.0,127.0,127.0,5,1111,19.0,843.0,843.0
0.01,6,10,1972,5,910,2.0,642.0,642.0,5,1062,2.0,794.0,794.0
0.014,6,10,1677,5,827,3.0,559.0,559.0,5,850,3.0,582.0,582.0
0.009,6,10,1989,5,910,2.0,642.0,642.0,5,1079,2.0,811.0,811.0
0.073,6,10,1506,5,395,16.0,127.0,127.0,5,1111,16.0,843.0,843.0
0.008,6,10,1989,5,910,2.0,642.0,642.0,5,1079,2.0,811.0,811.0
0.021,17,2,140,1,62,0.0,34.0,34.0,1,78,0.0,50.0,50.0
0.005,6,10,2006,5,927,1.0,659.0,659.0,5,1079,1.0,811.0,811.0
0.006,6,10,1547,5,764,1.0,496.0,496.0,5,783,1.0,515.0,515.0
0.013,6,10,1972,5,910,3.0,642.0,642.0,5,1062,3.0,794.0,794.0
0.005,6,10,1989,5,927,1.0,659.0,659.0,5,1062,1.0,794.0,794.0
0.006,17,2,152,1,68,0.0,40.0,40.0,1,84,0.0,56.0,56.0
0.009,17,2,162,1,65,0.0,37.0,37.0,1,97,0.0,69.0,69.0
0.012,6,10,1989,5,910,3.0,642.0,642.0,5,1079,3.0,811.0,811.0
240.49,6,35,8923,18,2071,14145.0,692.0,225.0,17,6852,15030.0,1402.0,597.0
0.004,6,10,1989,5,927,1.0,659.0,659.0,5,1062,1.0,794.0,794.0
40.066,17,10,676,5,460,10014.0,104.0,64.0,5,216,10015.0,20.0,15.0
0.005,6,10,1643,5,860,1.0,592.0,592.0,5,783,1.0,515.0,515.0
0.005,6,10,2007,5,928,1.0,660.0,660.0,5,1079,1.0,811.0,811.0
40.066,17,10,676,5,460,10014.0,104.0,64.0,5,216,10015.0,20.0,15.0
0.009,6,10,1990,5,911,2.0,643.0,643.0,5,1079,2.0,811.0,811.0
0.075,6,10,1506,5,395,15.0,127.0,127.0,5,1111,16.0,843.0,843.0
0.004,6,10,1989,5,927,1.0,659.0,659.0,5,1062,1.0,794.0,794.0
0.002,17,2,152,1,76,0.0,48.0,48.0,1,76,0.0,48.0,48.0
333.448,17,20,1124,10,716,37035.0,48.0,43.0,10,408,37035.0,20.0,12.0
0.075,6,10,1506,5,395,16.0,127.0,127.0,5,1111,16.0,843.0,843.0
0.171,6,3,453,2,321,171.0,241.0,241.0,1,132,0.0,92.0,92.0
0.012,6,10,1677,5,827,3.0,559.0,559.0,5,850,2.0,582.0,582.0
0.003,17,2,148,1,60,0.0,32.0,32.0,1,88,0.0,60.0,60.0
0.096,6,10,1506,5,395,21.0,127.0,127.0,5,1111,21.0,843.0,843.0
0.014,6,10,1677,5,827,3.0,559.0,559.0,5,850,3.0,582.0,582.0
0.006,6,10,1990,5,911,1.0,643.0,643.0,5,1079,1.0,811.0,811.0
0.015,6,10,1989,5,910,3.0,642.0,642.0,5,1079,3.0,811.0,811.0
0.079,6,10,1506,5,395,17.0,127.0,127.0,5,1111,19.0,843.0,843.0
0.143,17,4,352,2,130,3.0,37.0,37.0,2,222,84.0,89.0,83.0
0.068,17,8,3613,4,1874,22.0,1350.0,440.0,4,1739,11.0,1350.0,406.0
0.087,6,10,1506,5,395,19.0,127.0,127.0,5,1111,16.0,843.0,843.0
0.004,17,2,148,1,60,0.0,32.0,32.0,1,88,0.0,60.0,60.0
0.159,6,10,1506,5,395,36.0,127.0,127.0,5,1111,36.0,843.0,843.0
0.162,17,2,152,1,76,0.0,48.0,48.0,1,76,0.0,48.0,48.0
0.008,6,10,1983,5,910,2.0,642.0,642.0,5,1073,1.0,805.0,805.0
0.072,6,10,1506,5,395,16.0,127.0,127.0,5,1111,14.0,843.0,843.0
0.004,17,4,284,2,120,0.0,32.0,32.0,2,164,0.0,60.0,54.0
0.101,6,10,1506,5,395,24.0,127.0,127.0,5,1111,20.0,843.0,843.0
0.015,6,10,1605,5,388,3.0,120.0,120.0,5,1217,3.0,949.0,949.0
0.005,6,10,1989,5,927,1.0,659.0,659.0,5,1062,1.0,794.0,794.0
0.006,17,2,175,1,65,0.0,37.0,37.0,1,110,0.0,82.0,82.0
0.014,6,10,1989,5,910,3.0,642.0,642.0,5,1079,3.0,811.0,811.0
40.061,17,10,676,5,460,10014.0,104.0,64.0,5,216,10014.0,20.0,15.0
0.005,6,10,1547,5,764,1.0,496.0,496.0,5,783,1.0,515.0,515.0
0.013,6,10,1983,5,910,3.0,642.0,642.0,5,1073,3.0,805.0,805.0
0.005,6,10,2000,5,927,1.0,659.0,659.0,5,1073,1.0,805.0,805.0
0.034,6,10,1983,5,910,8.0,642.0,642.0,5,1073,8.0,805.0,805.0
0.213,6,10,1506,5,395,44.0,127.0,127.0,5,1111,52.0,843.0,843.0
0.004,6,10,1989,5,927,1.0,659.0,659.0,5,1062,1.0,794.0,794.0
0.09,6,10,1506,5,395,20.0,127.0,127.0,5,1111,16.0,843.0,843.0
0.09,6,10,1506,5,395,19.0,127.0,127.0,5,1111,18.0,843.0,843.0
0.014,6,10,1972,5,910,3.0,642.0,642.0,5,1062,3.0,794.0,794.0
0.015,17,2,198,1,91,0.0,63.0,63.0,1,107,0.0,79.0,79.0
0.024,17,4,284,2,120,0.0,32.0,32.0,2,164,0.0,60.0,54.0
0.004,17,2,136,1,60,0.0,32.0,32.0,1,76,0.0,48.0,48.0
0.004,6,10,2006,5,927,1.0,659.0,659.0,5,1079,1.0,811.0,811.0
10.833,17,26,4073,13,1845,894.0,268.0,113.0,13,2228,893.0,587.0,143.0
0.012,6,10,1989,5,910,3.0,642.0,642.0,5,1079,2.0,811.0,811.0
0.009,6,10,1989,5,910,2.0,642.0,642.0,5,1079,2.0,811.0,811.0
40.056,17,10,676,5,460,10013.0,104.0,64.0,5,216,10013.0,20.0,15.0
0.005,6,10,2007,5,928,1.0,660.0,660.0,5,1079,1.0,811.0,811.0
0.008,6,10,1972,5,910,2.0,642.0,642.0,5,1062,2.0,794.0,794.0
0.018,6,10,1677,5,827,4.0,559.0,559.0,5,850,4.0,582.0,582.0
178.048,17,74,10595,37,2468,4945.0,44.0,38.0,37,8127,4945.0,261.0,191.0
0.003,6,10,1702,5,863,0.0,595.0,595.0,5,839,0.0,571.0,571.0
0.004,6,10,1702,5,863,0.0,595.0,595.0,5,839,1.0,571.0,571.0
0.03,6,10,1990,5,911,7.0,643.0,643.0,5,1079,7.0,811.0,811.0
0.011,6,10,1972,5,910,2.0,642.0,642.0,5,1062,2.0,794.0,794.0
0.094,6,38,33548,17,1985,5.0,525.0,364.0,21,31563,4.0,2804.0,1791.0
0.006,17,2,230,1,68,0.0,40.0,40.0,1,162,0.0,134.0,134.0
0.127,6,10,1506,5,395,30.0,127.0,127.0,5,1111,28.0,843.0,843.0
0.175,6,10,1506,5,395,42.0,127.0,127.0,5,1111,36.0,843.0,843.0
0.004,17,2,136,1,60,0.0,32.0,32.0,1,76,0.0,48.0,48.0
0.039,17,4,420,2,122,0.0,33.0,33.0,2,298,2.0,145.0,121.0
0.009,6,10,1989,5,910,2.0,642.0,642.0,5,1079,2.0,811.0,811.0
0.006,6,10,1643,5,860,1.0,592.0,592.0,5,783,1.0,515.0,515.0
0.006,6,10,1547,5,764,1.0,496.0,496.0,5,783,1.0,515.0,515.0
0.005,6,13,3690,7,452,0.0,80.0,80.0,6,3238,0.0,1470.0,1459.0
0.013,6,10,1972,5,910,3.0,642.0,642.0,5,1062,3.0,794.0,794.0
0.008,6,10,1989,5,910,2.0,642.0,642.0,5,1079,2.0,811.0,811.0
0.006,6,10,1547,5,764,1.0,496.0,496.0,5,783,1.0,515.0,515.0
0.011,6,10,1990,5,911,2.0,643.0,643.0,5,1079,2.0,811.0,811.0
0.016,6,10,1677,5,827,4.0,559.0,559.0,5,850,4.0,582.0,582.0
240.009,6,9,787,5,488,60002.0,232.0,232.0,4,299,80002.0,83.0,83.0
0.006,6,10,1547,5,764,1.0,496.0,496.0,5,783,1.0,515.0,515.0
361.805,6,21,1793,16,1030,24120.0,190.0,190.0,5,763,60010.0,462.0,247.0
0.024,6,10,1983,5,910,6.0,642.0,642.0,5,1073,5.0,805.0,805.0
0.004,17,2,136,1,60,0.0,32.0,32.0,1,76,0.0,48.0,48.0
0.076,6,10,1506,5,395,16.0,127.0,127.0,5,1111,18.0,843.0,843.0
0.006,6,10,1689,5,839,1.0,571.0,571.0,5,850,1.0,582.0,582.0
0.005,6,10,2007,5,928,1.0,660.0,660.0,5,1079,1.0,811.0,811.0
0.006,6,10,1547,5,764,1.0,496.0,496.0,5,783,1.0,515.0,515.0
0.005,6,10,1989,5,927,1.0,659.0,659.0,5,1062,1.0,794.0,794.0
0.022,6,10,1631,5,848,5.0,580.0,580.0,5,783,5.0,515.0,515.0
0.069,6,10,1506,5,395,16.0,127.0,127.0,5,1111,14.0,843.0,843.0
40.064,17,10,676,5,460,10013.0,104.0,64.0,5,216,10015.0,20.0,15.0
0.009,6,10,1643,5,860,2.0,592.0,592.0,5,783,2.0,515.0,515.0
0.005,6,10,2006,5,927,1.0,659.0,659.0,5,1079,1.0,811.0,811.0
0.005,6,10,2007,5,928,1.0,660.0,660.0,5,1079,1.0,811.0,811.0
0.005,6,10,1989,5,927,1.0,659.0,659.0,5,1062,1.0,794.0,794.0
0.113,6,10,1506,5,395,26.0,127.0,127.0,5,1111,26.0,843.0,843.0
0.005,17,2,214,1,75,0.0,47.0,47.0,1,139,0.0,111.0,111.0
0.006,6,10,1989,5,927,1.0,659.0,659.0,5,1062,1.0,794.0,794.0
0.005,6,10,2006,5,927,1.0,659.0,659.0,5,1079,1.0,811.0,811.0
0.017,6,10,1989,5,910,4.0,642.0,642.0,5,1079,4.0,811.0,811.0
0.005,6,10,2000,5,927,1.0,659.0,659.0,5,1073,1.0,805.0,805.0
0.009,6,10,1989,5,910,2.0,642.0,642.0,5,1079,2.0,811.0,811.0
0.008,6,10,1989,5,910,2.0,642.0,642.0,5,1079,2.0,811.0,811.0
0.005,6,10,2006,5,927,1.0,659.0,659.0,5,1079,1.0,811.0,811.0
0.005,6,10,1854,5,889,1.0,621.0,621.0,5,965,1.0,697.0,697.0
0.005,17,2,166,1,75,0.0,47.0,47.0,1,91,0.0,63.0,63.0
0.005,6,10,2007,5,928,1.0,660.0,660.0,5,1079,1.0,811.0,811.0
0.071,6,10,1506,5,395,16.0,127.0,127.0,5,1111,16.0,843.0,843.0
0.005,6,10,2007,5,928,1.0,660.0,660.0,5,1079,1.0,811.0,811.0
0.005,6,14,3736,7,446,0.0,74.0,74.0,7,3290,0.0,1448.0,972.0
0.006,6,10,2000,5,927,1.0,659.0,659.0,5,1073,1.0,805.0,805.0
0.008,6,10,1990,5,911,2.0,643.0,643.0,5,1079,2.0,811.0,811.0
0.012,6,10,1989,5,927,3.0,659.0,659.0,5,1062,3.0,794.0,794.0
0.004,6,10,2006,5,927,1.0,659.0,659.0,5,1079,1.0,811.0,811.0
0.137,6,10,1506,5,395,30.0,127.0,127.0,5,1111,31.0,843.0,843.0
0.004,6,10,1774,5,923,1.0,655.0,655.0,5,851,1.0,583.0,583.0
0.004,6,10,1774,5,923,1.0,655.0,655.0,5,851,1.0,583.0,583.0
0.005,6,10,2006,5,927,1.0,659.0,659.0,5,1079,1.0,811.0,811.0
0.016,6,13,3735,7,497,2.0,125.0,125.0,6,3238,3.0,1470.0,1459.0
0.155,6,10,1506,5,395,37.0,127.0,127.0,5,1111,15.0,843.0,843.0
12.031,17,28,4397,14,1994,917.0,269.0,114.0,14,2403,917.0,586.0,143.0
0.005,6,14,3736,7,446,0.0,74.0,74.0,7,3290,0.0,1448.0,972.0
0.006,6,10,1547,5,764,1.0,496.0,496.0,5,783,1.0,515.0,515.0
0.009,6,12,1926,6,1189,1.0,659.0,434.0,6,737,1.0,417.0,417.0
0.009,6,10,1983,5,910,2.0,642.0,642.0,5,1073,2.0,805.0,805.0
0.121,6,10,1506,5,395,28.0,127.0,127.0,5,1111,28.0,843.0,843.0
0.085,6,10,1506,5,395,17.0,127.0,127.0,5,1111,18.0,843.0,843.0
0.14,6,10,1506,5,395,27.0,127.0,127.0,5,1111,31.0,843.0,843.0
0.754,6,10,2009,6,1655,150.0,1403.0,1403.0,4,354,174.0,182.0,182.0
0.007,6,10,1547,5,764,1.0,496.0,496.0,5,783,1.0,515.0,515.0
0.004,6,10,2000,5,927,1.0,659.0,659.0,5,1073,1.0,805.0,805.0
0.072,17,2,148,1,60,0.0,32.0,32.0,1,88,0.0,60.0,60.0
0.068,6,10,1506,5,395,15.0,127.0,127.0,5,1111,15.0,843.0,843.0
0.005,6,10,1989,5,927,1.0,659.0,659.0,5,1062,1.0,794.0,794.0
0.004,6,10,1702,5,863,1.0,595.0,595.0,5,839,1.0,571.0,571.0
0.003,17,2,136,1,60,0.0,32.0,32.0,1,76,0.0,48.0,48.0
0.011,6,10,1989,5,910,2.0,642.0,642.0,5,1079,2.0,811.0,811.0
0.006,6,10,1689,5,839,1.0,571.0,571.0,5,850,1.0,582.0,582.0
0.055,6,10,1506,5,395,12.0,127.0,127.0,5,1111,12.0,843.0,843.0
0.013,6,10,1631,5,848,3.0,580.0,580.0,5,783,3.0,515.0,515.0
0.018,6,10,1972,5,910,4.0,642.0,642.0,5,1062,4.0,794.0,794.0
0.001,17,2,136,1,60,0.0,32.0,32.0,1,76,0.0,48.0,48.0
0.042,17,2,148,1,60,0.0,32.0,32.0,1,88,0.0,60.0,60.0
0.008,6,10,1989,5,910,2.0,642.0,642.0,5,1079,2.0,811.0,811.0
0.003,17,2,148,1,60,0.0,32.0,32.0,1,88,0.0,60.0,60.0
0.011,6,10,1677,5,827,2.0,559.0,559.0,5,850,2.0,582.0,582.0
0.004,6,10,2006,5,927,1.0,659.0,659.0,5,1079,1.0,811.0,811.0
0.001,17,2,180,1,65,0.0,37.0,37.0,1,115,0.0,87.0,87.0
0.005,6,10,1989,5,927,1.0,659.0,659.0,5,1062,1.0,794.0,794.0
0.012,6,14,3787,7,497,1.0,125.0,125.0,7,3290,2.0,1448.0,972.0
0.016,6,10,1983,5,910,4.0,642.0,642.0,5,1073,3.0,805.0,805.0
240.013,6,9,787,5,488,60003.0,232.0,232.0,4,299,80003.0,83.0,83.0
0.004,17,4,284,2,120,0.0,32.0,32.0,2,164,0.0,60.0,54.0
0.005,17,2,144,1,64,0.0,36.0,36.0,1,80,0.0,52.0,52.0
0.07,6,10,1506,5,395,14.0,127.0,127.0,5,1111,16.0,843.0,843.0
241.439,6,300,342896,122,17857,1995.0,2736.0,959.0,178,325039,1364.0,2804.0,1879.0
0.09,6,10,1506,5,395,17.0,127.0,127.0,5,1111,20.0,843.0,843.0
11.26,17,27,4363,13,1938,924.0,270.0,121.0,14,2425,853.0,588.0,145.0
0.004,17,2,136,1,60,0.0,32.0,32.0,1,76,0.0,48.0,48.0
0.011,6,10,1972,5,910,2.0,642.0,642.0,5,1062,2.0,794.0,794.0
0.011,6,10,1989,5,910,2.0,642.0,642.0,5,1079,2.0,811.0,811.0
0.003,17,2,148,1,60,0.0,32.0,32.0,1,88,0.0,60.0,60.0
0.003,17,4,284,2,120,0.0,32.0,32.0,2,164,0.0,60.0,54.0
0.014,6,10,1990,5,911,3.0,643.0,643.0,5,1079,3.0,811.0,811.0
0.005,6,10,1989,5,927,1.0,659.0,659.0,5,1062,1.0,794.0,794.0
1719.215,6,61,7141,40,4348,44082.0,1641.0,113.0,21,2793,85951.0,1112.0,85.0
40.08,17,10,676,5,460,10018.0,104.0,64.0,5,216,10019.0,20.0,15.0
0.014,6,10,1989,5,910,3.0,642.0,642.0,5,1079,3.0,811.0,811.0
0.005,17,2,166,1,75,0.0,47.0,47.0,1,91,0.0,63.0,63.0
0.006,17,2,170,1,65,0.0,37.0,37.0,1,105,0.0,77.0,77.0
0.006,6,10,1689,5,839,1.0,571.0,571.0,5,850,1.0,582.0,582.0
0.011,6,10,1677,5,827,2.0,559.0,559.0,5,850,2.0,582.0,582.0
0.005,6,10,2006,5,927,1.0,659.0,659.0,5,1079,1.0,811.0,811.0
0.066,6,10,1506,5,395,15.0,127.0,127.0,5,1111,13.0,843.0,843.0
0.111,6,10,1506,5,395,27.0,127.0,127.0,5,1111,26.0,843.0,843.0
0.785,6,10,937,6,427,157.0,107.0,107.0,4,510,175.0,294.0,294.0
0.005,6,10,2006,5,927,1.0,659.0,659.0,5,1079,1.0,811.0,811.0
0.004,17,2,180,1,58,0.0,30.0,30.0,1,122,0.0,94.0,94.0
0.003,17,4,284,2,120,0.0,32.0,32.0,2,164,0.0,60.0,54.0
308.771,17,20,1124,10,716,34296.0,48.0,43.0,10,408,34295.0,20.0,12.0
40.061,17,10,676,5,460,10014.0,104.0,64.0,5,216,10014.0,20.0,15.0
0.005,6,10,1774,5,923,1.0,655.0,655.0,5,851,1.0,583.0,583.0
0.006,17,2,179,1,71,0.0,43.0,43.0,1,108,0.0,80.0,80.0
0.006,6,10,1547,5,764,1.0,496.0,496.0,5,783,1.0,515.0,515.0
0.005,17,2,179,1,71,0.0,43.0,43.0,1,108,0.0,80.0,80.0
0.005,6,10,2006,5,927,1.0,659.0,659.0,5,1079,1.0,811.0,811.0
0.004,6,10,1989,5,927,1.0,659.0,659.0,5,1062,1.0,794.0,794.0
10.817,17,26,4100,13,1821,892.0,268.0,112.0,13,2279,892.0,586.0,147.0
0.007,6,10,1762,5,911,1.0,643.0,643.0,5,851,1.0,583.0,583.0
0.005,17,2,166,1,75,0.0,47.0,47.0,1,91,0.0,63.0,63.0
0.099,6,10,1506,5,395,22.0,127.0,127.0,5,1111,22.0,843.0,843.0
0.005,6,10,2007,5,928,1.0,660.0,660.0,5,1079,1.0,811.0,811.0
0.008,6,10,2006,5,927,2.0,659.0,659.0,5,1079,2.0,811.0,811.0
0.012,6,10,1989,5,910,3.0,642.0,642.0,5,1079,3.0,811.0,811.0
15.082,17,15,8698,8,6537,2150.0,1350.0,789.0,7,2161,2508.0,1350.0,280.0
0.005,17,2,273,1,66,0.0,38.0,38.0,1,207,0.0,179.0,179.0
0.005,6,10,1689,5,839,1.0,571.0,571.0,5,850,1.0,582.0,582.0
0.108,6,10,1506,5,395,24.0,127.0,127.0,5,1111,25.0,843.0,843.0
0.004,6,10,2007,5,928,1.0,660.0,660.0,5,1079,1.0,811.0,811.0
0.003,17,4,284,2,120,0.0,32.0,32.0,2,164,0.0,60.0,54.0
9.038,17,6,376,5,280,2259.0,28.0,28.0,1,96,0.0,68.0,68.0
300.586,6,28,7485,16,1409,20039.0,217.0,142.0,12,6076,21867.0,1402.0,680.0
0.004,6,10,1774,5,923,1.0,655.0,655.0,5,851,1.0,583.0,583.0
0.006,17,2,186,1,61,0.0,33.0,33.0,1,125,0.0,97.0,97.0
0.005,6,10,1779,5,928,1.0,660.0,660.0,5,851,1.0,583.0,583.0
0.09,6,10,1506,5,395,20.0,127.0,127.0,5,1111,21.0,843.0,843.0
0.005,17,2,180,1,66,0.0,38.0,38.0,1,114,0.0,86.0,86.0
0.005,6,10,1989,5,927,1.0,659.0,659.0,5,1062,1.0,794.0,794.0
0.082,6,10,1506,5,395,19.0,127.0,127.0,5,1111,18.0,843.0,843.0
0.031,6,10,1677,5,827,7.0,559.0,559.0,5,850,7.0,582.0,582.0
40.051,17,10,676,5,460,10012.0,104.0,64.0,5,216,10011.0,20.0,15.0
0.118,6,10,1506,5,395,27.0,127.0,127.0,5,1111,25.0,843.0,843.0
0.106,6,10,1506,5,395,24.0,127.0,127.0,5,1111,23.0,843.0,843.0
0.014,6,10,1972,5,910,3.0,642.0,642.0,5,1062,3.0,794.0,794.0
0.009,6,10,1989,5,910,2.0,642.0,642.0,5,1079,2.0,811.0,811.0
0.122,6,10,1506,5,395,27.0,127.0,127.0,5,1111,28.0,843.0,843.0
0.152,6,10,1506,5,395,35.0,127.0,127.0,5,1111,34.0,843.0,843.0
0.006,6,13,3747,7,509,0.0,137.0,137.0,6,3238,1.0,1470.0,1459.0
0.009,6,10,1989,5,910,2.0,642.0,642.0,5,1079,2.0,811.0,811.0
0.008,6,10,1989,5,910,2.0,642.0,642.0,5,1079,2.0,811.0,811.0
0.004,17,2,136,1,60,0.0,32.0,32.0,1,76,0.0,48.0,48.0
1795.044,6,530,186085,271,161581,6648.0,2883.0,921.0,259,24504,6957.0,387.0,114.0
0.02,6,10,1990,5,911,4.0,643.0,643.0,5,1079,4.0,811.0,811.0
0.096,6,10,1506,5,395,19.0,127.0,127.0,5,1111,22.0,843.0,843.0
0.01,6,10,1989,5,910,2.0,642.0,642.0,5,1079,2.0,811.0,811.0
0.009,6,10,1972,5,910,2.0,642.0,642.0,5,1062,2.0,794.0,794.0
0.004,6,10,1989,5,927,1.0,659.0,659.0,5,1062,1.0,794.0,794.0
0.01,6,10,1989,5,910,2.0,642.0,642.0,5,1079,2.0,811.0,811.0
0.003,17,2,148,1,60,0.0,32.0,32.0,1,88,0.0,60.0,60.0
0.011,6,10,1983,5,910,2.0,642.0,642.0,5,1073,2.0,805.0,805.0
0.099,17,2,144,1,64,0.0,36.0,36.0,1,80,0.0,52.0,52.0
39.026,17,27,16325,15,13460,2784.0,1350.0,869.0,12,2865,3545.0,1350.0,210.0
0.061,6,10,1506,5,395,13.0,127.0,127.0,5,1111,12.0,843.0,843.0
0.007,6,10,1989,5,910,1.0,642.0,642.0,5,1079,1.0,811.0,811.0
0.005,6,10,1989,5,927,1.0,659.0,659.0,5,1062,1.0,794.0,794.0
0.015,6,10,1972,5,910,3.0,642.0,642.0,5,1062,3.0,794.0,794.0
0.003,17,2,148,1,60,0.0,32.0,32.0,1,88,0.0,60.0,60.0
0.006,6,10,1689,5,839,1.0,571.0,571.0,5,850,1.0,582.0,582.0
0.006,6,10,1547,5,764,1.0,496.0,496.0,5,783,1.0,515.0,515.0
0.074,17,2,136,1,60,0.0,32.0,32.0,1,76,0.0,48.0,48.0
0.001,17,2,180,1,66,0.0,38.0,38.0,1,114,0.0,86.0,86.0
0.006,17,2,170,1,65,0.0,37.0,37.0,1,105,0.0,77.0,77.0
0.047,17,2,148,1,60,0.0,32.0,32.0,1,88,0.0,60.0,60.0
9.038,17,6,376,5,280,2259.0,28.0,28.0,1,96,0.0,68.0,68.0
15.078,17,16,8024,8,5936,2149.0,1350.0,714.0,8,2088,2149.0,1350.0,233.0
0.081,6,10,1506,5,395,18.0,127.0,127.0,5,1111,17.0,843.0,843.0
0.008,6,10,1989,5,910,2.0,642.0,642.0,5,1079,2.0,811.0,811.0
0.007,6,10,1972,5,910,1.0,642.0,642.0,5,1062,1.0,794.0,794.0
0.005,6,10,2000,5,927,1.0,659.0,659.0,5,1073,1.0,805.0,805.0
5.141,6,23,6467,13,1827,428.0,801.0,282.0,10,4640,570.0,1925.0,824.0
0.224,6,16,2778,8,1396,32.0,533.0,324.0,8,1382,20.0,529.0,239.0
1.147,17,6,780,3,183,554.0,33.0,33.0,3,597,554.0,323.0,171.0
0.093,6,10,1506,5,395,20.0,127.0,127.0,5,1111,20.0,843.0,843.0
11.002,17,28,4390,14,2312,837.0,587.0,137.0,14,2078,837.0,269.0,120.0
308.309,17,20,1124,10,716,34244.0,48.0,43.0,10,408,34243.0,20.0,12.0
0.005,6,10,2006,5,927,1.0,659.0,659.0,5,1079,1.0,811.0,811.0
0.019,6,10,1677,5,827,4.0,559.0,559.0,5,850,4.0,582.0,582.0
0.014,6,10,1989,5,910,3.0,642.0,642.0,5,1079,3.0,811.0,811.0
1788.212,6,64,7361,42,4485,43614.0,1641.0,109.0,22,2876,85144.0,1112.0,82.0
0.077,6,10,1506,5,395,17.0,127.0,127.0,5,1111,15.0,843.0,843.0
0.085,6,10,1506,5,395,18.0,127.0,127.0,5,1111,19.0,843.0,843.0
0.018,6,10,1983,5,910,4.0,642.0,642.0,5,1073,4.0,805.0,805.0
0.111,6,10,1506,5,395,22.0,127.0,127.0,5,1111,26.0,843.0,843.0
0.067,6,10,1506,5,395,13.0,127.0,127.0,5,1111,14.0,843.0,843.0
0.011,6,14,3787,7,497,1.0,125.0,125.0,7,3290,1.0,1448.0,972.0
0.005,6,10,1643,5,860,1.0,592.0,592.0,5,783,1.0,515.0,515.0
0.001,17,2,180,1,66,0.0,38.0,38.0,1,114,0.0,86.0,86.0
240.167,6,51,7323,23,3316,10916.0,588.0,211.0,28,4007,8894.0,580.0,211.0
0.472,17,59,38899,34,32674,14.0,1350.0,933.0,25,6225,17.0,1350.0,221.0
0.016,17,2,198,1,91,0.0,63.0,63.0,1,107,0.0,79.0,79.0
10.866,17,26,4101,13,1845,896.0,268.0,113.0,13,2256,896.0,587.0,145.0
0.011,6,10,1990,5,911,2.0,643.0,643.0,5,1079,2.0,811.0,811.0
291.44,6,403,348363,199,21907,1471.0,2736.0,888.0,204,326456,1435.0,2804.0,1671.0
10.805,17,28,4421,14,1993,822.0,268.0,114.0,14,2428,822.0,587.0,145.0
172.261,17,76,10900,38,2537,4655.0,44.0,38.0,38,8363,4655.0,261.0,192.0
0.004,6,10,1702,5,863,1.0,595.0,595.0,5,839,1.0,571.0,571.0
0.014,6,10,1631,5,848,3.0,580.0,580.0,5,783,3.0,515.0,515.0
0.065,6,10,1506,5,395,14.0,127.0,127.0,5,1111,14.0,843.0,843.0
0.006,6,10,1547,5,764,1.0,496.0,496.0,5,783,1.0,515.0,515.0
0.012,6,10,1989,5,910,2.0,642.0,642.0,5,1079,3.0,811.0,811.0
0.02,6,10,1677,5,827,4.0,559.0,559.0,5,850,5.0,582.0,582.0
0.006,17,2,170,1,65,0.0,37.0,37.0,1,105,0.0,77.0,77.0
0.109,6,10,1506,5,395,25.0,127.0,127.0,5,1111,24.0,843.0,843.0
0.012,6,10,1989,5,910,2.0,642.0,642.0,5,1079,3.0,811.0,811.0
0.128,6,10,1506,5,395,30.0,127.0,127.0,5,1111,24.0,843.0,843.0
0.01,6,10,1972,5,910,2.0,642.0,642.0,5,1062,2.0,794.0,794.0
0.004,6,10,1989,5,927,1.0,659.0,659.0,5,1062,1.0,794.0,794.0
0.004,6,10,1779,5,928,1.0,660.0,660.0,5,851,1.0,583.0,583.0
0.003,17,2,148,1,60,0.0,32.0,32.0,1,88,0.0,60.0,60.0
0.011,6,10,1983,5,910,2.0,642.0,642.0,5,1073,2.0,805.0,805.0
0.009,6,10,1854,5,889,2.0,621.0,621.0,5,965,2.0,697.0,697.0
0.099,6,10,1506,5,395,21.0,127.0,127.0,5,1111,23.0,843.0,843.0
0.168,17,2,152,1,76,0.0,48.0,48.0,1,76,0.0,48.0,48.0
0.006,6,10,1547,5,764,1.0,496.0,496.0,5,783,1.0,515.0,515.0
308.332,17,18,1008,9,640,38525.0,48.0,43.0,9,368,38525.0,20.0,12.0
0.004,6,10,2007,5,928,1.0,660.0,660.0,5,1079,1.0,811.0,811.0
0.097,6,10,1506,5,395,20.0,127.0,127.0,5,1111,21.0,843.0,843.0
1770.465,6,87,5687,43,2286,42152.0,50.0,50.0,44,3401,41172.0,503.0,371.0
0.005,6,10,2006,5,927,1.0,659.0,659.0,5,1079,1.0,811.0,811.0
0.094,6,10,1506,5,395,21.0,127.0,127.0,5,1111,22.0,843.0,843.0
0.001,17,2,136,1,60,0.0,32.0,32.0,1,76,0.0,48.0,48.0
240.013,6,9,787,5,488,60003.0,232.0,232.0,4,299,80003.0,83.0,83.0
0.016,17,2,198,1,91,0.0,63.0,63.0,1,107,0.0,79.0,79.0
0.005,17,2,164,1,74,0.0,46.0,46.0,1,90,0.0,62.0,62.0
0.005,6,13,3747,7,509,0.0,137.0,137.0,6,3238,1.0,1470.0,1459.0
0.006,6,10,1547,5,764,1.0,496.0,496.0,5,783,1.0,515.0,515.0
0.009,6,12,1926,6,1189,1.0,659.0,434.0,6,737,1.0,417.0,417.0
0.005,6,10,2006,5,927,1.0,659.0,659.0,5,1079,1.0,811.0,811.0
240.091,6,31,8165,16,5649,16006.0,1515.0,535.0,15,2516,17149.0,580.0,216.0
0.01,6,10,1989,5,910,2.0,642.0,642.0,5,1079,2.0,811.0,811.0
0.005,17,2,180,1,66,0.0,38.0,38.0,1,114,0.0,86.0,86.0
0.086,6,10,1506,5,395,18.0,127.0,127.0,5,1111,19.0,843.0,843.0
40.056,17,10,676,5,460,10012.0,104.0,64.0,5,216,10013.0,20.0,15.0
0.086,6,10,1506,5,395,17.0,127.0,127.0,5,1111,19.0,843.0,843.0
0.004,6,10,1989,5,927,1.0,659.0,659.0,5,1062,1.0,794.0,794.0
0.005,6,14,3799,7,509,0.0,137.0,137.0,7,3290,0.0,1448.0,972.0
173.257,17,78,11149,39,2611,4559.0,44.0,38.0,39,8538,4559.0,252.0,190.0
0.009,6,10,1689,5,839,2.0,571.0,571.0,5,850,2.0,582.0,582.0
178.524,17,82,11335,41,2735,4462.0,44.0,38.0,41,8600,4463.0,239.0,181.0
0.004,6,10,2007,5,928,1.0,660.0,660.0,5,1079,1.0,811.0,811.0
241.655,6,320,343836,117,17607,2083.0,2736.0,886.0,203,326229,1196.0,2804.0,1635.0
0.012,6,10,1989,5,910,3.0,642.0,642.0,5,1079,3.0,811.0,811.0
0.005,6,10,2006,5,927,1.0,659.0,659.0,5,1079,1.0,811.0,811.0
0.006,6,10,1547,5,764,1.0,496.0,496.0,5,783,1.0,515.0,515.0
0.084,6,10,1506,5,395,19.0,127.0,127.0,5,1111,19.0,843.0,843.0
11.179,17,28,4423,14,1994,847.0,269.0,114.0,14,2429,847.0,588.0,145.0
0.005,6,10,1643,5,860,1.0,592.0,592.0,5,783,1.0,515.0,515.0
0.102,6,10,1506,5,395,19.0,127.0,127.0,5,1111,22.0,843.0,843.0
0.128,17,4,284,2,120,0.0,32.0,32.0,2,164,124.0,60.0,54.0
0.11,6,10,1506,5,395,26.0,127.0,127.0,5,1111,24.0,843.0,843.0
0.004,6,10,2006,5,927,1.0,659.0,659.0,5,1079,1.0,811.0,811.0
0.15,6,10,1506,5,395,36.0,127.0,127.0,5,1111,33.0,843.0,843.0
0.005,6,10,2006,5,927,1.0,659.0,659.0,5,1079,1.0,811.0,811.0
0.005,17,2,148,1,60,0.0,32.0,32.0,1,88,0.0,60.0,60.0
291.836,6,380,347820,197,21797,1488.0,2736.0,889.0,183,326023,1603.0,4206.0,1872.0
0.07,6,10,1506,5,395,15.0,127.0,127.0,5,1111,15.0,843.0,843.0
0.06,6,10,1506,5,395,14.0,127.0,127.0,5,1111,12.0,843.0,843.0
0.108,6,10,1506,5,395,24.0,127.0,127.0,5,1111,26.0,843.0,843.0
0.004,6,10,2000,5,927,1.0,659.0,659.0,5,1073,1.0,805.0,805.0
0.007,6,12,1698,6,863,1.0,327.0,271.0,6,835,1.0,515.0,515.0
0.005,6,10,2007,5,928,1.0,660.0,660.0,5,1079,1.0,811.0,811.0
1770.605,17,120,11460,60,5460,30009.0,63.0,63.0,60,6000,30009.0,72.0,72.0
0.127,17,2,136,1,60,0.0,32.0,32.0,1,76,0.0,48.0,48.0
0.001,17,2,179,1,62,0.0,34.0,34.0,1,117,0.0,89.0,89.0
0.004,17,2,136,1,60,0.0,32.0,32.0,1,76,0.0,48.0,48.0
0.005,17,2,180,1,66,0.0,38.0,38.0,1,114,0.0,86.0,86.0
0.005,6,10,1689,5,839,1.0,571.0,571.0,5,850,1.0,582.0,582.0
0.001,17,2,180,1,65,0.0,37.0,37.0,1,115,0.0,87.0,87.0
0.006,17,2,164,1,74,0.0,46.0,46.0,1,90,0.0,62.0,62.0
0.088,6,10,1506,5,395,18.0,127.0,127.0,5,1111,18.0,843.0,843.0
15.076,17,16,9302,8,6912,2149.0,1350.0,836.0,8,2390,2149.0,1350.0,270.0
0.005,6,10,2006,5,927,1.0,659.0,659.0,5,1079,1.0,811.0,811.0
0.006,6,10,1774,5,923,1.0,655.0,655.0,5,851,1.0,583.0,583.0
0.095,6,10,1506,5,395,23.0,127.0,127.0,5,1111,20.0,843.0,843.0
0.127,6,10,1506,5,395,29.0,127.0,127.0,5,1111,29.0,843.0,843.0
0.005,6,10,1643,5,860,1.0,592.0,592.0,5,783,1.0,515.0,515.0
0.017,6,10,1631,5,848,4.0,580.0,580.0,5,783,4.0,515.0,515.0
0.005,6,10,2000,5,927,1.0,659.0,659.0,5,1073,1.0,805.0,805.0
11.101,17,28,4419,14,1995,841.0,270.0,114.0,14,2424,841.0,587.0,145.0
0.07,6,10,1506,5,395,14.0,127.0,127.0,5,1111,16.0,843.0,843.0
40.071,17,10,676,5,460,10015.0,104.0,64.0,5,216,10016.0,20.0,15.0
0.039,17,2,148,1,60,0.0,32.0,32.0,1,88,0.0,60.0,60.0
0.005,6,10,1547,5,764,1.0,496.0,496.0,5,783,1.0,515.0,515.0
0.005,6,10,1774,5,923,1.0,655.0,655.0,5,851,1.0,583.0,583.0
0.097,6,10,1506,5,395,22.0,127.0,127.0,5,1111,20.0,843.0,843.0
0.011,6,10,1989,5,910,2.0,642.0,642.0,5,1079,2.0,811.0,811.0
0.003,17,2,148,1,60,0.0,32.0,32.0,1,88,0.0,60.0,60.0
40.094,17,10,676,5,460,10022.0,104.0,64.0,5,216,10022.0,20.0,15.0
15.073,17,15,9238,8,6902,2149.0,1350.0,834.0,7,2336,2507.0,1350.0,305.0
40.081,17,10,676,5,460,10017.0,104.0,64.0,5,216,10019.0,20.0,15.0
0.006,6,10,2006,5,927,1.0,659.0,659.0,5,1079,1.0,811.0,811.0
0.015,17,2,170,1,65,0.0,37.0,37.0,1,105,0.0,77.0,77.0
0.009,6,12,1926,6,1189,1.0,659.0,434.0,6,737,1.0,417.0,417.0
0.005,6,10,2007,5,928,1.0,660.0,660.0,5,1079,1.0,811.0,811.0
10.772,17,28,4422,14,1995,820.0,270.0,114.0,14,2427,820.0,586.0,145.0
0.071,6,10,1506,5,395,15.0,127.0,127.0,5,1111,14.0,843.0,843.0
40.071,17,10,676,5,460,10016.0,104.0,64.0,5,216,10016.0,20.0,15.0
15.075,17,16,9303,8,6912,2149.0,1350.0,836.0,8,2391,2149.0,1350.0,270.0
0.083,6,10,1506,5,395,17.0,127.0,127.0,5,1111,17.0,843.0,843.0
0.008,6,14,3787,7,497,1.0,125.0,125.0,7,3290,1.0,1448.0,972.0
0.114,6,10,1506,5,395,22.0,127.0,127.0,5,1111,23.0,843.0,843.0
40.06,17,10,676,5,460,10013.0,104.0,64.0,5,216,10014.0,20.0,15.0
633.183,6,57,23915,29,5843,22613.0,676.0,480.0,28,18072,21227.0,1948.0,922.0
0.123,17,2,80,1,32,0.0,4.0,4.0,1,48,0.0,20.0,20.0
0.004,17,2,136,1,60,0.0,32.0,32.0,1,76,0.0,48.0,48.0
0.005,17,2,194,1,57,0.0,29.0,29.0,1,137,0.0,109.0,109.0
0.2,6,16,2670,8,1396,28.0,533.0,324.0,8,1274,18.0,529.0,212.0
0.169,17,2,152,1,76,0.0,48.0,48.0,1,76,0.0,48.0,48.0
0.004,6,10,2006,5,927,1.0,659.0,659.0,5,1079,1.0,811.0,811.0
0.005,6,10,1774,5,923,1.0,655.0,655.0,5,851,1.0,583.0,583.0
368.715,6,24,2405,17,919,23044.0,195.0,195.0,7,1486,3901.0,419.0,398.0
0.004,17,4,284,2,120,0.0,32.0,32.0,2,164,0.0,60.0,54.0
0.066,17,8,3613,4,1874,22.0,1350.0,440.0,4,1739,10.0,1350.0,406.0
0.073,6,10,1506,5,395,17.0,127.0,127.0,5,1111,14.0,843.0,843.0
0.005,6,10,2007,5,928,1.0,660.0,660.0,5,1079,1.0,811.0,811.0
0.005,17,2,179,1,71,0.0,43.0,43.0,1,108,0.0,80.0,80.0
0.006,6,10,1547,5,764,1.0,496.0,496.0,5,783,1.0,515.0,515.0
0.014,6,10,1762,5,911,3.0,643.0,643.0,5,851,3.0,583.0,583.0
0.005,6,10,2006,5,927,1.0,659.0,659.0,5,1079,1.0,811.0,811.0
0.012,6,10,1989,5,910,3.0,642.0,642.0,5,1079,3.0,811.0,811.0
0.004,6,10,2006,5,927,1.0,659.0,659.0,5,1079,1.0,811.0,811.0
0.006,6,10,1547,5,764,1.0,496.0,496.0,5,783,1.0,515.0,515.0
0.013,6,10,1972,5,910,3.0,642.0,642.0,5,1062,3.0,794.0,794.0
0.022,6,10,1990,5,911,5.0,643.0,643.0,5,1079,5.0,811.0,811.0
0.005,6,10,2006,5,927,1.0,659.0,659.0,5,1079,1.0,811.0,811.0
0.184,6,10,1506,5,395,43.0,127.0,127.0,5,1111,38.0,843.0,843.0
0.073,17,8,3613,4,1874,24.0,1350.0,440.0,4,1739,10.0,1350.0,406.0
0.005,6,10,2006,5,927,1.0,659.0,659.0,5,1079,1.0,811.0,811.0
0.065,6,10,1506,5,395,12.0,127.0,127.0,5,1111,13.0,843.0,843.0
0.091,6,10,1506,5,395,18.0,127.0,127.0,5,1111,21.0,843.0,843.0
0.072,17,4,284,2,120,0.0,32.0,32.0,2,164,68.0,60.0,54.0
0.005,6,10,2006,5,927,1.0,659.0,659.0,5,1079,1.0,811.0,811.0
0.006,6,10,2006,5,927,1.0,659.0,659.0,5,1079,1.0,811.0,811.0
0.678,6,25,5459,12,1557,52.0,325.0,152.0,13,3902,47.0,1414.0,563.0
0.013,6,10,1972,5,910,3.0,642.0,642.0,5,1062,3.0,794.0,794.0
0.004,17,2,146,1,65,0.0,37.0,37.0,1,81,0.0,53.0,53.0
0.094,6,10,1506,5,395,20.0,127.0,127.0,5,1111,20.0,843.0,843.0
10.819,17,29,4549,14,1993,824.0,268.0,114.0,15,2556,765.0,587.0,142.0
0.012,17,2,138,1,61,0.0,33.0,33.0,1,77,0.0,49.0,49.0
0.041,17,2,148,1,60,0.0,32.0,32.0,1,88,0.0,60.0,60.0
293.092,6,387,347288,201,22021,1465.0,2736.0,889.0,186,325267,1584.0,2804.0,1834.0
1792.161,6,568,191750,286,164407,6288.0,2883.0,940.0,282,27343,6377.0,580.0,124.0
369.543,6,22,2313,16,867,24636.0,195.0,195.0,6,1446,4636.0,419.0,398.0
0.013,6,10,1990,5,911,3.0,643.0,643.0,5,1079,3.0,811.0,811.0
0.017,6,10,1983,5,910,4.0,642.0,642.0,5,1073,4.0,805.0,805.0
0.005,6,10,2006,5,927,1.0,659.0,659.0,5,1079,1.0,811.0,811.0
0.101,6,10,1506,5,395,24.0,127.0,127.0,5,1111,20.0,843.0,843.0
0.005,6,10,2000,5,927,1.0,659.0,659.0,5,1073,1.0,805.0,805.0
0.004,6,10,2007,5,928,1.0,660.0,660.0,5,1079,1.0,811.0,811.0
0.01,6,10,1989,5,910,2.0,642.0,642.0,5,1079,2.0,811.0,811.0
0.005,6,13,3747,7,509,0.0,137.0,137.0,6,3238,0.0,1470.0,1459.0
0.011,6,13,3735,7,497,1.0,125.0,125.0,6,3238,2.0,1470.0,1459.0
0.013,6,10,1989,5,910,3.0,642.0,642.0,5,1079,3.0,811.0,811.0
0.006,17,2,154,1,69,0.0,41.0,41.0,1,85,0.0,57.0,57.0
0.007,6,10,1990,5,911,1.0,643.0,643.0,5,1079,1.0,811.0,811.0
285.345,6,28,6457,15,1369,20381.0,517.0,290.0,13,5088,23778.0,2378.0,1104.0
0.017,6,10,1990,5,911,4.0,643.0,643.0,5,1079,4.0,811.0,811.0
0.005,6,13,3747,7,509,0.0,137.0,137.0,6,3238,0.0,1470.0,1459.0
0.014,6,10,1983,5,910,3.0,642.0,642.0,5,1073,3.0,805.0,805.0
160.637,6,24,8608,13,1683,13386.0,684.0,333.0,11,6925,16059.0,1402.0,1057.0
1787.553,6,154,19574,92,13852,19643.0,302.0,302.0,62,5722,29304.0,83.0,83.0
0.005,6,10,2006,5,927,1.0,659.0,659.0,5,1079,1.0,811.0,811.0
0.011,6,10,1983,5,910,2.0,642.0,642.0,5,1073,2.0,805.0,805.0
0.005,17,2,170,1,65,0.0,37.0,37.0,1,105,0.0,77.0,77.0
40.064,17,10,676,5,460,10015.0,104.0,64.0,5,216,10015.0,20.0,15.0
0.005,17,2,424,1,72,0.0,44.0,44.0,1,352,0.0,324.0,324.0
0.004,17,2,186,1,61,0.0,33.0,33.0,1,125,0.0,97.0,97.0
0.013,6,10,1972,5,910,3.0,642.0,642.0,5,1062,3.0,794.0,794.0
0.006,6,10,1547,5,764,1.0,496.0,496.0,5,783,1.0,515.0,515.0
0.012,6,10,1762,5,911,3.0,643.0,643.0,5,851,2.0,583.0,583.0
0.006,6,10,1547,5,764,1.0,496.0,496.0,5,783,1.0,515.0,515.0
0.005,6,10,1689,5,839,1.0,571.0,571.0,5,850,1.0,582.0,582.0
0.004,6,10,2006,5,927,1.0,659.0,659.0,5,1079,1.0,811.0,811.0
0.017,6,10,1989,5,910,4.0,642.0,642.0,5,1079,4.0,811.0,811.0
1.115,6,27,8604,16,2211,74.0,517.0,273.0,11,6393,110.0,1402.0,726.0
1786.198,6,154,19574,92,13852,19628.0,302.0,302.0,62,5722,29281.0,83.0,83.0
0.005,6,10,2006,5,927,1.0,659.0,659.0,5,1079,1.0,811.0,811.0
287.58,6,39,9947,15,6757,20541.0,1882.0,664.0,24,3190,12503.0,580.0,128.0
0.019,6,10,1983,5,910,4.0,642.0,642.0,5,1073,4.0,805.0,805.0
0.01,17,2,140,1,62,0.0,34.0,34.0,1,78,0.0,50.0,50.0
40.067,17,10,676,5,460,10015.0,104.0,64.0,5,216,10015.0,20.0,15.0
0.006,6,10,1689,5,839,1.0,571.0,571.0,5,850,1.0,582.0,582.0
0.001,17,2,180,1,66,0.0,38.0,38.0,1,114,0.0,86.0,86.0
0.018,6,10,1989,5,910,4.0,642.0,642.0,5,1079,4.0,811.0,811.0
0.1,6,10,1506,5,395,23.0,127.0,127.0,5,1111,22.0,843.0,843.0
0.123,6,10,1506,5,395,29.0,127.0,127.0,5,1111,25.0,843.0,843.0
40.062,17,10,676,5,460,10014.0,104.0,64.0,5,216,10014.0,20.0,15.0
0.098,6,10,1506,5,395,22.0,127.0,127.0,5,1111,21.0,843.0,843.0
0.013,6,14,3787,7,497,2.0,125.0,125.0,7,3290,2.0,1448.0,972.0
0.001,17,2,166,1,75,0.0,47.0,47.0,1,91,0.0,63.0,63.0
10.787,17,26,4102,13,1822,890.0,269.0,112.0,13,2280,890.0,587.0,147.0
0.043,17,2,412,1,61,0.0,33.0,33.0,1,351,0.0,323.0,323.0
0.001,17,2,146,1,65,0.0,37.0,37.0,1,81,0.0,53.0,53.0
0.013,6,10,1677,5,827,3.0,559.0,559.0,5,850,3.0,582.0,582.0
0.013,6,10,1983,5,910,3.0,642.0,642.0,5,1073,3.0,805.0,805.0
634.638,17,126,18295,63,4203,10236.0,44.0,38.0,63,14092,10236.0,249.0,195.0
0.061,6,10,1506,5,395,14.0,127.0,127.0,5,1111,12.0,843.0,843.0
0.001,17,2,180,1,65,0.0,37.0,37.0,1,115,0.0,87.0,87.0
0.006,6,10,1689,5,839,1.0,571.0,571.0,5,850,1.0,582.0,582.0
11.05,17,28,4396,14,2311,841.0,586.0,137.0,14,2085,841.0,268.0,120.0
0.003,17,4,284,2,120,0.0,32.0,32.0,2,164,0.0,60.0,54.0
301.167,6,56,25978,31,19951,10038.0,2720.0,1245.0,25,6027,375.0,2667.0,385.0
0.005,6,10,1989,5,927,1.0,659.0,659.0,5,1062,1.0,794.0,794.0
0.009,6,10,1989,5,910,2.0,642.0,642.0,5,1079,2.0,811.0,811.0
0.014,6,10,1989,5,910,3.0,642.0,642.0,5,1079,3.0,811.0,811.0
0.013,6,10,1989,5,910,3.0,642.0,642.0,5,1079,3.0,811.0,811.0
0.007,6,10,2006,5,927,1.0,659.0,659.0,5,1079,1.0,811.0,811.0
0.01,6,10,1989,5,910,2.0,642.0,642.0,5,1079,2.0,811.0,811.0
0.007,6,10,1547,5,764,1.0,496.0,496.0,5,783,1.0,515.0,515.0
0.014,6,10,1990,5,911,3.0,643.0,643.0,5,1079,3.0,811.0,811.0
0.008,17,2,179,1,71,0.0,43.0,43.0,1,108,0.0,80.0,80.0
0.004,6,10,1702,5,863,1.0,595.0,595.0,5,839,1.0,571.0,571.0
40.07,17,10,676,5,460,10016.0,104.0,64.0,5,216,10016.0,20.0,15.0
0.079,6,10,1506,5,395,15.0,127.0,127.0,5,1111,17.0,843.0,843.0
0.009,6,10,1972,5,910,2.0,642.0,642.0,5,1062,2.0,794.0,794.0
0.005,6,10,2006,5,927,1.0,659.0,659.0,5,1079,1.0,811.0,811.0
0.005,17,2,248,1,68,0.0,40.0,40.0,1,180,0.0,152.0,152.0
0.004,6,10,2007,5,928,1.0,660.0,660.0,5,1079,1.0,811.0,811.0
35.195,6,36,8465,18,1994,506.0,886.0,414.0,18,6471,2062.0,2720.0,478.0
0.135,17,2,152,1,76,0.0,48.0,48.0,1,76,0.0,48.0,48.0
0.068,17,8,3613,4,1874,22.0,1350.0,440.0,4,1739,11.0,1350.0,406.0
0.004,17,2,170,1,65,0.0,37.0,37.0,1,105,0.0,77.0,77.0
0.169,17,2,152,1,76,0.0,48.0,48.0,1,76,0.0,48.0,48.0
308.471,17,18,1008,9,640,38543.0,48.0,43.0,9,368,38543.0,20.0,12.0
0.116,6,10,1506,5,395,27.0,127.0,127.0,5,1111,26.0,843.0,843.0
0.004,6,10,2006,5,927,1.0,659.0,659.0,5,1079,1.0,811.0,811.0
38.657,17,26,14947,14,12082,2971.0,1350.0,835.0,12,2865,3511.0,1350.0,210.0
0.009,6,12,1926,6,1189,1.0,659.0,434.0,6,737,1.0,417.0,417.0
0.004,6,10,2007,5,928,1.0,660.0,660.0,5,1079,1.0,811.0,811.0
0.125,6,10,1506,5,395,26.0,127.0,127.0,5,1111,23.0,843.0,843.0
0.003,17,2,136,1,60,0.0,32.0,32.0,1,76,0.0,48.0,48.0
0.005,6,10,1779,5,928,1.0,660.0,660.0,5,851,1.0,583.0,583.0
308.636,17,20,1124,10,716,34278.0,48.0,43.0,10,408,34278.0,20.0,12.0
66.028,6,22,10140,12,3973,6002.0,1579.0,835.0,10,6167,7317.0,2111.0,939.0
0.006,6,10,1854,5,889,1.0,621.0,621.0,5,965,1.0,697.0,697.0
0.003,17,2,148,1,60,0.0,32.0,32.0,1,88,0.0,60.0,60.0
0.009,6,13,3735,7,497,1.0,125.0,125.0,6,3238,1.0,1470.0,1459.0
0.098,6,10,1506,5,395,22.0,127.0,127.0,5,1111,21.0,843.0,843.0
0.005,6,10,2006,5,927,1.0,659.0,659.0,5,1079,1.0,811.0,811.0
0.053,17,2,184,1,61,0.0,33.0,33.0,1,123,0.0,95.0,95.0
0.004,17,2,148,1,60,0.0,32.0,32.0,1,88,0.0,60.0,60.0
0.008,17,2,194,1,59,0.0,31.0,31.0,1,135,0.0,107.0,107.0
0.018,6,10,1972,5,910,4.0,642.0,642.0,5,1062,4.0,794.0,794.0
0.079,6,10,1506,5,395,18.0,127.0,127.0,5,1111,15.0,843.0,843.0
0.113,6,10,1506,5,395,26.0,127.0,127.0,5,1111,26.0,843.0,843.0
40.05,17,10,676,5,460,10011.0,104.0,64.0,5,216,10011.0,20.0,15.0
0.011,6,6,716,3,458,4.0,302.0,302.0,3,258,4.0,102.0,102.0
0.088,6,10,1506,5,395,19.0,127.0,127.0,5,1111,18.0,843.0,843.0
0.006,6,10,1989,5,927,1.0,659.0,659.0,5,1062,1.0,794.0,794.0
0.005,6,10,1989,5,927,1.0,659.0,659.0,5,1062,1.0,794.0,794.0
0.085,6,10,1506,5,395,18.0,127.0,127.0,5,1111,19.0,843.0,843.0
175.182,17,72,10432,36,2400,5005.0,44.0,38.0,36,8032,5005.0,239.0,195.0
0.023,6,10,1631,5,848,5.0,580.0,580.0,5,783,5.0,515.0,515.0
0.006,6,10,1854,5,889,1.0,621.0,621.0,5,965,1.0,697.0,697.0
0.005,17,2,166,1,75,0.0,47.0,47.0,1,91,0.0,63.0,63.0
0.064,6,10,1506,5,395,13.0,127.0,127.0,5,1111,14.0,843.0,843.0
0.003,6,10,1702,5,863,0.0,595.0,595.0,5,839,0.0,571.0,571.0
0.004,17,4,284,2,120,1.0,32.0,32.0,2,164,0.0,60.0,54.0
0.006,6,10,1643,5,860,1.0,592.0,592.0,5,783,1.0,515.0,515.0
15.081,17,19,9893,10,7373,1672.0,1350.0,709.0,9,2520,1881.0,1350.0,252.0
0.068,17,8,3613,4,1874,22.0,1350.0,440.0,4,1739,11.0,1350.0,406.0
0.041,17,4,596,2,122,1.0,33.0,33.0,2,474,2.0,323.0,209.0
0.091,6,10,1506,5,395,18.0,127.0,127.0,5,1111,22.0,843.0,843.0
0.086,6,10,1506,5,395,18.0,127.0,127.0,5,1111,20.0,843.0,843.0
0.004,6,10,1774,5,923,1.0,655.0,655.0,5,851,1.0,583.0,583.0
0.009,17,2,166,1,75,0.0,47.0,47.0,1,91,0.0,63.0,63.0
0.081,6,10,1506,5,395,17.0,127.0,127.0,5,1111,17.0,843.0,843.0
0.006,6,12,1698,6,863,1.0,327.0,271.0,6,835,1.0,515.0,515.0
0.015,6,10,1990,5,911,3.0,643.0,643.0,5,1079,3.0,811.0,811.0
0.004,6,10,2007,5,928,1.0,660.0,660.0,5,1079,1.0,811.0,811.0
45.07,58,3,216,2,144,45070.0,24.0,24.0,1,72,0.0,24.0,24.0
0.013,6,10,1631,5,848,3.0,580.0,580.0,5,783,3.0,515.0,515.0
0.004,6,10,1702,5,863,1.0,595.0,595.0,5,839,1.0,571.0,571.0
0.006,17,2,170,1,65,0.0,37.0,37.0,1,105,0.0,77.0,77.0
0.011,6,10,1989,5,910,2.0,642.0,642.0,5,1079,2.0,811.0,811.0
0.01,6,14,3787,7,497,1.0,125.0,125.0,7,3290,1.0,1448.0,972.0
0.038,17,2,144,1,64,0.0,36.0,36.0,1,80,0.0,52.0,52.0
0.012,6,10,1990,5,911,3.0,643.0,643.0,5,1079,2.0,811.0,811.0
0.014,6,10,1972,5,910,3.0,642.0,642.0,5,1062,3.0,794.0,794.0
0.005,17,2,157,1,59,0.0,31.0,31.0,1,98,0.0,70.0,70.0
0.079,6,10,1506,5,395,17.0,127.0,127.0,5,1111,14.0,843.0,843.0
0.006,6,10,1547,5,764,1.0,496.0,496.0,5,783,1.0,515.0,515.0
177.065,17,76,10759,38,2533,4785.0,44.0,38.0,38,8226,4785.0,261.0,188.0
0.013,6,10,1677,5,827,3.0,559.0,559.0,5,850,3.0,582.0,582.0
0.07,17,8,3613,4,1874,23.0,1350.0,440.0,4,1739,12.0,1350.0,406.0
0.005,6,10,2007,5,928,1.0,660.0,660.0,5,1079,1.0,811.0,811.0
0.005,17,2,144,1,64,0.0,36.0,36.0,1,80,0.0,52.0,52.0
0.005,6,10,2000,5,927,1.0,659.0,659.0,5,1073,1.0,805.0,805.0
0.007,6,10,1547,5,764,1.0,496.0,496.0,5,783,1.0,515.0,515.0
0.004,17,2,148,1,60,0.0,32.0,32.0,1,88,0.0,60.0,60.0
0.04,17,4,284,2,120,0.0,32.0,32.0,2,164,36.0,60.0,54.0
0.012,6,13,3735,7,497,2.0,125.0,125.0,6,3238,2.0,1470.0,1459.0
0.038,17,2,128,1,56,0.0,28.0,28.0,1,72,0.0,44.0,44.0
0.004,17,2,148,1,60,0.0,32.0,32.0,1,88,0.0,60.0,60.0
0.005,6,10,1989,5,927,1.0,659.0,659.0,5,1062,1.0,794.0,794.0
0.001,17,2,179,1,62,0.0,34.0,34.0,1,117,0.0,89.0,89.0
0.038,17,2,182,1,65,0.0,37.0,37.0,1,117,0.0,89.0,89.0
0.013,6,10,1990,5,911,3.0,643.0,643.0,5,1079,3.0,811.0,811.0
0.009,6,13,3735,7,497,1.0,125.0,125.0,6,3238,1.0,1470.0,1459.0
372.248,6,24,2405,17,919,23265.0,195.0,195.0,7,1486,3915.0,419.0,398.0
0.008,17,2,166,1,75,0.0,47.0,47.0,1,91,0.0,63.0,63.0
0.075,6,10,1506,5,395,16.0,127.0,127.0,5,1111,14.0,843.0,843.0
0.078,6,10,1506,5,395,16.0,127.0,127.0,5,1111,16.0,843.0,843.0
0.144,6,10,1506,5,395,35.0,127.0,127.0,5,1111,29.0,843.0,843.0
0.01,17,2,169,1,62,0.0,34.0,34.0,1,107,0.0,79.0,79.0
0.006,6,10,1547,5,764,1.0,496.0,496.0,5,783,1.0,515.0,515.0
0.017,6,10,1983,5,910,4.0,642.0,642.0,5,1073,4.0,805.0,805.0
0.012,6,10,1972,5,910,3.0,642.0,642.0,5,1062,3.0,794.0,794.0
0.07,6,10,1506,5,395,16.0,127.0,127.0,5,1111,13.0,843.0,843.0
0.014,6,10,1983,5,910,3.0,642.0,642.0,5,1073,3.0,805.0,805.0
0.004,6,10,2007,5,928,1.0,660.0,660.0,5,1079,1.0,811.0,811.0
0.019,17,2,144,1,64,0.0,36.0,36.0,1,80,0.0,52.0,52.0
0.009,6,10,1989,5,910,2.0,642.0,642.0,5,1079,2.0,811.0,811.0
0.005,17,2,294,1,64,0.0,36.0,36.0,1,230,0.0,202.0,202.0
0.005,6,10,2006,5,927,1.0,659.0,659.0,5,1079,1.0,811.0,811.0
592.09,6,29,8114,15,3116,42292.0,676.0,388.0,14,4998,40929.0,1402.0,608.0
240.014,6,9,787,5,488,60003.0,232.0,232.0,4,299,80003.0,83.0,83.0
0.106,6,10,1506,5,395,24.0,127.0,127.0,5,1111,24.0,843.0,843.0
0.004,6,10,1989,5,927,1.0,659.0,659.0,5,1062,1.0,794.0,794.0
0.017,6,13,3735,7,497,2.0,125.0,125.0,6,3238,3.0,1470.0,1459.0
309.747,17,20,1124,10,716,34402.0,48.0,43.0,10,408,34402.0,20.0,12.0
0.012,6,10,1989,5,910,2.0,642.0,642.0,5,1079,2.0,811.0,811.0
0.107,6,10,1506,5,395,19.0,127.0,127.0,5,1111,21.0,843.0,843.0
1772.734,17,120,11460,60,5460,30046.0,63.0,63.0,60,6000,30045.0,72.0,72.0
0.005,6,10,2007,5,928,1.0,660.0,660.0,5,1079,1.0,811.0,811.0
40.06,17,10,676,5,460,10012.0,104.0,64.0,5,216,10011.0,20.0,15.0
0.009,6,10,1983,5,910,2.0,642.0,642.0,5,1073,2.0,805.0,805.0
0.008,6,10,1972,5,910,1.0,642.0,642.0,5,1062,1.0,794.0,794.0
0.005,6,10,1989,5,927,1.0,659.0,659.0,5,1062,1.0,794.0,794.0
0.01,6,13,3735,7,497,1.0,125.0,125.0,6,3238,1.0,1470.0,1459.0
0.008,6,10,2006,5,927,2.0,659.0,659.0,5,1079,2.0,811.0,811.0
0.01,6,10,1762,5,911,2.0,643.0,643.0,5,851,2.0,583.0,583.0
15.075,17,16,9081,8,6784,2149.0,1350.0,820.0,8,2297,2149.0,1350.0,259.0
0.01,6,12,1926,6,1189,2.0,659.0,434.0,6,737,2.0,417.0,417.0
0.041,17,2,146,1,65,0.0,37.0,37.0,1,81,0.0,53.0,53.0
0.003,17,2,148,1,60,0.0,32.0,32.0,1,88,0.0,60.0,60.0
0.113,6,10,1506,5,395,24.0,127.0,127.0,5,1111,27.0,843.0,843.0
0.804,6,10,937,6,427,160.0,107.0,107.0,4,510,179.0,294.0,294.0
0.211,6,3,453,2,321,211.0,241.0,241.0,1,132,0.0,92.0,92.0
0.072,6,10,1506,5,395,15.0,127.0,127.0,5,1111,15.0,843.0,843.0
0.042,17,4,284,2,120,0.0,32.0,32.0,2,164,39.0,60.0,54.0
0.004,6,10,2007,5,928,1.0,660.0,660.0,5,1079,1.0,811.0,811.0
0.072,17,2,234,1,61,0.0,33.0,33.0,1,173,0.0,145.0,145.0
0.02,6,10,1990,5,911,5.0,643.0,643.0,5,1079,4.0,811.0,811.0
0.005,17,2,236,1,64,0.0,36.0,36.0,1,172,0.0,144.0,144.0
0.005,6,10,2006,5,927,1.0,659.0,659.0,5,1079,1.0,811.0,811.0
0.004,17,2,148,1,60,0.0,32.0,32.0,1,88,0.0,60.0,60.0
0.018,6,10,1631,5,848,4.0,580.0,580.0,5,783,4.0,515.0,515.0
0.111,17,2,80,1,32,0.0,4.0,4.0,1,48,0.0,20.0,20.0
0.006,6,10,1854,5,889,1.0,621.0,621.0,5,965,1.0,697.0,697.0
0.004,17,2,148,1,60,0.0,32.0,32.0,1,88,0.0,60.0,60.0
0.075,6,10,1506,5,395,17.0,127.0,127.0,5,1111,17.0,843.0,843.0
0.006,6,10,1547,5,764,1.0,496.0,496.0,5,783,1.0,515.0,515.0
0.097,6,10,1506,5,395,21.0,127.0,127.0,5,1111,21.0,843.0,843.0
40.065,17,10,676,5,460,10013.0,104.0,64.0,5,216,10015.0,20.0,15.0
0.083,6,10,1506,5,395,19.0,127.0,127.0,5,1111,17.0,843.0,843.0
0.006,6,10,2007,5,928,1.0,660.0,660.0,5,1079,1.0,811.0,811.0
0.075,6,10,1506,5,395,18.0,127.0,127.0,5,1111,18.0,843.0,843.0
0.005,6,14,3742,7,452,0.0,80.0,80.0,7,3290,0.0,1448.0,972.0
0.092,6,10,1506,5,395,19.0,127.0,127.0,5,1111,20.0,843.0,843.0
0.009,6,10,1972,5,910,2.0,642.0,642.0,5,1062,2.0,794.0,794.0
0.004,6,10,2007,5,928,1.0,660.0,660.0,5,1079,1.0,811.0,811.0
0.013,6,10,1990,5,911,3.0,643.0,643.0,5,1079,3.0,811.0,811.0
0.014,6,10,1989,5,910,3.0,642.0,642.0,5,1079,3.0,811.0,811.0
0.013,6,10,1990,5,911,3.0,643.0,643.0,5,1079,3.0,811.0,811.0
11.503,17,28,4389,14,2311,872.0,586.0,137.0,14,2078,872.0,269.0,120.0
0.006,6,10,1547,5,764,1.0,496.0,496.0,5,783,1.0,515.0,515.0
0.011,6,10,1990,5,911,2.0,643.0,643.0,5,1079,2.0,811.0,811.0
40.062,17,10,676,5,460,10013.0,104.0,64.0,5,216,10014.0,20.0,15.0
0.001,17,2,180,1,66,0.0,38.0,38.0,1,114,0.0,86.0,86.0
0.005,17,2,144,1,64,0.0,36.0,36.0,1,80,0.0,52.0,52.0
0.041,17,2,144,1,64,0.0,36.0,36.0,1,80,0.0,52.0,52.0
0.12,6,10,1506,5,395,28.0,127.0,127.0,5,1111,26.0,843.0,843.0
0.005,6,10,2007,5,928,1.0,660.0,660.0,5,1079,1.0,811.0,811.0
0.005,6,10,1854,5,889,1.0,621.0,621.0,5,965,1.0,697.0,697.0
0.008,6,12,1926,6,1189,1.0,659.0,434.0,6,737,1.0,417.0,417.0
0.008,6,10,1989,5,910,1.0,642.0,642.0,5,1079,1.0,811.0,811.0
40.057,17,10,676,5,460,10013.0,104.0,64.0,5,216,10013.0,20.0,15.0
0.005,6,14,3799,7,509,0.0,137.0,137.0,7,3290,0.0,1448.0,972.0
0.005,6,10,2000,5,927,1.0,659.0,659.0,5,1073,1.0,805.0,805.0
0.003,17,2,136,1,60,0.0,32.0,32.0,1,76,0.0,48.0,48.0
0.005,6,10,2006,5,927,1.0,659.0,659.0,5,1079,1.0,811.0,811.0
10.771,17,29,4547,14,1994,820.0,269.0,114.0,15,2553,761.0,588.0,142.0
0.015,6,10,1972,5,910,3.0,642.0,642.0,5,1062,3.0,794.0,794.0
0.11,6,10,1506,5,395,24.0,127.0,127.0,5,1111,25.0,843.0,843.0
0.006,6,10,1547,5,764,1.0,496.0,496.0,5,783,1.0,515.0,515.0
0.106,6,10,1506,5,395,24.0,127.0,127.0,5,1111,26.0,843.0,843.0
0.006,17,2,179,1,71,0.0,43.0,43.0,1,108,0.0,80.0,80.0
0.073,6,10,1506,5,395,17.0,127.0,127.0,5,1111,15.0,843.0,843.0
0.074,6,10,1506,5,395,16.0,127.0,127.0,5,1111,16.0,843.0,843.0
1770.311,6,83,4368,42,2210,43177.0,26.0,26.0,41,2158,44256.0,26.0,26.0
15.036,17,50,24772,27,21337,577.0,1350.0,762.0,23,3435,682.0,1350.0,121.0
0.098,6,10,1506,5,395,22.0,127.0,127.0,5,1111,22.0,843.0,843.0
0.005,6,10,1989,5,927,1.0,659.0,659.0,5,1062,1.0,794.0,794.0
0.004,6,10,1702,5,863,0.0,595.0,595.0,5,839,1.0,571.0,571.0
40.068,17,10,676,5,460,10014.0,104.0,64.0,5,216,10015.0,20.0,15.0
0.047,6,10,1631,5,848,11.0,580.0,580.0,5,783,11.0,515.0,515.0
0.006,6,10,1989,5,927,1.0,659.0,659.0,5,1062,1.0,794.0,794.0
0.012,6,10,1972,5,910,2.0,642.0,642.0,5,1062,2.0,794.0,794.0
0.006,6,10,2007,5,928,1.0,660.0,660.0,5,1079,1.0,811.0,811.0
281.881,6,32,11186,16,3300,18791.0,676.0,489.0,16,7886,18791.0,1402.0,882.0
0.059,17,2,144,1,64,0.0,36.0,36.0,1,80,0.0,52.0,52.0
0.011,6,10,1989,5,910,2.0,642.0,642.0,5,1079,2.0,811.0,811.0
0.127,17,2,182,1,65,0.0,37.0,37.0,1,117,0.0,89.0,89.0
300.15,6,22,4935,11,2369,30014.0,1026.0,447.0,11,2566,30012.0,1162.0,399.0
0.011,6,10,1762,5,911,2.0,643.0,643.0,5,851,2.0,583.0,583.0
0.004,17,4,284,2,120,0.0,32.0,32.0,2,164,0.0,60.0,54.0
0.013,6,10,1972,5,910,3.0,642.0,642.0,5,1062,3.0,794.0,794.0
0.001,17,2,180,1,66,0.0,38.0,38.0,1,114,0.0,86.0,86.0
0.009,6,10,1989,5,910,2.0,642.0,642.0,5,1079,2.0,811.0,811.0
0.015,6,10,1989,5,910,3.0,642.0,642.0,5,1079,3.0,811.0,811.0
0.003,17,2,148,1,60,0.0,32.0,32.0,1,88,0.0,60.0,60.0
0.003,17,2,148,1,60,0.0,32.0,32.0,1,88,0.0,60.0,60.0
0.005,6,10,2007,5,928,1.0,660.0,660.0,5,1079,1.0,811.0,811.0
0.009,6,10,1990,5,911,2.0,643.0,643.0,5,1079,2.0,811.0,811.0
0.109,6,10,1506,5,395,21.0,127.0,127.0,5,1111,25.0,843.0,843.0
0.014,6,10,1972,5,910,3.0,642.0,642.0,5,1062,3.0,794.0,794.0
0.004,6,14,3742,7,452,0.0,80.0,80.0,7,3290,0.0,1448.0,972.0
40.082,17,10,676,5,460,10019.0,104.0,64.0,5,216,10019.0,20.0,15.0
0.051,17,2,412,1,61,0.0,33.0,33.0,1,351,0.0,323.0,323.0
0.006,6,10,2006,5,927,1.0,659.0,659.0,5,1079,1.0,811.0,811.0
0.007,6,10,1989,5,910,1.0,642.0,642.0,5,1079,1.0,811.0,811.0
0.008,6,10,1990,5,911,2.0,643.0,643.0,5,1079,2.0,811.0,811.0
0.005,6,10,1702,5,863,1.0,595.0,595.0,5,839,1.0,571.0,571.0
0.009,6,10,1990,5,911,2.0,643.0,643.0,5,1079,2.0,811.0,811.0
0.004,6,10,1702,5,863,1.0,595.0,595.0,5,839,1.0,571.0,571.0
0.014,6,10,1990,5,911,3.0,643.0,643.0,5,1079,3.0,811.0,811.0
300.781,6,36,9557,19,4079,16710.0,2903.0,821.0,17,5478,538.0,2667.0,435.0
0.004,6,10,1989,5,927,1.0,659.0,659.0,5,1062,1.0,794.0,794.0
309.898,17,20,1124,10,716,34426.0,48.0,43.0,10,408,34426.0,20.0,12.0
40.078,17,10,676,5,460,10016.0,104.0,64.0,5,216,10018.0,20.0,15.0
1795.749,6,290,40091,119,20734,15217.0,1939.0,169.0,171,19357,10562.0,1360.0,150.0
0.005,6,10,1547,5,764,1.0,496.0,496.0,5,783,1.0,515.0,515.0
0.005,17,2,140,1,62,0.0,34.0,34.0,1,78,0.0,50.0,50.0
0.003,17,2,160,1,72,0.0,44.0,44.0,1,88,0.0,60.0,60.0
0.006,6,10,1547,5,764,1.0,496.0,496.0,5,783,1.0,515.0,515.0
0.013,6,10,1989,5,910,3.0,642.0,642.0,5,1079,3.0,811.0,811.0
15.082,17,15,8530,8,6382,2150.0,1350.0,769.0,7,2148,2508.0,1350.0,278.0
1.507,6,11,1566,6,455,296.0,127.0,127.0,5,1111,25.0,843.0,843.0
0.01,6,10,1677,5,827,2.0,559.0,559.0,5,850,2.0,582.0,582.0
240.091,6,16,4482,9,963,30011.0,238.0,166.0,7,3519,40014.0,1402.0,786.0
0.069,17,8,3613,4,1874,23.0,1350.0,440.0,4,1739,11.0,1350.0,406.0
0.005,6,10,1989,5,927,1.0,659.0,659.0,5,1062,1.0,794.0,794.0
0.106,6,10,1506,5,395,22.0,127.0,127.0,5,1111,24.0,843.0,843.0
0.019,6,10,1677,5,827,4.0,559.0,559.0,5,850,4.0,582.0,582.0
40.066,17,10,676,5,460,10013.0,104.0,64.0,5,216,10016.0,20.0,15.0
0.006,6,10,1689,5,839,1.0,571.0,571.0,5,850,1.0,582.0,582.0
0.013,6,10,1983,5,910,3.0,642.0,642.0,5,1073,3.0,805.0,805.0
0.006,6,10,1643,5,860,1.0,592.0,592.0,5,783,1.0,515.0,515.0
0.014,6,10,1983,5,910,3.0,642.0,642.0,5,1073,3.0,805.0,805.0
0.006,6,10,2000,5,927,1.0,659.0,659.0,5,1073,1.0,805.0,805.0
10.813,17,28,4419,14,1995,823.0,270.0,114.0,14,2424,823.0,587.0,145.0
0.015,6,10,1990,5,911,3.0,643.0,643.0,5,1079,3.0,811.0,811.0
0.012,6,10,1990,5,911,3.0,643.0,643.0,5,1079,2.0,811.0,811.0
0.003,17,2,152,1,76,0.0,48.0,48.0,1,76,0.0,48.0,48.0
0.014,6,10,1989,5,910,3.0,642.0,642.0,5,1079,3.0,811.0,811.0
0.124,17,4,284,2,120,0.0,32.0,32.0,2,164,53.0,60.0,54.0
0.103,6,10,1506,5,395,23.0,127.0,127.0,5,1111,22.0,843.0,843.0
290.811,6,317,343700,121,17845,2423.0,2736.0,825.0,196,325855,1491.0,2804.0,1734.0
0.094,6,10,1506,5,395,21.0,127.0,127.0,5,1111,22.0,843.0,843.0
0.006,6,10,1547,5,764,1.0,496.0,496.0,5,783,1.0,515.0,515.0
0.08,6,10,1506,5,395,17.0,127.0,127.0,5,1111,16.0,843.0,843.0
0.005,6,10,1689,5,839,1.0,571.0,571.0,5,850,1.0,582.0,582.0
0.005,17,2,170,1,65,0.0,37.0,37.0,1,105,0.0,77.0,77.0
0.006,6,10,1547,5,764,1.0,496.0,496.0,5,783,1.0,515.0,515.0
0.205,17,2,80,1,32,0.0,4.0,4.0,1,48,0.0,20.0,20.0
0.006,6,10,1689,5,839,1.0,571.0,571.0,5,850,1.0,582.0,582.0
0.095,6,10,1506,5,395,21.0,127.0,127.0,5,1111,16.0,843.0,843.0
0.084,6,10,1506,5,395,19.0,127.0,127.0,5,1111,18.0,843.0,843.0
0.005,17,2,222,1,65,0.0,37.0,37.0,1,157,0.0,129.0,129.0
0.006,6,10,1854,5,889,1.0,621.0,621.0,5,965,1.0,697.0,697.0
0.004,17,2,148,1,60,0.0,32.0,32.0,1,88,0.0,60.0,60.0
0.009,6,10,1631,5,848,2.0,580.0,580.0,5,783,2.0,515.0,515.0
0.008,6,13,3735,7,497,1.0,125.0,125.0,6,3238,1.0,1470.0,1459.0
240.104,6,17,4533,9,963,30013.0,238.0,166.0,8,3570,34300.0,1402.0,786.0
0.071,6,10,1506,5,395,15.0,127.0,127.0,5,1111,17.0,843.0,843.0
0.073,6,10,1506,5,395,16.0,127.0,127.0,5,1111,14.0,843.0,843.0
0.009,6,12,1926,6,1189,1.0,659.0,434.0,6,737,1.0,417.0,417.0
1756.23,6,105,6270,60,3525,29765.0,27.0,27.0,45,2745,39913.0,27.0,27.0
0.005,6,10,1989,5,927,1.0,659.0,659.0,5,1062,1.0,794.0,794.0
361.824,6,21,1793,16,1030,24121.0,190.0,190.0,5,763,60009.0,462.0,247.0
0.006,6,13,3747,7,509,1.0,137.0,137.0,6,3238,1.0,1470.0,1459.0
0.003,17,2,148,1,60,0.0,32.0,32.0,1,88,0.0,60.0,60.0
0.006,6,10,1689,5,839,1.0,571.0,571.0,5,850,1.0,582.0,582.0
0.006,6,10,1989,5,927,1.0,659.0,659.0,5,1062,1.0,794.0,794.0
0.014,6,10,1972,5,910,3.0,642.0,642.0,5,1062,3.0,794.0,794.0
0.009,6,10,1989,5,910,2.0,642.0,642.0,5,1079,2.0,811.0,811.0
0.005,6,10,1989,5,927,1.0,659.0,659.0,5,1062,1.0,794.0,794.0
0.005,6,10,2006,5,927,1.0,659.0,659.0,5,1079,1.0,811.0,811.0
0.004,6,10,2007,5,928,1.0,660.0,660.0,5,1079,1.0,811.0,811.0
0.008,17,2,164,1,74,0.0,46.0,46.0,1,90,0.0,62.0,62.0
0.014,6,10,1989,5,910,3.0,642.0,642.0,5,1079,3.0,811.0,811.0
0.004,17,4,284,2,120,1.0,32.0,32.0,2,164,1.0,60.0,54.0
0.003,17,2,170,1,65,0.0,37.0,37.0,1,105,0.0,77.0,77.0
0.005,6,10,2006,5,927,1.0,659.0,659.0,5,1079,1.0,811.0,811.0
240.172,6,20,4874,10,889,26685.0,180.0,93.0,10,3985,26679.0,1593.0,576.0
0.003,17,2,148,1,60,0.0,32.0,32.0,1,88,0.0,60.0,60.0
40.064,17,10,676,5,460,10015.0,104.0,64.0,5,216,10015.0,20.0,15.0
1741.824,6,295,93269,184,82789,9518.0,1402.0,659.0,111,10480,15834.0,93.0,65.0
40.054,17,10,676,5,460,10012.0,104.0,64.0,5,216,10012.0,20.0,15.0
0.012,6,10,1989,5,910,3.0,642.0,642.0,5,1079,3.0,811.0,811.0
0.096,6,10,1506,5,395,20.0,127.0,127.0,5,1111,21.0,843.0,843.0
0.005,6,10,2006,5,927,1.0,659.0,659.0,5,1079,1.0,811.0,811.0
354.019,6,21,1795,16,1030,23601.0,190.0,190.0,5,765,60003.0,464.0,248.0
11.115,17,28,4417,14,1993,842.0,268.0,114.0,14,2424,842.0,587.0,145.0
40.058,17,10,676,5,460,10011.0,104.0,64.0,5,216,10013.0,20.0,15.0
0.009,6,10,1990,5,911,2.0,643.0,643.0,5,1079,2.0,811.0,811.0
0.013,6,10,1983,5,910,3.0,642.0,642.0,5,1073,3.0,805.0,805.0
0.097,6,10,1506,5,395,19.0,127.0,127.0,5,1111,21.0,843.0,843.0
0.104,6,10,1506,5,395,22.0,127.0,127.0,5,1111,24.0,843.0,843.0
0.074,6,10,1506,5,395,15.0,127.0,127.0,5,1111,17.0,843.0,843.0
0.011,6,10,1972,5,910,2.0,642.0,642.0,5,1062,2.0,794.0,794.0
0.012,6,10,1631,5,848,3.0,580.0,580.0,5,783,3.0,515.0,515.0
0.005,6,10,2000,5,927,1.0,659.0,659.0,5,1073,1.0,805.0,805.0
0.124,6,10,1506,5,395,23.0,127.0,127.0,5,1111,25.0,843.0,843.0
110.508,58,5,360,4,288,36836.0,24.0,24.0,1,72,0.0,24.0,24.0
0.083,6,10,1506,5,395,20.0,127.0,127.0,5,1111,19.0,843.0,843.0
1761.208,6,64,7361,42,4485,42956.0,1641.0,109.0,22,2876,83858.0,1112.0,82.0
0.005,17,2,148,1,60,0.0,32.0,32.0,1,88,0.0,60.0,60.0
0.067,6,10,1506,5,395,15.0,127.0,127.0,5,1111,12.0,843.0,843.0
0.003,17,4,284,2,120,0.0,32.0,32.0,2,164,0.0,60.0,54.0
0.109,6,10,1506,5,395,25.0,127.0,127.0,5,1111,25.0,843.0,843.0
0.01,6,10,1983,5,910,2.0,642.0,642.0,5,1073,2.0,805.0,805.0
0.006,6,10,1689,5,839,1.0,571.0,571.0,5,850,1.0,582.0,582.0
0.227,6,16,2777,8,1395,32.0,533.0,323.0,8,1382,21.0,529.0,239.0
0.183,17,4,596,2,122,112.0,33.0,33.0,2,474,146.0,323.0,209.0
10.966,17,28,4397,14,2311,835.0,586.0,137.0,14,2086,835.0,269.0,121.0
0.103,6,10,1506,5,395,24.0,127.0,127.0,5,1111,16.0,843.0,843.0
0.094,6,10,1506,5,395,21.0,127.0,127.0,5,1111,23.0,843.0,843.0
0.139,6,10,1506,5,395,23.0,127.0,127.0,5,1111,32.0,843.0,843.0
0.004,6,10,2006,5,927,1.0,659.0,659.0,5,1079,1.0,811.0,811.0
40.071,17,10,676,5,460,10014.0,104.0,64.0,5,216,10016.0,20.0,15.0
0.083,6,10,1506,5,395,18.0,127.0,127.0,5,1111,16.0,843.0,843.0
0.005,6,10,2007,5,928,1.0,660.0,660.0,5,1079,1.0,811.0,811.0
0.005,6,10,1774,5,923,1.0,655.0,655.0,5,851,1.0,583.0,583.0
0.007,6,10,1983,5,910,1.0,642.0,642.0,5,1073,1.0,805.0,805.0
0.114,6,10,1506,5,395,25.0,127.0,127.0,5,1111,25.0,843.0,843.0
0.107,6,10,1506,5,395,18.0,127.0,127.0,5,1111,25.0,843.0,843.0
0.099,6,10,1506,5,395,22.0,127.0,127.0,5,1111,17.0,843.0,843.0
0.006,6,10,1547,5,764,1.0,496.0,496.0,5,783,1.0,515.0,515.0
40.045,17,10,676,5,460,10010.0,104.0,64.0,5,216,10010.0,20.0,15.0
0.007,17,2,194,1,59,0.0,31.0,31.0,1,135,0.0,107.0,107.0
0.006,6,10,1689,5,839,1.0,571.0,571.0,5,850,1.0,582.0,582.0
0.013,6,12,1926,6,1189,2.0,659.0,434.0,6,737,2.0,417.0,417.0
0.012,6,10,1990,5,911,3.0,643.0,643.0,5,1079,2.0,811.0,811.0
0.017,6,10,1631,5,848,4.0,580.0,580.0,5,783,4.0,515.0,515.0
0.042,17,2,170,1,65,0.0,37.0,37.0,1,105,0.0,77.0,77.0
0.01,6,10,1972,5,910,2.0,642.0,642.0,5,1062,2.0,794.0,794.0
0.006,6,10,1547,5,764,1.0,496.0,496.0,5,783,1.0,515.0,515.0
0.025,6,10,1990,5,911,6.0,643.0,643.0,5,1079,6.0,811.0,811.0
0.011,6,6,716,3,458,4.0,302.0,302.0,3,258,4.0,102.0,102.0
0.012,6,10,1631,5,848,3.0,580.0,580.0,5,783,3.0,515.0,515.0
291.501,6,394,348066,192,21548,1526.0,2736.0,888.0,202,326518,1450.0,2804.0,1680.0
0.01,6,10,1762,5,911,2.0,643.0,643.0,5,851,2.0,583.0,583.0
0.005,6,10,1689,5,839,1.0,571.0,571.0,5,850,1.0,582.0,582.0
0.009,6,12,1926,6,1189,1.0,659.0,434.0,6,737,1.0,417.0,417.0
0.005,17,2,180,1,66,0.0,38.0,38.0,1,114,0.0,86.0,86.0
10.819,17,26,4074,13,1822,892.0,269.0,112.0,13,2252,892.0,587.0,145.0
0.001,17,2,180,1,66,0.0,38.0,38.0,1,114,0.0,86.0,86.0
0.026,6,10,1762,5,911,6.0,643.0,643.0,5,851,6.0,583.0,583.0
0.016,6,10,1762,5,911,3.0,643.0,643.0,5,851,3.0,583.0,583.0
0.002,17,2,180,1,66,0.0,38.0,38.0,1,114,0.0,86.0,86.0
0.005,6,10,1854,5,889,1.0,621.0,621.0,5,965,1.0,697.0,697.0
301.262,6,37,8261,20,1830,15855.0,651.0,249.0,17,6431,568.0,2126.0,478.0
0.001,17,2,136,1,60,0.0,32.0,32.0,1,76,0.0,48.0,48.0
0.012,6,10,1989,5,910,3.0,642.0,642.0,5,1079,3.0,811.0,811.0
40.1,17,10,676,5,460,10021.0,104.0,64.0,5,216,10024.0,20.0,15.0
0.006,6,10,1854,5,889,1.0,621.0,621.0,5,965,1.0,697.0,697.0
0.005,17,2,148,1,60,0.0,32.0,32.0,1,88,0.0,60.0,60.0
0.075,17,2,136,1,60,0.0,32.0,32.0,1,76,0.0,48.0,48.0
0.019,6,13,3735,7,497,3.0,125.0,125.0,6,3238,3.0,1470.0,1459.0
0.005,6,10,2006,5,927,1.0,659.0,659.0,5,1079,1.0,811.0,811.0
308.379,17,20,1124,10,716,34252.0,48.0,43.0,10,408,34253.0,20.0,12.0
39.255,58,2,144,1,72,0.0,24.0,24.0,1,72,0.0,24.0,24.0
0.111,6,10,1506,5,395,25.0,127.0,127.0,5,1111,26.0,843.0,843.0
11.126,17,26,4098,13,1846,917.0,269.0,114.0,13,2252,917.0,587.0,145.0
0.004,6,10,1989,5,927,1.0,659.0,659.0,5,1062,1.0,794.0,794.0
9.039,17,6,376,5,280,2259.0,28.0,28.0,1,96,0.0,68.0,68.0
0.005,6,10,1989,5,927,1.0,659.0,659.0,5,1062,1.0,794.0,794.0
0.013,6,10,1990,5,911,3.0,643.0,643.0,5,1079,3.0,811.0,811.0
174.158,17,80,11469,40,2673,4465.0,44.0,38.0,40,8796,4465.0,249.0,191.0
308.416,17,20,1124,10,716,34254.0,48.0,43.0,10,408,34255.0,20.0,12.0
0.013,6,10,1631,5,848,3.0,580.0,580.0,5,783,3.0,515.0,515.0
0.095,6,10,1506,5,395,22.0,127.0,127.0,5,1111,23.0,843.0,843.0
0.007,6,10,1989,5,910,1.0,642.0,642.0,5,1079,1.0,811.0,811.0
0.005,6,10,1547,5,764,1.0,496.0,496.0,5,783,1.0,515.0,515.0
0.087,6,10,1506,5,395,17.0,127.0,127.0,5,1111,19.0,843.0,843.0
0.012,6,10,1990,5,911,3.0,643.0,643.0,5,1079,3.0,811.0,811.0
0.012,6,10,1989,5,910,3.0,642.0,642.0,5,1079,3.0,811.0,811.0
0.008,17,2,132,1,58,0.0,30.0,30.0,1,74,0.0,46.0,46.0
0.01,6,10,1983,5,910,2.0,642.0,642.0,5,1073,2.0,805.0,805.0
0.116,6,10,1506,5,395,26.0,127.0,127.0,5,1111,28.0,843.0,843.0
0.004,6,10,1779,5,928,1.0,660.0,660.0,5,851,1.0,583.0,583.0
0.01,6,10,1990,5,911,2.0,643.0,643.0,5,1079,2.0,811.0,811.0
11.158,17,28,4422,14,1994,846.0,269.0,114.0,14,2428,845.0,587.0,145.0
371.027,6,22,2313,16,867,24735.0,195.0,195.0,6,1446,4648.0,419.0,398.0
0.005,6,10,2000,5,927,1.0,659.0,659.0,5,1073,1.0,805.0,805.0
0.005,6,10,2000,5,927,1.0,659.0,659.0,5,1073,1.0,805.0,805.0
0.001,17,2,180,1,66,0.0,38.0,38.0,1,114,0.0,86.0,86.0
0.006,6,10,1547,5,764,1.0,496.0,496.0,5,783,1.0,515.0,515.0
240.112,6,16,4482,9,963,30014.0,238.0,166.0,7,3519,40018.0,1402.0,786.0
240.095,6,16,4480,9,963,30011.0,238.0,166.0,7,3517,40015.0,1402.0,786.0
0.212,6,16,2777,8,1395,30.0,533.0,323.0,8,1382,19.0,529.0,239.0
300.315,6,16,2170,9,684,37517.0,146.0,146.0,7,1486,50023.0,419.0,398.0
0.004,17,2,136,1,60,0.0,32.0,32.0,1,76,0.0,48.0,48.0
1755.415,6,458,66418,254,35296,6938.0,613.0,197.0,204,31122,8646.0,453.0,144.0
15.075,17,16,10617,9,8280,1880.0,1350.0,892.0,7,2337,2507.0,1350.0,305.0
0.006,6,10,1689,5,839,1.0,571.0,571.0,5,850,1.0,582.0,582.0
0.01,6,13,3735,7,497,1.0,125.0,125.0,6,3238,2.0,1470.0,1459.0
0.005,6,10,1547,5,764,1.0,496.0,496.0,5,783,1.0,515.0,515.0
0.076,6,10,1506,5,395,17.0,127.0,127.0,5,1111,17.0,843.0,843.0
0.005,6,10,2007,5,928,1.0,660.0,660.0,5,1079,1.0,811.0,811.0
0.005,6,10,1689,5,839,1.0,571.0,571.0,5,850,1.0,582.0,582.0
0.005,6,10,1989,5,927,1.0,659.0,659.0,5,1062,1.0,794.0,794.0
0.004,6,10,2000,5,927,1.0,659.0,659.0,5,1073,1.0,805.0,805.0
0.015,6,10,1989,5,910,3.0,642.0,642.0,5,1079,3.0,811.0,811.0
0.12,6,10,1506,5,395,29.0,127.0,127.0,5,1111,19.0,843.0,843.0
0.013,6,10,1990,5,911,3.0,643.0,643.0,5,1079,3.0,811.0,811.0
0.075,6,10,1506,5,395,15.0,127.0,127.0,5,1111,16.0,843.0,843.0
0.006,6,10,1854,5,889,1.0,621.0,621.0,5,965,1.0,697.0,697.0
0.005,6,14,3799,7,509,0.0,137.0,137.0,7,3290,0.0,1448.0,972.0
0.091,6,10,1506,5,395,19.0,127.0,127.0,5,1111,20.0,843.0,843.0
0.129,17,4,284,2,120,0.0,32.0,32.0,2,164,126.0,60.0,54.0
11.156,17,28,4393,14,2312,849.0,587.0,137.0,14,2081,849.0,268.0,120.0
0.022,6,10,1990,5,911,5.0,643.0,643.0,5,1079,5.0,811.0,811.0
0.005,6,10,2007,5,928,1.0,660.0,660.0,5,1079,1.0,811.0,811.0
126.289,6,28,15747,13,14953,10504.0,2828.0,2060.0,15,794,9004.0,182.0,182.0
0.005,6,13,3747,7,509,0.0,137.0,137.0,6,3238,1.0,1470.0,1459.0
0.006,17,2,136,1,60,0.0,32.0,32.0,1,76,0.0,48.0,48.0
0.011,6,10,1989,5,910,2.0,642.0,642.0,5,1079,2.0,811.0,811.0
0.014,6,10,1972,5,910,3.0,642.0,642.0,5,1062,3.0,794.0,794.0
0.012,6,10,1989,5,910,2.0,642.0,642.0,5,1079,2.0,811.0,811.0
0.004,17,2,136,1,60,0.0,32.0,32.0,1,76,0.0,48.0,48.0
0.087,6,10,1506,5,395,20.0,127.0,127.0,5,1111,19.0,843.0,843.0
0.047,17,2,170,1,65,0.0,37.0,37.0,1,105,0.0,77.0,77.0
0.001,17,2,174,1,72,0.0,44.0,44.0,1,102,0.0,74.0,74.0
0.006,6,10,2007,5,928,1.0,660.0,660.0,5,1079,1.0,811.0,811.0
0.004,6,10,1774,5,923,1.0,655.0,655.0,5,851,1.0,583.0,583.0
0.012,6,10,1989,5,910,3.0,642.0,642.0,5,1079,2.0,811.0,811.0
0.005,6,10,1779,5,928,1.0,660.0,660.0,5,851,1.0,583.0,583.0
0.833,6,10,2345,5,1230,144.0,1018.0,1018.0,5,1115,144.0,903.0,903.0
0.005,6,10,2000,5,927,1.0,659.0,659.0,5,1073,1.0,805.0,805.0
40.055,17,10,676,5,460,10012.0,104.0,64.0,5,216,10012.0,20.0,15.0
0.064,6,10,1506,5,395,14.0,127.0,127.0,5,1111,14.0,843.0,843.0
0.008,6,10,1989,5,910,2.0,642.0,642.0,5,1079,1.0,811.0,811.0
0.005,6,10,1989,5,927,1.0,659.0,659.0,5,1062,1.0,794.0,794.0
352.758,6,20,2210,6,1308,12003.0,494.0,494.0,14,902,27135.0,83.0,83.0
0.001,17,2,180,1,66,0.0,38.0,38.0,1,114,0.0,86.0,86.0
0.016,6,10,1631,5,848,4.0,580.0,580.0,5,783,3.0,515.0,515.0
0.011,6,10,1989,5,910,2.0,642.0,642.0,5,1079,2.0,811.0,811.0
0.016,6,10,1983,5,910,4.0,642.0,642.0,5,1073,3.0,805.0,805.0
0.005,17,2,179,1,71,0.0,43.0,43.0,1,108,0.0,80.0,80.0
0.009,6,10,1989,5,910,2.0,642.0,642.0,5,1079,2.0,811.0,811.0
0.066,6,10,1506,5,395,14.0,127.0,127.0,5,1111,15.0,843.0,843.0
0.011,6,14,3787,7,497,1.0,125.0,125.0,7,3290,1.0,1448.0,972.0
0.004,17,2,170,1,65,0.0,37.0,37.0,1,105,0.0,77.0,77.0
0.007,6,10,1990,5,911,1.0,643.0,643.0,5,1079,1.0,811.0,811.0
0.001,17,2,180,1,66,0.0,38.0,38.0,1,114,0.0,86.0,86.0
0.079,6,10,1506,5,395,17.0,127.0,127.0,5,1111,14.0,843.0,843.0
0.013,6,10,1762,5,911,3.0,643.0,643.0,5,851,3.0,583.0,583.0
312.743,17,20,1124,10,716,34734.0,48.0,43.0,10,408,34734.0,20.0,12.0
0.1,6,10,1506,5,395,23.0,127.0,127.0,5,1111,23.0,843.0,843.0
0.005,6,10,1989,5,927,1.0,659.0,659.0,5,1062,1.0,794.0,794.0
0.086,6,10,1506,5,395,19.0,127.0,127.0,5,1111,20.0,843.0,843.0
0.009,6,10,1983,5,910,2.0,642.0,642.0,5,1073,2.0,805.0,805.0
0.038,17,2,186,1,61,0.0,33.0,33.0,1,125,0.0,97.0,97.0
368.653,6,22,2313,16,867,24576.0,195.0,195.0,6,1446,4639.0,419.0,398.0
78.32,58,3,216,2,144,78320.0,24.0,24.0,1,72,0.0,24.0,24.0
0.01,6,10,1972,5,910,2.0,642.0,642.0,5,1062,2.0,794.0,794.0
0.001,17,2,180,1,66,0.0,38.0,38.0,1,114,0.0,86.0,86.0
1774.752,6,298,51606,122,34135,14666.0,2720.0,301.0,176,17471,10140.0,1360.0,128.0
0.01,6,10,1990,5,911,2.0,643.0,643.0,5,1079,2.0,811.0,811.0
0.076,6,10,1506,5,395,15.0,127.0,127.0,5,1111,15.0,843.0,843.0
15.073,17,15,9238,8,6902,2149.0,1350.0,834.0,7,2336,2507.0,1350.0,305.0
0.073,6,10,1506,5,395,17.0,127.0,127.0,5,1111,14.0,843.0,843.0
0.113,6,10,1506,5,395,24.0,127.0,127.0,5,1111,22.0,843.0,843.0
300.413,6,16,2170,9,684,37530.0,146.0,146.0,7,1486,50040.0,419.0,398.0
0.067,6,10,1506,5,395,15.0,127.0,127.0,5,1111,14.0,843.0,843.0
0.005,6,10,2000,5,927,1.0,659.0,659.0,5,1073,1.0,805.0,805.0
0.009,17,2,162,1,65,0.0,37.0,37.0,1,97,0.0,69.0,69.0
1778.68,17,143,41496,72,22752,25051.0,288.0,288.0,71,18744,25409.0,236.0,236.0
0.011,6,10,1989,5,910,2.0,642.0,642.0,5,1079,2.0,811.0,811.0
300.787,6,38,11059,20,5541,15830.0,1605.0,784.0,18,5518,506.0,2667.0,435.0
0.004,6,10,2006,5,927,1.0,659.0,659.0,5,1079,1.0,811.0,811.0
1786.909,6,154,19574,92,13852,19636.0,302.0,302.0,62,5722,29293.0,83.0,83.0
0.01,6,10,1990,5,911,2.0,643.0,643.0,5,1079,2.0,811.0,811.0
0.152,6,10,1506,5,395,37.0,127.0,127.0,5,1111,34.0,843.0,843.0
308.562,17,20,1124,10,716,34269.0,48.0,43.0,10,408,34269.0,20.0,12.0
0.013,6,10,1990,5,911,3.0,643.0,643.0,5,1079,3.0,811.0,811.0
0.008,17,2,194,1,59,0.0,31.0,31.0,1,135,0.0,107.0,107.0
0.086,6,10,1506,5,395,18.0,127.0,127.0,5,1111,18.0,843.0,843.0
0.006,6,10,1547,5,764,1.0,496.0,496.0,5,783,1.0,515.0,515.0
292.998,6,398,348457,204,22170,1443.0,2736.0,888.0,194,326287,1518.0,3322.0,1756.0
11.03,17,28,4390,14,2312,839.0,587.0,137.0,14,2078,839.0,269.0,120.0
0.095,6,10,1506,5,395,18.0,127.0,127.0,5,1111,19.0,843.0,843.0
0.008,6,10,1689,5,839,2.0,571.0,571.0,5,850,1.0,582.0,582.0
35.252,6,36,9962,18,4444,525.0,1360.0,738.0,18,5518,2063.0,2667.0,435.0
354.087,6,19,1691,15,978,25291.0,190.0,190.0,4,713,80003.0,497.0,497.0
0.013,6,10,1631,5,848,3.0,580.0,580.0,5,783,3.0,515.0,515.0
0.001,17,2,180,1,66,0.0,38.0,38.0,1,114,0.0,86.0,86.0
0.009,6,12,1698,6,863,1.0,327.0,271.0,6,835,1.0,515.0,515.0
0.001,17,2,136,1,60,0.0,32.0,32.0,1,76,0.0,48.0,48.0
0.004,6,10,1989,5,927,1.0,659.0,659.0,5,1062,1.0,794.0,794.0
0.005,6,10,1547,5,764,1.0,496.0,496.0,5,783,1.0,515.0,515.0
0.006,6,10,2006,5,927,1.0,659.0,659.0,5,1079,1.0,811.0,811.0
1.325,6,30,13240,17,5841,82.0,2720.0,854.0,13,7399,95.0,2720.0,858.0
0.01,6,10,1983,5,910,2.0,642.0,642.0,5,1073,2.0,805.0,805.0
40.077,17,10,676,5,460,10017.0,104.0,64.0,5,216,10018.0,20.0,15.0
0.014,17,2,179,1,71,0.0,43.0,43.0,1,108,0.0,80.0,80.0
0.005,6,10,2006,5,927,1.0,659.0,659.0,5,1079,1.0,811.0,811.0
0.006,17,2,169,1,62,0.0,34.0,34.0,1,107,0.0,79.0,79.0
0.007,6,10,1547,5,764,1.0,496.0,496.0,5,783,1.0,515.0,515.0
0.012,6,10,1972,5,910,3.0,642.0,642.0,5,1062,3.0,794.0,794.0
0.093,6,10,1506,5,395,21.0,127.0,127.0,5,1111,19.0,843.0,843.0
0.005,6,14,3742,7,452,0.0,80.0,80.0,7,3290,0.0,1448.0,972.0
15.071,17,15,9238,8,6902,2149.0,1350.0,834.0,7,2336,2507.0,1350.0,305.0
0.081,6,10,1506,5,395,17.0,127.0,127.0,5,1111,18.0,843.0,843.0
0.012,6,10,1990,5,911,3.0,643.0,643.0,5,1079,2.0,811.0,811.0
0.006,17,2,194,1,59,0.0,31.0,31.0,1,135,0.0,107.0,107.0
292.524,6,383,347593,196,21755,1500.0,2690.0,888.0,187,325838,1572.0,2804.0,1827.0
0.042,17,4,284,2,120,0.0,32.0,32.0,2,164,38.0,60.0,54.0
240.081,6,16,4480,9,963,30010.0,238.0,166.0,7,3517,40013.0,1402.0,786.0
364.434,6,21,1792,16,1030,24295.0,190.0,190.0,5,762,60011.0,461.0,247.0
0.009,6,10,1989,5,910,2.0,642.0,642.0,5,1079,2.0,811.0,811.0
0.004,6,13,3690,7,452,0.0,80.0,80.0,6,3238,0.0,1470.0,1459.0
0.003,17,4,284,2,120,0.0,32.0,32.0,2,164,0.0,60.0,54.0
240.014,6,9,787,5,488,60003.0,232.0,232.0,4,299,80003.0,83.0,83.0
0.008,6,10,1989,5,910,2.0,642.0,642.0,5,1079,2.0,811.0,811.0
65.858,6,27,17889,15,9943,4704.0,2804.0,1525.0,12,7946,5972.0,2317.0,1219.0
0.093,6,10,1506,5,395,21.0,127.0,127.0,5,1111,21.0,843.0,843.0
40.04,17,10,676,5,460,10008.0,104.0,64.0,5,216,10008.0,20.0,15.0
0.006,6,10,2006,5,927,1.0,659.0,659.0,5,1079,1.0,811.0,811.0
0.005,6,10,1547,5,764,1.0,496.0,496.0,5,783,1.0,515.0,515.0
0.004,17,2,148,1,60,0.0,32.0,32.0,1,88,0.0,60.0,60.0
0.004,17,4,284,2,120,0.0,32.0,32.0,2,164,0.0,60.0,54.0
0.006,6,13,3747,7,509,0.0,137.0,137.0,6,3238,1.0,1470.0,1459.0
0.012,6,10,1990,5,911,3.0,643.0,643.0,5,1079,3.0,811.0,811.0
0.041,17,2,412,1,61,0.0,33.0,33.0,1,351,0.0,323.0,323.0
0.006,6,10,1689,5,839,1.0,571.0,571.0,5,850,1.0,582.0,582.0
0.004,6,10,2006,5,927,1.0,659.0,659.0,5,1079,1.0,811.0,811.0
0.012,6,10,1990,5,911,3.0,643.0,643.0,5,1079,2.0,811.0,811.0
0.016,6,10,1989,5,910,3.0,642.0,642.0,5,1079,4.0,811.0,811.0
0.057,6,10,1506,5,395,13.0,127.0,127.0,5,1111,13.0,843.0,843.0
0.001,17,2,136,1,60,0.0,32.0,32.0,1,76,0.0,48.0,48.0
0.005,6,10,1643,5,860,1.0,592.0,592.0,5,783,1.0,515.0,515.0
0.005,17,2,160,1,72,0.0,44.0,44.0,1,88,0.0,60.0,60.0
0.001,17,2,180,1,66,0.0,38.0,38.0,1,114,0.0,86.0,86.0
0.006,6,10,1547,5,764,1.0,496.0,496.0,5,783,1.0,515.0,515.0
0.092,6,10,1506,5,395,19.0,127.0,127.0,5,1111,20.0,843.0,843.0
0.007,6,10,1547,5,764,1.0,496.0,496.0,5,783,1.0,515.0,515.0
0.001,17,2,136,1,60,0.0,32.0,32.0,1,76,0.0,48.0,48.0
10.884,17,28,4423,14,1994,829.0,269.0,114.0,14,2429,829.0,588.0,145.0
0.01,6,10,1990,5,911,2.0,643.0,643.0,5,1079,2.0,811.0,811.0
0.039,17,2,156,1,64,0.0,36.0,36.0,1,92,0.0,64.0,64.0
0.006,6,10,1854,5,889,1.0,621.0,621.0,5,965,1.0,697.0,697.0
0.006,6,10,1547,5,764,1.0,496.0,496.0,5,783,1.0,515.0,515.0
0.012,6,13,3913,7,495,1.0,123.0,123.0,6,3418,2.0,1650.0,1549.0
0.005,6,10,2006,5,927,1.0,659.0,659.0,5,1079,1.0,811.0,811.0
0.007,17,2,179,1,71,0.0,43.0,43.0,1,108,0.0,80.0,80.0
0.169,17,2,152,1,76,0.0,48.0,48.0,1,76,0.0,48.0,48.0
0.009,6,6,716,3,458,3.0,302.0,302.0,3,258,3.0,102.0,102.0
0.005,6,10,2006,5,927,1.0,659.0,659.0,5,1079,1.0,811.0,811.0
0.009,6,10,1762,5,911,2.0,643.0,643.0,5,851,2.0,583.0,583.0
0.072,6,10,1506,5,395,15.0,127.0,127.0,5,1111,14.0,843.0,843.0
0.005,6,10,2006,5,927,1.0,659.0,659.0,5,1079,1.0,811.0,811.0
0.06,6,10,1506,5,395,13.0,127.0,127.0,5,1111,13.0,843.0,843.0
0.001,17,2,180,1,66,0.0,38.0,38.0,1,114,0.0,86.0,86.0
0.01,6,10,1762,5,911,2.0,643.0,643.0,5,851,2.0,583.0,583.0
242.589,6,399,348495,194,21607,1256.0,2736.0,959.0,205,326888,1189.0,2804.0,1621.0
0.015,6,10,1972,5,910,3.0,642.0,642.0,5,1062,3.0,794.0,794.0
0.09,6,10,1506,5,395,19.0,127.0,127.0,5,1111,18.0,843.0,843.0
0.003,17,2,136,1,60,0.0,32.0,32.0,1,76,0.0,48.0,48.0
8.964,6,39,10487,20,4929,471.0,1360.0,682.0,19,5558,486.0,2667.0,435.0
0.005,6,13,3690,7,452,0.0,80.0,80.0,6,3238,1.0,1470.0,1459.0
176.035,17,76,10842,38,2538,4757.0,44.0,38.0,38,8304,4757.0,239.0,190.0
0.005,6,10,2006,5,927,1.0,659.0,659.0,5,1079,1.0,811.0,811.0
0.005,6,13,3747,7,509,0.0,137.0,137.0,6,3238,0.0,1470.0,1459.0
1085.984,6,302,60195,151,53095,7239.0,421.0,359.0,151,7100,7239.0,53.0,53.0
40.058,17,10,676,5,460,10013.0,104.0,64.0,5,216,10013.0,20.0,15.0
0.102,6,10,1506,5,395,22.0,127.0,127.0,5,1111,22.0,843.0,843.0
0.004,6,10,2006,5,927,1.0,659.0,659.0,5,1079,1.0,811.0,811.0
0.006,6,10,1643,5,860,1.0,592.0,592.0,5,783,1.0,515.0,515.0
0.081,6,10,1506,5,395,18.0,127.0,127.0,5,1111,16.0,843.0,843.0
0.076,6,10,1506,5,395,16.0,127.0,127.0,5,1111,16.0,843.0,843.0
0.042,17,2,148,1,60,0.0,32.0,32.0,1,88,0.0,60.0,60.0
0.013,6,10,1677,5,827,3.0,559.0,559.0,5,850,3.0,582.0,582.0
0.009,6,10,1989,5,910,2.0,642.0,642.0,5,1079,2.0,811.0,811.0
15.078,17,16,8471,8,6319,2150.0,1350.0,761.0,8,2152,2149.0,1350.0,241.0
0.004,6,10,1774,5,923,1.0,655.0,655.0,5,851,1.0,583.0,583.0
0.011,6,10,1605,5,388,2.0,120.0,120.0,5,1217,2.0,949.0,949.0
40.066,17,10,676,5,460,10015.0,104.0,64.0,5,216,10010.0,20.0,15.0
0.011,6,10,1762,5,911,2.0,643.0,643.0,5,851,2.0,583.0,583.0
0.001,17,2,179,1,62,0.0,34.0,34.0,1,117,0.0,89.0,89.0
0.005,6,10,2007,5,928,1.0,660.0,660.0,5,1079,1.0,811.0,811.0
0.123,6,10,1506,5,395,28.0,127.0,127.0,5,1111,29.0,843.0,843.0
280.237,6,23,6075,11,1226,28023.0,267.0,156.0,12,4849,25473.0,1400.0,873.0
0.005,6,10,2000,5,927,1.0,659.0,659.0,5,1073,1.0,805.0,805.0
0.001,17,2,180,1,66,0.0,38.0,38.0,1,114,0.0,86.0,86.0
0.005,6,10,2000,5,927,1.0,659.0,659.0,5,1073,1.0,805.0,805.0
15.081,17,16,9838,9,7714,1881.0,1350.0,829.0,7,2124,2508.0,1350.0,275.0
0.005,17,2,170,1,65,0.0,37.0,37.0,1,105,0.0,77.0,77.0
0.01,6,10,1983,5,910,2.0,642.0,642.0,5,1073,2.0,805.0,805.0
0.006,17,2,164,1,74,0.0,46.0,46.0,1,90,0.0,62.0,62.0
0.106,17,2,142,1,63,0.0,35.0,35.0,1,79,0.0,51.0,51.0
0.003,17,4,284,2,120,0.0,32.0,32.0,2,164,0.0,60.0,54.0
0.004,6,10,2007,5,928,1.0,660.0,660.0,5,1079,1.0,811.0,811.0
0.072,17,2,182,1,65,0.0,37.0,37.0,1,117,0.0,89.0,89.0
0.04,17,4,284,2,120,0.0,32.0,32.0,2,164,36.0,60.0,54.0
0.114,6,10,1506,5,395,26.0,127.0,127.0,5,1111,22.0,843.0,843.0
0.213,6,10,1785,6,1346,42.0,519.0,519.0,4,439,69.0,223.0,223.0
0.006,6,10,1854,5,889,1.0,621.0,621.0,5,965,1.0,697.0,697.0
0.116,17,2,80,1,32,0.0,4.0,4.0,1,48,0.0,20.0,20.0
0.076,6,10,1506,5,395,16.0,127.0,127.0,5,1111,15.0,843.0,843.0
0.008,6,10,1972,5,910,2.0,642.0,642.0,5,1062,1.0,794.0,794.0
0.011,6,10,1989,5,910,2.0,642.0,642.0,5,1079,2.0,811.0,811.0
40.059,17,10,676,5,460,10013.0,104.0,64.0,5,216,10013.0,20.0,15.0
0.004,6,10,1989,5,927,1.0,659.0,659.0,5,1062,1.0,794.0,794.0
0.004,17,2,136,1,60,0.0,32.0,32.0,1,76,0.0,48.0,48.0
0.012,6,10,1983,5,910,3.0,642.0,642.0,5,1073,3.0,805.0,805.0
0.176,17,2,194,1,59,0.0,31.0,31.0,1,135,0.0,107.0,107.0
0.005,6,10,1989,5,927,1.0,659.0,659.0,5,1062,1.0,794.0,794.0
0.013,6,10,1990,5,911,3.0,643.0,643.0,5,1079,3.0,811.0,811.0
0.012,6,10,1989,5,910,3.0,642.0,642.0,5,1079,2.0,811.0,811.0
0.001,17,2,166,1,75,0.0,47.0,47.0,1,91,0.0,63.0,63.0
0.006,6,10,1547,5,764,1.0,496.0,496.0,5,783,1.0,515.0,515.0
0.014,6,10,1983,5,910,3.0,642.0,642.0,5,1073,3.0,805.0,805.0
10.795,17,28,4422,14,1994,822.0,269.0,114.0,14,2428,822.0,587.0,145.0
0.066,6,10,1506,5,395,15.0,127.0,127.0,5,1111,14.0,843.0,843.0
0.005,6,13,3690,7,452,0.0,80.0,80.0,6,3238,0.0,1470.0,1459.0
0.004,17,2,136,1,60,0.0,32.0,32.0,1,76,0.0,48.0,48.0
0.078,6,10,1506,5,395,14.0,127.0,127.0,5,1111,16.0,843.0,843.0
0.003,17,2,136,1,60,0.0,32.0,32.0,1,76,0.0,48.0,48.0
0.082,6,10,1506,5,395,18.0,127.0,127.0,5,1111,18.0,843.0,843.0
0.143,6,10,1506,5,395,31.0,127.0,127.0,5,1111,31.0,843.0,843.0
0.006,6,13,3690,7,452,1.0,80.0,80.0,6,3238,1.0,1470.0,1459.0
0.006,17,2,169,1,62,0.0,34.0,34.0,1,107,0.0,79.0,79.0
0.016,6,10,1972,5,910,4.0,642.0,642.0,5,1062,4.0,794.0,794.0
0.005,6,10,2007,5,928,1.0,660.0,660.0,5,1079,1.0,811.0,811.0
0.006,6,10,1547,5,764,1.0,496.0,496.0,5,783,1.0,515.0,515.0
0.001,17,2,144,1,64,0.0,36.0,36.0,1,80,0.0,52.0,52.0
320.716,17,20,1124,10,716,35621.0,48.0,43.0,10,408,35621.0,20.0,12.0
301.031,6,43,13135,23,7308,13683.0,1882.0,908.0,20,5827,466.0,2667.0,385.0
0.038,17,2,136,1,60,0.0,32.0,32.0,1,76,0.0,48.0,48.0
0.113,6,10,1506,5,395,25.0,127.0,127.0,5,1111,26.0,843.0,843.0
0.005,6,10,1779,5,928,1.0,660.0,660.0,5,851,1.0,583.0,583.0
0.085,6,10,1506,5,395,18.0,127.0,127.0,5,1111,18.0,843.0,843.0
0.005,6,10,1989,5,927,1.0,659.0,659.0,5,1062,1.0,794.0,794.0
0.128,17,2,148,1,60,0.0,32.0,32.0,1,88,0.0,60.0,60.0
0.072,17,2,166,1,75,0.0,47.0,47.0,1,91,0.0,63.0,63.0
0.114,6,10,1506,5,395,22.0,127.0,127.0,5,1111,23.0,843.0,843.0
0.073,17,4,580,2,122,0.0,33.0,33.0,2,458,35.0,307.0,201.0
0.061,6,10,1506,5,395,14.0,127.0,127.0,5,1111,14.0,843.0,843.0
0.005,17,2,170,1,65,0.0,37.0,37.0,1,105,0.0,77.0,77.0
0.013,6,10,1983,5,910,3.0,642.0,642.0,5,1073,3.0,805.0,805.0
0.167,17,2,152,1,76,0.0,48.0,48.0,1,76,0.0,48.0,48.0
0.006,6,10,2007,5,928,1.0,660.0,660.0,5,1079,1.0,811.0,811.0
0.008,6,10,1631,5,848,1.0,580.0,580.0,5,783,2.0,515.0,515.0
178.387,17,84,11932,42,2816,4350.0,44.0,39.0,42,9116,4350.0,239.0,189.0
168.084,17,76,10869,38,2530,4542.0,44.0,38.0,38,8339,4542.0,261.0,191.0
0.105,6,10,1506,5,395,24.0,127.0,127.0,5,1111,24.0,843.0,843.0
0.039,17,2,136,1,60,0.0,32.0,32.0,1,76,0.0,48.0,48.0
0.01,6,10,1677,5,827,2.0,559.0,559.0,5,850,2.0,582.0,582.0
0.037,17,2,182,1,65,0.0,37.0,37.0,1,117,0.0,89.0,89.0
120.824,6,71,30554,40,5407,3098.0,992.0,207.0,31,25147,4027.0,2804.0,1176.0
0.006,6,10,1547,5,764,1.0,496.0,496.0,5,783,1.0,515.0,515.0
0.005,6,10,2006,5,927,1.0,659.0,659.0,5,1079,1.0,811.0,811.0
0.005,6,14,3736,7,446,0.0,74.0,74.0,7,3290,0.0,1448.0,972.0
0.006,6,10,1547,5,764,1.0,496.0,496.0,5,783,1.0,515.0,515.0
1758.958,6,426,64164,252,35168,7007.0,613.0,197.0,174,28996,10166.0,453.0,142.0
0.078,6,10,1506,5,395,17.0,127.0,127.0,5,1111,15.0,843.0,843.0
0.078,6,10,1506,5,395,16.0,127.0,127.0,5,1111,15.0,843.0,843.0
0.092,6,10,1506,5,395,22.0,127.0,127.0,5,1111,18.0,843.0,843.0
40.062,17,10,676,5,460,10014.0,104.0,64.0,5,216,10014.0,20.0,15.0
40.071,17,10,676,5,460,10017.0,104.0,64.0,5,216,10017.0,20.0,15.0
0.077,6,10,1506,5,395,18.0,127.0,127.0,5,1111,17.0,843.0,843.0
0.165,6,10,1506,5,395,39.0,127.0,127.0,5,1111,37.0,843.0,843.0
0.154,6,10,1506,5,395,37.0,127.0,127.0,5,1111,31.0,843.0,843.0
0.006,6,10,1547,5,764,1.0,496.0,496.0,5,783,1.0,515.0,515.0
0.009,6,10,2007,5,928,2.0,660.0,660.0,5,1079,2.0,811.0,811.0
0.009,17,2,307,1,61,0.0,33.0,33.0,1,246,0.0,218.0,218.0
0.006,17,2,222,1,65,0.0,37.0,37.0,1,157,0.0,129.0,129.0
0.007,6,10,1547,5,764,1.0,496.0,496.0,5,783,1.0,515.0,515.0
10.909,17,28,4422,14,1994,829.0,269.0,114.0,14,2428,830.0,587.0,145.0
0.116,6,10,1506,5,395,26.0,127.0,127.0,5,1111,19.0,843.0,843.0
240.09,6,32,9286,16,6825,16006.0,1898.0,666.0,16,2461,16005.0,580.0,202.0
0.027,6,10,1631,5,848,6.0,580.0,580.0,5,783,6.0,515.0,515.0
0.005,6,10,1779,5,928,1.0,660.0,660.0,5,851,1.0,583.0,583.0
1730.37,6,45,2790,30,1725,59667.0,35.0,35.0,15,1065,123592.0,31.0,31.0
0.067,6,10,1506,5,395,14.0,127.0,127.0,5,1111,16.0,843.0,843.0
15.076,17,14,9190,8,6902,2149.0,1350.0,834.0,6,2288,3009.0,1350.0,353.0
0.078,6,10,1506,5,395,17.0,127.0,127.0,5,1111,16.0,843.0,843.0
11.117,17,28,4423,14,1994,842.0,269.0,114.0,14,2429,842.0,588.0,145.0
0.08,6,10,1506,5,395,18.0,127.0,127.0,5,1111,17.0,843.0,843.0
154.757,6,21,8147,11,1985,83.0,1174.0,504.0,10,6162,17176.0,2720.0,958.0
0.014,6,10,1983,5,910,3.0,642.0,642.0,5,1073,3.0,805.0,805.0
0.054,6,13,3816,7,578,9.0,206.0,206.0,6,3238,10.0,1470.0,1459.0
0.006,6,10,1547,5,764,1.0,496.0,496.0,5,783,1.0,515.0,515.0
1770.473,17,92,8096,46,4048,39343.0,60.0,60.0,46,4048,39343.0,60.0,60.0
0.014,6,10,1972,5,910,3.0,642.0,642.0,5,1062,3.0,794.0,794.0
0.068,17,8,3613,4,1874,22.0,1350.0,440.0,4,1739,11.0,1350.0,406.0
0.07,6,10,1506,5,395,16.0,127.0,127.0,5,1111,16.0,843.0,843.0
0.005,6,10,1779,5,928,1.0,660.0,660.0,5,851,1.0,583.0,583.0
0.076,6,10,1506,5,395,16.0,127.0,127.0,5,1111,16.0,843.0,843.0
0.083,6,10,1506,5,395,15.0,127.0,127.0,5,1111,19.0,843.0,843.0
301.132,6,53,24848,29,18861,10754.0,2720.0,1359.0,24,5987,390.0,2667.0,385.0
0.014,17,2,152,1,56,0.0,28.0,28.0,1,96,0.0,68.0,68.0
0.011,6,10,1762,5,911,2.0,643.0,643.0,5,851,2.0,583.0,583.0
0.005,17,2,144,1,64,0.0,36.0,36.0,1,80,0.0,52.0,52.0
0.011,6,10,1677,5,827,2.0,559.0,559.0,5,850,2.0,582.0,582.0
0.005,17,2,164,1,74,0.0,46.0,46.0,1,90,0.0,62.0,62.0
0.038,17,2,152,1,76,0.0,48.0,48.0,1,76,0.0,48.0,48.0
40.056,17,10,676,5,460,10013.0,104.0,64.0,5,216,10012.0,20.0,15.0
0.001,17,2,180,1,66,0.0,38.0,38.0,1,114,0.0,86.0,86.0
0.01,6,10,1972,5,910,2.0,642.0,642.0,5,1062,2.0,794.0,794.0
0.092,6,10,1506,5,395,22.0,127.0,127.0,5,1111,19.0,843.0,843.0
0.009,6,10,1972,5,910,2.0,642.0,642.0,5,1062,2.0,794.0,794.0
0.002,17,2,166,1,75,0.0,47.0,47.0,1,91,0.0,63.0,63.0
0.011,6,10,1631,5,848,2.0,580.0,580.0,5,783,2.0,515.0,515.0
0.161,17,2,152,1,76,0.0,48.0,48.0,1,76,0.0,48.0,48.0
15.072,17,14,9190,8,6902,2149.0,1350.0,834.0,6,2288,3008.0,1350.0,353.0
0.109,6,10,1506,5,395,24.0,127.0,127.0,5,1111,22.0,843.0,843.0
0.093,6,10,1506,5,395,21.0,127.0,127.0,5,1111,19.0,843.0,843.0
0.006,6,10,2000,5,927,1.0,659.0,659.0,5,1073,1.0,805.0,805.0
0.077,6,10,1506,5,395,16.0,127.0,127.0,5,1111,18.0,843.0,843.0
0.013,6,10,1990,5,911,3.0,643.0,643.0,5,1079,3.0,811.0,811.0
0.01,6,10,1972,5,910,2.0,642.0,642.0,5,1062,2.0,794.0,794.0
0.094,6,10,1506,5,395,23.0,127.0,127.0,5,1111,21.0,843.0,843.0
0.011,6,13,3735,7,497,1.0,125.0,125.0,6,3238,2.0,1470.0,1459.0
0.023,17,2,194,1,59,0.0,31.0,31.0,1,135,0.0,107.0,107.0
0.014,6,10,1989,5,910,3.0,642.0,642.0,5,1079,3.0,811.0,811.0
0.004,6,10,1774,5,923,1.0,655.0,655.0,5,851,1.0,583.0,583.0
178.442,17,78,11037,39,2601,4695.0,44.0,38.0,39,8436,4695.0,239.0,188.0
0.004,6,10,1702,5,863,1.0,595.0,595.0,5,839,0.0,571.0,571.0
10.715,17,28,4417,14,1993,816.0,268.0,114.0,14,2424,816.0,587.0,145.0
11.121,17,28,4421,14,1994,842.0,269.0,114.0,14,2427,843.0,586.0,145.0
0.018,6,10,1631,5,848,4.0,580.0,580.0,5,783,4.0,515.0,515.0
11.062,17,28,4399,14,2313,842.0,588.0,137.0,14,2086,842.0,269.0,121.0
171.135,17,78,11425,39,2627,4503.0,44.0,39.0,39,8798,4503.0,260.0,197.0
0.068,17,8,3613,4,1874,22.0,1350.0,440.0,4,1739,11.0,1350.0,406.0
0.039,17,4,284,2,120,0.0,32.0,32.0,2,164,36.0,60.0,54.0
0.129,6,10,1506,5,395,28.0,127.0,127.0,5,1111,28.0,843.0,843.0
0.012,6,10,1989,5,910,3.0,642.0,642.0,5,1079,3.0,811.0,811.0
0.099,6,10,1506,5,395,22.0,127.0,127.0,5,1111,21.0,843.0,843.0
15.074,17,15,9238,8,6902,2149.0,1350.0,834.0,7,2336,2507.0,1350.0,305.0
0.012,6,10,1989,5,910,3.0,642.0,642.0,5,1079,3.0,811.0,811.0
0.012,6,10,1990,5,911,3.0,643.0,643.0,5,1079,2.0,811.0,811.0
0.014,6,10,1762,5,911,3.0,643.0,643.0,5,851,3.0,583.0,583.0
0.071,6,10,1506,5,395,15.0,127.0,127.0,5,1111,16.0,843.0,843.0
177.37,17,82,11973,41,2749,4434.0,44.0,39.0,41,9224,4434.0,279.0,196.0
0.005,6,10,2007,5,928,1.0,660.0,660.0,5,1079,1.0,811.0,811.0
0.101,6,10,1506,5,395,24.0,127.0,127.0,5,1111,22.0,843.0,843.0
0.015,6,10,1983,5,910,3.0,642.0,642.0,5,1073,3.0,805.0,805.0
0.009,6,12,1926,6,1189,1.0,659.0,434.0,6,737,1.0,417.0,417.0
293.69,6,395,348597,199,21912,1483.0,2736.0,888.0,196,326685,1506.0,4127.0,1738.0
365.872,6,22,2313,16,867,24391.0,195.0,195.0,6,1446,4643.0,419.0,398.0
0.006,17,2,136,1,60,0.0,32.0,32.0,1,76,0.0,48.0,48.0
10.938,17,28,4394,14,1993,832.0,268.0,114.0,14,2401,831.0,588.0,143.0
0.001,17,2,180,1,66,0.0,38.0,38.0,1,114,0.0,86.0,86.0
0.004,6,10,2006,5,927,1.0,659.0,659.0,5,1079,1.0,811.0,811.0
40.067,17,10,676,5,460,10013.0,104.0,64.0,5,216,10015.0,20.0,15.0
0.075,6,10,1506,5,395,17.0,127.0,127.0,5,1111,16.0,843.0,843.0
240.205,6,49,14839,24,3448,10443.0,796.0,311.0,25,11391,10008.0,2804.0,775.0
0.037,17,2,148,1,60,0.0,32.0,32.0,1,88,0.0,60.0,60.0
0.001,17,2,180,1,66,0.0,38.0,38.0,1,114,0.0,86.0,86.0
0.005,6,14,3742,7,452,0.0,80.0,80.0,7,3290,0.0,1448.0,972.0
0.004,17,2,148,1,60,0.0,32.0,32.0,1,88,0.0,60.0,60.0
0.17,6,3,453,2,321,170.0,241.0,241.0,1,132,0.0,92.0,92.0
0.005,6,13,3747,7,509,0.0,137.0,137.0,6,3238,1.0,1470.0,1459.0
0.004,17,2,136,1,60,0.0,32.0,32.0,1,76,0.0,48.0,48.0
0.005,6,10,2007,5,928,1.0,660.0,660.0,5,1079,1.0,811.0,811.0
0.005,6,10,1989,5,927,1.0,659.0,659.0,5,1062,1.0,794.0,794.0
0.041,17,2,152,1,76,0.0,48.0,48.0,1,76,0.0,48.0,48.0
0.011,6,10,2006,5,927,2.0,659.0,659.0,5,1079,2.0,811.0,811.0
0.001,17,2,136,1,60,0.0,32.0,32.0,1,76,0.0,48.0,48.0
0.14,6,10,1506,5,395,31.0,127.0,127.0,5,1111,31.0,843.0,843.0
0.01,6,10,1762,5,911,2.0,643.0,643.0,5,851,2.0,583.0,583.0
1798.147,17,2467,188796,1228,99468,1465.0,75.0,53.0,1239,89328,1452.0,227.0,44.0
0.014,6,10,1983,5,910,3.0,642.0,642.0,5,1073,3.0,805.0,805.0
0.017,6,13,3735,7,497,2.0,125.0,125.0,6,3238,3.0,1470.0,1459.0
0.005,6,10,2007,5,928,1.0,660.0,660.0,5,1079,1.0,811.0,811.0
0.102,6,10,1506,5,395,24.0,127.0,127.0,5,1111,18.0,843.0,843.0
0.005,6,10,2007,5,928,1.0,660.0,660.0,5,1079,1.0,811.0,811.0
0.011,6,10,1989,5,910,2.0,642.0,642.0,5,1079,2.0,811.0,811.0
0.033,17,2,136,1,60,0.0,32.0,32.0,1,76,0.0,48.0,48.0
0.011,6,10,1762,5,911,2.0,643.0,643.0,5,851,2.0,583.0,583.0
40.063,17,10,676,5,460,10014.0,104.0,64.0,5,216,10014.0,20.0,15.0
0.005,6,10,1689,5,839,1.0,571.0,571.0,5,850,1.0,582.0,582.0
0.005,6,10,2007,5,928,1.0,660.0,660.0,5,1079,1.0,811.0,811.0
40.08,17,10,676,5,460,10017.0,104.0,64.0,5,216,10019.0,20.0,15.0
0.004,6,10,1989,5,927,1.0,659.0,659.0,5,1062,1.0,794.0,794.0
0.009,6,13,3735,7,497,1.0,125.0,125.0,6,3238,1.0,1470.0,1459.0
240.015,6,9,787,5,488,60003.0,232.0,232.0,4,299,80004.0,83.0,83.0
0.005,6,10,1989,5,927,1.0,659.0,659.0,5,1062,1.0,794.0,794.0
0.001,17,2,174,1,72,0.0,44.0,44.0,1,102,0.0,74.0,74.0
0.001,17,2,142,1,63,0.0,35.0,35.0,1,79,0.0,51.0,51.0
0.111,6,10,1506,5,395,27.0,127.0,127.0,5,1111,22.0,843.0,843.0
0.001,17,2,166,1,75,0.0,47.0,47.0,1,91,0.0,63.0,63.0
0.011,6,10,1983,5,910,2.0,642.0,642.0,5,1073,2.0,805.0,805.0
0.005,6,10,2006,5,927,1.0,659.0,659.0,5,1079,1.0,811.0,811.0
0.024,6,10,1677,5,827,5.0,559.0,559.0,5,850,5.0,582.0,582.0
0.006,6,10,1547,5,764,1.0,496.0,496.0,5,783,1.0,515.0,515.0
40.076,17,10,676,5,460,10018.0,104.0,64.0,5,216,10018.0,20.0,15.0
0.011,6,10,1990,5,911,2.0,643.0,643.0,5,1079,2.0,811.0,811.0
0.064,6,10,1506,5,395,13.0,127.0,127.0,5,1111,13.0,843.0,843.0
0.006,6,10,1779,5,928,1.0,660.0,660.0,5,851,1.0,583.0,583.0
0.103,6,10,1506,5,395,22.0,127.0,127.0,5,1111,23.0,843.0,843.0
0.109,6,10,1506,5,395,23.0,127.0,127.0,5,1111,22.0,843.0,843.0
0.011,6,10,1989,5,910,2.0,642.0,642.0,5,1079,2.0,811.0,811.0
1738.237,6,65,7399,43,4522,41386.0,1402.0,103.0,22,2877,82764.0,1113.0,82.0
0.006,6,10,1547,5,764,1.0,496.0,496.0,5,783,1.0,515.0,515.0
0.005,17,2,144,1,64,0.0,36.0,36.0,1,80,0.0,52.0,52.0
0.098,6,10,1506,5,395,21.0,127.0,127.0,5,1111,21.0,843.0,843.0
0.005,17,2,180,1,66,0.0,38.0,38.0,1,114,0.0,86.0,86.0
0.008,6,10,1972,5,910,2.0,642.0,642.0,5,1062,1.0,794.0,794.0
0.005,6,10,2000,5,927,1.0,659.0,659.0,5,1073,1.0,805.0,805.0
0.007,6,10,1677,5,827,1.0,559.0,559.0,5,850,1.0,582.0,582.0
0.016,6,10,1631,5,848,4.0,580.0,580.0,5,783,3.0,515.0,515.0
0.005,6,10,1854,5,889,1.0,621.0,621.0,5,965,1.0,697.0,697.0
40.055,17,10,676,5,460,10012.0,104.0,64.0,5,216,10013.0,20.0,15.0
0.007,6,10,1990,5,911,1.0,643.0,643.0,5,1079,1.0,811.0,811.0
0.001,17,2,180,1,66,0.0,38.0,38.0,1,114,0.0,86.0,86.0
0.015,6,10,1989,5,910,3.0,642.0,642.0,5,1079,3.0,811.0,811.0
0.005,6,10,2000,5,927,1.0,659.0,659.0,5,1073,1.0,805.0,805.0
0.004,6,10,2007,5,928,1.0,660.0,660.0,5,1079,1.0,811.0,811.0
0.121,6,10,1506,5,395,26.0,127.0,127.0,5,1111,27.0,843.0,843.0
0.126,6,10,1506,5,395,29.0,127.0,127.0,5,1111,25.0,843.0,843.0
0.001,17,2,180,1,66,0.0,38.0,38.0,1,114,0.0,86.0,86.0
0.006,6,10,1547,5,764,1.0,496.0,496.0,5,783,1.0,515.0,515.0
0.006,6,10,1547,5,764,1.0,496.0,496.0,5,783,1.0,515.0,515.0
0.008,17,2,148,1,60,0.0,32.0,32.0,1,88,0.0,60.0,60.0
0.008,17,2,148,1,60,0.0,32.0,32.0,1,88,0.0,60.0,60.0
0.013,17,2,230,1,68,0.0,40.0,40.0,1,162,0.0,134.0,134.0
0.005,6,10,1547,5,764,1.0,496.0,496.0,5,783,1.0,515.0,515.0
40.05,17,10,676,5,460,10011.0,104.0,64.0,5,216,10011.0,20.0,15.0
0.049,6,10,1989,5,910,12.0,642.0,642.0,5,1079,12.0,811.0,811.0
0.111,6,10,1506,5,395,21.0,127.0,127.0,5,1111,23.0,843.0,843.0
0.005,6,13,3747,7,509,0.0,137.0,137.0,6,3238,0.0,1470.0,1459.0
0.042,17,2,234,1,61,0.0,33.0,33.0,1,173,0.0,145.0,145.0
0.016,6,10,1677,5,827,3.0,559.0,559.0,5,850,3.0,582.0,582.0
0.018,6,10,1983,5,910,4.0,642.0,642.0,5,1073,4.0,805.0,805.0
240.208,6,32,9534,16,7054,16013.0,2126.0,691.0,16,2480,16010.0,580.0,205.0
15.072,17,16,10617,9,8280,1880.0,1350.0,892.0,7,2337,2508.0,1350.0,305.0
280.246,6,24,6115,11,1226,28024.0,267.0,156.0,13,4889,23353.0,1400.0,873.0
0.005,6,13,3747,7,509,0.0,137.0,137.0,6,3238,1.0,1470.0,1459.0
0.012,6,10,1989,5,910,3.0,642.0,642.0,5,1079,2.0,811.0,811.0
0.018,6,10,1762,5,911,4.0,643.0,643.0,5,851,4.0,583.0,583.0
0.142,6,10,1506,5,395,34.0,127.0,127.0,5,1111,30.0,843.0,843.0
0.002,17,2,166,1,75,0.0,47.0,47.0,1,91,0.0,63.0,63.0
0.127,17,4,284,2,120,1.0,32.0,32.0,2,164,123.0,60.0,54.0
0.016,6,10,1989,5,910,3.0,642.0,642.0,5,1079,3.0,811.0,811.0
0.124,6,10,1506,5,395,28.0,127.0,127.0,5,1111,26.0,843.0,843.0
0.005,17,2,170,1,65,0.0,37.0,37.0,1,105,0.0,77.0,77.0
0.129,17,2,80,1,32,0.0,4.0,4.0,1,48,0.0,20.0,20.0
0.007,6,10,1643,5,860,1.0,592.0,592.0,5,783,1.0,515.0,515.0
0.104,6,10,1506,5,395,25.0,127.0,127.0,5,1111,24.0,843.0,843.0
0.004,6,10,1774,5,923,1.0,655.0,655.0,5,851,1.0,583.0,583.0
40.058,17,10,676,5,460,10013.0,104.0,64.0,5,216,10013.0,20.0,15.0
0.009,6,10,1677,5,827,2.0,559.0,559.0,5,850,2.0,582.0,582.0
0.006,6,14,3799,7,509,1.0,137.0,137.0,7,3290,0.0,1448.0,972.0
0.071,6,10,1506,5,395,15.0,127.0,127.0,5,1111,16.0,843.0,843.0
0.014,6,10,1972,5,910,3.0,642.0,642.0,5,1062,3.0,794.0,794.0
0.017,6,10,1989,5,910,4.0,642.0,642.0,5,1079,4.0,811.0,811.0
0.014,6,10,1989,5,910,3.0,642.0,642.0,5,1079,3.0,811.0,811.0
0.006,6,10,1989,5,927,1.0,659.0,659.0,5,1062,1.0,794.0,794.0
0.006,6,10,1547,5,764,1.0,496.0,496.0,5,783,1.0,515.0,515.0
0.129,6,10,1506,5,395,29.0,127.0,127.0,5,1111,28.0,843.0,843.0
0.057,6,10,1506,5,395,13.0,127.0,127.0,5,1111,13.0,843.0,843.0
0.009,6,10,1631,5,848,2.0,580.0,580.0,5,783,2.0,515.0,515.0
0.01,6,10,1972,5,910,2.0,642.0,642.0,5,1062,2.0,794.0,794.0
0.006,6,10,1854,5,889,1.0,621.0,621.0,5,965,1.0,697.0,697.0
0.07,6,10,1506,5,395,16.0,127.0,127.0,5,1111,14.0,843.0,843.0
0.013,6,10,1972,5,910,3.0,642.0,642.0,5,1062,3.0,794.0,794.0
11.178,17,28,4419,14,1995,847.0,270.0,114.0,14,2424,847.0,587.0,145.0
0.005,6,10,1989,5,927,1.0,659.0,659.0,5,1062,1.0,794.0,794.0
0.011,6,10,1677,5,827,2.0,559.0,559.0,5,850,2.0,582.0,582.0
0.076,6,10,1506,5,395,16.0,127.0,127.0,5,1111,16.0,843.0,843.0
40.063,17,10,676,5,460,10014.0,104.0,64.0,5,216,10014.0,20.0,15.0
0.003,17,2,136,1,60,0.0,32.0,32.0,1,76,0.0,48.0,48.0
0.005,6,10,1854,5,889,1.0,621.0,621.0,5,965,1.0,697.0,697.0
0.01,6,10,1989,5,910,2.0,642.0,642.0,5,1079,2.0,811.0,811.0
0.005,6,14,3799,7,509,0.0,137.0,137.0,7,3290,0.0,1448.0,972.0
0.006,17,2,179,1,71,0.0,43.0,43.0,1,108,0.0,80.0,80.0
15.07,17,15,9238,8,6902,2148.0,1350.0,834.0,7,2336,2506.0,1350.0,305.0
0.006,6,10,1547,5,764,1.0,496.0,496.0,5,783,1.0,515.0,515.0
0.168,17,2,152,1,76,0.0,48.0,48.0,1,76,0.0,48.0,48.0
0.005,6,10,2006,5,927,1.0,659.0,659.0,5,1079,1.0,811.0,811.0
0.071,6,10,1506,5,395,16.0,127.0,127.0,5,1111,15.0,843.0,843.0
0.005,6,10,2006,5,927,1.0,659.0,659.0,5,1079,1.0,811.0,811.0
0.057,17,2,179,1,71,0.0,43.0,43.0,1,108,0.0,80.0,80.0
0.013,17,2,152,1,56,0.0,28.0,28.0,1,96,0.0,68.0,68.0
0.006,6,10,1989,5,927,1.0,659.0,659.0,5,1062,1.0,794.0,794.0
0.004,6,10,2006,5,927,1.0,659.0,659.0,5,1079,1.0,811.0,811.0
0.072,17,4,284,2,120,0.0,32.0,32.0,2,164,69.0,60.0,54.0
0.131,6,10,1506,5,395,30.0,127.0,127.0,5,1111,30.0,843.0,843.0
0.009,6,10,1972,5,910,2.0,642.0,642.0,5,1062,2.0,794.0,794.0
0.006,6,10,1547,5,764,1.0,496.0,496.0,5,783,1.0,515.0,515.0
0.005,17,2,136,1,60,0.0,32.0,32.0,1,76,0.0,48.0,48.0
0.001,17,2,180,1,66,0.0,38.0,38.0,1,114,0.0,86.0,86.0
0.079,6,10,1506,5,395,15.0,127.0,127.0,5,1111,17.0,843.0,843.0
0.006,6,10,1547,5,764,1.0,496.0,496.0,5,783,1.0,515.0,515.0
0.01,6,10,1989,5,910,2.0,642.0,642.0,5,1079,2.0,811.0,811.0
40.076,17,10,676,5,460,10018.0,104.0,64.0,5,216,10018.0,20.0,15.0
0.008,6,10,1990,5,911,2.0,643.0,643.0,5,1079,1.0,811.0,811.0
0.113,6,10,1506,5,395,23.0,127.0,127.0,5,1111,22.0,843.0,843.0
0.005,6,10,2006,5,927,1.0,659.0,659.0,5,1079,1.0,811.0,811.0
0.202,6,16,2674,8,1400,28.0,533.0,325.0,8,1274,18.0,529.0,212.0
0.004,17,2,136,1,60,0.0,32.0,32.0,1,76,0.0,48.0,48.0
240.107,6,32,9487,16,6892,16007.0,1963.0,673.0,16,2595,16006.0,580.0,219.0
0.012,6,10,1989,5,910,3.0,642.0,642.0,5,1079,3.0,811.0,811.0
0.105,6,10,1506,5,395,24.0,127.0,127.0,5,1111,25.0,843.0,843.0
0.004,6,10,2000,5,927,1.0,659.0,659.0,5,1073,1.0,805.0,805.0
0.107,6,10,1506,5,395,23.0,127.0,127.0,5,1111,23.0,843.0,843.0
0.004,6,10,2007,5,928,1.0,660.0,660.0,5,1079,1.0,811.0,811.0
0.074,6,10,1506,5,395,16.0,127.0,127.0,5,1111,16.0,843.0,843.0
0.009,6,10,1989,5,910,2.0,642.0,642.0,5,1079,2.0,811.0,811.0
240.023,6,9,787,5,488,60005.0,232.0,232.0,4,299,80004.0,83.0,83.0
240.023,6,9,787,5,488,60005.0,232.0,232.0,4,299,80007.0,83.0,83.0
0.069,6,10,1506,5,395,15.0,127.0,127.0,5,1111,14.0,843.0,843.0
0.005,6,10,2007,5,928,1.0,660.0,660.0,5,1079,1.0,811.0,811.0
0.005,6,10,1989,5,927,1.0,659.0,659.0,5,1062,1.0,794.0,794.0
0.079,6,10,1506,5,395,17.0,127.0,127.0,5,1111,16.0,843.0,843.0
0.006,6,10,2006,5,927,1.0,659.0,659.0,5,1079,1.0,811.0,811.0
0.011,6,10,1983,5,910,2.0,642.0,642.0,5,1073,2.0,805.0,805.0
0.049,6,10,1506,5,395,11.0,127.0,127.0,5,1111,11.0,843.0,843.0
0.014,6,10,1989,5,910,3.0,642.0,642.0,5,1079,3.0,811.0,811.0
0.014,6,10,1989,5,910,3.0,642.0,642.0,5,1079,3.0,811.0,811.0
40.057,17,10,676,5,460,10013.0,104.0,64.0,5,216,10013.0,20.0,15.0
0.008,6,13,3735,7,497,1.0,125.0,125.0,6,3238,1.0,1470.0,1459.0
0.005,6,10,2007,5,928,1.0,660.0,660.0,5,1079,1.0,811.0,811.0
352.9,6,20,2210,6,1308,12005.0,494.0,494.0,14,902,27145.0,83.0,83.0
40.073,17,10,676,5,460,10014.0,104.0,64.0,5,216,10017.0,20.0,15.0
0.005,6,10,1989,5,927,1.0,659.0,659.0,5,1062,1.0,794.0,794.0
0.01,17,4,284,2,120,0.0,32.0,32.0,2,164,1.0,60.0,54.0
0.008,6,10,1989,5,910,2.0,642.0,642.0,5,1079,2.0,811.0,811.0
0.005,6,10,1643,5,860,1.0,592.0,592.0,5,783,1.0,515.0,515.0
0.005,6,10,1689,5,839,1.0,571.0,571.0,5,850,1.0,582.0,582.0
295.426,6,20,3709,11,2232,29534.0,585.0,330.0,9,1477,36921.0,824.0,337.0
0.123,17,2,80,1,32,0.0,4.0,4.0,1,48,0.0,20.0,20.0
0.075,6,10,1989,5,910,18.0,642.0,642.0,5,1079,18.0,811.0,811.0
0.097,6,10,1506,5,395,22.0,127.0,127.0,5,1111,21.0,843.0,843.0
0.012,6,10,1983,5,910,3.0,642.0,642.0,5,1073,2.0,805.0,805.0
0.013,6,10,1972,5,910,3.0,642.0,642.0,5,1062,3.0,794.0,794.0
0.005,6,10,2000,5,927,1.0,659.0,659.0,5,1073,1.0,805.0,805.0
0.005,6,10,1989,5,927,1.0,659.0,659.0,5,1062,1.0,794.0,794.0
0.005,6,10,1779,5,928,1.0,660.0,660.0,5,851,1.0,583.0,583.0
302.747,6,27,7932,16,2116,20183.0,253.0,214.0,11,5816,30274.0,1402.0,654.0
0.003,17,2,148,1,60,0.0,32.0,32.0,1,88,0.0,60.0,60.0
0.007,6,10,1989,5,910,1.0,642.0,642.0,5,1079,1.0,811.0,811.0
0.015,6,10,1762,5,911,3.0,643.0,643.0,5,851,3.0,583.0,583.0
0.005,6,10,1854,5,889,1.0,621.0,621.0,5,965,1.0,697.0,697.0
0.08,6,10,1506,5,395,18.0,127.0,127.0,5,1111,15.0,843.0,843.0
0.011,6,10,1972,5,910,2.0,642.0,642.0,5,1062,2.0,794.0,794.0
0.003,17,2,148,1,60,0.0,32.0,32.0,1,88,0.0,60.0,60.0
0.001,17,2,180,1,66,0.0,38.0,38.0,1,114,0.0,86.0,86.0
0.004,6,10,1702,5,863,1.0,595.0,595.0,5,839,0.0,571.0,571.0
0.116,6,10,1506,5,395,24.0,127.0,127.0,5,1111,24.0,843.0,843.0
0.109,6,10,1506,5,395,24.0,127.0,127.0,5,1111,22.0,843.0,843.0
0.004,6,10,1989,5,927,1.0,659.0,659.0,5,1062,1.0,794.0,794.0
0.006,6,10,2006,5,927,1.0,659.0,659.0,5,1079,1.0,811.0,811.0
0.012,6,10,1983,5,910,3.0,642.0,642.0,5,1073,3.0,805.0,805.0
0.005,6,10,1774,5,923,1.0,655.0,655.0,5,851,1.0,583.0,583.0
0.011,6,10,1989,5,910,2.0,642.0,642.0,5,1079,2.0,811.0,811.0
0.011,6,10,1990,5,911,2.0,643.0,643.0,5,1079,2.0,811.0,811.0
0.002,17,2,132,1,58,0.0,30.0,30.0,1,74,0.0,46.0,46.0
0.005,6,10,1689,5,839,1.0,571.0,571.0,5,850,1.0,582.0,582.0
0.004,6,10,2006,5,927,1.0,659.0,659.0,5,1079,1.0,811.0,811.0
1778.17,17,144,45504,72,22752,25044.0,288.0,288.0,72,22752,25044.0,288.0,288.0
0.013,6,10,1983,5,910,3.0,642.0,642.0,5,1073,3.0,805.0,805.0
0.038,6,3,210,2,132,38.0,28.0,28.0,1,78,0.0,26.0,26.0
0.005,17,2,230,1,68,0.0,40.0,40.0,1,162,0.0,134.0,134.0
0.13,6,10,1506,5,395,27.0,127.0,127.0,5,1111,31.0,843.0,843.0
0.005,6,10,2007,5,928,1.0,660.0,660.0,5,1079,1.0,811.0,811.0
0.004,6,10,1779,5,928,1.0,660.0,660.0,5,851,1.0,583.0,583.0
0.004,6,10,2007,5,928,1.0,660.0,660.0,5,1079,1.0,811.0,811.0
0.007,6,10,1989,5,910,1.0,642.0,642.0,5,1079,1.0,811.0,811.0
0.005,6,10,1989,5,927,1.0,659.0,659.0,5,1062,1.0,794.0,794.0
0.074,6,10,1506,5,395,16.0,127.0,127.0,5,1111,16.0,843.0,843.0
240.376,6,25,8205,12,2283,21852.0,988.0,332.0,13,5922,20031.0,1665.0,654.0
0.092,6,10,1506,5,395,19.0,127.0,127.0,5,1111,21.0,843.0,843.0
0.007,6,10,1643,5,860,1.0,592.0,592.0,5,783,1.0,515.0,515.0
308.42,17,20,1124,10,716,34254.0,48.0,43.0,10,408,34251.0,20.0,12.0
0.042,17,4,596,2,122,1.0,33.0,33.0,2,474,1.0,323.0,209.0
0.088,6,10,1506,5,395,16.0,127.0,127.0,5,1111,19.0,843.0,843.0
0.004,6,10,2006,5,927,1.0,659.0,659.0,5,1079,1.0,811.0,811.0
0.006,6,10,1547,5,764,1.0,496.0,496.0,5,783,1.0,515.0,515.0
0.039,17,4,364,2,160,0.0,52.0,52.0,2,204,1.0,80.0,74.0
0.008,6,12,1926,6,1189,1.0,659.0,434.0,6,737,1.0,417.0,417.0
1788.646,6,334,38013,168,17892,10710.0,2736.0,480.0,166,20121,10840.0,1625.0,76.0
40.063,17,10,676,5,460,10014.0,104.0,64.0,5,216,10014.0,20.0,15.0
0.005,6,10,2007,5,928,1.0,660.0,660.0,5,1079,1.0,811.0,811.0
40.064,17,10,676,5,460,10015.0,104.0,64.0,5,216,10015.0,20.0,15.0
0.015,6,10,1631,5,848,3.0,580.0,580.0,5,783,3.0,515.0,515.0
0.122,6,10,1506,5,395,25.0,127.0,127.0,5,1111,25.0,843.0,843.0
0.115,6,10,1506,5,395,26.0,127.0,127.0,5,1111,25.0,843.0,843.0
0.09,6,10,1506,5,395,21.0,127.0,127.0,5,1111,17.0,843.0,843.0
0.195,6,10,1506,5,395,39.0,127.0,127.0,5,1111,47.0,843.0,843.0
0.005,17,2,180,1,58,0.0,30.0,30.0,1,122,0.0,94.0,94.0
0.011,6,10,1989,5,910,2.0,642.0,642.0,5,1079,2.0,811.0,811.0
0.109,6,10,1506,5,395,24.0,127.0,127.0,5,1111,23.0,843.0,843.0
0.096,6,10,1506,5,395,21.0,127.0,127.0,5,1111,18.0,843.0,843.0
0.004,6,10,2007,5,928,1.0,660.0,660.0,5,1079,1.0,811.0,811.0
0.009,6,10,1989,5,910,2.0,642.0,642.0,5,1079,2.0,811.0,811.0
0.006,6,10,1689,5,839,1.0,571.0,571.0,5,850,1.0,582.0,582.0
0.005,6,10,2006,5,927,1.0,659.0,659.0,5,1079,1.0,811.0,811.0
0.004,17,2,136,1,60,0.0,32.0,32.0,1,76,0.0,48.0,48.0
0.009,6,10,1989,5,927,2.0,659.0,659.0,5,1062,2.0,794.0,794.0
0.014,6,10,1762,5,911,3.0,643.0,643.0,5,851,3.0,583.0,583.0
0.011,6,10,1989,5,910,2.0,642.0,642.0,5,1079,2.0,811.0,811.0
0.006,17,2,170,1,65,0.0,37.0,37.0,1,105,0.0,77.0,77.0
0.019,6,10,1990,5,911,4.0,643.0,643.0,5,1079,4.0,811.0,811.0
0.001,17,2,180,1,66,0.0,38.0,38.0,1,114,0.0,86.0,86.0
0.005,6,14,3742,8,504,0.0,80.0,80.0,6,3238,1.0,1470.0,1459.0
0.011,6,10,1990,5,911,2.0,643.0,643.0,5,1079,2.0,811.0,811.0
0.009,6,10,1989,5,910,2.0,642.0,642.0,5,1079,2.0,811.0,811.0
0.008,6,10,1983,5,910,2.0,642.0,642.0,5,1073,1.0,805.0,805.0
0.012,17,2,180,1,66,0.0,38.0,38.0,1,114,0.0,86.0,86.0
0.004,6,10,2006,5,927,1.0,659.0,659.0,5,1079,1.0,811.0,811.0
0.204,6,16,2777,8,1395,29.0,533.0,323.0,8,1382,18.0,529.0,239.0
0.01,6,10,1989,5,910,2.0,642.0,642.0,5,1079,2.0,811.0,811.0
15.074,17,15,9238,8,6902,2149.0,1350.0,834.0,7,2336,2507.0,1350.0,305.0
1799.839,6,136,6550,76,3625,23997.0,39.0,39.0,60,2925,29993.0,35.0,35.0
0.001,17,2,166,1,75,0.0,47.0,47.0,1,91,0.0,63.0,63.0
0.004,6,10,2006,5,927,1.0,659.0,659.0,5,1079,1.0,811.0,811.0
0.005,6,10,2007,5,928,1.0,660.0,660.0,5,1079,1.0,811.0,811.0
0.001,17,2,180,1,66,0.0,38.0,38.0,1,114,0.0,86.0,86.0
0.005,17,2,166,1,75,0.0,47.0,47.0,1,91,0.0,63.0,63.0
0.006,6,10,1547,5,764,1.0,496.0,496.0,5,783,1.0,515.0,515.0
0.006,6,10,1689,5,839,1.0,571.0,571.0,5,850,1.0,582.0,582.0
0.001,17,2,180,1,65,0.0,37.0,37.0,1,115,0.0,87.0,87.0
0.014,6,10,1990,5,911,3.0,643.0,643.0,5,1079,3.0,811.0,811.0
0.009,6,10,1972,5,910,2.0,642.0,642.0,5,1062,2.0,794.0,794.0
0.012,6,13,3735,7,497,2.0,125.0,125.0,6,3238,2.0,1470.0,1459.0
40.086,17,10,676,5,460,10020.0,104.0,64.0,5,216,10020.0,20.0,15.0
0.02,6,10,1989,5,910,4.0,642.0,642.0,5,1079,5.0,811.0,811.0
176.047,17,76,10580,38,2530,4757.0,44.0,38.0,38,8050,4757.0,239.0,183.0
0.023,6,10,1990,5,911,5.0,643.0,643.0,5,1079,5.0,811.0,811.0
0.071,17,2,136,1,60,0.0,32.0,32.0,1,76,0.0,48.0,48.0
0.004,17,2,136,1,60,0.0,32.0,32.0,1,76,0.0,48.0,48.0
0.094,6,10,1506,5,395,21.0,127.0,127.0,5,1111,22.0,843.0,843.0
178.231,17,76,10827,38,2530,4816.0,44.0,38.0,38,8297,4816.0,249.0,190.0
40.067,17,10,676,5,460,10014.0,104.0,64.0,5,216,10015.0,20.0,15.0
0.108,6,10,1506,5,395,22.0,127.0,127.0,5,1111,23.0,843.0,843.0
0.104,6,10,1506,5,395,23.0,127.0,127.0,5,1111,23.0,843.0,843.0
0.005,6,10,1989,5,927,1.0,659.0,659.0,5,1062,1.0,794.0,794.0
0.215,6,16,2669,8,1395,30.0,533.0,323.0,8,1274,19.0,529.0,212.0
0.014,6,10,1989,5,910,3.0,642.0,642.0,5,1079,3.0,811.0,811.0
0.006,6,10,1547,5,764,1.0,496.0,496.0,5,783,1.0,515.0,515.0
66.47,58,3,216,2,144,66470.0,24.0,24.0,1,72,0.0,24.0,24.0
0.089,6,10,1506,5,395,20.0,127.0,127.0,5,1111,21.0,843.0,843.0
300.335,6,16,2170,9,684,37521.0,146.0,146.0,7,1486,50028.0,419.0,398.0
0.101,6,10,1506,5,395,22.0,127.0,127.0,5,1111,21.0,843.0,843.0
0.351,17,46,27915,27,24832,13.0,1350.0,891.0,19,3083,16.0,1350.0,134.0
0.013,6,10,1990,5,911,3.0,643.0,643.0,5,1079,3.0,811.0,811.0
0.011,6,10,1990,5,911,2.0,643.0,643.0,5,1079,2.0,811.0,811.0
40.058,17,10,676,5,460,10013.0,104.0,64.0,5,216,10013.0,20.0,15.0
0.003,17,2,152,1,76,0.0,48.0,48.0,1,76,0.0,48.0,48.0
0.04,17,4,364,2,160,0.0,52.0,52.0,2,204,0.0,80.0,74.0
0.034,6,13,3913,7,495,5.0,123.0,123.0,6,3418,6.0,1650.0,1549.0
0.019,6,10,1972,5,910,4.0,642.0,642.0,5,1062,4.0,794.0,794.0
0.005,6,10,2006,5,927,1.0,659.0,659.0,5,1079,1.0,811.0,811.0
0.004,6,10,2006,5,927,1.0,659.0,659.0,5,1079,1.0,811.0,811.0
0.016,6,10,1983,5,910,3.0,642.0,642.0,5,1073,3.0,805.0,805.0
0.006,6,10,1854,5,889,1.0,621.0,621.0,5,965,1.0,697.0,697.0
0.013,6,10,1990,5,911,3.0,643.0,643.0,5,1079,3.0,811.0,811.0
0.038,17,4,284,2,120,0.0,32.0,32.0,2,164,34.0,60.0,54.0
0.006,6,10,1547,5,764,1.0,496.0,496.0,5,783,1.0,515.0,515.0
0.016,6,10,1762,5,911,3.0,643.0,643.0,5,851,3.0,583.0,583.0
0.146,6,10,1506,5,395,35.0,127.0,127.0,5,1111,33.0,843.0,843.0
0.013,6,14,3787,7,497,2.0,125.0,125.0,7,3290,2.0,1448.0,972.0
0.011,6,10,1989,5,910,2.0,642.0,642.0,5,1079,2.0,811.0,811.0
0.004,17,2,148,1,60,0.0,32.0,32.0,1,88,0.0,60.0,60.0
0.005,17,2,164,1,74,0.0,46.0,46.0,1,90,0.0,62.0,62.0
0.1,6,10,1506,5,395,18.0,127.0,127.0,5,1111,22.0,843.0,843.0
0.103,6,10,1506,5,395,19.0,127.0,127.0,5,1111,21.0,843.0,843.0
0.004,6,10,2000,5,927,1.0,659.0,659.0,5,1073,1.0,805.0,805.0
40.061,17,10,676,5,460,10011.0,104.0,64.0,5,216,10013.0,20.0,15.0
0.125,6,10,1506,5,395,28.0,127.0,127.0,5,1111,27.0,843.0,843.0
0.008,6,10,1762,5,911,2.0,643.0,643.0,5,851,2.0,583.0,583.0
0.005,6,10,2006,5,927,1.0,659.0,659.0,5,1079,1.0,811.0,811.0
40.06,17,10,676,5,460,10011.0,104.0,64.0,5,216,10014.0,20.0,15.0
0.011,6,14,3787,7,497,1.0,125.0,125.0,7,3290,1.0,1448.0,972.0
0.017,6,10,1989,5,910,4.0,642.0,642.0,5,1079,4.0,811.0,811.0
0.001,17,2,136,1,60,0.0,32.0,32.0,1,76,0.0,48.0,48.0
1787.433,6,154,19574,92,13852,19642.0,302.0,302.0,62,5722,29302.0,83.0,83.0
0.041,17,2,152,1,76,0.0,48.0,48.0,1,76,0.0,48.0,48.0
0.005,6,10,1643,5,860,1.0,592.0,592.0,5,783,1.0,515.0,515.0
0.005,6,10,1702,5,863,1.0,595.0,595.0,5,839,1.0,571.0,571.0
0.006,6,10,1547,5,764,1.0,496.0,496.0,5,783,1.0,515.0,515.0
0.005,17,2,144,1,64,0.0,36.0,36.0,1,80,0.0,52.0,52.0
10.801,17,26,4103,13,1823,891.0,270.0,112.0,13,2280,891.0,587.0,147.0
0.005,6,10,2007,5,928,1.0,660.0,660.0,5,1079,1.0,811.0,811.0
0.016,17,2,198,1,91,0.0,63.0,63.0,1,107,0.0,79.0,79.0
0.005,6,10,2006,5,927,1.0,659.0,659.0,5,1079,1.0,811.0,811.0
0.007,6,10,1689,5,839,1.0,571.0,571.0,5,850,1.0,582.0,582.0
300.318,6,16,2170,9,684,37519.0,146.0,146.0,7,1486,50025.0,419.0,398.0
40.06,17,10,676,5,460,10013.0,104.0,64.0,5,216,10014.0,20.0,15.0
241.188,6,377,347719,180,20891,1347.0,2736.0,960.0,197,326828,1230.0,4127.0,1692.0
66.534,6,20,8232,11,1898,6653.0,986.0,439.0,9,6334,8295.0,2111.0,976.0
0.004,17,2,136,1,60,0.0,32.0,32.0,1,76,0.0,48.0,48.0
0.008,6,10,1972,5,910,2.0,642.0,642.0,5,1062,2.0,794.0,794.0
0.085,6,10,1506,5,395,19.0,127.0,127.0,5,1111,17.0,843.0,843.0
351.986,6,20,2210,6,1308,12003.0,494.0,494.0,14,902,27075.0,83.0,83.0
0.006,6,10,1547,5,764,1.0,496.0,496.0,5,783,1.0,515.0,515.0
0.102,6,10,1506,5,395,21.0,127.0,127.0,5,1111,21.0,843.0,843.0
0.076,6,10,1506,5,395,18.0,127.0,127.0,5,1111,16.0,843.0,843.0
240.096,6,16,4480,9,963,30012.0,238.0,166.0,7,3517,40013.0,1402.0,786.0
40.057,17,10,676,5,460,10013.0,104.0,64.0,5,216,10013.0,20.0,15.0
0.006,17,2,164,1,74,0.0,46.0,46.0,1,90,0.0,62.0,62.0
0.087,6,10,1506,5,395,20.0,127.0,127.0,5,1111,19.0,843.0,843.0
0.004,6,10,2000,5,927,1.0,659.0,659.0,5,1073,1.0,805.0,805.0
0.009,6,10,1989,5,910,2.0,642.0,642.0,5,1079,2.0,811.0,811.0
0.018,6,10,1631,5,848,4.0,580.0,580.0,5,783,4.0,515.0,515.0
0.005,6,10,2007,5,928,1.0,660.0,660.0,5,1079,1.0,811.0,811.0
0.005,6,10,2000,5,927,1.0,659.0,659.0,5,1073,1.0,805.0,805.0
0.099,6,10,1506,5,395,21.0,127.0,127.0,5,1111,22.0,843.0,843.0
0.001,17,2,180,1,66,0.0,38.0,38.0,1,114,0.0,86.0,86.0
40.063,17,10,676,5,460,10014.0,104.0,64.0,5,216,10014.0,20.0,15.0
0.151,6,10,1506,5,395,36.0,127.0,127.0,5,1111,36.0,843.0,843.0
0.005,6,10,2007,5,928,1.0,660.0,660.0,5,1079,1.0,811.0,811.0
0.012,6,10,1990,5,911,3.0,643.0,643.0,5,1079,3.0,811.0,811.0
0.096,6,10,1506,5,395,20.0,127.0,127.0,5,1111,18.0,843.0,843.0
0.025,6,10,1989,5,910,6.0,642.0,642.0,5,1079,6.0,811.0,811.0
0.007,6,10,1989,5,910,1.0,642.0,642.0,5,1079,1.0,811.0,811.0
0.039,6,10,1983,5,910,9.0,642.0,642.0,5,1073,9.0,805.0,805.0
361.854,6,21,1793,16,1030,24123.0,190.0,190.0,5,763,60012.0,462.0,247.0
0.004,6,10,2006,5,927,1.0,659.0,659.0,5,1079,1.0,811.0,811.0
0.006,6,10,1689,5,839,1.0,571.0,571.0,5,850,1.0,582.0,582.0
0.005,6,10,2006,5,927,1.0,659.0,659.0,5,1079,1.0,811.0,811.0
0.056,6,10,1506,5,395,12.0,127.0,127.0,5,1111,13.0,843.0,843.0
0.003,17,2,136,1,60,0.0,32.0,32.0,1,76,0.0,48.0,48.0
0.015,6,10,1631,5,848,3.0,580.0,580.0,5,783,3.0,515.0,515.0
0.063,6,10,1506,5,395,15.0,127.0,127.0,5,1111,14.0,843.0,843.0
0.178,17,4,352,2,130,107.0,37.0,37.0,2,222,174.0,89.0,83.0
40.062,17,10,676,5,460,10014.0,104.0,64.0,5,216,10014.0,20.0,15.0
0.005,6,10,1689,5,839,1.0,571.0,571.0,5,850,1.0,582.0,582.0
0.009,17,2,166,1,75,0.0,47.0,47.0,1,91,0.0,63.0,63.0
0.019,6,10,1972,5,910,4.0,642.0,642.0,5,1062,4.0,794.0,794.0
0.005,6,10,2006,5,927,1.0,659.0,659.0,5,1079,1.0,811.0,811.0
1.016,6,12,3142,6,2099,153.0,1328.0,923.0,6,1043,153.0,791.0,791.0
0.078,6,10,1506,5,395,17.0,127.0,127.0,5,1111,17.0,843.0,843.0
0.004,17,2,136,1,60,0.0,32.0,32.0,1,76,0.0,48.0,48.0
0.004,6,10,2006,5,927,1.0,659.0,659.0,5,1079,1.0,811.0,811.0
0.179,17,16,8824,8,6330,25.0,1350.0,763.0,8,2494,17.0,1350.0,283.0
240.093,6,16,4482,9,963,30011.0,238.0,166.0,7,3519,40015.0,1402.0,786.0
0.041,17,2,182,1,65,0.0,37.0,37.0,1,117,0.0,89.0,89.0
0.004,6,10,2006,5,927,1.0,659.0,659.0,5,1079,1.0,811.0,811.0
0.129,17,2,184,1,61,0.0,33.0,33.0,1,123,0.0,95.0,95.0
371.492,6,22,2313,16,867,24766.0,195.0,195.0,6,1446,4636.0,419.0,398.0
0.074,6,10,1506,5,395,16.0,127.0,127.0,5,1111,17.0,843.0,843.0
0.004,6,10,1989,5,927,1.0,659.0,659.0,5,1062,1.0,794.0,794.0
0.011,6,10,1972,5,910,2.0,642.0,642.0,5,1062,2.0,794.0,794.0
0.04,6,14,3787,7,497,6.0,125.0,125.0,7,3290,6.0,1448.0,972.0
362.796,6,39,16243,20,3092,19094.0,676.0,408.0,19,13151,20155.0,1402.0,935.0
0.006,6,12,1698,6,863,1.0,327.0,271.0,6,835,1.0,515.0,515.0
0.004,6,10,2000,5,927,1.0,659.0,659.0,5,1073,1.0,805.0,805.0
0.013,6,10,1990,5,911,3.0,643.0,643.0,5,1079,3.0,811.0,811.0
0.084,6,10,1506,5,395,19.0,127.0,127.0,5,1111,19.0,843.0,843.0
0.003,6,10,1702,5,863,0.0,595.0,595.0,5,839,0.0,571.0,571.0
0.005,6,10,2000,5,927,1.0,659.0,659.0,5,1073,1.0,805.0,805.0
0.005,17,2,169,1,62,0.0,34.0,34.0,1,107,0.0,79.0,79.0
0.013,6,10,1989,5,910,3.0,642.0,642.0,5,1079,3.0,811.0,811.0
0.005,6,10,1989,5,927,1.0,659.0,659.0,5,1062,1.0,794.0,794.0
0.013,6,10,1983,5,910,3.0,642.0,642.0,5,1073,3.0,805.0,805.0
0.005,6,10,1779,5,928,1.0,660.0,660.0,5,851,1.0,583.0,583.0
0.01,6,10,1990,5,911,2.0,643.0,643.0,5,1079,2.0,811.0,811.0
0.037,17,2,144,1,64,0.0,36.0,36.0,1,80,0.0,52.0,52.0
0.01,6,10,1631,5,848,2.0,580.0,580.0,5,783,2.0,515.0,515.0
0.982,6,32,16215,18,9711,57.0,2720.0,1119.0,14,6504,62.0,2720.0,988.0
294.014,6,386,347803,194,21661,1523.0,2736.0,889.0,192,326142,1539.0,2804.0,1776.0
0.288,17,40,20317,21,17042,14.0,1350.0,783.0,19,3275,13.0,1350.0,144.0
0.073,6,10,1506,5,395,17.0,127.0,127.0,5,1111,14.0,843.0,843.0
0.006,6,10,1854,5,889,1.0,621.0,621.0,5,965,1.0,697.0,697.0
0.005,6,10,2000,5,927,1.0,659.0,659.0,5,1073,1.0,805.0,805.0
0.004,17,2,170,1,65,0.0,37.0,37.0,1,105,0.0,77.0,77.0
0.001,17,2,178,1,81,0.0,53.0,53.0,1,97,0.0,69.0,69.0
0.006,6,10,1689,5,839,1.0,571.0,571.0,5,850,1.0,582.0,582.0
240.028,6,9,787,5,488,60007.0,232.0,232.0,4,299,80008.0,83.0,83.0
40.089,17,10,676,5,460,10020.0,104.0,64.0,5,216,10021.0,20.0,15.0
0.011,6,10,1983,5,910,2.0,642.0,642.0,5,1073,2.0,805.0,805.0
0.009,6,10,1990,5,911,2.0,643.0,643.0,5,1079,2.0,811.0,811.0
15.08,17,15,8217,8,6023,2150.0,1350.0,724.0,7,2194,2508.0,1350.0,285.0
300.306,6,16,2170,9,684,37517.0,146.0,146.0,7,1486,50023.0,419.0,398.0
10.736,17,28,4419,14,1994,817.0,269.0,114.0,14,2425,817.0,588.0,145.0
0.087,6,10,1506,5,395,20.0,127.0,127.0,5,1111,17.0,843.0,843.0
0.105,6,10,1506,5,395,19.0,127.0,127.0,5,1111,22.0,843.0,843.0
0.131,6,10,1506,5,395,29.0,127.0,127.0,5,1111,29.0,843.0,843.0
0.005,6,10,1989,5,927,1.0,659.0,659.0,5,1062,1.0,794.0,794.0
0.011,6,10,1972,5,910,2.0,642.0,642.0,5,1062,2.0,794.0,794.0
0.054,17,2,152,1,76,0.0,48.0,48.0,1,76,0.0,48.0,48.0
0.01,6,12,1926,6,1189,2.0,659.0,434.0,6,737,2.0,417.0,417.0
0.109,6,10,1506,5,395,24.0,127.0,127.0,5,1111,24.0,843.0,843.0
300.309,6,16,2170,9,684,37518.0,146.0,146.0,7,1486,50024.0,419.0,398.0
174.108,17,78,11169,39,2598,4581.0,44.0,38.0,39,8571,4581.0,239.0,191.0
0.11,6,10,1506,5,395,25.0,127.0,127.0,5,1111,23.0,843.0,843.0
0.008,6,12,1926,6,1189,1.0,659.0,434.0,6,737,1.0,417.0,417.0
0.004,6,10,2006,5,927,1.0,659.0,659.0,5,1079,1.0,811.0,811.0
0.005,6,10,2000,5,927,1.0,659.0,659.0,5,1073,1.0,805.0,805.0
0.005,6,10,1643,5,860,1.0,592.0,592.0,5,783,1.0,515.0,515.0
0.006,6,10,2006,5,927,1.0,659.0,659.0,5,1079,1.0,811.0,811.0
0.012,6,10,1972,5,910,2.0,642.0,642.0,5,1062,3.0,794.0,794.0
0.078,6,10,1506,5,395,17.0,127.0,127.0,5,1111,19.0,843.0,843.0
0.006,17,2,170,1,65,0.0,37.0,37.0,1,105,0.0,77.0,77.0
0.068,6,10,1506,5,395,16.0,127.0,127.0,5,1111,15.0,843.0,843.0
40.071,17,10,676,5,460,10016.0,104.0,64.0,5,216,10016.0,20.0,15.0
0.006,6,10,1643,5,860,1.0,592.0,592.0,5,783,1.0,515.0,515.0
0.251,17,47,29323,28,26195,9.0,1350.0,907.0,19,3128,11.0,1350.0,136.0
0.006,17,2,160,1,72,0.0,44.0,44.0,1,88,0.0,60.0,60.0
0.101,6,10,1506,5,395,20.0,127.0,127.0,5,1111,20.0,843.0,843.0
0.01,6,10,1989,5,910,2.0,642.0,642.0,5,1079,2.0,811.0,811.0
0.001,17,2,136,1,60,0.0,32.0,32.0,1,76,0.0,48.0,48.0
40.072,17,10,676,5,460,10017.0,104.0,64.0,5,216,10017.0,20.0,15.0
0.112,6,10,1506,5,395,23.0,127.0,127.0,5,1111,25.0,843.0,843.0
0.001,17,2,180,1,65,0.0,37.0,37.0,1,115,0.0,87.0,87.0
0.006,6,10,1643,5,860,1.0,592.0,592.0,5,783,1.0,515.0,515.0
11.146,17,28,4400,14,2313,848.0,588.0,137.0,14,2087,848.0,270.0,121.0
0.016,6,10,1989,5,910,3.0,642.0,642.0,5,1079,4.0,811.0,811.0
0.006,6,10,1854,5,889,1.0,621.0,621.0,5,965,1.0,697.0,697.0
0.005,6,10,1854,5,889,1.0,621.0,621.0,5,965,1.0,697.0,697.0
0.005,6,10,1689,5,839,1.0,571.0,571.0,5,850,1.0,582.0,582.0
0.089,6,10,1506,5,395,22.0,127.0,127.0,5,1111,19.0,843.0,843.0
1772.701,17,120,11460,60,5460,30045.0,63.0,63.0,60,6000,30045.0,72.0,72.0
0.062,17,2,80,1,32,0.0,4.0,4.0,1,48,0.0,20.0,20.0
0.085,6,10,1506,5,395,19.0,127.0,127.0,5,1111,16.0,843.0,843.0
0.01,6,13,3735,7,497,1.0,125.0,125.0,6,3238,1.0,1470.0,1459.0
0.105,6,10,1506,5,395,21.0,127.0,127.0,5,1111,23.0,843.0,843.0
0.005,6,10,1643,5,860,1.0,592.0,592.0,5,783,1.0,515.0,515.0
0.164,6,10,1506,5,395,38.0,127.0,127.0,5,1111,35.0,843.0,843.0
0.005,6,10,2006,5,927,1.0,659.0,659.0,5,1079,1.0,811.0,811.0
0.012,6,10,1989,5,910,2.0,642.0,642.0,5,1079,2.0,811.0,811.0
0.082,6,10,1506,5,395,16.0,127.0,127.0,5,1111,17.0,843.0,843.0
0.006,6,10,1547,5,764,1.0,496.0,496.0,5,783,1.0,515.0,515.0
0.066,6,10,1506,5,395,15.0,127.0,127.0,5,1111,13.0,843.0,843.0
0.012,6,10,1677,5,827,3.0,559.0,559.0,5,850,3.0,582.0,582.0
0.007,17,2,136,1,60,0.0,32.0,32.0,1,76,0.0,48.0,48.0
0.005,6,10,1689,5,839,1.0,571.0,571.0,5,850,1.0,582.0,582.0
15.07,17,15,9238,8,6902,2148.0,1350.0,834.0,7,2336,2506.0,1350.0,305.0
0.017,6,10,1989,5,910,4.0,642.0,642.0,5,1079,4.0,811.0,811.0
40.068,17,10,676,5,460,10016.0,104.0,64.0,5,216,10016.0,20.0,15.0
0.004,6,10,2006,5,927,1.0,659.0,659.0,5,1079,1.0,811.0,811.0
0.017,6,10,1989,5,910,4.0,642.0,642.0,5,1079,4.0,811.0,811.0
0.077,6,10,1506,5,395,17.0,127.0,127.0,5,1111,18.0,843.0,843.0
0.011,6,10,1990,5,911,2.0,643.0,643.0,5,1079,2.0,811.0,811.0
0.008,6,10,1989,5,910,2.0,642.0,642.0,5,1079,2.0,811.0,811.0
300.336,6,16,2170,9,684,37521.0,146.0,146.0,7,1486,50029.0,419.0,398.0
0.072,17,2,412,1,61,0.0,33.0,33.0,1,351,0.0,323.0,323.0
372.102,6,21,1794,16,1030,24806.0,190.0,190.0,5,764,60018.0,463.0,248.0
0.005,6,10,1854,5,889,1.0,621.0,621.0,5,965,1.0,697.0,697.0
11.111,17,28,4421,14,1994,842.0,269.0,114.0,14,2427,842.0,586.0,145.0
0.001,17,2,166,1,75,0.0,47.0,47.0,1,91,0.0,63.0,63.0
0.009,6,10,1972,5,910,2.0,642.0,642.0,5,1062,2.0,794.0,794.0
0.011,6,10,1972,5,910,2.0,642.0,642.0,5,1062,2.0,794.0,794.0
0.003,17,2,136,1,60,0.0,32.0,32.0,1,76,0.0,48.0,48.0
0.004,6,10,2006,5,927,1.0,659.0,659.0,5,1079,1.0,811.0,811.0
0.016,6,10,1677,5,827,4.0,559.0,559.0,5,850,3.0,582.0,582.0
40.043,17,10,676,5,460,10009.0,104.0,64.0,5,216,10010.0,20.0,15.0
169.346,17,80,11016,40,2671,4341.0,44.0,38.0,40,8345,4342.0,239.0,180.0
9.037,17,6,376,5,280,2259.0,28.0,28.0,1,96,0.0,68.0,68.0
162.225,6,22,9233,11,1575,73.0,794.0,367.0,11,7658,16209.0,1360.0,1029.0
0.135,6,10,1506,5,395,31.0,127.0,127.0,5,1111,29.0,843.0,843.0
0.012,6,10,1631,5,848,3.0,580.0,580.0,5,783,3.0,515.0,515.0
241.65,6,372,347455,192,21503,1265.0,2736.0,959.0,180,325952,1349.0,2804.0,1862.0
1756.068,6,105,6270,60,3525,29763.0,27.0,27.0,45,2745,39909.0,27.0,27.0
309.246,17,20,1124,10,716,34346.0,48.0,43.0,10,408,34346.0,20.0,12.0
0.005,17,2,170,1,65,0.0,37.0,37.0,1,105,0.0,77.0,77.0
0.004,6,10,1989,5,927,1.0,659.0,659.0,5,1062,1.0,794.0,794.0
0.005,6,10,1854,5,889,1.0,621.0,621.0,5,965,1.0,697.0,697.0
15.085,17,15,8255,8,6113,2150.0,1350.0,736.0,7,2142,2509.0,1350.0,278.0
0.006,6,10,1547,5,764,1.0,496.0,496.0,5,783,1.0,515.0,515.0
240.011,6,9,787,5,488,60002.0,232.0,232.0,4,299,80003.0,83.0,83.0
0.006,17,2,230,1,68,0.0,40.0,40.0,1,162,0.0,134.0,134.0
0.812,6,10,2009,6,1655,162.0,1403.0,1403.0,4,354,194.0,182.0,182.0
0.087,6,10,1506,5,395,21.0,127.0,127.0,5,1111,18.0,843.0,843.0
0.008,6,10,1989,5,910,2.0,642.0,642.0,5,1079,1.0,811.0,811.0
0.007,6,10,1762,5,911,1.0,643.0,643.0,5,851,1.0,583.0,583.0
0.315,17,42,20676,22,17101,15.0,1350.0,749.0,20,3575,13.0,1350.0,150.0
0.001,17,2,180,1,66,0.0,38.0,38.0,1,114,0.0,86.0,86.0
0.004,17,2,185,1,73,0.0,45.0,45.0,1,112,0.0,84.0,84.0
0.005,6,10,1689,5,839,1.0,571.0,571.0,5,850,1.0,582.0,582.0
40.065,17,10,676,5,460,10009.0,104.0,64.0,5,216,10012.0,20.0,15.0
0.005,17,2,178,1,65,0.0,37.0,37.0,1,113,0.0,85.0,85.0
0.005,6,10,2007,5,928,1.0,660.0,660.0,5,1079,1.0,811.0,811.0
65.694,6,22,10162,12,3995,5972.0,1601.0,840.0,10,6167,7280.0,2111.0,939.0
0.006,6,10,1854,5,889,1.0,621.0,621.0,5,965,1.0,697.0,697.0
0.008,6,10,1989,5,910,2.0,642.0,642.0,5,1079,1.0,811.0,811.0
0.013,6,10,1677,5,827,3.0,559.0,559.0,5,850,3.0,582.0,582.0
314.434,17,20,1124,10,716,34924.0,48.0,43.0,10,408,34926.0,20.0,12.0
15.077,17,16,8757,8,6451,2149.0,1350.0,778.0,8,2306,2149.0,1350.0,260.0
0.009,6,10,1990,5,911,2.0,643.0,643.0,5,1079,2.0,811.0,811.0
0.005,6,10,2007,5,928,1.0,660.0,660.0,5,1079,1.0,811.0,811.0
0.005,6,10,1854,5,889,1.0,621.0,621.0,5,965,1.0,697.0,697.0
0.185,17,4,352,2,130,144.0,37.0,37.0,2,222,147.0,89.0,83.0
0.183,6,44,11550,24,3222,7.0,1022.0,197.0,20,8328,9.0,1402.0,606.0
0.005,6,14,3742,7,452,0.0,80.0,80.0,7,3290,0.0,1448.0,972.0
0.09,6,10,1506,5,395,17.0,127.0,127.0,5,1111,19.0,843.0,843.0
40.078,17,10,676,5,460,10017.0,104.0,64.0,5,216,10018.0,20.0,15.0
0.062,17,2,80,1,32,0.0,4.0,4.0,1,48,0.0,20.0,20.0
0.004,6,10,2006,5,927,1.0,659.0,659.0,5,1079,1.0,811.0,811.0
0.048,6,10,1990,5,911,11.0,643.0,643.0,5,1079,11.0,811.0,811.0
0.011,6,10,1989,5,910,2.0,642.0,642.0,5,1079,2.0,811.0,811.0
0.023,6,10,1990,5,911,5.0,643.0,643.0,5,1079,5.0,811.0,811.0
0.008,6,10,1990,5,911,2.0,643.0,643.0,5,1079,2.0,811.0,811.0
0.004,17,2,136,1,60,0.0,32.0,32.0,1,76,0.0,48.0,48.0
0.004,17,2,148,1,60,0.0,32.0,32.0,1,88,0.0,60.0,60.0
0.124,17,2,182,1,65,0.0,37.0,37.0,1,117,0.0,89.0,89.0
0.014,6,10,1972,5,910,3.0,642.0,642.0,5,1062,3.0,794.0,794.0
564.008,17,6,474,3,189,282001.0,35.0,35.0,3,285,282001.0,67.0,67.0
0.01,6,10,1677,5,827,2.0,559.0,559.0,5,850,2.0,582.0,582.0
367.242,6,22,2313,16,867,24482.0,195.0,195.0,6,1446,4634.0,419.0,398.0
0.065,6,10,1506,5,395,16.0,127.0,127.0,5,1111,14.0,843.0,843.0
308.472,17,20,1124,10,716,34260.0,48.0,43.0,10,408,34260.0,20.0,12.0
0.219,6,16,2778,8,1396,31.0,533.0,324.0,8,1382,20.0,529.0,239.0
0.006,6,10,1547,5,764,1.0,496.0,496.0,5,783,1.0,515.0,515.0
0.118,17,4,352,2,130,76.0,37.0,37.0,2,222,45.0,89.0,83.0
242.336,6,315,344149,120,17764,2036.0,2736.0,886.0,195,326385,1249.0,2804.0,1709.0
0.019,6,13,3735,7,497,3.0,125.0,125.0,6,3238,3.0,1470.0,1459.0
0.012,6,10,1989,5,910,3.0,642.0,642.0,5,1079,2.0,811.0,811.0
0.071,17,8,3613,4,1874,23.0,1350.0,440.0,4,1739,12.0,1350.0,406.0
0.005,6,10,2007,5,928,1.0,660.0,660.0,5,1079,1.0,811.0,811.0
0.011,6,10,1989,5,910,2.0,642.0,642.0,5,1079,2.0,811.0,811.0
310.784,17,20,1124,10,716,34518.0,48.0,43.0,10,408,34518.0,20.0,12.0
0.005,6,10,2007,5,928,1.0,660.0,660.0,5,1079,1.0,811.0,811.0
0.04,17,2,148,1,60,0.0,32.0,32.0,1,88,0.0,60.0,60.0
0.005,17,2,178,1,65,0.0,37.0,37.0,1,113,0.0,85.0,85.0
0.012,6,10,1989,5,910,2.0,642.0,642.0,5,1079,3.0,811.0,811.0
0.122,6,10,1506,5,395,26.0,127.0,127.0,5,1111,29.0,843.0,843.0
1769.59,6,561,191208,288,164686,6165.0,2883.0,907.0,273,26522,6505.0,580.0,120.0
0.013,6,10,1990,5,911,3.0,643.0,643.0,5,1079,3.0,811.0,811.0
0.006,6,10,1547,5,764,1.0,496.0,496.0,5,783,1.0,515.0,515.0
11.382,17,28,4422,14,1994,863.0,269.0,114.0,14,2428,863.0,587.0,145.0
0.07,17,8,3613,4,1874,23.0,1350.0,440.0,4,1739,11.0,1350.0,406.0
0.006,6,10,1854,5,889,1.0,621.0,621.0,5,965,1.0,697.0,697.0
0.07,17,8,3613,4,1874,23.0,1350.0,440.0,4,1739,11.0,1350.0,406.0
0.017,6,10,1631,5,848,4.0,580.0,580.0,5,783,4.0,515.0,515.0
0.005,17,2,144,1,64,0.0,36.0,36.0,1,80,0.0,52.0,52.0
0.005,6,10,2006,5,927,1.0,659.0,659.0,5,1079,1.0,811.0,811.0
0.037,17,4,284,2,120,0.0,32.0,32.0,2,164,33.0,60.0,54.0
240.013,6,9,787,5,488,60003.0,232.0,232.0,4,299,80003.0,83.0,83.0
0.099,6,10,1506,5,395,21.0,127.0,127.0,5,1111,21.0,843.0,843.0
10.824,17,26,4103,13,1823,893.0,270.0,112.0,13,2280,893.0,587.0,147.0
240.164,6,24,4124,11,1756,24016.0,539.0,235.0,13,2368,20013.0,1322.0,242.0
0.006,6,10,1547,5,764,1.0,496.0,496.0,5,783,1.0,515.0,515.0
0.052,17,2,152,1,76,0.0,48.0,48.0,1,76,0.0,48.0,48.0
240.016,6,9,787,5,488,60004.0,232.0,232.0,4,299,80004.0,83.0,83.0
0.067,17,8,3613,4,1874,22.0,1350.0,440.0,4,1739,11.0,1350.0,406.0
10.773,17,28,4422,14,1994,820.0,269.0,114.0,14,2428,820.0,587.0,145.0
0.078,6,10,1506,5,395,17.0,127.0,127.0,5,1111,16.0,843.0,843.0
0.112,6,10,1506,5,395,27.0,127.0,127.0,5,1111,23.0,843.0,843.0
0.008,6,10,1972,5,910,1.0,642.0,642.0,5,1062,2.0,794.0,794.0
0.012,6,10,1972,5,910,2.0,642.0,642.0,5,1062,3.0,794.0,794.0
0.113,6,10,1506,5,395,26.0,127.0,127.0,5,1111,26.0,843.0,843.0
308.985,17,20,1124,10,716,34316.0,48.0,43.0,10,408,34316.0,20.0,12.0
0.005,6,10,2000,5,927,1.0,659.0,659.0,5,1073,1.0,805.0,805.0
0.068,6,10,1506,5,395,15.0,127.0,127.0,5,1111,14.0,843.0,843.0
0.124,17,2,148,1,60,0.0,32.0,32.0,1,88,0.0,60.0,60.0
0.067,6,10,1506,5,395,15.0,127.0,127.0,5,1111,14.0,843.0,843.0
40.075,17,10,676,5,460,10015.0,104.0,64.0,5,216,10016.0,20.0,15.0
0.011,6,10,1990,5,911,2.0,643.0,643.0,5,1079,2.0,811.0,811.0
0.069,17,8,3613,4,1874,23.0,1350.0,440.0,4,1739,11.0,1350.0,406.0
0.113,6,10,1506,5,395,25.0,127.0,127.0,5,1111,25.0,843.0,843.0
0.161,17,2,152,1,76,0.0,48.0,48.0,1,76,0.0,48.0,48.0
0.176,6,10,1506,5,395,42.0,127.0,127.0,5,1111,40.0,843.0,843.0
0.024,6,10,1989,5,910,6.0,642.0,642.0,5,1079,6.0,811.0,811.0
40.066,17,10,676,5,460,10015.0,104.0,64.0,5,216,10015.0,20.0,15.0
0.073,6,10,1506,5,395,17.0,127.0,127.0,5,1111,15.0,843.0,843.0
0.078,6,10,1506,5,395,18.0,127.0,127.0,5,1111,15.0,843.0,843.0
0.009,6,10,1677,5,827,2.0,559.0,559.0,5,850,2.0,582.0,582.0
1770.819,6,135,6510,75,3585,23926.0,39.0,39.0,60,2925,30009.0,35.0,35.0
0.005,6,10,2000,5,927,1.0,659.0,659.0,5,1073,1.0,805.0,805.0
0.005,6,10,2006,5,927,1.0,659.0,659.0,5,1079,1.0,811.0,811.0
0.004,6,10,1989,5,927,1.0,659.0,659.0,5,1062,1.0,794.0,794.0
175.155,17,78,10906,39,2599,4609.0,44.0,38.0,39,8307,4609.0,261.0,185.0
240.086,6,28,20266,15,1824,17149.0,770.0,349.0,13,18442,20006.0,2804.0,1775.0
0.003,17,4,284,2,120,0.0,32.0,32.0,2,164,0.0,60.0,54.0
1794.949,6,555,190810,275,163649,6550.0,2883.0,945.0,280,27161,6433.0,580.0,123.0
0.005,17,2,164,1,74,0.0,46.0,46.0,1,90,0.0,62.0,62.0
0.005,6,10,1989,5,927,1.0,659.0,659.0,5,1062,1.0,794.0,794.0
0.01,6,10,1989,5,910,2.0,642.0,642.0,5,1079,2.0,811.0,811.0
0.004,17,2,148,1,60,0.0,32.0,32.0,1,88,0.0,60.0,60.0
0.017,6,10,1972,5,910,4.0,642.0,642.0,5,1062,4.0,794.0,794.0
0.012,17,4,284,2,120,2.0,32.0,32.0,2,164,3.0,60.0,54.0
0.132,6,10,1506,5,395,30.0,127.0,127.0,5,1111,32.0,843.0,843.0
0.005,6,10,1989,5,927,1.0,659.0,659.0,5,1062,1.0,794.0,794.0
0.018,6,10,1631,5,848,4.0,580.0,580.0,5,783,4.0,515.0,515.0
0.1,6,10,1506,5,395,23.0,127.0,127.0,5,1111,22.0,843.0,843.0
0.009,6,10,1972,5,910,2.0,642.0,642.0,5,1062,2.0,794.0,794.0
0.013,6,10,1989,5,910,3.0,642.0,642.0,5,1079,3.0,811.0,811.0
0.006,6,10,1547,5,764,1.0,496.0,496.0,5,783,1.0,515.0,515.0
0.004,6,10,2000,5,927,1.0,659.0,659.0,5,1073,1.0,805.0,805.0
0.015,6,10,1990,5,911,3.0,643.0,643.0,5,1079,3.0,811.0,811.0
0.009,6,10,1972,5,910,2.0,642.0,642.0,5,1062,2.0,794.0,794.0
0.014,6,10,1990,5,911,3.0,643.0,643.0,5,1079,3.0,811.0,811.0
0.004,6,10,2006,5,927,1.0,659.0,659.0,5,1079,1.0,811.0,811.0
0.006,6,10,1689,5,839,1.0,571.0,571.0,5,850,1.0,582.0,582.0
0.005,6,10,1774,5,923,1.0,655.0,655.0,5,851,1.0,583.0,583.0
0.006,17,2,170,1,65,0.0,37.0,37.0,1,105,0.0,77.0,77.0
1730.428,6,48,2957,31,1800,57680.0,35.0,35.0,17,1157,108147.0,31.0,31.0
0.005,6,10,2000,5,927,1.0,659.0,659.0,5,1073,1.0,805.0,805.0
0.004,6,10,2006,5,927,1.0,659.0,659.0,5,1079,1.0,811.0,811.0
0.014,6,10,1990,5,911,3.0,643.0,643.0,5,1079,3.0,811.0,811.0
15.075,17,15,9238,8,6902,2149.0,1350.0,834.0,7,2336,2507.0,1350.0,305.0
40.066,17,10,676,5,460,10012.0,104.0,64.0,5,216,10014.0,20.0,15.0
0.005,6,10,2007,5,928,1.0,660.0,660.0,5,1079,1.0,811.0,811.0
0.101,6,10,1506,5,395,17.0,127.0,127.0,5,1111,18.0,843.0,843.0
0.004,6,10,1779,5,928,1.0,660.0,660.0,5,851,1.0,583.0,583.0
0.011,6,10,1990,5,911,2.0,643.0,643.0,5,1079,2.0,811.0,811.0
0.005,6,10,2007,5,928,1.0,660.0,660.0,5,1079,1.0,811.0,811.0
0.009,6,13,3735,7,497,1.0,125.0,125.0,6,3238,1.0,1470.0,1459.0
0.001,17,2,180,1,65,0.0,37.0,37.0,1,115,0.0,87.0,87.0
0.016,6,10,1983,5,910,4.0,642.0,642.0,5,1073,3.0,805.0,805.0
0.039,17,2,136,1,60,0.0,32.0,32.0,1,76,0.0,48.0,48.0
0.005,6,10,1643,5,860,1.0,592.0,592.0,5,783,1.0,515.0,515.0
0.124,17,2,80,1,32,0.0,4.0,4.0,1,48,0.0,20.0,20.0
300.291,6,27,7433,16,1409,20019.0,217.0,142.0,11,6024,24025.0,1679.0,777.0
240.023,6,9,787,5,488,60005.0,232.0,232.0,4,299,80006.0,83.0,83.0
0.081,6,10,1506,5,395,19.0,127.0,127.0,5,1111,19.0,843.0,843.0
0.014,6,10,1989,5,910,3.0,642.0,642.0,5,1079,3.0,811.0,811.0
0.147,6,10,1506,5,395,32.0,127.0,127.0,5,1111,35.0,843.0,843.0
0.015,6,10,1990,5,911,3.0,643.0,643.0,5,1079,3.0,811.0,811.0
1774.146,6,554,190359,279,164040,6381.0,2883.0,952.0,275,26319,6474.0,580.0,117.0
240.01,6,9,787,5,488,60002.0,232.0,232.0,4,299,80002.0,83.0,83.0
0.052,6,13,3735,7,497,8.0,125.0,125.0,6,3238,10.0,1470.0,1459.0
1778.772,17,144,45504,72,22752,25053.0,288.0,288.0,72,22752,25053.0,288.0,288.0
0.004,17,4,284,2,120,0.0,32.0,32.0,2,164,1.0,60.0,54.0
0.015,6,10,1989,5,910,3.0,642.0,642.0,5,1079,3.0,811.0,811.0
0.06,17,2,80,1,32,0.0,4.0,4.0,1,48,0.0,20.0,20.0
0.003,17,2,148,1,60,0.0,32.0,32.0,1,88,0.0,60.0,60.0
0.038,17,2,234,1,61,0.0,33.0,33.0,1,173,0.0,145.0,145.0
0.001,17,2,136,1,60,0.0,32.0,32.0,1,76,0.0,48.0,48.0
0.006,6,10,1547,5,764,1.0,496.0,496.0,5,783,1.0,515.0,515.0
0.005,6,10,2007,5,928,1.0,660.0,660.0,5,1079,1.0,811.0,811.0
0.006,6,10,2006,5,927,1.0,659.0,659.0,5,1079,1.0,811.0,811.0
0.009,6,10,1677,5,827,2.0,559.0,559.0,5,850,2.0,582.0,582.0
0.005,6,10,2006,5,927,1.0,659.0,659.0,5,1079,1.0,811.0,811.0
0.001,17,2,180,1,66,0.0,38.0,38.0,1,114,0.0,86.0,86.0
0.091,6,10,1506,5,395,18.0,127.0,127.0,5,1111,21.0,843.0,843.0
308.453,17,20,1124,10,716,34256.0,48.0,43.0,10,408,34256.0,20.0,12.0
0.112,6,10,1506,5,395,23.0,127.0,127.0,5,1111,23.0,843.0,843.0
0.065,6,10,1506,5,395,14.0,127.0,127.0,5,1111,13.0,843.0,843.0
1.236,6,11,1566,6,455,245.0,127.0,127.0,5,1111,16.0,843.0,843.0
0.007,6,10,1854,5,889,1.0,621.0,621.0,5,965,1.0,697.0,697.0
0.065,6,10,1506,5,395,14.0,127.0,127.0,5,1111,14.0,843.0,843.0
0.011,6,10,1989,5,910,2.0,642.0,642.0,5,1079,2.0,811.0,811.0
0.005,6,10,1854,5,889,1.0,621.0,621.0,5,965,1.0,697.0,697.0
0.005,6,10,1989,5,927,1.0,659.0,659.0,5,1062,1.0,794.0,794.0
0.018,6,10,1762,5,911,4.0,643.0,643.0,5,851,4.0,583.0,583.0
0.006,6,10,2000,5,927,1.0,659.0,659.0,5,1073,1.0,805.0,805.0
0.268,6,19,3557,9,1598,28.0,533.0,280.0,10,1959,25.0,529.0,286.0
0.094,6,10,1506,5,395,21.0,127.0,127.0,5,1111,18.0,843.0,843.0
0.071,6,10,1506,5,395,15.0,127.0,127.0,5,1111,15.0,843.0,843.0
0.006,17,2,146,1,65,0.0,37.0,37.0,1,81,0.0,53.0,53.0
0.102,6,10,1506,5,395,23.0,127.0,127.0,5,1111,24.0,843.0,843.0
0.003,17,2,136,1,60,0.0,32.0,32.0,1,76,0.0,48.0,48.0
0.003,17,2,148,1,60,0.0,32.0,32.0,1,88,0.0,60.0,60.0
0.129,17,2,184,1,61,0.0,33.0,33.0,1,123,0.0,95.0,95.0
0.05,17,2,136,1,60,0.0,32.0,32.0,1,76,0.0,48.0,48.0
0.259,17,39,20114,20,16988,13.0,1350.0,821.0,19,3126,10.0,1350.0,136.0
0.005,17,2,180,1,58,0.0,30.0,30.0,1,122,0.0,94.0,94.0
0.008,17,2,170,1,65,0.0,37.0,37.0,1,105,0.0,77.0,77.0
0.041,17,2,148,1,60,0.0,32.0,32.0,1,88,0.0,60.0,60.0
40.068,17,10,676,5,460,10016.0,104.0,64.0,5,216,10016.0,20.0,15.0
0.015,6,10,1972,5,910,3.0,642.0,642.0,5,1062,3.0,794.0,794.0
0.096,6,10,1506,5,395,22.0,127.0,127.0,5,1111,17.0,843.0,843.0
0.133,6,10,1506,5,395,29.0,127.0,127.0,5,1111,27.0,843.0,843.0
0.003,17,2,148,1,60,0.0,32.0,32.0,1,88,0.0,60.0,60.0
0.007,17,2,179,1,71,0.0,43.0,43.0,1,108,0.0,80.0,80.0
0.017,6,10,1989,5,910,4.0,642.0,642.0,5,1079,4.0,811.0,811.0
0.015,6,10,1972,5,910,3.0,642.0,642.0,5,1062,3.0,794.0,794.0
40.062,17,10,676,5,460,10014.0,104.0,64.0,5,216,10014.0,20.0,15.0
0.005,6,10,2007,5,928,1.0,660.0,660.0,5,1079,1.0,811.0,811.0
0.012,6,10,1990,5,911,3.0,643.0,643.0,5,1079,2.0,811.0,811.0
40.053,17,10,676,5,460,10012.0,104.0,64.0,5,216,10012.0,20.0,15.0
0.004,17,2,148,1,60,0.0,32.0,32.0,1,88,0.0,60.0,60.0
0.008,6,10,1990,5,911,2.0,643.0,643.0,5,1079,2.0,811.0,811.0
0.013,17,2,152,1,56,0.0,28.0,28.0,1,96,0.0,68.0,68.0
0.059,17,2,152,1,76,0.0,48.0,48.0,1,76,0.0,48.0,48.0
0.075,6,10,1506,5,395,15.0,127.0,127.0,5,1111,15.0,843.0,843.0
0.019,6,10,1990,5,911,4.0,643.0,643.0,5,1079,4.0,811.0,811.0
40.064,17,10,676,5,460,10013.0,104.0,64.0,5,216,10015.0,20.0,15.0
179.35,58,3,216,2,144,179350.0,24.0,24.0,1,72,0.0,24.0,24.0
168.312,17,74,10480,37,2466,4675.0,44.0,38.0,37,8014,4675.0,260.0,188.0
0.017,6,10,1989,5,910,4.0,642.0,642.0,5,1079,4.0,811.0,811.0
0.114,6,10,1506,5,395,25.0,127.0,127.0,5,1111,23.0,843.0,843.0
0.015,6,10,1990,5,911,3.0,643.0,643.0,5,1079,3.0,811.0,811.0
0.004,6,10,1989,5,927,1.0,659.0,659.0,5,1062,1.0,794.0,794.0
0.001,17,2,136,1,60,0.0,32.0,32.0,1,76,0.0,48.0,48.0
0.006,17,2,180,1,66,0.0,38.0,38.0,1,114,0.0,86.0,86.0
0.006,17,2,170,1,65,0.0,37.0,37.0,1,105,0.0,77.0,77.0
0.007,17,2,194,1,59,0.0,31.0,31.0,1,135,0.0,107.0,107.0
0.005,6,10,1643,5,860,1.0,592.0,592.0,5,783,1.0,515.0,515.0
0.004,6,10,1989,5,927,1.0,659.0,659.0,5,1062,1.0,794.0,794.0
0.01,17,4,284,2,120,0.0,32.0,32.0,2,164,1.0,60.0,54.0
0.001,17,2,180,1,66,0.0,38.0,38.0,1,114,0.0,86.0,86.0
0.006,17,2,170,1,65,0.0,37.0,37.0,1,105,0.0,77.0,77.0
0.005,6,10,1854,5,889,1.0,621.0,621.0,5,965,1.0,697.0,697.0
11.354,17,28,4421,14,1994,860.0,269.0,114.0,14,2427,860.0,586.0,145.0
0.018,6,10,1972,5,910,4.0,642.0,642.0,5,1062,4.0,794.0,794.0
300.623,6,24,8029,14,2843,23124.0,1757.0,526.0,10,5186,3963.0,2804.0,776.0
0.005,6,10,2007,5,928,1.0,660.0,660.0,5,1079,1.0,811.0,811.0
0.021,6,10,1762,5,911,5.0,643.0,643.0,5,851,5.0,583.0,583.0
0.005,17,2,293,1,73,0.0,45.0,45.0,1,220,0.0,192.0,192.0
0.083,6,10,1506,5,395,17.0,127.0,127.0,5,1111,19.0,843.0,843.0
0.005,6,13,3747,7,509,0.0,137.0,137.0,6,3238,0.0,1470.0,1459.0
11.161,17,28,4421,14,1994,846.0,269.0,114.0,14,2427,845.0,586.0,145.0
300.79,6,36,9586,19,4108,16710.0,2932.0,829.0,17,5478,539.0,2667.0,435.0
0.005,6,10,1702,5,863,1.0,595.0,595.0,5,839,1.0,571.0,571.0
0.109,6,10,1506,5,395,24.0,127.0,127.0,5,1111,19.0,843.0,843.0
351.987,6,20,2210,6,1308,12003.0,494.0,494.0,14,902,27075.0,83.0,83.0
0.015,6,10,1631,5,848,3.0,580.0,580.0,5,783,3.0,515.0,515.0
0.009,6,10,1989,5,910,2.0,642.0,642.0,5,1079,2.0,811.0,811.0
0.013,6,10,1990,5,911,3.0,643.0,643.0,5,1079,3.0,811.0,811.0
0.006,6,10,1547,5,764,1.0,496.0,496.0,5,783,1.0,515.0,515.0
0.027,6,10,1989,5,910,6.0,642.0,642.0,5,1079,6.0,811.0,811.0
0.006,6,10,1547,5,764,1.0,496.0,496.0,5,783,1.0,515.0,515.0
0.09,6,10,1506,5,395,20.0,127.0,127.0,5,1111,21.0,843.0,843.0
0.006,6,10,1689,5,839,1.0,571.0,571.0,5,850,1.0,582.0,582.0
0.079,6,10,1506,5,395,16.0,127.0,127.0,5,1111,19.0,843.0,843.0
0.012,6,10,1989,5,910,3.0,642.0,642.0,5,1079,3.0,811.0,811.0
0.008,17,2,164,1,74,0.0,46.0,46.0,1,90,0.0,62.0,62.0
11.183,17,28,4422,14,1995,848.0,270.0,114.0,14,2427,848.0,586.0,145.0
412.851,6,29,4409,12,3102,10911.0,494.0,494.0,17,1307,25803.0,83.0,83.0
0.006,6,10,1854,5,889,1.0,621.0,621.0,5,965,1.0,697.0,697.0
0.012,6,10,1989,5,910,3.0,642.0,642.0,5,1079,2.0,811.0,811.0
0.079,6,10,1506,5,395,18.0,127.0,127.0,5,1111,17.0,843.0,843.0
0.074,6,10,1506,5,395,17.0,127.0,127.0,5,1111,16.0,843.0,843.0
0.005,6,10,1989,5,927,1.0,659.0,659.0,5,1062,1.0,794.0,794.0
40.054,17,10,676,5,460,10012.0,104.0,64.0,5,216,10012.0,20.0,15.0
0.005,6,10,2007,5,928,1.0,660.0,660.0,5,1079,1.0,811.0,811.0
0.171,6,3,453,2,321,171.0,241.0,241.0,1,132,0.0,92.0,92.0
300.738,6,37,9775,20,4297,15828.0,1753.0,693.0,17,5478,536.0,2667.0,435.0
0.006,6,10,1643,5,860,1.0,592.0,592.0,5,783,1.0,515.0,515.0
0.01,6,10,1989,5,910,2.0,642.0,642.0,5,1079,2.0,811.0,811.0
40.083,17,10,676,5,460,10011.0,104.0,64.0,5,216,10020.0,20.0,15.0
0.013,6,10,1983,5,910,3.0,642.0,642.0,5,1073,3.0,805.0,805.0
178.487,17,74,10378,37,2465,4957.0,44.0,38.0,37,7913,4957.0,261.0,185.0
0.005,6,10,1989,5,927,1.0,659.0,659.0,5,1062,1.0,794.0,794.0
0.006,6,10,1547,5,764,1.0,496.0,496.0,5,783,1.0,515.0,515.0
0.006,6,10,1547,5,764,1.0,496.0,496.0,5,783,1.0,515.0,515.0
0.004,6,10,1989,5,927,1.0,659.0,659.0,5,1062,1.0,794.0,794.0
0.055,17,2,179,1,71,0.0,43.0,43.0,1,108,0.0,80.0,80.0
351.987,6,20,2210,6,1308,12003.0,494.0,494.0,14,902,27075.0,83.0,83.0
40.065,17,10,676,5,460,10015.0,104.0,64.0,5,216,10015.0,20.0,15.0
0.006,6,10,1547,5,764,1.0,496.0,496.0,5,783,1.0,515.0,515.0
0.004,17,2,136,1,60,0.0,32.0,32.0,1,76,0.0,48.0,48.0
0.005,6,10,2000,5,927,1.0,659.0,659.0,5,1073,1.0,805.0,805.0
0.012,6,10,1989,5,910,3.0,642.0,642.0,5,1079,2.0,811.0,811.0
0.005,6,10,2006,5,927,1.0,659.0,659.0,5,1079,1.0,811.0,811.0
0.005,6,10,2007,5,928,1.0,660.0,660.0,5,1079,1.0,811.0,811.0
0.005,17,2,240,1,61,0.0,33.0,33.0,1,179,0.0,151.0,151.0
0.004,6,10,1779,5,928,1.0,660.0,660.0,5,851,1.0,583.0,583.0
0.016,17,2,136,1,60,0.0,32.0,32.0,1,76,0.0,48.0,48.0
178.213,17,78,11109,39,2609,4689.0,44.0,38.0,39,8500,4689.0,260.0,189.0
0.005,17,2,169,1,62,0.0,34.0,34.0,1,107,0.0,79.0,79.0
0.004,6,10,2000,5,927,1.0,659.0,659.0,5,1073,1.0,805.0,805.0
0.082,6,10,1506,5,395,17.0,127.0,127.0,5,1111,17.0,843.0,843.0
0.009,6,10,1989,5,910,2.0,642.0,642.0,5,1079,2.0,811.0,811.0
11.013,17,28,4423,14,1995,838.0,270.0,114.0,14,2428,838.0,587.0,145.0
0.009,6,10,1762,5,911,2.0,643.0,643.0,5,851,2.0,583.0,583.0
0.173,6,3,453,2,321,173.0,241.0,241.0,1,132,0.0,92.0,92.0
308.358,17,17,1004,10,716,34255.0,48.0,43.0,7,288,51383.0,20.0,13.0
0.153,6,10,1506,5,395,21.0,127.0,127.0,5,1111,36.0,843.0,843.0
0.018,6,10,1983,5,910,4.0,642.0,642.0,5,1073,4.0,805.0,805.0
0.005,6,10,2007,5,928,1.0,660.0,660.0,5,1079,1.0,811.0,811.0
0.109,6,10,1506,5,395,25.0,127.0,127.0,5,1111,26.0,843.0,843.0
0.167,17,2,152,1,76,0.0,48.0,48.0,1,76,0.0,48.0,48.0
0.014,6,10,1989,5,910,3.0,642.0,642.0,5,1079,3.0,811.0,811.0
0.005,6,10,2000,5,927,1.0,659.0,659.0,5,1073,1.0,805.0,805.0
0.005,6,10,1689,5,839,1.0,571.0,571.0,5,850,1.0,582.0,582.0
0.006,6,10,1689,5,839,1.0,571.0,571.0,5,850,1.0,582.0,582.0
0.005,6,10,1779,5,928,1.0,660.0,660.0,5,851,1.0,583.0,583.0
308.51,17,20,1124,10,716,34264.0,48.0,43.0,10,408,34263.0,20.0,12.0
0.009,6,10,1972,5,910,2.0,642.0,642.0,5,1062,2.0,794.0,794.0
0.014,6,10,1989,5,910,3.0,642.0,642.0,5,1079,3.0,811.0,811.0
0.025,6,10,1989,5,910,6.0,642.0,642.0,5,1079,6.0,811.0,811.0
0.004,6,10,1702,5,863,1.0,595.0,595.0,5,839,0.0,571.0,571.0
0.003,17,2,136,1,60,0.0,32.0,32.0,1,76,0.0,48.0,48.0
0.004,6,10,2006,5,927,1.0,659.0,659.0,5,1079,1.0,811.0,811.0
0.008,6,12,1926,6,1189,1.0,659.0,434.0,6,737,1.0,417.0,417.0
0.005,6,10,2007,5,928,1.0,660.0,660.0,5,1079,1.0,811.0,811.0
0.006,6,10,1547,5,764,1.0,496.0,496.0,5,783,1.0,515.0,515.0
0.006,6,10,1547,5,764,1.0,496.0,496.0,5,783,1.0,515.0,515.0
0.077,6,10,1506,5,395,15.0,127.0,127.0,5,1111,16.0,843.0,843.0
0.016,17,2,198,1,91,0.0,63.0,63.0,1,107,0.0,79.0,79.0
290.431,6,414,349353,196,21747,1489.0,2736.0,888.0,218,327606,1338.0,2804.0,1550.0
0.032,6,10,1762,5,911,7.0,643.0,643.0,5,851,7.0,583.0,583.0
0.011,17,2,148,1,60,0.0,32.0,32.0,1,88,0.0,60.0,60.0
0.009,6,10,1990,5,911,2.0,643.0,643.0,5,1079,2.0,811.0,811.0
0.013,6,10,1762,5,911,3.0,643.0,643.0,5,851,3.0,583.0,583.0
0.115,6,10,1506,5,395,24.0,127.0,127.0,5,1111,23.0,843.0,843.0
0.063,6,10,1506,5,395,13.0,127.0,127.0,5,1111,13.0,843.0,843.0
0.011,6,10,1989,5,910,2.0,642.0,642.0,5,1079,2.0,811.0,811.0
0.005,6,10,1774,5,923,1.0,655.0,655.0,5,851,1.0,583.0,583.0
0.019,6,10,1989,5,910,4.0,642.0,642.0,5,1079,4.0,811.0,811.0
0.122,6,10,1506,5,395,27.0,127.0,127.0,5,1111,24.0,843.0,843.0
0.006,6,10,1547,5,764,1.0,496.0,496.0,5,783,1.0,515.0,515.0
0.099,6,10,1506,5,395,18.0,127.0,127.0,5,1111,23.0,843.0,843.0
40.065,17,10,676,5,460,10013.0,104.0,64.0,5,216,10015.0,20.0,15.0
0.07,6,10,1506,5,395,15.0,127.0,127.0,5,1111,16.0,843.0,843.0
0.012,6,10,1762,5,911,3.0,643.0,643.0,5,851,2.0,583.0,583.0
0.07,6,10,1506,5,395,14.0,127.0,127.0,5,1111,15.0,843.0,843.0
0.009,6,10,1677,5,827,2.0,559.0,559.0,5,850,2.0,582.0,582.0
0.004,6,10,2007,5,928,1.0,660.0,660.0,5,1079,1.0,811.0,811.0
0.006,17,2,170,1,65,0.0,37.0,37.0,1,105,0.0,77.0,77.0
0.128,6,10,1506,5,395,30.0,127.0,127.0,5,1111,27.0,843.0,843.0
0.005,6,10,1854,5,889,1.0,621.0,621.0,5,965,1.0,697.0,697.0
0.019,6,10,1677,5,827,4.0,559.0,559.0,5,850,4.0,582.0,582.0
15.075,17,15,9239,8,6902,2149.0,1350.0,834.0,7,2337,2507.0,1350.0,305.0
0.008,6,10,1990,5,911,2.0,643.0,643.0,5,1079,1.0,811.0,811.0
0.01,6,10,1990,5,911,2.0,643.0,643.0,5,1079,2.0,811.0,811.0
0.011,6,10,1989,5,910,2.0,642.0,642.0,5,1079,2.0,811.0,811.0
0.013,6,10,1989,5,910,3.0,642.0,642.0,5,1079,3.0,811.0,811.0
0.016,17,2,198,1,91,0.0,63.0,63.0,1,107,0.0,79.0,79.0
0.104,6,10,1506,5,395,21.0,127.0,127.0,5,1111,24.0,843.0,843.0
0.011,6,10,1989,5,910,2.0,642.0,642.0,5,1079,2.0,811.0,811.0
290.881,6,388,348331,196,21761,1491.0,2736.0,889.0,192,326570,1522.0,2804.0,1778.0
0.004,6,10,1702,5,863,1.0,595.0,595.0,5,839,1.0,571.0,571.0
361.795,6,21,1793,16,1030,24119.0,190.0,190.0,5,763,60009.0,462.0,247.0
0.011,6,10,1990,5,911,2.0,643.0,643.0,5,1079,2.0,811.0,811.0
15.233,17,23,14986,11,9724,1520.0,1350.0,856.0,12,5262,1382.0,1350.0,410.0
0.004,6,10,1989,5,927,1.0,659.0,659.0,5,1062,1.0,794.0,794.0
0.008,6,10,1990,5,911,2.0,643.0,643.0,5,1079,2.0,811.0,811.0
0.004,17,2,136,1,60,0.0,32.0,32.0,1,76,0.0,48.0,48.0
0.012,6,10,1989,5,910,3.0,642.0,642.0,5,1079,2.0,811.0,811.0
0.0,17,2,180,1,66,0.0,38.0,38.0,1,114,0.0,86.0,86.0
0.167,17,2,152,1,76,0.0,48.0,48.0,1,76,0.0,48.0,48.0
0.004,17,2,148,1,60,0.0,32.0,32.0,1,88,0.0,60.0,60.0
0.009,17,2,164,1,74,0.0,46.0,46.0,1,90,0.0,62.0,62.0
0.005,6,10,2006,5,927,1.0,659.0,659.0,5,1079,1.0,811.0,811.0
0.062,6,10,1506,5,395,13.0,127.0,127.0,5,1111,12.0,843.0,843.0
0.005,6,10,1989,5,927,1.0,659.0,659.0,5,1062,1.0,794.0,794.0
0.004,6,10,1989,5,927,1.0,659.0,659.0,5,1062,1.0,794.0,794.0
0.081,6,10,1506,5,395,17.0,127.0,127.0,5,1111,16.0,843.0,843.0
0.039,17,4,284,2,120,0.0,32.0,32.0,2,164,36.0,60.0,54.0
0.005,6,14,3736,7,446,0.0,74.0,74.0,7,3290,0.0,1448.0,972.0
0.109,6,10,1506,5,395,25.0,127.0,127.0,5,1111,23.0,843.0,843.0
0.005,17,2,175,1,65,0.0,37.0,37.0,1,110,0.0,82.0,82.0
0.127,6,10,1506,5,395,31.0,127.0,127.0,5,1111,29.0,843.0,843.0
308.891,17,20,1124,10,716,34307.0,48.0,43.0,10,408,34307.0,20.0,12.0
0.117,6,10,1506,5,395,24.0,127.0,127.0,5,1111,24.0,843.0,843.0
0.081,6,10,1506,5,395,18.0,127.0,127.0,5,1111,18.0,843.0,843.0
0.014,6,10,1972,5,910,3.0,642.0,642.0,5,1062,3.0,794.0,794.0
0.009,6,10,1972,5,910,2.0,642.0,642.0,5,1062,2.0,794.0,794.0
0.14,6,10,1506,5,395,31.0,127.0,127.0,5,1111,32.0,843.0,843.0
0.096,6,10,1506,5,395,20.0,127.0,127.0,5,1111,19.0,843.0,843.0
0.001,17,2,136,1,60,0.0,32.0,32.0,1,76,0.0,48.0,48.0
0.004,6,13,3690,7,452,0.0,80.0,80.0,6,3238,0.0,1470.0,1459.0
0.127,6,10,1506,5,395,28.0,127.0,127.0,5,1111,29.0,843.0,843.0
0.003,17,2,136,1,60,0.0,32.0,32.0,1,76,0.0,48.0,48.0
0.085,6,10,1506,5,395,19.0,127.0,127.0,5,1111,17.0,843.0,843.0
0.001,17,2,180,1,66,0.0,38.0,38.0,1,114,0.0,86.0,86.0
433.033,6,35,12323,19,3924,24057.0,1152.0,488.0,16,8399,24867.0,1402.0,839.0
0.001,17,2,136,1,60,0.0,32.0,32.0,1,76,0.0,48.0,48.0
0.001,17,2,180,1,66,0.0,38.0,38.0,1,114,0.0,86.0,86.0
0.004,6,10,1702,5,863,1.0,595.0,595.0,5,839,0.0,571.0,571.0
0.011,6,10,1631,5,848,2.0,580.0,580.0,5,783,2.0,515.0,515.0
0.005,6,10,1643,5,860,1.0,592.0,592.0,5,783,1.0,515.0,515.0
0.005,6,10,2007,5,928,1.0,660.0,660.0,5,1079,1.0,811.0,811.0
0.115,6,10,1506,5,395,26.0,127.0,127.0,5,1111,26.0,843.0,843.0
0.095,6,10,1506,5,395,21.0,127.0,127.0,5,1111,22.0,843.0,843.0
0.071,6,10,1506,5,395,16.0,127.0,127.0,5,1111,17.0,843.0,843.0
0.001,17,2,166,1,75,0.0,47.0,47.0,1,91,0.0,63.0,63.0
300.328,6,16,2170,9,684,37519.0,146.0,146.0,7,1486,50026.0,419.0,398.0
0.019,6,11,2041,6,962,3.0,642.0,642.0,5,1079,4.0,811.0,811.0
240.131,6,29,9430,15,6984,17152.0,2109.0,689.0,14,2446,18471.0,580.0,244.0
0.004,6,10,2006,5,927,1.0,659.0,659.0,5,1079,1.0,811.0,811.0
0.004,6,10,2006,5,927,1.0,659.0,659.0,5,1079,1.0,811.0,811.0
0.009,6,13,3735,7,497,1.0,125.0,125.0,6,3238,1.0,1470.0,1459.0
0.009,6,10,1983,5,910,2.0,642.0,642.0,5,1073,2.0,805.0,805.0
0.005,6,14,3799,7,509,0.0,137.0,137.0,7,3290,0.0,1448.0,972.0
0.012,6,10,1972,5,910,3.0,642.0,642.0,5,1062,2.0,794.0,794.0
0.072,17,2,156,1,64,0.0,36.0,36.0,1,92,0.0,64.0,64.0
0.011,6,10,1762,5,911,2.0,643.0,643.0,5,851,2.0,583.0,583.0
0.009,6,10,1989,5,910,2.0,642.0,642.0,5,1079,2.0,811.0,811.0
269.543,58,6,432,4,288,85280.0,24.0,24.0,2,144,139132.0,24.0,24.0
172.196,17,84,12301,42,2825,4199.0,44.0,39.0,42,9476,4199.0,261.0,197.0
0.016,6,10,1631,5,848,3.0,580.0,580.0,5,783,4.0,515.0,515.0
0.017,6,10,1989,5,910,4.0,642.0,642.0,5,1079,4.0,811.0,811.0
0.013,6,10,1972,5,910,3.0,642.0,642.0,5,1062,3.0,794.0,794.0
0.264,17,40,21637,22,18420,12.0,1350.0,809.0,18,3217,11.0,1350.0,150.0
0.02,17,2,144,1,64,0.0,36.0,36.0,1,80,0.0,52.0,52.0
0.061,17,2,152,1,76,0.0,48.0,48.0,1,76,0.0,48.0,48.0
0.122,6,10,1506,5,395,26.0,127.0,127.0,5,1111,25.0,843.0,843.0
0.014,6,10,1972,5,910,3.0,642.0,642.0,5,1062,3.0,794.0,794.0
0.005,17,2,170,1,65,0.0,37.0,37.0,1,105,0.0,77.0,77.0
0.016,6,10,1972,5,910,4.0,642.0,642.0,5,1062,3.0,794.0,794.0
174.312,17,86,12521,43,2889,4150.0,44.0,39.0,43,9632,4150.0,239.0,196.0
0.004,6,10,2006,5,927,1.0,659.0,659.0,5,1079,1.0,811.0,811.0
0.003,17,4,284,2,120,0.0,32.0,32.0,2,164,0.0,60.0,54.0
0.01,6,10,1762,5,911,2.0,643.0,643.0,5,851,2.0,583.0,583.0
0.006,6,14,3742,8,504,0.0,80.0,80.0,6,3238,1.0,1470.0,1459.0
378.79,6,22,2313,16,867,25252.0,195.0,195.0,6,1446,4637.0,419.0,398.0
0.133,6,10,1506,5,395,28.0,127.0,127.0,5,1111,27.0,843.0,843.0
0.005,6,10,2000,5,927,1.0,659.0,659.0,5,1073,1.0,805.0,805.0
0.011,6,10,1989,5,910,2.0,642.0,642.0,5,1079,2.0,811.0,811.0
240.019,6,9,787,5,488,60004.0,232.0,232.0,4,299,80005.0,83.0,83.0
0.004,17,2,132,1,58,0.0,30.0,30.0,1,74,0.0,46.0,46.0
0.006,6,13,3690,7,452,1.0,80.0,80.0,6,3238,1.0,1470.0,1459.0
0.014,6,13,3735,7,497,2.0,125.0,125.0,6,3238,2.0,1470.0,1459.0
0.038,17,2,170,1,65,0.0,37.0,37.0,1,105,0.0,77.0,77.0
0.01,6,10,1989,5,910,2.0,642.0,642.0,5,1079,2.0,811.0,811.0
0.095,6,10,1506,5,395,21.0,127.0,127.0,5,1111,23.0,843.0,843.0
0.005,6,13,3690,7,452,0.0,80.0,80.0,6,3238,0.0,1470.0,1459.0
0.017,6,10,1989,5,910,4.0,642.0,642.0,5,1079,4.0,811.0,811.0
240.078,6,16,4481,9,963,30009.0,238.0,166.0,7,3518,40012.0,1402.0,786.0
0.004,6,10,2006,5,927,1.0,659.0,659.0,5,1079,1.0,811.0,811.0
0.273,17,46,28139,26,23460,10.0,1350.0,874.0,20,4679,11.0,1350.0,205.0
0.159,17,2,80,1,32,0.0,4.0,4.0,1,48,0.0,20.0,20.0
0.006,6,10,1547,5,764,1.0,496.0,496.0,5,783,1.0,515.0,515.0
0.093,6,10,1506,5,395,20.0,127.0,127.0,5,1111,20.0,843.0,843.0
0.007,6,10,1762,5,911,1.0,643.0,643.0,5,851,1.0,583.0,583.0
0.008,6,10,1989,5,910,1.0,642.0,642.0,5,1079,2.0,811.0,811.0
0.006,6,10,2006,5,927,1.0,659.0,659.0,5,1079,1.0,811.0,811.0
0.007,6,10,1774,5,923,1.0,655.0,655.0,5,851,1.0,583.0,583.0
1750.09,6,447,65272,251,35116,7000.0,613.0,197.0,196,30156,8974.0,453.0,142.0
0.01,6,10,1972,5,910,2.0,642.0,642.0,5,1062,2.0,794.0,794.0
280.355,6,22,6035,9,1146,35043.0,267.0,156.0,13,4889,23362.0,1400.0,873.0
0.006,6,10,1547,5,764,1.0,496.0,496.0,5,783,1.0,515.0,515.0
0.016,6,10,1989,5,910,4.0,642.0,642.0,5,1079,4.0,811.0,811.0
0.13,6,10,1506,5,395,27.0,127.0,127.0,5,1111,29.0,843.0,843.0
0.085,6,10,1506,5,395,20.0,127.0,127.0,5,1111,20.0,843.0,843.0
0.005,17,2,170,1,65,0.0,37.0,37.0,1,105,0.0,77.0,77.0
0.005,17,2,170,1,65,0.0,37.0,37.0,1,105,0.0,77.0,77.0
0.009,17,2,170,1,65,0.0,37.0,37.0,1,105,0.0,77.0,77.0
0.005,17,2,214,1,75,0.0,47.0,47.0,1,139,0.0,111.0,111.0
0.164,17,2,152,1,76,0.0,48.0,48.0,1,76,0.0,48.0,48.0
0.125,6,10,1506,5,395,26.0,127.0,127.0,5,1111,25.0,843.0,843.0
0.014,6,10,1989,5,910,3.0,642.0,642.0,5,1079,3.0,811.0,811.0
0.01,6,10,1990,5,911,2.0,643.0,643.0,5,1079,2.0,811.0,811.0
0.007,17,2,132,1,58,0.0,30.0,30.0,1,74,0.0,46.0,46.0
15.071,17,15,9238,8,6902,2149.0,1350.0,834.0,7,2336,2507.0,1350.0,305.0
0.014,6,10,1989,5,910,3.0,642.0,642.0,5,1079,3.0,811.0,811.0
0.128,6,10,1506,5,395,26.0,127.0,127.0,5,1111,26.0,843.0,843.0
354.035,6,21,1795,16,1030,23602.0,190.0,190.0,5,765,60002.0,464.0,248.0
0.106,6,10,1506,5,395,24.0,127.0,127.0,5,1111,22.0,843.0,843.0
0.12,6,10,1506,5,395,28.0,127.0,127.0,5,1111,26.0,843.0,843.0
0.006,6,10,1547,5,764,1.0,496.0,496.0,5,783,1.0,515.0,515.0
240.091,6,16,4481,9,963,30011.0,238.0,166.0,7,3518,40014.0,1402.0,786.0
0.004,17,2,136,1,60,0.0,32.0,32.0,1,76,0.0,48.0,48.0
0.109,6,10,1506,5,395,25.0,127.0,127.0,5,1111,19.0,843.0,843.0
0.006,17,2,169,1,62,0.0,34.0,34.0,1,107,0.0,79.0,79.0
0.004,17,2,136,1,60,0.0,32.0,32.0,1,76,0.0,48.0,48.0
40.061,17,10,676,5,460,10014.0,104.0,64.0,5,216,10014.0,20.0,15.0
40.059,17,10,676,5,460,10012.0,104.0,64.0,5,216,10014.0,20.0,15.0
0.006,17,2,148,1,60,0.0,32.0,32.0,1,88,0.0,60.0,60.0
0.012,6,10,1990,5,911,3.0,643.0,643.0,5,1079,3.0,811.0,811.0
0.005,6,10,1989,5,927,1.0,659.0,659.0,5,1062,1.0,794.0,794.0
0.005,6,10,1989,5,927,1.0,659.0,659.0,5,1062,1.0,794.0,794.0
0.005,6,10,1779,5,928,1.0,660.0,660.0,5,851,1.0,583.0,583.0
0.005,6,10,2007,5,928,1.0,660.0,660.0,5,1079,1.0,811.0,811.0
0.012,6,10,1990,5,911,2.0,643.0,643.0,5,1079,3.0,811.0,811.0
0.013,6,10,1990,5,911,3.0,643.0,643.0,5,1079,3.0,811.0,811.0
10.786,17,28,4423,14,1994,821.0,269.0,114.0,14,2429,821.0,588.0,145.0
0.008,6,10,1990,5,911,1.0,643.0,643.0,5,1079,2.0,811.0,811.0
0.006,6,10,1547,5,764,1.0,496.0,496.0,5,783,1.0,515.0,515.0
0.091,6,10,1506,5,395,19.0,127.0,127.0,5,1111,20.0,843.0,843.0
40.048,17,10,676,5,460,10011.0,104.0,64.0,5,216,10011.0,20.0,15.0
0.003,17,2,148,1,60,0.0,32.0,32.0,1,88,0.0,60.0,60.0
0.005,6,10,1989,5,927,1.0,659.0,659.0,5,1062,1.0,794.0,794.0
0.005,6,10,2007,5,928,1.0,660.0,660.0,5,1079,1.0,811.0,811.0
0.01,6,10,1989,5,910,2.0,642.0,642.0,5,1079,2.0,811.0,811.0
15.083,17,15,8549,8,6410,2150.0,1350.0,773.0,7,2139,2509.0,1350.0,277.0
0.012,6,10,1983,5,910,3.0,642.0,642.0,5,1073,2.0,805.0,805.0
0.111,6,10,1506,5,395,22.0,127.0,127.0,5,1111,25.0,843.0,843.0
240.008,6,9,787,5,488,60002.0,232.0,232.0,4,299,80001.0,83.0,83.0
0.018,6,10,1989,5,910,4.0,642.0,642.0,5,1079,4.0,811.0,811.0
0.009,6,10,1972,5,910,2.0,642.0,642.0,5,1062,2.0,794.0,794.0
0.004,6,10,1779,5,928,1.0,660.0,660.0,5,851,1.0,583.0,583.0
0.01,6,13,3735,7,497,1.0,125.0,125.0,6,3238,1.0,1470.0,1459.0
0.01,6,10,1983,5,910,2.0,642.0,642.0,5,1073,2.0,805.0,805.0
0.005,6,10,1989,5,927,1.0,659.0,659.0,5,1062,1.0,794.0,794.0
0.006,6,10,1689,5,839,1.0,571.0,571.0,5,850,1.0,582.0,582.0
366.902,6,22,2313,16,867,24460.0,195.0,195.0,6,1446,4637.0,419.0,398.0
412.249,6,29,4409,12,3102,10911.0,494.0,494.0,17,1307,25765.0,83.0,83.0
0.006,6,10,1547,5,764,1.0,496.0,496.0,5,783,1.0,515.0,515.0
0.114,6,10,1506,5,395,26.0,127.0,127.0,5,1111,27.0,843.0,843.0
169.401,17,82,11572,41,2731,4234.0,44.0,38.0,41,8841,4234.0,261.0,187.0
0.02,6,10,1972,5,910,5.0,642.0,642.0,5,1062,5.0,794.0,794.0
0.112,6,10,1506,5,395,22.0,127.0,127.0,5,1111,23.0,843.0,843.0
0.017,6,10,1989,5,910,4.0,642.0,642.0,5,1079,4.0,811.0,811.0
0.012,17,2,193,1,71,0.0,43.0,43.0,1,122,0.0,94.0,94.0
0.017,17,2,198,1,91,0.0,63.0,63.0,1,107,0.0,79.0,79.0
0.004,17,2,136,1,60,0.0,32.0,32.0,1,76,0.0,48.0,48.0
0.038,17,2,152,1,76,0.0,48.0,48.0,1,76,0.0,48.0,48.0
0.007,6,10,1689,5,839,1.0,571.0,571.0,5,850,1.0,582.0,582.0
0.083,6,10,1506,5,395,18.0,127.0,127.0,5,1111,19.0,843.0,843.0
0.088,6,10,1506,5,395,21.0,127.0,127.0,5,1111,20.0,843.0,843.0
0.098,6,10,1506,5,395,22.0,127.0,127.0,5,1111,23.0,843.0,843.0
0.007,17,2,299,1,65,0.0,37.0,37.0,1,234,0.0,206.0,206.0
0.006,17,2,179,1,71,0.0,43.0,43.0,1,108,0.0,80.0,80.0
0.011,6,10,1990,5,911,2.0,643.0,643.0,5,1079,2.0,811.0,811.0
0.007,6,10,1990,5,911,1.0,643.0,643.0,5,1079,1.0,811.0,811.0
40.064,17,10,676,5,460,10013.0,104.0,64.0,5,216,10015.0,20.0,15.0
0.012,17,2,148,1,60,0.0,32.0,32.0,1,88,0.0,60.0,60.0
0.004,6,10,2007,5,928,1.0,660.0,660.0,5,1079,1.0,811.0,811.0
0.001,17,2,180,1,66,0.0,38.0,38.0,1,114,0.0,86.0,86.0
0.099,6,10,1506,5,395,22.0,127.0,127.0,5,1111,17.0,843.0,843.0
0.005,6,13,3747,7,509,0.0,137.0,137.0,6,3238,1.0,1470.0,1459.0
0.005,6,10,2006,5,927,1.0,659.0,659.0,5,1079,1.0,811.0,811.0
0.004,17,4,284,2,120,0.0,32.0,32.0,2,164,1.0,60.0,54.0
0.005,17,2,170,1,65,0.0,37.0,37.0,1,105,0.0,77.0,77.0
0.004,6,10,1989,5,927,1.0,659.0,659.0,5,1062,1.0,794.0,794.0
0.09,6,10,1506,5,395,15.0,127.0,127.0,5,1111,20.0,843.0,843.0
0.012,6,10,1983,5,910,3.0,642.0,642.0,5,1073,3.0,805.0,805.0
0.005,6,10,2007,5,928,1.0,660.0,660.0,5,1079,1.0,811.0,811.0
40.059,17,10,676,5,460,10013.0,104.0,64.0,5,216,10013.0,20.0,15.0
0.011,6,10,1990,5,911,2.0,643.0,643.0,5,1079,2.0,811.0,811.0
0.014,6,10,1989,5,910,3.0,642.0,642.0,5,1079,3.0,811.0,811.0
0.001,17,2,164,1,74,0.0,46.0,46.0,1,90,0.0,62.0,62.0
10.928,17,28,4423,14,1994,832.0,269.0,114.0,14,2429,832.0,588.0,145.0
10.728,17,28,4419,14,1995,816.0,270.0,114.0,14,2424,816.0,587.0,145.0
0.006,6,10,1547,5,764,1.0,496.0,496.0,5,783,1.0,515.0,515.0
0.006,17,2,170,1,65,0.0,37.0,37.0,1,105,0.0,77.0,77.0
0.016,6,10,1990,5,911,4.0,643.0,643.0,5,1079,4.0,811.0,811.0
0.004,6,10,1989,5,927,1.0,659.0,659.0,5,1062,1.0,794.0,794.0
0.004,17,2,136,1,60,0.0,32.0,32.0,1,76,0.0,48.0,48.0
0.001,17,2,136,1,60,0.0,32.0,32.0,1,76,0.0,48.0,48.0
0.005,6,10,1643,5,860,1.0,592.0,592.0,5,783,1.0,515.0,515.0
0.086,6,10,1506,5,395,20.0,127.0,127.0,5,1111,16.0,843.0,843.0
0.009,6,12,1926,6,1189,1.0,659.0,434.0,6,737,1.0,417.0,417.0
0.064,6,10,1506,5,395,13.0,127.0,127.0,5,1111,14.0,843.0,843.0
0.09,6,10,1506,5,395,19.0,127.0,127.0,5,1111,19.0,843.0,843.0
0.013,6,14,3787,7,497,2.0,125.0,125.0,7,3290,2.0,1448.0,972.0
79.131,6,22,7437,11,1305,118.0,530.0,277.0,11,6132,7896.0,1823.0,946.0
0.014,6,19,9922,11,704,1.0,124.0,124.0,8,9218,1.0,2896.0,2198.0
0.11,6,10,1506,5,395,23.0,127.0,127.0,5,1111,25.0,843.0,843.0
0.005,6,10,1989,5,927,1.0,659.0,659.0,5,1062,1.0,794.0,794.0
0.005,17,2,169,1,62,0.0,34.0,34.0,1,107,0.0,79.0,79.0
0.003,17,2,152,1,76,0.0,48.0,48.0,1,76,0.0,48.0,48.0
0.1,6,10,1506,5,395,23.0,127.0,127.0,5,1111,20.0,843.0,843.0
0.014,6,10,1983,5,910,3.0,642.0,642.0,5,1073,3.0,805.0,805.0
0.022,6,10,1983,5,910,5.0,642.0,642.0,5,1073,5.0,805.0,805.0
0.011,6,10,1677,5,827,2.0,559.0,559.0,5,850,2.0,582.0,582.0
0.07,17,2,152,1,76,0.0,48.0,48.0,1,76,0.0,48.0,48.0
0.005,17,2,168,1,76,0.0,48.0,48.0,1,92,0.0,64.0,64.0
0.005,17,2,148,1,60,0.0,32.0,32.0,1,88,0.0,60.0,60.0
0.053,17,2,152,1,76,0.0,48.0,48.0,1,76,0.0,48.0,48.0
0.006,6,10,1547,5,764,1.0,496.0,496.0,5,783,1.0,515.0,515.0
15.078,17,15,9239,8,6902,2149.0,1350.0,834.0,7,2337,2508.0,1350.0,305.0
0.012,6,10,1989,5,910,3.0,642.0,642.0,5,1079,3.0,811.0,811.0
0.017,6,10,1762,5,911,4.0,643.0,643.0,5,851,4.0,583.0,583.0
0.005,17,2,144,1,64,0.0,36.0,36.0,1,80,0.0,52.0,52.0
0.015,6,10,1972,5,910,3.0,642.0,642.0,5,1062,3.0,794.0,794.0
0.015,6,10,1762,5,911,3.0,643.0,643.0,5,851,3.0,583.0,583.0
40.072,17,10,676,5,460,10015.0,104.0,64.0,5,216,10017.0,20.0,15.0
0.009,6,10,1972,5,910,2.0,642.0,642.0,5,1062,2.0,794.0,794.0
0.005,6,10,2006,5,927,1.0,659.0,659.0,5,1079,1.0,811.0,811.0
0.004,6,10,2006,5,927,1.0,659.0,659.0,5,1079,1.0,811.0,811.0
0.024,6,10,1631,5,848,6.0,580.0,580.0,5,783,6.0,515.0,515.0
0.009,6,10,1989,5,910,2.0,642.0,642.0,5,1079,2.0,811.0,811.0
40.068,17,10,676,5,460,10015.0,104.0,64.0,5,216,10014.0,20.0,15.0
0.001,17,2,180,1,66,0.0,38.0,38.0,1,114,0.0,86.0,86.0
1730.366,6,45,2790,30,1725,59667.0,35.0,35.0,15,1065,123592.0,31.0,31.0
0.043,17,2,152,1,76,0.0,48.0,48.0,1,76,0.0,48.0,48.0
0.006,6,13,3747,7,509,1.0,137.0,137.0,6,3238,1.0,1470.0,1459.0
0.005,6,10,2006,5,927,1.0,659.0,659.0,5,1079,1.0,811.0,811.0
0.076,6,10,1506,5,395,17.0,127.0,127.0,5,1111,17.0,843.0,843.0
0.006,6,10,1547,5,764,1.0,496.0,496.0,5,783,1.0,515.0,515.0
0.006,6,10,1547,5,764,1.0,496.0,496.0,5,783,1.0,515.0,515.0
266.027,6,39,9742,15,6716,19001.0,1839.0,660.0,24,3026,11566.0,580.0,118.0
0.004,6,10,1989,5,927,1.0,659.0,659.0,5,1062,1.0,794.0,794.0
0.009,6,13,3735,7,497,1.0,125.0,125.0,6,3238,1.0,1470.0,1459.0
40.056,17,10,676,5,460,10013.0,104.0,64.0,5,216,10013.0,20.0,15.0
0.225,6,16,2778,8,1396,32.0,533.0,324.0,8,1382,20.0,529.0,239.0
352.249,6,20,2210,6,1308,12003.0,494.0,494.0,14,902,27095.0,83.0,83.0
0.008,6,10,1990,5,911,2.0,643.0,643.0,5,1079,2.0,811.0,811.0
15.076,17,16,8637,8,6558,2149.0,1350.0,791.0,8,2079,2149.0,1350.0,231.0
300.415,6,16,2170,9,684,37531.0,146.0,146.0,7,1486,50041.0,419.0,398.0
0.17,17,2,152,1,76,0.0,48.0,48.0,1,76,0.0,48.0,48.0
0.025,6,10,1972,5,910,6.0,642.0,642.0,5,1062,6.0,794.0,794.0
0.005,6,10,1774,5,923,1.0,655.0,655.0,5,851,1.0,583.0,583.0
0.006,17,2,179,1,71,0.0,43.0,43.0,1,108,0.0,80.0,80.0
0.003,17,2,148,1,60,0.0,32.0,32.0,1,88,0.0,60.0,60.0
240.498,6,37,9695,19,2171,13360.0,743.0,235.0,18,7524,14146.0,1402.0,599.0
0.006,6,10,1689,5,839,1.0,571.0,571.0,5,850,1.0,582.0,582.0
0.005,6,10,2006,5,927,1.0,659.0,659.0,5,1079,1.0,811.0,811.0
300.259,6,27,7436,16,1409,20017.0,217.0,142.0,11,6027,24025.0,1679.0,778.0
0.015,6,10,1990,5,911,3.0,643.0,643.0,5,1079,3.0,811.0,811.0
0.003,17,2,136,1,60,0.0,32.0,32.0,1,76,0.0,48.0,48.0
0.006,6,10,2000,5,927,1.0,659.0,659.0,5,1073,1.0,805.0,805.0
0.0,17,2,132,1,58,0.0,30.0,30.0,1,74,0.0,46.0,46.0
0.015,6,10,1990,5,911,3.0,643.0,643.0,5,1079,3.0,811.0,811.0
0.08,6,10,1506,5,395,17.0,127.0,127.0,5,1111,19.0,843.0,843.0
0.204,6,16,2670,8,1396,29.0,533.0,324.0,8,1274,18.0,529.0,212.0
0.004,6,10,1702,5,863,0.0,595.0,595.0,5,839,1.0,571.0,571.0
0.017,6,10,1990,5,911,4.0,643.0,643.0,5,1079,4.0,811.0,811.0
0.007,17,2,299,1,65,0.0,37.0,37.0,1,234,0.0,206.0,206.0
40.062,17,10,676,5,460,10014.0,104.0,64.0,5,216,10014.0,20.0,15.0
0.003,17,4,284,2,120,0.0,32.0,32.0,2,164,0.0,60.0,54.0
0.004,17,4,284,2,120,0.0,32.0,32.0,2,164,0.0,60.0,54.0
0.006,6,10,2007,5,928,1.0,660.0,660.0,5,1079,1.0,811.0,811.0
0.012,6,10,1762,5,911,2.0,643.0,643.0,5,851,3.0,583.0,583.0
0.084,6,10,1506,5,395,19.0,127.0,127.0,5,1111,18.0,843.0,843.0
0.079,6,10,1506,5,395,17.0,127.0,127.0,5,1111,18.0,843.0,843.0
0.004,6,10,1702,5,863,1.0,595.0,595.0,5,839,0.0,571.0,571.0
0.004,6,10,2007,5,928,1.0,660.0,660.0,5,1079,1.0,811.0,811.0
240.538,6,33,8634,17,1835,15031.0,568.0,188.0,16,6799,16033.0,1402.0,597.0
0.006,6,10,1989,5,927,1.0,659.0,659.0,5,1062,1.0,794.0,794.0
0.005,6,10,1989,5,927,1.0,659.0,659.0,5,1062,1.0,794.0,794.0
241.283,6,385,347682,195,21670,1243.0,2736.0,886.0,190,326012,1276.0,2915.0,1756.0
0.008,6,14,3736,7,446,1.0,74.0,74.0,7,3290,1.0,1448.0,972.0
0.005,6,10,1989,5,927,1.0,659.0,659.0,5,1062,1.0,794.0,794.0
0.004,6,10,1989,5,927,1.0,659.0,659.0,5,1062,1.0,794.0,794.0
0.008,6,10,1972,5,910,2.0,642.0,642.0,5,1062,2.0,794.0,794.0
0.014,6,10,1989,5,910,3.0,642.0,642.0,5,1079,3.0,811.0,811.0
0.011,6,10,1990,5,911,2.0,643.0,643.0,5,1079,2.0,811.0,811.0
0.005,17,2,214,1,75,0.0,47.0,47.0,1,139,0.0,111.0,111.0
0.009,17,2,140,1,62,0.0,34.0,34.0,1,78,0.0,50.0,50.0
0.095,6,10,1506,5,395,18.0,127.0,127.0,5,1111,21.0,843.0,843.0
0.171,6,3,453,2,321,171.0,241.0,241.0,1,132,0.0,92.0,92.0
0.119,6,10,1506,5,395,27.0,127.0,127.0,5,1111,24.0,843.0,843.0
0.011,6,10,1983,5,910,2.0,642.0,642.0,5,1073,2.0,805.0,805.0
0.122,17,2,80,1,32,0.0,4.0,4.0,1,48,0.0,20.0,20.0
0.123,17,4,284,2,120,2.0,32.0,32.0,2,164,118.0,60.0,54.0
0.005,6,10,1547,5,764,1.0,496.0,496.0,5,783,1.0,515.0,515.0
0.001,17,2,179,1,62,0.0,34.0,34.0,1,117,0.0,89.0,89.0
0.005,6,10,1547,5,764,1.0,496.0,496.0,5,783,1.0,515.0,515.0
0.088,6,10,1506,5,395,18.0,127.0,127.0,5,1111,19.0,843.0,843.0
0.004,6,10,1702,5,863,1.0,595.0,595.0,5,839,0.0,571.0,571.0
0.093,6,10,1506,5,395,20.0,127.0,127.0,5,1111,22.0,843.0,843.0
0.005,17,2,170,1,65,0.0,37.0,37.0,1,105,0.0,77.0,77.0
1777.768,17,144,45504,72,22752,25038.0,288.0,288.0,72,22752,25038.0,288.0,288.0
0.015,6,10,1989,5,910,3.0,642.0,642.0,5,1079,3.0,811.0,811.0
240.087,6,31,9418,15,6936,17149.0,2061.0,684.0,16,2482,16005.0,580.0,205.0
367.182,6,22,2313,16,867,24478.0,195.0,195.0,6,1446,4637.0,419.0,398.0
0.04,17,2,144,1,64,0.0,36.0,36.0,1,80,0.0,52.0,52.0
0.011,6,10,1990,5,911,2.0,643.0,643.0,5,1079,2.0,811.0,811.0
0.011,6,10,1983,5,910,2.0,642.0,642.0,5,1073,2.0,805.0,805.0
0.003,17,2,148,1,60,0.0,32.0,32.0,1,88,0.0,60.0,60.0
0.039,17,2,148,1,60,0.0,32.0,32.0,1,88,0.0,60.0,60.0
0.106,6,10,1506,5,395,22.0,127.0,127.0,5,1111,23.0,843.0,843.0
0.276,17,16,8351,8,5953,39.0,1350.0,716.0,8,2398,23.0,1350.0,271.0
0.215,6,16,2777,8,1395,30.0,533.0,323.0,8,1382,19.0,529.0,239.0
0.005,6,10,2006,5,927,1.0,659.0,659.0,5,1079,1.0,811.0,811.0
0.018,6,10,1972,5,910,4.0,642.0,642.0,5,1062,4.0,794.0,794.0
40.058,17,10,676,5,460,10013.0,104.0,64.0,5,216,10013.0,20.0,15.0
1799.997,6,137,6590,76,3625,23996.0,39.0,39.0,61,2965,29995.0,35.0,35.0
0.017,6,10,1989,5,910,4.0,642.0,642.0,5,1079,4.0,811.0,811.0
0.006,6,10,1854,5,889,1.0,621.0,621.0,5,965,1.0,697.0,697.0
0.011,6,12,1926,6,1189,2.0,659.0,434.0,6,737,2.0,417.0,417.0
0.116,6,10,1506,5,395,28.0,127.0,127.0,5,1111,26.0,843.0,843.0
0.038,17,2,148,1,60,0.0,32.0,32.0,1,88,0.0,60.0,60.0
0.072,6,10,1506,5,395,15.0,127.0,127.0,5,1111,15.0,843.0,843.0
0.006,17,2,214,1,75,0.0,47.0,47.0,1,139,0.0,111.0,111.0
0.014,6,10,1631,5,848,3.0,580.0,580.0,5,783,3.0,515.0,515.0
0.005,17,2,214,1,75,0.0,47.0,47.0,1,139,0.0,111.0,111.0
0.011,6,10,1972,5,910,2.0,642.0,642.0,5,1062,2.0,794.0,794.0
0.004,17,2,136,1,60,0.0,32.0,32.0,1,76,0.0,48.0,48.0
0.106,6,10,1506,5,395,23.0,127.0,127.0,5,1111,25.0,843.0,843.0
0.005,6,10,1989,5,927,1.0,659.0,659.0,5,1062,1.0,794.0,794.0
0.004,6,10,2000,5,927,1.0,659.0,659.0,5,1073,1.0,805.0,805.0
0.001,17,2,180,1,66,0.0,38.0,38.0,1,114,0.0,86.0,86.0
0.005,6,10,2000,5,927,1.0,659.0,659.0,5,1073,1.0,805.0,805.0
11.224,6,35,9664,18,4186,660.0,3113.0,1144.0,17,5478,540.0,2667.0,435.0
0.022,6,10,1989,5,910,5.0,642.0,642.0,5,1079,5.0,811.0,811.0
240.149,6,25,9801,14,1292,18473.0,260.0,189.0,11,8509,24014.0,1561.0,991.0
0.016,6,10,1983,5,910,4.0,642.0,642.0,5,1073,4.0,805.0,805.0
368.826,6,22,2313,16,867,24588.0,195.0,195.0,6,1446,4634.0,419.0,398.0
0.001,17,2,180,1,66,0.0,38.0,38.0,1,114,0.0,86.0,86.0
0.005,6,10,2007,5,928,1.0,660.0,660.0,5,1079,1.0,811.0,811.0
15.168,17,21,12287,11,8726,1513.0,1350.0,765.0,10,3561,1682.0,1350.0,328.0
0.109,6,10,1506,5,395,24.0,127.0,127.0,5,1111,23.0,843.0,843.0
308.359,17,20,1124,10,716,34255.0,48.0,43.0,10,408,34254.0,20.0,12.0
0.006,6,10,1702,5,863,1.0,595.0,595.0,5,839,1.0,571.0,571.0
0.005,6,10,2007,5,928,1.0,660.0,660.0,5,1079,1.0,811.0,811.0
240.041,6,9,787,5,488,60010.0,232.0,232.0,4,299,80012.0,83.0,83.0
0.105,6,10,1506,5,395,22.0,127.0,127.0,5,1111,22.0,843.0,843.0
0.165,6,10,1506,5,395,14.0,127.0,127.0,5,1111,39.0,843.0,843.0
0.023,6,14,3787,7,497,3.0,125.0,125.0,7,3290,3.0,1448.0,972.0
0.107,6,10,1506,5,395,23.0,127.0,127.0,5,1111,24.0,843.0,843.0
0.075,17,2,412,1,61,0.0,33.0,33.0,1,351,0.0,323.0,323.0
0.018,6,10,1989,5,910,4.0,642.0,642.0,5,1079,4.0,811.0,811.0
0.005,17,2,144,1,64,0.0,36.0,36.0,1,80,0.0,52.0,52.0
0.005,17,2,170,1,65,0.0,37.0,37.0,1,105,0.0,77.0,77.0
0.016,6,10,1989,5,910,4.0,642.0,642.0,5,1079,3.0,811.0,811.0
15.071,17,15,9239,8,6902,2149.0,1350.0,834.0,7,2337,2506.0,1350.0,305.0
0.017,6,10,1989,5,910,4.0,642.0,642.0,5,1079,4.0,811.0,811.0
0.011,6,14,3787,7,497,1.0,125.0,125.0,7,3290,1.0,1448.0,972.0
0.018,6,10,1762,5,911,4.0,643.0,643.0,5,851,4.0,583.0,583.0
371.307,6,22,2313,16,867,24753.0,195.0,195.0,6,1446,4639.0,419.0,398.0
0.009,6,10,1990,5,911,2.0,643.0,643.0,5,1079,2.0,811.0,811.0
0.338,6,10,1506,5,395,82.0,127.0,127.0,5,1111,81.0,843.0,843.0
0.003,17,2,148,1,60,0.0,32.0,32.0,1,88,0.0,60.0,60.0
335.276,17,20,1124,10,716,37239.0,48.0,43.0,10,408,37239.0,20.0,12.0
40.082,17,10,676,5,460,10019.0,104.0,64.0,5,216,10019.0,20.0,15.0
10.739,17,28,4422,14,1994,817.0,269.0,114.0,14,2428,817.0,587.0,145.0
10.814,17,26,4097,13,1821,892.0,268.0,112.0,13,2276,892.0,587.0,147.0
300.788,6,37,9597,20,4119,15830.0,1543.0,657.0,17,5478,539.0,2667.0,435.0
0.123,6,10,1506,5,395,27.0,127.0,127.0,5,1111,29.0,843.0,843.0
0.145,6,10,1506,5,395,30.0,127.0,127.0,5,1111,34.0,843.0,843.0
0.009,6,10,1989,5,910,2.0,642.0,642.0,5,1079,2.0,811.0,811.0
0.075,6,10,1506,5,395,16.0,127.0,127.0,5,1111,16.0,843.0,843.0
1750.553,6,479,70464,266,36270,6605.0,613.0,189.0,213,34194,8256.0,613.0,154.0
0.006,6,10,1547,5,764,1.0,496.0,496.0,5,783,1.0,515.0,515.0
0.106,6,10,1506,5,395,22.0,127.0,127.0,5,1111,22.0,843.0,843.0
0.005,6,10,1779,5,928,1.0,660.0,660.0,5,851,1.0,583.0,583.0
240.1,6,16,4481,9,963,30012.0,238.0,166.0,7,3518,40016.0,1402.0,786.0
0.004,6,10,2000,5,927,1.0,659.0,659.0,5,1073,1.0,805.0,805.0
0.114,6,10,1506,5,395,25.0,127.0,127.0,5,1111,24.0,843.0,843.0
0.013,6,10,1989,5,910,3.0,642.0,642.0,5,1079,3.0,811.0,811.0
0.006,6,12,1698,6,863,1.0,327.0,271.0,6,835,1.0,515.0,515.0
0.006,6,10,2007,5,928,1.0,660.0,660.0,5,1079,1.0,811.0,811.0
0.004,6,10,2006,5,927,1.0,659.0,659.0,5,1079,1.0,811.0,811.0
0.071,6,10,1506,5,395,16.0,127.0,127.0,5,1111,14.0,843.0,843.0
0.101,6,10,1506,5,395,21.0,127.0,127.0,5,1111,21.0,843.0,843.0
0.005,6,10,1854,5,889,1.0,621.0,621.0,5,965,1.0,697.0,697.0
0.005,6,10,1854,5,889,1.0,621.0,621.0,5,965,1.0,697.0,697.0
0.011,6,10,1631,5,848,2.0,580.0,580.0,5,783,2.0,515.0,515.0
0.124,17,2,148,1,60,0.0,32.0,32.0,1,88,0.0,60.0,60.0
0.039,17,2,170,1,65,0.0,37.0,37.0,1,105,0.0,77.0,77.0
0.008,6,10,1677,5,827,1.0,559.0,559.0,5,850,1.0,582.0,582.0
371.295,6,22,2313,16,867,24753.0,195.0,195.0,6,1446,4650.0,419.0,398.0
0.011,6,10,1990,5,911,2.0,643.0,643.0,5,1079,2.0,811.0,811.0
0.009,6,10,1983,5,910,2.0,642.0,642.0,5,1073,2.0,805.0,805.0
0.043,17,2,136,1,60,0.0,32.0,32.0,1,76,0.0,48.0,48.0
0.012,6,10,1989,5,910,3.0,642.0,642.0,5,1079,2.0,811.0,811.0
0.039,17,4,284,2,120,0.0,32.0,32.0,2,164,35.0,60.0,54.0
0.015,17,2,148,1,60,0.0,32.0,32.0,1,88,0.0,60.0,60.0
0.005,6,10,2007,5,928,1.0,660.0,660.0,5,1079,1.0,811.0,811.0
0.099,6,10,1506,5,395,22.0,127.0,127.0,5,1111,21.0,843.0,843.0
0.01,6,10,1989,5,910,2.0,642.0,642.0,5,1079,2.0,811.0,811.0
0.01,6,10,1677,5,827,2.0,559.0,559.0,5,850,2.0,582.0,582.0
0.005,6,10,2006,5,927,1.0,659.0,659.0,5,1079,1.0,811.0,811.0
0.011,6,10,1972,5,910,2.0,642.0,642.0,5,1062,2.0,794.0,794.0
0.088,6,10,1506,5,395,21.0,127.0,127.0,5,1111,19.0,843.0,843.0
0.009,6,10,1990,5,911,2.0,643.0,643.0,5,1079,2.0,811.0,811.0
242.625,6,26,8247,12,1730,22056.0,815.0,362.0,14,6517,18663.0,1402.0,642.0
241.397,6,305,343589,126,18066,1931.0,2736.0,959.0,179,325523,1356.0,2769.0,1871.0
0.093,6,10,1506,5,395,22.0,127.0,127.0,5,1111,21.0,843.0,843.0
0.003,17,2,136,1,60,0.0,32.0,32.0,1,76,0.0,48.0,48.0
0.103,6,10,1506,5,395,22.0,127.0,127.0,5,1111,22.0,843.0,843.0
177.098,17,78,11195,39,2610,4660.0,44.0,38.0,39,8585,4660.0,261.0,192.0
0.004,6,10,1989,5,927,1.0,659.0,659.0,5,1062,1.0,794.0,794.0
0.006,6,10,1643,5,860,1.0,592.0,592.0,5,783,1.0,515.0,515.0
0.02,6,10,1990,5,911,5.0,643.0,643.0,5,1079,5.0,811.0,811.0
0.005,6,10,1989,5,927,1.0,659.0,659.0,5,1062,1.0,794.0,794.0
0.005,6,10,1702,5,863,1.0,595.0,595.0,5,839,1.0,571.0,571.0
40.058,17,10,676,5,460,10012.0,104.0,64.0,5,216,10013.0,20.0,15.0
0.005,17,2,140,1,62,0.0,34.0,34.0,1,78,0.0,50.0,50.0
0.005,6,10,1643,5,860,1.0,592.0,592.0,5,783,1.0,515.0,515.0
0.119,6,10,1506,5,395,25.0,127.0,127.0,5,1111,23.0,843.0,843.0
0.214,6,16,2669,8,1395,30.0,533.0,323.0,8,1274,19.0,529.0,212.0
0.006,6,10,1689,5,839,1.0,571.0,571.0,5,850,1.0,582.0,582.0
0.001,17,2,180,1,66,0.0,38.0,38.0,1,114,0.0,86.0,86.0
0.013,6,12,1926,6,1189,2.0,659.0,434.0,6,737,2.0,417.0,417.0
0.01,6,10,1972,5,910,2.0,642.0,642.0,5,1062,2.0,794.0,794.0
0.005,6,10,1779,5,928,1.0,660.0,660.0,5,851,1.0,583.0,583.0
0.089,6,10,1506,5,395,21.0,127.0,127.0,5,1111,21.0,843.0,843.0
11.182,17,28,4423,14,1995,847.0,270.0,114.0,14,2428,847.0,587.0,145.0
0.005,17,2,170,1,65,0.0,37.0,37.0,1,105,0.0,77.0,77.0
0.009,6,10,1990,5,911,2.0,643.0,643.0,5,1079,2.0,811.0,811.0
0.001,17,2,180,1,66,0.0,38.0,38.0,1,114,0.0,86.0,86.0
0.005,6,13,3747,7,509,0.0,137.0,137.0,6,3238,1.0,1470.0,1459.0
0.067,17,8,3613,4,1874,22.0,1350.0,440.0,4,1739,11.0,1350.0,406.0
0.01,6,10,1972,5,910,2.0,642.0,642.0,5,1062,2.0,794.0,794.0
0.005,6,13,3747,7,509,0.0,137.0,137.0,6,3238,1.0,1470.0,1459.0
0.116,6,10,1506,5,395,26.0,127.0,127.0,5,1111,28.0,843.0,843.0
240.293,6,48,7113,23,3315,10922.0,588.0,211.0,25,3798,10012.0,580.0,207.0
0.005,6,10,1989,5,927,1.0,659.0,659.0,5,1062,1.0,794.0,794.0
240.099,6,16,4482,9,963,30012.0,238.0,166.0,7,3519,40015.0,1402.0,786.0
0.007,6,10,2006,5,927,1.0,659.0,659.0,5,1079,1.0,811.0,811.0
0.014,6,10,1972,5,910,3.0,642.0,642.0,5,1062,3.0,794.0,794.0
0.006,6,10,1689,5,839,1.0,571.0,571.0,5,850,1.0,582.0,582.0
0.077,6,10,1506,5,395,16.0,127.0,127.0,5,1111,17.0,843.0,843.0
0.115,6,10,1506,5,395,28.0,127.0,127.0,5,1111,22.0,843.0,843.0
0.006,6,10,1547,5,764,1.0,496.0,496.0,5,783,1.0,515.0,515.0
0.001,17,2,136,1,60,0.0,32.0,32.0,1,76,0.0,48.0,48.0
40.063,17,10,676,5,460,10014.0,104.0,64.0,5,216,10014.0,20.0,15.0
0.109,6,10,1506,5,395,24.0,127.0,127.0,5,1111,25.0,843.0,843.0
0.009,6,10,1631,5,848,2.0,580.0,580.0,5,783,2.0,515.0,515.0
40.053,17,10,676,5,460,10012.0,104.0,64.0,5,216,10012.0,20.0,15.0
0.012,6,10,1631,5,848,3.0,580.0,580.0,5,783,2.0,515.0,515.0
0.011,6,10,1989,5,910,2.0,642.0,642.0,5,1079,2.0,811.0,811.0
0.006,6,10,1547,5,764,1.0,496.0,496.0,5,783,1.0,515.0,515.0
0.009,6,10,1989,5,910,2.0,642.0,642.0,5,1079,2.0,811.0,811.0
0.009,6,10,1677,5,827,2.0,559.0,559.0,5,850,2.0,582.0,582.0
0.011,6,10,1983,5,910,2.0,642.0,642.0,5,1073,2.0,805.0,805.0
0.004,17,4,284,2,120,0.0,32.0,32.0,2,164,0.0,60.0,54.0
0.02,6,10,1983,5,910,5.0,642.0,642.0,5,1073,5.0,805.0,805.0
0.005,6,10,1689,5,839,1.0,571.0,571.0,5,850,1.0,582.0,582.0
0.003,17,2,148,1,60,0.0,32.0,32.0,1,88,0.0,60.0,60.0
0.007,6,10,1547,5,764,1.0,496.0,496.0,5,783,1.0,515.0,515.0
240.02,6,9,787,5,488,60005.0,232.0,232.0,4,299,80005.0,83.0,83.0
0.005,6,14,3742,8,504,0.0,80.0,80.0,6,3238,0.0,1470.0,1459.0
320.22,17,20,1124,10,716,35566.0,48.0,43.0,10,408,35566.0,20.0,12.0
0.069,6,10,1506,5,395,16.0,127.0,127.0,5,1111,15.0,843.0,843.0
0.14,6,10,1506,5,395,34.0,127.0,127.0,5,1111,34.0,843.0,843.0
0.089,6,10,1506,5,395,17.0,127.0,127.0,5,1111,20.0,843.0,843.0
0.001,17,2,180,1,66,0.0,38.0,38.0,1,114,0.0,86.0,86.0
280.348,6,22,6035,10,1186,31149.0,267.0,156.0,12,4849,25483.0,1400.0,873.0
0.042,17,2,152,1,76,0.0,48.0,48.0,1,76,0.0,48.0,48.0
0.086,6,10,1506,5,395,19.0,127.0,127.0,5,1111,18.0,843.0,843.0
0.015,6,10,1990,5,911,3.0,643.0,643.0,5,1079,3.0,811.0,811.0
0.004,17,2,234,1,61,0.0,33.0,33.0,1,173,0.0,145.0,145.0
40.065,17,10,676,5,460,10015.0,104.0,64.0,5,216,10015.0,20.0,15.0
0.014,6,11,1729,6,879,2.0,559.0,559.0,5,850,3.0,582.0,582.0
0.038,6,10,1677,5,827,9.0,559.0,559.0,5,850,9.0,582.0,582.0
0.12,6,10,1506,5,395,28.0,127.0,127.0,5,1111,26.0,843.0,843.0
0.012,6,10,1972,5,910,3.0,642.0,642.0,5,1062,3.0,794.0,794.0
0.08,6,10,1506,5,395,17.0,127.0,127.0,5,1111,18.0,843.0,843.0
0.013,6,10,1972,5,910,3.0,642.0,642.0,5,1062,3.0,794.0,794.0
0.007,6,10,1547,5,764,1.0,496.0,496.0,5,783,1.0,515.0,515.0
0.066,6,10,1506,5,395,13.0,127.0,127.0,5,1111,14.0,843.0,843.0
0.004,17,2,136,1,60,0.0,32.0,32.0,1,76,0.0,48.0,48.0
0.003,17,2,136,1,60,0.0,32.0,32.0,1,76,0.0,48.0,48.0
0.04,17,4,284,2,120,3.0,32.0,32.0,2,164,35.0,60.0,54.0
0.057,17,2,412,1,61,0.0,33.0,33.0,1,351,0.0,323.0,323.0
0.001,17,2,136,1,60,0.0,32.0,32.0,1,76,0.0,48.0,48.0
0.005,6,10,1689,5,839,1.0,571.0,571.0,5,850,1.0,582.0,582.0
1774.878,6,240,46350,116,33947,15433.0,2472.0,1033.0,124,12403,14429.0,580.0,61.0
0.037,17,2,148,1,60,0.0,32.0,32.0,1,88,0.0,60.0,60.0
0.008,6,10,1972,5,910,2.0,642.0,642.0,5,1062,1.0,794.0,794.0
352.744,6,20,2210,6,1308,12003.0,494.0,494.0,14,902,27133.0,83.0,83.0
0.009,6,10,2006,5,927,2.0,659.0,659.0,5,1079,2.0,811.0,811.0
0.157,6,10,1506,5,395,31.0,127.0,127.0,5,1111,35.0,843.0,843.0
0.007,6,10,1972,5,910,1.0,642.0,642.0,5,1062,1.0,794.0,794.0
0.091,6,10,1506,5,395,21.0,127.0,127.0,5,1111,20.0,843.0,843.0
0.005,6,10,2007,5,928,1.0,660.0,660.0,5,1079,1.0,811.0,811.0
0.005,6,10,1547,5,764,1.0,496.0,496.0,5,783,1.0,515.0,515.0
0.001,17,2,180,1,66,0.0,38.0,38.0,1,114,0.0,86.0,86.0
0.006,6,10,1854,5,889,1.0,621.0,621.0,5,965,1.0,697.0,697.0
0.126,6,10,1506,5,395,30.0,127.0,127.0,5,1111,20.0,843.0,843.0
0.009,6,10,1989,5,910,2.0,642.0,642.0,5,1079,2.0,811.0,811.0
0.004,6,10,2007,5,928,1.0,660.0,660.0,5,1079,1.0,811.0,811.0
0.004,6,14,3742,7,452,0.0,80.0,80.0,7,3290,0.0,1448.0,972.0
0.073,6,10,1506,5,395,14.0,127.0,127.0,5,1111,15.0,843.0,843.0
0.001,17,2,180,1,66,0.0,38.0,38.0,1,114,0.0,86.0,86.0
0.005,17,2,170,1,65,0.0,37.0,37.0,1,105,0.0,77.0,77.0
0.067,17,8,3613,4,1874,22.0,1350.0,440.0,4,1739,11.0,1350.0,406.0
0.024,6,14,3965,7,495,4.0,123.0,123.0,7,3470,4.0,1448.0,1032.0
0.008,6,10,1990,5,911,2.0,643.0,643.0,5,1079,2.0,811.0,811.0
0.006,6,10,1547,5,764,1.0,496.0,496.0,5,783,1.0,515.0,515.0
0.006,6,10,1547,5,764,1.0,496.0,496.0,5,783,1.0,515.0,515.0
0.014,6,10,1762,5,911,3.0,643.0,643.0,5,851,3.0,583.0,583.0
308.759,17,20,1124,10,716,34292.0,48.0,43.0,10,408,34292.0,20.0,12.0
0.008,6,10,1972,5,910,2.0,642.0,642.0,5,1062,2.0,794.0,794.0
0.004,6,10,2006,5,927,1.0,659.0,659.0,5,1079,1.0,811.0,811.0
1779.065,17,140,44240,72,22752,25045.0,288.0,288.0,68,21488,26551.0,288.0,288.0
0.011,6,10,1972,5,910,2.0,642.0,642.0,5,1062,2.0,794.0,794.0
0.006,6,10,1547,5,764,1.0,496.0,496.0,5,783,1.0,515.0,515.0
40.065,17,10,676,5,460,10015.0,104.0,64.0,5,216,10015.0,20.0,15.0
0.006,6,10,1854,5,889,1.0,621.0,621.0,5,965,1.0,697.0,697.0
0.011,6,10,1972,5,910,2.0,642.0,642.0,5,1062,2.0,794.0,794.0
0.009,6,10,1989,5,910,2.0,642.0,642.0,5,1079,2.0,811.0,811.0
0.013,6,10,1972,5,910,3.0,642.0,642.0,5,1062,3.0,794.0,794.0
0.005,17,2,164,1,74,0.0,46.0,46.0,1,90,0.0,62.0,62.0
0.004,6,10,1702,5,863,1.0,595.0,595.0,5,839,0.0,571.0,571.0
0.11,6,10,1506,5,395,24.0,127.0,127.0,5,1111,22.0,843.0,843.0
0.016,6,10,1990,5,911,4.0,643.0,643.0,5,1079,3.0,811.0,811.0
0.005,6,10,2006,6,979,1.0,659.0,659.0,4,1027,1.0,811.0,811.0
0.015,6,10,1983,5,910,3.0,642.0,642.0,5,1073,3.0,805.0,805.0
0.006,6,10,1547,5,764,1.0,496.0,496.0,5,783,1.0,515.0,515.0
163.476,17,70,10101,35,2339,4807.0,44.0,38.0,35,7762,4808.0,239.0,193.0
240.092,6,16,4481,9,963,30011.0,238.0,166.0,7,3518,40015.0,1402.0,786.0
0.015,6,10,1972,5,910,3.0,642.0,642.0,5,1062,3.0,794.0,794.0
0.005,17,2,154,1,69,0.0,41.0,41.0,1,85,0.0,57.0,57.0
0.074,6,10,1506,5,395,15.0,127.0,127.0,5,1111,16.0,843.0,843.0
0.004,6,10,1779,5,928,1.0,660.0,660.0,5,851,1.0,583.0,583.0
0.008,6,10,1972,5,910,2.0,642.0,642.0,5,1062,2.0,794.0,794.0
0.015,6,10,1677,5,827,3.0,559.0,559.0,5,850,3.0,582.0,582.0
0.057,6,10,1506,5,395,12.0,127.0,127.0,5,1111,11.0,843.0,843.0
0.001,17,2,180,1,66,0.0,38.0,38.0,1,114,0.0,86.0,86.0
0.017,17,2,136,1,60,0.0,32.0,32.0,1,76,0.0,48.0,48.0
0.012,6,10,1983,5,910,2.0,642.0,642.0,5,1073,2.0,805.0,805.0
0.01,17,4,284,2,120,5.0,32.0,32.0,2,164,5.0,60.0,54.0
0.004,17,4,284,2,120,1.0,32.0,32.0,2,164,0.0,60.0,54.0
0.005,6,10,2006,5,927,1.0,659.0,659.0,5,1079,1.0,811.0,811.0
0.014,6,10,1990,5,911,3.0,643.0,643.0,5,1079,3.0,811.0,811.0
176.392,17,76,11052,38,2533,4767.0,44.0,38.0,38,8519,4767.0,261.0,196.0
0.012,6,10,1631,5,848,3.0,580.0,580.0,5,783,3.0,515.0,515.0
0.005,6,10,2007,5,928,1.0,660.0,660.0,5,1079,1.0,811.0,811.0
0.005,6,10,1989,5,927,1.0,659.0,659.0,5,1062,1.0,794.0,794.0
0.011,6,10,1989,5,910,2.0,642.0,642.0,5,1079,2.0,811.0,811.0
0.003,17,2,148,1,60,0.0,32.0,32.0,1,88,0.0,60.0,60.0
0.003,17,2,148,1,60,0.0,32.0,32.0,1,88,0.0,60.0,60.0
40.057,17,10,676,5,460,10013.0,104.0,64.0,5,216,10013.0,20.0,15.0
0.005,6,14,3736,7,446,0.0,74.0,74.0,7,3290,0.0,1448.0,972.0
0.011,6,10,1983,5,910,2.0,642.0,642.0,5,1073,2.0,805.0,805.0
0.004,17,2,136,1,60,0.0,32.0,32.0,1,76,0.0,48.0,48.0
0.149,6,10,1506,5,395,35.0,127.0,127.0,5,1111,35.0,843.0,843.0
0.005,6,10,1547,5,764,1.0,496.0,496.0,5,783,1.0,515.0,515.0
0.02,6,13,3913,7,495,3.0,123.0,123.0,6,3418,3.0,1650.0,1549.0
15.074,17,15,9238,8,6902,2149.0,1350.0,834.0,7,2336,2507.0,1350.0,305.0
0.003,17,2,148,1,60,0.0,32.0,32.0,1,88,0.0,60.0,60.0
0.138,6,10,1506,5,395,29.0,127.0,127.0,5,1111,28.0,843.0,843.0
0.012,6,10,1631,5,848,3.0,580.0,580.0,5,783,2.0,515.0,515.0
0.005,6,10,2007,5,928,1.0,660.0,660.0,5,1079,1.0,811.0,811.0
0.004,6,10,1989,5,927,1.0,659.0,659.0,5,1062,1.0,794.0,794.0
0.013,6,10,1990,5,911,3.0,643.0,643.0,5,1079,3.0,811.0,811.0
15.076,17,15,8067,8,5969,2149.0,1350.0,718.0,7,2098,2507.0,1350.0,271.0
0.001,17,2,180,1,66,0.0,38.0,38.0,1,114,0.0,86.0,86.0
240.102,6,16,4480,9,963,30012.0,238.0,166.0,7,3517,40016.0,1402.0,786.0
240.093,6,16,4481,9,963,30011.0,238.0,166.0,7,3518,40015.0,1402.0,786.0
0.152,6,10,1506,5,395,35.0,127.0,127.0,5,1111,35.0,843.0,843.0
0.013,6,10,1983,5,910,3.0,642.0,642.0,5,1073,3.0,805.0,805.0
364.708,6,22,2313,16,867,24313.0,195.0,195.0,6,1446,4634.0,419.0,398.0
0.01,6,10,1989,5,910,2.0,642.0,642.0,5,1079,2.0,811.0,811.0
11.176,17,28,4422,14,1994,847.0,269.0,114.0,14,2428,847.0,587.0,145.0
0.16,6,10,1506,5,395,29.0,127.0,127.0,5,1111,33.0,843.0,843.0
11.249,17,28,4421,14,1994,852.0,269.0,114.0,14,2427,852.0,586.0,145.0
0.147,6,10,1506,5,395,35.0,127.0,127.0,5,1111,31.0,843.0,843.0
0.005,17,2,170,1,65,0.0,37.0,37.0,1,105,0.0,77.0,77.0
0.081,6,10,1506,5,395,19.0,127.0,127.0,5,1111,17.0,843.0,843.0
0.083,6,10,1506,5,395,18.0,127.0,127.0,5,1111,17.0,843.0,843.0
0.088,6,10,1506,5,395,19.0,127.0,127.0,5,1111,20.0,843.0,843.0
0.005,17,2,152,1,68,0.0,40.0,40.0,1,84,0.0,56.0,56.0
0.004,17,2,234,1,61,0.0,33.0,33.0,1,173,0.0,145.0,145.0
0.101,6,10,1506,5,395,24.0,127.0,127.0,5,1111,21.0,843.0,843.0
0.005,6,15,3794,8,504,0.0,80.0,80.0,7,3290,0.0,1448.0,972.0
0.017,6,10,1762,5,911,4.0,643.0,643.0,5,851,4.0,583.0,583.0
0.013,6,10,1972,5,910,3.0,642.0,642.0,5,1062,3.0,794.0,794.0
0.011,6,10,1989,5,910,2.0,642.0,642.0,5,1079,2.0,811.0,811.0
0.005,6,13,3747,7,509,0.0,137.0,137.0,6,3238,1.0,1470.0,1459.0
0.006,6,10,1547,5,764,1.0,496.0,496.0,5,783,1.0,515.0,515.0
0.005,6,10,1989,5,927,1.0,659.0,659.0,5,1062,1.0,794.0,794.0
0.016,6,10,1989,5,910,4.0,642.0,642.0,5,1079,4.0,811.0,811.0
0.144,6,10,1506,5,395,33.0,127.0,127.0,5,1111,34.0,843.0,843.0
0.01,17,2,175,1,65,0.0,37.0,37.0,1,110,0.0,82.0,82.0
0.009,6,10,1989,5,910,2.0,642.0,642.0,5,1079,2.0,811.0,811.0
0.005,17,2,170,1,65,0.0,37.0,37.0,1,105,0.0,77.0,77.0
0.012,6,10,1989,5,910,3.0,642.0,642.0,5,1079,3.0,811.0,811.0
0.085,6,10,1506,5,395,19.0,127.0,127.0,5,1111,20.0,843.0,843.0
165.442,17,76,10813,38,2537,4471.0,44.0,38.0,38,8276,4471.0,261.0,189.0
574.514,6,52,22226,28,5710,21278.0,1273.0,530.0,24,16516,22363.0,1402.0,953.0
0.047,17,2,170,1,65,0.0,37.0,37.0,1,105,0.0,77.0,77.0
0.008,6,10,1989,5,910,1.0,642.0,642.0,5,1079,2.0,811.0,811.0
0.013,6,10,1989,5,910,3.0,642.0,642.0,5,1079,3.0,811.0,811.0
0.013,17,2,152,1,56,0.0,28.0,28.0,1,96,0.0,68.0,68.0
0.011,6,10,1972,5,910,2.0,642.0,642.0,5,1062,2.0,794.0,794.0
308.353,17,20,1124,10,716,34246.0,48.0,43.0,10,408,34246.0,20.0,12.0
0.006,17,2,170,1,65,0.0,37.0,37.0,1,105,0.0,77.0,77.0
0.005,6,10,2006,5,927,1.0,659.0,659.0,5,1079,1.0,811.0,811.0
1799.841,6,136,6550,76,3625,23997.0,39.0,39.0,60,2925,29992.0,35.0,35.0
0.004,17,4,284,2,120,0.0,32.0,32.0,2,164,1.0,60.0,54.0
0.096,6,10,1506,5,395,21.0,127.0,127.0,5,1111,19.0,843.0,843.0
0.134,17,2,80,1,32,0.0,4.0,4.0,1,48,0.0,20.0,20.0
0.005,6,10,1854,5,889,1.0,621.0,621.0,5,965,1.0,697.0,697.0
0.006,6,10,2006,5,927,1.0,659.0,659.0,5,1079,1.0,811.0,811.0
0.004,17,4,284,2,120,0.0,32.0,32.0,2,164,0.0,60.0,54.0
0.078,6,10,1506,5,395,17.0,127.0,127.0,5,1111,14.0,843.0,843.0
0.094,6,10,1506,5,395,20.0,127.0,127.0,5,1111,21.0,843.0,843.0
0.006,6,10,1547,5,764,1.0,496.0,496.0,5,783,1.0,515.0,515.0
0.017,6,10,1972,5,910,4.0,642.0,642.0,5,1062,4.0,794.0,794.0
0.004,6,10,2006,5,927,1.0,659.0,659.0,5,1079,1.0,811.0,811.0
0.006,6,13,3747,7,509,0.0,137.0,137.0,6,3238,1.0,1470.0,1459.0
0.004,6,10,2006,5,927,1.0,659.0,659.0,5,1079,1.0,811.0,811.0
0.071,17,8,3613,4,1874,23.0,1350.0,440.0,4,1739,12.0,1350.0,406.0
0.005,6,10,1989,5,927,1.0,659.0,659.0,5,1062,1.0,794.0,794.0
0.001,17,2,180,1,66,0.0,38.0,38.0,1,114,0.0,86.0,86.0
0.005,6,10,2000,5,927,1.0,659.0,659.0,5,1073,1.0,805.0,805.0
0.079,6,10,1506,5,395,16.0,127.0,127.0,5,1111,16.0,843.0,843.0
0.004,17,2,148,1,60,0.0,32.0,32.0,1,88,0.0,60.0,60.0
300.878,6,37,9597,20,4119,15835.0,1543.0,657.0,17,5478,542.0,2667.0,435.0
0.005,17,2,214,1,75,0.0,47.0,47.0,1,139,0.0,111.0,111.0
0.04,17,4,284,2,120,0.0,32.0,32.0,2,164,36.0,60.0,54.0
0.114,6,10,1506,5,395,26.0,127.0,127.0,5,1111,22.0,843.0,843.0
0.016,6,10,1972,5,910,4.0,642.0,642.0,5,1062,4.0,794.0,794.0
177.636,17,70,10154,35,2330,5224.0,44.0,38.0,35,7824,5224.0,261.0,195.0
1797.669,6,244,35804,152,26032,11905.0,302.0,302.0,92,9772,19754.0,83.0,83.0
0.004,6,10,2006,5,927,1.0,659.0,659.0,5,1079,1.0,811.0,811.0
40.057,17,10,676,5,460,10013.0,104.0,64.0,5,216,10013.0,20.0,15.0
0.004,6,10,2000,5,927,1.0,659.0,659.0,5,1073,1.0,805.0,805.0
0.005,17,2,186,1,60,0.0,32.0,32.0,1,126,0.0,98.0,98.0
0.004,17,4,284,2,120,1.0,32.0,32.0,2,164,0.0,60.0,54.0
0.005,17,2,188,1,62,0.0,34.0,34.0,1,126,0.0,98.0,98.0
0.017,6,10,1983,5,910,4.0,642.0,642.0,5,1073,4.0,805.0,805.0
0.087,6,10,1506,5,395,19.0,127.0,127.0,5,1111,19.0,843.0,843.0
0.005,6,13,3690,7,452,0.0,80.0,80.0,6,3238,0.0,1470.0,1459.0
1729.283,6,63,4556,40,2740,44340.0,33.0,33.0,23,1816,78596.0,31.0,31.0
0.005,6,10,1689,5,839,1.0,571.0,571.0,5,850,1.0,582.0,582.0
0.073,6,10,1506,5,395,15.0,127.0,127.0,5,1111,17.0,843.0,843.0
353.245,6,20,2210,6,1308,12004.0,494.0,494.0,14,902,27172.0,83.0,83.0
0.004,6,10,2006,5,927,1.0,659.0,659.0,5,1079,1.0,811.0,811.0
0.011,6,10,1631,5,848,2.0,580.0,580.0,5,783,2.0,515.0,515.0
0.001,17,2,180,1,66,0.0,38.0,38.0,1,114,0.0,86.0,86.0
0.041,17,2,380,1,61,0.0,33.0,33.0,1,319,0.0,291.0,291.0
0.009,6,10,1972,5,910,2.0,642.0,642.0,5,1062,2.0,794.0,794.0
0.038,17,2,412,1,61,0.0,33.0,33.0,1,351,0.0,323.0,323.0
0.079,17,4,284,2,120,0.0,32.0,32.0,2,164,76.0,60.0,54.0
0.005,6,10,2007,5,928,1.0,660.0,660.0,5,1079,1.0,811.0,811.0
0.008,6,12,1926,6,1189,1.0,659.0,434.0,6,737,1.0,417.0,417.0
0.053,17,2,152,1,76,0.0,48.0,48.0,1,76,0.0,48.0,48.0
334.769,17,20,1124,10,716,37185.0,48.0,43.0,10,408,37189.0,20.0,12.0
0.015,6,10,1989,5,910,3.0,642.0,642.0,5,1079,3.0,811.0,811.0
0.005,6,10,2007,5,928,1.0,660.0,660.0,5,1079,1.0,811.0,811.0
0.003,17,2,148,1,60,0.0,32.0,32.0,1,88,0.0,60.0,60.0
0.005,6,10,1689,5,839,1.0,571.0,571.0,5,850,1.0,582.0,582.0
0.097,6,10,1506,5,395,22.0,127.0,127.0,5,1111,20.0,843.0,843.0
300.023,6,12,1782,7,1348,50003.0,494.0,494.0,5,434,75005.0,83.0,83.0
0.01,6,12,1926,6,1189,2.0,659.0,434.0,6,737,1.0,417.0,417.0
40.065,17,10,676,5,460,10015.0,104.0,64.0,5,216,10015.0,20.0,15.0
0.04,17,2,136,1,60,0.0,32.0,32.0,1,76,0.0,48.0,48.0
0.019,6,10,1677,5,827,4.0,559.0,559.0,5,850,4.0,582.0,582.0
0.01,6,12,1926,6,1189,1.0,659.0,434.0,6,737,2.0,417.0,417.0
0.005,17,2,140,1,62,0.0,34.0,34.0,1,78,0.0,50.0,50.0
0.041,17,2,412,1,61,0.0,33.0,33.0,1,351,0.0,323.0,323.0
0.005,17,2,168,1,76,0.0,48.0,48.0,1,92,0.0,64.0,64.0
300.077,6,12,1782,7,1348,50012.0,494.0,494.0,5,434,75018.0,83.0,83.0
11.284,17,28,4422,14,1994,855.0,269.0,114.0,14,2428,855.0,587.0,145.0
0.011,17,2,138,1,61,0.0,33.0,33.0,1,77,0.0,49.0,49.0
0.001,17,2,180,1,66,0.0,38.0,38.0,1,114,0.0,86.0,86.0
0.005,17,2,170,1,65,0.0,37.0,37.0,1,105,0.0,77.0,77.0
40.069,17,10,676,5,460,10016.0,104.0,64.0,5,216,10016.0,20.0,15.0
0.07,6,10,1506,5,395,16.0,127.0,127.0,5,1111,15.0,843.0,843.0
40.062,17,10,676,5,460,10014.0,104.0,64.0,5,216,10014.0,20.0,15.0
0.015,6,13,3735,7,497,2.0,125.0,125.0,6,3238,3.0,1470.0,1459.0
0.008,17,2,148,1,60,0.0,32.0,32.0,1,88,0.0,60.0,60.0
0.004,6,10,2007,5,928,1.0,660.0,660.0,5,1079,1.0,811.0,811.0
0.01,6,10,1989,5,910,2.0,642.0,642.0,5,1079,2.0,811.0,811.0
0.01,6,10,1989,5,910,2.0,642.0,642.0,5,1079,2.0,811.0,811.0
0.007,6,10,1854,5,889,1.0,621.0,621.0,5,965,1.0,697.0,697.0
0.134,6,10,1506,5,395,31.0,127.0,127.0,5,1111,29.0,843.0,843.0
0.011,6,10,1972,5,910,2.0,642.0,642.0,5,1062,2.0,794.0,794.0
0.01,6,10,1972,5,910,2.0,642.0,642.0,5,1062,2.0,794.0,794.0
0.009,6,13,3735,7,497,1.0,125.0,125.0,6,3238,1.0,1470.0,1459.0
405.318,6,40,15951,22,2957,19300.0,663.0,361.0,18,12994,20306.0,1948.0,1004.0
0.01,6,10,1983,5,910,2.0,642.0,642.0,5,1073,2.0,805.0,805.0
0.003,17,2,136,1,60,0.0,32.0,32.0,1,76,0.0,48.0,48.0
0.082,6,10,1506,5,395,19.0,127.0,127.0,5,1111,19.0,843.0,843.0
0.018,6,10,1989,5,910,4.0,642.0,642.0,5,1079,4.0,811.0,811.0
0.026,6,10,1989,5,910,6.0,642.0,642.0,5,1079,6.0,811.0,811.0
0.006,6,10,1547,5,764,1.0,496.0,496.0,5,783,1.0,515.0,515.0
300.331,6,16,2170,9,684,37520.0,146.0,146.0,7,1486,50027.0,419.0,398.0
0.025,6,10,1983,5,910,6.0,642.0,642.0,5,1073,6.0,805.0,805.0
0.006,6,10,1547,5,764,1.0,496.0,496.0,5,783,1.0,515.0,515.0
8.805,6,24,7517,13,1385,733.0,530.0,277.0,11,6132,863.0,2720.0,946.0
0.005,17,2,144,1,64,0.0,36.0,36.0,1,80,0.0,52.0,52.0
0.013,6,10,1631,5,848,3.0,580.0,580.0,5,783,3.0,515.0,515.0
0.005,17,2,140,1,62,0.0,34.0,34.0,1,78,0.0,50.0,50.0
0.013,6,10,1972,5,910,3.0,642.0,642.0,5,1062,3.0,794.0,794.0
0.117,6,10,1506,5,395,25.0,127.0,127.0,5,1111,23.0,843.0,843.0
0.005,6,10,1989,5,927,1.0,659.0,659.0,5,1062,1.0,794.0,794.0
1794.129,6,277,25764,140,9132,12907.0,747.0,263.0,137,16632,13192.0,1626.0,72.0
0.01,6,13,3735,7,497,1.0,125.0,125.0,6,3238,1.0,1470.0,1459.0
0.005,6,10,2007,5,928,1.0,660.0,660.0,5,1079,1.0,811.0,811.0
10.846,17,28,4422,14,1993,825.0,268.0,114.0,14,2429,825.0,588.0,145.0
0.173,17,4,596,2,122,143.0,33.0,33.0,2,474,133.0,323.0,209.0
0.008,6,12,1926,6,1189,1.0,659.0,434.0,6,737,1.0,417.0,417.0
290.189,6,378,346864,192,21544,1519.0,2736.0,888.0,186,325320,1568.0,2804.0,1835.0
0.018,6,10,1972,5,910,4.0,642.0,642.0,5,1062,4.0,794.0,794.0
0.111,6,10,1506,5,395,25.0,127.0,127.0,5,1111,24.0,843.0,843.0
40.062,17,10,676,5,460,10014.0,104.0,64.0,5,216,10014.0,20.0,15.0
0.015,6,10,1983,5,910,3.0,642.0,642.0,5,1073,3.0,805.0,805.0
0.01,17,2,136,1,60,0.0,32.0,32.0,1,76,0.0,48.0,48.0
0.006,6,10,1689,5,839,1.0,571.0,571.0,5,850,1.0,582.0,582.0
0.262,17,46,29396,27,24849,10.0,1350.0,892.0,19,4547,11.0,1350.0,211.0
0.011,6,10,1983,5,910,2.0,642.0,642.0,5,1073,2.0,805.0,805.0
0.208,6,16,2669,8,1395,29.0,533.0,323.0,8,1274,19.0,529.0,212.0
10.82,17,28,4421,14,1993,823.0,268.0,114.0,14,2428,823.0,587.0,145.0
366.778,6,22,2313,16,867,24451.0,195.0,195.0,6,1446,4675.0,419.0,398.0
0.014,6,10,1983,5,910,3.0,642.0,642.0,5,1073,3.0,805.0,805.0
0.112,6,10,1506,5,395,24.0,127.0,127.0,5,1111,25.0,843.0,843.0
10.929,17,28,4422,14,1993,832.0,268.0,114.0,14,2429,832.0,588.0,145.0
0.005,6,10,2006,5,927,1.0,659.0,659.0,5,1079,1.0,811.0,811.0
0.004,17,2,148,1,60,0.0,32.0,32.0,1,88,0.0,60.0,60.0
0.001,17,2,180,1,66,0.0,38.0,38.0,1,114,0.0,86.0,86.0
0.019,6,10,1983,5,910,4.0,642.0,642.0,5,1073,4.0,805.0,805.0
0.003,17,2,136,1,60,0.0,32.0,32.0,1,76,0.0,48.0,48.0
0.011,6,10,1990,5,911,2.0,643.0,643.0,5,1079,2.0,811.0,811.0
0.003,17,2,136,1,60,0.0,32.0,32.0,1,76,0.0,48.0,48.0
300.991,6,43,18655,23,13057,13681.0,4080.0,1513.0,20,5598,463.0,2667.0,435.0
0.016,6,10,1989,5,910,4.0,642.0,642.0,5,1079,4.0,811.0,811.0
0.013,6,10,1972,5,910,3.0,642.0,642.0,5,1062,3.0,794.0,794.0
475.144,6,49,13418,24,6023,20658.0,1031.0,681.0,25,7395,19797.0,1162.0,381.0
0.011,6,10,1983,5,910,2.0,642.0,642.0,5,1073,2.0,805.0,805.0
0.005,6,10,2007,5,928,1.0,660.0,660.0,5,1079,1.0,811.0,811.0
0.006,17,2,230,1,68,0.0,40.0,40.0,1,162,0.0,134.0,134.0
0.006,6,10,1547,5,764,1.0,496.0,496.0,5,783,1.0,515.0,515.0
0.012,6,10,1972,5,910,3.0,642.0,642.0,5,1062,2.0,794.0,794.0
0.166,17,2,152,1,76,0.0,48.0,48.0,1,76,0.0,48.0,48.0
0.013,6,10,1989,5,910,3.0,642.0,642.0,5,1079,3.0,811.0,811.0
0.006,6,10,1547,5,764,1.0,496.0,496.0,5,783,1.0,515.0,515.0
0.004,6,10,1702,5,863,1.0,595.0,595.0,5,839,0.0,571.0,571.0
0.004,6,10,1989,5,927,1.0,659.0,659.0,5,1062,1.0,794.0,794.0
0.007,17,2,170,1,65,0.0,37.0,37.0,1,105,0.0,77.0,77.0
240.014,6,9,787,5,488,60003.0,232.0,232.0,4,299,80003.0,83.0,83.0
0.005,6,10,2000,5,927,1.0,659.0,659.0,5,1073,1.0,805.0,805.0
0.076,6,10,1506,5,395,16.0,127.0,127.0,5,1111,17.0,843.0,843.0
1778.25,17,144,45504,72,22752,25045.0,288.0,288.0,72,22752,25044.0,288.0,288.0
0.013,6,10,1989,5,910,3.0,642.0,642.0,5,1079,3.0,811.0,811.0
0.009,6,10,1972,5,910,2.0,642.0,642.0,5,1062,2.0,794.0,794.0
0.004,6,10,1702,5,863,1.0,595.0,595.0,5,839,1.0,571.0,571.0
289.82,6,323,345123,120,17784,2435.0,2736.0,888.0,203,327339,1434.0,2804.0,1676.0
0.094,6,10,1506,5,395,19.0,127.0,127.0,5,1111,22.0,843.0,843.0
0.01,6,10,1990,5,911,2.0,643.0,643.0,5,1079,2.0,811.0,811.0
0.013,6,14,3787,7,497,2.0,125.0,125.0,7,3290,2.0,1448.0,972.0
0.119,6,10,1506,5,395,22.0,127.0,127.0,5,1111,29.0,843.0,843.0
15.075,17,15,9238,8,6902,2149.0,1350.0,834.0,7,2336,2507.0,1350.0,305.0
0.071,17,4,580,2,122,0.0,33.0,33.0,2,458,31.0,307.0,201.0
0.016,6,10,1972,5,910,3.0,642.0,642.0,5,1062,3.0,794.0,794.0
0.01,6,10,1762,5,911,2.0,643.0,643.0,5,851,2.0,583.0,583.0
0.005,17,2,166,1,75,0.0,47.0,47.0,1,91,0.0,63.0,63.0
0.011,6,10,1983,5,910,2.0,642.0,642.0,5,1073,2.0,805.0,805.0
0.038,17,2,148,1,60,0.0,32.0,32.0,1,88,0.0,60.0,60.0
40.06,17,10,676,5,460,10014.0,104.0,64.0,5,216,10014.0,20.0,15.0
0.01,6,10,1990,5,911,2.0,643.0,643.0,5,1079,2.0,811.0,811.0
0.012,6,10,1990,5,911,3.0,643.0,643.0,5,1079,2.0,811.0,811.0
0.013,6,10,1972,5,910,3.0,642.0,642.0,5,1062,3.0,794.0,794.0
371.347,6,22,2313,16,867,24756.0,195.0,195.0,6,1446,4665.0,419.0,398.0
0.005,17,2,136,1,60,0.0,32.0,32.0,1,76,0.0,48.0,48.0
0.008,6,12,1926,6,1189,1.0,659.0,434.0,6,737,1.0,417.0,417.0
0.007,6,10,1689,5,839,1.0,571.0,571.0,5,850,1.0,582.0,582.0
10.801,17,26,4101,13,1822,890.0,269.0,112.0,13,2279,890.0,586.0,147.0
0.004,6,10,1702,5,863,1.0,595.0,595.0,5,839,1.0,571.0,571.0
0.022,6,10,1972,5,910,5.0,642.0,642.0,5,1062,5.0,794.0,794.0
0.011,6,10,1983,5,910,2.0,642.0,642.0,5,1073,2.0,805.0,805.0
0.018,6,10,1972,5,910,4.0,642.0,642.0,5,1062,4.0,794.0,794.0
0.019,6,10,1972,5,910,4.0,642.0,642.0,5,1062,4.0,794.0,794.0
0.005,6,10,1779,5,928,1.0,660.0,660.0,5,851,1.0,583.0,583.0
0.005,6,10,2006,5,927,1.0,659.0,659.0,5,1079,1.0,811.0,811.0
0.005,6,13,3747,7,509,0.0,137.0,137.0,6,3238,0.0,1470.0,1459.0
0.005,6,10,1989,5,927,1.0,659.0,659.0,5,1062,1.0,794.0,794.0
0.04,17,2,152,1,76,0.0,48.0,48.0,1,76,0.0,48.0,48.0
310.373,17,18,1044,9,684,38781.0,48.0,48.0,9,360,38781.0,12.0,12.0
1757.999,6,571,191084,297,164824,5939.0,2883.0,905.0,274,26260,6439.0,580.0,115.0
0.005,6,10,1689,5,839,1.0,571.0,571.0,5,850,1.0,582.0,582.0
0.074,6,10,1506,5,395,17.0,127.0,127.0,5,1111,16.0,843.0,843.0
0.005,17,2,164,1,74,0.0,46.0,46.0,1,90,0.0,62.0,62.0
1796.115,17,2905,218448,1446,115793,1242.0,82.0,52.0,1459,102655,1231.0,226.0,42.0
0.189,6,10,1506,5,395,45.0,127.0,127.0,5,1111,43.0,843.0,843.0
0.073,6,10,1506,5,395,17.0,127.0,127.0,5,1111,17.0,843.0,843.0
0.004,6,10,2006,5,927,1.0,659.0,659.0,5,1079,1.0,811.0,811.0
0.005,6,10,1643,5,860,1.0,592.0,592.0,5,783,1.0,515.0,515.0
0.013,6,10,1989,5,910,3.0,642.0,642.0,5,1079,3.0,811.0,811.0
0.004,17,4,284,2,120,1.0,32.0,32.0,2,164,0.0,60.0,54.0
1778.348,17,144,45504,72,22752,25047.0,288.0,288.0,72,22752,25047.0,288.0,288.0
0.012,6,10,1972,5,910,3.0,642.0,642.0,5,1062,2.0,794.0,794.0
0.004,6,10,1989,5,927,1.0,659.0,659.0,5,1062,1.0,794.0,794.0
0.038,17,4,284,2,120,0.0,32.0,32.0,2,164,35.0,60.0,54.0
0.005,6,10,2000,5,927,1.0,659.0,659.0,5,1073,1.0,805.0,805.0
0.005,6,10,2006,5,927,1.0,659.0,659.0,5,1079,1.0,811.0,811.0
10.93,17,28,4398,14,2312,832.0,587.0,137.0,14,2086,832.0,269.0,121.0
1777.94,17,142,41232,72,22752,25041.0,288.0,288.0,70,18480,25767.0,236.0,236.0
0.005,6,10,2006,5,927,1.0,659.0,659.0,5,1079,1.0,811.0,811.0
9.039,17,6,376,5,280,2259.0,28.0,28.0,1,96,0.0,68.0,68.0
0.005,6,10,2006,5,927,1.0,659.0,659.0,5,1079,1.0,811.0,811.0
40.074,17,10,676,5,460,10015.0,104.0,64.0,5,216,10017.0,20.0,15.0
0.039,17,2,152,1,76,0.0,48.0,48.0,1,76,0.0,48.0,48.0
0.009,6,10,1990,5,911,2.0,643.0,643.0,5,1079,2.0,811.0,811.0
0.007,6,10,2000,5,927,1.0,659.0,659.0,5,1073,1.0,805.0,805.0
0.017,6,10,1990,5,911,4.0,643.0,643.0,5,1079,4.0,811.0,811.0
0.066,17,8,3613,4,1874,22.0,1350.0,440.0,4,1739,11.0,1350.0,406.0
0.013,6,10,1605,5,388,3.0,120.0,120.0,5,1217,3.0,949.0,949.0
0.008,6,10,1989,5,910,2.0,642.0,642.0,5,1079,1.0,811.0,811.0
0.146,6,10,1506,5,395,29.0,127.0,127.0,5,1111,34.0,843.0,843.0
0.001,17,2,140,1,62,0.0,34.0,34.0,1,78,0.0,50.0,50.0
40.068,17,10,676,5,460,10014.0,104.0,64.0,5,216,10016.0,20.0,15.0
0.144,6,10,1506,5,395,28.0,127.0,127.0,5,1111,29.0,843.0,843.0
0.004,6,10,2007,5,928,1.0,660.0,660.0,5,1079,1.0,811.0,811.0
0.015,6,10,1989,5,910,3.0,642.0,642.0,5,1079,3.0,811.0,811.0
0.004,6,10,2000,5,927,1.0,659.0,659.0,5,1073,1.0,805.0,805.0
0.007,6,10,1990,5,911,1.0,643.0,643.0,5,1079,1.0,811.0,811.0
0.027,6,10,1989,5,910,6.0,642.0,642.0,5,1079,6.0,811.0,811.0
0.004,6,10,2007,5,928,1.0,660.0,660.0,5,1079,1.0,811.0,811.0
0.021,6,10,1983,5,910,5.0,642.0,642.0,5,1073,5.0,805.0,805.0
0.008,6,10,1989,5,910,2.0,642.0,642.0,5,1079,1.0,811.0,811.0
0.084,6,10,1506,5,395,18.0,127.0,127.0,5,1111,18.0,843.0,843.0
0.02,6,10,1990,5,911,5.0,643.0,643.0,5,1079,5.0,811.0,811.0
0.015,6,10,1983,5,910,3.0,642.0,642.0,5,1073,3.0,805.0,805.0
0.008,6,13,3735,7,497,1.0,125.0,125.0,6,3238,1.0,1470.0,1459.0
0.111,6,10,1506,5,395,25.0,127.0,127.0,5,1111,23.0,843.0,843.0
0.005,6,10,2006,5,927,1.0,659.0,659.0,5,1079,1.0,811.0,811.0
0.01,6,10,1972,5,910,2.0,642.0,642.0,5,1062,2.0,794.0,794.0
0.004,6,10,2006,5,927,1.0,659.0,659.0,5,1079,1.0,811.0,811.0
11.044,17,28,4397,14,2311,840.0,586.0,137.0,14,2086,840.0,269.0,121.0
0.084,6,10,1506,5,395,19.0,127.0,127.0,5,1111,14.0,843.0,843.0
0.008,6,10,2006,5,927,2.0,659.0,659.0,5,1079,1.0,811.0,811.0
0.005,17,2,169,1,62,0.0,34.0,34.0,1,107,0.0,79.0,79.0
0.004,17,4,284,2,120,0.0,32.0,32.0,2,164,0.0,60.0,54.0
0.004,6,10,2000,5,927,1.0,659.0,659.0,5,1073,1.0,805.0,805.0
0.005,6,10,2006,5,927,1.0,659.0,659.0,5,1079,1.0,811.0,811.0
0.079,6,10,1506,5,395,17.0,127.0,127.0,5,1111,17.0,843.0,843.0
0.005,6,10,1989,5,927,1.0,659.0,659.0,5,1062,1.0,794.0,794.0
0.014,6,10,1972,5,910,3.0,642.0,642.0,5,1062,3.0,794.0,794.0
0.001,17,2,180,1,66,0.0,38.0,38.0,1,114,0.0,86.0,86.0
0.004,6,10,1702,5,863,1.0,595.0,595.0,5,839,0.0,571.0,571.0
0.131,17,2,144,1,64,0.0,36.0,36.0,1,80,0.0,52.0,52.0
0.006,6,10,2006,5,927,1.0,659.0,659.0,5,1079,1.0,811.0,811.0
0.006,6,10,2007,5,928,1.0,660.0,660.0,5,1079,1.0,811.0,811.0
0.089,6,10,1506,5,395,20.0,127.0,127.0,5,1111,17.0,843.0,843.0
0.043,17,4,352,2,130,1.0,37.0,37.0,2,222,39.0,89.0,83.0
0.007,17,2,140,1,62,0.0,34.0,34.0,1,78,0.0,50.0,50.0
0.005,17,2,169,1,62,0.0,34.0,34.0,1,107,0.0,79.0,79.0
0.005,6,10,1689,5,839,1.0,571.0,571.0,5,850,1.0,582.0,582.0
0.264,17,39,20207,21,17028,13.0,1350.0,782.0,18,3179,12.0,1350.0,148.0
0.003,17,2,185,1,73,0.0,45.0,45.0,1,112,0.0,84.0,84.0
0.083,6,10,1506,5,395,16.0,127.0,127.0,5,1111,19.0,843.0,843.0
0.01,6,10,1983,5,910,2.0,642.0,642.0,5,1073,2.0,805.0,805.0
0.088,6,10,1506,5,395,19.0,127.0,127.0,5,1111,20.0,843.0,843.0
0.129,17,2,80,1,32,0.0,4.0,4.0,1,48,0.0,20.0,20.0
0.001,17,2,180,1,66,0.0,38.0,38.0,1,114,0.0,86.0,86.0
0.025,6,10,1989,5,910,6.0,642.0,642.0,5,1079,6.0,811.0,811.0
0.141,6,10,1506,5,395,31.0,127.0,127.0,5,1111,31.0,843.0,843.0
0.004,6,10,2006,5,927,1.0,659.0,659.0,5,1079,1.0,811.0,811.0
40.087,17,10,676,5,460,10020.0,104.0,64.0,5,216,10020.0,20.0,15.0
0.006,6,10,1689,5,839,1.0,571.0,571.0,5,850,1.0,582.0,582.0
0.011,6,10,1989,5,910,2.0,642.0,642.0,5,1079,2.0,811.0,811.0
0.082,6,10,1506,5,395,18.0,127.0,127.0,5,1111,17.0,843.0,843.0
0.005,17,2,164,1,74,0.0,46.0,46.0,1,90,0.0,62.0,62.0
0.001,17,2,180,1,66,0.0,38.0,38.0,1,114,0.0,86.0,86.0
0.005,6,10,2000,5,927,1.0,659.0,659.0,5,1073,1.0,805.0,805.0
0.014,6,10,1989,5,910,3.0,642.0,642.0,5,1079,3.0,811.0,811.0
0.005,17,2,214,1,75,0.0,47.0,47.0,1,139,0.0,111.0,111.0
0.097,6,10,1506,5,395,21.0,127.0,127.0,5,1111,21.0,843.0,843.0
0.022,6,10,1990,5,911,5.0,643.0,643.0,5,1079,5.0,811.0,811.0
264.614,17,18,1008,9,640,33060.0,48.0,43.0,9,368,33060.0,20.0,12.0
10.802,17,28,4423,14,1995,822.0,270.0,114.0,14,2428,822.0,587.0,145.0
0.006,6,10,1547,5,764,1.0,496.0,496.0,5,783,1.0,515.0,515.0
0.001,17,2,180,1,66,0.0,38.0,38.0,1,114,0.0,86.0,86.0
0.005,6,10,2006,5,927,1.0,659.0,659.0,5,1079,1.0,811.0,811.0
0.116,6,10,1506,5,395,26.0,127.0,127.0,5,1111,27.0,843.0,843.0
0.009,6,12,1926,6,1189,1.0,659.0,434.0,6,737,1.0,417.0,417.0
0.006,17,2,170,1,65,0.0,37.0,37.0,1,105,0.0,77.0,77.0
0.01,6,10,1990,5,911,2.0,643.0,643.0,5,1079,2.0,811.0,811.0
0.005,6,10,2007,5,928,1.0,660.0,660.0,5,1079,1.0,811.0,811.0
0.005,6,10,2007,5,928,1.0,660.0,660.0,5,1079,1.0,811.0,811.0
40.065,17,10,676,5,460,10015.0,104.0,64.0,5,216,10015.0,20.0,15.0
10.788,17,28,4421,14,1993,821.0,268.0,114.0,14,2428,821.0,587.0,145.0
241.655,6,314,343245,116,17545,2101.0,2736.0,959.0,198,325700,1226.0,2804.0,1677.0
0.006,6,10,2006,5,927,1.0,659.0,659.0,5,1079,1.0,811.0,811.0
0.009,6,10,1972,5,910,2.0,642.0,642.0,5,1062,2.0,794.0,794.0
300.318,6,16,2170,9,684,37518.0,146.0,146.0,7,1486,50025.0,419.0,398.0
0.009,6,13,3735,7,497,1.0,125.0,125.0,6,3238,1.0,1470.0,1459.0
0.005,6,10,1854,5,889,1.0,621.0,621.0,5,965,1.0,697.0,697.0
0.004,17,2,148,1,60,0.0,32.0,32.0,1,88,0.0,60.0,60.0
0.017,6,10,1989,5,910,4.0,642.0,642.0,5,1079,4.0,811.0,811.0
0.011,6,10,1972,5,910,2.0,642.0,642.0,5,1062,2.0,794.0,794.0
0.004,6,10,1779,5,928,1.0,660.0,660.0,5,851,1.0,583.0,583.0
0.004,6,10,2006,5,927,1.0,659.0,659.0,5,1079,1.0,811.0,811.0
0.001,17,2,180,1,66,0.0,38.0,38.0,1,114,0.0,86.0,86.0
0.006,6,10,1547,5,764,1.0,496.0,496.0,5,783,1.0,515.0,515.0
0.005,6,10,1989,5,927,1.0,659.0,659.0,5,1062,1.0,794.0,794.0
0.005,6,10,1547,5,764,1.0,496.0,496.0,5,783,1.0,515.0,515.0
0.101,6,10,1506,5,395,21.0,127.0,127.0,5,1111,17.0,843.0,843.0
0.004,6,10,1989,5,927,1.0,659.0,659.0,5,1062,1.0,794.0,794.0
0.01,6,12,1926,6,1189,1.0,659.0,434.0,6,737,2.0,417.0,417.0
240.09,6,16,4481,9,963,30011.0,238.0,166.0,7,3518,40014.0,1402.0,786.0
0.068,17,8,3613,4,1874,22.0,1350.0,440.0,4,1739,12.0,1350.0,406.0
0.104,6,10,1506,5,395,23.0,127.0,127.0,5,1111,23.0,843.0,843.0
0.805,6,25,5555,12,1445,61.0,267.0,136.0,13,4110,56.0,1414.0,597.0
0.011,6,10,1762,5,911,2.0,643.0,643.0,5,851,2.0,583.0,583.0
11.177,17,28,4422,14,1994,847.0,269.0,114.0,14,2428,847.0,587.0,145.0
0.011,6,10,1983,5,910,2.0,642.0,642.0,5,1073,2.0,805.0,805.0
0.005,6,10,2007,5,928,1.0,660.0,660.0,5,1079,1.0,811.0,811.0
0.01,6,10,1990,5,911,2.0,643.0,643.0,5,1079,2.0,811.0,811.0
0.004,6,10,2007,5,928,1.0,660.0,660.0,5,1079,1.0,811.0,811.0
0.005,6,10,2000,5,927,1.0,659.0,659.0,5,1073,1.0,805.0,805.0
240.098,6,16,4479,9,963,30012.0,238.0,166.0,7,3516,40015.0,1402.0,786.0
40.075,17,10,676,5,460,10017.0,104.0,64.0,5,216,10017.0,20.0,15.0
0.013,6,10,1677,5,827,3.0,559.0,559.0,5,850,3.0,582.0,582.0
0.065,6,10,1506,5,395,15.0,127.0,127.0,5,1111,15.0,843.0,843.0
0.004,6,14,3799,7,509,0.0,137.0,137.0,7,3290,0.0,1448.0,972.0
240.279,6,35,10319,18,2211,14133.0,555.0,253.0,17,8108,15017.0,1504.0,657.0
0.006,6,12,1698,6,863,1.0,327.0,271.0,6,835,1.0,515.0,515.0
0.072,6,10,1506,5,395,16.0,127.0,127.0,5,1111,17.0,843.0,843.0
0.006,6,10,1702,5,863,1.0,595.0,595.0,5,839,1.0,571.0,571.0
0.005,6,10,1989,5,927,1.0,659.0,659.0,5,1062,1.0,794.0,794.0
0.021,6,10,1989,5,910,5.0,642.0,642.0,5,1079,5.0,811.0,811.0
0.01,6,10,1989,5,910,2.0,642.0,642.0,5,1079,2.0,811.0,811.0
0.561,6,22,7185,11,1635,55.0,748.0,263.0,11,5550,54.0,2333.0,994.0
0.012,6,10,1990,5,911,3.0,643.0,643.0,5,1079,2.0,811.0,811.0
0.006,17,2,214,1,75,0.0,47.0,47.0,1,139,0.0,111.0,111.0
0.005,6,10,2000,5,927,1.0,659.0,659.0,5,1073,1.0,805.0,805.0
0.016,6,10,1990,5,911,3.0,643.0,643.0,5,1079,4.0,811.0,811.0
0.001,17,2,136,1,60,0.0,32.0,32.0,1,76,0.0,48.0,48.0
0.001,17,2,180,1,66,0.0,38.0,38.0,1,114,0.0,86.0,86.0
0.008,17,2,136,1,60,0.0,32.0,32.0,1,76,0.0,48.0,48.0
0.016,6,10,1989,5,910,4.0,642.0,642.0,5,1079,3.0,811.0,811.0
0.081,6,10,1506,5,395,18.0,127.0,127.0,5,1111,18.0,843.0,843.0
0.005,6,10,2006,5,927,1.0,659.0,659.0,5,1079,1.0,811.0,811.0
0.065,6,10,1506,5,395,15.0,127.0,127.0,5,1111,15.0,843.0,843.0
0.013,6,10,1990,5,911,3.0,643.0,643.0,5,1079,3.0,811.0,811.0
300.313,6,19,3084,11,1647,30031.0,517.0,266.0,8,1437,34329.0,824.0,337.0
0.003,17,2,148,1,60,0.0,32.0,32.0,1,88,0.0,60.0,60.0
0.007,6,10,1689,5,839,1.0,571.0,571.0,5,850,1.0,582.0,582.0
0.009,6,10,2007,5,928,2.0,660.0,660.0,5,1079,2.0,811.0,811.0
0.037,17,2,170,1,65,0.0,37.0,37.0,1,105,0.0,77.0,77.0
15.073,17,15,9238,8,6902,2149.0,1350.0,834.0,7,2336,2507.0,1350.0,305.0
0.012,6,10,1990,5,911,3.0,643.0,643.0,5,1079,3.0,811.0,811.0
0.005,17,2,166,1,75,0.0,47.0,47.0,1,91,0.0,63.0,63.0
308.953,17,20,1124,10,716,34309.0,48.0,43.0,10,408,34315.0,20.0,12.0
0.006,6,10,1547,5,764,1.0,496.0,496.0,5,783,1.0,515.0,515.0
0.005,6,10,1989,5,927,1.0,659.0,659.0,5,1062,1.0,794.0,794.0
0.013,6,10,1631,5,848,3.0,580.0,580.0,5,783,3.0,515.0,515.0
0.003,17,4,284,2,120,0.0,32.0,32.0,2,164,0.0,60.0,54.0
0.014,6,13,3735,7,497,2.0,125.0,125.0,6,3238,2.0,1470.0,1459.0
0.003,17,2,148,1,60,0.0,32.0,32.0,1,88,0.0,60.0,60.0
0.004,6,10,2006,5,927,1.0,659.0,659.0,5,1079,1.0,811.0,811.0
0.005,6,10,2007,5,928,1.0,660.0,660.0,5,1079,1.0,811.0,811.0
0.02,6,10,1989,5,910,4.0,642.0,642.0,5,1079,5.0,811.0,811.0
0.114,6,10,1506,5,395,27.0,127.0,127.0,5,1111,23.0,843.0,843.0
0.014,6,10,1972,5,910,3.0,642.0,642.0,5,1062,3.0,794.0,794.0
0.008,6,10,1989,5,910,2.0,642.0,642.0,5,1079,1.0,811.0,811.0
0.008,6,10,1972,5,910,2.0,642.0,642.0,5,1062,2.0,794.0,794.0
0.005,17,2,170,1,65,0.0,37.0,37.0,1,105,0.0,77.0,77.0
0.101,6,10,1506,5,395,19.0,127.0,127.0,5,1111,21.0,843.0,843.0
0.169,17,2,152,1,76,0.0,48.0,48.0,1,76,0.0,48.0,48.0
0.12,6,10,1506,5,395,26.0,127.0,127.0,5,1111,22.0,843.0,843.0
15.073,17,15,9238,8,6902,2149.0,1350.0,834.0,7,2336,2507.0,1350.0,305.0
0.014,6,13,3735,7,497,2.0,125.0,125.0,6,3238,2.0,1470.0,1459.0
0.001,17,2,132,1,58,0.0,30.0,30.0,1,74,0.0,46.0,46.0
0.001,17,2,180,1,66,0.0,38.0,38.0,1,114,0.0,86.0,86.0
360.026,6,21,3981,13,3142,30002.0,494.0,494.0,8,839,51431.0,83.0,83.0
0.005,6,10,2006,5,927,1.0,659.0,659.0,5,1079,1.0,811.0,811.0
0.006,6,10,1547,5,764,1.0,496.0,496.0,5,783,1.0,515.0,515.0
0.009,6,12,1926,6,1189,1.0,659.0,434.0,6,737,1.0,417.0,417.0
0.119,6,10,1506,5,395,28.0,127.0,127.0,5,1111,24.0,843.0,843.0
85.819,6,26,14469,14,6900,76.0,3225.0,1261.0,12,7569,7786.0,2720.0,1179.0
240.092,6,32,9356,15,6916,17149.0,2028.0,680.0,17,2440,15005.0,580.0,193.0
0.095,6,10,1506,5,395,20.0,127.0,127.0,5,1111,20.0,843.0,843.0
0.005,6,13,3747,7,509,0.0,137.0,137.0,6,3238,0.0,1470.0,1459.0
0.006,17,2,144,1,64,0.0,36.0,36.0,1,80,0.0,52.0,52.0
0.011,17,18,2571,9,606,0.0,44.0,39.0,9,1965,1.0,252.0,190.0
0.007,6,10,1989,5,910,1.0,642.0,642.0,5,1079,1.0,811.0,811.0
0.004,6,10,2007,5,928,1.0,660.0,660.0,5,1079,1.0,811.0,811.0
0.101,6,10,1506,5,395,24.0,127.0,127.0,5,1111,23.0,843.0,843.0
0.009,6,10,1990,5,911,2.0,643.0,643.0,5,1079,2.0,811.0,811.0
0.01,6,10,1989,5,910,2.0,642.0,642.0,5,1079,2.0,811.0,811.0
0.001,17,2,180,1,66,0.0,38.0,38.0,1,114,0.0,86.0,86.0
0.09,6,10,1506,5,395,20.0,127.0,127.0,5,1111,20.0,843.0,843.0
0.006,17,2,214,1,75,0.0,47.0,47.0,1,139,0.0,111.0,111.0
0.027,6,10,1989,5,910,6.0,642.0,642.0,5,1079,6.0,811.0,811.0
0.006,17,2,299,1,65,0.0,37.0,37.0,1,234,0.0,206.0,206.0
0.005,6,10,2007,5,928,1.0,660.0,660.0,5,1079,1.0,811.0,811.0
0.184,6,10,1506,5,395,41.0,127.0,127.0,5,1111,42.0,843.0,843.0
0.029,6,12,1926,6,1189,5.0,659.0,434.0,6,737,5.0,417.0,417.0
0.008,6,13,3735,7,497,1.0,125.0,125.0,6,3238,1.0,1470.0,1459.0
11.185,17,28,4417,14,1993,847.0,268.0,114.0,14,2424,847.0,587.0,145.0
0.009,6,10,1989,5,910,2.0,642.0,642.0,5,1079,2.0,811.0,811.0
0.011,6,10,1983,5,910,2.0,642.0,642.0,5,1073,2.0,805.0,805.0
0.005,6,10,2007,5,928,1.0,660.0,660.0,5,1079,1.0,811.0,811.0
0.005,17,2,144,1,64,0.0,36.0,36.0,1,80,0.0,52.0,52.0
0.092,6,10,1506,5,395,21.0,127.0,127.0,5,1111,19.0,843.0,843.0
0.005,6,10,2006,5,927,1.0,659.0,659.0,5,1079,1.0,811.0,811.0
0.005,17,2,144,1,64,0.0,36.0,36.0,1,80,0.0,52.0,52.0
0.104,6,10,1506,5,395,21.0,127.0,127.0,5,1111,24.0,843.0,843.0
40.044,17,10,676,5,460,10006.0,104.0,64.0,5,216,10008.0,20.0,15.0
0.016,6,10,1972,5,910,4.0,642.0,642.0,5,1062,3.0,794.0,794.0
0.259,17,4,580,2,122,123.0,33.0,33.0,2,458,222.0,307.0,201.0
40.062,17,10,676,5,460,10014.0,104.0,64.0,5,216,10014.0,20.0,15.0
0.059,17,2,152,1,76,0.0,48.0,48.0,1,76,0.0,48.0,48.0
0.009,6,10,1972,5,910,2.0,642.0,642.0,5,1062,2.0,794.0,794.0
0.004,17,2,136,1,60,0.0,32.0,32.0,1,76,0.0,48.0,48.0
0.005,17,2,169,1,62,0.0,34.0,34.0,1,107,0.0,79.0,79.0
0.006,6,10,1854,5,889,1.0,621.0,621.0,5,965,1.0,697.0,697.0
1792.625,6,490,99412,246,88062,7316.0,421.0,365.0,244,11350,7376.0,53.0,53.0
0.009,6,10,1677,5,827,2.0,559.0,559.0,5,850,2.0,582.0,582.0
0.004,6,10,2006,5,927,1.0,659.0,659.0,5,1079,1.0,811.0,811.0
11.098,17,28,4421,14,1994,841.0,269.0,114.0,14,2427,841.0,586.0,145.0
0.597,6,28,13518,15,3899,42.0,1512.0,780.0,13,9619,49.0,1402.0,992.0
254.426,6,27,7779,12,3336,23129.0,1031.0,679.0,15,4443,18173.0,1162.0,406.0
0.004,17,4,284,2,120,0.0,32.0,32.0,2,164,0.0,60.0,54.0
0.004,17,2,249,1,64,0.0,36.0,36.0,1,185,0.0,157.0,157.0
0.041,17,2,170,1,65,0.0,37.0,37.0,1,105,0.0,77.0,77.0
0.043,17,2,186,1,61,0.0,33.0,33.0,1,125,0.0,97.0,97.0
0.008,6,10,1972,5,910,2.0,642.0,642.0,5,1062,2.0,794.0,794.0
240.568,6,33,9269,16,1837,16035.0,625.0,199.0,17,7432,15033.0,1402.0,595.0
0.004,17,2,208,1,72,0.0,44.0,44.0,1,136,0.0,108.0,108.0
0.011,6,10,1631,5,848,2.0,580.0,580.0,5,783,2.0,515.0,515.0
0.03,6,10,1989,5,910,7.0,642.0,642.0,5,1079,7.0,811.0,811.0
40.075,17,10,676,5,460,10015.0,104.0,64.0,5,216,10016.0,20.0,15.0
0.011,6,10,1989,5,910,2.0,642.0,642.0,5,1079,2.0,811.0,811.0
0.005,6,10,1689,5,839,1.0,571.0,571.0,5,850,1.0,582.0,582.0
40.065,17,10,676,5,460,10015.0,104.0,64.0,5,216,10015.0,20.0,15.0
0.097,6,10,1506,5,395,22.0,127.0,127.0,5,1111,20.0,843.0,843.0
40.074,17,10,676,5,460,10016.0,104.0,64.0,5,216,10017.0,20.0,15.0
0.016,6,10,1990,5,911,3.0,643.0,643.0,5,1079,4.0,811.0,811.0
0.005,6,10,2007,5,928,1.0,660.0,660.0,5,1079,1.0,811.0,811.0
0.009,6,12,1926,6,1189,1.0,659.0,434.0,6,737,1.0,417.0,417.0
0.039,17,2,184,1,61,0.0,33.0,33.0,1,123,0.0,95.0,95.0
0.037,17,2,170,1,65,0.0,37.0,37.0,1,105,0.0,77.0,77.0
40.078,17,10,676,5,460,10018.0,104.0,64.0,5,216,10018.0,20.0,15.0
0.01,6,12,1926,6,1189,2.0,659.0,434.0,6,737,1.0,417.0,417.0
0.012,6,10,1990,5,911,2.0,643.0,643.0,5,1079,3.0,811.0,811.0
0.005,6,10,1989,5,927,1.0,659.0,659.0,5,1062,1.0,794.0,794.0
1799.69,17,122,11651,61,5551,29994.0,63.0,63.0,61,6100,29994.0,72.0,72.0
0.005,6,10,2007,5,928,1.0,660.0,660.0,5,1079,1.0,811.0,811.0
0.05,6,10,1506,5,395,11.0,127.0,127.0,5,1111,11.0,843.0,843.0
0.069,6,10,1506,5,395,14.0,127.0,127.0,5,1111,16.0,843.0,843.0
0.009,17,2,140,1,62,0.0,34.0,34.0,1,78,0.0,50.0,50.0
0.004,17,2,136,1,60,0.0,32.0,32.0,1,76,0.0,48.0,48.0
0.015,6,10,1990,5,911,3.0,643.0,643.0,5,1079,3.0,811.0,811.0
0.02,6,10,1972,5,910,5.0,642.0,642.0,5,1062,5.0,794.0,794.0
0.015,6,10,1989,5,910,3.0,642.0,642.0,5,1079,3.0,811.0,811.0
354.054,6,21,1795,16,1030,23603.0,190.0,190.0,5,765,60003.0,464.0,248.0
40.063,17,10,676,5,460,10014.0,104.0,64.0,5,216,10014.0,20.0,15.0
0.087,6,10,1506,5,395,19.0,127.0,127.0,5,1111,21.0,843.0,843.0
0.005,6,10,2007,5,928,1.0,660.0,660.0,5,1079,1.0,811.0,811.0
0.073,6,10,1506,5,395,15.0,127.0,127.0,5,1111,14.0,843.0,843.0
0.005,17,2,222,1,65,0.0,37.0,37.0,1,157,0.0,129.0,129.0
0.009,6,10,1972,5,910,2.0,642.0,642.0,5,1062,2.0,794.0,794.0
0.004,6,10,2000,5,927,1.0,659.0,659.0,5,1073,1.0,805.0,805.0
0.004,6,10,1702,5,863,0.0,595.0,595.0,5,839,1.0,571.0,571.0
0.005,6,10,2006,5,927,1.0,659.0,659.0,5,1079,1.0,811.0,811.0
0.004,6,10,1702,5,863,1.0,595.0,595.0,5,839,0.0,571.0,571.0
0.006,6,10,1547,5,764,1.0,496.0,496.0,5,783,1.0,515.0,515.0
0.071,17,4,284,2,120,0.0,32.0,32.0,2,164,36.0,60.0,54.0
0.018,6,10,1762,5,911,4.0,643.0,643.0,5,851,4.0,583.0,583.0
0.022,6,10,1677,5,827,5.0,559.0,559.0,5,850,5.0,582.0,582.0
0.119,6,10,1506,5,395,26.0,127.0,127.0,5,1111,24.0,843.0,843.0
40.066,17,10,676,5,460,10013.0,104.0,64.0,5,216,10015.0,20.0,15.0
0.005,6,13,3747,7,509,0.0,137.0,137.0,6,3238,0.0,1470.0,1459.0
0.218,17,14,8577,7,4012,36.0,1350.0,545.0,7,4565,27.0,1350.0,624.0
10.766,17,28,4421,14,1994,819.0,269.0,114.0,14,2427,819.0,586.0,145.0
0.007,6,10,1989,5,910,1.0,642.0,642.0,5,1079,1.0,811.0,811.0
40.083,17,10,676,5,460,10017.0,104.0,64.0,5,216,10020.0,20.0,15.0
0.096,6,10,1506,5,395,20.0,127.0,127.0,5,1111,18.0,843.0,843.0
0.012,6,10,1990,5,911,3.0,643.0,643.0,5,1079,3.0,811.0,811.0
0.096,6,10,1506,5,395,16.0,127.0,127.0,5,1111,21.0,843.0,843.0
0.071,6,10,1506,5,395,16.0,127.0,127.0,5,1111,16.0,843.0,843.0
0.004,6,10,1774,5,923,1.0,655.0,655.0,5,851,1.0,583.0,583.0
172.045,17,88,12184,44,2942,4000.0,44.0,38.0,44,9242,4000.0,239.0,182.0
0.005,6,10,2007,5,928,1.0,660.0,660.0,5,1079,1.0,811.0,811.0
240.094,6,16,4480,9,963,30011.0,238.0,166.0,7,3517,40015.0,1402.0,786.0
0.022,6,10,1983,5,910,5.0,642.0,642.0,5,1073,5.0,805.0,805.0
0.005,17,2,144,1,64,0.0,36.0,36.0,1,80,0.0,52.0,52.0
0.176,6,10,1506,5,395,37.0,127.0,127.0,5,1111,28.0,843.0,843.0
0.004,17,4,284,2,120,0.0,32.0,32.0,2,164,0.0,60.0,54.0
0.006,6,10,2006,5,927,1.0,659.0,659.0,5,1079,1.0,811.0,811.0
0.069,6,10,1506,5,395,16.0,127.0,127.0,5,1111,16.0,843.0,843.0
0.005,6,10,1989,5,927,1.0,659.0,659.0,5,1062,1.0,794.0,794.0
2.183,6,38,7266,22,4046,103.0,1103.0,222.0,16,3220,137.0,1796.0,396.0
0.073,6,10,1506,5,395,16.0,127.0,127.0,5,1111,15.0,843.0,843.0
0.006,6,10,1689,5,839,1.0,571.0,571.0,5,850,1.0,582.0,582.0
240.026,6,9,787,5,488,60006.0,232.0,232.0,4,299,80005.0,83.0,83.0
0.085,6,10,1506,5,395,18.0,127.0,127.0,5,1111,20.0,843.0,843.0
40.063,17,10,676,5,460,10014.0,104.0,64.0,5,216,10015.0,20.0,15.0
0.013,6,10,1989,5,910,3.0,642.0,642.0,5,1079,3.0,811.0,811.0
0.017,6,10,1989,5,910,4.0,642.0,642.0,5,1079,4.0,811.0,811.0
0.081,6,10,1506,5,395,18.0,127.0,127.0,5,1111,17.0,843.0,843.0
0.111,6,10,1506,5,395,25.0,127.0,127.0,5,1111,24.0,843.0,843.0
0.235,17,4,352,2,130,108.0,37.0,37.0,2,222,232.0,89.0,83.0
10.725,17,28,4424,14,1995,816.0,270.0,114.0,14,2429,816.0,588.0,145.0
0.002,17,2,132,1,58,0.0,30.0,30.0,1,74,0.0,46.0,46.0
0.008,6,10,2006,5,927,2.0,659.0,659.0,5,1079,1.0,811.0,811.0
0.012,6,10,1990,5,911,3.0,643.0,643.0,5,1079,2.0,811.0,811.0
0.01,17,2,164,1,74,0.0,46.0,46.0,1,90,0.0,62.0,62.0
0.005,6,14,3742,8,504,0.0,80.0,80.0,6,3238,1.0,1470.0,1459.0
0.004,17,2,148,1,60,0.0,32.0,32.0,1,88,0.0,60.0,60.0
0.17,6,3,453,2,321,170.0,241.0,241.0,1,132,0.0,92.0,92.0
0.005,6,13,3747,7,509,0.0,137.0,137.0,6,3238,1.0,1470.0,1459.0
0.003,17,2,156,1,64,0.0,36.0,36.0,1,92,0.0,64.0,64.0
0.007,6,13,3816,7,578,1.0,206.0,206.0,6,3238,1.0,1470.0,1459.0
0.005,6,10,2006,5,927,1.0,659.0,659.0,5,1079,1.0,811.0,811.0
0.005,17,2,169,1,62,0.0,34.0,34.0,1,107,0.0,79.0,79.0
0.004,6,10,2006,5,927,1.0,659.0,659.0,5,1079,1.0,811.0,811.0
15.072,17,14,9190,8,6902,2149.0,1350.0,834.0,6,2288,3008.0,1350.0,353.0
0.005,6,10,1702,5,863,1.0,595.0,595.0,5,839,1.0,571.0,571.0
0.001,17,2,180,1,66,0.0,38.0,38.0,1,114,0.0,86.0,86.0
0.005,6,10,1989,5,927,1.0,659.0,659.0,5,1062,1.0,794.0,794.0
0.128,17,2,80,1,32,0.0,4.0,4.0,1,48,0.0,20.0,20.0
0.005,17,2,146,1,65,0.0,37.0,37.0,1,81,0.0,53.0,53.0
0.011,6,10,1989,5,910,2.0,642.0,642.0,5,1079,2.0,811.0,811.0
0.011,6,10,1989,5,927,2.0,659.0,659.0,5,1062,2.0,794.0,794.0
0.005,6,10,1689,5,839,1.0,571.0,571.0,5,850,1.0,582.0,582.0
0.016,6,10,1989,5,910,3.0,642.0,642.0,5,1079,3.0,811.0,811.0
0.005,6,10,2006,5,927,1.0,659.0,659.0,5,1079,1.0,811.0,811.0
0.071,17,2,182,1,65,0.0,37.0,37.0,1,117,0.0,89.0,89.0
242.72,6,387,352106,194,21894,1257.0,2736.0,959.0,193,330212,1264.0,4206.0,1749.0
0.017,6,10,1990,5,911,4.0,643.0,643.0,5,1079,4.0,811.0,811.0
0.019,6,10,1983,5,910,4.0,642.0,642.0,5,1073,4.0,805.0,805.0
158.47,17,74,10655,37,2461,4401.0,44.0,38.0,37,8194,4401.0,261.0,193.0
0.005,6,10,1989,5,927,1.0,659.0,659.0,5,1062,1.0,794.0,794.0
0.005,6,10,2007,5,928,1.0,660.0,660.0,5,1079,1.0,811.0,811.0
0.016,6,10,1990,5,911,4.0,643.0,643.0,5,1079,3.0,811.0,811.0
1.307,6,31,12751,18,3352,76.0,1360.0,517.0,13,9399,92.0,2720.0,985.0
315.942,17,18,1008,9,640,39483.0,48.0,43.0,9,368,39479.0,20.0,12.0
308.38,17,20,1124,10,716,34250.0,48.0,43.0,10,408,34250.0,20.0,12.0
40.077,17,10,676,5,460,10018.0,104.0,64.0,5,216,10018.0,20.0,15.0
0.006,6,10,1854,5,889,1.0,621.0,621.0,5,965,1.0,697.0,697.0
0.005,6,10,2006,5,927,1.0,659.0,659.0,5,1079,1.0,811.0,811.0
0.007,6,10,1702,5,863,1.0,595.0,595.0,5,839,1.0,571.0,571.0
0.008,6,10,1972,5,910,2.0,642.0,642.0,5,1062,1.0,794.0,794.0
0.004,6,10,2006,5,927,1.0,659.0,659.0,5,1079,1.0,811.0,811.0
0.011,6,10,1990,5,911,2.0,643.0,643.0,5,1079,2.0,811.0,811.0
0.072,17,2,148,1,60,0.0,32.0,32.0,1,88,0.0,60.0,60.0
0.011,6,10,1989,5,910,2.0,642.0,642.0,5,1079,2.0,811.0,811.0
0.013,6,10,1990,5,911,3.0,643.0,643.0,5,1079,3.0,811.0,811.0
0.004,6,10,1989,5,927,1.0,659.0,659.0,5,1062,1.0,794.0,794.0
0.007,6,10,1547,5,764,1.0,496.0,496.0,5,783,1.0,515.0,515.0
0.017,6,10,1605,5,388,4.0,120.0,120.0,5,1217,4.0,949.0,949.0
0.005,6,10,1989,5,927,1.0,659.0,659.0,5,1062,1.0,794.0,794.0
0.001,17,2,166,1,75,0.0,47.0,47.0,1,91,0.0,63.0,63.0
0.006,17,2,148,1,60,0.0,32.0,32.0,1,88,0.0,60.0,60.0
0.079,17,2,80,1,32,0.0,4.0,4.0,1,48,0.0,20.0,20.0
0.132,6,10,1506,5,395,31.0,127.0,127.0,5,1111,31.0,843.0,843.0
0.057,6,10,1506,5,395,13.0,127.0,127.0,5,1111,13.0,843.0,843.0
0.019,6,10,1762,5,911,4.0,643.0,643.0,5,851,4.0,583.0,583.0
0.166,17,2,152,1,76,0.0,48.0,48.0,1,76,0.0,48.0,48.0
0.005,6,10,1643,5,860,1.0,592.0,592.0,5,783,1.0,515.0,515.0
0.006,6,10,1689,5,839,1.0,571.0,571.0,5,850,1.0,582.0,582.0
40.062,17,10,676,5,460,10014.0,104.0,64.0,5,216,10014.0,20.0,15.0
0.04,17,2,148,1,60,0.0,32.0,32.0,1,88,0.0,60.0,60.0
0.097,6,10,1506,5,395,22.0,127.0,127.0,5,1111,22.0,843.0,843.0
0.121,6,10,1506,5,395,27.0,127.0,127.0,5,1111,25.0,843.0,843.0
15.07,17,15,9239,8,6902,2148.0,1350.0,834.0,7,2337,2506.0,1350.0,305.0
40.052,17,10,676,5,460,10012.0,104.0,64.0,5,216,10012.0,20.0,15.0
40.055,17,10,676,5,460,10012.0,104.0,64.0,5,216,10011.0,20.0,15.0
0.01,6,10,1989,5,910,2.0,642.0,642.0,5,1079,2.0,811.0,811.0
0.094,6,10,1506,5,395,22.0,127.0,127.0,5,1111,19.0,843.0,843.0
0.013,6,10,1762,5,911,3.0,643.0,643.0,5,851,3.0,583.0,583.0
361.818,6,19,1688,15,978,25844.0,190.0,190.0,4,710,80013.0,494.0,494.0
0.006,17,2,179,1,71,0.0,43.0,43.0,1,108,0.0,80.0,80.0
0.016,6,10,1990,5,911,3.0,643.0,643.0,5,1079,3.0,811.0,811.0
0.005,6,10,1989,5,927,1.0,659.0,659.0,5,1062,1.0,794.0,794.0
66.549,6,24,11975,13,5359,5545.0,2804.0,935.0,11,6616,6638.0,2111.0,1006.0
300.313,6,16,2170,9,684,37518.0,146.0,146.0,7,1486,50025.0,419.0,398.0
0.009,6,10,1989,5,910,2.0,642.0,642.0,5,1079,2.0,811.0,811.0
0.067,17,8,3613,4,1874,22.0,1350.0,440.0,4,1739,12.0,1350.0,406.0
40.085,17,10,676,5,460,10018.0,104.0,64.0,5,216,10020.0,20.0,15.0
0.004,6,10,1989,5,927,1.0,659.0,659.0,5,1062,1.0,794.0,794.0
0.094,6,10,1506,5,395,17.0,127.0,127.0,5,1111,20.0,843.0,843.0
0.007,6,10,1990,5,911,1.0,643.0,643.0,5,1079,1.0,811.0,811.0
0.08,6,10,1506,5,395,19.0,127.0,127.0,5,1111,16.0,843.0,843.0
0.001,17,2,180,1,66,0.0,38.0,38.0,1,114,0.0,86.0,86.0
0.077,6,10,1506,5,395,15.0,127.0,127.0,5,1111,17.0,843.0,843.0
0.001,17,2,180,1,66,0.0,38.0,38.0,1,114,0.0,86.0,86.0
0.07,6,10,1506,5,395,15.0,127.0,127.0,5,1111,15.0,843.0,843.0
0.04,17,2,152,1,76,0.0,48.0,48.0,1,76,0.0,48.0,48.0
240.119,6,31,9309,15,6953,17151.0,2076.0,686.0,16,2356,16007.0,580.0,189.0
10.807,17,24,3781,12,1673,972.0,268.0,111.0,12,2108,972.0,587.0,147.0
0.007,17,2,179,1,71,0.0,43.0,43.0,1,108,0.0,80.0,80.0
0.066,17,8,3613,4,1874,22.0,1350.0,440.0,4,1739,11.0,1350.0,406.0
0.006,6,10,2006,5,927,1.0,659.0,659.0,5,1079,1.0,811.0,811.0
0.076,6,10,1506,5,395,17.0,127.0,127.0,5,1111,16.0,843.0,843.0
368.405,6,22,2313,16,867,24560.0,195.0,195.0,6,1446,4635.0,419.0,398.0
0.066,6,10,1506,5,395,14.0,127.0,127.0,5,1111,14.0,843.0,843.0
0.123,17,2,80,1,32,0.0,4.0,4.0,1,48,0.0,20.0,20.0
0.116,6,10,1506,5,395,23.0,127.0,127.0,5,1111,24.0,843.0,843.0
0.006,6,10,2007,5,928,1.0,660.0,660.0,5,1079,1.0,811.0,811.0
0.038,17,2,136,1,60,0.0,32.0,32.0,1,76,0.0,48.0,48.0
0.085,6,10,1506,5,395,18.0,127.0,127.0,5,1111,20.0,843.0,843.0
0.014,6,10,1677,5,827,3.0,559.0,559.0,5,850,3.0,582.0,582.0
0.001,17,2,142,1,63,0.0,35.0,35.0,1,79,0.0,51.0,51.0
0.109,6,10,1506,5,395,24.0,127.0,127.0,5,1111,20.0,843.0,843.0
0.005,6,13,3747,7,509,0.0,137.0,137.0,6,3238,0.0,1470.0,1459.0
162.105,17,82,12331,41,2768,4052.0,44.0,39.0,41,9563,4052.0,279.0,205.0
0.005,17,2,225,1,65,0.0,37.0,37.0,1,160,0.0,132.0,132.0
0.004,17,2,136,1,60,0.0,32.0,32.0,1,76,0.0,48.0,48.0
0.005,6,10,1689,5,839,1.0,571.0,571.0,5,850,1.0,582.0,582.0
0.006,6,10,1547,5,764,1.0,496.0,496.0,5,783,1.0,515.0,515.0
143.591,6,26,9479,13,1655,11965.0,794.0,367.0,13,7824,11952.0,1360.0,810.0
0.004,17,2,136,1,60,0.0,32.0,32.0,1,76,0.0,48.0,48.0
0.006,17,2,170,1,65,0.0,37.0,37.0,1,105,0.0,77.0,77.0
0.013,6,10,1989,5,910,3.0,642.0,642.0,5,1079,3.0,811.0,811.0
0.008,6,10,1989,5,910,2.0,642.0,642.0,5,1079,2.0,811.0,811.0
0.005,17,2,170,1,65,0.0,37.0,37.0,1,105,0.0,77.0,77.0
0.004,6,10,1702,5,863,1.0,595.0,595.0,5,839,0.0,571.0,571.0
0.004,17,2,136,1,60,0.0,32.0,32.0,1,76,0.0,48.0,48.0
0.222,6,16,2777,8,1395,31.0,533.0,323.0,8,1382,20.0,529.0,239.0
0.01,6,10,1990,5,911,2.0,643.0,643.0,5,1079,2.0,811.0,811.0
280.226,6,22,6035,10,1186,31136.0,267.0,156.0,12,4849,25474.0,1400.0,873.0
0.001,17,2,180,1,66,0.0,38.0,38.0,1,114,0.0,86.0,86.0
0.093,6,10,1506,5,395,18.0,127.0,127.0,5,1111,19.0,843.0,843.0
11.137,17,28,4420,14,1993,844.0,268.0,114.0,14,2427,843.0,586.0,145.0
0.004,17,2,136,1,60,0.0,32.0,32.0,1,76,0.0,48.0,48.0
0.005,17,2,152,1,68,0.0,40.0,40.0,1,84,0.0,56.0,56.0
0.041,17,2,152,1,76,0.0,48.0,48.0,1,76,0.0,48.0,48.0
0.006,6,10,2006,5,927,1.0,659.0,659.0,5,1079,1.0,811.0,811.0
0.007,17,2,194,1,59,0.0,31.0,31.0,1,135,0.0,107.0,107.0
0.012,6,10,1983,5,910,3.0,642.0,642.0,5,1073,3.0,805.0,805.0
0.09,6,10,1506,5,395,20.0,127.0,127.0,5,1111,19.0,843.0,843.0
0.006,6,10,1547,5,764,1.0,496.0,496.0,5,783,1.0,515.0,515.0
0.072,17,4,284,2,120,0.0,32.0,32.0,2,164,68.0,60.0,54.0
15.179,17,21,12919,11,9283,1515.0,1350.0,815.0,10,3636,1683.0,1350.0,335.0
0.017,17,2,198,1,91,0.0,63.0,63.0,1,107,0.0,79.0,79.0
0.001,17,2,180,1,66,0.0,38.0,38.0,1,114,0.0,86.0,86.0
0.019,6,10,1989,5,910,4.0,642.0,642.0,5,1079,4.0,811.0,811.0
0.006,6,10,2006,5,927,1.0,659.0,659.0,5,1079,1.0,811.0,811.0
0.109,6,10,1506,5,395,21.0,127.0,127.0,5,1111,24.0,843.0,843.0
240.018,6,9,787,5,488,60004.0,232.0,232.0,4,299,80005.0,83.0,83.0
0.029,6,10,1972,5,910,7.0,642.0,642.0,5,1062,7.0,794.0,794.0
0.004,6,10,1779,5,928,1.0,660.0,660.0,5,851,1.0,583.0,583.0
0.009,6,10,1631,5,848,2.0,580.0,580.0,5,783,2.0,515.0,515.0
11.034,17,28,4390,14,2313,840.0,588.0,137.0,14,2077,840.0,268.0,120.0
0.023,6,10,1972,5,910,5.0,642.0,642.0,5,1062,5.0,794.0,794.0
0.009,6,10,1990,5,911,2.0,643.0,643.0,5,1079,2.0,811.0,811.0
0.013,17,2,169,1,62,0.0,34.0,34.0,1,107,0.0,79.0,79.0
0.013,6,7,695,4,448,4.0,232.0,232.0,3,247,4.0,83.0,83.0
0.009,6,13,3735,7,497,1.0,125.0,125.0,6,3238,1.0,1470.0,1459.0
40.052,17,10,676,5,460,10011.0,104.0,64.0,5,216,10012.0,20.0,15.0
0.228,6,16,2777,8,1395,32.0,533.0,323.0,8,1382,21.0,529.0,239.0
0.005,6,10,1779,5,928,1.0,660.0,660.0,5,851,1.0,583.0,583.0
0.006,6,10,1547,5,764,1.0,496.0,496.0,5,783,1.0,515.0,515.0
0.005,6,10,2006,5,927,1.0,659.0,659.0,5,1079,1.0,811.0,811.0
0.005,6,10,2006,5,927,1.0,659.0,659.0,5,1079,1.0,811.0,811.0
0.01,6,13,3735,7,497,1.0,125.0,125.0,6,3238,1.0,1470.0,1459.0
0.006,6,10,1643,5,860,1.0,592.0,592.0,5,783,1.0,515.0,515.0
0.044,17,2,148,1,60,0.0,32.0,32.0,1,88,0.0,60.0,60.0
0.071,6,10,1506,5,395,15.0,127.0,127.0,5,1111,17.0,843.0,843.0
0.006,6,10,1547,5,764,1.0,496.0,496.0,5,783,1.0,515.0,515.0
0.005,6,10,1689,5,839,1.0,571.0,571.0,5,850,1.0,582.0,582.0
0.077,6,10,1506,5,395,18.0,127.0,127.0,5,1111,17.0,843.0,843.0
0.014,6,13,3735,7,497,2.0,125.0,125.0,6,3238,2.0,1470.0,1459.0
0.005,17,2,179,1,71,0.0,43.0,43.0,1,108,0.0,80.0,80.0
0.004,6,10,2006,5,927,1.0,659.0,659.0,5,1079,1.0,811.0,811.0
0.017,6,10,1990,5,911,4.0,643.0,643.0,5,1079,4.0,811.0,811.0
0.08,6,10,1506,5,395,17.0,127.0,127.0,5,1111,16.0,843.0,843.0
0.004,17,2,170,1,65,0.0,37.0,37.0,1,105,0.0,77.0,77.0
0.004,6,10,2006,5,927,1.0,659.0,659.0,5,1079,1.0,811.0,811.0
0.015,6,10,1989,5,910,3.0,642.0,642.0,5,1079,3.0,811.0,811.0
0.011,6,10,1990,5,911,2.0,643.0,643.0,5,1079,2.0,811.0,811.0
0.023,6,10,1990,5,911,5.0,643.0,643.0,5,1079,5.0,811.0,811.0
0.066,6,10,1506,5,395,15.0,127.0,127.0,5,1111,13.0,843.0,843.0
0.02,6,10,1989,5,910,4.0,642.0,642.0,5,1079,4.0,811.0,811.0
0.006,6,10,1854,5,889,1.0,621.0,621.0,5,965,1.0,697.0,697.0
0.008,6,10,1989,5,910,1.0,642.0,642.0,5,1079,2.0,811.0,811.0
0.004,6,10,1702,5,863,1.0,595.0,595.0,5,839,0.0,571.0,571.0
11.494,17,28,4397,14,2312,871.0,587.0,137.0,14,2085,871.0,268.0,120.0
0.109,6,10,1506,5,395,24.0,127.0,127.0,5,1111,23.0,843.0,843.0
240.09,6,16,4481,9,963,30011.0,238.0,166.0,7,3518,40014.0,1402.0,786.0
0.001,17,2,180,1,65,0.0,37.0,37.0,1,115,0.0,87.0,87.0
1.106,6,32,13392,18,5893,65.0,2074.0,854.0,14,7499,72.0,2720.0,769.0
40.084,17,10,676,5,460,10020.0,104.0,64.0,5,216,10020.0,20.0,15.0
0.01,6,10,1989,5,910,2.0,642.0,642.0,5,1079,2.0,811.0,811.0
0.069,6,10,1506,5,395,15.0,127.0,127.0,5,1111,15.0,843.0,843.0
0.051,17,2,136,1,60,0.0,32.0,32.0,1,76,0.0,48.0,48.0
0.004,6,10,2006,5,927,1.0,659.0,659.0,5,1079,1.0,811.0,811.0
0.005,6,10,2006,5,927,1.0,659.0,659.0,5,1079,1.0,811.0,811.0
0.012,6,10,1990,5,911,2.0,643.0,643.0,5,1079,2.0,811.0,811.0
0.004,17,2,136,1,60,0.0,32.0,32.0,1,76,0.0,48.0,48.0
0.008,6,10,1762,5,911,1.0,643.0,643.0,5,851,1.0,583.0,583.0
0.087,6,10,1506,5,395,20.0,127.0,127.0,5,1111,17.0,843.0,843.0
0.006,6,10,2007,5,928,1.0,660.0,660.0,5,1079,1.0,811.0,811.0
0.001,17,2,180,1,66,0.0,38.0,38.0,1,114,0.0,86.0,86.0
0.015,6,10,1990,5,911,3.0,643.0,643.0,5,1079,3.0,811.0,811.0
0.135,17,2,80,1,32,0.0,4.0,4.0,1,48,0.0,20.0,20.0
0.079,6,10,1506,5,395,17.0,127.0,127.0,5,1111,15.0,843.0,843.0
0.004,6,10,1774,5,923,1.0,655.0,655.0,5,851,1.0,583.0,583.0
0.017,6,10,1989,5,910,4.0,642.0,642.0,5,1079,4.0,811.0,811.0
0.129,6,10,1506,5,395,19.0,127.0,127.0,5,1111,26.0,843.0,843.0
40.055,17,10,676,5,460,10012.0,104.0,64.0,5,216,10011.0,20.0,15.0
0.005,17,2,170,1,65,0.0,37.0,37.0,1,105,0.0,77.0,77.0
0.015,6,10,1972,5,910,3.0,642.0,642.0,5,1062,3.0,794.0,794.0
0.05,6,10,1989,5,910,12.0,642.0,642.0,5,1079,12.0,811.0,811.0
0.022,6,10,1762,5,911,5.0,643.0,643.0,5,851,5.0,583.0,583.0
0.085,6,10,1506,5,395,17.0,127.0,127.0,5,1111,19.0,843.0,843.0
40.063,17,10,676,5,460,10013.0,104.0,64.0,5,216,10014.0,20.0,15.0
335.265,17,20,1124,10,716,37237.0,48.0,43.0,10,408,37235.0,20.0,12.0
0.008,6,10,1762,5,911,2.0,643.0,643.0,5,851,1.0,583.0,583.0
0.005,17,2,136,1,60,0.0,32.0,32.0,1,76,0.0,48.0,48.0
0.072,17,2,136,1,60,0.0,32.0,32.0,1,76,0.0,48.0,48.0
0.013,6,10,1972,5,910,3.0,642.0,642.0,5,1062,3.0,794.0,794.0
40.069,17,10,676,5,460,10015.0,104.0,64.0,5,216,10016.0,20.0,15.0
0.005,17,2,166,1,75,0.0,47.0,47.0,1,91,0.0,63.0,63.0
0.015,6,10,1631,5,848,3.0,580.0,580.0,5,783,3.0,515.0,515.0
300.38,6,16,2170,9,684,37526.0,146.0,146.0,7,1486,50035.0,419.0,398.0
15.069,17,16,10617,9,8280,1880.0,1350.0,892.0,7,2337,2508.0,1350.0,305.0
40.072,17,10,676,5,460,10016.0,104.0,64.0,5,216,10017.0,20.0,15.0
0.01,6,10,1972,5,910,2.0,642.0,642.0,5,1062,2.0,794.0,794.0
0.059,6,10,1506,5,395,14.0,127.0,127.0,5,1111,12.0,843.0,843.0
0.015,6,10,1972,5,910,3.0,642.0,642.0,5,1062,3.0,794.0,794.0
0.077,6,10,1506,5,395,17.0,127.0,127.0,5,1111,18.0,843.0,843.0
0.014,6,10,1983,5,910,3.0,642.0,642.0,5,1073,3.0,805.0,805.0
0.041,17,2,152,1,76,0.0,48.0,48.0,1,76,0.0,48.0,48.0
367.038,6,22,2313,16,867,24469.0,195.0,195.0,6,1446,4644.0,419.0,398.0
0.015,6,10,1989,5,910,3.0,642.0,642.0,5,1079,3.0,811.0,811.0
0.088,6,10,1506,5,395,15.0,127.0,127.0,5,1111,18.0,843.0,843.0
0.008,6,10,1989,5,910,2.0,642.0,642.0,5,1079,2.0,811.0,811.0
0.005,6,10,2006,5,927,1.0,659.0,659.0,5,1079,1.0,811.0,811.0
0.097,6,10,1506,5,395,23.0,127.0,127.0,5,1111,22.0,843.0,843.0
240.142,6,31,9270,15,6846,17153.0,1969.0,674.0,16,2424,16008.0,580.0,198.0
0.041,17,2,148,1,60,0.0,32.0,32.0,1,88,0.0,60.0,60.0
0.014,6,10,1972,5,910,3.0,642.0,642.0,5,1062,3.0,794.0,794.0
0.01,6,10,1990,5,911,2.0,643.0,643.0,5,1079,2.0,811.0,811.0
0.013,6,10,1989,5,910,3.0,642.0,642.0,5,1079,3.0,811.0,811.0
0.001,17,2,136,1,60,0.0,32.0,32.0,1,76,0.0,48.0,48.0
0.006,6,10,1547,5,764,1.0,496.0,496.0,5,783,1.0,515.0,515.0
0.009,6,10,1762,5,911,2.0,643.0,643.0,5,851,2.0,583.0,583.0
0.074,6,10,1506,5,395,17.0,127.0,127.0,5,1111,13.0,843.0,843.0
0.009,6,10,1983,5,910,2.0,642.0,642.0,5,1073,2.0,805.0,805.0
0.124,6,10,1506,5,395,25.0,127.0,127.0,5,1111,29.0,843.0,843.0
0.005,6,14,3799,7,509,0.0,137.0,137.0,7,3290,0.0,1448.0,972.0
0.014,6,10,1990,5,911,3.0,643.0,643.0,5,1079,3.0,811.0,811.0
316.252,17,20,1124,10,716,35124.0,48.0,43.0,10,408,35124.0,20.0,12.0
0.005,6,10,2006,5,927,1.0,659.0,659.0,5,1079,1.0,811.0,811.0
0.006,6,10,1547,5,764,1.0,496.0,496.0,5,783,1.0,515.0,515.0
0.013,6,10,1677,5,827,3.0,559.0,559.0,5,850,3.0,582.0,582.0
0.005,6,10,2007,5,928,1.0,660.0,660.0,5,1079,1.0,811.0,811.0
0.006,6,10,1643,5,860,1.0,592.0,592.0,5,783,1.0,515.0,515.0
0.013,6,10,1762,5,911,3.0,643.0,643.0,5,851,3.0,583.0,583.0
0.054,6,10,1631,5,848,13.0,580.0,580.0,5,783,13.0,515.0,515.0
0.015,6,10,1983,5,910,3.0,642.0,642.0,5,1073,3.0,805.0,805.0
0.011,6,10,1990,5,911,2.0,643.0,643.0,5,1079,2.0,811.0,811.0
0.089,6,10,1506,5,395,19.0,127.0,127.0,5,1111,20.0,843.0,843.0
0.016,17,2,198,1,91,0.0,63.0,63.0,1,107,0.0,79.0,79.0
0.17,17,2,152,1,76,0.0,48.0,48.0,1,76,0.0,48.0,48.0
0.018,6,10,1677,5,827,4.0,559.0,559.0,5,850,4.0,582.0,582.0
0.005,6,13,3747,7,509,0.0,137.0,137.0,6,3238,0.0,1470.0,1459.0
0.005,6,10,2000,5,927,1.0,659.0,659.0,5,1073,1.0,805.0,805.0
0.005,17,2,230,1,68,0.0,40.0,40.0,1,162,0.0,134.0,134.0
0.006,6,10,2006,5,927,1.0,659.0,659.0,5,1079,1.0,811.0,811.0
0.117,6,10,1506,5,395,26.0,127.0,127.0,5,1111,23.0,843.0,843.0
0.004,6,10,2006,5,927,1.0,659.0,659.0,5,1079,1.0,811.0,811.0
0.01,6,10,1762,5,911,2.0,643.0,643.0,5,851,2.0,583.0,583.0
