flow_duration,protocol,TotPackets,TotBytes,tot_fwd_pkts,totlen_fwd_pkts,fwd_iat_mean,fwd_pkt_len_max,fwd_pkt_len_mean,tot_bwd_pkts,totlen_bwd_pkts,bwd_iat_mean,bwd_pkt_len_max,bwd_pkt_len_mean
7.466,6,67,20182,34,541,226,1152,15435,33,489,224,1179,4747
52.176,6,6561,6275629,4220,1407,12,1448,6149149,2341,776,22,1448,126480
0.053,6,10,1495,5,507,13,507,727,5,556,13,556,768
0.007,6,2,80,1,0,0,0,40,1,0,0,0,40
0.012,1,2,112,2,28,12,28,112,0,0,0,0,0
1752.655,6,95,7203,63,38,28268,205,4476,32,33,56525,98,2727
467.806,6,55,8547,31,304,15593,304,6168,24,83,20310,83,2379
1757.293,6,206,26918,111,304,15975,304,18352,95,83,18694,83,8566
75.016,6,28,7824,9,174,122,267,1413,19,376,4165,3417,6411
1778.376,1,156,8736,156,28,11473,28,8736,0,0,0,0,0
1.833,6,115,86973,50,131,37,232,2529,65,1364,25,1430,84444
1.266,6,10,1687,7,100,211,100,384,3,1179,507,1179,1303
2.366,17,4,240,2,32,2365,32,120,2,32,2365,32,120
1.483,17,15,6097,7,447,247,1350,3331,8,317,191,1350,2766
1770.31,6,101,9344,66,65,27235,65,5577,35,59,52065,59,3767
1783.334,6,106,8456,68,65,26616,65,4930,38,59,48195,59,3526
1771.104,1,58,4872,58,56,31072,56,4872,0,0,0,0,0
17.913,6,1397,1253275,823,1438,21,1448,1216307,574,776,30,1448,36968
1748.155,6,95,7203,63,38,28196,205,4476,32,33,56384,98,2727
1740.546,17,30,31680,30,1028,60018,1028,31680,0,0,0,0,0
3.129,6,38,10271,17,455,195,1440,4394,21,357,147,1440,5877
280.038,6,27,7312,12,158,25458,267,1277,15,678,20000,2045,6035
179.786,6,22,9261,11,514,93,1236,2014,11,970,17961,1360,7247
0.241,17,4,624,2,64,239,64,184,2,192,128,192,440
280.361,6,26,7272,12,158,25487,267,1277,14,678,21561,2045,5995
0.083,17,2,390,1,46,0,46,74,1,288,0,288,316
0.6,6,10,1110,6,177,120,177,674,4,110,143,110,436
93.071,17,10,880,5,48,23265,48,380,5,72,23265,72,500
1785.146,17,87,3648,86,14,21001,14,3612,1,8,0,8,36
923.025,6,82,9258,50,82,18837,722,4526,32,127,29769,2026,4732
240.209,6,56,20523,30,844,8282,1418,17617,26,193,9607,580,2906
1785.852,6,368,25552,213,99,8423,469,15005,155,69,11596,69,10547
11.59,6,98,32859,50,611,236,1152,26457,48,447,241,1179,6402
151.611,6,25,11382,12,433,72,990,1847,13,1000,12623,1360,9535
238.611,6,44,13456,27,389,9177,1360,6184,17,658,14899,3494,7272
0.647,6,10,1840,5,901,161,901,1169,5,403,161,403,671
1.084,6,29,8200,15,222,66,540,1964,14,809,69,1460,6236
1786.521,6,102,8364,68,66,26664,66,4964,34,60,54134,60,3400
276.797,1,4,224,4,28,92265,28,224,0,0,0,0,0
1680.6,17,12,498,11,14,168060,14,462,1,8,0,8,36
24.58,6,13,5586,4,106,8193,106,274,9,822,3044,1420,5312
51.905,6,48,10415,23,533,704,910,3147,25,329,2157,2720,7268
11.031,6,19,1645,8,555,1575,555,995,11,19,1082,19,650
0.421,17,2,136,1,32,0,32,60,1,48,0,48,76
188.426,6,26,1638,10,46,17616,46,676,16,46,12560,46,962
33.789,6,32,5341,15,154,2413,721,1857,17,324,2098,1368,3484
694.259,1,4,224,4,28,231419,28,224,0,0,0,0,0
371.119,6,25,1651,17,177,23194,177,1117,8,110,9226,110,534
1.872,17,15,5424,15,333,133,361,5424,0,0,0,0,0
1770.324,6,99,9240,66,65,27235,65,5577,33,59,55319,59,3663
0.558,6,21,7217,12,318,50,599,1905,9,967,68,1471,5312
116.523,6,45,10434,22,723,549,1360,4588,23,327,5288,2720,5846
1773.611,6,181,15589,120,69,14904,69,8940,61,69,29552,69,6649
57.89,6,9,1432,9,134,7236,134,1432,0,0,0,0,0
126.162,2,2,64,2,8,126162,8,64,0,0,0,0,0
0.781,6,10,1687,7,100,130,100,384,3,1179,263,1179,1303
61.239,6,10,412,7,0,10206,0,284,3,0,30568,0,128
0.145,17,2,304,1,60,0,60,88,1,188,0,188,216
1.12,17,2,122,2,33,1120,33,122,0,0,0,0,0
3.783,6,30,12339,17,653,236,1360,4645,13,795,301,2720,7694
0.46,6,13,1693,6,288,87,288,548,7,426,43,434,1145
1.146,6,32,6300,16,138,76,267,1755,16,650,67,1452,4545
0.055,17,4,284,2,32,44,32,120,2,54,43,60,164
0.207,6,21,5000,11,137,20,267,1132,10,692,22,2800,3868
0.255,6,27,6202,13,181,21,537,1578,14,555,18,1542,4624
300.795,6,72,53631,45,1246,6836,1368,47214,27,715,1444,2736,6417
329.698,6,31,7338,20,118,17352,267,1873,11,836,20,3436,5465
0.161,17,4,368,2,32,129,32,120,2,96,130,96,248
79.372,6,29,7682,8,162,621,267,1303,21,395,3968,1420,6379
15.464,17,15,7594,7,560,2572,1350,4121,8,406,2207,1350,3473
1777.899,17,73,3060,72,14,25040,14,3024,1,8,0,8,36
0.473,6,48,21608,27,1027,18,1380,16535,21,467,21,1923,5073
1.411,6,23,6975,10,141,156,275,686,13,720,93,1380,6289
1789.053,6,365,25570,211,100,8519,469,14856,154,69,11690,69,10714
1724.449,17,12,498,11,14,172444,14,462,1,8,0,8,36
6.828,6,7,573,3,177,3414,177,341,4,0,2029,0,232
0.054,17,2,312,1,64,0,64,92,1,192,0,192,220
1786.698,6,102,8296,68,65,26667,65,4930,34,59,54139,59,3366
623.61,1,16,896,16,28,41574,28,896,0,0,0,0,0
1740.763,17,27,28512,27,1028,66952,1028,28512,0,0,0,0,0
0.156,6,8,799,4,69,37,69,229,4,205,16,341,570
717.983,6,31,2449,16,65,25239,65,1160,15,45,51278,59,1289
0.89,6,32,12174,17,525,55,1360,3362,15,820,51,1379,8812
124.599,6,30,7432,13,158,10383,267,1317,17,543,7785,1400,6115
1669.053,1,18,1008,18,28,98179,28,1008,0,0,0,0,0
2.514,6,28,8865,17,281,157,577,1529,11,984,229,1452,7336
925.435,17,74,5920,37,48,25706,48,2812,37,56,25706,56,3108
0.42,6,10,1992,5,288,98,288,508,5,424,59,434,1484
0.054,17,4,352,2,37,47,37,130,2,83,46,89,222
0.405,17,2,152,1,48,0,48,76,1,48,0,48,76
11.275,6,2380,2214150,1519,1380,7,1408,2164714,861,931,12,2801,49436
1793.014,6,356,22520,208,69,8661,69,12460,148,69,12197,69,10060
279.149,17,4,352,2,60,279148,60,176,2,60,279148,60,176
331.131,6,44,2956,17,46,20695,46,1278,27,46,12730,46,1678
92.869,6,120,94002,79,1244,1190,1408,83747,41,811,2316,3847,10255
0.017,6,13,3980,7,88,2,88,388,6,1670,3,2920,3592
3.074,17,3,228,2,48,3048,48,152,1,48,0,48,76
82.936,1,8,448,8,28,11848,28,448,0,0,0,0,0
1769.218,6,104,9577,67,65,26806,65,5694,37,59,49141,59,3883
0.992,6,27,8120,14,266,63,540,1924,13,944,68,1591,6196
0.053,17,4,284,2,32,46,32,120,2,54,46,60,164
0.203,6,9,1002,5,213,50,213,417,4,421,53,421,585
4.227,6,39,7269,19,218,234,314,3383,20,440,208,1152,3886
0.805,6,27,5927,13,156,67,267,1462,14,650,55,1420,4465
153.25,6,31,8912,14,158,11788,267,1357,17,687,9571,2036,7555
74.063,6,24,2436,10,177,155,177,1248,14,110,5683,110,1188
1.891,6,41,15703,22,428,90,1360,3956,19,844,94,1360,11747
2.991,1,3,168,3,28,1495,28,168,0,0,0,0,0
4.113,17,4,268,4,39,1371,39,268,0,0,0,0,0
19.21,17,4,352,2,60,19208,60,176,2,60,19209,60,176
0.578,2,2,80,2,16,578,16,80,0,0,0,0,0
28.163,6,38,8695,15,401,37,889,1836,23,348,1274,4080,6859
7.912,6,18,6871,9,275,989,275,643,9,1171,665,1440,6228
1.125,6,24,8004,12,164,86,267,1288,12,1014,86,2816,6716
1631.148,1,8,448,8,28,233021,28,448,0,0,0,0,0
1790.912,6,355,22480,207,69,8622,69,12420,148,69,12180,69,10060
178.782,17,8,2688,8,308,25540,308,2688,0,0,0,0,0
6.679,17,4,240,2,32,6678,32,120,2,32,6678,32,120
2.008,17,6,483,3,40,996,41,206,3,64,995,80,277
8.622,6,1329,1187398,827,1386,10,1420,1163097,502,467,17,1883,24301
1130.017,17,219,16644,219,48,5183,48,16644,0,0,0,0,0
1796.755,1,342,28728,342,56,5269,56,28728,0,0,0,0,0
299.541,6,7,404,4,31,99847,31,222,3,31,149763,31,182
1796.318,17,447,39580,403,35,4468,288,25676,44,288,40951,288,13904
294.672,17,4,352,2,60,294671,60,176,2,60,294671,60,176
6.315,6,9,588,3,106,3152,106,234,6,90,1261,90,354
107.974,6,48,9050,23,372,708,802,2141,25,327,4492,1360,6909
61.338,6,45,24502,27,1026,2359,1448,16811,18,749,3593,1448,7691
69.086,6,25,7097,12,155,6280,267,1266,13,589,5756,2840,5831
0.237,6,12,3705,6,171,32,171,491,6,964,36,1448,3214
359.271,2,3,96,3,8,179635,8,96,0,0,0,0,0
1709.806,1,8,848,8,78,244258,78,848,0,0,0,0,0
5.609,17,5,320,5,36,1402,36,320,0,0,0,0,0
1770.207,6,223,19136,83,75,21585,339,8479,140,70,12735,1062,10657
15.008,17,12,5220,6,509,3000,1350,3224,6,304,2995,1350,1996
1799.085,2,28,896,28,8,66632,8,896,0,0,0,0,0
135.702,17,3,1008,3,308,67851,308,1008,0,0,0,0,0
255.506,6,12,5544,4,112,85163,112,280,8,987,36499,1420,5264
30.676,1,36,3744,0,0,0,0,0,36,76,876,76,3744
1295.553,17,242,18392,242,48,5375,48,18392,0,0,0,0,0
1774.253,6,180,15480,120,69,14909,69,8940,60,69,30071,69,6540
90.923,6,35,14972,17,894,66,1460,6089,18,741,5338,1460,8883
8.685,6,14,2245,8,211,1240,211,846,6,545,1725,904,1399
0.234,6,25,5989,12,164,21,453,1442,13,643,18,1542,4547
365.957,6,78,5052,44,78,8510,138,2864,34,69,11089,69,2188
1.452,6,47,18040,26,873,58,1360,12424,21,433,62,1360,5616
0.285,6,26,7256,13,155,23,267,1301,13,678,21,2045,5955
65.084,6,80,56396,51,1196,1301,1368,48127,29,964,2211,3887,8269
0.038,17,4,288,2,33,0,33,122,2,55,33,61,166
1771.626,6,99,9240,66,65,27255,65,5577,33,59,55360,59,3663
1733.089,1,8,848,8,78,247584,78,848,0,0,0,0,0
1786.667,6,104,8308,68,64,26666,64,4896,36,58,51045,58,3412
1798.045,17,448,39896,403,35,4472,288,25676,45,288,40019,288,14220
115.268,17,2,72,1,8,0,8,36,1,8,0,8,36
207.364,6,83,54311,49,1201,4320,1368,45806,34,841,1873,2519,8505
0.003,6,12,29340,1,0,0,0,40,11,2611,0,6840,29300
302.15,6,79,32277,44,954,7026,1360,24701,35,268,292,2667,7576
1797.977,17,366,60110,366,136,4925,391,60110,0,0,0,0,0
1770.546,6,99,9240,66,65,27239,65,5577,33,59,55326,59,3663
0.019,17,2,192,1,37,0,37,65,1,99,0,99,127
240.101,6,44,5526,23,247,10913,835,2950,21,164,12004,594,2576
238.662,2,2,64,2,8,238662,8,64,0,0,0,0,0
92.379,17,10,3384,10,310,10264,326,3384,0,0,0,0,0
1681.708,17,14,1036,7,30,280279,30,406,7,62,280279,62,630
16.284,17,12,1764,6,48,3255,48,456,6,190,3254,308,1308
81.226,17,4,352,2,60,81225,60,176,2,60,81224,60,176
0.705,17,4,768,2,39,693,39,134,2,289,443,289,634
1786.49,6,106,8456,68,65,26664,65,4930,38,59,48280,59,3526
0.105,17,4,624,2,64,71,64,184,2,192,69,192,440
30.251,6,1764,1555377,1136,1293,26,1368,1518057,628,776,47,2736,37320
120.319,2,3,96,3,8,60159,8,96,0,0,0,0,0
1793.535,6,128,8684,72,60,25261,208,5421,56,31,32602,31,3263
184.096,17,4,514,2,36,184091,36,128,2,165,184091,187,386
123.68,6,231,188402,148,1302,841,1368,173180,83,605,1505,1368,15222
0.066,6,2,92,1,0,0,0,40,1,0,0,0,52
1782.503,6,354,22440,207,69,8652,69,12420,147,69,12208,69,10020
0.485,17,2,170,1,37,0,37,65,1,77,0,77,105
77.864,6,32,7653,12,155,7078,267,1266,20,371,4089,1460,6387
3.636,6,29,8288,14,164,266,267,1400,15,869,247,1440,6888
0.019,6,10,1371,5,126,4,126,394,5,356,4,380,977
1.155,6,24,8004,12,164,89,267,1288,12,1014,89,2804,6716
0.226,6,9,1148,5,145,56,145,349,4,635,53,635,799
0.271,6,24,7176,12,155,24,267,1261,12,775,23,3445,5915
1770.356,6,108,9927,69,65,26034,65,5822,39,59,46585,59,4105
5.03,17,4,558,2,36,5006,36,128,2,187,5020,187,430
112.52,6,9,528,2,112,112510,112,200,7,0,18751,0,328
1788.048,6,127,7765,69,27,26294,27,4146,58,27,31368,27,3619
280.347,6,30,7432,13,158,23362,267,1317,17,543,17516,1400,6115
280.557,6,30,7432,13,158,23379,267,1317,17,543,17531,1400,6115
1.72,6,14,2351,8,188,245,245,700,6,703,290,1152,1651
77.402,6,15,3935,4,407,2518,722,1030,11,1164,7722,1448,2905
14.856,6,18,1562,10,226,1650,226,984,8,110,2096,110,578
1729.661,1,8,448,8,28,247094,28,448,0,0,0,0,0
1786.391,17,87,3648,86,14,21016,14,3612,1,8,0,8,36
175.261,17,2,72,1,8,0,8,36,1,8,0,8,36
0.023,6,20,9141,10,96,2,96,624,10,1141,2,1448,8517
14.408,6,22,5193,13,250,1200,383,2781,9,512,383,1179,2412
0.288,17,2,152,1,48,0,48,76,1,48,0,48,76
7.342,6,1502,1449655,998,1379,7,1408,1418783,504,931,14,2801,30872
0.14,6,5,296,4,0,46,0,232,1,0,0,0,64
1.26,6,33,6547,16,164,84,267,1962,17,650,69,1452,4585
0.024,17,3,676,2,60,0,60,176,1,472,0,472,500
1776.628,17,73,3060,72,14,25022,14,3024,1,8,0,8,36
1798.378,6,363,23007,211,69,8563,69,12787,152,69,11909,69,10220
1798.432,6,364,24523,212,88,8523,469,14027,152,69,11907,69,10496
300.84,6,47,10818,24,646,13080,1360,4941,23,309,1027,2720,5877
3.237,17,5,1074,3,40,1155,40,204,2,407,3226,407,870
13.537,6,9,527,5,43,3384,43,311,4,0,4510,0,216
26.285,6,47,12986,22,199,1251,721,2479,25,633,1075,1440,10507
384.965,6,20,1358,15,180,27497,180,980,5,110,15169,110,378
50.722,6,36,8161,18,311,511,619,1687,18,478,2975,2128,6474
0.533,17,22,12061,10,522,55,1350,5502,12,518,45,1350,6559
3.747,17,10,1319,5,31,907,31,295,5,176,932,196,1024
1799.95,1,56,4704,56,56,32726,56,4704,0,0,0,0,0
0.12,17,2,312,1,64,0,64,92,1,192,0,192,220
1.367,6,47,18977,26,945,54,1460,13361,21,433,58,1460,5616
1.908,17,3,264,3,60,954,60,264,0,0,0,0,0
36.949,1,3,399,3,105,18474,119,399,0,0,0,0,0
1786.517,6,364,25392,212,100,8466,469,14896,152,69,11829,69,10496
1785.891,6,109,8710,69,66,26263,66,5070,40,60,45789,60,3640
101.424,17,4,240,2,32,101423,32,120,2,32,101423,32,120
20.175,6,23,5775,13,107,1681,159,1138,10,684,2239,1418,4637
47.818,1,2,112,2,28,47818,28,112,0,0,0,0,0
658.112,2,5,160,5,8,164528,8,160,0,0,0,0,0
203.123,17,4,352,2,60,203122,60,176,2,60,203122,60,176
0.208,6,40,16447,23,964,9,1420,11546,17,467,11,1883,4901
1.71,17,2,384,1,39,0,39,67,1,289,0,289,317
162.429,6,22,8452,11,314,78,634,1415,11,940,16229,1460,7037
19.0,17,4,352,2,48,18954,48,152,2,72,18960,72,200
15.195,17,12,6055,6,584,3031,1350,3676,6,368,3031,1350,2379
21.418,6,27,4813,14,196,1647,517,1962,13,428,1783,499,2851
0.56,6,23,7437,14,274,43,668,2109,9,1210,65,1946,5328
0.268,17,3,451,2,39,100,39,134,1,289,0,289,317
1.333,6,24,8004,12,164,102,267,1288,12,1216,103,3859,6716
126.246,17,4,288,2,36,126215,36,128,2,52,126214,52,160
1754.534,6,100,7866,66,45,26992,205,4902,34,35,53156,98,2964
130.682,6,34,15784,17,512,315,1360,3801,17,940,8158,1360,11983
1773.663,6,181,15589,120,69,14904,69,8940,61,69,29554,69,6649
30.72,6,9,588,4,106,10240,106,274,5,90,7642,90,314
76.289,17,4,352,2,60,76288,60,176,2,60,76288,60,176
300.306,6,46,26914,20,405,15805,1066,2669,26,1089,4043,2899,24245
127.8,6,49,22046,27,603,4915,1402,5031,22,1133,6084,2838,17015
0.13,6,100,117223,43,281,3,868,3990,57,2120,2,5632,113233
1772.625,6,180,15480,120,69,14896,69,8940,60,69,30036,69,6540
1773.307,6,180,15480,120,69,14901,69,8940,60,69,30050,69,6540
1.58,6,48,17235,28,801,58,1360,11614,20,437,72,2715,5621
962.635,2,8,256,8,8,137519,8,256,0,0,0,0,0
0.15,6,43,19980,25,1078,6,1420,15039,18,467,8,1883,4941
173.345,6,26,9556,13,709,73,1360,3403,13,803,14430,3113,6153
1781.76,6,365,23087,211,69,8484,69,12787,154,69,11645,69,10300
0.03,6,10,1903,5,657,7,657,925,5,710,7,710,978
0.333,6,7,364,3,0,6,0,156,4,0,111,0,208
418.225,17,14,5451,14,361,32171,371,5451,0,0,0,0,0
1793.192,17,180,11520,180,36,10017,36,11520,0,0,0,0,0
1792.019,6,356,22520,208,69,8657,69,12460,148,69,12190,69,10060
39.858,17,44,6468,22,48,1897,48,1672,22,190,1897,308,4796
372.109,6,18,1242,14,180,28623,180,916,4,110,20070,110,326
15.762,6,23,8325,13,275,1313,275,1078,10,1367,1194,1420,7247
0.012,17,2,244,1,43,0,43,71,1,145,0,145,173
285.595,6,27,2905,14,324,21968,585,1385,13,282,23799,580,1520
100.447,17,4,352,2,60,100446,60,176,2,60,100446,60,176
1795.862,6,358,22669,209,69,8633,69,12500,149,69,12132,69,10169
60.719,1,4,224,4,28,20239,28,224,0,0,0,0,0
1795.719,17,448,39896,403,35,4466,288,25676,45,288,40024,288,14220
1785.859,6,390,27522,221,101,8117,469,16346,169,69,10630,69,11176
1793.024,17,69,23008,69,305,26368,320,23008,0,0,0,0,0
2.022,17,4,644,2,33,1930,33,122,2,233,0,233,522
0.48,17,2,384,1,39,0,39,67,1,289,0,289,317
280.753,6,31,7813,13,158,23396,267,1317,18,524,16492,1400,6496
40.07,6,26,4100,15,179,2862,517,1876,11,411,4006,499,2224
1.385,6,50,21100,28,952,51,1360,15444,22,433,57,1360,5656
0.425,6,12,1653,6,288,81,288,548,6,426,45,434,1105
373.616,6,25,1651,17,177,23351,177,1117,8,110,9258,110,534
17.561,17,8,608,8,48,2508,48,608,0,0,0,0,0
374.083,6,23,1523,15,177,26720,177,989,8,110,9264,110,534
156.81,17,2,150,2,47,156810,47,150,0,0,0,0,0
1768.821,6,178,11596,90,57,19874,208,7084,88,31,20326,31,4512
1772.411,6,180,15480,120,69,14894,69,8940,60,69,30039,69,6540
1.323,6,37,8212,19,320,73,1162,2716,18,476,67,2715,5496
0.51,17,2,904,2,424,510,548,904,0,0,0,0,0
0.642,6,110,80080,68,1285,9,1432,72238,42,615,15,1871,7842
1780.422,17,135,8640,135,36,13286,36,8640,0,0,0,0,0
630.39,2,6,192,6,8,126078,8,192,0,0,0,0,0
11.325,6,19,4402,10,275,1258,275,958,9,768,734,1440,3444
4.857,6,34,8231,17,298,303,578,1606,17,494,52,1460,6625
240.222,6,56,17743,30,774,8283,1402,14750,26,204,9608,580,2993
41.289,6,26,7143,12,156,3753,267,1272,14,530,3172,2006,5871
1764.52,17,338,54308,338,132,5235,391,54308,0,0,0,0,0
2.818,6,129,89942,61,131,46,232,2969,68,1358,41,1430,86973
0.172,17,2,152,1,48,0,48,76,1,48,0,48,76
0.306,6,2,123,1,0,0,0,40,1,31,0,31,83
5.032,17,3,208,2,36,5009,36,128,1,52,0,52,80
0.063,17,2,279,1,36,0,36,64,1,187,0,187,215
0.669,17,18,5891,8,361,95,1350,3117,10,249,70,1350,2774
475.583,6,33,7568,13,158,39631,267,1317,20,603,25026,1400,6251
76.868,6,75,50202,46,1198,1708,1408,41962,29,747,2201,1408,8240
744.418,6,76,10630,40,83,19083,722,3623,36,197,21264,2026,7007
0.075,6,9,1002,5,213,18,213,417,4,421,18,421,585
0.19,17,2,290,1,40,0,40,68,1,194,0,194,222
310.032,6,27,5493,14,298,23848,1382,2353,13,373,25832,1460,3140
1.569,6,392,345011,232,216,6,256,14949,160,2049,9,12672,330062
1792.531,6,164,12328,84,85,21596,208,8074,80,31,22613,31,4254
161.695,6,76,52380,48,1190,3440,1408,44184,28,841,2282,2439,8196
738.663,17,141,10716,141,48,5276,48,10716,0,0,0,0,0
24.545,6,647,595870,413,1364,59,1368,582466,234,0,104,0,13404
12.95,6,16,2509,9,322,1618,581,1133,7,334,2155,580,1376
242.82,1,6,336,6,28,48564,28,336,0,0,0,0,0
1700.4,17,12,498,11,14,170040,14,462,1,8,0,8,36
4.005,17,5,514,4,32,1330,32,240,1,246,0,246,274
376.65,17,6,528,3,60,188324,60,264,3,60,188324,60,264
99.889,6,855,440600,490,836,204,1152,421193,365,436,273,1179,19407
6.136,6,232,178772,126,229,49,256,9176,106,1577,57,5472,169596
62.812,17,4,352,2,48,62803,48,152,2,72,62801,72,200
0.095,6,2,111,1,0,0,0,40,1,31,0,31,71
280.451,6,30,7432,14,158,21573,267,1357,16,678,18693,3456,6075
0.901,6,23,7437,14,274,69,668,2109,9,1210,106,1946,5328
6.26,6,45,8409,23,227,284,314,4102,22,427,285,1152,4307
14.24,6,14,1025,7,222,2372,222,506,7,231,2371,231,519
4.529,6,39,7285,20,218,238,314,3423,19,516,237,1179,3862
0.18,17,2,154,1,33,0,33,61,1,65,0,65,93
0.0,17,1,674,1,646,0,646,674,0,0,0,0,0
96.604,6,26,5666,10,107,10733,159,970,16,967,6439,1669,4696
0.066,17,2,152,1,48,0,48,76,1,48,0,48,76
12.892,6,24,6993,13,275,1074,275,1078,11,910,789,1440,5915
1039.685,6,115,11582,74,91,14242,485,6345,41,87,25980,453,5237
1571.88,6,56,5531,37,110,43663,1440,4016,19,31,87299,31,1515
1799.099,17,142,11360,71,48,25701,48,5396,71,56,25701,56,5964
1796.693,17,446,38980,404,35,4458,288,25708,42,288,42946,288,13272
1799.686,6,373,26028,217,98,8331,469,15303,156,69,11609,69,10725
1.604,6,46,18982,27,881,61,1360,13446,19,476,77,2715,5536
1.513,6,35,11587,18,447,89,1332,3470,17,928,83,2720,8117
17.636,17,16,9199,9,734,2200,1350,6860,7,306,2934,1350,2339
3.95,17,2,134,2,39,3950,39,134,0,0,0,0,0
1.416,6,50,19717,27,922,54,1460,14021,23,433,55,1460,5696
1799.775,17,449,39928,404,35,4465,288,25708,45,288,40020,288,14220
1779.624,6,353,22400,206,69,8681,69,12380,147,69,12189,69,10020
10.41,6,80,24485,39,552,273,1152,18704,41,459,253,1179,5781
1768.959,1,58,4872,58,56,31034,56,4872,0,0,0,0,0
0.036,17,2,426,1,46,0,46,74,1,324,0,324,352
8.399,6,1808,1718290,1175,1386,6,1408,1680710,633,931,12,2801,37580
13.625,6,2109,1973619,1313,1423,10,1448,1924371,796,931,16,2896,49248
122.678,6,26,6335,9,181,302,293,1269,17,398,7652,1152,5066
41.245,6,39,8702,16,371,48,800,1811,23,331,1867,2720,6891
0.011,17,2,307,1,33,0,33,61,1,218,0,218,246
2.567,6,59,14900,30,551,88,1429,5124,29,409,88,1460,9776
0.161,17,2,214,1,39,0,39,67,1,119,0,119,147
1787.572,6,102,8228,68,64,26680,64,4896,34,58,54166,58,3332
61.329,6,38,17487,23,804,2787,1408,9301,15,822,4362,2816,8186
1791.234,6,186,24254,105,304,17223,304,16804,81,83,22390,83,7450
125.976,6,38,19894,22,1002,2698,1360,11956,16,1040,8386,4445,7938
1.731,6,23,5714,13,158,128,370,1315,10,998,176,1691,4399
0.776,6,5,1109,5,169,194,247,1109,0,0,0,0,0
2.27,6,22,3473,12,162,206,293,1458,10,537,223,1179,2015
0.306,6,26,9039,13,266,25,705,1750,13,1100,24,2804,7289
1758.98,17,43,14440,43,307,41880,308,14440,0,0,0,0,0
191.78,17,4,352,2,60,191779,60,176,2,60,191779,60,176
5.348,6,12,3432,3,299,476,299,463,9,356,666,492,2969
4.338,6,37,7189,19,218,241,314,3383,18,513,239,1179,3806
0.412,6,52,21921,28,1036,15,1380,16719,24,421,16,1923,5202
0.2,17,2,572,1,39,0,39,67,1,477,0,477,505
0.015,17,4,284,2,32,9,32,120,2,54,9,60,164
3.64,17,10,1415,5,31,907,31,295,5,196,907,196,1120
60.482,17,4,352,2,60,60481,60,176,2,60,60481,60,176
20.199,6,24,5827,14,107,1553,159,1190,10,684,2243,1418,4637
7.83,17,12,1764,6,48,1563,48,456,6,190,1563,308,1308
210.225,17,4,288,2,36,210212,36,128,2,52,210211,52,160
2.36,6,14,2351,8,188,337,245,700,6,703,419,1152,1651
365.329,6,55,14524,33,489,11416,1360,8749,22,348,473,2667,5775
0.021,17,4,344,2,47,19,47,150,2,69,20,75,194
66.343,6,25,7097,12,155,6031,267,1266,13,589,5527,3426,5831
22.533,6,23,4063,15,211,1609,211,1469,8,545,3218,904,2594
1771.676,6,99,9306,66,66,27256,66,5610,33,60,55361,60,3696
111.922,6,129,98119,81,1261,1399,1368,87497,48,738,2376,2519,10622
39.791,17,22,1672,22,48,1894,48,1672,0,0,0,0,0
40.046,6,27,7177,12,155,3640,267,1266,15,482,2859,1420,5911
1.042,17,17,9431,9,741,130,1350,6926,8,285,120,1350,2505
1772.512,6,203,22290,130,75,13740,267,10057,73,134,24615,1997,12233
10.598,6,83,24541,43,550,252,1152,18800,40,459,265,1179,5741
42.634,6,27,7177,13,155,3552,267,1306,14,530,3278,4260,5871
1796.848,1,264,14784,264,28,6832,28,14784,0,0,0,0,0
367.283,6,23,1535,16,177,24485,177,1053,7,110,10360,110,482
100.065,17,22,1936,11,48,10005,48,836,11,72,10005,72,1100
3.975,6,13,3463,7,188,662,245,660,6,1279,744,1407,2803
1797.025,17,448,39612,404,35,4459,288,25708,44,288,40954,288,13904
241.469,6,47,6225,22,192,11497,585,3087,25,165,10059,580,3138
1790.43,1,280,29680,280,78,6417,78,29680,0,0,0,0,0
1.104,6,25,8056,12,164,85,267,1288,13,869,78,1402,6768
1746.789,1,92,7728,92,56,19195,56,7728,0,0,0,0,0
27.376,17,4,240,2,32,27375,32,120,2,32,27375,32,120
147.53,6,30,7106,12,208,6969,516,1736,18,387,8665,1452,5370
0.52,17,17,11289,9,735,65,1350,6867,8,524,60,1350,4422
9.198,6,81,24994,41,568,229,1152,19253,40,459,229,1179,5741
15.256,17,16,5395,7,370,2537,1350,2792,9,261,1903,1350,2603
11.464,6,1811,1584089,1101,1385,10,1420,1551468,710,467,16,1883,32621
1798.767,6,157,14618,91,60,19986,722,7390,66,77,27668,1440,7228
1.095,6,26,9564,13,164,77,267,1388,13,1070,77,2816,8176
2.224,6,27,8799,16,277,148,565,1477,11,859,202,1380,7322
0.228,6,22,5960,12,181,20,537,1526,10,558,24,1408,4434
0.037,17,2,136,1,32,0,32,60,1,48,0,48,76
300.632,6,36,8584,20,336,15822,999,2190,16,522,562,2720,6394
100.809,6,12,8789,2,133,4750,133,217,10,1360,11199,1360,8572
0.139,6,46,21869,27,1052,5,1420,16888,19,467,7,1883,4981
0.247,6,19,4286,11,165,24,456,1394,8,493,28,888,2892
1776.909,17,73,3060,72,14,25026,14,3024,1,8,0,8,36
316.914,6,71,19144,39,313,8339,1360,10067,32,486,10218,1360,9077
125.543,6,173,135281,110,1283,1151,1408,122493,63,731,1925,3847,12788
859.799,6,191,17476,87,99,9996,641,8885,104,86,8347,1360,8591
280.463,6,28,7352,12,158,25496,267,1277,16,678,18694,2085,6075
22.992,17,4,352,2,48,22836,48,152,2,72,22975,72,200
45.133,6,27,7177,13,155,3761,267,1306,14,530,3471,3417,5871
17.087,6,4,160,1,0,0,0,40,3,0,4500,0,120
280.487,17,4,296,2,30,280413,30,116,2,62,280450,62,180
0.144,17,2,166,1,39,0,39,67,1,71,0,71,99
21.875,6,9,527,5,43,5468,43,311,4,0,7287,0,216
0.024,6,10,1723,6,578,3,997,1400,4,159,7,159,323
4.878,17,4,240,2,32,4876,32,120,2,32,4877,32,120
64.857,6,7459,7091730,4639,1444,13,1448,6930274,2820,776,22,1448,161456
52.717,6,28,7217,13,155,4393,267,1306,15,482,3764,1997,5911
10.567,6,16,2373,10,211,1172,211,974,6,545,2113,904,1399
1771.593,6,99,9240,66,65,27255,65,5577,33,59,55359,59,3663
1786.32,6,464,29520,246,100,7291,469,16256,218,34,8231,64,13264
1772.303,6,180,15480,120,69,14893,69,8940,60,69,30036,69,6540
1480.303,2,11,352,11,8,148030,8,352,0,0,0,0,0
3.272,17,5,1166,3,30,1606,30,174,2,468,3260,468,992
0.0,1,1,60,1,32,0,32,60,0,0,0,0,0
1.434,17,22,14707,12,992,129,1350,12248,10,217,155,1350,2459
1258.689,1,10,1160,10,88,139854,88,1160,0,0,0,0,0
30.006,6,43,9633,20,331,1579,722,3125,23,557,1345,1380,6508
756.524,2,7,224,7,8,126087,8,224,0,0,0,0,0
0.21,6,9,1002,5,213,52,213,417,4,421,50,421,585
0.822,17,4,524,2,39,809,39,134,2,167,805,167,390
0.316,17,2,140,1,34,0,34,62,1,50,0,50,78
14.106,6,2150,2023504,1363,1406,10,1448,1977916,787,776,17,1448,45588
378.118,2,4,128,4,8,126039,8,128,0,0,0,0,0
0.005,6,3,425,2,140,0,250,385,1,0,0,0,40
10.985,6,18,4266,10,275,1220,275,958,8,992,879,1440,3308
1797.759,17,448,39896,403,35,4472,288,25676,45,288,40018,288,14220
134.375,6,22,9920,11,433,73,990,1771,11,1099,13423,1440,8149
153.646,6,29,9676,14,529,56,956,2721,15,576,10965,1360,6955
1793.897,6,250,36744,154,302,11724,302,26740,96,83,18883,83,10004
2.77,17,3,183,3,33,1385,33,183,0,0,0,0,0
0.044,17,3,215,2,33,24,33,122,1,65,0,65,93
1744.669,2,19,608,19,8,96926,8,608,0,0,0,0,0
5.092,17,2,2200,2,1072,5092,1072,2200,0,0,0,0,0
0.207,6,39,16966,23,1015,9,1420,12105,16,467,13,1883,4861
1727.655,17,254,53383,254,182,6828,358,53383,0,0,0,0,0
0.233,17,2,154,1,33,0,33,61,1,65,0,65,93
79.578,6,42,9984,21,533,487,910,3031,21,469,3972,3488,6953
1.95,17,2,134,2,39,1950,39,134,0,0,0,0,0
31.88,6,74,64288,27,140,1226,343,1825,47,1395,692,2836,62463
378.906,2,4,128,4,8,126302,8,128,0,0,0,0,0
1.332,6,47,18940,26,942,53,1440,13324,21,433,57,1440,5616
4.31,6,13,5764,4,112,1436,112,280,9,730,514,1997,5484
0.086,6,3,156,1,0,0,0,40,2,0,36,0,116
1.369,6,50,19236,29,883,48,1360,13575,21,437,59,2720,5661
0.027,17,6,462,3,33,0,33,183,3,65,0,65,279
115.919,17,4,272,2,40,115918,47,136,2,40,115918,47,136
0.995,6,29,12012,17,522,62,1360,3338,12,1022,72,3921,8674
4.975,1,10,280,10,0,0,0,280,0,0,0,0,0
1.332,6,49,18654,27,849,51,1360,12998,22,476,55,2715,5656
240.225,6,52,17715,27,800,9239,1402,15027,25,197,10009,580,2688
34.623,6,36,8272,18,348,514,730,1798,18,478,2028,2880,6474
1794.983,17,449,39928,404,35,4454,288,25708,45,288,40022,288,14220
1622.655,6,108,13057,63,85,23568,501,5080,45,146,36876,1420,7977
0.107,17,3,634,2,32,29,32,120,1,486,0,486,514
157.813,6,30,7432,13,158,13151,267,1317,17,603,9860,2076,6115
2.501,17,28,12472,13,644,208,1350,8743,15,220,112,1350,3729
5.514,6,41,7349,21,218,275,314,3463,20,440,277,1152,3886
0.67,6,40,11595,22,570,31,1188,7415,18,323,34,524,4180
0.027,17,2,1152,1,548,0,548,576,1,548,0,548,576
1772.375,6,180,15480,120,69,14893,69,8940,60,69,30034,69,6540
1798.047,17,448,39896,403,35,4472,288,25676,45,288,40018,288,14220
1.384,6,47,18655,26,920,55,1460,13039,21,433,59,1460,5616
57.702,17,10,880,5,48,14423,48,380,5,72,14423,72,500
137.058,17,4,352,2,60,137057,60,176,2,60,137057,60,176
0.767,6,18,5172,10,150,85,174,704,8,828,96,1420,4468
1770.534,1,58,4872,58,56,31062,56,4872,0,0,0,0,0
0.009,17,2,554,2,249,9,249,554,0,0,0,0,0
1786.036,6,110,8746,70,65,25884,65,5140,40,59,45792,59,3606
125.543,6,34,7935,12,155,30,267,1266,22,340,5977,3417,6669
1756.967,6,94,7151,62,38,28802,205,4424,32,33,56663,98,2727
4.628,6,13,1824,8,483,661,483,1390,5,83,1155,83,434
10.535,6,72,20979,36,523,301,1152,16096,36,491,293,1179,4883
0.197,1,2,163,2,53,197,78,163,0,0,0,0,0
1799.052,6,223,27207,114,110,15920,721,12196,109,200,16655,1420,15011
33.065,17,20,1520,20,48,1740,48,1520,0,0,0,0,0
10.769,6,18,5610,10,275,1196,275,958,8,1440,820,1440,4652
1799.298,6,367,25650,214,99,8447,469,15045,153,69,11835,69,10605
0.001,6,2,104,1,0,0,0,40,1,0,0,0,64
47.338,6,25,4898,9,341,5587,722,1500,16,232,3143,1408,3398
584.685,17,48,3840,24,48,25420,48,1824,24,56,25420,56,2016
371.436,17,14,4960,14,326,28572,548,4960,0,0,0,0,0
1.584,6,39,9888,21,440,79,1360,4392,18,433,81,1360,5496
1372.115,6,173,11868,66,46,21109,46,5012,107,46,12943,46,6856
11.85,6,1920,1633282,1152,1363,10,1380,1598320,768,421,15,1923,34962
1795.995,1,58,4872,58,56,31508,56,4872,0,0,0,0,0
60.439,6,152,12690,131,132,464,174,6174,21,472,3015,1452,6516
0.488,6,7,295,4,0,162,0,164,3,7,143,7,131
1741.119,6,84,6104,56,31,31656,31,3780,28,31,64484,31,2324
0.201,6,10,1386,6,145,40,145,389,4,833,63,833,997
0.014,17,2,267,1,35,0,35,63,1,176,0,176,204
11.707,6,1835,1684273,1130,1410,10,1448,1642949,705,776,16,1448,41324
1740.019,17,27,1539,27,29,66923,29,1539,0,0,0,0,0
619.204,6,78,11999,42,125,15102,721,4698,36,278,17685,2840,7301
0.041,17,2,364,1,43,0,43,71,1,265,0,265,293
0.0,6,1,60,0,0,0,0,0,1,0,0,0,60
0.139,17,2,178,1,29,0,29,57,1,93,0,93,121
8.262,6,1831,1726046,1184,1381,6,1408,1687738,647,776,12,1408,38308
294.243,17,4,558,2,36,294238,36,128,2,187,294238,187,430
252.499,2,2,64,2,8,252499,8,64,0,0,0,0,0
840.567,17,10,2654,5,31,210140,37,297,5,443,210140,463,2357
1792.503,17,180,14040,180,50,10013,50,14040,0,0,0,0,0
87.596,6,21,5014,12,536,7963,1244,2778,9,293,7526,1282,2236
0.36,17,2,168,1,48,0,48,76,1,64,0,64,92
1787.903,6,364,25392,212,100,8473,469,14896,152,69,11840,69,10496
0.568,6,26,9017,13,261,47,683,1728,13,943,41,1448,7289
372.458,6,25,1651,17,177,23278,177,1117,8,110,9234,110,534
1791.276,6,356,22520,208,69,8653,69,12460,148,69,12185,69,10060
1.333,6,50,19309,27,892,51,1460,13613,23,433,50,1460,5696
2.439,6,5,280,2,0,2439,0,100,3,0,1172,0,180
5.373,6,40,7309,21,218,268,314,3463,19,440,283,1152,3846
1684.367,17,16,3136,16,168,112291,168,3136,0,0,0,0,0
1745.654,6,95,7203,63,38,28155,205,4476,32,33,56303,98,2727
0.424,17,8,2750,8,315,60,354,2750,0,0,0,0,0
2.209,6,27,8175,15,350,157,1088,2355,12,1067,200,1731,5820
184.129,17,4,558,2,36,184124,36,128,2,187,184124,187,430
0.846,17,21,14756,13,923,69,1350,12375,8,269,116,1350,2381
292.36,17,4,352,2,60,292359,60,176,2,60,292359,60,176
394.12,1,22,1232,22,28,18767,28,1232,0,0,0,0,0
1786.671,6,102,8296,68,65,26666,65,4930,34,59,54138,59,3366
280.358,6,27,7312,12,158,25487,267,1277,15,678,20021,2045,6035
1783.032,6,365,23087,211,69,8490,69,12787,154,69,11653,69,10300
1090.695,6,261,15861,130,70,8435,138,7822,131,36,8389,64,8039
560.455,17,6,1559,3,30,280223,30,174,3,433,280222,463,1385
1.244,6,38,9848,21,440,62,1360,4392,17,529,66,4075,5456
7.267,6,1677,1550653,1065,1378,6,1408,1514165,612,931,11,2816,36488
5.427,6,248,209887,104,634,52,1011,9087,144,1390,37,1440,200800
41.786,6,34,19232,20,509,2199,1018,2601,14,1589,3213,2954,16631
19.943,6,5,260,4,0,6647,0,172,1,48,0,48,88
0.562,6,10,968,5,256,138,256,460,5,304,138,304,508
1796.106,6,381,26736,213,99,8472,469,15074,168,65,10755,69,11662
280.422,6,28,7352,13,158,23368,267,1317,15,603,20027,2760,6035
149.02,17,4,352,2,60,149019,60,176,2,60,149019,60,176
270.74,6,14,995,9,31,33842,31,580,5,31,67643,31,415
42.034,17,4,3100,4,747,14011,1451,3100,0,0,0,0,0
1772.242,6,182,15629,121,69,14768,69,8980,61,69,29533,69,6649
300.834,6,42,12379,23,733,13674,1360,6817,19,399,479,1360,5562
1.012,17,3,183,2,33,999,33,122,1,33,0,33,61
0.053,17,4,284,2,32,39,32,120,2,54,41,60,164
2.995,17,13,7953,7,802,497,1350,5816,6,328,591,1350,2137
0.028,17,2,235,1,36,0,36,64,1,143,0,143,171
62.295,6,24,11777,13,367,64,783,1678,11,1378,6215,3966,10099
0.227,17,8,2758,8,316,32,355,2758,0,0,0,0,0
367.159,6,27,1767,18,177,21597,177,1181,9,110,8550,110,586
1743.918,6,97,7307,63,38,28127,205,4476,34,33,52835,98,2831
2.654,17,6,870,3,40,1311,40,204,3,194,1311,194,666
0.021,6,10,1512,5,503,5,503,771,5,473,5,473,741
1786.5,6,354,22509,206,69,8714,69,12380,148,69,12151,69,10129
37.184,17,4,352,2,60,37182,60,176,2,60,37183,60,176
14.692,6,10,436,4,0,4897,0,172,6,0,1736,0,264
1798.563,17,384,64287,384,139,4695,391,64287,0,0,0,0,0
1.329,6,41,9968,21,440,66,1360,4392,20,433,60,1360,5576
1740.592,17,28,6580,28,207,64466,207,6580,0,0,0,0,0
0.0,17,1,100,1,72,0,72,100,0,0,0,0,0
1769.271,1,58,4872,0,0,0,0,0,58,56,31039,56,4872
1756.796,17,54,18144,54,308,33147,308,18144,0,0,0,0,0
21.242,6,22,3222,13,183,1770,517,1601,9,381,2654,499,1621
153.908,6,27,6494,11,220,6225,516,1326,16,348,10254,1452,5168
0.264,6,21,5000,10,137,29,267,1092,11,692,25,1467,3908
756.161,2,6,192,6,8,151232,8,192,0,0,0,0,0
1799.992,6,201,13974,73,46,24999,46,5910,128,46,14065,46,8064
1401.249,17,12,888,6,30,280247,30,348,6,62,280246,62,540
1796.18,17,87,3648,86,14,21131,14,3612,1,8,0,8,36
1787.321,6,102,8228,68,64,26676,64,4896,34,58,54157,58,3332
1.339,6,38,8252,19,320,74,1162,2716,19,433,64,1360,5536
2.182,6,10,1687,7,100,363,100,384,3,1179,959,1179,1303
1773.59,6,183,15738,121,69,14779,69,8980,62,69,29067,69,6758
503.92,2,4,128,4,8,167973,8,128,0,0,0,0,0
1799.117,17,448,39896,403,35,4475,288,25676,45,288,40017,288,14220
4.19,6,39,7269,19,218,232,314,3383,20,440,207,1152,3886
1795.08,6,357,22629,208,69,8671,69,12460,149,69,12126,69,10169
0.827,6,149,103186,82,1308,10,1432,96215,67,427,11,1432,6971
280.542,6,27,7312,12,158,25503,267,1277,15,775,20033,3465,6035
1.191,6,12,2293,7,145,198,145,429,5,830,173,830,1864
53.453,6,26,8848,7,155,380,267,1066,19,467,2968,1460,7782
1753.515,6,189,11921,95,52,18654,208,7231,94,31,18852,31,4690
0.067,6,11,1535,5,507,16,507,727,6,556,13,556,808
1.737,6,14,2351,8,188,248,245,700,6,703,293,1152,1651
1799.566,17,142,11360,71,48,25708,48,5396,71,56,25708,56,5964
0.239,6,14,6093,7,128,39,128,500,7,1305,39,1448,5593
216.509,6,30,7432,13,158,18042,267,1317,17,543,13528,1400,6115
1797.484,6,346,28493,198,75,9124,267,13191,148,132,12227,1452,15302
23.849,17,27,9126,12,418,2164,1350,5361,15,223,1700,1350,3765
281.403,6,32,7516,14,158,21646,267,1357,18,603,16550,2076,6159
1789.134,17,17,5712,17,308,111820,308,5712,0,0,0,0,0
1.198,1,10,840,10,56,133,56,840,0,0,0,0,0
1793.792,6,358,22876,208,69,8665,69,12598,150,69,12038,69,10278
0.171,17,2,152,1,48,0,48,76,1,48,0,48,76
3.04,17,2,122,2,33,3040,33,122,0,0,0,0,0
4.461,17,2,656,2,300,4461,300,656,0,0,0,0,0
0.426,6,18,3004,9,266,53,517,1542,9,493,51,828,1462
143.531,1,4,224,4,28,47843,28,224,0,0,0,0,0
125.651,6,5,267,3,0,62825,0,152,2,7,125429,7,115
4.515,6,38,7245,20,218,237,314,3423,18,516,249,1179,3822
6.104,6,1559,1486473,991,1423,5,1448,1452273,568,776,10,1448,34200
1.621,6,49,20882,28,940,60,1460,15266,21,433,72,1460,5616
1778.847,17,140,11200,70,48,25780,48,5320,70,56,25780,56,5880
1741.451,17,30,7050,30,207,60050,207,7050,0,0,0,0,0
1791.386,17,87,3648,86,14,21075,14,3612,1,8,0,8,36
0.264,6,10,1380,5,145,66,145,349,5,827,64,827,1031
1.348,6,49,19102,28,881,49,1360,13486,21,476,58,2715,5616
1.996,17,2,120,2,32,1996,32,120,0,0,0,0,0
256.723,17,4,240,2,32,256722,32,120,2,32,256722,32,120
9.213,6,88,28951,45,581,209,1152,22733,43,449,213,1179,6218
1776.433,1,268,15008,268,28,6653,28,15008,0,0,0,0,0
1.815,17,2,154,1,33,0,33,61,1,65,0,65,93
187.258,1,2,208,2,76,187258,76,208,0,0,0,0,0
2.357,17,4,1536,4,356,785,356,1536,0,0,0,0,0
852.526,1,24,2544,24,78,37066,78,2544,0,0,0,0,0
0.513,17,3,451,2,39,184,39,134,1,289,0,289,317
0.068,17,2,323,1,33,0,33,61,1,234,0,234,262
281.681,6,29,7392,13,158,23473,267,1317,16,603,18758,2036,6075
1780.973,17,73,3060,72,14,25084,14,3024,1,8,0,8,36
1790.309,6,362,22898,210,69,8566,69,12678,152,69,11855,69,10220
969.16,1,14,784,14,28,74550,28,784,0,0,0,0,0
751.021,17,20,1520,20,48,39527,48,1520,0,0,0,0,0
104.773,6,86,58518,52,1211,2054,1368,49954,34,747,1926,1368,8564
133.937,6,27,7312,12,158,12176,267,1277,15,678,9563,2045,6035
300.932,6,46,16225,25,955,12538,1460,10583,21,399,435,1460,5642
46.803,6,6153,5926679,4117,1363,11,1408,5816143,2036,931,22,2801,110536
254.571,17,4,352,2,60,254570,60,176,2,60,254570,60,176
4.001,17,4,248,4,34,1333,34,248,0,0,0,0,0
2.406,6,57,24104,32,997,77,1460,18283,25,400,88,1460,5821
257.995,17,4,1536,4,356,85998,356,1536,0,0,0,0,0
688.278,17,6,246,5,14,172069,14,210,1,8,0,8,36
2.95,17,2,124,2,34,2950,34,124,0,0,0,0,0
56.14,6,19,3624,10,476,6232,580,2912,9,212,7013,212,712
2.321,6,14,2351,8,188,331,245,700,6,703,412,1152,1651
31.113,17,36,5292,18,48,1829,48,1368,18,190,1829,308,3924
0.411,6,21,7203,13,318,33,600,1958,8,1205,56,1851,5245
280.009,6,32,7512,15,158,20000,267,1397,17,543,17500,1400,6115
21.443,17,12,1056,6,48,4286,48,456,6,72,4285,72,600
3.638,17,10,2770,5,30,905,30,290,5,468,892,468,2480
1741.315,17,28,6580,28,207,64493,207,6580,0,0,0,0,0
0.077,17,2,178,1,29,0,29,57,1,93,0,93,121
280.603,6,30,7432,13,158,23383,267,1317,17,603,17534,2076,6115
59.331,6,355,284651,172,209,346,230,13509,183,1469,320,2816,271142
2.506,17,28,17156,12,585,223,1350,7356,16,584,163,1350,9800
0.02,17,2,503,1,40,0,40,68,1,407,0,407,435
1785.857,6,359,22709,209,69,8585,69,12569,150,69,11985,69,10140
1741.323,17,30,31680,30,1028,60045,1028,31680,0,0,0,0,0
300.857,6,51,10566,25,433,12535,910,3258,26,312,530,1460,7308
0.017,17,4,524,2,39,3,39,134,2,167,2,167,390
280.597,6,28,7352,12,158,25508,267,1277,16,603,18700,1400,6075
32.678,6,31,5676,18,174,1922,517,2350,13,440,2722,499,3326
1766.439,6,80,4212,40,26,45292,26,2106,40,26,45292,26,2106
2.396,17,3,1176,3,364,1198,364,1176,0,0,0,0,0
0.205,17,2,152,1,48,0,48,76,1,48,0,48,76
303.038,6,56,24305,32,1062,9775,1360,18314,24,358,472,1360,5991
0.257,6,21,5000,11,137,25,267,1132,10,692,27,1467,3868
1737.627,1,56,4704,56,56,31593,56,4704,0,0,0,0,0
0.076,17,2,245,1,32,0,32,60,1,157,0,157,185
7.721,6,4,168,3,0,3860,0,124,1,0,0,0,44
7.84,6,40,7602,21,224,392,314,3756,19,513,421,1179,3846
126.411,6,17,3307,8,92,18058,92,504,9,333,15766,1408,2803
0.0,17,1,1477,1,1449,0,1449,1477,0,0,0,0,0
316.998,6,72,18809,38,311,8567,1360,9330,34,386,9602,4649,9479
1792.809,17,180,11520,180,36,10015,36,11520,0,0,0,0,0
136.008,6,27,8752,14,158,10462,267,1357,13,1145,11316,4845,7395
33.36,17,28,12540,14,659,2563,1350,9620,14,180,2563,1350,2920
35.397,6,26,4125,11,304,3539,304,2708,15,83,2526,83,1417
4.006,17,8,792,4,39,1332,39,268,4,103,1332,103,524
1786.684,6,105,8416,68,65,26666,65,4930,37,59,49627,59,3486
1.027,6,10,1687,7,100,171,100,384,3,1179,380,1179,1303
618.074,6,72,14388,32,180,19937,621,4067,40,300,15844,4649,10321
1787.91,6,373,25959,215,98,8354,469,15223,158,69,11387,69,10736
0.205,17,2,180,1,30,0,30,58,1,94,0,94,122
1658.992,6,29,5158,19,273,92166,413,3499,10,125,184311,269,1659
1684.453,2,26,832,26,8,67378,8,832,0,0,0,0,0
0.165,6,2,116,1,0,0,0,64,1,0,0,0,52
4.727,6,39,7269,19,218,262,314,3383,20,513,235,1179,3886
0.696,6,10,861,5,222,172,222,426,5,231,172,231,435
1735.921,1,8,448,8,28,247988,28,448,0,0,0,0,0
0.345,6,10,887,5,248,84,248,452,5,231,84,231,435
0.06,6,10,1495,5,507,14,507,727,5,556,15,556,768
36.003,6,5,3080,3,0,18001,0,120,2,1440,27904,1440,2960
1795.972,6,355,22480,207,69,8718,69,12420,148,69,12217,69,10060
4.34,17,26,7423,12,252,391,1350,3367,14,261,331,1350,4056
46.685,6,8,352,7,0,2994,0,308,1,0,0,0,44
1799.658,6,370,26239,215,105,8409,469,15554,155,69,11684,69,10685
11.326,6,1828,1561051,1102,1363,10,1380,1527769,726,421,15,1923,33282
1777.723,17,79,3312,78,14,23087,14,3276,1,8,0,8,36
378.108,2,3,96,3,8,189054,8,96,0,0,0,0,0
0.639,6,7,295,4,0,213,0,164,3,7,161,7,131
175.174,17,2,72,1,8,0,8,36,1,8,0,8,36
15.153,6,24,6993,13,275,1262,275,1078,11,910,1014,1440,5915
64.533,6,39,11473,16,310,4302,1189,2822,23,454,2931,1997,8651
137.609,6,5343,4529321,2540,610,54,1396,143212,2803,1518,49,6980,4386109
0.321,6,130,271136,87,194,3,230,5311,43,6428,6,21120,265825
628.359,17,12,1056,6,48,125669,48,456,6,72,125669,72,600
0.007,17,2,503,1,40,0,40,68,1,407,0,407,435
254.49,6,7,418,4,106,84830,106,274,3,0,1517,0,144
56.691,17,4,352,2,48,56683,48,152,2,72,56682,72,200
1770.486,6,99,9240,66,65,27238,65,5577,33,59,55324,59,3663
0.528,17,3,451,2,39,38,39,134,1,289,0,289,317
240.704,2,3,96,3,8,120352,8,96,0,0,0,0,0
240.217,6,54,17901,29,803,8579,1408,15180,25,176,10008,580,2721
3.124,6,22,3505,13,167,260,293,1530,9,537,357,1179,1975
0.366,17,2,152,1,48,0,48,76,1,48,0,48,76
0.429,6,10,1992,5,288,97,288,508,5,424,63,434,1484
2.67,17,4,518,3,39,568,39,201,1,289,0,289,317
1792.308,6,355,22480,207,69,8700,69,12420,148,69,12192,69,10060
298.351,2,3,96,3,8,149175,8,96,0,0,0,0,0
1796.045,17,448,39896,403,35,4467,288,25676,45,288,40017,288,14220
20.182,17,22,1637,14,40,1547,41,960,8,56,2875,57,677
1796.485,6,253,37214,155,302,11665,302,27094,98,83,18520,83,10120
1787.454,6,104,8376,68,65,26678,65,4930,36,59,51065,59,3446
1787.69,6,102,8160,68,63,26681,63,4862,34,57,54167,57,3298
755.717,2,6,192,6,8,151143,8,192,0,0,0,0,0
7.661,17,6,528,3,48,3824,48,228,3,72,3824,72,300
0.569,6,10,924,5,283,98,283,551,5,105,98,105,373
8.368,6,41,7280,26,126,334,267,2704,15,567,469,1420,4576
1776.199,17,73,3060,72,14,25016,14,3024,1,8,0,8,36
0.745,17,2,266,1,41,0,41,69,1,169,0,169,197
369.534,6,18,1242,14,180,28425,180,916,4,110,20059,110,326
20.149,6,19,2949,10,255,2238,517,1815,9,323,2517,499,1134
1744.69,2,27,864,27,8,67103,8,864,0,0,0,0,0
1795.312,17,29,9512,29,300,64118,300,9512,0,0,0,0,0
18.06,6,28,7376,10,165,17,267,1069,18,398,1062,3417,6307
0.382,6,21,7215,13,318,31,600,1970,8,964,52,1851,5245
1783.295,17,140,11200,70,48,25844,48,5320,70,56,25844,56,5880
365.997,6,27,1767,18,177,21529,177,1181,9,110,8849,110,586
1782.69,6,204,14140,74,46,24420,46,5950,130,46,13818,46,8190
0.031,17,3,244,2,32,10,32,120,1,96,0,96,124
4.506,17,10,820,10,54,500,54,820,0,0,0,0,0
0.16,6,27,7296,13,155,13,267,1301,14,603,11,1400,5995
4.798,6,16,5155,7,150,799,174,584,9,701,542,1452,4571
1678.719,17,18,4639,9,31,209838,37,536,9,427,209838,463,4103
1655.658,1,8,448,8,28,236522,28,448,0,0,0,0,0
0.021,17,2,172,1,50,0,50,78,1,66,0,66,94
0.856,6,51,13829,24,551,37,1429,4840,27,464,32,1986,8989
1794.539,6,367,23236,212,69,8504,69,12827,155,69,11652,69,10409
58.03,6,6929,6517302,4527,1361,12,1408,6387722,2402,931,24,2801,129580
1753.793,1,59,4956,59,56,30237,56,4956,0,0,0,0,0
1789.684,6,399,92691,183,421,9831,1460,65595,216,196,8322,2920,27096
277.823,17,4,240,2,32,277822,32,120,2,32,277822,32,120
1772.296,6,180,15480,120,69,14893,69,8940,60,69,30031,69,6540
1773.441,6,180,15480,120,69,14902,69,8940,60,69,30049,69,6540
0.035,6,10,1542,5,505,8,505,773,5,501,8,501,769
0.281,6,44,17254,24,937,12,1420,12233,20,420,14,1420,5021
11.794,6,102,31302,51,568,235,1152,24780,51,447,229,1179,6522
1771.167,6,101,9410,66,66,27248,66,5610,35,60,52090,60,3800
1.33,6,49,17833,26,851,53,1440,12137,23,433,52,1440,5696
280.479,6,29,7392,13,158,23373,267,1317,16,775,18694,4836,6075
1772.927,6,180,15480,120,69,14898,69,8940,60,69,30047,69,6540
0.17,1,2,168,2,56,170,56,168,0,0,0,0,0
262.163,6,34,4489,18,304,15421,304,3052,16,83,17447,83,1437
112.456,17,4,352,2,60,112455,60,176,2,60,112454,60,176
13.1,6,32,8952,14,158,1007,267,1357,18,763,767,2076,7595
0.181,6,42,16385,23,950,8,1420,11392,19,420,9,1420,4993
0.027,17,2,495,1,39,0,39,67,1,400,0,400,428
4.259,6,35,6209,18,206,250,314,2784,17,548,249,1179,3425
0.581,1,20,560,20,0,0,0,560,0,0,0,0,0
2.182,17,4,314,2,31,2136,31,118,2,70,2130,70,196
1353.897,6,78,6344,52,65,26547,65,3770,26,59,54149,59,2574
0.016,17,2,152,1,48,0,48,76,1,48,0,48,76
74.06,6,29,11994,9,156,9257,267,1152,20,627,3892,2006,10842
1.288,17,4,624,2,64,976,64,184,2,192,919,192,440
1748.805,1,8,448,8,28,249829,28,448,0,0,0,0,0
0.354,6,2,80,1,0,0,0,40,1,0,0,0,40
0.089,6,9,1339,5,145,22,145,349,4,826,26,826,990
280.605,6,32,7853,14,158,21585,267,1357,18,524,16505,1400,6496
280.499,6,29,7392,14,158,21576,267,1357,15,678,20028,3456,6035
1794.097,6,356,22520,208,69,8667,69,12460,148,69,12204,69,10060
0.013,6,10,1512,5,503,3,503,771,5,473,3,473,741
158.825,6,32,7912,17,189,9790,516,1630,15,473,11338,1452,6282
24.814,17,4,352,2,60,24813,60,176,2,60,24812,60,176
55.665,17,9,3480,9,358,6958,548,3480,0,0,0,0,0
0.006,17,2,399,1,39,0,39,67,1,304,0,304,332
1785.883,17,29,9512,29,300,63781,300,9512,0,0,0,0,0
0.004,17,2,449,1,48,0,48,76,1,345,0,345,373
64.097,6,25,3500,11,304,6409,304,2088,14,83,4912,83,1412
0.01,17,2,410,1,46,0,46,74,1,308,0,308,336
1791.022,6,356,22520,208,69,8652,69,12460,148,69,12183,69,10060
0.641,6,22,5330,12,113,57,162,936,10,665,70,1420,4394
0.984,17,2,144,1,36,0,36,64,1,52,0,52,80
1.326,6,38,8252,19,320,73,1162,2716,19,476,64,2715,5536
355.832,6,58,19085,29,541,12708,1360,6147,29,619,12694,1360,12938
10.998,6,20,4442,11,275,1099,275,998,9,768,777,1440,3444
1712.87,17,12,498,11,14,171287,14,462,1,8,0,8,36
17.15,17,60,22112,27,506,659,1350,14437,33,204,533,1350,7675
318.278,6,594,523238,393,1334,811,1360,508094,201,228,129,2667,15144
0.014,6,2,116,0,0,0,0,0,2,0,0,0,116
1791.9,1,342,28728,342,56,5254,56,28728,0,0,0,0,0
11.296,6,1798,1561658,1083,1388,10,1420,1528837,715,467,15,1883,32821
1782.671,1,90,5040,90,28,20030,28,5040,0,0,0,0,0
1.659,6,48,18749,29,854,59,1360,13168,19,437,81,2715,5581
373.496,6,18,1242,14,180,28730,180,916,4,110,20067,110,326
0.018,17,2,375,1,29,0,29,57,1,290,0,290,318
60.851,6,2974,2693617,1946,1306,31,1368,2633253,1028,776,59,1473,60364
1700.468,17,12,498,11,14,170046,14,462,1,8,0,8,36
7.69,17,18,8210,8,315,1098,1350,2749,10,518,761,1350,5461
33.811,6,31,5095,15,154,2415,722,1860,16,342,2241,1440,3235
14.528,6,2243,2107414,1457,1369,9,1408,2061878,786,931,18,2816,45536
10.871,6,18,5610,10,275,1207,275,958,8,1440,837,1440,4652
1790.518,17,87,3648,86,14,21064,14,3612,1,8,0,8,36
1788.268,17,87,3648,86,14,21038,14,3612,1,8,0,8,36
33.237,6,24,7098,11,229,3316,517,1497,13,820,2763,2448,5601
1788.81,17,87,3648,86,14,21044,14,3612,1,8,0,8,36
1.227,6,24,8004,12,164,95,267,1288,12,1014,95,2804,6716
1794.774,17,406,52785,194,178,9297,1350,40103,212,31,8506,60,12682
0.091,6,10,1514,5,503,22,503,771,5,475,22,475,743
0.102,6,10,1512,5,503,25,503,771,5,473,25,473,741
0.007,17,2,481,1,72,0,72,100,1,353,0,353,381
1797.163,6,367,25650,214,99,8437,469,15045,153,69,11820,69,10605
10.952,6,20,4442,11,275,1095,275,998,9,768,771,1440,3444
3.014,17,4,1108,2,30,1030,30,116,2,468,0,468,992
1785.111,6,102,8364,68,66,26643,66,4964,34,60,54091,60,3400
1783.814,6,359,22709,209,69,8576,69,12569,150,69,11971,69,10140
3.346,6,2,88,2,0,0,0,88,0,0,0,0,0
1275.891,6,198,13964,71,47,17799,92,5158,127,47,10061,138,8806
0.976,6,27,8441,14,270,61,561,1945,13,994,66,1791,6496
300.216,6,30,11747,17,588,18763,1438,4425,13,948,20016,1488,7322
3.84,6,13,3293,6,49,768,92,407,7,503,115,1448,2886
301.545,6,80,13474,36,179,7074,1189,3967,44,257,7012,1460,9507
1.178,6,23,7952,12,164,92,267,1288,11,1216,101,3819,6664
1.323,6,49,20209,27,957,50,1460,14553,22,476,54,2615,5656
1681.329,17,14,3843,7,30,280219,30,406,7,463,280219,463,3437
114.233,6,40,8775,17,401,1808,889,1916,23,348,5186,3488,6859
0.043,17,2,384,1,32,0,32,60,1,296,0,296,324
4.431,6,12,1040,5,283,1063,283,563,7,105,709,105,477
18.231,17,35,13980,19,569,1011,1350,11356,16,136,1213,1350,2624
1681.731,17,14,1036,7,30,280286,30,406,7,62,280286,62,630
1.418,6,45,18906,26,946,56,1460,13370,19,476,68,2615,5536
1796.222,17,446,38980,404,35,4457,288,25708,42,288,42936,288,13272
11.484,6,25,6679,13,346,956,1070,2257,12,982,1043,1731,4422
3.903,17,5,295,5,31,975,31,295,0,0,0,0,0
1.451,6,38,8252,19,320,80,1162,2716,19,476,70,2615,5536
0.542,6,22,5960,12,108,49,147,919,10,927,56,1608,5041
7.358,6,1102,990162,669,1402,10,1448,962982,433,776,16,1448,27180
1.401,6,51,19105,29,871,50,1360,13404,22,437,58,2715,5701
1799.957,6,232,20105,88,77,20689,337,9125,144,71,12586,1062,10980
1784.214,17,287,59389,287,178,6238,361,59389,0,0,0,0,0
6.302,6,6,344,2,0,6001,0,112,4,0,2043,0,232
98.043,6,33,9061,14,158,7541,267,1357,19,578,5433,1400,7704
1773.227,6,180,15480,120,69,14901,69,8940,60,69,30051,69,6540
0.021,6,4,220,2,0,21,0,104,2,0,17,0,116
301.061,6,47,18257,27,961,11579,1360,12655,20,435,467,2667,5602
1752.295,6,95,7203,63,38,28262,205,4476,32,33,56518,98,2727
240.314,6,43,9015,21,521,12014,1418,5789,22,230,11442,618,3226
26.582,6,5,264,3,0,13291,0,160,2,0,1018,0,104
1793.894,6,1545,449127,739,772,2430,1418,383796,806,62,2228,580,65331
6.05,6,39,7269,19,218,336,314,3383,20,440,304,1152,3886
1763.929,2,14,448,14,8,135686,8,448,0,0,0,0,0
0.002,6,4,2932,1,0,0,0,40,3,1368,0,1368,2892
0.765,17,3,216,2,31,727,31,118,1,70,0,70,98
0.013,17,2,384,1,39,0,39,67,1,289,0,289,317
0.009,17,2,362,1,32,0,32,60,1,274,0,274,302
1796.665,17,448,39612,404,35,4458,288,25708,44,288,40951,288,13904
1782.195,6,354,22440,207,69,8651,69,12420,147,69,12206,69,10020
0.044,17,2,176,1,60,0,60,88,1,60,0,60,88
0.67,6,2,87,1,0,0,0,40,1,7,0,7,47
1790.286,6,366,25541,213,100,8444,469,14936,153,69,11775,69,10605
1799.278,1,57,4788,57,56,32129,56,4788,0,0,0,0,0
0.08,17,4,1375,4,315,26,354,1375,0,0,0,0,0
0.696,17,4,1344,4,308,232,308,1344,0,0,0,0,0
1798.76,17,407,36312,366,35,4928,288,23356,41,288,44021,288,12956
9.472,6,22,6748,13,529,784,944,2271,9,667,1177,1368,4477
0.346,6,31,7168,18,244,20,656,2434,13,601,27,1420,4734
1.975,17,4,360,2,30,1048,30,116,2,94,1,94,244
1.876,6,66,16668,33,539,58,1429,5773,33,434,57,3446,10895
1681.837,17,14,1036,7,30,280303,30,406,7,62,280303,62,630
1771.322,6,99,9306,66,66,27251,66,5610,33,60,55351,60,3696
1680.54,17,12,498,11,14,168054,14,462,1,8,0,8,36
15.531,6,6,264,1,0,0,0,44,5,0,3862,0,220
0.051,6,10,1495,5,507,12,507,727,5,556,12,556,768
3.708,6,492,381488,235,342,15,351,15084,257,1395,14,2736,366404
1772.168,6,180,15480,120,69,14892,69,8940,60,69,30035,69,6540
4.294,6,40,7309,20,218,226,314,3423,20,440,212,1152,3886
0.128,17,7,2438,7,320,21,354,2438,0,0,0,0,0
4.61,6,38,7229,20,218,242,314,3423,18,513,257,1179,3806
0.066,6,4,160,2,0,27,0,80,2,0,0,0,80
1785.718,17,337,25612,337,48,5314,48,25612,0,0,0,0,0
502.674,17,8,2045,4,31,167556,37,239,4,423,167556,463,1806
0.09,6,10,1671,6,552,18,948,1348,4,159,30,159,323
0.817,17,12,6362,6,615,163,1350,3860,6,389,150,1350,2502
35.062,6,4223,4116594,2745,1421,12,1448,4035026,1478,776,23,1448,81568
484.657,17,12,4032,12,308,44059,308,4032,0,0,0,0,0
262.674,6,78,53204,48,1211,5588,1368,44909,30,840,2128,2519,8295
24.325,6,3,132,0,0,0,0,0,3,0,0,0,132
280.362,6,30,7432,13,158,23363,267,1317,17,543,17519,1400,6115
0.089,17,2,672,2,308,89,308,672,0,0,0,0,0
129.783,1,2,232,2,88,129783,88,232,0,0,0,0,0
1783.808,6,363,24814,212,94,8454,469,14427,151,69,11892,69,10387
1796.718,1,345,28980,345,56,5223,56,28980,0,0,0,0,0
1772.226,6,180,15480,120,69,14892,69,8940,60,69,30036,69,6540
1798.979,6,226,21318,117,76,15508,721,10524,109,173,16050,1440,10794
1785.857,6,363,23007,210,69,8544,69,12747,153,69,11749,69,10260
3.403,6,21,6352,9,262,420,517,1264,12,744,305,1418,5088
1796.971,1,345,28980,345,56,5223,56,28980,0,0,0,0,0
15.12,17,24,6084,10,260,1676,1350,2886,14,200,1160,1350,3198
1799.57,6,1920,2052655,529,127,3408,344,33279,1391,1472,1294,4206,2019376
658.887,17,130,9880,130,48,5107,48,9880,0,0,0,0,0
228.692,17,229,17453,121,40,1904,41,8305,108,56,2136,57,9148
252.058,17,4,352,2,60,252057,60,176,2,60,252057,60,176
161.093,17,4,558,2,36,161089,36,128,2,187,161086,187,430
0.045,17,4,336,2,34,0,34,124,2,78,38,84,212
28.148,17,26,9278,11,466,2811,1350,5444,15,227,2008,1350,3834
361.003,2,4,128,4,8,120334,8,128,0,0,0,0,0
0.286,17,8,2750,8,315,40,354,2750,0,0,0,0,0
0.425,6,24,7359,13,318,34,600,1958,11,964,40,1471,5401
2.274,17,4,360,2,30,1925,30,116,2,94,1942,94,244
1795.479,17,448,39896,403,35,4466,288,25676,45,288,40017,288,14220
0.255,6,22,5040,10,137,28,267,1092,12,577,22,1400,3948
284.372,1,4,326,4,53,94790,78,326,0,0,0,0,0
504.045,2,4,128,4,8,168015,8,128,0,0,0,0,0
1772.792,6,180,15480,120,69,14897,69,8940,60,69,30045,69,6540
871.063,1,8,652,8,53,124437,78,652,0,0,0,0,0
7.409,6,73,23731,38,567,200,1152,18563,35,470,210,1179,5168
69.992,6,706,327571,363,837,193,1152,308346,343,392,203,1152,19225
1.394,6,22,7381,14,280,107,600,2136,8,964,171,1471,5245
104.221,6,34,17081,18,1040,80,1360,9078,16,918,6933,1360,8003
0.005,17,2,480,1,59,0,59,87,1,365,0,365,393
1790.361,17,142,11360,71,48,25576,48,5396,71,56,25576,56,5964
249.972,6,34,6962,11,168,12208,516,1455,23,254,11358,1452,5507
283.946,6,60,39001,38,1165,7674,1408,31122,22,961,2924,3847,7879
1782.134,17,83,3480,82,14,22001,14,3444,1,8,0,8,36
0.216,6,46,20533,26,1032,8,1420,15512,20,467,10,1883,5021
1789.957,6,373,23614,214,69,8403,69,13114,159,69,11328,69,10500
0.085,17,2,193,1,46,0,46,74,1,91,0,91,119
34.813,17,20,1760,10,48,3867,48,760,10,72,3867,72,1000
0.999,17,2,677,1,300,0,300,328,1,321,0,321,349
5.894,6,42,8273,21,227,294,314,4022,21,486,280,1179,4251
1784.185,6,359,22709,209,69,8577,69,12569,150,69,11974,69,10140
0.173,17,2,465,2,204,173,360,465,0,0,0,0,0
0.11,17,2,152,1,48,0,48,76,1,48,0,48,76
1797.638,17,449,39928,404,35,4460,288,25708,45,288,40012,288,14220
212.197,17,9,2968,9,301,26524,308,2968,0,0,0,0,0
680.717,17,10,3344,10,306,75635,308,3344,0,0,0,0,0
0.001,6,2,100,1,0,0,0,40,1,0,0,0,60
0.02,17,2,290,1,40,0,40,68,1,194,0,194,222
87.611,6,28,12097,15,505,440,690,3666,13,877,7288,2568,8431
1771.377,6,105,9618,66,66,27251,66,5610,39,60,46613,60,4008
16.363,17,4,352,2,60,16362,60,176,2,60,16362,60,176
0.362,17,3,543,2,39,357,39,134,1,381,0,381,409
0.479,17,3,451,2,39,268,39,134,1,289,0,289,317
0.254,6,48,22536,27,1090,9,1420,17463,21,467,11,1883,5073
7.936,6,14,1247,7,222,1315,222,728,7,231,1316,231,519
1523.617,6,103,12522,65,85,23806,501,5160,38,176,41175,1420,7362
1794.807,1,339,28476,339,56,5310,56,28476,0,0,0,0,0
0.046,6,7,423,4,43,2,43,259,3,0,22,0,164
38.689,17,11,836,11,48,3868,48,836,0,0,0,0,0
1.387,6,36,8172,19,320,77,1162,2716,17,476,75,2615,5456
0.211,6,48,24116,29,1056,7,1420,19135,19,526,11,3303,4981
161.782,17,4,240,2,32,161781,32,120,2,32,161781,32,120
33.541,17,10,590,10,31,3726,31,590,0,0,0,0,0
1759.644,1,42,2352,42,28,42918,28,2352,0,0,0,0,0
1.704,6,280,225317,167,1344,10,1420,216506,113,427,15,1420,8811
2.653,6,12,1767,8,100,379,100,424,4,589,802,1152,1343
81.894,6,42,10921,16,450,930,1189,3804,26,357,3275,2920,7117
166.047,6,44,9257,13,139,12937,267,1918,31,264,5534,1452,7339
1.602,6,50,18975,29,865,57,1360,13314,21,437,69,2715,5661
0.004,17,2,290,1,40,0,40,68,1,194,0,194,222
240.325,6,46,9136,24,523,10448,1408,5969,22,223,11443,617,3167
240.202,6,54,17646,29,773,8578,1408,14657,25,210,10008,580,2989
0.942,6,31,12122,17,525,58,1360,3350,14,820,59,1379,8772
0.318,17,2,167,1,39,0,39,67,1,72,0,72,100
1786.106,6,39,6818,27,241,68696,241,5418,12,92,162351,92,1400
0.843,6,20,5952,11,282,84,548,1292,9,716,94,1420,4660
0.205,6,45,48466,25,186,8,255,1868,20,2530,10,7040,46598
1.145,6,24,8004,12,164,88,267,1288,12,1014,88,2816,6716
1796.447,6,355,22480,207,69,8720,69,12420,148,69,12220,69,10060
0.122,1,2,163,2,53,122,78,163,0,0,0,0,0
2.892,17,3,183,3,33,1446,33,183,0,0,0,0,0
0.402,6,13,1693,7,288,65,288,588,6,426,45,434,1105
1790.68,17,140,11200,70,48,25951,48,5320,70,56,25951,56,5880
1771.879,6,180,15480,120,69,14889,69,8940,60,69,30030,69,6540
280.405,6,27,7312,12,158,25491,267,1277,15,678,20026,2045,6035
8.806,6,16,1549,8,222,1250,222,990,8,231,1249,231,559
216.69,17,4,240,2,32,216689,32,120,2,32,216689,32,120
24.302,6,32,8778,16,340,1620,721,2685,16,681,1592,2840,6093
240.231,6,53,16147,28,693,8897,1402,13251,25,198,10009,580,2896
0.595,6,125,82669,69,1286,8,1432,76138,56,475,10,1871,6531
1799.295,17,142,11360,71,48,25704,48,5396,71,56,25704,56,5964
11.365,6,1760,1568641,1087,1391,10,1420,1537500,673,467,16,1883,31141
1786.523,6,102,8296,68,65,26664,65,4930,34,59,54134,59,3366
13.005,6,20,3871,11,211,1300,211,1225,9,545,1625,904,2646
0.252,6,9,1338,5,145,63,145,349,4,825,40,825,989
1747.879,1,57,4788,57,56,31212,56,4788,0,0,0,0,0
150.056,6,24,10054,12,532,73,1360,2642,12,1153,13627,2574,7412
0.137,17,2,193,1,43,0,43,71,1,94,0,94,122
2.385,6,14,2351,8,188,340,245,700,6,703,426,1152,1651
365.492,6,370,222630,193,1141,1903,1448,111747,177,875,868,1877,110883
280.23,6,25,7232,12,158,25475,267,1277,13,905,23346,4845,5955
1799.659,1,80,6720,80,56,22780,56,6720,0,0,0,0,0
1772.369,6,180,15480,120,69,14893,69,8940,60,69,30037,69,6540
1.98,17,2,672,2,308,1980,308,672,0,0,0,0,0
185.192,6,18,1367,9,332,23149,332,808,9,83,23091,83,559
1791.994,6,235,25940,115,81,15719,721,10794,120,240,15056,1440,15146
11.467,6,87,28181,44,577,266,1152,21979,43,407,266,1152,6202
1681.552,17,16,4225,8,30,240219,37,471,8,441,240219,463,3754
1795.814,1,342,28728,342,56,5266,56,28728,0,0,0,0,0
8.226,6,71,20678,38,554,222,1152,15931,33,427,249,1152,4747
300.708,6,39,8322,20,244,15826,630,1809,19,441,475,1460,6513
1785.619,6,104,8444,68,66,26651,66,4964,36,60,51015,60,3480
1744.377,6,95,7203,63,38,28135,205,4476,32,33,56258,98,2727
0.0,17,2,136,1,40,0,40,68,1,40,0,40,68
0.661,6,18,6625,7,186,107,267,661,11,689,64,1452,5964
21.857,6,14,820,6,0,4371,0,340,8,0,2143,0,480
33.442,6,206,155141,119,1376,281,1440,146606,87,358,386,1440,8535
0.016,17,2,189,1,30,0,30,58,1,103,0,103,131
600.241,1,7,605,7,58,100040,88,605,0,0,0,0,0
1774.864,6,180,15480,120,69,14914,69,8940,60,69,30078,69,6540
0.198,17,2,152,1,48,0,48,76,1,48,0,48,76
3.047,6,2,88,2,0,0,0,88,0,0,0,0,0
370.877,6,18,1242,14,180,28529,180,916,4,110,20064,110,326
0.788,17,22,12149,12,557,71,1350,7020,10,484,84,1350,5129
3.086,6,2,88,2,0,0,0,88,0,0,0,0,0
1.321,6,38,9848,21,440,66,1360,4392,17,476,71,2715,5456
90.171,6,45,10957,22,819,746,1360,5080,23,329,4089,4027,5877
0.024,17,8,1670,8,180,3,219,1670,0,0,0,0,0
2.885,17,4,296,4,46,961,46,296,0,0,0,0,0
1769.814,6,99,9306,66,66,27227,66,5610,33,60,55303,60,3696
76.73,6,63,45517,43,1183,1826,1408,37743,20,960,3243,3847,7774
131.435,6,27,8908,13,498,263,721,1532,14,756,10097,2840,7376
8.39,6,2011,1865097,1274,1385,6,1408,1822109,737,931,11,2816,42988
1.304,6,49,19875,27,936,50,1460,14219,22,433,53,1460,5656
1624.318,2,25,800,25,8,67679,8,800,0,0,0,0,0
0.503,6,25,6044,12,164,45,453,1442,13,781,38,2224,4602
1796.543,17,448,39896,403,35,4469,288,25676,45,288,40023,288,14220
82.495,6,12,492,5,0,4287,0,204,7,0,13748,0,288
10.764,6,20,4390,11,275,1076,275,998,9,755,755,1414,3392
1782.693,17,142,11360,71,48,25466,48,5396,71,56,25466,56,5964
107.154,6,131,100338,82,1274,1322,1408,89662,49,676,2227,1408,10676
0.066,1,2,163,2,53,66,78,163,0,0,0,0,0
316.593,6,8,564,5,106,79148,106,420,3,0,1524,0,144
44.344,17,4,352,2,60,44343,60,176,2,60,44343,60,176
1787.916,6,446,26381,233,69,7706,69,13529,213,35,8433,64,12852
0.019,17,2,304,1,28,0,28,56,1,220,0,220,248
0.176,6,12,2069,7,324,29,585,1009,5,396,35,580,1060
1118.59,6,92,10013,52,79,21933,721,4699,40,115,26531,1448,5314
241.507,6,54,13761,29,676,8623,1368,10993,25,162,10061,580,2768
0.867,17,4,360,2,30,808,30,116,2,94,820,94,244
0.483,6,2,80,1,0,0,0,40,1,0,0,0,40
1740.43,6,87,6322,58,31,30533,31,3915,29,31,62156,31,2407
317.056,6,70,18769,34,370,9607,1460,9535,36,338,9054,3089,9234
250.171,17,4,352,2,60,250170,60,176,2,60,250170,60,176
0.132,6,10,1569,5,627,32,627,895,5,406,32,406,674
1675.15,1,65,5460,0,0,0,0,0,65,56,26174,56,5460
840.585,17,8,2196,4,30,280193,30,232,4,463,280193,463,1964
74.423,6,20,9181,11,514,80,1236,2014,9,1359,9280,3639,7167
197.84,17,4,240,2,32,197839,32,120,2,32,197839,32,120
111.802,17,4,1344,4,308,37267,308,1344,0,0,0,0,0
1791.901,6,237,43498,135,313,13372,1303,25454,102,211,17740,1420,18044
0.131,17,2,396,1,39,0,39,67,1,301,0,301,329
170.376,17,4,240,2,32,170373,32,120,2,32,170375,32,120
1681.652,17,14,1036,7,30,280273,30,406,7,62,280272,62,630
0.712,17,4,566,2,31,702,31,118,2,196,701,196,448
35.982,6,15,3396,3,92,1479,92,256,12,358,3254,1408,3140
1781.165,17,142,11360,71,48,25445,48,5396,71,56,25445,56,5964
214.349,6,120,91498,77,1264,2820,1408,81137,43,811,1959,3847,10361
1775.899,6,181,15589,120,69,14923,69,8940,61,69,29594,69,6649
35.867,17,44,6468,22,48,1704,48,1672,22,190,1704,308,4796
1.537,6,41,8431,21,321,76,1164,2810,20,400,70,1360,5621
280.446,6,29,7392,13,158,23370,267,1317,16,678,18692,3456,6075
23.941,17,21,8243,11,520,2359,1350,6035,10,192,2629,1350,2208
628.552,17,12,912,12,48,57141,48,912,0,0,0,0,0
101.042,6,11,719,11,31,10104,31,719,0,0,0,0,0
1773.407,6,180,15480,120,69,14902,69,8940,60,69,30056,69,6540
4.375,6,23,4490,12,213,397,597,1701,11,441,418,1408,2789
286.978,17,4,352,2,60,286977,60,176,2,60,286977,60,176
250.744,6,53,21151,27,924,9643,1418,18085,26,155,10029,580,3066
1772.499,6,205,22439,131,75,13634,267,10097,74,133,24273,1420,12342
1737.499,1,56,4704,0,0,0,0,0,56,56,31590,56,4704
13.132,6,9,488,5,0,3283,0,280,4,0,2520,0,208
1.906,17,2,672,2,308,1906,308,672,0,0,0,0,0
1772.951,6,180,15480,120,69,14898,69,8940,60,69,30048,69,6540
0.234,6,34,7989,17,278,14,517,1815,17,498,13,1432,6174
1174.317,1,6,336,6,28,234863,28,336,0,0,0,0,0
19.067,6,14,2245,8,211,2723,211,846,6,545,3809,904,1399
1776.009,6,180,15480,120,69,14924,69,8940,60,69,30097,69,6540
0.005,6,2,1235,1,0,0,0,40,1,1155,0,1155,1195
1746.65,6,95,7203,63,38,28171,205,4476,32,33,56337,98,2727
0.016,6,10,1800,6,616,3,1076,1477,4,159,5,159,323
82.594,17,3,228,3,48,41297,48,228,0,0,0,0,0
4.379,6,39,7269,20,218,230,314,3423,19,440,228,1152,3846
33.729,6,31,5092,15,154,2409,722,1858,16,342,2233,1448,3234
1799.999,6,224,19154,83,75,21585,301,8502,141,69,12857,1062,10652
0.152,6,3,120,2,0,152,0,80,1,0,0,0,40
0.004,6,2,328,1,248,0,248,288,1,0,0,0,40
0.017,6,10,1798,6,615,3,1075,1475,4,159,5,159,323
61.519,6,45,25715,28,1038,2278,1448,18077,17,843,3830,2359,7638
123.923,6,25,10709,13,741,56,1360,3529,12,1114,11253,3068,7180
1781.76,6,465,26880,257,69,6959,69,14420,208,34,8607,64,12460
0.033,6,10,690,6,71,6,71,391,4,83,8,83,299
20.116,17,6,6388,6,1036,4023,1043,6388,0,0,0,0,0
2.149,17,3,174,3,30,1074,30,174,0,0,0,0,0
199.339,6,40,7578,18,153,11723,517,1875,22,504,9490,1418,5703
300.359,6,47,29682,25,190,12514,444,2117,22,1650,11526,7040,27565
159.385,6,221,167577,130,1329,1235,1448,153064,91,601,1506,1448,14513
2.91,17,4,304,2,48,2903,48,152,2,48,2903,48,152
0.913,6,10,1687,7,100,152,100,384,3,1179,328,1179,1303
0.965,17,4,352,2,60,964,60,176,2,60,964,60,176
242.888,6,39,6146,17,331,15176,1056,3213,22,220,11563,580,2933
280.184,6,29,7392,13,158,23348,267,1317,16,543,18678,1400,6075
150.616,6,24,9651,12,372,63,802,1630,12,1075,13680,1757,8021
1794.074,6,356,22520,208,69,8667,69,12460,148,69,12203,69,10060
1799.411,17,449,39928,404,35,4465,288,25708,45,288,40018,288,14220
0.468,6,22,5040,11,137,46,267,1132,11,692,44,1467,3908
22.272,6,10,436,4,0,7424,0,172,6,0,4276,0,264
0.401,6,3,151,1,0,0,0,40,2,31,0,31,111
4.012,17,8,848,4,46,1333,46,296,4,110,1285,110,552
61.709,6,61,40462,38,1175,1667,1448,32537,23,746,2794,1448,7925
44.844,6,27,7177,13,155,3737,267,1306,14,530,3448,2840,5871
1729.825,6,77,13804,49,111,36038,1448,5129,28,288,64060,1448,8675
3.184,17,3,228,2,48,3016,48,152,1,48,0,48,76
240.262,6,54,17622,28,775,8898,1418,14654,26,201,9610,580,2968
3.807,1,8,832,0,0,0,0,0,8,76,543,76,832
1786.976,6,252,46216,125,871,14411,1402,33570,127,60,14182,580,12646
0.026,6,12,3704,6,171,4,171,491,6,964,4,1448,3213
1795.606,17,447,39296,403,35,4466,288,25392,44,288,40950,288,13904
1144.805,6,17,1021,11,31,114480,31,595,6,31,228929,31,426
1.033,6,10,1687,7,100,172,100,384,3,1179,383,1179,1303
2.822,17,3,468,3,128,1411,128,468,0,0,0,0,0
1763.869,2,11,352,11,8,176386,8,352,0,0,0,0,0
0.014,17,2,358,1,32,0,32,60,1,270,0,270,298
233.493,17,2,130,2,37,233493,37,130,0,0,0,0,0
0.406,6,20,7151,12,318,35,600,1906,8,1205,55,1851,5245
280.265,6,28,7352,12,158,25478,267,1277,16,603,18682,1400,6075
0.013,17,3,634,2,32,10,32,120,1,486,0,486,514
1.347,6,47,18744,27,861,51,1360,13168,20,433,61,1360,5576
10.781,6,19,4362,11,275,1078,275,998,8,1010,856,2840,3364
1776.729,1,60,5040,60,56,30114,56,5040,0,0,0,0,0
891.138,6,118,17988,73,302,12376,302,13146,45,83,20252,83,4842
128.877,6,72,49880,46,1193,2863,1408,41793,26,961,2464,3847,8087
0.028,17,2,136,1,32,0,32,60,1,48,0,48,76
1772.207,6,180,15480,120,69,14892,69,8940,60,69,30034,69,6540
36.312,6,7937,7959858,3684,339,9,341,219860,4253,1775,8,5472,7739998
3.614,17,2,204,1,34,0,34,62,1,114,0,114,142
1744.666,2,29,928,29,8,62309,8,928,0,0,0,0,0
1764.708,2,14,448,14,8,135746,8,448,0,0,0,0,0
841.332,17,8,592,4,30,280439,30,232,4,62,280440,62,360
1796.151,17,286,55041,286,164,6302,353,55041,0,0,0,0,0
1787.431,6,102,8364,68,66,26678,66,4964,34,60,54161,60,3400
1.051,17,3,451,2,39,739,39,134,1,289,0,289,317
0.024,17,2,118,1,31,0,31,59,1,31,0,31,59
4.163,17,5,295,5,31,1040,31,295,0,0,0,0,0
186.24,17,6,360,3,32,93119,32,180,3,32,93119,32,180
1770.787,6,101,9344,66,65,27242,65,5577,35,59,52079,59,3767
0.679,17,2,237,1,72,0,72,100,1,109,0,109,137
46.501,6,6149,5929959,4121,1362,11,1408,5819839,2028,776,22,1408,110120
180.356,6,100,66441,57,1231,3220,1368,57181,43,747,1548,1368,9260
10.112,6,95,32771,49,611,210,1152,26433,46,449,219,1179,6338
0.287,6,10,1840,5,901,71,901,1169,5,403,71,403,671
202.583,6,32,7074,13,201,4576,477,1532,19,298,11250,1452,5542
20.163,6,21,5418,12,107,1833,159,1074,9,967,2518,1669,4344
1791.155,17,144,11520,72,48,25227,48,5472,72,56,25227,56,6048
2.531,6,10,1102,6,483,506,483,803,4,83,840,83,299
27.671,6,40,8474,21,175,1383,721,2253,19,778,1527,1420,6221
1776.616,6,180,15480,120,69,14929,69,8940,60,69,30109,69,6540
0.261,6,20,4960,10,137,29,267,1092,10,692,28,1467,3868
1785.518,6,354,22440,207,69,8667,69,12420,147,69,12229,69,10020
16.5,6,22,6733,7,140,2750,267,849,15,527,1177,1997,5884
1756.45,6,107,6344,60,26,29769,26,3510,47,26,38182,26,2834
378.044,2,4,128,4,8,126014,8,128,0,0,0,0,0
0.128,17,2,602,1,46,0,46,74,1,500,0,500,528
111.578,6,25,9849,12,531,61,1440,2637,13,954,9286,1440,7212
6.586,6,42,16046,21,665,329,1460,3618,21,826,249,1460,12428
1786.483,6,104,8444,68,66,26663,66,4964,36,60,51039,60,3480
1772.36,6,180,15480,120,69,14893,69,8940,60,69,30034,69,6540
0.27,6,24,4571,12,165,24,456,1446,12,415,23,888,3125
0.309,17,2,167,1,39,0,39,67,1,72,0,72,100
1.361,6,10,1687,7,100,226,100,384,3,1179,548,1179,1303
1791.482,17,144,11520,72,48,25231,48,5472,72,56,25231,56,6048
5.076,17,4,288,2,36,5044,36,128,2,52,5037,52,160
14.721,6,1916,1752368,1225,1375,12,1380,1716386,691,421,21,1923,35982
38.55,17,44,6468,22,48,1835,48,1672,22,190,1835,308,4796
37.08,17,4,352,2,60,37079,60,176,2,60,37079,60,176
1794.353,6,367,25650,214,99,8424,469,15045,153,69,11803,69,10605
300.701,6,37,8569,20,315,15826,882,2105,17,481,531,2720,6464
1785.751,6,333,26361,159,323,11297,515,10855,174,38,10320,63,15506
1779.591,17,138,11040,69,48,26170,48,5244,69,56,26170,56,5796
1772.248,6,180,15480,120,69,14892,69,8940,60,69,30033,69,6540
0.327,6,26,8868,13,227,27,547,1592,13,941,26,1438,7276
2.777,6,2,88,2,0,0,0,88,0,0,0,0,0
1789.917,1,58,4872,58,56,31402,56,4872,0,0,0,0,0
300.077,6,44,14201,24,845,13039,1440,8599,20,399,15784,1440,5602
1793.153,17,60,20160,60,308,30392,308,20160,0,0,0,0,0
1794.659,6,356,22520,208,69,8669,69,12460,148,69,12208,69,10060
1783.699,17,142,11360,71,48,25480,48,5396,71,56,25480,56,5964
0.477,6,4,220,2,0,477,0,100,2,0,305,0,120
0.322,17,2,154,1,33,0,33,61,1,65,0,65,93
1.392,6,45,18084,26,882,55,1360,12548,19,476,66,2715,5536
0.099,17,2,154,1,33,0,33,61,1,65,0,65,93
21.839,6,74,15325,38,360,590,734,3904,36,382,576,1460,11421
1792.51,6,356,22520,208,69,8659,69,12460,148,69,12193,69,10060
37.508,17,11,836,11,48,3750,48,836,0,0,0,0,0
1.316,6,46,18709,27,861,50,1360,13173,19,529,61,4075,5536
6.441,6,41,7349,21,218,322,314,3463,20,513,324,1179,3886
257.99,6,17,1275,6,66,21678,66,438,11,39,25789,60,837
1430.167,6,300,19624,158,69,9109,69,9632,142,62,10141,69,9992
1.433,1,2,112,2,28,1433,28,112,0,0,0,0,0
300.839,6,50,14737,26,859,12033,1460,8851,24,327,478,2567,5886
0.39,6,20,4960,10,137,43,267,1092,10,692,40,1467,3868
1799.366,1,282,29892,282,78,6403,78,29892,0,0,0,0,0
3.504,17,5,290,5,30,876,30,290,0,0,0,0,0
16.064,6,14,5709,5,98,4012,106,405,9,822,2006,1452,5304
0.696,6,23,7395,14,266,53,626,2067,9,1210,81,1946,5328
97.594,17,4,304,2,48,97466,48,152,2,48,97462,48,152
82.407,17,4,352,2,60,82406,60,176,2,60,82406,60,176
6.998,6,39,7269,20,218,368,314,3423,19,513,375,1179,3846
5.829,6,41,7349,23,218,264,314,3543,18,513,327,1179,3806
0.006,17,2,409,1,52,0,52,80,1,301,0,301,329
1770.132,6,223,18018,85,80,21071,337,9051,138,49,12920,143,8967
280.508,6,28,7352,13,158,23375,267,1317,15,775,20028,3465,6035
1794.165,17,80,3354,79,14,23002,14,3318,1,8,0,8,36
3.73,6,16,4681,9,49,466,92,587,7,745,83,1408,4094
1786.848,6,356,22520,208,69,8632,69,12460,148,69,12155,69,10060
136.655,17,4,352,2,60,136654,60,176,2,60,136654,60,176
0.614,6,10,924,5,283,104,283,551,5,105,101,105,373
1776.62,1,128,7168,128,28,13989,28,7168,0,0,0,0,0
10.873,6,89,26389,45,555,247,1152,20147,44,447,246,1179,6242
9.992,6,5,248,3,0,4996,0,144,2,0,607,0,104
0.485,6,23,7352,12,325,43,626,1932,11,968,47,1475,5420
8.375,6,11,3727,6,407,1569,722,1134,5,1164,1970,1448,2593
1788.132,1,8,448,8,28,255447,28,448,0,0,0,0,0
0.01,17,2,376,1,39,0,39,67,1,281,0,281,309
3.655,17,14,6765,6,482,730,1350,3060,8,435,516,1350,3705
1751.908,1,79,6636,79,56,22460,56,6636,0,0,0,0,0
10.924,6,20,4442,11,275,1092,275,998,9,768,773,1440,3444
1785.856,6,364,25392,212,100,8463,469,14896,152,69,11826,69,10496
61.388,6,37,16662,22,800,2923,1402,9159,15,746,4366,1402,7503
5.006,17,4,288,2,36,5005,36,128,2,52,4994,52,160
1.678,6,48,18201,26,882,67,1360,12545,22,476,69,2720,5656
0.023,6,13,4282,7,111,3,111,483,6,1159,4,1863,3799
11.771,6,1862,1625433,1135,1378,10,1420,1592132,727,467,16,1883,33301
14.996,6,924,836966,583,1357,25,1368,810630,341,776,43,1473,26336
1740.391,17,30,7050,30,207,60013,207,7050,0,0,0,0,0
1799.705,6,380,66555,174,298,10402,1360,44504,206,143,8778,1360,22051
0.151,6,3,120,2,0,151,0,80,1,0,0,0,40
0.48,6,27,9149,13,257,40,667,1715,14,837,35,2816,7434
1789.033,17,142,11360,71,48,25557,48,5396,71,56,25557,56,5964
870.689,17,48,16128,48,308,18525,308,16128,0,0,0,0,0
103.769,6,25,11302,12,421,78,956,1789,13,997,8635,1460,9513
280.588,6,29,7392,13,158,23382,267,1317,16,603,18700,2076,6075
10.235,6,82,24485,40,550,262,1152,18664,42,459,242,1179,5821
14.143,6,19,4303,10,243,1551,722,1501,9,772,1745,1408,2802
225.077,17,57,3144,27,25,8656,34,1445,30,28,7682,41,1699
1798.701,6,355,22549,206,69,8774,69,12380,149,69,12153,69,10169
280.471,6,27,7312,13,158,23372,267,1317,14,775,21569,3445,5995
1.076,17,4,360,2,30,1015,30,116,2,94,1031,94,244
374.548,6,19,1303,14,177,28811,177,925,5,110,15204,110,378
240.203,6,55,17794,30,731,8282,1408,14728,25,219,10008,580,3066
220.367,17,4,352,2,60,220366,60,176,2,60,220366,60,176
0.054,17,2,412,1,48,0,48,76,1,308,0,308,336
33.641,6,33,5206,16,154,2242,722,1911,17,300,2090,2026,3295
1744.6,2,28,896,28,8,64614,8,896,0,0,0,0,0
66.905,6,24,6724,7,154,11150,267,752,17,527,4179,1917,5972
0.029,17,2,461,1,34,0,34,62,1,371,0,371,399
1778.008,17,142,11360,71,48,25399,48,5396,71,56,25399,56,5964
12.729,6,85,26293,41,557,318,1152,20051,44,447,289,1179,6242
280.205,6,30,7432,14,158,21554,267,1357,16,603,18676,1400,6075
1746.851,6,95,7203,63,38,28175,205,4476,32,33,56338,98,2727
0.086,6,9,1340,5,145,21,145,349,4,827,23,827,991
193.69,6,34,7456,21,148,9684,267,1907,13,836,16139,3436,5549
313.224,6,35,7141,15,168,11718,516,1615,20,277,16481,1452,5526
280.318,6,28,7352,12,158,25483,267,1277,16,603,18686,1400,6075
3.181,17,4,644,2,33,1940,33,122,2,233,0,233,522
281.528,6,62,8894,29,158,10054,267,1957,33,467,8796,1400,6937
0.02,17,2,237,1,72,0,72,100,1,109,0,109,137
17.291,6,10,851,4,279,5763,279,495,6,0,3420,0,356
1681.323,1,15,840,15,28,120094,28,840,0,0,0,0,0
280.192,6,31,7472,14,158,21553,267,1357,17,543,17511,1400,6115
1783.81,6,415,24928,208,69,8617,69,12460,207,35,8659,69,12468
1.295,17,2,154,1,33,0,33,61,1,65,0,65,93
376.121,17,8,704,4,60,125373,60,352,4,60,125373,60,352
10.135,6,81,24765,42,560,247,1152,19048,39,461,259,1179,5717
1792.967,1,345,28980,345,56,5212,56,28980,0,0,0,0,0
150.618,6,22,10160,11,433,67,990,1771,11,1133,15046,2720,8389
2.236,6,13,2311,8,188,319,245,700,5,1407,499,1407,1611
292.687,6,36,7176,17,274,18290,517,1716,19,744,16257,1418,5460
0.697,6,23,5715,13,158,57,370,1315,10,999,76,1731,4400
336.896,17,53,10071,39,40,8865,41,2673,14,500,25837,505,7398
1.402,6,46,18818,26,936,56,1460,13242,20,476,63,2615,5576
428.495,6,21,1092,10,0,47610,0,520,11,0,42837,0,572
240.239,6,55,19310,31,819,8007,1408,16375,24,209,10445,580,2935
0.359,17,2,152,1,48,0,48,76,1,48,0,48,76
1750.633,17,12,498,11,14,175063,14,462,1,8,0,8,36
772.221,1,11,1661,11,123,77222,320,1661,0,0,0,0,0
1785.856,6,363,23145,209,69,8585,69,12569,154,69,11672,69,10576
0.456,6,52,21655,28,1020,16,1380,16453,24,421,18,1923,5202
0.552,6,28,9233,13,268,46,710,1770,15,832,35,1368,7463
1777.045,17,73,3060,72,14,25028,14,3024,1,8,0,8,36
0.139,6,9,1002,5,213,34,213,417,4,421,35,421,585
29.873,17,4,5464,4,1338,9957,1338,5464,0,0,0,0,0
0.876,17,2,586,1,46,0,46,74,1,484,0,484,512
1775.576,17,73,3060,72,14,25008,14,3024,1,8,0,8,36
1797.662,6,376,25748,216,92,8361,469,14932,160,69,11304,69,10816
0.098,6,9,527,5,43,24,43,311,4,0,31,0,216
49.823,6,49,8585,21,227,285,314,4022,28,491,1836,1179,4563
0.018,6,26,13381,15,125,1,125,985,11,1688,1,3012,12396
25.148,6,1202,1086515,715,1437,34,1448,1054995,487,776,51,1448,31520
51.314,17,12,1764,6,48,10261,48,456,6,190,10260,308,1308
1798.558,17,448,39896,403,35,4474,288,25676,45,288,40014,288,14220
0.195,17,2,2756,2,1350,195,1350,2756,0,0,0,0,0
1741.857,6,87,6322,58,31,30558,31,3915,29,31,62208,31,2407
280.208,6,28,7352,13,158,23350,267,1317,15,678,20010,4200,6035
4.322,6,3,226,1,0,0,0,40,2,53,3746,53,186
12.136,17,20,3900,10,32,1346,32,600,10,302,1346,308,3300
1798.355,17,448,39896,403,35,4473,288,25676,45,288,40021,288,14220
60.306,17,4,1344,4,308,20102,308,1344,0,0,0,0,0
3.321,17,16,2052,16,100,221,357,2052,0,0,0,0,0
35.326,6,5025,4734067,3273,1368,10,1408,4638299,1752,931,20,2816,95768
277.086,6,29,7392,13,158,23090,267,1317,16,603,18470,2036,6075
1795.916,6,355,22480,207,69,8718,69,12420,148,69,12217,69,10060
1742.677,1,16,896,16,28,116178,28,896,0,0,0,0,0
18.674,17,33,7239,14,198,1434,1350,3165,19,186,1035,1350,4074
1770.405,17,313,52709,313,140,5674,386,52709,0,0,0,0,0
122.619,6,18,5702,5,112,30654,112,320,13,537,10215,1452,5382
1795.147,6,355,22480,207,69,8714,69,12420,148,69,12211,69,10060
1798.305,17,142,11360,71,48,25690,48,5396,71,56,25690,56,5964
300.712,6,42,8910,17,308,18786,889,1971,25,311,12524,1360,6939
152.589,6,25,10769,12,380,72,832,1665,13,952,12704,1460,9104
0.414,6,10,968,5,256,101,256,460,5,304,100,304,508
1504.022,2,13,416,13,8,125335,8,416,0,0,0,0,0
1783.934,6,382,32034,205,92,8744,1189,14315,177,126,10135,1420,17719
0.63,17,4,1108,2,30,608,30,116,2,468,615,468,992
25.73,6,45,12894,22,199,1225,721,2478,23,730,1161,2840,10416
1740.517,17,27,6345,27,207,66942,207,6345,0,0,0,0,0
0.663,6,15,1785,8,288,73,288,640,7,426,79,434,1145
1780.752,6,354,22440,207,69,8644,69,12420,147,69,12196,69,10020
1790.741,17,87,3648,86,14,21067,14,3612,1,8,0,8,36
50.185,6,12,722,6,41,10008,46,405,6,38,10008,46,317
69.693,6,28,15440,17,1021,4355,1360,7860,11,1425,6952,3957,7580
300.895,6,37,8343,20,269,15836,730,1909,17,478,547,2128,6434
11.304,6,1772,1560589,1083,1388,10,1420,1528808,689,467,16,1883,31781
1786.639,6,104,8444,68,66,26666,66,4964,36,60,51044,60,3480
2.925,17,4,304,2,48,2904,48,152,2,48,2900,48,152
1605.898,1,8,448,8,28,229414,28,448,0,0,0,0,0
0.03,6,2,92,1,0,0,0,40,1,0,0,0,52
19.319,17,29,14319,16,694,1286,1350,11566,13,183,1607,1350,2753
9.609,6,1031,823785,551,1401,17,1448,789583,480,702,19,1448,34202
97.232,6,15,1132,4,226,127,226,442,11,110,9704,110,690
82.522,6,35,7842,13,155,6876,267,1306,22,332,3929,1420,6536
1787.046,6,102,8364,68,66,26672,66,4964,34,60,54149,60,3400
1.25,6,12,1462,6,145,250,145,389,6,825,246,825,1073
111.143,6,27,5029,15,201,7938,515,1610,12,419,10079,1452,3419
156.842,6,24,6248,9,272,103,516,1180,15,372,11195,1452,5068
19.318,6,1134,1034729,726,1346,26,1368,1004449,408,776,46,1473,30280
0.107,17,2,245,1,32,0,32,60,1,157,0,157,185
1781.531,6,354,22440,207,69,8648,69,12420,147,69,12201,69,10020
128.424,6,23,10229,11,433,60,990,1771,12,995,11663,1360,8458
0.857,17,4,624,2,64,856,64,184,2,192,739,192,440
4.983,17,4,288,2,36,4982,36,128,2,52,4971,52,160
1.414,6,50,19275,27,890,54,1360,13579,23,433,55,1360,5696
0.068,6,10,1495,5,507,16,507,727,5,556,16,556,768
1772.057,6,182,15698,120,69,14891,69,8940,62,69,29046,69,6758
618.025,6,110,22384,50,274,12612,1360,10577,60,218,10472,4649,11807
1786.114,17,142,11360,71,48,25515,48,5396,71,56,25515,56,5964
280.284,6,28,7352,13,158,23357,267,1317,15,678,20017,3436,6035
0.29,6,27,9120,13,266,24,705,1750,14,947,21,2804,7370
1.659,6,14,2351,8,188,237,245,700,6,703,282,1152,1651
1787.095,6,103,8326,68,64,26673,64,4896,35,58,52558,58,3430
1797.08,6,191,18610,126,99,14376,469,11525,65,69,28075,69,7085
1740.266,6,87,6322,58,31,30530,31,3915,29,31,62150,31,2407
1772.513,6,180,15480,120,69,14895,69,8940,60,69,30038,69,6540
0.42,6,12,1653,6,288,82,288,548,6,426,45,434,1105
1322.101,6,132,11352,88,69,15196,69,6556,44,69,30743,69,4796
5.687,6,41,7349,22,218,270,314,3503,19,513,301,1179,3846
58.779,6,35,14794,22,658,2799,833,4873,13,1043,4882,4460,9921
126.37,6,14,2351,6,188,158,245,620,8,1407,18018,1407,1731
308.058,2,5,160,5,8,77014,8,160,0,0,0,0,0
1799.333,6,356,22520,208,69,8692,69,12460,148,69,12237,69,10060
0.008,1,2,689,2,316,8,327,689,0,0,0,0,0
1772.232,6,180,15480,120,69,14892,69,8940,60,69,30036,69,6540
280.54,6,30,7432,13,158,23378,267,1317,17,543,17528,1400,6115
1744.666,2,25,800,25,8,72694,8,800,0,0,0,0,0
2.981,17,2,685,1,308,0,308,336,1,321,0,321,349
98.367,2,8,320,8,16,14052,16,320,0,0,0,0,0
0.468,6,4,1037,2,0,230,0,104,2,853,241,853,933
2.723,17,2,144,1,36,0,36,64,1,52,0,52,80
84.7,6,13,3819,7,407,14090,722,1186,6,1164,16908,1408,2633
1.71,6,62,16090,29,557,61,1429,5685,33,412,52,1460,10405
1740.488,17,29,19517,29,645,62160,645,19517,0,0,0,0,0
1762.007,6,110,6635,62,27,28883,27,3668,48,27,37488,27,2967
563.145,6,59,3799,33,47,17598,208,2449,26,31,22519,31,1350
5.635,6,44,8369,21,227,281,314,4022,23,489,242,1179,4347
1779.002,17,142,11464,71,49,25414,136,5484,71,56,25414,72,5980
135.616,1,6,336,6,28,27123,28,336,0,0,0,0,0
1744.651,2,25,800,25,8,72693,8,800,0,0,0,0,0
3.184,17,5,295,5,31,796,31,295,0,0,0,0,0
1776.887,6,274,33424,114,138,15723,1360,16235,160,131,11174,1942,17189
211.34,6,30,6844,11,220,5532,516,1325,19,297,11736,1452,5519
1798.038,1,282,15792,282,28,6398,28,15792,0,0,0,0,0
1787.961,6,356,22520,208,69,8637,69,12460,148,69,12162,69,10060
61.256,6,27,7177,13,155,5104,267,1306,14,530,4711,3417,5871
1772.07,6,180,15480,120,69,14891,69,8940,60,69,30034,69,6540
31.676,6,7,308,1,0,0,0,44,6,0,6290,0,264
7.83,6,2,80,1,0,0,0,40,1,0,0,0,40
1258.477,6,553,37989,278,31,4543,62,19216,275,32,4452,118,18773
1777.878,17,142,11360,71,48,25397,48,5396,71,56,25397,56,5964
1684.521,2,26,832,26,8,67380,8,832,0,0,0,0,0
0.015,17,3,993,3,303,7,332,993,0,0,0,0,0
0.497,6,14,5730,9,290,62,517,1057,5,1468,118,2423,4673
1784.151,6,102,8228,68,64,26629,64,4896,34,58,54062,58,3332
689.585,6,75,6450,48,71,14671,138,3645,27,69,26521,69,2805
1793.563,6,356,22520,208,69,8664,69,12460,148,69,12201,69,10060
14.147,6,56,15239,29,512,505,1152,11414,27,456,534,1152,3825
123.27,17,4,352,2,48,123260,48,152,2,72,123260,72,200
88.032,6,51,13276,27,889,376,1360,7421,24,348,3819,2667,5855
282.214,6,29,7392,13,158,23517,267,1317,16,603,18807,2760,6075
1795.542,6,240,35580,150,302,12050,302,25920,90,83,20174,83,9660
109.098,17,8,10972,8,1343,15585,1346,10972,0,0,0,0,0
1.669,6,14,2351,8,188,238,245,700,6,703,282,1152,1651
1741.007,6,87,6322,58,31,30543,31,3915,29,31,62178,31,2407
366.229,6,25,1651,17,177,22889,177,1117,8,110,9171,110,534
1783.157,17,274,52141,274,162,6531,356,52141,0,0,0,0,0
1770.168,6,99,9306,66,66,27233,66,5610,33,60,55314,60,3696
0.093,2,2,64,2,8,93,8,64,0,0,0,0,0
282.007,1,4,224,4,28,94002,28,224,0,0,0,0,0
240.192,6,55,18202,29,817,8577,1418,15417,26,158,9607,580,2785
0.933,6,10,1687,7,100,155,100,384,3,1179,331,1179,1303
1787.679,1,58,4872,0,0,0,0,0,58,56,31362,56,4872
0.006,17,4,288,2,33,0,33,122,2,55,0,61,166
1791.789,6,267,32543,106,135,17063,1360,15350,161,130,11197,1360,17193
0.944,6,10,1687,7,100,157,100,384,3,1179,338,1179,1303
15.731,6,52,35996,33,1226,491,1360,28340,19,983,864,3132,7656
0.364,6,10,1185,6,279,72,279,587,4,191,61,272,598
1744.503,6,98,7402,64,38,27690,205,4559,34,33,52856,98,2843
300.693,6,23,1932,12,226,27320,226,1144,11,110,30053,110,788
45.277,6,81,26505,40,966,288,1101,15159,41,276,1128,1460,11346
0.062,17,2,214,1,39,0,39,67,1,119,0,119,147
301.067,6,55,10882,28,433,11150,910,3402,27,304,590,1460,7480
1.302,17,2,237,1,72,0,72,100,1,109,0,109,137
402.846,6,23,1538,16,180,26856,180,1056,7,110,10442,110,482
1.904,17,2,784,2,364,1904,364,784,0,0,0,0,0
0.346,17,4,398,2,46,0,46,148,2,97,1,103,250
1770.796,6,99,9306,66,66,27243,66,5610,33,60,55334,60,3696
1796.131,17,144,11520,72,48,25297,48,5472,72,56,25297,56,6048
0.893,6,10,1687,7,100,148,100,384,3,1179,317,1179,1303
0.122,6,12,3462,6,75,24,75,395,6,1373,24,1448,3067
1799.714,17,448,39896,403,35,4476,288,25676,45,288,40019,288,14220
1774.24,1,59,4956,59,56,30590,56,4956,0,0,0,0,0
0.015,6,3,120,0,0,0,0,0,3,0,0,0,120
0.03,6,10,583,5,43,7,43,311,5,0,6,0,272
1794.277,17,83,3480,82,14,22151,14,3444,1,8,0,8,36
1703.742,1,15,840,15,28,121695,28,840,0,0,0,0,0
220.284,17,4,352,2,60,220283,60,176,2,60,220283,60,176
1230.097,6,586,40243,290,31,4256,31,19433,296,31,4169,62,20810
0.991,6,25,9854,14,350,76,1043,1994,11,1234,79,2570,7860
99.743,6,118,93285,77,1295,1312,1448,83039,41,675,2113,1448,10246
0.277,17,8,2758,8,316,39,355,2758,0,0,0,0,0
10.671,6,96,32203,50,596,217,1152,25881,46,447,231,1179,6322
7.414,17,428,357743,137,521,54,1350,75230,291,942,25,1350,282513
0.06,6,10,1609,5,106,15,106,374,5,967,15,967,1235
0.15,17,2,154,1,33,0,33,61,1,65,0,65,93
0.071,6,2,80,1,0,0,0,40,1,0,0,0,40
1.535,6,10,1687,7,100,255,100,384,3,1179,637,1179,1303
583.588,1,6,489,6,53,116717,78,489,0,0,0,0,0
14.503,6,34,7339,16,154,949,721,1959,18,444,841,1368,5380
134.918,17,4,352,2,60,134917,60,176,2,60,134917,60,176
279.928,6,30,7432,13,158,23327,267,1317,17,543,17492,1400,6115
1796.82,17,448,39612,404,35,4458,288,25708,44,288,40954,288,13904
66.674,6,68,50065,46,1197,1481,1408,40780,22,1016,2946,4224,9285
1789.823,6,356,22865,203,69,8860,69,12260,153,69,11775,69,10605
27.29,6,37,10468,19,830,492,1360,4946,18,435,1594,2667,5522
1787.201,6,102,8296,68,65,26674,65,4930,34,59,54153,59,3366
31.441,6,8,348,2,0,62,0,84,6,0,6286,0,264
349.616,17,11,1153,11,76,34961,355,1153,0,0,0,0,0
1787.004,6,102,8296,68,65,26671,65,4930,34,59,54147,59,3366
0.015,17,2,165,1,37,0,37,65,1,72,0,72,100
0.175,6,49,23002,28,1049,6,1420,17929,21,467,8,1883,5073
1680.446,1,15,870,15,30,120031,30,870,0,0,0,0,0
127.18,1,2,208,2,76,127180,76,208,0,0,0,0,0
0.654,6,24,7489,14,274,50,668,2109,10,968,68,1475,5380
0.428,6,7,670,4,180,142,180,396,3,110,122,110,274
0.46,6,53,23253,30,991,15,1380,18091,23,421,18,1923,5162
4.31,17,20,13328,9,419,538,1350,4028,11,817,219,1350,9300
0.884,6,10,1687,7,100,147,100,384,3,1179,315,1179,1303
3.332,6,27,6572,16,167,222,517,2010,11,663,324,1418,4562
1.272,6,49,20163,28,893,47,1360,14547,21,476,55,2720,5616
64.609,6,37,10104,15,328,173,1189,2581,22,473,3076,1420,7523
0.364,6,10,967,5,256,88,256,460,5,303,88,303,507
2.521,1,2,120,2,32,2521,32,120,0,0,0,0,0
0.011,6,3,327,2,103,1,138,287,1,0,0,0,40
0.028,17,2,223,1,36,0,36,64,1,131,0,131,159
1782.444,17,83,3480,82,14,22005,14,3444,1,8,0,8,36
3.621,6,28,7302,14,657,278,1418,5341,14,245,276,580,1961
294.922,17,4,240,2,32,294921,32,120,2,32,294920,32,120
75.288,6,13,540,6,0,2454,0,244,7,0,12546,0,296
0.004,6,2,80,1,0,0,0,40,1,0,0,0,40
1791.831,6,359,22778,210,69,8573,69,12678,149,69,12106,69,10100
0.098,6,9,1340,5,145,24,145,349,4,827,28,827,991
0.751,6,10,1687,7,100,125,100,384,3,1179,254,1179,1303
1323.55,2,11,352,11,8,132355,8,352,0,0,0,0,0
0.781,6,11,1727,7,100,130,100,384,4,589,175,1152,1343
0.523,17,2,476,1,39,0,39,67,1,381,0,381,409
61.749,6,57,35352,35,1147,1816,1448,28209,22,665,2929,1448,7143
0.894,6,25,11216,13,150,74,288,1436,12,1143,77,2055,9780
0.403,6,6,248,4,0,134,0,164,2,0,201,0,84
1777.199,1,56,4704,56,56,32312,56,4704,0,0,0,0,0
0.944,6,34,8135,19,247,52,643,1781,15,574,58,4848,6354
1770.994,6,120,14040,78,86,22999,481,7355,42,118,43191,1368,6685
280.525,6,31,7472,13,158,23377,267,1317,18,603,16494,2076,6155
1799.194,17,448,39896,403,35,4475,288,25676,45,288,40018,288,14220
11.629,6,1829,1599824,1107,1390,10,1420,1566723,722,467,16,1883,33101
11.801,6,1857,1629360,1129,1388,10,1420,1596019,728,467,16,1883,33341
1791.244,6,356,22520,208,69,8653,69,12460,148,69,12185,69,10060
230.067,6,23,4713,9,267,1043,501,1165,14,298,17690,1420,3548
1796.965,17,340,25840,340,48,5300,48,25840,0,0,0,0,0
1799.602,17,449,39928,404,35,4465,288,25708,45,288,40018,288,14220
15.528,17,21,14916,13,948,1288,1350,12698,8,249,2207,1350,2218
33.648,6,31,5095,15,180,2403,722,1859,16,300,2230,1408,3236
10.458,17,18,6956,8,501,1493,1350,4235,10,244,1158,1350,2721
0.455,6,91,58451,51,1262,9,1432,52560,40,427,11,1432,5891
1795.154,17,81,3390,79,14,23014,14,3318,2,8,23011,8,72
0.041,17,4,284,2,32,34,32,120,2,54,34,60,164
1.192,6,25,8068,12,164,92,267,1300,13,869,84,1408,6768
1796.273,17,142,11360,71,48,25660,48,5396,71,56,25660,56,5964
53.597,6,11,1583,11,127,5359,127,1583,0,0,0,0,0
1772.153,6,180,15480,120,69,14892,69,8940,60,69,30035,69,6540
240.172,6,53,19953,29,858,8577,1408,16967,24,247,10442,580,2986
1.13,17,2,322,1,33,0,33,61,1,233,0,233,261
0.022,6,10,1806,6,619,4,1079,1483,4,159,6,159,323
1.644,6,47,18632,27,853,63,1360,13056,20,529,74,4075,5576
1787.137,6,102,8228,68,64,26673,64,4896,34,58,54152,58,3332
1784.691,1,58,4872,58,56,31310,56,4872,0,0,0,0,0
23.56,6,3620,3364620,2215,1434,10,1448,3282672,1405,776,16,1448,81948
11.453,6,33,4134,23,211,520,211,1587,10,665,857,904,2547
1790.858,6,180,15480,120,69,15049,69,8940,60,69,30345,69,6540
9.903,17,4,824,2,33,9899,33,122,2,323,9898,323,702
83.685,6,45,13310,21,181,4184,267,2300,24,772,3638,2045,11010
0.045,17,4,284,2,32,1,32,120,2,54,38,60,164
0.296,6,2,80,1,0,0,0,40,1,0,0,0,40
1.29,6,41,8443,21,321,64,1164,2822,20,480,59,4075,5621
0.818,6,10,1687,7,100,136,100,384,3,1179,280,1179,1303
1796.312,6,356,22520,208,69,8677,69,12460,148,69,12219,69,10060
485.21,6,124,16271,60,188,8223,1189,6737,64,224,7701,1420,9534
31.44,17,8,1648,4,48,10473,48,304,4,308,10474,308,1344
135.488,17,2,388,2,166,135488,166,388,0,0,0,0,0
50.151,6,32,8952,14,158,3857,267,1357,18,624,2947,1400,7595
1772.297,6,180,15480,120,69,14893,69,8940,60,69,30032,69,6540
102.443,6,29,7392,13,158,8536,267,1317,16,603,6822,2036,6075
1776.146,17,73,3060,72,14,25016,14,3024,1,8,0,8,36
10.989,6,20,4442,11,275,1098,275,998,9,768,790,1440,3444
98.503,6,27,7177,12,155,31,267,1266,15,482,7035,1420,5911
1747.147,6,95,7203,63,38,28179,205,4476,32,33,56347,98,2727
235.248,17,4,352,2,60,235247,60,176,2,60,235247,60,176
2.013,1,2,56,2,0,0,0,56,0,0,0,0,0
172.301,17,5,1680,5,308,43075,308,1680,0,0,0,0,0
17.265,6,22,4547,11,211,1706,722,1636,11,778,1701,1448,2911
1793.999,6,397,70245,252,304,7147,304,52060,145,83,12458,83,18185
61.171,17,4,304,4,48,20390,48,304,0,0,0,0,0
2.06,6,19,3781,10,234,228,564,1452,9,463,230,1343,2329
23.448,6,35,8257,17,175,1465,721,2084,18,681,1367,2840,6173
130.835,6,59,11924,23,263,3529,1189,3033,36,275,3737,1420,8891
0.561,17,4,368,2,32,401,32,120,2,96,429,96,248
280.034,6,28,7352,13,158,23336,267,1317,15,678,19999,4200,6035
166.862,6,23,3712,7,92,147,92,464,16,185,11112,1408,3248
1797.543,17,138,11040,69,48,26434,48,5244,69,56,26434,56,5796
280.231,6,30,7432,13,158,23352,267,1317,17,543,17512,1400,6115
1744.676,2,29,928,29,8,62309,8,928,0,0,0,0,0
0.1,17,3,543,2,39,95,39,134,1,381,0,381,409
1.34,6,38,8254,19,321,74,1164,2718,19,433,64,1440,5536
4.036,17,4,304,4,48,1345,48,304,0,0,0,0,0
2.485,17,2,677,1,300,0,300,328,1,321,0,321,349
443.207,17,6,528,3,60,221602,60,264,3,60,221603,60,264
135.814,6,70,29963,36,462,844,1460,4894,34,947,4111,1460,25069
1780.542,17,142,11360,71,48,25436,48,5396,71,56,25436,56,5964
1786.352,6,382,26526,218,97,8232,469,15550,164,69,10958,69,10976
26.039,6,21,7690,10,424,2893,721,1678,11,928,2310,2535,6012
3.456,6,2,88,2,0,0,0,88,0,0,0,0,0
1796.944,6,132,8313,74,47,24615,208,5001,58,31,31517,31,3312
0.029,6,13,4256,7,85,4,85,457,6,1159,5,1863,3799
25.032,6,20,3130,12,183,2275,517,1561,8,381,3574,499,1569
1.773,17,4,644,2,33,1040,33,122,2,233,0,233,522
40.241,17,9,9622,9,1041,5030,1044,9622,0,0,0,0,0
359.996,2,4,128,4,8,119998,8,128,0,0,0,0,0
0.5,17,2,144,1,36,0,36,64,1,52,0,52,80
4.181,6,38,7229,19,218,232,314,3383,19,513,218,1179,3846
92.197,6,8,533,4,31,30732,31,239,4,31,30667,31,294
0.027,17,2,904,1,300,0,300,328,1,548,0,548,576
288.244,17,4,352,2,60,288242,60,176,2,60,288243,60,176
0.01,17,2,588,1,39,0,39,67,1,493,0,493,521
585.053,1,23,1932,23,56,26593,56,1932,0,0,0,0,0
0.023,6,3,120,2,0,23,0,80,1,0,0,0,40
0.072,6,10,1677,6,555,13,951,1354,4,159,7,159,323
65.525,6,47,12230,21,392,127,1189,5174,26,352,2620,1420,7056
1787.245,6,104,8444,68,66,26675,66,4964,36,60,51061,60,3480
12.023,17,20,4295,10,37,1334,37,650,10,336,1334,348,3645
0.026,17,2,160,1,48,0,48,76,1,56,0,56,84
49.506,6,28,7217,13,155,4125,267,1306,15,482,3535,1997,5911
1798.764,6,413,39465,234,151,7720,1189,20917,179,137,10105,3417,18548
0.868,6,51,13813,24,549,37,1429,4824,27,464,32,1986,8989
0.331,6,26,8991,13,247,27,624,1672,13,947,26,1438,7319
372.09,6,18,1242,14,180,28622,180,916,4,110,20064,110,326
286.332,17,4,240,2,32,286331,32,120,2,32,286330,32,120
32.295,6,9,527,5,43,8073,43,311,4,0,10763,0,216
204.102,17,3,231,3,49,102051,49,231,0,0,0,0,0
1787.146,6,104,8376,68,65,26673,65,4930,36,59,51057,59,3446
5.502,6,41,7349,22,218,262,314,3503,19,513,291,1179,3846
3.774,6,10,560,6,0,754,0,328,4,0,1230,0,232
280.201,6,29,7392,13,158,23350,267,1317,16,603,18679,1400,6075
1783.312,17,83,3480,82,14,22016,14,3444,1,8,0,8,36
0.508,6,15,1773,7,288,58,288,588,8,284,50,434,1185
0.084,17,2,164,1,46,0,46,74,1,62,0,62,90
1.184,17,20,6041,8,280,169,1350,2467,12,269,72,1350,3574
7.283,6,1862,1720115,1176,1384,6,1408,1679779,686,931,10,2816,40336
175.326,17,2,72,1,8,0,8,36,1,8,0,8,36
0.006,17,2,322,1,36,0,36,64,1,230,0,230,258
1745.718,6,97,7307,63,38,28156,205,4476,34,33,52891,98,2831
1794.663,6,356,22520,208,69,8669,69,12460,148,69,12208,69,10060
110.154,6,25,11667,13,712,95,1306,3401,12,1295,9997,3639,8266
1786.626,6,102,8364,68,66,26666,66,4964,34,60,54137,60,3400
1.815,6,49,17949,26,860,72,1440,12253,23,433,74,1440,5696
1796.516,6,356,22520,208,69,8678,69,12460,148,69,12221,69,10060
0.014,17,2,384,1,32,0,32,60,1,296,0,296,324
0.034,6,9,1880,5,910,8,910,1178,4,486,11,486,702
36.528,17,8,704,4,48,12173,48,304,4,72,12172,72,400
58.036,6,46,20109,25,1221,369,1460,14467,21,399,2892,1460,5642
34.136,17,5,380,5,48,8534,48,380,0,0,0,0,0
0.011,17,2,438,1,30,0,30,58,1,352,0,352,380
240.651,6,66,27932,33,995,7520,1418,24636,33,174,7520,580,3296
0.013,17,4,865,2,47,0,47,150,2,329,3,341,715
1.222,6,21,5188,12,142,111,174,910,9,782,129,1452,4278
58.942,6,10,951,6,332,11788,332,652,4,83,19630,83,299
300.771,6,38,9598,20,648,15830,1440,4076,18,399,506,1440,5522
1.745,6,13,2311,8,188,249,245,700,5,1407,371,1407,1611
3.328,17,10,2427,5,40,829,40,340,5,389,828,423,2087
10.98,6,18,5610,10,275,1220,275,958,8,1440,852,1440,4652
241.292,6,43,6345,20,248,12699,582,2824,23,231,10967,599,3521
210.518,6,25,6318,9,272,98,516,1180,16,345,14028,1452,5138
1681.156,17,14,3843,7,30,280191,30,406,7,463,280191,463,3437
1778.449,17,140,11200,70,48,25774,48,5320,70,56,25774,56,5880
0.517,17,2,167,1,39,0,39,67,1,72,0,72,100
7.592,6,43,7433,22,218,361,314,3503,21,513,364,1179,3930
0.001,6,2,357,2,277,1,277,357,0,0,0,0,0
120.542,6,9,2799,5,100,30135,100,304,4,1165,40090,1179,2495
1.402,6,54,21142,28,944,51,1440,15326,26,433,48,1440,5816
1763.589,6,27,4077,18,241,103740,241,2889,9,92,220426,92,1188
300.775,2,3,96,3,8,150387,8,96,0,0,0,0,0
0.164,6,46,21047,26,1069,6,1420,16026,20,467,8,1883,5021
281.25,6,29,7392,13,158,23437,267,1317,16,603,18747,2036,6075
1754.01,6,185,11345,93,47,19065,208,6735,92,31,19272,31,4610
361.026,2,3,96,3,8,180513,8,96,0,0,0,0,0
240.233,6,54,17809,29,793,8579,1408,15003,25,187,10009,580,2806
1787.438,6,102,8296,68,65,26678,65,4930,34,59,54160,59,3366
1764.411,2,14,448,14,8,135723,8,448,0,0,0,0,0
0.101,6,9,1339,5,145,25,145,349,4,826,21,826,990
670.262,6,39,2865,20,31,28526,31,1350,19,31,37227,31,1515
9.005,6,91,30121,48,610,191,1152,23919,43,407,208,1152,6202
0.29,17,2,134,2,39,290,39,134,0,0,0,0,0
9.537,17,4,824,2,48,9512,48,152,2,308,9517,308,672
1.141,17,2,572,1,39,0,39,67,1,477,0,477,505
103.042,6,12665,12093226,8161,1401,12,1448,11853934,4504,931,22,2761,239292
0.205,17,2,384,1,36,0,36,64,1,292,0,292,320
4.807,6,35,6213,18,206,282,314,2784,17,548,283,1179,3429
197.213,17,4,240,2,32,197211,32,120,2,32,197212,32,120
1.482,6,9,527,5,43,370,43,311,4,0,492,0,216
617.3,1,7,420,7,32,102883,32,420,0,0,0,0,0
37.199,6,2,708,2,302,37199,302,708,0,0,0,0,0
0.091,17,8,1670,8,180,13,219,1670,0,0,0,0,0
1798.107,17,450,39960,405,35,4450,288,25740,45,288,40020,288,14220
0.577,6,10,1671,6,552,115,948,1348,4,159,192,159,323
1783.349,6,104,8444,68,66,26617,66,4964,36,60,50950,60,3480
0.25,17,2,2754,2,1349,250,1349,2754,0,0,0,0,0
4.888,6,39,7269,19,218,271,314,3383,20,513,242,1179,3886
10.906,6,81,24445,41,550,272,1152,18704,40,459,272,1179,5741
0.039,6,17,3193,8,465,4,822,1821,9,224,4,694,1372
280.215,6,28,7352,12,158,25474,267,1277,16,603,18679,1400,6075
300.258,6,45,29621,26,190,12010,444,2181,19,2034,13540,13597,27440
0.243,17,2,362,1,46,0,46,74,1,260,0,260,288
1789.96,6,359,22847,208,69,8647,69,12460,151,69,11933,69,10387
7.031,6,2,1175,1,0,0,0,40,1,1095,0,1095,1135
0.012,17,2,603,1,48,0,48,76,1,499,0,499,527
16.148,17,25,14226,14,823,1239,1350,11926,11,181,1611,1350,2300
59.424,1,4,224,4,28,19808,28,224,0,0,0,0,0
903.967,6,94,8107,62,69,14819,69,4619,32,69,29142,69,3488
280.46,17,4,352,2,60,280459,60,176,2,60,280459,60,176
79.993,17,17,18460,17,1057,4999,1061,18460,0,0,0,0,0
1787.332,6,105,8348,68,64,26676,64,4896,37,58,49645,58,3452
37.961,17,22,1672,22,48,1807,48,1672,0,0,0,0,0
20.153,6,24,5859,13,107,1679,159,1138,11,690,2014,1402,4721
1779.149,17,82,3438,81,14,22239,14,3402,1,8,0,8,36
15.257,17,30,13625,15,650,1087,1350,10183,15,201,1087,1350,3442
0.937,2,3,96,3,8,468,8,96,0,0,0,0,0
1.158,6,28,10616,14,658,89,1360,3248,14,755,74,1725,7368
22.775,17,22,7509,11,399,2274,1350,4697,11,227,2274,1350,2812
0.184,17,2,136,1,32,0,32,60,1,48,0,48,76
1795.025,17,449,39928,404,35,4454,288,25708,45,288,40019,288,14220
1772.279,6,180,15480,120,69,14893,69,8940,60,69,30035,69,6540
79.888,6,21,6686,5,154,19972,267,672,16,487,5323,1933,6014
1.494,17,8,1582,4,32,494,32,240,4,307,482,319,1342
0.126,1,2,163,2,53,126,78,163,0,0,0,0,0
1788.283,6,365,23087,209,69,8597,69,12707,156,69,11534,69,10380
0.02,17,2,527,1,39,0,39,67,1,432,0,432,460
1.043,17,4,668,2,32,1038,32,120,2,246,52,246,548
8.67,6,23,6772,6,156,1734,267,718,17,447,524,1452,6054
1786.726,1,66,3696,66,28,27488,28,3696,0,0,0,0,0
288.794,1,6,336,6,28,57758,28,336,0,0,0,0,0
300.409,6,173,261257,93,162,3265,230,5666,80,3265,3802,11216,255591
0.461,6,52,22350,28,1064,17,1380,17136,24,421,18,1923,5214
156.097,6,32,8952,14,158,12007,267,1357,18,624,9169,1400,7595
0.014,17,4,648,3,60,0,60,264,1,356,0,356,384
1.882,6,115,86775,50,131,38,232,2529,65,1360,26,1430,84246
1784.703,17,142,11360,71,48,25495,48,5396,71,56,25494,56,5964
1.995,17,23,16370,10,734,221,1350,7620,13,645,163,1350,8750
0.028,17,4,284,2,32,20,32,120,2,54,19,60,164
1799.621,17,8320,399360,4160,20,432,20,199680,4160,20,432,20,199680
0.234,17,2,148,1,30,0,30,58,1,62,0,62,90
66.075,6,18,8559,8,498,320,721,1320,10,1708,7320,2840,7239
18.574,6,47,9920,27,241,714,314,5677,20,491,958,1179,4243
1749.489,6,100,7866,66,45,26915,205,4902,34,35,53009,98,2964
1583.446,6,103,8845,60,78,24728,293,4759,43,62,37699,247,4086
12.195,6,40,8781,18,412,717,889,2024,22,345,531,1360,6757
26.514,6,32,10622,18,268,1559,721,3138,14,988,2023,2840,7484
1750.571,17,12,498,11,14,175057,14,462,1,8,0,8,36
1796.502,6,123,12265,77,62,23638,722,6370,46,92,39918,2026,5895
1774.075,6,182,15629,121,69,14783,69,8980,61,69,29550,69,6649
280.455,6,30,7432,13,158,23371,267,1317,17,603,17526,2076,6115
0.016,17,2,322,1,36,0,36,64,1,230,0,230,258
372.486,6,25,1651,17,177,23280,177,1117,8,110,9241,110,534
1771.011,6,99,9240,66,65,27246,65,5577,33,59,55341,59,3663
166.235,17,4,352,2,60,166234,60,176,2,60,166234,60,176
0.126,6,2,912,1,832,0,832,872,1,0,0,0,40
1785.858,6,359,22778,208,69,8627,69,12529,151,69,11905,69,10249
145.702,17,4,352,2,60,145700,60,176,2,60,145701,60,176
1.645,6,49,18801,27,859,63,1360,13145,22,433,68,1360,5656
1786.418,6,104,8376,68,65,26662,65,4930,36,59,51037,59,3446
61.474,6,27,7177,13,155,5122,267,1306,14,530,4728,3417,5871
11.016,6,20,4390,11,275,1101,275,998,9,755,787,1414,3392
158.222,17,4,352,2,60,158220,60,176,2,60,158221,60,176
1.079,17,4,352,2,60,1078,60,176,2,60,1078,60,176
1781.756,6,382,26526,218,97,8210,469,15550,164,69,10931,69,10976
1744.642,2,22,704,22,8,83078,8,704,0,0,0,0,0
0.108,6,15,3958,10,75,12,75,603,5,1029,27,2500,3355
1.442,6,58,18034,28,707,53,1360,8925,30,438,49,1360,9109
13.029,17,4,824,2,48,13007,48,152,2,308,13007,308,672
3.677,17,32,17828,19,769,202,1350,15147,13,178,303,1350,2681
280.179,6,27,7312,12,158,25470,267,1277,15,678,20010,2045,6035
0.675,17,2,167,1,39,0,39,67,1,72,0,72,100
5.042,17,4,744,2,39,5026,39,134,2,277,5028,277,610
0.064,6,13,5845,6,186,11,267,621,7,1234,9,2006,5224
0.067,6,3,2880,2,1368,0,1368,2840,1,0,0,0,40
5.004,17,3,208,2,36,4989,36,128,1,52,0,52,80
1054.202,1,14,784,14,28,81092,28,784,0,0,0,0,0
3.023,17,3,228,2,48,2904,48,152,1,48,0,48,76
15.291,6,1366,1202381,790,1435,19,1448,1165385,576,776,25,1448,36996
1786.373,6,104,8444,68,66,26662,66,4964,36,60,51036,60,3480
50.501,6,19,6428,4,112,16833,112,280,15,426,3605,1420,6148
1.531,6,50,18962,27,867,58,1360,13266,23,433,59,1360,5696
1782.306,17,84,3516,82,14,22001,14,3444,2,8,1782123,8,72
1772.763,6,180,15480,120,69,14897,69,8940,60,69,30039,69,6540
408.248,17,14,1384,14,70,31403,355,1384,0,0,0,0,0
41.085,17,22,1672,22,48,1956,48,1672,0,0,0,0,0
1777.052,6,104,8376,68,65,26523,65,4930,36,59,50770,59,3446
11.613,6,1841,1595719,1114,1377,10,1420,1562418,727,467,15,1883,33301
1793.151,6,365,36386,174,421,10365,841,14504,191,67,9433,1418,21882
1443.862,2,15,480,15,8,103133,8,480,0,0,0,0,0
81.068,6,14,580,6,0,2407,0,244,8,0,11578,0,336
107.164,17,4,352,2,60,107163,60,176,2,60,107163,60,176
1795.718,17,448,39612,404,35,4455,288,25708,44,288,40947,288,13904
10.039,6,3,312,1,0,0,0,40,2,96,9984,96,272
1789.519,17,142,11360,71,48,25564,48,5396,71,56,25564,56,5964
0.322,6,20,7229,12,334,28,663,1969,8,1209,44,1906,5260
0.135,6,2,80,1,0,0,0,40,1,0,0,0,40
0.12,1,2,112,2,28,120,28,112,0,0,0,0,0
5.154,6,14,2520,8,178,736,193,780,6,473,1021,891,1740
1.145,6,25,8068,12,164,88,267,1300,13,869,81,1408,6768
0.382,17,8,2750,8,315,54,354,2750,0,0,0,0,0
0.06,17,4,368,2,32,17,32,120,2,96,0,96,248
1797.673,17,448,39896,403,35,4471,288,25676,45,288,40020,288,14220
0.558,6,22,7345,13,334,46,663,2021,9,1209,61,1946,5324
184.28,2,2,64,2,8,184280,8,64,0,0,0,0,0
20.145,6,24,7054,11,181,2014,267,1168,13,670,1672,2036,5886
10.752,6,3,1560,1,0,0,0,40,2,1440,1210,1440,1520
4.987,17,4,288,2,36,4986,36,128,2,52,4986,52,160
0.002,17,4,240,2,32,0,32,120,2,32,1,32,120
34.18,17,20,1760,10,48,3796,48,760,10,72,3796,72,1000
0.991,6,31,8912,14,158,76,267,1357,17,687,57,2036,7555
1788.331,17,87,3648,86,14,21039,14,3612,1,8,0,8,36
0.282,6,26,8990,13,247,23,624,1672,13,1105,22,2816,7318
6.201,6,44,8369,21,227,310,314,4022,23,489,268,1179,4347
366.997,6,18,1242,14,180,28230,180,916,4,110,20062,110,326
2.214,6,14,2351,8,188,316,245,700,6,703,387,1152,1651
1789.38,17,44,14784,44,308,41613,308,14784,0,0,0,0,0
32.876,6,34,6331,18,199,1933,517,2350,16,448,2189,499,3981
1730.073,17,176,41640,176,208,9886,422,41640,0,0,0,0,0
4.73,6,30,8941,14,158,363,267,1357,16,771,308,2800,7584
1.872,17,5,927,3,39,670,39,201,2,335,1359,381,726
13.4,6,20,6579,6,154,2680,267,712,14,529,1018,1420,5867
157.492,6,53,14446,23,168,7158,267,2445,30,599,5429,1400,12001
369.593,6,31,2679,20,141,19452,141,1033,11,398,2714,419,1646
69.087,6,25,7097,12,155,6280,267,1266,13,589,5756,3426,5831
5.052,17,4,288,2,36,5004,36,128,2,52,5001,52,160
0.828,6,51,13829,24,551,36,1429,4840,27,438,31,1460,8989
251.617,2,2,64,2,8,251617,8,64,0,0,0,0,0
17.89,1,14,5035,14,331,1376,533,5035,0,0,0,0,0
12.463,6,25,4690,13,205,1023,722,1745,12,579,1117,2026,2945
0.244,17,2,412,1,48,0,48,76,1,308,0,308,336
37.52,17,44,6468,22,48,1786,48,1672,22,190,1786,308,4796
1143.107,2,15,480,15,8,81650,8,480,0,0,0,0,0
1402.355,17,14,3664,7,31,233724,37,413,7,436,233724,463,3251
1772.351,6,182,15629,121,69,14769,69,8980,61,69,29531,69,6649
240.439,6,47,9160,24,521,10451,1418,5947,23,223,10927,618,3213
114.944,6,70,48663,45,1196,2612,1408,40630,25,960,2567,3847,8033
1744.634,6,95,7203,63,38,28139,205,4476,32,33,56267,98,2727
141.742,6,33,18709,18,702,54,1360,4967,15,1313,10113,2720,13742
7.729,6,53,18559,28,525,286,1440,5448,25,636,286,1440,13111
240.232,6,54,18078,28,807,8897,1418,15198,26,190,9608,580,2880
1796.864,17,136,10880,68,48,26818,48,5168,68,56,26818,56,5712
1739.213,6,87,6322,58,31,30512,31,3915,29,31,62114,31,2407
1782.248,17,140,11200,70,48,25829,48,5320,70,56,25829,56,5880
1681.534,17,14,1036,7,30,280250,30,406,7,62,280249,62,630
5.899,6,507,442136,321,1313,17,1368,427800,186,776,30,1473,14336
1746.106,6,97,7307,63,38,28163,205,4476,34,33,52902,98,2831
10.606,6,82,24485,42,550,258,1152,18744,40,459,264,1179,5741
14.091,6,2,88,1,0,0,0,40,1,0,0,0,48
11.876,6,25,8453,13,275,989,275,1078,12,983,866,1420,7375
280.508,6,30,7432,13,158,23375,267,1317,17,678,17528,2760,6115
61.388,6,36,16027,22,814,2923,1402,9301,14,748,4702,2804,6726
0.027,17,2,531,1,65,0,65,93,1,410,0,410,438
0.401,6,52,20957,28,973,14,1380,15755,24,383,16,1380,5202
0.973,6,12,949,6,222,191,222,470,6,231,188,231,479
1.034,17,23,14792,10,526,114,1350,5544,13,683,54,1350,9248
17.373,6,14,2185,8,324,2481,585,1073,6,396,3469,580,1112
1793.33,17,381,51318,177,191,10187,1350,38930,204,32,8833,60,12388
34.653,17,44,6468,22,48,1647,48,1672,22,190,1649,308,4796
21.051,6,92,23063,44,417,489,1152,15542,48,430,442,1179,7521
252.057,6,173,165873,63,270,4065,883,4916,110,1600,2312,4206,160957
0.908,6,17,5164,9,150,113,174,664,8,835,110,1452,4500
8.894,6,39,7273,20,218,468,314,3423,19,513,479,1179,3850
1699.209,6,30,4611,19,241,94400,241,3411,11,92,169902,92,1200
150.733,6,33,23801,19,840,46,1360,5835,14,2484,11584,8160,17966
1771.468,6,99,9240,66,65,27253,65,5577,33,59,55355,59,3663
368.687,6,27,1767,18,177,21687,177,1181,9,110,8945,110,586
0.863,6,11,1727,7,100,143,100,384,4,589,204,1152,1343
223.607,17,4,352,2,60,223606,60,176,2,60,223606,60,176
110.32,6,27,3004,15,304,7880,304,2008,12,83,10028,83,996
28.881,6,1416,1304913,908,1359,31,1368,1270581,508,931,56,2736,34332
240.919,6,51,15014,25,206,10033,582,2546,26,793,9627,1418,12468
8.04,6,80,24485,41,552,201,1152,18784,39,413,205,1152,5701
286.616,1,4,326,4,53,95538,78,326,0,0,0,0,0
0.235,6,22,5040,11,137,23,267,1132,11,577,22,1400,3908
39.096,2,4,128,4,8,13032,8,128,0,0,0,0,0
0.168,6,2,116,1,0,0,0,64,1,0,0,0,52
70.46,6,16,652,7,0,7927,0,284,9,0,8806,0,368
188.295,17,8,2688,8,308,26899,308,2688,0,0,0,0,0
104.446,6,45,14752,24,902,4533,1440,9110,21,399,5213,1440,5642
184.53,6,9,522,2,106,184520,106,194,7,0,30753,0,328
1786.668,6,104,8435,69,65,26274,65,4970,35,59,52546,59,3465
80.582,6,44,11476,18,290,1900,1189,2764,26,425,3222,1420,8712
15.128,17,6,528,3,48,7559,48,228,3,72,7558,72,300
10.758,6,20,4390,11,275,1075,275,998,9,755,751,1414,3392
0.006,17,2,152,1,48,0,48,76,1,48,0,48,76
0.988,17,2,312,2,128,988,128,312,0,0,0,0,0
15.432,17,12,5146,6,490,3072,1350,3109,6,311,3070,1350,2037
1798.108,6,358,22738,208,69,8686,69,12460,150,69,12067,69,10278
1799.887,6,240,19784,94,70,19032,301,8859,146,68,12412,1062,10925
1.011,17,4,502,2,31,1002,31,118,2,164,999,164,384
74.992,6,4,185,2,0,44992,0,104,2,1,30003,1,81
208.934,1,10,560,10,28,23214,28,560,0,0,0,0,0
0.116,17,2,184,1,32,0,32,60,1,96,0,96,124
0.136,17,2,180,1,30,0,30,58,1,94,0,94,122
41.804,6,13,919,5,275,10451,275,479,8,96,5941,96,440
0.47,6,28,7047,17,244,29,655,2393,11,701,46,1728,4654
1796.042,17,443,39168,399,35,4512,288,25264,44,288,40949,288,13904
5.622,6,25,8785,15,288,401,598,1470,10,987,516,1452,7315
1.041,6,23,7952,12,164,80,267,1288,11,1216,88,3819,6664
9.842,6,71,20742,36,556,281,1152,15915,35,489,281,1179,4827
232.895,1,10,280,10,0,0,0,280,0,0,0,0,0
0.306,6,27,9043,13,247,25,624,1672,14,947,23,1408,7371
62.917,6,22,9273,11,514,88,1236,2026,11,970,6273,1360,7247
1792.444,1,58,4872,0,0,0,0,0,58,56,31446,56,4872
4.696,6,12,1771,7,100,782,100,384,5,1179,1108,1179,1387
1741.23,6,87,6322,58,31,30547,31,3915,29,31,62184,31,2407
1771.981,6,103,9514,66,66,27261,66,5610,37,60,49219,60,3904
1681.216,1,15,840,15,28,120086,28,840,0,0,0,0,0
43.026,17,4,352,2,60,43025,60,176,2,60,43025,60,176
0.335,6,25,8965,13,261,27,683,1728,12,1100,29,2816,7237
1779.444,17,140,11200,70,48,25788,48,5320,70,56,25788,56,5880
0.421,6,6,324,4,0,140,0,216,2,0,234,0,108
62.384,6,27,7177,13,155,5198,267,1306,14,530,4797,3417,5871
8.134,6,27,3705,14,125,625,293,1570,13,402,655,1152,2135
1670.773,1,7,392,7,28,278462,28,392,0,0,0,0,0
0.258,17,4,768,2,39,253,39,134,2,289,6,289,634
1787.147,17,87,3648,86,14,21025,14,3612,1,8,0,8,36
1749.839,6,159,10026,84,50,21082,208,6127,75,31,23643,31,3899
0.93,17,4,668,2,32,925,32,120,2,246,0,246,548
1744.658,2,18,576,18,8,102626,8,576,0,0,0,0,0
0.067,6,4,160,2,0,67,0,80,2,0,0,0,80
248.021,17,4,240,2,32,248020,32,120,2,32,248019,32,120
0.289,6,25,9008,13,271,24,726,1771,12,1100,25,2816,7237
0.846,6,3,151,1,0,0,0,40,2,31,0,31,111
0.389,6,14,1733,7,288,61,288,588,7,284,37,434,1145
0.134,17,2,152,2,48,134,48,152,0,0,0,0,0
0.117,1,2,112,2,28,117,28,112,0,0,0,0,0
1775.002,6,215,24458,134,86,13345,469,11176,81,133,22181,1460,13282
1783.812,6,368,25152,213,93,8414,469,14605,155,69,11583,69,10547
0.36,6,10,860,6,181,72,181,489,4,77,80,134,371
10.24,6,18,1482,10,275,1137,275,958,8,96,1116,96,524
131.706,6,25,10176,12,541,63,1360,2677,13,995,10964,1360,7499
1.326,6,51,20953,28,940,49,1440,15257,23,433,51,1440,5696
5.038,17,4,288,2,36,5016,36,128,2,52,5016,52,160
1788.153,6,104,8366,68,63,26688,64,4868,36,57,51087,58,3498
0.012,6,3,120,0,0,0,0,0,3,0,0,0,120
12.245,17,10,850,5,37,3060,37,325,5,77,3059,77,525
0.265,1,2,112,2,28,265,28,112,0,0,0,0,0
0.882,6,7,380,4,0,294,0,216,3,0,436,0,164
1759.575,1,8,448,8,28,251367,28,448,0,0,0,0,0
0.124,1,2,112,2,28,124,28,112,0,0,0,0,0
0.487,6,6,718,3,304,239,304,460,3,102,237,102,258
29.403,17,19,10689,10,663,3267,1350,6913,9,391,44,1350,3776
3.623,17,4,1556,4,361,1207,361,1556,0,0,0,0,0
280.413,6,30,7432,13,158,23367,267,1317,17,678,17523,2760,6115
20.488,6,15,6136,4,222,5056,222,402,11,880,2033,1440,5734
1738.534,6,87,6322,58,31,30500,31,3915,29,31,62090,31,2407
0.136,17,2,602,1,46,0,46,74,1,500,0,500,528
1.403,6,26,6121,13,108,116,147,959,13,662,116,1420,5162
61.111,6,11,2993,5,92,15277,92,348,6,1164,12185,1408,2645
1.902,17,5,625,3,31,949,31,177,2,196,19,196,448
0.138,6,3,740,2,608,61,608,700,1,0,0,0,40
1.44,6,47,18160,25,882,60,1460,12504,22,433,59,1460,5656
198.463,17,4,240,2,32,198462,32,120,2,32,198462,32,120
15.728,17,16,5530,8,373,2241,1350,3211,8,261,2235,1350,2319
254.792,6,9,635,2,63,90,63,143,7,35,42450,57,492
1796.716,1,345,28980,345,56,5223,56,28980,0,0,0,0,0
87.943,17,4,240,2,32,87942,32,120,2,32,87942,32,120
1788.476,6,360,22818,210,69,8557,69,12678,150,69,12000,69,10140
228.426,17,18,2528,9,48,28551,48,684,9,176,28551,308,1844
0.705,6,11,3652,6,171,140,171,491,5,1446,157,2675,3161
1.337,17,16,5284,7,409,215,1350,3064,9,218,157,1350,2220
0.104,6,9,1340,5,145,26,145,349,4,827,28,827,991
0.608,6,2,100,1,0,0,0,60,1,0,0,0,40
1776.579,17,140,11200,70,48,25747,48,5320,70,56,25747,56,5880
1716.277,1,8,448,8,28,245182,28,448,0,0,0,0,0
312.46,6,10,668,4,106,104153,106,380,6,0,6309,0,288
5.006,17,3,343,2,36,5000,36,128,1,187,0,187,215
1770.524,17,314,63111,314,172,5656,422,63111,0,0,0,0,0
11.863,17,4,304,4,48,3954,48,304,0,0,0,0,0
0.578,6,15,1785,8,288,75,288,640,7,426,66,434,1145
1794.667,17,453,50986,219,142,8216,1350,37351,234,30,7702,60,13635
0.809,6,24,6208,13,264,66,662,1848,11,783,80,1420,4360
1768.206,1,125,7000,125,28,14259,28,7000,0,0,0,0,0
1791.241,1,58,4872,0,0,0,0,0,58,56,31425,56,4872
318.087,17,10,3205,10,292,35343,301,3205,0,0,0,0,0
18.528,17,4,352,2,60,18527,60,176,2,60,18527,60,176
17.807,17,35,9578,14,297,1367,1350,4561,21,210,888,1350,5017
1790.977,6,383,24290,218,69,8253,69,13550,165,69,10919,69,10740
76.414,6,7,404,4,31,25471,31,222,3,31,38202,31,182
1.019,17,6,936,3,64,502,64,276,3,192,469,192,660
146.268,6,6920,6016954,4436,1276,32,1368,5883122,2484,776,58,1473,133832
453.253,6,273,45062,156,304,2924,304,32280,117,83,3905,83,12782
0.089,6,10,766,5,185,20,185,453,5,45,13,45,313
0.138,17,2,685,1,308,0,308,336,1,321,0,321,349
20.973,17,22,8599,10,538,2327,1350,5662,12,216,1904,1350,2937
1799.96,17,179,26671,179,121,10112,121,26671,0,0,0,0,0
10.642,6,20,5441,11,215,1064,517,1237,9,929,1317,1448,4204
382.383,6,18,1242,14,180,29414,180,916,4,110,20058,110,326
128.519,6,23,10250,12,579,62,1360,2831,11,1393,12838,3934,7419
1659.77,1,7,392,7,28,276628,28,392,0,0,0,0,0
17.819,17,44,22685,23,781,808,1350,18617,21,165,889,1350,4068
0.041,17,2,198,1,37,0,37,65,1,105,0,105,133
60.112,2,2,64,2,8,60112,8,64,0,0,0,0,0
0.092,6,10,1671,6,552,18,948,1348,4,159,29,159,323
26.109,6,36,9280,17,291,1631,721,3016,19,611,1393,1440,6264
300.343,6,39,21606,25,1042,12514,1408,15902,14,828,2012,1491,5704
0.018,6,18,6108,10,88,2,88,556,8,1305,2,1880,5552
16.53,6,23,6944,7,165,2755,267,949,16,445,1087,1452,5995
1795.018,17,142,11360,71,48,25643,48,5396,71,56,25643,56,5964
268.835,17,4,240,2,32,268834,32,120,2,32,268834,32,120
3.092,17,8,1360,4,33,1001,33,244,4,251,1028,323,1116
1780.054,1,332,27888,332,56,5377,56,27888,0,0,0,0,0
1772.886,6,180,15480,120,69,14898,69,8940,60,69,30046,69,6540
37.93,6,44,8686,21,333,502,685,1920,23,388,1716,2128,6766
1542.982,17,126,10080,63,48,24886,48,4788,63,56,24886,56,5292
33.095,1,39,4056,0,0,0,0,0,39,76,870,76,4056
230.055,6,139,105891,89,1273,2614,1408,93756,50,680,2982,2439,12135
24.621,6,32,8807,14,339,1893,721,2603,18,548,1423,1440,6204
15.182,17,8,6796,8,821,2168,1451,6796,0,0,0,0,0
0.175,6,3,199,1,31,0,31,83,2,0,175,0,116
1.499,6,50,19257,27,889,57,1460,13561,23,476,59,2615,5696
300.323,6,56,37360,30,349,10355,349,1917,26,1481,12012,4224,35443
1797.014,6,135,15098,84,85,21650,475,7752,51,113,35938,1408,7346
281.599,17,4,352,2,60,281598,60,176,2,60,281598,60,176
1773.538,6,180,15480,120,69,14903,69,8940,60,69,30052,69,6540
1796.978,6,356,22589,207,69,8723,69,12420,149,69,12141,69,10169
23.202,1,3,279,3,65,11601,88,279,0,0,0,0,0
5.017,17,4,288,2,36,5009,36,128,2,52,5007,52,160
1.388,6,6,252,4,0,462,0,164,2,0,1087,0,88
240.237,6,55,18536,30,781,8283,1402,15630,25,199,10009,580,2906
1745.551,6,95,7203,63,38,28154,205,4476,32,33,56301,98,2727
0.003,6,2,80,1,0,0,0,40,1,0,0,0,40
236.948,1,16,1664,0,0,0,0,0,16,76,15796,76,1664
0.162,6,24,7176,12,155,14,267,1261,12,775,14,2800,5915
4.48,17,3,2906,3,940,2240,1451,2906,0,0,0,0,0
94.563,6,40,11112,16,373,6303,1189,4011,24,340,4110,1917,7101
1776.676,17,136,10880,68,48,26517,48,5168,68,56,26517,56,5712
2.01,6,27,8851,16,286,134,591,1503,11,863,182,1380,7348
300.992,6,38,8418,19,278,16721,734,1905,19,441,487,1360,6513
0.045,17,2,1152,1,548,0,548,576,1,548,0,548,576
187.194,6,9,515,5,43,46798,43,299,4,0,62395,0,216
0.07,17,4,588,2,48,57,48,152,2,190,40,308,436
782.143,2,7,224,7,8,130357,8,224,0,0,0,0,0
6.381,17,24,7744,9,252,797,1350,2525,15,319,230,1350,5219
6.04,17,5,754,4,32,1333,32,240,1,486,0,486,514
153.524,17,16,18239,16,1111,10234,1452,18239,0,0,0,0,0
1786.036,17,1920,145887,1044,40,1712,41,71688,876,56,2041,57,74199
6.196,6,3,1560,1,0,0,0,40,2,1440,1497,1440,1520
138.132,17,4,352,2,60,138131,60,176,2,60,138131,60,176
12.223,17,15,17706,15,1152,873,1449,17706,0,0,0,0,0
1763.709,17,150,24498,150,135,11836,389,24498,0,0,0,0,0
1.343,6,49,19551,27,913,51,1440,13895,22,433,55,1440,5656
1686.304,17,14,2716,14,166,129715,166,2716,0,0,0,0,0
62.729,17,34,19584,14,765,1593,1350,11103,20,396,3299,1350,8481
20.274,6,30,6884,16,133,1351,267,1448,14,810,1463,1467,5436
350.65,6,21,8210,8,189,50092,267,707,13,697,29209,1933,7503
131.609,6,25,6559,12,262,11960,517,1420,13,744,10963,1418,5139
11.672,6,1871,1605849,1133,1363,10,1380,1570176,738,511,15,1923,35673
2.273,6,20,3833,11,234,227,564,1504,9,463,260,1343,2329
301.028,6,57,25049,33,1117,9407,1360,19242,24,371,385,1360,5807
1778.002,6,205,22439,130,75,13782,267,10057,75,132,24019,1460,12382
316.138,6,99,20018,48,274,6726,1460,9983,51,241,6319,1629,10035
20.019,17,25,14032,13,818,1665,1350,11008,12,224,1816,1350,3024
1798.776,6,210,14472,78,46,23002,46,6156,132,46,13730,46,8316
1.0,17,4,809,2,33,990,33,122,2,315,974,327,687
11.848,6,1886,1637307,1142,1379,10,1420,1603326,744,467,15,2840,33981
1776.763,6,275,35666,111,144,16151,1360,16648,164,149,10899,4662,19018
1770.047,1,58,4872,58,56,31053,56,4872,0,0,0,0,0
1789.659,6,242,19311,141,69,12783,69,10125,101,55,17811,69,9186
23.717,6,1392,1361869,547,657,43,657,29109,845,1530,28,2816,1332760
2.284,6,12,2271,7,188,380,245,660,5,1407,507,1407,1611
1790.576,6,359,22709,209,69,8608,69,12569,150,69,12017,69,10140
33.682,6,31,5093,15,154,2405,722,1858,16,342,2233,1448,3235
4.283,17,5,340,5,40,1070,40,340,0,0,0,0,0
0.673,1,10,280,10,0,0,0,280,0,0,0,0,0
1785.862,6,362,22898,210,69,8544,69,12678,152,69,11826,69,10220
6.38,6,9,520,4,0,2126,0,220,5,0,1262,0,300
789.128,6,101,13720,47,129,15083,721,5387,54,205,14885,2840,8333
5.043,17,3,239,2,32,5028,32,120,1,91,0,91,119
3.001,1,3,168,3,28,1500,28,168,0,0,0,0,0
1775.06,6,180,15480,120,69,14916,69,8940,60,69,30079,69,6540
0.28,6,22,4442,11,165,28,456,1394,11,493,27,888,3048
252.373,2,2,64,2,8,252373,8,64,0,0,0,0,0
1681.376,17,16,4181,8,30,240195,37,471,8,435,240195,463,3710
601.63,2,4,128,4,8,200543,8,128,0,0,0,0,0
280.239,6,26,7272,12,158,25476,267,1277,14,775,21554,3445,5995
1773.399,6,182,15629,121,69,14778,69,8980,61,69,29554,69,6649
171.713,6,41,15638,23,661,121,1460,6904,18,727,10091,1548,8734
1786.503,6,102,8296,68,65,26664,65,4930,34,59,54133,59,3366
18.614,6,27,7177,13,155,1551,267,1306,14,530,1431,3417,5871
0.792,6,27,5689,13,140,66,267,1224,14,650,56,1414,4465
1754.16,1,8,848,8,78,250594,78,848,0,0,0,0,0
1682.038,17,14,1036,7,30,280337,30,406,7,62,280328,62,630
1786.95,6,102,8160,68,63,26670,63,4862,34,57,54147,57,3298
0.063,6,10,1514,5,503,15,503,771,5,475,15,475,743
31.776,6,253,214181,119,136,269,331,7941,134,1532,237,2836,206240
10.013,17,2,146,2,45,10013,45,146,0,0,0,0,0
0.941,6,10,1687,7,100,156,100,384,3,1179,338,1179,1303
0.549,6,2,80,1,0,0,0,40,1,0,0,0,40
1787.396,6,361,22858,210,69,8552,69,12609,151,69,11914,69,10249
1745.242,6,95,7203,63,38,28149,205,4476,32,33,56291,98,2727
280.388,1,3,336,3,84,140194,88,336,0,0,0,0,0
300.17,6,40,9995,21,593,14999,1360,4433,19,399,16666,1360,5562
1799.591,17,152,12680,76,53,23994,136,6216,76,57,23994,72,6464
349.486,1,5,280,5,28,87371,28,280,0,0,0,0,0
240.234,6,54,18440,29,826,8579,1402,15563,25,196,10009,580,2877
1797.689,6,356,22520,208,69,8684,69,12460,148,69,12229,69,10060
1754.494,6,187,11425,94,47,18865,208,6806,93,31,19067,31,4619
322.872,17,10,3390,10,311,35874,329,3390,0,0,0,0,0
1785.309,6,109,9233,70,71,25874,292,5302,39,64,46979,247,3931
2.18,17,3,468,3,128,1090,128,468,0,0,0,0,0
1739.505,1,15,870,15,30,124250,30,870,0,0,0,0,0
0.576,17,8,2750,8,315,82,354,2750,0,0,0,0,0
3.453,6,6,364,0,0,0,0,0,6,31,690,31,364
375.241,17,4,800,4,172,125080,172,800,0,0,0,0,0
0.041,6,3,144,2,0,41,0,92,1,0,0,0,52
0.11,17,4,1379,4,316,36,355,1379,0,0,0,0,0
4.435,6,39,7269,19,218,246,314,3383,20,440,220,1152,3886
0.075,17,8,2446,8,277,10,316,2446,0,0,0,0,0
1781.333,17,142,11360,71,48,25447,48,5396,71,56,25447,56,5964
1788.284,6,356,22520,208,69,8639,69,12460,148,69,12165,69,10060
0.079,6,9,1343,5,145,19,145,349,4,830,20,830,994
129.371,6,40,27070,17,754,44,1460,3730,23,1318,5874,1605,23340
0.854,17,2,154,1,33,0,33,61,1,65,0,65,93
2.295,6,14,2351,8,188,327,245,700,6,703,407,1152,1651
1793.868,1,141,7896,141,28,12813,28,7896,0,0,0,0,0
1.553,17,4,240,2,32,1552,32,120,2,32,1552,32,120
1797.855,17,449,39928,404,35,4461,288,25708,45,288,40018,288,14220
6.323,6,1231,1072283,715,1417,8,1448,1040787,516,776,11,1448,31496
1740.922,6,87,6322,58,31,30542,31,3915,29,31,62174,31,2407
0.048,17,2,206,1,44,0,44,72,1,106,0,106,134
34.296,17,20,1520,20,48,1805,48,1520,0,0,0,0,0
5.853,6,39,7269,21,218,292,314,3463,18,513,327,1179,3806
1780.105,1,342,28728,342,56,5220,56,28728,0,0,0,0,0
1799.94,17,448,39896,403,35,4477,288,25676,45,288,40015,288,14220
0.072,17,2,251,1,36,0,36,64,1,159,0,159,187
10.14,17,4,5484,4,1343,3380,1348,5484,0,0,0,0,0
7.351,1,12,1248,0,0,0,0,0,12,76,668,76,1248
1744.675,2,29,928,29,8,62309,8,928,0,0,0,0,0
0.917,6,25,8805,14,290,70,802,1753,11,942,72,1460,7052
1.175,17,4,884,2,30,1163,30,116,2,356,1165,468,768
0.351,17,2,231,1,34,0,34,62,1,141,0,141,169
0.519,17,3,451,2,39,485,39,134,1,289,0,289,317
1157.081,17,627,58670,590,40,1964,41,40501,37,463,3310,505,18169
4.649,6,39,7269,19,218,258,314,3383,20,440,231,1152,3886
1798.719,17,178,11392,178,36,10162,36,11392,0,0,0,0,0
1798.032,17,448,39896,403,35,4472,288,25676,45,288,40010,288,14220
20.162,6,21,5418,12,107,1832,159,1074,9,773,2516,1418,4344
4.083,6,9,527,5,43,1020,43,311,4,0,1339,0,216
67.468,6,32,8952,14,158,5189,267,1357,18,687,3962,1781,7595
1.051,6,36,8369,19,277,58,762,1936,17,478,57,2720,6433
17.556,6,160,85771,79,1269,225,1360,73145,81,425,209,1360,12626
1799.9,17,142,11360,71,48,25712,48,5396,71,56,25712,56,5964
3.491,17,7,612,4,32,1163,32,240,3,96,778,96,372
1747.332,6,101,7546,64,38,27735,205,4528,37,33,48528,98,3018
3.387,17,38,30019,24,1118,145,1350,27514,14,150,258,1350,2505
2.029,6,19,5273,11,388,199,634,2522,8,767,282,1328,2751
168.872,6,66,16341,32,364,910,1440,6120,34,383,5113,1440,10221
240.231,6,58,21101,32,822,7749,1418,18128,26,201,9608,580,2973
1624.378,2,16,512,16,8,108291,8,512,0,0,0,0,0
0.265,6,9,1340,5,145,66,145,349,4,827,28,827,991
114.446,6,46,8987,21,165,5722,721,2333,25,403,4642,1414,6654
0.006,6,3,450,1,0,0,0,40,2,165,0,261,410
1787.677,6,240,35580,150,302,11997,302,25920,90,83,20086,83,9660
1778.275,1,200,21200,200,78,8936,78,21200,0,0,0,0,0
130.697,17,4,352,2,60,130696,60,176,2,60,130696,60,176
1799.887,6,28,4707,19,258,99993,413,3342,9,111,196221,269,1365
54.476,1,3,279,3,65,27238,88,279,0,0,0,0,0
1719.423,17,12,498,11,14,171942,14,462,1,8,0,8,36
247.69,17,4,240,2,32,247689,32,120,2,32,247688,32,120
695.829,1,92,5152,92,28,7646,28,5152,0,0,0,0,0
0.513,17,2,440,1,39,0,39,67,1,345,0,345,373
196.72,1,8,1689,8,183,28102,293,1689,0,0,0,0,0
5.967,6,21,4374,12,213,542,597,1689,9,552,722,1767,2685
0.047,17,6,552,3,32,7,32,180,3,96,0,96,372
0.013,17,2,410,1,50,0,50,78,1,304,0,304,332
240.337,6,45,8499,23,449,10924,1402,5700,22,205,11444,580,2799
1774.937,6,130,7908,69,26,26102,26,4156,61,26,29567,26,3752
534.13,6,44,2889,24,58,23214,208,1779,20,31,28101,31,1110
0.533,17,4,288,2,36,486,36,128,2,52,489,52,160
10.763,6,18,5610,10,275,1195,275,958,8,1440,820,1440,4652
240.263,6,56,18065,29,793,8580,1418,15009,27,205,9240,580,3056
0.359,17,17,8245,8,578,51,1350,4850,9,349,38,1350,3395
280.423,6,31,7472,13,158,23368,267,1317,18,543,16493,1380,6155
29.234,6,37,8383,18,372,512,802,1869,19,441,1616,1460,6514
142.879,17,4,352,2,60,142878,60,176,2,60,142877,60,176
1789.364,6,355,22480,207,69,8686,69,12420,148,69,12170,69,10060
1795.013,17,142,11360,71,48,25642,48,5396,71,56,25642,56,5964
280.391,6,30,7432,13,158,23365,267,1317,17,543,17520,1400,6115
1.226,6,10,1687,7,100,204,100,384,3,1179,481,1179,1303
0.065,17,7,2172,7,282,10,316,2172,0,0,0,0,0
2.41,6,12,5634,3,112,1205,112,240,9,718,276,1460,5394
0.541,6,21,7290,13,335,41,668,2026,8,1210,71,1946,5264
280.035,6,27,7312,12,158,25457,267,1277,15,678,20000,2045,6035
1.843,17,2,782,2,363,1843,363,782,0,0,0,0,0
1.141,17,4,396,2,39,1001,39,134,2,103,0,103,262
1784.837,1,273,15288,273,28,6561,28,15288,0,0,0,0,0
396.5,17,3,222,3,46,198250,46,222,0,0,0,0,0
15.87,17,25,18344,12,843,1434,1350,10462,13,578,1314,1350,7882
1632.023,1,9,504,9,28,204002,28,504,0,0,0,0,0
7.366,6,1856,1804923,1236,1386,5,1408,1768019,620,931,11,2801,36904
280.308,6,28,7352,12,158,25482,267,1277,16,603,18684,1400,6075
0.36,6,9,1340,5,145,90,145,349,4,827,85,827,991
240.306,6,38,4962,18,235,14133,751,2594,20,165,12645,494,2368
11.969,6,5,3080,2,0,11969,0,80,3,1440,4782,1440,3000
1791.382,1,342,28728,342,56,5253,56,28728,0,0,0,0,0
1739.453,1,15,870,15,30,124246,30,870,0,0,0,0,0
1.1,6,15,2638,8,288,133,288,640,7,568,117,853,1998
2.917,17,3,201,3,39,1458,39,201,0,0,0,0,0
13.492,6,14,2242,8,210,1925,210,844,6,545,2698,904,1398
5.543,6,39,7285,20,218,291,314,3423,19,516,293,1179,3862
281.549,6,30,7432,13,158,23462,267,1317,17,543,17594,1400,6115
1750.762,17,13,534,11,14,175057,14,462,2,8,1750578,8,72
421.12,2,5,160,5,8,105280,8,160,0,0,0,0,0
38.786,6,363,167654,193,812,202,1152,156372,170,447,228,1179,11282
11.902,6,1849,1640023,1159,1364,10,1380,1608181,690,421,17,1923,31842
90.549,6,38,15982,23,799,4115,1448,9203,15,748,4365,2359,6779
1764.122,2,15,480,15,8,126008,8,480,0,0,0,0,0
31.435,6,7,336,1,0,0,0,48,6,0,6285,0,288
16.703,6,30,7297,14,155,1284,267,1346,16,441,1112,1420,5951
2.172,17,21,14231,12,946,197,1350,11690,9,254,267,1350,2541
8.934,6,451,388052,290,1276,30,1368,375016,161,776,54,1473,13036
3.393,6,10,1102,6,483,678,483,803,4,83,1128,83,299
1797.528,6,417,29292,232,97,7781,469,17407,185,69,9767,69,11885
173.494,17,4,352,2,60,173493,60,176,2,60,173493,60,176
10.638,6,16,3911,9,275,1329,275,643,7,992,957,1440,3268
1.397,6,50,18939,27,866,53,1360,13243,23,476,55,2715,5696
0.943,17,22,11581,11,446,90,1350,5221,11,550,91,1350,6360
94.735,17,5,380,5,48,23683,48,380,0,0,0,0,0
300.64,6,41,8720,22,291,14316,787,2113,19,416,469,3488,6607
1790.991,6,355,22480,207,69,8694,69,12420,148,69,12183,69,10060
0.026,17,2,120,1,32,0,32,60,1,32,0,32,60
4.977,6,37,7189,19,218,276,314,3383,18,513,276,1179,3806
1.297,17,4,368,2,32,991,32,120,2,96,1036,96,248
125.744,2,2,64,2,8,125744,8,64,0,0,0,0,0
0.359,6,27,8922,13,232,29,567,1612,14,939,26,1408,7310
15.338,6,13,5577,4,106,5109,106,274,9,985,1916,1420,5303
679.981,2,9,288,9,8,84997,8,288,0,0,0,0,0
1744.352,6,94,7151,62,38,28595,205,4424,32,33,56259,98,2727
1179.337,6,122,14280,68,85,17602,721,5968,54,211,22211,1420,8312
1770.086,6,99,9240,66,65,27232,65,5577,33,59,55312,59,3663
315.896,6,78,19852,39,326,8313,1360,10081,39,327,8309,4649,9771
1740.493,17,30,20190,30,645,60017,645,20190,0,0,0,0,0
38.798,17,44,6468,22,48,1847,48,1672,22,190,1847,308,4796
1770.623,6,100,9358,66,66,27240,66,5610,34,60,53652,60,3748
13.329,6,1735,989920,935,168,14,168,37572,800,1153,16,2304,952348
1748.185,6,95,7203,63,38,28196,205,4476,32,33,56379,98,2727
10.539,6,20,4442,11,275,1053,275,998,9,768,717,1440,3444
2.163,17,3,174,3,30,1081,30,174,0,0,0,0,0
300.294,6,27,8510,15,409,21449,1050,2438,12,680,3502,1491,6072
1.53,6,38,9848,21,440,76,1360,4392,17,529,81,4075,5456
77.104,17,6,528,3,48,38548,48,228,3,72,38548,72,300
1775.628,6,181,15589,120,69,14921,69,8940,61,69,29587,69,6649
96.411,6,34,7871,13,155,8034,267,1306,21,357,4820,2840,6565
301.067,6,37,8250,21,245,15053,635,1854,16,522,596,3488,6396
1774.961,17,140,11200,70,48,25724,48,5320,70,56,25724,56,5880
192.656,17,4,284,2,32,192606,32,120,2,54,192644,60,164
12.186,17,10,850,5,37,3044,37,325,5,77,3045,77,525
1787.003,6,102,8364,68,66,26671,66,4964,34,60,54148,60,3400
1772.387,6,180,15480,120,69,14894,69,8940,60,69,30035,69,6540
0.013,17,2,244,1,43,0,43,71,1,145,0,145,173
1799.585,1,59,4956,59,56,31027,56,4956,0,0,0,0,0
280.247,6,28,7352,12,158,25477,267,1277,16,603,18677,1400,6075
307.432,6,88,14928,42,314,7498,1408,7562,46,215,6831,1408,7366
1799.619,17,480,58898,223,162,8106,1350,42526,257,35,7029,1350,16372
1.544,6,64,46911,40,1255,39,1408,39758,24,1179,59,3819,7153
228.988,17,12,1056,6,48,45796,48,456,6,72,45793,72,600
0.051,17,4,284,2,32,1,32,120,2,54,38,60,164
1799.874,6,356,22589,207,69,8737,69,12420,149,69,12161,69,10169
1783.266,1,8,448,8,28,254752,28,448,0,0,0,0,0
0.288,17,2,632,1,288,0,288,316,1,288,0,288,316
1799.297,6,133,8685,75,52,24311,208,5156,58,31,31563,31,3529
300.671,6,36,8391,20,291,15824,786,1997,16,522,568,4080,6394
1772.68,6,270,49291,129,857,13849,1418,35130,141,60,12661,580,14161
128.841,17,4,352,2,60,128840,60,176,2,60,128840,60,176
0.006,6,3,327,2,103,0,138,287,1,0,0,0,40
2.912,17,4,624,4,128,970,128,624,0,0,0,0,0
259.322,6,27,7247,8,138,37046,267,883,19,430,14398,1460,6364
1785.595,6,102,8296,68,65,26650,65,4930,34,59,54105,59,3366
0.001,17,2,2070,2,1007,1,1007,2070,0,0,0,0,0
1783.283,17,140,11200,70,48,25844,48,5320,70,56,25844,56,5880
0.301,6,10,1840,5,901,75,901,1169,5,403,75,403,671
280.107,6,26,7272,13,158,23342,267,1317,13,905,23333,4845,5955
32.141,6,9,396,2,0,3540,0,88,7,0,5341,0,308
1674.14,1,8,448,8,28,239162,28,448,0,0,0,0,0
1793.909,17,144,11520,72,48,25266,48,5472,72,56,25266,56,6048
1788.955,17,87,3648,86,14,21046,14,3612,1,8,0,8,36
2.046,17,4,918,2,40,2031,40,136,2,363,15,363,782
0.104,17,2,214,1,39,0,39,67,1,119,0,119,147
1282.528,6,534,231115,256,78,5029,517,19959,278,1068,4630,7040,211156
300.722,6,45,8867,23,266,13669,720,2078,22,346,613,1928,6789
180.14,6,22,2688,13,302,15011,302,1880,9,83,22516,83,808
8.115,6,78,24405,40,552,208,1152,18744,38,413,212,1152,5661
2.875,6,25,6858,12,257,254,517,1675,13,749,232,2448,5183
1772.427,6,180,15480,120,69,14894,69,8940,60,69,30035,69,6540
1793.82,6,356,22520,208,69,8665,69,12460,148,69,12202,69,10060
2.031,17,4,464,3,64,1000,64,276,1,160,0,160,188
135.98,6,25,11777,12,746,57,1460,3497,13,1106,11320,1460,8280
1784.404,6,360,22818,210,69,8537,69,12678,150,69,11975,69,10140
2.267,6,27,6134,16,138,151,267,1755,11,787,194,1460,4379
31.95,6,7,396,1,0,0,0,60,6,0,6312,0,336
0.393,6,10,968,5,256,96,256,460,5,304,96,304,508
1.861,17,20,5180,20,231,97,388,5180,0,0,0,0,0
0.47,6,12,1653,6,288,87,288,548,6,426,52,434,1105
0.719,2,2,64,2,8,719,8,64,0,0,0,0,0
1780.313,17,140,11200,70,48,25801,48,5320,70,56,25801,56,5880
5.812,6,38,7229,19,218,322,314,3383,19,513,308,1179,3846
0.616,17,23,16640,14,975,46,1350,14046,9,260,72,1350,2594
280.469,6,28,7352,12,158,25497,267,1277,16,678,18693,2760,6075
1781.146,17,138,11040,69,48,26193,48,5244,69,56,26193,56,5796
0.576,6,28,7047,17,244,36,655,2393,11,701,56,1696,4654
1683.712,17,14,1036,7,30,280616,30,406,7,62,280616,62,630
31.01,17,6,604,6,72,6202,84,604,0,0,0,0,0
13.178,6,30,5651,13,197,1098,314,2105,17,408,808,1152,3546
1745.896,6,104,7826,63,38,28159,205,4476,41,32,43640,98,3350
0.025,6,10,1671,6,552,4,948,1348,4,159,8,159,323
279.991,6,29,7392,13,158,23332,267,1317,16,603,18663,1400,6075
240.22,6,53,17729,28,789,8896,1418,14893,25,191,10008,580,2836
0.138,17,4,284,2,32,0,32,120,2,54,128,60,164
9.101,6,8,416,4,0,2949,0,208,4,0,2973,0,208
0.776,17,4,368,2,32,754,32,120,2,96,546,96,248
69.719,6,15,1666,9,180,8714,180,1016,6,110,13898,110,650
1798.216,17,140,11200,70,48,26060,48,5320,70,56,26060,56,5880
201.464,6,67,46989,44,1185,4685,1408,39060,23,960,2799,3847,7929
0.006,6,2,100,1,0,0,0,40,1,0,0,0,60
1170.364,17,806,56547,730,40,1605,41,50120,76,56,529,57,6427
299.637,17,3,1008,3,308,149818,308,1008,0,0,0,0,0
1773.74,6,208,23961,133,89,13437,981,11158,75,137,23967,1917,12803
4.734,17,5,320,5,36,1183,36,320,0,0,0,0,0
399.405,17,20,840,20,14,21021,14,840,0,0,0,0,0
559.524,17,22,7524,22,314,26644,320,7524,0,0,0,0,0
11.64,17,8,704,4,48,3874,48,304,4,72,3875,72,400
413.879,6,34,2878,23,69,18812,69,1679,11,69,30045,69,1199
3.417,6,10,2928,4,92,1139,92,296,6,579,596,1408,2632
0.847,6,10,1687,7,100,141,100,384,3,1179,288,1179,1303
1786.99,6,102,8296,68,65,26671,65,4930,34,59,54148,59,3366
11.703,6,1840,1604517,1111,1389,10,1420,1571136,729,467,16,1883,33381
1791.977,6,356,22520,208,69,8656,69,12460,148,69,12190,69,10060
123.953,6,26,7132,12,155,28,267,1266,14,529,9534,3417,5866
1794.616,17,144,11520,72,48,25276,48,5472,72,56,25276,56,6048
0.313,6,26,8911,13,237,26,590,1635,13,1098,25,2816,7276
0.365,6,20,7151,11,318,35,600,1854,9,964,44,1471,5297
0.021,6,2,80,1,0,0,0,40,1,0,0,0,40
1799.73,1,66,5544,66,56,27688,56,5544,0,0,0,0,0
1793.815,17,66,2766,65,14,28028,14,2730,1,8,0,8,36
56.379,6,551,246551,278,823,203,1152,230110,273,424,206,1179,16441
5.817,6,42,8289,21,227,290,314,4022,21,489,277,1179,4267
0.343,6,24,5980,12,164,31,453,1442,12,651,29,1448,4538
15.013,6,5,300,5,0,0,0,300,0,0,0,0,0
0.174,6,45,21042,26,1071,6,1420,16061,19,526,9,3303,4981
0.015,17,2,128,1,36,0,36,64,1,36,0,36,64
125.873,6,33,7826,12,155,28,267,1266,21,357,6293,3417,6560
1786.613,17,87,3648,86,14,21018,14,3612,1,8,0,8,36
1.139,6,58,18034,28,707,42,1360,8925,30,438,38,1360,9109
3.167,17,2,292,1,53,0,53,81,1,183,0,183,211
294.521,17,4,288,2,36,294489,36,128,2,52,294490,52,160
90.723,6,44,8936,21,391,768,860,2107,23,346,4116,2720,6829
0.376,6,12,1653,6,288,69,288,548,6,426,43,434,1105
0.128,17,4,588,2,48,111,48,152,2,190,107,308,436
1783.547,6,372,26319,215,105,8334,469,15554,157,69,11432,69,10765
5.052,6,27,9283,14,533,388,933,2324,13,784,420,1408,6959
1705.929,1,8,448,8,28,243704,28,448,0,0,0,0,0
4.284,17,4,3964,4,963,1428,1451,3964,0,0,0,0,0
1794.087,17,142,11360,71,48,25629,48,5396,71,56,25629,56,5964
5.036,17,3,208,2,36,5002,36,128,1,52,0,52,80
65.413,6,46,9978,23,642,605,1360,4225,23,401,2965,2667,5753
1.134,6,22,7900,11,164,113,267,1236,11,1014,93,2491,6664
0.641,17,11,4498,5,432,160,1350,2300,6,338,72,1350,2198
53.724,6,16,1935,5,100,1354,100,304,11,589,5347,1152,1631
1798.233,1,345,28980,345,56,5227,56,28980,0,0,0,0,0
1763.505,17,168,14050,156,30,11377,37,9090,12,385,154886,463,4960
0.23,17,2,180,1,30,0,30,58,1,94,0,94,122
450.83,6,45,8683,21,190,22537,517,2053,24,672,19598,1368,6630
1785.017,17,142,11360,71,48,25499,48,5396,71,56,25499,56,5964
280.054,6,28,7352,13,158,23337,267,1317,15,678,19999,2800,6035
64.146,6,43,8823,21,367,818,787,2034,22,368,3048,3488,6789
1.925,6,27,8825,16,281,128,577,1489,11,984,174,1452,7336
7.643,6,25,8846,8,154,1091,267,792,17,613,476,1420,8054
46.251,17,4,304,4,48,15417,48,304,0,0,0,0,0
10.92,6,22,9934,11,275,1092,275,998,11,1414,1074,1414,8936
1795.968,1,339,28476,339,56,5313,56,28476,0,0,0,0,0
1777.821,6,273,33062,112,134,16015,1360,15915,161,132,11110,1360,17147
1789.624,1,16,896,16,28,119308,28,896,0,0,0,0,0
1765.208,1,8,448,8,28,252172,28,448,0,0,0,0,0
1785.857,6,367,25581,213,99,8423,469,15005,154,69,11672,69,10576
64.294,17,4,352,2,60,64292,60,176,2,60,64293,60,176
7.792,6,80,24757,41,561,194,1152,19056,39,413,198,1152,5701
11.646,6,1859,1610658,1120,1383,10,1420,1576865,739,467,15,1883,33793
1793.659,1,328,27552,328,56,5485,56,27552,0,0,0,0,0
1799.427,17,446,39264,402,35,4487,288,25360,44,288,40953,288,13904
1787.778,6,157,24143,93,230,19432,1294,15416,64,114,28377,350,8727
1799.965,17,142,11360,71,48,25713,48,5396,71,56,25713,56,5964
1792.772,17,180,11520,180,36,10015,36,11520,0,0,0,0,0
6.118,6,3,180,3,0,0,0,180,0,0,0,0,0
301.087,6,39,8792,22,335,14337,994,2313,17,482,541,3388,6479
1793.555,6,240,35580,150,302,12037,302,25920,90,83,20152,83,9660
1798.829,6,356,22520,208,69,8689,69,12460,148,69,12236,69,10060
0.356,17,4,420,2,33,0,33,122,2,121,1,145,298
0.214,17,2,152,1,48,0,48,76,1,48,0,48,76
1769.918,6,101,9212,66,63,27229,63,5511,35,57,52054,57,3701
369.575,6,18,1242,14,180,28428,180,916,4,110,20057,110,326
1776.095,6,181,15589,120,69,14925,69,8940,61,69,29597,69,6649
1789.948,6,441,26985,234,69,7682,69,13707,207,44,8689,69,13278
2.194,6,16,2174,9,211,274,211,695,7,545,263,904,1479
1743.759,6,99,7411,63,38,28125,205,4476,36,33,49815,98,2935
367.017,6,25,1654,17,180,22938,180,1120,8,110,9226,110,534
1.714,6,51,20088,29,941,61,1460,14387,22,400,69,1460,5701
300.624,6,37,8301,20,258,15822,688,1867,17,522,531,3488,6434
10.768,6,20,4390,11,275,1076,275,998,9,755,754,1414,3392
0.247,17,2,154,1,33,0,33,61,1,65,0,65,93
14.953,6,2569,2411896,1661,1374,8,1408,2360016,908,931,16,2816,51880
0.055,6,2,92,1,0,0,0,52,1,0,0,0,40
40.988,6,27,7177,13,155,3415,267,1306,14,530,3152,3417,5871
1.227,6,10,1687,7,100,204,100,384,3,1179,486,1179,1303
124.861,6,24,10043,13,653,63,1360,3166,11,1070,12469,2235,6877
76.143,17,4,1344,4,308,25381,308,1344,0,0,0,0,0
200.743,17,7,2382,7,312,33457,326,2382,0,0,0,0,0
2.313,6,14,2351,8,188,330,245,700,6,703,410,1152,1651
0.203,6,23,7324,12,177,18,337,1342,11,1080,18,1588,5982
71.089,6,22,10172,11,433,70,990,1783,11,1133,7094,1390,8389
0.048,17,2,190,1,59,0,59,87,1,75,0,75,103
0.143,17,3,2906,3,940,71,1451,2906,0,0,0,0,0
95.565,6,33,15163,16,894,81,1360,6049,17,842,5961,1360,9114
1782.91,17,142,11360,71,48,25470,48,5396,71,56,25470,56,5964
0.191,6,46,21983,27,1060,7,1420,17002,19,467,10,1883,4981
281.3,6,33,7813,15,175,20092,267,1658,18,543,16543,1400,6155
0.051,17,2,146,1,37,0,37,65,1,53,0,53,81
2.025,17,33,7416,14,221,153,1350,3489,19,178,110,1350,3927
0.082,17,2,198,1,39,0,39,67,1,103,0,103,131
1.442,6,48,18892,26,935,57,1460,13236,22,433,59,1460,5656
1.966,6,17,4523,10,327,214,634,1836,7,767,320,1328,2687
0.072,17,4,308,2,38,0,38,132,2,60,67,66,176
0.783,6,11,1727,7,100,130,100,384,4,589,175,1152,1343
639.28,6,72,9269,32,144,17114,722,4411,40,146,16383,1448,4858
1.264,6,52,22251,29,960,45,1360,16555,23,433,49,1360,5696
8.105,6,6,260,2,0,8105,0,84,4,0,2368,0,176
24.64,17,4,240,2,32,24639,32,120,2,32,24640,32,120
1795.38,17,437,38976,393,35,4580,288,25072,44,288,40956,288,13904
1738.214,1,144,12096,144,56,12155,56,12096,0,0,0,0,0
326.92,17,8,608,8,48,46702,48,608,0,0,0,0,0
0.406,6,12,1653,6,288,73,288,548,6,426,45,434,1105
315.884,6,95,20502,51,310,6317,1360,10577,44,291,7343,2720,9925
1019.908,17,200,15200,200,48,5125,48,15200,0,0,0,0,0
1.304,17,20,5180,20,231,68,388,5180,0,0,0,0,0
1771.46,6,101,9410,66,66,27253,66,5610,35,60,52099,60,3800
189.024,6,12,740,6,92,37768,92,412,6,0,37766,0,328
0.028,6,10,1371,5,126,7,126,394,5,356,6,380,977
0.59,6,12,2084,6,288,81,288,560,6,424,81,434,1524
1791.15,6,373,26028,216,98,8330,469,15263,157,69,11478,69,10765
0.307,6,21,7281,12,334,27,663,1969,9,967,37,1471,5312
0.032,17,2,554,1,30,0,30,58,1,468,0,468,496
1798.948,17,449,39928,404,35,4463,288,25708,45,288,40017,288,14220
1.593,6,50,19327,29,890,56,1360,13666,21,437,69,2715,5661
9.518,6,15,5847,4,98,3169,106,365,11,718,950,1420,5482
297.251,1,4,224,4,28,99083,28,224,0,0,0,0,0
0.427,6,55,24245,30,1052,14,1380,17080,25,558,15,1923,7165
34.333,17,20,1520,20,48,1807,48,1520,0,0,0,0,0
7.782,6,24,6444,13,304,648,866,2047,11,790,752,1460,4397
1681.257,1,15,870,15,30,120089,30,870,0,0,0,0,0
604.682,6,45,7600,21,262,30230,517,1888,24,744,26287,1418,5712
1681.438,1,15,870,15,30,120102,30,870,0,0,0,0,0
1791.874,6,356,22520,208,69,8656,69,12460,148,69,12189,69,10060
281.475,6,31,7541,13,158,23456,267,1317,18,500,16515,1400,6224
457.84,17,32,2560,16,48,30522,48,1216,16,56,30522,56,1344
1744.611,2,29,928,29,8,62307,8,928,0,0,0,0,0
1795.763,17,448,39612,404,35,4455,288,25708,44,288,40950,288,13904
0.053,17,4,336,2,34,0,34,124,2,78,4,84,212
1790.14,1,270,15120,270,28,6654,28,15120,0,0,0,0,0
8.071,6,78,24938,40,568,206,1152,19229,38,465,211,1179,5709
1792.426,17,87,3648,86,14,21087,14,3612,1,8,0,8,36
271.292,17,4,352,2,60,271290,60,176,2,60,271291,60,176
1772.16,6,240,17880,120,69,14892,69,8940,120,34,14892,48,8940
12.29,17,3,1035,3,317,6145,317,1035,0,0,0,0,0
0.021,17,2,120,1,32,0,32,60,1,32,0,32,60
417.222,2,5,160,5,8,104305,8,160,0,0,0,0,0
506.074,6,56,7244,28,103,18743,721,2807,28,156,15456,2026,4437
126.076,2,2,64,2,8,126076,8,64,0,0,0,0,0
17.554,17,21,6738,10,388,1946,1350,4160,11,206,1751,1350,2578
1762.248,17,327,53137,327,134,5405,357,53137,0,0,0,0,0
0.224,6,27,7296,13,155,18,267,1301,14,603,16,1400,5995
1532.513,6,100,18022,60,101,25974,721,6755,40,568,8217,2391,11267
180.413,2,2,64,2,8,180413,8,64,0,0,0,0,0
280.395,6,29,7392,13,158,23366,267,1317,16,603,18689,2036,6075
3.241,6,2,88,2,0,0,0,88,0,0,0,0,0
7.837,6,2,1175,1,0,0,0,40,1,1095,0,1095,1135
255.117,6,8,548,7,106,42519,106,500,1,0,0,0,48
281.527,6,32,7650,13,158,23460,267,1317,19,556,15623,2760,6333
1777.699,17,142,11360,71,48,25395,48,5396,71,56,25395,56,5964
0.259,17,3,451,2,39,123,39,134,1,289,0,289,317
1799.916,6,363,24414,212,88,8530,469,14027,151,69,11996,69,10387
0.092,17,2,1896,2,920,92,1442,1896,0,0,0,0,0
0.073,17,2,642,1,300,0,300,328,1,286,0,286,314
368.836,6,20,1355,15,177,26345,177,977,5,110,15167,110,378
1.066,1,10,840,10,56,118,56,840,0,0,0,0,0
1771.38,6,108,9856,68,65,26438,65,5758,40,59,45416,59,4098
1771.688,1,246,13776,246,28,7231,28,13776,0,0,0,0,0
1774.66,6,180,15480,120,69,14913,69,8940,60,69,30076,69,6540
1797.227,6,376,26217,218,98,8282,469,15412,158,69,11446,69,10805
6.847,6,478,442449,319,1327,20,1368,429517,159,931,42,2736,12932
1.565,6,13,3293,7,192,260,192,564,6,1204,312,1408,2729
1786.106,6,102,8296,68,65,26658,65,4930,34,59,54120,59,3366
0.004,17,2,264,1,31,0,31,59,1,177,0,177,205
34.613,6,13,939,6,186,6920,186,506,7,45,5768,45,433
1.269,6,2,80,1,0,0,0,40,1,0,0,0,40
6.813,6,30,7504,12,155,619,267,1266,18,393,400,1997,6238
7.389,2,2,64,2,8,7389,8,64,0,0,0,0,0
1783.664,1,58,4872,0,0,0,0,0,58,56,31292,56,4872
0.021,6,19,4192,10,101,2,101,629,9,441,2,500,3563
0.021,17,4,791,2,32,0,32,120,2,307,1,319,671
356.362,6,34,11324,23,269,16198,1360,4184,11,1114,44,2720,7140
14.022,6,10,538,5,46,3396,46,246,5,46,3499,46,292
1796.864,17,447,39864,402,35,4480,288,25644,45,288,40017,288,14220
1786.647,6,102,8296,68,65,26666,65,4930,34,59,54138,59,3366
1799.876,6,368,25828,213,99,8489,469,15005,155,69,11687,69,10823
1747.214,6,94,7151,62,38,28642,205,4424,32,33,56349,98,2727
1772.524,6,181,15589,120,69,14895,69,8940,61,69,29539,69,6649
4.953,6,39,7269,20,218,260,314,3423,19,513,261,1179,3846
156.538,6,25,10208,12,549,71,1360,2709,13,995,13032,1360,7499
1754.909,1,61,5124,61,56,29248,56,5124,0,0,0,0,0
300.547,6,41,11208,20,345,15818,1408,2833,21,519,12191,1408,8375
0.149,17,2,780,2,362,149,362,780,0,0,0,0,0
376.167,6,18,1239,14,177,28935,177,913,4,110,20061,110,326
81.096,6,11,3020,2,92,20911,92,204,9,1164,10114,1448,2816
1680.723,17,12,498,11,14,168072,14,462,1,8,0,8,36
384.306,1,5,580,5,88,96076,88,580,0,0,0,0,0
1787.824,6,102,8228,68,64,26683,64,4896,34,58,54174,58,3332
1764.295,2,13,416,13,8,147024,8,416,0,0,0,0,0
20.52,6,21,3549,11,211,2050,211,1022,10,665,2266,904,2527
0.159,17,2,136,1,32,0,32,60,1,48,0,48,76
0.535,17,2,476,1,39,0,39,67,1,381,0,381,409
5.395,6,39,7269,21,218,269,314,3463,18,513,301,1179,3806
111.262,6,24,10180,12,549,67,1360,2721,12,1161,10101,2574,7459
367.365,6,25,1651,17,177,22960,177,1117,8,110,9175,110,534
61.349,6,36,16050,22,817,2921,1408,9324,14,748,4699,2439,6726
1795.812,6,358,22738,207,69,8717,69,12558,151,69,11969,69,10180
300.762,6,56,30150,25,190,12531,444,2117,31,1056,8081,1402,28033
0.118,6,26,22125,16,180,7,250,1382,10,2526,11,8539,20743
62.754,17,6,8262,6,1349,12550,1349,8262,0,0,0,0,0
180.686,17,4,352,2,60,180685,60,176,2,60,180685,60,176
1.646,6,26,8108,13,164,123,267,1340,13,869,123,1408,6768
1680.523,1,15,840,15,28,120037,28,840,0,0,0,0,0
0.069,17,2,1920,2,932,69,932,1920,0,0,0,0,0
165.373,6,199,152751,123,1277,1355,1368,139281,76,679,1775,2736,13470
1782.402,1,342,28728,342,56,5226,56,28728,0,0,0,0,0
300.655,6,36,8381,19,286,16703,797,1948,17,478,530,2128,6433
92.692,6,814,402694,451,837,205,1152,382328,363,389,255,1152,20366
300.25,6,32,11872,17,592,18765,1402,4445,15,829,17157,1402,7427
0.752,6,68,37262,40,1122,19,1380,29757,28,558,26,1923,7505
53.084,17,3,2994,3,970,26542,1322,2994,0,0,0,0,0
0.012,17,2,904,1,300,0,300,328,1,548,0,548,576
2.225,6,14,2351,8,188,317,245,700,6,703,392,1152,1651
7.847,2,2,64,2,8,7847,8,64,0,0,0,0,0
240.323,6,43,8950,21,523,12015,1408,5812,22,220,11443,617,3138
0.0,17,2,116,2,30,0,30,116,0,0,0,0,0
240.225,6,55,18919,30,792,8283,1402,15829,25,222,10009,580,3090
25.13,17,5,380,5,48,6282,48,380,0,0,0,0,0
1799.087,17,130,10400,65,48,28110,48,4940,65,56,28110,56,5460
5.424,6,720,637717,451,1344,11,1368,619065,269,776,19,1473,18652
0.058,6,13,3980,7,88,9,88,388,6,1670,11,1880,3592
88.889,17,4,240,2,32,88887,32,120,2,32,88887,32,120
1.648,6,13,2311,8,188,235,245,700,5,1407,349,1407,1611
0.844,17,4,560,2,64,842,64,184,2,160,730,160,376
11.2,6,15,6655,7,275,1866,275,563,8,1440,937,1440,6092
0.321,6,2,111,1,0,0,0,40,1,31,0,31,71
576.002,6,4,436,4,69,192000,69,436,0,0,0,0,0
294.178,6,48,6384,24,113,12790,722,2508,24,187,10077,1448,3876
21.165,6,21,3182,12,183,1924,517,1561,9,381,2644,499,1621
1060.782,17,207,15732,207,48,5149,48,15732,0,0,0,0,0
0.155,17,2,412,1,33,0,33,61,1,323,0,323,351
11.586,6,21,6825,12,275,1053,275,1038,9,1353,821,1440,5787
1782.292,17,142,11360,71,48,25461,48,5396,71,56,25461,56,5964
3.213,17,5,340,5,40,803,40,340,0,0,0,0,0
1749.507,6,97,7307,63,38,28217,205,4476,34,33,53002,98,2831
24.157,17,31,14293,16,646,1608,1350,10787,15,205,1722,1350,3506
0.074,1,6,3456,6,548,14,548,3456,0,0,0,0,0
1743.387,6,97,7338,64,38,27672,205,4528,33,33,54458,98,2810
0.929,6,30,7496,14,161,71,267,1531,16,760,57,1420,5965
7.973,6,18,6767,9,275,996,275,643,9,1150,645,1414,6124
68.536,17,8,1176,4,48,22841,48,304,4,190,22840,308,872
4.259,6,39,7269,20,218,224,314,3423,19,440,222,1152,3846
1.136,6,37,22094,23,1096,51,1408,15461,14,1179,74,2816,6633
373.399,6,19,1294,14,180,28723,180,916,5,110,15046,110,378
1740.661,1,8,448,8,28,248665,28,448,0,0,0,0,0
1778.45,17,328,52576,328,132,5438,376,52576,0,0,0,0,0
123.392,6,30,7432,13,158,10282,267,1317,17,543,7709,1400,6115
17.71,17,24,12681,14,722,1359,1350,10505,10,189,1964,1350,2176
0.008,17,4,248,2,34,6,34,124,2,34,7,34,124
305.117,6,42,7610,18,142,10248,516,1865,24,265,13262,1452,5745
1792.316,6,359,22847,207,69,8700,69,12489,152,69,11869,69,10358
4.884,6,542,471506,335,1341,13,1368,456078,207,776,22,1473,15428
1795.352,6,364,23047,211,69,8549,69,12787,153,69,11810,69,10260
1699.479,17,12,498,11,14,169947,14,462,1,8,0,8,36
3.883,6,23,6465,10,262,426,517,1316,13,744,319,1418,5149
1798.731,17,448,39896,403,35,4474,288,25676,45,288,40018,288,14220
5.487,6,41,7349,22,218,261,314,3503,19,513,290,1179,3846
62.459,6,12,724,4,106,20816,106,274,8,90,8921,90,450
11.83,6,1949,1645925,1161,1363,10,1380,1608240,788,558,14,1923,37685
16.676,6,35,4968,19,304,926,304,3440,16,83,1110,83,1528
1748.63,6,99,7411,63,38,28203,205,4476,36,33,49951,98,2935
170.752,6,9,572,6,92,34113,92,412,3,0,85269,0,160
0.179,6,9,1343,5,145,44,145,349,4,830,56,830,994
1790.988,17,179,13962,179,50,10061,50,13962,0,0,0,0,0
1.196,6,19,5907,10,281,132,543,1247,9,716,138,1420,4660
47.171,1,6,336,6,28,9434,28,336,0,0,0,0,0
1743.757,6,95,7203,63,38,28125,205,4476,32,33,56241,98,2727
0.004,1,2,112,2,28,4,28,112,0,0,0,0,0
2.408,6,27,8825,16,281,160,577,1489,11,984,222,1452,7336
1.47,6,51,19920,27,933,56,1460,14184,24,433,55,1460,5736
1769.143,6,27,4077,18,241,104067,241,2889,9,92,221121,92,1188
1713.014,1,51,6231,51,94,34260,320,6231,0,0,0,0,0
0.015,17,2,290,1,40,0,40,68,1,194,0,194,222
1.168,6,30,6112,15,138,83,267,1573,15,655,77,1420,4539
394.132,17,6,2016,6,308,78826,308,2016,0,0,0,0,0
0.483,6,24,7341,13,257,39,745,1712,11,1009,47,2804,5629
41.081,6,41,8747,17,333,48,685,1772,24,315,1779,3488,6975
600.027,6,9,546,6,31,120005,31,333,3,31,299873,31,213
0.041,6,4,196,1,0,0,0,40,3,0,5,0,156
21.382,6,37,8470,18,401,522,888,1956,19,441,1178,1360,6514
33.618,6,32,5153,15,180,2401,721,1858,17,267,2086,1368,3295
1799.16,1,56,4704,56,56,32712,56,4704,0,0,0,0,0
1.352,6,58,18034,28,707,50,1360,8925,30,438,46,1360,9109
1786.102,17,140,11200,70,48,25885,48,5320,70,56,25885,56,5880
60.676,6,9,484,5,0,15169,0,268,4,0,20147,0,216
0.456,6,6,300,3,0,124,0,144,3,0,216,0,156
1773.112,6,180,15480,120,69,14900,69,8940,60,69,30049,69,6540
255.375,17,4,352,2,60,255374,60,176,2,60,255374,60,176
3.216,17,2,166,1,47,0,47,75,1,63,0,63,91
29.667,17,4,240,2,32,29666,32,120,2,32,29666,32,120
3.724,6,13,3051,5,92,931,92,348,8,567,452,1408,2703
10.953,17,14,16229,14,1131,842,1449,16229,0,0,0,0,0
412.696,6,36,7165,16,274,27510,517,1664,20,744,21718,1408,5501
10.971,6,20,5694,11,275,1097,275,998,9,1440,746,1440,4696
300.63,6,45,8991,19,283,16701,787,1949,26,299,2308,2128,7042
1685.508,17,12,498,11,14,168550,14,462,1,8,0,8,36
232.942,6,28,1802,15,38,16625,62,1065,13,31,19396,31,737
0.159,17,2,152,1,48,0,48,76,1,48,0,48,76
1772.42,6,180,15480,120,69,14894,69,8940,60,69,30038,69,6540
50.497,17,4,240,2,32,50496,32,120,2,32,50496,32,120
1737.051,1,56,4704,56,56,31582,56,4704,0,0,0,0,0
33.568,6,30,5064,15,154,2397,721,1881,15,399,2384,2026,3183
0.088,6,10,1495,5,507,21,507,727,5,556,22,556,768
537.379,1,3,168,3,28,268689,28,168,0,0,0,0,0
1772.956,6,180,15480,120,69,14898,69,8940,60,69,30042,69,6540
375.924,6,18,1242,14,180,28917,180,916,4,110,20057,110,326
300.861,6,50,10526,25,433,12535,910,3258,25,312,544,1460,7268
33.469,6,30,5041,14,180,2574,722,1807,16,299,2217,1408,3234
3.285,17,2,656,2,300,3285,300,656,0,0,0,0,0
117.741,6,26,6423,11,220,5630,516,1326,15,374,8402,1452,5097
1797.956,6,356,22589,207,69,8727,69,12420,149,69,12147,69,10169
1.518,6,29,6387,15,164,108,267,1922,14,780,111,1420,4465
108.064,6,30,7432,13,158,9005,267,1317,17,543,6753,1400,6115
0.164,6,22,7096,12,155,14,267,1261,10,905,17,4845,5835
2.882,17,4,268,4,39,960,39,268,0,0,0,0,0
1796.185,17,448,39896,403,35,4468,288,25676,45,288,40021,288,14220
0.118,17,2,586,1,46,0,46,74,1,484,0,484,512
1787.122,6,104,8376,68,65,26673,65,4930,36,59,51056,59,3446
12.385,6,106,34826,53,621,238,1152,28224,53,447,233,1179,6602
20.79,6,22,5790,10,275,2310,275,966,12,1440,1742,1440,4824
0.303,17,2,152,1,48,0,48,76,1,48,0,48,76
100.372,17,4,300,2,47,100371,47,150,2,47,100371,47,150
6.926,6,698,599979,425,1334,15,1368,578655,273,776,24,1473,21324
9.343,6,38,7182,19,214,519,314,2904,19,502,504,1152,4278
280.963,6,34,9637,15,158,20068,267,1397,19,623,15603,1400,8240
1.059,17,4,360,2,30,1014,30,116,2,94,1014,94,244
1797.587,17,462,60699,226,173,7989,1350,45610,236,35,7649,1350,15089
2.996,6,50,19121,28,942,110,1460,13420,22,400,123,1460,5701
1.962,6,51,20748,28,925,72,1360,15028,23,476,77,2720,5720
1767.2,6,129,12758,78,62,22950,721,6403,51,86,35337,1448,6355
1784.814,17,142,11360,71,48,25497,48,5396,71,56,25497,56,5964
1798.279,17,450,39960,405,35,4451,288,25740,45,288,40022,288,14220
0.194,6,40,16845,23,1000,8,1420,11944,17,467,11,1883,4901
319.734,6,47,5896,28,304,11842,304,4208,19,83,17596,83,1688
1.501,6,52,19707,29,909,53,1360,13966,23,437,59,2715,5741
127.265,6,7,418,3,106,63615,106,234,4,0,42412,0,184
12.21,6,1948,1687361,1178,1377,10,1420,1652340,770,467,15,1883,35021
147.922,6,6,394,3,122,77,122,262,3,0,73889,0,132
1796.422,6,164,10288,85,49,21383,208,6198,79,31,23028,31,4090
1.413,17,23,16520,14,994,106,1350,14308,9,217,172,1350,2212
0.063,17,8,1670,8,180,9,219,1670,0,0,0,0,0
0.062,2,2,64,2,8,62,8,64,0,0,0,0,0
1741.417,17,30,31680,30,1028,60048,1028,31680,0,0,0,0,0
1771.87,6,99,9240,66,65,27259,65,5577,33,59,55367,59,3663
4.158,6,39,7269,20,218,218,314,3423,19,513,217,1179,3846
71.882,17,4,304,2,48,71881,64,152,2,48,71881,64,152
0.004,17,4,368,2,64,1,64,184,2,64,3,64,184
1.415,6,49,19959,27,942,54,1460,14303,22,476,58,2615,5656
1773.537,1,58,4872,0,0,0,0,0,58,56,31114,56,4872
41.206,6,25,6757,12,181,3746,267,1212,13,717,3432,2036,5545
0.096,6,10,1495,5,507,24,507,727,5,556,24,556,768
4.992,17,4,558,2,36,4987,36,128,2,187,4988,187,430
249.088,17,10,880,5,48,62269,48,380,5,72,62269,72,500
1785.859,17,142,11360,71,48,25512,48,5396,71,56,25512,56,5964
16.988,2,2,64,2,8,16988,8,64,0,0,0,0,0
0.354,17,8,2742,8,314,50,353,2742,0,0,0,0,0
6.011,17,4,724,2,41,6004,41,138,2,265,6004,265,586
60.393,6,8,432,5,0,15098,0,268,3,0,30101,0,164
1787.235,6,355,22480,207,69,8675,69,12420,148,69,12157,69,10060
1744.658,2,24,768,24,8,75854,8,768,0,0,0,0,0
0.622,6,22,7272,13,319,51,602,1960,9,1209,76,1906,5312
280.427,6,28,7352,12,158,25493,267,1277,16,603,18691,1400,6075
300.678,6,41,8743,22,315,14318,882,2185,19,445,470,2720,6558
1792.535,6,355,22480,207,69,8701,69,12420,148,69,12194,69,10060
1770.731,6,99,9240,66,65,27242,65,5577,33,59,55331,59,3663
97.058,6,46,9961,18,290,2577,1189,2764,28,337,3594,1420,7197
1780.049,6,312,80300,187,718,9570,723,54274,125,156,14355,271,26026
14.16,6,26,4851,14,154,1072,722,1856,12,591,1251,2026,2995
128.178,6,21,6509,11,275,12817,275,723,10,895,14194,1414,5786
1795.09,6,418,36439,232,113,7770,1189,18292,186,138,9702,2086,18147
1679.986,1,15,840,15,28,119999,28,840,0,0,0,0,0
1796.848,17,353,118608,353,308,5104,308,118608,0,0,0,0,0
222.11,17,4,352,2,60,222109,60,176,2,60,222109,60,176
23.809,17,4,304,4,48,7936,48,304,0,0,0,0,0
0.013,6,13,3980,7,88,2,88,388,6,1670,2,2920,3592
0.691,6,10,924,5,283,127,283,551,5,105,115,105,373
1781.807,6,102,8296,68,65,26594,65,4930,34,59,53991,59,3366
271.66,17,4,352,2,60,271659,60,176,2,60,271658,60,176
280.391,6,30,7432,13,158,23365,267,1317,17,603,17521,2760,6115
1732.236,6,94,7480,60,65,29359,65,4350,34,59,52489,59,3130
3.078,17,4,624,4,128,1026,128,624,0,0,0,0,0
12.138,6,1901,1663766,1152,1389,10,1420,1629585,749,467,16,1883,34181
915.941,6,158,25988,78,223,11895,1360,12783,80,181,11592,2720,13205
100.067,17,22,1936,11,48,10006,48,836,11,72,10005,72,1100
1790.187,6,356,22520,208,69,8648,69,12460,148,69,12178,69,10060
280.16,6,29,7392,14,158,21550,267,1357,15,678,20010,4200,6035
280.198,6,30,7432,14,158,21553,267,1357,16,603,18677,1400,6075
0.12,17,2,2380,2,1162,120,1162,2380,0,0,0,0,0
0.063,6,9,1268,5,584,15,584,840,4,212,16,212,428
10.862,17,15,17710,15,1152,775,1450,17710,0,0,0,0,0
1799.701,17,449,39928,404,35,4465,288,25708,45,288,40018,288,14220
0.246,6,29,7376,14,155,18,267,1341,15,543,15,1400,6035
2.129,17,4,518,3,39,558,39,201,1,289,0,289,317
300.813,6,50,15072,26,899,12032,1360,9217,24,325,409,1360,5855
0.031,6,10,520,0,0,0,0,0,10,0,0,0,520
140.906,6,74,51169,47,1192,3063,1408,43031,27,747,2369,1408,8138
4.317,17,29,10824,12,447,392,1350,5705,17,273,209,1350,5119
171.352,6,20,8731,11,334,64,661,1474,9,1377,21403,3928,7257
8.395,6,1659,1524321,1046,1379,7,1408,1487781,613,931,13,2816,36540
1008.875,2,7,224,7,8,168145,8,224,0,0,0,0,0
3.783,6,11,467,6,0,756,0,248,5,7,688,7,219
1.372,17,2,778,2,361,1372,361,778,0,0,0,0,0
0.012,6,32,18994,16,127,0,127,967,16,1322,0,1448,18027
1788.053,1,58,4872,58,56,31369,56,4872,0,0,0,0,0
11.855,6,89,26602,44,550,275,1152,19931,45,442,263,1179,6671
122.145,6,64,41730,40,1171,3131,1448,33727,24,749,2674,1448,8003
4.963,6,38,7245,20,218,261,314,3423,18,516,276,1179,3822
359.211,6,78,48388,45,1174,8163,1448,39944,33,746,1924,1448,8444
3.366,17,27,9056,11,400,336,1350,4718,16,243,212,1350,4338
36.854,17,22,1936,11,48,3684,48,836,11,72,3684,72,1100
1775.636,6,180,15480,120,69,14921,69,8940,60,69,30086,69,6540
143.904,6,48,10622,20,290,7573,1189,2844,28,369,5324,1420,7778
1719.432,17,12,498,11,14,171943,14,462,1,8,0,8,36
175.508,6,13,1156,7,177,29223,177,738,6,110,35068,110,418
280.315,6,29,7392,13,158,23359,267,1317,16,603,18683,1400,6075
1798.281,6,140,15524,86,72,21156,722,7409,54,115,33922,1448,8115
0.066,6,9,1343,5,145,16,145,349,4,830,15,830,994
367.073,6,18,1242,14,180,28236,180,916,4,110,20066,110,326
6.582,6,11,984,5,283,1600,283,551,6,105,1279,105,433
1787.534,17,52,17472,52,308,35049,308,17472,0,0,0,0,0
1.963,6,38,14699,20,529,103,1460,3514,18,804,97,1460,11185
2.245,6,15,2391,9,188,280,245,740,6,703,395,1152,1651
171.4,6,25,10220,13,549,54,1360,2761,12,995,15570,1360,7459
5.833,6,44,8369,22,227,277,314,4062,22,489,265,1179,4307
1745.211,6,95,7203,63,38,28148,205,4476,32,33,56288,98,2727
942.533,6,198,14819,114,124,8341,469,9044,84,69,11231,69,5775
599.612,6,34,9252,21,272,29980,1408,4916,13,608,49957,1955,4336
11.826,6,1856,1602777,1131,1363,10,1380,1569523,725,421,16,1923,33254
6.233,17,2,178,1,29,0,29,57,1,93,0,93,121
179.512,6,42,19264,22,987,2905,1440,10790,20,696,9438,1440,8474
0.013,6,10,1510,5,657,3,657,925,5,317,3,317,585
17.388,6,18,3055,9,75,2173,75,547,9,404,1641,500,2508
1800.0,6,244,16816,94,46,19032,46,7170,150,46,12080,46,9646
0.01,17,3,634,2,32,5,32,120,1,486,0,486,514
37.0,17,3,228,3,48,18500,48,228,0,0,0,0,0
0.799,17,14,7084,7,613,132,1350,4492,7,342,127,1350,2592
5.947,17,12,1032,6,47,1188,47,450,6,69,1188,75,582
348.031,1,24,2496,0,0,0,0,0,24,76,15131,76,2496
61.315,6,37,15910,22,798,2919,1408,9132,15,665,4361,1408,6778
0.023,17,2,417,1,44,0,44,72,1,317,0,317,345
1787.274,17,140,11200,70,48,25902,48,5320,70,56,25902,56,5880
1422.829,6,321,22769,166,108,8623,469,12159,155,53,9239,69,10610
166.078,1,4,240,4,32,55359,32,240,0,0,0,0,0
1.334,6,38,9848,20,502,70,1440,4352,18,433,66,1440,5496
1794.413,17,140,11200,70,48,26005,48,5320,70,56,26005,56,5880
1791.888,17,140,11184,72,48,25237,48,5472,68,56,26744,56,5712
206.703,17,8,2688,8,308,29529,308,2688,0,0,0,0,0
3.785,17,5,295,5,31,946,31,295,0,0,0,0,0
0.053,6,10,1512,5,503,13,503,771,5,473,13,473,741
0.105,17,2,2754,2,1349,105,1349,2754,0,0,0,0,0
0.857,6,11,1727,7,100,142,100,384,4,589,203,1152,1343
3.838,17,5,290,5,30,959,30,290,0,0,0,0,0
163.064,6,25,10909,12,380,85,832,1665,13,968,13575,1360,9244
9.769,6,765,705537,508,1322,18,1368,687509,257,776,37,1473,18028
503.876,2,3,96,3,8,251938,8,96,0,0,0,0,0
1744.801,6,95,7203,63,38,28141,205,4476,32,33,56272,98,2727
1799.23,1,342,28728,342,56,5276,56,28728,0,0,0,0,0
1741.795,6,87,6322,58,31,30557,31,3915,29,31,62206,31,2407
1778.99,6,205,14017,102,67,17601,208,8967,103,31,17440,31,5050
2.123,6,57,24398,32,984,68,1460,17081,25,522,79,2615,7317
1799.979,17,456,55234,213,157,8455,1350,39600,243,36,7437,1350,15634
299.352,17,4,352,2,60,299351,60,176,2,60,299351,60,176
299.032,17,6,1408,3,32,149509,37,181,3,381,149510,419,1227
302.359,6,93,50528,57,1177,5399,1360,43550,36,307,289,2667,6978
240.194,6,47,10392,23,209,10917,834,2692,24,585,10443,2338,7700
29.795,6,12,1313,7,185,4965,185,557,5,244,7441,476,756
0.076,17,2,152,1,48,0,48,76,1,48,0,48,76
718.853,6,145,9181,84,69,8660,69,5016,61,69,11980,69,4165
154.165,6,28,10558,15,412,197,1360,3106,13,1153,12832,2720,7452
1.539,6,52,23331,29,1027,54,1460,17635,23,433,60,1460,5696
16.662,17,19,11805,11,851,1658,1350,9679,8,237,2367,1350,2126
1772.538,6,180,15480,120,69,14895,69,8940,60,69,30039,69,6540
1.344,6,50,19132,28,943,49,1460,13431,22,400,55,1460,5701
0.6,6,24,7437,13,334,50,663,2021,11,967,54,1946,5416
1607.176,6,196,14823,74,66,22014,295,6992,122,48,13282,78,7831
1790.92,1,342,28728,342,56,5251,56,28728,0,0,0,0,0
70.44,6,29,7395,13,155,5870,267,1306,16,453,4695,3417,6089
9.255,6,1470,1275006,903,1362,10,1380,1246149,567,558,16,1923,28857
299.567,6,6,364,4,31,99855,31,222,2,31,299523,31,142
1786.668,6,102,8296,68,65,26666,65,4930,34,59,54137,59,3366
5.072,17,4,288,2,36,5005,36,128,2,52,4903,52,160
0.944,6,27,9272,15,208,67,475,1478,12,1043,69,3926,7794
53.458,17,16,18211,16,1110,3563,1451,18211,0,0,0,0,0
25.558,6,30,7432,13,158,2129,267,1317,17,543,1595,1400,6115
178.578,17,4,352,2,60,178577,60,176,2,60,178577,60,176
7.657,6,16,1563,7,283,1246,283,946,9,105,934,105,617
92.787,6,30,14650,16,488,324,1360,3127,14,1368,7126,3928,11523
1.685,6,25,8757,15,284,120,584,1456,10,985,167,1420,7301
1763.418,2,20,640,20,8,92811,8,640,0,0,0,0,0
1799.396,1,345,28980,345,56,5230,56,28980,0,0,0,0,0
280.51,6,29,7392,12,158,25500,267,1277,17,603,17525,1380,6115
0.043,17,8,2438,8,276,6,315,2438,0,0,0,0,0
534.403,2,6,192,6,8,106880,8,192,0,0,0,0,0
110.238,6,28,6195,12,267,73,502,1286,16,328,7343,1420,4909
24.272,6,36,8319,17,171,1517,722,2055,19,611,1336,1380,6264
0.935,17,2,144,1,36,0,36,64,1,52,0,52,80
279.794,1,4,326,4,53,93264,78,326,0,0,0,0,0
1786.951,6,102,8296,68,65,26670,65,4930,34,59,54145,59,3366
1.763,6,25,8056,12,164,144,267,1288,13,869,131,1448,6768
0.032,17,3,244,2,32,15,32,120,1,96,0,96,124
5.428,6,20,9537,9,275,678,275,639,11,939,487,1414,8898
1074.251,6,65,5170,42,65,26201,65,2980,23,57,48825,59,2190
1.236,6,40,9928,21,440,61,1360,4392,19,476,59,2715,5536
1777.681,17,140,11200,70,48,25763,48,5320,70,56,25763,56,5880
30.828,6,32,8952,14,158,2371,267,1357,18,624,1812,1400,7595
1788.589,1,228,12768,228,28,7879,28,12768,0,0,0,0,0
33.439,6,30,5065,15,154,2388,721,1882,15,399,2376,2026,3183
328.222,17,8,2688,8,308,46888,308,2688,0,0,0,0,0
280.279,6,29,7392,12,158,25479,267,1277,17,543,17515,1400,6115
1784.124,6,104,8376,68,65,26628,65,4930,36,59,50972,59,3446
1770.15,6,99,9240,66,65,27233,65,5577,33,59,55314,59,3663
25.737,6,29,7257,13,155,2144,267,1306,16,441,1715,1420,5951
7.154,6,1118,1030576,688,1423,10,1448,1003552,430,776,16,1448,27024
9.025,6,904,768017,521,1396,16,1448,743437,383,776,23,1448,24580
1729.173,6,63,4601,41,33,43229,33,2825,22,31,82333,31,1776
0.723,6,23,5560,13,121,60,267,1255,10,780,72,1460,4305
1693.626,17,23,8098,23,324,76983,1438,8098,0,0,0,0,0
426.903,6,80,11987,39,137,10913,721,4590,41,337,10668,1440,7397
32.367,6,12,1765,5,229,8019,597,959,7,147,5394,346,806
1.299,6,49,18790,27,858,49,1360,13134,22,476,53,2715,5656
139.159,17,49,10086,33,40,4348,41,2262,16,461,7998,505,7824
2.412,17,4,1560,4,362,804,362,1560,0,0,0,0,0
0.315,1,2,112,2,28,315,28,112,0,0,0,0,0
5.754,6,41,7349,22,218,274,314,3503,19,513,304,1179,3846
1782.111,6,356,22520,207,69,8651,69,12420,149,69,12040,69,10100
1787.786,17,87,3648,86,14,21032,14,3612,1,8,0,8,36
4.173,6,38,7245,19,218,231,314,3383,19,516,218,1179,3862
0.03,6,2,133,1,0,0,0,40,1,53,0,53,93
66.502,6,32,17041,19,1014,3694,1448,9122,13,904,5528,1719,7919
60.626,6,9,771,5,177,15156,177,445,4,110,20058,110,326
557.21,6,84,12217,43,89,13266,267,3610,41,193,13923,1420,8607
146.681,6,78,23941,38,697,3964,1287,13375,40,344,3758,1420,10566
1796.166,17,447,39580,403,35,4468,288,25676,44,288,40949,288,13904
0.165,17,2,268,1,54,0,54,82,1,158,0,158,186
1.338,6,49,19268,27,892,51,1440,13612,22,433,55,1440,5656
4.307,17,28,11515,13,345,358,1350,4856,15,415,301,1350,6659
0.333,6,26,8990,13,247,27,624,1672,13,947,26,1438,7318
239.818,6,29,7392,13,158,19984,267,1317,16,603,15985,1400,6075
75.55,6,24,9887,12,410,61,922,1766,12,953,6854,1696,8121
0.39,6,12,1653,6,288,77,288,548,6,426,42,434,1105
10.986,6,18,4266,10,275,1220,275,958,8,992,885,1440,3308
0.107,17,4,284,2,32,14,32,120,2,54,96,60,164
10.099,6,82,24485,40,550,258,1152,18664,42,459,239,1179,5821
280.305,6,30,7432,13,158,23358,267,1317,17,543,17516,1300,6115
4.756,6,38,7229,19,218,264,314,3383,19,513,248,1179,3846
46.719,17,16,2588,8,48,6672,48,608,8,219,6672,308,1980
1449.41,17,116,9280,58,48,25428,48,4408,58,56,25428,56,4872
1771.378,6,101,9344,66,65,27251,65,5577,35,59,52096,59,3767
820.579,17,66,5280,33,48,25642,48,2508,33,56,25642,56,2772
9.104,6,15,1087,8,275,1300,275,603,7,96,1355,96,484
0.108,17,4,1016,2,64,103,64,184,2,388,102,388,832
0.224,17,2,157,1,31,0,31,59,1,70,0,70,98
0.213,17,2,184,1,32,0,32,60,1,96,0,96,124
1746.3,6,96,7286,63,38,28166,205,4476,33,33,54562,98,2810
0.985,6,2,120,2,0,0,0,120,0,0,0,0,0
338.675,17,23,1900,10,48,25950,48,760,13,59,28222,72,1140
1799.797,17,142,11360,71,48,25711,48,5396,71,56,25711,56,5964
35.332,6,44,9932,22,289,1682,721,3495,22,616,1632,1420,6437
299.562,6,6,364,4,31,99854,31,222,2,31,299538,31,142
0.922,6,10,1687,7,100,153,100,384,3,1179,327,1179,1303
0.258,6,21,5000,11,137,25,267,1132,10,692,27,2800,3868
0.856,6,24,5807,13,156,71,267,1462,11,650,78,1420,4345
0.075,17,3,618,2,32,0,32,120,1,470,0,470,498
247.244,6,43,13667,27,387,9509,1360,6549,16,718,16470,3497,7118
7.959,6,18,6871,9,275,994,275,643,9,1171,691,1440,6228
1773.032,6,180,15480,120,69,14899,69,8940,60,69,30047,69,6540
1770.484,6,102,9473,67,65,26825,65,5694,35,59,52069,59,3779
1062.166,6,89,12558,55,90,19669,501,4370,34,227,32183,1420,8188
6.108,6,10,814,5,103,756,138,407,5,69,1527,69,407
0.015,17,2,574,1,32,0,32,60,1,486,0,486,514
37.104,17,20,1760,10,48,4121,48,760,10,72,4120,72,1000
0.53,6,15,5386,8,965,75,1360,3217,7,269,48,272,2169
2.869,17,18,12570,11,889,286,1350,10093,7,325,330,1350,2477
47.115,6,37,8400,18,378,503,786,1886,19,441,2611,1360,6514
0.025,17,2,2142,2,1043,25,1043,2142,0,0,0,0,0
1773.05,6,180,15480,120,69,14899,69,8940,60,69,30044,69,6540
1.52,6,11,6780,4,170,506,170,398,7,1202,203,1408,6382
0.45,17,8,2758,8,316,64,355,2758,0,0,0,0,0
371.585,6,25,1651,17,177,23224,177,1117,8,110,9219,110,534
0.245,17,3,451,2,39,29,39,134,1,289,0,289,317
1.271,6,50,21161,30,952,43,1360,15540,20,437,58,2720,5621
1743.195,6,95,7203,63,38,28116,205,4476,32,33,56225,98,2727
1740.525,17,29,6699,29,203,62161,203,6699,0,0,0,0,0
7.203,6,172,198838,126,133,57,201,5607,46,4556,155,33936,193231
0.191,6,10,1042,5,213,47,213,417,5,421,38,421,625
15.613,6,2415,2049955,1352,1420,11,1448,1981143,1063,776,14,1448,68812
0.63,6,10,1671,6,552,126,948,1348,4,159,209,159,323
0.006,17,2,204,1,31,0,31,59,1,117,0,117,145
1773.492,6,181,15589,120,69,14903,69,8940,61,69,29550,69,6649
33.507,6,31,5094,15,180,2393,722,1858,16,300,2220,1448,3236
1792.065,6,356,22520,208,69,8657,69,12460,148,69,12190,69,10060
1770.631,6,99,9306,66,66,27240,66,5610,33,60,55328,60,3696
3.091,6,29,8829,17,304,193,663,3325,12,1209,275,1946,5504
1.33,6,41,11051,21,575,66,1360,5475,20,433,60,1360,5576
0.51,17,4,768,2,39,504,39,134,2,289,12,289,634
1746.028,6,97,7307,63,38,28161,205,4476,34,33,52898,98,2831
6.292,6,9,1738,6,95,1207,100,435,3,1179,3019,1179,1303
0.099,6,6,328,4,0,33,0,216,2,0,58,0,112
5.319,17,4,288,2,36,5004,36,128,2,52,4932,52,160
1795.393,17,446,39832,401,35,4488,288,25612,45,288,40022,288,14220
3.237,6,4,228,1,0,0,0,60,3,0,1523,0,168
0.495,6,51,22097,30,1047,17,1380,16982,21,387,22,1923,5115
0.954,6,28,5780,13,125,79,267,1275,15,650,63,1420,4505
1777.391,17,73,3060,72,14,25033,14,3024,1,8,0,8,36
6.11,6,41,13496,20,330,321,722,3120,21,794,295,2760,10376
0.016,17,2,360,1,128,0,128,156,1,176,0,176,204
0.145,17,4,420,2,33,0,33,122,2,121,123,145,298
840.623,17,8,592,4,30,280202,30,232,4,62,280201,62,360
406.908,17,14,4704,14,308,31300,308,4704,0,0,0,0,0
4.633,6,39,7269,19,218,257,314,3383,20,513,230,1179,3886
11.869,6,1796,1624632,1148,1361,10,1432,1594349,648,427,18,1432,30283
32.115,6,9,396,2,0,3483,0,88,7,0,5338,0,308
263.743,17,4,240,2,32,263741,32,120,2,32,263742,32,120
1783.384,17,336,25536,336,48,5323,48,25536,0,0,0,0,0
100.573,6,24,10168,12,549,72,1360,2709,12,1161,9129,2720,7459
1778.979,17,140,11200,70,48,25782,48,5320,70,56,25782,56,5880
1782.112,6,364,25392,212,100,8446,469,14896,152,69,11802,69,10496
1773.817,6,180,15480,120,69,14906,69,8940,60,69,30056,69,6540
252.281,2,3,96,3,8,126140,8,96,0,0,0,0,0
5.792,6,509,424324,307,1314,18,1368,409156,202,776,27,2736,15168
3.139,6,29,10279,15,665,224,1360,3306,14,914,227,2235,6973
1796.391,1,57,4788,57,56,32078,56,4788,0,0,0,0,0
79.148,6,161,115933,93,1304,860,1448,104014,68,631,1178,1448,11919
240.234,6,57,19905,29,851,8579,1418,16836,28,200,8897,580,3069
217.992,6,82,64288,54,1276,907,1360,55837,28,731,8067,1772,8451
1773.204,6,180,15480,120,69,14900,69,8940,60,69,30047,69,6540
1797.931,1,81,6804,81,56,22474,56,6804,0,0,0,0,0
1785.827,17,87,3648,86,14,21009,14,3612,1,8,0,8,36
105.314,6,39,5694,19,148,5850,722,2184,20,224,5532,1408,3510
0.015,17,2,378,1,36,0,36,64,1,286,0,286,314
352.667,6,76,54696,49,1222,7347,1448,46569,27,839,2370,2359,8127
1788.887,17,278,78030,278,252,6458,422,78030,0,0,0,0,0
117.148,6,30,7432,13,158,9762,267,1317,17,543,7318,1400,6115
15.336,6,36,15371,18,537,888,1360,4125,18,1051,892,1360,11246
8.286,17,6,456,6,48,1657,48,456,0,0,0,0,0
0.006,17,2,602,1,46,0,46,74,1,500,0,500,528
1763.918,1,54,4536,54,56,33281,56,4536,0,0,0,0,0
0.601,17,2,152,1,48,0,48,76,1,48,0,48,76
1755.787,6,105,6240,60,26,29758,26,3510,45,26,39903,26,2730
1682.095,17,14,1036,7,30,280343,30,406,7,62,280343,62,630
9.189,6,82,25034,42,550,224,1152,19293,40,459,229,1179,5741
54.268,6,36,8360,18,378,512,786,1886,18,478,3183,2128,6474
1789.513,6,437,43374,239,165,7518,1189,23099,198,128,9081,1452,20275
2.034,6,29,10365,17,367,127,833,1785,12,1012,178,1420,8580
0.092,6,9,1002,5,213,23,213,417,4,421,25,421,585
71.782,6,23,9374,11,304,94,610,1408,12,1067,6508,1360,7966
10.292,6,1654,1409394,995,1363,10,1380,1378804,659,421,15,1923,30590
12.217,17,10,2085,5,34,3050,34,310,5,327,3050,327,1775
0.01,6,5,678,2,316,5,316,420,3,102,3,102,258
1786.876,6,356,22520,208,69,8632,69,12460,148,69,12155,69,10060
37.667,17,22,1936,11,48,3765,48,836,11,72,3764,72,1100
251.969,2,3,96,3,8,125984,8,96,0,0,0,0,0
1773.067,6,180,15480,120,69,14899,69,8940,60,69,30044,69,6540
1677.506,1,21,1176,21,28,83875,28,1176,0,0,0,0,0
0.09,17,2,488,1,60,0,60,88,1,372,0,372,400
5.331,6,38,8442,19,352,296,1352,2906,19,433,285,1460,5536
18.627,17,19,6476,9,432,2324,1350,4146,10,205,2066,1350,2330
1667.771,1,34,4035,34,90,50538,105,4035,0,0,0,0,0
75.636,6,35,7773,14,155,5818,267,1346,21,348,3781,1420,6427
1738.853,6,138,9177,75,59,23498,208,5603,63,31,28039,31,3574
0.319,6,20,7238,12,335,28,668,1974,8,1210,44,1906,5264
379.791,6,21,1422,15,180,27127,180,992,6,110,12276,110,430
0.016,17,2,374,1,47,0,47,75,1,271,0,271,299
86.149,6,102,77396,65,1278,1346,1448,67308,37,741,2387,2359,10088
147.393,6,71,47672,44,1201,3427,1448,39537,27,747,2372,1448,8135
2.173,17,4,1556,4,361,724,361,1556,0,0,0,0,0
37.437,17,11,836,11,48,3743,48,836,0,0,0,0,0
1740.544,1,15,840,15,28,124324,28,840,0,0,0,0,0
10.148,6,2316,2194748,1500,1386,6,1408,2147652,816,931,12,2816,47096
288.729,6,9,558,6,43,57745,43,394,3,0,144361,0,164
1783.81,6,356,22520,208,69,8617,69,12460,148,69,12134,69,10060
137.494,6,23,9138,12,401,89,925,1716,11,1161,13731,2555,7422
1699.814,17,13,534,11,14,169964,14,462,2,8,1699644,8,72
11.49,6,1817,1587085,1102,1386,10,1420,1554252,715,467,16,1883,32833
1691.89,1,8,448,8,28,241698,28,448,0,0,0,0,0
0.008,17,2,520,1,64,0,64,92,1,400,0,400,428
1772.963,6,180,15480,120,69,14898,69,8940,60,69,30045,69,6540
1740.748,17,29,30624,29,1028,62169,1028,30624,0,0,0,0,0
20.14,17,8,1176,4,48,6710,48,304,4,190,6709,308,872
629.45,2,5,160,5,8,157362,8,160,0,0,0,0,0
0.427,6,20,7151,12,318,38,600,1906,8,964,57,1471,5245
38.685,17,11,836,11,48,3868,48,836,0,0,0,0,0
280.238,6,28,7352,13,158,23353,267,1317,15,678,20011,2045,6035
0.272,17,2,384,1,39,0,39,67,1,289,0,289,317
1.809,6,13,2311,8,188,258,245,700,5,1407,386,1407,1611
1777.16,6,105,8610,70,66,25755,66,5110,35,60,52266,60,3500
1.06,6,51,13849,24,549,46,1429,4860,27,464,40,1986,8989
15.015,17,5,380,5,48,3753,48,380,0,0,0,0,0
30.012,17,12,920,6,40,6002,41,412,6,56,5990,57,508
90.462,6,22,5227,5,341,22615,722,1281,17,235,5619,1448,3946
1785.86,6,355,22549,208,69,8627,69,12529,147,69,12231,69,10020
1263.369,2,14,448,14,8,97182,8,448,0,0,0,0,0
240.206,6,51,17789,27,849,9238,1418,15011,24,190,10443,580,2778
524.345,1,14,784,14,28,40334,28,784,0,0,0,0,0
1.668,6,25,8757,15,284,119,584,1456,10,985,165,1420,7301
1622.079,1,110,6160,110,28,14881,28,6160,0,0,0,0,0
1785.744,17,83,3480,82,14,22046,14,3444,1,8,0,8,36
380.068,6,24,1551,14,177,29236,177,913,10,110,10452,110,638
0.089,17,2,144,1,36,0,36,64,1,52,0,52,80
5.138,6,14,2355,7,188,856,245,660,7,703,813,1152,1695
280.428,6,31,7472,13,158,23369,267,1317,18,603,16492,2076,6155
240.131,6,37,4631,19,181,13340,517,2087,18,228,14125,851,2544
151.486,6,25,11178,12,397,78,884,1717,13,992,12612,1460,9461
59.961,2,2,64,2,8,59961,8,64,0,0,0,0,0
0.691,17,8,2750,8,315,98,354,2750,0,0,0,0,0
60.2,2,2,64,2,8,60200,8,64,0,0,0,0,0
29.425,17,20,12070,10,663,3269,1350,6913,10,487,42,1350,5157
305.249,6,526,460826,337,1391,908,1460,446403,189,228,78,1460,14423
0.367,17,2,152,1,48,0,48,76,1,48,0,48,76
300.262,6,39,26634,21,413,15013,1066,2789,18,1761,1823,4224,23845
43.314,17,7,2352,7,308,7219,308,2352,0,0,0,0,0
129.702,6,42,9798,16,231,629,314,3194,26,397,5178,1179,6604
0.033,17,2,144,1,36,0,36,64,1,52,0,52,80
280.236,6,30,7432,13,158,23353,267,1317,17,543,17513,1400,6115
1789.224,6,125,7825,70,44,25930,208,4540,55,31,33126,31,3285
0.866,6,10,1687,7,100,144,100,384,3,1179,309,1179,1303
377.251,6,18,1242,14,180,29019,180,916,4,110,20060,110,326
240.177,6,53,17987,28,798,8895,1402,15042,25,204,10007,580,2945
10.023,6,82,24789,43,560,238,1152,19088,39,459,256,1179,5701
0.218,17,8,2758,8,316,31,355,2758,0,0,0,0,0
0.922,6,11,1727,7,100,153,100,384,4,589,218,1152,1343
1785.853,6,352,22498,202,69,8884,69,12220,150,69,11985,69,10278
1654.65,6,105,12964,60,85,23796,518,4886,45,153,37603,1420,8078
0.431,6,9,1137,5,271,107,271,539,4,191,77,272,598
279.681,17,4,240,2,32,279680,32,120,2,32,279680,32,120
0.027,6,6,716,3,302,9,302,458,3,102,8,102,258
666.312,6,42,3270,22,64,25694,64,1584,20,46,35064,58,1686
5.919,6,40,7602,20,224,311,314,3716,20,440,298,1152,3886
0.35,17,2,152,1,48,0,48,76,1,48,0,48,76
1787.908,17,87,3648,86,14,21034,14,3612,1,8,0,8,36
300.479,6,56,27581,34,393,9105,1018,3433,22,1352,2149,5632,24148
362.857,1,118,9912,118,56,3101,56,9912,0,0,0,0,0
42.515,6,27,7424,8,154,2299,267,792,19,418,2361,1420,6632
3.235,17,13,6912,7,613,539,1350,4491,6,375,565,1350,2421
5.571,6,580,580317,413,1346,13,1368,566969,167,776,32,1473,13348
20.617,17,12,1056,6,48,4121,48,456,6,72,4121,72,600
0.042,17,2,281,1,36,0,36,64,1,189,0,189,217
232.427,1,8,448,8,28,33203,28,448,0,0,0,0,0
22.266,17,4,352,2,60,22265,60,176,2,60,22265,60,176
1799.927,1,16,896,16,28,119995,28,896,0,0,0,0,0
0.209,6,49,24103,29,1053,7,1432,19082,20,467,10,1871,5021
1798.591,1,256,14336,256,28,7053,28,14336,0,0,0,0,0
0.329,1,2,112,2,28,329,28,112,0,0,0,0,0
0.262,6,22,4467,11,165,26,456,1394,11,498,25,888,3073
733.321,6,48,4018,35,64,21568,64,2744,13,58,54145,58,1274
10.024,17,4,704,2,37,10014,37,130,2,259,10014,275,574
0.441,17,18,7373,9,501,55,1350,4764,9,261,47,1350,2609
1.578,6,42,8471,21,321,78,1164,2810,21,400,69,1460,5661
5.237,6,40,7309,21,218,261,314,3463,19,513,276,1179,3846
2.027,6,42,10714,22,517,96,1460,5087,20,370,96,1460,5627
0.892,6,24,5755,13,158,74,370,1315,11,799,88,1420,4440
16.492,17,31,17598,17,707,1028,1350,12507,14,335,1266,1350,5091
1740.048,6,87,6322,58,31,30527,31,3915,29,31,62144,31,2407
354.548,6,92,31405,47,582,7707,1402,11207,45,743,8057,2804,20198
11.837,6,25,8473,13,275,986,275,1078,12,986,851,1440,7395
1745.355,6,95,7203,63,38,28150,205,4476,32,33,56294,98,2727
0.178,6,44,20677,26,1048,7,1414,15736,18,467,9,1889,4941
5.875,6,43,7429,23,218,267,314,3543,20,513,292,1179,3886
61.389,6,37,15941,22,801,2923,1448,9163,15,665,4365,1448,6778
1782.363,6,185,15887,123,69,14609,69,9129,62,69,29216,69,6758
47.296,6,35,8415,17,410,553,882,1942,18,478,2773,2720,6473
0.026,17,2,402,1,41,0,41,69,1,305,0,305,333
33.799,6,33,5199,16,154,2253,722,1912,17,299,2100,1448,3287
86.614,1,4,224,4,28,28871,28,224,0,0,0,0,0
13.933,17,8,608,8,48,1990,48,608,0,0,0,0,0
124.621,17,4,240,2,32,124620,32,120,2,32,124619,32,120
0.035,17,2,241,1,36,0,36,64,1,149,0,149,177
126.149,2,2,64,2,8,126149,8,64,0,0,0,0,0
0.284,6,22,5040,10,137,31,267,1092,12,577,24,1400,3948
32.024,6,6,360,0,0,0,0,0,6,0,0,0,360
744.504,17,85,7389,78,30,9668,37,4552,7,377,113804,463,2837
1.263,6,43,11527,24,547,54,1360,5946,19,437,60,2715,5581
2.015,17,2,148,2,46,2015,46,148,0,0,0,0,0
1630.407,1,8,448,8,28,232915,28,448,0,0,0,0,0
15.381,17,20,13990,12,955,1393,1350,11804,8,245,2187,1350,2186
1789.77,6,380,26584,220,98,8171,469,15423,160,69,11254,69,11161
1.833,6,40,8515,21,268,91,727,1957,19,413,85,1460,6558
1799.184,17,763,46011,763,32,2361,37,46011,0,0,0,0,0
150.273,6,31,13516,17,488,309,1360,3155,14,1087,11548,2568,10361
31.28,17,18,1368,18,48,1840,48,1368,0,0,0,0,0
1741.39,6,81,5886,54,31,32856,31,3645,27,31,66976,31,2241
371.268,6,25,1651,17,177,23204,177,1117,8,110,9215,110,534
8.616,6,27,8507,11,185,861,267,1376,16,589,562,1300,7131
32.324,6,434,356826,205,126,158,301,11219,229,1483,141,2816,345607
0.01,17,2,390,1,32,0,32,60,1,302,0,302,330
126.083,6,15,3203,7,92,21013,92,452,8,388,17973,1448,2751
1739.919,6,91,6604,59,31,29998,31,3998,32,31,56126,31,2606
1738.84,6,87,6322,58,31,30505,31,3915,29,31,62101,31,2407
0.166,17,2,152,1,48,0,48,76,1,48,0,48,76
1790.918,6,354,23061,197,69,9137,69,12158,157,69,11478,69,10903
4.305,6,5,280,2,0,4305,0,100,3,0,1556,0,180
0.371,6,6,328,4,0,123,0,216,2,0,187,0,112
90.15,6,9,472,5,0,22537,0,256,4,0,30048,0,216
1.298,17,11,7755,7,804,216,1350,5828,4,453,337,1350,1927
1777.845,1,342,28728,342,56,5213,56,28728,0,0,0,0,0
11.433,6,1828,1576798,1114,1363,10,1380,1543996,714,421,15,1923,32802
0.592,17,4,314,2,31,571,31,118,2,70,564,70,196
1758.897,17,361,90606,361,222,4885,373,90606,0,0,0,0,0
8.407,6,2185,2001016,1366,1385,6,1408,1953764,819,931,10,2816,47252
1755.348,6,362,25657,202,100,8732,469,14634,160,69,11039,69,11023
1786.813,6,119,13875,75,81,24146,501,5950,44,162,41551,1420,7925
73.344,6,49,13238,26,158,2933,264,1706,23,588,2853,1360,11532
1798.371,1,58,4872,0,0,0,0,0,58,56,31550,56,4872
21.168,17,4,824,2,48,21159,48,152,2,308,21159,308,672
125.996,2,2,64,2,8,125996,8,64,0,0,0,0,0
1792.851,6,356,22520,208,69,8661,69,12460,148,69,12195,69,10060
1795.449,17,448,39896,403,35,4466,288,25676,45,288,40018,288,14220
1.623,1,10,840,10,56,180,56,840,0,0,0,0,0
1782.094,6,356,22520,208,69,8609,69,12460,148,69,12121,69,10060
134.293,17,4,352,2,60,134292,60,176,2,60,134292,60,176
4.514,6,68,26874,35,980,132,1440,16215,33,543,133,1440,10659
8.631,6,18,5532,9,275,1078,275,918,9,1414,954,1414,4614
295.432,6,36,8086,13,158,24619,267,1317,23,365,13427,1400,6769
0.326,17,24,14758,12,750,26,1350,9342,12,423,26,1350,5416
0.262,17,2,2382,2,1163,262,1163,2382,0,0,0,0,0
1798.63,6,356,22520,208,69,8689,69,12460,148,69,12235,69,10060
29.503,6,3566,3373415,2320,1377,12,1408,3303923,1246,931,23,2816,69492
1797.173,6,82,4354,41,26,44928,26,2184,41,26,44928,26,2170
1774.883,17,140,11200,70,48,25722,48,5320,70,56,25722,56,5880
0.248,6,21,7203,12,318,21,600,1906,9,964,29,1471,5297
1709.665,17,187,34228,187,155,9191,422,34228,0,0,0,0,0
1.283,6,48,20301,28,904,47,1360,14725,20,476,58,2715,5576
111.415,17,4,1344,4,308,37138,308,1344,0,0,0,0,0
0.04,1,2,112,2,28,40,28,112,0,0,0,0,0
1786.716,6,157,20723,92,316,19634,316,14592,65,83,27917,83,6131
240.464,6,46,8946,24,523,10454,1418,5970,22,202,11450,640,2976
1773.807,6,356,85351,158,461,11297,1460,65956,198,143,9003,3098,19395
96.181,6,31,7746,11,140,9617,267,1433,20,367,5061,1460,6313
1749.498,6,100,7866,66,45,26915,205,4902,34,35,53003,98,2964
0.007,6,2,92,1,0,0,0,40,1,0,0,0,52
1796.5,17,448,39612,404,35,4457,288,25708,44,288,40954,288,13904
318.718,6,43,8124,16,153,13437,516,1720,27,221,12254,1452,6404
1658.262,1,46,2576,46,28,36850,28,2576,0,0,0,0,0
136.417,17,4,240,2,32,136416,32,120,2,32,136416,32,120
1781.764,6,368,23276,212,69,8444,69,12896,156,69,11495,69,10380
247.382,6,38,4454,17,180,15461,595,1996,21,150,12368,580,2458
1775.502,17,73,3060,72,14,25007,14,3024,1,8,0,8,36
8.379,6,1794,1681864,1151,1384,7,1408,1643764,643,931,12,2816,38100
7.033,6,6,493,4,245,2344,245,409,2,0,251,0,84
0.24,17,4,304,2,48,121,48,152,2,48,121,48,152
0.531,6,52,20948,29,1038,18,1380,15741,23,426,22,3303,5207
0.263,17,2,234,1,41,0,41,69,1,137,0,137,165
70.255,6,12,648,4,0,23418,0,216,8,0,10028,0,432
4.876,6,12,1036,6,283,938,283,603,6,105,938,105,433
1771.655,6,103,9448,66,65,27256,65,5577,37,59,49210,59,3871
1796.445,6,356,22520,208,69,8678,69,12460,148,69,12220,69,10060
1737.465,1,56,4704,0,0,0,0,0,56,56,31590,56,4704
29.037,6,19,5816,10,267,3226,502,1206,9,707,3618,1420,4610
289.175,17,3,1000,3,305,144587,308,1000,0,0,0,0,0
1.992,6,24,5604,13,151,164,380,1281,11,775,197,1460,4323
1779.852,1,342,28728,342,56,5219,56,28728,0,0,0,0,0
282.344,6,29,8792,12,158,25667,267,1277,17,683,17642,1400,7515
3.685,17,4,240,4,32,1228,32,240,0,0,0,0,0
1.291,6,27,6307,14,164,99,267,1882,13,780,94,1460,4425
0.88,17,3,1167,3,361,440,361,1167,0,0,0,0,0
283.371,17,4,352,2,60,283370,60,176,2,60,283369,60,176
1.438,6,41,8429,21,320,71,1162,2808,20,400,65,1360,5621
2.528,17,4,1568,4,364,842,364,1568,0,0,0,0,0
1787.313,6,102,8364,68,66,26676,66,4964,34,60,54157,60,3400
0.279,6,159,144951,61,278,4,517,4331,98,1441,2,2880,140620
22.642,6,11,640,4,0,7547,0,220,7,0,2874,0,420
280.489,6,31,7472,13,158,23374,267,1317,18,543,16495,1380,6155
12.019,17,20,4031,10,37,1334,37,650,10,310,1335,348,3381
377.248,6,18,1242,14,180,29019,180,916,4,110,20063,110,326
413.796,17,84,15652,42,48,10092,48,3192,42,268,10092,308,12460
14.957,6,2676,2606600,1786,1384,8,1408,2555644,890,776,16,1408,50956
1.644,6,49,19621,27,918,63,1360,13965,22,476,69,2715,5656
75.429,17,4,352,2,60,75428,60,176,2,60,75427,60,176
0.665,17,2,152,1,48,0,48,76,1,48,0,48,76
13.145,6,32,13724,17,498,821,721,3675,15,1180,907,1440,10049
64.149,6,65,21561,31,872,2138,1440,15271,34,341,1892,1440,6290
0.317,6,22,4442,11,165,31,456,1394,11,493,30,888,3048
0.105,17,2,602,1,46,0,46,74,1,500,0,500,528
126.33,6,34,7935,12,155,30,267,1266,22,340,6015,3417,6669
0.013,17,2,588,1,39,0,39,67,1,493,0,493,521
1795.618,17,142,11360,71,48,25651,48,5396,71,56,25651,56,5964
366.976,6,21,1422,15,180,26212,180,992,6,110,12238,110,430
33.401,1,4,224,4,28,11133,28,224,0,0,0,0,0
1796.324,17,449,39928,404,35,4457,288,25708,45,288,40022,288,14220
0.015,17,2,158,1,34,0,34,62,1,68,0,68,96
0.405,17,2,221,1,35,0,35,63,1,130,0,130,158
1791.473,6,356,22520,208,69,8654,69,12460,148,69,12186,69,10060
1770.208,6,101,9344,66,65,27233,65,5577,35,59,52061,59,3767
1757.014,1,81,6804,81,56,21962,56,6804,0,0,0,0,0
0.454,6,9,1340,5,145,113,145,349,4,827,146,827,991
5.855,6,14,6248,5,215,1462,267,854,9,1005,731,3417,5394
240.197,6,36,7713,20,138,12641,517,2028,16,807,16012,1408,5685
130.806,6,22,4396,8,296,1471,722,1313,14,261,10047,1408,3083
11.934,6,25,8473,13,275,994,275,1078,12,986,892,1440,7395
1772.482,6,204,22330,130,75,13740,267,10057,74,132,24277,1460,12273
22.701,17,15,7566,7,535,3778,1350,3942,8,425,3238,1350,3624
0.077,17,2,588,1,39,0,39,67,1,493,0,493,521
530.695,6,9,546,6,31,106139,31,333,3,31,265342,31,213
0.0,17,1,194,1,166,0,166,194,0,0,0,0,0
6.504,6,26,10127,14,528,500,1024,3234,12,800,575,1360,6893
2.46,6,14,1640,7,256,406,256,1052,7,304,407,304,588
1753.898,1,8,448,8,28,250556,28,448,0,0,0,0,0
137.19,6,22,8516,11,315,68,638,1419,11,949,13706,1440,7097
1.231,6,50,18824,27,858,47,1360,13128,23,433,47,1360,5696
145.534,17,6,528,3,60,72766,60,264,3,60,72766,60,264
1772.314,6,203,22290,130,75,13738,267,10057,73,134,24612,2009,12233
110.406,17,4,1344,4,308,36802,308,1344,0,0,0,0,0
0.006,17,2,371,1,65,0,65,93,1,250,0,250,278
0.124,17,2,154,1,33,0,33,61,1,65,0,65,93
1797.25,1,345,28980,345,56,5224,56,28980,0,0,0,0,0
11.844,6,25,8453,13,275,987,275,1078,12,983,868,1420,7375
1799.76,17,449,39928,404,35,4465,288,25708,45,288,40019,288,14220
0.168,17,4,420,2,33,0,33,122,2,121,2,145,298
1775.571,6,180,15480,120,69,14920,69,8940,60,69,30089,69,6540
0.897,6,10,1687,7,100,149,100,384,3,1179,317,1179,1303
1.744,17,17,10367,9,888,213,1350,8247,8,237,243,1350,2120
1763.077,17,150,24194,150,133,11832,373,24194,0,0,0,0,0
11.678,6,30,13935,18,304,686,597,1713,12,1466,1045,4441,12222
1771.037,6,99,9306,66,66,27246,66,5610,33,60,55342,60,3696
182.577,17,12,4168,12,319,16597,548,4168,0,0,0,0,0
644.796,6,140,17104,64,131,10233,1189,5992,76,206,8581,1420,11112
1789.95,6,371,25810,215,99,8364,469,15154,156,69,11548,69,10656
0.87,6,10,1687,7,100,145,100,384,3,1179,309,1179,1303
1.592,6,13,2311,8,188,227,245,700,5,1407,331,1407,1611
0.122,6,10,1495,5,507,30,507,727,5,556,30,556,768
0.092,17,2,138,1,33,0,33,61,1,49,0,49,77
1773.237,6,181,15589,120,69,14901,69,8940,61,69,29549,69,6649
11.672,6,1852,1611758,1122,1381,10,1420,1578337,730,467,15,1883,33421
1771.234,6,125,11402,76,66,23616,66,6466,49,60,36898,60,4936
17.07,17,4,352,2,60,17069,60,176,2,60,17069,60,176
71.751,6,37,8456,18,360,891,766,1881,19,446,3976,2720,6575
0.226,6,46,21816,27,1049,8,1420,16835,19,467,12,1883,4981
1.784,17,2,178,1,29,0,29,57,1,93,0,93,121
1779.678,17,142,11360,71,48,25423,48,5396,71,56,25423,56,5964
0.539,17,4,284,2,32,0,32,120,2,54,0,60,164
7.392,6,1757,1633510,1086,1424,6,1448,1593930,671,776,10,1448,39580
1.261,6,48,19509,27,912,48,1360,13893,21,476,54,2715,5616
48.464,6,28,7217,13,155,4038,267,1306,15,482,3460,2840,5911
0.172,6,25,7216,13,155,14,267,1301,12,678,14,3436,5915
1648.51,1,24,1344,24,28,71674,28,1344,0,0,0,0,0
1794.375,17,140,11200,70,48,26005,48,5320,70,56,26005,56,5880
0.298,17,14,5825,6,395,59,1350,2538,8,382,32,1350,3287
243.539,17,6,525,3,32,121761,37,181,3,86,121761,136,344
1.297,6,48,20070,28,889,48,1360,14494,20,476,57,2720,5576
1798.24,17,448,39896,403,35,4473,288,25676,45,288,40018,288,14220
11.079,6,18,7870,9,275,1384,275,643,9,1371,1333,1440,7227
5.07,6,7,400,3,0,2535,0,160,4,0,1340,0,240
521.962,17,30,10080,30,308,17998,308,10080,0,0,0,0,0
0.938,6,23,7409,14,334,72,663,2097,9,806,110,1368,5312
0.112,6,13,2100,8,329,16,500,1082,5,750,28,750,1018
0.521,6,12,1793,6,288,71,288,608,6,432,71,446,1185
12.462,6,1864,1709708,1207,1365,10,1432,1677230,657,559,18,1871,32478
0.158,6,45,22209,27,1077,6,1420,17268,18,526,8,3303,4941
1.336,6,29,6387,15,164,95,267,1922,14,780,90,1460,4465
0.567,17,14,6927,7,614,94,1350,4495,7,319,89,1350,2432
0.036,17,2,198,1,37,0,37,65,1,105,0,105,133
1792.387,17,142,11360,71,48,25604,48,5396,71,56,25604,56,5964
8.533,17,6,528,3,48,4261,48,228,3,72,4261,72,300
1787.24,6,104,8366,68,63,26675,64,4868,36,57,51061,58,3498
1787.907,6,371,26086,212,99,8473,469,14965,159,69,11315,69,11121
1790.822,1,342,28728,342,56,5251,56,28728,0,0,0,0,0
21.753,17,22,6564,11,358,2172,1350,4250,11,182,2172,1350,2314
0.083,17,2,380,1,39,0,39,67,1,285,0,285,313
0.154,6,9,1343,5,145,38,145,349,4,830,30,830,994
1793.822,17,87,3648,86,14,21103,14,3612,1,8,0,8,36
0.021,17,2,167,1,39,0,39,67,1,72,0,72,100
1799.975,17,488,123985,488,226,3696,453,123985,0,0,0,0,0
282.203,17,4,352,2,60,282202,60,176,2,60,282201,60,176
6.901,6,29,7464,12,155,627,267,1266,17,423,430,3417,6198
1770.475,6,101,9410,66,66,27238,66,5610,35,60,52069,60,3800
1693.702,1,8,448,8,28,241957,28,448,0,0,0,0,0
280.039,6,30,7432,14,158,21541,267,1357,16,603,18666,1400,6075
23.456,6,36,8299,17,175,1466,722,2086,19,681,1291,2760,6213
3.18,6,5,232,2,0,3180,0,88,3,0,1511,0,144
1743.294,6,95,7203,63,38,28117,205,4476,32,33,56228,98,2727
1742.051,6,96,7255,62,38,28558,205,4424,34,33,52780,98,2831
553.321,17,84,6384,84,48,6666,48,6384,0,0,0,0,0
1795.393,17,80,3354,79,14,23017,14,3318,1,8,0,8,36
111.404,6,21,8279,11,525,96,1237,2048,10,969,12355,1791,6231
1784.472,6,104,8376,68,65,26633,65,4930,36,59,50981,59,3446
1784.159,6,416,24920,208,69,8619,69,12460,208,34,8619,64,12460
300.5,6,57,27608,34,393,9106,1018,3445,23,1275,1695,4133,24163
0.232,6,12,3462,6,75,46,75,395,6,1373,46,1448,3067
2.002,17,6,360,3,32,1000,32,180,3,32,1000,32,180
9.452,6,67,21334,34,562,286,1152,15419,33,573,287,1179,5915
596.191,6,96,12343,50,83,12163,721,4589,46,256,13245,1414,7754
368.959,6,27,1767,18,177,21703,177,1181,9,110,8607,110,586
300.595,6,45,10357,23,308,13663,889,2271,22,423,402,1360,8086
3.789,17,10,1415,5,31,943,31,295,5,196,944,196,1120
0.12,17,4,1223,4,277,40,316,1223,0,0,0,0,0
1798.011,1,228,24168,228,78,7920,78,24168,0,0,0,0,0
1790.622,17,144,11520,72,48,25219,48,5472,72,56,25219,56,6048
1799.503,17,449,39928,404,35,4465,288,25708,45,288,40014,288,14220
14.806,17,12,2000,6,48,2958,48,456,6,229,2958,308,1544
1797.97,6,356,22520,208,69,8685,69,12460,148,69,12231,69,10060
1741.405,6,95,6867,61,31,29023,31,4145,34,31,52769,31,2722
0.178,17,2,152,2,48,178,48,152,0,0,0,0,0
1774.992,17,140,11200,70,48,25724,48,5320,70,56,25724,56,5880
1730.155,6,399,69471,162,295,10746,1440,39379,237,160,7328,1702,30092
45.431,6,35,8190,17,334,538,688,1716,18,478,2665,2720,6474
37.147,6,34,8423,17,410,553,882,1990,17,521,2311,3488,6433
32.578,6,201,232232,53,122,626,288,3122,148,1526,221,2804,229110
86.702,17,3,228,3,48,43351,48,228,0,0,0,0,0
0.016,17,2,491,1,40,0,40,68,1,395,0,395,423
1744.66,2,27,864,27,8,67102,8,864,0,0,0,0,0
0.331,6,28,7037,17,242,20,645,2383,11,701,32,1734,4654
15.037,17,15,11482,8,818,2143,1350,6773,7,644,2504,1350,4709
0.301,17,2,152,1,48,0,48,76,1,48,0,48,76
6.062,6,1403,1271979,871,1382,6,1408,1239651,532,931,11,2816,32328
15.228,17,14,7577,8,664,2169,1350,5541,6,311,3036,1350,2036
1788.961,17,140,11200,70,48,25926,48,5320,70,56,25926,56,5880
0.218,6,20,4960,10,137,24,267,1092,10,692,23,1467,3868
1684.568,2,14,448,14,8,129582,8,448,0,0,0,0,0
1773.241,6,185,16756,123,75,14534,485,9614,62,75,29065,453,7142
1.658,6,40,9928,21,440,82,1360,4392,19,476,80,2715,5536
1.363,6,50,18935,27,865,52,1360,13239,23,433,53,1360,5696
1773.997,17,140,11200,70,48,25709,48,5320,70,56,25709,56,5880
1799.377,6,142,9784,78,64,23366,208,6201,64,31,28558,31,3583
0.227,6,9,1148,5,145,56,145,349,4,635,54,635,799
1784.654,17,142,11360,71,48,25495,48,5396,71,56,25495,56,5964
46.703,17,4,352,2,60,46701,60,176,2,60,46702,60,176
299.098,1,4,326,4,53,99699,78,326,0,0,0,0,0
1707.543,17,25,1738,16,30,113831,30,928,9,62,211421,62,810
1.404,6,50,19146,27,881,54,1360,13450,23,433,55,1360,5696
1737.018,1,57,4788,57,56,31018,56,4788,0,0,0,0,0
4.902,17,2,656,2,300,4902,300,656,0,0,0,0,0
240.161,6,54,16191,29,686,8576,1402,13193,25,211,10006,580,2998
1797.987,17,449,39928,404,35,4461,288,25708,45,288,40018,288,14220
15.124,17,11,4313,5,414,3771,1350,2211,6,322,3017,1350,2102
232.51,6,54,9489,27,117,8942,267,2615,27,304,8942,1460,6874
1800.0,6,228,19815,84,78,21325,339,8940,144,70,12587,1062,10875
259.409,6,31,8912,14,158,19954,267,1357,17,687,16209,1400,7555
1776.554,6,182,15698,120,69,14929,69,8940,62,69,29115,69,6758
1740.487,17,29,30624,29,1028,62160,1028,30624,0,0,0,0,0
1358.982,6,295,25024,169,156,8089,965,14594,126,94,10871,485,10430
1.463,6,47,18528,27,845,56,1360,12952,20,476,66,2715,5576
240.19,6,52,17623,27,793,9237,1402,14896,25,177,10007,580,2727
1724.522,1,8,448,8,28,246360,28,448,0,0,0,0,0
16.75,6,25,4662,13,275,1395,275,1086,12,768,1088,1440,3576
1782.532,6,354,22440,207,69,8653,69,12420,147,69,12208,69,10020
1.138,6,25,9552,14,350,87,1041,1992,11,1015,91,1460,7560
1794.125,17,80,3354,79,14,23001,14,3318,1,8,0,8,36
124.713,6,27,3482,10,183,13856,517,1457,17,381,7794,499,2025
825.862,6,67,10044,37,111,18051,498,3383,30,202,28475,1420,6661
280.369,6,26,7272,12,158,25488,267,1277,14,678,21564,2045,5995
2.451,6,61,23131,33,907,76,1440,14121,28,492,83,1440,9010
71.426,6,13,1079,12,43,6493,43,1019,1,0,0,0,60
114.049,17,3,225,3,47,57024,47,225,0,0,0,0,0
5.17,6,5,232,2,0,5170,0,88,3,0,1514,0,144
1796.394,6,362,22967,209,69,8636,69,12638,153,69,11815,69,10329
125.916,2,2,64,2,8,125916,8,64,0,0,0,0,0
1.201,6,25,8056,12,164,92,267,1288,13,869,85,1440,6768
1.491,6,49,19248,27,891,57,1360,13592,22,476,61,2715,5656
1.243,6,43,14969,24,767,54,1360,9433,19,476,59,2715,5536
11.818,6,1870,1633889,1132,1389,10,1420,1600112,738,467,16,1883,33777
0.328,17,2,152,1,48,0,48,76,1,48,0,48,76
34.034,17,20,1760,10,48,3780,48,760,10,72,3780,72,1000
150.316,17,9,684,9,48,18789,48,684,0,0,0,0,0
3.648,17,5,295,5,31,912,31,295,0,0,0,0,0
218.306,17,4,352,2,60,218305,60,176,2,60,218305,60,176
0.075,17,2,152,1,48,0,48,76,1,48,0,48,76
0.225,6,9,1339,5,145,56,145,349,4,826,46,826,990
1790.713,17,83,3480,82,14,22107,14,3444,1,8,0,8,36
655.223,17,174,18809,84,133,7894,1350,13541,90,30,6831,60,5268
118.625,6,20,8483,11,549,88,1308,2119,9,1198,14805,3151,6364
1770.636,17,168,13986,156,30,11423,37,9090,12,380,155533,463,4896
0.201,17,7,2445,7,321,33,355,2445,0,0,0,0,0
9.937,17,76,9255,21,182,496,1350,4416,55,59,183,1350,4839
7.524,6,34,4897,18,195,442,293,2293,16,390,483,1152,2604
1785.647,17,142,11360,71,48,25509,48,5396,71,56,25509,56,5964
231.653,17,4,288,2,36,231636,36,128,2,52,231632,52,160
804.984,1,41,2296,41,28,20124,28,2296,0,0,0,0,0
4.663,6,38,7245,19,218,259,314,3383,19,516,245,1179,3862
1684.411,17,16,3641,16,199,112294,673,3641,0,0,0,0,0
298.495,1,4,326,4,53,99498,78,326,0,0,0,0,0
1744.017,6,95,7203,63,38,28129,205,4476,32,33,56244,98,2727
124.284,6,6,1255,4,327,41428,413,814,2,180,124094,269,441
300.621,6,37,8431,19,291,16701,786,1957,18,478,496,2720,6474
123.987,6,12,934,2,31,349,31,135,10,31,13757,31,799
1772.71,6,180,15480,120,69,14896,69,8940,60,69,30043,69,6540
12.627,6,33,11441,12,125,1147,126,1278,21,925,283,1440,10163
93.593,6,34,7733,16,131,6239,267,1702,18,482,5495,1933,6031
1796.082,17,450,39960,405,35,4445,288,25740,45,288,40018,288,14220
251.234,2,2,64,2,8,251234,8,64,0,0,0,0,0
47.783,17,4,352,2,60,47782,60,176,2,60,47782,60,176
8.489,6,7,414,3,31,4244,31,175,4,31,2740,31,239
0.214,17,4,284,2,32,0,32,120,2,54,0,60,164
1789.738,6,356,22520,208,69,8646,69,12460,148,69,12174,69,10060
25.13,1,31,3224,0,0,0,0,0,31,76,837,76,3224
1763.712,17,275,43735,275,131,6436,357,43735,0,0,0,0,0
0.55,6,22,7333,13,334,45,663,2021,9,1209,63,1946,5312
240.228,6,56,20082,31,780,8007,1418,17220,25,222,10008,580,2862
142.042,6,29,7392,13,158,11836,267,1317,16,603,9466,2800,6075
155.101,6,53,14105,23,168,7050,267,2445,30,580,5347,1400,11660
2.485,6,22,6419,10,268,271,517,1333,12,744,221,1418,5086
300.217,6,33,17329,21,989,15010,1408,11985,12,785,5563,1491,5344
58.462,6,37,10658,20,248,3076,722,2799,17,870,3645,2514,7859
1090.821,17,216,16416,216,48,5073,48,16416,0,0,0,0,0
1797.659,17,449,39928,404,35,4460,288,25708,45,288,40019,288,14220
0.016,17,2,255,1,31,0,31,59,1,168,0,168,196
367.188,6,23,1535,16,177,24479,177,1053,7,110,10362,110,482
0.411,17,3,543,2,39,406,39,134,1,381,0,381,409
0.137,6,9,1340,5,145,34,145,349,4,827,30,827,991
1.474,6,9,1002,5,213,368,213,417,4,421,382,421,585
1798.402,6,367,25650,214,99,8443,469,15045,153,69,11829,69,10605
1800.0,6,380,26238,163,46,10925,46,10566,217,46,8333,46,15672
120.33,2,3,96,3,8,60165,8,96,0,0,0,0,0
0.561,6,10,968,5,256,133,256,460,5,304,130,304,508
1772.229,6,240,17880,120,69,14892,69,8940,120,34,14892,48,8940
1783.18,17,83,3480,82,14,22014,14,3444,1,8,0,8,36
1797.59,17,448,39896,403,35,4471,288,25676,45,288,40015,288,14220
2.982,6,2,88,2,0,0,0,88,0,0,0,0,0
0.059,17,4,588,2,48,50,48,152,2,190,47,308,436
1743.331,6,99,7442,64,38,27671,205,4528,35,33,51267,98,2914
0.628,6,14,1745,7,288,73,288,600,7,426,70,434,1145
1771.34,6,102,9540,67,66,26838,66,5728,35,60,52095,60,3812
240.245,6,53,15251,27,678,9239,1418,12274,26,202,9609,580,2977
1740.808,17,30,7050,30,207,60027,207,7050,0,0,0,0,0
12.244,1,4,224,4,28,4081,28,224,0,0,0,0,0
275.654,17,4,352,2,60,275652,60,176,2,60,275652,60,176
1738.961,1,56,4704,56,56,31617,56,4704,0,0,0,0,0
1748.133,6,95,7203,63,38,28195,205,4476,32,33,56383,98,2727
0.112,17,2,136,1,32,0,32,60,1,48,0,48,76
42.62,17,46,6644,23,48,1935,48,1748,23,184,1934,308,4896
1679.544,17,12,498,11,14,167954,14,462,1,8,0,8,36
1789.141,6,389,23840,207,69,8685,69,12420,182,44,9884,69,11420
4.321,6,38,7245,19,218,240,314,3383,19,516,224,1179,3862
33.728,6,95,73038,38,612,911,1360,4614,57,1271,599,1360,68424
0.019,6,2,80,1,0,0,0,40,1,0,0,0,40
0.036,17,4,352,2,37,0,37,130,2,83,9,89,222
0.567,6,21,7290,12,335,50,668,1974,9,968,70,1475,5316
0.429,6,27,9120,13,266,35,705,1750,14,829,31,1438,7370
280.303,6,30,7432,13,158,23358,267,1317,17,543,17514,1300,6115
521.811,17,104,7904,104,48,5066,48,7904,0,0,0,0,0
12.342,1,28,784,28,0,0,0,784,0,0,0,0,0
65.303,6,46,10532,24,612,2831,1360,4726,22,351,3101,4027,5806
0.305,6,28,7336,13,155,25,267,1301,15,543,16,1400,6035
174.79,6,63,14943,29,191,6236,721,4043,34,529,5291,1440,10900
0.121,17,2,396,1,39,0,39,67,1,301,0,301,329
1780.183,17,370,93320,370,224,4824,422,93320,0,0,0,0,0
19.084,1,16,1664,0,0,0,0,0,16,76,1272,76,1664
39.577,17,22,1936,11,48,3957,48,836,11,72,3956,72,1100
240.327,6,43,9039,21,524,12015,1418,5816,22,230,11443,618,3223
164.792,6,25,10133,12,531,60,1360,2681,13,988,13722,1360,7452
65.685,6,24,9834,12,410,54,922,1742,12,950,5959,1696,8092
0.435,6,20,7229,13,334,36,663,2021,7,1209,66,1946,5208
49.245,6,15,1375,6,275,9849,275,523,9,96,6119,96,852
1720.462,17,12,498,11,14,172046,14,462,1,8,0,8,36
8.178,6,173,121503,105,1208,78,1460,80380,68,1163,119,1580,41123
61.162,6,29,7257,14,155,4704,267,1346,15,482,4368,1997,5911
8.006,6,23,10902,11,275,800,275,723,12,1210,706,1440,10179
16.77,17,43,9879,18,236,984,1350,4765,25,176,697,1350,5114
11.753,6,25,8453,13,275,979,275,1078,12,983,824,1420,7375
962.586,2,8,256,8,8,137512,8,256,0,0,0,0,0
299.705,6,40,9975,21,590,14975,1360,4413,19,399,16639,1360,5562
29.558,6,3270,3018232,1990,1430,14,1448,2939200,1280,776,22,1448,79032
1.106,6,23,7952,11,164,94,267,1236,12,1014,85,2423,6716
1766.681,1,58,4872,58,56,30994,56,4872,0,0,0,0,0
1793.366,17,179,11456,179,36,10075,36,11456,0,0,0,0,0
1772.806,6,180,15480,120,69,14897,69,8940,60,69,30043,69,6540
543.889,6,72,9392,37,304,15108,304,6188,35,83,15958,83,3204
1.207,6,29,11148,14,164,78,267,1460,15,988,73,1408,9688
1773.558,6,181,15589,120,69,14903,69,8940,61,69,29554,69,6649
1740.733,17,27,6345,27,207,66951,207,6345,0,0,0,0,0
1.372,17,4,334,2,39,707,39,134,2,72,0,72,200
14.732,17,4,352,2,60,14731,60,176,2,60,14731,60,176
1.295,6,40,9928,21,440,64,1360,4392,19,476,62,2715,5536
1771.779,6,99,9306,66,66,27258,66,5610,33,60,55365,60,3696
15.71,17,10,880,5,48,3924,48,380,5,72,3923,72,500
256.525,6,322,241006,185,1305,1394,1368,222441,137,641,1002,2736,18565
0.171,6,3,132,2,0,4,0,92,1,0,0,0,40
1787.628,6,102,8296,68,65,26681,65,4930,34,59,54166,59,3366
3.93,6,1035,1047556,515,348,7,351,30321,520,1930,7,4104,1017235
1772.252,1,61,5124,61,56,29537,56,5124,0,0,0,0,0
136.228,6,25,10829,12,380,72,832,1665,13,959,11341,1440,9164
1637.208,1,8,848,8,78,233886,78,848,0,0,0,0,0
1794.04,1,222,23532,222,78,8117,78,23532,0,0,0,0,0
0.909,17,2,685,1,308,0,308,336,1,321,0,321,349
0.477,6,11,3652,6,171,89,171,491,5,1446,108,2675,3161
1794.333,17,85,3564,84,14,21618,14,3528,1,8,0,8,36
2.785,6,35,22345,23,760,126,1360,6349,12,2214,240,7551,15996
143.695,6,30,16842,16,461,50,1062,2105,14,1416,11042,3412,14737
411.557,6,41,7575,20,151,9593,501,1865,21,286,20573,1420,5710
577.754,17,19,6880,19,334,32097,382,6880,0,0,0,0,0
1799.412,17,449,39928,404,35,4465,288,25708,45,288,40015,288,14220
240.132,6,36,6592,19,158,13340,517,2107,17,718,15007,2684,4485
298.999,6,74,8550,35,156,8793,585,4384,39,150,7868,580,4166
1762.814,6,78,4056,39,0,46381,0,2028,39,0,46381,0,2028
1773.258,17,140,11200,70,48,25699,48,5320,70,56,25699,56,5880
0.09,17,2,152,1,48,0,48,76,1,48,0,48,76
1797.111,1,345,28980,345,56,5224,56,28980,0,0,0,0,0
0.085,17,2,116,1,30,0,30,58,1,30,0,30,58
20.117,17,4,5480,4,1342,6705,1347,5480,0,0,0,0,0
574.32,17,10,880,5,48,143577,48,380,5,72,143577,72,500
1764.781,2,15,480,15,8,126055,8,480,0,0,0,0,0
0.096,17,2,394,1,46,0,46,74,1,292,0,292,320
4.373,2,2,64,2,8,4373,8,64,0,0,0,0,0
1769.84,6,99,9240,66,65,27228,65,5577,33,59,55304,59,3663
239.548,6,39,8780,22,301,11407,588,1839,17,520,614,4848,6941
481.315,2,7,224,7,8,80219,8,224,0,0,0,0,0
1769.761,6,101,9410,66,66,27227,66,5610,35,60,52048,60,3800
0.512,6,25,6081,13,108,42,147,959,12,773,45,1608,5122
280.194,6,30,7432,13,158,23349,267,1317,17,543,17511,1400,6115
1789.767,6,174,20823,87,87,20811,517,6770,87,261,20793,1418,14053
1772.448,6,180,15480,120,69,14894,69,8940,60,69,30032,69,6540
0.018,17,2,410,1,63,0,63,91,1,291,0,291,319
0.37,17,2,154,1,33,0,33,61,1,65,0,65,93
4.478,6,39,7285,20,218,235,314,3423,19,516,234,1179,3862
281.007,6,27,7312,13,158,23417,267,1317,14,775,21604,4836,5995
39.792,17,22,1672,22,48,1894,48,1672,0,0,0,0,0
0.0,17,4,1379,4,316,0,355,1379,0,0,0,0,0
0.06,6,9,533,5,45,15,45,313,4,0,19,0,220
41.446,6,39,8538,19,350,484,734,1854,20,419,2174,1460,6684
0.427,6,28,7048,17,244,26,656,2394,11,701,41,1696,4654
11.669,6,1845,1612378,1116,1391,10,1420,1578997,729,467,16,1883,33381
1793.563,17,143,11436,72,48,25259,48,5472,71,56,25621,56,5964
1777.746,17,140,11200,70,48,25764,48,5320,70,56,25764,56,5880
604.931,1,9,1133,9,97,75616,117,1133,0,0,0,0,0
24.152,17,46,8917,20,126,1269,1350,3088,26,196,964,1350,5829
64.128,6,16,760,4,0,21376,0,200,12,7,5641,7,560
366.208,6,27,1767,18,177,21541,177,1181,9,110,8533,110,586
1781.765,6,364,23047,211,69,8484,69,12787,153,69,11722,69,10260
99.954,6,985,492124,540,843,185,1152,469533,445,435,224,1179,22591
195.609,17,10,580,10,30,21734,30,580,0,0,0,0,0
1.146,17,6,552,3,32,572,32,180,3,96,554,96,372
0.345,6,24,4571,12,165,31,456,1446,12,415,29,888,3125
0.12,6,10,767,5,186,22,186,454,5,45,25,45,313
1775.373,1,9,504,9,28,221921,28,504,0,0,0,0,0
10.091,6,746,647813,459,1339,21,1368,628213,287,776,34,1473,19600
1781.315,17,142,11360,71,48,25447,48,5396,71,56,25447,56,5964
11.966,17,3,984,3,300,5983,300,984,0,0,0,0,0
1799.197,6,377,26726,218,103,8291,469,15881,159,69,11385,69,10845
1752.933,6,187,11425,94,47,18848,208,6806,93,31,19050,31,4619
41.658,1,45,4680,0,0,0,0,0,45,76,946,76,4680
3.843,17,2,778,2,361,3843,361,778,0,0,0,0,0
280.028,6,28,7352,13,158,23335,267,1317,15,678,19999,3436,6035
0.128,17,2,672,2,308,128,308,672,0,0,0,0,0
0.625,6,15,2638,8,288,79,288,640,7,568,74,853,1998
1740.448,17,30,31680,30,1028,60015,1028,31680,0,0,0,0,0
0.557,6,10,924,5,283,96,283,551,5,105,96,105,373
81.465,6,22,2174,9,181,10183,181,826,13,166,6611,206,1348
1.485,6,31,6467,15,164,106,267,1922,16,650,87,1380,4545
0.806,17,4,952,2,39,523,39,134,2,381,288,381,818
976.268,6,56,5193,31,41,30098,205,2282,25,64,40670,131,2911
1787.623,6,102,8364,68,66,26680,66,4964,34,60,54166,60,3400
175.578,17,14,1940,7,48,29261,48,532,7,173,29261,308,1408
0.017,6,16,6016,9,88,2,88,504,7,1740,2,1880,5512
0.005,6,3,156,1,0,0,0,52,2,0,5,0,104
0.137,17,2,180,1,30,0,30,58,1,94,0,94,122
1740.423,17,27,6345,27,207,66939,207,6345,0,0,0,0,0
37.97,17,44,6468,22,48,1807,48,1672,22,190,1807,308,4796
12.428,17,22,5698,22,231,591,388,5698,0,0,0,0,0
0.2,6,36,18798,17,173,12,319,1584,19,1350,10,1625,17214
1699.591,17,13,534,11,14,169942,14,462,2,8,1699422,8,72
280.533,6,27,7312,12,158,25503,267,1277,15,678,20028,2085,6035
7.289,6,914,851356,585,1382,12,1408,829560,329,776,21,1408,21796
0.543,6,20,7229,13,334,45,663,2021,7,1209,80,1946,5208
0.022,6,10,2031,6,732,4,1304,1708,4,159,6,159,323
294.563,6,8,320,8,0,0,0,320,0,0,0,0,0
1.246,6,45,20387,28,918,46,1360,14931,17,529,67,4075,5456
8.375,6,1532,1304455,853,1431,9,1448,1255099,679,776,12,1448,49356
30.672,17,6,456,6,48,6134,48,456,0,0,0,0,0
166.084,6,22,8961,11,514,79,1236,2014,11,927,16591,1460,6947
1774.283,6,180,15480,120,69,14909,69,8940,60,69,30063,69,6540
1781.765,6,355,22480,207,69,8649,69,12420,148,69,12120,69,10060
147.733,6,72,65419,40,929,102,1360,9997,32,2353,4761,8160,55422
0.005,17,4,304,2,37,0,37,130,2,59,2,65,174
369.608,6,18,1242,14,180,28431,180,916,4,110,20059,110,326
1259.92,2,8,256,8,8,179988,8,256,0,0,0,0,0
4.158,1,2,72,2,8,4158,8,72,0,0,0,0,0
0.602,6,16,1825,8,288,61,288,640,8,284,61,434,1185
160.958,6,25,9532,7,267,497,501,1085,18,482,9462,1420,8447
0.559,6,27,8454,14,247,42,1011,2218,13,925,46,2816,6236
5.729,6,23,6462,11,262,566,517,1368,12,744,514,1368,5094
470.284,6,47,3226,29,49,16795,208,2258,18,35,27588,62,968
240.162,6,55,17457,30,761,8281,1408,14513,25,204,10006,580,2944
1765.769,1,154,16324,154,78,11540,78,16324,0,0,0,0,0
1795.732,17,449,39928,404,35,4455,288,25708,45,288,40020,288,14220
0.152,17,2,303,1,45,0,45,73,1,202,0,202,230
0.032,6,10,2047,6,740,5,1323,1724,4,159,10,159,323
301.091,6,45,10271,22,433,14337,910,3114,23,345,550,2128,7157
0.251,6,9,527,5,43,62,43,311,4,0,49,0,216
1794.932,17,142,11360,71,48,25641,48,5396,71,56,25641,56,5964
1795.613,17,446,39548,402,35,4477,288,25644,44,288,40944,288,13904
0.389,6,12,1653,6,288,76,288,548,6,426,41,434,1105
197.79,17,4,352,2,60,197788,60,176,2,60,197789,60,176
1785.282,6,106,8388,68,64,26646,64,4896,38,58,48248,58,3492
2.68,6,3,564,2,210,2217,210,524,1,0,0,0,40
596.024,1,48,2688,48,28,12681,28,2688,0,0,0,0,0
56.079,6,39,10166,20,627,2951,1360,3352,19,464,480,1360,6814
71.101,6,30,7435,13,155,5925,267,1306,17,453,4443,3417,6129
5.032,17,4,788,2,34,5016,34,124,2,304,5019,312,664
300.639,6,40,8637,21,291,15031,786,2061,19,414,471,2128,6576
319.909,6,24,6430,9,267,1332,501,1165,15,388,22844,1420,5265
62.153,6,74,52302,47,1191,1351,1368,44163,27,840,2380,2519,8139
0.353,17,2,152,1,48,0,48,76,1,48,0,48,76
280.513,6,29,7392,13,158,23376,267,1317,16,603,18692,2076,6075
240.218,6,57,18968,31,762,8007,1402,16114,26,186,9608,580,2854
4.63,6,38,7229,20,218,243,314,3423,18,513,257,1179,3806
1799.223,1,226,12656,226,28,7996,28,12656,0,0,0,0,0
3.841,6,480,415194,212,213,18,257,13407,268,1463,14,4320,401787
2.683,6,141,93763,78,1328,34,1432,86850,63,396,38,1871,6913
18.366,6,18,2443,9,329,2295,595,1143,9,396,2294,580,1300
44.174,17,15,7808,8,655,6310,1350,5466,7,306,2518,1350,2342
127.03,1,4,540,4,107,42343,121,540,0,0,0,0,0
6.529,6,42,7682,21,224,326,314,3756,21,513,312,1179,3926
1798.328,17,142,11360,71,48,25690,48,5396,71,56,25690,56,5964
1790.857,6,357,22629,209,69,8609,69,12569,148,69,12182,69,10060
0.853,6,10,1687,7,100,142,100,384,3,1179,303,1179,1303
1750.12,17,12,498,11,14,175012,14,462,1,8,0,8,36
1744.795,6,116,9659,75,57,23578,205,5895,41,39,43614,98,3764
240.233,6,54,17964,29,796,8579,1418,15054,25,200,10009,580,2910
1794.327,1,96,10176,96,78,18887,78,10176,0,0,0,0,0
1.343,6,47,19825,27,938,51,1460,14249,20,476,61,2615,5576
240.469,6,52,14551,29,644,8585,1418,11820,23,190,10928,580,2731
2.362,17,3,1176,3,364,1181,364,1176,0,0,0,0,0
0.2,6,12,1684,6,121,39,121,453,6,911,39,911,1231
23.835,17,28,4116,14,48,1832,48,1064,14,190,1832,308,3052
1785.008,17,125,41952,125,307,14395,308,41952,0,0,0,0,0
7.084,6,3,300,0,0,0,0,0,3,90,3542,149,300
1797.321,6,388,34613,224,148,8059,1093,19177,164,116,11026,1381,15436
1793.05,17,142,11360,71,48,25614,48,5396,71,56,25593,56,5964
15.922,17,14,6202,7,560,2648,1350,4117,7,269,2648,1350,2085
280.291,6,29,7392,14,158,21560,267,1357,15,678,20018,3436,6035
1773.84,17,30,31680,30,1028,61166,1028,31680,0,0,0,0,0
0.057,17,2,227,1,44,0,44,72,1,127,0,127,155
0.429,17,8,2766,8,317,61,356,2766,0,0,0,0,0
1794.449,6,384,23928,219,69,8231,69,12900,165,57,10941,69,11028
1798.025,6,357,22629,208,69,8686,69,12460,149,69,12148,69,10169
1783.813,6,354,22440,207,69,8659,69,12420,147,69,12217,69,10020
3.39,6,58,21680,30,919,116,1460,14150,28,426,110,1460,7530
1.17,6,24,8004,12,164,90,267,1288,12,1014,90,2816,6716
0.01,17,2,912,1,308,0,308,336,1,548,0,548,576
297.954,2,6,192,6,8,59590,8,192,0,0,0,0,0
1778.931,1,118,6608,118,28,15204,28,6608,0,0,0,0,0
4.023,17,8,616,4,33,1334,33,244,4,65,1333,65,372
1797.029,17,445,39800,400,35,4503,288,25580,45,288,40027,288,14220
0.372,17,4,300,2,39,370,39,134,2,55,370,55,166
1741.175,6,91,6604,59,31,30020,31,3998,32,31,56164,31,2606
5.405,6,42,7405,23,218,245,314,3543,19,516,285,1179,3862
10.991,6,20,4442,11,275,1099,275,998,9,768,774,1440,3444
69.829,6,29,8168,13,155,5819,267,1306,16,517,4641,2006,6862
163.714,6,28,12945,15,835,58,1360,5645,13,1128,13627,4445,7300
245.098,6,108,99285,49,214,5106,605,3892,59,1709,4225,5632,95393
0.241,6,24,11365,14,145,18,261,1306,10,1361,24,3655,10059
96.407,6,30,7642,11,155,31,267,1226,19,403,5355,3426,6416
0.0,17,4,1305,4,298,0,332,1305,0,0,0,0,0
0.038,17,4,368,2,32,26,32,120,2,96,21,96,248
1770.583,6,99,9240,66,65,27239,65,5577,33,59,55327,59,3663
1786.964,6,104,8376,68,65,26671,65,4930,36,59,51052,59,3446
1.18,6,4,184,2,0,1180,0,88,2,0,1020,0,96
180.481,2,3,96,3,8,90240,8,96,0,0,0,0,0
0.813,17,21,7219,10,427,90,1350,4550,11,214,77,1350,2669
1787.929,6,375,26508,216,104,8315,469,15663,159,69,11315,69,10845
1603.757,6,105,14490,63,96,25867,721,7079,42,439,9579,1440,7411
1.958,17,22,5709,22,231,93,389,5709,0,0,0,0,0
300.955,6,31,18397,19,373,16719,938,2489,12,1909,5616,6864,15908
1797.723,6,366,24603,213,87,8479,469,14136,153,69,11823,69,10467
1784.045,1,52,4368,0,0,0,0,0,52,56,34981,56,4368
0.477,6,4,1037,2,0,221,0,104,2,853,259,853,933
11.302,6,1803,1555155,1098,1362,10,1380,1522713,705,468,15,3303,32442
16.257,17,21,13224,11,609,1619,1350,7011,10,593,1798,1350,6213
240.615,6,43,8395,22,449,11457,1408,5648,21,205,12030,580,2747
9.586,2,3,144,3,24,4793,32,144,0,0,0,0,0
9.175,6,9,527,5,43,2293,43,311,4,0,3056,0,216
0.203,6,16,6734,8,120,29,120,544,8,1153,29,1448,6190
263.908,17,2,672,2,308,263908,308,672,0,0,0,0,0
1765.124,6,130,14510,68,84,26344,517,5309,62,269,28935,1368,9201
1740.415,6,87,6322,58,31,30533,31,3915,29,31,62157,31,2407
1797.556,17,448,39896,403,35,4471,288,25676,45,288,40018,288,14220
295.958,6,40,8912,18,326,17406,517,2273,22,684,14091,1418,6639
1796.229,6,361,23860,211,82,8553,501,13582,150,69,12055,69,10278
0.128,1,5,485,5,69,32,69,485,0,0,0,0,0
1795.909,1,170,9520,170,28,10626,28,9520,0,0,0,0,0
109.649,1,10,1647,10,136,12183,222,1647,0,0,0,0,0
1.157,6,200,150137,116,1325,10,1420,142486,84,427,13,1420,7651
280.265,6,29,7392,13,158,23355,267,1317,16,543,18683,1400,6075
102.87,6,21,9089,11,418,73,921,1728,10,1158,11413,2521,7361
1786.336,6,104,8444,68,66,26661,66,4964,36,60,51035,60,3480
240.175,6,53,18076,29,769,8577,1402,15370,24,181,10442,580,2706
1771.307,6,101,9344,66,65,27250,65,5577,35,59,52093,59,3767
0.556,6,16,1825,8,288,54,288,640,8,284,54,434,1185
10.783,6,18,5610,10,275,1198,275,958,8,1440,822,1440,4652
1796.208,17,448,39896,403,35,4468,288,25676,45,288,40020,288,14220
0.15,17,2,304,1,60,0,60,88,1,188,0,188,216
0.507,17,3,451,2,39,272,39,134,1,289,0,289,317
12.201,17,10,850,5,37,3048,37,325,5,77,3048,77,525
0.197,6,25,7216,13,155,16,267,1301,12,678,17,4200,5915
181.785,6,5,260,5,0,0,0,260,0,0,0,0,0
1762.197,6,123,7829,72,48,24819,208,4828,51,31,35238,31,3001
972.494,17,593,40957,578,40,1685,41,39688,15,56,1211,57,1269
12.761,6,1934,1747354,1231,1369,10,1380,1711476,703,515,18,1923,35878
0.145,6,9,1339,5,145,36,145,349,4,826,33,826,990
0.621,6,19,9135,10,126,64,126,654,9,1334,74,2048,8481
0.048,17,4,284,2,32,31,32,120,2,54,34,60,164
0.01,17,2,414,1,30,0,30,58,1,328,0,328,356
0.923,6,10,1687,7,100,153,100,384,3,1179,331,1179,1303
1773.49,6,182,15698,120,69,14903,69,8940,62,69,29066,69,6758
0.137,6,2,1050,1,970,0,970,1010,1,0,0,0,40
1788.428,17,83,3480,82,14,22079,14,3444,1,8,0,8,36
39.858,6,69,26163,35,1063,212,1360,19543,34,328,1202,1360,6620
1787.955,6,469,31891,222,112,8090,965,15846,247,38,7268,96,16045
1780.237,17,140,11200,70,48,25750,48,5320,70,56,25788,56,5880
15.36,17,10,880,5,48,3836,48,380,5,72,3836,72,500
1796.895,17,144,11520,72,48,25308,48,5472,72,56,25308,56,6048
0.135,17,2,602,1,46,0,46,74,1,500,0,500,528
88.446,6,686,348424,382,848,232,1071,334308,304,488,290,1179,14116
1.285,17,6,1230,3,36,640,36,192,3,318,640,318,1038
26.002,6,18,1674,8,275,3714,275,878,10,96,2660,96,796
4.872,6,40,7309,21,218,243,314,3463,19,440,256,1152,3846
69.174,6,47,10010,23,450,520,766,2813,24,366,3001,3488,7197
4.893,6,35,6225,19,206,271,314,2824,16,551,308,1179,3401
41.414,17,44,6468,22,48,1971,48,1672,22,190,1971,308,4796
1746.056,1,56,4704,56,56,31746,56,4704,0,0,0,0,0
10.987,6,20,4442,11,275,1098,275,998,9,768,780,1440,3444
11.645,6,1833,1602074,1112,1385,10,1420,1569001,721,467,16,1883,33073
22.443,6,42,8947,20,447,581,1025,2221,22,388,1062,2128,6726
0.243,17,2,184,1,32,0,32,60,1,96,0,96,124
0.356,17,2,157,1,31,0,31,59,1,70,0,70,98
17.578,17,4,352,2,60,17576,60,176,2,60,17577,60,176
0.149,6,44,20439,26,1031,5,1420,15498,18,467,8,1883,4941
1776.834,17,73,3060,72,14,25025,14,3024,1,8,0,8,36
1799.2,6,1323,236998,867,304,2077,304,177124,456,83,3953,83,59874
82.413,6,701,343366,390,822,211,1152,326460,311,446,265,1179,16906
1799.986,6,225,20025,85,83,21428,349,9343,140,72,12948,1062,10682
31.554,6,881,666745,487,1344,64,1360,643209,394,217,79,1360,23536
0.027,17,2,330,1,30,0,30,58,1,244,0,244,272
0.324,6,27,9059,13,252,27,647,1704,14,945,24,1408,7355
0.439,6,7,295,4,0,146,0,164,3,7,111,7,131
0.005,17,3,342,2,31,0,31,118,1,196,0,196,224
194.261,17,4,352,2,60,194260,60,176,2,60,194260,60,176
3.336,17,5,295,5,31,834,31,295,0,0,0,0,0
9.519,6,1669,1596499,1100,1376,8,1408,1562247,569,776,16,1408,34252
1793.371,17,180,11520,180,36,10018,36,11520,0,0,0,0,0
82.917,6,43,6125,21,182,4145,585,3119,22,153,3936,580,3006
212.113,17,4,240,2,32,212112,32,120,2,32,212112,32,120
1.19,6,4,184,2,0,1190,0,88,2,0,1033,0,96
1743.261,6,96,7286,63,38,28117,205,4476,33,33,54471,98,2810
0.015,17,2,198,1,39,0,39,67,1,103,0,103,131
1773.5,6,211,24150,134,89,13334,981,11198,77,135,23333,1420,12952
292.515,6,34,7025,16,262,19498,517,1628,18,744,17204,1418,5397
0.173,6,3,213,2,46,0,62,173,1,0,0,0,40
29.321,17,15,7784,8,655,4188,1350,5471,7,302,45,1350,2313
8.685,6,802,643107,435,1391,19,1448,618270,367,688,23,1448,24837
1784.239,17,142,11360,71,48,25488,48,5396,71,56,25488,56,5964
3.395,6,9,483,4,0,1131,0,204,5,7,774,7,279
9.853,6,1594,1365268,946,1388,10,1420,1335115,648,420,15,1420,30153
51.037,17,4,352,2,60,51036,60,176,2,60,51036,60,176
0.188,6,38,24858,18,180,11,250,1498,20,1239,5,1735,23360
158.617,6,22,10179,12,397,62,884,1717,10,1341,17608,3928,8462
29.798,6,41,8875,21,208,1489,721,2518,20,693,1549,1420,6357
4.678,6,39,7285,20,218,246,314,3423,19,516,245,1179,3862
278.099,6,33,20174,22,964,13242,1295,14653,11,705,2802,1448,5521
36.893,6,12,984,11,43,3689,43,924,1,0,0,0,60
1670.262,1,7,392,7,28,278377,28,392,0,0,0,0,0
0.994,17,2,312,2,128,994,128,312,0,0,0,0,0
399.867,6,73,4828,25,69,16660,69,1690,48,39,8507,48,3138
10.498,6,41,7349,22,218,499,314,3503,19,440,479,1152,3846
96.661,6,18,1532,6,180,127,180,680,12,110,8769,110,852
2.074,1,2,112,2,28,2074,28,112,0,0,0,0,0
240.185,6,53,18148,28,808,8895,1402,15208,25,204,10007,580,2940
0.055,17,2,384,1,32,0,32,60,1,296,0,296,324
11.607,6,1862,1605055,1122,1375,10,1420,1571222,740,467,15,1883,33833
38.8,17,22,1936,11,48,3879,48,836,11,72,3878,72,1100
1799.52,1,58,4872,58,56,31570,56,4872,0,0,0,0,0
15.707,6,19,5387,10,275,1745,275,687,9,1440,1344,1440,4700
42.03,6,25,7097,12,155,3820,267,1266,13,589,3501,3426,5831
1780.37,17,140,11200,70,48,25801,48,5320,70,56,25802,56,5880
0.187,1,2,112,2,28,187,28,112,0,0,0,0,0
13.214,17,3,2906,3,940,6607,1451,2906,0,0,0,0,0
1772.493,6,242,17965,121,69,14770,69,8980,121,34,14770,64,8985
0.1,17,3,1091,3,335,50,356,1091,0,0,0,0,0
0.27,17,4,344,2,47,263,47,150,2,69,260,75,194
33.331,6,37,9998,19,736,492,1360,4476,18,435,1950,2667,5522
0.28,6,22,4442,11,165,28,456,1394,11,493,26,888,3048
1750.576,17,12,498,11,14,175057,14,462,1,8,0,8,36
1778.853,6,34,5654,23,241,80856,241,4294,11,92,177867,92,1360
1752.433,6,118,8046,64,27,27815,27,3850,54,67,33063,427,4196
300.833,6,44,13789,25,892,12534,1360,8182,19,439,483,4027,5607
0.117,6,15,3958,10,75,13,75,603,5,1543,28,1587,3355
4.993,17,23,13414,12,842,453,1350,10451,11,241,391,1350,2963
300.868,6,49,10486,25,433,12536,910,3258,24,329,582,2128,7228
22.415,17,4,240,2,32,22414,32,120,2,32,22414,32,120
0.262,6,5,248,3,0,100,0,156,2,0,262,0,92
7.424,17,6,1356,6,198,1484,207,1356,0,0,0,0,0
26.006,6,14,2185,8,324,3715,585,1073,6,396,5198,580,1112
1774.635,6,180,15480,120,69,14912,69,8940,60,69,30070,69,6540
290.729,17,4,352,2,60,290728,60,176,2,60,290728,60,176
1739.882,6,87,6322,58,31,30524,31,3915,29,31,62138,31,2407
7.145,6,8,448,4,0,2336,0,240,4,0,2335,0,208
0.232,6,4,1037,2,0,220,0,104,2,853,13,853,933
723.115,2,6,192,6,8,144623,8,192,0,0,0,0,0
49.921,6,26,7272,12,158,4538,267,1277,14,775,3837,3445,5995
134.213,6,8,446,2,0,1249,0,112,6,7,26804,7,334
92.254,6,45,10341,19,541,48,910,2971,26,315,3684,3488,7370
1.064,6,23,7952,12,164,82,267,1288,11,1216,90,3825,6664
1.009,17,2,432,1,64,0,64,92,1,312,0,312,340
1746.494,6,146,8997,79,45,22390,208,5418,67,31,26457,31,3579
1701.885,1,8,448,8,28,243126,28,448,0,0,0,0,0
1.989,17,4,610,3,39,736,39,201,1,381,0,381,409
111.408,6,24,7700,8,272,263,516,1140,16,455,7419,1452,6560
1793.051,1,58,4872,58,56,31457,56,4872,0,0,0,0,0
14.633,6,10,472,6,0,2926,0,280,4,0,667,0,192
3.561,6,66,43615,38,718,96,1408,6354,28,1789,131,7724,37261
0.267,6,26,6066,12,164,24,453,1442,14,555,19,1408,4624
62.804,6,32,26798,18,667,62,1360,4087,14,2459,4816,10880,22711
1719.782,17,16,5244,16,299,114652,1424,5244,0,0,0,0,0
11.178,6,1743,1522167,1077,1363,10,1380,1491252,666,387,16,1923,30915
1788.943,17,87,3648,86,14,21046,14,3612,1,8,0,8,36
0.915,6,10,1687,7,100,152,100,384,3,1179,329,1179,1303
1771.725,6,248,25342,102,67,17540,681,9494,146,135,12217,3298,15848
300.209,6,30,11768,17,592,18763,1408,4445,13,948,20015,1578,7323
39.769,17,44,6468,22,48,1893,48,1672,22,190,1893,308,4796
1772.076,6,180,15480,120,69,14891,69,8940,60,69,30031,69,6540
1795.452,17,449,39928,404,35,4455,288,25708,45,288,40018,288,14220
1.859,17,25,9974,13,341,152,1350,4805,12,402,166,1350,5169
15.137,6,24,6993,13,275,1261,275,1078,11,910,1011,1440,5915
0.639,17,21,14208,12,941,57,1350,11633,9,258,76,1350,2575
353.779,6,45,24560,29,377,12634,1360,6483,16,1742,32,4080,18077
1770.715,1,59,4956,59,56,30529,56,4956,0,0,0,0,0
1787.251,6,104,8308,68,64,26675,64,4896,36,58,51062,58,3412
2.006,17,3,174,3,30,1003,30,174,0,0,0,0,0
10.316,6,40,8586,21,468,515,763,2302,19,393,503,1432,6284
1794.253,17,87,3648,86,14,21108,14,3612,1,8,0,8,36
354.369,6,50,9455,25,134,14765,889,2516,25,311,847,1460,6939
0.19,6,28,7336,13,155,15,267,1301,15,543,12,1400,6035
17.44,6,9,1005,4,517,5811,517,733,5,0,4357,0,272
134.768,6,32,23775,19,840,34,1360,5835,13,2176,11219,5440,17940
0.635,6,14,2185,8,326,90,589,1065,6,396,125,580,1120
280.276,6,30,7432,13,158,23356,267,1317,17,543,17515,1400,6115
1789.954,6,375,26715,220,104,8173,469,15892,155,69,11623,69,10823
53.482,17,4,352,2,60,53481,60,176,2,60,53481,60,176
4.75,6,39,7269,19,218,263,314,3383,20,513,235,1179,3886
0.124,17,2,241,1,36,0,36,64,1,149,0,149,177
0.113,17,2,179,1,43,0,43,71,1,80,0,80,108
0.015,17,4,288,2,33,5,33,122,2,55,5,61,166
1685.781,1,7,392,7,28,280963,28,392,0,0,0,0,0
43.776,6,6,393,3,31,11167,31,187,3,31,21888,31,206
69.095,6,26,7137,12,155,6281,267,1266,14,530,5314,2006,5871
6.99,6,545,468930,334,1337,20,1368,453282,211,776,32,1473,15648
1.018,6,29,13282,16,511,67,1360,3239,13,1056,69,2561,10043
94.986,17,8,704,4,48,31658,48,304,4,72,31658,72,400
0.831,6,276,218291,135,131,6,316,8962,141,1463,5,2836,209329
3.371,17,561,639580,99,94,34,1350,12097,462,1330,7,1350,627483
0.549,6,27,9133,13,273,45,733,1778,14,945,40,1368,7355
280.491,6,30,7432,14,158,21576,267,1357,16,678,18696,3456,6075
20.097,6,40,8783,16,391,49,860,1883,24,329,867,1928,6900
55.241,6,7,368,4,0,18412,0,216,3,0,27618,0,152
3.094,17,3,228,2,48,3049,48,152,1,48,0,48,76
1783.15,17,83,3480,82,14,22014,14,3444,1,8,0,8,36
182.765,17,5,1680,5,308,45691,308,1680,0,0,0,0,0
1215.993,6,219,30184,101,203,12159,1360,13849,118,138,10391,4649,16335
53.644,6,31,9636,9,165,620,267,1029,22,428,2554,1420,8607
1789.729,17,140,11184,72,48,25207,48,5472,68,56,26712,56,5712
88.349,17,4,240,2,32,88348,32,120,2,32,88348,32,120
40.664,6,27,7177,13,155,3388,267,1306,14,530,3127,3417,5871
1782.009,6,401,24677,222,69,8063,69,13089,179,49,10011,69,11588
3.132,17,5,418,3,30,1566,30,174,2,94,1032,94,244
0.031,17,4,344,2,47,0,47,150,2,69,1,75,194
88.962,17,6,360,3,32,44480,32,180,3,32,44480,32,180
1781.65,6,354,22440,207,69,8648,69,12420,147,69,12202,69,10020
1713.141,17,161,10304,161,36,10707,36,10304,0,0,0,0,0
1771.507,6,104,9883,68,70,26440,234,5948,36,60,50612,83,3935
1771.596,6,101,9344,66,65,27255,65,5577,35,59,52102,59,3767
1.183,6,23,7952,11,164,100,267,1236,12,1014,91,2411,6716
1741.431,17,30,7050,30,207,60049,207,7050,0,0,0,0,0
300.554,6,18,1227,5,177,75094,177,445,13,110,25031,110,782
474.311,6,38,6659,20,250,24963,1314,2556,18,281,27900,1420,4103
1793.185,17,180,11520,180,36,10017,36,11520,0,0,0,0,0
38.101,17,22,1936,11,48,3809,48,836,11,72,3809,72,1100
0.576,17,4,608,2,60,275,60,176,2,188,293,188,432
0.103,17,2,142,1,35,0,35,63,1,51,0,51,79
1796.003,6,397,27940,224,101,8053,469,16535,173,69,10439,69,11405
1769.606,1,60,5040,0,0,0,0,0,60,56,29993,56,5040
34.282,17,40,5880,20,48,1803,48,1520,20,190,1803,308,4360
99.179,17,4,304,4,48,33059,48,304,0,0,0,0,0
38.978,17,44,6468,22,48,1854,48,1672,22,190,1853,308,4796
1744.618,2,25,800,25,8,72692,8,800,0,0,0,0,0
1740.906,1,224,23744,224,78,7806,78,23744,0,0,0,0,0
1787.354,6,104,8444,68,66,26676,66,4964,36,60,51063,60,3480
118.22,17,3,2906,3,940,59110,1451,2906,0,0,0,0,0
3.096,6,3,180,3,0,0,0,180,0,0,0,0,0
4.906,6,755,671243,479,1360,10,1432,655900,276,427,17,1432,15343
2.663,17,4,610,3,39,570,39,201,1,381,0,381,409
1681.777,17,14,1036,7,30,280293,30,406,7,62,280292,62,630
167.67,6,162,126311,102,1319,1660,1448,112212,60,609,2838,1448,14099
1.222,17,16,9185,8,822,174,1350,6803,8,269,130,1350,2382
1786.396,6,102,8364,68,66,26662,66,4964,34,60,54130,60,3400
1792.965,6,355,22480,207,69,8703,69,12420,148,69,12196,69,10060
0.082,17,2,2752,2,1348,82,1348,2752,0,0,0,0,0
1.42,6,47,19571,27,920,54,1360,13995,20,476,65,2720,5576
0.322,17,8,2758,8,316,46,355,2758,0,0,0,0,0
1790.456,6,366,25541,213,100,8445,469,14936,153,69,11779,69,10605
1787.417,6,102,8296,68,65,26677,65,4930,34,59,54161,59,3366
1647.597,1,8,448,8,28,235371,28,448,0,0,0,0,0
1.615,6,49,19173,27,886,62,1360,13517,22,433,67,1360,5656
141.421,6,31,4258,17,302,8838,302,2692,14,83,10164,83,1566
1795.067,6,356,22520,208,69,8671,69,12460,148,69,12211,69,10060
1.088,17,3,1170,3,362,544,362,1170,0,0,0,0,0
280.52,6,28,7352,12,158,25501,267,1277,16,678,18698,2760,6075
1260.104,2,9,288,9,8,157513,8,288,0,0,0,0,0
10.105,6,3,555,1,304,0,304,356,2,83,10105,83,199
1795.31,17,447,39864,402,35,4477,288,25644,45,288,40023,288,14220
0.97,6,24,8922,14,208,74,475,1426,10,1180,87,2720,7496
1771.413,6,101,9344,66,65,27252,65,5577,35,59,52097,59,3767
11.616,6,15,2294,9,210,1451,210,896,6,545,2322,904,1398
254.513,6,12,760,5,112,63625,112,432,7,0,42416,0,328
1799.012,17,762,46002,762,32,2364,37,46002,0,0,0,0,0
52.138,17,4,240,2,32,52137,32,120,2,32,52137,32,120
4.097,17,5,290,5,30,1024,30,290,0,0,0,0,0
270.053,6,6,1255,4,327,90017,413,814,2,180,269865,269,441
1.357,17,2,204,1,34,0,34,62,1,114,0,114,142
1787.131,17,87,3648,86,14,21025,14,3612,1,8,0,8,36
31.834,1,4,424,4,78,10611,78,424,0,0,0,0,0
1.016,1,2,168,2,56,1016,56,168,0,0,0,0,0
0.164,6,45,21599,27,1037,6,1420,16658,18,526,9,3303,4941
1700.467,17,12,498,11,14,170046,14,462,1,8,0,8,36
280.525,6,30,7432,13,158,23377,267,1317,17,678,17527,2760,6115
1776.993,17,73,3060,72,14,25028,14,3024,1,8,0,8,36
152.348,6,30,7432,13,158,12695,267,1317,17,543,9519,1400,6115
1771.822,6,101,9344,66,65,27258,65,5577,35,59,52109,59,3767
1782.861,1,65,5460,65,56,27857,56,5460,0,0,0,0,0
1651.735,1,8,848,8,78,235962,78,848,0,0,0,0,0
240.194,6,53,17699,28,783,8895,1402,14778,25,201,10007,580,2921
0.067,17,2,2754,2,1349,67,1349,2754,0,0,0,0,0
896.589,6,14,839,10,31,99621,31,555,4,31,213757,31,284
898.272,6,14,839,9,31,112284,31,484,5,31,224329,31,355
1786.519,6,108,8724,70,66,25891,66,5044,38,60,48281,60,3680
1797.339,6,355,22480,207,69,8724,69,12420,148,69,12226,69,10060
4.78,17,5,320,5,36,1195,36,320,0,0,0,0,0
1783.339,17,83,3480,82,14,22016,14,3444,1,8,0,8,36
1740.639,6,87,6322,58,31,30537,31,3915,29,31,62165,31,2407
0.021,6,10,1816,6,624,3,1092,1493,4,159,6,159,323
282.116,6,28,8034,13,158,23509,267,1317,15,764,20116,4845,6717
1782.349,17,211,44081,211,180,8487,377,44081,0,0,0,0,0
0.265,6,27,7296,13,155,22,267,1301,14,603,18,2800,5995
1741.259,17,28,29568,28,1028,64491,1028,29568,0,0,0,0,0
109.082,17,1243,241650,1150,169,94,172,226846,93,131,1165,172,14804
0.93,6,10,1687,7,100,155,100,384,3,1179,333,1179,1303
0.905,17,4,368,2,32,232,32,120,2,96,0,96,248
0.578,6,22,5040,11,137,57,267,1132,11,577,53,1400,3908
108.944,6,76,51557,47,1201,2368,1448,43319,29,746,2200,1448,8238
11.479,6,15,2297,9,211,1434,211,898,6,545,2293,904,1399
171.815,17,4,240,2,32,171814,32,120,2,32,171814,32,120
63.784,17,4,352,2,60,63783,60,176,2,60,63783,60,176
1798.82,17,448,39612,404,35,4463,288,25708,44,288,40951,288,13904
55.939,6,50,10507,23,533,689,910,3159,27,312,2146,1460,7348
2.887,6,2,88,2,0,0,0,88,0,0,0,0,0
5.31,6,39,7269,20,218,279,314,3423,19,513,279,1179,3846
0.245,17,4,566,2,31,233,31,118,2,196,235,196,448
1772.263,6,180,15480,120,69,14892,69,8940,60,69,30032,69,6540
1771.179,6,106,9892,69,66,26046,66,5856,37,60,49196,60,4036
162.058,6,30,6746,15,154,11575,516,1684,15,495,11568,1452,5062
1.3,17,6,936,3,64,571,64,276,3,192,546,192,660
0.511,17,3,451,2,39,440,39,134,1,289,0,289,317
77.083,6,25,10208,12,549,66,1360,2709,13,995,6412,1360,7499
15.646,6,6,340,1,0,0,0,60,5,0,3866,0,280
43.028,6,27,7177,13,155,3585,267,1306,14,530,3309,3417,5871
0.085,6,2,116,1,0,0,0,52,1,0,0,0,64
3.176,17,4,1560,4,362,1058,362,1560,0,0,0,0,0
125.89,2,2,64,2,8,125890,8,64,0,0,0,0,0
279.476,6,26,7134,12,181,25406,267,1208,14,595,21479,1400,5926
3.209,17,5,290,5,30,802,30,290,0,0,0,0,0
1786.077,6,124,15218,76,191,23814,1289,10332,48,78,37999,240,4886
0.181,17,3,1102,3,339,90,354,1102,0,0,0,0,0
300.927,6,51,10578,26,433,12037,910,3310,25,329,638,2720,7268
0.085,17,2,279,1,36,0,36,64,1,187,0,187,215
4.899,6,10,1102,6,483,979,483,803,4,83,1628,83,299
1770.403,6,99,9240,66,65,27236,65,5577,33,59,55321,59,3663
2.816,6,13,1553,8,177,402,177,955,5,110,648,110,598
240.248,6,66,20703,33,830,7507,1408,17515,33,162,7507,580,3188
2.003,17,2,154,1,33,0,33,61,1,65,0,65,93
15.658,17,25,5888,11,238,1563,1350,2926,14,183,1202,1350,2962
8.076,6,673,587634,427,1310,18,1368,570178,246,931,32,2736,17456
380.327,6,9,522,3,106,190163,106,234,6,0,6314,0,288
0.514,6,45,19712,26,1048,20,1380,14722,19,421,24,1923,4990
0.413,6,10,2101,5,1195,103,1195,1451,5,370,53,370,650
1787.318,1,339,28476,339,56,5287,56,28476,0,0,0,0,0
438.295,6,89,5975,45,69,9961,69,2766,44,69,10192,69,3209
280.413,6,29,7392,12,158,25492,267,1277,17,678,17522,2085,6115
280.017,6,28,7352,12,158,25456,267,1277,16,603,18666,1400,6075
307.98,6,125,74478,68,566,4596,970,9787,57,1370,614,3594,64691
0.073,17,2,421,1,47,0,47,75,1,318,0,318,346
0.011,6,3,124,2,0,11,0,84,1,0,0,0,40
240.132,6,39,8639,19,165,13340,517,1990,20,622,12637,1418,6649
2.71,17,4,1564,4,363,903,363,1564,0,0,0,0,0
7.991,6,18,6767,9,275,998,275,643,9,1150,649,1414,6124
1781.761,6,363,23007,211,69,8484,69,12718,152,69,11799,69,10289
5.436,17,4,240,2,32,5435,32,120,2,32,5435,32,120
1.036,6,1552,1856949,686,338,1,340,36357,866,2057,1,8208,1820592
13.006,17,2,152,2,48,13006,48,152,0,0,0,0,0
8.853,6,80,24725,40,542,227,1152,18968,40,415,219,1152,5757
12.017,6,2154,2072724,1457,1348,8,1368,2031816,697,931,16,2736,40908
1.116,6,32,12971,17,525,69,1440,3350,15,819,67,1440,9621
1783.287,17,83,3480,82,14,22015,14,3444,1,8,0,8,36
368.599,6,29,2660,16,184,24573,184,856,13,424,4669,434,1804
1745.594,6,95,7203,63,38,28154,205,4476,32,33,56300,98,2727
1788.329,17,87,3648,86,14,21039,14,3612,1,8,0,8,36
1.04,6,28,8160,15,222,61,540,1964,13,944,71,1591,6196
0.016,6,16,6016,9,88,2,88,504,7,1740,2,1880,5512
8.012,6,1531,1475327,980,1429,7,1448,1442011,551,931,14,2761,33316
4.322,6,38,7229,19,218,240,314,3383,19,513,226,1179,3846
1791.66,6,356,22520,208,69,8655,69,12460,148,69,12188,69,10060
5.05,6,33,6129,17,206,315,314,2744,16,548,318,1179,3385
319.491,6,159,51727,79,609,4096,1360,37362,80,293,4042,1938,14365
421.063,6,33,2214,14,27,32389,27,863,19,27,23389,27,1351
1661.237,1,8,448,8,28,237319,28,448,0,0,0,0,0
0.142,17,4,364,2,52,5,52,160,2,74,8,80,204
249.12,1,4,224,4,28,83040,28,224,0,0,0,0,0
1775.381,17,138,11040,69,48,26108,48,5244,69,56,26108,56,5796
1547.869,17,132,10976,66,53,23812,136,5368,66,56,23812,72,5608
0.284,17,3,234,2,39,246,39,134,1,72,0,72,100
0.365,6,27,8914,13,231,30,563,1608,14,938,27,1448,7306
0.322,17,12,4365,12,335,29,358,4365,0,0,0,0,0
356.096,6,46,8997,26,113,14243,685,2320,20,391,538,2720,6677
368.8,6,19,1303,14,177,28369,177,925,5,110,15157,110,378
16.244,6,25,4883,11,232,1624,722,1729,14,342,1227,1448,3154
0.239,6,49,22919,27,1113,9,1420,17806,22,467,10,1883,5113
6.615,6,5,280,2,0,6615,0,100,3,0,1512,0,180
1.354,6,24,8004,12,164,104,267,1288,12,1014,105,2491,6716
1744.904,6,95,7203,63,38,28143,205,4476,32,33,56278,98,2727
245.802,1,2,212,2,78,245802,78,212,0,0,0,0,0
1796.8,17,144,11520,72,48,25306,48,5472,72,56,25306,56,6048
477.48,2,5,160,5,8,119370,8,160,0,0,0,0,0
252.272,2,2,64,2,8,252272,8,64,0,0,0,0,0
1680.47,1,15,840,15,28,120033,28,840,0,0,0,0,0
1307.174,17,116,10323,106,30,12449,37,6183,10,386,138602,463,4140
2.858,17,17,6193,8,395,407,1350,3387,9,283,353,1350,2806
1.528,6,29,6187,14,161,117,267,1531,15,578,102,1380,4656
2.742,6,2,88,2,0,0,0,88,0,0,0,0,0
5.033,17,4,288,2,36,5001,36,128,2,52,4998,52,160
3.999,17,2,120,2,32,3999,32,120,0,0,0,0,0
1787.911,1,204,11424,204,28,8807,28,11424,0,0,0,0,0
121.4,6,1023,520607,579,838,210,1152,497715,444,427,273,1179,22892
293.062,6,85,15485,41,247,6094,1189,5356,44,363,6814,4837,10129
5.111,17,3,208,2,36,5006,36,128,1,52,0,52,80
1785.595,6,104,8444,68,66,26650,66,4964,36,60,51014,60,3480
1798.715,17,449,39928,404,35,4463,288,25708,45,288,40019,288,14220
184.196,6,44,8547,22,108,8770,267,2080,22,348,8770,1460,6467
291.508,6,38,8752,18,326,17144,517,2261,20,777,15340,1418,6491
4.732,6,39,7269,19,218,262,314,3383,20,513,233,1179,3886
26.437,17,16,1216,16,48,1762,48,1216,0,0,0,0,0
0.264,17,2,384,1,39,0,39,67,1,289,0,289,317
1795.213,17,80,3354,79,14,23015,14,3318,1,8,0,8,36
191.335,6,43,7233,22,179,5285,516,1958,21,295,9561,1452,5275
1723.213,1,8,448,8,28,246173,28,448,0,0,0,0,0
0.395,17,4,288,2,36,324,36,128,2,52,335,52,160
1792.011,6,449,27188,221,69,8145,69,13256,228,36,7894,69,13932
1.759,6,38,9848,20,502,92,1460,4352,18,433,91,1460,5496
6.855,2,2,64,2,8,6855,8,64,0,0,0,0,0
421.188,1,33,1848,33,28,13162,28,1848,0,0,0,0,0
1.255,6,20,4756,12,101,114,101,733,8,599,179,1000,4023
1770.999,6,104,9500,66,65,27246,65,5577,38,59,47862,59,3923
2.052,17,12,6490,6,711,404,1350,4437,6,314,403,1350,2053
0.168,1,2,112,2,28,168,28,112,0,0,0,0,0
61.316,6,37,15985,22,805,2919,1408,9206,15,665,4361,1408,6779
12.216,6,16,2297,9,324,1527,585,1125,7,396,2032,580,1172
1.458,6,38,8278,19,321,81,1164,2742,19,476,70,2720,5536
1699.425,17,12,498,11,14,169942,14,462,1,8,0,8,36
1744.48,2,14,448,14,8,134190,8,448,0,0,0,0,0
1797.797,17,448,39896,403,35,4472,288,25676,45,288,40018,288,14220
0.305,17,2,212,1,46,0,46,74,1,110,0,110,138
0.205,17,2,2344,2,1144,205,1258,2344,0,0,0,0,0
0.385,6,21,7290,12,335,34,668,1974,9,968,46,1475,5316
5.118,6,39,7269,20,218,269,314,3423,19,513,269,1179,3846
0.021,17,2,397,1,48,0,48,76,1,293,0,293,321
1786.252,6,102,8364,68,66,26660,66,4964,34,60,54126,60,3400
0.272,6,23,4494,11,165,27,456,1394,12,493,24,888,3100
0.181,17,8,2750,8,315,25,354,2750,0,0,0,0,0
13.104,6,15,3543,6,188,332,245,620,9,1279,1605,1407,2923
114.829,6,36,8384,18,378,523,786,1910,18,478,6745,2128,6474
1775.617,1,151,8456,151,28,11837,28,8456,0,0,0,0,0
28.125,6,3899,3592810,2488,1364,11,1408,3514774,1411,931,19,2801,78036
328.922,17,8,2688,8,308,46988,308,2688,0,0,0,0,0
1799.713,17,449,39928,404,35,4465,288,25708,45,288,40016,288,14220
368.987,6,49,10930,31,302,12299,1360,5228,18,414,509,2667,5702
733.374,6,65,9691,43,90,17461,504,3808,22,277,30940,1452,5883
4.196,17,5,290,5,30,1049,30,290,0,0,0,0,0
1786.847,6,355,22480,207,69,8674,69,12420,148,69,12155,69,10060
1780.275,17,140,11200,70,48,25800,48,5320,70,56,25800,56,5880
3.61,6,21,5635,11,158,361,370,1235,10,999,288,1691,4400
46.252,6,49,10626,24,541,703,910,3275,25,333,1921,1360,7351
1797.546,6,373,25159,215,87,8399,469,14354,158,69,11448,69,10805
1793.72,17,757,45642,757,32,2372,37,45642,0,0,0,0,0
3.91,17,5,290,5,30,977,30,290,0,0,0,0,0
0.117,17,2,223,1,36,0,36,64,1,131,0,131,159
7.356,6,41,7365,22,218,350,314,3503,19,516,394,1179,3862
280.207,6,28,7352,13,158,23350,267,1317,15,678,20013,3436,6035
1795.106,17,447,39580,403,35,4465,288,25676,44,288,40947,288,13904
63.688,6,14,1116,7,226,10614,226,634,7,110,10416,110,482
147.949,6,4109,3725598,1680,753,88,1448,117745,2429,1443,60,2896,3607853
0.525,17,3,451,2,39,425,39,134,1,289,0,289,317
0.033,6,17,6068,10,88,3,88,556,7,1740,5,1880,5512
102.847,6,36,8463,18,412,518,922,1990,18,478,6041,2720,6473
258.836,6,25,4440,11,150,1476,174,744,14,261,19902,1452,3696
15.136,17,27,16617,14,965,1161,1350,13915,13,179,1258,1350,2702
1757.932,6,4040,3857678,1368,150,1285,941,78613,2672,1401,658,2836,3779065
1772.584,6,180,15480,120,69,14895,69,8940,60,69,30036,69,6540
450.379,17,19,798,19,14,25021,14,798,0,0,0,0,0
0.346,17,2,212,1,46,0,46,74,1,110,0,110,138
0.314,17,2,178,1,29,0,29,57,1,93,0,93,121
1798.795,17,266,89428,266,308,6787,376,89428,0,0,0,0,0
589.542,6,9,546,6,31,117908,31,333,3,31,294757,31,213
61.257,6,17,692,9,0,7655,0,364,8,0,8748,0,328
0.254,6,9,1002,5,213,63,213,417,4,421,67,421,585
1797.001,17,449,39928,404,35,4459,288,25708,45,288,40018,288,14220
1668.904,1,7,392,7,28,278150,28,392,0,0,0,0,0
6.766,6,620,530331,376,1337,17,1368,512979,244,931,26,2736,17352
24.891,6,9,527,5,43,6222,43,311,4,0,8295,0,216
3.316,17,8,700,4,34,1061,34,248,4,85,1103,91,452
1791.476,1,122,6832,122,28,14805,28,6832,0,0,0,0,0
1799.783,17,4190,201120,2095,20,859,20,100560,2095,20,859,20,100560
1746.208,1,31,4081,31,103,58206,351,4081,0,0,0,0,0
1773.708,6,180,15480,120,69,14905,69,8940,60,69,30060,69,6540
1451.923,1,162,9072,162,28,9018,28,9072,0,0,0,0,0
20.79,17,30,2220,20,40,1093,41,1373,10,56,1986,57,847
1793.186,6,358,22738,208,69,8662,69,12529,150,69,12034,69,10209
4.373,6,38,7245,19,218,242,314,3383,19,516,228,1179,3862
368.588,6,27,1767,18,177,21681,177,1181,9,110,8620,110,586
240.82,17,2,136,2,40,240820,47,136,0,0,0,0,0
125.33,6,30,15814,17,970,48,1360,8500,13,968,10429,2720,7314
172.14,17,6,2016,6,308,34428,308,2016,0,0,0,0,0
0.532,6,24,4571,12,165,48,456,1446,12,415,45,888,3125
1746.783,6,97,7307,63,38,28173,205,4476,34,33,52919,98,2831
300.914,6,42,11421,22,609,14329,1440,4566,20,464,455,1440,6855
1742.593,6,94,7151,62,38,28567,205,4424,32,33,56203,98,2727
0.016,17,2,240,1,47,0,47,75,1,137,0,137,165
6.012,6,49,8569,25,211,250,314,4182,24,427,250,1152,4387
1797.816,17,450,39960,405,35,4450,288,25740,45,288,40022,288,14220
1.521,6,19,3781,10,234,169,564,1452,9,463,166,1343,2329
1164.584,6,248,45610,100,224,11763,1440,19619,148,243,7921,1702,25991
1740.44,17,29,30566,29,1026,62158,1026,30566,0,0,0,0,0
19.084,17,34,17305,16,494,1269,1350,8361,18,468,1120,1350,8944
65.089,6,10,420,5,0,505,0,208,5,0,16270,0,212
18.577,6,66,21125,34,875,562,1360,14603,32,326,501,2720,6522
8.612,6,34,8145,18,333,506,685,1752,16,521,562,3488,6393
1792.723,6,354,22440,207,69,8702,69,12420,147,69,12278,69,10020
61.817,6,63,41410,39,1161,1626,1448,33409,24,749,2676,1448,8001
8.196,6,25,5026,13,225,683,383,2105,12,487,722,1179,2921
101.676,6,24,10282,12,433,62,990,1823,12,995,9232,2568,8459
1799.692,1,16,896,16,28,119979,28,896,0,0,0,0,0
0.297,6,9,1346,5,145,74,145,349,4,833,47,833,997
687.738,6,73,6301,45,69,15630,69,3387,28,69,25471,69,2914
1773.253,6,210,23593,109,70,16419,721,9147,101,236,17728,1414,14446
962.519,2,9,288,9,8,120314,8,288,0,0,0,0,0
140.194,6,26,8360,13,201,61,290,1167,13,740,11671,1708,7193
1780.516,17,140,11200,70,48,25804,48,5320,70,56,25804,56,5880
1789.954,6,389,26584,219,100,8210,469,15176,170,56,10591,69,11408
1774.281,6,182,15629,121,69,14785,69,8980,61,69,29570,69,6649
5.243,6,15,2650,7,188,873,245,660,8,554,712,1152,1990
1.366,6,51,19799,30,920,47,1360,14138,21,437,58,2715,5661
1787.323,6,102,8296,68,65,26676,65,4930,34,59,54159,59,3366
231.106,6,2064,1125815,1240,842,186,1152,1086376,824,341,280,341,39439
0.623,6,22,7304,13,272,51,517,1772,9,1264,73,2736,5532
231.413,6,35,7828,15,154,12600,516,1684,20,296,12163,1452,6144
251.324,2,2,64,2,8,251324,8,64,0,0,0,0,0
1774.864,17,142,11360,71,48,25355,48,5396,71,56,25355,56,5964
5.074,17,4,288,2,36,5003,36,128,2,52,5001,52,160
0.057,17,2,154,1,33,0,33,61,1,65,0,65,93
1772.824,6,180,15480,120,69,14897,69,8940,60,69,30039,69,6540
1788.415,17,83,3480,82,14,22079,14,3444,1,8,0,8,36
224.791,17,4,352,2,60,224790,60,176,2,60,224790,60,176
8.51,6,77,24834,40,568,218,1152,19213,37,459,228,1179,5621
1643.108,1,8,448,8,28,234729,28,448,0,0,0,0,0
2.462,17,2,677,1,300,0,300,328,1,321,0,321,349
241.637,6,193,126431,97,542,2516,1408,9563,96,1331,2543,1408,116868
1769.159,17,167,13948,155,30,11488,37,9032,12,381,155403,463,4916
0.328,6,26,8911,13,237,27,590,1635,13,941,26,1408,7276
0.821,6,23,7307,13,318,68,600,1958,10,964,82,1471,5349
1740.711,17,29,30624,29,1028,62168,1028,30624,0,0,0,0,0
1786.638,6,102,8228,68,64,26666,64,4896,34,58,54136,58,3332
1781.764,6,356,22520,208,69,8607,69,12460,148,69,12120,69,10060
300.756,6,38,9578,21,537,15037,1360,4096,17,435,536,2667,5482
70.295,6,18,732,8,0,7867,0,324,10,0,7808,0,408
280.433,6,31,7472,13,158,23369,267,1317,18,543,16492,1380,6155
228.65,17,4,240,2,32,228649,32,120,2,32,228649,32,120
0.494,6,10,767,5,186,117,186,454,5,45,115,45,313
1314.003,2,16,512,16,8,87600,8,512,0,0,0,0,0
368.299,6,18,1242,14,180,28330,180,916,4,110,20058,110,326
106.952,6,26,12043,12,510,185,1192,2098,14,1041,8212,1460,9945
7.653,6,46,9179,23,227,347,314,4102,23,461,335,1179,5077
105.815,6,21,3242,12,181,9619,595,1722,9,261,13225,580,1520
255.306,6,3127,3815421,689,502,371,531,50145,2438,1499,104,4314,3765276
0.944,17,4,724,2,32,940,32,120,2,274,61,274,604
1789.473,6,361,22858,210,69,8562,69,12678,151,69,11928,69,10180
31.542,6,10,436,3,0,306,0,128,7,0,5224,0,308
1783.519,6,356,22520,208,69,8616,69,12460,148,69,12131,69,10060
1745.152,6,100,7893,65,45,27268,205,4844,35,35,51316,98,3049
0.295,17,2,212,1,46,0,46,74,1,110,0,110,138
1.33,2,3,128,3,18,665,24,128,0,0,0,0,0
0.055,17,2,154,1,33,0,33,61,1,65,0,65,93
365.998,6,69,28501,29,743,13071,1408,10439,40,694,9384,1470,18062
83.863,6,76,49395,48,1164,1784,1448,39778,28,741,3017,2359,9617
2.485,17,3,1164,3,360,1242,360,1164,0,0,0,0,0
1421.4,17,373,36430,166,117,8614,1350,24192,207,31,6899,60,12238
1785.539,17,45,15112,45,307,40580,308,15112,0,0,0,0,0
0.366,1,2,112,2,28,366,28,112,0,0,0,0,0
1681.028,17,12,498,11,14,168102,14,462,1,8,0,8,36
1742.369,1,8,848,8,78,248909,78,848,0,0,0,0,0
2.162,6,14,2351,8,188,308,245,700,6,703,383,1152,1651
1449.114,6,81,6067,53,37,27867,205,3705,28,33,53664,98,2362
1790.673,1,248,13888,248,28,7249,28,13888,0,0,0,0,0
1795.851,1,8,448,8,28,256550,28,448,0,0,0,0,0
41.825,6,43,13429,20,529,2201,1152,8741,23,470,1884,1179,4688
0.055,6,9,1002,5,213,13,213,417,4,421,13,421,585
0.667,6,38,11707,22,592,31,1188,7660,16,356,38,1048,4047
1579.792,6,38,6778,26,241,63191,241,5378,12,92,143601,92,1400
3.759,6,25,6859,11,257,371,517,1621,14,643,285,1418,5238
0.051,6,4,251,1,0,0,0,64,3,31,24,31,187
29.007,17,2,908,2,426,29007,687,908,0,0,0,0,0
0.412,6,44,19983,25,998,17,1414,14993,19,421,22,1889,4990
6.592,6,10,1695,5,100,1648,100,304,5,589,1583,1152,1391
47.756,6,3752,3567947,2511,1344,18,1440,3496353,1241,1033,38,1440,71594
1758.459,17,378,61126,378,133,4664,386,61126,0,0,0,0,0
280.197,6,27,7312,13,158,23349,267,1317,14,775,21551,2800,5995
3.916,17,4,240,4,32,1305,32,240,0,0,0,0,0
1787.698,6,371,23534,213,69,8432,69,13005,158,69,11383,69,10529
91.95,6,18,1532,6,180,112,180,680,12,110,8343,110,852
100.438,6,354,282036,222,1312,453,1360,270110,132,254,765,4027,11926
0.747,6,21,7798,14,370,57,663,2590,7,1209,116,1946,5208
0.035,6,3,120,2,0,35,0,80,1,0,0,0,40
1789.142,6,370,28309,215,121,8360,1189,16376,155,88,11617,485,11933
0.229,6,10,1495,5,507,57,507,727,5,556,57,556,768
66.351,6,16,1183,8,177,9478,177,649,8,110,9224,110,534
1779.792,17,142,11360,71,48,25425,48,5396,71,56,25425,56,5964
3.617,6,2,88,2,0,0,0,88,0,0,0,0,0
17.949,17,22,6942,10,388,1991,1350,4168,12,203,1628,1350,2774
1789.988,17,32,10496,32,300,57741,300,10496,0,0,0,0,0
8.017,17,2,2500,2,1222,8017,1222,2500,0,0,0,0,0
176.049,6,74,49312,46,1173,3912,1408,41113,28,841,2282,2816,8199
11.009,6,18,5610,10,275,1223,275,958,8,1440,856,1440,4652
18.862,17,35,9819,18,310,1107,1350,6101,17,190,1176,1350,3718
1791.294,6,366,24534,212,87,8489,469,14096,154,69,11705,69,10438
358.401,1,22,2332,22,78,17066,78,2332,0,0,0,0,0
16.841,6,11,862,3,112,8420,112,240,8,90,2382,90,622
2.466,6,49,19014,28,937,91,1460,13353,21,400,114,1460,5661
1773.093,1,69,5796,0,0,0,0,0,69,56,26074,56,5796
21.841,6,16,3042,9,187,2730,293,1115,7,547,3589,1179,1927
1798.028,6,367,25650,214,99,8441,469,15045,153,69,11828,69,10605
1788.574,6,122,14516,80,84,22640,498,6426,42,160,43621,1420,8090
1784.235,6,105,8416,68,65,26630,65,4930,37,59,49559,59,3486
0.821,17,2,237,1,72,0,72,100,1,109,0,109,137
3.478,17,5,290,5,30,869,30,290,0,0,0,0,0
34.013,6,13,5941,4,189,11334,267,547,9,1005,4250,2006,5394
1774.008,6,240,33579,148,154,12068,1221,17536,92,143,19491,2006,16043
1785.981,6,153,19582,91,304,19844,304,13860,62,83,29278,83,5722
1681.342,17,14,3843,7,30,280223,30,406,7,463,280222,463,3437
1777.201,17,140,11200,70,48,25756,48,5320,70,56,25756,56,5880
0.207,6,21,5000,10,137,23,267,1092,11,692,19,1467,3908
61.575,6,57,18845,29,891,462,1360,12830,28,348,2272,2667,6015
0.062,17,4,420,2,33,16,33,122,2,121,50,145,298
280.036,6,28,7352,13,158,23336,267,1317,15,678,19999,3436,6035
240.104,6,44,5422,23,247,10913,834,2949,21,152,12005,461,2473
2.074,6,14,2351,8,188,296,245,700,6,703,361,1152,1651
1772.524,6,180,15480,120,69,14895,69,8940,60,69,30041,69,6540
1789.901,6,451,26320,243,69,7396,69,13860,208,34,8646,64,12460
8.279,6,17,5313,9,275,1034,275,643,8,1084,1095,1414,4670
1782.439,6,378,29832,214,77,8368,267,13959,164,132,10934,1452,15873
0.359,6,27,9069,13,261,29,683,1728,14,943,26,1448,7341
162.128,6,18,5839,10,627,18014,1360,3538,8,247,23124,272,2301
21.511,6,25,6284,14,117,1654,159,1337,11,873,2148,1675,4947
1785.829,17,87,3648,86,14,21009,14,3612,1,8,0,8,36
1.568,17,24,10061,11,360,156,1350,4275,13,417,104,1350,5786
0.111,1,2,112,2,28,111,28,112,0,0,0,0,0
1478.392,17,32,3414,32,78,47690,371,3414,0,0,0,0,0
9.34,6,84,24645,42,535,227,1152,18824,42,459,221,1179,5821
1792.018,6,363,23007,210,69,8574,69,12678,153,69,11789,69,10329
177.177,6,40,20104,20,901,85,1460,7151,20,1103,9317,4328,12953
300.126,6,51,4339,20,93,15789,338,2303,31,53,10000,143,2036
0.109,17,2,572,1,39,0,39,67,1,477,0,477,505
5.691,6,39,7269,20,218,299,314,3423,19,513,302,1179,3846
1785.129,6,126,9679,69,26,26251,26,4102,57,117,31875,427,5577
39.725,17,22,1936,11,48,3971,48,836,11,72,3971,72,1100
217.069,6,16,1297,10,63,24118,63,715,6,57,43394,57,582
1787.905,6,376,26148,216,98,8315,469,15332,160,69,11244,69,10816
2.732,6,28,8890,16,277,182,565,1477,12,769,229,1380,7413
0.43,17,4,560,2,64,195,64,184,2,160,185,160,376
372.434,6,19,1303,14,177,28648,177,925,5,110,15167,110,378
67.454,6,27,7177,13,155,5621,267,1306,14,530,5188,2840,5871
16.755,6,3,166,1,0,0,0,40,2,46,16754,46,126
0.532,6,23,7428,13,273,44,663,2052,10,967,53,2736,5376
9.737,6,1515,1211556,802,1412,11,1448,1164820,713,776,13,1448,46736
0.185,6,45,21983,27,1062,7,1420,17042,18,467,10,1883,4941
1.672,6,13,2311,8,188,238,245,700,5,1407,353,1407,1611
0.395,6,12,1653,6,288,75,288,548,6,426,45,434,1105
43.643,6,52,16607,28,331,1616,1193,3277,24,948,1830,1591,13330
1.295,6,50,19500,27,906,49,1360,13804,23,433,50,1360,5696
259.663,6,25,7232,12,158,23605,267,1277,13,905,21634,4845,5955
300.771,6,40,8523,21,270,15038,734,1965,19,413,473,1460,6558
61.839,6,68,47461,43,1199,1472,1408,39427,25,960,2567,3847,8034
5.622,6,39,7285,20,218,295,314,3423,19,516,297,1179,3862
31.0,6,23,8857,12,290,2818,517,1237,11,1406,3048,2120,7620
1797.894,6,384,27144,220,102,8209,469,16099,164,69,11027,69,11045
15.379,17,17,6601,8,483,2186,1350,4095,9,250,1911,1350,2506
10.686,6,20,4442,11,275,1068,275,998,9,768,733,1440,3444
1752.903,1,54,4536,54,56,33073,56,4536,0,0,0,0,0
1799.088,17,449,39928,404,35,4464,288,25708,45,288,40023,288,14220
4.258,6,27,10116,14,660,327,1360,3234,13,907,340,1360,6882
2.002,6,75,58721,49,1254,41,1368,51464,26,982,71,2491,7257
22.162,6,20,3701,10,324,2462,585,1197,10,488,2457,580,2504
1.655,6,25,8753,15,283,118,582,1454,10,985,164,1420,7299
300.205,6,46,19569,27,1019,11546,1408,13713,19,486,2046,1491,5856
1745.541,6,90,6540,60,31,29585,31,4050,30,31,60182,31,2490
1.427,6,49,19324,27,896,54,1360,13668,22,476,58,2715,5656
16.73,6,16,6148,4,106,5576,106,274,12,538,1507,1420,5874
40.265,17,4,240,2,32,40264,32,120,2,32,40263,32,120
106.799,1,4,224,4,28,35599,28,224,0,0,0,0,0
2.715,17,2,780,2,362,2715,362,780,0,0,0,0,0
0.046,17,2,241,1,36,0,36,64,1,149,0,149,177
1772.613,6,180,15480,120,69,14895,69,8940,60,69,30041,69,6540
1755.901,6,106,6322,60,27,29760,27,3525,46,27,39018,27,2797
4.994,17,4,530,2,36,4984,36,128,2,173,4984,187,402
1740.771,17,29,6815,29,207,62170,207,6815,0,0,0,0,0
1785.853,6,104,8376,68,65,26654,65,4930,36,59,51021,59,3446
1799.595,17,503,100933,503,172,3584,336,100933,0,0,0,0,0
1696.982,1,8,448,8,28,242426,28,448,0,0,0,0,0
1747.753,6,96,7286,63,38,28189,205,4476,33,33,54605,98,2810
0.168,17,4,624,2,64,167,64,184,2,192,46,192,440
0.274,17,4,420,2,33,153,33,122,2,121,139,145,298
1793.416,17,65,2730,65,14,28022,14,2730,0,0,0,0,0
18.65,17,28,5917,14,223,1432,1350,3517,14,143,1432,1350,2400
1.347,6,31,8912,14,158,103,267,1357,17,687,78,1400,7555
1795.171,17,446,39832,401,35,4487,288,25612,45,288,40019,288,14220
1779.862,1,115,6440,115,28,15612,28,6440,0,0,0,0,0
1586.269,6,203,16268,78,80,20598,366,8182,125,49,12791,143,8086
0.006,17,2,122,1,33,0,33,61,1,33,0,33,61
0.077,6,5,200,3,0,38,0,120,2,0,21,0,80
10.483,6,15,6302,7,275,1747,275,559,8,1353,1320,1440,5743
1756.544,6,110,6594,62,26,28794,27,3661,48,26,37372,27,2933
0.099,17,2,187,1,43,0,43,71,1,88,0,88,116
3.887,17,5,1160,5,204,971,204,1160,0,0,0,0,0
1772.361,6,203,22365,130,75,13739,267,10063,73,135,24612,3417,12302
1772.981,6,181,15589,120,69,14899,69,8940,61,69,29545,69,6649
1770.047,6,101,9344,66,65,27231,65,5577,35,59,52057,59,3767
105.522,6,691,320595,355,833,298,1152,305199,336,488,314,1179,15396
161.148,17,4,240,2,32,161147,32,120,2,32,161147,32,120
138.603,17,4,352,2,60,138602,60,176,2,60,138602,60,176
1.221,6,24,8004,12,164,94,267,1288,12,1014,93,2896,6716
42.231,17,12,912,12,48,3839,48,912,0,0,0,0,0
10.27,1,8,832,0,0,0,0,0,8,76,1467,76,832
6.814,6,30,7432,13,158,567,267,1317,17,543,423,1400,6115
0.104,6,2,116,1,0,0,0,64,1,0,0,0,52
0.387,17,2,144,1,36,0,36,64,1,52,0,52,80
0.305,17,2,237,1,72,0,72,100,1,109,0,109,137
41.252,17,43,3238,25,40,1718,41,1715,18,56,2136,57,1523
234.194,17,9,3016,9,307,29274,308,3016,0,0,0,0,0
1776.424,17,138,11040,69,48,26123,48,5244,69,56,26123,56,5796
1.635,6,13,2311,8,188,233,245,700,5,1407,348,1407,1611
12.345,6,14,2243,8,210,1763,210,844,6,545,2468,905,1399
0.674,6,14,2598,7,288,76,288,600,7,568,79,853,1998
0.022,17,2,672,2,308,22,308,672,0,0,0,0,0
300.26,6,38,12387,21,593,15013,1408,4732,17,614,15231,1578,7655
222.313,6,506,227227,256,826,871,1152,211040,250,412,888,1179,16187
280.422,6,30,7432,13,158,23368,267,1317,17,603,17524,2076,6115
312.329,6,83,14715,40,308,8007,1368,7327,43,233,7435,1368,7388
33.659,6,33,5209,16,154,2243,722,1922,17,299,994,1408,3287
300.816,6,41,8877,17,308,18791,889,1947,24,331,13072,3488,6930
34.24,17,40,5880,20,48,1801,48,1520,20,190,1801,308,4360
221.736,6,29,6640,17,169,13858,516,1698,12,495,20139,1452,4942
62.02,6,71,53352,48,1192,1319,1368,45420,23,841,2807,2519,7932
1.429,6,34,11518,17,418,89,1360,3662,17,1023,77,1360,7856
6.499,6,10,628,3,106,3245,106,234,7,90,1081,90,394
1.606,6,49,20300,27,966,61,1440,14644,22,433,67,1440,5656
86.924,17,4,352,2,60,86923,60,176,2,60,86923,60,176
0.485,17,3,451,2,39,413,39,134,1,289,0,289,317
203.194,6,73,50997,47,1190,4417,1408,42912,26,960,2467,2816,8085
1.06,6,2,96,2,0,0,0,96,0,0,0,0,0
1.977,17,4,518,3,39,725,39,201,1,289,0,289,317
1747.972,6,97,7307,63,38,28193,205,4476,34,33,52957,98,2831
14.829,6,6,690,0,0,0,0,0,6,90,2965,90,690
1786.225,6,107,9105,70,72,25887,294,5338,37,65,49614,247,3767
280.504,6,30,7432,13,158,23375,267,1317,17,603,17524,2760,6115
97.089,6,29,7933,9,156,12134,267,1620,20,393,5109,1917,6313
0.823,17,12,6344,6,615,164,1350,3860,6,386,131,1350,2484
19.519,6,1900,1553296,1050,1385,18,1448,1500052,850,776,22,1448,53244
4.351,6,39,7285,20,218,229,314,3423,19,516,227,1179,3862
1741.813,6,87,6322,58,31,30558,31,3915,29,31,62207,31,2407
0.549,17,18,8347,8,562,77,1350,4720,10,334,57,1350,3627
0.322,6,7,659,3,71,160,139,371,4,68,106,68,288
1.76,17,20,5180,20,231,92,388,5180,0,0,0,0,0
1773.107,6,181,15589,120,69,14900,69,8940,61,69,29549,69,6649
0.297,2,3,96,3,8,148,8,96,0,0,0,0,0
0.345,6,14,6093,7,128,57,128,500,7,1305,50,1448,5593
2.9,17,4,624,4,128,966,128,624,0,0,0,0,0
3.541,6,2,88,2,0,0,0,88,0,0,0,0,0
167.979,17,4,240,2,32,167978,32,120,2,32,167978,32,120
6.966,17,3,2145,3,687,3483,687,2145,0,0,0,0,0
0.08,17,2,362,1,46,0,46,74,1,260,0,260,288
33.911,6,32,5146,15,154,2422,722,1859,17,299,2106,1408,3287
38.964,17,22,1672,22,48,1855,48,1672,0,0,0,0,0
63.448,6,38,10063,14,328,144,1189,2541,24,327,2758,1420,7522
0.86,6,10,1687,7,100,143,100,384,3,1179,305,1179,1303
56.36,6,28,7217,13,155,4696,267,1306,15,482,4025,2840,5911
300.644,6,39,20525,21,514,15032,1114,3671,18,1223,2090,4206,16854
63.762,6,41,9785,21,650,444,1360,4138,20,402,3346,2667,5647
1773.182,6,180,15480,120,69,14900,69,8940,60,69,30049,69,6540
1752.658,6,99,7442,64,38,27819,205,4528,35,33,51526,98,2914
280.448,6,30,7432,13,158,23370,267,1317,17,603,17525,2036,6115
2.375,17,4,1552,4,360,791,360,1552,0,0,0,0,0
280.615,6,30,7432,13,158,23384,267,1317,17,603,17535,2076,6115
0.528,17,3,451,2,39,208,39,134,1,289,0,289,317
150.742,6,22,8452,11,314,72,634,1415,11,940,15060,1460,7037
1795.719,1,232,12992,232,28,7773,28,12992,0,0,0,0,0
51.719,6,38,5566,17,154,3232,722,1963,21,227,2572,1408,3603
96.638,17,7,2344,7,306,16106,308,2344,0,0,0,0,0
1681.355,17,14,3843,7,30,280224,30,406,7,463,280224,463,3437
5.005,17,4,288,2,36,5003,36,128,2,52,5003,52,160
300.664,6,36,8205,20,245,15824,633,1812,16,521,565,3488,6393
300.935,6,47,10572,25,619,12538,1360,4783,22,326,412,1360,5789
0.443,6,238,269049,108,262,4,517,7471,130,2022,3,12618,261578
1791.628,17,142,11360,71,48,25594,48,5396,71,56,25594,56,5964
0.024,6,10,1512,5,503,6,503,771,5,473,5,473,741
1771.493,6,103,9448,66,65,27253,65,5577,37,59,49204,59,3871
1782.328,17,142,11360,71,48,25461,48,5396,71,56,25461,56,5964
31.923,6,4072,3846188,2598,1400,12,1448,3764876,1474,776,21,1448,81312
1797.535,17,87,3648,86,14,21147,14,3612,1,8,0,8,36
29.589,6,49,13232,23,173,1344,722,2656,26,733,1143,1380,10576
0.086,6,10,1042,5,213,21,213,417,5,421,16,421,625
1787.921,6,353,22262,206,69,8721,69,12311,147,69,12245,69,9951
126.648,17,4,240,2,32,126647,32,120,2,32,126646,32,120
280.436,6,25,7232,12,158,25494,267,1277,13,775,23364,3465,5955
0.33,17,6,2155,6,331,66,359,2155,0,0,0,0,0
1789.817,17,140,11200,70,48,25939,48,5320,70,56,25939,56,5880
2.23,17,4,1344,4,308,743,308,1344,0,0,0,0,0
29.841,6,12,1313,7,185,4973,185,557,5,244,7458,476,756
8.111,17,2,152,2,48,8111,48,152,0,0,0,0,0
4.52,17,4,352,2,60,4519,60,176,2,60,4519,60,176
0.395,6,10,1185,6,279,79,279,587,4,191,61,272,598
0.081,17,2,240,1,48,0,48,76,1,136,0,136,164
0.07,17,2,128,1,28,0,28,56,1,44,0,44,72
0.12,17,2,154,1,33,0,33,61,1,65,0,65,93
1793.488,17,144,11520,72,48,25260,48,5472,72,56,25260,56,6048
1780.769,17,142,11360,71,48,25438,48,5396,71,56,25438,56,5964
1787.906,6,363,24255,210,83,8554,981,13590,153,74,11762,405,10665
1773.682,1,108,6048,108,28,16576,28,6048,0,0,0,0,0
41.543,17,32,5412,16,48,2768,48,1216,16,234,2768,308,4196
35.924,17,20,1760,10,48,3990,48,760,10,72,3990,72,1000
0.405,6,12,1653,6,288,78,288,548,6,426,45,434,1105
7.766,6,15,1362,8,275,1109,275,878,7,96,995,96,484
0.007,17,2,384,1,39,0,39,67,1,289,0,289,317
13.661,1,9,756,0,0,0,0,0,9,56,1707,56,756
280.04,6,31,7472,15,158,20002,267,1397,16,603,18666,2800,6075
1782.53,17,83,3480,82,14,22006,14,3444,1,8,0,8,36
369.353,6,25,1651,17,177,23084,177,1117,8,110,9764,110,534
0.613,6,4,191,3,31,184,31,151,1,0,0,0,40
1796.173,6,359,22778,209,69,8635,69,12500,150,69,12054,69,10278
33.853,6,31,5093,15,154,2418,721,1858,16,342,2241,1368,3235
909.135,6,116,14872,66,82,12477,267,5289,50,168,18553,1420,9583
1789.146,1,315,26460,315,56,5697,56,26460,0,0,0,0,0
300.081,6,41,9732,22,543,14282,1360,4170,19,399,16662,1360,5562
165.36,17,4,352,2,60,165359,60,176,2,60,165359,60,176
18.308,6,1681,1537524,1007,1441,17,1448,1492156,674,776,26,1448,45368
68.008,6,33,8279,15,150,4857,267,1662,18,490,3997,1420,6617
895.844,6,77,10630,38,95,19316,501,3430,39,181,23572,1420,7200
11.894,6,1890,1667561,1173,1366,10,1380,1632219,717,421,16,1923,35342
1408.422,6,83,6727,55,65,26081,65,3955,28,59,52155,59,2772
158.493,6,28,6391,9,267,393,501,1165,19,343,8800,1420,5226
461.13,6,121,15100,57,150,8234,1189,5152,64,199,7317,1420,9948
0.029,6,2,80,1,0,0,0,40,1,0,0,0,40
1799.549,1,16,896,16,28,119969,28,896,0,0,0,0,0
249.262,6,38,8338,16,461,148,1408,5450,22,192,11869,580,2888
1755.8,6,105,6270,60,27,29758,27,3525,45,27,39903,27,2745
1795.143,17,80,3354,79,14,23014,14,3318,1,8,0,8,36
0.457,6,15,2458,8,323,65,582,1082,7,334,66,580,1376
705.466,1,8,994,8,96,100780,117,994,0,0,0,0,0
15.393,17,20,13208,11,964,1533,1350,10922,9,226,1912,1350,2286
113.133,17,4,352,2,60,113131,60,176,2,60,113132,60,176
196.224,6,29,7392,14,158,15094,267,1357,15,678,14012,3436,6035
1799.087,1,345,28980,345,56,5229,56,28980,0,0,0,0,0
299.548,6,6,364,4,31,99849,31,222,2,31,299533,31,142
25.761,6,31,6321,12,148,114,194,958,19,327,1420,2567,5363
1792.426,17,180,14040,180,50,10013,50,14040,0,0,0,0,0
1.562,6,47,18197,26,882,62,1360,12581,21,476,68,2715,5616
1790.133,6,391,25167,217,81,8287,469,13758,174,52,10347,69,11409
47.946,6,26,8612,13,401,3989,1050,2290,13,706,3991,1571,6322
153.481,1,6,336,6,28,30696,28,336,0,0,0,0,0
1743.462,6,95,7203,63,38,28120,205,4476,32,33,56228,98,2727
300.194,1,12,1272,12,78,27290,78,1272,0,0,0,0,0
208.622,1,4,224,4,28,69540,28,224,0,0,0,0,0
0.378,6,27,8949,13,227,31,547,1592,14,827,28,1408,7357
1335.208,6,85,11507,53,96,20851,498,4527,32,203,43068,1420,6980
20.337,6,17,2316,10,189,2259,517,1298,7,323,3379,499,1018
1.99,17,3,222,3,46,995,46,222,0,0,0,0,0
281.14,6,32,7512,14,158,21626,267,1357,18,543,16532,1380,6155
1763.249,6,130,7920,70,26,25553,26,4206,60,26,29884,26,3714
0.819,6,24,6208,14,264,62,662,1888,10,979,90,1731,4320
2.081,17,2,329,1,45,0,45,73,1,228,0,228,256
19.62,6,8,506,0,0,0,0,0,8,31,2802,31,506
280.462,6,28,7352,12,158,25496,267,1277,16,678,18691,2760,6075
0.637,6,10,924,5,283,111,283,551,5,105,104,105,373
1743.045,6,95,7203,63,38,28113,205,4476,32,33,56219,98,2727
1.233,6,49,20600,28,922,45,1360,14984,21,476,52,2715,5616
4.047,6,28,8993,14,357,311,721,1635,14,754,290,1420,7358
1744.875,6,95,7203,63,38,28143,205,4476,32,33,56276,98,2727
4.171,17,26,16954,14,803,320,1350,11644,12,414,344,1350,5310
1796.771,17,449,39928,404,35,4458,288,25708,45,288,40018,288,14220
95.1,6,910,446048,491,841,194,1152,424497,419,398,226,1152,21551
111.523,6,143,38574,72,519,473,1460,20719,71,340,1591,1642,17855
1772.497,6,180,15480,120,69,14894,69,8940,60,69,30037,69,6540
1686.614,17,12,498,11,14,168661,14,462,1,8,0,8,36
0.051,6,3,182,2,31,51,31,111,1,31,0,31,71
4.15,6,2,88,2,0,0,0,88,0,0,0,0,0
280.429,6,28,7352,13,158,23369,267,1317,15,775,20028,4836,6035
16.678,17,26,18266,14,815,1277,1350,11815,12,509,1509,1350,6451
1786.434,6,102,8364,68,66,26663,66,4964,34,60,54131,60,3400
10.975,6,20,4390,11,275,1097,275,998,9,755,780,1414,3392
107.368,6,14,1080,4,226,236,226,442,10,110,11909,110,638
9.11,6,16,2297,9,324,1138,585,1125,7,396,1515,580,1172
6.348,6,1786,1748800,1198,1386,5,1408,1713560,588,776,10,1408,35240
0.158,6,26,7256,13,155,13,267,1301,13,603,12,2800,5955
240.249,6,57,18072,32,673,7749,1402,15201,25,195,10009,580,2871
1681.526,17,14,1036,7,30,280248,30,406,7,62,280249,62,630
10.678,6,39,8010,19,218,593,314,3383,20,546,548,1179,4627
1764.259,2,20,640,20,8,92855,8,640,0,0,0,0,0
1788.124,6,354,22440,207,69,8680,69,12420,147,69,12247,69,10020
92.58,6,9,998,8,105,13225,105,954,1,0,0,0,44
0.249,17,3,451,2,39,235,39,134,1,289,0,289,317
1242.215,6,260,19371,141,140,8872,1189,10991,119,55,10527,421,8380
8.798,6,79,24930,41,568,219,1152,19269,38,459,231,1179,5661
0.545,6,121,87870,55,131,10,232,2729,66,1352,8,2471,85141
7.896,6,1204,1601180,483,342,16,351,28914,721,2164,10,9576,1572266
1796.534,1,59,4956,0,0,0,0,0,59,56,30974,56,4956
4.894,17,4,288,2,36,4841,36,128,2,52,4846,52,160
1793.224,17,83,3480,82,14,22138,14,3444,1,8,0,8,36
0.516,17,3,451,2,39,244,39,134,1,289,0,289,317
463.019,6,43,13821,28,377,17148,1360,6818,15,710,33059,3494,7003
1.438,6,10,1687,7,100,239,100,384,3,1179,587,1179,1303
8.658,6,17,5391,9,275,1082,275,643,8,1104,970,1440,4748
3.394,6,25,7557,12,262,304,517,1432,13,777,279,1418,6125
415.011,17,6,1996,6,304,83002,308,1996,0,0,0,0,0
3.231,17,4,304,2,48,3224,48,152,2,48,3223,48,152
0.025,17,2,495,1,39,0,39,67,1,400,0,400,428
1642.721,1,8,448,8,28,234674,28,448,0,0,0,0,0
374.687,6,21,1422,15,180,26763,180,992,6,110,12250,110,430
0.128,6,9,1002,5,213,32,213,417,4,421,31,421,585
1779.094,17,140,11200,70,48,25783,48,5320,70,56,25783,56,5880
28.785,6,30,7574,12,156,2616,267,1272,18,398,1692,3417,6302
1185.241,6,235,14920,135,70,8845,138,8229,100,69,11972,69,6691
10.309,6,8,348,3,0,5154,0,128,5,0,1623,0,220
1791.353,6,1487,414008,736,739,2437,1418,353541,751,59,2388,580,60467
0.676,6,10,924,5,283,115,283,551,5,105,120,105,373
15.492,6,27,4868,13,154,1245,722,1767,14,394,1163,1448,3101
20.298,6,19,2432,10,189,2255,517,1298,9,323,2532,499,1134
0.051,17,2,152,1,48,0,48,76,1,48,0,48,76
1.757,6,25,8764,15,285,125,587,1459,10,985,171,1420,7305
0.441,17,2,2748,2,1346,441,1346,2748,0,0,0,0,0
1777.803,17,73,3060,72,14,25039,14,3024,1,8,0,8,36
1.247,6,4,212,2,0,1247,0,100,2,0,1,0,112
8.335,6,1568,1439973,996,1371,8,1408,1405565,572,931,14,2801,34408
1313.344,17,104,8320,52,48,25751,48,3952,52,56,25751,56,4368
6.389,6,27,8909,16,338,425,663,2883,11,1353,635,3314,6026
1.027,6,29,8521,15,225,62,561,1985,14,852,66,1360,6536
201.015,6,30,2235,13,82,16751,138,934,17,69,9743,69,1301
82.004,17,4,352,2,60,82003,60,176,2,60,82003,60,176
1792.083,6,356,22520,208,69,8657,69,12460,148,69,12190,69,10060
41.25,17,4,352,2,60,41248,60,176,2,60,41249,60,176
2.467,17,2,685,1,308,0,308,336,1,321,0,321,349
38.897,17,22,1672,22,48,1852,48,1672,0,0,0,0,0
90.176,6,41,9776,15,223,257,405,2393,26,316,3606,3417,7383
7.327,6,40,7325,21,218,366,314,3463,19,516,392,1179,3862
1684.475,2,15,480,15,8,120319,8,480,0,0,0,0,0
1740.515,17,29,6815,29,207,62161,207,6815,0,0,0,0,0
1681.813,17,14,1036,7,30,280298,30,406,7,62,280299,62,630
1787.741,6,117,13854,76,81,23836,501,5990,41,159,44691,1420,7864
33.678,6,33,5198,16,154,2245,722,1911,17,299,2092,1448,3287
204.349,6,40,10155,15,236,287,314,2968,25,412,8503,1179,7187
256.586,6,29,7001,14,229,135,498,1712,15,390,18321,1420,5289
119.973,6,26,5717,11,162,1640,293,1418,15,410,8551,1179,4299
1788.639,6,356,22520,208,69,8640,69,12460,148,69,12167,69,10060
10.998,6,20,4442,11,275,1099,275,998,9,768,788,1440,3444
0.544,6,22,7345,13,334,45,663,2021,9,1209,63,1946,5324
1789.076,1,58,4872,58,56,31387,56,4872,0,0,0,0,0
1786.967,6,102,8296,68,65,26671,65,4930,34,59,54146,59,3366
1680.585,17,12,498,11,14,168058,14,462,1,8,0,8,36
120.526,6,5947,5165671,3792,1282,31,1368,5048923,2155,776,55,1473,116748
254.604,1,4,224,4,28,84868,28,224,0,0,0,0,0
143.004,17,18,1378,9,40,17873,41,617,9,56,17873,57,761
59.911,17,3,228,3,48,29955,48,228,0,0,0,0,0
4.704,17,5,4754,5,922,1176,1451,4754,0,0,0,0,0
111.94,6,21,9896,11,380,66,832,1613,10,1311,12424,2568,8283
0.123,6,3,144,1,0,0,0,52,2,0,123,0,92
16.362,17,21,5307,10,266,1814,1350,2940,11,187,1633,1350,2367
1773.078,6,100,9358,66,66,27278,66,5610,34,60,53726,60,3748
20.429,6,19,2313,7,283,3376,283,1229,12,105,1841,105,1084
0.058,6,4,220,3,0,29,0,168,1,0,0,0,52
1771.746,6,101,9344,66,65,27257,65,5577,35,59,52107,59,3767
1787.085,17,140,11200,70,48,25899,48,5320,70,56,25899,56,5880
298.486,6,34,8006,13,158,24873,267,1317,21,417,14923,2045,6689
1.435,17,2,154,1,33,0,33,61,1,65,0,65,93
453.04,1,26,1456,26,28,18121,28,1456,0,0,0,0,0
1304.164,6,215616,204335278,89603,338,14,340,5331990,126013,1527,10,5608,199003288
6.418,6,551,468883,321,1387,19,1448,452259,230,776,27,1448,16624
280.029,6,29,7392,13,158,23335,267,1317,16,603,18665,1400,6075
1.426,6,19,3966,10,158,158,174,878,9,681,165,1452,3088
125.544,6,23,8901,11,295,73,578,1359,12,1007,11401,1460,7542
248.58,6,7,328,2,0,248580,0,88,5,0,3857,0,240
0.205,17,14,9436,6,711,41,1350,4436,8,597,22,1350,5000
0.841,6,23,8166,12,201,76,290,1115,11,942,63,2720,7051
280.23,6,29,7392,13,158,23352,267,1317,16,603,18677,1400,6075
1785.235,17,73,3060,72,14,25144,14,3024,1,8,0,8,36
1789.269,6,356,22520,208,69,8643,69,12460,148,69,12171,69,10060
7.97,6,40,7400,20,218,419,314,3423,20,453,405,1179,3977
240.248,6,54,17780,29,777,8580,1408,14731,25,217,10010,580,3049
32.185,6,24,2412,10,199,3576,517,1171,14,147,2475,147,1241
0.023,6,4,208,2,0,16,0,104,2,0,20,0,104
1798.281,6,100,7799,66,43,27665,205,4837,34,35,54481,98,2962
739.628,1,4,224,4,28,246542,28,224,0,0,0,0,0
1741.297,6,87,6322,58,31,30549,31,3915,29,31,62188,31,2407
1786.332,6,105,8416,68,65,26661,65,4930,37,59,49617,59,3486
1786.071,6,165,14200,90,110,20068,208,10239,75,31,23902,31,3961
377.511,2,3,96,3,8,188755,8,96,0,0,0,0,0
226.658,17,26,2288,13,48,18887,48,988,13,72,18887,72,1300
8.61,6,17,5313,9,275,1076,275,643,8,1084,889,1414,4670
5.363,6,40,7309,20,218,282,314,3423,20,440,269,1152,3886
1798.381,1,345,28980,345,56,5227,56,28980,0,0,0,0,0
0.004,17,2,364,1,62,0,62,90,1,246,0,246,274
0.236,6,19,4920,10,137,26,267,1092,9,866,28,2867,3828
1780.846,17,47,15792,47,308,38714,308,15792,0,0,0,0,0
1795.311,17,447,39864,402,35,4477,288,25644,45,288,40021,288,14220
1.297,6,231,176606,134,1336,9,1420,168435,97,427,13,1420,8171
1785.921,6,104,8444,68,66,26655,66,4964,36,60,51023,60,3480
1787.106,6,410,35491,231,115,7770,1189,18045,179,135,10039,3466,17446
0.324,17,8,2766,8,317,46,356,2766,0,0,0,0,0
1741.293,17,28,6580,28,207,64492,207,6580,0,0,0,0,0
14.514,1,10,929,10,64,1612,78,929,0,0,0,0,0
1720.542,17,12,498,11,14,172054,14,462,1,8,0,8,36
0.492,6,406,396022,272,183,1,230,15477,134,2830,3,14080,380545
0.51,17,3,451,2,39,267,39,134,1,289,0,289,317
147.333,6,25,9908,12,549,69,1460,2709,13,952,12266,1460,7199
0.011,17,2,387,1,35,0,35,63,1,296,0,296,324
0.116,6,2,92,1,0,0,0,40,1,0,0,0,52
1.4,6,38,9127,20,399,73,1360,3631,18,433,71,1360,5496
3.313,17,4,1556,4,361,1104,361,1556,0,0,0,0,0
1.351,6,49,20189,27,958,51,1460,14533,22,433,55,1460,5656
0.059,17,2,503,1,40,0,40,68,1,407,0,407,435
1789.983,6,371,26348,212,104,8483,469,15503,159,69,11328,69,10845
297.57,17,2,386,2,165,297570,165,386,0,0,0,0,0
280.214,6,22,6974,10,181,31134,267,1128,12,766,25471,2045,5846
1.408,6,47,19784,28,873,52,1360,14248,19,529,68,4075,5536
0.322,6,27,9043,13,252,26,647,1692,14,945,24,1408,7351
0.105,6,12,1867,7,125,17,125,497,5,367,26,500,1370
11.873,6,1932,1636813,1155,1364,10,1380,1601458,777,387,15,1923,35355
36.065,6,16,1221,9,182,4508,182,678,7,77,5903,134,543
21.391,17,28,9630,13,211,1780,1350,3107,15,406,1525,1350,6523
302.372,6,62,11483,31,104,10079,267,2822,31,322,10077,1420,8661
103.465,6,79,54437,49,1210,2155,1408,46143,30,840,2125,2439,8294
48.593,17,4,1344,4,308,16197,308,1344,0,0,0,0,0
0.29,6,27,9043,13,247,24,624,1672,14,947,20,1438,7371
146.544,17,8,2688,8,308,20934,308,2688,0,0,0,0,0
1.635,6,30,8649,14,141,112,267,1455,16,792,97,1448,7194
586.232,1,6,489,6,53,117246,78,489,0,0,0,0,0
39.747,17,22,1672,22,48,1892,48,1672,0,0,0,0,0
1198.199,6,106,10307,58,97,21019,407,5857,48,45,25484,98,4450
3.305,6,52,35783,33,954,103,1360,11849,19,2105,176,6087,23934
1795.064,17,80,3354,79,14,23013,14,3318,1,8,0,8,36
86.977,6,29,7392,13,158,7248,267,1317,16,603,5795,1400,6075
4.307,17,6,1344,6,196,861,205,1344,0,0,0,0,0
0.002,6,2,949,1,0,0,0,40,1,869,0,869,909
277.903,1,4,224,4,28,92634,28,224,0,0,0,0,0
374.134,6,25,1651,17,177,23383,177,1117,8,110,9239,110,534
38.44,17,12,912,12,48,3494,48,912,0,0,0,0,0
0.013,17,2,162,1,36,0,36,64,1,70,0,70,98
1743.154,6,95,7203,63,38,28115,205,4476,32,33,56220,98,2727
1743.478,1,60,5040,60,56,29550,56,5040,0,0,0,0,0
1776.938,17,73,3060,72,14,25027,14,3024,1,8,0,8,36
1785.608,6,365,25432,213,100,8422,469,14936,152,69,11824,69,10496
1795.446,6,366,24534,212,87,8509,469,14096,154,69,11734,69,10438
1781.632,17,142,11360,71,48,25451,48,5396,71,56,25451,56,5964
1682.729,17,14,1036,7,30,280447,30,406,7,62,280449,62,630
369.537,6,27,1767,18,177,21737,177,1181,9,110,8599,110,586
1772.73,6,180,15480,120,69,14896,69,8940,60,69,30041,69,6540
1793.364,6,356,22520,208,69,8663,69,12460,148,69,12196,69,10060
1797.854,17,228,57535,228,224,7920,422,57535,0,0,0,0,0
1794.235,1,166,17596,166,78,10874,78,17596,0,0,0,0,0
1637.095,6,563,121749,276,524,5953,1360,92645,287,103,5723,4080,29104
1.787,6,24,8671,14,276,137,561,1393,10,982,178,1420,7278
1755.679,6,186,11385,93,47,19083,208,6766,93,31,19080,31,4619
1775.802,6,181,15589,120,69,14922,69,8940,61,69,29589,69,6649
0.277,17,4,768,2,39,263,39,134,2,289,10,289,634
57.778,6,12048,12070432,8291,1380,6,1408,11870392,3757,776,15,1408,200040
0.038,17,2,904,1,300,0,300,328,1,548,0,548,576
0.232,6,20,4960,10,137,25,267,1092,10,692,24,1467,3868
295.468,1,4,224,4,28,98489,28,224,0,0,0,0,0
1788.858,17,395,48921,173,174,10400,1350,35065,222,34,8093,61,13856
1792.014,6,244,35804,152,302,11867,302,26032,92,83,19692,83,9772
240.272,6,42,9186,20,523,12645,1408,5758,22,252,11441,618,3428
300.296,6,26,8092,14,417,23099,1114,2418,12,720,3012,2899,5674
382.63,6,10,432,7,0,63771,0,288,3,0,1515,0,144
15.871,17,29,21596,18,1042,931,1350,19269,11,183,1584,1350,2327
0.423,6,6,324,4,0,141,0,216,2,0,219,0,108
49.559,6,38,6779,22,111,2359,267,2227,16,558,3270,1452,4552
280.2,6,32,7512,15,158,20014,267,1397,17,543,17510,1400,6115
1779.501,17,142,11360,71,48,25421,48,5396,71,56,25421,56,5964
61.328,6,36,16089,22,819,2920,1408,9363,14,748,4698,2439,6726
0.067,17,2,152,1,40,0,40,68,1,56,0,56,84
0.158,17,2,904,2,424,158,548,904,0,0,0,0,0
1798.27,17,448,39896,403,35,4473,288,25676,45,288,40020,288,14220
0.371,6,4,1037,2,0,212,0,104,2,853,171,853,933
348.047,6,47,6350,25,116,14501,721,2589,22,215,16563,1448,3761
377.917,2,3,96,3,8,188958,8,96,0,0,0,0,0
504.067,2,3,96,3,8,252033,8,96,0,0,0,0,0
20.885,6,20,4450,12,275,1898,275,1050,8,768,890,1440,3400
40.278,6,9,529,5,45,10069,45,313,4,0,13420,0,216
1799.517,6,356,22520,208,69,8693,69,12460,148,69,12241,69,10060
42.636,2,4,128,4,8,14212,8,128,0,0,0,0,0
1772.25,6,180,15480,120,69,14892,69,8940,60,69,30035,69,6540
1786.513,6,104,8308,68,64,26664,64,4896,36,58,51040,58,3412
1770.043,6,99,9306,66,66,27231,66,5610,33,60,55310,60,3696
1770.487,6,99,9174,66,64,27238,64,5544,33,58,55324,58,3630
3.873,17,3,1167,3,361,1936,361,1167,0,0,0,0,0
0.0,17,2,166,1,47,0,47,75,1,63,0,63,91
0.232,17,2,334,1,32,0,32,60,1,246,0,246,274
1755.437,6,181,11154,91,48,19504,208,6624,90,31,19721,31,4530
114.189,6,41,8691,19,410,641,882,2058,22,441,5431,1360,6633
0.47,6,9,527,5,43,117,43,311,4,0,146,0,216
2.469,6,24,8004,12,164,183,267,1288,12,1014,194,2331,6716
1729.199,6,64,4684,41,33,43229,33,2825,23,31,78591,31,1859
2.987,17,2,1430,2,687,2987,687,1430,0,0,0,0,0
301.232,2,4,128,4,8,100410,8,128,0,0,0,0,0
48.308,6,43,9378,24,117,2100,377,1941,19,555,2581,1702,7437
1.378,6,31,6155,17,142,86,267,1686,14,780,94,1460,4469
11.849,6,25,8473,13,275,987,275,1078,12,986,853,1440,7395
0.009,6,2,92,1,0,0,0,40,1,0,0,0,52
0.024,17,2,466,1,72,0,72,100,1,338,0,338,366
0.386,17,2,602,1,46,0,46,74,1,500,0,500,528
5.224,17,3,208,2,36,5003,36,128,1,52,0,52,80
240.181,6,39,5353,18,205,14128,517,2379,21,232,12008,851,2974
0.205,6,27,7296,13,155,17,267,1301,14,603,14,1400,5995
0.441,6,16,5015,9,290,55,517,1069,7,893,40,1497,3946
22.026,17,4,288,2,36,22021,36,128,2,52,22025,52,160
1772.409,6,180,15480,120,69,14894,69,8940,60,69,30039,69,6540
0.016,17,2,180,1,30,0,30,58,1,94,0,94,122
0.344,17,12,4377,12,336,31,359,4377,0,0,0,0,0
1789.419,17,87,3648,86,14,21051,14,3612,1,8,0,8,36
21.365,17,12,1056,6,48,4270,48,456,6,72,4270,72,600
272.049,17,4,352,2,60,272047,60,176,2,60,272048,60,176
71.415,6,27,6404,10,267,3530,502,1206,17,322,4457,1420,5198
0.462,17,2,152,1,48,0,48,76,1,48,0,48,76
1796.041,1,200,11200,200,28,9025,28,11200,0,0,0,0,0
2.809,17,12,6382,6,615,561,1350,3860,6,392,244,1350,2522
300.277,6,45,29535,24,190,13055,444,2053,21,1758,12048,6599,27482
928.125,1,62,6572,62,78,15215,78,6572,0,0,0,0,0
0.223,17,2,167,1,39,0,39,67,1,72,0,72,100
9.86,17,14,17072,14,1191,758,1451,17072,0,0,0,0,0
0.278,6,25,8960,13,252,23,646,1694,12,1105,23,2804,7266
72.122,6,31,7544,13,155,6010,267,1306,18,423,4242,3417,6238
69.104,6,30,7297,14,155,5315,267,1346,16,441,4605,1420,5951
1771.98,6,99,9240,66,65,27261,65,5577,33,59,55371,59,3663
1770.17,6,210,16142,78,68,22987,294,7634,132,48,13512,78,8508
302.101,6,45,18416,25,369,12587,661,3596,20,860,3581,2518,14820
1193.556,1,8,1269,8,130,170508,147,1269,0,0,0,0,0
4.105,6,42,13248,17,326,26,469,4280,25,379,170,1420,8968
49.949,6,44,15409,24,626,441,1152,13491,20,557,2628,741,1918
1781.718,6,366,23329,212,69,8444,69,12896,154,67,11643,69,10433
1777.792,17,73,3060,72,14,25039,14,3024,1,8,0,8,36
369.418,6,27,1767,18,177,21730,177,1181,9,110,8956,110,586
280.459,6,29,7392,13,158,23371,267,1317,16,603,18694,2760,6075
304.519,6,18,1355,9,332,38063,332,808,9,83,38063,83,547
1758.794,1,57,4788,57,56,31407,56,4788,0,0,0,0,0
286.513,17,4,240,2,32,286512,32,120,2,32,286512,32,120
17.273,17,13,7474,6,650,3448,1350,4071,7,458,2873,1350,3403
1799.989,17,87259,3490300,43637,8,41,8,1570932,43622,16,41,16,1919368
1793.651,17,179,33715,179,160,10076,428,33715,0,0,0,0,0
1773.032,6,182,15698,120,69,14899,69,8940,62,69,29062,69,6758
1793.443,17,141,11268,72,48,25255,48,5472,69,56,26372,56,5796
0.071,17,2,251,1,36,0,36,64,1,159,0,159,187
11.793,6,25,8473,13,275,982,275,1078,12,986,850,1440,7395
5.821,6,43,7429,22,218,277,314,3503,21,440,276,1152,3926
1772.437,6,180,15480,120,69,14894,69,8940,60,69,30033,69,6540
1.432,6,47,19001,26,947,57,1460,13385,21,476,62,2615,5616
1764.76,1,63,5292,0,0,0,0,0,63,56,28463,56,5292
1786.166,6,102,8296,68,65,26659,65,4930,34,59,54122,59,3366
1.581,6,38,8087,19,293,87,998,2551,19,433,76,1360,5536
36.697,17,4,304,4,48,12232,48,304,0,0,0,0,0
16.623,6,30,5055,15,154,1187,722,1871,15,400,1175,1408,3184
3.466,6,2,88,2,0,0,0,88,0,0,0,0,0
0.567,6,56,23786,32,1012,18,1380,18539,24,387,22,1923,5247
6.485,17,25,7801,10,305,720,1350,3338,15,269,233,1350,4463
10.756,6,19,7010,11,275,1075,275,998,8,1893,860,2840,6012
1792.034,6,356,22520,208,69,8657,69,12460,148,69,12190,69,10060
1787.389,6,385,24037,219,69,8199,69,12900,166,57,10798,69,11137
856.189,1,8,448,8,28,122312,28,448,0,0,0,0,0
1791.479,17,73,3060,72,14,25232,14,3024,1,8,0,8,36
14.266,17,2,152,2,48,14266,48,152,0,0,0,0,0
1788.038,6,356,22520,208,69,8637,69,12460,148,69,12163,69,10060
1799.336,1,74,6216,74,56,24648,56,6216,0,0,0,0,0
12.134,17,10,965,5,46,3032,46,370,5,91,3031,91,595
0.108,17,2,144,1,36,0,36,64,1,52,0,52,80
1786.574,6,365,23087,211,69,8507,69,12787,154,69,11676,69,10300
0.463,6,12,1653,6,288,86,288,548,6,426,53,434,1105
1680.516,1,15,840,15,28,120036,28,840,0,0,0,0,0
99.945,6,30,7432,13,158,8328,267,1317,17,543,6243,1400,6115
1774.906,6,180,15480,120,69,14915,69,8940,60,69,30077,69,6540
1786.446,6,102,8364,68,66,26663,66,4964,34,60,54131,60,3400
1749.769,6,219,17865,111,100,15906,208,12646,108,31,16350,31,5219
1798.332,1,58,4872,58,56,31549,56,4872,0,0,0,0,0
240.291,6,43,9239,21,523,12014,1408,5810,22,253,11442,619,3429
1765.106,1,50,2800,50,28,36022,28,2800,0,0,0,0,0
4.587,6,6,395,0,0,0,0,0,6,31,917,31,395
0.233,6,28,7336,14,155,17,267,1341,14,603,16,2036,5995
74.604,6,27,9605,13,703,74,1360,3412,14,702,5726,1753,6193
1742.19,6,95,7203,63,38,28099,205,4476,32,33,56185,98,2727
9.883,6,84,24565,44,533,229,1152,18824,40,459,246,1179,5741
1794.813,6,366,25679,212,99,8506,469,14965,154,69,11729,69,10714
1742.464,6,94,7151,62,38,28564,205,4424,32,33,56198,98,2727
0.013,17,4,632,3,60,0,60,264,1,340,0,340,368
120.254,2,2,64,2,8,120254,8,64,0,0,0,0,0
0.661,17,3,507,2,39,380,39,134,1,345,0,345,373
7.763,17,12,1764,6,48,1550,48,456,6,190,1550,308,1308
9.007,6,78,24341,40,550,230,1152,18680,38,459,236,1179,5661
11.822,6,1918,1631712,1151,1363,10,1380,1596790,767,421,15,1923,34922
0.213,6,37,24499,17,180,13,250,1434,20,1223,6,1440,23065
1.262,6,44,10145,23,440,57,1360,4484,21,400,54,1360,5661
180.458,2,4,128,4,8,60152,8,128,0,0,0,0,0
0.917,6,27,5927,14,156,70,267,1502,13,650,69,1452,4425
1772.167,6,182,15629,121,69,14768,69,8980,61,69,29531,69,6649
24.592,17,4,352,2,60,24591,60,176,2,60,24591,60,176
1773.671,6,181,15589,120,69,14904,69,8940,61,69,29556,69,6649
240.33,6,41,8260,21,449,12015,1418,5596,20,230,12648,580,2664
0.589,17,2,152,1,48,0,48,76,1,48,0,48,76
62.812,17,4,352,2,48,62803,48,152,2,72,62800,72,200
176.0,6,30,16074,14,533,73,1287,2205,16,1201,11721,1524,13869
3.796,17,2,152,2,48,3796,48,152,0,0,0,0,0
1.42,6,47,18562,26,913,56,1460,12946,21,433,61,1460,5616
1795.638,17,448,39896,403,35,4466,288,25676,45,288,40018,288,14220
0.007,6,2,1022,1,930,0,930,982,1,0,0,0,40
1793.27,1,198,20988,198,78,9102,78,20988,0,0,0,0,0
0.195,17,2,144,1,36,0,36,64,1,52,0,52,80
311.095,1,4,224,4,28,103698,28,224,0,0,0,0,0
38.472,17,44,6468,22,48,1830,48,1672,22,190,1828,308,4796
368.62,6,23,1535,16,177,24574,177,1053,7,110,10373,110,482
6.251,2,2,64,2,8,6251,8,64,0,0,0,0,0
10.91,6,20,4442,11,275,1091,275,998,9,768,764,1440,3444
0.239,17,2,602,1,46,0,46,74,1,500,0,500,528
5.873,6,39,7285,21,218,293,314,3463,18,516,329,1179,3822
31.468,6,7,308,1,0,0,0,44,6,0,6273,0,264
1166.908,17,794,55629,724,40,1613,41,49709,70,56,515,57,5920
1788.607,17,142,11360,71,48,25550,48,5396,71,56,25551,56,5964
0.004,6,2,414,1,322,0,322,374,1,0,0,0,40
90.693,6,15,2237,9,324,11336,585,1125,6,396,18104,580,1112
14.684,6,21,1979,12,222,1310,222,1372,9,231,1833,231,607
234.579,1,4,224,4,28,78193,28,224,0,0,0,0,0
7.275,6,1522,1385234,950,1380,7,1408,1350826,572,931,12,2801,34408
38.465,6,6,328,4,0,12821,0,216,2,0,38449,0,112
10.154,6,14,1247,7,222,1691,222,728,7,231,1691,231,519
11.919,6,1869,1645835,1139,1391,10,1420,1612414,730,467,16,1883,33421
1717.264,6,355,24404,152,46,11337,46,9844,203,46,8501,46,14560
1770.458,6,87,6322,58,31,31060,31,3915,29,31,63229,31,2407
1739.376,6,87,6322,58,31,30515,31,3915,29,31,62120,31,2407
0.037,17,2,522,1,72,0,72,100,1,394,0,394,422
1104.031,6,14,1940,14,98,84925,138,1940,0,0,0,0,0
1.355,6,50,19264,27,889,52,1460,13568,23,433,52,1460,5696
240.398,6,54,15701,27,703,9243,1418,12662,27,203,9244,580,3039
252.088,1,6,336,6,28,50417,28,336,0,0,0,0,0
26.974,6,4,425,4,54,8991,124,425,0,0,0,0,0
367.067,6,23,1538,16,180,24471,180,1056,7,110,10398,110,482
129.363,6,30,13946,16,852,55,1360,6637,14,962,9938,1725,7309
180.72,2,5,160,5,8,45180,8,160,0,0,0,0,0
2.125,6,2,1520,1,0,0,0,40,1,1440,0,1440,1480
8.886,6,2,104,2,0,0,0,104,0,0,0,0,0
0.446,6,27,8920,13,227,37,547,1592,14,941,33,1438,7328
7.144,6,102,196038,71,133,102,201,3407,31,7088,232,49700,192631
0.005,17,2,547,1,40,0,40,68,1,451,0,451,479
21.282,6,91,28180,44,566,494,1152,21040,47,438,456,1179,7140
98.728,17,4,240,2,32,98727,32,120,2,32,98727,32,120
164.466,6,57,11200,25,204,6842,721,4272,32,402,5297,1440,6928
1750.674,17,12,498,11,14,175067,14,462,1,8,0,8,36
106.03,6,48,10100,22,237,2950,1189,3259,26,445,4240,1917,6841
1794.12,6,240,35580,150,302,12041,302,25920,90,83,20158,83,9660
5.07,6,40,7309,20,218,266,314,3423,20,440,252,1152,3886
1787.46,6,148,19670,95,219,19015,1295,13467,53,94,34371,269,6203
1769.175,1,186,10416,186,28,9563,28,10416,0,0,0,0,0
1796.504,17,449,39928,404,35,4457,288,25708,45,288,40019,288,14220
1794.081,17,80,3354,79,14,23001,14,3318,1,8,0,8,36
1787.699,17,142,11360,71,48,25538,48,5396,71,56,25537,56,5964
1786.823,6,102,8364,68,66,26669,66,4964,34,60,54142,60,3400
1330.276,17,12,3159,6,31,266051,37,355,6,439,266053,463,2804
0.877,6,52,13869,24,551,38,1429,4840,28,438,31,1460,9029
1744.707,2,27,864,27,8,67104,8,864,0,0,0,0,0
2.295,17,2,196,1,62,0,62,90,1,78,0,78,106
1.653,17,3,204,3,40,826,40,204,0,0,0,0,0
895.347,17,176,13376,176,48,5116,48,13376,0,0,0,0,0
503.558,1,3,168,3,28,251779,28,168,0,0,0,0,0
64.392,6,35,8416,17,410,538,916,1943,18,478,3780,2720,6473
1787.681,6,3175,3333840,1106,126,1617,333,65490,2069,1584,864,4206,3268350
0.306,6,28,7336,13,155,25,267,1301,15,543,19,1400,6035
0.033,17,2,904,1,300,0,300,328,1,548,0,548,576
1792.654,1,67,5628,67,56,27161,56,5628,0,0,0,0,0
0.005,17,2,554,1,64,0,64,92,1,434,0,434,462
1770.526,6,103,9519,67,65,26826,65,5641,36,59,50583,59,3878
0.0,17,1,480,1,452,0,452,480,0,0,0,0,0
1785.378,17,87,3648,86,14,21004,14,3612,1,8,0,8,36
280.505,6,26,7272,12,158,25500,267,1277,14,678,21572,2085,5995
1788.674,17,142,11360,71,48,25552,48,5396,71,56,25551,56,5964
45.08,6,35,8320,17,378,595,786,1846,18,478,2643,2128,6474
0.188,6,28,7336,14,155,14,267,1341,14,603,12,2800,5995
240.223,6,54,17954,29,758,8579,1408,15168,25,184,10009,580,2786
5.31,6,39,7269,19,218,295,314,3383,20,513,266,1179,3886
0.197,17,2,152,1,48,0,48,76,1,48,0,48,76
1781.921,6,358,22876,207,69,8650,69,12420,151,69,11879,69,10456
2.086,2,3,96,3,8,1043,8,96,0,0,0,0,0
0.266,17,2,166,1,47,0,47,75,1,63,0,63,91
1788.747,17,88,3687,86,13,21041,14,3607,2,12,1788569,16,80
0.005,17,2,394,1,63,0,63,91,1,275,0,275,303
0.138,6,3,132,1,0,0,0,52,2,0,138,0,80
314.104,6,20,2429,7,242,52350,517,1111,13,323,26175,499,1318
5.986,17,2,152,2,48,5986,48,152,0,0,0,0,0
1665.018,1,7,742,7,78,277503,78,742,0,0,0,0,0
4.273,6,36,8460,18,308,251,888,1986,18,441,243,1360,6474
6.985,17,4,352,2,60,6984,60,176,2,60,6984,60,176
299.241,2,4,128,4,8,99747,8,128,0,0,0,0,0
127.638,6,14,3150,4,92,42546,92,296,10,332,14160,1448,2854
111.66,6,15,1308,3,106,55830,106,234,12,80,10138,90,1074
282.335,1,50,1400,50,0,0,0,1400,0,0,0,0,0
6.286,6,1381,1247085,855,1380,7,1408,1215069,526,931,11,2816,32016
1775.756,6,286,34134,121,135,14796,1460,16956,165,125,10826,1642,17178
323.393,1,13,728,13,28,26949,28,728,0,0,0,0,0
1740.626,17,29,6815,29,207,62165,207,6815,0,0,0,0,0
1781.761,6,415,24880,207,69,8649,69,12420,208,34,8607,64,12460
20.311,6,19,2432,10,189,2256,517,1298,9,323,2532,499,1134
4.063,17,5,295,5,31,1015,31,295,0,0,0,0,0
0.773,6,162,126117,74,215,10,250,5196,88,1368,8,1735,120921
1101.308,1,74,4144,74,28,15086,28,4144,0,0,0,0,0
280.253,6,30,7432,13,158,23354,267,1317,17,543,17512,1400,6115
46.836,17,7,1151,4,37,15580,39,262,3,268,23160,289,889
1793.563,1,58,4872,0,0,0,0,0,58,56,31466,56,4872
111.608,17,4,352,2,60,111607,60,176,2,60,111607,60,176
1783.519,6,116,13755,76,81,23780,501,5990,40,162,45728,1420,7765
0.16,17,8,2758,8,316,22,355,2758,0,0,0,0,0
1799.353,17,178,13884,178,50,10165,50,13884,0,0,0,0,0
9.238,6,14,1247,7,222,1530,222,728,7,231,1533,231,519
1796.846,17,448,39896,403,35,4469,288,25676,45,288,40021,288,14220
0.81,6,28,9179,13,257,67,669,1726,15,831,54,1438,7453
300.774,2,3,96,3,8,150387,8,96,0,0,0,0,0
1625.619,1,8,448,8,28,232231,28,448,0,0,0,0,0
337.609,6,36,7232,17,154,14589,516,1764,19,294,18750,1452,5468
20.342,6,37,15858,20,899,1070,1360,6255,17,891,1258,3639,9603
11.925,6,1893,1647050,1142,1388,10,1420,1612789,751,467,15,1883,34261
1754.431,6,101,7974,66,45,26991,205,4927,35,35,51592,98,3047
1792.038,6,121,10578,64,27,28444,27,3757,57,166,31999,430,6821
1756.184,6,107,6374,60,27,29765,27,3525,47,27,38177,27,2849
81.931,6,44,11710,15,291,2418,1189,2650,29,375,2925,1420,9060
1772.988,6,181,15589,120,69,14899,69,8940,61,69,29548,69,6649
1781.039,17,138,11040,69,48,26191,48,5244,69,56,26191,56,5796
1684.013,17,14,1036,7,30,280660,30,406,7,62,280660,62,630
123.263,17,14,1232,7,48,20542,48,532,7,72,20542,72,700
44.727,6,20,4463,9,341,5590,722,1487,11,342,4452,1408,2976
6.915,6,42,8289,21,227,345,314,4022,21,489,320,1179,4267
1798.531,6,183,16138,122,75,14863,469,9489,61,69,29970,69,6649
0.513,17,3,451,2,39,249,39,134,1,289,0,289,317
1218.369,6,67,13289,43,147,29008,721,6738,24,558,532,2007,6551
0.043,17,2,198,1,39,0,39,67,1,103,0,103,131
1770.552,6,105,9632,69,64,26037,64,5776,36,58,50584,58,3856
0.805,6,10,1687,7,100,134,100,384,3,1179,276,1179,1303
0.175,6,2,80,1,0,0,0,40,1,0,0,0,40
2.156,6,30,7432,13,158,179,267,1317,17,543,134,1400,6115
23.459,6,36,9488,22,136,1117,159,2389,14,707,1803,1675,7099
4.975,17,8,664,4,39,1333,39,268,4,71,1652,71,396
297.156,17,4,240,2,32,297155,32,120,2,32,297155,32,120
12.048,6,81,24147,41,519,301,1152,18779,40,470,300,1179,5368
0.958,6,27,8420,15,222,57,540,1964,12,1192,71,3151,6456
138.257,6,854,392090,435,834,318,1152,369457,419,391,329,1179,22633
0.927,6,11,1727,7,100,154,100,384,4,589,218,1152,1343
306.931,17,50,54068,50,1053,6263,1450,54068,0,0,0,0,0
11.603,6,1840,1603121,1117,1380,10,1420,1569980,723,467,16,1883,33141
10.839,6,81,24749,41,560,270,1152,19008,40,459,269,1179,5741
1796.491,17,448,39896,403,35,4468,288,25676,45,288,40018,288,14220
33.727,6,32,5147,15,154,2409,722,1859,17,300,2095,1440,3288
1.375,6,116,88577,50,131,28,232,2529,66,1367,18,1430,86048
280.246,6,29,7392,14,158,21557,267,1357,15,678,20013,3436,6035
45.954,6,9,570,6,43,9190,43,406,3,0,22975,0,164
1784.829,6,416,24920,208,69,8622,69,12460,208,34,8622,48,12460
1.308,6,25,8056,12,164,100,267,1288,13,869,91,1448,6768
1.832,17,4,240,2,32,1831,32,120,2,32,1831,32,120
1.241,17,21,5883,9,330,151,1350,3226,12,193,109,1350,2657
180.562,2,3,96,3,8,90281,8,96,0,0,0,0,0
280.194,6,31,7472,14,158,21553,267,1357,17,543,17510,1400,6115
0.391,6,12,1641,6,288,76,288,548,6,420,43,422,1093
53.821,6,37,9561,18,811,519,1460,3999,19,399,2980,1460,5562
0.105,17,2,1920,2,932,105,932,1920,0,0,0,0,0
3.283,17,29,9253,13,419,273,1350,5811,16,187,216,1350,3442
1.038,6,5,262,4,31,324,31,222,1,0,0,0,40
164.888,6,66,14424,40,165,4227,267,3330,26,717,6592,2045,11094
4.347,6,39,7269,20,218,228,314,3423,19,513,227,1179,3846
0.022,6,3,120,0,0,0,0,0,3,0,0,0,120
1797.316,6,372,26264,213,98,8477,469,15143,159,69,11373,69,11121
24.288,17,4,240,2,32,24287,32,120,2,32,24287,32,120
280.18,6,27,7312,13,158,23348,267,1317,14,775,21549,4836,5995
1787.93,6,371,29286,211,75,8513,267,13573,160,134,11244,1452,15713
5.583,6,40,7325,21,218,279,314,3463,19,516,296,1179,3862
1795.465,17,449,39928,404,35,4455,288,25708,45,288,40019,288,14220
0.176,17,2,140,1,34,0,34,62,1,50,0,50,78
11.256,6,27,11373,13,275,938,275,1078,14,1080,830,1420,10295
1783.709,6,103,8464,68,66,26622,66,4964,35,60,52459,60,3500
1794.775,17,388,68853,388,149,4637,385,68853,0,0,0,0,0
105.49,6,32,8952,14,158,8114,267,1357,18,624,6201,1400,7595
19.832,6,25,6757,12,181,1802,267,1212,13,717,1651,2036,5545
1740.945,6,91,6604,59,31,30016,31,3998,32,31,56158,31,2606
1.905,17,3,468,3,128,952,128,468,0,0,0,0,0
240.203,6,53,17816,28,803,8896,1402,15125,25,172,10008,580,2691
1796.71,17,449,39928,404,35,4458,288,25708,45,288,40020,288,14220
0.255,17,3,451,2,39,204,39,134,1,289,0,289,317
0.277,17,14,9425,8,832,34,1350,6883,6,395,47,1350,2542
0.013,6,2,116,0,0,0,0,0,2,0,0,0,116
280.189,6,29,7392,14,158,21553,267,1357,15,678,20011,2800,6035
40.88,17,42,6056,21,48,2043,48,1596,21,184,2043,308,4460
1681.221,17,16,1265,8,30,240171,37,471,8,71,240171,136,794
62.387,6,71,48155,45,1178,1417,1408,40069,26,960,2466,3847,8086
629.919,2,5,160,5,8,157479,8,160,0,0,0,0,0
4.188,6,40,7309,20,218,220,314,3423,20,440,207,1152,3886
4.971,17,2,128,2,36,4971,36,128,0,0,0,0,0
1796.222,17,140,11200,70,48,26032,48,5320,70,56,26032,56,5880
0.109,6,13,1175,7,146,16,146,430,6,250,19,499,745
55.667,6,35,5325,20,154,2929,722,2143,15,342,1102,1408,3182
5.675,2,2,64,2,8,5675,8,64,0,0,0,0,0
0.141,17,3,404,2,64,1,64,184,1,192,0,192,220
0.231,6,2,92,1,0,0,0,52,1,0,0,0,40
20.1,6,23,6856,6,154,4020,267,712,17,454,1236,1452,6144
0.936,17,4,368,2,32,923,32,120,2,96,914,96,248
1766.123,17,168,14082,156,30,11394,37,9090,12,388,154954,463,4992
0.605,17,18,7328,9,501,72,1350,4765,9,256,65,1350,2563
1.785,6,27,10187,16,286,119,591,1503,11,1030,160,1420,8684
60.017,6,37,11147,13,375,166,1189,3908,24,313,2609,1997,7239
1.434,6,45,18080,26,882,57,1360,12544,19,476,69,2715,5536
0.065,17,2,158,1,34,0,34,62,1,68,0,68,96
1782.991,6,363,23007,211,69,8490,69,12649,152,69,11807,69,10358
350.421,17,12,2472,6,48,70081,48,456,6,308,70081,308,2016
1791.514,17,180,14040,180,50,10008,50,14040,0,0,0,0,0
1770.24,6,102,9473,67,65,26821,65,5694,35,59,52061,59,3779
1755.64,1,79,6636,79,56,22508,56,6636,0,0,0,0,0
1794.052,6,377,26395,216,99,8344,469,15194,161,69,11212,69,11201
1790.113,17,142,11360,71,48,25572,48,5396,71,56,25572,56,5964
595.138,17,20,6688,20,306,31323,308,6688,0,0,0,0,0
44.373,6,37,8400,18,378,514,786,1886,19,478,2457,2720,6514
74.138,6,7,575,1,267,0,267,307,6,7,14825,7,268
0.269,6,25,6032,12,164,24,453,1442,13,651,21,1408,4590
31.37,6,23,1619,11,222,3136,222,888,12,231,2850,231,731
1792.544,6,121,7842,69,49,26360,208,4677,52,31,35143,31,3165
62.239,6,88,58164,51,1201,1244,1368,49505,37,840,1721,2519,8659
240.192,6,54,17817,30,747,8282,1402,15014,24,193,10442,580,2803
82.103,17,4,352,2,60,82102,60,176,2,60,82102,60,176
0.431,6,27,9069,13,261,35,683,1728,14,943,32,1408,7341
1758.447,6,105,6240,60,26,29799,26,3510,45,26,39959,26,2730
10.905,6,1657,1498360,1044,1384,10,1432,1468856,613,389,17,1432,29504
0.338,6,26,4717,13,165,28,456,1510,13,360,27,888,3207
1.355,6,48,18707,27,855,52,1360,13091,21,476,58,2715,5616
8.323,6,32,8952,14,158,640,267,1357,18,624,485,1400,7595
915.831,6,241,31165,99,193,9345,1360,13778,142,110,6461,4649,17387
7.775,6,16,1402,9,275,971,275,918,7,96,970,96,484
1740.741,17,30,31680,30,1028,60025,1028,31680,0,0,0,0,0
450.847,6,83,16029,41,184,8299,469,5530,42,238,10995,1460,10499
1.266,6,47,18627,27,852,48,1360,13051,20,476,57,2715,5576
280.24,6,28,7352,13,158,23353,267,1317,15,678,20013,3436,6035
492.793,17,6,1452,3,32,246394,37,181,3,395,246394,447,1271
58.105,17,4,1344,4,308,19368,308,1344,0,0,0,0,0
0.747,17,2,685,1,308,0,308,336,1,321,0,321,349
12.132,17,4,824,2,48,12113,48,152,2,308,12110,308,672
16.37,6,2012,1826314,1267,1362,12,1408,1782910,745,776,21,1408,43404
315.839,6,90,20510,45,336,7178,1360,10315,45,279,7175,3289,10195
3.52,17,2,632,1,288,0,288,316,1,288,0,288,316
0.075,17,2,383,1,33,0,33,61,1,294,0,294,322
16.927,17,6,528,3,48,8459,48,228,3,72,8458,72,300
0.447,6,6,324,4,0,149,0,216,2,0,250,0,108
0.53,6,20,8135,11,290,53,517,1149,9,1085,44,1812,6986
0.403,6,7,371,4,0,134,0,204,3,7,112,7,167
1.128,6,28,7996,13,156,94,267,1312,15,552,69,1997,6684
1.446,6,49,19045,26,876,57,1360,13349,23,476,57,2720,5696
1763.48,2,14,448,14,8,135652,8,448,0,0,0,0,0
1239.01,6,96,11241,57,79,22125,517,4482,39,314,30427,2414,6759
2.034,6,2,1030,1,0,0,0,40,1,950,0,950,990
0.194,1,2,112,2,28,194,28,112,0,0,0,0,0
373.954,6,21,1419,15,177,26711,177,989,6,110,13187,110,430
25.044,1,2,351,2,147,25044,207,351,0,0,0,0,0
0.064,17,2,154,2,49,64,49,154,0,0,0,0,0
159.621,6,57,35343,27,562,159,1460,5076,30,1383,5499,2920,30267
0.538,17,17,6087,8,389,72,1350,3339,9,277,57,1350,2748
1681.268,17,14,3771,7,30,280210,30,406,7,452,280210,463,3365
1.746,17,2,182,1,37,0,37,65,1,89,0,89,117
12.129,6,25,8473,13,275,1010,275,1078,12,986,905,1440,7395
90.688,17,20,1760,10,48,10075,48,760,10,72,10075,72,1000
1748.763,6,133,13408,82,68,21589,722,6998,51,93,34966,1408,6410
1797.276,17,449,39928,404,35,4459,288,25708,45,288,40019,288,14220
1770.268,6,99,9240,66,65,27234,65,5577,33,59,55317,59,3663
31.697,6,7,396,1,0,0,0,60,6,0,6302,0,336
0.268,17,2,152,1,48,0,48,76,1,48,0,48,76
0.135,17,2,152,1,48,0,48,76,1,48,0,48,76
2.906,17,4,1370,2,308,1912,308,672,2,321,1910,321,698
34.036,6,30,5042,15,154,2431,722,1860,15,399,2416,2026,3182
747.038,2,10,320,10,8,83004,8,320,0,0,0,0,0
300.798,6,47,10406,24,433,13078,910,3218,23,347,587,4080,7188
21.168,6,15,817,7,31,3499,31,497,8,0,2999,0,320
1791.194,17,87,3648,86,14,21072,14,3612,1,8,0,8,36
104.232,17,5,380,5,48,26058,48,380,0,0,0,0,0
1679.223,2,23,736,23,8,76328,8,736,0,0,0,0,0
1744.637,2,27,864,27,8,67101,8,864,0,0,0,0,0
12.202,6,119,43663,62,661,200,1152,36901,57,407,213,1152,6762
2.702,6,22,6404,10,262,295,517,1316,12,744,241,1418,5088
782.072,2,8,256,8,8,111724,8,256,0,0,0,0,0
0.155,17,2,182,1,39,0,39,67,1,87,0,87,115
0.039,6,12,3409,6,100,7,100,420,6,889,7,1448,2989
817.461,17,66,5280,33,48,25545,48,2508,33,56,25545,56,2772
1291.804,6,132,11352,88,69,14848,69,6556,44,69,30032,69,4796
1.816,6,26,8811,16,286,121,591,1503,10,986,179,2760,7308
1798.599,17,448,39896,403,35,4474,288,25676,45,288,40023,288,14220
1764.609,2,15,480,15,8,126043,8,480,0,0,0,0,0
4.855,17,17,11909,8,659,693,1350,5497,9,684,519,1350,6412
1681.023,1,15,840,15,28,120073,28,840,0,0,0,0,0
28.803,6,73,26094,37,635,800,1152,20545,36,410,815,1152,5549
0.129,17,2,362,1,46,0,46,74,1,260,0,260,288
1.919,6,20,6553,10,181,174,267,1128,10,1004,210,4836,5425
1794.598,17,144,11520,72,48,25275,48,5472,72,56,25275,56,6048
1797.784,6,3775,3479629,1370,129,1313,343,81018,2405,1404,747,2836,3398611
280.612,6,28,7352,13,158,23384,267,1317,15,678,20037,2045,6035
1783.965,17,138,11040,69,48,26234,48,5244,69,56,26234,56,5796
0.761,6,11,1727,7,100,126,100,384,4,589,170,1152,1343
8.889,6,24,7593,12,301,808,721,1691,12,774,630,1414,5902
1797.41,1,262,14672,262,28,6886,28,14672,0,0,0,0,0
280.432,6,30,7432,14,158,21571,267,1357,16,678,18691,3456,6075
126.217,2,2,64,2,8,126217,8,64,0,0,0,0,0
1772.586,6,180,15480,120,69,14895,69,8940,60,69,30037,69,6540
131.921,1,6,336,6,28,26384,28,336,0,0,0,0,0
54.061,6,26,7137,13,155,4505,267,1306,13,589,4504,4837,5831
0.853,6,20,5948,11,281,85,544,1288,9,716,95,1420,4660
1087.116,17,114,9754,105,30,10452,37,6125,9,375,128177,463,3629
68.184,6,27,7198,11,155,6818,267,1226,16,443,4543,1420,5972
0.975,6,27,8420,15,222,57,540,1964,12,1192,72,3151,6456
2.382,6,13,2311,8,188,340,245,700,5,1407,534,1407,1611
1752.114,6,103,8053,66,45,26955,205,4902,37,35,48661,98,3151
1791.998,6,359,22778,209,69,8615,69,12569,150,69,12026,69,10209
291.879,6,369,58723,203,304,1444,304,41020,166,83,1768,83,17703
1785.081,6,104,8444,68,66,26643,66,4964,36,60,50999,60,3480
0.643,6,14,1745,7,288,74,288,600,7,426,74,434,1145
7.303,17,37,7586,16,196,484,1350,3591,21,162,363,1350,3995
14.786,6,28,7352,13,158,1232,267,1317,15,678,1053,2800,6035
0.52,17,2,476,1,39,0,39,67,1,381,0,381,409
246.175,6,90,14248,41,235,6154,1189,5659,49,264,4646,1917,8589
5.012,17,4,288,2,36,4998,36,128,2,52,5000,52,160
125.404,6,14,3144,7,92,20900,92,452,7,464,20866,1408,2692
1031.152,6,207,15455,118,123,8813,469,9273,89,69,11716,69,6182
0.47,6,13,1693,6,288,88,288,548,7,426,42,434,1145
0.908,6,10,1687,7,100,151,100,384,3,1179,326,1179,1303
1786.444,1,60,5040,60,56,30278,56,5040,0,0,0,0,0
1744.427,6,98,7421,64,38,27689,205,4528,34,33,52807,98,2893
698.234,1,6,696,6,88,139646,88,696,0,0,0,0,0
1786.871,6,102,8228,68,64,26669,64,4896,34,58,54144,58,3332
146.209,6,25,11330,12,659,89,1360,3148,13,1092,12169,1360,8182
1797.357,1,345,28980,345,56,5224,56,28980,0,0,0,0,0
2.07,17,2,134,2,39,2070,39,134,0,0,0,0,0
8.43,6,44,7669,22,201,401,314,3703,22,513,387,1179,3966
1759.385,6,127,7726,69,26,25872,26,4142,58,26,30865,26,3584
0.295,17,2,167,1,39,0,39,67,1,72,0,72,100
9.045,6,1846,1700453,1165,1381,7,1408,1660377,681,931,13,2801,40076
1790.185,6,358,22669,209,69,8606,69,12569,149,69,12093,69,10100
240.188,6,55,17219,30,722,8282,1408,14570,25,167,10007,580,2649
15.175,17,16,9501,7,612,2524,1350,4486,9,529,1892,1350,5015
216.117,17,4,352,2,60,216116,60,176,2,60,216116,60,176
280.364,6,30,7432,13,158,23363,267,1317,17,543,17516,1400,6115
0.51,6,48,19231,26,1002,20,1380,14109,22,383,17,1380,5122
207.248,17,4,352,2,60,207247,60,176,2,60,207247,60,176
4.059,17,5,290,5,30,1014,30,290,0,0,0,0,0
3.927,17,4,352,2,48,3923,48,152,2,72,3920,72,200
1774.039,6,181,15589,120,69,14907,69,8940,61,69,29558,69,6649
2.908,17,4,1370,2,308,1915,308,672,2,321,1910,321,698
6.051,6,45,8409,23,211,275,314,4102,22,489,275,1179,4307
1792.76,6,281,36026,112,141,16149,1360,16718,169,147,10670,3302,19308
2.834,17,3,180,3,32,1417,32,180,0,0,0,0,0
1797.723,17,448,39896,403,35,4471,288,25676,45,288,40019,288,14220
1.304,6,14,1688,7,256,215,256,796,7,304,215,304,892
1781.776,6,371,25810,215,99,8326,469,15154,156,69,11495,69,10656
1787.0,6,105,8406,68,64,26671,64,4896,37,58,49636,58,3510
1797.211,6,485,43165,185,66,9576,615,13704,300,74,6010,1929,29461
9.421,17,12,1764,6,48,1881,48,456,6,190,1881,308,1308
1794.69,6,377,23912,216,69,8347,69,13332,161,69,11216,69,10580
3.025,17,4,624,4,128,1008,128,624,0,0,0,0,0
110.339,17,4,288,2,36,110338,36,128,2,52,110338,52,160
187.653,6,55,11982,21,261,9382,469,4247,34,235,5686,1420,7735
254.719,1,2,232,2,88,254719,88,232,0,0,0,0,0
264.385,17,4,352,2,60,264384,60,176,2,60,264384,60,176
1797.301,17,449,39928,404,35,4459,288,25708,45,288,40018,288,14220
0.913,6,10,1687,7,100,152,100,384,3,1179,319,1179,1303
4.753,6,719,729943,338,206,14,446,14448,381,1857,11,15752,715495
1799.502,17,87,3648,86,14,21170,14,3612,1,8,0,8,36
1.195,17,6,540,3,30,574,30,174,3,94,444,94,366
0.023,17,2,912,1,308,0,308,336,1,548,0,548,576
1795.178,6,133,8946,75,59,24259,208,5603,58,31,31487,31,3343
36.883,6,15,620,8,0,5267,0,324,7,0,6145,0,296
1772.139,6,180,15480,120,69,14891,69,8940,60,69,30029,69,6540
125.827,6,34,7935,12,155,29,267,1266,22,340,5991,3417,6669
1.838,17,43,19387,22,710,87,1350,16250,21,121,90,1350,3137
15.18,6,14,5625,5,106,3794,106,314,9,823,1896,1460,5311
14.863,17,4,824,2,48,14843,48,152,2,308,14842,308,672
62.421,6,15,5673,4,106,20803,106,274,11,706,6240,1460,5399
0.145,6,2,126,1,46,0,46,86,1,0,0,0,40
0.553,6,12,3658,6,125,95,125,445,6,964,97,1448,3213
280.041,6,28,7352,13,158,23336,267,1317,15,678,19999,3436,6035
504.608,2,5,160,5,8,126152,8,160,0,0,0,0,0
1.069,6,27,8506,15,229,64,583,2007,12,1201,81,3151,6499
0.881,17,2,268,1,54,0,54,82,1,158,0,158,186
16.024,6,13,2133,8,324,2289,585,1073,5,396,3993,580,1060
1746.362,6,95,7203,63,38,28167,205,4476,32,33,56322,98,2727
0.914,6,10,1687,7,100,152,100,384,3,1179,317,1179,1303
0.602,6,20,4960,10,137,66,267,1092,10,692,56,1467,3868
120.384,2,2,64,2,8,120384,8,64,0,0,0,0,0
1787.334,6,102,8296,68,65,26676,65,4930,34,59,54157,59,3366
1787.734,17,140,11200,70,48,25909,48,5320,70,56,25909,56,5880
0.273,6,26,9084,13,271,22,726,1795,13,1100,22,2816,7289
1743.848,6,95,7203,63,38,28126,205,4476,32,33,56244,98,2727
0.519,6,10,1514,5,503,129,503,771,5,475,129,475,743
1774.261,6,180,15480,120,69,14909,69,8940,60,69,30069,69,6540
240.937,6,45,6303,21,196,12044,585,3064,24,165,10473,580,3239
87.382,6,25,10089,12,531,67,1360,2637,13,988,7269,1360,7452
0.44,6,12,1653,6,288,86,288,548,6,426,46,434,1105
1799.396,1,15,840,15,28,128528,28,840,0,0,0,0,0
1786.871,6,103,8336,68,65,26669,65,4930,35,59,52552,59,3406
316.306,6,23,1550,15,180,22593,180,1016,8,110,9175,110,534
0.261,6,22,4442,11,165,26,456,1394,11,493,24,888,3048
1781.779,6,413,24800,206,69,8691,69,12380,207,34,8649,48,12420
3.405,17,4,1568,4,364,1135,364,1568,0,0,0,0,0
367.152,6,19,1303,14,177,28242,177,925,5,110,15156,110,378
1795.705,6,384,27144,220,102,8199,469,16099,164,69,11014,69,11045
1747.106,6,95,7203,63,38,28179,205,4476,32,33,56349,98,2727
373.964,6,23,1523,15,177,26711,177,989,8,110,9249,110,534
55.927,6,34,5260,20,154,2943,721,2130,14,479,1208,2026,3130
16.032,6,127,44564,66,648,246,1152,37642,61,447,262,1179,6922
240.167,6,118,92066,43,282,5717,876,3938,75,1315,3244,2836,88128
770.913,17,152,11552,152,48,5105,48,11552,0,0,0,0,0
0.106,17,2,245,1,32,0,32,60,1,157,0,157,185
1.116,6,28,8160,15,222,67,540,1964,13,944,75,1591,6196
0.164,17,2,136,1,32,0,32,60,1,48,0,48,76
1796.071,17,449,39928,404,35,4456,288,25708,45,288,40017,288,14220
1776.299,17,73,3060,72,14,25018,14,3024,1,8,0,8,36
22.793,6,18,788,8,0,3256,0,348,10,0,2421,0,440
1798.477,6,365,25032,213,94,8483,469,14536,152,69,11910,69,10496
68.814,6,18,1606,4,106,22938,106,274,14,74,5291,90,1332
1786.923,6,104,8435,69,65,26278,65,4970,35,59,52553,59,3465
31.309,6,22,6490,11,292,3126,517,1458,11,744,3126,1408,5032
0.013,17,2,214,1,39,0,39,67,1,119,0,119,147
0.006,17,8,1670,8,180,0,219,1670,0,0,0,0,0
1778.19,1,254,14224,254,28,7028,28,14224,0,0,0,0,0
103.033,6,36,15784,18,894,79,1360,6153,18,809,6050,2279,9631
281.786,6,29,7392,13,158,23482,267,1317,16,603,18761,2036,6075
0.653,6,23,4780,13,208,54,524,1715,10,507,62,1408,3065
0.253,17,2,152,1,48,0,48,76,1,48,0,48,76
107.59,6,26,12831,15,831,56,1360,5642,11,1122,10742,2720,7189
0.129,17,2,144,1,36,0,36,64,1,52,0,52,80
1799.999,6,226,19712,84,78,21686,376,8947,142,70,12765,1062,10765
0.09,6,10,767,5,186,18,186,454,5,45,17,45,313
0.099,6,2,302,1,210,0,210,262,1,0,0,0,40
1786.688,6,104,8376,68,65,26666,65,4930,36,59,51045,59,3446
1744.669,2,27,864,27,8,67102,8,864,0,0,0,0,0
5.026,17,4,558,2,36,5006,36,128,2,187,5009,187,430
1794.439,6,80,4250,40,26,46010,26,2132,40,26,46010,26,2118
1782.236,6,104,8376,68,65,26600,65,4930,36,59,50918,59,3446
1796.217,17,449,39928,404,35,4457,288,25708,45,288,40021,288,14220
1679.944,1,15,840,15,28,119996,28,840,0,0,0,0,0
0.06,17,4,284,2,32,40,32,120,2,54,40,60,164
0.208,1,2,112,2,28,208,28,112,0,0,0,0,0
4.344,1,4,482,4,92,1448,98,482,0,0,0,0,0
1681.292,17,14,1036,7,30,280210,30,406,7,62,280212,62,630
197.619,6,585,593641,409,1391,484,1408,573887,176,1324,908,1853,19754
8.312,17,2,152,2,48,8312,48,152,0,0,0,0,0
0.959,6,10,1687,7,100,159,100,384,3,1179,356,1179,1303
1772.387,6,241,17920,121,69,14769,69,8980,120,34,14893,48,8940
4.952,1,10,280,10,0,0,0,280,0,0,0,0,0
10.538,6,20,4442,11,275,1053,275,998,9,768,736,1440,3444
1700.736,17,13,534,11,14,170056,14,462,2,8,1700562,8,72
0.495,6,29,9715,14,308,38,590,2289,15,828,34,1408,7426
1742.572,6,95,7203,63,38,28106,205,4476,32,33,56199,98,2727
41.27,2,4,128,4,8,13756,8,128,0,0,0,0,0
820.617,17,10,821,5,31,205150,37,297,5,76,205150,136,524
300.344,6,44,26908,28,1155,11123,1408,21100,16,828,1631,1491,5808
7.995,6,19,8221,9,275,999,275,643,10,1194,818,1414,7578
232.827,6,29,8832,14,158,17909,267,1357,15,981,16627,3465,7475
17.542,17,37,9557,16,253,1167,1350,4501,21,212,875,1350,5056
127.73,6,37,5418,21,180,6386,722,2183,16,299,1523,1408,3235
9.179,17,8,772,4,46,3057,46,296,4,91,3057,91,476
121.607,6,21,3575,7,152,227,267,742,14,206,9336,1152,2833
0.01,17,4,680,2,33,0,33,122,2,251,0,323,558
0.033,6,6,716,3,302,10,302,458,3,102,9,102,258
0.227,17,2,214,1,39,0,39,67,1,119,0,119,147
252.005,2,3,96,3,8,126002,8,96,0,0,0,0,0
300.767,6,42,26223,20,724,15822,1460,5918,22,1294,14315,1460,20305
128.216,17,4,352,2,60,128215,60,176,2,60,128214,60,176
0.618,17,4,1108,2,30,607,30,116,2,468,606,468,992
882.116,1,8,448,8,28,126016,28,448,0,0,0,0,0
1766.483,1,58,4872,58,56,30990,56,4872,0,0,0,0,0
1777.899,17,142,11360,71,48,25397,48,5396,71,56,25398,56,5964
0.183,17,2,167,1,39,0,39,67,1,72,0,72,100
1.657,6,14,2351,8,188,236,245,700,6,703,280,1152,1651
1753.734,6,132,8468,76,46,23383,208,5515,56,31,23822,31,2953
1756.635,1,69,5796,0,0,0,0,0,69,56,25832,56,5796
1740.541,6,87,6322,58,31,30535,31,3915,29,31,62161,31,2407
1.374,6,10,1687,7,100,229,100,384,3,1179,560,1179,1303
1742.038,1,15,840,15,28,124431,28,840,0,0,0,0,0
1796.933,1,345,28980,345,56,5223,56,28980,0,0,0,0,0
4.133,17,5,364,4,32,1188,32,240,1,96,0,96,124
0.11,17,2,904,2,424,110,548,904,0,0,0,0,0
94.368,6,25,9794,12,532,62,1460,2642,13,945,7852,1460,7152
4.054,6,11,1086,6,213,810,213,461,5,421,292,421,625
1779.768,1,342,28728,342,56,5219,56,28728,0,0,0,0,0
10.108,6,20,6569,9,92,1263,92,592,11,600,990,1408,5977
373.551,6,25,1651,17,177,23346,177,1117,8,110,9241,110,534
1791.908,1,269,15064,269,28,6686,28,15064,0,0,0,0,0
1.593,6,25,8056,12,164,129,267,1288,13,869,118,1408,6768
1799.862,17,144,11520,72,48,25350,48,5472,72,56,25350,56,6048
1770.853,6,145,14743,83,80,21595,722,7455,62,81,29023,1408,7288
76.264,6,9,372,4,0,25421,0,164,5,0,17681,0,208
0.008,6,10,1634,6,131,1,131,451,4,967,2,967,1183
1741.309,6,89,6426,58,31,30549,31,3915,31,31,58042,31,2511
77.474,17,12,4032,12,308,7043,308,4032,0,0,0,0,0
0.223,6,2,100,1,0,0,0,60,1,0,0,0,40
5.845,17,12,2571,6,45,1166,45,438,6,327,1145,339,2133
0.505,17,3,451,2,39,454,39,134,1,289,0,289,317
0.005,17,2,539,1,35,0,35,63,1,448,0,448,476
21.801,6,8,506,0,0,0,0,0,8,31,3114,31,506
374.786,6,18,1242,14,180,28829,180,916,4,110,20082,110,326
1785.627,1,58,4872,58,56,31326,56,4872,0,0,0,0,0
1.467,6,50,19653,27,917,56,1460,13957,23,433,57,1460,5696
0.574,17,2,776,2,360,574,360,776,0,0,0,0,0
0.027,17,4,368,2,32,8,32,120,2,96,9,96,248
1745.111,6,95,7203,63,38,28146,205,4476,32,33,56284,98,2727
4.221,17,5,4754,5,922,1055,1451,4754,0,0,0,0,0
1634.44,1,50,2800,50,28,33355,28,2800,0,0,0,0,0
1.181,6,53,13946,25,553,49,1429,4908,28,439,43,1986,9038
1785.853,6,364,24316,211,88,8504,469,13987,153,69,11749,69,10329
16.588,17,36,7781,15,201,1182,1350,3443,21,178,827,1350,4338
1771.662,6,101,9410,66,66,27256,66,5610,35,60,52104,60,3800
6.756,6,29,7464,12,155,614,267,1266,17,423,421,3417,6198
480.446,6,10,586,6,31,96089,31,333,4,31,160145,31,253
1465.306,6,76,6003,44,64,26442,64,3168,32,50,47265,58,2835
0.512,17,3,1008,3,308,256,308,1008,0,0,0,0,0
0.758,6,15,2205,7,332,126,728,1296,8,192,83,374,909
186.407,17,6,360,3,32,93203,32,180,3,32,93202,32,180
4.643,6,40,7325,21,218,232,314,3463,19,516,243,1179,3862
1794.895,1,149,8344,149,28,12127,28,8344,0,0,0,0,0
1775.028,6,221,19449,82,82,21911,365,8910,139,70,12861,1062,10539
295.448,6,39,8812,18,326,17376,517,2261,21,778,14770,1418,6551
0.214,1,6,624,0,0,0,0,0,6,76,42,76,624
2.232,6,13,2311,8,188,318,245,700,5,1407,495,1407,1611
1.242,6,50,19154,27,881,47,1360,13458,23,433,48,1360,5696
1800.0,6,202,14106,71,46,25285,46,5830,131,46,13846,46,8276
3.263,6,24,8169,13,150,271,374,1275,11,1075,325,1731,6894
281.581,6,31,7472,13,158,23465,267,1317,18,603,16562,1400,6155
0.236,17,2,144,1,36,0,36,64,1,52,0,52,80
290.239,6,43,11265,21,1026,14511,1408,8355,22,293,13820,293,2910
0.698,6,11,440,6,0,139,0,240,5,0,136,0,200
11.504,6,48,19212,26,1111,460,1440,13301,22,358,537,1440,5911
0.613,17,2,116,2,30,613,30,116,0,0,0,0,0
377.483,6,51,9449,23,111,17158,267,2264,28,275,13980,1420,7185
21.418,17,2,904,1,300,0,300,328,1,548,0,548,576
1788.973,17,142,11360,71,48,25556,48,5396,71,56,25556,56,5964
0.385,17,8,2758,8,316,55,355,2758,0,0,0,0,0
1738.61,6,87,6322,58,31,30501,31,3915,29,31,62092,31,2407
20.128,6,22,6127,12,147,1829,318,1233,10,727,2235,1418,4894
30.193,6,6,328,4,0,10064,0,216,2,0,30179,0,112
1795.659,17,449,39928,404,35,4455,288,25708,45,288,40016,288,14220
1344.519,1,14,1682,14,92,103424,117,1682,0,0,0,0,0
0.265,17,8,2750,8,315,37,354,2750,0,0,0,0,0
125.561,6,14,11894,3,125,265,125,249,11,1244,12552,1460,11645
0.185,17,2,193,1,46,0,46,74,1,91,0,91,119
1777.312,17,140,11200,70,48,25758,48,5320,70,56,25758,56,5880
1786.578,17,87,3648,86,14,21018,14,3612,1,8,0,8,36
42.485,17,4,352,2,60,42484,60,176,2,60,42484,60,176
1741.681,1,16,896,16,28,116112,28,896,0,0,0,0,0
1785.692,17,87,3648,86,14,21008,14,3612,1,8,0,8,36
0.385,17,2,152,1,48,0,48,76,1,48,0,48,76
0.691,6,15,2204,8,288,90,288,640,7,424,86,434,1564
70.388,6,31,7475,14,155,5414,267,1346,17,418,4398,1997,6129
0.136,17,2,672,2,308,136,308,672,0,0,0,0,0
1.627,6,12,1163,6,222,323,222,688,6,231,323,231,475
13.57,6,27,4757,13,204,1115,722,1708,14,386,1003,1448,3049
1741.401,17,295,69895,295,208,5923,356,69895,0,0,0,0,0
0.006,6,3,2880,1,0,0,0,40,2,1368,0,1368,2840
23.868,17,63,17811,29,245,851,1350,7938,34,262,721,1350,9873
228.192,17,4,352,2,60,228191,60,176,2,60,228191,60,176
1776.976,1,152,8512,152,28,11768,28,8512,0,0,0,0,0
4.85,6,7,412,3,0,2335,0,164,4,0,1556,0,248
1680.205,1,7,392,7,28,280034,28,392,0,0,0,0,0
44.719,1,46,4784,0,0,0,0,0,46,76,993,76,4784
20.082,17,4,352,2,48,20068,48,152,2,72,20068,72,200
1794.655,17,87,3648,86,14,21113,14,3612,1,8,0,8,36
31.941,6,116,114343,39,139,840,339,2445,77,1458,420,2804,111898
1787.323,6,102,8228,68,64,26676,64,4896,34,58,54157,58,3332
1.534,6,50,21381,28,971,56,1460,15725,22,476,63,2615,5656
182.389,6,6896,6364716,4388,1366,41,1368,6212676,2508,931,72,2736,152040
1794.552,6,240,35580,150,302,12043,302,25920,90,83,20163,83,9660
1740.798,6,94,7151,62,38,28537,205,4424,32,33,56142,98,2727
0.499,6,23,7428,14,273,38,663,2104,9,1209,58,1946,5324
92.175,1,4,224,4,28,30725,28,224,0,0,0,0,0
980.382,1,60,6360,60,78,16616,78,6360,0,0,0,0,0
281.665,6,29,7392,13,158,23472,267,1317,16,603,18759,2036,6075
0.363,6,10,1992,5,288,85,288,508,5,424,49,434,1484
11.775,6,7,380,4,0,3925,0,216,3,0,5877,0,164
968.411,6,95,5704,44,42,18952,208,3044,51,31,19364,31,2660
40.245,6,39,9184,23,538,1829,1228,5499,16,203,2682,1282,3685
1.237,6,26,7243,14,298,95,834,2055,12,940,111,1731,5188
0.057,6,10,1806,6,619,11,1079,1483,4,159,18,159,323
1741.075,6,91,6604,59,31,30018,31,3998,32,31,56162,31,2606
1798.494,6,364,23985,212,81,8523,469,13627,152,69,11909,69,10358
1798.533,17,448,39896,403,35,4473,288,25676,45,288,40018,288,14220
282.238,6,36,2406,14,46,21710,46,1020,22,46,13439,46,1386
1789.816,17,142,11360,71,48,25568,48,5396,71,56,25568,56,5964
2.975,17,4,240,2,32,2974,32,120,2,32,2974,32,120
962.551,2,9,288,9,8,120318,8,288,0,0,0,0,0
0.146,17,2,586,1,46,0,46,74,1,484,0,484,512
28.466,6,16,3277,8,211,4066,211,870,8,665,4065,904,2407
0.461,6,12,1653,6,288,90,288,548,6,426,49,434,1105
1.313,6,50,19434,27,901,50,1360,13738,23,433,51,1360,5696
366.233,6,18,1239,14,177,28171,177,913,4,110,20055,110,326
1744.026,6,96,7286,63,38,28129,205,4476,33,33,54494,98,2810
1562.274,6,95,7079,57,39,27897,205,4071,38,33,42212,98,3008
300.624,6,64,32221,33,190,9394,444,2569,31,1121,8115,1621,29652
0.494,6,10,924,5,283,83,283,551,5,105,82,105,373
0.034,17,2,157,1,31,0,31,59,1,70,0,70,98
106.267,17,3,1008,3,308,53133,308,1008,0,0,0,0,0
0.722,6,26,6095,13,108,60,147,959,13,768,57,1581,5136
1.693,6,13,2311,8,188,241,245,700,5,1407,358,1407,1611
661.771,2,7,224,7,8,110295,8,224,0,0,0,0,0
0.762,17,4,344,2,47,755,47,150,2,69,754,75,194
0.005,17,4,1123,2,33,0,33,122,2,472,0,507,1001
1744.683,2,15,480,15,8,124620,8,480,0,0,0,0,0
1789.83,6,356,22520,208,69,8646,69,12460,148,69,12175,69,10060
0.314,6,27,8646,14,219,24,531,1625,13,1056,25,1408,7021
0.568,17,2,198,1,39,0,39,67,1,103,0,103,131
0.114,6,10,1495,5,507,28,507,727,5,556,28,556,768
0.35,6,9,1340,5,145,87,145,349,4,827,78,827,991
316.946,6,73,18864,37,322,8804,1360,9259,36,354,9051,1929,9605
278.105,6,30,8872,14,158,21392,267,1357,16,763,18539,2800,7515
274.461,6,211,154098,122,1319,2268,1448,136951,89,542,2210,1448,17147
1746.79,6,102,8147,67,48,26466,205,5021,35,37,51366,108,3126
0.629,17,15,8080,7,657,104,1350,4796,8,382,85,1350,3284
0.016,6,9,1557,5,515,4,515,783,4,558,5,558,774
1796.179,17,449,39928,404,35,4457,288,25708,45,288,40023,288,14220
77.091,6,23,9538,12,387,58,855,1723,11,1051,7696,4080,7815
1743.105,6,106,7973,67,38,26410,205,4715,39,32,45865,98,3258
1740.653,17,30,20190,30,645,60022,645,20190,0,0,0,0,0
1798.411,6,372,25988,216,99,8364,469,15194,156,69,11601,69,10794
2.857,6,38,17622,19,689,158,1440,5633,19,1121,150,1440,11989
1794.506,17,144,11520,72,48,25274,48,5472,72,56,25274,56,6048
0.953,17,4,368,2,32,938,32,120,2,96,940,96,248
1.65,17,31,19157,15,635,104,1350,9955,16,547,102,1350,9202
3.797,17,10,2322,5,30,944,30,290,5,378,932,468,2032
13.193,6,15,4982,8,49,1884,92,523,7,1022,2166,1448,4459
0.187,6,28,7336,14,155,14,267,1341,14,603,13,2800,5995
1.45,6,14,2351,8,188,207,245,700,6,703,236,1152,1651
756.111,2,7,224,7,8,126018,8,224,0,0,0,0,0
3.776,17,5,295,5,31,944,31,295,0,0,0,0,0
5.556,6,37,7205,19,218,308,314,3383,18,516,311,1179,3822
132.525,6,632,563788,284,884,46,1460,19810,348,1558,380,8760,543978
300.116,6,71,49842,46,1194,6669,1408,41808,25,960,2569,3847,8034
240.171,6,54,18211,29,800,8577,1402,15131,25,221,10006,580,3080
1.126,6,24,8004,12,164,86,267,1288,12,1014,86,2411,6716
366.492,1,6,336,6,28,73298,28,336,0,0,0,0,0
1.082,6,3,160,2,0,1081,0,120,1,0,0,0,40
0.044,6,12,3705,6,171,8,171,491,6,964,6,1448,3214
0.409,6,55,24331,31,992,13,1380,17206,24,511,16,1923,7125
1741.322,17,29,19517,29,645,62190,645,19517,0,0,0,0,0
33.824,6,32,5144,15,180,2416,722,1858,17,299,2101,1448,3286
1791.946,1,168,9408,168,28,10730,28,9408,0,0,0,0,0
722.673,6,75,6450,50,69,14748,69,3725,25,69,30094,69,2725
1788.888,6,364,25392,212,100,8478,469,14896,152,69,11846,69,10496
300.672,6,38,8578,20,315,15824,882,2105,18,441,499,1360,6473
29.497,6,40,9452,20,291,1552,721,3140,20,687,1498,1420,6312
1797.699,17,178,13884,178,50,10156,50,13884,0,0,0,0,0
1744.025,6,95,7203,63,38,28129,205,4476,32,33,56251,98,2727
1789.838,6,193,22671,107,75,16885,267,9206,86,125,21053,1452,13465
1.243,6,50,19150,27,881,47,1360,13454,23,433,48,1360,5696
315.971,6,87,20323,46,312,7021,1360,10426,41,305,7895,2720,9897
236.864,17,4,240,2,32,236863,32,120,2,32,236863,32,120
240.217,6,57,18048,31,797,8007,1402,15188,26,166,9608,580,2860
38.958,17,44,6468,22,48,1854,48,1672,22,190,1854,308,4796
1788.535,6,357,22629,208,69,8640,69,12460,149,69,12084,69,10169
62.542,6,74,48746,44,1192,1454,1448,40445,30,746,2149,1448,8301
240.194,6,54,18482,29,823,8578,1402,15516,25,207,10007,580,2966
1784.475,6,104,8376,68,65,26633,65,4930,36,59,50982,59,3446
0.854,17,25,11429,11,453,85,1350,5299,14,409,46,1350,6130
68.306,17,4,240,2,32,68305,32,120,2,32,68305,32,120
122.292,6,34,11299,18,310,275,1360,3248,16,921,8136,1360,8051
1770.784,6,101,9344,66,65,27242,65,5577,35,59,52079,59,3767
1783.238,6,102,8296,68,65,26615,65,4930,34,59,54034,59,3366
20.487,6,6,328,4,0,6829,0,216,2,0,20194,0,112
0.045,6,2,80,1,0,0,0,40,1,0,0,0,40
317.631,6,16,1138,12,180,28875,180,812,4,110,20069,110,326
34.599,17,20,1520,20,48,1821,48,1520,0,0,0,0,0
7.504,6,22,6456,9,154,938,267,832,13,637,624,1420,5624
0.441,6,6,248,4,0,147,0,164,2,0,205,0,84
25.46,6,34,8220,16,175,1697,721,2047,18,681,1485,2007,6173
1679.54,17,12,498,11,14,167954,14,462,1,8,0,8,36
0.203,17,2,2378,2,1161,203,1161,2378,0,0,0,0,0
280.105,6,28,7352,13,158,23342,267,1317,15,678,20000,3436,6035
1053.654,6,169,22372,100,120,10642,469,9684,69,187,15238,1460,12688
1743.103,6,98,7066,62,31,28575,31,4247,36,31,49801,31,2819
280.437,6,28,7352,13,158,23369,267,1317,15,678,20028,3456,6035
616.292,6,79,14588,31,151,20543,658,3993,48,298,13109,1360,10595
240.272,6,43,9190,21,523,12013,1408,5809,22,247,11441,618,3381
329.498,17,35,35454,35,984,9691,1450,35454,0,0,0,0,0
0.076,6,16,5383,10,290,8,517,1109,6,988,13,1687,4274
1780.005,1,56,4704,56,56,32363,56,4704,0,0,0,0,0
1771.547,6,99,9306,66,66,27254,66,5610,33,60,55358,60,3696
34.992,2,2,64,2,8,34992,8,64,0,0,0,0,0
1.471,6,50,19436,27,902,56,1460,13740,23,433,55,1460,5696
498.341,1,16,896,16,28,33222,28,896,0,0,0,0,0
3.043,17,4,304,2,48,3035,48,152,2,48,3034,48,152
0.526,17,2,384,1,39,0,39,67,1,289,0,289,317
5.368,2,3,96,3,8,2684,8,96,0,0,0,0,0
1786.725,6,360,22887,211,69,8508,69,12718,149,69,12072,69,10169
0.33,6,22,5040,10,137,36,267,1092,12,577,29,1400,3948
0.027,17,4,284,2,32,10,32,120,2,54,11,60,164
1771.841,6,180,15480,120,69,14889,69,8940,60,69,30031,69,6540
1771.189,6,106,9823,69,65,26046,65,5822,37,59,49197,59,4001
1797.506,1,254,14224,254,28,7104,28,14224,0,0,0,0,0
10.678,6,90,27537,44,546,248,1152,20874,46,438,231,1179,6663
1796.158,17,448,39896,403,35,4468,288,25676,45,288,40013,288,14220
33.579,6,33,5212,16,154,2227,722,1924,17,342,2088,1448,3288
1669.463,2,16,512,16,8,111297,8,512,0,0,0,0,0
0.497,17,17,10560,9,881,61,1350,8181,8,269,66,1350,2379
1799.972,6,366,25610,213,99,8490,469,15005,153,69,11841,69,10605
0.459,6,7,376,4,0,153,0,216,3,0,116,0,160
59.59,6,8,7955,8,1077,8512,1077,7955,0,0,0,0,0
300.866,6,51,20302,30,1027,10374,1360,14615,21,402,433,2667,5687
2.1,6,20,3833,11,234,210,564,1504,9,463,240,1343,2329
1744.327,6,95,7203,63,38,28134,205,4476,32,33,56256,98,2727
0.075,6,2,80,1,0,0,0,40,1,0,0,0,40
154.136,6,13,532,4,0,3964,0,164,9,0,19265,0,368
0.832,6,20,5952,11,282,83,548,1292,9,716,93,1420,4660
488.304,1,12,672,12,28,44391,28,672,0,0,0,0,0
0.381,6,10,967,5,256,91,256,460,5,303,92,303,507
326.452,1,8,448,8,28,46636,28,448,0,0,0,0,0
124.621,6,45,9973,21,631,762,1360,4087,24,307,5410,1360,5886
179.178,6,25,9794,12,532,61,1460,2642,13,945,14920,1460,7152
1795.831,17,448,39896,403,35,4467,288,25676,45,288,40020,288,14220
0.063,17,4,1574,4,365,21,373,1574,0,0,0,0,0
7.446,6,32,6247,15,150,531,267,1655,17,558,454,1452,4592
0.124,17,2,194,1,61,0,61,89,1,77,0,77,105
93.289,17,7,532,7,48,15548,48,532,0,0,0,0,0
16.254,6,2494,2415764,1701,1347,9,1368,2369864,793,776,20,2736,45900
1646.703,1,8,448,8,28,235243,28,448,0,0,0,0,0
121.988,6,23,9615,12,372,62,802,1630,11,1255,12186,2720,7985
1682.738,17,16,1265,8,30,240386,37,471,8,71,240382,136,794
1794.186,17,80,3354,79,14,23002,14,3318,1,8,0,8,36
239.5,6,52,3950,30,65,6615,65,1915,22,88,11400,208,2035
1763.648,6,118,11984,75,63,23833,721,6265,43,99,41987,2329,5719
2.925,6,14,2351,8,188,417,245,700,6,1407,533,1407,1651
0.198,17,3,3096,3,1004,99,1437,3096,0,0,0,0,0
3.406,6,7,376,4,0,1135,0,216,3,0,1580,0,160
2.104,6,29,10365,17,367,131,833,1785,12,1012,182,1420,8580
10.035,6,69,24551,34,864,304,1440,13577,35,499,283,1440,10974
1746.399,1,54,4536,54,56,32950,56,4536,0,0,0,0,0
1761.736,1,74,6216,74,56,24133,56,6216,0,0,0,0,0
1789.957,6,369,23385,213,69,8443,69,13005,156,69,11548,69,10380
33.061,17,20,1520,20,48,1740,48,1520,0,0,0,0,0
756.309,2,5,160,5,8,189077,8,160,0,0,0,0,0
1781.759,6,361,22858,209,69,8566,69,12638,152,69,11799,69,10220
1797.433,1,272,15232,272,28,6632,28,15232,0,0,0,0,0
1797.543,17,533,179088,533,308,3378,308,179088,0,0,0,0,0
862.697,17,162,12312,162,48,5358,48,12312,0,0,0,0,0
0.085,6,2,123,1,31,0,31,83,1,0,0,0,40
2.288,6,10,924,5,283,554,283,551,5,105,527,105,373
1796.317,17,142,11360,71,48,25661,48,5396,71,56,25661,56,5964
3.822,6,33,6145,17,206,238,314,2744,16,551,237,1179,3401
1680.485,17,13,534,11,14,168029,14,462,2,8,1680297,8,72
373.714,6,25,1651,17,177,23357,177,1117,8,110,9264,110,534
0.025,6,10,1060,5,517,6,517,785,5,7,6,7,275
210.137,17,4,558,2,36,210133,36,128,2,187,210132,187,430
0.028,17,4,368,2,32,10,32,120,2,96,11,96,248
0.332,17,4,556,2,36,328,36,128,2,186,325,186,428
66.619,6,41,9744,21,642,443,1360,4097,20,371,3496,1360,5647
1.274,6,48,19492,27,911,49,1360,13876,21,476,55,2715,5616
220.383,6,29,8832,13,158,18365,267,1317,16,763,14688,1781,7515
1781.269,1,133,7448,133,28,13494,28,7448,0,0,0,0,0
0.546,6,24,7480,14,273,42,663,2104,10,1209,55,1946,5376
1089.526,17,32,12592,32,365,35146,373,12592,0,0,0,0,0
555.605,6,5,6385,5,1237,138901,1237,6385,0,0,0,0,0
0.037,17,2,176,1,60,0,60,88,1,60,0,60,88
1.5,6,50,19107,27,878,57,1360,13411,23,433,59,1360,5696
0.251,17,2,144,1,36,0,36,64,1,52,0,52,80
0.19,6,10,1840,5,901,47,901,1169,5,403,47,403,671
0.037,17,4,304,2,48,0,48,152,2,48,0,48,152
0.528,6,20,7168,12,319,47,602,1908,8,1209,74,1906,5260
1796.259,17,447,39864,402,35,4479,288,25644,45,288,40017,288,14220
31.51,6,37,8467,18,400,1174,885,1953,19,441,1742,1440,6514
0.216,6,9,1002,5,213,54,213,417,4,421,67,421,585
124.316,6,27,6500,9,272,327,516,1180,18,306,7307,1452,5320
280.3,6,27,7312,12,158,25481,267,1277,15,678,20019,2045,6035
0.028,17,2,462,2,203,28,360,462,0,0,0,0,0
22.45,6,40,8625,17,401,418,889,1952,23,478,1013,1928,6673
58.267,1,25,2600,0,0,0,0,0,25,76,2427,76,2600
4.857,6,38,7229,19,218,269,314,3383,19,513,255,1179,3846
4.596,6,39,7269,20,218,241,314,3423,19,513,241,1179,3846
1.544,6,38,8294,19,321,85,1168,2758,19,476,74,2715,5536
0.45,6,50,21241,27,1069,17,1380,16079,23,383,18,1380,5162
1.352,6,51,19735,29,916,48,1360,14034,22,437,55,2715,5701
0.462,6,29,13616,14,171,35,313,1422,15,1267,31,1648,12194
3.001,17,3,180,3,32,1500,32,180,0,0,0,0,0
1652.56,1,8,448,8,28,236080,28,448,0,0,0,0,0
0.207,6,27,7296,13,155,17,267,1301,14,603,14,1400,5995
0.021,6,2,80,1,0,0,0,40,1,0,0,0,40
7.187,6,1427,1305470,895,1381,7,1408,1273142,532,931,13,2801,32328
62.753,17,4,352,2,60,62751,60,176,2,60,62752,60,176
2.121,17,3,3140,3,1018,1060,1438,3140,0,0,0,0,0
1.334,6,49,19130,28,946,49,1460,13469,21,400,57,1460,5661
10.157,6,81,24461,41,550,253,1152,18720,40,459,253,1179,5741
1786.359,6,102,8228,68,64,26662,64,4896,34,58,54129,58,3332
1750.743,17,13,534,11,14,175055,14,462,2,8,1750543,8,72
38.301,6,21,5871,6,341,7660,599,1674,15,376,2721,810,4197
0.707,6,150,95247,79,1286,9,1420,88107,71,389,9,1420,7140
57.742,6,39,10097,15,327,96,1189,2575,24,327,2510,1420,7522
33.616,6,32,5155,15,180,2401,721,1858,17,267,2087,1368,3297
1741.252,17,29,30624,29,1028,62187,1028,30624,0,0,0,0,0
280.259,6,28,7352,12,158,25478,267,1277,16,603,18682,1400,6075
13.684,6,26,4816,13,154,1122,722,1767,13,473,1125,1448,3049
962.583,2,8,256,8,8,137511,8,256,0,0,0,0,0
1775.737,6,183,15738,122,69,14675,69,9089,61,69,29588,69,6649
1770.939,6,99,9240,66,65,27245,65,5577,33,59,55337,59,3663
0.023,6,3,120,2,0,23,0,80,1,0,0,0,40
127.721,6,37,5620,21,180,6386,722,2184,16,325,1072,1408,3436
0.145,6,10,585,5,45,36,45,313,5,0,35,0,272
141.922,17,4,240,2,32,141921,32,120,2,32,141921,32,120
0.296,17,2,138,1,33,0,33,61,1,49,0,49,77
0.528,17,7,2368,7,310,88,354,2368,0,0,0,0,0
1.003,6,4,220,2,0,1003,0,100,2,0,305,0,120
1740.672,17,30,7050,30,207,60023,207,7050,0,0,0,0,0
0.054,17,2,152,1,48,0,48,76,1,48,0,48,76
1.632,6,11,1727,7,100,272,100,384,4,589,458,1152,1343
280.196,6,29,7392,14,158,21553,267,1357,15,678,20012,3436,6035
1772.241,6,99,9240,66,65,27265,65,5577,33,59,55379,59,3663
33.004,6,18,4470,8,152,3000,267,782,10,469,3640,1179,3688
1790.161,17,179,13962,179,50,10057,50,13962,0,0,0,0,0
4.978,17,4,288,2,36,4946,36,128,2,52,4945,52,160
1750.994,17,13,534,11,14,175080,14,462,2,8,1750809,8,72
376.516,6,26,1703,17,177,23532,177,1117,9,110,8961,110,586
297.799,1,4,224,4,28,99266,28,224,0,0,0,0,0
0.518,6,7,295,4,0,172,0,164,3,7,107,7,131
1790.565,6,358,22669,209,69,8608,69,12500,149,69,12097,69,10169
3.068,17,2,778,2,361,3068,361,778,0,0,0,0,0
37.93,17,42,6292,21,48,1896,48,1596,21,195,1896,308,4696
0.92,17,4,560,2,64,686,64,184,2,160,711,160,376
371.044,6,18,1239,14,177,28541,177,913,4,110,20059,110,326
0.029,17,2,399,1,39,0,39,67,1,304,0,304,332
0.052,17,2,218,1,65,0,65,93,1,97,0,97,125
1783.812,6,352,22360,206,69,8701,69,12380,146,69,12302,69,9980
300.269,6,48,29677,28,190,11121,444,2309,20,1880,12645,6557,27368
280.396,6,27,7312,13,158,23366,267,1317,14,678,21564,2760,5995
92.913,6,42,8867,19,410,667,882,2070,23,345,4217,1360,6797
1786.403,6,104,8308,68,64,26662,64,4896,36,58,51037,58,3412
0.566,6,15,1773,7,288,65,288,588,8,284,56,434,1185
33.771,6,32,5148,15,154,2412,722,1860,17,300,2097,1408,3288
23.334,6,44,13005,19,889,42,1460,7017,25,276,964,1460,5988
0.596,6,14,1745,7,288,69,288,600,7,426,66,434,1145
3.996,17,4,244,4,33,1332,33,244,0,0,0,0,0
3.849,17,4,352,4,60,1283,60,352,0,0,0,0,0
116.674,17,39,2087,19,25,6481,34,1010,20,25,6135,41,1077
1682.757,17,14,1036,7,30,280449,30,406,7,62,280453,62,630
1787.404,6,104,8376,68,65,26677,65,4930,36,59,51065,59,3446
1798.477,6,359,22709,209,69,8646,69,12569,150,69,12069,69,10140
177.239,2,2,64,2,8,177239,8,64,0,0,0,0,0
1780.808,17,73,3060,72,14,25081,14,3024,1,8,0,8,36
494.497,1,10,560,10,28,54944,28,560,0,0,0,0,0
7.302,6,5,220,1,0,0,0,44,4,0,2352,0,176
1769.534,6,103,9448,66,65,27223,65,5577,37,59,49150,59,3871
365.68,6,18,1242,14,180,28129,180,916,4,110,20056,110,326
5.059,17,3,208,2,36,5001,36,128,1,52,0,52,80
38.329,17,22,1672,22,48,1825,48,1672,0,0,0,0,0
1786.633,6,102,8364,68,66,26666,66,4964,34,60,54137,60,3400
0.032,6,10,2031,6,732,6,1304,1708,4,159,10,159,323
1.265,17,3,1176,3,364,632,364,1176,0,0,0,0,0
1775.425,17,140,11200,70,48,25730,48,5320,70,56,25730,56,5880
13.935,6,30,5068,14,154,1052,721,1818,16,301,914,1368,3250
3.681,17,29,9957,15,299,259,1350,4908,14,332,279,1350,5049
7.952,6,26,12019,12,275,722,275,1034,14,947,407,2840,10985
17.586,17,31,10973,15,460,1254,1350,7329,16,199,1170,1350,3644
2.562,17,3,1173,3,363,1281,363,1173,0,0,0,0,0
134.624,17,4,352,2,60,134623,60,176,2,60,134623,60,176
0.06,17,2,701,2,322,60,353,701,0,0,0,0,0
9.296,6,1509,1288533,895,1387,10,1420,1259716,614,467,15,1883,28817
107.194,6,29,11025,16,523,7145,1448,3995,13,793,8932,1448,7030
0.018,17,2,352,1,32,0,32,60,1,264,0,264,292
2.121,17,2,204,1,34,0,34,62,1,114,0,114,142
3.201,17,2,322,1,33,0,33,61,1,233,0,233,261
69.047,6,97,32644,47,658,1497,1440,16471,50,524,1405,1440,16173
1.519,6,49,18297,28,882,56,1360,12636,21,480,66,4075,5661
1741.096,6,87,6322,58,31,30545,31,3915,29,31,62179,31,2407
1.651,6,13,2311,8,188,235,245,700,5,1407,348,1407,1611
6.516,6,996,896059,637,1362,10,1432,875537,359,559,18,1871,20522
18.817,17,24,3528,12,48,1708,48,912,12,190,1702,308,2616
1798.698,1,264,14784,264,28,6839,28,14784,0,0,0,0,0
503.888,2,5,160,5,8,125972,8,160,0,0,0,0,0
2.034,17,3,1164,3,360,1017,360,1164,0,0,0,0,0
1719.53,17,12,498,11,14,171953,14,462,1,8,0,8,36
280.347,6,29,7392,14,158,21565,267,1357,15,678,20022,3436,6035
767.367,6,31,2060,14,33,42015,33,959,17,31,47949,31,1101
1789.955,6,374,26068,216,98,8325,469,15263,158,69,11400,69,10805
280.233,6,29,7392,13,158,23352,267,1317,16,603,18677,1400,6075
0.088,17,2,154,1,41,0,41,69,1,57,0,57,85
1.531,6,48,19075,26,949,61,1460,13419,22,433,64,1460,5656
96.724,6,12216,11278308,7808,1363,12,1408,11044308,4408,776,21,1408,234000
1756.128,6,100,7866,66,45,27017,205,4902,34,35,53205,98,2964
1.942,17,3,468,3,128,971,128,468,0,0,0,0,0
0.09,6,11,912,6,181,18,181,489,5,77,15,134,423
4.121,17,5,340,5,40,1030,40,340,0,0,0,0,0
1669.341,1,7,742,7,78,278223,78,742,0,0,0,0,0
717.756,6,47,3647,29,65,25634,65,2070,18,57,42215,59,1577
3.053,17,4,336,2,34,2,34,124,2,78,0,84,212
0.254,17,4,865,2,47,243,47,150,2,329,244,341,715
0.109,17,8,2454,8,278,15,317,2454,0,0,0,0,0
5.011,17,4,530,2,36,5006,36,128,2,173,4998,187,402
1649.141,1,8,448,8,28,235591,28,448,0,0,0,0,0
133.965,6,25,9106,12,666,84,1360,3200,13,767,11149,1360,5906
0.194,6,21,5000,10,137,21,267,1092,11,577,18,1400,3908
1797.659,1,180,10080,180,28,10042,28,10080,0,0,0,0,0
0.218,17,4,420,2,33,0,33,122,2,121,0,145,298
0.895,17,2,122,2,33,895,33,122,0,0,0,0,0
276.203,17,4,352,2,60,276202,60,176,2,60,276202,60,176
111.634,6,29,7392,13,158,9302,267,1317,16,603,7439,2800,6075
1081.623,6,65,5054,40,43,27733,205,2908,25,33,45059,98,2146
1681.347,17,14,1036,7,30,280221,30,406,7,62,280221,62,630
1786.466,6,361,22927,209,69,8588,69,12569,152,69,11828,69,10358
33.835,6,24,6753,9,154,4229,267,840,15,529,2400,1917,5913
1744.6,2,21,672,21,8,87230,8,672,0,0,0,0,0
1771.025,6,101,9410,66,66,27246,66,5610,35,60,52086,60,3800
0.061,17,2,574,1,32,0,32,60,1,486,0,486,514
9.57,6,18,3995,10,275,1063,275,683,8,992,686,1440,3312
756.839,2,4,128,4,8,252279,8,128,0,0,0,0,0
114.001,17,5,385,5,49,28500,49,385,0,0,0,0,0
1.59,6,48,19222,27,892,61,1360,13606,21,433,68,1360,5616
9.367,6,1652,1394450,920,1424,10,1448,1347974,732,776,12,1448,46476
1.204,6,30,8486,16,277,67,672,2336,14,796,76,1772,6150
0.019,17,2,579,1,41,0,41,69,1,482,0,482,510
248.099,6,10,556,5,0,62024,0,264,5,0,61898,0,292
0.313,6,25,8818,13,232,26,567,1612,12,1095,28,2816,7206
1741.306,6,87,6322,58,31,30549,31,3915,29,31,62180,31,2407
1.521,6,40,9897,22,440,72,1360,4432,18,525,78,2715,5465
288.231,6,30,3069,15,324,20587,585,1437,15,282,20587,580,1632
782.376,1,31,3286,31,78,26079,78,3286,0,0,0,0,0
32.09,6,373,328090,160,144,201,354,9892,213,1469,151,2816,318198
317.074,6,48,12353,21,267,15853,1305,3288,27,398,12189,3289,9065
1741.954,6,100,7866,66,45,26799,205,4902,34,35,52779,98,2964
280.444,6,27,7312,10,158,31160,267,1197,17,543,17520,1400,6115
1799.706,6,358,22600,208,69,8694,69,12460,150,69,12078,69,10140
0.852,6,52,13853,24,549,37,1429,4824,28,438,30,1460,9029
1.327,6,40,9928,21,440,66,1360,4392,19,476,63,2715,5536
1.172,6,204,156073,119,1329,9,1432,148382,85,427,13,1432,7691
0.015,17,2,554,2,249,15,249,554,0,0,0,0,0
1795.416,6,367,25650,214,99,8429,469,15045,153,69,11811,69,10605
16.664,6,14,1025,7,222,2775,222,506,7,231,2776,231,519
0.004,17,2,588,1,39,0,39,67,1,493,0,493,521
69.801,6,61,40026,39,1157,1836,1408,32139,22,748,2925,1408,7887
71.324,17,8,1176,4,48,23773,48,304,4,190,23772,308,872
123.873,17,12,16480,12,1345,11261,1347,16480,0,0,0,0,0
280.244,6,28,7352,13,158,23353,267,1317,15,678,20015,2800,6035
0.953,6,23,6376,12,299,85,838,1979,11,988,94,1731,4397
1797.654,6,356,22520,208,69,8684,69,12460,148,69,12228,69,10060
1736.895,1,56,4704,56,56,31579,56,4704,0,0,0,0,0
10.293,6,1898,1767080,1187,1409,8,1448,1725444,711,776,14,1448,41636
5.397,6,37,9429,20,131,284,358,1798,17,578,92,1360,7631
0.128,17,2,187,1,36,0,36,64,1,95,0,95,123
1796.359,17,762,45960,762,32,2360,37,45960,0,0,0,0,0
773.249,6,13,768,8,31,110464,31,444,5,31,193308,31,324
256.343,6,27,7218,9,156,32042,267,838,18,513,15075,1460,6380
1.082,17,4,1344,4,308,360,308,1344,0,0,0,0,0
1740.948,1,15,840,15,28,124353,28,840,0,0,0,0,0
1787.71,1,250,14000,250,28,7179,28,14000,0,0,0,0,0
1799.998,6,276,20566,112,66,15945,702,10058,164,48,11042,142,10508
2.459,6,11,1426,6,145,491,145,389,5,829,609,829,1037
13.224,6,109,38214,55,638,244,1152,31572,54,447,244,1179,6642
7.895,6,30,7297,14,155,607,267,1346,16,441,525,1420,5951
300.742,6,40,13573,23,892,13670,1360,8091,17,479,543,4027,5482
4.289,17,23,13616,12,857,389,1350,10626,11,243,314,1350,2990
351.553,6,22,7871,6,106,70310,106,354,16,527,23434,1452,7517
1763.894,2,15,480,15,8,125992,8,480,0,0,0,0,0
5.002,17,3,343,2,36,4997,36,128,1,187,0,187,215
1781.105,6,104,8308,68,64,26583,64,4896,36,58,50886,58,3412
856.903,17,124,9424,124,48,6966,48,9424,0,0,0,0,0
4.811,6,40,7309,20,218,253,314,3423,20,513,237,1179,3886
280.219,6,29,7392,13,158,23351,267,1317,16,543,18680,1400,6075
282.207,6,29,7392,14,158,21708,267,1357,15,678,20143,3436,6035
71.746,6,28,8792,14,158,5518,267,1357,14,981,5516,3445,7435
284.04,1,4,224,4,28,94680,28,224,0,0,0,0,0
0.086,6,20,13942,13,127,6,127,811,7,3189,14,8688,13131
0.0,6,1,1470,0,0,0,0,0,1,1430,0,1430,1470
39.68,6,20,6488,6,154,7936,267,712,14,520,3034,1452,5776
0.001,6,2,111,0,0,0,0,0,2,31,1,31,111
0.049,17,8,1670,8,180,7,219,1670,0,0,0,0,0
0.014,17,8,2446,8,277,2,316,2446,0,0,0,0,0
1738.585,6,87,6322,58,31,30501,31,3915,29,31,62091,31,2407
1756.784,6,105,6270,60,27,29775,27,3525,45,27,39925,27,2745
1795.827,17,353,83753,353,209,5101,422,83753,0,0,0,0,0
0.075,17,2,390,1,46,0,46,74,1,288,0,288,316
54.478,6,73,48847,42,239,1328,517,3089,31,1780,1815,4173,45758
1773.881,17,238,52798,238,193,7484,422,52798,0,0,0,0,0
2.361,17,4,1568,4,364,787,364,1568,0,0,0,0,0
3.678,17,5,290,5,30,919,30,290,0,0,0,0,0
1681.511,17,14,1036,7,30,280250,30,406,7,62,280249,62,630
1770.4,6,100,9358,66,66,27236,66,5610,34,60,53645,60,3748
1118.843,6,301,48133,143,300,7878,1360,30324,158,119,7125,4658,17809
17.045,6,2850,2701059,1860,1375,9,1408,2644915,990,931,17,2801,56144
1797.321,1,59,4956,0,0,0,0,0,59,56,30988,56,4956
16.712,6,27,7755,14,402,1285,721,1774,13,908,1356,2840,5981
0.872,6,19,9056,11,499,87,1193,1971,8,1350,89,3639,7085
20.011,17,3,447,3,121,10005,121,447,0,0,0,0,0
0.607,6,24,6012,13,108,50,147,959,11,921,56,2599,5053
0.047,17,2,602,1,46,0,46,74,1,500,0,500,528
38.081,17,22,1936,11,48,3807,48,836,11,72,3807,72,1100
112.535,6,63,40678,39,1143,2961,1448,31767,24,765,2713,1448,8911
4.145,6,38,7229,19,218,230,314,3383,19,440,216,1152,3846
6.223,6,1341,1267299,871,1380,6,1408,1238195,470,776,12,1408,29104
9.575,17,53,16903,24,352,416,1350,9132,29,239,339,1350,7771
1.202,6,23,7952,12,164,94,267,1288,11,1216,104,3819,6664
1772.32,6,180,15480,120,69,14893,69,8940,60,69,30030,69,6540
60.344,6,39,20411,19,131,3352,134,1520,20,991,3173,1448,18891
358.945,6,73,41430,44,184,8347,1306,4508,29,1475,1259,5608,36922
301.712,6,55,13013,29,316,10775,889,2567,26,447,579,1928,10446
6.256,2,2,64,2,8,6256,8,64,0,0,0,0,0
4.789,17,5,320,5,36,1197,36,320,0,0,0,0,0
1794.474,17,172,13416,172,50,10494,50,13416,0,0,0,0,0
280.324,6,27,7312,12,158,25484,267,1277,15,678,20021,2045,6035
136.602,6,25,7094,11,181,13660,267,1168,14,595,10506,1400,5926
28.24,6,2,880,2,388,28240,388,880,0,0,0,0,0
910.205,1,18,1008,18,28,53541,28,1008,0,0,0,0,0
2.26,17,31,25420,16,899,148,1350,14838,15,677,159,1350,10582
242.587,6,31,8912,14,158,18660,267,1357,17,687,15157,1400,7555
1778.879,6,172,10825,93,47,19335,208,6797,79,31,22801,31,4028
4.274,17,31,7720,13,309,356,1350,4382,18,157,222,1350,3338
2.657,17,24,7862,12,377,238,1350,4869,12,221,238,1350,2993
126.658,2,2,64,2,8,126658,8,64,0,0,0,0,0
1.328,6,48,17063,28,790,49,1360,11442,20,437,60,2715,5621
2.457,17,4,1556,4,361,819,361,1556,0,0,0,0,0
1763.057,17,44,14784,44,308,41001,308,14784,0,0,0,0,0
7.129,1,7,588,0,0,0,0,0,7,56,1188,56,588
0.857,17,2,180,1,30,0,30,58,1,94,0,94,122
46.175,6,52,14878,26,971,604,1360,8912,26,307,1839,1360,5966
380.939,1,14,1176,0,0,0,0,0,14,56,29303,56,1176
9.414,6,6,240,6,0,0,0,240,0,0,0,0,0
1773.006,6,209,24070,132,89,13534,981,11118,77,135,23322,1420,12952
0.106,17,2,2380,2,1162,106,1162,2380,0,0,0,0,0
2.942,6,29,10386,17,367,183,833,1785,12,1014,259,1414,8601
75.643,6,33,7693,13,155,6303,267,1306,20,371,3980,1997,6387
266.153,17,4,352,2,60,266152,60,176,2,60,266152,60,176
1.412,6,46,19129,26,891,56,1460,13553,20,476,63,2920,5576
2.783,6,30,10405,18,367,163,833,1825,12,1012,244,1420,8580
119.123,6,33,15435,17,630,41,1440,3233,16,1050,7932,1440,12202
1795.199,1,59,4956,59,56,30951,56,4956,0,0,0,0,0
4.783,6,38,7229,19,218,265,314,3383,19,513,251,1179,3846
154.141,6,15,612,5,0,5918,0,204,10,0,17125,0,408
40.0,6,174,83764,99,766,408,1360,62625,75,697,529,4658,21139
49.986,6,27,7177,13,155,4165,267,1306,14,530,3844,3417,5871
122.961,17,4,300,2,47,122960,47,150,2,47,122960,47,150
0.155,6,46,21637,27,1037,5,1420,16656,19,467,8,1883,4981
1796.27,17,761,45902,761,32,2363,37,45902,0,0,0,0,0
0.02,6,9,1880,5,910,5,910,1178,4,486,6,486,702
1.214,6,30,6369,15,172,86,267,1813,15,564,64,1420,4556
7.285,6,1171,1009549,703,1389,10,1420,986608,468,526,15,3303,22941
298.545,1,4,224,4,28,99515,28,224,0,0,0,0,0
3.49,6,6,424,3,92,1535,92,256,3,0,1510,0,168
1793.951,17,87,3648,86,14,21105,14,3612,1,8,0,8,36
11.337,17,6,528,3,48,5663,48,228,3,72,5662,72,300
0.106,6,9,1346,5,145,26,145,349,4,833,30,833,997
1.375,6,48,18798,27,862,52,1360,13182,21,476,58,2715,5616
1740.408,1,60,5040,60,56,29498,56,5040,0,0,0,0,0
5.518,6,43,7429,22,218,262,314,3503,21,440,263,1152,3926
1.773,6,28,10226,17,286,110,590,1542,11,1030,160,1420,8684
0.84,6,20,5948,11,281,84,544,1288,9,716,94,1420,4660
57.695,6,8,536,5,92,14423,92,360,3,0,5853,0,176
240.181,6,54,17878,28,785,8895,1402,14831,26,187,9607,580,3047
549.673,1,6,336,6,28,109934,28,336,0,0,0,0,0
1700.387,17,12,498,11,14,170038,14,462,1,8,0,8,36
0.225,6,27,7296,13,155,18,267,1301,14,603,13,2036,5995
0.138,6,9,1339,5,145,34,145,349,4,826,32,826,990
1798.155,6,356,22520,208,69,8686,69,12460,148,69,12232,69,10060
1793.126,1,156,16536,156,78,11568,78,16536,0,0,0,0,0
11.69,6,17,2422,9,210,1460,210,920,8,545,1669,904,1502
1772.754,6,180,15480,120,69,14897,69,8940,60,69,30038,69,6540
0.076,1,2,163,2,53,76,78,163,0,0,0,0,0
11.558,6,84,24581,43,533,275,1152,18800,41,459,281,1179,5781
1.601,17,19,5980,9,353,186,1350,3434,10,226,167,1350,2546
372.192,6,27,1767,18,177,21893,177,1181,9,110,8606,110,586
0.478,6,52,22116,28,1050,17,1380,16902,24,383,19,1380,5214
1472.24,17,267,34233,132,170,11234,1350,26221,135,31,10985,60,8012
1794.772,6,244,46664,152,483,11885,483,36892,92,83,19722,83,9772
1798.914,6,416,24920,208,69,8690,69,12460,208,34,8690,64,12460
0.33,17,2,231,1,34,0,34,62,1,141,0,141,169
164.885,6,56,16015,22,439,7851,1189,7045,34,271,4996,1420,8970
0.547,17,2,694,1,317,0,317,345,1,321,0,321,349
5.688,6,45,8409,23,227,258,314,4102,22,427,259,1152,4307
3.634,6,8,460,4,0,1211,0,220,4,0,964,0,240
1.998,6,28,7336,13,155,166,267,1301,15,543,118,1400,6035
18.834,17,42,15511,20,537,989,1350,11313,22,162,895,1350,4198
300.895,6,43,14006,24,828,13082,1360,8444,19,399,483,1360,5562
38.536,6,60,13228,31,141,1284,159,3346,29,597,1365,1418,9882
0.023,17,2,576,1,33,0,33,61,1,487,0,487,515
299.524,6,7,404,4,31,99841,31,222,3,31,149758,31,182
61.986,6,34,7664,15,140,4427,267,1593,19,441,3432,1420,6071
1740.577,17,30,31680,30,1028,60019,1028,31680,0,0,0,0,0
1797.585,17,142,11360,71,48,25678,48,5396,71,56,25678,56,5964
0.696,17,24,17350,14,862,50,1350,12467,10,460,67,1350,4883
17.388,17,8,704,4,48,5791,48,304,4,72,5791,72,400
0.49,6,23,7307,13,318,38,600,1958,10,803,50,1448,5349
173.591,17,6,488,3,53,86795,64,244,3,53,86795,64,244
7.218,6,70,25580,34,890,218,1440,14825,36,543,201,1440,10755
0.043,17,4,588,2,48,38,48,152,2,190,37,308,436
282.472,1,4,326,4,53,94157,78,326,0,0,0,0,0
1744.278,6,95,7203,63,38,28133,205,4476,32,33,56257,98,2727
298.164,6,47,11199,25,617,12416,1460,5376,22,352,14190,1460,5823
1783.811,6,423,25413,212,69,8454,69,12689,211,35,8494,69,12724
1786.668,6,102,8228,68,64,26666,64,4896,34,58,54138,58,3332
1323.451,2,10,320,10,8,147050,8,320,0,0,0,0,0
15.912,17,26,17322,15,965,1132,1350,14906,11,191,1583,1350,2416
1782.555,6,354,22509,207,69,8653,69,12489,147,69,12209,69,10020
0.702,17,2,144,1,36,0,36,64,1,52,0,52,80
21.961,6,20,4636,10,238,2440,722,1707,10,793,2420,1408,2929
612.621,6,43,3891,24,70,26635,130,2093,19,57,34025,59,1798
1799.324,17,449,39928,404,35,4464,288,25708,45,288,40021,288,14220
3.637,17,2,656,2,300,3637,300,656,0,0,0,0,0
23.622,17,4,352,2,60,23620,60,176,2,60,23619,60,176
1799.27,6,355,22480,207,69,8734,69,12420,148,69,12239,69,10060
581.206,17,1080,641338,604,856,963,1350,534041,476,197,1223,1350,107297
0.074,17,2,192,1,37,0,37,65,1,99,0,99,127
0.2,6,28,7336,13,155,16,267,1301,15,543,13,1300,6035
1771.507,6,99,9306,66,66,27253,66,5610,33,60,55357,60,3696
129.159,6,48,13989,25,485,5381,1360,5909,23,510,5861,1360,8080
280.312,6,30,7432,13,158,23359,267,1317,17,543,17517,1400,6115
1750.295,17,13,534,11,14,175010,14,462,2,8,1748551,8,72
8.406,6,2129,1755681,1141,1438,7,1448,1690349,988,776,8,1448,65332
1754.691,6,194,24793,108,304,16398,304,16976,86,83,20643,83,7817
1798.395,6,367,25650,214,99,8443,469,15045,153,69,11830,69,10605
3.788,17,4,352,2,48,3780,48,152,2,72,3779,72,200
6.251,6,14,5889,3,98,3120,106,325,11,639,624,1420,5564
32.706,6,38,8664,16,401,42,889,1876,22,368,1550,3488,6788
312.545,6,49,6569,21,135,6847,722,2355,28,144,11569,2026,4214
2.647,17,3,1173,3,363,1323,363,1173,0,0,0,0,0
1756.618,6,100,7866,66,45,27024,205,4902,34,35,53219,98,2964
0.027,17,2,489,1,34,0,34,62,1,399,0,399,427
1795.922,17,446,39832,401,35,4489,288,25612,45,288,40014,288,14220
3.996,17,8,1176,4,48,1329,48,304,4,190,1328,308,872
50.553,6,20,5854,11,267,5055,501,1245,9,707,6307,1420,4609
114.105,17,7,539,7,49,19017,49,539,0,0,0,0,0
2.047,17,2,778,2,361,2047,361,778,0,0,0,0,0
12.118,17,10,850,5,37,3028,37,325,5,77,3027,77,525
41.824,17,24,2112,12,48,3801,48,912,12,72,3801,72,1200
1744.653,2,29,928,29,8,62309,8,928,0,0,0,0,0
1.978,17,4,502,2,31,1967,31,118,2,164,1933,164,384
95.697,6,31,8912,14,158,7361,267,1357,17,763,5971,2076,7555
1776.165,17,138,11040,69,48,26119,48,5244,69,56,26119,56,5796
29.312,6,43,8936,21,401,735,889,2148,22,368,1390,3488,6788
10.167,6,84,24981,43,563,242,1152,19200,41,459,247,1179,5781
0.45,6,3,120,2,0,450,0,80,1,0,0,0,40
535.381,1,15,840,15,28,38241,28,840,0,0,0,0,0
0.09,17,4,284,2,32,0,32,120,2,54,15,60,164
240.207,6,55,21102,29,923,8578,1418,18144,26,199,9607,580,2958
1007.259,2,7,224,7,8,167876,8,224,0,0,0,0,0
2.883,17,2,136,1,32,0,32,60,1,48,0,48,76
1795.182,17,80,3354,79,14,23015,14,3318,1,8,0,8,36
0.066,17,2,373,1,34,0,34,62,1,283,0,283,311
299.559,6,6,364,4,31,99853,31,222,2,31,299535,31,142
20.353,6,19,2432,10,189,2261,517,1298,9,323,2537,499,1134
19.71,6,25,6770,14,330,1513,517,1726,11,893,1961,2451,5044
2.019,17,6,460,3,40,1001,41,206,3,56,1001,57,254
1.333,6,50,21508,28,980,49,1460,15852,22,433,54,1460,5656
0.016,17,2,462,2,203,16,360,462,0,0,0,0,0
0.12,17,6,1416,3,60,57,60,264,3,356,56,356,1152
0.457,6,56,24025,32,1031,14,1380,16855,24,515,18,1923,7170
20.175,6,24,6085,14,107,1551,159,1190,10,727,2240,1418,4895
0.032,17,4,304,2,37,25,37,130,2,59,25,65,174
229.729,6,177,134997,107,1287,2167,1368,122783,70,676,1662,1368,12214
152.802,6,40,30381,19,579,60,1360,3109,21,1761,7631,5440,27272
154.915,1,3,168,3,28,77457,28,168,0,0,0,0,0
0.41,6,10,967,5,256,98,256,460,5,303,97,303,507
1790.787,17,179,13962,179,50,10060,50,13962,0,0,0,0,0
1772.505,6,180,15480,120,69,14895,69,8940,60,69,30035,69,6540
0.971,6,54,13954,25,549,40,1429,4876,29,416,33,1460,9078
1780.305,1,159,8904,159,28,11267,28,8904,0,0,0,0,0
0.13,17,2,268,1,54,0,54,82,1,158,0,158,186
2.085,6,29,10388,17,373,130,851,1803,12,1012,181,1420,8585
1785.401,6,356,22520,208,69,8625,69,12460,148,69,12145,69,10060
0.766,6,26,9013,13,257,63,669,1714,13,945,60,1438,7299
300.795,2,4,128,4,8,100265,8,128,0,0,0,0,0
0.257,17,2,152,1,48,0,48,76,1,48,0,48,76
0.89,17,4,918,2,40,879,40,136,2,363,874,363,782
42.443,6,28,7217,13,155,3536,267,1306,15,482,3031,1997,5911
0.775,6,9,1647,6,100,155,100,344,3,1179,262,1179,1303
0.251,6,9,1346,5,145,62,145,349,4,833,35,833,997
1795.0,6,356,22520,208,69,8671,69,12460,148,69,12210,69,10060
304.946,6,91,22882,52,683,5979,838,11725,39,290,336,1928,11157
902.417,2,8,256,8,8,128916,8,256,0,0,0,0,0
240.216,6,54,18185,29,803,8579,1408,15172,25,213,10008,580,3013
7.302,6,1596,1485048,1016,1384,7,1408,1450224,580,931,12,2801,34824
1744.581,2,27,864,27,8,67099,8,864,0,0,0,0,0
1771.769,6,101,9410,66,66,27257,66,5610,35,60,52108,60,3800
38.258,17,12,912,12,48,3478,48,912,0,0,0,0,0
13.059,17,4,1344,4,308,4353,308,1344,0,0,0,0,0
1775.232,17,73,3060,72,14,25003,14,3024,1,8,0,8,36
1786.574,6,104,8444,68,66,26665,66,4964,36,60,51042,60,3480
0.327,17,2,152,1,48,0,48,76,1,48,0,48,76
5.035,17,4,288,2,36,5004,36,128,2,52,5002,52,160
31.005,17,6,666,6,83,6201,84,666,0,0,0,0,0
10.823,6,1913,1829101,1260,1375,8,1408,1790481,653,776,16,1408,38620
1785.408,6,108,8468,68,64,26647,64,4896,40,58,45777,58,3572
0.024,17,2,656,2,300,24,300,656,0,0,0,0,0
12.124,6,1896,1658893,1153,1383,10,1420,1624952,743,420,16,1420,33941
370.146,17,6,528,3,60,185072,60,264,3,60,185072,60,264
156.589,6,65,19826,34,653,4745,1288,11819,31,355,5216,1452,8007
240.576,6,321,380062,163,460,1485,1408,12195,158,2463,1532,8448,367867
0.053,17,3,543,2,39,48,39,134,1,381,0,381,409
10.491,17,4,824,2,48,10465,48,152,2,308,10476,308,672
0.072,17,4,420,2,33,22,33,122,2,121,51,145,298
34.352,17,6,528,3,48,17170,48,228,3,72,17170,72,300
28.111,17,16,1216,16,48,1874,48,1216,0,0,0,0,0
9.691,6,1521,1464975,1007,1381,9,1408,1433559,514,931,18,2801,31416
33.828,6,34,5251,16,154,2255,722,1912,18,266,1978,1448,3339
0.683,6,10,924,5,283,123,283,551,5,105,113,105,373
0.123,6,9,1002,5,213,30,213,417,4,421,32,421,585
1770.684,6,99,9306,66,66,27241,66,5610,33,60,55330,60,3696
0.791,6,11,1727,7,100,131,100,384,4,589,178,1152,1343
0.36,6,3,210,1,0,0,0,40,2,90,285,90,170
263.974,17,4,352,2,60,263973,60,176,2,60,263973,60,176
0.159,17,2,157,1,31,0,31,59,1,70,0,70,98
1.219,6,50,19055,27,874,46,1360,13359,23,433,47,1360,5696
0.775,17,4,963,2,33,770,37,123,2,392,767,463,840
115.972,6,24,10168,13,549,55,1360,2749,11,1161,11583,2720,7419
1793.144,1,246,13776,246,28,7318,28,13776,0,0,0,0,0
1796.168,17,134,10720,67,48,27214,48,5092,67,56,27214,56,5628
41.649,6,21,9313,5,124,1450,126,468,16,744,2767,1929,8845
0.061,6,5,260,0,0,0,0,0,5,0,0,0,260
0.005,17,2,233,1,33,0,33,61,1,144,0,144,172
0.044,17,2,163,1,30,0,30,58,1,77,0,77,105
1.631,6,51,19406,29,892,58,1360,13705,22,400,67,1360,5701
1797.315,1,226,12656,226,28,7988,28,12656,0,0,0,0,0
1.65,6,27,10176,16,284,110,585,1497,11,1029,148,1420,8679
1654.919,1,7,392,7,28,275819,28,392,0,0,0,0,0
0.432,17,8,2750,8,315,61,354,2750,0,0,0,0,0
1786.622,6,102,8296,68,65,26666,65,4930,34,59,54137,59,3366
372.291,6,18,1239,14,177,28637,177,913,4,110,20060,110,326
158.841,6,30,8872,13,158,13236,267,1317,17,687,9919,1400,7555
6.267,6,1382,1101633,718,1434,8,1448,1057065,664,776,9,1448,44568
1787.086,6,130,18116,80,243,22621,1258,12958,50,78,36468,192,5158
4.114,17,4,268,4,39,1371,39,268,0,0,0,0,0
138.983,17,175,13379,89,40,1579,41,6104,86,56,1634,57,7275
1775.691,1,65,5460,65,56,27745,56,5460,0,0,0,0,0
53.254,6,24,4654,11,207,5325,722,1607,13,464,4418,1408,3047
0.325,17,2,212,1,46,0,46,74,1,110,0,110,138
0.05,6,6,312,0,0,0,0,0,6,0,0,0,312
7.106,6,148,197878,78,133,92,201,3687,70,2990,100,11312,194191
1791.216,6,179,23538,101,304,17912,304,16256,78,83,23262,83,7282
300.683,6,37,8527,19,315,16704,882,2053,18,441,503,1440,6474
1780.203,6,167,12625,89,84,20227,208,8606,78,31,23116,31,4019
14.161,6,1863,1713347,1143,1418,12,1448,1671207,720,776,19,1448,42140
348.239,6,16,1218,6,275,69647,275,794,10,0,14083,0,424
1797.559,17,762,45953,762,32,2362,37,45953,0,0,0,0,0
1797.226,17,442,39136,398,35,4527,288,25232,44,288,40952,288,13904
1794.382,17,144,11520,72,48,25272,48,5472,72,56,25272,56,6048
1679.912,1,15,840,15,28,119993,28,840,0,0,0,0,0
1741.921,1,15,840,15,28,124422,28,840,0,0,0,0,0
1785.486,6,359,22709,209,69,8584,69,12569,150,69,11983,69,10140
370.443,6,17,1190,13,180,30870,180,864,4,110,20098,110,326
5.356,6,39,7269,19,218,297,314,3383,20,440,265,1152,3886
0.803,1,30,840,30,0,0,0,840,0,0,0,0,0
1769.323,1,58,4872,58,56,31040,56,4872,0,0,0,0,0
301.087,17,10,3328,10,304,33454,308,3328,0,0,0,0,0
1407.748,17,12,3294,6,30,281534,30,348,6,463,281546,463,2946
72.072,6,25,10717,13,746,50,1360,3537,12,1114,6540,3068,7180
1788.944,17,85,3569,83,14,21816,15,3487,2,13,212330,18,82
1798.95,6,369,25330,214,93,8445,469,14714,155,69,11681,69,10616
0.026,6,2,80,1,0,0,0,40,1,0,0,0,40
73.749,6,9,468,9,0,0,0,468,0,0,0,0,0
2.015,6,38,10899,20,683,106,1360,5653,18,449,105,1360,5246
0.222,17,2,503,1,40,0,40,68,1,407,0,407,435
1771.797,6,101,9344,66,65,27258,65,5577,35,59,52107,59,3767
391.979,6,66,11096,25,96,14020,267,2545,41,186,9799,4837,8551
0.018,6,11,3287,6,81,3,81,401,5,872,4,1448,2886
1740.624,17,30,31680,30,1028,60021,1028,31680,0,0,0,0,0
3.202,17,5,295,5,31,800,31,295,0,0,0,0,0
1118.458,6,84,10922,46,93,21639,501,3815,38,174,30226,1420,7107
13.716,6,18,2523,8,125,1959,245,700,10,703,1496,1152,1823
1744.659,2,14,448,14,8,134204,8,448,0,0,0,0,0
0.058,17,2,144,1,36,0,36,64,1,52,0,52,80
181.285,1,4,224,4,28,60428,28,224,0,0,0,0,0
1776.013,17,73,3060,72,14,25014,14,3024,1,8,0,8,36
0.677,6,20,7168,12,319,61,602,1908,8,1209,95,1906,5260
0.105,6,3,136,2,0,105,0,88,1,0,0,0,48
1.481,6,49,18525,26,904,59,1460,12829,23,433,58,1460,5696
55.023,17,12,13034,12,1058,5002,1061,13034,0,0,0,0,0
0.154,17,2,178,1,29,0,29,57,1,93,0,93,121
1.05,17,2,255,1,59,0,59,87,1,140,0,140,168
17.616,6,49,12733,26,672,688,1460,5842,23,425,789,4925,6891
147.139,6,48,34408,30,1226,30,1360,28232,18,777,8645,1360,6176
1795.442,17,447,39296,404,35,4455,288,25708,43,288,41918,288,13588
0.402,6,4,196,2,0,1,0,92,2,0,6,0,104
8.992,6,74,21362,39,541,236,1152,16178,35,472,256,1179,5184
1788.768,6,473,29752,257,100,6987,469,16696,216,34,8319,64,13056
16.727,6,12,3945,6,49,3345,92,419,6,1070,3298,1448,3526
0.404,6,19,7099,11,318,39,600,1854,8,1205,57,1891,5245
300.678,6,68,53450,46,1248,6681,1368,47330,22,993,2666,2939,6120
64.872,6,42,8910,20,410,878,915,2122,22,368,3083,3488,6788
1.055,6,37,8483,19,277,58,762,1900,18,450,54,1360,6583
8.46,6,76,22406,38,556,228,1152,17118,38,418,221,1152,5288
4.084,17,30,10239,12,308,371,1350,4033,18,316,203,1350,6206
1.361,6,25,8056,12,164,107,267,1288,13,869,98,1448,6768
20.149,6,23,6180,13,117,1679,159,1285,10,873,2237,1659,4895
0.02,17,4,420,2,33,1,33,122,2,121,0,145,298
1798.911,17,449,39928,404,35,4463,288,25708,45,288,40020,288,14220
1.462,6,37,8214,19,321,81,1164,2718,18,476,75,2615,5496
0.023,17,2,656,2,300,23,300,656,0,0,0,0,0
42.607,6,67,14210,31,317,960,766,2714,36,417,1213,1360,11496
240.214,6,104,82305,47,216,5221,681,4111,57,1600,4289,4224,78194
15.671,17,31,14103,16,652,1042,1350,10892,15,186,1116,1350,3211
37.462,6,28,7223,13,156,3121,267,1312,15,482,2675,1420,5911
174.637,17,10,880,5,48,43656,48,380,5,72,43656,72,500
0.589,6,27,7296,13,155,49,267,1301,14,603,39,2036,5995
0.016,6,2,182,1,102,0,102,142,1,0,0,0,40
0.19,6,27,7296,13,155,15,267,1301,14,603,13,1400,5995
157.488,6,23,8129,12,417,69,949,1788,11,841,15733,2720,6341
1798.67,17,449,39928,404,35,4463,288,25708,45,288,40014,288,14220
0.029,17,4,1148,2,32,15,32,120,2,486,15,486,1028
0.017,17,2,142,1,35,0,35,63,1,51,0,51,79
7.872,6,712,596794,428,1321,17,1368,577362,284,776,27,1473,19432
1787.431,6,109,8956,72,66,25175,66,5256,37,60,49645,60,3700
2.157,6,13,2311,8,188,308,245,700,5,1407,473,1407,1611
1778.701,17,140,11200,70,48,25778,48,5320,70,56,25778,56,5880
112.454,6,127,91597,77,1260,1479,1408,80874,50,811,1795,3847,10723
1680.623,17,29,30624,29,1028,60022,1028,30624,0,0,0,0,0
379.228,6,25,1700,17,226,23701,226,1166,8,110,9279,110,534
8.308,6,1653,1493377,1026,1376,7,1408,1456109,627,931,12,2816,37268
1789.33,6,363,23214,208,69,8644,69,12667,155,69,11618,69,10547
0.086,6,9,1147,5,145,21,145,349,4,634,25,634,798
1778.083,17,73,3060,72,14,25043,14,3024,1,8,0,8,36
1777.124,17,142,11360,71,48,25386,48,5396,71,56,25386,56,5964
1768.193,1,58,4872,0,0,0,0,0,58,56,31020,56,4872
2.948,6,11,460,7,0,491,0,288,4,0,849,0,172
1785.962,6,106,8388,68,64,26656,64,4896,38,58,48266,58,3492
280.536,6,29,7392,13,158,23378,267,1317,16,678,18698,3456,6075
70.896,6,18,3736,5,92,17724,92,348,13,384,5887,2026,3388
0.216,17,3,2906,3,940,108,1451,2906,0,0,0,0,0
299.549,6,6,364,4,31,99849,31,222,2,31,299527,31,142
10.435,17,3,984,3,300,5217,300,984,0,0,0,0,0
61.901,6,16,2431,6,188,12380,245,620,10,703,6850,1152,1811
41.172,6,28,7238,10,165,4574,267,1069,18,388,2420,1420,6169
5.044,17,3,208,2,36,5003,36,128,1,52,0,52,80
1710.659,17,12,498,11,14,171065,14,462,1,8,0,8,36
785.665,6,82,9274,38,83,21234,722,3483,44,97,18266,1408,5791
1764.881,2,15,480,15,8,126062,8,480,0,0,0,0,0
0.21,6,15,3660,8,101,30,101,533,7,1373,34,1448,3127
0.037,17,2,588,1,39,0,39,67,1,493,0,493,521
240.531,6,55,17997,30,798,8293,1402,15152,25,192,10021,580,2845
0.003,6,2,149,1,0,0,0,40,1,69,0,69,109
1786.506,17,87,3648,86,14,21017,14,3612,1,8,0,8,36
1.368,6,47,18873,26,937,54,1460,13257,21,433,59,1460,5616
1784.519,1,321,26964,321,56,5576,56,26964,0,0,0,0,0
1785.634,6,356,22520,208,69,8626,69,12460,148,69,12147,69,10060
0.512,6,50,21270,28,999,18,1380,16148,22,421,21,1923,5122
10.021,17,3,433,2,37,10016,37,130,1,275,0,275,303
6.125,6,1465,1334791,916,1379,6,1408,1301579,549,931,10,2801,33212
16.719,6,2611,2471073,1659,1410,9,1448,2416905,952,776,17,1448,54168
1386.101,2,9,288,9,8,173262,8,288,0,0,0,0,0
1739.668,17,205,46258,205,197,8527,422,46258,0,0,0,0,0
1.131,6,24,8004,11,164,95,267,1236,13,869,79,1448,6768
280.264,6,29,7392,13,158,23355,267,1317,16,603,18681,2236,6075
375.897,6,21,1422,15,180,26849,180,992,6,110,12239,110,430
1798.135,6,365,25432,213,100,8481,469,14936,152,69,11853,69,10496
0.029,17,4,344,2,47,19,47,150,2,69,21,75,194
1765.535,17,168,13990,156,30,11390,37,9090,12,380,155061,463,4900
12.02,17,10,620,10,34,1335,34,620,0,0,0,0,0
280.317,6,29,7392,13,158,23359,267,1317,16,603,18685,2036,6075
1370.228,6,156,10748,57,46,24468,46,4534,99,46,13980,46,6214
0.062,17,4,288,2,33,0,33,122,2,55,11,61,166
240.704,6,39,7294,20,204,12659,517,2274,19,503,13364,1460,5020
0.305,6,28,9162,14,257,23,669,1766,14,949,22,2804,7396
1772.498,6,180,15480,120,69,14894,69,8940,60,69,30035,69,6540
14.713,1,15,1560,0,0,0,0,0,15,76,1050,76,1560
240.802,6,52,10145,27,213,9255,517,2908,25,494,10028,1501,7237
5.62,6,39,7285,21,218,281,314,3463,18,516,314,1179,3822
51.255,17,6,480,3,48,25623,48,228,3,56,25619,56,252
1680.671,17,12,498,11,14,168067,14,462,1,8,0,8,36
1781.672,6,102,8296,68,65,26592,65,4930,34,59,53987,59,3366
280.765,6,29,7392,13,158,23397,267,1317,16,603,18708,2800,6075
0.339,6,21,7203,12,318,30,600,1906,9,964,41,1471,5297
1798.83,17,87,3648,86,14,21162,14,3612,1,8,0,8,36
0.024,6,3,181,1,0,0,0,40,2,37,0,37,141
23.86,17,4,1344,4,308,7953,308,1344,0,0,0,0,0
66.826,6,25,10769,12,380,93,832,1665,13,952,5558,1460,9104
1.051,17,4,534,2,31,1040,31,118,2,180,1031,196,416
13.396,6,29,3388,21,210,667,210,1886,8,545,1885,904,1502
0.062,17,4,284,2,32,22,32,120,2,54,56,60,164
1786.635,1,8,448,8,28,255233,28,448,0,0,0,0,0
1783.116,17,83,3480,82,14,22013,14,3444,1,8,0,8,36
0.474,6,12,1653,6,288,87,288,548,6,426,47,434,1105
20.177,6,22,5458,13,107,1681,159,1114,9,967,2520,1675,4344
1792.918,17,180,14040,180,50,10016,50,14040,0,0,0,0,0
42.494,6,58,15522,30,517,1465,1152,11564,28,403,1395,1152,3958
1783.099,17,83,3480,82,14,22013,14,3444,1,8,0,8,36
2.824,6,34,18094,21,777,141,1360,6314,13,1606,223,2720,11780
743.579,17,84,6973,78,30,9656,37,4545,6,376,136575,463,2428
1144.864,2,15,480,15,8,81776,8,480,0,0,0,0,0
1.621,6,48,18741,27,857,62,1360,13113,21,433,70,1360,5628
828.539,1,22,1232,22,28,39454,28,1232,0,0,0,0,0
5.676,6,178,134525,75,111,76,232,3560,103,1393,53,2860,130965
1791.61,17,179,13962,179,50,10065,50,13962,0,0,0,0,0
1787.93,6,368,25759,213,100,8433,469,14936,155,69,11609,69,10823
252.007,17,4,240,2,32,252006,32,120,2,32,252006,32,120
66.089,6,30,7297,14,155,5083,267,1346,16,441,4405,1420,5951
371.566,6,18,1239,14,177,28582,177,913,4,110,20059,110,326
1407.447,1,7,392,7,28,234574,28,392,0,0,0,0,0
0.347,17,2,180,1,30,0,30,58,1,94,0,94,122
19.909,6,14,2245,8,211,2843,211,846,6,545,3981,904,1399
146.841,2,2,64,2,8,146841,8,64,0,0,0,0,0
1749.505,17,12,498,11,14,174950,14,462,1,8,0,8,36
127.459,17,4,352,2,60,127458,60,176,2,60,127458,60,176
89.015,6,24,6350,7,272,453,516,1100,17,326,5557,1452,5250
32.103,6,37,8495,18,410,508,916,1983,19,441,1775,1360,6512
1792.584,1,203,11368,203,28,8874,28,11368,0,0,0,0,0
8.73,6,16,1113,8,222,1245,222,546,8,231,1245,231,567
1743.081,6,95,7203,63,38,28114,205,4476,32,33,56221,98,2727
317.156,6,78,17525,41,282,7928,1460,8189,37,326,8805,2920,9336
1759.305,6,141,11280,86,51,20697,205,6544,55,37,32572,98,4736
0.517,6,14,1733,7,288,81,288,588,7,284,49,434,1145
1281.553,6,269,17177,152,71,8487,138,9599,117,69,11047,69,7578
1786.35,17,87,3648,86,14,21015,14,3612,1,8,0,8,36
50.924,6,26,7137,13,155,4243,267,1306,13,589,4243,3426,5831
56.181,6,27,7177,13,155,4681,267,1306,14,530,4321,3417,5871
32.831,17,18,1584,9,48,4102,48,684,9,72,4102,72,900
146.693,6,31,18785,17,708,46,1360,4290,14,1547,11274,3880,14495
0.07,17,4,284,2,32,53,32,120,2,54,56,60,164
667.263,17,50,3984,27,48,25663,48,2052,23,56,25610,56,1932
1794.366,1,59,4956,59,56,30937,56,4956,0,0,0,0,0
4.264,6,35,6209,18,206,250,314,2784,17,456,250,1152,3425
280.27,6,29,7392,13,158,23355,267,1317,16,603,18683,1400,6075
1798.392,17,87,3648,86,14,21157,14,3612,1,8,0,8,36
0.857,6,26,7256,12,155,77,267,1261,14,603,63,1400,5995
154.311,17,4,240,2,32,154310,32,120,2,32,154310,32,120
1788.251,1,57,4788,57,56,31933,56,4788,0,0,0,0,0
1.158,6,23,7952,12,164,89,267,1288,11,1216,98,2816,6664
89.977,6,21,8279,11,525,83,1237,2048,10,969,9979,1791,6231
10.777,6,20,7130,11,275,1077,275,998,9,1440,749,1440,6132
9.098,17,6,528,3,48,4542,48,228,3,72,4540,72,300
3.194,6,14,1526,7,304,532,304,968,7,83,427,83,558
1772.286,6,180,15480,120,69,14893,69,8940,60,69,30037,69,6540
173.598,6,20753,20108357,14008,1358,12,1408,19752893,6745,776,25,1408,355464
25.945,6,29,7808,18,129,1526,159,1863,11,766,2593,1675,5945
1792.995,6,363,23007,211,69,8538,69,12787,152,69,11871,69,10220
45.128,6,28,7217,13,155,3760,267,1306,15,482,3222,1997,5911
26.298,6,179,69508,92,714,288,1152,60864,87,430,302,1179,8644
0.053,6,16,6004,8,88,7,88,452,8,1305,7,1880,5552
0.405,6,8,335,4,0,135,0,164,4,7,71,7,171
299.548,6,8,475,6,31,59909,31,333,2,31,299513,31,142
94.362,6,15,1083,4,177,119,177,393,11,110,9419,110,690
0.024,17,4,284,2,32,0,32,120,2,54,9,60,164
0.012,17,2,392,1,49,0,49,77,1,287,0,287,315
1681.611,17,14,1036,7,30,280266,30,406,7,62,280265,62,630
1786.193,17,87,3648,86,14,21014,14,3612,1,8,0,8,36
7.191,17,4,3100,4,747,2397,1451,3100,0,0,0,0,0
366.987,6,21,1419,15,177,26213,177,989,6,110,12231,110,430
890.357,6,21,23992,3,174,144,174,298,18,1435,52368,1452,23694
1787.175,17,87,3648,86,14,21025,14,3612,1,8,0,8,36
0.173,6,26,7256,14,155,13,267,1341,12,678,15,2045,5915
20.139,6,9,2553,9,243,2517,259,2553,0,0,0,0,0
1745.736,6,90,6540,60,31,29588,31,4050,30,31,60190,31,2490
150.938,17,4,240,2,32,150937,32,120,2,32,150937,32,120
16.868,6,29,6346,18,270,992,383,4243,11,553,698,1179,2103
120.293,6,3,760,3,302,60146,302,760,0,0,0,0,0
70.554,6,40,22107,17,490,328,660,2852,23,902,3198,1408,19255
1789.454,6,103,8336,68,65,26708,65,4930,35,59,52628,59,3406
1624.324,2,14,448,14,8,124948,8,448,0,0,0,0,0
240.594,6,43,8757,22,562,11456,1418,5654,21,250,12028,651,3103
1781.923,17,244,63315,244,231,7333,422,63315,0,0,0,0,0
1.169,6,25,8056,13,164,82,267,1340,12,869,90,1408,6716
0.563,6,15,1785,8,288,56,288,640,7,426,64,434,1145
4.12,6,15,5928,4,106,1373,106,274,11,578,391,1452,5654
1797.555,6,381,26555,219,97,8245,469,15590,162,69,11163,69,10965
1682.956,17,14,1036,7,30,280484,30,406,7,62,280482,62,630
280.23,6,29,7392,13,158,23352,267,1317,16,603,18676,2036,6075
1.346,6,10,1687,7,100,224,100,384,3,1179,543,1179,1303
1777.002,17,73,3060,72,14,25028,14,3024,1,8,0,8,36
4.486,6,39,7269,20,218,236,314,3423,19,513,233,1179,3846
1787.348,6,102,8296,68,65,26676,65,4930,34,59,54158,59,3366
0.045,17,2,182,1,44,0,44,72,1,82,0,82,110
1780.757,6,282,35389,117,152,15350,1460,18301,165,127,10857,1642,17088
174.176,6,32,8952,15,158,12441,267,1397,17,687,10882,1400,7555
0.518,6,10,924,5,283,87,283,551,5,105,88,105,373
61.002,17,4,352,2,48,60992,48,152,2,72,60990,72,200
155.154,17,6,518,3,32,77575,33,181,3,84,77575,145,337
84.873,17,8,5000,8,597,12124,1417,5000,0,0,0,0,0
4.52,2,2,64,2,8,4520,8,64,0,0,0,0,0
2.267,6,9,1647,6,100,453,100,344,3,1179,1001,1179,1303
1740.394,1,15,840,15,28,124313,28,840,0,0,0,0,0
279.744,17,4,352,2,60,279743,60,176,2,60,279743,60,176
0.014,17,3,474,2,36,9,36,128,1,318,0,318,346
1.175,6,32,12259,15,476,83,1360,2573,17,749,54,1360,9686
1793.568,17,86,3606,85,14,21352,14,3570,1,8,0,8,36
0.883,6,2,87,1,0,0,0,40,1,7,0,7,47
8.18,6,76,52536,47,1198,177,1368,45626,29,899,284,2519,6910
16.498,17,4,352,2,48,16490,48,152,2,72,16489,72,200
4.387,6,34,6169,19,206,243,314,2824,15,548,291,1179,3345
782.185,2,10,320,10,8,86909,8,320,0,0,0,0,0
280.518,6,27,7312,12,158,25501,267,1277,15,678,20034,2045,6035
2.47,2,2,64,2,8,2470,8,64,0,0,0,0,0
1746.795,6,99,7708,65,40,27293,205,4674,34,37,52920,170,3034
1790.898,6,450,26546,240,69,7493,69,13878,210,34,8568,64,12668
1786.74,6,102,8228,68,64,26667,64,4896,34,58,54141,58,3332
93.292,17,4,352,2,60,93291,60,176,2,60,93290,60,176
154.575,6,140,105541,85,1305,1840,1440,94517,55,679,2118,1440,11024
0.075,6,13,4387,7,92,12,92,464,6,1201,15,2121,3923
0.98,6,11,1727,7,100,163,100,384,4,589,240,1152,1343
9.319,6,2110,1976486,1355,1381,6,1408,1932562,755,931,12,2801,43924
324.756,17,6,2016,6,308,64951,308,2016,0,0,0,0,0
1795.031,6,244,46664,152,483,11887,483,36892,92,83,19725,83,9772
0.029,17,2,904,1,300,0,300,328,1,548,0,548,576
1772.44,6,180,15480,120,69,14894,69,8940,60,69,30032,69,6540
19.742,6,9,527,5,43,4935,43,311,4,0,6577,0,216
1749.414,6,97,7307,63,38,28216,205,4476,34,33,53001,98,2831
1725.214,17,12,498,11,14,172521,14,462,1,8,0,8,36
1740.499,17,27,6345,27,207,66942,207,6345,0,0,0,0,0
1796.488,17,456,41624,405,35,4446,288,25740,51,283,35491,308,15884
1738.067,1,56,4704,56,56,31601,56,4704,0,0,0,0,0
0.989,6,10,1687,7,100,164,100,384,3,1179,366,1179,1303
0.02,6,7,280,2,0,20,0,80,5,0,1,0,200
70.173,6,79,55512,50,1207,1432,1368,47267,29,841,2251,2736,8245
353.79,6,93,11473,45,97,6883,267,3462,48,276,7527,1460,8011
5.278,17,26,14453,13,822,439,1350,11058,13,233,404,1350,3395
1679.543,17,12,498,11,14,167954,14,462,1,8,0,8,36
1777.648,17,140,11200,70,48,25762,48,5320,70,56,25762,56,5880
8.254,17,6,456,6,48,1650,48,456,0,0,0,0,0
1799.937,17,763,46067,763,32,2362,37,46067,0,0,0,0,0
233.28,6,8,2017,5,355,58320,413,1267,3,210,116527,269,750
2.092,6,3,151,0,0,0,0,0,3,31,1046,31,151
240.219,6,52,17717,28,795,8896,1418,14983,24,184,10443,580,2734
0.102,17,4,284,2,32,1,32,120,2,54,39,60,164
141.817,6,48,19078,26,640,301,1360,5042,22,1010,6744,3107,14036
1793.798,6,356,22520,208,69,8665,69,12460,148,69,12201,69,10060
0.367,6,27,9098,13,261,30,683,1728,14,829,26,1448,7370
840.58,17,10,2594,5,31,210141,37,297,5,431,210142,463,2297
60.861,17,4,304,4,48,20287,48,304,0,0,0,0,0
1794.295,6,366,23265,211,69,8544,69,12787,155,69,11651,69,10478
1684.532,2,14,448,14,8,129579,8,448,0,0,0,0,0
169.92,17,14,4704,14,308,13070,308,4704,0,0,0,0,0
21.827,17,4,352,2,60,21826,60,176,2,60,21826,60,176
1786.985,6,105,8416,68,65,26671,65,4930,37,59,49634,59,3486
341.56,17,6,528,3,60,170779,60,264,3,60,170779,60,264
1772.512,6,203,22290,130,75,13740,267,10057,73,134,24616,1997,12233
0.984,17,23,7096,11,391,95,1350,4613,12,178,86,1350,2483
1782.646,6,385,24944,210,69,8529,69,12816,175,63,10245,69,12128
2.881,17,3,201,3,39,1440,39,201,0,0,0,0,0
1755.879,1,57,4788,0,0,0,0,0,57,56,31354,56,4788
0.08,6,12,2818,7,610,13,684,1592,5,479,18,939,1226
6.41,17,32,8533,14,333,493,1350,5062,18,164,350,1350,3471
1787.656,17,83,3480,82,14,22069,14,3444,1,8,0,8,36
0.16,6,49,23612,28,1088,5,1420,18551,21,420,7,1420,5061
33.549,6,29,4991,14,180,2580,722,1807,15,342,2382,1408,3184
372.908,6,37,7294,17,153,13565,516,1760,20,278,19622,1452,5534
0.064,17,2,214,1,39,0,39,67,1,119,0,119,147
0.504,6,10,968,5,256,122,256,460,5,304,122,304,508
1699.426,17,12,498,11,14,169942,14,462,1,8,0,8,36
4.261,6,39,7285,20,218,224,314,3423,19,516,222,1179,3862
0.051,17,2,198,1,63,0,63,91,1,79,0,79,107
75.341,6,17,700,8,0,5348,0,324,9,0,9415,0,376
1796.06,17,449,39928,404,35,4456,288,25708,45,288,40015,288,14220
0.136,17,2,2382,2,1163,136,1163,2382,0,0,0,0,0
1796.51,1,232,12992,232,28,7777,28,12992,0,0,0,0,0
113.87,6,28,5770,10,107,12651,159,970,18,773,6697,1408,4800
0.831,6,23,6428,13,314,68,908,2094,10,982,91,1731,4334
0.388,6,13,1693,7,288,60,288,588,6,426,40,434,1105
1770.639,6,100,9250,66,64,27240,65,5556,34,58,53653,59,3694
1.004,6,27,8420,15,222,60,540,1964,12,1192,74,3151,6456
23.735,17,4,240,2,32,23734,32,120,2,32,23734,32,120
0.095,17,2,180,1,30,0,30,58,1,94,0,94,122
4.183,17,2,656,2,300,4183,300,656,0,0,0,0,0
3.756,17,5,290,5,30,939,30,290,0,0,0,0,0
1742.558,6,98,7390,63,38,28105,205,4476,35,33,51245,98,2914
0.127,17,4,608,2,60,2,60,176,2,188,7,188,432
0.539,6,28,7336,13,155,44,267,1301,15,543,32,1400,6035
25.179,6,33,8180,16,175,1678,721,2047,17,778,1561,2840,6133
368.566,6,36,4901,20,304,19398,304,3468,16,83,24570,83,1433
1772.372,6,180,15480,120,69,14893,69,8940,60,69,30036,69,6540
90.224,6,24,10294,12,433,81,990,1835,12,995,8188,1390,8459
196.733,6,31,8821,16,174,13115,385,1538,15,721,14050,1438,7283
0.548,6,24,7470,13,335,45,668,2038,11,968,51,1475,5432
17.126,17,4,352,2,48,17112,48,152,2,72,17105,72,200
240.241,6,62,21202,32,826,7749,1418,18210,30,178,8283,580,2992
7.833,2,2,64,2,8,7833,8,64,0,0,0,0,0
1681.423,17,14,3843,7,30,280236,30,406,7,463,280236,463,3437
5.038,1,2,192,0,0,0,0,0,2,68,5038,68,192
11.241,6,15,1178,10,275,1228,275,962,5,0,1955,0,216
0.119,6,10,1671,6,552,23,948,1348,4,159,39,159,323
0.299,6,26,8995,13,252,24,647,1692,13,945,23,1408,7303
0.158,17,2,358,1,32,0,32,60,1,270,0,270,298
0.33,6,26,8868,13,227,27,547,1592,13,941,24,1438,7276
10.91,17,2,152,2,48,10910,48,152,0,0,0,0,0
280.206,6,29,7392,13,158,23350,267,1317,16,603,18679,1400,6075
46.176,6,37,8457,15,144,177,267,1485,22,506,2193,1460,6972
1772.19,6,180,15480,120,69,14892,69,8940,60,69,30034,69,6540
3.59,6,11,1727,6,100,201,100,344,5,1179,836,1179,1383
7.476,6,12,2271,7,188,1246,245,660,5,1407,1798,1407,1611
1.523,6,32,6507,15,164,108,267,1922,17,650,82,1452,4585
1739.072,1,55,4620,0,0,0,0,0,55,56,32205,56,4620
1.265,6,47,19047,27,882,48,1360,13471,20,433,57,1360,5576
300.686,6,38,8285,20,245,15825,633,1812,18,441,503,1460,6473
0.6,17,2,154,1,33,0,33,61,1,65,0,65,93
0.365,17,2,304,1,60,0,60,88,1,188,0,188,216
1789.652,17,142,11360,71,48,25566,48,5396,71,56,25566,56,5964
160.83,6,21,8712,11,314,60,634,1415,10,1147,17855,2720,7297
0.536,17,3,451,2,39,435,39,134,1,289,0,289,317
1797.659,1,264,14784,264,28,6835,28,14784,0,0,0,0,0
287.236,6,31,3701,15,324,20516,585,1437,16,357,19148,580,2264
125.822,2,2,64,2,8,125822,8,64,0,0,0,0,0
0.046,17,2,196,1,62,0,62,90,1,78,0,78,106
1785.866,6,363,23076,210,69,8544,69,12609,153,69,11749,69,10467
1741.973,2,26,832,26,8,69678,8,832,0,0,0,0,0
1.528,6,49,19086,28,943,56,1460,13425,21,437,66,2615,5661
662.167,6,240,60434,117,465,5708,1360,48946,123,123,5427,918,11488
317.141,6,73,20074,39,367,8345,1360,10451,34,485,9606,2720,9623
1.063,6,23,6380,13,299,88,842,2023,10,988,117,1731,4357
1216.903,6,217,29171,85,185,14486,1460,12710,132,113,9242,1460,16461
61.049,6,15,1666,9,180,7631,180,1016,6,110,12161,110,650
855.194,17,124,9424,124,48,6952,48,9424,0,0,0,0,0
1.087,6,11,1727,7,100,181,100,384,4,589,277,1152,1343
1792.453,6,404,37296,228,103,7896,469,17072,176,173,10242,2760,20224
369.387,6,25,1651,17,177,23086,177,1117,8,110,9205,110,534
5.006,17,4,778,2,44,5002,44,144,2,289,5000,289,634
10.002,17,3,1008,3,308,5001,308,1008,0,0,0,0,0
283.162,17,4,296,2,30,283143,30,116,2,62,283087,62,180
3.968,6,2,88,2,0,0,0,88,0,0,0,0,0
0.016,17,2,574,1,32,0,32,60,1,486,0,486,514
1.585,6,50,18850,29,856,56,1360,13189,21,400,68,1360,5661
1797.467,17,448,39896,403,35,4471,288,25676,45,288,40014,288,14220
1710.491,17,12,498,11,14,171049,14,462,1,8,0,8,36
300.192,6,91,15388,45,310,6822,1408,7955,46,209,6670,1408,7433
1793.176,1,261,14616,261,28,6896,28,14616,0,0,0,0,0
601.595,2,4,128,4,8,200531,8,128,0,0,0,0,0
1770.982,6,99,9306,66,66,27245,66,5610,33,60,55340,60,3696
0.047,6,12,3462,6,75,9,75,395,6,1373,9,1448,3067
76.912,17,8,640,4,48,25633,48,304,4,56,25632,56,336
9.052,17,4,488,4,94,3017,94,488,0,0,0,0,0
0.624,17,25,17728,14,1045,45,1350,15025,11,217,54,1350,2703
1798.429,17,449,39928,404,35,4462,288,25708,45,288,40023,288,14220
76.533,6,38,24326,20,840,37,1360,5911,18,1607,4494,8160,18415
70.406,6,31,7475,14,155,5415,267,1346,17,418,4399,2840,6129
1781.236,1,172,9632,172,28,10416,28,9632,0,0,0,0,0
1741.147,6,87,6322,58,31,30546,31,3915,29,31,62181,31,2407
280.248,6,29,7392,13,158,23354,267,1317,16,543,18682,1400,6075
1771.702,6,125,12473,77,62,23311,722,6402,48,91,37690,1448,6071
1795.386,1,58,4872,58,56,31498,56,4872,0,0,0,0,0
1786.607,6,104,8504,69,66,26273,66,5004,35,60,52544,60,3500
1755.826,6,2343,2094786,896,141,1961,888,58170,1447,1427,1214,4254,2036616
600.026,1,6,336,6,28,120005,28,336,0,0,0,0,0
890.039,6,122,9813,48,83,18316,338,5027,74,50,12192,143,4786
0.099,17,2,180,1,30,0,30,58,1,94,0,94,122
1793.434,6,356,22520,208,69,8663,69,12460,148,69,12199,69,10060
1.124,6,25,9512,13,164,79,267,1388,12,1248,86,4224,8124
1.053,6,37,8231,19,241,58,619,1757,18,441,49,1460,6474
196.39,6,26,3493,9,302,24548,302,1672,17,83,12273,83,1821
0.243,17,2,218,1,65,0,65,93,1,97,0,97,125
367.139,6,23,1535,16,177,24475,177,1053,7,110,10364,110,482
2.172,6,13,2311,8,188,310,245,700,5,1407,482,1407,1611
1786.849,6,104,8376,68,65,26669,65,4930,36,59,51050,59,3446
240.211,6,53,18053,28,807,8896,1418,15190,25,194,10008,580,2863
1788.239,1,244,13664,244,28,7359,28,13664,0,0,0,0,0
21.979,6,22,6936,6,154,1801,267,712,16,506,1463,1917,6224
1.521,17,4,304,3,32,752,32,180,1,96,0,96,124
15.471,6,7,328,2,0,15471,0,88,5,0,3811,0,240
16.317,17,15,6627,8,539,2311,1350,4540,7,270,2702,1350,2087
0.036,17,4,760,3,60,5,60,264,1,468,0,468,496
0.475,6,49,20327,27,1006,18,1380,15205,22,421,21,1923,5122
0.002,17,2,124,1,34,0,34,62,1,34,0,34,62
15.37,6,13,1103,6,275,3074,275,523,7,96,2048,96,580
4.522,6,33,6129,17,206,282,314,2744,16,548,284,1179,3385
68.828,6,34,18749,18,702,53,1360,4967,16,1193,4578,3056,13782
300.629,6,46,8967,23,283,13664,787,2169,23,366,462,2720,6798
0.367,6,10,968,5,256,88,256,460,5,304,88,304,508
15.601,17,18,13294,11,985,1553,1350,11147,7,278,2588,1350,2147
0.514,6,18,6377,9,141,64,275,646,9,894,29,1380,5731
1741.269,6,92,6668,60,31,29513,31,4062,32,31,56169,31,2606
1787.669,6,102,8296,68,65,26681,65,4930,34,59,54168,59,3366
1.459,6,45,17817,26,862,58,1360,12281,19,476,70,2720,5536
0.831,6,10,1687,7,100,138,100,384,3,1179,287,1179,1303
0.056,6,10,767,5,186,12,186,454,5,45,12,45,313
1763.36,1,16,1304,16,53,117557,78,1304,0,0,0,0,0
66.454,1,8,832,0,0,0,0,0,8,76,9493,76,832
0.04,17,4,284,2,32,17,32,120,2,54,25,60,164
141.654,6,59,28672,34,411,4292,1357,3891,25,1303,3183,2876,24781
13.245,6,19,6745,10,275,1471,275,958,9,1353,1347,1440,5787
1769.634,6,194,11891,96,47,18627,208,6948,98,31,18241,31,4943
1.305,6,49,20418,28,910,48,1360,14802,21,476,56,2715,5616
38.669,17,21,1596,21,48,1933,48,1596,0,0,0,0,0
15.578,17,5,380,5,48,3894,48,380,0,0,0,0,0
0.933,17,4,314,2,31,901,31,118,2,70,902,70,196
110.251,17,12,1056,6,48,22048,48,456,6,72,22047,72,600
369.859,6,23,1511,14,177,28450,177,925,9,110,9251,110,586
608.0,6,58,7170,33,87,19000,722,3153,25,169,23565,2026,4017
38.447,6,9,567,4,138,12714,138,298,5,34,9611,48,269
0.614,6,24,6041,13,108,51,147,959,11,773,51,1608,5082
0.057,17,12,4365,12,335,5,358,4365,0,0,0,0,0
1772.348,6,180,15480,120,69,14893,69,8940,60,69,30032,69,6540
1074.072,2,15,480,15,8,76719,8,480,0,0,0,0,0
134.536,6,38,5839,13,154,11211,722,1755,25,185,5597,1408,4084
1786.197,6,104,8376,68,65,26659,65,4930,36,59,51031,59,3446
14.865,6,86,25311,44,526,345,1152,19149,42,447,354,1179,6162
0.237,17,3,468,3,128,118,128,468,0,0,0,0,0
1787.332,6,104,8435,69,65,26284,65,4970,35,59,52564,59,3465
159.326,6,35,8134,11,152,15931,267,1364,24,305,6926,1460,6770
5.011,17,4,558,2,36,5006,36,128,2,187,5006,187,430
0.01,17,2,391,1,44,0,44,72,1,291,0,291,319
13.735,6,26,4815,13,154,1127,722,1767,13,473,1130,2026,3048
1787.907,6,369,25730,214,99,8393,469,15114,155,69,11609,69,10616
0.262,6,23,5080,12,137,23,267,1172,11,577,25,1400,3908
0.674,6,25,10169,13,136,56,136,820,12,1089,61,1448,9349
1.336,6,39,8292,19,320,74,1162,2716,20,433,61,1360,5576
12.71,6,2013,1751425,1218,1381,10,1420,1715392,795,467,15,1883,36033
0.385,6,12,1653,6,288,76,288,548,6,426,42,434,1105
0.345,17,2,167,1,39,0,39,67,1,72,0,72,100
97.978,17,4,352,2,60,97977,60,176,2,60,97977,60,176
32.235,6,35,7911,14,149,2479,267,1760,21,441,1610,1460,6151
1.635,6,30,12050,16,525,109,1360,3298,14,908,99,1379,8752
280.616,6,30,7432,13,158,23384,267,1317,17,543,17536,1400,6115
0.091,17,3,231,3,49,45,49,231,0,0,0,0,0
0.862,6,10,1687,7,100,143,100,384,3,1179,310,1179,1303
33.492,6,31,5102,15,180,2392,722,1859,16,300,2221,1402,3243
142.06,6,174,140318,112,1295,1279,1408,127584,62,730,2325,3847,12734
63.929,6,38,22157,22,549,31,1360,3172,16,1833,4253,4080,18985
2.035,17,4,352,2,60,2033,60,176,2,60,2034,60,176
1785.554,17,87,3648,86,14,21006,14,3612,1,8,0,8,36
1.342,6,50,19324,27,894,51,1360,13628,23,433,51,1360,5696
151.345,6,74,50641,47,1177,3290,1408,42502,27,961,2371,3847,8139
63.922,6,30,8872,13,158,5326,267,1317,17,687,3992,1400,7555
1.769,6,47,18943,27,863,68,1360,13271,20,441,82,2720,5672
1798.661,6,384,26744,220,97,8213,469,15699,164,69,11032,69,11045
1656.476,1,8,448,8,28,236639,28,448,0,0,0,0,0
1729.363,6,60,4400,40,33,44342,33,2740,20,31,91006,31,1660
124.49,6,7,418,4,106,41496,106,274,3,0,1517,0,144
1.649,6,44,10147,23,440,74,1360,4486,21,400,72,1360,5661
1788.609,17,87,3648,86,14,21042,14,3612,1,8,0,8,36
1745.984,2,26,832,26,8,69839,8,832,0,0,0,0,0
1777.123,17,73,3060,72,14,25029,14,3024,1,8,0,8,36
0.056,17,2,198,1,39,0,39,67,1,103,0,103,131
0.009,17,2,399,1,47,0,47,75,1,296,0,296,324
33.712,6,32,5346,15,154,2408,722,1858,17,325,2093,1402,3488
0.19,6,13,3040,7,695,31,860,1762,6,479,26,939,1278
15.921,6,22,1583,12,222,1443,222,932,10,231,1737,231,651
1787.046,17,87,3648,86,14,21024,14,3612,1,8,0,8,36
1793.536,1,59,4956,59,56,30923,56,4956,0,0,0,0,0
317.927,6,92,35243,45,725,7225,1360,24334,47,310,6908,1929,10909
68.976,17,4,352,2,60,68974,60,176,2,60,68975,60,176
33.508,6,9,396,2,0,2826,0,88,7,0,5570,0,308
126.152,6,25,6318,9,272,1010,516,1180,16,345,8404,1452,5138
0.402,6,88,55942,50,1248,8,1432,48260,38,559,10,1871,7682
0.157,6,42,19834,24,1070,6,1420,14893,18,467,8,1883,4941
3.047,17,8,480,4,32,1015,32,240,4,32,1015,32,240
315.016,6,61,38302,38,1135,8513,1408,30370,23,841,2791,2816,7932
1772.909,6,180,15480,120,69,14898,69,8940,60,69,30047,69,6540
0.005,17,2,176,1,48,0,48,76,1,72,0,72,100
369.57,6,18,1242,14,180,28428,180,916,4,110,20064,110,326
1019.899,17,200,15200,200,48,5125,48,15200,0,0,0,0,0
1795.062,6,186,11239,92,45,19711,208,6518,94,31,19300,31,4721
240.307,6,43,8751,21,524,12014,1418,5816,22,198,11442,618,2935
1786.472,6,102,8364,68,66,26663,66,4964,34,60,54132,60,3400
280.314,6,29,7392,13,158,23359,267,1317,16,603,18683,2036,6075
1791.493,6,191,11678,95,47,19058,208,6877,96,31,18855,31,4801
53.849,17,10,1352,5,48,13460,48,380,5,166,13459,308,972
67.97,6,27,7177,13,155,5664,267,1306,14,530,5227,3417,5871
2.445,6,29,6175,15,338,174,1314,2294,14,368,187,1414,3881
0.035,17,2,251,1,31,0,31,59,1,164,0,164,192
137.311,17,27,2307,27,57,5281,355,2307,0,0,0,0,0
9.736,6,74,44621,45,1219,221,1360,38430,29,386,339,2720,6191
180.613,6,33,19143,16,708,47,1460,4226,17,1185,11280,1850,14917
139.884,6,25,6454,10,220,6359,516,1286,15,380,9964,1452,5168
1700.975,1,8,448,8,28,242996,28,448,0,0,0,0,0
1789.014,1,342,28728,342,56,5246,56,28728,0,0,0,0,0
19.551,6,2452,2256724,1564,1365,12,1408,2205884,888,931,21,2801,50840
0.264,17,3,451,2,39,233,39,134,1,289,0,289,317
157.6,6,21,7979,11,525,87,1237,2048,10,919,17491,1591,5931
280.479,6,29,7392,13,158,23373,267,1317,16,678,18696,2085,6075
1786.415,6,360,24156,210,88,8547,469,13878,150,69,11987,69,10278
258.99,17,4,240,2,32,258989,32,120,2,32,258989,32,120
1785.502,6,360,22818,209,69,8584,69,12638,151,69,11903,69,10180
11.011,6,83,24525,43,550,262,1152,18784,40,459,275,1179,5741
1781.126,1,340,28560,340,56,5254,56,28560,0,0,0,0,0
1681.513,17,14,1036,7,30,280247,30,406,7,62,280250,62,630
3.533,6,44,19961,24,529,153,1360,3710,20,1029,175,1945,16251
3.339,6,12,1634,6,503,667,503,831,6,475,667,475,803
4.676,6,37,7205,19,218,259,314,3383,18,516,259,1179,3822
0.156,6,27,7296,13,155,13,267,1301,14,603,11,2800,5995
5.768,6,5,347,2,75,5768,75,167,3,0,875,0,180
0.083,17,2,362,1,32,0,32,60,1,274,0,274,302
27.961,6,38,8413,19,199,1553,721,2161,19,685,1534,1440,6252
1645.622,1,7,392,7,28,274270,28,392,0,0,0,0,0
167.921,6,32,8952,14,158,12917,267,1357,18,624,9874,1400,7595
0.703,17,4,352,2,60,701,60,176,2,60,702,60,176
30.63,6,29,8832,14,158,2356,267,1357,15,858,2186,3436,7475
4.263,6,39,7269,19,218,236,314,3383,20,440,210,1152,3886
6.84,6,561,505493,364,1324,18,1368,490585,197,776,33,1473,14908
208.852,17,5,1676,5,307,52213,308,1676,0,0,0,0,0
1772.252,6,180,15480,120,69,14892,69,8940,60,69,30037,69,6540
0.835,6,12,3046,5,92,208,92,360,7,463,47,1408,2686
0.198,6,40,14359,22,851,9,1420,9418,18,420,11,1420,4941
15.48,17,19,2604,10,48,1718,48,760,9,176,1918,308,1844
1.374,6,50,19131,27,880,52,1440,13435,23,433,54,1440,5696
0.733,6,24,5755,13,158,60,370,1315,11,799,72,1420,4440
1797.434,1,57,4788,57,56,32097,56,4788,0,0,0,0,0
3.83,6,24,6551,13,333,318,1005,2191,11,783,382,1420,4360
15.64,6,8,480,2,0,1021,0,120,6,0,3096,0,360
1791.635,1,240,25440,240,78,7496,78,25440,0,0,0,0,0
1635.131,1,7,392,7,28,272521,28,392,0,0,0,0,0
0.007,6,2,214,1,134,0,134,174,1,0,0,0,40
102.943,6,34,8341,16,367,4110,787,1774,18,448,6047,4848,6567
0.904,17,3,372,2,64,876,64,184,1,160,0,160,188
421.146,2,5,160,5,8,105286,8,160,0,0,0,0,0
1785.832,6,382,23848,217,69,8267,69,12820,165,57,10889,69,11028
1773.21,1,58,4872,0,0,0,0,0,58,56,31108,56,4872
1777.806,1,339,28476,339,56,5259,56,28476,0,0,0,0,0
28.683,6,29,7392,13,158,2390,267,1317,16,603,1906,2800,6075
1773.062,6,181,15589,120,69,14899,69,8940,61,69,29546,69,6649
3.997,17,8,616,4,33,1332,33,244,4,65,1332,65,372
1687.861,1,8,448,8,28,241123,28,448,0,0,0,0,0
4.249,6,34,6169,19,206,236,314,2824,15,548,285,1179,3345
42.835,17,3,228,3,48,21417,48,228,0,0,0,0,0
243.114,2,4,128,4,8,81038,8,128,0,0,0,0,0
0.19,17,4,308,2,33,0,33,122,2,65,0,65,186
1761.238,6,125,12573,68,66,26285,517,4740,57,242,31449,2448,7833
9.412,6,9,527,5,43,2353,43,311,4,0,3136,0,216
1.411,6,37,8214,19,321,78,1164,2718,18,476,72,2715,5496
1799.83,6,368,25897,213,99,8489,469,15005,155,69,11687,69,10892
193.417,6,193,132186,108,1262,1807,1368,118011,85,679,1562,2519,14175
55.122,6,6600,6261083,4094,1443,13,1448,6113925,2506,899,21,1448,147158
75.051,6,17,700,8,0,5190,0,324,9,0,9380,0,376
0.976,17,2,677,1,300,0,300,328,1,321,0,321,349
0.015,17,2,588,1,45,0,45,73,1,487,0,487,515
1.111,6,28,8631,15,236,66,625,2049,13,1210,76,3151,6582
11.976,6,37,10560,20,357,630,674,4633,17,992,744,1946,5927
1759.686,6,78,3588,39,0,46307,0,2028,39,0,46307,0,1560
10.65,6,14,2242,8,210,1521,210,844,6,545,2129,904,1398
1786.873,6,102,8296,68,65,26669,65,4930,34,59,54144,59,3366
48.439,17,4,352,2,60,48438,60,176,2,60,48438,60,176
372.057,6,18,1239,14,177,28619,177,913,4,110,20060,110,326
1776.673,6,79,4650,39,36,46753,36,2100,40,458,45554,458,2550
19.088,1,6,168,6,0,0,0,168,0,0,0,0,0
0.537,6,21,5000,10,137,59,267,1092,11,692,43,1467,3908
1.663,6,14,2351,8,188,237,245,700,6,703,281,1152,1651
1786.349,6,102,8228,68,64,26661,64,4896,34,58,54128,58,3332
2.608,6,10,1687,7,100,434,100,384,3,1179,1172,1179,1303
66.366,6,40,8723,19,378,859,787,1974,21,393,3311,4848,6749
1796.14,17,448,39896,403,35,4468,288,25676,45,288,40018,288,14220
1.408,6,41,8453,21,320,70,1162,2832,20,400,64,1360,5621
42.23,17,12,912,12,48,3839,48,912,0,0,0,0,0
317.008,6,77,19771,39,325,8342,1360,10086,38,339,8562,1360,9685
0.255,17,3,451,2,39,91,39,134,1,289,0,289,317
0.018,17,2,374,1,47,0,47,75,1,271,0,271,299
0.655,6,25,6627,12,137,59,267,1172,13,704,54,1467,5455
1772.943,6,181,15589,120,69,14898,69,8940,61,69,29548,69,6649
125.393,6,12,3039,6,92,25078,92,400,6,580,25039,1402,2639
0.68,6,10,968,5,256,167,256,460,5,304,166,304,508
15.465,6,27,4868,14,154,1149,722,1820,13,473,1251,2026,3048
0.501,6,26,8925,13,239,41,597,1642,13,942,38,1402,7283
1.424,6,49,19747,27,927,54,1440,14091,22,433,58,1440,5656
5.186,6,5,232,2,0,5186,0,88,3,0,1526,0,144
1796.254,17,449,39928,404,35,4457,288,25708,45,288,40023,288,14220
280.177,6,29,7392,13,158,23348,267,1317,16,603,18676,2036,6075
240.33,6,45,8511,23,449,10923,1408,5712,22,205,11444,580,2799
253.005,6,29,7392,13,158,21083,267,1317,16,603,16862,2760,6075
0.296,6,5,303,2,0,45,0,104,3,31,148,31,199
21.749,17,20,6972,9,433,2715,1350,4152,11,228,2171,1350,2820
1.528,17,2,241,1,36,0,36,64,1,149,0,149,177
9.908,6,82,25050,42,568,241,1152,19309,40,459,247,1179,5741
1796.817,1,278,15568,278,28,6486,28,15568,0,0,0,0,0
1.629,17,12,6330,6,615,325,1350,3860,6,383,150,1350,2470
1798.236,1,345,28980,345,56,5227,56,28980,0,0,0,0,0
1799.769,17,4207,201936,2104,20,855,20,100992,2103,20,856,20,100944
1770.689,6,105,9552,66,65,27241,65,5577,39,59,46594,59,3975
1082.904,2,14,448,14,8,83300,8,448,0,0,0,0,0
1706.517,1,14,784,14,28,131270,28,784,0,0,0,0,0
129.919,6,31,12258,19,449,7217,1035,2261,12,1357,5912,2256,9997
330.986,6,27,2985,13,324,27581,585,1357,14,226,25459,580,1628
0.692,6,141,100023,81,1305,8,1432,93323,60,389,11,1432,6700
1.311,17,4,252,3,31,654,31,177,1,47,0,47,75
0.423,6,5,248,3,0,211,0,144,2,0,418,0,104
1633.774,1,8,848,8,78,233396,78,848,0,0,0,0,0
1683.939,17,16,1265,8,30,240556,37,471,8,71,240555,136,794
1143.393,17,16,6428,16,373,76226,1123,6428,0,0,0,0,0
1.336,6,48,18699,26,920,53,1460,13043,22,433,54,1460,5656
1742.665,6,87,6322,58,31,30573,31,3915,29,31,62237,31,2407
1.313,6,46,17950,26,869,52,1440,12374,20,433,60,1440,5576
44.983,17,8,616,8,49,6426,49,616,0,0,0,0,0
66.274,6,27,7177,13,155,5522,267,1306,14,530,5097,3417,5871
9.584,1,12,1248,0,0,0,0,0,12,76,871,76,1248
5.037,17,4,288,2,36,5005,36,128,2,52,4987,52,160
3.936,17,5,290,5,30,984,30,290,0,0,0,0,0
1648.638,1,101,5656,101,28,16486,28,5656,0,0,0,0,0
1.679,6,10,1687,7,100,279,100,384,3,1179,713,1179,1303
1748.109,1,8,848,8,78,249729,78,848,0,0,0,0,0
0.018,17,2,412,1,48,0,48,76,1,308,0,308,336
60.761,6,21,5947,11,267,6076,502,1246,10,613,6741,1420,4701
915.809,6,124,18206,45,143,20813,1305,5083,79,157,11735,4649,13123
6.89,6,42,7389,22,218,328,314,3503,20,440,349,1152,3886
1.025,6,23,6516,13,334,84,1010,2196,10,979,112,1691,4320
5.722,6,42,7389,22,218,272,314,3503,20,513,285,1179,3886
2.108,17,6,471,3,31,580,31,177,3,70,0,70,294
1.96,6,29,8932,17,286,122,591,1543,12,863,158,1380,7389
0.4,6,46,17650,25,961,16,1380,12568,21,421,18,1923,5082
1746.27,6,106,7911,67,38,26458,205,4715,39,33,45949,98,3196
12.581,6,19,2277,10,229,1397,619,1338,9,283,1556,415,939
0.162,6,3,120,1,0,0,0,40,2,0,87,0,80
367.002,6,18,1242,14,180,28230,180,916,4,110,20063,110,326
1794.868,17,140,11200,70,48,26012,48,5320,70,56,26012,56,5880
15.464,6,14,1025,7,222,2575,222,506,7,231,2575,231,519
1773.302,6,180,15480,120,69,14901,69,8940,60,69,30052,69,6540
1.037,6,25,8703,14,264,79,700,1651,11,942,85,1460,7052
3.412,6,7,1690,7,189,568,259,1690,0,0,0,0,0
1797.642,17,447,39864,402,35,4482,288,25644,45,288,40020,288,14220
7.077,6,1279,1125279,775,1372,8,1408,1094407,504,776,13,1408,30872
1.432,6,27,8160,14,164,95,267,1392,13,869,104,1408,6768
128.59,6,23,8261,11,186,12859,267,821,12,869,1506,1917,7440
98.78,6,29,12066,14,476,62,1360,2499,15,995,7046,2720,9567
0.084,6,9,1002,5,213,21,213,417,4,421,23,421,585
1773.323,6,163,25231,98,215,18281,810,15454,65,133,27706,1448,9777
12.139,6,1954,1670590,1177,1364,10,1380,1635268,777,468,15,3303,35322
92.881,17,5,380,5,48,23220,48,380,0,0,0,0,0
1784.881,6,357,22629,208,69,8622,69,12460,149,69,12058,69,10169
28.56,6,27,5081,11,205,2856,722,1629,16,261,1889,2026,3452
1791.622,6,404,36371,225,133,7998,1189,18718,179,127,10065,1420,17653
4.593,6,37,7189,19,218,255,314,3383,18,513,254,1179,3806
3.011,17,4,292,2,37,3005,37,130,2,53,3003,53,162
0.105,17,4,350,2,34,28,34,124,2,85,96,91,226
1788.972,17,142,11360,71,48,25556,48,5396,71,56,25556,56,5964
12.841,17,4,352,2,60,12840,60,176,2,60,12840,60,176
0.175,6,26,7256,13,155,14,267,1301,13,678,14,2800,5955
323.607,17,21,7056,21,308,16180,308,7056,0,0,0,0,0
1.546,6,3,160,2,0,1037,0,120,1,0,0,0,40
296.111,6,34,4353,16,237,19739,585,1601,18,226,17417,580,2752
0.097,17,2,152,1,48,0,48,76,1,48,0,48,76
3.048,6,15,3217,5,92,762,92,348,10,579,304,1408,2869
325.71,6,8,475,6,31,65142,31,333,2,31,299523,31,142
240.317,6,46,8551,24,449,10448,1402,5752,22,205,11443,580,2799
31.578,6,4557,4355794,2948,1398,10,1440,4267462,1609,776,19,1440,88332
1792.926,17,141,11276,71,48,25612,48,5396,70,56,25983,56,5880
1748.234,6,97,7307,63,38,28197,205,4476,34,33,52965,98,2831
1772.212,6,180,15480,120,69,14892,69,8940,60,69,30034,69,6540
15.061,6,30,8872,14,158,1158,267,1357,16,763,999,2760,7515
1786.608,6,102,8364,68,66,26665,66,4964,34,60,54137,60,3400
1798.244,17,449,39928,404,35,4462,288,25708,45,288,40019,288,14220
1786.148,17,87,3648,86,14,21013,14,3612,1,8,0,8,36
38.0,17,20,1760,10,48,4221,48,760,10,72,4220,72,1000
106.84,17,16,3340,16,180,7122,219,3340,0,0,0,0,0
1.065,6,31,6260,16,138,71,267,1755,15,650,71,1420,4505
1747.056,6,123,10459,76,60,23294,205,6199,47,40,37971,98,4260
0.986,17,4,240,2,32,985,32,120,2,32,984,32,120
1775.707,17,140,11200,70,48,25734,48,5320,70,56,25734,56,5880
1.315,6,47,19512,27,916,50,1360,13936,20,476,60,2715,5576
1441.283,6,229,14999,126,69,11530,69,7731,103,68,14130,69,7268
0.071,17,2,572,1,39,0,39,67,1,477,0,477,505
0.037,1,2,112,2,28,37,28,112,0,0,0,0,0
0.005,17,2,245,1,32,0,32,60,1,157,0,157,185
1.226,6,50,20434,28,908,45,1360,14778,22,476,50,2715,5656
1679.669,17,12,498,11,14,167966,14,462,1,8,0,8,36
0.011,17,4,368,2,32,10,32,120,2,96,11,96,248
1.433,6,24,8004,12,164,110,267,1288,12,1014,110,2491,6716
0.342,6,10,968,5,256,84,256,460,5,304,84,304,508
0.005,17,2,375,1,29,0,29,57,1,290,0,290,318
365.776,6,20,1358,15,180,26126,180,980,5,110,15168,110,378
1744.755,2,27,864,27,8,67105,8,864,0,0,0,0,0
1672.119,1,8,448,8,28,238874,28,448,0,0,0,0,0
2.741,17,72,62186,25,548,114,1350,14417,47,988,56,1350,47769
1772.915,6,180,15480,120,69,14898,69,8940,60,69,30043,69,6540
1741.16,6,91,6604,59,31,30020,31,3998,32,31,56165,31,2606
0.038,6,2,80,1,0,0,0,40,1,0,0,0,40
20.491,6,25,6284,15,117,1463,159,1389,10,727,2275,1418,4895
1695.22,1,8,448,8,28,242174,28,448,0,0,0,0,0
93.586,6,11,806,11,26,9358,26,806,0,0,0,0,0
0.874,6,20,8495,11,549,87,1308,2131,9,998,81,1791,6364
0.283,17,2,252,1,54,0,54,82,1,142,0,142,170
4.013,6,39,7269,20,218,211,314,3423,19,440,209,1152,3846
1779.375,17,85,3564,84,14,21438,14,3528,1,8,0,8,36
1772.162,1,59,4956,59,56,30554,56,4956,0,0,0,0,0
8.905,6,35,8275,18,363,523,774,1841,17,478,533,1928,6434
99.421,6,11,719,11,31,9942,31,719,0,0,0,0,0
1796.861,6,183,16138,122,75,14850,469,9489,61,69,29941,69,6649
0.15,6,14,3436,8,106,21,106,518,6,866,21,1448,2918
6.802,6,2,104,2,0,0,0,104,0,0,0,0,0
144.378,6,37,13412,14,615,11106,917,7334,23,468,6550,1179,6078
155.119,17,4,352,2,60,155118,60,176,2,60,155118,60,176
1795.845,1,56,4704,56,56,32651,56,4704,0,0,0,0,0
4.988,17,2,128,2,36,4988,36,128,0,0,0,0,0
1783.824,6,371,25810,215,99,8335,469,15154,156,69,11508,69,10656
173.918,6,33,1936,15,69,12420,69,876,18,37,10230,64,1060
7.474,6,744,657200,471,1325,15,1368,638340,273,776,26,1473,18860
1742.304,6,95,7203,63,38,28101,205,4476,32,33,56196,98,2727
1.354,6,52,21315,29,901,48,1360,15619,23,433,53,1360,5696
2.442,17,3,366,3,94,1221,94,366,0,0,0,0,0
297.501,1,4,224,4,28,99167,28,224,0,0,0,0,0
41.685,6,21,3765,11,328,4168,593,1269,10,488,4621,580,2496
15.114,17,28,13448,14,692,1160,1350,10091,14,211,1160,1350,3357
0.901,6,29,11914,16,511,60,1360,3227,13,1019,61,2720,8687
1786.602,17,87,3648,86,14,21018,14,3612,1,8,0,8,36
280.255,6,28,7352,12,158,25477,267,1277,16,603,18678,1400,6075
50.642,6,10,648,10,31,5626,31,648,0,0,0,0,0
1783.811,6,366,25072,212,93,8454,469,14565,154,69,11658,69,10507
14.978,17,27,8268,12,407,1359,1350,5224,15,174,1067,1350,3044
0.229,6,20,4960,10,137,25,267,1092,10,866,24,2867,3868
280.474,6,30,7432,14,158,21574,267,1357,16,678,18694,3456,6075
1787.949,6,367,25650,214,99,8394,469,15045,153,69,11762,69,10605
0.406,6,14,1733,7,288,65,288,588,7,284,37,434,1145
280.237,6,25,7094,11,181,28023,267,1168,14,595,21554,1400,5926
301.171,6,33,2838,22,69,14341,69,1639,11,69,30070,69,1199
1744.76,6,95,7203,63,38,28141,205,4476,32,33,56264,98,2727
11.149,6,18,5610,10,275,1238,275,958,8,1440,858,1440,4652
33.377,6,12,2219,5,275,8344,275,479,7,1440,5497,1440,1740
16.148,6,22,3590,12,162,1468,293,1458,10,432,1766,1179,2132
0.05,17,4,284,2,32,1,32,120,2,54,4,60,164
17.29,2,2,64,2,8,17290,8,64,0,0,0,0,0
6.41,6,4,176,3,0,3205,0,128,1,0,0,0,48
1682.877,17,14,1036,7,30,280470,30,406,7,62,280469,62,630
80.741,6,145,38889,70,572,1170,1440,25775,75,279,1088,1440,13114
1.316,6,38,8254,19,321,73,1164,2718,19,433,62,1360,5536
44.178,6,8,440,5,0,11044,0,268,3,0,21873,0,172
770.914,17,43,14448,43,308,18355,308,14448,0,0,0,0,0
1756.048,6,105,6258,60,26,29762,27,3519,45,26,39909,27,2739
0.806,6,19,6417,11,141,80,275,726,8,894,44,1420,5691
61.01,6,15,1666,9,180,7626,180,1016,6,110,12160,110,650
0.179,17,4,314,2,31,148,31,118,2,70,132,70,196
5.433,6,39,7285,21,218,271,314,3463,18,516,304,1179,3822
1793.683,17,144,11520,72,48,25263,48,5472,72,56,25263,56,6048
1.14,6,23,7952,12,164,88,267,1288,11,1216,97,2816,6664
3.603,17,31,10298,15,293,254,1350,4816,16,314,237,1350,5482
1786.354,6,153,20254,91,316,19848,316,14528,62,83,29284,83,5726
240.33,6,44,8448,22,449,11443,1418,5648,22,206,11443,580,2800
1791.636,17,761,45902,761,32,2357,37,45902,0,0,0,0,0
1.253,6,29,9529,15,380,89,1408,3072,14,635,84,3047,6457
901.073,6,92,8022,56,69,14745,69,4172,36,68,25744,69,3850
17.486,17,19,6576,9,428,2181,1350,4111,10,218,1939,1350,2465
0.243,17,6,2008,6,306,48,354,2008,0,0,0,0,0
353.713,6,25,2045,14,65,27208,65,1015,11,59,34384,59,1030
1773.496,6,180,15480,120,69,14903,69,8940,60,69,30052,69,6540
241.829,6,52,6289,27,247,9300,835,3206,25,147,10076,502,3083
0.038,6,10,1755,5,657,9,657,925,5,562,9,562,830
4.584,6,39,7269,20,218,241,314,3423,19,513,239,1179,3846
1787.028,6,102,8228,68,64,26672,64,4896,34,58,54148,58,3332
1791.464,6,374,25599,216,93,8332,469,14794,158,69,11409,69,10805
240.199,6,53,17542,28,777,8895,1418,14674,25,195,10007,580,2868
0.086,17,2,167,1,39,0,39,67,1,72,0,72,100
2.116,6,13,1174,7,304,352,304,688,6,83,328,83,486
0.092,17,4,284,2,32,0,32,120,2,54,80,60,164
1799.773,17,448,39896,403,35,4477,288,25676,45,288,40019,288,14220
92.409,6,813,385952,438,816,211,1152,366161,375,435,246,1179,19791
1786.608,6,102,8296,68,65,26665,65,4930,34,59,54136,59,3366
1786.555,6,102,8228,68,64,26665,64,4896,34,58,54134,58,3332
0.086,17,2,264,1,63,0,63,91,1,145,0,145,173
129.052,6,21,9136,11,499,82,1193,1971,10,1125,14320,2279,7165
19.486,6,29,8832,14,158,1498,267,1357,15,858,1390,3445,7475
0.203,17,2,164,1,46,0,46,74,1,62,0,62,90
87.351,6,49,9077,23,360,704,766,2117,26,346,3487,2128,6960
7.357,6,45,8425,22,227,350,314,4062,23,491,322,1179,4363
1775.405,17,73,3060,72,14,25005,14,3024,1,8,0,8,36
37.61,17,44,6468,22,48,1790,48,1672,22,190,1790,308,4796
143.069,17,6,528,3,48,71528,48,228,3,72,71528,72,300
0.996,6,30,12081,16,525,66,1360,3310,14,819,63,1379,8771
29.112,17,4,352,2,60,29111,60,176,2,60,29111,60,176
11.03,6,18,5610,10,275,1225,275,958,8,1440,847,1440,4652
31.738,6,7,396,1,0,0,0,60,6,0,6313,0,336
100.786,6,54,23343,30,1089,3469,1360,17581,24,435,4374,2667,5762
1744.747,2,30,960,30,8,60163,8,960,0,0,0,0,0
1781.841,6,354,22440,207,69,8649,69,12420,147,69,12204,69,10020
1.307,6,48,19591,27,918,50,1460,13975,21,433,56,1460,5616
184.466,6,27,7312,13,158,15372,267,1317,14,775,14185,2800,5995
0.028,17,4,352,2,37,0,37,130,2,83,2,89,222
192.716,6,72,47151,44,1182,4481,1408,38960,28,961,2280,3847,8191
23.211,6,3722,3474939,2304,1423,10,1448,3389483,1418,776,16,1448,85456
1755.29,17,13,534,11,14,175508,14,462,2,8,1755091,8,72
3.727,6,31,7686,13,467,306,1152,5197,18,353,218,373,2489
280.527,6,28,7352,12,158,25502,267,1277,16,678,18692,2085,6075
1792.513,6,183,16138,122,75,14814,469,9489,61,69,29869,69,6649
1798.723,17,450,39960,405,35,4452,288,25740,45,288,40021,288,14220
1779.054,17,142,11360,71,48,25414,48,5396,71,56,25414,56,5964
280.472,6,29,7392,13,158,23372,267,1317,16,678,18691,2760,6075
11.85,6,1874,1636206,1134,1388,10,1420,1602385,740,526,16,3303,33821
1.462,6,50,21018,28,947,54,1360,15362,22,433,61,1360,5656
89.194,17,4,240,2,32,89193,32,120,2,32,89193,32,120
0.336,6,23,7339,11,270,32,797,1660,12,841,29,1418,5679
1.309,17,4,368,2,32,965,32,120,2,96,984,96,248
1772.541,6,180,15480,120,69,14895,69,8940,60,69,30039,69,6540
16.056,6,13,760,5,0,4014,0,280,8,0,2209,0,480
0.035,17,2,482,1,37,0,37,65,1,389,0,389,417
2.15,6,20,3833,11,234,215,564,1504,9,463,246,1343,2329
1740.401,17,30,7050,30,207,60013,207,7050,0,0,0,0,0
12.939,6,14,2245,8,211,1843,211,846,6,545,2586,904,1399
1740.743,17,29,30624,29,1028,62169,1028,30624,0,0,0,0,0
10.608,6,20,4442,11,275,1060,275,998,9,768,728,1440,3444
301.019,6,38,10447,21,682,15050,1360,4965,17,435,551,2720,5482
0.042,17,5,738,3,60,14,60,264,2,209,23,230,474
1740.945,6,90,6521,59,31,30016,31,3998,31,31,58031,31,2523
4.01,17,8,1288,4,33,1333,33,244,4,233,1333,233,1044
0.776,6,8,320,4,0,244,0,160,4,0,97,0,160
26.766,6,46,13749,22,299,1274,721,3282,24,678,1147,1440,10467
663.557,17,124,9424,124,48,5394,48,9424,0,0,0,0,0
1789.71,1,228,12768,228,28,7884,28,12768,0,0,0,0,0
2.064,6,34,13615,18,525,121,1360,3402,16,869,120,1380,10213
9.16,6,14,3148,5,92,2290,92,348,9,464,1105,1408,2800
1105.163,17,216,16416,216,48,5140,48,16416,0,0,0,0,0
1744.673,2,17,544,17,8,109042,8,544,0,0,0,0,0
1798.014,17,767,46327,767,32,2347,37,46327,0,0,0,0,0
268.091,17,2,908,2,426,268091,687,908,0,0,0,0,0
1.322,6,50,18700,27,849,50,1360,13004,23,433,52,1360,5696
1769.876,1,58,4872,58,56,31050,56,4872,0,0,0,0,0
1772.307,6,180,15480,120,69,14893,69,8940,60,69,30033,69,6540
1653.656,1,8,448,8,28,236236,28,448,0,0,0,0,0
369.363,6,25,1651,17,177,23085,177,1117,8,110,9207,110,534
121.295,6,28,7352,13,158,10107,267,1317,15,678,8661,2800,6035
0.071,17,2,586,1,46,0,46,74,1,484,0,484,512
1790.769,6,364,25392,212,100,8487,469,14896,152,69,11859,69,10496
219.125,6,57,10948,24,216,9526,1189,3349,33,313,6847,1997,7599
0.374,6,15,5317,9,273,46,517,1035,6,1320,73,1408,4282
1773.16,6,180,15480,120,69,14900,69,8940,60,69,30051,69,6540
1798.298,2,23,736,23,8,81740,8,736,0,0,0,0,0
211.774,6,4,191,3,31,105813,31,151,1,0,0,0,40
1765.439,2,16,512,16,8,117695,8,512,0,0,0,0,0
1786.555,6,102,8364,68,66,26665,66,4964,34,60,54134,60,3400
1795.21,6,356,22520,208,69,8672,69,12460,148,69,12212,69,10060
1789.819,17,140,11200,70,48,25939,48,5320,70,56,25939,56,5880
1797.303,17,449,39928,404,35,4459,288,25708,45,288,40014,288,14220
1786.721,6,102,8364,68,66,26667,66,4964,34,60,54140,60,3400
1800.0,6,359,24798,154,46,11575,46,10066,205,46,8823,46,14732
4.749,17,29,17608,13,619,395,1350,8421,16,546,227,1350,9187
1740.421,17,28,6580,28,207,64460,207,6580,0,0,0,0,0
2.379,6,5,284,3,0,1097,0,164,2,0,2195,0,120
447.277,6,91,17614,42,361,10909,1148,8786,49,283,9313,1501,8828
278.578,17,4,352,2,60,278576,60,176,2,60,278577,60,176
0.029,6,12,3705,6,171,2,171,491,6,964,5,1448,3214
1709.147,1,8,448,8,28,244163,28,448,0,0,0,0,0
245.32,2,2,64,2,8,245320,8,64,0,0,0,0,0
119.512,6,33,8996,14,158,9193,267,1357,19,624,6636,1400,7639
5.914,6,1318,1192953,796,1419,7,1448,1161145,522,776,11,1448,31808
1650.33,1,7,392,7,28,275055,28,392,0,0,0,0,0
1.479,6,10,1687,7,100,246,100,384,3,1179,615,1179,1303
1770.721,6,101,9410,66,66,27241,66,5610,35,60,52077,60,3800
11.346,6,20,7130,11,275,1134,275,998,9,1440,775,1440,6132
214.658,1,4,1357,4,311,71552,327,1357,0,0,0,0,0
1798.664,17,440,39072,396,35,4553,288,25168,44,288,40948,288,13904
1750.96,17,12,498,11,14,175096,14,462,1,8,0,8,36
1796.966,1,345,28980,345,56,5223,56,28980,0,0,0,0,0
73.771,6,8,432,3,0,36885,0,164,5,0,18363,0,268
3.489,17,5,295,5,31,872,31,295,0,0,0,0,0
365.751,6,23,1538,16,180,24383,180,1056,7,110,10364,110,482
137.141,6,87,11112,41,126,3428,630,4479,46,166,3045,580,6633
1790.366,6,356,22520,208,69,8649,69,12460,148,69,12178,69,10060
1795.644,17,414,48196,179,162,10087,1350,34035,235,32,7672,60,14161
210.282,6,14,616,14,0,0,0,616,0,0,0,0,0
257.33,1,3,348,3,88,128665,88,348,0,0,0,0,0
1772.673,6,180,15480,120,69,14896,69,8940,60,69,30043,69,6540
90.862,6,25,10057,12,523,50,1360,2605,13,988,7562,1360,7452
280.235,6,28,7352,13,158,23352,267,1317,15,678,20015,2800,6035
1564.166,2,20,640,20,8,82324,8,640,0,0,0,0,0
0.096,6,10,1495,5,507,23,507,727,5,556,24,556,768
0.029,17,2,296,1,32,0,32,60,1,208,0,208,236
300.643,6,41,8657,22,283,14316,787,2081,19,414,468,2128,6576
1786.33,6,109,8830,71,66,25519,66,5150,38,60,48276,60,3680
10.86,17,15,17706,15,1152,775,1449,17706,0,0,0,0,0
1775.41,17,142,11360,71,48,25362,48,5396,71,56,25362,56,5964
0.398,2,2,64,2,8,398,8,64,0,0,0,0,0
3.043,17,4,836,2,37,3030,37,130,2,325,3028,325,706
280.603,6,30,7432,13,158,23383,267,1317,17,543,17532,1400,6115
100.634,6,72,47870,45,1168,2287,1408,39734,27,960,2368,3847,8136
0.184,17,2,152,1,48,0,48,76,1,48,0,48,76
1797.381,17,448,39896,403,35,4471,288,25676,45,288,40014,288,14220
195.329,2,4,128,4,8,65109,8,128,0,0,0,0,0
1741.356,6,89,6469,59,31,30023,31,3979,30,31,60046,31,2490
1.294,6,32,6507,15,164,92,267,1922,17,650,71,1452,4585
3.127,6,12,1767,7,100,521,100,384,5,1179,719,1179,1383
0.141,17,2,290,1,40,0,40,68,1,194,0,194,222
1787.412,6,103,8268,68,64,26677,64,4896,35,58,52568,58,3372
1797.266,17,449,39928,404,35,4459,288,25708,45,288,40018,288,14220
1797.213,6,250,19857,154,83,11746,965,11334,96,74,18912,405,8523
2.158,17,53,43639,21,356,107,1350,8075,32,1083,66,1350,35564
317.024,6,75,18975,40,311,8128,1360,9410,35,388,9320,3289,9565
280.241,6,29,7392,13,158,23353,267,1317,16,603,18678,2600,6075
1666.164,1,7,392,7,28,277694,28,392,0,0,0,0,0
0.23,6,9,1345,5,145,57,145,349,4,832,31,832,996
1790.016,17,142,11360,71,48,25571,48,5396,71,56,25571,56,5964
0.409,17,8,2758,8,316,58,355,2758,0,0,0,0,0
251.259,6,17,5734,9,267,101,501,1165,8,707,35881,1420,4569
1739.497,6,89,6426,58,31,30517,31,3915,31,31,57982,31,2511
1786.019,6,102,8364,68,66,26657,66,4964,34,60,54118,60,3400
1794.421,1,58,4872,0,0,0,0,0,58,56,31481,56,4872
120.34,2,3,96,3,8,60170,8,96,0,0,0,0,0
5.008,17,4,514,2,36,5004,36,128,2,165,5003,171,386
0.021,6,2,80,1,0,0,0,40,1,0,0,0,40
280.032,6,29,7392,14,158,21540,267,1357,15,678,19999,4200,6035
368.544,6,18,1239,14,177,28349,177,913,4,110,20057,110,326
17.683,6,16,1327,8,222,2524,222,768,8,231,2524,231,559
1724.503,17,167,37579,167,197,10388,422,37579,0,0,0,0,0
101.714,6,44,8899,21,367,858,787,2070,23,346,4617,2720,6829
279.312,17,3,1152,3,356,139656,356,1152,0,0,0,0,0
45.345,6,1303,1137699,792,1356,57,1368,1104489,511,1124,88,2736,33210
558.104,6,62,4180,31,64,18603,208,2599,31,31,18539,31,1581
1700.411,17,12,498,11,14,170041,14,462,1,8,0,8,36
300.35,6,55,27276,32,1123,9688,1408,20836,23,436,1596,1491,6440
10.025,17,10,3360,10,308,1113,308,3360,0,0,0,0,0
1418.131,1,12,1426,12,90,128921,117,1426,0,0,0,0,0
1684.496,2,14,448,14,8,129576,8,448,0,0,0,0,0
21.838,17,4,352,2,48,21829,48,152,2,72,21829,72,200
1680.822,17,12,498,11,14,168082,14,462,1,8,0,8,36
65.726,6,35,8415,17,410,548,882,1942,18,478,3856,2128,6473
188.896,6,77,18019,36,297,3932,965,6803,41,289,4722,1420,11216
280.283,6,30,7432,13,158,23356,267,1317,17,543,17512,1400,6115
1753.196,6,95,7203,63,38,28277,205,4476,32,33,56542,98,2727
3.587,6,40,24280,25,933,149,1360,11308,15,1765,243,4655,12972
102.336,6,33,10666,10,155,400,267,1186,23,475,4650,1452,9480
0.209,6,9,1339,5,145,52,145,349,4,826,37,826,990
0.313,17,2,167,1,39,0,39,67,1,72,0,72,100
1162.339,6,215,16742,104,214,11267,555,6863,111,39,10566,76,9879
5.052,17,3,208,2,36,5007,36,128,1,52,0,52,80
91.007,6,42,19253,25,857,3791,1368,11634,17,747,3928,1368,7619
231.521,6,309,255530,197,1313,1181,1368,237409,112,585,2083,1368,18121
4.918,6,36,6249,19,206,273,314,2824,17,548,288,1179,3425
4.442,6,54,20513,27,967,170,1440,14657,27,433,162,1440,5856
1771.22,6,115,10504,71,65,25303,65,6056,44,59,41188,59,4448
20.551,6,17,2316,10,189,2283,517,1298,7,323,3404,499,1018
56.622,6,10,648,10,31,6291,31,648,0,0,0,0,0
1792.8,6,759,51445,378,31,4755,31,25825,381,31,4717,31,25620
1776.497,6,193,11851,95,47,18898,208,6908,98,31,18311,31,4943
47.68,6,29,7437,9,159,4679,267,1167,20,390,2508,1452,6270
11.79,6,1886,1613553,1138,1363,10,1380,1579023,748,421,15,1923,34530
1793.107,1,217,12152,217,28,8301,28,12152,0,0,0,0,0
0.509,17,15,7249,7,605,81,1350,4434,8,323,66,1350,2815
0.869,6,11,1727,7,100,144,100,384,4,589,205,1152,1343
1.161,6,29,12598,16,529,77,1360,3318,13,972,80,2561,9280
280.371,6,29,7392,13,158,23364,267,1317,16,603,18685,1400,6075
0.332,6,24,5937,12,164,30,453,1442,12,643,28,1542,4495
3.624,17,5,295,5,31,906,31,295,0,0,0,0,0
0.983,17,2,421,1,47,0,47,75,1,318,0,318,346
1386.21,2,11,352,11,8,138621,8,352,0,0,0,0,0
53.578,6,13,1079,12,43,4870,43,1019,1,0,0,0,60
4.248,17,24,9325,10,381,472,1350,4094,14,345,206,1350,5231
0.342,17,2,154,1,33,0,33,61,1,65,0,65,93
0.795,17,4,624,2,64,636,64,184,2,192,647,192,440
240.125,6,35,8406,16,165,16007,517,1830,19,697,13339,1418,6576
203.949,17,2,122,2,33,203949,33,122,0,0,0,0,0
1.512,17,2,262,1,39,0,39,67,1,167,0,167,195
9.797,6,95,29758,49,556,204,1152,23095,46,401,212,1152,6663
8.191,17,2,152,2,48,8191,48,152,0,0,0,0,0
38.863,6,29,7392,13,158,3238,267,1317,16,603,2588,2036,6075
1783.881,6,104,8376,68,65,26625,65,4930,36,59,50965,59,3446
240.195,6,56,19235,30,784,8282,1418,16465,26,176,9607,580,2770
1.42,6,39,8294,19,321,78,1164,2718,20,433,65,1360,5576
1773.607,6,180,15480,120,69,14904,69,8940,60,69,30055,69,6540
280.526,6,30,7432,13,158,23377,267,1317,17,543,17530,1400,6115
106.557,6,20,812,8,0,6985,0,324,12,0,9686,0,488
0.154,6,9,1002,5,213,38,213,417,4,421,44,421,585
71.528,17,16,2352,8,48,10217,48,608,8,190,10217,308,1744
1748.601,1,63,5292,0,0,0,0,0,63,56,28203,56,5292
5.248,17,24,9192,10,381,583,1350,4094,14,336,220,1350,5098
16.692,6,2611,2424971,1597,1434,10,1448,2363183,1014,931,16,2761,61788
1772.662,6,180,15480,120,69,14896,69,8940,60,69,30041,69,6540
300.633,6,38,8566,20,315,15822,882,2093,18,441,499,1360,6473
34.642,1,40,4160,0,0,0,0,0,40,76,888,76,4160
4.466,6,38,7229,19,218,248,314,3383,19,513,233,1179,3846
73.98,17,4,352,2,60,73979,60,176,2,60,73978,60,176
20.171,6,23,6465,13,147,1680,318,1297,10,773,2240,1675,5168
5.054,6,38,7245,20,218,266,314,3423,18,516,282,1179,3822
158.843,6,25,6388,9,272,152,516,1180,16,351,10583,1452,5208
0.047,6,3,168,1,0,0,0,52,2,0,44,0,116
49.351,17,4,352,2,60,49350,60,176,2,60,49350,60,176
4.332,6,35,6209,18,206,254,314,2784,17,548,254,1179,3425
1.678,6,25,8701,15,274,119,556,1428,10,981,166,1420,7273
1788.394,17,246,66305,246,241,7299,422,66305,0,0,0,0,0
1777.62,1,192,10752,192,28,9306,28,10752,0,0,0,0,0
11.128,6,14,2299,8,275,1589,275,603,6,1440,1767,1440,1696
10.964,6,20,4442,11,275,1096,275,998,9,768,774,1440,3444
0.025,6,11,3287,6,81,5,81,401,5,872,6,1448,2886
1797.816,6,374,26137,217,98,8323,469,15372,157,69,11521,69,10765
0.138,6,10,1514,5,503,34,503,771,5,475,34,475,743
0.178,6,17,7213,9,133,22,133,609,8,1236,25,1734,6604
1.739,6,48,24062,24,221,75,517,2389,24,1134,71,1555,21673
1771.875,6,99,9240,66,65,27259,65,5577,33,59,55368,59,3663
60.752,17,2,152,2,48,60752,48,152,0,0,0,0,0
16.652,17,20,9569,10,670,1843,1350,6981,10,230,1841,1350,2588
5.015,17,4,288,2,36,5011,36,128,2,52,5015,52,160
14.836,6,1977,1803648,1261,1375,11,1380,1766714,716,421,20,1923,36934
0.418,6,6,324,4,0,139,0,216,2,0,217,0,108
1795.822,6,380,28929,220,125,8200,469,17699,160,69,11292,69,11230
0.055,17,4,420,2,33,1,33,122,2,121,33,145,298
222.856,17,13,2893,13,194,18571,390,2893,0,0,0,0,0
4.909,6,40,7309,20,218,258,314,3423,20,440,245,1152,3886
9.85,6,84,24885,43,542,234,1152,19088,41,461,239,1179,5797
1794.183,17,80,3354,79,14,23002,14,3318,1,8,0,8,36
0.079,6,2,80,1,0,0,0,40,1,0,0,0,40
1797.511,1,345,28980,345,56,5225,56,28980,0,0,0,0,0
1771.54,6,101,9410,66,66,27254,66,5610,35,60,52100,60,3800
1.245,6,44,10157,23,440,56,1360,4496,21,437,53,2720,5661
691.451,17,186,48174,186,231,3737,388,48174,0,0,0,0,0
21.476,17,2,904,1,300,0,300,328,1,548,0,548,576
0.011,17,4,360,3,46,2,46,222,1,110,0,110,138
56.27,6,30,7685,11,155,5627,267,1226,19,379,3125,3426,6459
1798.685,17,448,39896,403,35,4474,288,25676,45,288,40023,288,14220
13.633,6,50,24590,21,475,681,1440,3779,29,980,480,1440,20811
6.822,6,24,6629,12,280,616,517,1510,12,642,616,1408,5119
1798.923,1,58,4872,0,0,0,0,0,58,56,31560,56,4872
67.364,6,15,3928,8,127,9623,127,467,7,792,11214,1460,3461
54.093,17,16,18211,16,1110,3606,1451,18211,0,0,0,0,0
1799.954,1,345,28980,345,56,5232,56,28980,0,0,0,0,0
317.066,6,79,19587,41,354,7926,1360,9902,38,326,8564,1929,9685
240.181,6,54,18166,29,804,8577,1408,15196,25,207,10007,580,2970
1799.97,17,74,24894,74,308,24657,329,24894,0,0,0,0,0
87.038,1,2,112,2,28,87038,28,112,0,0,0,0,0
1757.028,17,117,20997,117,151,15146,372,20997,0,0,0,0,0
682.483,6,107,14471,47,155,14836,1189,4683,60,199,11567,1420,9788
313.873,6,28,7081,8,216,9044,501,1190,20,317,16514,1420,5891
280.236,6,29,7392,13,158,23353,267,1317,16,543,18681,1400,6075
57.593,17,6,528,3,48,28792,48,228,3,72,28791,72,300
28.588,17,4,1312,4,300,9529,300,1312,0,0,0,0,0
0.024,17,2,167,1,39,0,39,67,1,72,0,72,100
0.006,17,3,383,2,33,0,33,122,1,233,0,233,261
0.016,6,9,1560,5,514,3,514,782,4,562,5,562,778
172.227,1,2,120,2,32,172227,32,120,0,0,0,0,0
1.539,17,6,552,3,32,615,32,180,3,96,605,96,372
100.903,6,48,20220,27,1122,3874,1460,14578,21,399,5036,1460,5642
5.048,6,45,8425,22,227,240,314,4062,23,491,217,1179,4363
280.537,6,30,7432,13,158,23378,267,1317,17,543,17529,1400,6115
0.299,17,8,2750,8,315,42,354,2750,0,0,0,0,0
63.34,6,43,11050,19,266,3518,469,4503,24,348,2753,1460,6547
1786.964,17,140,11200,70,48,25897,48,5320,70,56,25897,56,5880
0.229,6,3,160,2,0,229,0,100,1,0,0,0,60
0.11,6,3,151,1,0,0,0,40,2,31,1,31,111
0.343,6,4,1037,2,0,220,0,104,2,853,125,853,933
281.753,6,33,7561,14,158,21673,267,1357,19,544,15648,1380,6204
11.913,6,1852,1647419,1164,1360,10,1420,1615452,688,427,17,1420,31967
0.113,6,2,421,1,0,0,0,40,1,341,0,341,381
0.865,6,23,10044,12,673,78,1360,3242,11,1058,63,2720,6802
2.657,6,33,5803,21,89,132,147,1669,12,696,240,1418,4134
280.529,6,29,7392,13,158,23377,267,1317,16,678,18690,3456,6075
0.488,6,10,1669,6,551,97,947,1346,4,159,162,159,323
738.27,6,33,2551,20,63,25656,63,1430,13,54,61515,57,1121
374.68,6,23,1535,16,177,24978,177,1053,7,110,10403,110,482
1786.042,6,383,27035,219,102,8192,469,16059,164,69,10956,69,10976
1763.59,2,13,416,13,8,146965,8,416,0,0,0,0,0
188.962,6,26,7475,11,181,18896,267,1168,15,570,13487,1400,6307
300.575,6,11,863,6,177,60079,177,497,5,110,75098,110,366
65.181,2,3,96,3,8,32590,8,96,0,0,0,0,0
24.392,6,178,75475,97,747,254,1152,68126,81,456,301,1179,7349
1787.967,6,356,22520,208,69,8637,69,12460,148,69,12162,69,10060
136.233,6,32,8952,14,158,10479,267,1357,18,624,8010,1400,7595
1776.543,17,140,11200,70,48,25746,48,5320,70,56,25746,56,5880
0.6,6,10,766,5,185,144,185,453,5,45,66,45,313
280.037,6,25,7232,12,158,25457,267,1277,13,905,23333,4845,5955
1800.0,6,226,15528,86,46,20823,46,6662,140,46,12949,46,8866
240.25,6,54,18025,28,801,8897,1418,15085,26,225,9609,580,2940
1.309,6,51,21023,28,945,48,1460,15327,23,433,51,1460,5696
601.623,2,7,224,7,8,100270,8,224,0,0,0,0,0
0.716,6,234,270165,50,609,14,958,5046,184,1411,3,1459,265119
0.003,6,2,131,1,0,0,0,40,1,51,0,51,91
1760.487,6,76,3496,38,0,47580,0,1976,38,0,47580,0,1520
240.207,6,55,17731,30,748,8283,1408,15033,25,173,10008,580,2698
0.035,17,5,1567,5,285,8,316,1567,0,0,0,0,0
1778.62,17,138,11040,69,48,26156,48,5244,69,56,26156,56,5796
240.329,6,46,9358,24,524,10448,1418,5976,22,247,11443,639,3382
220.92,17,4,352,2,60,220919,60,176,2,60,220919,60,176
18.98,17,30,6218,15,209,1353,1350,3568,15,148,1353,1350,2650
1796.938,17,449,39928,404,35,4458,288,25708,45,288,40021,288,14220
1798.984,17,443,92051,443,179,4070,352,92051,0,0,0,0,0
1724.55,6,370,55542,146,290,11310,1360,30975,224,94,7732,2720,24567
9.813,17,27,13763,14,710,754,1350,10333,13,235,219,1350,3430
11.275,6,16,4735,9,290,1409,517,1057,7,1102,1855,1448,3678
0.255,6,22,4467,11,165,25,456,1394,11,498,24,888,3073
1797.043,6,367,25650,214,99,8436,469,15045,153,69,11822,69,10605
16.089,6,23,6410,14,139,1237,159,1294,9,773,2010,1675,5116
1681.678,17,14,1036,7,30,280270,30,406,7,62,280272,62,630
96.685,6,43,8805,21,378,496,786,2078,22,389,4597,2128,6727
101.745,17,4,352,2,60,101744,60,176,2,60,101744,60,176
1670.339,1,7,392,7,28,278389,28,392,0,0,0,0,0
112.423,6,8,474,2,106,112410,106,194,6,0,22481,0,280
1775.106,6,180,15480,120,69,14916,69,8940,60,69,30082,69,6540
1710.517,1,8,448,8,28,244359,28,448,0,0,0,0,0
13.99,6,25,4761,13,154,1146,722,1766,12,591,1254,1408,2995
233.673,6,143,108838,89,1277,2655,1368,97905,54,811,1581,3887,10933
0.006,17,3,385,2,39,0,39,134,1,223,0,223,251
180.487,2,3,96,3,8,90243,8,96,0,0,0,0,0
0.401,6,2,348,2,134,401,134,348,0,0,0,0,0
1772.097,1,58,4872,0,0,0,0,0,58,56,31089,56,4872
3.984,17,4,892,2,32,3980,32,120,2,358,3980,470,772
1.019,6,15,1785,8,288,125,288,640,7,426,140,434,1145
1773.228,6,180,15480,120,69,14901,69,8940,60,69,30047,69,6540
200.918,6,46,17120,25,1044,8364,1460,11478,21,399,10037,1460,5642
1785.861,6,361,22927,209,69,8585,69,12569,152,69,11826,69,10358
300.779,6,40,13572,23,892,13671,1360,8090,17,479,540,4027,5482
1741.151,6,94,6803,60,31,29511,31,4081,34,31,52760,31,2722
0.103,17,2,152,1,48,0,48,76,1,48,0,48,76
0.011,6,2,84,1,0,0,0,44,1,0,0,0,40
1790.997,6,366,23265,212,69,8488,69,12689,154,69,11705,69,10576
0.59,6,27,7296,13,155,49,267,1301,14,603,38,2800,5995
0.02,6,10,1888,5,130,5,130,350,5,1326,5,1326,1538
91.374,6,11264,10619627,7377,1360,12,1408,10412839,3887,776,23,1408,206788
1742.917,6,96,7286,63,38,28111,205,4476,33,33,54454,98,2810
1781.603,6,106,8524,68,66,26591,66,4964,38,60,48148,60,3560
194.714,6,109,17642,43,230,4636,805,9188,66,141,2987,580,8454
1787.229,6,105,8481,69,65,26282,65,5035,36,59,51060,59,3446
1791.182,6,356,22520,208,69,8653,69,12460,148,69,12184,69,10060
0.013,17,2,189,1,37,0,37,65,1,96,0,96,124
0.403,6,48,25197,26,171,16,313,2158,22,1459,18,3741,23039
176.11,6,45,6552,21,165,8797,722,2590,24,181,7649,1408,3962
4.224,17,5,295,5,31,1056,31,295,0,0,0,0,0
1784.504,6,108,8514,70,63,25862,63,4942,38,57,48227,57,3572
300.689,6,43,8744,22,266,14318,721,2027,21,366,535,2128,6717
1729.195,6,62,4504,40,33,44338,33,2740,22,31,82334,31,1764
1773.872,6,100,9292,66,65,27290,65,5577,34,59,53750,59,3715
1786.882,6,108,8604,68,66,26669,66,4964,40,60,45811,60,3640
3.032,17,4,332,2,47,3026,47,150,2,63,3025,63,182
280.224,6,29,7392,13,158,23352,267,1317,16,603,18680,1400,6075
0.075,17,2,642,1,300,0,300,328,1,286,0,286,314
32.014,17,4,240,2,32,32013,32,120,2,32,32013,32,120
0.039,17,2,216,1,34,0,34,62,1,126,0,126,154
1.775,6,4,220,2,0,1775,0,100,2,0,1003,0,120
1742.385,6,97,7307,63,38,28102,205,4476,34,33,52788,98,2831
1799.467,1,16,896,16,28,119964,28,896,0,0,0,0,0
1785.425,6,418,25021,209,69,8583,69,12500,209,34,8583,48,12521
1.159,6,25,8080,12,164,89,267,1312,13,869,81,1408,6768
286.243,6,29,7392,13,158,23853,267,1317,16,678,19079,2085,6075
1780.784,6,102,8364,68,66,26578,66,4964,34,60,53959,60,3400
1782.686,6,103,8268,68,64,26607,64,4896,35,58,52429,58,3372
243.09,1,4,224,4,28,81030,28,224,0,0,0,0,0
546.371,6,112,19752,52,113,10709,721,5958,60,455,9257,1440,13794
1.414,6,49,19294,27,894,54,1360,13638,22,433,58,1360,5656
0.616,6,14,1745,7,288,70,288,600,7,426,72,434,1145
31.863,6,6,360,0,0,0,0,0,6,0,0,0,360
58.4,6,34,7942,11,145,15,267,1323,23,334,2654,1460,6619
2.094,17,4,706,3,39,1001,39,201,1,477,0,477,505
7.143,17,4,288,2,36,5006,36,128,2,52,0,52,160
1.979,6,3,120,2,0,1979,0,80,1,0,0,0,40
0.943,6,7,295,4,0,314,0,164,3,7,268,7,131
0.025,17,2,178,1,29,0,29,57,1,93,0,93,121
218.639,17,4,352,2,60,218636,60,176,2,60,218638,60,176
0.015,17,2,294,1,36,0,36,64,1,202,0,202,230
0.002,6,5,317,1,0,0,0,40,4,34,0,38,277
1743.777,1,56,4704,56,56,31705,56,4704,0,0,0,0,0
1792.841,1,57,4788,57,56,32015,56,4788,0,0,0,0,0
419.293,17,29,3325,29,86,14974,357,3325,0,0,0,0,0
280.049,6,28,7352,13,158,23337,267,1317,15,678,20000,2800,6035
225.153,6,25,2844,15,302,16082,302,1984,10,83,25016,83,860
1799.21,17,448,39896,403,35,4475,288,25676,45,288,40007,288,14220
366.825,6,27,1767,18,177,21577,177,1181,9,110,8562,110,586
1794.074,17,82,3438,81,14,22425,14,3402,1,8,0,8,36
11.475,6,27,11355,13,275,956,275,1078,14,1078,850,1414,10277
373.373,6,18,1242,14,180,28721,180,916,4,110,20069,110,326
1401.107,17,12,888,6,30,280217,30,348,6,62,280217,62,540
4.053,6,40,7309,20,218,213,314,3423,20,440,200,1152,3886
1795.525,17,449,39928,404,35,4455,288,25708,45,288,40022,288,14220
1136.94,17,164,12464,164,48,6975,48,12464,0,0,0,0,0
11.802,6,16,1196,10,304,1311,304,844,6,0,2352,0,352
3.302,17,3,1170,3,362,1651,362,1170,0,0,0,0,0
280.067,6,28,7352,13,158,23338,267,1317,15,678,20000,2800,6035
1.008,17,4,624,2,64,937,64,184,2,192,704,192,440
0.025,17,2,591,1,41,0,41,69,1,494,0,494,522
0.111,17,4,912,2,60,100,60,176,2,340,98,340,736
280.55,6,30,7432,13,158,23379,267,1317,17,603,17528,2076,6115
102.766,6,15,1132,4,226,129,226,442,11,110,10259,110,690
136.221,17,2,672,2,308,136221,308,672,0,0,0,0,0
2.464,17,4,240,2,32,2463,32,120,2,32,2463,32,120
1776.23,17,73,3060,72,14,25017,14,3024,1,8,0,8,36
32.565,6,4427,4156073,2872,1366,11,1368,4062349,1555,776,20,1473,93724
23.951,17,47,8760,21,205,1196,1350,4910,26,120,956,1350,3850
1774.906,6,180,15480,120,69,14915,69,8940,60,69,30079,69,6540
231.123,1,17,1428,17,56,14445,56,1428,0,0,0,0,0
17.925,6,451,383930,271,1349,66,1368,369104,180,899,98,1473,14826
1797.316,6,358,22600,207,69,8724,69,12351,151,69,11979,69,10249
42.378,17,4,352,2,60,42377,60,176,2,60,42377,60,176
0.082,6,10,1514,5,503,20,503,771,5,475,20,475,743
32.743,6,1007,865861,610,1341,53,1368,839589,397,776,82,1473,26272
4.901,6,39,7285,20,218,257,314,3423,19,516,258,1179,3862
1771.047,1,58,4872,0,0,0,0,0,58,56,31071,56,4872
34.659,17,22,1672,22,48,1650,48,1672,0,0,0,0,0
6.734,6,22,7306,13,138,561,267,1500,9,2653,815,5255,5806
23.411,17,8,704,4,48,7800,48,304,4,72,7800,72,400
1216.706,6,81,7380,51,64,24334,64,4288,30,58,41952,58,3092
1013.706,6,51,4025,30,64,26151,64,2160,21,51,50670,58,1865
240.298,6,50,15721,26,732,9611,1402,13076,24,173,10447,580,2645
0.358,6,27,8920,13,227,29,547,1592,14,941,27,1408,7328
1749.573,17,12,498,11,14,174957,14,462,1,8,0,8,36
0.495,6,27,9128,13,268,41,710,1758,14,947,34,1368,7370
94.967,6,18,10004,4,202,6757,241,766,14,867,7305,959,9238
0.321,6,22,7342,12,335,28,668,1974,10,1210,35,1906,5368
328.082,17,10,760,10,48,36453,48,760,0,0,0,0,0
3.969,1,5,420,5,56,992,56,420,0,0,0,0,0
280.405,6,30,7432,13,158,23367,267,1317,17,543,17514,1400,6115
75.342,17,4,240,2,32,75341,32,120,2,32,75341,32,120
4.307,6,726,604104,428,1378,10,1420,587954,298,468,14,3303,16150
0.706,6,19,7099,13,318,58,600,1958,6,1607,124,3299,5141
1790.823,1,106,5936,106,28,17055,28,5936,0,0,0,0,0
0.585,6,20,7168,13,319,48,602,1960,7,1209,91,1946,5208
1795.485,17,449,39928,404,35,4455,288,25708,45,288,40021,288,14220
1.014,17,8,840,4,33,335,33,244,4,121,335,145,596
1.214,17,2,322,1,33,0,33,61,1,233,0,233,261
111.916,6,45,13370,23,955,508,1360,7688,22,435,5320,2667,5682
1.836,17,2,2899,2,1421,1836,1427,2899,0,0,0,0,0
0.964,6,16,1825,8,288,108,288,640,8,284,105,434,1185
0.005,17,2,366,1,36,0,36,64,1,274,0,274,302
1.233,6,8,342,4,0,411,0,164,4,7,278,7,178
1770.549,6,110,10100,69,66,26037,66,5856,41,60,44261,60,4244
1778.471,1,62,5208,0,0,0,0,0,62,56,29155,56,5208
280.472,6,28,7352,13,158,23372,267,1317,15,678,20030,3456,6035
1786.63,1,58,4872,58,56,31344,56,4872,0,0,0,0,0
1800.0,6,211,16456,78,71,22987,331,7862,133,48,13636,78,8594
177.349,6,28,6562,11,220,5614,516,1325,17,325,11079,1452,5237
20.301,6,23,5534,13,107,1691,159,1126,10,967,2249,1709,4408
0.163,17,4,624,2,64,161,64,184,2,192,38,192,440
5.69,17,4,352,2,60,5689,60,176,2,60,5689,60,176
1798.394,6,368,25690,215,99,8403,469,15085,153,69,11829,69,10605
97.779,6,138,109588,89,1307,1111,1448,97466,49,683,2031,2359,12122
1783.422,17,83,3480,82,14,22017,14,3444,1,8,0,8,36
765.414,17,12,2992,6,32,153081,37,362,6,410,153081,463,2630
1798.625,6,374,26537,217,104,8326,469,15703,157,69,11527,69,10834
0.104,17,2,182,1,37,0,37,65,1,89,0,89,117
12.16,17,10,2105,5,47,3036,47,375,5,318,3036,318,1730
165.701,6,22,10186,11,304,79,597,1385,11,1192,16552,1460,8801
0.094,6,2,84,1,0,0,0,44,1,0,0,0,40
787.453,6,181,25690,96,304,8288,304,17608,85,83,9367,83,8082
8.616,6,17,5313,9,275,1077,275,643,8,1084,823,1414,4670
0.386,6,10,968,5,256,92,256,460,5,304,92,304,508
1786.573,6,103,8404,68,66,26665,66,4964,35,60,52542,60,3440
64.196,6,11,452,5,0,6068,0,204,6,0,12836,0,248
240.189,6,54,17877,29,797,8577,1402,15078,25,186,10007,580,2799
1789.031,6,126,15224,81,90,22362,502,6763,45,162,40657,1420,8461
11.515,6,21,6825,12,275,1046,275,1038,9,1353,813,1440,5787
281.296,6,31,7610,13,158,23441,267,1317,18,506,16521,2036,6293
0.172,6,2,104,1,0,0,0,64,1,0,0,0,40
0.472,6,12,1653,6,288,92,288,548,6,426,58,434,1105
1744.821,6,95,7203,63,38,28142,205,4476,32,33,56278,98,2727
1793.94,17,180,11520,180,36,10022,36,11520,0,0,0,0,0
1.111,6,24,8004,12,164,86,267,1288,12,1014,86,2411,6716
371.205,6,27,1767,18,177,21835,177,1181,9,110,8611,110,586
2.706,6,28,8438,15,332,192,1001,2267,13,941,224,1731,6171
64.095,17,4,830,2,43,64085,43,142,2,316,64084,316,688
280.055,6,29,7392,14,158,21542,267,1357,15,678,20000,3436,6035
106.813,6,68,49543,46,1189,2373,1408,41665,22,960,2932,3847,7878
0.248,6,23,5080,11,137,24,267,1132,12,577,21,1400,3948
0.18,6,26,7256,13,155,15,267,1301,13,603,14,2036,5955
1.136,6,214,155454,118,1345,9,1432,147321,96,420,11,1432,8133
103.689,6,28,10341,14,486,74,1440,3038,14,961,7965,2880,7303
2.75,6,30,8985,17,290,161,1085,2635,13,1133,215,3847,6350
1.345,6,50,19470,27,904,51,1360,13774,23,433,53,1360,5696
300.532,6,29,10127,16,515,20035,1018,3415,13,669,3973,1491,6712
0.847,6,2,1253,1,0,0,0,40,1,1173,0,1173,1213
280.328,6,29,7392,13,158,23360,267,1317,16,603,18684,2036,6075
144.424,6,36,15732,18,887,99,1360,6101,18,889,8485,3639,9631
0.192,6,40,16490,23,968,8,1420,11589,17,467,11,1883,4901
1787.919,6,102,8228,68,64,26685,64,4896,34,58,54177,58,3332
2.439,6,26,8795,15,283,174,583,1455,11,985,213,1420,7340
61.37,6,37,15899,22,796,2922,1408,9120,15,665,4365,1408,6779
574.008,17,10,880,5,48,143500,48,380,5,72,143499,72,500
1783.811,6,359,22847,207,69,8659,69,12489,152,69,11813,69,10358
0.311,17,2,198,1,39,0,39,67,1,103,0,103,131
2.63,17,2,144,1,36,0,36,64,1,52,0,52,80
1799.198,1,58,4872,0,0,0,0,0,58,56,31564,56,4872
0.451,17,2,152,1,48,0,48,76,1,48,0,48,76
0.212,6,10,1379,5,145,53,145,349,5,826,41,826,1030
1795.128,17,142,11360,71,48,25644,48,5396,71,56,25644,56,5964
280.476,6,30,7432,13,158,23373,267,1317,17,543,17527,1400,6115
16.429,6,25,9576,8,154,2347,267,792,17,674,1021,1420,8784
61.651,6,62,41756,39,1176,1622,1448,33807,23,843,2791,2359,7949
11.631,6,1849,1606286,1117,1382,10,1420,1572785,732,526,15,3303,33501
171.371,6,31,8912,14,158,13182,267,1357,17,687,10702,2036,7555
2.929,2,2,64,2,8,2929,8,64,0,0,0,0,0
1799.578,6,385,25915,220,86,8217,469,14830,165,69,10971,69,11085
0.455,6,14,1733,7,288,70,288,588,7,284,41,434,1145
241.004,6,45,5674,22,205,11476,517,2625,23,183,10954,851,3049
132.083,6,24,9749,12,531,63,1460,2637,12,1103,11994,2374,7112
1795.744,17,448,39896,403,35,4467,288,25676,45,288,40018,288,14220
1682.915,17,14,1036,7,30,280477,30,406,7,62,280477,62,630
1770.592,6,101,9344,66,65,27239,65,5577,35,59,52072,59,3767
0.906,17,2,136,1,32,0,32,60,1,48,0,48,76
0.399,1,5,420,5,56,99,56,420,0,0,0,0,0
35.728,17,3,228,3,48,17864,48,228,0,0,0,0,0
1797.66,1,220,12320,220,28,8208,28,12320,0,0,0,0,0
63.864,6,81,34874,48,1051,1358,1448,29836,33,157,1989,303,5038
11.985,6,16,4735,9,290,1498,517,1057,7,1102,1975,1448,3678
6.045,6,15,2399,7,188,1007,245,660,8,703,826,1152,1739
824.974,6,24,19682,4,174,3624,174,338,20,1235,43415,1420,19344
9.684,6,39,7269,21,218,484,314,3463,18,513,535,1179,3806
1798.305,17,278,54330,278,167,6492,356,54330,0,0,0,0,0
1787.375,6,105,8416,68,65,26677,65,4930,37,59,49645,59,3486
301.038,6,8,475,5,31,75259,31,262,3,31,150512,31,213
10.7,6,82,24805,42,542,260,1152,19048,40,461,267,1179,5757
0.807,17,23,12912,12,586,73,1350,7379,11,475,71,1350,5533
1.666,6,13,2311,8,188,238,245,700,5,1407,353,1407,1611
27.688,6,17,5750,10,272,3076,516,1220,7,849,119,1452,4530
1.401,6,60,18135,29,707,50,1360,8977,31,416,46,1360,9158
0.006,6,2,1230,1,1150,0,1150,1190,1,0,0,0,40
0.303,17,2,157,1,31,0,31,59,1,70,0,70,98
1789.523,17,144,11520,72,48,25204,48,5472,72,56,25204,56,6048
1081.7,17,13,4095,13,287,90141,1238,4095,0,0,0,0,0
1799.465,17,3824,183552,1912,20,941,20,91776,1912,20,941,20,91776
495.641,17,8,673,4,31,165208,37,239,4,80,165209,136,434
644.148,1,102,10812,102,78,6377,78,10812,0,0,0,0,0
0.041,17,2,180,1,30,0,30,58,1,94,0,94,122
51.644,6,25,7193,7,166,603,267,955,18,393,3036,1917,6238
1797.27,17,449,39928,404,35,4459,288,25708,45,288,40022,288,14220
1.276,6,42,12004,22,612,60,1460,6428,20,433,57,1460,5576
66.64,6,44,9856,19,265,3702,1189,2895,25,372,2770,1420,6961
0.102,6,27,13460,14,138,7,138,874,13,1190,5,1448,12586
1795.125,17,80,3354,79,14,23014,14,3318,1,8,0,8,36
384.026,6,19,6272,7,156,64002,267,758,12,718,34910,1420,5514
295.337,6,54,8458,26,116,11811,517,2343,28,356,10936,1418,6115
1.217,6,24,8004,12,164,110,267,1288,12,1014,91,2491,6716
0.025,17,2,586,1,46,0,46,74,1,484,0,484,512
0.346,6,17,4722,9,226,42,226,702,8,899,46,1402,4020
1786.501,6,104,8444,68,66,26664,66,4964,36,60,51039,60,3480
280.221,6,28,7352,12,158,25474,267,1277,16,603,18679,1400,6075
0.007,17,4,608,2,36,0,36,128,2,212,0,276,480
3.615,17,5,295,5,31,903,31,295,0,0,0,0,0
69.693,6,30,7366,14,152,5361,267,1484,16,475,4635,1460,5882
1749.019,6,102,7703,66,38,26907,205,4663,36,33,49933,98,3040
284.196,17,84,11372,39,157,7469,1350,7242,45,63,6450,1350,4130
1799.754,17,772,46540,772,32,2334,37,46540,0,0,0,0,0
1143.038,2,14,448,14,8,87926,8,448,0,0,0,0,0
1.205,17,5,1680,5,308,301,308,1680,0,0,0,0,0
21.488,6,26,8157,11,181,2148,267,1168,15,638,1509,3436,6989
15.294,6,7,304,2,0,20,0,84,5,0,3820,0,220
1089.18,2,42,1768,42,18,26565,24,1768,0,0,0,0,0
1740.913,17,27,28458,27,1026,66958,1026,28458,0,0,0,0,0
1799.108,6,1356,145260,558,110,3221,110,65760,798,110,2257,110,79500
0.882,17,2,685,1,308,0,308,336,1,321,0,321,349
41.475,17,6,1236,3,48,20733,48,228,3,308,20733,308,1008
281.032,6,32,7853,14,158,21617,267,1357,18,524,16525,1400,6496
125.268,6,34,7866,13,155,10439,267,1306,21,357,6263,3417,6560
1790.643,1,58,4872,58,56,31414,56,4872,0,0,0,0,0
0.699,6,24,6605,13,344,57,1058,2245,11,783,69,1420,4360
0.737,6,2,104,1,0,0,0,52,1,0,0,0,52
10.926,6,20,4402,11,275,1092,275,998,9,758,767,1420,3404
4.157,6,2,88,2,0,0,0,88,0,0,0,0,0
252.94,6,63,9645,27,312,9727,1056,5500,36,160,7225,580,4145
1782.886,6,102,8296,68,65,26610,65,4930,34,59,54024,59,3366
1.911,6,27,11017,16,346,127,770,1682,11,1111,172,1420,9335
36.105,17,4,240,2,32,36104,32,120,2,32,36104,32,120
0.027,17,2,912,1,308,0,308,336,1,548,0,548,576
0.267,17,2,2382,2,1163,267,1163,2382,0,0,0,0,0
13.261,6,2588,2463322,1648,1416,7,1448,2409766,940,776,13,1448,53556
15.112,17,17,5202,7,304,2513,1350,2326,10,259,1675,1350,2876
51.756,17,2,142,2,43,51756,43,142,0,0,0,0,0
194.889,6,39,8485,14,123,7306,267,1553,25,282,8119,1452,6932
388.66,17,60,4560,60,48,6587,48,4560,0,0,0,0,0
0.639,6,2,92,1,0,0,0,40,1,0,0,0,52
300.843,6,41,9746,22,531,14325,1360,4122,19,373,478,2720,5624
1781.907,6,354,22440,207,69,8650,69,12420,147,69,12204,69,10020
1.976,17,3,180,3,32,988,32,180,0,0,0,0,0
299.501,6,121,25162,59,329,5163,1360,14333,62,225,4907,1929,10829
1791.215,6,416,24920,208,69,8653,69,12460,208,34,8653,48,12460
0.205,6,27,7296,13,155,17,267,1301,14,603,15,2800,5995
3.353,17,5,290,5,30,838,30,290,0,0,0,0,0
255.303,17,4,352,2,60,255301,60,176,2,60,255302,60,176
1794.767,17,247,51543,247,180,7295,377,51543,0,0,0,0,0
175.856,6,23,9002,11,514,90,1237,2015,12,927,15970,1460,6987
7.991,6,16,1402,9,275,998,275,918,7,96,1014,96,484
1774.42,6,257,26491,127,105,14081,721,14882,130,182,13753,1420,11609
1.386,6,38,8254,19,321,77,1164,2718,19,433,65,1440,5536
1681.778,17,14,1036,7,30,280294,30,406,7,62,280293,62,630
300.262,6,37,12228,19,592,16681,1402,4584,18,670,14174,1402,7644
0.261,17,7,2368,7,310,43,354,2368,0,0,0,0,0
13.429,6,1754,1613401,1138,1368,11,1432,1581882,616,546,21,1871,31519
1.952,17,3,1176,3,364,976,364,1176,0,0,0,0,0
131.761,6,15,3958,8,663,115,1460,2992,7,337,21931,522,966
158.549,6,46,7415,22,285,7549,585,3500,24,264,6876,595,3915
0.073,17,4,640,2,40,0,40,136,2,224,48,296,504
1772.376,6,180,15480,120,69,14893,69,8940,60,69,30033,69,6540
1.481,6,29,9151,14,250,113,639,1744,15,942,103,1368,7407
1786.26,6,155,20441,91,316,19847,316,14528,64,83,28353,83,5913
89.07,6,23,11278,12,433,74,990,1823,11,1286,8893,3928,9455
116.641,1,28,2912,0,0,0,0,0,28,76,4320,76,2912
0.135,1,2,112,2,28,135,28,112,0,0,0,0,0
0.076,6,11,819,6,186,15,186,506,5,45,15,45,313
6.899,6,42,7405,22,218,328,314,3503,20,516,349,1179,3902
1773.322,6,136,8389,73,27,24628,27,4432,63,27,28601,27,3957
2.418,6,14,2351,8,188,345,245,700,6,703,433,1152,1651
15.202,6,41,11690,18,839,45,1360,5813,23,290,682,1360,5877
62.239,6,42,14377,24,450,2706,1292,4858,18,659,3646,1469,9519
60.856,6,27,7312,12,158,5532,267,1277,15,678,4345,2045,6035
1.379,6,24,9050,13,422,114,1205,2374,11,1219,118,2491,6676
1787.267,6,371,25810,214,99,8390,469,15114,157,69,11455,69,10696
60.169,2,2,64,2,8,60169,8,64,0,0,0,0,0
5.014,17,3,343,2,36,5003,36,128,1,187,0,187,215
0.084,17,2,132,1,30,0,30,58,1,46,0,46,74
64.417,6,37,11386,12,297,5856,1189,2869,25,441,2683,1420,8517
1788.834,6,356,22520,208,69,8641,69,12460,148,69,12168,69,10060
1.462,17,53,38265,21,356,73,1350,8077,32,915,43,1350,30188
1781.067,1,52,4368,52,56,34922,56,4368,0,0,0,0,0
281.901,6,31,7563,13,158,23491,267,1317,18,552,16575,2076,6246
1785.85,6,361,24803,210,94,8544,469,14347,151,69,11905,69,10456
92.05,17,4,558,2,36,92045,36,128,2,187,92045,187,430
383.733,17,6,1496,3,32,191860,37,181,3,410,191862,463,1315
0.036,17,4,368,2,32,12,32,120,2,96,0,96,248
4.45,6,5,280,2,0,4450,0,100,3,0,1518,0,180
280.29,6,28,7352,12,158,25480,267,1277,16,603,18683,1400,6075
0.026,17,2,382,1,32,0,32,60,1,294,0,294,322
280.623,6,29,7392,13,158,23385,267,1317,16,603,18705,1400,6075
1785.859,6,371,25810,215,99,8345,469,15154,156,69,11521,69,10656
42.373,17,24,2112,12,48,3845,48,912,12,72,3850,72,1200
117.704,17,30,35356,30,1150,4058,1451,35356,0,0,0,0,0
1770.955,6,99,9240,66,65,27245,65,5577,33,59,55339,59,3663
1.209,1,10,280,10,0,0,0,280,0,0,0,0,0
61.84,6,69,48111,44,1180,1438,1408,40076,25,961,2567,3847,8035
0.842,17,14,7071,7,614,135,1350,4494,7,340,124,1350,2577
0.005,17,2,369,1,32,0,32,60,1,281,0,281,309
1770.397,6,100,9292,66,65,27236,65,5577,34,59,53645,59,3715
31.968,6,9,396,2,0,3446,0,88,7,0,5312,0,308
298.917,1,24,1344,24,28,12996,28,1344,0,0,0,0,0
728.82,1,10,560,10,28,80980,28,560,0,0,0,0,0
1.024,17,4,454,3,32,506,32,180,1,246,0,246,274
27.016,6,39,9074,20,340,1421,722,2849,19,778,1489,1380,6225
1744.752,6,95,7203,63,38,28141,205,4476,32,33,56274,98,2727
3.088,6,27,6156,13,164,257,453,1506,14,558,236,1448,4650
0.014,17,2,399,1,35,0,35,63,1,308,0,308,336
91.509,6,52,17584,26,633,3660,1360,4983,26,607,3653,1360,12601
300.795,6,42,9844,22,540,14323,1360,4180,20,373,454,2667,5664
657.032,6,36,2573,23,31,29865,31,1525,13,31,54733,31,1048
1756.841,6,110,6596,62,26,28800,27,3662,48,26,37378,27,2934
0.446,6,20,7196,12,325,40,626,1932,8,1210,62,1906,5264
1.638,6,27,10179,16,285,109,587,1499,11,1029,147,1420,8680
179.12,6,49,15287,23,752,8141,1408,12485,26,173,7163,580,2802
86.801,6,3,1062,3,302,43400,302,1062,0,0,0,0,0
839.995,1,4,224,4,28,279998,28,224,0,0,0,0,0
0.011,17,2,192,1,60,0,60,88,1,76,0,76,104
1799.923,17,21,1344,21,36,89996,36,1344,0,0,0,0,0
0.898,6,26,9002,13,208,74,475,1386,13,1012,60,1360,7616
5.01,17,4,530,2,36,5006,36,128,2,173,5006,187,402
49.451,6,29,6424,11,179,4945,722,1643,18,381,2896,1408,4781
0.04,17,4,680,2,33,0,33,122,2,251,1,323,558
0.036,6,12,3462,6,75,7,75,395,6,1373,7,1448,3067
184.61,17,4,240,2,32,184609,32,120,2,32,184609,32,120
280.269,6,28,7352,13,158,23355,267,1317,15,678,20011,2800,6035
1741.206,6,87,6322,58,31,30547,31,3915,29,31,62183,31,2407
0.035,17,4,420,2,33,28,33,122,2,121,28,145,298
842.235,2,6,192,6,8,168447,8,192,0,0,0,0,0
1795.332,17,449,39928,404,35,4454,288,25708,45,288,40019,288,14220
240.357,6,44,8448,22,449,11444,1418,5648,22,206,11444,580,2800
178.108,6,181,30167,104,304,1729,304,21624,77,83,2304,83,8543
1796.852,17,449,39928,404,35,4458,288,25708,45,288,40015,288,14220
11.126,17,4,352,2,60,11125,60,176,2,60,11125,60,176
1783.472,17,83,3480,82,14,22018,14,3444,1,8,0,8,36
1768.938,1,58,4872,58,56,31034,56,4872,0,0,0,0,0
11.394,6,2273,2161293,1488,1377,7,1408,2115809,785,931,14,2801,45484
35.663,6,33,5197,16,154,2377,722,1911,17,299,2200,1448,3286
317.035,6,66,18583,39,313,8343,1360,9752,27,552,12188,3289,8831
1789.953,6,360,22887,209,69,8604,69,12707,151,69,11933,69,10180
3.989,17,8,1120,4,64,1329,64,368,4,160,1329,160,752
16.805,17,21,9455,11,603,1677,1350,6951,10,222,1863,1350,2504
236.717,17,4,240,2,32,236716,32,120,2,32,236716,32,120
0.008,17,2,308,1,34,0,34,62,1,218,0,218,246
146.854,6,74,49698,46,1176,3263,1408,40099,28,903,2281,2816,9599
1740.403,17,28,6580,28,207,64459,207,6580,0,0,0,0,0
9.917,6,82,24837,42,561,241,1152,19096,40,413,247,1152,5741
70.627,6,26,11075,13,410,60,922,1830,13,968,5874,2720,9245
101.645,17,5,380,5,48,25411,48,380,0,0,0,0,0
1689.157,17,22,7324,22,304,80436,901,7324,0,0,0,0,0
4.896,6,7,400,3,0,2448,0,160,4,0,1072,0,240
3.994,17,8,1176,4,48,1328,48,304,4,190,1328,308,872
1.825,17,2,122,2,33,1825,33,122,0,0,0,0,0
0.441,6,27,7296,13,155,36,267,1301,14,603,29,2036,5995
280.225,6,30,7432,14,158,21555,267,1357,16,603,18677,2236,6075
1742.807,6,95,7203,63,38,28109,205,4476,32,33,56210,98,2727
181.285,6,14,2351,7,188,30214,245,660,7,1407,30169,1407,1691
1794.977,6,356,22520,208,69,8671,69,12460,148,69,12210,69,10060
0.243,17,2,624,1,64,0,64,92,1,504,0,504,532
1771.593,6,80,4212,41,26,44287,26,2158,39,26,45406,26,2054
17.427,6,16,15558,3,218,78,218,358,13,1629,1439,3934,15200
1767.368,6,100,7866,66,45,27190,205,4902,34,35,53544,98,2964
363.114,17,6,2472,6,384,72622,394,2472,0,0,0,0,0
1772.482,6,180,15480,120,69,14894,69,8940,60,69,30040,69,6540
0.238,17,2,152,1,48,0,48,76,1,48,0,48,76
0.036,17,6,912,3,60,6,60,264,3,188,5,188,648
1.113,6,28,8631,15,236,66,625,2049,13,1008,77,2720,6582
4.607,6,37,7189,19,218,255,314,3383,18,513,254,1179,3806
1773.677,6,181,15589,121,69,14780,69,9049,60,69,30058,69,6540
0.0,6,1,48,0,0,0,0,0,1,0,0,0,48
1741.956,1,56,4704,56,56,31671,56,4704,0,0,0,0,0
74.368,6,46,10243,22,677,518,1360,4357,24,307,3226,1360,5886
7.957,6,18,6871,9,275,994,275,643,9,1171,887,1440,6228
0.066,17,2,2382,2,1163,66,1163,2382,0,0,0,0,0
1183.661,6,110,19670,58,403,18804,1283,14015,52,96,23209,267,5655
1772.565,6,180,15480,120,69,14895,69,8940,60,69,30034,69,6540
1798.961,17,83,3480,82,14,22209,14,3444,1,8,0,8,36
1745.831,6,90,6540,60,31,29590,31,4050,30,31,60186,31,2490
34.14,17,3,228,3,48,17070,48,228,0,0,0,0,0
0.029,17,2,422,1,72,0,72,100,1,294,0,294,322
1799.274,17,448,39896,403,35,4475,288,25676,45,288,40017,288,14220
0.201,6,12,2069,7,324,33,585,1009,5,396,37,580,1060
1798.342,17,87,3648,86,14,21156,14,3612,1,8,0,8,36
1780.15,1,342,28728,342,56,5220,56,28728,0,0,0,0,0
35.703,17,22,1936,11,48,3562,48,836,11,72,3560,72,1100
38.523,6,27,7177,13,155,3210,267,1306,14,530,2962,3417,5871
1776.429,6,184,15778,122,69,14681,69,9020,62,69,29121,69,6758
265.393,17,13,988,13,48,22116,48,988,0,0,0,0,0
255.382,6,12,4009,4,112,85123,112,280,8,848,36481,1460,3729
877.308,6,11,1540,11,110,87730,110,1540,0,0,0,0,0
0.38,6,22,7342,12,335,34,668,1974,10,1210,41,1906,5368
11.117,6,551,521098,368,1352,29,1368,506198,183,776,59,1473,14900
1796.832,17,448,39896,403,35,4469,288,25676,45,288,40023,288,14220
1799.535,17,144,11520,72,48,25345,48,5472,72,56,25345,56,6048
1.802,17,25,10241,11,485,180,1350,5649,14,300,133,1350,4592
11.924,6,21,6825,12,275,1084,275,1038,9,1353,864,1440,5787
292.479,6,22,1535,11,31,29232,31,727,11,31,29230,31,808
3.0,17,3,186,3,34,1500,34,186,0,0,0,0,0
0.41,6,12,1653,6,288,77,288,548,6,426,42,434,1105
160.875,17,4,240,2,32,160874,32,120,2,32,160874,32,120
0.018,17,2,330,1,30,0,30,58,1,244,0,244,272
0.008,6,3,120,1,0,0,0,40,2,0,0,0,80
1782.209,17,83,3480,82,14,22002,14,3444,1,8,0,8,36
1795.32,17,81,3390,79,14,23014,14,3318,2,8,1795139,8,72
0.196,6,26,7256,13,155,16,267,1301,13,603,15,2036,5955
1.489,17,6,360,3,32,743,32,180,3,32,744,32,180
1794.521,6,360,24343,210,87,8586,1189,13729,150,74,12042,405,10614
137.144,6,26,6394,15,189,9796,516,1552,11,549,13699,1452,4842
4.652,6,12,945,6,222,928,222,466,6,231,928,231,479
5.785,17,8,1640,4,36,1927,36,256,4,318,1926,318,1384
1796.521,17,449,39416,404,34,4457,288,25444,45,282,40020,288,13972
1258.193,17,14,1117,7,31,209697,37,413,7,72,209696,136,704
1740.635,17,30,31680,30,1028,60021,1028,31680,0,0,0,0,0
7.42,6,30,8848,13,155,618,267,1306,17,527,463,3417,7542
280.345,6,29,7392,13,158,23362,267,1317,16,603,18686,2036,6075
32.436,6,4471,4240413,2854,1405,11,1448,4151047,1617,792,19,1448,89366
0.839,6,35,8152,19,241,46,619,1758,16,522,46,3488,6394
296.556,17,4,240,2,32,296555,32,120,2,32,296554,32,120
0.09,17,4,420,2,33,1,33,122,2,121,1,145,298
1787.184,1,660,74002,660,84,2711,85,74002,0,0,0,0,0
594.024,1,6,336,6,28,118804,28,336,0,0,0,0,0
4.258,17,10,785,5,31,1052,31,295,5,70,1053,70,490
1799.101,17,142,11360,71,48,25701,48,5396,71,56,25701,56,5964
1766.034,17,16,4225,8,30,252289,37,471,8,441,252289,463,3754
0.923,6,27,8420,15,222,55,540,1964,12,1192,68,3151,6456
1194.109,17,46,4376,23,33,54276,37,1418,23,100,54276,136,2958
1715.264,1,118,6608,118,28,14660,28,6608,0,0,0,0,0
3.811,6,14,3144,8,49,544,92,511,6,579,63,1408,2633
1798.127,17,447,39580,403,35,4472,288,25676,44,288,40948,288,13904
252.354,2,2,64,2,8,252354,8,64,0,0,0,0,0
580.232,17,37,12468,37,308,16117,376,12468,0,0,0,0,0
0.265,17,2,440,1,39,0,39,67,1,345,0,345,373
0.029,17,2,231,1,34,0,34,62,1,141,0,141,169
7.244,6,1668,1527961,1047,1381,6,1408,1491005,621,931,11,2801,36956
10.83,6,89,27445,46,570,240,1152,21243,43,407,251,1152,6202
1.045,17,2,194,1,61,0,61,89,1,77,0,77,105
1750.553,17,12,498,11,14,175055,14,462,1,8,0,8,36
0.004,17,2,394,1,37,0,37,65,1,301,0,301,329
1795.372,17,142,11360,71,48,25647,48,5396,71,56,25647,56,5964
0.888,6,10,1687,7,100,148,100,384,3,1179,322,1179,1303
5.387,6,1060,938345,650,1368,8,1402,912361,410,931,12,2807,25984
0.886,6,38,8370,19,260,49,694,1857,19,441,41,1360,6513
1.953,17,6,1493,3,40,970,40,204,3,401,971,423,1289
0.112,17,2,602,1,46,0,46,74,1,500,0,500,528
157.936,6,32,13329,17,501,9871,1440,4425,15,1012,11268,1440,8904
187.706,17,4,304,2,48,187705,64,152,2,48,187705,64,152
0.013,17,2,515,1,40,0,40,68,1,419,0,419,447
1684.445,2,14,448,14,8,129572,8,448,0,0,0,0,0
0.451,17,4,1108,2,30,438,30,116,2,468,412,468,992
9.236,6,8,460,3,0,4618,0,160,5,0,1798,0,300
65.393,6,12,976,4,226,138,226,442,8,110,9314,110,534
280.52,6,28,7352,13,158,23376,267,1317,15,775,20032,2760,6035
88.116,6,24,11082,13,616,56,1360,3634,11,1166,8798,2580,7448
300.667,6,36,8261,20,258,15824,688,1867,16,522,563,2720,6394
1799.603,1,110,6160,110,28,16510,28,6160,0,0,0,0,0
59.61,6,2366,2271119,1582,1361,37,1368,2224931,784,776,75,1473,46188
1.629,6,12,1767,7,100,271,100,384,5,589,342,1152,1383
11.729,6,1848,1620721,1100,1419,10,1432,1586556,748,420,15,1432,34165
2.26,6,6,340,3,0,1130,0,160,3,0,497,0,180
0.014,6,3,120,1,0,0,0,40,2,0,13,0,80
0.02,17,2,160,1,36,0,36,64,1,68,0,68,96
1.36,6,46,15674,25,751,56,1360,10058,21,476,58,2715,5616
1.403,2,3,96,3,8,701,8,96,0,0,0,0,0
1774.892,1,268,15008,268,28,6647,28,15008,0,0,0,0,0
300.744,2,3,96,3,8,150372,8,96,0,0,0,0,0
71.014,6,26,10081,13,216,5917,500,1389,13,816,5910,1420,8692
67.183,17,4,352,2,60,67182,60,176,2,60,67182,60,176
0.109,17,4,288,2,36,79,36,128,2,52,79,52,160
512.949,6,105,6615,60,69,8693,69,3642,45,69,11657,69,2973
1.372,6,51,19084,28,936,50,1460,13343,23,400,53,1460,5741
0.556,6,10,924,5,283,92,283,551,5,105,92,105,373
0.018,6,13,4256,7,85,3,85,457,6,1159,3,2896,3799
1.062,6,26,9205,14,288,81,796,1747,12,1161,81,2720,7458
280.377,6,29,7392,13,158,23364,267,1317,16,603,18690,2036,6075
287.392,17,4,352,2,60,287391,60,176,2,60,287391,60,176
5.319,17,3,208,2,36,5006,36,128,1,52,0,52,80
1.266,6,49,19174,26,886,50,1440,13478,23,433,49,1440,5696
0.344,6,27,8633,14,219,26,531,1613,13,1056,26,1438,7020
1788.424,17,87,3648,86,14,21040,14,3612,1,8,0,8,36
1.048,17,4,580,2,40,1017,40,136,2,194,1001,194,444
400.746,17,56,4678,52,30,7857,37,3030,4,384,113326,463,1648
1786.691,6,104,8376,68,65,26667,65,4930,36,59,51044,59,3446
0.165,17,2,152,2,48,165,48,152,0,0,0,0,0
22.994,6,14,3743,6,275,4598,275,523,8,1440,3019,1440,3220
135.359,17,6,2016,6,308,27071,308,2016,0,0,0,0,0
11.867,6,102,30620,52,556,232,1152,23797,50,438,237,1179,6823
1779.269,17,142,11360,71,48,25418,48,5396,71,56,25418,56,5964
1796.264,6,300,20349,179,69,10091,69,11300,121,69,14968,69,9049
0.75,17,4,1116,2,32,745,32,120,2,470,745,470,996
504.386,2,4,128,4,8,168128,8,128,0,0,0,0,0
2.12,6,70,49123,42,1243,51,1408,40759,28,985,71,2816,8364
215.649,6,31,8912,14,158,16588,267,1357,17,687,13475,1781,7555
5.198,6,44,8369,22,227,247,314,4062,22,489,235,1179,4307
1515.919,17,223,53283,223,210,6828,422,53283,0,0,0,0,0
1.441,6,52,18954,26,928,57,1440,13138,26,433,50,1440,5816
372.197,6,18,1242,14,180,28630,180,916,4,110,20076,110,326
87.531,6,47,9399,22,388,542,619,2513,25,419,3641,1360,6886
1764.37,2,15,480,15,8,126026,8,480,0,0,0,0,0
1738.762,6,87,6322,58,31,30504,31,3915,29,31,62098,31,2407
1741.189,17,28,29568,28,1028,64488,1028,29568,0,0,0,0,0
1796.826,1,218,12208,218,28,8280,28,12208,0,0,0,0,0
61.418,6,15,3928,8,127,8774,127,467,7,1056,10225,1704,3461
0.821,6,29,10515,15,545,58,1328,2316,14,762,52,1605,8199
87.829,6,21,864,9,0,5296,0,368,12,0,7981,0,496
1793.038,17,66,2766,65,14,28016,14,2730,1,8,0,8,36
378.091,2,4,128,4,8,126030,8,128,0,0,0,0,0
11.825,6,1856,1632889,1135,1385,10,1420,1599816,721,467,16,1883,33073
1700.593,17,13,534,11,14,170041,14,462,2,8,1700413,8,72
0.443,6,21,7217,13,318,36,599,1957,8,1209,62,1906,5260
10.467,6,93,29068,46,564,232,1152,22722,47,446,221,1179,6346
1783.103,1,58,4872,0,0,0,0,0,58,56,31282,56,4872
1772.191,6,99,9240,66,65,27264,65,5577,33,59,55376,59,3663
1764.201,2,15,480,15,8,126014,8,480,0,0,0,0,0
1772.76,6,180,15480,120,69,14897,69,8940,60,69,30044,69,6540
495.63,17,8,2640,8,302,70804,308,2640,0,0,0,0,0
0.016,6,2,100,1,0,0,0,40,1,0,0,0,60
7.954,6,496,403929,298,1287,26,1368,388969,198,776,39,1473,14960
6.278,1,4,224,4,28,2092,28,224,0,0,0,0,0
1795.553,17,142,11360,71,48,25650,48,5396,71,56,25650,56,5964
1773.42,17,138,11040,69,48,26079,48,5244,69,56,26079,56,5796
6.141,2,2,64,2,8,6141,8,64,0,0,0,0,0
1.312,6,10,1687,7,100,218,100,384,3,1179,534,1179,1303
1681.046,1,15,840,15,28,120074,28,840,0,0,0,0,0
315.935,6,8,416,8,0,0,0,416,0,0,0,0,0
300.554,6,38,8584,20,316,15818,888,2110,18,441,495,1360,6474
0.885,6,50,13837,24,551,38,1429,4888,26,493,34,3446,8949
372.455,6,1317,870477,675,1243,552,1368,768993,642,245,581,2375,101484
1799.581,1,345,28980,345,56,5231,56,28980,0,0,0,0,0
280.447,6,31,7472,13,158,23370,267,1317,18,543,16494,1380,6155
51.227,17,6,528,3,48,25608,48,228,3,72,25608,72,300
1304.245,6,52,3778,32,36,42066,92,2254,20,31,68635,31,1524
1753.905,17,250,68201,250,244,7043,422,68201,0,0,0,0,0
0.014,17,2,480,1,39,0,39,67,1,385,0,385,413
1681.293,17,14,3783,7,30,280213,30,406,7,454,280213,463,3377
8.359,6,13,2311,8,188,1194,245,700,5,1407,2022,1407,1611
2.786,6,2,88,2,0,0,0,88,0,0,0,0,0
1796.373,17,449,39928,404,35,4457,288,25708,45,288,40023,288,14220
246.488,6,573,431728,256,736,966,1408,32795,317,1332,780,2816,398933
5.009,17,4,514,2,36,5005,36,128,2,165,5004,171,386
0.498,17,2,384,1,39,0,39,67,1,289,0,289,317
189.93,6,13,944,4,106,63310,106,274,9,90,23724,90,670
5.428,6,38,7245,20,218,285,314,3423,18,516,304,1179,3822
53.843,6,27,7177,13,155,4486,267,1306,14,530,4141,3417,5871
1.292,6,52,20977,28,939,47,1460,15241,24,433,48,1460,5736
58.464,6,28,7217,13,155,4872,267,1306,15,482,4175,1997,5911
0.778,17,18,7967,8,468,111,1350,3971,10,371,77,1350,3996
0.998,6,26,5700,13,125,83,267,1275,13,650,76,1420,4425
0.107,17,2,412,1,33,0,33,61,1,323,0,323,351
1.269,6,50,18843,27,859,48,1360,13147,23,433,49,1360,5696
2.936,6,2,88,2,0,0,0,88,0,0,0,0,0
1792.636,17,143,11436,72,48,25247,48,5472,71,56,25604,56,5964
69.016,6,26,6797,12,181,6274,267,1212,14,627,5307,1400,5585
281.103,6,30,7570,13,158,23425,267,1317,17,556,17541,4200,6253
5.021,17,4,288,2,36,5003,36,128,2,52,5006,52,160
0.014,17,2,440,1,39,0,39,67,1,345,0,345,373
1799.069,6,442,26024,233,69,7754,69,13460,209,34,8649,64,12564
4.915,6,41,7365,21,218,245,314,3463,20,442,244,1152,3902
1.587,17,19,7661,9,512,198,1350,4863,10,251,170,1350,2798
0.299,6,26,8990,13,247,24,624,1672,13,947,24,1408,7318
300.851,6,52,10618,26,433,12034,910,3310,26,312,614,1460,7308
15.109,17,16,5282,7,361,2513,1350,2726,9,256,1884,1350,2556
240.363,17,6,2016,6,308,48072,308,2016,0,0,0,0,0
1134.105,2,8,256,8,8,162015,8,256,0,0,0,0,0
0.31,6,28,9123,13,247,25,624,1672,15,832,21,1408,7451
1.415,17,4,284,2,32,606,32,120,2,54,815,60,164
0.02,6,12,3940,7,88,3,88,388,5,3340,5,3340,3552
0.377,6,27,8920,13,227,31,547,1592,14,941,27,1448,7328
9.441,6,18,5431,9,275,1180,275,643,9,1104,1122,1440,4788
2.733,6,12,2271,7,188,455,245,660,5,1407,621,1407,1611
10.514,6,1546,1437728,1017,1364,10,1432,1412277,529,427,19,1432,25451
183.874,6,90,63381,54,1177,3469,1448,54643,36,839,87,1448,8738
84.622,6,769,367347,414,825,204,1152,346587,355,364,238,643,20760
1785.012,6,108,8664,69,66,26250,66,5004,39,60,46970,60,3660
0.835,17,2,925,1,548,0,548,576,1,321,0,321,349
1787.072,6,102,8364,68,66,26672,66,4964,34,60,54149,60,3400
361.341,6,48,10921,29,320,12905,1360,5359,19,399,481,1360,5562
240.646,6,53,13947,26,623,9625,1418,10125,27,241,9254,746,3822
1787.629,6,117,13909,75,83,24157,516,5998,42,163,43598,1452,7911
253.855,17,2,140,2,42,253855,47,140,0,0,0,0,0
677.648,17,30,8027,15,39,48403,43,1019,15,439,48403,505,7008
3.282,17,8,1612,4,36,1092,36,256,4,311,1092,318,1356
1799.439,17,448,39896,403,35,4476,288,25676,45,288,40020,288,14220
0.065,17,2,347,1,29,0,29,57,1,262,0,262,290
1772.247,6,132,12933,79,62,22721,722,6474,53,94,34077,2026,6459
38.242,6,27,7177,13,155,3186,267,1306,14,530,2941,3417,5871
13.704,6,28,4918,13,154,1124,722,1766,15,338,966,1408,3152
0.25,17,3,451,2,39,184,39,134,1,289,0,289,317
92.473,6,24,8539,12,312,74,623,1448,12,824,8395,1708,7091
280.23,6,29,7392,13,158,23352,267,1317,16,603,18680,1400,6075
1791.666,6,358,22600,208,69,8655,69,12460,150,69,12024,69,10140
287.151,6,51,9379,26,105,11486,267,2309,25,303,11964,2840,7070
247.747,6,31,9050,14,158,19057,267,1357,17,700,15453,3436,7693
12.204,17,17,2229,17,103,762,285,2229,0,0,0,0,0
1195.791,6,107,11064,59,73,20617,722,5123,48,93,25432,1448,5941
4.578,6,41,8470,21,227,228,564,1794,20,418,216,1460,6676
8.785,6,1408,1221557,854,1380,10,1420,1195164,554,467,15,1883,26393
0.545,6,20,7229,13,334,45,663,2021,7,1209,83,1946,5208
91.366,6,26,8133,7,155,920,267,1066,19,419,5075,1420,7067
1777.992,17,156,52416,156,308,11470,308,52416,0,0,0,0,0
0.031,6,9,1348,5,145,7,145,349,4,835,7,835,999
0.97,6,10,1687,7,100,161,100,384,3,1179,351,1179,1303
1265.214,6,140,18228,77,304,16647,304,12548,63,83,20406,83,5680
126.292,2,2,64,2,8,126292,8,64,0,0,0,0,0
5.184,17,4,3355,4,810,1728,1438,3355,0,0,0,0,0
1788.646,17,87,3648,86,14,21042,14,3612,1,8,0,8,36
290.455,1,4,224,4,28,96818,28,224,0,0,0,0,0
0.093,17,2,144,1,36,0,36,64,1,52,0,52,80
0.326,6,22,4442,11,165,32,456,1394,11,493,29,888,3048
0.056,6,15,5658,7,106,9,106,394,8,822,2,1420,5264
367.316,6,21,1419,15,177,26236,177,989,6,110,12231,110,430
280.197,6,28,7352,13,158,23349,267,1317,15,678,20011,3900,6035
25.297,6,9,527,5,43,6324,43,311,4,0,8429,0,216
91.969,6,802,399063,445,839,207,1152,378921,357,418,257,1179,20142
0.092,17,2,362,1,46,0,46,74,1,260,0,260,288
1049.628,6,107,9179,70,69,15211,69,5284,37,69,29155,69,3895
11.676,6,847,739152,536,1307,21,1368,718316,311,776,37,1473,20836
1741.01,6,87,6322,58,31,30544,31,3915,29,31,62177,31,2407
0.773,6,12,1304,6,256,150,256,756,6,304,151,304,548
51.652,6,27,7177,13,155,4304,267,1306,14,530,3972,4260,5871
143.503,17,8,2688,8,308,20500,308,2688,0,0,0,0,0
1776.96,17,73,3060,72,14,25027,14,3024,1,8,0,8,36
0.191,6,27,7296,14,155,14,267,1341,13,678,15,3436,5955
3.017,17,4,400,2,48,3000,48,152,2,96,3001,96,248
1780.269,1,342,28728,342,56,5220,56,28728,0,0,0,0,0
2.134,17,2,169,1,34,0,34,62,1,79,0,79,107
0.061,17,4,352,2,37,0,37,130,2,83,13,89,222
17.14,6,514,424679,298,1351,57,1368,407437,216,899,78,2736,17242
1772.268,6,180,15480,120,69,14893,69,8940,60,69,30037,69,6540
33.094,6,28,7217,13,155,2757,267,1306,15,482,2363,1997,5911
1789.537,17,136,10880,68,48,26709,48,5168,68,56,26709,56,5712
241.646,6,44,5320,20,181,12717,517,2183,24,171,10506,851,3137
0.37,17,2,172,1,50,0,50,78,1,66,0,66,94
107.354,6,32,13556,17,488,293,1360,3155,15,978,7659,1360,10401
240.219,6,52,17613,28,784,8896,1418,14801,24,222,10443,580,2812
64.389,6,75,48537,46,1183,1430,1408,40280,29,747,2290,1408,8257
1.464,6,39,8292,19,320,81,1162,2716,20,433,67,1360,5576
1.563,6,47,19570,27,920,60,1360,13994,20,433,70,1360,5576
1.52,6,46,19131,27,889,58,1360,13595,19,476,73,2715,5536
0.162,17,2,154,1,33,0,33,61,1,65,0,65,93
0.236,17,2,2384,2,1164,236,1164,2384,0,0,0,0,0
1771.724,6,99,9306,66,66,27257,66,5610,33,60,55363,60,3696
102.58,6,119,94896,77,1299,1349,1448,84598,42,675,2496,1448,10298
1740.102,17,79,27248,79,316,22309,548,27248,0,0,0,0,0
421.126,2,4,128,4,8,140375,8,128,0,0,0,0,0
155.26,6,48,14790,21,181,7763,267,2296,27,670,5970,3436,12494
5.217,6,45,8409,22,227,248,314,4062,23,489,225,1179,4347
1.334,6,50,19404,27,899,51,1360,13708,23,433,52,1360,5696
11.622,6,2326,2191817,1467,1415,7,1448,2142485,859,776,13,1448,49332
4.132,6,55,20984,25,839,172,1440,11993,30,513,134,1440,8991
280.486,6,28,7352,13,158,23373,267,1317,15,603,20029,2076,6035
2.813,6,20,2336,11,304,281,304,1516,9,83,349,83,820
0.706,6,29,9197,14,261,54,683,1792,15,943,47,1408,7405
11.87,6,1881,1623972,1147,1361,10,1380,1590370,734,421,16,1923,33602
26.596,6,10,1181,4,483,8865,483,687,6,83,5063,83,494
0.044,17,2,167,1,39,0,39,67,1,72,0,72,100
1783.808,6,356,22520,208,69,8617,69,12460,148,69,12134,69,10060
0.14,17,4,284,2,32,0,32,120,2,54,128,60,164
1779.336,17,140,11200,70,48,25787,48,5320,70,56,25787,56,5880
0.555,6,4,220,2,0,555,0,100,2,0,307,0,120
0.003,17,4,352,2,60,2,60,176,2,60,2,60,176
206.101,17,6,360,3,32,103050,32,180,3,32,103050,32,180
4.797,6,39,7285,21,218,239,314,3463,18,516,267,1179,3822
240.316,6,43,9194,21,524,12015,1418,5819,22,247,11442,618,3375
1787.149,17,87,3648,86,14,21025,14,3612,1,8,0,8,36
2.793,17,3,1167,3,361,1396,361,1167,0,0,0,0,0
1787.318,6,102,8296,68,65,26676,65,4930,34,59,54156,59,3366
1797.725,1,345,28980,345,56,5225,56,28980,0,0,0,0,0
1779.875,6,424,25368,215,69,8317,69,12740,209,34,8557,64,12628
1.202,6,25,8056,12,164,92,267,1288,13,869,85,1408,6768
0.426,6,13,1693,7,288,70,288,588,6,426,47,434,1105
2.137,6,32,7477,16,149,142,267,1993,16,806,130,1460,5484
1045.167,1,10,560,10,28,116129,28,560,0,0,0,0,0
1770.631,6,154,22120,92,206,19457,827,14291,62,100,29025,234,7829
1786.792,6,109,8836,71,66,25525,66,5216,38,60,48287,60,3620
960.718,17,17,11441,17,645,60044,645,11441,0,0,0,0,0
1739.783,2,16,512,16,8,115985,8,512,0,0,0,0,0
0.921,17,2,179,1,43,0,43,71,1,80,0,80,108
1774.573,1,57,4788,57,56,31688,56,4788,0,0,0,0,0
16.62,17,26,10163,14,418,1275,1350,6251,12,298,1507,1350,3912
280.042,6,30,7432,13,158,23336,267,1317,17,543,17499,1400,6115
1.459,6,50,19363,27,896,56,1360,13667,23,433,57,1360,5696
280.285,6,30,7432,13,158,23357,267,1317,17,543,17510,1400,6115
1612.388,1,8,448,8,28,230341,28,448,0,0,0,0,0
300.538,6,17,1175,5,177,75092,177,445,12,110,27306,110,730
5.19,17,5,532,4,30,1009,30,232,1,272,0,272,300
57.852,6,14,1847,7,100,9642,100,384,7,589,9593,1152,1463
0.045,17,2,279,1,36,0,36,64,1,187,0,187,215
0.165,6,28,7336,14,155,12,267,1341,14,603,11,2036,5995
1799.536,17,144,11520,72,48,25345,48,5472,72,56,25345,56,6048
850.566,6,105,13273,57,304,15188,304,9112,48,83,18084,83,4161
300.083,1,4,224,4,28,100027,28,224,0,0,0,0,0
279.678,17,435,68690,375,147,746,172,65926,60,18,4739,172,2764
0.13,6,2,206,1,126,0,126,166,1,0,0,0,40
1797.333,6,365,25032,213,94,8477,469,14536,152,69,11902,69,10496
0.027,17,2,591,1,36,0,36,64,1,499,0,499,527
372.261,6,18,1242,14,180,28635,180,916,4,110,20062,110,326
1380.433,17,14,3648,7,31,230069,37,413,7,434,230070,463,3235
255.488,17,4,352,2,60,255487,60,176,2,60,255487,60,176
1735.884,1,8,848,8,78,247983,78,848,0,0,0,0,0
0.001,17,2,460,2,202,1,355,460,0,0,0,0,0
371.946,6,18,1239,14,177,28611,177,913,4,110,20061,110,326
0.648,6,10,1677,6,555,127,951,1354,4,159,201,159,323
1789.343,6,365,25501,212,100,8480,469,14896,153,69,11769,69,10605
0.325,17,4,420,2,33,0,33,122,2,121,0,145,298
1783.656,17,83,3480,82,14,22020,14,3444,1,8,0,8,36
2.14,6,72,52413,44,1257,49,1368,45052,28,982,71,2491,7361
1789.854,6,356,22520,208,69,8646,69,12460,148,69,12175,69,10060
1798.163,6,240,21177,149,104,12149,469,12983,91,69,19978,69,8194
0.598,6,12,965,7,182,99,182,542,5,77,124,134,423
178.941,6,63,43288,25,633,51,1360,4833,38,1230,4832,1360,38455
1757.09,6,104,8074,65,45,27454,205,4850,39,35,46228,98,3224
1774.865,6,180,15480,120,69,14914,69,8940,60,69,30073,69,6540
10.607,6,81,24461,41,550,265,1152,18720,40,459,264,1179,5741
0.869,17,17,6141,8,396,123,1350,3392,9,277,104,1350,2749
279.88,6,32,7097,14,186,8553,502,1498,18,304,16458,1420,5599
11.11,6,83,24541,41,550,277,1152,18720,42,459,263,1179,5821
1730.744,6,99,8052,66,65,26626,65,4785,33,59,54082,59,3267
1799.717,17,447,39580,403,35,4476,288,25676,44,288,40949,288,13904
32.14,6,22,6546,8,154,4591,267,792,14,576,2459,1420,5754
95.681,6,30,7802,8,153,13667,267,1250,22,333,4555,1460,6552
1747.045,6,110,7948,68,31,26075,31,4650,42,31,42609,31,3298
1.302,6,50,20576,27,983,50,1460,14880,23,433,51,1460,5696
1788.873,6,244,25025,97,67,18632,616,9183,147,136,12251,4080,15842
211.034,6,70,45248,43,1161,5024,1408,37114,27,746,2366,1408,8134
280.498,6,29,7392,14,158,21576,267,1357,15,678,20029,3456,6035
1786.145,6,106,8524,68,66,26658,66,4964,38,60,48271,60,3560
0.224,6,10,1514,5,503,56,503,771,5,475,56,475,743
1.194,6,31,12124,17,525,74,1360,3350,14,820,74,1380,8774
1746.65,6,96,7286,63,38,28171,205,4476,33,33,54570,98,2810
5.034,6,14,2351,8,188,719,245,700,6,703,951,1152,1651
18.892,17,19,6599,9,428,2356,1350,4112,10,220,2094,1350,2487
3.582,6,70,18154,36,551,102,1429,5428,34,436,98,1986,12726
1770.671,1,59,4956,59,56,30528,56,4956,0,0,0,0,0
1.925,6,25,8701,15,274,137,556,1428,10,981,194,1420,7273
1782.09,6,356,22520,208,69,8609,69,12460,148,69,12123,69,10060
4.12,17,3,174,3,30,2060,30,174,0,0,0,0,0
1563.541,1,116,12296,116,78,13596,78,12296,0,0,0,0,0
0.137,17,2,2380,2,1162,137,1162,2380,0,0,0,0,0
18.252,6,2925,2832838,1964,1367,9,1408,2778202,961,931,18,2801,54636
0.09,6,10,1514,5,503,22,503,771,5,475,22,475,743
23.665,6,31,8737,15,340,1690,721,2644,16,681,1564,1420,6093
1743.851,6,96,7286,63,38,28126,205,4476,33,33,54485,98,2810
11.058,6,20,1495,10,222,1223,222,848,10,231,1224,231,647
0.07,6,10,767,5,186,17,186,454,5,45,12,45,313
0.537,17,2,152,1,48,0,48,76,1,48,0,48,76
0.88,6,26,5947,14,142,67,267,1562,12,780,73,1460,4385
280.052,6,27,7312,13,158,23337,267,1317,14,775,21538,2800,5995
8.322,1,5,140,5,0,0,0,140,0,0,0,0,0
3.005,17,3,468,3,128,1502,128,468,0,0,0,0,0
4.938,17,6,432,3,36,2428,36,192,3,52,2429,52,240
256.301,1,2,208,2,76,256301,76,208,0,0,0,0,0
3.404,17,3,228,2,48,3050,48,152,1,48,0,48,76
174.309,2,3,96,3,8,87154,8,96,0,0,0,0,0
746.58,17,84,7065,78,30,9695,37,4545,6,392,136960,463,2520
127.038,6,22,8532,11,538,92,1309,2088,11,998,12686,1791,6444
6.807,6,40,7309,21,218,340,314,3463,19,513,364,1179,3846
1785.493,6,104,8240,68,63,26649,63,4862,36,57,51008,57,3378
158.657,17,4,352,2,60,158655,60,176,2,60,158656,60,176
0.038,17,4,284,2,32,18,32,120,2,54,22,60,164
75.197,6,11,626,5,31,13464,31,293,6,31,15039,31,333
823.863,1,12,672,12,28,74896,28,672,0,0,0,0,0
2.513,17,3,451,2,39,996,39,134,1,289,0,289,317
1755.645,6,3083,2848787,1164,143,1509,880,76941,1919,1448,915,5672,2771846
245.404,6,50,6813,26,126,9816,722,2870,24,192,10662,1408,3943
0.532,17,2,672,2,308,532,308,672,0,0,0,0,0
1798.604,6,363,24414,212,88,8524,469,14027,151,69,11988,69,10387
0.373,6,23,5080,11,137,37,267,1132,12,577,30,1400,3948
93.148,6,32,6151,10,308,1614,722,1774,22,188,4427,2026,4377
1741.861,6,87,6322,58,31,30558,31,3915,29,31,62208,31,2407
5.278,6,39,7269,21,218,263,314,3463,18,513,293,1179,3806
13.041,6,1446,1338353,938,1351,13,1408,1307273,508,931,25,2801,31080
1772.697,6,180,15480,120,69,14896,69,8940,60,69,30041,69,6540
1134.327,2,8,256,8,8,162046,8,256,0,0,0,0,0
1785.865,6,356,22520,208,69,8627,69,12460,148,69,12146,69,10060
0.013,17,2,904,1,300,0,300,328,1,548,0,548,576
1797.573,6,334,30427,195,102,9265,469,15209,139,130,13025,1452,15218
146.577,17,4,352,2,60,146576,60,176,2,60,146576,60,176
1775.231,17,142,11360,71,48,25360,48,5396,71,56,25360,56,5964
3.722,6,24,5755,13,158,308,370,1315,11,999,370,1691,4440
300.867,6,43,14410,24,867,13081,1460,8848,19,479,482,4027,5562
9.445,6,17,6735,9,275,1180,275,643,8,1440,1248,1440,6092
3.655,17,4,368,4,64,1218,64,368,0,0,0,0,0
1.521,6,34,11610,18,225,88,561,2141,16,979,89,1631,9469
25.346,6,12,6375,4,100,4021,100,264,8,964,3584,1152,6111
0.185,17,2,241,1,36,0,36,64,1,149,0,149,177
1771.375,6,99,9240,66,65,27251,65,5577,33,59,55351,59,3663
11.361,6,26,9953,13,275,946,275,1078,13,1042,844,1440,8875
14.796,6,1645,1485013,1007,1394,14,1448,1447173,638,776,22,1448,37840
1782.228,17,83,3480,82,14,22002,14,3444,1,8,0,8,36
1793.736,6,136,13429,84,66,21611,722,7060,52,83,35166,1408,6369
104.091,6,156,84058,104,801,1010,1152,80363,52,537,1950,1179,3695
99.82,6,38,8130,13,155,8318,267,1306,25,290,4151,1460,6824
1.396,6,47,18804,26,932,55,1460,13188,21,433,60,1460,5616
0.53,6,23,7406,13,335,44,668,2026,10,1210,53,1946,5380
7.893,6,18,1691,9,283,964,283,795,9,105,964,105,896
479.358,6,120,15103,56,146,7703,1189,5181,64,198,7608,1420,9922
0.391,17,3,663,2,39,386,39,134,1,501,0,501,529
1793.553,17,83,3480,82,14,22142,14,3444,1,8,0,8,36
203.705,6,32,8952,14,158,15669,267,1357,18,624,11982,1400,7595
55.054,1,20,1680,20,56,2897,56,1680,0,0,0,0,0
1.334,6,48,20117,28,892,49,1360,14541,20,433,60,1360,5576
1781.763,6,369,25799,214,100,8365,469,14976,155,69,11569,69,10823
331.202,6,24,2873,11,324,33119,585,1241,13,192,27599,580,1632
302.882,6,140,91240,84,1168,3649,1408,62938,56,906,726,3450,28302
1740.697,17,30,20190,30,645,60024,645,20190,0,0,0,0,0
1770.844,6,108,10159,70,68,25664,232,6060,38,58,47858,81,4099
18.636,17,12,1056,6,48,3725,48,456,6,72,3725,72,600
20.784,6,24,6281,13,290,1732,517,1273,11,1468,1827,2416,5008
0.526,6,12,1653,6,288,100,288,548,6,426,56,434,1105
0.101,17,4,368,2,32,100,32,120,2,96,47,96,248
0.152,17,2,2380,2,1162,152,1162,2380,0,0,0,0,0
5.081,6,36,6249,19,206,282,314,2824,17,548,300,1179,3425
0.945,17,17,7023,8,533,134,1350,4489,9,253,114,1350,2534
1.323,6,49,20186,28,894,49,1360,14570,21,476,57,2715,5616
1.313,6,41,9968,21,440,65,1360,4392,20,433,60,1360,5576
176.782,6,23,9806,13,410,50,922,1794,10,1266,19627,4416,8012
3.607,17,3,1167,3,361,1803,361,1167,0,0,0,0,0
21.512,6,17,2425,9,211,2688,211,922,8,545,3072,904,1503
280.668,6,30,7501,13,158,23389,267,1317,17,550,17527,1400,6184
1.021,17,2,116,2,30,1021,30,116,0,0,0,0,0
6.154,6,42,7405,22,218,293,314,3503,20,516,309,1179,3902
130.873,17,4,240,2,32,130871,32,120,2,32,130872,32,120
1789.947,6,4398,4399278,1390,126,1288,339,83821,3008,1418,595,5672,4315457
0.489,17,2,780,2,362,489,362,780,0,0,0,0,0
51.239,17,6,528,3,48,25615,48,228,3,72,25614,72,300
5.794,17,25,7890,10,313,643,1350,3415,15,270,232,1350,4475
1709.312,1,96,5376,96,28,17992,28,5376,0,0,0,0,0
1729.284,6,60,4400,40,33,44340,33,2740,20,31,91003,31,1660
1771.421,6,99,9306,66,66,27252,66,5610,33,60,55353,60,3696
0.465,17,4,368,2,32,227,32,120,2,96,234,96,248
120.823,6,37,8605,16,401,3529,889,1888,21,366,6035,2128,6717
1798.194,6,244,35804,152,302,11908,302,26032,92,83,19760,83,9772
114.754,6,25,6307,14,181,8827,479,1471,11,549,11466,1452,4836
1767.413,6,87,6322,58,31,31007,31,3915,29,31,63121,31,2407
0.017,17,2,146,1,37,0,37,65,1,53,0,53,81
1797.833,6,56708,45530306,25249,340,71,342,1623200,31459,1359,57,4104,43907106
1777.321,17,79,3312,78,14,23082,14,3276,1,8,0,8,36
0.926,6,11,1727,7,100,154,100,384,4,589,218,1152,1343
0.012,6,21,9444,12,134,1,134,706,9,1673,1,3453,8738
1787.734,1,86,4816,86,28,21032,28,4816,0,0,0,0,0
0.026,17,2,396,1,39,0,39,67,1,301,0,301,329
2.997,6,4,1600,2,0,2997,0,80,2,1440,1907,1440,1520
2.02,6,52,20165,27,948,77,1440,14389,25,433,72,1440,5776
346.71,6,76,13749,35,207,10197,469,5349,41,204,8667,1460,8400
1.901,17,21,14885,12,1001,172,1350,12352,9,253,233,1350,2533
11.4,6,1831,1585367,1120,1364,10,1380,1550762,711,558,16,1923,34605
0.015,6,2,80,1,0,0,0,40,1,0,0,0,40
1790.349,6,355,22480,207,69,8690,69,12420,148,69,12177,69,10060
1778.133,1,342,28728,342,56,5214,56,28728,0,0,0,0,0
1744.676,2,25,800,25,8,72694,8,800,0,0,0,0,0
0.204,17,8,2750,8,315,29,354,2750,0,0,0,0,0
1790.879,1,63,5292,63,56,28885,56,5292,0,0,0,0,0
1787.536,1,192,10752,192,28,9358,28,10752,0,0,0,0,0
96.342,6,26,6311,10,267,89,501,1205,16,343,6416,1420,5106
0.282,6,2,80,1,0,0,0,40,1,0,0,0,40
0.26,17,4,1162,4,262,86,294,1162,0,0,0,0,0
0.153,6,10,1569,5,627,38,627,895,5,406,38,406,674
53.471,2,2,64,2,8,53471,8,64,0,0,0,0,0
0.076,17,2,181,1,32,0,32,60,1,93,0,93,121
1744.683,6,99,7895,65,64,27260,64,4648,34,57,52866,58,3247
0.46,6,26,9013,13,257,38,669,1714,13,945,34,1438,7299
247.183,6,40,13340,26,387,9887,1360,6497,14,783,18999,3494,6843
0.617,17,2,780,2,362,617,362,780,0,0,0,0,0
0.044,17,2,172,1,50,0,50,78,1,66,0,66,94
768.48,6,70,8415,40,94,19700,722,3888,30,155,26493,1408,4527
312.089,17,20,5088,12,40,28371,41,824,8,505,44440,505,4264
8.479,6,1490,1405442,939,1419,8,1448,1372114,551,776,15,1448,33328
7.044,17,4,488,4,94,2348,94,488,0,0,0,0,0
1674.367,1,8,448,8,28,239195,28,448,0,0,0,0,0
1795.358,1,252,14112,252,28,7152,28,14112,0,0,0,0,0
103.407,17,4,352,2,60,103406,60,176,2,60,103406,60,176
20.374,17,15,8193,8,539,2898,1350,4541,7,493,2956,1350,3652
1745.71,6,95,7203,63,38,28156,205,4476,32,33,56304,98,2727
1.285,6,53,19841,29,918,45,1360,14060,24,400,48,1360,5781
27.33,17,20,10908,10,670,3032,1350,6984,10,364,3032,1350,3924
0.958,6,22,7996,14,400,73,663,2736,8,967,132,1946,5260
1796.244,6,374,23654,214,69,8433,69,13114,160,69,11296,69,10540
1797.518,6,378,26366,218,97,8283,469,15481,160,69,11303,69,10885
74.164,6,49,10344,24,541,716,910,3231,25,435,3084,2128,7113
1668.538,1,8,448,8,28,238362,28,448,0,0,0,0,0
0.048,17,2,157,1,31,0,31,59,1,70,0,70,98
1744.663,2,25,800,25,8,72694,8,800,0,0,0,0,0
45.223,6,24,10393,8,241,6460,722,1376,16,815,2995,1408,9017
0.117,6,10,520,0,0,0,0,0,10,0,0,0,520
0.017,6,10,1903,5,657,4,657,925,5,710,4,710,978
1773.666,1,59,4956,0,0,0,0,0,59,56,30580,56,4956
1134.264,2,7,224,7,8,189044,8,224,0,0,0,0,0
185.169,17,4,240,2,32,185168,32,120,2,32,185168,32,120
280.728,6,53,16722,33,574,8772,1460,11120,20,399,457,1460,5602
1.349,6,42,11430,22,547,64,1360,5854,20,433,60,1360,5576
1790.933,17,180,11520,180,36,10005,36,11520,0,0,0,0,0
1635.402,17,15,6975,15,437,116814,1431,6975,0,0,0,0,0
1760.81,6,133,13273,75,62,23794,722,6266,58,90,30885,1448,7007
0.023,17,4,352,2,37,13,37,130,2,83,12,89,222
34.735,6,4564,4374730,3040,1363,11,1408,4290818,1524,776,22,1408,83912
1797.195,1,81,6804,0,0,0,0,0,81,56,22464,56,6804
0.931,6,10,1687,7,100,155,100,384,3,1179,334,1179,1303
1777.331,1,63,5292,63,56,28666,56,5292,0,0,0,0,0
1740.563,17,30,31595,30,1025,60019,1028,31595,0,0,0,0,0
1744.315,6,95,7203,63,38,28134,205,4476,32,33,56258,98,2727
1.053,6,28,8481,15,225,62,561,1985,13,994,71,1791,6496
2.053,6,14,2351,8,188,293,245,700,6,703,358,1152,1651
0.527,6,21,7290,12,335,47,668,1974,9,968,64,1475,5316
4.008,17,8,1152,4,64,1329,64,368,4,168,1330,192,784
0.347,17,6,2149,6,330,69,361,2149,0,0,0,0,0
86.399,6,94,68729,60,1237,1464,1408,58838,34,676,2611,1408,9891
5.809,6,41,7365,22,218,276,314,3503,19,516,308,1179,3862
0.687,6,10,924,5,283,136,283,551,5,105,129,105,373
1779.925,17,140,11200,70,48,25795,48,5320,70,56,25795,56,5880
1795.646,1,264,14784,264,28,6827,28,14784,0,0,0,0,0
9.001,6,3,180,3,0,0,0,180,0,0,0,0,0
45.334,1,12,1248,0,0,0,0,0,12,76,4121,76,1248
0.023,6,11,1566,6,503,4,503,823,5,475,5,475,743
0.044,17,3,244,2,32,19,32,120,1,96,0,96,124
17.4,17,31,11214,14,386,1336,1350,5797,17,290,1085,1350,5417
0.023,6,4,208,2,0,12,0,104,2,0,23,0,104
30.025,17,4,702,2,31,30020,33,118,2,264,30020,278,584
157.922,1,6,336,6,28,31584,28,336,0,0,0,0,0
0.042,6,3,168,2,0,1,0,104,1,0,0,0,64
1798.005,17,444,38632,401,34,4495,288,25044,43,288,41924,288,13588
1743.415,1,78,6552,0,0,0,0,0,78,56,22641,56,6552
1739.392,1,15,840,15,28,124242,28,840,0,0,0,0,0
5.013,17,4,766,2,47,5002,47,150,2,280,4952,280,616
0.264,17,2,152,1,48,0,48,76,1,48,0,48,76
63.659,1,9,504,9,28,7957,28,504,0,0,0,0,0
0.672,6,12,1163,6,222,132,222,688,6,231,132,231,475
1.239,6,50,19830,28,868,45,1360,14174,22,433,51,1360,5656
1740.127,6,87,6322,58,31,30528,31,3915,29,31,62146,31,2407
0.09,6,12,964,6,181,18,181,489,6,77,16,134,475
210.855,6,130,95921,80,1266,2669,1408,85197,50,811,2030,3847,10724
1769.912,6,100,9357,67,65,26816,65,5694,33,59,55306,59,3663
1638.075,2,13,416,13,8,136506,8,416,0,0,0,0,0
1763.785,2,15,480,15,8,125984,8,480,0,0,0,0,0
1797.937,6,375,26177,217,98,8323,469,15372,158,69,11448,69,10805
0.594,6,5,208,3,0,297,0,124,2,0,334,0,84
0.41,6,6,324,4,0,136,0,216,2,0,215,0,108
0.555,6,21,7281,13,334,46,663,2021,8,967,72,1471,5260
1714.36,1,8,448,8,28,244908,28,448,0,0,0,0,0
1799.374,1,58,4872,58,56,31567,56,4872,0,0,0,0,0
240.595,2,3,96,3,8,120297,8,96,0,0,0,0,0
0.068,6,10,766,5,185,16,185,453,5,45,14,45,313
0.82,17,2,925,1,548,0,548,576,1,321,0,321,349
0.997,17,2,677,1,300,0,300,328,1,321,0,321,349
1.348,6,10,1687,7,100,224,100,384,3,1179,547,1179,1303
1783.745,17,83,3480,82,14,22021,14,3444,1,8,0,8,36
248.895,6,54,7824,24,332,10821,1056,3653,30,185,8582,580,4171
1744.625,2,27,864,27,8,67100,8,864,0,0,0,0,0
1784.839,1,67,5628,0,0,0,0,0,67,56,27043,56,5628
1794.977,6,356,22520,208,69,8671,69,12460,148,69,12210,69,10060
4.147,17,4,304,4,48,1382,48,304,0,0,0,0,0
0.473,6,27,9157,13,277,39,747,1804,14,943,34,1368,7353
8.528,6,78,24890,40,568,218,1152,19229,38,459,223,1179,5661
0.115,6,15,4873,9,290,14,517,1057,6,874,20,1418,3816
60.173,2,2,64,2,8,60173,8,64,0,0,0,0,0
769.933,17,62,4960,31,48,25664,48,2356,31,56,25664,56,2604
1777.999,1,8,448,8,28,253999,28,448,0,0,0,0,0
0.07,17,4,284,2,32,18,32,120,2,54,54,60,164
7.436,6,64,20526,34,559,225,1152,15915,30,486,247,1179,4611
280.381,6,30,7432,13,158,23365,267,1317,17,603,17521,2076,6115
183.854,6,38,10937,20,394,9669,1275,3811,18,516,10807,2816,7126
3.951,17,8,1932,4,60,1313,60,352,4,367,1312,400,1580
0.652,6,15,2638,7,288,75,288,600,8,568,64,853,2038
0.038,17,2,154,1,33,0,33,61,1,65,0,65,93
1680.413,17,28,6468,28,203,62237,203,6468,0,0,0,0,0
1.402,6,49,21070,28,952,51,1360,15454,21,476,61,2715,5616
0.224,17,2,180,1,30,0,30,58,1,94,0,94,122
23.969,6,34,8166,16,188,1597,722,1962,18,608,1384,2760,6204
12.713,17,2,152,2,48,12713,48,152,0,0,0,0,0
3.874,6,7,376,4,0,1291,0,216,3,0,1848,0,160
3.987,17,4,248,4,34,1329,34,248,0,0,0,0,0
0.087,17,2,602,1,46,0,46,74,1,500,0,500,528
1.188,6,25,8056,12,164,91,267,1288,13,869,83,1448,6768
10.779,17,268,356778,265,1317,33,1472,356658,3,12,4999,12,120
1787.935,17,142,11360,71,48,25541,48,5396,71,56,25541,56,5964
5.404,6,39,7285,20,218,284,314,3423,19,516,285,1179,3862
0.211,6,9,1340,5,145,52,145,349,4,827,38,827,991
282.631,6,33,7552,14,158,21740,267,1357,19,543,15699,1400,6195
1798.883,17,763,46046,763,32,2360,37,46046,0,0,0,0,0
33.771,6,32,5146,15,154,2412,722,1859,17,342,2100,1402,3287
13.658,6,24,4712,12,154,1221,722,1716,12,592,1224,1408,2996
0.166,17,4,624,2,64,165,64,184,2,192,48,192,440
61.892,6,68,47484,43,1199,1473,1408,39450,25,747,2569,1408,8034
123.924,6,124,93674,77,1296,1630,1448,83113,47,675,1690,1448,10561
295.986,6,36,8086,13,158,24665,267,1317,23,365,13453,1400,6769
3.009,6,13,1499,7,299,500,299,679,6,246,599,459,820
0.447,6,27,8942,13,232,37,569,1614,14,941,31,1438,7328
1789.365,6,121,14499,79,85,22940,516,6404,42,160,43640,1420,8095
1788.253,6,356,22520,208,69,8638,69,12460,148,69,12164,69,10060
0.026,17,2,329,1,45,0,45,73,1,228,0,228,256
60.145,6,41,30756,27,570,2313,991,3705,14,2392,4623,11115,27051
244.922,17,4,352,2,60,244921,60,176,2,60,244921,60,176
1786.276,17,87,3648,86,14,21015,14,3612,1,8,0,8,36
1744.735,2,28,896,28,8,64619,8,896,0,0,0,0,0
12.22,6,1936,1690695,1178,1381,10,1420,1656142,758,467,16,1883,34553
352.527,6,19,6399,2,112,518,112,200,17,367,22032,1420,6199
0.02,17,4,284,2,32,1,32,120,2,54,8,60,164
4.007,17,4,240,4,32,1335,32,240,0,0,0,0,0
0.017,17,2,144,1,36,0,36,64,1,52,0,52,80
1777.91,17,142,11360,71,48,25398,48,5396,71,56,25397,56,5964
3.483,6,42,15558,22,342,165,790,4038,20,973,174,1591,11520
1763.273,17,112,19730,112,148,15885,358,19730,0,0,0,0,0
35.214,6,46,14250,23,315,1600,721,3453,23,896,1591,1440,10797
1799.999,6,83,4860,42,31,43902,36,2246,41,241,43740,456,2614
1780.637,6,355,22549,207,69,8643,69,12420,148,69,12113,69,10129
280.065,6,30,7432,13,158,23338,267,1317,17,543,17499,1400,6115
61.095,6,8,416,8,0,0,0,416,0,0,0,0,0
16.7,6,13,5586,4,106,5566,106,274,9,822,2050,1420,5312
4.504,17,29,10142,13,413,375,1350,5742,16,247,243,1350,4400
126.717,6,22,9856,11,380,95,832,1613,11,1298,12656,2720,8243
159.037,6,42,10099,14,269,12231,1189,2721,28,297,5889,1460,7378
3.677,17,10,900,5,30,907,30,290,5,94,911,94,610
0.277,6,9,1148,5,145,69,145,349,4,635,63,635,799
251.445,2,2,64,2,8,251445,8,64,0,0,0,0,0
372.376,6,27,1767,18,177,21904,177,1181,9,110,8925,110,586
1799.726,17,144,11520,72,48,25348,48,5472,72,56,25348,56,6048
280.306,6,30,7432,13,158,23358,267,1317,17,543,17514,1400,6115
280.582,6,30,7432,13,158,23381,267,1317,17,603,17532,2076,6115
1753.134,6,95,7203,63,38,28276,205,4476,32,33,56542,98,2727
0.16,6,43,18055,24,1006,6,1420,13062,19,467,8,1883,4993
222.861,6,28,7352,13,158,18571,267,1317,15,678,15915,3436,6035
9.993,17,3,2046,3,654,4996,654,2046,0,0,0,0,0
0.997,6,3,128,2,0,997,0,84,1,0,0,0,44
1786.199,1,158,8848,158,28,11377,28,8848,0,0,0,0,0
11.626,6,1829,1599848,1113,1382,10,1420,1566987,716,467,16,1883,32861
106.848,6,25,11118,12,433,76,990,1823,13,973,8892,1440,9295
902.494,2,10,320,10,8,100277,8,320,0,0,0,0,0
0.111,17,2,194,1,61,0,61,89,1,77,0,77,105
0.191,6,41,17674,24,982,8,1420,12773,17,467,11,1883,4901
3.066,17,4,660,2,30,3055,30,116,2,244,3056,244,544
128.483,17,12,960,6,48,25694,48,456,6,56,25694,56,504
2.253,6,29,10457,17,368,140,837,1789,12,1023,197,1420,8668
358.211,2,4,128,4,8,119403,8,128,0,0,0,0,0
0.154,6,22,10013,11,136,15,136,716,11,1089,15,1448,9297
11.438,6,1810,1579910,1096,1388,10,1420,1547129,714,467,16,1883,32781
152.968,6,7,382,3,0,76484,0,152,4,7,50914,7,230
1.516,17,31,24534,16,822,101,1350,13607,15,700,89,1350,10927
1700.608,17,12,498,11,14,170060,14,462,1,8,0,8,36
4.619,6,3,180,3,0,0,0,180,0,0,0,0,0
1674.569,1,7,392,7,28,279094,28,392,0,0,0,0,0
1791.275,1,58,4872,0,0,0,0,0,58,56,31425,56,4872
1.439,6,53,23889,30,997,49,1460,18193,23,433,55,1460,5696
86.185,6,777,388734,436,832,198,1152,369589,341,392,252,1152,19145
0.515,17,2,476,1,39,0,39,67,1,381,0,381,409
1765.255,6,195,19895,105,83,16973,721,9949,90,191,14856,1440,9946
1019.502,2,8,256,8,8,145643,8,256,0,0,0,0,0
1740.809,17,30,20190,30,645,60027,645,20190,0,0,0,0,0
0.287,6,171,157462,115,201,2,230,7389,56,2725,4,14173,150073
4.99,6,42,7389,21,218,249,314,3463,21,440,237,1152,3926
1787.873,6,362,22898,210,69,8554,69,12678,152,69,11840,69,10220
1795.674,17,142,11360,71,48,25652,48,5396,71,56,25651,56,5964
1788.861,17,83,3480,82,14,22084,14,3444,1,8,0,8,36
35.698,17,4,352,2,60,35697,60,176,2,60,35697,60,176
0.015,17,2,182,1,44,0,44,72,1,82,0,82,110
0.386,17,2,152,1,48,0,48,76,1,48,0,48,76
1.76,17,2,198,1,39,0,39,67,1,103,0,103,131
0.255,17,3,451,2,39,240,39,134,1,289,0,289,317
11.188,6,27,11433,13,275,932,275,1078,14,1087,803,1440,10355
1793.133,6,244,35804,152,302,11875,302,26032,92,83,19704,83,9772
292.535,6,33,6981,16,262,19499,517,1628,17,744,18280,1418,5353
0.165,17,2,142,1,35,0,35,63,1,51,0,51,79
0.267,6,9,1339,5,145,66,145,349,4,826,28,826,990
9.189,6,17,6735,9,275,1148,275,643,8,1440,1234,1440,6092
1793.78,2,25,800,25,8,74740,8,800,0,0,0,0,0
4.93,6,41,7349,21,201,246,314,3463,20,513,246,1179,3886
1771.875,6,180,15480,120,69,14889,69,8940,60,69,30031,69,6540
4.471,6,4,184,3,0,2145,0,144,1,0,0,0,40
44.743,17,22,1936,11,48,4473,48,836,11,72,4473,72,1100
1682.063,17,14,1036,7,30,280338,30,406,7,62,280338,62,630
1788.039,6,356,22589,207,69,8679,69,12420,149,69,12078,69,10169
1.522,17,373,395996,88,141,17,1350,14913,285,1309,5,1350,381083
1770.629,6,103,9448,66,65,27240,65,5577,37,59,49180,59,3871
11.449,6,2,1175,1,0,0,0,40,1,1095,0,1095,1135
1783.964,6,104,8308,68,64,26626,64,4896,36,58,50968,58,3412
2.722,6,22,4103,11,288,259,288,1068,11,639,254,853,3035
1789.463,17,142,11360,71,48,25563,48,5396,71,56,25563,56,5964
1707.219,1,8,448,8,28,243888,28,448,0,0,0,0,0
1796.521,6,123,12310,77,62,23638,722,6403,46,94,39914,1440,5907
0.059,17,2,472,1,60,0,60,88,1,356,0,356,384
282.472,6,29,7392,13,158,23539,267,1317,16,603,18810,2036,6075
300.638,6,52,32145,32,1219,9698,1440,26092,20,715,1401,1440,6053
0.005,17,2,394,1,37,0,37,65,1,301,0,301,329
1799.504,6,686,121597,439,304,4108,304,90104,247,83,7315,83,31493
34.31,17,20,1520,20,48,1805,48,1520,0,0,0,0,0
1787.27,6,102,8296,68,65,26675,65,4930,34,59,54155,59,3366
242.624,6,48,22330,22,442,11545,1360,4908,26,1023,9698,2720,17422
790.307,6,47,3640,34,34,23948,94,2420,13,41,50366,170,1220
1.293,6,41,9968,21,440,64,1360,4392,20,433,58,1360,5576
18.925,6,14,2245,8,211,2692,211,846,6,545,3784,904,1399
7.285,6,23,4490,12,213,662,597,1689,11,552,708,1767,2801
0.186,6,27,7296,13,155,15,267,1301,14,603,12,1400,5995
1742.334,6,97,7307,63,38,28102,205,4476,34,33,52787,98,2831
4.284,6,39,7285,20,218,225,314,3423,19,516,223,1179,3862
1439.397,2,13,416,13,8,119949,8,416,0,0,0,0,0
0.346,17,4,420,2,33,0,33,122,2,121,0,145,298
9.122,6,84,26317,43,559,217,1152,20179,41,449,221,1179,6138
7.405,6,864,756025,526,1356,13,1368,730205,338,931,21,2736,25820
1373.377,6,283,21004,163,99,8477,1093,11373,120,94,11540,965,9631
1790.57,1,240,13440,240,28,7491,28,13440,0,0,0,0,0
156.234,6,19,2445,11,324,15623,585,1229,8,396,22309,580,1216
79.397,6,9848,9497310,6613,1359,11,1408,9324414,3235,776,24,1408,172896
1798.75,1,54,4536,0,0,0,0,0,54,56,33938,56,4536
0.742,6,6,319,3,0,371,0,152,3,7,218,7,167
2.85,6,23,6595,12,350,258,1420,2235,11,783,284,1420,4360
1750.565,17,12,498,11,14,175056,14,462,1,8,0,8,36
1783.226,17,284,95438,284,308,6301,329,95438,0,0,0,0,0
1729.771,6,76,13759,49,111,36036,1408,5131,27,300,66522,2816,8628
0.148,17,2,192,1,60,0,60,88,1,76,0,76,104
0.393,6,12,1653,6,288,76,288,548,6,426,43,434,1105
1616.17,1,8,448,8,28,230881,28,448,0,0,0,0,0
9.104,6,20,12188,8,275,1300,275,874,12,1353,733,1414,11314
1.361,6,34,14518,18,529,80,1440,3422,16,870,79,1440,11096
48.437,6,50,12808,24,957,664,1460,6811,26,290,1930,1460,5997
63.065,17,8,1818,8,199,9009,206,1818,0,0,0,0,0
1786.587,6,106,8456,68,65,26665,65,4930,38,59,48283,59,3526
310.804,6,15,1086,11,180,31080,180,760,4,110,20080,110,326
0.989,6,26,9893,14,350,76,1042,1993,12,1058,73,1360,7900
12.034,6,1753,1631851,1151,1369,10,1380,1602368,602,387,19,1923,29483
1786.745,6,102,8364,68,66,26667,66,4964,34,60,54140,60,3400
1796.742,6,353,22400,206,69,8764,69,12380,147,69,12306,69,10020
76.271,6,39,10156,20,627,4014,1360,3340,19,464,482,1360,6816
1787.728,6,115,13783,75,82,24158,502,5984,40,163,45836,1420,7799
1747.19,6,94,7151,62,38,28642,205,4424,32,33,56351,98,2727
1773.33,6,180,15480,120,69,14901,69,8940,60,69,30051,69,6540
3.027,6,26,7553,13,265,252,764,1767,13,847,250,2365,5786
0.051,17,4,420,2,33,0,33,122,2,121,9,145,298
9.975,6,83,24541,41,550,249,1152,18720,42,459,236,1179,5821
0.138,17,2,259,1,53,0,53,81,1,150,0,150,178
212.141,6,61,9657,31,107,7071,267,2655,30,304,7314,1460,7002
1790.143,6,764,51822,379,31,4735,31,25863,385,31,4661,31,25959
1.39,6,51,19053,27,871,53,1360,13317,24,433,52,1360,5736
1799.965,6,359,23647,210,81,8612,469,13478,149,69,12161,69,10169
280.319,17,4,296,2,30,280296,30,116,2,62,280303,62,180
0.516,6,29,9263,13,263,43,688,1748,16,832,31,1368,7515
1788.364,1,8,448,8,28,255480,28,448,0,0,0,0,0
7.801,6,32,7853,14,158,600,267,1357,18,524,458,1400,6496
1.873,6,6,340,3,0,936,0,160,3,0,507,0,180
365.889,6,105,14046,50,154,7467,1189,4941,55,229,6773,1460,9105
15.254,17,23,5647,10,260,1691,1350,2884,13,184,1268,1350,2763
163.881,17,4,352,2,60,163880,60,176,2,60,163880,60,176
1.217,6,48,19601,27,919,46,1360,13985,21,476,52,2720,5616
1.913,17,365,395535,76,102,25,1350,9920,289,1306,6,1350,385615
103.013,6,23,9674,13,447,56,1360,2342,10,1384,11429,3934,7332
215.759,17,4,352,2,60,215758,60,176,2,60,215757,60,176
6.214,6,1694,1537568,1047,1389,5,1408,1499260,647,931,9,2801,38308
293.159,6,35,7088,17,262,18319,517,1680,18,744,17241,1418,5408
1.351,6,50,19691,27,920,51,1440,13995,23,433,53,1440,5696
430.036,17,144,9888,144,40,3007,41,9888,0,0,0,0,0
1770.772,6,103,9448,66,65,27242,65,5577,37,59,49185,59,3871
691.837,6,32,2117,21,330,34591,330,1454,11,83,24046,83,663
62.524,6,63,43025,40,1178,1603,1448,35077,23,843,2828,2359,7948
0.252,6,23,5080,11,137,25,267,1132,12,577,21,1400,3948
1788.922,17,87,3648,86,14,21046,14,3612,1,8,0,8,36
0.074,17,2,168,1,48,0,48,76,1,64,0,64,92
0.0,17,1,1480,1,1452,0,1452,1480,0,0,0,0,0
1773.204,6,180,15480,120,69,14900,69,8940,60,69,30046,69,6540
0.302,17,2,212,1,46,0,46,74,1,110,0,110,138
1776.46,17,73,3060,72,14,25020,14,3024,1,8,0,8,36
14.752,17,54,10862,24,210,639,1350,5719,30,143,507,1350,5143
0.055,6,15,4072,8,88,7,88,440,7,1670,9,1880,3632
7.996,6,14,1156,6,283,1564,283,603,8,105,1117,105,553
368.758,6,23,1523,15,177,26339,177,989,8,110,9199,110,534
0.379,17,3,543,2,39,373,39,134,1,381,0,381,409
0.411,6,6,324,4,0,137,0,216,2,0,217,0,108
1749.257,6,157,9915,83,50,21332,208,6056,74,31,23958,31,3859
0.387,6,17,6096,9,70,47,133,504,8,1317,53,1414,5592
167.532,17,4,352,2,60,167531,60,176,2,60,167531,60,176
240.179,6,54,17771,29,741,8577,1402,14856,25,200,10007,580,2915
1741.239,6,105,7590,65,31,27206,31,4420,40,31,44645,31,3170
0.033,17,2,167,1,39,0,39,67,1,72,0,72,100
1772.845,6,183,15738,121,69,14773,69,8980,62,69,29059,69,6758
0.961,6,17,5164,9,150,120,174,664,8,835,120,1452,4500
373.607,6,25,1651,17,177,23350,177,1117,8,110,9236,110,534
0.858,6,11,1727,7,100,143,100,384,4,589,202,1152,1343
603.261,6,156,15602,78,88,7834,267,5515,78,193,7820,1420,10087
1795.688,6,367,25650,214,99,8430,469,15045,153,69,11811,69,10605
295.316,17,6,360,3,32,147657,32,180,3,32,147657,32,180
1.105,6,25,8068,12,164,85,267,1300,13,869,78,1408,6768
0.234,6,9,464,6,46,28,46,298,3,46,116,46,166
1.109,6,24,8004,11,164,94,267,1236,13,869,78,1448,6768
1775.103,6,180,15480,120,69,14916,69,8940,60,69,30082,69,6540
560.446,17,6,1647,3,30,280217,30,174,3,463,280217,463,1473
316.73,6,110,37221,56,618,5758,1460,26432,54,287,5973,1629,10789
0.052,17,2,904,1,300,0,300,328,1,548,0,548,576
7.392,6,50,13814,24,330,321,721,3278,26,632,278,2840,10536
1795.092,17,80,3354,79,14,23014,14,3318,1,8,0,8,36
1794.601,1,59,4956,59,56,30941,56,4956,0,0,0,0,0
6.019,6,987,894601,616,1377,9,1408,870633,371,776,15,1408,23968
15.242,6,2443,2284140,1529,1414,9,1448,2231924,914,776,16,1448,52216
22.636,6,50,21843,23,723,1022,1460,6109,27,973,865,1460,15734
1786.593,6,104,8444,68,66,26665,66,4964,36,60,51043,60,3480
2.068,6,16,2978,8,288,281,288,928,8,568,270,853,2050
1712.279,1,8,448,8,28,244611,28,448,0,0,0,0,0
179.087,17,4,352,2,60,179085,60,176,2,60,179086,60,176
1.186,6,26,8905,14,288,91,796,1747,12,1111,87,2370,7158
53.062,6,26,7137,13,155,4421,267,1306,13,589,4421,4837,5831
0.438,6,6,324,4,0,146,0,216,2,0,191,0,108
24.054,6,838,664463,491,1324,49,1360,643468,347,230,69,1360,20995
1090.818,17,216,16416,216,48,5073,48,16416,0,0,0,0,0
550.727,17,20,6720,20,308,28985,308,6720,0,0,0,0,0
40.086,17,4,3100,4,747,13362,1451,3100,0,0,0,0,0
0.051,17,2,218,1,34,0,34,62,1,128,0,128,156
240.197,6,53,18048,28,803,8896,1408,15126,25,201,10008,580,2922
894.502,6,12,728,8,31,127786,31,444,4,31,298164,31,284
0.334,17,8,2766,8,317,47,356,2766,0,0,0,0,0
240.779,6,56,17559,28,769,8917,1418,14550,28,192,8917,580,3009
1773.281,6,180,15480,120,69,14901,69,8940,60,69,30047,69,6540
0.007,6,2,80,1,0,0,0,40,1,0,0,0,40
1772.319,6,180,15480,120,69,14893,69,8940,60,69,30035,69,6540
9.535,2,2,64,2,8,9535,8,64,0,0,0,0,0
1787.04,6,102,8228,68,64,26672,64,4896,34,58,54150,58,3332
0.072,6,3,607,2,231,1,432,567,1,0,0,0,40
1798.532,17,448,39896,403,35,4473,288,25676,45,288,40021,288,14220
1768.833,6,99,9240,66,65,27212,65,5577,33,59,55271,59,3663
0.487,6,21,5000,11,137,48,267,1132,10,692,50,1467,3868
240.646,6,52,17701,28,798,8912,1418,15042,24,200,10462,580,2659
0.509,6,10,1671,6,552,101,948,1348,4,159,169,159,323
1798.421,6,363,24414,212,88,8523,469,14027,151,69,11987,69,10387
3.413,6,14,2209,7,324,566,585,1029,7,396,567,580,1180
0.471,6,27,9152,13,268,39,710,1770,14,947,33,1368,7382
90.026,6,5,214,3,0,45013,0,132,2,1,45002,1,82
169.039,17,596,641212,581,1074,291,1252,640604,15,12,3745,16,608
1750.498,6,102,8032,67,45,26522,205,4985,35,35,51474,98,3047
11.708,6,1854,1600111,1130,1363,10,1380,1566873,724,425,16,1923,33238
1760.808,6,80,3200,40,0,45148,0,1600,40,0,45148,0,1600
7.983,6,11,5498,4,106,2661,106,274,7,987,1265,1420,5224
1791.842,1,284,15904,284,28,6331,28,15904,0,0,0,0,0
80.496,17,4,352,2,60,80495,60,176,2,60,80495,60,176
133.991,6,48,17829,25,415,5582,661,4478,23,776,5933,1360,13351
755.951,6,155,15686,80,84,8532,267,5573,75,186,10215,1452,10113
0.604,6,133,89325,72,1306,8,1432,82594,61,427,9,1432,6731
71.526,6,21,7226,11,321,7152,517,1235,10,910,7829,1408,5991
139.988,6,30,7432,13,158,11665,267,1317,17,543,8739,1400,6115
0.282,17,2,144,1,36,0,36,64,1,52,0,52,80
0.298,6,21,7281,12,334,26,663,1969,9,967,33,1471,5312
1797.576,17,348,26448,348,48,5180,48,26448,0,0,0,0,0
2.51,6,104,63364,59,1296,43,1432,53044,45,531,48,1871,10320
280.038,6,25,7232,12,158,25458,267,1277,13,905,23333,4845,5955
0.069,6,2,80,1,0,0,0,40,1,0,0,0,40
240.67,6,45,9019,21,519,12033,1402,5774,24,221,10463,618,3245
2.888,6,9,527,5,43,722,43,311,4,0,961,0,216
0.408,17,14,5237,6,364,81,1350,2356,8,332,26,1350,2881
1786.077,1,61,5124,61,56,29767,56,5124,0,0,0,0,0
1793.815,1,114,6384,114,28,15874,28,6384,0,0,0,0,0
1768.875,6,99,9306,66,66,27213,66,5610,33,60,55273,60,3696
1776.383,17,73,3060,72,14,25019,14,3024,1,8,0,8,36
1681.008,1,30,1680,30,28,57965,28,1680,0,0,0,0,0
28.776,6,67,33178,38,907,777,1460,12506,29,1025,960,2920,20672
8.314,6,1801,1657821,1107,1417,7,1448,1617069,694,776,11,1448,40752
1790.982,6,363,23007,210,69,8569,69,12678,153,69,11782,69,10329
378.435,2,3,96,3,8,189217,8,96,0,0,0,0,0
19.285,6,2772,2711230,1806,1424,10,1448,2656298,966,776,19,1448,54932
10.642,6,1668,1540802,1037,1407,10,1448,1503326,631,776,16,1448,37476
0.256,17,2,384,1,39,0,39,67,1,289,0,289,317
1723.659,17,143,24226,143,141,12138,377,24226,0,0,0,0,0
1782.336,1,116,6496,116,28,15498,28,6496,0,0,0,0,0
1743.053,6,96,7288,63,38,28113,205,4476,33,33,54457,98,2812
1762.571,6,135,9004,74,54,24142,208,5417,61,31,29373,31,3587
5.856,6,27,5095,15,232,418,597,2183,12,453,514,1767,2912
27.425,6,43,8656,23,367,1246,786,2102,20,522,629,3488,6554
1799.605,17,450,39960,405,35,4454,288,25740,45,288,40022,288,14220
0.995,17,2,134,2,39,995,39,134,0,0,0,0,0
1.992,17,17,9758,8,376,284,1350,3238,9,696,237,1350,6520
4.981,17,4,514,2,36,4973,36,128,2,165,4976,187,386
14.128,6,20,4438,10,275,1569,275,954,10,768,1412,1440,3484
1783.817,6,365,25432,213,100,8414,469,14936,152,69,11813,69,10496
0.556,17,4,624,2,64,554,64,184,2,192,436,192,440
1.375,6,31,6467,14,164,105,267,1882,17,650,76,1452,4585
0.027,17,2,251,1,36,0,36,64,1,159,0,159,187
276.96,6,87,12916,43,179,6594,1189,4247,44,287,6436,1460,8669
125.749,6,165,131656,108,1275,1175,1408,119182,57,730,2177,3847,12474
2.212,17,24,8964,10,363,245,1350,3914,14,332,148,1350,5050
0.613,17,3,451,2,39,200,39,134,1,289,0,289,317
242.817,6,42,4596,21,180,12140,595,2228,21,158,12140,580,2368
87.003,6,807,381006,419,842,208,1152,360354,388,394,224,1152,20652
9.27,6,1403,1276810,904,1362,10,1420,1252511,499,427,18,1420,24299
381.051,1,9,504,9,28,47631,28,504,0,0,0,0,0
1787.363,6,102,8296,68,65,26677,65,4930,34,59,54158,59,3366
219.19,6,26,2825,13,324,18265,585,1333,13,396,18265,580,1492
1786.653,6,102,8364,68,66,26666,66,4964,34,60,54138,60,3400
0.296,17,2,152,1,48,0,48,76,1,48,0,48,76
0.1,17,2,2380,2,1162,100,1162,2380,0,0,0,0,0
3.188,17,5,290,5,30,797,30,290,0,0,0,0,0
82.592,17,3,228,3,48,41296,48,228,0,0,0,0,0
1789.177,1,9,504,9,28,223647,28,504,0,0,0,0,0
1789.607,1,266,14896,266,28,6753,28,14896,0,0,0,0,0
1.181,6,25,8056,12,164,91,267,1288,13,869,84,1448,6768
2.281,6,13,2311,8,188,325,245,700,5,1407,509,1407,1611
246.087,6,41,11005,20,1266,12951,1408,8721,21,293,12304,293,2284
1787.154,6,102,8296,68,65,26673,65,4930,34,59,54152,59,3366
0.363,6,8,440,4,0,121,0,216,4,0,116,0,224
1746.055,6,95,7203,63,38,28162,205,4476,32,33,56310,98,2727
1746.763,6,101,7974,66,45,26873,205,4927,35,35,51369,98,3047
1782.338,17,83,3480,82,14,22004,14,3444,1,8,0,8,36
12.695,6,1864,1630383,1146,1367,11,1380,1594749,718,383,17,1380,35634
130.118,6,22,8602,8,275,18588,275,599,14,676,9961,1414,8003
1.354,6,24,8004,12,164,103,267,1288,12,1014,104,2491,6716
7.932,17,4,352,2,60,7930,60,176,2,60,7931,60,176
180.425,2,3,96,3,8,90212,8,96,0,0,0,0,0
278.99,17,34,2516,34,46,8454,46,2516,0,0,0,0,0
1093.536,6,971,919448,324,135,3385,347,21902,647,1435,1692,4254,897546
120.683,6,19,7406,10,220,13409,516,1285,9,822,7217,1452,6121
6.754,6,564,484899,349,1322,18,1368,469055,215,931,30,2736,15844
0.256,6,5,212,3,0,128,0,132,2,0,175,0,80
34.555,17,4,824,2,48,34550,48,152,2,308,34549,308,672
11.997,6,21,6825,12,275,1090,275,1038,9,1353,870,1440,5787
17.109,17,35,14628,17,628,1067,1350,11168,18,164,1004,1350,3460
11.986,17,4,352,2,48,11976,48,152,2,72,11974,72,200
1793.278,17,87,3648,86,14,21097,14,3612,1,8,0,8,36
121.983,17,4,352,2,60,121981,60,176,2,60,121981,60,176
257.108,1,12,672,12,28,23373,28,672,0,0,0,0,0
5.541,6,14,2351,8,188,791,245,700,6,703,1054,1152,1651
1746.023,6,96,7255,63,38,28161,205,4476,33,33,54555,98,2779
0.019,17,4,344,2,47,11,47,150,2,69,12,75,194
1746.342,6,90,6540,60,31,29599,31,4050,30,31,60205,31,2490
1754.013,1,66,5544,66,56,26984,56,5544,0,0,0,0,0
0.016,17,2,672,2,308,16,308,672,0,0,0,0,0
881.444,2,7,224,7,8,146907,8,224,0,0,0,0,0
1797.138,1,223,12488,223,28,8095,28,12488,0,0,0,0,0
3.01,17,3,222,3,46,1505,46,222,0,0,0,0,0
121.812,17,9,2992,9,304,15226,308,2992,0,0,0,0,0
1182.415,17,90,7184,47,48,25704,48,3572,43,56,25723,56,3612
0.214,17,2,181,1,32,0,32,60,1,93,0,93,121
1788.312,1,266,14896,266,28,6748,28,14896,0,0,0,0,0
0.492,6,3,144,2,0,492,0,92,1,0,0,0,52
1796.607,6,372,26057,216,99,8356,469,15194,156,69,11589,69,10863
159.548,2,3,96,3,8,79774,8,96,0,0,0,0,0
1.423,6,38,8254,19,321,79,1164,2718,19,476,69,2715,5536
5.326,6,41,7365,21,201,266,314,3463,20,516,266,1179,3902
0.188,6,44,18718,25,978,7,1432,13737,19,420,9,1432,4981
8.38,6,15,1503,7,283,1386,283,938,8,105,1172,105,565
3.616,6,10,1102,6,483,723,483,803,4,83,1203,83,299
0.38,6,26,9017,13,261,31,683,1728,13,943,30,1448,7289
4.593,17,20,14339,12,950,417,1350,11737,8,297,651,1350,2602
1770.054,6,101,9344,66,65,27231,65,5577,35,59,52057,59,3767
1776.875,17,140,11200,70,48,25751,48,5320,70,56,25751,56,5880
1787.901,6,366,25610,212,100,8473,469,14896,154,69,11685,69,10714
5.026,17,4,558,2,36,5003,36,128,2,187,4999,187,430
1625.813,1,8,448,8,28,232259,28,448,0,0,0,0,0
1788.961,6,356,22520,208,69,8642,69,12460,148,69,12166,69,10060
5.168,6,5,280,2,0,5168,0,100,3,0,1523,0,180
1681.347,1,15,840,15,28,120096,28,840,0,0,0,0,0
16.026,6,11,612,6,0,3205,0,328,5,0,3925,0,284
0.867,6,20,5952,11,282,86,548,1292,9,716,97,1420,4660
1.217,6,50,20080,28,884,45,1360,14424,22,433,50,1360,5656
1.491,6,53,23888,30,997,51,1460,18192,23,433,58,1460,5696
3.79,6,14,3144,8,49,541,92,511,6,579,61,1408,2633
6.335,6,1340,1185653,785,1426,7,1448,1149493,555,776,11,1448,36160
1800.0,6,219,18572,80,71,22405,301,8065,139,69,13043,1062,10507
240.3,6,41,5226,21,235,12013,751,2750,20,178,12645,534,2476
0.272,17,19,11021,8,418,33,1350,3574,11,649,22,1350,7447
0.112,17,2,586,1,46,0,46,74,1,484,0,484,512
423.37,2,4,128,4,8,141123,8,128,0,0,0,0,0
1786.588,6,102,8296,68,65,26665,65,4930,34,59,54136,59,3366
3.37,6,11,975,6,304,674,304,624,5,83,805,83,351
0.077,17,2,144,1,36,0,36,64,1,52,0,52,80
1799.572,17,449,39928,404,35,4465,288,25708,45,288,40017,288,14220
1.117,6,23,7952,12,164,86,267,1288,11,1216,94,3819,6664
0.783,6,28,5967,13,156,65,267,1462,15,650,51,1414,4505
3.426,6,8,432,4,0,1142,0,216,4,0,1074,0,216
1786.884,6,106,8584,69,66,26277,66,5004,37,60,49632,60,3580
1.772,6,2,111,1,0,0,0,40,1,31,0,31,71
0.008,17,4,792,3,60,0,60,264,1,500,0,500,528
1740.484,17,29,30624,29,1028,62160,1028,30624,0,0,0,0,0
2.198,17,4,360,2,30,1934,30,116,2,94,1967,94,244
7.551,6,20,6737,6,138,1510,267,803,14,596,578,3426,5934
0.326,6,3,182,2,31,326,31,111,1,31,0,31,71
561.545,17,6,444,3,30,280756,30,174,3,62,280756,62,270
0.375,6,11,3287,6,81,75,81,401,5,872,93,1448,2886
69.617,17,4,352,2,60,69615,60,176,2,60,69615,60,176
172.031,17,4,530,2,36,172021,36,128,2,173,172020,187,402
1744.58,6,94,7151,62,38,28599,205,4424,32,33,56263,98,2727
301.243,6,45,8963,24,267,13097,731,2098,21,375,439,1360,6865
0.503,6,3,199,1,31,0,31,83,2,0,503,0,116
145.064,6,22,2665,11,324,14506,585,1253,11,396,14504,580,1412
0.0,2,1,32,1,8,0,8,32,0,0,0,0,0
0.055,17,2,386,1,46,0,46,74,1,284,0,284,312
2.326,6,26,7927,17,364,145,1125,3233,9,721,289,1420,4694
1795.145,17,80,3354,79,14,23014,14,3318,1,8,0,8,36
3.86,6,26,5271,12,137,350,267,1172,14,504,295,1400,4099
90.002,6,853,408946,461,823,195,1152,388118,392,428,229,1179,20828
280.218,6,30,7432,13,158,23351,267,1317,17,543,17511,1400,6115
51.52,17,34,9881,15,334,3677,1350,5435,19,206,2860,1350,4446
300.635,6,45,8944,23,286,13665,766,2156,22,346,635,2720,6788
300.8,6,18,1227,5,177,75099,177,445,13,110,25052,110,782
7.512,6,1826,1603341,1046,1439,7,1448,1549653,780,776,9,1448,53688
13.97,6,15,5846,4,106,4656,106,274,11,639,1369,1460,5572
119.256,6,820,395208,432,844,276,1152,376368,388,414,307,1179,18840
271.511,6,29,7392,13,158,22625,267,1317,16,603,18098,2036,6075
1787.293,6,123,14556,79,84,22914,498,6386,44,160,41562,1420,8170
840.927,17,8,2196,4,30,280304,30,232,4,463,280305,463,1964
3.091,17,2,656,2,300,3091,300,656,0,0,0,0,0
1.175,6,47,19151,27,888,45,1360,13575,20,433,53,1360,5576
15.628,6,2668,2392939,1578,1426,9,1448,2322703,1090,776,14,1448,70236
3.299,17,5,340,5,40,824,40,340,0,0,0,0,0
1797.996,17,448,39896,403,35,4472,288,25676,45,288,40023,288,14220
0.044,6,9,1340,5,145,11,145,349,4,827,12,827,991
255.25,6,7,328,2,0,255250,0,88,5,0,3861,0,240
143.334,6,104,79506,67,1292,2171,1448,69422,37,741,2864,2359,10084
1680.57,17,12,498,11,14,168057,14,462,1,8,0,8,36
95.62,6,74,49892,46,1191,2124,1448,41712,28,746,2282,1448,8180
280.397,6,28,7352,13,158,23366,267,1317,15,678,20024,4200,6035
0.013,17,4,284,2,32,7,32,120,2,54,9,60,164
15.111,17,11,4721,5,505,3769,1350,2665,6,314,3015,1350,2056
1784.751,1,225,12600,225,28,7967,28,12600,0,0,0,0,0
0.01,6,4,477,3,140,1,250,437,1,0,0,0,40
1680.566,17,12,498,11,14,168056,14,462,1,8,0,8,36
1797.317,17,448,39896,403,35,4470,288,25676,45,288,40020,288,14220
0.521,6,50,21206,27,1064,20,1380,16044,23,421,21,1923,5162
0.073,17,6,1416,3,60,31,60,264,3,356,31,356,1152
956.02,6,59,4719,38,66,25838,66,2708,21,58,47796,60,2011
0.039,17,4,368,2,35,0,35,126,2,93,1,99,242
1.758,17,20,5190,20,231,92,389,5190,0,0,0,0,0
1786.784,6,88,7174,58,66,31347,66,4234,30,60,61609,60,2940
0.067,6,10,1327,5,299,12,299,567,5,246,13,459,760
280.614,6,30,7432,13,158,23384,267,1317,17,543,17526,1400,6115
1798.538,6,356,22520,208,69,8688,69,12460,148,69,12234,69,10060
0.88,6,2,92,1,0,0,0,40,1,0,0,0,52
0.224,6,10,767,5,186,52,186,454,5,45,55,45,313
1.741,6,51,20835,28,932,64,1440,15139,23,433,71,1440,5696
0.06,17,4,420,2,33,0,33,122,2,121,14,145,298
1680.442,1,15,840,15,28,120031,28,840,0,0,0,0,0
0.014,17,8,1670,8,180,2,219,1670,0,0,0,0,0
5.005,6,39,7269,19,218,278,314,3383,20,440,249,1152,3886
11.817,6,1930,1630966,1149,1363,10,1380,1594941,781,396,15,1380,36025
0.289,6,21,7281,12,334,25,663,1969,9,967,34,1906,5312
1.419,6,48,18786,27,861,54,1360,13170,21,476,61,2715,5616
1789.257,17,142,11360,71,48,25560,48,5396,71,56,25560,56,5964
1783.169,6,366,24534,213,88,8411,469,14067,153,69,11731,69,10467
3.2,6,24,4862,13,300,266,564,2196,11,414,243,1343,2666
111.948,17,4,352,2,60,111947,60,176,2,60,111946,60,176
1796.361,1,58,4872,58,56,31515,56,4872,0,0,0,0,0
1782.195,17,83,3480,82,14,22002,14,3444,1,8,0,8,36
1799.706,1,57,4788,57,56,32137,56,4788,0,0,0,0,0
9.58,6,10,1469,4,279,3132,279,495,6,218,1875,272,974
3.311,6,72,44849,38,966,89,1460,12186,34,1360,96,1607,32663
1.392,6,48,19380,27,903,53,1360,13764,21,476,60,2715,5616
368.276,6,18,1242,14,180,28328,180,916,4,110,20057,110,326
10.554,6,20,7130,11,275,1055,275,998,9,1440,705,1440,6132
94.01,6,43,10193,16,138,6267,267,2037,27,392,3615,1420,8156
0.076,6,10,1514,5,503,19,503,771,5,475,19,475,743
0.059,6,9,1346,5,145,14,145,349,4,833,13,833,997
0.023,6,13,1052,8,181,3,181,629,5,77,5,134,423
1785.103,6,102,8296,68,65,26643,65,4930,34,59,54091,59,3366
14.047,17,4,352,2,48,14027,48,152,2,72,14027,72,200
11.875,6,1878,1640220,1135,1392,10,1420,1606279,743,467,15,1883,33941
3.614,17,4,368,4,64,1204,64,368,0,0,0,0,0
20.164,6,24,5827,13,107,1680,159,1138,11,684,2015,1418,4689
0.399,6,14,1733,7,288,63,288,588,7,284,38,434,1145
0.46,6,53,21539,30,1005,15,1380,16332,23,387,19,1923,5207
0.352,6,26,8880,13,227,29,547,1604,13,941,28,1408,7276
1771.858,6,180,15480,120,69,14889,69,8940,60,69,30030,69,6540
1751.271,17,13,534,11,14,175102,14,462,2,8,1751051,8,72
31.78,6,2157,1845277,1289,1371,24,1380,1802259,868,421,36,1923,43018
92.556,6,29,13834,15,610,6610,1448,4452,14,962,7118,1448,9382
0.825,6,795,860861,236,183,3,230,12829,559,1470,1,7240,848032
1772.209,6,180,15480,120,69,14892,69,8940,60,69,30035,69,6540
11.852,6,22,6817,12,275,1077,275,1038,10,1073,759,1440,5779
71.022,17,4,1344,4,308,23674,308,1344,0,0,0,0,0
21.07,17,4,288,2,36,21038,36,128,2,52,21038,52,160
120.33,2,2,64,2,8,120330,8,64,0,0,0,0,0
4.481,6,40,7309,21,218,224,314,3463,19,513,235,1179,3846
1788.679,17,87,3648,86,14,21043,14,3612,1,8,0,8,36
0.15,17,2,152,1,48,0,48,76,1,48,0,48,76
1785.782,6,356,22520,208,69,8626,69,12460,148,69,12148,69,10060
5.021,17,4,558,2,36,5017,36,128,2,187,5016,187,430
1792.903,17,174,11136,174,36,10363,36,11136,0,0,0,0,0
120.31,2,2,64,2,8,120310,8,64,0,0,0,0,0
1782.909,6,368,23345,212,69,8449,69,12896,156,69,11502,69,10449
1782.58,17,30,20190,30,645,61468,645,20190,0,0,0,0,0
251.406,17,4,240,2,32,251405,32,120,2,32,251405,32,120
0.626,6,113,81036,69,1267,9,1420,75043,44,467,14,1883,5993
1797.345,6,355,22480,207,69,8724,69,12420,148,69,12225,69,10060
1788.949,17,142,11360,71,48,25556,48,5396,71,56,25556,56,5964
1788.869,6,100,6484,64,47,28394,208,4114,36,31,51098,31,2370
1.968,6,25,8056,12,164,152,267,1288,13,869,134,1448,6768
69.087,6,29,7257,14,155,5314,267,1346,15,482,4934,2840,5911
0.071,6,11,3652,6,171,13,171,491,5,1446,17,2675,3161
0.811,6,23,5715,13,158,67,370,1315,10,999,89,1731,4400
1742.453,1,73,6132,0,0,0,0,0,73,56,24200,56,6132
1638.405,2,13,416,13,8,136533,8,416,0,0,0,0,0
0.087,2,3,96,3,8,43,8,96,0,0,0,0,0
1782.933,17,140,11200,70,48,25839,48,5320,70,56,25839,56,5880
1.752,17,13,5326,6,463,349,1350,2950,7,311,286,1350,2376
28.357,6,47,13109,23,172,1288,721,2653,24,791,1223,2840,10456
1.076,17,2,784,2,364,1076,364,784,0,0,0,0,0
186.545,6,70,48988,45,1206,4239,1408,40953,25,961,2567,3847,8035
721.941,2,6,192,6,8,144388,8,192,0,0,0,0,0
0.484,6,10,1514,5,503,121,503,771,5,475,121,475,743
0.442,6,53,24779,30,1093,15,1380,17694,23,558,17,1923,7085
11.944,6,1786,1651513,1163,1370,10,1432,1619854,623,513,19,1871,31659
190.51,6,4,176,3,0,95255,0,128,1,0,0,0,48
24.37,6,116,82036,49,388,507,913,6826,67,1353,369,2804,75210
1744.742,2,29,928,29,8,62312,8,928,0,0,0,0,0
280.75,6,29,7392,13,158,23395,267,1317,16,603,18710,2036,6075
0.005,17,2,445,1,34,0,34,62,1,355,0,355,383
1786.243,6,102,8228,68,64,26660,64,4896,34,58,54125,58,3332
34.867,6,27,7177,13,155,2905,267,1306,14,530,2681,3417,5871
300.906,6,41,8697,22,307,14328,882,2153,19,412,484,1440,6544
280.315,6,30,7432,13,158,23359,267,1317,17,543,17512,1400,6115
0.172,6,9,1340,5,145,43,145,349,4,827,55,827,991
0.129,1,2,163,2,53,129,78,163,0,0,0,0,0
0.012,17,2,410,1,36,0,36,64,1,318,0,318,346
1736.916,1,57,4788,57,56,31016,56,4788,0,0,0,0,0
1752.079,6,97,7307,63,38,28259,205,4476,34,33,53083,98,2831
1792.726,17,142,11352,72,48,25249,48,5472,70,56,25981,56,5880
39.527,17,11,836,11,48,3952,48,836,0,0,0,0,0
1780.186,17,73,3060,72,14,25073,14,3024,1,8,0,8,36
5.537,6,40,7309,20,218,291,314,3423,20,513,277,1179,3886
64.292,6,9,372,4,0,4103,0,164,5,0,16071,0,208
1746.562,6,94,7151,62,38,28632,205,4424,32,33,56327,98,2727
5.968,17,4,352,2,60,5967,60,176,2,60,5967,60,176
3.648,17,5,1680,5,308,912,308,1680,0,0,0,0,0
1743.628,6,99,7411,63,38,28123,205,4476,36,33,49809,98,2935
1738.524,6,87,6322,58,31,30500,31,3915,29,31,62089,31,2407
7.967,6,18,8085,9,275,995,275,643,9,1414,693,1414,7442
0.523,17,3,451,2,39,413,39,134,1,289,0,289,317
125.414,6,14,3144,7,92,20902,92,452,7,464,20868,1408,2692
0.043,17,4,344,2,47,1,47,150,2,69,1,75,194
20.582,6,25,5668,15,92,1470,159,1261,10,773,2285,1418,4407
0.813,17,29,21911,15,893,58,1350,13819,14,550,54,1350,8092
16.568,6,3138,2973749,2046,1375,8,1408,2912301,1092,931,15,2816,61448
0.492,6,12,1304,6,256,88,256,756,6,304,92,304,548
0.057,17,3,208,2,36,18,36,128,1,52,0,52,80
5.022,17,4,558,2,36,5015,36,128,2,187,5018,187,430
3.79,17,10,2350,5,30,943,30,290,5,384,944,468,2060
79.579,6,136,105511,84,1308,958,1440,94645,52,679,1556,1440,10866
0.042,17,4,284,2,32,21,32,120,2,54,23,60,164
300.124,6,73,33862,37,1097,8332,1360,26778,36,256,8569,2720,7084
1681.555,17,14,1036,7,30,280256,30,406,7,62,280256,62,630
33.564,6,31,5096,15,180,2397,722,1860,16,300,2224,1448,3236
290.644,6,12,850,2,64,135,64,144,10,34,32284,58,706
1755.577,1,56,4704,0,0,0,0,0,56,56,31919,56,4704
755.961,2,5,160,5,8,188990,8,160,0,0,0,0,0
0.061,17,4,368,2,32,50,32,120,2,96,0,96,248
481.28,2,3,96,3,8,240640,8,96,0,0,0,0,0
0.526,6,28,14270,15,251,37,251,1039,13,1254,32,1438,13231
5.524,6,22,9290,11,275,552,275,719,11,903,253,1380,8571
1749.631,1,69,5796,69,56,25729,56,5796,0,0,0,0,0
0.011,17,2,167,1,39,0,39,67,1,72,0,72,100
2.999,17,3,222,3,46,1499,46,222,0,0,0,0,0
304.876,6,35,7149,15,168,12239,516,1615,20,278,16041,1452,5534
1775.194,6,200,16901,128,69,13977,69,9467,72,69,24999,69,7434
1786.674,6,107,8630,69,66,26274,66,5070,38,60,48284,60,3560
21.449,6,24,6219,13,147,1787,318,1273,11,727,2144,1418,4946
2.06,17,3,174,3,30,1030,30,174,0,0,0,0,0
0.422,17,12,4389,12,337,38,360,4389,0,0,0,0,0
1771.687,6,99,9306,66,66,27256,66,5610,33,60,55362,60,3696
107.317,6,145,158100,52,133,2104,517,3924,93,1777,1166,4224,154176
0.326,17,4,344,2,47,320,47,150,2,69,317,75,194
0.007,6,2,2884,1,0,0,0,40,1,2792,0,2792,2844
1796.538,17,178,11392,178,36,10149,36,11392,0,0,0,0,0
270.485,6,73,10572,35,96,6305,267,3051,38,315,7306,4837,7521
17.643,17,3,1008,3,308,8821,308,1008,0,0,0,0,0
228.056,6,54,9037,25,335,9502,1056,5329,29,181,8143,580,3708
952.415,1,32,2688,0,0,0,0,0,32,56,30723,56,2688
1745.02,1,8,448,8,28,249288,28,448,0,0,0,0,0
10.763,6,18,5610,10,275,1195,275,958,8,1440,822,1440,4652
0.266,17,12,4413,12,339,24,362,4413,0,0,0,0,0
1792.774,17,142,11360,71,48,25610,48,5396,71,56,25610,56,5964
0.528,6,52,20586,30,945,18,1380,15419,22,387,23,1923,5167
3.137,6,11,1424,6,145,627,145,389,5,827,657,827,1035
1739.959,1,15,840,15,28,124282,28,840,0,0,0,0,0
0.47,6,108,87844,56,131,8,232,2769,52,1765,9,4260,85075
407.215,17,180,10860,180,32,2274,37,10860,0,0,0,0,0
10.103,17,2,146,2,45,10103,45,146,0,0,0,0,0
1.531,6,48,20348,27,972,58,1440,14732,21,433,67,1440,5616
0.604,17,4,624,2,64,602,64,184,2,192,492,192,440
1771.597,6,103,9382,66,64,27255,64,5544,37,58,49208,58,3838
2.103,6,33,10852,18,563,123,1460,4144,15,677,135,1934,6708
0.927,6,10,1687,7,100,154,100,384,3,1179,333,1179,1303
100.891,17,4,352,2,60,100890,60,176,2,60,100890,60,176
1784.973,6,118,9211,74,63,24451,63,5228,44,57,41508,57,3983
1796.711,17,448,39896,403,35,4469,288,25676,45,288,40018,288,14220
128.039,6,5,293,4,31,42679,31,222,1,31,0,31,71
36.78,17,22,1936,11,48,3672,48,836,11,72,3675,72,1100
1.456,6,37,8214,19,321,80,1164,2718,18,476,74,2715,5496
263.415,17,4,352,2,60,263414,60,176,2,60,263414,60,176
1779.019,1,58,4872,58,56,31210,56,4872,0,0,0,0,0
1773.69,6,182,15629,121,69,14780,69,9049,61,69,29559,69,6580
0.304,6,22,7312,11,270,29,797,1660,11,1014,29,2373,5652
1.351,6,24,8004,12,164,104,267,1288,12,1014,105,2491,6716
81.144,6,34,15410,16,585,70,1440,3609,18,922,4765,1440,11801
0.921,6,27,5927,13,156,76,267,1462,14,650,64,1420,4465
3.002,6,22,7004,12,185,272,275,1041,10,794,259,4140,5963
159.215,6,47,10908,18,315,9365,1144,4410,29,349,5682,1408,6498
1774.181,1,58,4872,0,0,0,0,0,58,56,31125,56,4872
287.526,6,32,7924,9,152,35875,267,1284,23,317,13068,1420,6640
34.64,6,35,6200,17,142,2165,722,2034,18,401,2026,2026,4166
1772.235,6,180,15480,120,69,14892,69,8940,60,69,30034,69,6540
1772.168,6,180,15480,120,69,14892,69,8940,60,69,30032,69,6540
300.847,6,48,10279,25,433,12535,910,3246,23,435,539,2720,7033
11.086,6,18,6386,4,154,3690,267,632,14,576,851,1452,5754
1788.529,17,87,3648,86,14,21041,14,3612,1,8,0,8,36
1796.63,17,449,39928,404,35,4458,288,25708,45,288,40020,288,14220
0.387,17,2,632,1,288,0,288,316,1,288,0,288,316
1.628,6,31,6260,16,138,108,267,1755,15,780,103,1460,4505
1768.416,1,58,4872,58,56,31024,56,4872,0,0,0,0,0
23.803,17,4,304,4,48,7934,48,304,0,0,0,0,0
283.24,6,28,7352,12,158,25749,267,1277,16,603,18879,1400,6075
0.08,17,4,352,2,37,46,37,130,2,83,40,89,222
224.843,6,12,673,3,0,112421,0,152,9,7,28080,7,521
0.019,17,2,157,1,31,0,31,59,1,70,0,70,98
0.034,17,2,180,1,30,0,30,58,1,94,0,94,122
280.282,6,29,7392,13,158,23356,267,1317,16,603,18680,1400,6075
217.207,6,42,3060,19,78,12063,138,1312,23,69,9870,69,1748
0.981,17,2,784,2,364,981,364,784,0,0,0,0,0
8.584,6,32,8952,14,158,660,267,1357,18,687,499,1781,7595
1770.203,6,99,9306,66,66,27233,66,5610,33,60,55316,60,3696
0.337,6,10,1677,6,555,67,951,1354,4,159,110,159,323
872.458,6,61,3716,33,26,27264,26,1976,28,26,32291,26,1740
281.012,6,31,7813,13,158,23417,267,1317,18,524,16506,1400,6496
8.626,6,31,8912,14,158,663,267,1357,17,763,531,2076,7555
1788.969,1,264,14784,264,28,6802,28,14784,0,0,0,0,0
0.018,17,4,420,2,33,2,33,122,2,121,0,145,298
1682.949,17,14,1036,7,30,280482,30,406,7,62,280482,62,630
18.024,6,13,2190,7,210,3003,210,792,6,545,3596,904,1398
31.339,17,4,1344,4,308,10446,308,1344,0,0,0,0,0
3.014,17,4,272,2,32,3010,32,120,2,48,3009,48,152
1777.347,17,140,11200,70,48,25758,48,5320,70,56,25758,56,5880
0.507,17,3,451,2,39,114,39,134,1,289,0,289,317
376.337,6,23,1535,16,177,25089,177,1053,7,110,10404,110,482
1799.57,17,449,39928,404,35,4465,288,25708,45,288,40023,288,14220
1777.579,1,208,11648,208,28,8587,28,11648,0,0,0,0,0
1771.198,6,106,9820,68,66,26435,66,5792,38,60,47867,60,4028
1.255,6,50,19898,28,872,46,1360,14242,22,476,51,2715,5656
300.581,6,19,1279,6,177,60081,177,497,13,110,25033,110,782
1.511,6,37,8250,19,321,83,1164,2754,18,476,77,2615,5496
98.323,17,4,240,2,32,98321,32,120,2,32,98322,32,120
0.055,17,2,190,1,59,0,59,87,1,75,0,75,103
0.106,17,5,632,3,60,14,60,264,2,156,48,156,368
1795.722,17,448,39896,403,35,4466,288,25676,45,288,40020,288,14220
20.192,6,21,5418,12,107,1835,159,1074,9,773,2517,1418,4344
11.821,17,16,2352,8,48,1686,48,608,8,190,1686,308,1744
0.005,17,3,821,1,137,0,137,165,2,300,1,300,656
0.349,6,14,1733,7,288,57,288,588,7,284,31,434,1145
1681.697,17,14,1036,7,30,280277,30,406,7,62,280277,62,630
1745.84,6,89,6767,59,39,30100,205,4206,30,33,60192,98,2561
0.84,6,20,5952,11,282,84,548,1292,9,716,94,1420,4660
68.751,17,7,2344,7,306,11458,308,2344,0,0,0,0,0
300.474,6,50,28716,30,1122,10361,1402,22919,20,593,2822,1402,5797
1.733,17,3,984,1,300,0,300,328,2,300,48,300,656
0.121,6,9,1340,5,145,30,145,349,4,827,31,827,991
2.745,6,10,1110,6,177,549,177,674,4,110,834,110,436
382.139,6,106,74894,64,1272,6065,1448,64417,42,679,2446,1448,10477
1796.882,6,381,24541,217,74,8318,469,13772,164,69,11023,69,10769
162.175,6,31,4760,17,304,10135,304,3332,14,83,12452,83,1428
0.049,6,12,3656,6,124,9,124,444,6,964,9,1448,3212
0.465,6,2,80,1,0,0,0,40,1,0,0,0,40
1796.637,17,296,22496,296,48,6090,48,22496,0,0,0,0,0
259.172,17,4,240,2,32,259171,32,120,2,32,259171,32,120
1796.81,17,447,39580,403,35,4469,288,25676,44,288,40949,288,13904
0.123,6,9,1348,5,145,30,145,349,4,835,30,835,999
0.016,17,2,330,1,30,0,30,58,1,244,0,244,272
0.403,6,13,1693,7,288,64,288,588,6,426,45,434,1105
1797.966,1,345,28980,345,56,5226,56,28980,0,0,0,0,0
0.0,17,1,1376,1,1348,0,1348,1376,0,0,0,0,0
42.421,6,34,9067,14,327,59,1189,2535,20,440,2232,1420,6532
565.556,6,45,2845,27,44,21752,270,1877,18,31,33258,31,968
1.289,6,48,18200,26,882,51,1460,12544,22,433,52,1460,5656
300.283,6,36,28993,22,190,14299,444,1937,14,2924,18479,11264,27056
5.024,17,4,558,2,36,5019,36,128,2,187,5019,187,430
1203.239,2,13,416,13,8,100269,8,416,0,0,0,0,0
151.684,6,204,164991,131,1290,1166,1368,151356,73,679,1978,2519,13635
1794.774,17,79,3312,78,14,23308,14,3276,1,8,0,8,36
1798.521,6,367,25650,214,99,8443,469,15045,153,69,11832,69,10605
0.034,17,2,522,1,72,0,72,100,1,394,0,394,422
0.104,17,2,586,1,46,0,46,74,1,484,0,484,512
0.305,6,7,466,5,43,66,43,354,2,0,303,0,112
0.141,6,2,111,1,0,0,0,40,1,31,0,31,71
1797.347,6,372,25988,216,99,8359,469,15194,156,69,11595,69,10794
1785.446,6,368,25690,215,99,8343,469,15085,153,69,11746,69,10605
1795.641,17,448,39896,403,35,4466,288,25676,45,288,40022,288,14220
7.548,6,21,4374,12,213,686,597,1689,9,552,919,1767,2685
9.944,6,84,26618,45,572,226,1152,21274,39,472,254,1179,5344
280.531,6,27,7653,13,158,23377,267,1317,14,824,21577,4845,6336
240.198,6,52,17459,27,778,9238,1408,14652,25,187,10008,580,2807
1.6,6,51,19421,29,891,57,1360,13720,22,437,66,2715,5701
55.579,6,16,2346,10,210,6175,210,948,6,545,11115,904,1398
0.045,6,2,99,1,0,0,0,40,1,7,0,7,59
0.016,17,2,240,1,48,0,48,76,1,136,0,136,164
1.115,6,25,8056,12,164,86,267,1288,13,869,78,1408,6768
139.802,6,68,14083,29,299,4992,1189,5963,39,262,3678,1460,8120
503.887,2,4,128,4,8,167962,8,128,0,0,0,0,0
0.275,6,27,9072,13,252,22,647,1692,14,949,20,2816,7380
0.214,6,14,2247,7,503,35,503,1390,7,473,35,473,857
13.383,6,12,1355,7,284,2230,517,940,5,147,3344,147,415
36.009,17,10,760,10,48,4001,48,760,0,0,0,0,0
1681.628,17,14,1036,7,30,280265,30,406,7,62,280265,62,630
1775.1,17,139,11116,70,48,25725,48,5320,69,56,26104,56,5796
122.852,6,22,9339,11,598,67,1451,2267,11,945,12272,1460,7072
4.223,17,5,295,5,31,1055,31,295,0,0,0,0,0
8.108,6,69,20566,35,552,238,1152,15763,34,491,238,1179,4803
1745.47,6,95,7203,63,38,28152,205,4476,32,33,56292,98,2727
1787.909,6,359,22709,209,69,8595,69,12569,150,69,11999,69,10140
301.331,6,92,64319,57,1328,5380,1460,58117,35,435,268,2567,6202
232.116,17,12,1764,6,48,46421,48,456,6,190,46421,308,1308
0.09,6,2,100,1,0,0,0,60,1,0,0,0,40
113.734,6,53,14268,28,1014,339,1360,8328,25,328,4731,2667,5940
11.626,6,1825,1591023,1105,1384,10,1420,1558002,720,420,16,1420,33021
61.688,6,46,27484,30,1018,2127,1408,19908,16,962,4097,3847,7576
7.406,6,46,8449,24,227,322,314,4142,22,489,339,1179,4307
0.039,17,2,334,1,32,0,32,60,1,246,0,246,274
1746.483,6,95,7203,63,38,28169,205,4476,32,33,56325,98,2727
1783.205,17,83,3480,82,14,22014,14,3444,1,8,0,8,36
1793.65,17,144,11520,72,48,25262,48,5472,72,56,25262,56,6048
5.035,17,4,288,2,36,5002,36,128,2,52,4989,52,160
33.728,6,31,5092,15,154,2409,722,1858,16,342,2234,1448,3234
371.21,6,18,1239,14,177,28554,177,913,4,110,20059,110,326
0.84,6,13,1981,7,288,136,288,876,6,426,135,434,1105
1767.753,6,121,12142,75,63,23888,721,6266,46,96,39276,1448,5876
1760.648,17,160,32385,160,174,11073,422,32385,0,0,0,0,0
1281.397,6,102,10705,59,73,22093,721,5122,43,98,28546,1448,5583
102.698,6,46,10191,23,294,4668,721,3579,23,516,4658,1414,6612
382.638,6,18,1242,14,180,29433,180,916,4,110,20068,110,326
87.747,6,23,7600,12,220,7977,516,1366,11,723,8764,1452,6234
579.131,6,77,5720,30,66,19965,291,2733,47,48,12586,78,2987
1.431,17,2,136,1,32,0,32,60,1,48,0,48,76
296.275,1,4,224,4,28,98758,28,224,0,0,0,0,0
5.053,17,6,5701,2,723,5053,1350,1503,4,1021,1281,1350,4198
238.551,2,3,96,3,8,119275,8,96,0,0,0,0,0
1778.827,6,110,8805,71,65,25411,65,5180,39,59,46808,59,3625
172.333,6,26,10809,12,380,99,832,1665,14,952,13245,1460,9144
1772.263,6,180,15480,120,69,14892,69,8940,60,69,30035,69,6540
5.216,6,40,7309,20,218,274,314,3423,20,513,261,1179,3886
1772.506,6,204,22399,130,75,13740,267,10057,74,133,24274,1997,12342
7.304,6,1247,1202079,828,1379,8,1408,1175627,419,776,17,1408,26452
2.856,6,11,3652,6,171,565,171,491,5,1446,708,2675,3161
1787.604,6,835,157370,444,344,4035,1189,80510,391,224,4582,1812,76860
1.46,6,49,19263,27,892,56,1460,13607,22,476,60,2615,5656
7.698,17,3,228,3,48,3849,48,228,0,0,0,0,0
14.895,6,41,7711,19,224,827,314,3676,22,393,695,1152,4035
1.536,6,10,1687,7,100,256,100,384,3,1179,620,1179,1303
1783.908,6,99,8052,66,65,27444,65,4785,33,59,55742,59,3267
1793.753,17,87,3648,86,14,21102,14,3612,1,8,0,8,36
16.758,17,23,16462,10,571,1858,1350,5993,13,777,1393,1350,10469
20.753,6,22,4521,13,205,1729,517,1931,9,528,2592,969,2590
1764.22,2,14,448,14,8,135709,8,448,0,0,0,0,0
4.885,6,39,7269,20,218,257,314,3423,19,513,256,1179,3846
25.616,17,25,15998,14,832,1967,1350,12051,11,330,2558,1350,3947
1.111,6,7,426,3,31,555,31,187,4,31,256,31,239
0.251,17,2,194,1,61,0,61,89,1,77,0,77,105
1.038,6,13,1182,7,146,172,146,430,6,254,206,506,752
1783.374,17,83,3480,82,14,22016,14,3444,1,8,0,8,36
0.59,6,6,324,4,0,196,0,216,2,0,364,0,108
1797.967,17,448,39896,403,35,4472,288,25676,45,288,40021,288,14220
280.627,6,30,7432,13,158,23385,267,1317,17,543,17536,1400,6115
0.013,17,2,492,1,64,0,64,92,1,372,0,372,400
55.612,6,47,9068,22,391,838,860,2159,25,327,2311,1460,6909
280.269,6,30,7432,14,158,21559,267,1357,16,603,18682,1400,6075
3.32,6,2,88,2,0,0,0,88,0,0,0,0,0
280.332,6,31,7472,14,158,21564,267,1357,17,603,17517,2036,6115
1683.134,17,12,498,11,14,168313,14,462,1,8,0,8,36
0.96,17,13,6290,6,584,192,1350,3677,7,345,134,1350,2613
196.195,6,12,1098,7,180,32678,180,732,5,110,49006,110,366
1786.709,6,104,8444,68,66,26667,66,4964,36,60,51046,60,3480
1.888,17,2,122,2,33,1888,33,122,0,0,0,0,0
8.272,6,1304,1144738,795,1389,10,1420,1120157,509,467,16,1883,24581
1.185,6,2,1175,1,0,0,0,40,1,1095,0,1095,1135
0.104,17,8,2750,8,315,14,354,2750,0,0,0,0,0
1796.974,1,345,28980,345,56,5223,56,28980,0,0,0,0,0
100.399,6,25,9472,13,519,70,952,2666,12,789,9115,4080,6806
1800.0,6,211,16242,78,68,22986,296,7648,133,48,13636,78,8594
0.007,17,2,195,1,32,0,32,60,1,107,0,107,135
1.042,17,3,216,2,31,1014,31,118,1,70,0,70,98
1.903,17,2,312,2,128,1903,128,312,0,0,0,0,0
1787.836,17,87,3648,86,14,21033,14,3612,1,8,0,8,36
280.475,6,31,7472,13,158,23372,267,1317,18,603,16494,2760,6155
1741.667,6,87,6322,58,31,30555,31,3915,29,31,62202,31,2407
1799.996,1,57,4788,57,56,32142,56,4788,0,0,0,0,0
1750.315,1,9,504,9,28,218789,28,504,0,0,0,0,0
126.442,2,2,64,2,8,126442,8,64,0,0,0,0,0
67.092,6,199,141340,98,430,691,647,6502,101,1322,668,2816,134838
105.239,6,26,10852,14,614,51,1360,3702,12,951,9555,2720,7150
3.78,17,10,1287,5,31,942,31,295,5,170,942,196,992
1787.578,6,106,8388,68,64,26680,64,4896,38,58,48310,58,3492
1789.898,6,358,22669,209,69,8605,69,12569,149,69,12093,69,10100
1743.396,6,97,7307,63,38,28119,205,4476,34,33,52821,98,2831
367.042,6,18,1242,14,180,28234,180,916,4,110,20068,110,326
0.796,6,3,151,1,0,0,0,40,2,31,672,31,111
1764.768,2,14,448,14,8,135751,8,448,0,0,0,0,0
315.92,6,98,20913,48,298,6721,1360,10380,50,250,6444,4649,10533
31.277,1,37,3848,0,0,0,0,0,37,76,868,76,3848
0.306,6,3,210,1,0,0,0,40,2,90,169,90,170
1259.521,2,8,256,8,8,179931,8,256,0,0,0,0,0
1744.122,6,95,7203,63,38,28131,205,4476,32,33,56253,98,2727
14.557,6,8,440,5,0,3639,0,268,3,0,7265,0,172
1.441,6,28,5975,15,156,102,267,1546,13,650,106,1452,4429
1776.321,6,181,15589,120,69,14927,69,8940,61,69,29604,69,6649
1787.399,6,105,8416,68,65,26677,65,4930,37,59,49646,59,3486
0.083,17,4,588,2,48,71,48,152,2,190,62,308,436
1.28,6,49,20688,28,928,47,1360,15072,21,476,56,2715,5616
0.932,6,25,8962,14,208,71,475,1426,11,1416,75,3926,7536
0.63,6,22,9190,12,318,56,600,1950,10,1118,69,1891,7240
3.017,6,55,14379,27,553,116,1429,5000,28,434,104,1986,9379
1763.419,2,15,480,15,8,125958,8,480,0,0,0,0,0
1787.942,1,8,448,8,28,255420,28,448,0,0,0,0,0
0.029,6,10,1512,5,503,7,503,771,5,473,7,473,741
9.968,6,80,24421,40,550,255,1152,18680,40,459,247,1179,5741
38.259,17,12,912,12,48,3478,48,912,0,0,0,0,0
1795.636,17,449,39928,404,35,4455,288,25708,45,288,40021,288,14220
130.326,6,14,3482,2,92,2994,92,204,12,294,11833,2026,3278
235.771,6,77,51969,47,1205,5125,1408,42267,30,903,2124,2816,9702
505.029,1,18,1512,0,0,0,0,0,18,56,29707,56,1512
1741.811,1,15,870,15,30,124415,30,870,0,0,0,0,0
1.672,6,14,2351,8,188,238,245,700,6,703,283,1152,1651
8.629,6,14,1896,7,256,1435,256,1308,7,304,1434,304,588
180.455,2,3,96,3,8,90227,8,96,0,0,0,0,0
109.857,6,112,77848,65,1278,1716,1448,67301,47,735,2383,2359,10547
1785.233,17,86,3606,85,14,21252,14,3570,1,8,0,8,36
0.538,17,2,167,1,39,0,39,67,1,72,0,72,100
0.044,17,2,216,1,45,0,45,73,1,115,0,115,143
1796.549,17,448,39896,403,35,4469,288,25676,45,288,40020,288,14220
0.018,17,4,398,2,46,11,46,148,2,97,8,103,250
0.003,17,3,821,1,137,0,137,165,2,300,0,300,656
33.615,6,26,4835,13,180,2801,722,1756,13,479,2784,1440,3079
1.155,6,53,13802,25,533,48,1301,4764,28,439,41,2720,9038
1782.168,6,364,25392,212,100,8446,469,14896,152,69,11802,69,10496
1773.507,6,204,22399,130,75,13748,267,10057,74,133,24290,1917,12342
0.09,6,10,1671,6,552,16,948,1348,4,159,29,159,323
33.83,6,30,5042,14,180,2602,722,1807,16,342,2243,1402,3235
81.289,6,22,900,10,0,6121,0,404,12,0,7388,0,496
280.303,6,27,7312,12,158,25482,267,1277,15,678,20018,2045,6035
744.969,1,119,6664,119,28,6313,28,6664,0,0,0,0,0
34.513,17,22,1936,11,48,3443,48,836,11,72,3449,72,1100
590.697,6,161,16414,84,99,6574,469,6643,77,215,7770,1917,9771
1790.562,17,140,11200,70,48,25949,48,5320,70,56,25949,56,5880
0.055,17,4,284,2,32,0,32,120,2,54,1,60,164
120.605,17,4,382,2,31,120291,34,119,2,103,120556,114,263
280.499,6,30,7432,13,158,23374,267,1317,17,603,17527,2760,6115
0.925,6,26,5887,13,156,77,267,1462,13,780,69,1460,4425
1.321,6,46,19215,27,897,50,1360,13679,19,433,63,1360,5536
3.858,17,4,296,4,46,1286,46,296,0,0,0,0,0
1744.691,2,15,480,15,8,124620,8,480,0,0,0,0,0
0.004,6,2,172,1,0,0,0,40,1,92,0,92,132
1608.352,1,8,448,8,28,229764,28,448,0,0,0,0,0
300.866,6,49,10486,24,433,13081,910,3218,25,312,551,1460,7268
11.82,6,25,8473,13,275,985,275,1078,12,986,843,1440,7395
1795.363,17,82,3443,80,14,22726,15,3361,2,13,1416931,18,82
1786.295,6,356,22520,208,69,8629,69,12460,148,69,12151,69,10060
655.714,6,104,15894,63,89,10576,267,5573,41,247,16392,1460,10321
67.686,6,8529,8301713,5594,1405,12,1448,8144333,2935,776,23,1448,157380
0.052,17,2,152,2,48,52,48,152,0,0,0,0,0
132.088,17,4,288,2,36,132088,36,128,2,52,132087,52,160
317.049,6,46,12261,21,267,15852,1305,3276,25,419,13205,4649,8985
15.485,17,20,6358,9,335,1926,1350,3272,11,252,1541,1350,3086
0.173,6,16,6056,9,70,20,133,504,7,1756,27,2440,5552
1.456,17,22,16102,10,775,161,1350,8030,12,644,127,1350,8072
0.139,17,2,136,1,32,0,32,60,1,48,0,48,76
0.027,17,2,195,1,32,0,32,60,1,107,0,107,135
0.249,17,2,259,1,53,0,53,81,1,150,0,150,178
1740.341,6,87,6322,58,31,30532,31,3915,29,31,62152,31,2407
0.079,1,8,672,8,56,11,56,672,0,0,0,0,0
0.952,17,8,2750,8,315,136,354,2750,0,0,0,0,0
1.075,6,29,10278,18,356,63,801,1793,11,1148,99,2840,8485
1136.573,6,92,9648,50,70,23191,722,4292,42,99,27716,2026,5356
280.364,6,29,7392,13,158,23363,267,1317,16,603,18683,2800,6075
300.733,17,26,4648,13,48,25060,48,988,13,253,25060,308,3660
1763.989,2,13,416,13,8,146999,8,416,0,0,0,0,0
1775.488,6,180,15480,120,69,14920,69,8940,60,69,30083,69,6540
1771.936,6,180,15480,120,69,14890,69,8940,60,69,30032,69,6540
1783.747,6,356,22520,208,69,8617,69,12460,148,69,12131,69,10060
240.258,6,40,8697,20,461,12644,1402,4737,20,364,12644,1402,3960
1681.214,17,14,3843,7,30,280201,30,406,7,463,280200,463,3437
1799.477,1,198,20988,198,78,9134,78,20988,0,0,0,0,0
157.605,17,4,352,2,60,157604,60,176,2,60,157604,60,176
153.189,6,28,7352,13,158,12765,267,1317,15,678,10939,2045,6035
0.017,6,3,327,2,103,1,138,287,1,0,0,0,40
1764.128,2,14,448,14,8,135702,8,448,0,0,0,0,0
4.285,6,37,7189,19,218,238,314,3383,18,513,236,1179,3806
237.78,17,4,352,2,60,237779,60,176,2,60,237779,60,176
1745.512,6,96,7255,62,38,28614,205,4424,34,33,52883,98,2831
0.715,6,10,861,5,222,175,222,426,5,231,176,231,435
1773.122,6,171,14706,114,69,15691,69,8493,57,69,31656,69,6213
30.907,6,12,724,3,106,15445,106,234,9,90,3861,90,490
31.157,6,42,12797,17,275,1947,512,1643,25,507,1261,1360,11154
1786.776,6,104,8444,68,66,26668,66,4964,36,60,51048,60,3480
0.04,17,4,398,2,46,33,46,148,2,97,32,103,250
1150.084,17,286,32674,137,147,8456,1350,23984,149,30,7770,60,8690
0.41,17,6,2075,6,317,82,355,2075,0,0,0,0,0
240.211,6,53,17654,28,782,8896,1418,14774,25,196,10008,580,2880
11.214,6,1775,1555179,1076,1393,10,1432,1522929,699,421,16,1871,32250
1792.56,6,280,19825,167,69,10798,69,10889,113,69,16004,69,8936
0.129,6,22,10013,11,136,12,136,716,11,1089,12,1448,9297
1759.62,17,85,3564,84,14,21200,14,3528,1,8,0,8,36
1773.545,17,128,10240,64,48,28151,48,4864,64,56,28151,56,5376
1771.322,1,59,4956,0,0,0,0,0,59,56,30540,56,4956
255.035,17,6,390,3,37,127516,47,195,3,37,127517,47,195
0.835,6,30,12263,16,758,55,1408,5390,14,1225,63,2816,6873
1.431,6,46,18697,26,926,57,1440,13121,20,433,65,1440,5576
338.853,6,26,2184,14,173,26065,173,1315,12,83,30804,83,869
211.528,17,4,296,4,46,70509,46,296,0,0,0,0,0
10.533,1,6,336,6,28,2106,28,336,0,0,0,0,0
467.178,6,16,1271,10,63,24093,63,715,6,52,93421,57,556
964.926,6,132,15699,63,106,15560,721,6981,69,238,14187,1440,8718
0.474,6,7,371,4,0,158,0,204,3,7,119,7,167
1772.248,6,180,15480,120,69,14892,69,8940,60,69,30034,69,6540
19.094,6,2561,2196493,1432,1436,13,1448,2120937,1129,776,16,1448,75556
14.033,6,11,612,6,0,2806,0,328,5,0,3417,0,284
1.002,6,6,302,2,31,6,31,111,4,31,334,31,191
171.471,6,127,97039,82,1246,2116,1368,86572,45,738,1951,2519,10467
4.488,6,38,7245,20,218,236,314,3423,18,516,248,1179,3822
2.483,17,3,543,2,39,994,39,134,1,381,0,381,409
167.878,6,77,28617,39,773,4417,1460,20167,38,494,4532,1460,8450
300.403,6,43,22074,25,1047,12516,1440,16014,18,511,2156,1440,6060
1797.907,1,58,4872,58,56,31542,56,4872,0,0,0,0,0
1.671,6,14,2181,8,322,238,581,1069,6,396,330,580,1112
0.172,17,4,1148,2,32,167,32,120,2,486,165,486,1028
2.091,17,12,4500,4,533,697,1350,2246,8,253,254,1350,2254
68.542,6,49,9020,23,345,709,720,2071,26,327,2736,1460,6949
1637.413,6,92,13572,56,95,29771,267,5510,36,213,14849,1460,8062
390.99,1,18,1008,18,28,22999,28,1008,0,0,0,0,0
756.208,2,5,160,5,8,189052,8,160,0,0,0,0,0
60.677,6,34,17757,20,708,3193,1360,4410,14,1419,4658,3056,13347
720.051,2,7,224,7,8,120008,8,224,0,0,0,0,0
2.285,6,13,2311,8,188,326,245,700,5,1407,506,1407,1611
0.009,17,2,470,1,67,0,67,95,1,347,0,347,375
1681.43,1,15,840,15,28,120102,28,840,0,0,0,0,0
19.871,17,2,152,2,48,19871,48,152,0,0,0,0,0
23.353,6,33,8096,16,188,1556,721,1963,17,681,1446,2840,6133
44.726,17,11,836,11,48,4472,48,836,0,0,0,0,0
300.399,6,55,27512,34,401,9103,1018,3453,21,1434,3418,8266,24059
10.175,17,19,7528,8,582,1449,1350,4882,11,212,1014,1350,2646
1744.54,1,62,5208,62,56,28599,56,5208,0,0,0,0,0
0.943,6,6,324,3,0,471,0,164,3,0,240,0,160
4.003,17,4,268,4,39,1334,39,268,0,0,0,0,0
1740.799,6,89,6426,58,31,30540,31,3915,31,31,58026,31,2511
7.4,6,42,7730,22,218,352,314,3503,20,489,376,1179,4227
1795.748,6,368,23276,212,69,8510,69,12896,156,69,11585,69,10380
1772.14,6,180,15480,120,69,14891,69,8940,60,69,30034,69,6540
106.38,1,5,280,5,28,26595,28,280,0,0,0,0,0
1.226,6,60,15796,29,561,43,1429,5693,31,442,39,1460,10103
1684.523,2,15,480,15,8,120323,8,480,0,0,0,0,0
1755.985,6,103,8084,66,45,27015,205,4933,37,35,48765,98,3151
312.753,6,34,7050,15,168,12204,516,1615,19,291,17370,1452,5435
0.101,17,4,272,2,32,69,32,120,2,48,69,48,152
92.914,17,6,2016,6,308,18582,308,2016,0,0,0,0,0
300.528,6,22,1507,11,177,30035,177,829,11,110,30035,110,678
1786.28,6,125,14045,80,82,22611,502,6184,45,155,40595,1420,7861
2.163,1,9,756,9,56,270,56,756,0,0,0,0,0
3.19,6,5,232,2,0,3190,0,88,3,0,927,0,144
45.116,6,2,104,2,0,0,0,104,0,0,0,0,0
585.114,6,86,6934,34,84,17726,337,3566,52,51,11470,143,3368
315.853,6,131,37793,60,528,5353,1360,25188,71,199,4510,2720,12605
1.021,17,4,566,2,31,801,31,118,2,196,0,196,448
1780.567,1,58,4872,58,56,31238,56,4872,0,0,0,0,0
11.719,6,1938,1621025,1140,1363,10,1380,1584131,798,421,14,1923,36894
0.035,17,3,208,2,36,15,36,128,1,52,0,52,80
126.629,6,13389,13258712,9209,1364,13,1408,13036676,4180,776,30,1408,222036
1764.494,17,30,7050,30,207,60844,207,7050,0,0,0,0,0
1797.04,17,448,39896,403,35,4470,288,25676,45,288,40019,288,14220
33.748,6,33,5209,16,154,2238,722,1922,17,342,2098,1448,3287
1780.003,1,342,28728,342,56,5219,56,28728,0,0,0,0,0
19.602,17,2,778,2,361,19602,361,778,0,0,0,0,0
0.246,6,3,128,2,0,246,0,84,1,0,0,0,44
1771.317,1,59,4956,0,0,0,0,0,59,56,30539,56,4956
7.411,6,67,20246,34,565,224,1152,15499,33,489,223,1179,4747
1798.711,6,373,26028,216,98,8366,469,15263,157,69,11528,69,10765
1787.948,6,174,30245,103,304,17528,1302,19043,71,157,25540,1420,11202
37.363,17,22,1936,11,48,3735,48,836,11,72,3735,72,1100
1775.134,17,73,3060,72,14,25001,14,3024,1,8,0,8,36
1786.834,6,104,8376,68,65,26669,65,4930,36,59,51049,59,3446
122.402,6,9,515,5,43,30600,43,299,4,0,40799,0,216
1171.604,17,59,4484,59,48,20200,48,4484,0,0,0,0,0
1785.618,6,430,25800,217,69,8266,69,12820,213,35,8422,64,12980
211.409,6,39,11214,14,236,854,314,2928,25,485,8798,1179,8286
147.344,17,6,525,3,32,73664,37,181,3,86,73666,136,344
1049.729,17,21,1596,21,48,52486,48,1596,0,0,0,0,0
19.978,6,9,577,0,0,0,0,0,9,31,2497,31,577
264.776,1,6,336,6,28,52955,28,336,0,0,0,0,0
782.142,2,8,256,8,8,111734,8,256,0,0,0,0,0
287.413,6,35,3534,17,323,17963,582,1586,18,169,16906,580,1948
1763.91,2,15,480,15,8,125993,8,480,0,0,0,0,0
0.37,6,10,1383,5,145,92,145,349,5,830,83,830,1034
27.889,17,4,304,4,48,9296,48,304,0,0,0,0,0
1.967,6,25,5795,13,158,163,370,1315,12,799,177,1420,4480
1776.238,2,23,736,23,8,80738,8,736,0,0,0,0,0
0.325,17,2,237,1,72,0,72,100,1,109,0,109,137
1794.366,17,144,11520,72,48,25272,48,5472,72,56,25272,56,6048
1787.698,17,87,3648,86,14,21031,14,3612,1,8,0,8,36
3.936,17,2,176,2,60,3936,60,176,0,0,0,0,0
1752.594,6,95,7203,63,38,28267,205,4476,32,33,56526,98,2727
691.143,6,90,6660,34,63,20939,294,3083,56,47,12566,78,3577
1784.493,6,102,8296,68,65,26634,65,4930,34,59,54072,59,3366
1787.086,6,104,8376,68,65,26672,65,4930,36,59,51055,59,3446
8.506,6,12,945,6,222,1698,222,466,6,231,1698,231,479
10.762,6,20,4322,11,275,1076,275,998,9,738,745,1380,3324
1659.935,1,8,448,8,28,237133,28,448,0,0,0,0,0
54.432,6,525,236432,268,819,203,1152,220631,257,424,211,1179,15801
206.307,6,136,88207,74,1251,2826,1408,75232,62,793,1859,2816,12975
12.135,17,20,4580,10,33,1346,33,610,10,369,1346,393,3970
166.715,17,4,240,2,32,166714,32,120,2,32,166714,32,120
1.658,6,47,18934,26,942,66,1460,13318,21,433,71,1460,5616
48.308,6,6,378,2,106,48290,106,194,4,0,16095,0,184
0.293,6,16,5217,8,75,41,75,586,8,1398,41,1448,4631
1797.171,6,367,25650,214,99,8437,469,15045,153,69,11823,69,10605
4.182,6,33,6145,17,206,261,314,2744,16,551,261,1179,3401
1797.617,6,366,25072,214,94,8439,469,14576,152,69,11903,69,10496
1783.119,6,356,22520,208,69,8614,69,12460,148,69,12129,69,10060
0.307,17,2,167,1,39,0,39,67,1,72,0,72,100
0.956,6,10,1687,7,100,159,100,384,3,1179,346,1179,1303
1680.228,1,7,392,7,28,280038,28,392,0,0,0,0,0
1.98,6,3,120,1,0,0,0,40,2,0,1850,0,80
154.203,6,205,166857,134,1285,1159,1408,152263,71,680,2199,3847,14594
1786.515,6,104,8444,68,66,26664,66,4964,36,60,51040,60,3480
1782.418,17,178,42025,178,208,10070,422,42025,0,0,0,0,0
0.072,6,84,82444,32,133,2,322,2064,52,1585,1,5672,80380
2.794,17,2,122,2,33,2794,33,122,0,0,0,0,0
1778.483,17,140,11200,70,48,25775,48,5320,70,56,25775,56,5880
1.415,6,50,20661,28,923,52,1440,15005,22,433,58,1440,5656
84.702,6,45,9831,19,269,1735,1189,2921,26,390,3387,1420,6910
33.184,6,24,7383,12,272,2850,516,1300,12,622,3009,1452,6083
0.548,6,23,6002,12,108,49,147,919,11,927,52,1608,5083
1504.072,2,10,320,10,8,167119,8,320,0,0,0,0,0
0.002,6,2,84,1,0,0,0,44,1,0,0,0,40
1771.888,6,180,15480,120,69,14889,69,8940,60,69,30031,69,6540
0.436,6,29,7376,13,155,36,267,1301,16,603,25,2760,6075
104.784,6,70,45299,43,1163,2494,1408,37161,27,960,2366,3847,8138
0.031,6,13,901,7,39,5,39,403,6,46,5,63,498
19.671,17,4,352,2,48,19663,48,152,2,72,19662,72,200
1798.344,17,140,11200,70,48,26062,48,5320,70,56,26062,56,5880
280.041,6,28,7352,13,158,23336,267,1317,15,678,19999,4200,6035
15.563,17,4,1824,2,308,15563,308,672,2,548,19,548,1152
668.233,6,169,18726,85,129,7955,1189,7031,84,177,8050,1420,11695
1799.579,1,57,4788,0,0,0,0,0,57,56,32135,56,4788
2.898,6,156,124235,68,284,43,889,5251,88,1395,29,2836,118984
0.033,17,2,425,1,58,0,58,86,1,311,0,311,339
0.001,6,2,129,1,0,0,0,40,1,37,0,37,89
54.422,6,40,10435,17,769,46,1360,4558,23,309,2465,2667,5877
1798.501,17,425,53822,199,172,9080,1350,39987,226,33,7993,61,13835
4.207,6,37,7205,19,218,233,314,3383,18,516,232,1179,3822
82.185,6,17,692,7,0,8484,0,284,10,0,9130,0,408
11.421,6,1773,1570478,1111,1363,10,1380,1539720,662,425,17,1923,30758
0.483,17,2,152,1,48,0,48,76,1,48,0,48,76
3.803,17,3,1176,3,364,1901,364,1176,0,0,0,0,0
1772.621,6,180,15480,120,69,14895,69,8940,60,69,30036,69,6540
1791.328,1,342,28728,342,56,5253,56,28728,0,0,0,0,0
1.717,6,13,2311,8,188,245,245,700,5,1407,364,1407,1611
0.026,17,2,154,1,33,0,33,61,1,65,0,65,93
1797.009,17,448,39612,404,35,4459,288,25708,44,288,40890,288,13904
1796.105,17,448,39896,403,35,4467,288,25676,45,288,40017,288,14220
0.345,6,14,6093,7,128,57,128,500,7,1305,56,1448,5593
1795.661,17,455,42128,403,36,4466,288,26044,52,281,34619,308,16084
1783.507,17,86,3606,85,14,21232,14,3570,1,8,0,8,36
0.261,6,2,80,1,0,0,0,40,1,0,0,0,40
372.446,6,25,1651,17,177,23277,177,1117,8,110,9229,110,534
8.21,6,664,520978,363,1350,22,1448,499654,301,776,26,1448,21324
0.126,17,2,154,1,33,0,33,61,1,65,0,65,93
2.198,17,2,154,1,33,0,33,61,1,65,0,65,93
0.22,17,2,172,1,50,0,50,78,1,66,0,66,94
0.501,6,7,295,4,0,167,0,164,3,7,150,7,131
9.014,1,10,840,10,56,1001,56,840,0,0,0,0,0
1111.27,17,220,16720,220,48,5074,48,16720,0,0,0,0,0
0.706,6,12,1163,6,222,138,222,688,6,231,138,231,475
1793.646,17,140,11200,70,48,25994,48,5320,70,56,25994,56,5880
25.623,6,43,12813,21,199,1281,721,2437,22,791,1211,2840,10376
161.521,6,32,24726,19,884,36,1360,6109,13,2260,13447,8819,18617
368.502,6,27,1767,18,177,21676,177,1181,9,110,8842,110,586
120.26,17,4,240,2,32,120259,32,120,2,32,120259,32,120
3.87,17,4,352,4,60,1290,60,352,0,0,0,0,0
373.488,6,18,1242,14,180,28729,180,916,4,110,20070,110,326
0.013,17,2,306,1,33,0,33,61,1,217,0,217,245
1769.108,1,58,4872,58,56,31036,56,4872,0,0,0,0,0
504.62,6,75,11374,41,91,12615,267,3392,34,228,15291,3417,7982
20.376,6,3106,2934123,2026,1370,9,1408,2873299,1080,931,18,2816,60824
2.25,6,21,6360,9,262,275,517,1264,12,744,200,1418,5096
1776.524,17,73,3060,72,14,25021,14,3024,1,8,0,8,36
7.477,6,21,4573,10,214,803,383,1692,11,487,723,1179,2881
23.115,1,4,224,4,28,7705,28,224,0,0,0,0,0
22.04,17,4,240,2,32,22039,32,120,2,32,22038,32,120
421.177,2,5,160,5,8,105294,8,160,0,0,0,0,0
1751.543,6,95,7203,63,38,28250,205,4476,32,33,56495,98,2727
4.607,6,41,7349,21,218,230,314,3463,20,440,229,1152,3886
1770.621,6,100,9292,66,65,27240,65,5577,34,59,53652,59,3715
78.175,1,4,224,4,28,26058,28,224,0,0,0,0,0
273.395,6,6,1255,4,327,91131,413,814,2,180,273187,269,441
40.353,17,4,304,4,48,13451,48,304,0,0,0,0,0
1741.105,1,14,784,14,28,133931,28,784,0,0,0,0,0
1772.231,6,180,15480,120,69,14892,69,8940,60,69,30037,69,6540
1772.929,6,180,15480,120,69,14898,69,8940,60,69,30042,69,6540
7.052,17,2,672,2,308,7052,308,672,0,0,0,0,0
21.71,6,18,13148,6,424,4342,721,1518,12,1393,1956,2840,11630
123.249,6,634,675037,218,714,567,1448,14917,416,1568,296,2896,660120
0.208,6,40,16946,23,1009,9,1420,12045,17,467,12,2840,4901
24.873,6,15,2716,7,821,4144,1420,1926,8,231,3552,231,790
1786.562,6,150,24780,90,483,20073,483,19170,60,83,30280,83,5610
0.049,17,2,212,1,46,0,46,74,1,110,0,110,138
0.301,17,2,152,1,48,0,48,76,1,48,0,48,76
1744.642,2,28,896,28,8,64616,8,896,0,0,0,0,0
332.229,6,48,6559,21,125,9775,722,2375,27,154,12771,1408,4184
1350.171,6,76,6040,50,63,27554,63,3575,26,57,53901,57,2465
13.25,6,14,2181,8,322,1892,581,1069,6,396,2605,580,1112
73.248,6,28,7352,12,158,6658,267,1277,16,603,4881,1400,6075
125.304,2,2,64,2,8,125304,8,64,0,0,0,0,0
0.637,17,4,624,2,64,635,64,184,2,192,519,192,440
0.022,1,4,416,0,0,0,0,0,4,76,7,76,416
0.33,6,26,9039,13,266,27,705,1750,13,943,24,1402,7289
0.397,17,2,167,1,39,0,39,67,1,72,0,72,100
20.906,6,20,3130,12,183,1900,517,1561,8,381,2985,499,1569
0.227,17,7,2131,7,276,37,317,2131,0,0,0,0,0
1795.047,6,356,22520,208,69,8671,69,12460,148,69,12211,69,10060
0.187,6,2,100,1,0,0,0,60,1,0,0,0,40
7.918,6,24,6993,7,140,1319,267,849,17,454,493,1420,6144
36.282,2,2,64,2,8,36282,8,64,0,0,0,0,0
0.546,6,22,7312,13,325,45,626,1984,9,1210,62,1946,5328
6.206,6,1691,1579577,1076,1389,5,1408,1542933,615,931,9,2801,36644
1794.906,17,87,3648,86,14,21116,14,3612,1,8,0,8,36
1.614,6,47,19172,27,891,62,1360,13596,20,433,74,1360,5576
1681.509,1,15,840,15,28,120107,28,840,0,0,0,0,0
0.172,17,2,146,1,37,0,37,65,1,53,0,53,81
0.075,17,2,317,1,43,0,43,71,1,218,0,218,246
1783.549,6,103,8395,68,65,26620,65,4930,35,59,52454,59,3465
0.091,17,4,284,2,32,0,32,120,2,54,78,60,164
0.093,17,4,420,2,33,0,33,122,2,121,4,145,298
115.524,6,22,4684,9,272,1041,516,1180,13,298,9619,1452,3504
0.917,6,10,1687,7,100,152,100,384,3,1179,331,1179,1303
2.421,17,24,8165,10,250,269,1350,2783,14,356,122,1350,5382
13.743,6,26,4816,13,154,1127,722,1768,13,473,1131,1408,3048
1781.759,6,356,22520,208,69,8607,69,12460,148,69,12120,69,10060
307.255,6,94,61328,54,1195,5797,1368,54236,40,828,1107,1571,7092
1738.7,6,87,6322,58,31,30503,31,3915,29,31,62096,31,2407
1793.64,17,87,3648,86,14,21101,14,3612,1,8,0,8,36
1.333,6,38,9848,20,502,70,1460,4352,18,433,65,1460,5496
0.469,6,2,80,1,0,0,0,40,1,0,0,0,40
76.12,6,30,7432,13,158,6343,267,1317,17,543,4754,1400,6115
1772.463,6,241,17920,121,69,14770,69,8980,120,34,14894,48,8940
1785.474,17,87,3648,86,14,21005,14,3612,1,8,0,8,36
2.354,6,23,5714,13,158,169,370,1315,10,998,237,1691,4399
30.416,6,31,7746,11,155,14,267,1226,20,357,1600,3417,6520
1782.505,17,83,3480,82,14,22006,14,3444,1,8,0,8,36
1786.654,6,118,9172,72,65,25164,65,5090,46,59,39699,59,4082
2.495,17,4,1568,4,364,831,364,1568,0,0,0,0,0
1798.314,17,142,11360,71,48,25690,48,5396,71,56,25690,56,5964
45.136,6,34,9067,14,327,148,1189,2535,20,440,2374,1460,6532
0.076,17,2,642,1,300,0,300,328,1,286,0,286,314
1.306,6,46,18747,27,864,50,1360,13211,19,529,62,4075,5536
28.554,6,33,7826,11,155,12,267,1226,22,317,1359,1420,6600
1787.15,6,102,8228,68,64,26673,64,4896,34,58,54153,58,3332
0.008,17,2,410,1,36,0,36,64,1,318,0,318,346
364.45,6,27,1767,18,177,21438,177,1181,9,110,9136,110,586
1680.579,17,29,6815,29,207,60020,207,6815,0,0,0,0,0
0.01,17,2,308,1,34,0,34,62,1,218,0,218,246
0.186,6,7,380,4,0,62,0,216,3,0,25,0,164
24.811,6,3596,3431892,2311,1406,10,1448,3360408,1285,776,19,1448,71484
1.365,17,2,154,1,41,0,41,69,1,57,0,57,85
0.012,17,2,152,1,48,0,48,76,1,48,0,48,76
41.642,1,47,4888,0,0,0,0,0,47,76,905,76,4888
10.776,6,20,4442,11,275,1077,275,998,9,768,751,1440,3444
299.95,6,6,364,4,31,99983,31,222,2,31,299658,31,142
300.145,6,41,10189,21,619,14998,1360,4587,20,399,15788,1360,5602
0.009,6,3,327,2,103,1,138,287,1,0,0,0,40
180.322,6,24,11318,12,433,68,990,1823,12,1125,16380,2568,9495
0.451,6,14,6045,8,182,64,182,606,6,1279,13,1408,5439
0.256,6,23,8222,13,483,20,808,2159,10,1107,27,2122,6063
186.665,17,4,352,2,60,186663,60,176,2,60,186663,60,176
0.003,6,2,80,2,0,0,0,80,0,0,0,0,0
1772.572,6,180,15480,120,69,14895,69,8940,60,69,30042,69,6540
842.254,2,7,224,7,8,140375,8,224,0,0,0,0,0
170.606,6,20467,19966169,14168,1334,12,1368,19633885,6299,776,27,1473,332284
1.697,6,28,10333,16,368,113,837,1749,12,1012,146,1420,8584
3.57,17,3,177,3,31,1785,31,177,0,0,0,0,0
0.298,6,26,6066,12,164,27,453,1442,14,555,22,1542,4624
0.0,17,1,247,1,219,0,219,247,0,0,0,0,0
0.0,17,1,83,1,55,0,55,83,0,0,0,0,0
1791.047,6,355,22480,207,69,8694,69,12420,148,69,12183,69,10060
92.581,6,26,10494,13,397,62,884,1769,13,910,7704,1360,8725
124.327,17,4,240,2,32,124326,32,120,2,32,124326,32,120
26.307,17,8,608,8,48,3758,48,608,0,0,0,0,0
1770.891,1,58,4872,0,0,0,0,0,58,56,31068,56,4872
342.468,17,6,2016,6,308,68493,308,2016,0,0,0,0,0
1771.491,6,107,9733,67,65,26840,65,5694,40,59,45419,59,4039
1.644,17,2,170,1,37,0,37,65,1,77,0,77,105
4.033,17,2,144,1,36,0,36,64,1,52,0,52,80
0.4,6,10,967,5,256,98,256,460,5,303,98,303,507
1776.096,6,156,14776,79,58,22769,517,5638,77,179,23369,1408,9138
28.955,6,37,9527,19,642,491,1360,4005,18,435,1693,2667,5522
0.011,6,2,218,1,138,0,138,178,1,0,0,0,40
0.33,17,4,624,2,64,210,64,184,2,192,214,192,440
1797.071,17,448,39896,403,35,4470,288,25676,45,288,40022,288,14220
15.132,6,5,752,3,46,7566,46,166,2,506,14960,506,586
31.466,17,7,604,4,48,10480,48,304,3,72,15724,72,300
0.583,17,4,820,2,36,578,36,128,2,318,577,318,692
1743.434,6,95,7203,63,38,28119,205,4476,32,33,56228,98,2727
1650.7,1,8,448,8,28,235814,28,448,0,0,0,0,0
284.958,1,4,224,4,28,94986,28,224,0,0,0,0,0
1792.514,6,342,38960,174,169,10361,655,31341,168,31,10613,31,7619
2.182,17,3,174,3,30,1091,30,174,0,0,0,0,0
1772.757,6,180,15480,120,69,14897,69,8940,60,69,30039,69,6540
16.015,17,20,5553,10,303,1775,1350,3312,10,196,1775,1350,2241
124.523,1,4,224,4,28,41507,28,224,0,0,0,0,0
12.127,17,10,850,5,37,3020,37,325,5,77,3020,77,525
1772.22,6,180,15480,120,69,14892,69,8940,60,69,30035,69,6540
0.01,17,2,308,1,34,0,34,62,1,218,0,218,246
0.304,6,27,9071,13,247,25,624,1672,14,832,22,1408,7399
107.67,6,35,7837,13,155,8972,267,1306,22,331,5117,1420,6531
589.31,6,50,10456,25,315,24551,517,2920,25,778,24551,2448,7536
1745.652,6,95,7203,63,38,28155,205,4476,32,33,56299,98,2727
0.988,6,28,8529,16,263,54,586,2250,12,826,73,3132,6279
5.421,6,39,7269,21,218,271,314,3463,18,513,304,1179,3806
5.764,6,18,2761,11,125,576,245,1070,7,1407,913,1407,1691
0.525,17,22,14856,10,665,58,1350,6931,12,632,36,1350,7925
5.621,6,7,400,3,0,2810,0,160,4,0,1371,0,240
0.972,17,11,4974,5,468,243,1350,2482,6,387,175,1350,2492
8.15,1,9,756,0,0,0,0,0,9,56,1018,56,756
1740.471,17,30,31680,30,1028,60016,1028,31680,0,0,0,0,0
0.081,6,10,766,5,185,19,185,453,5,45,18,45,313
0.528,6,49,20824,27,972,20,1380,15702,22,468,22,3303,5122
6.258,6,3,120,2,0,6080,0,80,1,0,0,0,40
2.651,17,27,6084,12,253,238,1350,3374,15,152,187,1350,2710
12.145,6,6,328,4,0,4048,0,216,2,0,11918,0,112
706.006,17,1089,168762,569,142,1242,1209,97035,520,109,307,1252,71727
0.383,6,13,1693,7,288,60,288,588,6,426,40,434,1105
4.334,6,5,280,2,0,4334,0,100,3,0,1509,0,180
3.387,17,4,240,4,32,1129,32,240,0,0,0,0,0
95.51,6,31,7472,13,158,7959,267,1317,18,543,5616,1400,6155
1787.357,6,105,8416,68,65,26676,65,4930,37,59,49645,59,3486
360.977,2,3,96,3,8,180488,8,96,0,0,0,0,0
1796.412,17,448,39896,403,35,4468,288,25676,45,288,40018,288,14220
1744.967,1,168,9408,168,28,10448,28,9408,0,0,0,0,0
5.635,6,4,942,2,0,5635,0,80,2,391,2300,391,862
1771.723,6,99,9306,66,66,27257,66,5610,33,60,55362,60,3696
59.092,1,2,112,2,28,59092,28,112,0,0,0,0,0
1796.09,17,449,39928,404,35,4456,288,25708,45,288,40013,288,14220
1772.109,6,180,15480,120,69,14891,69,8940,60,69,30032,69,6540
1786.218,6,106,8586,70,65,25887,65,5140,36,59,51031,59,3446
3.903,6,16,1221,10,182,433,182,738,6,77,145,134,483
1792.053,17,87,3648,86,14,21082,14,3612,1,8,0,8,36
31.837,6,75,66892,29,141,1137,345,1931,46,1489,707,2836,64961
1758.27,17,264,53747,264,175,6685,422,53747,0,0,0,0,0
1.359,17,22,6756,10,354,150,1350,3826,12,216,120,1350,2930
270.737,6,28,7352,12,158,24612,267,1277,16,603,18045,1400,6075
1775.155,17,73,3060,72,14,25002,14,3024,1,8,0,8,36
0.023,17,2,230,1,55,0,55,83,1,119,0,119,147
10.834,6,18,5610,10,275,1203,275,958,8,1440,831,1440,4652
5.021,17,4,288,2,36,5002,36,128,2,52,5004,52,160
5.97,6,40,7309,21,218,298,314,3463,19,513,316,1179,3846
8.38,6,1625,1519030,1018,1414,8,1448,1482802,607,776,13,1448,36228
33.601,6,30,5042,15,180,2400,722,1859,15,342,2385,1448,3183
1683.427,17,16,1265,8,30,240482,37,471,8,71,240481,136,794
1750.579,17,12,498,11,14,175057,14,462,1,8,0,8,36
15.838,6,2,1235,1,0,0,0,40,1,1155,0,1155,1195
32.06,6,45,9992,23,315,1457,721,3453,22,564,1477,1420,6539
1798.689,17,87,3648,86,14,21161,14,3612,1,8,0,8,36
1786.034,6,155,20046,92,316,19626,316,14272,63,83,28806,83,5774
1.03,17,3,436,2,46,1000,46,148,1,260,0,260,288
0.284,17,4,502,2,31,279,31,118,2,164,278,164,384
1789.125,6,362,22898,210,69,8560,69,12678,152,69,11846,69,10220
1.667,17,2,188,1,37,0,37,65,1,95,0,95,123
0.065,17,4,284,2,32,59,32,120,2,54,58,60,164
1798.884,17,142,11360,71,48,25698,48,5396,71,56,25698,56,5964
3.411,6,2,88,2,0,0,0,88,0,0,0,0,0
0.265,17,2,476,1,39,0,39,67,1,381,0,381,409
1789.69,17,142,11360,71,48,25566,48,5396,71,56,25566,56,5964
122.581,6,292,291773,96,671,1289,1448,10382,196,1458,627,2896,281391
24.983,6,18,1407,9,222,3121,222,808,9,231,3120,231,599
1709.484,17,12,498,11,14,170948,14,462,1,8,0,8,36
1598.374,6,163,12578,92,65,17564,65,6670,71,59,22736,59,5908
0.611,6,10,924,5,283,103,283,551,5,105,104,105,373
0.451,17,2,776,2,360,451,360,776,0,0,0,0,0
6.039,17,63,41604,27,414,230,1350,11957,36,795,171,1350,29647
4.193,17,5,295,5,31,1048,31,295,0,0,0,0,0
38.389,17,22,1936,11,48,3832,48,836,11,72,3835,72,1100
1793.274,17,142,11360,71,48,25618,48,5396,71,56,25618,56,5964
1793.052,17,87,3648,86,14,21094,14,3612,1,8,0,8,36
4.048,6,32,6089,17,206,253,314,2744,15,548,269,1179,3345
3.317,17,3,1173,3,363,1658,363,1173,0,0,0,0,0
96.979,6,25,9401,12,418,66,953,1780,13,787,8070,1440,7621
1787.914,6,364,25392,212,100,8473,469,14896,152,69,11840,69,10496
0.001,17,8,2758,8,316,0,355,2758,0,0,0,0,0
0.835,6,24,6466,13,313,68,906,2092,11,786,82,1420,4374
60.026,6,39,10934,14,450,78,1189,3724,25,310,2500,1420,7210
280.437,6,30,7432,13,158,23369,267,1317,17,603,17524,2076,6115
1786.618,6,108,8536,68,65,26665,65,4930,40,59,45807,59,3606
1778.434,1,59,4956,59,56,30662,56,4956,0,0,0,0,0
0.056,17,2,157,1,31,0,31,59,1,70,0,70,98
0.071,17,4,336,2,34,0,34,124,2,78,1,84,212
1778.46,6,181,15589,120,69,14945,69,8940,61,69,29633,69,6649
337.078,17,6,528,3,60,168538,60,264,3,60,168538,60,264
127.477,6,6,1225,4,319,42492,398,799,2,173,127286,254,426
1799.373,1,16,896,16,28,119958,28,896,0,0,0,0,0
101.688,6,24,8207,12,420,50,958,1797,12,739,9233,2720,6410
0.015,17,2,921,1,317,0,317,345,1,548,0,548,576
1796.046,6,366,23196,212,69,8512,69,12896,154,69,11736,69,10300
1787.829,6,392,91344,177,421,10157,1460,66607,215,164,8353,1460,24737
7.839,17,12,1764,6,48,1564,48,456,6,190,1565,308,1308
481.29,2,5,160,5,8,120322,8,160,0,0,0,0,0
0.024,17,2,543,1,34,0,34,62,1,453,0,453,481
1790.626,6,356,22520,208,69,8650,69,12460,148,69,12180,69,10060
0.002,6,3,181,1,0,0,0,40,2,37,0,37,141
1790.059,17,179,13962,179,50,10056,50,13962,0,0,0,0,0
0.324,6,20,7194,9,265,40,764,1539,11,1015,31,2371,5655
0.231,17,4,304,2,37,224,37,130,2,59,224,65,174
1.458,6,30,10064,18,377,85,863,1855,12,965,123,1452,8209
1785.862,6,385,26280,217,100,8267,469,15096,168,55,10693,69,11184
1772.363,6,180,15480,120,69,14893,69,8940,60,69,30037,69,6540
31.587,6,7,336,1,0,0,0,48,6,0,6315,0,288
1782.17,17,83,3480,82,14,22002,14,3444,1,8,0,8,36
1.319,17,15,8442,8,705,188,1350,5869,7,339,210,1350,2573
1796.966,17,448,39896,403,35,4470,288,25676,45,288,40017,288,14220
1798.437,6,266,21823,132,99,13728,469,11765,134,35,13521,69,10058
9.243,6,46,8742,24,231,401,314,4435,22,489,426,1179,4307
251.325,6,159,129812,107,1301,2370,1408,116177,52,642,3681,2439,13635
0.892,17,2,782,2,363,892,363,782,0,0,0,0,0
18.019,17,19,9717,9,733,2247,1350,6854,10,258,1997,1350,2863
1796.546,1,58,4872,0,0,0,0,0,58,56,31518,56,4872
1.938,17,22,6794,10,354,214,1350,3820,12,219,173,1350,2974
1773.617,6,180,15480,120,69,14904,69,8940,60,69,30053,69,6540
0.141,6,46,22392,27,1087,5,1420,17411,19,467,7,1883,4981
1797.061,6,366,25610,213,99,8476,469,15005,153,69,11821,69,10605
1795.988,17,447,39864,402,35,4478,288,25644,45,288,40021,288,14220
240.214,6,52,17991,27,798,9238,1418,14991,25,211,10008,580,3000
6.436,6,1620,1329056,865,1433,7,1448,1275348,755,776,8,1448,53708
1787.866,6,102,8160,68,63,26684,63,4862,34,57,54174,57,3298
64.452,17,64,25256,32,567,2079,1350,19041,32,166,2074,1350,6215
3.8,17,4,352,2,48,3789,48,152,2,72,3788,72,200
1799.053,1,58,4872,0,0,0,0,0,58,56,31562,56,4872
1786.814,6,102,8228,68,64,26668,64,4896,34,58,54143,58,3332
280.236,6,29,7392,13,158,23353,267,1317,16,603,18679,2800,6075
0.08,6,10,1495,5,507,19,507,727,5,556,20,556,768
1776.677,6,78,4108,39,26,46753,26,2054,39,26,46753,26,2054
0.007,17,2,204,1,34,0,34,62,1,114,0,114,142
378.236,2,4,128,4,8,126078,8,128,0,0,0,0,0
1.409,17,4,352,2,60,1407,60,176,2,60,1408,60,176
1772.02,6,180,15480,120,69,14890,69,8940,60,69,30033,69,6540
299.161,17,4,558,2,36,299156,36,128,2,187,299156,187,430
0.155,6,10,1384,6,145,31,145,389,4,831,48,831,995
0.029,17,2,273,1,35,0,35,63,1,182,0,182,210
1787.67,17,83,3480,82,14,22070,14,3444,1,8,0,8,36
1.842,6,27,8851,16,286,122,591,1503,11,863,163,1380,7348
300.524,6,77,15113,37,278,8347,1063,5550,40,373,7705,1402,9563
1744.089,6,95,7203,63,38,28130,205,4476,32,33,56246,98,2727
0.228,17,2,172,1,50,0,50,78,1,66,0,66,94
240.252,6,55,18380,28,825,8897,1418,15489,27,184,9240,580,2891
576.21,1,6,696,6,88,115242,88,696,0,0,0,0,0
1.301,6,39,11298,22,547,61,1360,5842,17,529,70,4075,5456
0.196,6,46,20969,26,1063,7,1420,15948,20,467,9,1883,5021
0.165,17,2,216,1,45,0,45,73,1,115,0,115,143
3.188,6,6,328,4,0,1062,0,216,2,0,3130,0,112
1.838,6,41,8431,21,321,91,1164,2810,20,400,83,1460,5621
0.049,17,2,182,1,39,0,39,67,1,87,0,87,115
1.554,6,47,19132,27,888,59,1360,13556,20,476,69,2715,5576
1666.1,1,8,448,8,28,238014,28,448,0,0,0,0,0
367.411,6,23,1535,16,177,24494,177,1053,7,110,10373,110,482
134.542,6,32,8952,14,158,10349,267,1357,18,624,7904,1400,7595
295.573,1,4,224,4,28,98524,28,224,0,0,0,0,0
242.793,6,55,15127,25,528,10116,1418,7681,30,531,8371,1418,7446
0.594,6,21,5000,11,137,59,267,1132,10,692,52,1467,3868
240.388,6,52,9397,27,524,9245,1418,6153,25,176,10015,618,3244
240.182,6,53,17914,29,754,8577,1408,15098,24,195,10442,580,2816
1.058,17,3,451,2,39,625,39,134,1,289,0,289,317
60.179,2,2,64,2,8,60179,8,64,0,0,0,0,0
44.202,6,28,7217,13,155,3683,267,1306,15,482,3156,1997,5911
3.198,17,5,295,5,31,799,31,295,0,0,0,0,0
1799.337,17,448,39896,403,35,4475,288,25676,45,288,40020,288,14220
1783.813,6,361,22927,209,69,8576,69,12707,152,69,11813,69,10220
0.035,17,2,410,1,50,0,50,78,1,304,0,304,332
1770.256,6,99,9174,66,64,27234,64,5544,33,58,55317,58,3630
0.306,17,3,507,2,39,59,39,134,1,345,0,345,373
287.799,1,7,392,7,28,47966,28,392,0,0,0,0,0
111.063,6,66,44272,42,1176,2708,1448,36299,24,839,2682,2359,7973
4.366,6,16,2676,9,207,545,245,985,7,703,674,1152,1691
8.108,1,9,756,0,0,0,0,0,9,56,1013,56,756
0.333,17,8,2766,8,317,47,356,2766,0,0,0,0,0
1797.542,1,345,28980,345,56,5225,56,28980,0,0,0,0,0
0.043,17,2,218,1,44,0,44,72,1,118,0,118,146
12.218,6,9,376,5,0,3053,0,204,4,0,4069,0,172
1.0,17,2,677,1,300,0,300,328,1,321,0,321,349
0.075,6,12,3462,6,75,15,75,395,6,1373,15,1448,3067
1680.743,17,13,534,11,14,168055,14,462,2,8,1680558,8,72
1786.318,6,361,22927,209,69,8588,69,12569,152,69,11829,69,10358
243.278,6,46,6755,21,317,12163,686,3665,25,195,10136,580,3090
245.413,6,2646,2588021,974,736,251,1396,63641,1672,1473,146,5584,2524380
1786.607,6,104,8444,68,66,26665,66,4964,36,60,51041,60,3480
182.509,6,35,5443,17,144,11406,722,2038,18,273,10722,1408,3405
13.988,6,24,6993,13,275,1165,275,1078,11,910,872,1440,5915
0.052,17,2,192,1,30,0,30,58,1,106,0,106,134
242.354,6,47,9240,22,524,11540,1418,5884,25,186,10097,618,3356
0.062,17,4,284,2,32,1,32,120,2,54,1,60,164
0.122,17,4,352,2,37,66,37,130,2,83,59,89,222
33.829,6,29,4987,14,180,2602,721,1805,15,342,2400,1368,3182
110.196,6,14,12073,14,822,8476,1460,12073,0,0,0,0,0
3.523,6,6,328,4,0,1174,0,216,2,0,3507,0,112
1768.341,1,59,4956,0,0,0,0,0,59,56,30488,56,4956
2.997,17,8,848,4,46,998,46,296,4,110,998,110,552
1.212,17,26,6544,11,269,118,1350,3273,15,190,84,1350,3271
0.079,17,2,348,1,39,0,39,67,1,253,0,253,281
1773.199,6,180,15480,120,69,14900,69,8940,60,69,30051,69,6540
1792.515,17,178,11392,178,36,10127,36,11392,0,0,0,0,0
1784.338,17,83,3480,82,14,22028,14,3444,1,8,0,8,36
0.054,17,2,152,2,48,54,48,152,0,0,0,0,0
159.143,17,2,152,2,48,159143,48,152,0,0,0,0,0
93.591,17,4,352,2,60,93590,60,176,2,60,93589,60,176
1790.697,1,258,14448,258,28,6967,28,14448,0,0,0,0,0
1763.664,6,4095,3752350,1511,151,1167,967,91291,2584,1403,682,2836,3661059
0.057,17,4,284,2,32,0,32,120,2,54,39,60,164
1783.962,6,107,8417,68,63,26626,63,4862,39,57,46944,57,3555
59.268,6,30,7865,8,185,1054,267,1256,22,336,2821,1420,6609
375.906,6,20,1358,15,180,26850,180,980,5,110,15164,110,378
3.645,17,4,368,4,64,1215,64,368,0,0,0,0,0
1798.242,2,25,800,25,8,74926,8,800,0,0,0,0,0
0.785,6,10,1687,7,100,130,100,384,3,1179,265,1179,1303
1787.295,6,102,8228,68,64,26676,64,4896,34,58,54157,58,3332
1789.355,17,142,11360,71,48,25562,48,5396,71,56,25562,56,5964
1785.864,6,362,24774,211,94,8504,469,14387,151,69,11905,69,10387
1776.411,17,73,3060,72,14,25019,14,3024,1,8,0,8,36
0.059,17,2,148,1,30,0,30,58,1,62,0,62,90
0.01,6,2,80,0,0,0,0,0,2,0,0,0,80
94.649,17,60,15550,60,231,1604,389,15550,0,0,0,0,0
667.04,6,39,2896,20,31,28524,31,1350,19,31,37047,31,1546
1797.402,6,404,28077,225,104,8024,469,16092,179,56,10097,69,11985
36.959,17,22,1672,22,48,1759,48,1672,0,0,0,0,0
15.653,17,22,7474,10,361,1735,1350,3890,12,270,1418,1350,3584
1773.508,6,180,15480,120,69,14903,69,8940,60,69,30057,69,6540
0.005,17,2,317,1,48,0,48,76,1,213,0,213,241
89.433,17,4,240,2,32,89431,32,120,2,32,89432,32,120
615.956,6,146,19017,60,102,10439,621,5798,86,155,7244,2720,13219
2.048,17,6,1450,3,32,716,32,180,3,395,0,470,1270
2.097,6,27,6164,14,108,161,147,999,13,662,145,1430,5165
0.051,17,2,323,1,33,0,33,61,1,234,0,234,262
28.637,17,31,12486,16,515,1906,1350,8697,15,224,2021,1350,3789
0.005,17,2,213,1,31,0,31,59,1,126,0,126,154
5.49,6,41,7365,22,218,261,314,3503,19,516,290,1179,3862
0.155,6,47,22585,27,1096,5,1420,17564,20,420,7,1420,5021
250.008,6,30,8872,13,158,20834,267,1317,17,687,15621,1400,7555
1792.107,1,232,12992,232,28,7758,28,12992,0,0,0,0,0
69.135,6,193,131578,98,430,712,647,6490,95,1305,729,2816,125088
3.71,2,2,64,2,8,3710,8,64,0,0,0,0,0
0.384,6,14,1733,7,288,61,288,588,7,284,36,434,1145
1.177,6,10,1687,7,100,196,100,384,3,1179,435,1179,1303
0.029,6,13,3980,7,88,4,88,388,6,1670,5,1880,3592
137.338,6,35,23879,19,840,36,1360,5835,16,1932,9147,5440,18044
10.017,17,34,25368,17,747,626,1350,13190,17,688,403,1350,12178
1799.714,17,449,39928,404,35,4465,288,25708,45,288,40017,288,14220
0.011,17,3,208,2,36,8,36,128,1,52,0,52,80
4.208,17,607,212597,375,481,11,1108,191244,232,64,18,598,21353
10.765,6,20,7050,11,275,1076,275,998,9,1420,748,1420,6052
254.324,6,50,11058,31,320,8477,1360,5451,19,371,482,1360,5607
9.139,6,78,24325,41,550,228,1152,18704,37,459,246,1179,5621
366.826,6,28,4025,19,342,20379,342,2490,9,232,24695,233,1535
1177.82,6,146,17388,88,79,12793,267,6928,58,156,20663,2840,10460
75.33,6,118,89282,75,1250,1017,1408,78926,43,737,1788,2439,10356
0.041,17,4,284,2,32,0,32,120,2,54,10,60,164
0.32,17,8,2766,8,317,45,356,2766,0,0,0,0,0
280.463,6,29,7392,13,158,23371,267,1317,16,775,18692,4836,6075
0.431,6,59,27086,34,1000,13,1380,18496,25,630,16,3303,8590
0.007,17,2,422,1,61,0,61,89,1,305,0,305,333
5.0,17,6,1392,6,204,1000,204,1392,0,0,0,0,0
47.275,17,26,2288,13,48,3938,48,988,13,72,3938,72,1300
1673.634,1,106,5936,106,28,15939,28,5936,0,0,0,0,0
334.023,6,71,5018,25,69,13917,69,1759,46,47,7422,69,3259
1.433,6,24,8004,12,164,110,267,1288,12,1216,112,3859,6716
240.305,6,43,9099,21,524,12014,1418,5817,22,236,11442,617,3282
1755.324,6,199,26502,106,304,16717,304,18048,93,83,19074,83,8454
99.321,6,30,7570,12,158,9029,267,1277,18,506,5825,1400,6293
52.704,6,61,23858,29,761,1879,917,20212,32,393,1692,1179,3646
645.36,17,48,3824,26,48,25814,48,1976,22,56,25771,56,1848
1770.233,6,101,9344,66,65,27234,65,5577,35,59,52062,59,3767
188.227,17,4,304,2,48,188213,48,152,2,48,188212,48,152
2.233,17,3,1167,3,361,1116,361,1167,0,0,0,0,0
62.853,6,85,55287,49,1226,1309,1448,46693,36,839,1761,2359,8594
0.008,17,2,384,1,39,0,39,67,1,289,0,289,317
1.996,1,3,252,3,56,998,56,252,0,0,0,0,0
1680.238,1,15,840,15,28,120017,28,840,0,0,0,0,0
0.133,6,4,208,3,0,43,0,156,1,0,0,0,52
0.101,17,2,152,1,48,0,48,76,1,48,0,48,76
143.256,17,7,532,7,48,23876,48,532,0,0,0,0,0
7.279,6,963,818732,566,1366,12,1408,793424,397,931,17,2816,25308
1772.998,6,180,15480,120,69,14899,69,8940,60,69,30046,69,6540
37.654,1,8,848,8,78,5379,78,848,0,0,0,0,0
0.128,6,10,1380,6,145,25,145,389,4,827,40,827,991
11.655,6,14,1247,7,222,1941,222,728,7,231,1941,231,519
5.654,6,40,7309,20,218,297,314,3423,20,513,283,1179,3886
1767.845,1,54,4536,54,56,33355,56,4536,0,0,0,0,0
2.219,6,14,3203,7,145,369,145,429,7,830,339,830,2774
2.909,17,4,624,4,128,969,128,624,0,0,0,0,0
376.363,6,25,1651,17,177,23522,177,1117,8,110,9282,110,534
352.285,17,8,2688,8,308,50326,308,2688,0,0,0,0,0
240.182,6,59,20142,30,811,8282,1408,16993,29,204,8577,580,3149
1.287,6,46,19206,27,897,49,1360,13670,19,476,61,2720,5536
1.651,6,49,18791,27,858,63,1360,13135,22,433,69,1360,5656
9.726,6,1558,1464401,962,1438,9,1448,1423705,596,776,16,1448,40696
0.241,17,2,148,1,32,0,32,60,1,60,0,60,88
1770.608,6,99,9306,66,66,27240,66,5610,33,60,55328,60,3696
1745.808,6,95,7203,63,38,28158,205,4476,32,33,56306,98,2727
0.246,6,2,104,1,0,0,0,64,1,0,0,0,40
272.999,17,6,360,3,32,136499,32,180,3,32,136499,32,180
12.677,17,2,152,2,48,12677,48,152,0,0,0,0,0
1794.958,17,142,11360,71,48,25642,48,5396,71,56,25642,56,5964
1776.586,17,73,3060,72,14,25022,14,3024,1,8,0,8,36
1263.342,2,11,352,11,8,126334,8,352,0,0,0,0,0
1.467,6,38,8264,18,320,86,1162,2688,20,433,67,1360,5576
1786.319,6,102,8364,68,66,26661,66,4964,34,60,54125,60,3400
1660.888,6,23,1385,15,31,118634,31,817,8,31,237217,31,568
0.053,17,2,740,2,342,53,353,740,0,0,0,0,0
4.957,6,38,7245,19,218,275,314,3383,19,516,261,1179,3862
1782.972,17,85,3558,83,14,21740,14,3486,2,8,1782526,8,72
1554.97,1,7,392,7,28,259161,28,392,0,0,0,0,0
39.478,17,3,1236,3,384,19739,394,1236,0,0,0,0,0
227.933,17,8,2688,8,308,32561,308,2688,0,0,0,0,0
280.24,6,30,7432,13,158,23353,267,1317,17,603,17513,2036,6115
0.421,6,21,7203,13,318,35,600,1958,8,964,57,1471,5245
11.504,6,46,14983,24,197,500,1024,2632,22,818,537,1929,12351
2.192,6,13,2311,8,188,313,245,700,5,1407,472,1407,1611
1785.104,6,102,8364,68,66,26643,66,4964,34,60,54091,60,3400
1762.473,6,192,11749,95,47,18749,208,6908,97,31,18356,31,4841
4.175,6,39,7269,19,218,231,314,3383,20,440,206,1152,3886
1650.479,1,8,448,8,28,235782,28,448,0,0,0,0,0
11.453,6,26,11958,13,275,954,275,1078,13,1293,915,1414,10880
167.836,6,22,5034,8,220,7846,515,1204,14,272,12902,1452,3830
30.324,6,4078,3871424,2611,1402,11,1448,3790476,1467,776,20,1448,80948
0.115,6,9,1343,5,145,28,145,349,4,830,31,830,994
1793.725,6,732,54614,360,38,4996,1448,25901,372,49,4834,1448,28713
94.43,6,21,8712,11,314,70,634,1415,10,1147,10477,2568,7297
318.762,6,24,4715,10,187,35418,187,727,14,361,19569,494,3988
4.3,6,35,6209,18,206,252,314,2784,17,456,252,1152,3425
13.532,1,4,224,4,28,4510,28,224,0,0,0,0,0
1780.608,6,465,26880,258,69,6928,69,14460,207,34,8643,64,12420
66.461,6,19,776,9,0,5933,0,364,10,0,7383,0,412
0.887,6,25,9110,14,212,68,495,1467,11,1027,71,1360,7643
79.483,1,16,1664,0,0,0,0,0,16,76,5298,76,1664
1.19,6,30,5292,15,184,85,536,1894,15,431,77,1368,3398
0.039,6,10,861,6,182,7,182,490,4,77,3,134,371
1784.036,6,367,23236,212,69,8455,69,12896,155,69,11584,69,10340
9.164,17,8,1792,4,46,3050,46,296,4,346,3050,346,1496
171.564,6,5280,5554453,1813,794,94,1448,108633,3467,1525,49,5792,5445820
61.819,6,71,48051,44,1175,1437,1408,39913,27,960,2368,3847,8138
0.191,6,9,1339,5,145,47,145,349,4,826,41,826,990
1.311,6,46,18803,27,868,50,1360,13267,19,476,63,2720,5536
1786.798,6,106,8716,71,66,25525,66,5216,35,60,52546,60,3500
163.795,17,6,528,3,60,81896,60,264,3,60,81896,60,264
35.397,6,25,7103,12,156,3217,267,1272,13,589,2949,3426,5831
1786.979,6,122,13361,74,159,24479,1257,8873,48,67,38018,191,4488
10.354,6,51,13317,25,321,431,1168,3034,26,543,403,1440,10283
7.786,6,14,1047,8,275,1112,275,603,6,96,1194,96,444
3.82,17,5,290,5,30,955,30,290,0,0,0,0,0
18.679,6,2809,2735601,1914,1356,9,1368,2684361,895,776,20,2736,51240
0.037,17,2,239,1,59,0,59,87,1,124,0,124,152
0.585,17,4,624,2,64,583,64,184,2,192,470,192,440
159.757,17,4,240,2,32,159756,32,120,2,32,159756,32,120
1792.429,17,144,11520,72,48,25245,48,5472,72,56,25241,56,6048
1787.152,17,87,3648,86,14,21025,14,3612,1,8,0,8,36
2.049,17,24,7503,11,299,201,1350,3598,13,272,168,1350,3905
1728.531,1,146,15476,146,78,11920,78,15476,0,0,0,0,0
0.423,6,24,6041,13,108,35,147,959,11,773,40,1608,5082
1795.558,17,448,39896,403,35,4466,288,25676,45,288,40022,288,14220
0.481,6,55,21753,30,1018,16,1380,14543,25,475,18,1923,7210
0.053,17,2,279,1,36,0,36,64,1,187,0,187,215
1786.86,6,358,22669,209,69,8590,69,12569,149,69,12073,69,10100
280.23,6,28,7352,13,158,23352,267,1317,15,678,20012,3436,6035
1.481,17,4,1344,4,308,493,308,1344,0,0,0,0,0
0.071,17,5,1762,5,324,17,355,1762,0,0,0,0,0
5.67,6,38,7229,20,218,298,314,3423,18,513,317,1179,3806
28.205,17,32,4704,16,48,1879,48,1216,16,190,1879,308,3488
1681.282,17,14,1036,7,30,280209,30,406,7,62,280210,62,630
1547.84,6,85,6516,52,40,30349,205,3706,33,33,48364,98,2810
0.025,17,2,176,1,60,0,60,88,1,60,0,60,88
0.036,17,2,251,1,36,0,36,64,1,159,0,159,187
173.813,6,20,9762,11,375,70,818,1599,9,1558,21709,3928,8163
0.34,17,3,1057,3,324,170,355,1057,0,0,0,0,0
0.959,6,29,8630,15,229,58,583,2051,14,858,60,1360,6579
11.769,6,1829,1598668,1129,1363,10,1380,1564503,700,558,16,1923,34165
1740.639,17,29,30624,29,1028,62165,1028,30624,0,0,0,0,0
0.0,6,2,135,2,31,0,31,135,0,0,0,0,0
1788.158,6,359,22709,209,69,8596,69,12569,150,69,12000,69,10140
1751.0,6,95,7203,63,38,28241,205,4476,32,33,56474,98,2727
1772.38,6,180,15480,120,69,14893,69,8940,60,69,30032,69,6540
1740.498,17,30,31680,30,1028,60017,1028,31680,0,0,0,0,0
1789.369,17,78,3270,77,14,23544,14,3234,1,8,0,8,36
1.561,6,20,3833,11,234,156,564,1504,9,463,171,1343,2329
11.186,6,104,34133,52,606,219,1152,27555,52,449,214,1179,6578
188.691,17,4,272,2,40,188690,47,136,2,40,188690,47,136
1745.127,6,101,7670,64,38,27700,205,4528,37,32,48465,98,3142
1788.682,6,356,22520,208,69,8640,69,12460,148,69,12167,69,10060
34.697,6,24,6232,14,117,2669,159,1337,10,727,3854,1418,4895
170.994,6,64,15169,33,165,5337,721,4298,31,566,5693,1414,10871
955.483,17,25,20894,25,807,39811,1451,20894,0,0,0,0,0
0.014,17,2,509,1,32,0,32,60,1,421,0,421,449
1799.538,17,449,39928,404,35,4465,288,25708,45,288,40023,288,14220
207.348,6,32,6897,13,189,9160,516,1470,19,291,11514,1452,5427
29.231,6,34,8080,18,311,516,619,1686,16,574,1939,4848,6394
1787.351,6,103,8395,68,65,26676,65,4930,35,59,52565,59,3465
0.808,6,25,5876,13,161,67,267,1491,12,780,66,1460,4385
33.684,6,31,5094,15,154,2406,722,1858,16,342,2233,1402,3236
1757.571,6,111,6687,62,27,28812,27,3668,49,27,36615,27,3019
564.389,17,16,6296,16,365,37625,373,6296,0,0,0,0,0
12.159,6,979,866288,622,1321,19,1368,842216,357,776,33,1473,24072
1794.915,1,218,12208,218,28,8271,28,12208,0,0,0,0,0
7.89,6,78,24677,39,561,207,1152,18976,39,413,201,1152,5701
0.412,6,26,8868,13,227,34,547,1592,13,941,31,1448,7276
66.146,6,24,6717,11,181,6614,267,1172,13,717,5508,1400,5545
1788.911,17,483,62133,217,172,8281,1350,43616,266,41,6749,1350,18517
280.189,6,28,7352,13,158,23349,267,1317,15,678,20010,3900,6035
0.826,17,19,9034,9,587,103,1350,5537,10,321,75,1350,3497
202.768,17,2,150,2,47,202768,47,150,0,0,0,0,0
1795.968,17,449,39928,404,35,4456,288,25708,45,288,40016,288,14220
1772.615,6,180,15480,120,69,14895,69,8940,60,69,30038,69,6540
371.573,6,21,1419,15,177,26540,177,989,6,110,12240,110,430
0.092,2,2,80,2,16,92,16,80,0,0,0,0,0
2.567,17,2,237,1,72,0,72,100,1,109,0,109,137
0.038,17,2,463,1,44,0,44,72,1,363,0,363,391
180.491,2,3,96,3,8,90245,8,96,0,0,0,0,0
194.402,17,3,1000,3,305,97201,308,1000,0,0,0,0,0
3.295,17,4,1564,4,363,1098,363,1564,0,0,0,0,0
0.929,6,10,1687,7,100,154,100,384,3,1179,333,1179,1303
15.257,6,6,288,1,0,0,0,48,5,0,3812,0,240
11.644,6,1280,1148168,765,1420,15,1448,1116700,515,776,22,1448,31468
280.264,6,26,7272,12,158,25478,267,1277,14,775,21550,3445,5995
268.833,6,17,1540,2,112,16470,112,200,15,77,19201,90,1340
1.093,6,26,6488,14,297,84,830,2051,12,790,97,1420,4437
5.662,6,39,7269,19,218,314,314,3383,20,513,282,1179,3886
0.319,17,8,2774,8,318,45,357,2774,0,0,0,0,0
3.481,17,5,900,4,64,3,64,368,1,504,0,504,532
0.199,17,4,352,2,37,0,37,130,2,83,1,89,222
3.989,6,11,467,6,0,797,0,248,5,7,741,7,219
72.904,6,703,319469,360,823,203,1152,300244,343,423,212,1179,19225
0.082,17,2,152,1,48,0,48,76,1,48,0,48,76
0.018,6,2,104,1,0,0,0,40,1,0,0,0,64
0.065,6,2,80,1,0,0,0,40,1,0,0,0,40
5.227,17,6,817,3,31,2105,31,177,3,185,2608,196,640
1793.638,17,87,3648,86,14,21101,14,3612,1,8,0,8,36
300.761,6,39,9955,21,593,15038,1360,4433,18,399,504,1360,5522
1783.507,17,140,11200,70,48,25847,48,5320,70,56,25847,56,5880
1696.512,17,16,1265,8,30,242354,37,471,8,71,242352,136,794
31.459,17,7,604,4,48,10478,48,304,3,72,15721,72,300
37.738,6,20,2601,12,211,3082,211,1090,8,545,4179,904,1511
0.11,17,4,556,2,36,100,36,128,2,186,100,186,428
2.57,17,21,6209,7,348,428,1350,2634,14,227,180,1350,3575
1.532,6,48,19072,26,949,61,1460,13416,22,433,62,1460,5656
54.901,17,12,12996,12,1055,4991,1055,12996,0,0,0,0,0
1786.553,6,102,8364,68,66,26664,66,4964,34,60,54134,60,3400
78.963,6,31,8912,14,158,6074,267,1357,17,687,4924,2036,7555
3.329,17,4,1568,4,364,1109,364,1568,0,0,0,0,0
4.943,17,3,1170,3,362,2471,362,1170,0,0,0,0,0
4.728,6,37,7189,19,218,262,314,3383,18,513,259,1179,3806
1758.948,17,168,13375,158,30,11203,37,9283,10,381,151286,463,4092
4.016,17,10,704,5,32,1002,32,300,5,52,1001,60,404
7.594,6,1430,1381509,913,1437,8,1448,1349961,517,776,14,1448,31548
0.471,6,53,21455,30,998,16,1380,16248,23,387,19,1923,5207
316.336,6,9,522,2,106,316325,106,194,7,0,52720,0,328
1782.512,6,357,22629,208,69,8611,69,12529,149,69,12043,69,10100
18.758,6,6,328,4,0,6252,0,216,2,0,18549,0,112
166.592,17,62,16058,62,231,2731,388,16058,0,0,0,0,0
240.269,6,46,9260,24,523,10446,1408,5965,22,238,11441,618,3295
1757.004,6,134,13311,78,69,22818,721,6630,56,80,31649,1448,6681
0.206,6,12,3705,6,171,40,171,491,6,964,41,1448,3214
675.213,1,16,1344,0,0,0,0,0,16,56,45014,56,1344
240.173,6,51,15525,27,701,9237,1402,12629,24,205,10441,580,2896
1583.811,6,25,3676,16,241,105587,241,2580,9,92,197949,92,1096
11.899,6,1798,1630597,1152,1362,10,1420,1600394,646,475,18,1883,30203
0.03,17,2,214,1,39,0,39,67,1,119,0,119,147
1785.857,6,362,24305,211,88,8504,469,13918,151,69,11905,69,10387
301.952,6,53,9358,27,205,11613,636,2418,26,327,419,1460,6940
280.167,6,25,7094,11,181,28016,267,1168,14,595,21550,1400,5926
1740.532,17,30,7050,30,207,60018,207,7050,0,0,0,0,0
1795.811,6,316,24660,153,260,11811,528,10030,163,39,11084,100,14630
4.04,17,9,9835,2,723,4040,1350,1503,7,1162,333,1350,8332
1335.192,6,83,11427,53,96,20853,498,4527,30,203,46038,1420,6900
0.922,6,52,13869,24,551,40,1429,4840,28,438,33,1460,9029
4.197,17,10,2320,10,204,466,204,2320,0,0,0,0,0
0.313,6,20,7229,12,334,28,663,1969,8,1209,44,1906,5260
0.06,17,4,588,2,48,39,48,152,2,190,40,308,436
1742.562,6,95,7203,63,38,28105,205,4476,32,33,56197,98,2727
1742.746,6,177,15222,118,69,14895,69,8791,59,69,30046,69,6431
1.593,6,49,18610,27,845,61,1360,12954,22,433,64,1360,5656
5.169,6,20,6008,12,186,469,318,1218,8,727,19,1418,4790
0.118,17,2,152,1,48,0,48,76,1,48,0,48,76
359.97,6,94,15171,42,166,7564,1189,4345,52,281,7058,1420,10826
11.576,6,18,4362,9,275,1447,275,918,9,768,801,1440,3444
689.475,2,12,384,12,8,62679,8,384,0,0,0,0,0
5.864,6,547,474821,342,1322,16,1368,459497,205,931,27,2736,15324
240.214,6,54,17499,29,737,8578,1408,14796,25,174,10008,580,2703
1790.109,17,87,3648,86,14,21060,14,3612,1,8,0,8,36
1.086,6,57,17994,29,707,38,1360,8965,28,438,39,1360,9029
1796.751,1,96,5376,96,28,18913,28,5376,0,0,0,0,0
165.303,6,23,940,9,0,6150,0,364,14,0,12714,0,576
365.949,6,18,1239,14,177,28149,177,913,4,110,20055,110,326
1.344,6,49,19986,27,944,51,1440,14330,22,433,54,1440,5656
0.276,6,7,466,5,43,58,43,354,2,0,274,0,112
1740.088,6,87,6322,58,31,30527,31,3915,29,31,62145,31,2407
47.762,17,4,352,2,60,47761,60,176,2,60,47761,60,176
280.366,6,28,7352,12,158,25487,267,1277,16,603,18686,1400,6075
0.426,6,14,1733,7,288,71,288,588,7,284,34,434,1145
6.124,6,1245,1152471,772,1415,7,1448,1123211,473,776,12,1448,29260
1782.987,6,353,22400,205,69,8740,69,12340,148,69,12129,69,10060
268.382,6,76,11782,37,188,5915,1189,3938,39,298,7062,1420,7844
1720.512,17,12,498,11,14,172051,14,462,1,8,0,8,36
15.153,6,10,560,5,0,3754,0,300,5,0,3754,0,260
24.903,6,33,8171,15,199,1778,721,1998,18,605,1454,1440,6173
62.904,6,28,7352,12,158,5718,267,1277,16,603,4187,1400,6075
284.38,6,30,7432,13,158,23698,267,1317,17,603,17771,2076,6115
0.714,6,1102,1072749,671,183,1,230,36989,431,2362,1,21120,1035760
1771.263,1,58,4872,0,0,0,0,0,58,56,31074,56,4872
64.694,6,84,55779,50,1207,1320,1368,47274,34,841,1876,2519,8505
108.679,6,28,12805,14,493,146,832,2577,14,965,8349,1460,10228
1772.967,6,180,15480,120,69,14898,69,8940,60,69,30044,69,6540
0.086,6,2,80,1,0,0,0,40,1,0,0,0,40
906.618,1,10,560,10,28,100735,28,560,0,0,0,0,0
2.898,6,22,3505,12,167,263,293,1490,10,402,293,1152,2015
0.251,6,10,1669,6,551,50,947,1346,4,159,83,159,323
101.72,6,27,12242,12,478,61,1460,2427,15,1022,7255,1460,9815
19.1,17,32,7704,15,268,1362,1350,4454,17,163,1191,1350,3250
0.119,17,2,572,1,39,0,39,67,1,477,0,477,505
300.658,6,40,8419,21,241,15032,619,1874,19,412,473,1360,6545
189.116,6,12,848,6,92,37823,92,504,6,0,4225,0,344
1.456,17,6,705,3,31,726,31,177,3,148,725,164,528
8.528,2,3,96,3,8,4264,8,96,0,0,0,0,0
0.178,6,25,7216,13,155,14,267,1301,12,775,15,4836,5915
1623.726,1,47,2632,47,28,35298,28,2632,0,0,0,0,0
115.024,6,21,8438,11,468,81,1067,1878,10,1024,12761,1591,6560
0.479,6,12,1653,6,288,91,288,548,6,426,55,434,1105
1789.03,1,62,3472,62,28,29328,28,3472,0,0,0,0,0
2.323,2,3,96,3,8,1161,8,96,0,0,0,0,0
1794.788,17,180,14040,180,50,10026,50,14040,0,0,0,0,0
0.278,17,4,768,2,39,273,39,134,2,289,12,289,634
11.72,6,1789,1616005,1096,1420,10,1432,1584064,693,420,16,1432,31941
0.94,6,29,8200,15,222,55,540,1964,14,944,59,1591,6236
1788.983,1,152,8512,152,28,11847,28,8512,0,0,0,0,0
127.504,6,6,378,2,106,127490,106,194,4,0,42496,0,184
1771.139,6,101,9410,66,66,27248,66,5610,35,60,52090,60,3800
1329.111,1,18,1008,18,28,78183,28,1008,0,0,0,0,0
1787.464,6,115,13683,75,81,24154,504,5920,40,162,45827,1452,7763
147.114,6,25,12059,12,410,65,922,1754,13,1085,12248,1460,10305
1787.315,6,102,8296,68,65,26676,65,4930,34,59,54157,59,3366
599.854,6,9,546,6,31,119970,31,333,3,31,299741,31,213
1300.275,6,51,4869,39,92,34217,138,4044,12,69,12034,69,825
1.573,6,10,1687,7,100,262,100,384,3,1179,660,1179,1303
0.045,17,4,608,2,60,27,60,176,2,188,27,188,432
1799.864,17,142,11360,71,48,25712,48,5396,71,56,25712,56,5964
241.497,6,54,6723,24,196,10498,585,3241,30,147,8326,580,3482
1772.755,6,181,15589,120,69,14897,69,8940,61,69,29543,69,6649
0.108,17,4,352,2,37,40,37,130,2,83,70,89,222
1778.64,1,129,7224,129,28,13895,28,7224,0,0,0,0,0
10.005,17,3,3258,3,1058,5002,1058,3258,0,0,0,0,0
340.45,17,5,1688,5,309,85112,316,1688,0,0,0,0,0
1311.838,1,21,1176,21,28,65591,28,1176,0,0,0,0,0
0.885,6,11,1727,7,100,147,100,384,4,589,213,1152,1343
1787.456,17,87,3648,86,14,21028,14,3612,1,8,0,8,36
1.638,6,10,1687,7,100,273,100,384,3,1179,685,1179,1303
1771.866,6,184,15778,122,69,14643,69,9020,62,69,29045,69,6758
1578.488,6,149,12993,94,70,16972,138,7141,55,68,29231,69,5852
1793.768,6,356,22520,208,69,8665,69,12460,148,69,12200,69,10060
1.66,6,281,218850,163,1337,10,1420,209827,118,475,14,1883,9023
1799.473,17,178,13884,178,50,10166,50,13884,0,0,0,0,0
0.29,6,26,8970,13,244,24,618,1687,13,1099,23,2816,7283
300.92,6,41,13606,23,891,13678,1360,8084,18,435,508,2720,5522
1.358,6,50,19873,28,871,50,1360,14217,22,433,56,1360,5656
123.224,6,34,7935,12,155,27,267,1266,22,340,5867,2840,6669
0.133,17,2,193,1,34,0,34,62,1,103,0,103,131
223.981,17,4,352,2,60,223980,60,176,2,60,223980,60,176
1791.707,6,361,22927,211,69,8531,69,12718,150,69,12023,69,10209
4.802,6,44,8385,22,227,228,314,4062,22,491,217,1179,4323
0.092,17,2,586,1,46,0,46,74,1,484,0,484,512
1.117,6,29,10756,17,522,69,1360,3338,12,865,85,3921,7418
0.177,6,3,128,2,0,177,0,84,1,0,0,0,44
81.854,6,787,372419,411,836,199,1152,351192,376,412,217,1179,21227
61.697,6,57,37419,36,1153,1762,1448,29574,21,843,3073,2359,7845
1770.182,6,393,54890,173,187,10290,1360,35751,220,126,8083,1062,19139
0.204,17,4,1038,4,231,68,389,1038,0,0,0,0,0
0.913,2,2,112,2,32,913,32,112,0,0,0,0,0
0.564,6,10,2219,5,145,141,145,349,5,833,131,833,1870
0.182,17,2,136,1,32,0,32,60,1,48,0,48,76
56.665,6,30,7685,10,155,11,267,1186,20,355,2982,2006,6499
1791.946,6,129,12638,74,63,23171,722,6152,55,78,33180,1402,6486
6.376,6,40,7309,21,218,318,314,3463,19,513,338,1179,3846
163.716,6,21,9253,11,524,82,1236,2046,10,1132,18171,2720,7207
1742.96,6,95,7203,63,38,28112,205,4476,32,33,56214,98,2727
1798.56,6,370,26239,215,105,8404,469,15554,155,69,11676,69,10685
7.414,6,1459,1300022,892,1377,8,1408,1265874,567,931,12,2816,34148
873.808,1,68,7208,68,78,13041,78,7208,0,0,0,0,0
1758.458,6,4903,4342330,2279,146,771,910,128702,2624,1594,670,7040,4213628
1795.026,17,87,3648,86,14,21117,14,3612,1,8,0,8,36
0.051,17,4,284,2,32,1,32,120,2,54,20,60,164
1793.655,17,87,3648,86,14,21101,14,3612,1,8,0,8,36
8.04,1,9,756,9,56,1005,56,756,0,0,0,0,0
1686.473,17,12,498,11,14,168647,14,462,1,8,0,8,36
0.424,6,215,188435,116,369,3,517,8273,99,1804,4,7040,180162
1786.305,6,104,8444,68,66,26661,66,4964,36,60,51034,60,3480
1784.883,6,248,25293,99,67,18211,659,9340,149,131,12059,1360,15953
1749.801,17,12,498,11,14,174980,14,462,1,8,0,8,36
36.911,17,4,352,2,48,36902,48,152,2,72,36903,72,200
0.741,6,23,5715,13,158,61,370,1315,10,999,81,1731,4400
240.698,6,50,8839,26,449,9627,1408,5880,24,189,10464,580,2959
215.46,17,3,984,3,300,107730,300,984,0,0,0,0,0
15.406,6,6,288,1,0,0,0,48,5,0,3848,0,240
0.028,17,8,1670,8,180,4,219,1670,0,0,0,0,0
37.637,17,4,1344,4,308,12545,308,1344,0,0,0,0,0
237.444,6,69,12061,31,156,7909,721,4845,38,474,6412,1440,7216
1769.713,6,101,9344,66,65,27226,65,5577,35,59,52046,59,3767
11.765,6,1868,1625865,1132,1382,10,1420,1592204,736,467,15,1883,33661
1785.857,6,366,23334,211,69,8504,69,12718,155,69,11596,69,10616
1719.461,17,12,498,11,14,171946,14,462,1,8,0,8,36
4.033,6,39,7269,21,218,201,314,3463,18,513,222,1179,3806
60.738,17,52,3823,36,40,1734,41,2470,16,56,2239,57,1353
6.122,6,40,7309,21,218,306,314,3463,19,513,325,1179,3846
62.019,6,79,55055,49,1194,1292,1368,46759,30,841,2129,2519,8296
1790.136,1,256,14336,256,28,7020,28,14336,0,0,0,0,0
280.5,6,29,7392,13,158,23375,267,1317,16,678,18693,2760,6075
1.058,6,27,10086,16,351,70,785,1697,11,993,98,1452,8389
72.935,6,27,10778,13,741,53,1360,3518,14,836,5600,1360,7260
0.844,17,33,24673,17,854,52,1350,15005,16,576,51,1350,9668
1795.604,6,356,22520,208,69,8674,69,12460,148,69,12213,69,10060
133.268,6,18,4149,9,296,16658,722,1353,9,464,16632,1408,2796
0.188,6,30,16938,15,129,13,129,917,15,1269,13,1448,16021
0.514,6,23,7394,13,335,42,668,2026,10,968,53,1946,5368
241.181,6,48,7573,22,224,11484,584,2772,26,312,9647,841,4801
58.347,6,8,798,0,0,0,0,0,8,68,8335,69,798
101.656,6,25,10748,13,754,54,1360,3568,12,1114,9228,3068,7180
1727.347,17,17,3225,17,161,107959,166,3225,0,0,0,0,0
335.423,17,9,3024,9,308,41927,308,3024,0,0,0,0,0
1738.144,17,170,14376,157,30,11141,37,9155,13,373,139702,463,5221
0.049,6,16,3115,8,457,7,796,1795,8,224,4,694,1320
15.646,6,14,1025,7,222,2606,222,506,7,231,2605,231,519
1799.501,6,214,22363,108,103,16817,721,11577,106,152,17136,2840,10786
0.114,17,2,558,1,32,0,32,60,1,470,0,470,498
13.15,17,4,824,2,48,13132,48,152,2,308,13126,308,672
1782.628,6,353,22469,206,69,8695,69,12449,147,69,12209,69,10020
1795.106,17,448,39612,404,35,4454,288,25708,44,288,40947,288,13904
288.162,6,29,3021,14,324,22165,585,1397,15,282,20582,580,1624
33.699,6,30,5042,15,154,2407,722,1859,15,399,2393,1402,3183
175.875,1,11,1166,11,78,17587,78,1166,0,0,0,0,0
69.946,6,32,16587,16,1039,64,1460,7959,16,886,4650,1460,8628
137.473,6,96,70286,62,1242,2253,1408,60380,34,677,2759,1408,9906
0.328,17,2,212,1,46,0,46,74,1,110,0,110,138
11.175,6,1812,1545535,1089,1363,10,1380,1512382,723,467,15,1923,33153
22.226,6,33,4489,18,304,1307,304,3080,15,83,1520,83,1409
1682.749,17,16,1265,8,30,240387,37,471,8,71,240383,136,794
630.98,6,66,5676,44,69,14673,69,3278,22,69,30043,69,2398
8.525,6,9,392,4,0,2841,0,172,5,0,1130,0,220
134.835,6,187,131440,99,1288,57,1460,42641,88,1253,1548,1460,88799
1797.448,6,356,22520,208,69,8683,69,12460,148,69,12227,69,10060
177.777,17,1465,286210,1449,168,122,172,284726,16,64,4287,172,1484
240.233,6,53,17551,28,775,8897,1418,14651,25,199,10009,580,2900
240.195,6,54,17890,29,786,8578,1418,14894,25,211,10007,580,2996
0.953,6,51,13865,24,551,41,1429,4876,27,464,35,1986,8989
94.724,6,32,14730,16,488,327,1360,3127,16,1095,6306,2568,11603
0.134,17,13,5158,6,480,26,1350,3053,7,272,15,1350,2105
62.477,6,33,7811,12,156,17,267,1272,21,334,3123,1997,6539
1751.166,6,186,11385,93,47,19034,208,6766,93,31,19031,31,4619
79.979,17,4,824,2,48,79972,48,152,2,308,79971,308,672
0.326,6,2,80,1,0,0,0,40,1,0,0,0,40
33.382,6,46,12591,22,957,716,1460,6705,24,307,1443,1460,5886
5.324,17,4,336,2,48,5306,48,152,2,64,5309,64,184
1383.675,2,15,480,15,8,98833,8,480,0,0,0,0,0
136.537,17,8,608,8,48,19505,48,608,0,0,0,0,0
0.921,17,4,624,2,64,920,64,184,2,192,883,192,440
1750.597,17,12,498,11,14,175059,14,462,1,8,0,8,36
0.01,17,2,378,1,42,0,42,70,1,280,0,280,308
66.291,6,47,10589,22,614,840,1360,3442,25,360,2753,2720,7147
1786.95,6,102,8228,68,64,26670,64,4896,34,58,54146,58,3332
133.154,6,23,6238,7,272,195,516,1100,16,345,8871,1452,5138
198.415,6,589,513587,397,1298,501,1360,498815,192,228,138,2667,14772
171.829,6,31,15768,15,576,52,1360,3525,16,1159,11447,2720,12243
146.412,6,22,9920,11,433,73,990,1771,11,1099,14628,1440,8149
4.497,6,3,132,3,0,0,0,132,0,0,0,0,0
253.994,17,6,2055,3,308,126499,308,1008,3,321,126501,321,1047
1788.62,17,87,3648,86,14,21042,14,3612,1,8,0,8,36
1.408,6,25,8056,12,164,109,267,1288,13,869,99,1368,6768
151.384,17,6,360,3,32,75691,32,180,3,32,75691,32,180
1.418,17,2,782,2,363,1418,363,782,0,0,0,0,0
37.346,17,11,836,11,48,3734,48,836,0,0,0,0,0
780.33,17,13,13702,13,1026,65027,1026,13702,0,0,0,0,0
0.136,17,2,186,1,57,0,57,85,1,73,0,73,101
1783.2,6,356,22589,208,69,8614,69,12460,148,69,12130,69,10129
164.781,6,18,5839,10,784,18309,1360,3538,8,247,23509,272,2301
248.54,6,10,568,4,112,82846,112,280,6,0,6321,0,288
6.836,6,29,6175,15,338,488,1314,2294,14,368,516,1460,3881
1775.011,1,39,4771,39,94,46710,351,4771,0,0,0,0,0
0.256,17,5,1696,5,311,64,354,1696,0,0,0,0,0
83.988,6,32,8952,14,158,6460,267,1357,18,624,4930,1400,7595
1797.416,17,448,39896,403,35,4471,288,25676,45,288,40019,288,14220
1798.631,6,369,25799,215,99,8404,469,15085,154,69,11755,69,10714
1799.997,6,420,143958,199,691,8939,1440,120006,221,173,8181,1440,23952
0.117,2,2,64,2,8,117,8,64,0,0,0,0,0
1799.491,17,142,11360,71,48,25706,48,5396,71,56,25706,56,5964
1770.426,6,99,9306,66,66,27237,66,5610,33,60,55322,60,3696
1781.761,6,372,29545,216,134,8287,1189,17365,156,87,11495,485,12180
1786.554,6,103,8268,68,64,26664,64,4896,35,58,52543,58,3372
1773.345,6,180,15480,120,69,14902,69,8940,60,69,30048,69,6540
113.507,6,802,397316,451,826,252,1152,378485,351,435,323,1179,18831
298.496,6,16,1270,11,66,29849,66,770,5,60,53789,60,500
280.46,6,31,7472,14,158,21573,267,1357,17,603,17525,2076,6115
12.194,6,1940,1684663,1176,1378,10,1420,1649882,764,467,15,1883,34781
30.369,6,25,8128,13,461,2529,1258,2530,12,711,2759,1448,5598
5.994,17,3,1008,3,308,2997,308,1008,0,0,0,0,0
240.377,6,44,8447,22,449,11446,1418,5648,22,205,11446,580,2799
1795.803,17,297,61327,297,178,6066,422,61327,0,0,0,0,0
0.336,6,26,8913,13,242,28,610,1655,13,1095,27,2816,7258
1.233,6,28,8609,15,236,74,625,2049,13,1004,85,2720,6560
0.048,17,4,764,3,60,11,60,264,1,472,0,472,500
316.93,6,72,19602,41,297,7923,1360,10335,31,400,10559,2720,9267
10.693,6,2011,1923335,1324,1378,7,1408,1882947,687,776,15,1408,40388
0.015,6,10,2031,6,732,2,1304,1708,4,159,4,159,323
3.764,6,14,3143,8,49,537,92,511,6,579,43,1448,2632
1738.565,6,87,6322,58,31,30501,31,3915,29,31,62091,31,2407
35.016,1,2,112,2,28,35016,28,112,0,0,0,0,0
0.081,17,2,2732,2,1338,81,1338,2732,0,0,0,0,0
147.308,17,4,604,4,123,49102,348,604,0,0,0,0,0
882.192,2,7,224,7,8,147032,8,224,0,0,0,0,0
1330.349,1,56,3136,56,28,24188,28,3136,0,0,0,0,0
280.302,6,30,7432,13,158,23358,267,1317,17,543,17517,1400,6115
88.036,17,4,288,2,36,88035,36,128,2,52,88035,52,160
0.92,6,11,1727,7,100,153,100,384,4,589,218,1152,1343
0.043,17,2,603,1,40,0,40,68,1,507,0,507,535
0.394,6,10,1992,5,288,94,288,508,5,424,52,434,1484
117.462,6,46,8991,22,412,604,889,2204,24,386,5101,1360,6787
1007.747,17,200,15200,200,48,5064,48,15200,0,0,0,0,0
5.005,17,4,288,2,36,5004,36,128,2,52,4992,52,160
15.309,17,15,4942,7,354,2538,1350,2679,8,254,2176,1350,2263
370.889,6,21,1422,15,180,26492,180,992,6,110,12273,110,430
13.679,6,68,20286,35,565,402,1152,15539,33,489,419,1179,4747
21.228,17,27,7689,11,280,2119,1350,3388,16,240,1413,1350,4301
661.832,2,7,224,7,8,110305,8,224,0,0,0,0,0
1789.883,6,356,22520,208,69,8646,69,12460,148,69,12176,69,10060
1773.087,6,180,15480,120,69,14899,69,8940,60,69,30048,69,6540
0.106,6,2,1500,1,0,0,0,40,1,1420,0,1420,1460
1796.663,17,449,39928,404,35,4458,288,25708,45,288,40020,288,14220
378.881,17,8,480,4,32,126293,32,240,4,32,126293,32,240
16.006,17,8,728,4,52,5333,52,320,4,74,5330,80,408
0.175,1,2,112,2,28,175,28,112,0,0,0,0,0
92.02,6,15,1928,9,483,11502,483,1442,6,83,18402,83,486
230.362,6,98,72450,63,1259,3715,1448,62472,35,740,3386,2896,9978
252.251,6,38,15989,23,800,11465,1448,9210,15,665,4362,1448,6779
1.72,6,293,235466,176,1338,9,1420,226495,117,475,14,1883,8971
4.337,17,4,232,4,30,1445,30,232,0,0,0,0,0
300.858,6,41,11479,24,703,13080,1360,5952,17,439,542,4027,5527
10.712,6,84,24581,44,550,249,1152,18840,40,459,267,1179,5741
40.419,17,3,228,3,48,20209,48,228,0,0,0,0,0
2.305,6,11,1326,6,241,447,241,758,5,92,526,92,568
11.865,6,82,24853,42,561,289,1152,19096,40,461,297,1179,5757
0.189,6,45,20620,26,1041,7,1420,15639,19,526,10,3303,4981
269.041,17,1728,331840,1684,167,159,172,328800,44,41,3603,172,3040
1776.134,17,142,11360,71,48,25373,48,5396,71,56,25373,56,5964
1768.664,1,58,4872,58,56,31029,56,4872,0,0,0,0,0
1786.442,6,102,8364,68,66,26663,66,4964,34,60,54132,60,3400
4.638,6,23,4697,12,143,421,293,1490,11,690,438,1179,3207
1756.597,1,56,4704,56,56,31938,56,4704,0,0,0,0,0
1798.698,17,142,47712,142,308,12756,308,47712,0,0,0,0,0
1747.173,6,95,7203,63,38,28180,205,4476,32,33,56347,98,2727
2.104,17,2,685,1,308,0,308,336,1,321,0,321,349
1774.324,1,54,4536,54,56,33477,56,4536,0,0,0,0,0
8.171,6,47,8846,24,227,355,314,4142,23,472,359,1179,4704
1647.809,1,7,392,7,28,274634,28,392,0,0,0,0,0
2.316,6,13,2311,8,188,330,245,700,5,1407,512,1407,1611
1.427,6,19,3781,10,234,158,564,1452,9,463,150,1343,2329
10.765,6,19,4362,11,275,1076,275,998,8,1010,855,2840,3364
10.946,6,20,4442,11,275,1094,275,998,9,768,775,1440,3444
1786.325,17,134,10720,67,48,27065,48,5092,67,56,27065,56,5628
0.408,17,2,152,1,48,0,48,76,1,48,0,48,76
1798.687,6,355,22480,207,69,8731,69,12420,148,69,12235,69,10060
240.186,6,53,17667,28,788,8895,1402,14874,25,185,10007,580,2793
369.643,6,18,1242,14,180,28434,180,916,4,110,20072,110,326
1799.84,6,340,22908,152,46,11745,46,9776,188,46,9624,46,13132
1.38,6,46,18757,26,931,55,1460,13181,20,433,62,1460,5576
280.025,6,30,7432,13,158,23335,267,1317,17,543,17499,1300,6115
3.305,6,2,88,2,0,0,0,88,0,0,0,0,0
1681.294,1,15,840,15,28,120092,28,840,0,0,0,0,0
7.264,6,1607,1506706,1033,1382,6,1408,1472194,574,931,12,2801,34512
1789.805,6,356,22520,208,69,8646,69,12460,148,69,12175,69,10060
0.076,17,2,144,1,36,0,36,64,1,52,0,52,80
1.491,6,52,21540,28,976,55,1460,15804,24,433,56,1460,5736
1741.541,17,30,6930,30,203,60053,203,6930,0,0,0,0,0
0.005,6,3,120,1,0,0,0,40,2,0,0,0,80
1.848,6,51,19599,27,910,71,1440,13863,24,433,70,1440,5736
4.253,6,26,8199,11,330,420,517,1926,15,685,300,1418,6273
1.398,6,24,8004,12,164,106,267,1288,12,1014,108,2491,6716
0.407,6,48,18939,27,910,15,1380,13857,21,421,18,1923,5082
292.661,17,12,2000,6,48,58530,48,456,6,229,58529,308,1544
301.358,17,6,2016,6,308,60271,308,2016,0,0,0,0,0
5.049,17,4,288,2,36,5006,36,128,2,52,5016,52,160
1799.989,17,450,39960,405,35,4455,288,25740,45,288,40020,288,14220
62.161,6,23,9794,12,410,78,922,1742,11,1085,6197,1696,8052
1770.164,6,27,4077,18,241,104127,241,2889,9,92,221244,92,1188
15.045,6,30,7297,14,155,1157,267,1346,16,441,1002,1420,5951
16.947,6,110,36202,56,593,308,1152,29544,54,449,314,1179,6658
1.229,6,21,5000,11,137,122,267,1132,10,692,90,1467,3868
1.364,6,48,20038,28,887,50,1360,14462,20,476,62,2715,5576
1786.956,6,110,8864,71,66,25527,66,5084,39,60,47022,60,3780
1795.609,17,448,39896,403,35,4466,288,25676,45,288,40018,288,14220
1743.379,1,15,840,15,28,124527,28,840,0,0,0,0,0
55.492,17,4,240,2,32,55491,32,120,2,32,55491,32,120
280.352,6,29,7392,13,158,23362,267,1317,16,603,18687,2036,6075
28.146,6,2531,2348752,1542,1438,18,1448,2288568,989,776,28,1448,60184
2.062,6,36,19859,21,213,103,517,1966,15,1710,145,5632,17893
68.048,17,4,352,2,60,68047,60,176,2,60,68047,60,176
1719.465,17,12,498,11,14,171946,14,462,1,8,0,8,36
40.125,17,4,352,2,60,40124,60,176,2,60,40124,60,176
10.692,6,80,24405,42,533,260,1152,18744,38,459,281,1179,5661
1795.41,1,250,14000,250,28,7210,28,14000,0,0,0,0,0
21.385,17,3,1008,3,308,10692,308,1008,0,0,0,0,0
0.013,17,2,255,1,43,0,43,71,1,156,0,156,184
8.935,6,3,180,3,0,0,0,180,0,0,0,0,0
767.097,1,6,740,6,95,153419,119,740,0,0,0,0,0
372.146,6,18,1242,14,180,28626,180,916,4,110,20064,110,326
1797.628,17,180,14040,180,50,10042,50,14040,0,0,0,0,0
3.115,17,3,228,2,48,3048,48,152,1,48,0,48,76
30.401,6,22,2920,12,211,2645,211,1313,10,545,3377,904,1607
1763.169,2,15,480,15,8,125940,8,480,0,0,0,0,0
15.447,6,15,3212,6,92,3089,92,400,9,579,1862,1408,2812
11.448,17,4,824,2,48,11432,48,152,2,308,11430,308,672
0.233,17,2,157,1,31,0,31,59,1,70,0,70,98
1681.282,1,15,870,15,30,120091,30,870,0,0,0,0,0
0.118,17,2,572,1,39,0,39,67,1,477,0,477,505
251.733,2,2,64,2,8,251733,8,64,0,0,0,0,0
0.49,6,53,22616,29,1012,17,1380,17414,24,421,19,1923,5202
33.548,6,35,8238,18,334,525,688,1804,17,522,2085,3488,6434
0.007,17,8,2454,8,278,1,317,2454,0,0,0,0,0
175.957,17,2,72,1,8,0,8,36,1,8,0,8,36
1788.693,6,405,33373,190,78,9463,267,13069,215,89,8358,1460,20304
1774.711,1,216,12096,216,28,8254,28,12096,0,0,0,0,0
1.766,1,3,318,3,78,883,78,318,0,0,0,0,0
1758.434,17,125,34425,125,247,14180,422,34425,0,0,0,0,0
1.081,6,24,8004,12,164,83,267,1288,12,1014,83,2816,6716
301.441,6,23,7951,12,433,27403,1178,2366,11,715,3761,1448,5585
1762.138,1,74,4144,74,28,24138,28,4144,0,0,0,0,0
126.832,6,16,3263,7,92,21138,92,452,9,334,15827,1408,2811
227.537,6,30,8872,14,158,17502,267,1357,16,763,15162,2036,7515
0.031,17,2,122,1,33,0,33,61,1,33,0,33,61
4.153,17,2,656,2,300,4153,300,656,0,0,0,0,0
280.883,6,30,7432,13,158,23406,267,1317,17,543,17547,1400,6115
0.249,17,2,290,1,40,0,40,68,1,194,0,194,222
1083.258,17,212,16112,212,48,5133,48,16112,0,0,0,0,0
32.249,6,44,18408,24,1181,386,1440,12806,20,399,1688,1440,5602
5.133,6,56,21615,28,965,190,1440,15635,28,433,183,1440,5980
168.521,6,25,6482,11,220,16852,516,1325,14,458,12913,1452,5157
39.171,6,48,10447,23,541,686,910,3179,25,329,1626,2720,7268
1790.295,17,87,3648,86,14,21062,14,3612,1,8,0,8,36
0.106,17,2,384,1,32,0,32,60,1,296,0,296,324
0.037,6,2,80,1,0,0,0,40,1,0,0,0,40
11.783,6,1849,1627193,1128,1389,10,1420,1594132,721,467,16,1883,33061
44.646,6,48,10415,22,533,732,910,3107,26,312,1780,1460,7308
179.733,6,31,13087,16,486,56,1460,2617,15,985,12828,1460,10470
0.256,6,36,19571,16,173,17,319,1532,20,1213,12,1438,18039
52.404,6,77,11320,42,304,1278,304,7760,35,83,1530,83,3560
13.097,6,1800,1668714,1173,1371,11,1380,1636664,627,386,20,1380,32050
1778.748,6,269,33258,109,139,16468,1360,16151,160,135,11186,3302,17107
101.668,6,26,10720,13,694,119,1236,3342,13,855,8458,1360,7378
0.061,17,2,366,1,33,0,33,61,1,277,0,277,305
1798.624,17,449,39928,404,35,4463,288,25708,45,288,40018,288,14220
1764.676,6,147,15309,89,78,20053,721,7990,58,85,30953,1448,7319
1.455,6,38,8252,19,320,80,1162,2716,19,433,71,1440,5536
0.008,6,2,104,2,24,8,24,104,0,0,0,0,0
0.016,6,10,1514,5,503,3,503,771,5,475,3,475,743
0.874,6,12,1163,6,222,170,222,688,6,231,170,231,475
222.703,17,4,240,2,32,222702,32,120,2,32,222702,32,120
0.144,17,2,144,1,36,0,36,64,1,52,0,52,80
0.06,6,13,3980,7,88,10,88,388,6,1670,11,1880,3592
240.368,6,46,9089,24,524,10450,1418,5974,22,218,11445,618,3115
2.675,6,52,20485,30,965,92,1460,14784,22,400,68,1460,5701
1799.982,17,448,39896,403,35,4477,288,25676,45,288,40017,288,14220
1791.4,17,144,11520,72,48,25228,48,5472,72,56,25230,56,6048
4.254,6,13,3115,8,49,607,92,523,5,2328,907,2328,2592
1.385,6,47,18160,26,882,55,1360,12544,21,433,60,1360,5616
1750.738,17,13,534,11,14,175054,14,462,2,8,1750540,8,72
240.107,6,42,5498,22,247,11433,834,2897,20,172,12636,458,2601
1787.299,6,102,8228,68,64,26676,64,4896,34,58,54157,58,3332
376.85,2,3,96,3,8,188425,8,96,0,0,0,0,0
280.412,6,30,7432,13,158,23367,267,1317,17,603,17522,2076,6115
32.723,6,27,7177,13,155,2726,267,1306,14,530,2516,3417,5871
1796.602,17,449,39928,404,35,4458,288,25708,45,288,40023,288,14220
1797.814,17,448,39896,403,35,4472,288,25676,45,288,40021,288,14220
157.709,17,4,1344,4,308,52569,308,1344,0,0,0,0,0
0.594,6,23,6395,13,310,48,889,2075,10,979,64,1691,4320
0.956,6,4,222,1,31,0,31,71,3,31,478,31,151
19.673,17,32,13945,17,637,1227,1350,11308,15,147,1402,1350,2637
33.741,6,33,5200,16,154,2249,722,1912,17,300,2094,1408,3288
1795.333,17,83,3480,82,14,22164,14,3444,1,8,0,8,36
1681.788,1,15,840,15,28,120127,28,840,0,0,0,0,0
1700.484,17,12,498,11,14,170048,14,462,1,8,0,8,36
157.273,17,4,240,2,32,157272,32,120,2,32,157272,32,120
315.862,6,94,21457,47,314,6866,1360,11090,47,264,6863,4080,10367
270.662,17,4,352,2,60,270661,60,176,2,60,270661,60,176
1.618,6,29,10385,17,372,101,850,1802,12,1012,139,1420,8583
87.117,17,16,1216,16,48,5807,48,1216,0,0,0,0,0
1401.511,17,12,888,6,30,280283,30,348,6,62,280298,62,540
1788.613,17,87,3648,86,14,21042,14,3612,1,8,0,8,36
4.705,6,37,7205,19,218,261,314,3383,18,516,261,1179,3822
139.653,17,2,136,2,40,139653,47,136,0,0,0,0,0
175.216,17,2,72,1,8,0,8,36,1,8,0,8,36
25.878,6,49,13135,24,186,1125,721,2639,25,678,1069,2840,10496
1793.645,17,87,3648,86,14,21101,14,3612,1,8,0,8,36
0.192,6,9,1002,5,213,48,213,417,4,421,46,421,585
0.026,17,2,167,1,39,0,39,67,1,72,0,72,100
4.645,6,34,6169,18,206,273,314,2784,16,548,291,1179,3385
1779.301,17,142,11360,71,48,25418,48,5396,71,56,25418,56,5964
0.664,6,14,2586,7,288,91,288,588,7,568,82,853,1998
1681.539,17,14,1036,7,30,280254,30,406,7,62,280254,62,630
1772.9,6,180,15480,120,69,14898,69,8940,60,69,30044,69,6540
1792.481,1,58,4872,0,0,0,0,0,58,56,31447,56,4872
72.21,6,34,7664,14,155,5554,267,1346,20,367,3800,1420,6318
0.029,17,2,389,1,34,0,34,62,1,299,0,299,327
0.316,6,26,6150,13,181,26,537,1578,13,555,25,1542,4572
21.457,6,16,1327,8,222,3063,222,768,8,231,3062,231,559
1799.882,6,219,17637,82,79,22006,376,8748,137,50,13234,143,8889
63.874,6,38,9255,16,294,182,1189,2712,22,471,3041,1420,6543
4.772,6,16,1331,8,222,679,222,768,8,231,679,231,563
0.004,17,2,608,1,44,0,44,72,1,508,0,508,536
0.015,17,2,362,1,46,0,46,74,1,260,0,260,288
316.943,6,125,37078,58,513,5560,1360,24955,67,241,4800,2720,12123
3.181,6,5,288,2,0,2770,0,112,3,0,1377,0,176
5.007,17,4,530,2,36,5002,36,128,2,173,5003,187,402
19.534,17,30,6029,15,209,1392,1350,3569,15,136,1392,1350,2460
1771.749,6,107,9794,68,64,26444,64,5724,39,58,46622,58,4070
240.441,6,43,9061,21,523,12021,1418,5814,22,232,11448,618,3247
93.233,6,24,6552,12,274,8471,517,1466,12,744,8471,1408,5086
1783.807,6,366,25541,213,100,8414,469,14936,153,69,11735,69,10605
1787.153,6,102,8296,68,65,26673,65,4930,34,59,54153,59,3366
9.812,6,89,26821,44,568,228,1152,20539,45,407,217,1152,6282
1795.623,17,448,39896,403,35,4466,288,25676,45,288,40016,288,14220
1782.2,17,83,3480,82,14,22002,14,3444,1,8,0,8,36
1.314,6,114,87193,49,131,27,232,2489,65,1391,18,2860,84704
0.904,6,10,1687,7,100,150,100,384,3,1179,320,1179,1303
1.258,17,2,677,1,300,0,300,328,1,321,0,321,349
0.012,17,3,1543,3,486,6,514,1543,0,0,0,0,0
0.673,6,9,1346,5,145,168,145,349,4,833,175,833,997
5.482,6,5,280,2,0,5482,0,100,3,0,1166,0,180
1796.295,17,448,39896,403,35,4468,288,25676,45,288,40018,288,14220
2.205,6,187,189172,52,283,43,882,4412,135,1356,16,1418,184760
0.483,6,13,1693,7,288,72,288,588,6,426,55,434,1105
4.555,6,12,1305,7,279,759,279,647,5,191,417,272,658
0.145,17,2,166,1,47,0,47,75,1,63,0,63,91
365.943,6,71,14481,33,320,11435,1460,6523,38,321,9884,1460,7958
1.269,6,115,86995,50,131,25,232,2529,65,1364,18,1430,84466
0.024,17,2,435,1,29,0,29,57,1,350,0,350,378
1783.868,6,354,22440,207,69,8659,69,12420,147,69,12218,69,10020
280.569,6,30,7432,13,158,23380,267,1317,17,603,17532,2076,6115
0.357,6,36,19385,16,171,23,313,1526,20,1200,18,1438,17859
280.605,6,37,11233,18,158,16506,267,1517,19,746,15586,2036,9716
10.306,17,2,152,2,48,10306,48,152,0,0,0,0,0
1624.387,2,12,384,12,8,147671,8,384,0,0,0,0,0
177.567,6,29,7392,13,158,14797,267,1317,16,603,11828,2036,6075
98.725,6,75,25104,35,602,2903,1152,18265,40,402,2194,1179,6839
2.289,6,95,55981,50,1281,46,1432,49464,45,426,40,1871,6517
2.988,17,4,240,4,32,996,32,240,0,0,0,0,0
962.597,2,12,384,12,8,87508,8,384,0,0,0,0,0
1798.786,6,368,25828,214,99,8445,469,15114,154,69,11756,69,10714
1786.422,6,102,8228,68,64,26663,64,4896,34,58,54131,58,3332
0.378,6,12,2989,7,695,63,860,1763,5,479,61,939,1226
47.276,17,8,2688,8,308,6753,308,2688,0,0,0,0,0
0.739,6,109,87816,53,131,14,232,2649,56,1625,12,8280,85167
1781.762,6,357,22629,208,69,8607,69,12460,149,69,12038,69,10169
1798.494,17,448,39896,403,35,4473,288,25676,45,288,40017,288,14220
0.46,17,4,1436,4,331,153,354,1436,0,0,0,0,0
1118.532,17,220,16720,220,48,5107,48,16720,0,0,0,0,0
57.045,17,20,1760,10,48,6337,48,760,10,72,6336,72,1000
1756.674,1,8,848,8,78,250953,78,848,0,0,0,0,0
1771.389,6,99,9306,66,66,27252,66,5610,33,60,55353,60,3696
0.654,6,15,1785,8,288,73,288,640,7,426,78,434,1145
8.325,6,1826,1698082,1163,1382,7,1408,1658942,663,931,12,2801,39140
1788.532,6,359,22709,209,69,8598,69,12569,150,69,12002,69,10140
1624.744,6,332,21353,187,70,8735,138,11551,145,69,11282,69,9802
1776.305,6,181,15589,120,69,14926,69,8940,61,69,29599,69,6649
0.423,17,2,152,1,48,0,48,76,1,48,0,48,76
1707.05,1,36,2016,36,28,48772,28,2016,0,0,0,0,0
0.125,17,2,672,2,308,125,308,672,0,0,0,0,0
1792.342,17,140,11200,70,48,25975,48,5320,70,56,25975,56,5880
42.261,6,26,7143,12,156,3841,267,1272,14,530,3249,2006,5871
1.152,6,25,8056,12,164,89,267,1288,13,869,81,1440,6768
31.999,6,7,308,1,0,0,0,44,6,0,6323,0,264
0.009,6,3,175,2,31,1,31,135,1,0,0,0,40
0.184,1,2,112,2,28,184,28,112,0,0,0,0,0
377.206,6,23,1535,16,177,25147,177,1053,7,110,10416,110,482
1750.44,6,173,17325,92,72,19235,721,7367,81,137,21876,2840,9958
488.252,1,3,252,3,56,244126,56,252,0,0,0,0,0
1793.058,6,241,35632,150,302,12033,302,25920,91,83,19922,83,9712
0.481,6,12,1653,6,288,92,288,548,6,426,54,434,1105
4.091,17,2,134,2,39,4091,39,134,0,0,0,0,0
7.492,6,1212,1031075,733,1360,10,1380,1007673,479,421,15,1923,23402
1786.544,6,104,8338,68,64,26664,65,4911,36,58,51041,59,3427
74.587,6,9498,9225287,6243,1399,11,1440,9051473,3255,899,22,1440,173814
1.581,6,68,45174,40,1231,40,1408,37813,28,1179,52,3819,7361
1798.417,6,494,30863,273,99,6611,469,17474,221,34,8174,64,13389
0.141,17,4,420,2,33,5,33,122,2,121,129,145,298
1.304,6,48,19378,27,903,50,1460,13762,21,433,56,1460,5616
2.248,6,30,10405,18,367,132,833,1825,12,1012,198,1420,8580
0.115,17,2,198,1,39,0,39,67,1,103,0,103,131
360.982,2,3,96,3,8,180491,8,96,0,0,0,0,0
60.093,6,8,432,5,0,15023,0,268,3,0,30042,0,164
10.962,6,17,4106,10,275,1218,275,958,7,1428,1026,2760,3148
7.716,17,3,228,3,48,3858,48,228,0,0,0,0,0
11.797,6,1915,1637090,1157,1361,10,1380,1600305,758,511,15,1923,36785
0.16,1,2,112,2,28,160,28,112,0,0,0,0,0
1770.378,17,188,41502,188,192,9467,358,41502,0,0,0,0,0
1629.758,1,7,392,7,28,271626,28,392,0,0,0,0,0
11.016,6,22,4526,12,275,1001,275,1038,10,768,706,1440,3488
1709.475,17,12,498,11,14,170947,14,462,1,8,0,8,36
4.0,17,4,240,2,32,3999,32,120,2,32,3998,32,120
1779.148,17,138,11040,69,48,26163,48,5244,69,56,26163,56,5796
1564.182,2,12,384,12,8,142198,8,384,0,0,0,0,0
0.16,6,13,1997,7,329,26,500,1030,6,323,31,500,967
907.346,6,118,15026,68,82,12559,267,5438,50,168,18516,1460,9588
0.022,17,4,304,2,37,0,37,130,2,59,1,65,174
1798.856,17,1069,333701,509,561,3536,1350,299870,560,32,3217,340,33831
126.002,2,2,64,2,8,126002,8,64,0,0,0,0,0
1796.351,6,390,23880,208,69,8678,69,12460,182,44,9924,69,11420
1775.245,17,140,11200,70,48,25728,48,5320,70,56,25728,56,5880
368.289,6,25,1654,17,180,23018,180,1120,8,110,9215,110,534
0.93,6,12,1653,6,288,182,288,548,6,426,98,434,1105
1786.491,17,87,3648,86,14,21017,14,3612,1,8,0,8,36
1771.495,6,101,9410,66,66,27253,66,5610,35,60,52100,60,3800
217.539,6,9,558,6,43,43507,43,394,3,0,108766,0,164
310.691,6,116,77416,64,693,4930,1007,11167,52,1352,6091,2736,66249
11.264,6,28,11413,14,275,866,275,1118,14,1080,830,1420,10295
840.823,17,8,592,4,30,280269,30,232,4,62,280269,62,360
1772.448,6,180,15480,120,69,14894,69,8940,60,69,30033,69,6540
280.515,6,27,7312,12,158,25501,267,1277,15,775,20034,3465,6035
5.566,6,30,9743,18,323,327,604,2342,12,864,487,1380,7401
6.631,6,558,428382,293,1380,22,1448,409938,265,776,24,1448,18444
2.197,6,20,3833,11,234,219,564,1504,9,463,250,1343,2329
170.613,6,23,8478,12,337,55,673,1525,11,928,17048,2720,6953
1770.423,1,58,4872,0,0,0,0,0,58,56,31060,56,4872
369.587,6,18,1242,14,180,28429,180,916,4,110,20071,110,326
0.062,17,2,323,1,33,0,33,61,1,234,0,234,262
155.387,6,23,1664,17,43,9711,43,1304,6,0,30426,0,360
0.045,17,2,602,1,49,0,49,77,1,497,0,497,525
1.615,6,25,8755,15,283,115,583,1455,10,985,159,1420,7300
537.746,6,58,9035,25,121,18076,516,2340,33,191,16801,1452,6695
0.218,17,2,290,1,40,0,40,68,1,194,0,194,222
240.348,6,52,10041,27,449,9244,1408,5988,25,228,10014,580,4053
418.554,6,62,7809,28,115,15496,722,3077,34,129,12678,1408,4732
0.24,6,26,7256,13,155,20,267,1301,13,678,18,2045,5955
1779.438,17,142,11360,71,48,25420,48,5396,71,56,25420,56,5964
377.931,2,3,96,3,8,188965,8,96,0,0,0,0,0
1793.58,6,356,22520,208,69,8664,69,12460,148,69,12200,69,10060
0.213,17,2,152,1,48,0,48,76,1,48,0,48,76
1772.156,6,180,15480,120,69,14892,69,8940,60,69,30031,69,6540
0.951,6,28,8546,15,229,56,583,2007,13,1201,64,3151,6539
1.958,17,22,5698,22,231,93,388,5698,0,0,0,0,0
1792.932,6,356,22520,208,69,8661,69,12460,148,69,12196,69,10060
23.692,6,8,440,5,0,5923,0,268,3,0,11831,0,172
0.008,17,2,152,1,48,0,48,76,1,48,0,48,76
153.423,6,70,47545,44,1198,3567,1408,39458,26,961,2463,3847,8087
41.83,6,23,6459,10,262,4642,517,1314,13,744,3481,1408,5145
0.009,17,2,278,1,36,0,36,64,1,186,0,186,214
0.043,17,2,292,1,53,0,53,81,1,183,0,183,211
0.929,6,26,8380,14,266,59,540,1924,12,1192,68,3151,6456
5.076,6,43,8345,21,227,253,314,4022,22,491,229,1179,4323
1773.026,6,180,15480,120,69,14899,69,8940,60,69,30050,69,6540
2.469,17,36,13851,15,265,176,1350,4401,21,422,117,1350,9450
94.891,6,24,10168,13,549,67,1360,2749,11,1161,9471,2574,7419
3.484,6,4,176,2,0,3484,0,88,2,0,1005,0,88
2.327,17,4,580,2,40,2036,40,136,2,194,2066,194,444
0.008,17,2,394,1,33,0,33,61,1,305,0,305,333
1789.103,1,58,4872,58,56,31387,56,4872,0,0,0,0,0
1772.439,6,180,15480,120,69,14894,69,8940,60,69,30033,69,6540
470.708,17,8,2688,8,308,67244,308,2688,0,0,0,0,0
0.481,17,7,2438,7,320,80,354,2438,0,0,0,0,0
0.422,6,95,66003,59,1260,7,1420,60342,36,467,11,2840,5661
905.888,1,28,1568,28,28,33551,28,1568,0,0,0,0,0
1329.92,6,147,20366,79,304,17050,304,13892,68,83,19835,83,6474
1791.541,6,244,46664,152,483,11864,483,36892,92,83,19686,83,9772
62.816,6,43,10080,21,677,509,1360,4305,22,348,2982,2667,5775
0.008,17,2,350,1,63,0,63,91,1,231,0,231,259
317.087,6,53,12463,29,245,11324,1305,3702,24,458,13780,4649,8761
18.934,17,33,12059,13,342,1575,1350,4818,20,334,994,1350,7241
1775.062,6,180,15480,120,69,14916,69,8940,60,69,30077,69,6540
33.593,6,32,5192,15,180,2399,722,1858,17,271,2086,1402,3334
88.198,6,22,9936,11,380,75,832,1613,11,1124,8806,1360,8323
1792.795,6,356,22520,208,69,8660,69,12460,148,69,12192,69,10060
0.413,6,12,1653,7,288,68,288,588,5,426,56,434,1065
297.062,17,4,352,2,60,297060,60,176,2,60,297061,60,176
134.732,17,16,1408,8,48,19246,48,608,8,72,19246,72,800
95.158,17,8,704,4,48,31717,48,304,4,72,31716,72,400
3.445,6,9,360,5,0,861,0,200,4,0,1040,0,160
8.899,6,81,24525,41,552,222,1152,18784,40,459,221,1179,5741
0.182,6,46,22748,27,1111,7,1420,17767,19,467,9,1883,4981
280.35,6,30,7432,13,158,23362,267,1317,17,543,17516,1300,6115
3.091,17,4,1568,4,364,1030,364,1568,0,0,0,0,0
1.575,6,10,1687,7,100,262,100,384,3,1179,654,1179,1303
1794.089,17,180,11520,180,36,10022,36,11520,0,0,0,0,0
1789.158,6,368,23345,213,69,8439,69,13005,155,69,11617,69,10340
21.451,6,17,1609,9,517,2681,517,997,8,156,2344,156,612
0.011,17,2,375,1,44,0,44,72,1,275,0,275,303
3.998,17,4,296,4,46,1332,46,296,0,0,0,0,0
12.323,6,21,6355,9,262,1535,517,1262,12,744,1116,1408,5093
1651.386,1,7,392,7,28,275231,28,392,0,0,0,0,0
1792.51,6,416,25298,222,69,8110,69,13089,194,42,9287,69,12209
15.13,17,4,1352,4,310,5043,318,1352,0,0,0,0,0
300.578,6,37,8526,19,315,16698,882,2053,18,441,496,1440,6473
1.614,6,51,18847,29,853,57,1360,13146,22,400,67,1360,5701
1.109,6,24,8004,12,164,85,267,1288,12,1014,85,2804,6716
481.316,2,4,128,4,8,160438,8,128,0,0,0,0,0
0.276,17,2,588,1,39,0,39,67,1,493,0,493,521
251.775,2,2,64,2,8,251775,8,64,0,0,0,0,0
16.414,17,19,6986,9,440,2051,1350,4213,10,249,1777,1350,2773
0.919,6,10,1687,7,100,153,100,384,3,1179,326,1179,1303
1.023,6,24,6435,14,310,78,889,2115,10,979,112,1731,4320
6.418,6,1053,893080,613,1411,10,1432,871223,440,420,14,1432,21857
1794.285,17,142,11360,71,48,25632,48,5396,71,56,25632,56,5964
43.408,17,12,912,12,48,3946,48,912,0,0,0,0,0
1.199,6,28,9595,14,431,92,1366,2317,14,958,78,1460,7278
1795.385,17,449,39928,404,35,4455,288,25708,45,288,40021,288,14220
289.858,1,4,224,4,28,96619,28,224,0,0,0,0,0
0.349,6,13,1693,7,288,58,288,588,6,284,37,434,1105
1785.859,6,385,28688,219,108,8192,1189,16023,166,86,10823,512,12665
1681.433,17,14,3843,7,30,280237,30,406,7,463,280237,463,3437
0.218,17,2,396,1,39,0,39,67,1,301,0,301,329
1777.451,17,75,3144,74,14,24348,14,3108,1,8,0,8,36
300.605,6,43,8764,18,308,17682,889,2011,25,441,1463,1360,6753
9.766,6,93,30670,49,591,203,1152,24428,44,447,220,1179,6242
126.779,6,63,42558,41,1162,3169,1448,34683,22,747,2931,1448,7875
1773.733,17,30,20190,30,645,61163,645,20190,0,0,0,0,0
7.011,6,1772,1661192,1137,1384,6,1408,1623508,635,776,10,1408,37684
1799.973,17,449,39928,404,35,4466,288,25708,45,288,40022,288,14220
0.039,17,4,368,2,32,23,32,120,2,96,19,96,248
1783.745,6,356,22520,208,69,8617,69,12460,148,69,12131,69,10060
32.239,17,36,2760,18,40,1891,41,1236,18,56,1891,57,1524
348.688,17,8,2688,8,308,49812,308,2688,0,0,0,0,0
0.506,6,22,5040,10,137,56,267,1092,12,692,42,1487,3948
1777.411,17,86,3606,85,14,21157,14,3570,1,8,0,8,36
0.488,17,2,2380,2,1162,488,1162,2380,0,0,0,0,0
68.683,6,31,10602,16,335,325,1360,3023,15,995,4894,1360,7579
60.873,2,2,64,2,8,60873,8,64,0,0,0,0,0
0.573,17,2,213,1,36,0,36,64,1,121,0,121,149
0.061,6,9,1343,5,145,15,145,349,4,830,13,830,994
1799.771,17,449,39928,404,35,4465,288,25708,45,288,40019,288,14220
280.225,6,29,7392,14,158,21555,267,1357,15,678,20012,3436,6035
1787.109,17,140,11200,70,48,25899,48,5320,70,56,25899,56,5880
0.249,6,22,5040,11,137,24,267,1132,11,692,24,1467,3908
9.999,6,7,300,2,0,9831,0,84,5,0,2458,0,216
0.626,6,22,5131,11,137,62,267,1132,11,592,61,1467,3999
4.061,17,4,240,4,32,1353,32,240,0,0,0,0,0
242.792,1,6,336,6,28,48558,28,336,0,0,0,0,0
0.507,6,10,968,5,256,122,256,460,5,304,120,304,508
1.242,6,50,20634,28,921,46,1360,14978,22,529,51,4075,5656
349.381,17,7,4458,7,608,58230,1123,4458,0,0,0,0,0
155.869,6,25,11069,12,380,70,832,1665,13,985,12978,1360,9404
171.228,17,2,460,2,202,171228,355,460,0,0,0,0,0
21.869,17,4,824,2,48,21860,48,152,2,308,21859,308,672
0.303,6,23,5994,12,181,27,537,1526,11,777,28,2206,4468
1769.999,6,101,9278,66,64,27230,64,5544,35,58,52056,58,3734
0.226,17,3,234,2,39,201,39,134,1,72,0,72,100
1793.554,6,355,22480,207,69,8706,69,12420,148,69,12200,69,10060
0.661,17,21,14525,12,982,59,1350,12129,9,238,78,1350,2396
1.295,6,38,11258,21,616,64,1460,5802,17,433,69,1460,5456
153.77,6,46,9170,19,139,8542,267,2158,27,296,5913,1933,7012
1798.855,17,448,39896,403,35,4474,288,25676,45,288,40018,288,14220
0.142,17,2,146,1,37,0,37,65,1,53,0,53,81
280.232,6,32,7512,15,158,20016,267,1397,17,543,17512,1400,6115
1710.289,1,8,448,8,28,244327,28,448,0,0,0,0,0
280.421,6,30,7432,13,158,23368,267,1317,17,543,17515,1400,6115
0.287,17,4,352,2,60,285,60,176,2,60,286,60,176
33.878,6,34,9170,14,158,2606,267,1357,20,539,1777,1400,7813
399.178,6,18,1242,14,180,30706,180,916,4,110,20101,110,326
132.567,17,5,1972,1,548,0,548,576,4,321,43855,321,1396
1744.815,6,101,7963,66,45,26843,205,4914,35,35,51306,98,3049
280.445,6,27,7312,12,158,25495,267,1277,15,775,20029,3465,6035
103.257,6,948,476971,536,828,193,1152,455359,412,394,250,1152,21612
240.818,6,59,18433,32,802,7768,1418,15339,27,186,9261,580,3094
0.08,6,10,1752,6,592,16,1028,1429,4,159,26,159,323
8.847,1,5,530,5,78,2211,78,530,0,0,0,0,0
0.922,6,10,1687,7,100,153,100,384,3,1179,329,1179,1303
0.377,6,22,5040,11,137,37,267,1132,11,692,36,1467,3908
175.41,6,40,6182,19,210,9745,585,2887,21,219,8758,580,3295
4.317,6,34,6169,18,206,253,314,2784,16,548,270,1179,3385
0.164,6,69,47961,37,181,4,253,2523,32,1458,3,4224,45438
1798.617,17,142,11360,71,48,25694,48,5396,71,56,25694,56,5964
3.987,17,4,244,4,33,1329,33,244,0,0,0,0,0
1.47,6,51,19016,29,865,52,1360,13315,22,437,60,2715,5701
1741.285,6,87,6322,58,31,30548,31,3915,29,31,62187,31,2407
0.336,6,21,7281,12,334,30,663,1969,9,967,41,1471,5312
1677.923,1,70,3920,70,28,24317,28,3920,0,0,0,0,0
177.066,6,27,8069,10,220,6967,516,1285,17,435,11061,1452,6784
586.957,17,22,7392,22,308,27950,308,7392,0,0,0,0,0
1786.296,6,106,8504,68,64,26661,64,4896,38,58,48275,58,3608
7.319,6,1695,1586885,1090,1379,6,1408,1550761,605,931,11,2816,36124
1769.961,1,58,4872,58,56,31051,56,4872,0,0,0,0,0
1.247,6,29,7636,15,269,89,780,1978,14,847,81,1538,5658
1798.029,6,399,24894,227,69,7955,69,13634,172,59,10514,69,11260
1773.287,6,181,15589,120,69,14901,69,8940,61,69,29548,69,6649
2.503,6,33,19019,18,1042,147,1460,10135,15,1034,165,1460,8884
0.421,6,10,1992,5,288,97,288,508,5,424,58,434,1484
1720.417,17,12,498,11,14,172041,14,462,1,8,0,8,36
0.035,17,2,180,1,30,0,30,58,1,94,0,94,122
1745.65,6,95,7203,63,38,28155,205,4476,32,33,56298,98,2727
0.786,6,10,1687,7,100,131,100,384,3,1179,268,1179,1303
531.435,17,8,1973,4,31,177141,37,239,4,405,177141,463,1734
2.754,6,3014,2720581,1553,212,1,230,84803,1461,1754,1,12672,2635778
214.518,6,42,7718,19,153,11915,517,1939,23,456,9748,1418,5779
1125.291,17,220,16720,220,48,5138,48,16720,0,0,0,0,0
0.248,6,9,1002,5,213,62,213,417,4,421,64,421,585
0.245,17,12,4401,12,338,22,361,4401,0,0,0,0,0
1794.265,17,300,61392,300,176,6000,422,61392,0,0,0,0,0
0.002,6,4,227,3,31,1,31,187,1,0,0,0,40
69.31,6,37,9362,14,155,5331,267,1346,23,373,3143,1420,8016
0.019,17,2,515,1,137,0,137,165,1,322,0,322,350
11.229,6,27,11433,13,275,935,275,1078,14,1087,850,1440,10355
1795.576,17,447,39864,402,35,4477,288,25644,45,288,40023,288,14220
208.366,1,22,1232,22,28,9922,28,1232,0,0,0,0,0
35.778,17,6,1236,3,48,17854,48,228,3,308,17880,308,1008
1793.618,17,142,11360,71,48,25623,48,5396,71,56,25623,56,5964
1680.602,17,12,498,11,14,168060,14,462,1,8,0,8,36
4.032,6,35,6209,18,206,237,314,2784,17,456,235,1152,3425
1634.449,1,8,448,8,28,233492,28,448,0,0,0,0,0
1791.045,6,304,29158,178,103,10118,469,14391,126,127,14328,1452,14767
65.277,6,637,299727,335,831,195,1152,282126,302,424,215,1179,17601
1772.605,6,180,15480,120,69,14895,69,8940,60,69,30042,69,6540
0.224,17,2,179,1,43,0,43,71,1,80,0,80,108
240.179,6,54,17781,29,791,8577,1408,14965,25,188,10007,580,2816
1662.456,1,7,742,7,78,277076,78,742,0,0,0,0,0
1788.579,6,121,14474,79,84,22930,497,6385,42,160,43621,1420,8089
4.005,17,5,4317,2,720,4005,1350,1497,3,912,773,1350,2820
3.03,6,18,7139,8,498,175,721,1320,10,1353,317,1414,5819
1749.0,6,171,15896,94,124,18806,447,11948,77,31,22656,31,3948
15.148,6,5,752,3,46,7574,46,166,2,506,14970,506,586
308.902,6,8,506,8,31,44128,31,506,0,0,0,0,0
1.366,6,51,19762,29,918,48,1360,14061,22,437,56,2715,5701
0.054,17,2,256,1,49,0,49,77,1,151,0,151,179
0.513,17,2,384,1,39,0,39,67,1,289,0,289,317
240.2,6,55,18427,29,816,8578,1408,15401,26,208,9607,580,3026
16.138,17,30,9452,14,319,1238,1350,4867,16,258,1073,1350,4585
1798.582,17,449,39928,404,35,4462,288,25708,45,288,40018,288,14220
0.072,17,3,1170,3,362,36,362,1170,0,0,0,0,0
0.185,6,10,1671,6,552,37,948,1348,4,159,61,159,323
9.129,17,4,304,4,48,3043,48,304,0,0,0,0,0
0.048,17,2,510,1,37,0,37,65,1,417,0,417,445
38.059,6,46,10156,22,533,510,910,3083,24,406,1649,1360,7073
0.457,17,2,144,1,36,0,36,64,1,52,0,52,80
231.388,17,12,4944,12,384,21035,394,4944,0,0,0,0,0
1706.647,17,15,2910,15,166,121903,166,2910,0,0,0,0,0
1785.859,6,362,23105,207,69,8669,69,12558,155,69,11596,69,10547
1704.782,1,8,448,8,28,243540,28,448,0,0,0,0,0
1797.305,6,356,22520,208,69,8682,69,12460,148,69,12224,69,10060
62.747,6,54,33204,33,1125,1960,1448,25359,21,749,3118,1448,7845
1576.075,1,16,1304,16,53,105071,78,1304,0,0,0,0,0
16.291,6,135,48781,68,682,243,1152,41619,67,407,243,1152,7162
2.082,17,5,952,3,32,509,32,180,2,358,0,470,772
1790.045,6,364,25392,212,100,8483,469,14896,152,69,11853,69,10496
0.716,17,3,1170,3,362,358,362,1170,0,0,0,0,0
16.254,17,35,21200,20,865,853,1350,17867,15,194,1158,1350,3333
0.053,17,2,904,1,300,0,300,328,1,548,0,548,576
12.13,6,1890,1666067,1153,1390,10,1420,1632366,737,467,16,2840,33701
280.67,6,31,7472,14,158,21590,267,1357,17,543,17538,1400,6115
1772.255,6,180,15480,120,69,14892,69,8940,60,69,30032,69,6540
1794.912,1,270,15120,270,28,6672,28,15120,0,0,0,0,0
1789.953,6,357,22629,208,69,8647,69,12460,149,69,12094,69,10169
1.588,6,45,17327,26,824,63,1360,11791,19,433,75,1360,5536
401.881,6,135,22725,65,413,6279,1418,12536,70,125,5821,1418,10189
240.204,6,55,20738,30,857,8282,1418,17855,25,225,10008,580,2883
4.151,17,10,2415,5,40,1036,40,340,5,387,1035,407,2075
1791.982,1,342,28728,342,56,5255,56,28728,0,0,0,0,0
0.46,17,18,11948,9,881,57,1350,8187,9,389,50,1350,3761
1772.877,6,180,15480,120,69,14898,69,8940,60,69,30041,69,6540
1786.561,6,102,8364,68,66,26665,66,4964,34,60,54135,60,3400
12.094,6,18,1252,10,92,1343,92,708,8,92,966,92,544
1799.078,1,58,4872,58,56,31562,56,4872,0,0,0,0,0
2.201,6,24,5569,12,140,200,267,1184,12,780,193,1460,4385
0.452,6,22,5040,10,137,50,267,1092,12,692,36,1487,3948
17.561,17,4,304,4,48,5853,48,304,0,0,0,0,0
19.17,17,2,152,2,48,19170,48,152,0,0,0,0,0
36.399,2,2,64,2,8,36399,8,64,0,0,0,0,0
1788.533,17,142,11360,71,48,25550,48,5396,71,56,25550,56,5964
138.57,17,30,35364,30,1150,4778,1451,35364,0,0,0,0,0
365.781,6,18,1242,14,180,28137,180,916,4,110,20065,110,326
1784.219,6,106,8446,69,64,26238,64,4936,37,58,49558,58,3510
0.086,17,2,152,1,48,0,48,76,1,48,0,48,76
0.06,17,4,336,2,34,1,34,124,2,78,0,84,212
33.684,6,29,4990,14,180,2591,721,1807,15,342,2388,1368,3183
7.96,6,1277,1104675,773,1380,10,1420,1080294,504,467,15,1883,24381
1787.214,6,107,8564,68,66,26674,66,4964,39,60,47028,60,3600
0.502,17,3,451,2,39,261,39,134,1,289,0,289,317
0.925,6,51,13829,24,551,40,1429,4840,27,464,34,1986,8989
7.508,6,29,6175,15,338,536,1314,2294,14,368,576,1420,3881
11.986,6,30,9282,14,375,922,721,3189,16,681,685,1420,6093
481.319,2,6,192,6,8,96263,8,192,0,0,0,0,0
5.76,6,41,7365,22,218,274,314,3503,19,516,305,1179,3862
1785.529,6,362,22898,210,69,8543,69,12678,152,69,11824,69,10220
485.407,6,80,11781,41,91,12135,267,3392,39,200,12769,1420,8389
177.788,17,6,528,3,60,88893,60,264,3,60,88893,60,264
1624.295,2,14,448,14,8,124945,8,448,0,0,0,0,0
1785.66,6,150,24780,90,483,20063,483,19170,60,83,30265,83,5610
0.128,17,2,396,1,39,0,39,67,1,301,0,301,329
1785.174,6,105,8406,68,64,26644,64,4896,37,58,49585,58,3510
1789.909,17,142,11360,71,48,25569,48,5396,71,56,25569,56,5964
1772.782,6,180,15480,120,69,14897,69,8940,60,69,30041,69,6540
1796.742,6,376,26286,217,98,8318,469,15303,159,69,11371,69,10983
6.164,6,45,8425,23,227,280,314,4102,22,491,281,1179,4323
0.04,17,6,912,3,60,12,60,264,3,188,13,188,648
1.001,2,3,120,3,16,500,16,120,0,0,0,0,0
300.678,6,35,8152,20,241,15825,619,1798,15,574,608,4848,6354
1785.055,6,198,34718,127,302,14167,302,25678,71,83,25499,83,9040
280.518,6,31,7472,13,158,23376,267,1317,18,543,16495,1380,6155
1796.69,17,448,39896,403,35,4469,288,25676,45,288,40021,288,14220
281.846,6,30,7432,13,158,23487,267,1317,17,543,17598,1400,6115
3.29,6,19,4920,9,137,411,267,1052,10,692,364,1467,3868
561.01,17,6,444,3,30,280475,30,174,3,62,280480,62,270
1775.505,6,208,22697,132,75,13553,267,10275,76,133,23668,1917,12422
378.016,2,3,96,3,8,189008,8,96,0,0,0,0,0
61.96,6,26,7137,12,155,5632,267,1266,14,530,4765,2006,5871
292.511,17,4,1344,4,308,97503,308,1344,0,0,0,0,0
1795.692,17,448,39896,403,35,4466,288,25676,45,288,40018,288,14220
30.369,6,32,7792,11,156,14,267,1232,21,336,1518,1997,6560
1737.321,1,56,4704,56,56,31587,56,4704,0,0,0,0,0
0.418,6,20,4960,10,137,46,267,1092,10,692,40,1467,3868
7.427,17,12,1764,6,48,1482,48,456,6,190,1481,308,1308
0.46,6,4,1037,2,0,222,0,104,2,853,243,853,933
280.688,6,29,7483,14,158,21591,267,1357,15,690,20045,4836,6126
451.355,6,46,4048,31,73,15045,138,2413,15,69,32238,69,1635
17.866,6,1924,1766428,1239,1374,14,1380,1731993,685,355,26,1380,34435
1794.219,6,374,27220,217,100,8306,693,15197,157,85,11501,725,12023
13.725,6,2359,2186047,1504,1375,9,1408,2136923,855,931,15,2816,49124
10.958,6,19,4362,11,275,1095,275,998,8,1010,884,2840,3364
126.438,6,21,10987,7,290,1103,517,953,14,844,9725,1408,10034
0.024,17,2,116,1,30,0,30,58,1,30,0,30,58
280.52,6,30,7432,13,158,23376,267,1317,17,603,17525,2076,6115
0.524,6,54,22182,30,1042,18,1380,16935,24,355,20,1380,5247
1794.635,17,29,30715,29,1031,64094,1064,30715,0,0,0,0,0
915.42,6,248,33355,120,177,7691,863,20969,128,196,7206,2007,12386
0.186,1,2,112,2,28,186,28,112,0,0,0,0,0
1682.931,17,14,1036,7,30,280480,30,406,7,62,280479,62,630
1.751,6,51,21919,29,941,62,1360,16263,22,433,73,1360,5656
1.008,6,10,1687,7,100,168,100,384,3,1179,360,1179,1303
93.069,6,59,23960,30,661,923,1440,7872,29,785,3318,1472,16088
196.199,1,4,224,4,28,65399,28,224,0,0,0,0,0
1740.694,17,28,6580,28,207,64470,207,6580,0,0,0,0,0
1797.893,17,448,39896,403,35,4472,288,25676,45,288,40021,288,14220
1787.69,17,87,3648,86,14,21031,14,3612,1,8,0,8,36
1780.133,1,67,5628,0,0,0,0,0,67,56,26971,56,5628
5.009,17,4,542,2,36,5004,36,128,2,179,5004,187,414
175.243,17,2,72,1,8,0,8,36,1,8,0,8,36
4.69,6,39,7269,19,218,260,314,3383,20,513,234,1179,3886
1784.833,6,362,25450,208,100,8622,469,14736,154,69,11665,69,10714
7.233,6,9,588,3,106,3602,106,234,6,90,1444,90,354
1789.512,6,191,24518,106,304,17042,304,16852,85,83,21303,83,7666
1.26,6,23,7952,12,164,97,267,1288,11,1216,106,3819,6664
0.894,6,19,9228,12,372,81,808,1628,7,1827,116,5776,7600
1.017,17,6,420,3,32,507,32,180,3,52,505,60,240
33.296,6,10,576,3,0,5460,0,172,7,0,5548,0,404
1.89,6,29,12044,17,529,118,1360,3370,12,1022,113,3921,8674
431.559,6,121,14665,59,145,7162,1189,5418,62,250,7074,1917,9247
1684.479,2,15,480,15,8,120319,8,480,0,0,0,0,0
1740.292,6,87,6322,58,31,30531,31,3915,29,31,62152,31,2407
300.297,6,35,9220,18,405,17664,1066,2626,17,475,2082,1491,6594
5.017,17,4,288,2,36,5003,36,128,2,52,4997,52,160
1792.971,1,236,25016,236,78,7629,78,25016,0,0,0,0,0
0.019,17,4,284,2,32,0,32,120,2,54,13,60,164
1710.948,1,8,448,8,28,244421,28,448,0,0,0,0,0
1775.154,17,73,3060,72,14,25002,14,3024,1,8,0,8,36
0.128,17,2,672,2,308,128,308,672,0,0,0,0,0
1796.568,17,446,38980,404,35,4457,288,25708,42,288,42955,288,13272
1799.951,17,757,45677,757,32,2380,37,45677,0,0,0,0,0
166.484,1,4,224,4,28,55494,28,224,0,0,0,0,0
33.921,6,38,7084,18,154,1995,721,2071,20,360,1775,2026,5013
1787.346,6,118,7129,64,27,28369,27,3841,54,27,33722,27,3288
0.253,6,22,7333,13,334,21,663,2021,9,1209,30,1906,5312
253.806,1,10,840,10,56,28200,56,840,0,0,0,0,0
0.248,6,23,4494,11,165,24,456,1394,12,493,21,888,3100
1679.689,17,13,534,11,14,167950,14,462,2,8,1679509,8,72
1798.35,17,449,39928,404,35,4462,288,25708,45,288,40018,288,14220
0.356,6,10,968,5,256,87,256,460,5,304,87,304,508
130.58,17,8,2688,8,308,18654,308,2688,0,0,0,0,0
5.768,6,495,464842,333,1336,16,1368,451754,162,776,34,1473,13088
1785.117,6,218,16794,83,70,21768,331,8135,135,48,13320,78,8659
1.384,6,50,19301,27,892,53,1460,13605,23,433,54,1460,5696
503.974,6,40,4413,24,122,21911,205,3069,16,32,33579,33,1344
1794.984,6,356,22520,208,69,8671,69,12460,148,69,12210,69,10060
0.167,17,2,200,1,64,0,64,92,1,80,0,80,108
34.146,6,23,16069,7,217,863,217,814,16,1438,2275,1440,15255
1.753,6,49,21587,30,984,60,1460,16006,19,437,83,2920,5581
472.207,6,35,6856,19,150,12054,499,1815,16,338,31475,2642,5041
7.349,6,1742,1615546,1109,1379,6,1408,1577966,633,931,11,2801,37580
151.762,17,8,2656,8,304,21680,308,2656,0,0,0,0,0
6.078,6,45,8425,23,227,276,314,4102,22,491,276,1179,4323
1744.625,2,25,800,25,8,72692,8,800,0,0,0,0,0
9.342,6,16,940,5,0,2335,0,280,11,0,899,0,660
256.006,6,4,346,4,46,85335,62,346,0,0,0,0,0
10.65,6,10,1699,4,100,3550,100,264,6,589,2005,1152,1435
4.954,17,2,2106,2,1025,4954,1043,2106,0,0,0,0,0
227.206,17,4,352,2,60,227205,60,176,2,60,227205,60,176
280.437,6,28,7352,13,158,23369,267,1317,15,678,20027,3456,6035
0.072,6,10,767,5,186,16,186,454,5,45,17,45,313
2.866,17,26,10289,11,485,286,1350,5649,15,281,121,1350,4640
1.481,17,6,840,3,64,550,64,276,3,160,569,160,564
1657.717,1,8,448,8,28,236816,28,448,0,0,0,0,0
20.19,6,18,3026,10,229,2243,517,1457,8,381,2879,499,1569
64.531,6,10,420,5,0,365,0,208,5,0,16130,0,212
0.096,17,2,2754,2,1349,96,1349,2754,0,0,0,0,0
285.52,17,6,528,3,60,142759,60,264,3,60,142759,60,264
10.862,6,20,4442,11,275,1086,275,998,9,768,760,1440,3444
49.13,17,4,352,2,60,49128,60,176,2,60,49128,60,176
1650.528,1,8,448,8,28,235789,28,448,0,0,0,0,0
12.189,6,1935,1663399,1173,1363,10,1380,1628677,762,421,15,1923,34722
27.818,6,37,8990,19,340,1545,722,2809,18,778,1588,1380,6181
34.194,17,20,1760,10,48,3798,48,760,10,72,3798,72,1000
1798.832,1,67,5628,67,56,27255,56,5628,0,0,0,0,0
382.362,6,19,1306,14,180,29412,180,928,5,110,15164,110,378
0.006,17,2,418,1,59,0,59,87,1,303,0,303,331
1797.939,17,446,39832,401,35,4494,288,25612,45,288,40020,288,14220
0.989,6,28,8503,15,225,57,561,1985,13,997,67,1791,6518
1786.8,6,106,8524,68,66,26668,66,4964,38,60,48289,60,3560
0.04,6,2,111,1,0,0,0,40,1,31,0,31,71
3.008,17,2,176,2,60,3008,60,176,0,0,0,0,0
3.475,6,22,6409,10,262,381,517,1316,12,744,311,1418,5093
40.612,17,2,672,2,308,40612,308,672,0,0,0,0,0
1799.889,17,449,39928,404,35,4466,288,25708,45,288,40021,288,14220
1779.805,17,142,11360,71,48,25425,48,5396,71,56,25425,56,5964
37.973,6,26,6335,15,117,2712,159,1389,11,727,3795,1418,4946
280.48,6,30,7432,13,158,23373,267,1317,17,603,17525,2760,6115
264.458,17,6,2016,6,308,52891,308,2016,0,0,0,0,0
0.714,6,23,6000,12,108,64,147,919,11,927,70,1608,5081
0.343,6,9,1339,5,145,85,145,349,4,826,101,826,990
1797.212,6,138,10416,78,82,23340,208,7086,60,31,30453,31,3330
0.472,17,3,451,2,39,454,39,134,1,289,0,289,317
0.013,17,2,272,1,60,0,60,88,1,156,0,156,184
281.362,6,30,7570,12,158,25578,267,1277,18,464,16526,1400,6293
1.703,6,13,2311,8,188,243,245,700,5,1407,360,1407,1611
0.364,6,10,968,5,256,89,256,460,5,304,89,304,508
1.394,6,236,186131,141,1336,9,1432,178040,95,475,14,2864,8091
39.11,17,22,1936,11,48,3910,48,836,11,72,3909,72,1100
9.57,6,71,21242,37,522,265,1152,16114,34,470,281,1179,5128
1.708,6,12,1304,6,256,339,256,756,6,304,339,304,548
1.344,6,49,18683,28,912,49,1460,13022,21,400,58,1460,5661
0.259,6,9,527,5,43,64,43,311,4,0,44,0,216
1770.938,6,125,7649,68,27,26431,27,4082,57,27,31623,27,3567
0.273,17,3,451,2,39,82,39,134,1,289,0,289,317
1150.912,6,222,22087,120,79,9499,267,8208,102,171,11395,1452,13879
1797.757,17,435,38344,392,35,4597,288,24756,43,288,41928,288,13588
317.062,6,75,19208,39,325,8343,1360,9741,36,400,9054,4080,9467
1680.501,1,15,840,15,28,120035,28,840,0,0,0,0,0
1773.031,6,180,15480,120,69,14899,69,8940,60,69,30048,69,6540
481.27,2,4,128,4,8,160423,8,128,0,0,0,0,0
1792.985,1,58,4872,58,56,31455,56,4872,0,0,0,0,0
18.968,17,28,6615,11,209,1893,1350,2614,17,207,1183,1350,4001
11.848,6,1792,1633478,1111,1418,10,1432,1602017,681,420,17,1432,31461
1.176,6,29,8303,15,225,72,561,1985,14,820,76,1440,6318
0.12,17,4,1375,4,315,40,354,1375,0,0,0,0,0
178.085,6,21,9564,11,556,89,1330,2140,10,1402,19766,3639,7424
116.612,17,14,1232,7,48,19434,48,532,7,72,19434,72,700
1687.642,1,266,14896,266,28,6368,28,14896,0,0,0,0,0
280.461,6,29,7392,13,158,23371,267,1317,16,775,18693,4836,6075
1730.424,6,24,3973,16,262,115361,413,2740,8,114,247178,269,1233
1.604,17,26,13866,12,447,145,1350,5700,14,555,108,1350,8166
8.484,6,23,4192,15,181,606,267,2054,8,362,1160,1179,2138
0.105,6,9,1002,5,213,26,213,417,4,421,26,421,585
1.366,6,52,21187,28,953,50,1460,15451,24,433,51,1460,5736
2.659,6,9,2799,6,100,531,100,344,3,1165,573,1179,2455
234.422,6,33,10773,14,158,18032,267,1357,19,721,13013,1781,9416
1789.523,6,359,22778,210,69,8562,69,12678,149,69,12089,69,10100
193.811,6,6,1257,4,327,64603,414,815,2,181,193615,270,442
111.3,6,33,11409,18,448,6547,1448,4531,15,676,7935,1448,6878
12.7,6,9,596,3,106,6350,106,234,6,90,2498,90,362
30.044,6,3894,3648716,2461,1402,12,1448,3569512,1433,776,20,1448,79204
11.351,6,1785,1557409,1100,1363,10,1380,1525767,685,421,16,1923,31642
0.668,6,25,6081,13,108,55,147,959,12,773,50,1608,5122
1798.165,17,450,39960,405,35,4450,288,25740,45,288,40017,288,14220
0.163,6,9,1002,5,213,40,213,417,4,421,40,421,585
1798.609,17,449,39928,404,35,4463,288,25708,45,288,40017,288,14220
1101.779,17,216,16416,216,48,5124,48,16416,0,0,0,0,0
352.817,6,77,50977,47,1183,7669,1408,42682,30,961,2159,3847,8295
0.919,6,30,13322,16,511,61,1360,3239,14,1056,57,2561,10083
166.484,6,18,3910,9,364,20810,1023,2655,9,110,20311,154,1255
5.635,17,4,240,2,32,5634,32,120,2,32,5634,32,120
1786.406,6,104,8308,68,64,26662,64,4896,36,58,51037,58,3412
1.336,6,47,19895,27,943,51,1460,14319,20,433,60,1460,5576
1755.472,17,16,3968,16,220,117031,1030,3968,0,0,0,0,0
0.079,6,13,2529,8,278,11,518,992,5,634,11,1250,1537
1768.252,1,76,6384,76,56,23576,56,6384,0,0,0,0,0
15.647,17,27,6020,12,217,1419,1350,2946,15,176,1115,1350,3074
375.887,6,18,1242,14,180,28914,180,916,4,110,20058,110,326
1769.239,1,152,8512,152,28,11716,28,8512,0,0,0,0,0
5.038,17,4,288,2,36,5005,36,128,2,52,5007,52,160
1.743,6,29,10254,17,284,108,584,1536,12,1029,143,1420,8718
1705.14,1,8,448,8,28,243591,28,448,0,0,0,0,0
17.031,17,24,5867,12,256,1545,1350,3415,12,176,1544,1350,2452
61.949,6,73,51076,46,1192,1376,1368,42937,27,747,2373,1368,8139
0.68,6,23,7336,13,319,56,602,1960,10,1209,70,1946,5376
1758.539,17,294,56186,294,163,6001,422,56186,0,0,0,0,0
297.092,1,4,224,4,28,99030,28,224,0,0,0,0,0
1789.035,17,87,3648,86,14,21047,14,3612,1,8,0,8,36
119.345,6,21,10149,11,433,61,990,1771,10,1327,13247,3928,8378
0.173,17,4,588,2,48,163,48,152,2,190,161,308,436
467.534,17,8,2045,4,31,155843,37,239,4,423,155843,463,1806
50.302,6,26,4850,11,179,5030,722,1643,15,342,3570,1408,3207
1799.315,17,449,39928,404,35,4464,288,25708,45,288,40016,288,14220
8.165,6,1485,1352262,929,1377,8,1408,1318686,556,931,14,2801,33576
1793.674,17,87,3648,86,14,21102,14,3612,1,8,0,8,36
35.29,6,4504,4113569,2706,1432,12,1448,4006693,1798,776,19,1448,106876
505.875,1,18,1512,18,56,29757,56,1512,0,0,0,0,0
64.017,6,38,9715,12,152,5818,267,1404,26,345,2560,1420,8311
5.801,6,523,449071,322,1328,17,1368,433955,201,776,28,2736,15116
1780.583,17,142,11360,71,48,25436,48,5396,71,56,25436,56,5964
1786.723,6,102,8296,68,65,26667,65,4930,34,59,54140,59,3366
0.004,17,2,491,1,37,0,37,65,1,398,0,398,426
1795.061,1,174,9744,174,28,10376,28,9744,0,0,0,0,0
11.995,6,9,527,5,43,2998,43,311,4,0,3970,0,216
6.55,6,5,224,3,0,3275,0,128,2,0,1012,0,96
26.116,6,27,7177,13,155,2176,267,1306,14,530,2008,2840,5871
0.04,6,2,133,1,0,0,0,40,1,53,0,53,93
40.961,17,6,1236,3,48,20475,48,228,3,308,20475,308,1008
0.046,17,2,198,1,37,0,37,65,1,105,0,105,133
56.086,6,29,7257,14,155,4314,267,1346,15,482,4005,2840,5911
15.332,17,4,240,2,32,15332,32,120,2,32,15331,32,120
0.002,6,4,172,1,0,0,0,40,3,0,0,0,132
121.777,17,4,352,2,60,121776,60,176,2,60,121776,60,176
0.16,17,2,632,1,288,0,288,316,1,288,0,288,316
4.355,6,40,7309,21,218,217,314,3463,19,513,228,1179,3846
7.178,2,2,64,2,8,7178,8,64,0,0,0,0,0
1740.423,17,29,6699,29,203,62157,203,6699,0,0,0,0,0
0.0,17,2,215,1,49,0,49,77,1,110,0,110,138
5.031,17,3,208,2,36,5001,36,128,1,52,0,52,80
11.94,6,8,336,4,0,3979,0,164,4,0,3977,0,172
0.009,17,2,225,1,37,0,37,65,1,132,0,132,160
73.747,6,9,794,9,48,9218,62,794,0,0,0,0,0
1787.094,1,74,6216,74,56,24480,56,6216,0,0,0,0,0
0.3,6,4,196,3,0,33,0,156,1,0,0,0,40
1.591,6,51,13850,25,551,66,1429,4892,26,439,62,1986,8958
0.206,1,2,112,2,28,206,28,112,0,0,0,0,0
6.624,6,41,7349,21,218,331,314,3463,20,513,333,1179,3886
1770.136,6,209,14398,78,46,22986,46,6168,131,46,13616,46,8230
0.059,17,2,904,1,300,0,300,328,1,548,0,548,576
126.189,6,33,16377,15,651,59,1460,3248,18,1033,7415,1460,13129
180.239,6,23,11278,12,433,77,990,1823,11,1286,18009,3928,9455
1784.914,6,117,9355,71,65,24012,65,5180,46,56,39520,59,4175
942.107,1,5,280,5,28,235526,28,280,0,0,0,0,0
5.253,6,14,7913,6,275,1050,275,794,8,1698,496,2760,7119
0.495,17,3,451,2,39,127,39,134,1,289,0,289,317
1720.431,17,14,587,12,14,156402,15,505,2,13,767475,18,82
280.426,6,29,7392,13,158,23368,267,1317,16,678,18693,2085,6075
1777.057,1,339,28476,339,56,5257,56,28476,0,0,0,0,0
0.049,17,4,288,2,33,2,33,122,2,55,1,61,166
1744.658,2,26,832,26,8,69786,8,832,0,0,0,0,0
1790.186,17,173,13494,173,50,10408,50,13494,0,0,0,0,0
1794.203,17,179,11456,179,36,10079,36,11456,0,0,0,0,0
11.84,6,1913,1633200,1153,1363,10,1380,1596635,760,558,15,1923,36565
42.846,17,24,1824,24,48,1862,48,1824,0,0,0,0,0
377.342,6,18,1242,14,180,29026,180,916,4,110,20066,110,326
29.803,17,4,352,2,48,29794,48,152,2,72,29792,72,200
30.495,17,4,352,2,60,30494,60,176,2,60,30494,60,176
0.269,17,3,1008,3,308,134,308,1008,0,0,0,0,0
4.117,6,33,6129,17,206,257,314,2744,16,548,256,1179,3385
0.134,1,2,112,2,28,134,28,112,0,0,0,0,0
115.633,17,4,352,2,60,115632,60,176,2,60,115632,60,176
0.024,17,2,262,1,62,0,62,90,1,144,0,144,172
157.903,17,4,352,2,60,157902,60,176,2,60,157902,60,176
0.311,6,12,3462,6,75,62,75,395,6,1373,62,1448,3067
831.748,1,12,672,12,28,75613,28,672,0,0,0,0,0
0.603,6,343,335388,116,183,5,230,6589,227,1408,1,2816,328799
0.245,17,6,2123,6,325,49,355,2123,0,0,0,0,0
222.048,1,20,1680,20,56,11686,56,1680,0,0,0,0,0
1786.796,6,102,8172,68,63,26668,64,4868,34,57,54142,58,3304
1797.335,17,448,39896,403,35,4470,288,25676,45,288,40021,288,14220
35.917,17,10,760,10,48,3990,48,760,0,0,0,0,0
1361.025,1,81,4536,81,28,17012,28,4536,0,0,0,0,0
96.845,6,36,5496,18,165,5696,722,2090,18,246,5685,2026,3406
1055.835,1,12,1116,12,65,95985,88,1116,0,0,0,0,0
1681.297,17,14,1036,7,30,280212,30,406,7,62,280213,62,630
1.266,17,4,524,2,39,1235,39,134,2,167,1234,167,390
62.381,6,33,8159,15,140,4455,267,1731,18,518,3668,1460,6428
8.2,6,18,6871,9,275,1025,275,643,9,1171,967,1440,6228
11.59,17,8,704,4,48,3859,48,304,4,72,3859,72,400
0.006,17,2,410,1,36,0,36,64,1,318,0,318,346
1799.695,17,449,39928,404,35,4465,288,25708,45,288,40021,288,14220
9.355,6,39,8438,20,345,492,720,1879,19,413,504,1460,6559
6.099,6,45,8425,23,227,277,314,4102,22,491,277,1179,4323
240.305,6,42,8742,21,519,12014,1402,5773,21,233,12014,619,2969
3.0,1,3,168,3,28,1500,28,168,0,0,0,0,0
16.021,17,20,5533,10,303,1776,1350,3310,10,194,1776,1350,2223
0.03,6,3,136,2,0,30,0,88,1,0,0,0,48
1796.668,1,250,14000,250,28,7215,28,14000,0,0,0,0,0
369.389,6,20,1355,15,177,26384,177,977,5,110,15166,110,378
1786.389,6,102,8364,68,66,26662,66,4964,34,60,54130,60,3400
759.565,6,65,14456,35,208,22336,1440,5808,30,370,26185,1440,8648
13.489,6,568,507123,360,1346,37,1368,491323,208,776,64,2736,15800
1682.627,17,14,1036,7,30,280432,30,406,7,62,280431,62,630
1.714,6,25,8761,15,284,122,586,1458,10,985,169,1420,7303
1786.433,17,73,3060,72,14,25161,14,3024,1,8,0,8,36
0.365,6,28,9150,13,261,30,683,1728,15,829,21,1408,7422
280.398,6,29,7392,13,158,23366,267,1317,16,775,18689,4836,6075
1786.265,17,87,3648,86,14,21014,14,3612,1,8,0,8,36
1770.954,6,99,9306,66,66,27245,66,5610,33,60,55339,60,3696
240.192,6,56,19564,30,793,8282,1418,16643,26,195,9607,580,2921
1793.802,17,87,3648,86,14,21103,14,3612,1,8,0,8,36
0.17,1,2,112,2,28,170,28,112,0,0,0,0,0
1783.198,17,83,3480,82,14,22014,14,3444,1,8,0,8,36
1796.917,1,58,4872,58,56,31524,56,4872,0,0,0,0,0
66.759,17,4,352,2,60,66758,60,176,2,60,66757,60,176
0.43,17,8,2758,8,316,61,355,2758,0,0,0,0,0
14.74,6,18,4190,9,273,1842,517,1023,9,1341,1101,1408,3167
0.516,17,15,8005,7,657,85,1350,4796,8,373,69,1350,3209
73.716,6,17,700,8,0,5040,0,324,9,0,9213,0,376
124.845,2,2,64,2,8,124845,8,64,0,0,0,0,0
290.372,6,288,45537,159,304,1837,304,31680,129,83,2261,83,13857
0.402,6,9,872,5,283,100,283,551,4,105,66,105,321
1.328,6,50,19022,27,872,51,1360,13326,23,476,52,2715,5696
7.277,6,1276,1143995,787,1375,9,1408,1113903,489,931,14,2816,30092
1784.637,6,359,22778,210,69,8538,69,12678,149,69,12058,69,10100
1683.484,17,14,1036,7,30,280575,30,406,7,62,280575,62,630
1785.97,17,86,3606,85,14,21261,14,3570,1,8,0,8,36
280.434,6,27,7312,12,158,25494,267,1277,15,775,20028,3465,6035
1740.48,17,30,7050,30,207,60016,207,7050,0,0,0,0,0
1771.463,6,113,10335,71,65,25306,65,6003,42,59,43204,59,4332
1778.331,17,79,3312,78,14,23095,14,3276,1,8,0,8,36
1.78,6,10,2046,6,739,355,1322,1723,4,159,587,159,323
9.559,6,71,20630,37,531,265,1152,15843,34,489,280,1179,4787
1116.276,6,226,16698,130,117,8260,469,10029,96,69,11750,69,6669
316.949,6,93,34007,48,644,6743,1360,23224,45,358,7200,4649,10783
300.572,6,37,8526,20,315,15819,882,2093,17,478,528,2720,6433
7.447,6,1511,1231611,802,1434,8,1448,1181827,709,776,10,1448,49784
1750.568,17,12,498,11,14,175056,14,462,1,8,0,8,36
11.071,6,20,4442,11,275,1107,275,998,9,768,788,1440,3444
0.622,6,5,262,4,31,203,31,222,1,0,0,0,40
0.007,17,2,408,1,46,0,46,74,1,306,0,306,334
1700.497,17,12,498,11,14,170049,14,462,1,8,0,8,36
0.279,6,2,1520,0,0,0,0,0,2,1440,279,1440,1520
2.15,6,36,11572,19,522,119,1360,4484,17,639,113,1360,7088
240.124,6,41,7102,21,194,12006,673,2264,20,421,12637,1408,4838
0.965,6,51,13829,24,551,41,1429,4840,27,464,35,1986,8989
61.845,6,619,286617,327,812,189,1152,269773,292,430,211,1179,16844
1776.838,17,73,3060,72,14,25025,14,3024,1,8,0,8,36
41.468,17,30,5236,15,48,2961,48,1140,15,245,2961,308,4096
368.251,6,645,744541,220,192,1681,919,15512,425,1745,868,8508,729029
1796.717,17,29,9512,29,300,64168,300,9512,0,0,0,0,0
0.52,17,20,3865,20,165,27,220,3865,0,0,0,0,0
7.054,2,2,64,2,8,7054,8,64,0,0,0,0,0
126.062,2,2,64,2,8,126062,8,64,0,0,0,0,0
1789.224,17,85,3561,83,13,21817,14,3481,2,12,1789033,16,80
1775.441,17,140,11200,70,48,25730,48,5320,70,56,25730,56,5880
0.899,6,11,1727,7,100,149,100,384,4,589,211,1152,1343
15.468,17,4,352,2,48,15457,48,152,2,72,15452,72,200
1798.477,6,383,25058,218,75,8287,485,13828,165,74,10964,421,11230
531.952,17,7,845,7,92,88658,355,845,0,0,0,0,0
367.154,6,23,1535,16,177,24476,177,1053,7,110,10392,110,482
368.939,6,23,1535,16,177,24595,177,1053,7,110,10376,110,482
1799.861,6,289,36683,120,140,15123,1360,17194,169,146,10712,2720,19489
1772.385,6,180,15480,120,69,14893,69,8940,60,69,30035,69,6540
373.831,6,20,1355,15,177,26702,177,977,5,110,15169,110,378
5.958,17,3,1008,3,308,2979,308,1008,0,0,0,0,0
280.508,6,28,7352,12,158,25500,267,1277,16,603,18695,1400,6075
0.633,6,14,1745,7,288,77,288,600,7,426,76,434,1145
8.424,6,80,24725,40,560,216,1152,18968,40,461,209,1179,5757
1794.219,17,80,3354,79,14,23002,14,3318,1,8,0,8,36
0.368,6,12,2023,6,288,68,288,548,6,305,40,434,1475
6.661,6,20,9544,8,275,951,275,599,12,846,493,1414,8945
0.116,6,13,2076,7,329,19,500,1030,6,363,23,500,1046
41.803,17,12,912,12,48,3800,48,912,0,0,0,0,0
1659.8,1,8,448,8,28,237114,28,448,0,0,0,0,0
1783.87,6,102,8364,68,66,26624,66,4964,34,60,54053,60,3400
0.481,17,29,20688,17,1020,30,1350,17820,12,211,39,1350,2868
367.0,6,23,1535,16,177,24466,177,1053,7,110,10381,110,482
1769.55,6,103,9448,66,65,27223,65,5577,37,59,49150,59,3871
1794.627,6,244,35804,152,302,11884,302,26032,92,83,19720,83,9772
44.559,6,255,215127,155,1335,287,1368,204422,100,668,448,1368,10705
0.068,17,2,304,1,60,0,60,88,1,188,0,188,216
26.707,6,48,13162,23,176,1213,721,2686,25,728,1105,1440,10476
25.06,6,9,5418,4,106,8353,106,274,5,1645,6124,4837,5144
0.056,17,4,1375,4,315,18,354,1375,0,0,0,0,0
0.053,6,9,1002,5,213,13,213,417,4,421,13,421,585
0.131,17,2,268,1,54,0,54,82,1,158,0,158,186
1795.728,17,386,49304,178,177,10145,1350,36647,208,32,8674,61,12657
0.078,17,4,352,2,37,72,37,130,2,83,71,89,222
1.12,17,22,11085,11,726,107,1350,8296,11,225,107,1350,2789
1772.941,6,107,8633,69,52,26072,205,5328,38,36,47907,98,3305
244.85,17,4,352,2,60,244848,60,176,2,60,244849,60,176
58.092,6,28,7223,13,156,4841,267,1312,15,482,4148,1997,5911
1777.986,17,142,11360,71,48,25399,48,5396,71,56,25399,56,5964
1793.915,17,144,11520,72,48,25266,48,5472,72,56,25266,56,6048
0.736,6,21,7290,13,335,57,668,2026,8,1210,99,1946,5264
288.231,2,4,128,4,8,96077,8,128,0,0,0,0,0
30.627,6,360,275571,196,1336,157,1368,261369,164,899,186,1473,14202
0.259,6,23,6012,12,181,23,537,1526,11,781,25,2224,4486
95.234,6,900,441811,484,848,197,1152,418984,416,412,228,1179,22827
0.5,17,3,543,2,39,443,39,134,1,381,0,381,409
2.175,6,20,3833,11,234,217,564,1504,9,463,247,1343,2329
1797.016,17,448,39896,403,35,4470,288,25676,45,288,40019,288,14220
12.295,6,9,376,5,0,3071,0,204,4,0,4093,0,172
1787.396,6,104,8376,68,65,26677,65,4930,36,59,51064,59,3446
1771.155,1,126,7056,126,28,14169,28,7056,0,0,0,0,0
1770.957,6,103,9448,66,65,27245,65,5577,37,59,49190,59,3871
314.943,6,7,763,7,69,52490,69,763,0,0,0,0,0
33.253,17,18,1584,9,48,4155,48,684,9,72,4155,72,900
76.912,6,21,9550,11,351,88,746,1527,10,1522,8531,3989,8023
0.09,17,2,245,1,32,0,32,60,1,157,0,157,185
1772.005,6,180,15480,120,69,14890,69,8940,60,69,30031,69,6540
240.232,6,58,20332,32,827,7749,1402,17392,26,197,9609,580,2940
0.092,6,2,104,1,0,0,0,52,1,0,0,0,52
1773.631,6,186,16134,120,69,14904,69,8940,66,69,27284,69,7194
10.767,6,19,4402,10,275,1196,275,958,9,768,746,1440,3444
1744.59,2,30,960,30,8,60158,8,960,0,0,0,0,0
78.5,6,41,10934,12,123,7135,267,1473,29,331,2803,1420,9461
1796.723,17,449,39928,404,35,4458,288,25708,45,288,40015,288,14220
0.426,1,10,840,10,56,47,56,840,0,0,0,0,0
0.308,6,25,6116,12,181,28,537,1526,13,651,25,2194,4590
0.081,6,12,3705,6,171,13,171,491,6,964,15,1448,3214
12.63,6,25,8473,13,275,1052,275,1078,12,986,1068,1440,7395
5.055,17,3,257,2,37,5006,37,130,1,99,0,99,127
0.181,6,2,92,1,0,0,0,52,1,0,0,0,40
3.004,6,14,1756,7,503,500,503,895,7,473,500,473,861
1.344,6,48,19480,27,910,51,1360,13864,21,476,57,2720,5616
14.365,6,61,23981,34,1167,435,1460,17777,27,300,543,1460,6204
69.09,6,28,7223,13,156,5757,267,1312,15,482,4934,2840,5911
1650.06,1,8,448,8,28,235722,28,448,0,0,0,0,0
1771.49,6,105,9759,68,65,26440,65,5758,37,59,49204,59,4001
1795.331,17,80,3354,79,14,23017,14,3318,1,8,0,8,36
0.114,6,15,3958,10,75,12,75,603,5,1543,28,1587,3355
1794.783,6,125,14294,80,79,22718,517,6226,45,152,40706,1420,8068
34.301,17,20,1520,20,48,1805,48,1520,0,0,0,0,0
0.883,6,25,9105,13,290,73,802,1713,12,985,65,1360,7392
14.238,6,41,9133,22,181,678,267,1604,19,483,788,1400,7529
0.241,17,2,178,1,29,0,29,57,1,93,0,93,121
234.462,6,30,7432,13,158,19538,267,1317,17,543,14648,1300,6115
0.017,17,2,152,1,48,0,48,76,1,48,0,48,76
21.453,17,2,642,1,300,0,300,328,1,286,0,286,314
1777.647,1,158,8848,158,28,11322,28,8848,0,0,0,0,0
81.305,2,2,64,2,8,81305,8,64,0,0,0,0,0
1.054,6,24,8004,12,164,81,267,1288,12,1014,81,2804,6716
0.166,17,2,2756,2,1350,166,1350,2756,0,0,0,0,0
282.253,6,28,7352,12,158,25659,267,1277,16,603,18813,1400,6075
0.43,6,97,85999,54,131,8,232,2689,43,2205,10,5680,83310
273.313,6,23,7014,11,181,27331,267,1168,12,766,24843,2800,5846
1772.246,6,180,15480,120,69,14892,69,8940,60,69,30037,69,6540
1741.28,17,30,7050,30,207,60044,207,7050,0,0,0,0,0
1783.893,6,375,26508,216,104,8297,469,15732,159,69,11290,69,10776
31.822,6,26,10133,10,138,3535,267,963,16,852,2120,4837,9170
0.348,6,12,1653,6,288,64,288,548,6,426,38,434,1105
1798.364,1,238,13328,238,28,7588,28,13328,0,0,0,0,0
1729.195,6,62,4504,40,33,44338,33,2740,22,31,82332,31,1764
0.004,17,2,408,1,62,0,62,90,1,290,0,290,318
0.256,6,35,8497,18,277,15,517,1863,17,540,15,1883,6634
1746.641,6,145,8957,78,45,22683,208,5347,67,31,26457,31,3610
1791.702,6,284,36187,114,146,15854,1460,17148,170,140,10601,1642,19039
280.238,6,30,7432,13,158,23353,267,1317,17,543,17513,1300,6115
1787.429,6,102,8228,68,64,26678,64,4896,34,58,54161,58,3332
1739.522,6,87,6322,58,31,30517,31,3915,29,31,62124,31,2407
1798.264,6,363,24483,212,87,8522,469,14096,151,69,11986,69,10387
1785.154,17,75,3149,73,14,24793,15,3067,2,13,848258,18,82
0.524,6,20,7229,13,334,43,663,2021,7,1209,80,1946,5208
1799.912,1,57,4788,57,56,32141,56,4788,0,0,0,0,0
0.009,17,2,231,1,55,0,55,83,1,120,0,120,148
58.122,17,4,352,2,60,58121,60,176,2,60,58121,60,176
1750.016,17,13,534,11,14,174981,14,462,2,8,1749793,8,72
1.924,17,2,312,2,128,1924,128,312,0,0,0,0,0
1795.344,17,448,39896,403,35,4466,288,25676,45,288,40020,288,14220
19.651,6,3015,2780772,1922,1367,10,1408,2719272,1093,931,17,2816,61500
1.405,6,24,8004,12,164,108,267,1288,12,1014,108,2491,6716
0.171,1,2,163,2,53,171,78,163,0,0,0,0,0
61.923,6,604,271867,314,808,197,1152,255119,290,428,213,1179,16748
5.011,17,4,542,2,36,5000,36,128,2,179,5001,187,414
41.817,17,8,2688,8,308,5973,308,2688,0,0,0,0,0
1.605,17,20,5190,20,231,84,389,5190,0,0,0,0,0
1699.424,17,12,498,11,14,169942,14,462,1,8,0,8,36
1786.618,6,104,8376,68,65,26665,65,4930,36,59,51043,59,3446
1795.584,17,448,39896,403,35,4466,288,25676,45,288,40015,288,14220
0.012,6,2,288,1,196,0,196,248,1,0,0,0,40
259.574,6,32,9021,14,158,19967,267,1357,18,630,15253,1781,7664
11.164,6,1761,1542195,1068,1389,10,1420,1510254,693,467,16,1883,31941
1.979,6,27,8849,16,286,131,590,1502,11,862,178,1380,7347
9.549,6,22,6308,11,295,954,584,1763,11,1317,939,2433,4545
2.55,17,4,1556,4,361,850,361,1556,0,0,0,0,0
280.381,6,30,7432,13,158,23365,267,1317,17,543,17518,1300,6115
0.562,6,2,80,1,0,0,0,40,1,0,0,0,40
9.729,6,15,2294,9,210,1216,210,896,6,545,1945,904,1398
316.948,6,105,34487,56,559,5762,1360,23544,49,345,6600,4080,10943
125.978,6,27,9420,13,542,108,1287,2190,14,739,9675,1791,7230
240.181,6,53,17995,28,797,8895,1402,15013,25,209,10007,580,2982
1786.866,6,102,8296,68,65,26669,65,4930,34,59,54144,59,3366
24.179,6,16,6160,4,190,5096,190,370,12,1059,2180,3488,5790
60.823,6,15,1657,9,177,7602,177,1007,6,110,12124,110,650
1798.626,17,140,11192,71,48,25694,48,5396,69,56,26450,56,5796
0.548,6,22,7345,13,334,45,663,2021,9,1209,62,1946,5324
11.966,6,29,9544,13,487,997,721,3447,16,605,749,1440,6097
307.713,6,34,8070,12,158,25468,267,1277,22,393,14652,3436,6793
0.064,6,9,1346,5,145,16,145,349,4,833,15,833,997
3.2,1,7,588,7,56,533,56,588,0,0,0,0,0
280.195,6,29,7392,13,158,23349,267,1317,16,603,18676,2800,6075
7.773,6,15,4050,9,275,971,275,918,6,1440,1182,1440,3132
1.377,6,121,75266,64,1320,21,1432,68605,57,396,24,1871,6661
152.239,6,22,8752,11,314,70,634,1415,11,983,15209,1360,7337
376.614,6,589,479581,345,1384,1094,1460,463676,244,278,67,2567,15905
171.322,6,21,2557,12,324,15574,585,1281,9,396,21410,580,1276
1743.778,6,103,8022,65,45,27246,205,4850,38,35,47122,98,3172
0.664,6,38,11972,22,619,31,1188,7954,16,353,38,758,4018
9.082,6,15,3756,4,92,3027,92,296,11,320,891,1408,3460
0.25,6,24,7660,12,176,22,334,1339,12,948,20,1438,6321
0.054,17,2,142,1,35,0,35,63,1,51,0,51,79
9.894,6,16,1113,8,222,1411,222,546,8,231,1411,231,567
229.76,17,4,240,2,32,229759,32,120,2,32,229759,32,120
1.323,6,30,6427,15,164,94,267,1922,15,650,83,1452,4505
0.015,6,9,1560,5,514,3,514,782,4,562,4,562,778
1797.192,17,448,39896,403,35,4470,288,25676,45,288,40022,288,14220
38.702,17,4,352,2,60,38701,60,176,2,60,38701,60,176
8.651,6,1427,1300681,896,1374,9,1408,1268405,531,931,15,2816,32276
0.201,6,46,20388,26,1021,8,1420,15367,20,467,10,1883,5021
5.33,17,3,208,2,36,5005,36,128,1,52,0,52,80
1798.215,6,366,23196,212,69,8522,69,12896,154,69,11752,69,10300
28.387,6,44,8688,21,319,735,643,1890,23,366,1283,2720,6798
4.836,17,4,352,2,48,4823,48,152,2,72,4822,72,200
1.649,17,16,7486,7,527,269,1350,3890,9,371,202,1350,3596
2.924,6,7,400,3,0,1462,0,160,4,0,906,0,240
1.398,17,31,14593,13,411,116,1350,5708,18,465,69,1350,8885
6.994,6,41,7349,21,218,349,314,3463,20,513,353,1179,3886
1.311,6,56,17842,27,767,50,1440,8773,29,438,46,1440,9069
9.068,6,1276,1135941,776,1410,11,1432,1110366,500,475,18,1871,25575
240.552,6,40,8944,19,510,13363,1418,5586,21,282,12027,624,3358
22.801,6,14,5061,5,170,5700,170,450,9,1029,2847,1448,4611
1797.883,1,270,15120,270,28,6683,28,15120,0,0,0,0,0
281.123,6,28,7352,13,158,23426,267,1317,15,678,20078,1400,6035
0.28,17,2,384,1,39,0,39,67,1,289,0,289,317
1796.67,17,448,39896,403,35,4469,288,25676,45,288,40021,288,14220
5.978,17,41,16311,21,474,297,1350,10548,20,260,312,1350,5763
1770.06,6,102,9779,68,70,26418,234,5948,34,60,53635,83,3831
1786.813,6,105,8481,69,65,26276,65,5035,36,59,51048,59,3446
1777.129,17,136,10880,68,48,26524,48,5168,68,56,26524,56,5712
1793.103,17,86,3606,85,14,21346,14,3570,1,8,0,8,36
1777.012,1,130,7280,130,28,13775,28,7280,0,0,0,0,0
1755.752,6,135,8672,75,50,23726,208,5311,60,31,29711,31,3361
1.267,6,25,8056,12,164,98,267,1288,13,869,90,1448,6768
0.497,17,2,384,1,39,0,39,67,1,289,0,289,317
0.513,6,23,6395,13,310,42,889,2075,10,979,56,1731,4320
0.166,17,2,178,1,29,0,29,57,1,93,0,93,121
240.863,6,59,15521,29,671,8602,1418,11619,30,232,8305,702,3902
86.299,6,737,352829,399,818,216,1152,334518,338,435,255,1179,18311
0.231,17,4,588,2,48,142,48,152,2,190,147,308,436
1790.669,17,118,9440,59,48,30873,48,4484,59,56,30873,56,4956
1787.486,6,110,8746,70,65,25905,65,5140,40,59,45783,59,3606
0.217,2,2,64,2,8,217,8,64,0,0,0,0,0
127.499,6,35,7843,13,156,32,267,1312,22,331,6071,1420,6531
3.606,6,21,6369,10,268,395,517,1333,11,744,356,1418,5036
1786.202,6,356,22520,208,69,8628,69,12460,148,69,12150,69,10060
137.507,6,235,187443,147,1303,941,1408,171948,88,642,1578,2439,15495
385.734,6,55,8700,24,140,12591,502,2086,31,206,12855,1420,6614
1792.033,6,356,22520,208,69,8657,69,12460,148,69,12190,69,10060
0.013,17,2,602,1,46,0,46,74,1,500,0,500,528
12.843,6,24,6993,13,275,1070,275,1078,11,910,783,1420,5915
1.939,1,3,252,3,56,969,56,252,0,0,0,0,0
1734.341,17,317,53696,317,141,5488,357,53696,0,0,0,0,0
255.866,17,4,240,2,32,255865,32,120,2,32,255865,32,120
0.504,6,12,1653,6,288,94,288,548,6,426,60,434,1105
882.655,2,10,320,10,8,98072,8,320,0,0,0,0,0
1740.456,17,30,31170,30,1011,60015,1011,31170,0,0,0,0,0
7.871,6,1268,1090886,761,1384,10,1420,1066385,507,420,15,1420,24501
0.107,6,12,3704,6,171,21,171,491,6,964,21,1448,3213
5.608,6,40,7309,21,218,280,314,3463,19,513,288,1179,3846
240.197,6,54,17813,29,792,8578,1408,14988,25,189,10008,580,2825
1772.114,6,180,15480,120,69,14891,69,8940,60,69,30034,69,6540
300.224,6,26,8060,15,385,21444,986,2342,11,734,6120,2899,5718
184.693,6,76,48768,45,1189,4197,1408,40422,31,747,2053,1408,8346
10.822,17,15,17718,15,1153,773,1452,17718,0,0,0,0,0
1.779,17,2,136,1,32,0,32,60,1,48,0,48,76
0.371,6,489,396099,236,183,1,230,12877,253,1474,1,4320,383222
0.872,6,27,5927,13,156,72,267,1462,14,650,61,1420,4465
0.007,6,2,104,2,0,0,0,104,0,0,0,0,0
0.095,6,162,139387,92,141,1,420,5774,70,2030,1,6900,133613
239.148,17,4,352,2,60,239146,60,176,2,60,239147,60,176
16.308,6,40,9546,21,450,815,766,2673,19,435,609,2128,6873
17.028,6,8,332,5,0,4255,0,204,3,0,8509,0,128
1775.687,17,140,11200,70,48,25734,48,5320,70,56,25734,56,5880
0.071,6,2,111,1,0,0,0,40,1,31,0,31,71
1747.518,6,97,7307,63,38,28185,205,4476,34,33,52948,98,2831
272.612,1,4,224,4,28,90870,28,224,0,0,0,0,0
252.095,2,3,96,3,8,126047,8,96,0,0,0,0,0
43.549,6,15,1149,7,105,7258,105,498,8,79,6218,85,651
280.006,6,27,7312,13,158,23333,267,1317,14,775,21538,4200,5995
0.317,6,20,7229,12,334,28,663,1969,8,1209,44,1906,5260
5.665,6,40,7309,21,218,283,314,3463,19,513,301,1179,3846
5.627,6,39,7269,20,218,296,314,3423,19,513,299,1179,3846
0.838,6,3,202,1,0,0,0,40,2,41,10,51,162
89.862,6,21,10120,11,433,80,990,1771,10,1322,9968,2720,8349
11.057,6,88,26173,47,550,240,1152,20051,41,447,270,1179,6122
170.911,17,4,240,2,32,170910,32,120,2,32,170910,32,120
15.943,6,22,6456,9,154,1992,267,832,13,566,1317,1420,5624
233.917,2,3,96,3,8,116958,8,96,0,0,0,0,0
1791.64,6,99,7650,65,40,27994,205,4678,34,35,54283,108,2972
1792.959,17,142,11352,72,48,25252,48,5472,70,56,25617,56,5880
0.23,17,2,152,1,48,0,48,76,1,48,0,48,76
1796.234,1,342,28728,342,56,5267,56,28728,0,0,0,0,0
1.124,6,24,8004,12,164,102,267,1288,12,869,79,1408,6716
1796.942,17,459,40652,405,35,4447,288,25784,54,247,33474,288,14868
104.642,6,30,8201,12,241,697,721,1691,18,482,6144,2840,6510
1684.594,1,66,3696,66,28,25916,28,3696,0,0,0,0,0
0.395,6,27,9107,13,263,32,691,1736,14,829,29,1448,7371
5.046,17,4,288,2,36,5000,36,128,2,52,5015,52,160
16.32,6,2058,1906912,1282,1407,12,1448,1860696,776,776,20,1448,46216
0.184,6,27,7296,13,155,15,267,1301,14,603,13,1400,5995
2.586,17,23,7834,9,272,323,1350,2706,14,338,124,1350,5128
2.066,1,2,112,2,28,2066,28,112,0,0,0,0,0
280.468,6,30,7432,13,158,23372,267,1317,17,603,17523,2076,6115
0.001,6,2,1460,1,0,0,0,40,1,1368,0,1368,1420
289.075,1,4,326,4,53,96358,78,326,0,0,0,0,0
1748.469,6,97,7307,63,38,28201,205,4476,34,33,52975,98,2831
64.113,6,22,9783,12,410,55,922,1742,10,1271,7108,4416,8041
1791.321,6,356,22520,208,69,8653,69,12460,148,69,12185,69,10060
241.212,6,37,4263,17,193,15075,585,1700,20,216,12695,580,2563
189.29,17,4,352,2,60,189289,60,176,2,60,189289,60,176
5.042,6,43,8345,21,227,252,314,4022,22,491,227,1179,4323
1797.022,1,109,6104,109,28,16639,28,6104,0,0,0,0,0
0.014,17,2,367,1,47,0,47,75,1,264,0,264,292
3.217,6,36,15767,18,583,189,1360,4253,18,979,179,1815,11514
1644.829,1,26,1456,26,28,65793,28,1456,0,0,0,0,0
355.405,17,236,82933,118,569,3037,1350,70541,118,77,3037,1350,12392
301.111,6,16,1208,8,226,42991,226,686,8,110,42990,110,522
104.087,6,31,15376,14,634,66,1460,3129,17,1050,6497,1460,12247
1773.632,17,325,68173,325,181,5474,422,68173,0,0,0,0,0
9.665,6,40,19366,26,122,386,186,2704,14,1447,742,3649,16662
3.596,17,3,228,2,48,3049,48,152,1,48,0,48,76
1786.275,17,87,3648,86,14,21015,14,3612,1,8,0,8,36
0.005,17,2,144,1,36,0,36,64,1,52,0,52,80
0.004,17,4,352,2,60,0,60,176,2,60,3,60,176
12.125,6,1917,1663699,1165,1372,10,1420,1629398,752,467,16,1883,34301
1782.279,17,86,3606,85,14,21217,14,3570,1,8,0,8,36
1776.034,1,56,4704,0,0,0,0,0,56,56,32291,56,4704
0.004,17,2,440,1,34,0,34,62,1,350,0,350,378
0.046,17,2,307,1,33,0,33,61,1,218,0,218,246
1.059,17,8,568,4,32,349,32,240,4,54,348,60,328
3.17,6,11,467,6,0,634,0,248,5,7,742,7,219
1792.398,1,59,4956,59,56,30903,56,4956,0,0,0,0,0
1.625,6,49,19262,29,885,58,1360,13641,20,437,73,2715,5621
0.004,6,5,5832,1,0,0,0,40,4,1396,0,1396,5792
1.11,6,24,8004,12,164,85,267,1288,12,1014,85,2423,6716
0.611,17,2,384,1,39,0,39,67,1,289,0,289,317
1798.963,1,110,6160,110,28,16504,28,6160,0,0,0,0,0
81.246,6,20,820,9,0,6092,0,364,11,0,8123,0,456
351.209,6,1422,1165289,810,1435,434,1460,1130372,612,176,96,2567,34917
0.293,17,2,586,1,46,0,46,74,1,484,0,484,512
1796.999,6,173,17623,90,75,20191,722,7155,83,140,21909,2760,10468
202.024,6,26612,22796662,12056,778,16,1396,660028,14556,1471,13,6980,22136634
3.653,17,10,1415,5,31,912,31,295,5,196,912,196,1120
1.948,17,2,672,2,308,1948,308,672,0,0,0,0,0
0.09,6,9,1348,5,145,22,145,349,4,835,27,835,999
0.406,6,9,1340,5,145,101,145,349,4,827,86,827,991
57.878,6,10,7447,3,100,127,100,224,7,1156,9605,1179,7223
444.551,6,98,6266,54,73,8387,138,3402,44,69,10338,69,2864
0.173,6,35,19157,17,173,10,319,1584,18,1279,9,1588,17573
1789.45,6,356,22520,208,69,8644,69,12460,148,69,12172,69,10060
1787.286,6,374,26468,216,104,8312,469,15732,158,69,11383,69,10736
0.616,6,413,395240,195,201,3,230,13341,218,1723,2,5608,381899
97.829,6,42,8549,21,345,792,721,1956,21,521,4883,3488,6593
300.814,6,35,15931,16,195,20054,431,1620,19,832,9002,2804,14311
3.497,6,2,88,2,0,0,0,88,0,0,0,0,0
104.636,17,3,1008,3,308,52318,308,1008,0,0,0,0,0
1.476,6,41,11378,22,547,70,1360,5842,19,433,70,1360,5536
1.941,6,13,2311,8,188,277,245,700,5,1407,423,1407,1611
280.463,17,4,296,2,30,280428,30,116,2,62,280390,62,180
1781.801,6,359,22709,209,69,8566,69,12569,150,69,11958,69,10140
1748.735,6,184,11274,93,47,19007,208,6735,91,31,19427,31,4539
5.408,6,38,7245,20,218,284,314,3423,18,516,302,1179,3822
1.315,17,18,12958,11,926,131,1350,10502,7,322,128,1350,2456
91.134,6,39,25701,20,884,42,1360,6185,19,1562,5054,8160,19516
376.014,6,18,1242,14,180,28924,180,916,4,110,20073,110,326
1771.084,6,100,9292,66,65,27247,65,5577,34,59,53666,59,3715
1752.264,6,168,10302,86,46,20614,208,6092,82,31,21629,31,4210
0.454,6,4,227,2,0,454,0,92,2,31,0,31,135
3.546,6,35,6209,18,206,208,314,2784,17,456,205,1152,3425
340.486,6,1432,1278368,911,1430,374,1460,1246928,521,167,92,1460,31440
77.849,6,14,1080,4,226,123,226,442,10,110,8630,110,638
1789.45,17,199,46980,199,208,9037,422,46980,0,0,0,0,0
0.485,6,47,21629,28,1032,17,1380,16639,19,421,25,1923,4990
1773.169,6,180,15480,120,69,14900,69,8940,60,69,30050,69,6540
1779.555,17,142,11360,71,48,25422,48,5396,71,56,25422,56,5964
95.067,17,8,704,4,48,31686,48,304,4,72,31686,72,400
56.073,6,17,5750,10,272,6230,516,1220,7,849,128,1452,4530
1.175,6,24,8004,12,164,91,267,1288,12,1014,91,2804,6716
214.661,6,281,44947,155,304,1393,304,31412,126,83,1713,83,13535
1740.02,1,15,840,15,28,124287,28,840,0,0,0,0,0
33.712,6,36,6110,17,225,2107,722,2698,19,267,1863,1408,3412
5.218,17,5,320,5,36,1304,36,320,0,0,0,0,0
271.282,17,4,240,2,32,271281,32,120,2,32,271281,32,120
0.3,17,8,2750,8,315,42,354,2750,0,0,0,0,0
20.42,17,22,8553,10,378,2265,1350,4069,12,345,1853,1350,4484
0.968,6,22,5675,13,158,79,370,1315,9,999,119,1737,4360
0.571,6,10,1327,5,299,105,299,567,5,246,97,459,760
1128.012,6,17,1455,17,45,70500,62,1455,0,0,0,0,0
1764.373,1,56,4704,56,56,32079,56,4704,0,0,0,0,0
61.674,6,24,1759,18,43,3627,43,1399,6,0,6201,0,360
282.91,6,28,7352,13,158,23575,267,1317,15,678,20205,2800,6035
225.801,6,31,7472,14,158,17369,267,1357,17,543,14109,1400,6115
49.421,6,8,432,5,0,12355,0,268,3,0,24703,0,164
268.554,1,3,180,3,32,134277,32,180,0,0,0,0,0
1784.748,17,142,11360,71,48,25495,48,5396,71,56,25496,56,5964
300.244,6,44,29493,28,190,11120,444,2333,16,2392,16012,9856,27160
71.098,6,18,1299,9,177,8887,177,713,9,110,8861,110,586
1769.907,6,218,43496,122,407,14627,811,31189,96,119,18629,192,12307
299.564,6,6,364,4,31,99854,31,222,2,31,299544,31,142
0.014,6,13,2027,7,329,2,500,1030,6,338,2,500,997
1787.736,6,294,36733,122,138,14773,1460,17614,172,140,10453,1642,19119
0.017,17,2,251,1,31,0,31,59,1,164,0,164,192
1.737,6,14,2351,8,188,248,245,700,6,703,295,1152,1651
1759.156,1,40,2240,40,28,45106,28,2240,0,0,0,0,0
1.179,6,27,9624,13,164,83,267,1396,14,936,77,1408,8228
4.706,17,5,320,5,36,1176,36,320,0,0,0,0,0
280.33,6,30,7432,13,158,23360,267,1317,17,543,17514,1400,6115
0.286,17,2,152,1,48,0,48,76,1,48,0,48,76
300.764,6,32,8195,18,204,17692,467,1808,14,706,5367,1408,6387
0.137,1,6,624,0,0,0,0,0,6,76,27,76,624
1789.954,6,359,22847,211,69,8523,69,12787,148,69,12176,69,10060
0.505,6,12,1653,6,288,94,288,548,6,426,58,434,1105
1799.24,1,73,6132,73,56,24989,56,6132,0,0,0,0,0
210.763,6,2038,1040187,1147,839,183,1152,993570,891,378,236,1179,46617
1777.852,17,73,3060,72,14,25040,14,3024,1,8,0,8,36
0.376,17,2,154,1,33,0,33,61,1,65,0,65,93
1440.181,17,360,31968,324,35,4458,288,20592,36,288,40024,288,11376
2.595,17,2,1439,2,691,2595,696,1439,0,0,0,0,0
1795.547,1,260,14560,260,28,6932,28,14560,0,0,0,0,0
1.031,17,4,454,3,32,509,32,180,1,246,0,246,274
1795.039,17,139,31728,139,200,13007,422,31728,0,0,0,0,0
0.374,6,11,1008,6,256,73,256,500,5,304,91,304,508
1744.897,6,95,7203,63,38,28143,205,4476,32,33,56275,98,2727
1.909,17,3,468,3,128,954,128,468,0,0,0,0,0
0.5,6,20,7229,13,334,41,663,2021,7,1209,73,1946,5208
1786.61,6,102,8296,68,65,26665,65,4930,34,59,54136,59,3366
4.355,17,4,1354,2,300,3354,300,656,2,321,3360,321,698
1740.03,6,90,6521,59,31,30000,31,3998,31,31,58000,31,2523
1776.293,6,206,35975,129,304,13877,304,26516,77,83,23372,83,9459
104.261,6,30,7432,13,158,8688,267,1317,17,543,6512,1400,6115
215.731,1,15,420,15,0,0,0,420,0,0,0,0,0
1799.191,17,448,39896,403,35,4475,288,25676,45,288,40018,288,14220
3.712,6,15,3195,9,49,464,92,563,6,579,44,1448,2632
1772.162,6,180,15480,120,69,14892,69,8940,60,69,30036,69,6540
1799.983,17,4100,196800,2051,20,878,20,98448,2049,20,878,20,98352
1768.455,6,85,4964,42,31,43131,36,2246,43,241,42104,456,2718
1.357,6,48,20117,27,956,52,1460,14501,21,433,56,1460,5616
1764.549,2,14,448,14,8,135734,8,448,0,0,0,0,0
5.584,6,40,7325,20,218,293,314,3423,20,442,280,1152,3902
1764.58,2,15,480,15,8,126041,8,480,0,0,0,0,0
370.893,6,18,1242,14,180,28530,180,916,4,110,20064,110,326
1589.493,6,315,19983,183,69,8733,69,11046,132,69,12133,69,8937
0.03,17,2,154,1,41,0,41,69,1,57,0,57,85
1795.395,1,113,6328,113,28,16030,28,6328,0,0,0,0,0
0.472,17,2,154,1,33,0,33,61,1,65,0,65,93
7.374,6,6,336,2,0,7374,0,112,4,0,2401,0,224
18.367,17,4,240,2,32,18366,32,120,2,32,18366,32,120
20.153,6,17,2316,10,189,2239,517,1298,7,323,3356,499,1018
0.834,6,29,9185,14,252,64,647,1744,15,831,58,1408,7441
280.524,6,26,7272,12,158,25502,267,1277,14,775,21569,3465,5995
1786.837,6,106,8515,69,65,26277,65,4970,37,59,49631,59,3545
280.327,6,28,7352,12,158,25484,267,1277,16,603,18683,1400,6075
63.763,6,13,1079,12,43,5796,43,1019,1,0,0,0,60
901.52,6,97,8434,61,71,15025,138,4648,36,69,25757,69,3786
11.209,6,96,30945,50,579,228,1152,24623,46,407,243,1152,6322
351.772,6,26,7310,11,118,35175,267,1276,15,904,25125,1452,6034
1782.287,1,59,4956,59,56,30729,56,4956,0,0,0,0,0
6.163,17,4,304,2,48,6152,48,152,2,48,6151,48,152
64.157,1,4,336,4,56,21385,56,336,0,0,0,0,0
4.917,17,3,3210,3,1042,2458,1066,3210,0,0,0,0,0
1.667,6,13,2311,8,188,238,245,700,5,1407,354,1407,1611
13.431,6,24,6993,13,275,1119,275,1078,11,910,840,1440,5915
11.398,6,1842,1585447,1120,1363,10,1380,1549022,722,683,15,3303,36425
1799.04,1,58,4872,0,0,0,0,0,58,56,31562,56,4872
1787.284,6,102,8296,68,65,26675,65,4930,34,59,54156,59,3366
0.073,17,2,334,1,32,0,32,60,1,246,0,246,274
1.365,6,41,8455,21,321,68,1164,2834,20,400,62,1360,5621
0.415,6,13,1693,7,288,63,288,588,6,426,47,434,1105
2.162,6,25,5795,14,158,165,370,1355,11,799,215,1420,4440
803.142,17,160,12160,160,48,5051,48,12160,0,0,0,0,0
1.453,6,39,8292,19,320,80,1162,2716,20,433,66,1440,5576
15.291,17,26,17142,14,845,1173,1350,12235,12,380,1387,1350,4907
1776.991,17,73,3060,72,14,25028,14,3024,1,8,0,8,36
0.971,6,26,9002,14,208,74,475,1426,12,1180,72,2720,7576
31.15,6,4393,4142096,2861,1369,10,1408,4057768,1532,931,20,2801,84328
247.346,6,123,89067,75,1263,3342,1408,78449,48,811,1654,3847,10618
297.98,6,7,435,4,31,99326,31,222,3,31,148923,31,213
77.306,17,4,352,2,60,77304,60,176,2,60,77305,60,176
7.29,17,4,352,2,60,7289,60,176,2,60,7289,60,176
1771.238,6,105,9700,68,65,26436,65,5758,37,59,49198,59,3942
1729.214,6,67,4885,42,33,42175,33,2910,25,31,72041,31,1975
281.374,6,32,7516,14,158,21644,267,1357,18,543,16546,1400,6159
105.198,6,33,16938,17,634,77,1360,3261,16,1184,7002,1360,13677
518.246,17,42,3360,21,48,25911,48,1596,21,56,25912,56,1764
252.022,2,3,96,3,8,126011,8,96,0,0,0,0,0
1772.748,6,180,15480,120,69,14897,69,8940,60,69,30042,69,6540
3.548,6,8,427,4,0,1182,0,204,4,7,1111,7,223
1787.188,6,102,8364,68,66,26674,66,4964,34,60,54151,60,3400
0.234,6,10,1669,6,551,46,947,1346,4,159,78,159,323
1779.693,1,342,28728,342,56,5219,56,28728,0,0,0,0,0
0.007,17,2,322,1,36,0,36,64,1,230,0,230,258
1795.625,17,448,39896,403,35,4466,288,25676,45,288,40018,288,14220
414.812,1,6,336,6,28,82962,28,336,0,0,0,0,0
4.727,1,7,3548,7,478,787,548,3548,0,0,0,0,0
360.988,2,4,128,4,8,120329,8,128,0,0,0,0,0
252.024,2,2,64,2,8,252024,8,64,0,0,0,0,0
268.746,6,32,8952,14,158,20672,267,1357,18,624,15806,1400,7595
0.249,6,26,7256,13,155,20,267,1301,13,678,19,3436,5955
1781.304,17,248,50478,248,175,7211,377,50478,0,0,0,0,0
1787.19,6,102,8296,68,65,26674,65,4930,34,59,54153,59,3366
1764.909,2,14,448,14,8,135762,8,448,0,0,0,0,0
1436.383,6,286,18133,166,69,8705,69,10021,120,69,12070,69,8112
0.001,6,3,192,3,0,0,0,192,0,0,0,0,0
0.067,6,2,84,1,0,0,0,44,1,0,0,0,40
94.37,6,79,51258,45,1186,2144,1368,42690,34,679,2853,2519,8568
1751.97,1,8,448,8,28,250281,28,448,0,0,0,0,0
1.642,6,20,3157,10,324,182,585,1201,10,285,181,580,1956
234.786,17,4,1344,4,308,78262,308,1344,0,0,0,0,0
0.614,6,28,9101,14,205,47,633,1761,14,941,43,1368,7340
0.898,6,11,1727,7,100,149,100,384,4,589,212,1152,1343
0.28,6,28,9124,13,247,23,624,1672,15,833,19,1408,7452
9.046,17,4,240,2,32,9045,32,120,2,32,9045,32,120
13.511,6,33,9210,19,158,750,489,1743,14,861,188,4662,7467
0.062,17,2,373,1,34,0,34,62,1,283,0,283,311
0.007,6,2,100,1,0,0,0,60,1,0,0,0,40
63.078,6,51,10442,23,533,1064,910,3147,28,362,2331,1460,7295
1.419,6,38,8254,19,321,78,1164,2718,19,433,68,1360,5536
1719.558,17,12,498,11,14,171955,14,462,1,8,0,8,36
280.188,6,28,7352,12,158,25471,267,1277,16,603,18678,1400,6075
4.794,6,40,7325,20,218,252,314,3423,20,516,238,1179,3902
0.196,6,20,4960,10,137,21,267,1092,10,692,21,1467,3868
1770.882,6,99,9306,66,66,27244,66,5610,33,60,55337,60,3696
0.138,17,2,158,1,34,0,34,62,1,68,0,68,96
5.661,17,2,2200,2,1072,5661,1072,2200,0,0,0,0,0
0.017,17,2,362,1,32,0,32,60,1,274,0,274,302
204.062,17,2,148,2,46,204062,46,148,0,0,0,0,0
1772.688,6,180,15480,120,69,14896,69,8940,60,69,30038,69,6540
0.375,6,13,1693,7,288,59,288,588,6,426,42,434,1105
4.771,17,32,6632,15,205,338,1350,3496,17,156,295,1350,3136
7.768,6,15,4050,8,275,1109,275,878,7,1440,992,1440,3172
1796.12,17,140,11200,70,48,26030,48,5320,70,56,26030,56,5880
63.024,6,11,851,11,31,6302,31,851,0,0,0,0,0
0.14,6,74,62328,44,181,3,253,2995,30,2063,4,5632,59333
0.82,17,2,134,2,39,820,39,134,0,0,0,0,0
1793.363,17,142,11360,71,48,25618,48,5396,71,56,25619,56,5964
1757.453,6,97,7307,63,38,28346,205,4476,34,33,53246,98,2831
240.671,2,3,96,3,8,120335,8,96,0,0,0,0,0
15.836,17,16,5676,7,416,2634,1350,3114,9,256,1975,1350,2562
1769.525,1,58,4872,0,0,0,0,0,58,56,31044,56,4872
280.252,6,28,7352,13,158,23354,267,1317,15,678,20014,2800,6035
58.798,6,24,6988,12,155,5345,267,1266,12,654,5344,3426,5722
0.037,17,3,634,2,32,1,32,120,1,486,0,486,514
300.812,6,38,9780,21,571,15040,1360,4298,17,435,541,2667,5482
361.012,2,4,128,4,8,120337,8,128,0,0,0,0,0
11.02,6,22,4526,12,275,1001,275,1038,10,768,693,1440,3488
1655.203,1,22,1232,22,28,78819,28,1232,0,0,0,0,0
1743.022,1,57,4788,57,56,31125,56,4788,0,0,0,0,0
1772.612,6,180,15480,120,69,14895,69,8940,60,69,30036,69,6540
0.091,6,9,1343,5,145,22,145,349,4,830,25,830,994
0.612,6,7,295,4,0,204,0,164,3,7,204,7,131
0.016,17,2,144,1,36,0,36,64,1,52,0,52,80
4.526,17,14,6867,7,590,754,1350,4330,7,334,745,1350,2537
1783.3,17,82,3438,81,14,22291,14,3402,1,8,0,8,36
57.879,17,6,528,3,48,28935,48,228,3,72,28934,72,300
117.325,6,23,6204,12,220,10665,516,1365,11,549,11721,1452,4839
1.29,6,47,19568,27,918,49,1360,13992,20,433,58,1360,5576
1720.912,1,8,848,8,78,245844,78,848,0,0,0,0,0
1.458,17,6,1326,3,30,726,30,174,3,356,726,484,1152
1799.172,6,101,7851,65,43,28112,205,4785,36,35,51398,98,3066
4.889,6,39,7269,19,218,271,314,3383,20,513,241,1179,3886
303.719,17,10,3360,10,308,33746,308,3360,0,0,0,0,0
2.427,6,18,3257,10,99,250,182,924,8,477,321,1343,2333
1750.497,17,12,498,11,14,175049,14,462,1,8,0,8,36
0.805,6,10,1687,7,100,134,100,384,3,1179,279,1179,1303
125.562,6,23,10687,13,726,2519,1329,3457,10,1136,13929,3151,7230
15.615,6,32,5158,16,154,1041,721,1922,16,300,1029,1408,3236
13.154,17,4,824,2,48,13138,48,152,2,308,13134,308,672
0.148,17,2,214,1,47,0,47,75,1,111,0,111,139
0.023,17,2,355,1,33,0,33,61,1,266,0,266,294
1783.06,6,354,22440,207,69,8655,69,12420,147,69,12212,69,10020
0.015,6,4,222,2,31,15,31,111,2,31,3,31,111
240.348,6,46,9171,24,519,10449,1402,5928,22,232,11444,618,3243
1720.411,17,12,498,11,14,172041,14,462,1,8,0,8,36
1785.901,6,355,22480,207,69,8669,69,12420,148,69,12146,69,10060
240.173,6,55,19103,30,811,8281,1408,16174,25,202,10007,580,2929
0.137,17,2,190,1,59,0,59,87,1,75,0,75,103
280.42,6,29,7392,13,158,23368,267,1317,16,678,18692,2085,6075
0.112,17,2,588,1,39,0,39,67,1,493,0,493,521
0.014,17,2,413,1,149,0,149,177,1,208,0,208,236
1682.029,17,14,1036,7,30,280330,30,406,7,62,280330,62,630
260.821,17,4,352,2,60,260820,60,176,2,60,260820,60,176
1794.13,6,381,32015,220,127,8192,1093,17098,161,116,11213,965,14917
21.011,6,23,2758,13,210,1741,210,1120,10,545,2226,904,1638
280.449,6,30,7432,13,158,23370,267,1317,17,603,17524,2076,6115
53.098,17,4,352,2,60,53097,60,176,2,60,53094,60,176
699.276,1,4,224,4,28,233092,28,224,0,0,0,0,0
1792.2,6,355,22480,207,69,8700,69,12420,148,69,12191,69,10060
6.0,2,3,96,3,8,3000,8,96,0,0,0,0,0
717.955,2,7,224,7,8,119659,8,224,0,0,0,0,0
0.006,6,6,7490,1,0,0,0,40,5,1438,1,1438,7450
0.148,6,7,423,4,43,36,43,259,3,0,23,0,164
11.74,6,1819,1601936,1130,1363,10,1380,1570143,689,467,17,1923,31793
1719.24,1,154,8624,154,28,11236,28,8624,0,0,0,0,0
43.327,17,41,8593,28,40,1604,41,1920,13,485,3610,505,6673
1798.308,17,144,11520,72,48,25328,48,5472,72,56,25328,56,6048
8.135,6,18,6871,9,275,1016,275,643,9,1171,664,1440,6228
4.0,6,10,420,6,0,800,0,248,4,0,989,0,172
1771.388,6,106,9752,68,65,26438,65,5758,38,59,47872,59,3994
990.706,6,62,3897,35,40,29133,208,2135,27,31,38097,31,1762
0.021,6,9,1880,5,910,5,910,1178,4,486,6,486,702
0.426,6,13,1693,7,288,66,288,588,6,426,49,434,1105
0.134,17,2,672,2,308,134,308,672,0,0,0,0,0
64.6,6,31,7445,9,165,8075,267,1029,22,325,3075,1420,6416
30.04,6,13,1369,7,174,5006,174,546,6,251,5996,476,823
5.71,6,38,7336,19,218,317,314,3383,19,455,303,1179,3953
1741.302,17,29,6815,29,207,62189,207,6815,0,0,0,0,0
1798.937,1,342,28728,342,56,5275,56,28728,0,0,0,0,0
63.161,6,23,9196,11,378,65,815,1606,12,1014,5730,1360,7590
0.625,6,15,1785,8,288,72,288,640,7,426,74,434,1145
0.891,6,10,1687,7,100,148,100,384,3,1179,317,1179,1303
1798.106,1,247,26182,247,78,7309,78,26182,0,0,0,0,0
1786.287,6,102,8364,68,66,26661,66,4964,34,60,54127,60,3400
3.873,6,2,1175,1,0,0,0,40,1,1095,0,1095,1135
1.508,6,47,18983,26,945,60,1460,13367,21,476,65,2615,5616
1751.241,6,95,7203,63,38,28245,205,4476,32,33,56482,98,2727
0.019,17,2,219,1,39,0,39,67,1,124,0,124,152
1402.198,17,12,888,6,30,280431,30,348,6,62,280428,62,540
53.94,17,4,1344,4,308,17980,308,1344,0,0,0,0,0
1756.241,6,133,13187,82,65,21681,722,6899,51,88,35115,2026,6288
1.309,6,38,8252,19,320,72,1162,2716,19,433,62,1460,5536
80.656,6,41,8851,16,401,2063,889,1912,25,311,3355,1360,6939
483.374,6,124,18963,61,263,8056,1189,8777,63,218,7796,1420,10186
17.251,17,29,7146,12,227,1565,1350,3065,17,212,1076,1350,4081
0.058,17,2,211,1,45,0,45,73,1,110,0,110,138
280.228,6,29,7392,14,158,21556,267,1357,15,678,20012,3436,6035
0.101,17,4,624,2,64,68,64,184,2,192,66,192,440
1783.282,17,73,3060,72,14,25116,14,3024,1,8,0,8,36
304.085,17,4,585,4,118,101361,335,585,0,0,0,0,0
1798.538,17,449,39928,404,35,4462,288,25708,45,288,40015,288,14220
21.772,17,4,352,2,60,21771,60,176,2,60,21771,60,176
0.551,6,25,10169,13,136,45,136,820,12,1089,46,1448,9349
1.526,6,11,1727,8,100,218,100,424,3,1179,581,1179,1303
22.182,6,3315,3187167,2152,1403,10,1448,3122027,1163,776,18,1448,65140
0.034,1,2,112,2,28,34,28,112,0,0,0,0,0
0.984,6,23,6380,13,299,82,842,2023,10,988,108,1731,4357
0.733,6,48,21506,28,1020,27,1380,16476,20,421,36,1923,5030
200.81,6,65,11739,27,224,7723,1189,3331,38,286,5423,1460,8408
1682.939,1,22,2878,22,102,80139,142,2878,0,0,0,0,0
39.31,17,22,1936,11,48,3919,48,836,11,72,3928,72,1100
4.039,17,5,295,5,31,1009,31,295,0,0,0,0,0
1787.505,6,102,8296,68,65,26679,65,4930,34,59,54163,59,3366
1.562,6,37,8214,19,321,86,1164,2718,18,476,80,2720,5496
1772.616,6,180,15480,120,69,14895,69,8940,60,69,30039,69,6540
519.531,17,466,35274,261,40,1997,41,17916,205,56,2546,57,17358
0.06,17,2,172,1,50,0,50,78,1,66,0,66,94
4.314,17,4,824,2,48,4299,48,152,2,308,4290,308,672
1785.57,6,114,9903,72,78,25148,292,5689,42,70,43548,247,4214
0.079,6,9,1339,5,145,19,145,349,4,826,21,826,990
130.079,6,24,9022,12,661,82,1360,3156,12,895,11808,1747,5866
113.265,6,24,10168,12,549,52,1360,2709,12,1161,10286,2720,7459
0.006,17,2,391,1,44,0,44,72,1,291,0,291,319
4.88,6,37,7189,19,218,271,314,3383,18,513,272,1179,3806
298.753,6,49,8076,24,129,12987,517,2185,25,456,12446,1418,5891
0.158,6,11,819,6,186,30,186,506,5,45,39,45,313
1.097,6,10,1687,7,100,182,100,384,3,1179,425,1179,1303
0.317,17,13,7111,7,639,52,1350,4669,6,379,41,1350,2442
14.064,6,24,6993,13,275,1172,275,1078,11,910,905,1440,5915
104.438,6,795,370157,417,824,251,1152,350571,378,446,276,1179,19586
1786.525,6,102,8364,68,66,26664,66,4964,34,60,54132,60,3400
110.583,17,4,352,2,60,110582,60,176,2,60,110581,60,176
1764.029,2,15,480,15,8,126002,8,480,0,0,0,0,0
4.467,6,14,1913,7,370,743,666,1394,7,231,742,231,519
1.381,6,46,18675,27,859,53,1360,13139,19,476,66,2715,5536
3.273,17,2,144,1,36,0,36,64,1,52,0,52,80
1786.447,6,104,8366,68,63,26663,64,4868,36,57,51038,58,3498
0.548,6,10,924,5,283,93,283,551,5,105,91,105,373
1681.683,17,14,1036,7,30,280272,30,406,7,62,280272,62,630
17.336,6,2688,2589684,1815,1353,9,1368,2539624,873,776,19,1473,50060
0.333,6,3,182,2,31,333,31,111,1,31,0,31,71
4.453,6,29,11582,11,270,445,797,1696,18,745,259,1418,9886
0.876,6,51,13813,24,549,38,1429,4824,27,464,33,1986,8989
38.953,17,22,1936,11,48,3894,48,836,11,72,3894,72,1100
0.117,17,2,672,2,308,117,308,672,0,0,0,0,0
1750.647,6,94,7151,62,38,28699,205,4424,32,33,56460,98,2727
396.667,6,18,1242,14,180,30512,180,916,4,110,20114,110,326
1788.812,1,232,12992,232,28,7743,28,12992,0,0,0,0,0
300.256,6,70,57580,34,145,9098,230,2428,36,1614,8578,2804,55152
91.163,6,24,10168,13,549,71,1360,2749,11,1161,9099,2574,7419
661.848,17,10,821,5,31,165454,37,297,5,76,165454,136,524
4.26,6,34,6169,18,206,250,314,2784,16,548,266,1179,3385
8.162,6,969,1594495,630,1144,12,1360,60793,339,4810,23,57120,1533702
1754.859,17,310,104128,310,307,5679,308,104128,0,0,0,0,0
4.182,17,14,14097,5,836,1045,1350,4323,9,1058,405,1350,9774
32.054,6,4,192,2,0,1480,0,96,2,0,13121,0,96
1793.835,17,87,3648,86,14,21103,14,3612,1,8,0,8,36
1.126,6,15,1343,8,248,153,248,824,7,231,179,231,519
0.179,17,4,624,2,64,177,64,184,2,192,52,192,440
11.439,17,4,304,4,48,3813,48,304,0,0,0,0,0
0.192,6,25,7216,13,155,16,267,1301,12,678,16,2045,5915
85.022,6,76,49525,46,1176,1889,1440,41211,30,749,2126,1440,8314
1.153,17,4,377,2,33,1139,37,123,2,99,1135,136,254
1684.478,2,16,512,16,8,112298,8,512,0,0,0,0,0
1774.631,6,180,15480,120,69,14912,69,8940,60,69,30071,69,6540
35.836,6,35,16070,16,490,2389,1360,3641,19,896,1980,3921,12429
5.167,17,3,2037,3,651,2583,651,2037,0,0,0,0,0
0.375,6,10,968,5,256,91,256,460,5,304,90,304,508
2.094,6,10,1687,7,100,349,100,384,3,1179,923,1179,1303
1662.346,1,8,448,8,28,237478,28,448,0,0,0,0,0
301.437,6,41,8501,22,254,14354,671,1942,19,413,513,1460,6559
1788.735,17,142,11360,71,48,25553,48,5396,71,56,25553,56,5964
0.126,17,2,212,1,46,0,46,74,1,110,0,110,138
1784.704,6,104,8444,68,66,26637,66,4964,36,60,50988,60,3480
0.179,6,3,175,2,31,2,31,135,1,0,0,0,40
1799.598,17,80,3354,79,14,23071,14,3318,1,8,0,8,36
24.22,17,12,1056,6,48,4808,48,456,6,72,4821,72,600
2.031,17,2,677,1,300,0,300,328,1,321,0,321,349
10.677,6,18,5610,10,275,1186,275,958,8,1440,810,1440,4652
504.099,2,3,96,3,8,252049,8,96,0,0,0,0,0
5.211,6,21,7053,8,275,744,275,874,13,565,390,1420,6179
53.717,17,4,304,4,48,17905,48,304,0,0,0,0,0
1796.153,6,385,29598,221,129,8164,469,18277,164,69,11019,69,11321
1772.514,6,204,22330,130,75,13740,267,10057,74,132,24280,1452,12273
1795.454,17,449,39928,404,35,4455,288,25708,45,288,40020,288,14220
0.315,6,3,180,1,0,0,0,60,2,0,303,0,120
0.199,6,50,39835,19,283,11,517,1845,31,1347,5,1408,37990
0.306,6,27,9098,13,261,25,683,1728,14,829,23,1408,7370
629.035,6,25,1991,16,63,25220,63,1144,9,54,78618,57,847
52.726,6,31,14323,17,857,3295,1376,5180,14,1050,4054,1408,9143
19.804,17,25,13677,13,835,1639,1350,11225,12,176,1775,1350,2452
2.036,17,3,183,3,33,1018,33,183,0,0,0,0,0
382.568,6,21,1444,14,226,29428,226,962,7,110,10478,110,482
179.265,6,128,88098,75,1242,2422,1368,77215,53,902,1932,5255,10883
503.387,2,4,128,4,8,167795,8,128,0,0,0,0,0
0.017,17,2,332,1,43,0,43,71,1,233,0,233,261
0.409,6,24,6064,12,181,37,537,1526,12,651,33,1448,4538
1796.53,2,17,544,17,8,112283,8,544,0,0,0,0,0
1.709,6,47,17081,26,799,68,1360,11465,21,433,74,1360,5616
1787.638,6,108,8468,68,64,26681,64,4896,40,58,45834,58,3572
0.91,6,26,5887,13,156,75,267,1462,13,780,69,1460,4425
0.235,6,14,4334,7,111,39,111,483,7,869,39,1448,3851
26.912,17,4,240,2,32,26911,32,120,2,32,26911,32,120
1797.889,1,189,10584,189,28,9563,28,10584,0,0,0,0,0
1752.358,6,95,7203,63,38,28263,205,4476,32,33,56514,98,2727
0.022,17,8,2446,8,277,3,316,2446,0,0,0,0,0
0.012,17,2,186,1,41,0,41,69,1,89,0,89,117
471.036,17,8,2736,8,314,67290,320,2736,0,0,0,0,0
4.862,6,37,7189,19,218,270,314,3383,18,513,266,1179,3806
11.758,6,1858,1624194,1130,1383,10,1420,1590853,728,467,16,1883,33341
1.433,6,239,189446,144,1335,10,1432,179484,95,559,14,1871,9962
0.382,6,19,7099,11,318,36,600,1854,8,1205,53,1891,5245
1740.492,17,29,30624,29,1028,62160,1028,30624,0,0,0,0,0
0.885,6,23,6397,13,310,73,891,2077,10,979,97,1731,4320
1786.569,17,87,3648,86,14,21018,14,3612,1,8,0,8,36
1797.188,17,449,39928,404,35,4459,288,25708,45,288,40010,288,14220
1797.076,1,342,28728,342,56,5270,56,28728,0,0,0,0,0
1793.357,1,208,11648,208,28,8663,28,11648,0,0,0,0,0
180.987,6,23,10009,12,531,67,1360,2637,11,1384,18084,3934,7372
1783.812,6,376,23464,211,69,8494,69,12580,165,55,10876,69,10884
661.782,2,6,192,6,8,132356,8,192,0,0,0,0,0
10.89,6,7,388,4,0,3630,0,216,3,0,5438,0,172
1781.886,6,360,24156,210,88,8525,469,13878,150,69,11958,69,10278
0.374,6,7,716,4,226,124,226,442,3,110,94,110,274
1790.494,17,87,3648,86,14,21064,14,3612,1,8,0,8,36
252.365,6,10,628,4,106,84117,106,274,6,90,50470,90,354
1785.853,17,87,3648,86,14,21010,14,3612,1,8,0,8,36
5.673,6,40,7325,21,218,283,314,3463,19,516,300,1179,3862
0.348,6,23,7394,12,335,31,668,1974,11,968,34,1475,5420
1793.737,17,66,2766,65,14,28027,14,2730,1,8,0,8,36
1686.017,1,7,392,7,28,281002,28,392,0,0,0,0,0
33.98,17,20,1760,10,48,3774,48,760,10,72,3774,72,1000
0.837,6,11,1727,7,100,139,100,384,4,589,189,1152,1343
0.018,17,2,554,1,30,0,30,58,1,468,0,468,496
24.62,17,4,352,2,60,24618,60,176,2,60,24619,60,176
7.666,6,67,20166,34,540,232,1152,15419,33,489,230,1179,4747
280.228,6,30,7432,14,158,21556,267,1357,16,603,18678,2036,6075
1749.572,17,12,498,11,14,174957,14,462,1,8,0,8,36
84.071,17,4,558,2,36,84065,36,128,2,187,84065,187,430
1798.225,17,449,39928,404,35,4462,288,25708,45,288,40018,288,14220
1749.548,17,12,498,11,14,174954,14,462,1,8,0,8,36
3.265,6,4,176,1,0,0,0,44,3,0,1510,0,132
0.173,17,2,586,1,46,0,46,74,1,484,0,484,512
0.052,17,4,420,2,33,1,33,122,2,121,0,145,298
164.14,6,33,16024,15,630,58,1440,3165,18,1010,9647,1440,12859
29.87,6,4356,4138658,2865,1366,10,1408,4056462,1491,931,19,2801,82196
20.101,6,17,2316,10,189,2233,517,1298,7,323,3348,499,1018
1740.419,17,30,7050,30,207,60014,207,7050,0,0,0,0,0
0.06,17,4,420,2,33,13,33,122,2,121,49,145,298
1798.521,1,345,28980,345,56,5228,56,28980,0,0,0,0,0
1080.473,2,12,384,12,8,98224,8,384,0,0,0,0,0
120.668,6,26,10550,13,491,128,1360,2516,13,1071,10042,2720,8034
4.608,6,38,7245,19,218,256,314,3383,19,516,241,1179,3862
8.986,6,3,180,3,0,0,0,180,0,0,0,0,0
2.831,6,10,1687,7,100,471,100,384,3,1179,1291,1179,1303
1781.762,6,434,28256,217,100,8248,469,15096,217,34,8248,64,13160
0.246,17,3,451,2,39,167,39,134,1,289,0,289,317
0.336,17,8,2766,8,317,48,356,2766,0,0,0,0,0
1744.708,2,24,768,24,8,75856,8,768,0,0,0,0,0
0.39,6,10,968,5,256,95,256,460,5,304,94,304,508
1790.255,17,87,3648,86,14,21061,14,3612,1,8,0,8,36
0.72,17,4,624,2,64,718,64,184,2,192,602,192,440
160.234,6,22,7983,12,378,58,799,1682,10,981,17790,4080,6301
17.937,17,14,11627,14,802,1379,1451,11627,0,0,0,0,0
1679.867,1,15,840,15,28,119990,28,840,0,0,0,0,0
0.291,6,24,5980,12,164,26,453,1442,12,781,25,2224,4538
1675.839,1,8,848,8,78,239405,78,848,0,0,0,0,0
0.602,6,23,6395,13,310,49,889,2075,10,979,65,1731,4320
11.061,6,92,27810,47,577,240,1152,21528,45,447,245,1179,6282
280.84,6,28,7352,13,158,23403,267,1317,15,678,20052,3436,6035
1798.245,17,450,39960,405,35,4451,288,25740,45,288,40021,288,14220
1784.061,6,115,13715,75,81,24108,501,5950,40,162,45742,1420,7765
45.637,6,13,3093,5,92,11409,92,348,8,465,6455,1408,2745
1789.8,1,190,20140,190,78,9469,78,20140,0,0,0,0,0
1772.55,17,138,11040,69,48,26066,48,5244,69,56,26066,56,5796
11.84,6,1874,1635867,1138,1383,10,1420,1602194,736,467,16,1883,33673
171.937,17,4,352,2,60,171936,60,176,2,60,171936,60,176
19.329,6,38,8750,16,419,41,944,1931,22,348,914,3488,6819
3.27,6,2,80,1,0,0,0,40,1,0,0,0,40
24.482,6,33,8930,15,303,1748,721,2726,18,608,1411,1440,6204
1796.349,6,368,25759,214,99,8433,469,15045,154,69,11739,69,10714
230.138,17,4,558,2,36,230133,36,128,2,187,230133,187,430
1745.184,6,106,7942,68,38,26047,205,4767,38,32,47156,98,3175
11.729,6,1889,1632582,1153,1363,10,1380,1596989,736,511,15,1923,35593
1798.421,17,449,39928,404,35,4462,288,25708,45,288,40019,288,14220
0.487,6,53,22167,29,984,17,1380,16965,24,421,19,1923,5202
1.311,6,24,8004,12,164,101,267,1288,12,1014,101,2491,6716
49.042,6,29,7257,13,155,4086,267,1306,16,441,3268,1420,5951
0.481,6,28,7336,13,155,40,267,1301,15,678,31,3456,6035
1772.591,6,180,15480,120,69,14895,69,8940,60,69,30037,69,6540
1787.563,6,102,8228,68,64,26680,64,4896,34,58,54165,58,3332
1.878,6,23,4813,12,321,170,517,2249,11,493,159,828,2564
0.005,17,4,240,2,32,0,32,120,2,32,1,32,120
181.203,6,92,61980,54,1224,3418,1368,53036,38,841,1692,2519,8944
56.849,6,12,2927,5,100,14212,100,304,7,777,9433,1152,2623
1685.839,17,12,498,11,14,168583,14,462,1,8,0,8,36
1772.984,6,181,15589,120,69,14899,69,8940,61,69,29549,69,6649
1383.436,6,111,9727,68,70,20648,138,5204,43,68,32938,69,4523
513.358,1,6,689,6,86,102671,93,689,0,0,0,0,0
227.124,17,4,352,2,60,227123,60,176,2,60,227122,60,176
7.329,6,5,220,1,0,0,0,44,4,0,2413,0,176
282.264,6,30,7432,13,158,23522,267,1317,17,543,17634,1400,6115
24.689,6,64,14581,33,483,771,1152,10996,31,387,807,1152,3585
0.319,6,27,9065,13,257,26,669,1714,14,945,23,1402,7351
4.629,6,38,7229,19,218,257,314,3383,19,513,241,1179,3846
0.386,6,24,6016,13,108,32,147,959,11,768,38,1581,5057
260.057,6,39,5924,22,119,12383,722,2465,17,321,16226,2329,3459
1790.912,1,58,4872,0,0,0,0,0,58,56,31419,56,4872
1740.518,17,29,6815,29,207,62161,207,6815,0,0,0,0,0
1.55,17,2,136,1,32,0,32,60,1,48,0,48,76
67.475,17,4,352,2,60,67474,60,176,2,60,67474,60,176
1795.688,17,448,39896,403,35,4466,288,25676,45,288,40010,288,14220
1789.15,17,142,11360,71,48,25559,48,5396,71,56,25559,56,5964
1789.22,1,190,10640,190,28,9466,28,10640,0,0,0,0,0
3.937,2,2,64,2,8,3937,8,64,0,0,0,0,0
2.666,17,4,518,3,39,562,39,201,1,289,0,289,317
0.91,6,4,160,1,0,0,0,40,3,0,455,0,120
1773.111,6,180,15480,120,69,14900,69,8940,60,69,30051,69,6540
282.662,6,30,7432,13,158,23555,267,1317,17,603,17663,1380,6115
280.029,6,27,7312,12,158,25457,267,1277,15,678,19999,2045,6035
40.493,6,25,7097,12,155,3681,267,1266,13,589,3373,3426,5831
0.123,6,11,1739,6,126,24,126,386,5,1149,28,1149,1353
11.882,17,4,296,4,46,3960,46,296,0,0,0,0,0
1786.291,17,87,3648,86,14,21015,14,3612,1,8,0,8,36
0.005,17,2,443,1,29,0,29,57,1,358,0,358,386
17.755,6,38,7392,23,272,807,383,4740,15,409,1136,1072,2652
1788.899,17,142,11360,71,48,25555,48,5396,71,56,25555,56,5964
1791.537,1,212,11872,212,28,8490,28,11872,0,0,0,0,0
13.478,6,1546,1415974,986,1383,13,1432,1388803,560,427,24,1432,27171
13.149,6,1255,1101540,752,1414,17,1432,1075584,503,428,25,2864,25956
1798.566,17,763,46018,763,32,2360,37,46018,0,0,0,0,0
1782.129,1,58,4872,0,0,0,0,0,58,56,31265,56,4872
1784.604,6,102,8364,68,66,26635,66,4964,34,60,54076,60,3400
1681.29,1,8,848,8,78,240184,78,848,0,0,0,0,0
3.353,17,2,166,1,47,0,47,75,1,63,0,63,91
1746.98,6,95,7203,63,38,28177,205,4476,32,33,56343,98,2727
4.667,6,140,136118,42,131,113,232,2209,98,1412,48,2840,133909
0.044,17,4,352,2,37,37,37,130,2,83,35,89,222
15.837,6,2707,2316655,1532,1416,10,1448,2239843,1175,776,13,1448,76812
0.513,6,29,9268,13,268,42,711,1768,16,831,30,1368,7500
0.133,6,6,328,4,0,44,0,216,2,0,126,0,112
194.172,17,10,3344,10,306,21574,308,3344,0,0,0,0,0
210.275,17,4,352,2,60,210273,60,176,2,60,210274,60,176
0.071,17,6,462,3,33,0,33,183,3,65,0,65,279
120.448,6,23,1699,17,43,7528,43,1339,6,0,24088,0,360
2.178,17,4,1556,4,361,726,361,1556,0,0,0,0,0
118.465,6,39,8407,17,146,7404,267,2009,22,367,5639,1452,6398
104.041,6,13020,12556594,8744,1359,11,1408,12329480,4276,792,24,1408,227114
26.74,6,44,8865,21,371,682,797,2069,23,366,1207,2128,6796
79.714,6,776,361951,405,831,197,1152,341265,371,417,214,1179,20686
1795.303,6,356,22520,208,69,8672,69,12460,148,69,12212,69,10060
1.157,6,25,8056,12,164,90,267,1288,13,869,82,1408,6768
5.884,6,27,8752,13,158,490,267,1317,14,981,448,3445,7435
1776.893,17,142,11360,71,48,25383,48,5396,71,56,25383,56,5964
366.97,6,25,1651,17,177,22935,177,1117,8,110,9184,110,534
54.56,6,24,996,13,0,4546,0,532,11,0,4880,0,464
300.537,6,59,43980,38,1283,8122,1448,37912,21,828,1459,1448,6068
11.233,6,1566,1245315,826,1406,13,1448,1194987,740,776,14,1448,50328
1.381,6,52,18984,29,857,49,1360,13243,23,400,54,1360,5741
2.662,17,4,340,2,37,2653,37,130,2,77,2653,77,210
4.116,17,3,183,3,33,2058,33,183,0,0,0,0,0
0.796,6,26,12805,15,830,56,1360,5614,11,1347,57,4445,7191
210.063,17,6,3742,6,595,42012,1115,3742,0,0,0,0,0
0.25,17,2,167,1,39,0,39,67,1,72,0,72,100
63.496,6,43,10045,20,258,3341,1189,3393,23,440,2885,1420,6652
237.388,17,4,352,2,60,237387,60,176,2,60,237387,60,176
1778.574,6,79,4160,40,26,45603,26,2106,39,26,46803,26,2054
0.237,17,2,259,1,53,0,53,81,1,150,0,150,178
1796.916,1,216,22896,216,78,8357,78,22896,0,0,0,0,0
113.48,6,44,9991,20,635,1269,1360,4043,24,292,4926,2720,5948
0.424,6,27,7296,13,155,35,267,1301,14,603,32,1400,5995
134.443,6,24,9833,13,465,64,1360,2414,11,1161,13427,2574,7419
1.264,6,50,19337,27,894,48,1360,13641,23,433,49,1360,5696
1740.41,17,30,7050,30,207,60014,207,7050,0,0,0,0,0
1796.548,6,760,51540,380,31,4740,31,25941,380,31,4739,31,25599
1740.444,17,29,19517,29,645,62158,645,19517,0,0,0,0,0
2.146,17,4,580,2,40,2033,40,136,2,194,2102,194,444
1.066,6,11,1727,7,100,177,100,384,4,589,272,1152,1343
1796.83,17,448,39896,403,35,4469,288,25676,45,288,40021,288,14220
1.368,6,38,9848,21,440,68,1360,4392,17,476,73,2715,5456
564.977,6,66,5745,38,72,15269,138,2969,28,69,20924,69,2776
0.318,6,26,8868,13,227,26,547,1592,13,1098,25,2816,7276
1795.151,6,353,22400,205,69,8799,69,12340,148,69,12209,69,10060
7.553,6,69,20326,36,543,215,1152,15579,33,489,228,1179,4747
0.091,17,4,284,2,32,13,32,120,2,54,80,60,164
15.404,6,12,2596,10,256,1711,365,2452,2,64,178,64,144
1.987,17,26,13468,12,558,180,1350,7040,14,431,121,1350,6428
0.298,6,26,8892,13,237,24,589,1634,13,1095,23,2804,7258
1785.564,6,106,8584,69,66,26258,66,5004,37,60,49596,60,3580
10.113,17,2,150,2,47,10113,47,150,0,0,0,0,0
1.4,6,38,8252,19,320,77,1162,2716,19,433,67,1440,5536
280.051,6,30,7432,14,158,21542,267,1357,16,603,18666,2800,6075
154.026,17,4,240,2,32,154025,32,120,2,32,154025,32,120
0.001,6,4,5668,1,0,0,0,40,3,1824,0,2736,5628
11.212,6,1899,1717284,1182,1374,9,1408,1675336,717,931,15,2816,41948
501.875,1,3,168,3,28,250937,28,168,0,0,0,0,0
1.555,17,19,6896,9,471,193,1350,4497,10,211,169,1350,2399
0.139,6,10,1669,6,551,27,947,1346,4,159,46,159,323
0.017,6,2,99,1,0,0,0,40,1,7,0,7,59
1784.13,1,216,12096,216,28,8298,28,12096,0,0,0,0,0
0.065,17,2,198,1,63,0,63,91,1,79,0,79,107
1725.584,6,176,15113,117,69,14875,69,8682,59,69,29751,69,6431
0.366,6,6,324,4,0,122,0,216,2,0,186,0,108
1771.047,6,102,9396,66,65,27246,65,5577,36,59,50599,59,3819
10.984,6,18,5610,10,275,1220,275,958,8,1440,853,1440,4652
1793.165,6,356,22520,208,69,8662,69,12460,148,69,12198,69,10060
0.037,17,2,198,1,39,0,39,67,1,103,0,103,131
1.675,6,13,2311,8,188,239,245,700,5,1407,353,1407,1611
1708.486,6,145,12700,99,69,17433,69,7755,46,69,29466,69,4945
0.012,17,2,904,2,424,12,548,904,0,0,0,0,0
91.485,6,858,405327,455,829,201,1152,383345,403,418,226,1179,21982
64.11,6,18,2121,9,304,8013,304,1376,9,83,7907,83,745
1740.525,6,91,6604,59,31,30009,31,3998,32,31,56145,31,2606
0.557,17,2,925,1,548,0,548,576,1,321,0,321,349
3.061,17,4,332,2,47,3055,47,150,2,63,3054,63,182
0.938,17,4,560,2,64,936,64,184,2,160,819,160,376
1776.826,17,140,11200,70,48,25750,48,5320,70,56,25750,56,5880
280.512,6,30,7432,13,158,23376,267,1317,17,603,17525,2760,6115
0.428,6,21,7203,12,318,38,600,1906,9,964,51,1471,5297
2.757,6,2,100,1,0,0,0,60,1,0,0,0,40
300.739,6,39,8649,20,315,15828,882,2105,19,412,474,1440,6544
2.279,6,14,2351,8,188,325,245,700,6,703,402,1152,1651
2.958,17,3,228,2,48,2915,48,152,1,48,0,48,76
1624.336,2,20,640,20,8,85491,8,640,0,0,0,0,0
1744.851,6,95,7203,63,38,28142,205,4476,32,33,56275,98,2727
155.066,17,4,824,2,48,155057,48,152,2,308,155057,308,672
1798.258,17,144,11520,72,48,25327,48,5472,72,56,25327,56,6048
0.066,17,4,284,2,32,0,32,120,2,54,0,60,164
1787.904,6,372,23574,213,69,8433,69,13005,159,69,11315,69,10569
64.838,6,23,6946,5,154,16209,267,672,18,396,3796,1460,6274
5.758,6,34,6185,18,206,338,314,2784,16,551,366,1179,3401
4.975,6,43,7429,23,218,226,314,3543,20,440,248,1152,3886
1790.104,6,335,27777,193,75,9323,267,12715,142,132,12695,1460,15062
0.544,17,2,245,1,32,0,32,60,1,157,0,157,185
3.471,6,35,13729,19,723,192,1295,3746,16,848,222,3614,9983
1787.202,6,356,22520,208,69,8633,69,12460,148,69,12157,69,10060
0.171,6,32,8065,16,297,11,517,1849,16,556,10,1883,6216
0.246,6,3,189,2,0,237,0,80,1,69,0,69,109
2.037,1,3,252,3,56,1018,56,252,0,0,0,0,0
0.323,17,8,2766,8,317,46,356,2766,0,0,0,0,0
0.299,17,2,152,1,48,0,48,76,1,48,0,48,76
1062.022,6,125,15790,68,81,15850,267,5507,57,156,18964,1997,10283
5.12,6,16,3532,9,179,640,194,846,7,578,847,905,2686
217.841,6,31,7472,14,158,16757,267,1357,17,543,13612,1400,6115
1761.48,6,87,6322,58,31,30903,31,3915,29,31,62908,31,2407
200.372,6,45,6658,16,132,13345,722,2028,29,164,7149,1408,4630
171.799,6,25,10081,13,523,46,1360,2669,12,988,15606,1360,7412
1.528,6,53,21418,31,902,50,1360,15717,22,437,63,2720,5701
1275.826,6,77,4598,44,27,29670,27,2585,33,27,39867,27,2013
0.011,17,2,572,1,39,0,39,67,1,477,0,477,505
5.931,6,14,2351,8,188,847,245,700,6,703,1134,1152,1651
2.191,17,3,1176,3,364,1095,364,1176,0,0,0,0,0
1649.85,1,7,392,7,28,274975,28,392,0,0,0,0,0
0.282,6,40,15905,23,914,12,1420,11004,17,420,17,1420,4901
30.406,17,3,228,3,48,15203,48,228,0,0,0,0,0
62.902,6,29,7257,13,155,5241,267,1306,16,441,4192,1420,5951
0.006,6,2,80,1,0,0,0,40,1,0,0,0,40
1770.176,6,718,208001,343,229,5175,1360,73735,375,736,4733,2720,134266
1799.828,17,772,46540,772,32,2334,37,46540,0,0,0,0,0
3.789,6,13,2311,8,188,541,245,700,5,1407,878,1407,1611
4.219,6,38,7229,19,218,234,314,3383,19,440,219,1152,3846
0.165,6,27,7296,14,155,12,267,1341,13,678,13,4200,5955
0.385,6,48,20958,27,1054,14,1380,15876,21,468,17,3303,5082
27.359,6,27,7177,13,155,2279,267,1306,14,530,2103,3417,5871
1786.766,6,104,8444,68,66,26668,66,4964,36,60,51047,60,3480
0.106,6,12,1697,7,253,17,500,878,5,551,26,551,819
9.587,6,1604,1484984,997,1411,9,1448,1448756,607,776,15,1448,36228
514.415,6,105,16056,63,304,8297,304,11516,42,83,12546,83,4540
11.016,6,20,4442,11,275,1101,275,998,9,768,770,1440,3444
119.627,6,53,30820,31,1069,3983,1408,24087,22,508,5690,3047,6733
1782.295,17,83,3480,82,14,22003,14,3444,1,8,0,8,36
1745.947,1,43,5314,43,95,41570,320,5314,0,0,0,0,0
0.841,6,23,4776,13,208,70,522,1713,10,633,84,2301,3063
11.59,6,1829,1589163,1108,1379,10,1420,1556102,721,467,16,1883,33061
1.696,6,25,8753,15,283,121,582,1454,10,985,168,1420,7299
1798.944,17,448,39896,403,35,4474,288,25676,45,288,40019,288,14220
735.129,6,52,8467,27,115,18747,501,2470,25,226,30626,1420,5997
2.934,17,4,624,4,128,978,128,624,0,0,0,0,0
1799.367,17,448,39896,403,35,4476,288,25676,45,288,40020,288,14220
2.006,17,4,496,3,64,995,64,276,1,192,0,192,220
1.523,6,41,12001,22,617,72,1360,6465,19,433,73,1360,5536
1750.572,17,12,498,11,14,175057,14,462,1,8,0,8,36
1729.229,6,60,4400,40,33,44339,33,2740,20,31,91002,31,1660
0.054,6,9,1556,5,515,13,515,783,4,557,17,557,773
73.422,6,12,927,4,177,247,177,393,8,110,10462,110,534
93.88,6,73,47129,44,1180,2183,1408,38886,29,961,2201,3847,8243
63.189,17,4,240,2,32,63188,32,120,2,32,63188,32,120
9.694,6,30,7297,14,155,745,267,1346,16,441,645,1420,5951
0.935,6,10,1687,7,100,155,100,384,3,1179,335,1179,1303
1756.049,6,105,6270,60,27,29762,27,3525,45,27,39909,27,2745
23.818,6,36,8329,17,175,1488,721,2085,19,608,1298,2840,6244
1799.748,17,144,11520,72,48,25348,48,5472,72,56,25348,56,6048
1758.621,17,46,15432,46,307,39080,308,15432,0,0,0,0,0
1750.778,6,102,7970,66,45,26935,205,4902,36,35,50011,98,3068
6.036,17,4,304,3,48,2989,48,228,1,48,0,48,76
18.699,6,18,1407,9,222,2336,222,808,9,231,2336,231,599
74.238,6,17,700,7,0,7880,0,284,10,0,8247,0,416
63.155,6,86,56867,50,1201,1288,1368,48259,36,747,1769,1368,8608
0.008,6,19,9933,11,125,0,125,705,8,2201,1,3012,9228
1744.415,6,100,7463,63,38,28135,205,4476,37,33,48446,98,2987
119.688,6,22,9936,11,380,75,832,1613,11,1124,11953,1360,8323
28.612,17,4,352,2,60,28611,60,176,2,60,28611,60,176
370.016,6,26,1978,18,177,21765,177,1334,8,110,8939,110,644
1796.658,17,449,39928,404,35,4458,288,25708,45,288,40014,288,14220
0.141,6,12,3705,6,171,27,171,491,6,964,25,1448,3214
0.354,1,2,112,2,28,354,28,112,0,0,0,0,0
240.342,6,45,9343,22,209,11444,835,2629,23,551,10924,2338,6714
1785.192,17,87,3648,86,14,21002,14,3612,1,8,0,8,36
1744.761,6,95,7203,63,38,28141,205,4476,32,33,56276,98,2727
0.073,6,9,1339,5,145,18,145,349,4,826,13,826,990
10.524,6,1590,1449358,1029,1363,10,1380,1419328,561,582,18,3303,30030
5.128,6,65,52629,42,906,125,1360,12572,23,2794,226,10880,40057
0.012,17,2,442,1,30,0,30,58,1,356,0,356,384
1.245,17,18,7356,9,495,155,1350,4715,9,265,148,1350,2641
0.501,6,26,8890,13,232,41,569,1614,13,941,39,1438,7276
1795.937,17,447,39864,402,35,4478,288,25644,45,288,40022,288,14220
2.519,6,58,21118,32,945,81,1460,13659,26,400,82,1460,7459
0.092,17,2,237,1,72,0,72,100,1,109,0,109,137
1799.345,17,449,39928,404,35,4464,288,25708,45,288,40020,288,14220
2.443,17,23,7898,9,272,305,1350,2705,14,342,122,1350,5193
119.66,6,37,8290,12,141,3059,267,1335,25,283,4985,1420,6955
3.394,6,24,7505,12,262,304,517,1432,12,779,304,1418,6073
445.593,6,110,15443,50,188,9093,1407,6145,60,202,7552,1452,9298
300.223,6,33,17265,20,983,15801,1440,11869,13,785,3157,1440,5396
0.001,6,2,1237,1,0,0,0,40,1,1145,0,1145,1197
4.221,6,34,6169,17,206,263,314,2744,17,548,248,1179,3425
14.099,6,2330,2154724,1481,1376,9,1408,2105912,849,931,16,2801,48812
69.091,6,27,7177,13,155,5757,267,1306,14,530,5314,3417,5871
0.364,1,2,112,2,28,364,28,112,0,0,0,0,0
44.154,17,4,240,2,32,44153,32,120,2,32,44152,32,120
1798.537,6,367,25650,214,99,8443,469,15045,153,69,11830,69,10605
3.741,6,33,6129,17,206,233,314,2744,16,548,230,1179,3385
1.267,6,40,9928,21,440,63,1360,4392,19,433,60,1360,5536
1775.001,6,207,22679,130,75,13759,267,10057,77,130,23349,1460,12622
1790.379,6,325,24646,191,105,9423,469,14594,134,69,13461,69,10052
240.303,6,59,17571,31,755,8009,1418,14459,28,206,8899,580,3112
0.157,17,3,2906,3,940,78,1451,2906,0,0,0,0,0
1755.908,6,106,6322,60,27,29760,27,3525,46,27,39019,27,2797
1698.167,6,24,3624,16,241,113211,241,2568,8,92,242571,92,1056
240.177,6,53,17525,28,778,8895,1402,14700,25,189,10007,580,2825
8.343,6,17,5391,9,275,1042,275,643,8,1104,799,1440,4748
64.626,6,554,250525,285,819,227,1152,234260,269,423,240,1179,16265
1746.397,1,82,8692,82,78,21560,78,8692,0,0,0,0,0
4.077,6,12,511,6,0,815,0,248,6,7,610,7,263
0.503,6,21,7293,13,334,41,663,2033,8,967,65,1471,5260
1772.979,6,187,15967,123,69,14532,69,9129,64,69,28135,69,6838
1798.881,6,373,26028,216,98,8366,469,15263,157,69,11528,69,10765
0.0,1,1,318,1,290,0,290,318,0,0,0,0,0
1786.506,6,356,22520,208,69,8630,69,12460,148,69,12150,69,10060
1797.314,1,345,28980,345,56,5224,56,28980,0,0,0,0,0
0.433,6,46,21429,26,1096,17,1420,16408,20,467,22,1883,5021
0.226,6,10,1840,5,901,56,901,1169,5,403,56,403,671
0.034,17,2,212,1,46,0,46,74,1,110,0,110,138
0.298,6,10,1671,6,552,59,948,1348,4,159,99,159,323
0.421,6,12,1653,6,288,81,288,548,6,426,47,434,1105
0.234,6,24,5962,12,164,21,453,1442,12,777,20,2206,4520
1797.569,17,447,39580,403,35,4471,288,25676,44,288,40947,288,13904
1681.284,17,16,1265,8,30,240180,37,471,8,71,240180,136,794
1798.442,6,381,26831,216,98,8364,469,15332,165,69,10964,69,11499
0.109,17,2,204,1,34,0,34,62,1,114,0,114,142
8.072,6,1793,1661018,1137,1383,6,1408,1622242,656,931,12,2816,38776
1775.108,6,182,15698,120,69,14916,69,8940,62,69,29094,69,6758
1.406,6,37,9808,20,502,74,1460,4352,17,476,76,2615,5456
3.95,6,2,88,2,0,0,0,88,0,0,0,0,0
1783.059,6,356,22520,208,69,8613,69,12460,148,69,12129,69,10060
11.619,6,1833,1591536,1110,1378,10,1420,1558395,723,467,16,1883,33141
101.589,6,174,133438,108,1276,949,1408,120497,66,678,1559,2816,12941
341.016,1,15,1260,15,56,24358,56,1260,0,0,0,0,0
1737.557,1,56,4704,56,56,31591,56,4704,0,0,0,0,0
1791.246,6,418,25048,209,69,8611,69,12500,209,34,8611,48,12548
1798.131,1,58,4872,58,56,31546,56,4872,0,0,0,0,0
300.331,6,36,7464,19,175,16685,358,1782,17,399,5991,1440,5682
1787.047,6,104,8504,69,66,26280,66,5004,35,60,52557,60,3500
32.016,6,23,8154,11,182,3201,267,1179,12,810,2908,1917,6975
333.816,6,68,48670,45,1199,7586,1408,40740,23,960,2801,3847,7930
1719.687,17,13,534,11,14,171949,14,462,2,8,1719495,8,72
1795.112,17,142,11360,71,48,25644,48,5396,71,56,25644,56,5964
4.312,6,39,7285,21,218,215,314,3463,18,516,238,1179,3822
261.72,1,2,112,2,28,261720,28,112,0,0,0,0,0
0.616,6,21,5921,11,108,61,147,879,10,927,63,1608,5042
3.137,6,6,328,4,0,1045,0,216,2,0,3078,0,112
1740.562,17,30,31680,30,1028,60019,1028,31680,0,0,0,0,0
1786.258,6,132,20525,83,202,21783,1290,11406,49,174,37211,2642,9119
3.194,17,37,16073,16,401,210,1350,6869,21,410,158,1350,9204
286.546,6,37,11449,15,143,20467,267,1466,22,606,13625,1400,9983
49.593,6,2579,2231563,1631,1289,30,1368,2177603,948,776,52,1473,53960
0.082,17,2,362,1,46,0,46,74,1,260,0,260,288
1798.774,17,449,39928,404,35,4463,288,25708,45,288,40021,288,14220
1755.884,6,94,7151,62,38,28784,205,4424,32,33,56630,98,2727
0.106,6,10,1669,6,551,21,947,1346,4,159,35,159,323
221.388,17,3,1022,3,312,110694,322,1022,0,0,0,0,0
1799.42,6,229,20154,85,82,21421,375,9234,144,70,12581,1062,10920
1.854,6,58,22850,29,982,66,1440,16914,29,433,59,1440,5936
1791.439,6,356,22658,206,69,8738,69,12380,150,69,12022,69,10278
1799.701,17,450,39960,405,35,4454,288,25740,45,288,40016,288,14220
286.216,17,4,288,2,36,286215,36,128,2,52,286216,52,160
300.743,6,38,8414,20,277,15828,761,1940,18,441,503,1460,6474
1681.218,1,15,840,15,28,120087,28,840,0,0,0,0,0
1798.262,1,342,28728,342,56,5273,56,28728,0,0,0,0,0
102.612,6,25,8319,13,419,65,955,1858,12,746,9315,4080,6461
1772.082,6,182,15629,121,69,14767,69,8980,61,69,29532,69,6649
174.696,17,5,380,5,48,43674,48,380,0,0,0,0,0
0.997,17,2,685,1,308,0,308,336,1,321,0,321,349
0.128,6,3,132,2,0,33,0,92,1,0,0,0,40
298.176,6,43,10938,20,158,15693,267,1601,23,646,13549,1400,9337
0.019,6,4,208,2,0,9,0,104,2,0,11,0,104
0.783,17,2,685,1,308,0,308,336,1,321,0,321,349
5.096,17,2,130,2,37,5096,37,130,0,0,0,0,0
1.052,6,24,6408,13,297,87,830,2011,11,988,104,1731,4397
1783.26,17,83,3480,82,14,22015,14,3444,1,8,0,8,36
1798.106,17,445,39232,401,35,4495,288,25328,44,288,40948,288,13904
0.828,6,27,13663,17,827,51,1360,6505,10,1349,70,4445,7158
216.162,6,167,26917,90,304,2428,304,19132,77,83,2834,83,7785
1799.754,17,764,46153,764,32,2358,37,46153,0,0,0,0,0
1772.324,6,180,15480,120,69,14893,69,8940,60,69,30038,69,6540
259.926,17,4,240,2,32,259925,32,120,2,32,259924,32,120
81.835,17,4,240,2,32,81834,32,120,2,32,81834,32,120
0.007,17,2,574,1,33,0,33,61,1,485,0,485,513
1680.904,2,15,480,15,8,120064,8,480,0,0,0,0,0
11.366,6,1029,944570,659,1356,16,1368,917386,370,776,30,1473,27184
2.354,17,2,179,1,43,0,43,71,1,80,0,80,108
1785.859,6,378,26697,217,103,8267,469,15841,161,69,11161,69,10856
25.123,6,8,506,8,31,3589,31,506,0,0,0,0,0
1770.121,1,58,4872,58,56,31054,56,4872,0,0,0,0,0
0.258,17,3,234,2,39,178,39,134,1,72,0,72,100
0.494,6,50,21976,28,1045,18,1380,16854,22,421,20,1923,5122
1.39,6,48,19423,26,906,55,1440,13767,22,433,57,1440,5656
30.583,17,18,2764,9,48,3821,48,684,9,203,3821,308,2080
1781.656,17,258,56492,258,190,6932,422,56492,0,0,0,0,0
240.248,6,53,17460,28,771,8897,1402,14575,25,197,10010,580,2885
418.846,6,52,8502,27,117,13610,516,2494,25,238,17447,1452,6008
31.825,6,9,396,2,0,3387,0,88,7,0,5289,0,308
0.052,17,2,239,1,59,0,59,87,1,124,0,124,152
226.919,17,6,1976,6,301,45383,308,1976,0,0,0,0,0
1776.122,17,73,3060,72,14,25015,14,3024,1,8,0,8,36
0.061,17,2,180,1,30,0,30,58,1,94,0,94,122
0.437,6,2,80,1,0,0,0,40,1,0,0,0,40
0.888,6,51,13813,24,549,38,1429,4824,27,464,32,1986,8989
2.799,17,4,624,4,128,933,128,624,0,0,0,0,0
147.577,6,697,444271,375,1248,394,1448,316586,322,827,459,2514,127685
1792.517,6,375,23694,214,69,8415,69,13114,161,69,11202,69,10580
5.104,17,3,208,2,36,5005,36,128,1,52,0,52,80
0.152,17,2,210,1,53,0,53,81,1,101,0,101,129
147.336,17,4,352,2,60,147335,60,176,2,60,147334,60,176
323.562,1,6,714,6,91,64712,105,714,0,0,0,0,0
0.003,6,3,120,3,0,0,0,120,0,0,0,0,0
76.022,6,16,9280,5,174,18982,174,378,11,1408,7593,1452,8902
14.78,1,8,448,8,28,2111,28,448,0,0,0,0,0
10.11,6,82,24789,41,560,252,1152,19008,41,459,245,1179,5781
0.798,6,129,88153,60,131,13,232,2929,69,1308,11,1420,85224
372.218,6,25,1651,17,177,23263,177,1117,8,110,9258,110,534
1759.64,6,101,7980,65,45,27494,205,4850,36,34,50268,98,3130
0.035,6,43,62704,42,1440,0,1440,62664,1,0,0,0,40
66.502,6,23,10128,13,549,47,1360,2749,10,1393,7376,3934,7379
65.861,17,4,352,2,60,65860,60,176,2,60,65860,60,176
1789.875,17,142,11360,71,48,25568,48,5396,71,56,25568,56,5964
1775.447,1,58,4872,58,56,31148,56,4872,0,0,0,0,0
150.484,17,7,2054,7,265,25080,377,2054,0,0,0,0,0
8.89,17,2,1430,2,687,8890,687,1430,0,0,0,0,0
1747.262,6,97,7307,62,38,28643,205,4424,35,33,51380,98,2883
0.901,17,4,368,2,64,899,64,184,2,64,900,64,184
1796.43,17,448,39896,403,35,4468,288,25676,45,288,40015,288,14220
1777.917,17,140,11200,70,48,25766,48,5320,70,56,25766,56,5880
0.019,17,2,306,1,33,0,33,61,1,217,0,217,245
1776.277,1,58,4872,58,56,31162,56,4872,0,0,0,0,0
314.118,6,22,1876,14,70,24162,205,1141,8,39,44845,98,735
2.64,6,3,156,3,0,0,0,156,0,0,0,0,0
15.494,17,21,15938,12,1007,1402,1350,12427,9,362,1928,1350,3511
20.882,6,14,1025,7,222,3479,222,506,7,231,3479,231,519
0.273,6,28,9152,13,252,22,647,1716,15,831,19,1408,7436
0.228,17,2,136,1,32,0,32,60,1,48,0,48,76
1.236,6,25,8056,12,164,96,267,1288,13,869,88,1440,6768
1772.076,6,180,15480,120,69,14891,69,8940,60,69,30034,69,6540
169.488,17,34,4244,34,96,5136,355,4244,0,0,0,0,0
280.215,6,30,7432,13,158,23351,267,1317,17,543,17511,1400,6115
1796.474,6,357,22629,209,69,8636,69,12569,148,69,12220,69,10060
69.545,6,25,9789,12,531,67,1460,2637,13,945,5783,1460,7152
280.718,6,29,7733,13,158,23393,267,1317,16,641,18711,2045,6416
1729.245,6,60,4400,40,33,44339,33,2740,20,31,91003,31,1660
10.569,6,33,13745,18,624,621,1360,6371,15,1125,744,2720,7374
19.031,6,41,8591,20,175,992,721,2205,21,503,942,2840,6386
8.969,6,88,28306,45,563,203,1152,22088,43,449,207,1179,6218
2.708,6,2,88,2,0,0,0,88,0,0,0,0,0
0.484,6,4,220,2,0,484,0,104,2,0,264,0,116
1.427,6,54,21414,30,959,49,1460,15633,24,400,54,1460,5781
83.321,17,34,10436,14,356,6409,1350,5387,20,224,4383,1350,5049
386.163,6,19,1306,14,180,29704,180,928,5,110,15177,110,378
1.325,6,540,727470,95,536,14,1396,7092,445,1581,2,6980,720378
3.069,6,17,3321,6,92,613,92,400,11,463,286,1408,2921
71.232,6,35,8214,17,334,553,688,1740,18,478,4179,2128,6474
0.958,17,2,152,2,48,958,48,152,0,0,0,0,0
240.193,6,53,18069,28,811,8895,1408,15264,25,187,10007,580,2805
1.556,6,40,11933,22,613,74,1360,6437,18,476,80,2715,5496
20.354,6,2175,2073283,1365,1440,14,1448,2025923,810,776,24,1448,47360
2.413,17,4,288,2,36,2389,36,128,2,52,2397,52,160
1787.337,6,372,24981,215,87,8352,469,14285,157,69,11454,69,10696
1791.03,1,262,14672,262,28,6862,28,14672,0,0,0,0,0
11.761,6,1869,1626121,1134,1380,10,1420,1592500,735,467,16,1883,33621
1786.039,6,150,24780,90,483,20067,483,19170,60,83,30271,83,5610
1782.144,17,83,3480,82,14,22001,14,3444,1,8,0,8,36
1.924,17,3,174,3,30,962,30,174,0,0,0,0,0
7.272,6,37,7205,19,218,404,314,3383,18,516,412,1179,3822
1749.982,1,57,4788,57,56,31249,56,4788,0,0,0,0,0
1771.441,6,103,9514,66,66,27252,66,5610,37,60,49204,60,3904
5.008,17,4,558,2,36,4996,36,128,2,187,4996,187,430
15.301,6,113,36684,57,615,273,1152,29962,56,447,273,1179,6722
300.598,6,51,9323,26,308,12023,889,2415,25,327,595,1360,6908
421.136,2,5,160,5,8,105284,8,160,0,0,0,0,0
1770.446,6,99,9240,66,65,27237,65,5577,33,59,55323,59,3663
1751.704,6,186,11385,93,47,19040,208,6766,93,31,19037,31,4619
125.297,17,4,352,2,60,125296,60,176,2,60,125296,60,176
1772.674,6,182,15629,121,69,14772,69,8980,61,69,29536,69,6649
1769.239,6,102,9643,68,68,26406,232,5880,34,58,53609,81,3763
1741.699,17,30,7050,30,207,60058,207,7050,0,0,0,0,0
1789.956,6,360,24156,210,88,8564,469,13878,150,69,12013,69,10278
4.293,6,39,7269,19,218,238,314,3383,20,513,212,1179,3886
368.371,6,7,508,5,106,92090,106,420,2,0,368360,0,88
280.549,6,27,7312,12,158,25504,267,1277,15,678,20031,2760,6035
1789.168,17,83,3480,82,14,22088,14,3444,1,8,0,8,36
0.463,6,9,1002,5,213,115,213,417,4,421,151,421,585
64.462,6,21,7537,12,318,5845,721,1758,9,1805,8035,2840,5779
12.506,6,11,3410,5,75,3126,75,331,6,1373,2431,1448,3079
257.035,6,31,6806,13,189,9775,516,1470,18,307,15114,1452,5336
122.373,17,4,240,2,32,122372,32,120,2,32,122372,32,120
49.051,6,20,828,10,0,5445,0,408,10,0,5444,0,420
0.269,17,2,198,1,63,0,63,91,1,79,0,79,107
0.479,6,28,9199,13,263,39,688,1736,15,832,32,1368,7463
3.991,17,8,747,4,32,1326,32,240,4,98,1327,107,507
300.637,6,37,8408,19,286,16702,797,1936,18,478,499,2128,6472
1756.923,6,2069,2036026,695,149,2531,909,46900,1374,1471,1279,5672,1989126
1786.899,6,106,8524,68,66,26670,66,4964,38,60,48291,60,3560
1798.577,6,118,9732,74,57,24638,205,5920,44,38,41817,98,3812
0.777,6,120,87456,55,131,14,232,2729,65,1368,11,2860,84727
317.033,6,73,19562,38,337,8568,1360,9997,35,370,9320,2720,9565
1.343,6,41,11964,22,612,63,1460,6428,19,433,64,1460,5536
68.897,17,4,240,2,32,68896,32,120,2,32,68896,32,120
1793.559,6,184,17079,122,83,14822,965,9985,62,74,29399,405,7094
11.441,6,1815,1581077,1097,1387,10,1420,1548136,718,467,15,1883,32941
168.32,17,2,128,2,36,168320,36,128,0,0,0,0,0
3.498,17,10,2370,5,30,871,30,290,5,388,871,468,2080
1775.049,17,140,11200,70,48,25725,48,5320,70,56,25725,56,5880
73.324,17,20,1760,10,48,8146,48,760,10,72,8145,72,1000
1756.355,6,108,6465,61,27,29271,27,3604,47,27,38180,27,2861
0.034,17,2,180,1,30,0,30,58,1,94,0,94,122
31.352,6,8,348,2,0,15,0,84,6,0,6269,0,264
0.006,17,2,223,1,36,0,36,64,1,131,0,131,159
704.922,6,123,8906,60,86,11923,86,3314,63,39,11369,63,5592
1.651,6,25,8702,15,274,117,556,1428,10,981,164,1420,7274
178.312,6,27,13365,16,493,37,1360,2647,11,1711,17819,3928,10718
1.347,6,50,18806,27,857,51,1360,13110,23,433,53,1360,5696
1777.211,17,140,11200,70,48,25756,48,5320,70,56,25756,56,5880
0.442,17,8,2758,8,316,63,355,2758,0,0,0,0,0
1.695,6,25,8701,15,274,121,556,1428,10,981,168,1420,7273
1773.817,1,83,6972,83,56,21631,56,6972,0,0,0,0,0
1763.963,2,15,480,15,8,125997,8,480,0,0,0,0,0
300.618,6,43,8833,22,315,14315,882,2209,21,412,467,1440,6624
1777.72,17,142,11360,71,48,25395,48,5396,71,56,25394,56,5964
1794.633,6,359,22778,209,69,8628,69,12500,150,69,12044,69,10278
737.109,17,6,2314,6,357,147421,1316,2314,0,0,0,0,0
0.192,6,9,527,5,43,48,43,311,4,0,30,0,216
0.862,6,37,8351,19,271,47,739,1878,18,441,42,1460,6473
1734.853,17,17,5622,17,302,108428,1451,5622,0,0,0,0,0
247.286,6,28,7352,13,158,20607,267,1317,15,678,17660,4200,6035
0.001,17,2,552,2,248,1,248,552,0,0,0,0,0
40.218,17,44,6468,22,48,1914,48,1672,22,190,1914,308,4796
0.968,17,2,178,1,29,0,29,57,1,93,0,93,121
301.161,6,49,22075,27,544,11583,1114,4144,22,987,2959,1578,17931
1799.99,17,177,26373,177,121,10227,121,26373,0,0,0,0,0
56.8,6,21,4589,11,271,5680,515,1259,10,487,6295,1452,3330
37.421,2,2,64,2,8,37421,8,64,0,0,0,0,0
372.755,6,17,1190,13,180,31062,180,864,4,110,20107,110,326
1799.999,6,424,28298,201,46,8854,46,12156,223,46,8108,46,16142
41.722,1,8,448,8,28,5960,28,448,0,0,0,0,0
280.497,6,28,7352,13,158,23374,267,1317,15,678,20030,3536,6035
122.262,6,32,7648,11,155,100,267,1226,21,348,6112,1460,6422
1.14,6,37,14030,20,541,60,1440,3589,17,886,58,1587,10441
125.675,2,2,64,2,8,125675,8,64,0,0,0,0,0
86.116,6,35,14383,18,681,225,1194,3551,17,844,5371,1631,10832
1781.95,6,466,26920,259,69,6906,69,14500,207,34,8650,64,12420
0.649,17,2,152,1,48,0,48,76,1,48,0,48,76
1772.387,6,102,7970,66,45,27267,205,4902,36,35,50627,98,3068
280.485,6,27,7312,13,158,23373,267,1317,14,775,21572,4836,5995
0.062,17,2,148,1,32,0,32,60,1,60,0,60,88
47.522,6,37,8495,18,410,509,882,1982,19,441,2633,1460,6513
1681.734,2,23,736,23,8,76442,8,736,0,0,0,0,0
1790.039,17,144,11520,72,48,25211,48,5472,72,56,25211,56,6048
1798.336,17,766,46192,766,32,2350,37,46192,0,0,0,0,0
171.392,17,6,456,6,48,34278,48,456,0,0,0,0,0
32.515,6,16,4396,7,256,5419,722,1396,9,503,2563,1448,3000
3.763,17,4,304,3,32,1865,32,180,1,96,0,96,124
1781.763,6,437,26399,217,69,8248,69,13027,220,36,8135,69,13372
1.318,6,25,8056,12,164,102,267,1288,13,869,93,1408,6768
1793.082,17,179,13962,179,50,10073,50,13962,0,0,0,0,0
0.909,6,31,13360,17,511,56,1360,3279,14,1056,57,2561,10081
59.924,6,44,8810,23,345,698,720,2047,21,394,2989,4848,6763
1783.984,6,112,6656,63,26,28772,26,3692,49,26,37164,26,2964
8.632,6,38,7229,20,218,454,314,3423,18,513,491,1179,3806
1760.073,1,20,1120,20,28,92635,28,1120,0,0,0,0,0
28.845,6,46,13953,22,289,1373,721,3491,24,730,1209,1414,10462
0.208,6,15,4875,9,290,26,517,1057,6,1166,37,1500,3818
0.179,17,2,182,1,34,0,34,62,1,92,0,92,120
0.926,6,7,295,4,0,308,0,164,3,7,105,7,131
1799.597,17,449,39928,404,35,4465,288,25708,45,288,40020,288,14220
0.004,6,2,453,1,361,0,361,413,1,0,0,0,40
0.071,6,9,1343,5,145,17,145,349,4,830,17,830,994
42.253,6,9,508,4,0,14084,0,216,5,0,10538,0,292
0.277,6,23,6012,12,181,25,537,1526,11,781,26,2224,4486
1771.536,17,350,57328,350,135,5076,391,57328,0,0,0,0,0
1680.555,1,15,840,15,28,120039,28,840,0,0,0,0,0
15.992,17,15,6639,8,539,2276,1350,4539,7,272,2655,1350,2100
21.595,17,2,642,1,300,0,300,328,1,286,0,286,314
1778.084,1,69,5796,69,56,26148,56,5796,0,0,0,0,0
1764.169,6,27,4077,18,241,103774,241,2889,9,92,220496,92,1188
8.23,17,4,352,2,60,8229,60,176,2,60,8227,60,176
3.591,17,4,240,4,32,1197,32,240,0,0,0,0,0
0.078,17,2,279,1,36,0,36,64,1,187,0,187,215
33.624,6,32,5347,15,154,2401,722,1859,17,325,2090,1402,3488
240.125,6,39,4765,20,181,12637,517,2139,19,203,13340,851,2626
0.103,17,4,284,2,32,13,32,120,2,54,92,60,164
0.113,17,2,279,1,36,0,36,64,1,187,0,187,215
154.148,6,48,9404,20,117,8112,267,1862,28,291,5708,1452,7542
36.005,17,81,52411,47,980,781,1350,47398,34,119,1087,1350,5013
0.019,17,2,211,1,45,0,45,73,1,110,0,110,138
1795.936,17,446,39548,402,35,4478,288,25644,44,288,40948,288,13904
0.435,6,49,20333,27,1007,16,1380,15211,22,421,18,1923,5122
1772.324,6,180,15480,120,69,14893,69,8940,60,69,30037,69,6540
1.466,6,24,8004,12,164,114,267,1288,12,1014,112,2896,6716
0.403,17,3,1167,3,361,201,361,1167,0,0,0,0,0
36.702,6,45,10676,22,769,649,1360,4830,23,327,1661,2667,5846
56.29,6,11,1583,11,127,5629,127,1583,0,0,0,0,0
10.752,6,1702,1485841,1029,1391,10,1420,1454700,673,467,15,1883,31141
0.01,17,36,5880,18,39,0,44,1212,18,231,0,345,4668
1759.222,6,99,7411,63,38,28374,205,4476,36,33,50252,98,2935
1681.763,17,16,1265,8,30,240219,37,471,8,71,240249,136,794
1.15,6,24,8004,11,164,97,267,1236,13,869,81,1440,6768
1795.12,17,65,2724,64,14,28493,14,2688,1,8,0,8,36
3.047,17,4,1552,4,360,1015,360,1552,0,0,0,0,0
4.741,6,7,400,3,0,2370,0,160,4,0,1010,0,240
26.86,6,16,4240,4,854,8950,1114,1924,12,212,2440,212,2316
147.262,6,36,12478,19,565,338,1311,4218,17,756,9194,1546,8260
280.243,6,29,7392,14,158,21557,267,1357,15,678,20011,3436,6035
1.341,6,36,8172,19,320,74,1162,2716,17,529,72,4075,5456
14.042,6,26,4814,13,154,1147,721,1765,13,473,1152,1368,3049
4.069,17,10,8588,4,708,1356,1350,2945,6,912,296,1350,5643
240.274,6,45,9223,23,523,10921,1408,5926,22,214,11441,619,3297
1795.007,6,356,22520,208,69,8671,69,12460,148,69,12210,69,10060
26.01,6,34,8251,16,175,1734,721,2047,18,685,1506,2840,6204
24.009,6,1423,1254602,917,1293,25,1368,1223626,506,776,47,1473,30976
0.547,17,2,384,1,39,0,39,67,1,289,0,289,317
1771.277,6,101,9410,66,66,27250,66,5610,35,60,52093,60,3800
841.24,17,12,969,6,31,168239,37,355,6,74,168241,136,614
65.076,2,3,96,3,8,32538,8,96,0,0,0,0,0
0.109,6,9,1002,5,213,27,213,417,4,421,31,421,585
1.348,6,38,9848,20,502,70,1460,4352,18,433,67,1460,5496
1.447,17,4,240,2,32,1446,32,120,2,32,1446,32,120
3.788,17,10,2606,5,30,945,30,290,5,435,945,484,2316
5.999,6,43,8345,22,227,285,314,4062,21,491,286,1179,4283
1795.082,17,448,39896,403,35,4465,288,25676,45,288,40018,288,14220
0.531,6,10,968,5,256,129,256,460,5,304,129,304,508
93.488,6,74,49897,46,1191,2077,1368,41704,28,841,2294,2736,8193
1785.419,6,358,23635,207,69,8667,69,12834,151,69,11902,69,10801
300.119,6,38,10049,21,615,14997,1360,4567,17,479,18746,4027,5482
1099.424,6,101,11321,54,80,20740,722,4752,47,111,23896,2026,6569
1786.805,6,104,8376,68,65,26668,65,4930,36,59,51049,59,3446
280.414,6,28,7352,13,158,23367,267,1317,15,603,20025,2760,6035
0.989,17,2,134,2,39,989,39,134,0,0,0,0,0
133.345,6,122,90099,76,1259,1777,1408,79583,46,676,1635,1408,10516
240.759,6,44,9062,22,519,11464,1402,5839,22,230,11464,619,3223
1732.316,1,93,5208,93,28,18829,28,5208,0,0,0,0,0
142.94,17,8,2688,8,308,20420,308,2688,0,0,0,0,0
120.371,2,2,64,2,8,120371,8,64,0,0,0,0,0
280.293,6,28,7352,12,158,25481,267,1277,16,603,18681,1400,6075
1.41,6,38,9848,21,440,70,1360,4392,17,476,76,2715,5456
1787.162,6,108,8536,68,65,26674,65,4930,40,59,45822,59,3606
440.664,17,25,1900,25,48,18361,48,1900,0,0,0,0,0
128.82,6,23,9968,11,408,56,884,1697,12,972,11699,1460,8271
0.014,17,3,704,2,60,11,60,176,1,500,0,500,528
0.58,6,10,957,5,191,100,259,583,5,58,99,110,374
7.061,6,65,20070,34,539,213,1152,15403,31,489,226,1179,4667
0.286,17,2,180,1,30,0,30,58,1,94,0,94,122
12.015,17,10,620,10,34,1335,34,620,0,0,0,0,0
3.98,17,5,514,4,32,1322,32,240,1,246,0,246,274
1787.8,6,358,22669,209,69,8595,69,12500,149,69,12079,69,10169
3.783,6,103,101731,46,140,82,230,3253,57,1872,66,5472,98478
61.939,6,75,52267,46,1224,1376,1448,44033,29,746,2202,1448,8234
1642.007,1,7,742,7,78,273667,78,742,0,0,0,0,0
0.022,17,3,1007,1,137,0,137,165,2,393,22,393,842
324.888,1,6,636,6,78,64977,78,636,0,0,0,0,0
30.926,17,61,46211,22,341,1472,1350,8136,39,948,769,1350,38075
280.372,6,28,7352,12,158,25488,267,1277,16,603,18683,1400,6075
0.339,17,2,180,1,30,0,30,58,1,94,0,94,122
630.331,2,4,128,4,8,210110,8,128,0,0,0,0,0
135.494,17,2,120,2,32,135494,32,120,0,0,0,0,0
289.158,6,56,7343,27,129,11116,722,2965,29,151,10320,1408,4378
1799.963,6,463,39080,226,69,7998,724,15543,237,85,7626,1360,23537
0.867,17,20,5992,8,280,123,1350,2469,12,265,71,1350,3523
1682.689,17,14,1036,7,30,280435,30,406,7,62,280439,62,630
1780.113,17,140,11200,70,48,25798,48,5320,70,56,25798,56,5880
5.012,17,4,558,2,36,5002,36,128,2,187,5002,187,430
1741.347,6,95,6867,61,31,29022,31,4145,34,31,52767,31,2722
280.063,6,27,7312,13,158,23338,267,1317,14,775,21538,4836,5995
11.715,6,95,29807,48,581,249,1152,23429,47,449,248,1179,6378
6.458,6,44,8369,23,227,293,314,4102,21,489,309,1179,4267
3.686,6,5,415,0,0,0,0,0,5,31,921,31,415
20.521,17,3,228,3,48,10260,48,228,0,0,0,0,0
182.227,17,4,352,2,60,182226,60,176,2,60,182226,60,176
280.254,6,28,7352,13,158,23354,267,1317,15,678,20012,2800,6035
63.169,6,7,420,7,0,0,0,420,0,0,0,0,0
17.663,17,23,13659,13,856,1469,1350,11501,10,187,1958,1350,2158
0.925,6,29,8500,15,222,55,540,1964,14,994,57,1791,6536
1.58,6,48,19055,26,948,63,1460,13399,22,433,65,1460,5656
1795.549,6,368,23276,212,69,8509,69,12896,156,69,11583,69,10380
1797.541,1,58,4872,58,56,31535,56,4872,0,0,0,0,0
1798.888,17,142,11360,71,48,25698,48,5396,71,56,25698,56,5964
11.1,6,25,8531,9,154,1387,267,832,16,640,676,1917,7699
70.624,6,24,9959,13,410,63,922,1830,11,1096,7048,3056,8129
0.079,17,2,672,2,308,79,332,672,0,0,0,0,0
44.938,6,43,8517,20,333,1635,685,1844,23,521,2036,3488,6673
1744.874,6,108,7844,68,31,26042,31,4650,40,31,44740,31,3194
1.562,17,18,10611,9,881,194,1350,8181,9,242,189,1350,2430
2.645,17,25,7473,12,272,237,1350,3610,13,269,217,1350,3863
1681.584,17,12,498,11,14,168158,14,462,1,8,0,8,36
141.411,17,4,352,2,60,141410,60,176,2,60,141410,60,176
4.832,6,39,7269,20,218,254,314,3423,19,440,254,1152,3846
340.399,17,8,2688,8,308,48628,308,2688,0,0,0,0,0
280.232,6,27,7312,12,158,25475,267,1277,15,678,20013,2045,6035
21.592,6,1825,1656865,1088,1437,19,1448,1610717,737,776,28,1448,46148
111.126,6,46,10797,20,239,734,721,4154,26,621,4437,1440,6643
1786.762,17,140,11200,70,48,25894,48,5320,70,56,25894,56,5880
113.626,6,157,24430,87,304,1321,304,17152,70,83,1646,83,7278
280.493,6,30,7432,13,158,23374,267,1317,17,603,17527,2076,6115
91.997,6,24,1739,17,43,5738,43,1339,7,0,15332,0,400
31.514,6,7,336,1,0,0,0,48,6,0,6290,0,288
0.002,17,2,182,1,39,0,39,67,1,87,0,87,115
3.046,6,2,88,2,0,0,0,88,0,0,0,0,0
1.935,6,20,3833,11,234,193,564,1504,9,463,218,1343,2329
371.411,6,23,1535,16,177,24760,177,1053,7,110,10383,110,482
15.147,17,26,13355,12,619,1376,1350,7764,14,371,1162,1350,5591
124.386,17,6,1984,6,302,24877,308,1984,0,0,0,0,0
1764.031,2,15,480,15,8,126002,8,480,0,0,0,0,0
161.57,6,25,1020,9,0,6903,0,364,16,0,10770,0,656
26.776,17,7,532,7,48,4462,48,532,0,0,0,0,0
1783.193,1,103,5768,103,28,17482,28,5768,0,0,0,0,0
1.492,6,13,2311,8,188,213,245,700,5,1407,312,1407,1611
1.946,17,6,552,3,32,972,32,180,3,96,951,96,372
61.81,6,74,48323,44,1178,1437,1408,40028,30,840,2124,2439,8295
44.219,17,19,10692,10,662,4913,1350,6908,9,392,1893,1350,3784
1.006,6,27,8463,14,270,63,561,1945,13,997,68,2720,6518
0.429,1,2,112,2,28,429,28,112,0,0,0,0,0
1175.221,6,138,16973,81,79,13143,267,6441,57,158,20985,2840,10532
1745.514,6,95,7203,63,38,28153,205,4476,32,33,56298,98,2727
1680.586,1,15,840,15,28,120041,28,840,0,0,0,0,0
0.065,17,4,284,2,32,28,32,120,2,54,38,60,164
73.653,6,13,540,6,0,2130,0,244,7,0,12273,0,296
280.889,6,30,7773,13,158,23407,267,1317,17,577,17539,1400,6456
0.646,17,2,677,1,300,0,300,328,1,321,0,321,349
1741.62,17,28,29604,28,1029,64504,1064,29604,0,0,0,0,0
0.006,17,2,344,1,35,0,35,63,1,253,0,253,281
1771.133,1,58,4872,58,56,31072,56,4872,0,0,0,0,0
0.288,6,26,9041,13,261,24,683,1752,13,943,23,1408,7289
143.717,6,21,4203,6,92,229,92,436,15,248,10250,2026,3767
1795.201,6,356,22520,208,69,8672,69,12460,148,69,12212,69,10060
0.017,6,2,80,1,0,0,0,40,1,0,0,0,40
0.019,6,2,88,1,0,0,0,40,1,0,0,0,48
15.51,17,20,2940,10,48,1722,48,760,10,190,1722,308,2180
1343.289,6,338,20459,167,69,8092,69,9992,171,35,7901,69,10467
0.007,6,3,327,2,103,1,138,287,1,0,0,0,40
300.634,6,43,8845,21,315,15031,882,2181,22,412,491,1440,6664
0.495,6,122,87928,56,131,9,232,2769,66,1352,7,2860,85159
4.424,6,2,88,2,0,0,0,88,0,0,0,0,0
0.723,17,14,7289,7,665,120,1350,4856,7,319,111,1350,2433
1779.749,1,342,28728,342,56,5219,56,28728,0,0,0,0,0
1772.573,6,180,15480,120,69,14895,69,8940,60,69,30034,69,6540
123.258,17,28,5532,14,48,9480,48,1064,14,291,9480,308,4468
1681.65,17,12,498,11,14,168165,14,462,1,8,0,8,36
599.181,6,9,546,6,31,119836,31,333,3,31,299583,31,213
15.943,17,32,15007,17,676,992,1350,11973,15,174,1133,1350,3034
17.557,17,2,778,2,361,17557,361,778,0,0,0,0,0
0.048,17,4,284,2,32,3,32,120,2,54,39,60,164
1774.71,6,274,32705,111,132,16132,1460,15754,163,127,10954,1642,16951
86.579,6,34,15446,16,585,59,1440,3609,18,925,5084,1440,11837
1795.768,1,280,15680,280,28,6436,28,15680,0,0,0,0,0
11.254,6,1798,1539350,1086,1363,10,1380,1506628,712,383,15,1380,32722
0.259,6,7,380,4,0,86,0,216,3,0,107,0,164
0.37,6,360,383843,234,183,1,230,13369,126,2934,2,18304,370474
0.065,17,4,588,2,48,58,48,152,2,190,55,308,436
0.423,17,3,543,2,39,407,39,134,1,381,0,381,409
1799.855,17,448,39896,403,35,4477,288,25676,45,288,40016,288,14220
300.826,6,39,11417,22,717,14325,1360,5935,17,435,537,2667,5482
0.147,6,2,149,1,0,0,0,40,1,69,0,69,109
62.45,6,22,9377,12,372,82,808,1628,10,1222,6923,4416,7749
1770.533,1,58,4872,0,0,0,0,0,58,56,31061,56,4872
280.466,6,32,7512,13,158,23372,267,1317,19,543,15578,1380,6195
240.205,6,52,17561,27,774,9238,1402,14571,25,240,10008,580,2990
1.568,6,54,37093,33,1182,49,1408,30096,21,1179,68,3819,6997
27.962,6,3,168,2,0,21432,0,116,1,0,0,0,52
1791.162,17,144,11520,72,48,25227,48,5472,72,56,25227,56,6048
5.707,6,10,6098,4,275,1902,275,439,6,1353,1098,1380,5659
1.71,6,13,2311,8,188,244,245,700,5,1407,362,1407,1611
11.314,6,3,256,1,0,0,0,40,2,56,5760,56,216
1.361,6,42,10020,21,440,68,1360,4404,21,433,57,1360,5616
1786.629,6,105,8550,69,66,26273,66,5070,36,60,51043,60,3480
114.282,6,40,5963,15,165,1255,722,1970,25,168,4754,1408,3993
1.772,6,13,2311,8,188,253,245,700,5,1407,375,1407,1611
1783.813,6,362,22898,210,69,8534,69,12678,152,69,11813,69,10220
1787.678,6,102,8296,68,65,26681,65,4930,34,59,54169,59,3366
1465.299,1,87,4872,87,28,17038,28,4872,0,0,0,0,0
1794.424,6,243,36050,151,302,11962,302,26274,92,83,19718,83,9776
15.589,1,20,2080,0,0,0,0,0,20,76,820,76,2080
1776.087,17,140,11200,70,48,25740,48,5320,70,56,25740,56,5880
280.371,6,30,7432,13,158,23364,267,1317,17,543,17522,1400,6115
1.089,6,30,12084,16,525,72,1360,3310,14,820,68,1380,8774
1798.112,6,356,22520,208,69,8686,69,12460,148,69,12231,69,10060
315.87,6,142,37976,69,463,4645,1360,25567,73,225,4384,4649,12409
74.996,6,11,704,5,92,18749,92,360,6,0,5416,0,344
0.505,6,51,21617,28,1020,18,1380,16455,23,421,20,1923,5162
5.653,6,41,7365,21,218,282,314,3463,20,516,284,1179,3902
0.392,6,12,1653,6,288,77,288,548,6,426,44,434,1105
0.176,6,26,7256,13,155,14,267,1301,13,678,13,3436,5955
1777.712,17,79,3312,78,14,23087,14,3276,1,8,0,8,36
0.443,6,13,1693,6,288,88,288,548,7,426,41,434,1145
902.384,2,10,320,10,8,100264,8,320,0,0,0,0,0
1799.331,17,770,46508,770,32,2339,37,46508,0,0,0,0,0
26.75,6,36,8360,18,378,509,786,1886,18,478,1565,2128,6474
115.009,6,124,92746,77,1260,1513,1368,82173,47,738,2494,2736,10573
3.409,17,4,352,2,60,3408,60,176,2,60,3408,60,176
1.193,6,13,1203,7,222,196,222,728,6,231,236,231,475
0.082,1,2,112,2,28,82,28,112,0,0,0,0,0
300.797,6,41,10092,23,593,13672,1360,4525,18,402,507,2667,5567
1771.914,6,99,9240,66,65,27260,65,5577,33,59,55368,59,3663
15.679,6,41,14129,21,295,783,569,1757,20,770,458,2720,12372
0.236,17,2,1920,2,932,236,932,1920,0,0,0,0,0
1795.01,1,278,15568,278,28,6480,28,15568,0,0,0,0,0
291.482,6,6,364,4,31,97160,31,222,2,31,291470,31,142
1795.798,6,467,58239,264,242,6828,1189,31912,203,158,8888,453,26327
1.462,6,48,18880,26,934,58,1460,13224,22,476,60,2615,5656
0.145,6,7,423,4,43,35,43,259,3,0,22,0,164
1793.3,1,56,4704,0,0,0,0,0,56,56,32605,56,4704
0.015,17,2,218,1,65,0,65,93,1,97,0,97,125
16.346,6,2614,2452971,1690,1373,9,1408,2400235,924,931,17,2816,52736
1.297,6,49,20874,28,940,48,1460,15258,21,433,56,1460,5616
1800.0,6,217,15066,80,46,22338,46,6228,137,46,13235,46,8838
1752.315,1,8,448,8,28,250330,28,448,0,0,0,0,0
249.153,17,4,240,2,32,249152,32,120,2,32,249152,32,120
65.11,1,4,426,4,78,21703,81,426,0,0,0,0,0
111.425,6,29,7392,13,158,9285,267,1317,16,603,7425,2036,6075
11.757,6,1856,1624939,1136,1377,10,1420,1591918,720,467,16,1883,33021
0.023,17,2,437,1,40,0,40,68,1,341,0,341,369
20.331,6,65,20166,34,565,616,1152,15499,31,489,669,1179,4667
32.105,6,29,13633,8,154,4586,267,792,21,749,1599,1420,12841
107.753,17,4,352,2,60,107752,60,176,2,60,107752,60,176
60.374,6,13,3831,7,407,10062,722,1186,6,1164,12037,1408,2645
0.043,6,10,1852,6,108,8,108,428,4,1208,6,1208,1424
1748.975,6,97,7307,63,38,28209,205,4476,34,33,52992,98,2831
0.459,17,22,13143,11,574,45,1350,6628,11,564,40,1350,6515
10.985,6,20,5694,11,275,1098,275,998,9,1440,750,1440,4696
2.965,6,51,31299,23,768,134,1440,6331,28,1254,104,1440,24968
32.892,17,4,1328,4,304,10964,308,1328,0,0,0,0,0
13.391,6,8,440,5,0,3347,0,268,3,0,6603,0,172
11.473,6,88,26653,44,548,266,1152,20411,44,447,260,1179,6242
1743.78,2,18,576,18,8,102575,8,576,0,0,0,0,0
0.82,17,2,162,1,45,0,45,73,1,61,0,61,89
280.023,6,27,7312,13,158,23335,267,1317,14,775,21538,4836,5995
481.277,2,3,96,3,8,240638,8,96,0,0,0,0,0
1.166,6,24,8004,12,164,90,267,1288,12,1014,89,2816,6716
0.026,17,2,198,1,37,0,37,65,1,105,0,105,133
1744.643,2,14,448,14,8,134203,8,448,0,0,0,0,0
20.798,6,220,116759,112,183,187,230,7761,108,975,193,4104,108998
1.526,6,46,18995,26,949,61,1460,13419,20,433,69,1460,5576
171.871,17,52,4700,44,38,3997,288,2912,8,195,23701,288,1788
1791.224,17,141,11276,71,48,25588,48,5396,70,56,25959,56,5880
240.197,6,53,17780,28,789,8895,1418,14891,25,197,10007,580,2889
1770.982,6,99,9240,66,65,27245,65,5577,33,59,55338,59,3663
0.008,6,3,175,2,31,1,31,135,1,0,0,0,40
1.312,17,4,401,3,31,653,31,177,1,196,0,196,224
199.798,17,4,240,2,32,199797,32,120,2,32,199797,32,120
158.603,6,23,3692,8,92,22657,92,504,15,200,11311,1408,3188
854.865,1,8,448,8,28,122123,28,448,0,0,0,0,0
7.725,17,36,9473,10,248,857,1350,2762,26,230,307,1350,6711
52.266,6,9,492,5,0,13066,0,268,4,0,17338,0,224
1793.518,6,183,15738,122,69,14822,69,9089,61,69,29889,69,6649
91.314,17,4,240,2,32,91313,32,120,2,32,91313,32,120
0.156,6,25,7216,13,155,13,267,1301,12,775,13,4836,5915
1795.602,6,108,8989,70,70,26021,274,5250,38,63,48527,247,3739
252.332,2,3,96,3,8,126166,8,96,0,0,0,0,0
112.602,6,5,293,4,31,37534,31,222,1,31,0,31,71
1741.381,17,30,31620,30,1026,60047,1026,31620,0,0,0,0,0
1262.864,6,250,15727,145,69,8769,69,8698,105,69,12122,69,7029
142.674,6,32,8952,14,158,10974,267,1357,18,624,8388,1400,7595
1785.856,6,354,22440,207,69,8669,69,12420,147,69,12231,69,10020
0.117,6,13,2076,7,329,19,500,1030,6,363,23,500,1046
4.222,6,12,879,6,186,829,186,506,6,45,841,45,373
1772.891,6,180,15480,120,69,14898,69,8940,60,69,30048,69,6540
0.204,17,2,304,1,60,0,60,88,1,188,0,188,216
149.167,17,4,256,4,36,49722,36,256,0,0,0,0,0
1.642,6,41,8431,21,321,82,1164,2810,20,400,75,1460,5621
94.393,6,916,421930,466,833,202,1152,398068,450,418,209,1179,23862
1785.054,6,437,77869,279,304,6421,304,57700,158,83,11369,83,20169
2.935,17,4,268,4,39,978,39,268,0,0,0,0,0
0.131,6,40,16869,23,1002,5,1420,11968,17,467,7,1883,4901
6.094,6,30,8443,13,155,507,267,1306,17,496,380,1420,7137
2.157,6,14,2351,8,188,308,245,700,6,703,378,1152,1651
0.056,6,10,1327,5,299,10,299,567,5,246,9,459,760
1771.389,6,99,9240,66,65,27252,65,5577,33,59,55353,59,3663
0.318,6,10,1669,6,551,63,947,1346,4,159,106,159,323
1741.291,17,30,20190,30,645,60044,645,20190,0,0,0,0,0
282.311,6,32,7719,12,158,25490,267,1277,20,469,14855,2760,6442
0.016,6,3,168,2,0,8,0,116,1,0,0,0,52
0.009,17,4,420,2,33,5,33,122,2,121,4,145,298
7.589,6,1864,1592724,1039,1438,7,1448,1538796,825,776,8,1448,53928
270.696,6,31,7472,13,158,22558,267,1317,18,543,15920,1380,6155
1216.026,6,226,30213,90,196,13663,1460,12914,136,118,9006,1460,17299
3.049,17,4,624,4,128,1016,128,624,0,0,0,0,0
0.485,6,95,92587,56,183,8,230,3637,39,2349,9,7040,88950
300.644,6,37,8301,19,258,16702,688,1827,18,441,499,1440,6474
0.667,6,30,10272,14,158,51,267,1357,16,919,43,2045,8915
121.888,6,11,584,2,0,286,0,112,9,0,15213,0,472
0.018,6,14,1104,9,181,2,181,681,5,77,3,134,423
1.772,6,26,6125,14,108,136,147,999,12,773,130,1608,5126
8.307,6,17,2425,9,211,1038,211,922,8,545,1186,904,1503
0.455,17,4,588,2,48,247,48,152,2,190,243,308,436
0.377,6,12,1653,6,288,74,288,548,6,426,41,434,1105
4.831,6,2,80,1,0,0,0,40,1,0,0,0,40
1.524,6,14,1371,7,186,253,186,930,7,45,253,45,441
1794.21,17,87,3648,86,14,21108,14,3612,1,8,0,8,36
10.76,6,20,4442,11,275,1076,275,998,9,768,760,1440,3444
0.122,6,10,1042,5,213,30,213,417,5,421,26,421,625
1754.415,6,186,16646,99,115,17902,264,11819,87,42,20394,224,4827
1.012,6,28,8460,15,222,63,540,1964,13,994,69,1791,6496
0.063,6,3,220,1,100,0,100,140,2,0,55,0,80
11.225,6,21,6825,12,275,1020,275,1038,9,1353,777,1440,5787
1782.41,17,265,62303,265,207,6751,422,62303,0,0,0,0,0
1.089,6,27,11905,16,522,72,1360,3282,11,1167,91,3921,8623
15.208,6,2666,2499708,1722,1373,8,1408,2445956,944,931,15,2816,53752
1743.223,6,95,7203,63,38,28116,205,4476,32,33,56225,98,2727
1680.281,17,12,498,11,14,168028,14,462,1,8,0,8,36
13.801,6,26,10030,15,651,985,1360,3236,11,1057,1360,2226,6794
1788.865,6,180,23811,101,304,17888,304,16548,79,83,22934,83,7263
3.199,17,2,782,2,363,3199,363,782,0,0,0,0,0
0.804,6,2,80,1,0,0,0,40,1,0,0,0,40
1794.177,17,144,11520,72,48,25268,48,5472,72,56,25270,56,6048
1797.531,1,58,4872,0,0,0,0,0,58,56,31535,56,4872
218.298,6,26,7475,11,181,21829,267,1168,15,570,15591,1400,6307
7.075,6,127,197067,81,133,88,201,3807,46,4557,153,23782,193260
0.446,6,7,371,4,0,148,0,204,3,7,102,7,167
0.074,6,2,99,1,0,0,0,40,1,7,0,7,59
1.97,6,9,527,5,43,492,43,311,4,0,619,0,216
842.275,2,11,352,11,8,84227,8,352,0,0,0,0,0
0.022,17,2,350,1,33,0,33,61,1,261,0,261,289
5.394,6,18,10630,8,275,770,275,599,10,1203,473,2840,10031
25.525,6,10,436,8,0,3646,0,348,2,0,22386,0,88
0.668,6,14,1745,7,288,78,288,600,7,426,78,434,1145
1796.593,17,449,39928,404,35,4458,288,25708,45,288,40019,288,14220
1.65,6,17,6337,10,141,183,275,686,7,1073,72,2840,5651
11.204,6,1774,1548519,1072,1391,10,1420,1516218,702,467,15,1883,32301
44.297,6,30,8588,10,625,149,1034,2441,20,364,2329,1368,6147
0.007,17,2,223,1,36,0,36,64,1,131,0,131,159
1799.831,17,448,39896,403,35,4477,288,25676,45,288,40017,288,14220
0.172,6,24,7176,12,155,15,267,1261,12,775,15,3445,5915
1772.241,6,180,15480,120,69,14892,69,8940,60,69,30034,69,6540
1786.423,6,102,8364,68,66,26663,66,4964,34,60,54131,60,3400
0.072,17,2,558,1,32,0,32,60,1,470,0,470,498
63.469,6,54,33669,34,1095,1923,1448,25877,20,843,3311,2359,7792
138.32,6,46,8558,18,131,8136,267,1782,28,332,5116,1420,6776
190.622,6,17,1337,14,33,14663,62,1088,3,31,95163,31,249
98.701,6,40,19001,22,702,53,1360,5127,18,1094,5795,2720,13874
1.505,6,26,6488,13,297,125,830,2011,13,790,123,1420,4477
14.254,6,24,6993,13,275,1187,275,1078,11,910,925,1440,5915
7.351,6,225,241054,166,133,44,201,7711,59,4199,123,14140,233343
0.411,17,19,13468,11,976,41,1350,11047,8,274,40,1350,2421
907.211,6,184,11638,106,69,8640,69,6379,78,69,11781,69,5259
239.933,17,11,836,11,48,23993,48,836,0,0,0,0,0
57.74,6,21,5692,12,266,5249,499,1283,9,674,7206,1420,4409
1755.733,6,95,7203,63,38,28318,205,4476,32,33,56624,98,2727
669.391,6,175,21251,85,179,7968,1189,9504,90,169,7521,1420,11747
0.071,17,4,588,2,48,66,48,152,2,190,66,308,436
0.608,17,11,4614,5,397,152,1350,2129,6,386,104,1350,2485
368.337,6,18,1242,14,180,28333,180,916,4,110,20065,110,326
251.992,2,3,96,3,8,125996,8,96,0,0,0,0,0
1789.53,17,87,3648,86,14,21053,14,3612,1,8,0,8,36
15.173,6,19,6761,5,189,3793,189,409,14,525,1155,3488,6352
0.434,17,2,144,1,36,0,36,64,1,52,0,52,80
0.934,17,2,588,1,39,0,39,67,1,493,0,493,521
1782.636,17,83,3480,82,14,22007,14,3444,1,8,0,8,36
315.151,6,21,2036,6,46,63030,46,378,15,81,22500,506,1658
316.972,6,112,41443,60,662,5372,1360,29122,52,378,6212,2720,12321
1.067,6,2,87,1,0,0,0,40,1,7,0,7,47
1760.324,6,123,8882,74,31,24114,31,5091,49,31,36673,31,3791
10.532,6,87,25037,45,544,239,1152,19216,42,413,250,1152,5821
1741.354,17,30,31680,30,1028,60046,1028,31680,0,0,0,0,0
294.377,6,35,8046,12,158,25473,267,1277,23,365,13380,1400,6769
0.011,17,2,162,1,36,0,36,64,1,70,0,70,98
1.296,6,48,16384,27,799,49,1460,10723,21,400,56,1460,5661
120.36,2,2,64,2,8,120360,8,64,0,0,0,0,0
1.749,6,48,19305,27,898,67,1460,13689,21,433,75,1460,5616
1784.448,6,113,8972,69,65,26241,65,4970,44,59,41488,59,4002
1.612,6,52,19529,27,902,62,1460,13753,25,433,59,1460,5776
17.718,6,22,7602,10,120,1968,147,812,12,1025,1610,1418,6790
379.793,6,18,1242,14,180,29214,180,916,4,110,20061,110,326
1785.432,17,83,3480,82,14,22042,14,3444,1,8,0,8,36
0.836,6,30,9475,17,451,52,1360,3421,13,788,53,1747,6054
3.878,17,4,240,4,32,1292,32,240,0,0,0,0,0
1.011,6,24,6041,13,108,84,147,959,11,773,99,1608,5082
0.183,6,26,7256,13,155,15,267,1301,13,678,14,2045,5955
0.528,17,3,543,2,39,107,39,134,1,381,0,381,409
186.337,1,39,4056,0,0,0,0,0,39,76,4903,76,4056
7.977,6,34,8423,15,401,65,889,1848,19,386,435,1360,6575
0.017,17,2,553,1,47,0,47,75,1,450,0,450,478
1789.954,6,358,23538,209,82,8605,469,13369,149,69,12094,69,10169
1.826,6,27,6573,15,126,130,517,1925,12,501,159,1552,4648
1741.166,17,30,7050,30,207,60040,207,7050,0,0,0,0,0
280.877,6,30,7432,13,158,23406,267,1317,17,543,17544,1400,6115
103.339,17,8,2688,8,308,14762,308,2688,0,0,0,0,0
83.392,6,15,1928,9,483,10424,483,1442,6,83,16675,83,486
7.496,17,23,7288,7,251,1248,1350,1953,16,305,497,1350,5335
10.954,6,18,5610,10,275,1217,275,958,8,1440,847,1440,4652
1794.39,17,180,11520,180,36,10024,36,11520,0,0,0,0,0
1799.763,17,449,39928,404,35,4465,288,25708,45,288,40021,288,14220
1799.644,1,16,896,16,28,119976,28,896,0,0,0,0,0
1772.007,6,180,15480,120,69,14890,69,8940,60,69,30033,69,6540
1770.795,6,104,9510,67,64,26830,64,5660,37,58,49185,58,3850
1799.983,17,181,26969,181,121,9999,121,26969,0,0,0,0,0
1778.279,6,191,11740,94,47,19121,208,6837,97,31,18521,31,4903
0.737,6,29,10195,14,257,55,669,1778,15,953,51,1438,8417
371.063,6,25,1651,17,177,23191,177,1117,8,110,9237,110,534
1661.834,1,7,392,7,28,276972,28,392,0,0,0,0,0
1766.052,1,58,4872,58,56,30983,56,4872,0,0,0,0,0
1706.297,1,8,448,8,28,243756,28,448,0,0,0,0,0
0.284,6,20,7238,12,335,25,668,1974,8,1210,39,1906,5264
1789.778,17,177,42233,177,210,10169,422,42233,0,0,0,0,0
7.951,6,18,6791,9,275,993,275,643,9,1155,689,1420,6148
280.282,6,27,7312,12,158,25480,267,1277,15,678,20017,2045,6035
176.886,6,22,9920,11,433,75,990,1771,11,1099,17675,1440,8149
22.016,17,4,530,2,36,22011,36,128,2,173,22011,187,402
1364.499,6,269,17039,155,70,8860,138,9374,114,69,12075,69,7665
1788.542,1,165,17490,165,78,10905,78,17490,0,0,0,0,0
228.109,17,4,352,2,60,228108,60,176,2,60,228108,60,176
1781.327,6,354,22440,207,69,8647,69,12420,147,69,12198,69,10020
147.068,6,31,8912,14,158,11312,267,1357,17,763,9186,2076,7555
31.483,6,7,308,1,0,0,0,44,6,0,6277,0,264
2.889,17,8,848,4,46,962,46,296,4,110,962,110,552
1.605,6,49,19394,29,895,57,1360,13773,20,437,73,2715,5621
0.021,17,2,438,1,72,0,72,100,1,310,0,310,338
0.006,17,2,379,1,39,0,39,67,1,284,0,284,312
463.241,6,45,14074,29,377,16544,1360,6870,16,655,30870,3494,7204
2.754,17,2,154,1,33,0,33,61,1,65,0,65,93
0.028,17,2,550,2,247,28,247,550,0,0,0,0,0
0.969,6,10,1687,6,100,193,100,344,4,589,233,1152,1343
3.736,6,32,6089,17,206,233,314,2744,15,548,247,1179,3345
1747.854,17,253,85052,253,308,6935,376,85052,0,0,0,0,0
1776.01,6,174,10489,89,42,20179,208,6128,85,31,21140,31,4361
1769.913,6,99,9240,66,65,27229,65,5577,33,59,55305,59,3663
240.304,6,46,9223,24,523,10447,1408,5966,22,233,11442,617,3257
1771.744,17,46,15424,46,307,39372,308,15424,0,0,0,0,0
78.043,6,30,8872,14,158,6003,267,1357,16,858,5196,3456,7515
0.066,17,2,146,1,37,0,37,65,1,53,0,53,81
4.329,6,38,7245,19,218,240,314,3383,19,516,226,1179,3862
1798.207,17,345,115664,345,307,5227,308,115664,0,0,0,0,0
1681.427,17,16,1265,8,30,240201,37,471,8,71,240201,136,794
1774.705,6,121,9614,75,50,23982,205,5733,46,36,39430,98,3881
182.962,6,8445,7633860,5416,1326,33,1368,7456434,3029,899,60,2736,177426
39.087,17,4,352,2,60,39086,60,176,2,60,39086,60,176
128.472,6,7,375,3,0,64236,0,152,4,7,42755,7,223
661.781,2,7,224,7,8,110296,8,224,0,0,0,0,0
1798.417,17,448,39896,403,35,4473,288,25676,45,288,40024,288,14220
1056.004,6,14,1211,14,46,81231,62,1211,0,0,0,0,0
38.149,6,15,2508,9,211,4768,211,1109,6,545,7623,904,1399
180.681,6,31,8647,17,229,11284,778,2040,14,653,13889,2521,6607
0.081,17,2,152,1,48,0,48,76,1,48,0,48,76
0.039,17,4,398,2,46,8,46,148,2,97,0,103,250
0.686,6,22,5040,11,137,68,267,1132,11,692,54,1467,3908
1773.958,17,44,14784,44,308,41254,308,14784,0,0,0,0,0
1.42,6,47,19490,27,914,54,1360,13914,20,476,64,2715,5576
1776.699,1,60,5040,60,56,30113,56,5040,0,0,0,0,0
2.325,6,126,102196,71,260,33,517,5822,55,2032,42,5632,96374
1246.486,17,403,27720,400,40,3123,41,27466,3,56,1017,57,254
0.165,6,41,16541,23,969,7,1420,11600,18,420,9,1420,4941
1744.621,2,23,736,23,8,79300,8,736,0,0,0,0,0
152.317,6,31,8912,14,158,11716,267,1357,17,687,9516,1781,7555
0.059,6,2,80,1,0,0,0,40,1,0,0,0,40
38.637,17,22,1936,11,48,3862,48,836,11,72,3862,72,1100
50.833,1,2,237,2,90,50833,105,237,0,0,0,0,0
6.329,6,1133,960160,663,1366,9,1408,931056,470,931,13,2801,29104
95.544,6,61,38537,38,1143,2582,1408,30600,23,748,2791,1408,7937
0.034,17,8,2446,8,277,4,316,2446,0,0,0,0,0
1624.959,17,128,10240,64,48,25792,48,4864,64,56,25792,56,5376
226.573,6,50,9192,24,138,9851,721,2482,26,435,9052,2840,6710
301.612,6,13,1028,6,226,60288,226,558,7,110,50240,110,470
1729.405,6,60,4400,40,33,44343,33,2740,20,31,91011,31,1660
0.123,17,2,184,1,32,0,32,60,1,96,0,96,124
1798.199,17,448,39896,403,35,4473,288,25676,45,288,40016,288,14220
62.239,6,70,54109,48,1214,1324,1368,46230,22,840,2952,2736,7879
0.501,6,3,156,2,0,501,0,100,1,0,0,0,56
38.914,17,3,228,3,48,19457,48,228,0,0,0,0,0
1782.381,17,83,3480,82,14,22004,14,3444,1,8,0,8,36
1785.717,6,117,9390,74,66,24461,66,5270,43,60,42514,60,4120
1799.582,6,136,8712,76,49,23994,208,5382,60,31,30496,31,3330
0.094,17,2,154,1,33,0,33,61,1,65,0,65,93
1783.449,17,83,3480,82,14,22017,14,3444,1,8,0,8,36
3.283,6,23,7373,12,357,298,721,1555,11,767,296,1420,5818
10.763,6,20,7026,11,275,1076,275,998,9,1414,742,1414,6028
0.518,6,9,1002,5,213,129,213,417,4,421,170,421,585
1784.339,17,138,11040,69,48,26240,48,5244,69,56,26240,56,5796
66.841,17,8,2624,8,300,9548,300,2624,0,0,0,0,0
22.723,17,7,532,7,48,3787,48,532,0,0,0,0,0
31.25,17,32,4704,16,48,2082,48,1216,16,190,2082,308,3488
3.982,6,32,6105,17,206,248,314,2744,15,551,265,1179,3361
1790.499,17,179,13962,179,50,10058,50,13962,0,0,0,0,0
77.892,6,14,1080,4,226,120,226,442,10,110,8635,110,638
0.979,17,4,624,2,64,978,64,184,2,192,864,192,440
1791.275,17,144,11520,72,48,25228,48,5472,72,56,25228,56,6048
850.741,6,89,13184,48,102,18100,469,4486,41,190,14349,1460,8698
0.075,17,4,344,2,47,0,47,150,2,69,1,75,194
1742.587,6,89,6426,58,31,30571,31,3915,31,31,58085,31,2511
300.75,6,38,8553,20,308,15828,888,2079,18,441,506,1360,6474
23.025,6,31,8017,15,188,1644,721,1924,16,778,1521,2840,6093
1739.897,6,172,10794,92,47,19119,208,6726,80,31,22019,31,4068
0.012,17,2,519,1,40,0,40,68,1,423,0,423,451
1.643,6,51,33546,31,1189,54,1408,26601,20,842,77,1408,6945
1.201,17,18,7232,9,501,150,1350,4764,9,246,143,1350,2468
183.513,6,51,10661,23,116,8341,267,2327,28,360,6795,1420,8334
0.226,6,2,364,1,0,0,0,40,1,272,0,272,324
1.28,6,50,18906,27,864,49,1360,13210,23,433,50,1360,5696
1787.396,6,106,8456,68,65,26677,65,4930,38,59,48303,59,3526
0.089,17,2,904,2,424,89,548,904,0,0,0,0,0
297.575,1,4,224,4,28,99191,28,224,0,0,0,0,0
167.639,6,138,21049,74,304,2296,304,14652,64,83,2653,83,6397
1788.793,6,134,18020,84,144,21551,1274,9146,50,156,36503,1380,8874
250.393,6,10,9078,0,0,0,0,0,10,867,27821,959,9078
2.717,6,53,19815,27,920,104,1440,13999,26,433,96,1440,5816
1799.912,17,180,14040,180,50,10055,50,14040,0,0,0,0,0
0.072,6,2,80,1,0,0,0,40,1,0,0,0,40
23.217,6,16,2568,8,210,3316,210,1054,8,545,3316,904,1514
1793.03,6,284,47085,123,250,14695,1360,30028,161,134,11205,1938,17057
280.202,6,28,7352,13,158,23350,267,1317,15,678,20011,4200,6035
33.744,6,32,5146,15,154,2410,722,1859,17,299,2096,1408,3287
0.093,6,3,920,1,800,0,800,840,2,0,93,0,80
40.144,17,6,528,3,48,20065,48,228,3,72,20062,72,300
0.833,6,54,13970,25,551,34,1429,4892,29,416,28,1460,9078
96.478,17,4,240,2,32,96477,32,120,2,32,96477,32,120
1773.086,6,180,15480,120,69,14899,69,8940,60,69,30051,69,6540
0.023,17,2,217,1,50,0,50,78,1,111,0,111,139
0.11,17,2,672,2,308,110,308,672,0,0,0,0,0
4.692,17,2,1358,2,651,4692,651,1358,0,0,0,0,0
1765.411,17,282,66295,282,207,6282,422,66295,0,0,0,0,0
1350.874,1,43,3612,0,0,0,0,0,43,56,32163,56,3612
1797.307,6,368,23483,212,69,8518,69,12689,156,69,11595,69,10794
1778.018,17,138,11040,69,48,26147,48,5244,69,56,26147,56,5796
19.618,17,34,7950,15,211,1399,1350,3590,19,201,1088,1350,4360
280.227,6,28,7352,13,158,23352,267,1317,15,678,20011,2800,6035
0.081,17,2,456,1,50,0,50,78,1,350,0,350,378
0.053,17,2,198,1,37,0,37,65,1,105,0,105,133
1796.065,17,265,53413,265,173,6803,422,53413,0,0,0,0,0
3.679,17,4,368,4,64,1226,64,368,0,0,0,0,0
1401.936,17,12,888,6,30,280380,30,348,6,62,280380,62,540
56.079,6,560,262767,292,835,192,1152,246542,268,423,209,1179,16225
34.46,6,10,420,3,0,17230,0,124,7,0,5721,0,296
1.05,17,2,784,2,364,1050,364,784,0,0,0,0,0
38.564,6,40,8772,15,389,41,854,1801,25,297,1601,1360,6971
229.952,6,5,293,5,31,57488,31,293,0,0,0,0,0
0.049,6,6,374,3,31,24,31,187,3,31,0,31,187
6.16,6,1607,1464194,997,1389,6,1408,1427810,610,931,9,2816,36384
646.995,17,128,9728,128,48,5094,48,9728,0,0,0,0,0
10.646,6,16,3911,9,275,1330,275,643,7,992,957,1440,3268
9.449,6,24,8948,13,198,787,285,1268,11,887,931,1440,7680
1787.362,17,87,3648,86,14,21027,14,3612,1,8,0,8,36
1735.823,1,76,4256,76,28,23144,28,4256,0,0,0,0,0
300.832,6,59,39911,37,593,8356,1370,4947,22,1988,1406,8266,34964
2.619,6,53,22805,29,982,93,1440,16914,24,409,85,1440,5891
21.686,6,3320,3103500,2138,1373,10,1408,3037372,1182,931,18,2816,66128
0.025,17,2,527,1,47,0,47,75,1,424,0,424,452
1787.556,6,102,8296,68,65,26679,65,4930,34,59,54164,59,3366
5.026,17,4,690,2,48,5014,48,152,2,241,5016,249,538
0.236,17,2,152,1,48,0,48,76,1,48,0,48,76
91.177,6,3220,2825193,1947,1364,46,1368,2747771,1273,899,71,1473,77422
452.907,17,33,4170,33,98,14153,355,4170,0,0,0,0,0
0.05,17,4,352,2,37,0,37,130,2,83,5,89,222
1.227,6,52,21283,29,899,43,1360,15587,23,476,47,2715,5696
1772.958,6,192,16305,125,69,14298,69,9278,67,69,26862,69,7027
787.322,1,36,3816,36,78,22494,78,3816,0,0,0,0,0
1786.847,6,102,8296,68,65,26669,65,4930,34,59,54142,59,3366
1787.413,6,102,8228,68,64,26677,64,4896,34,58,54160,58,3332
1072.46,17,212,16112,212,48,5082,48,16112,0,0,0,0,0
0.643,6,10,924,5,283,117,283,551,5,105,117,105,373
1721.806,1,8,448,8,28,245972,28,448,0,0,0,0,0
0.2,17,2,632,1,288,0,288,316,1,288,0,288,316
5.715,2,2,64,2,8,5715,8,64,0,0,0,0,0
3.127,17,4,304,2,48,2982,48,152,2,48,2982,48,152
5.446,6,40,7309,20,218,286,314,3423,20,513,271,1179,3886
240.167,6,39,5307,19,247,13342,835,2730,20,191,12640,640,2577
213.728,1,40,1120,40,0,0,0,1120,0,0,0,0,0
0.114,6,38,14383,22,862,5,1420,9522,16,420,7,1420,4861
240.201,6,55,18192,30,753,8282,1408,15133,25,218,10008,580,3059
1788.025,17,85,3564,84,14,21542,14,3528,1,8,0,8,36
137.533,17,4,240,2,32,137531,32,120,2,32,137532,32,120
1741.964,6,96,6962,62,31,28556,31,4209,34,31,52786,31,2753
231.282,17,4,352,2,60,231281,60,176,2,60,231281,60,176
4.881,6,38,7229,20,218,256,314,3423,18,513,271,1179,3806
280.51,6,30,7432,13,158,23375,267,1317,17,603,17523,2236,6115
1750.508,17,12,498,11,14,175050,14,462,1,8,0,8,36
29.213,6,4395,4186816,2878,1376,10,1408,4102776,1517,931,19,2816,84040
1796.096,17,449,39928,404,35,4456,288,25708,45,288,40021,288,14220
1786.467,6,112,8944,71,66,25520,66,5084,41,60,44659,60,3860
0.008,17,2,308,1,34,0,34,62,1,218,0,218,246
1624.319,2,23,736,23,8,73832,8,736,0,0,0,0,0
1.581,6,48,19514,27,913,60,1360,13898,21,433,68,1360,5616
1705.952,1,8,448,8,28,243707,28,448,0,0,0,0,0
251.241,17,4,352,2,60,251240,60,176,2,60,251240,60,176
1789.958,6,386,30107,220,134,8173,469,18637,166,69,10848,69,11470
0.17,1,2,112,2,28,170,28,112,0,0,0,0,0
0.914,6,28,8503,15,225,53,561,1985,13,997,62,1791,6518
99.713,6,23,9823,12,410,50,922,1742,11,1089,9959,2720,8081
1791.254,1,342,28728,342,56,5252,56,28728,0,0,0,0,0
1783.386,17,83,3480,82,14,22017,14,3444,1,8,0,8,36
1682.373,17,14,3815,7,30,280393,30,406,7,459,280393,463,3409
1795.426,17,142,11360,71,48,25648,48,5396,71,56,25648,56,5964
1.086,17,2,148,2,46,1086,46,148,0,0,0,0,0
0.548,6,23,7428,13,273,45,663,2052,10,967,56,1471,5376
258.448,6,31,8912,14,158,19880,267,1357,17,687,16151,1781,7555
15.999,1,3,168,3,28,7999,28,168,0,0,0,0,0
280.524,6,28,7352,12,158,25502,267,1277,16,603,18699,1400,6075
175.119,1,4,224,4,28,58373,28,224,0,0,0,0,0
375.255,17,8,2045,4,31,125083,37,239,4,423,125083,463,1806
1755.876,6,107,6344,60,26,29759,26,3510,47,26,38170,26,2834
1.831,6,25,8056,12,164,150,267,1288,13,869,137,1440,6768
61.888,6,67,46306,43,1163,1473,1408,38326,24,960,2680,3847,7980
1.564,6,60,42671,37,1245,43,1448,35570,23,842,63,1448,7101
1.516,6,51,22304,28,936,56,1360,15248,23,556,61,2715,7056
15.068,6,19,3342,13,210,1063,210,1944,6,545,3006,904,1398
1595.447,1,8,448,8,28,227921,28,448,0,0,0,0,0
0.304,6,22,7218,11,257,30,748,1611,11,1005,30,2374,5607
1.399,6,50,20316,28,900,51,1360,14660,22,476,57,2715,5656
0.001,17,2,128,1,36,0,36,64,1,36,0,36,64
88.316,1,4,224,4,28,29438,28,224,0,0,0,0,0
5.969,6,43,7429,22,201,284,314,3503,21,513,283,1179,3926
26.427,6,20,3130,12,183,2402,517,1561,8,381,3773,499,1569
0.079,6,6,328,4,0,26,0,216,2,0,42,0,112
0.907,6,11,1727,7,100,151,100,384,4,589,215,1152,1343
11.025,6,19,4362,11,275,1102,275,998,8,1010,895,2840,3364
1787.998,6,4988,4553748,1938,129,923,339,123477,3050,1434,586,5608,4430271
142.826,6,31,8912,14,158,10986,267,1357,17,763,8918,2076,7555
1.67,6,26,8794,16,283,111,582,1494,10,985,166,1420,7300
0.693,6,3,160,2,0,693,0,100,1,0,0,0,60
1797.924,17,448,39896,403,35,4472,288,25676,45,288,40015,288,14220
504.219,2,4,128,4,8,168073,8,128,0,0,0,0,0
1.38,6,28,6080,14,150,106,267,1615,14,780,93,1460,4465
317.048,6,104,35555,59,498,5466,1360,24864,45,355,7202,2720,10691
74.426,6,5,293,4,31,24808,31,222,1,31,0,31,71
0.732,17,2,144,1,36,0,36,64,1,52,0,52,80
1782.435,17,83,3480,82,14,22005,14,3444,1,8,0,8,36
0.446,6,6,324,4,0,148,0,216,2,0,250,0,108
191.682,6,74,14323,32,322,4226,1189,5807,42,243,4674,1997,8516
1772.139,6,180,15480,120,69,14891,69,8940,60,69,30033,69,6540
1789.469,1,240,13440,240,28,7487,28,13440,0,0,0,0,0
125.71,6,22,8388,11,526,87,1240,2095,11,834,12553,1360,6293
280.658,6,29,7392,13,158,23388,267,1317,16,603,18703,2036,6075
1790.19,6,190,17134,99,123,18267,208,12471,91,31,19887,31,4663
0.949,6,528,495486,205,183,4,230,11217,323,1456,2,2896,484269
58.7,17,4,352,2,60,58699,60,176,2,60,58699,60,176
1795.341,6,356,22520,208,69,8673,69,12460,148,69,12213,69,10060
1800.0,6,219,18790,80,74,22405,335,8289,139,69,13043,1062,10501
1740.441,17,30,31680,30,1028,60015,1028,31680,0,0,0,0,0
1792.195,1,94,5264,94,28,19270,28,5264,0,0,0,0,0
3.699,6,29,15610,16,634,246,1360,3209,13,1695,296,3928,12401
1787.58,1,224,12544,224,28,8016,28,12544,0,0,0,0,0
2.971,17,8,480,4,32,990,32,240,4,32,989,32,240
204.417,6,36808,36619116,12721,333,16,336,711523,24087,1439,8,4314,35907593
0.009,6,6,6497,1,0,0,0,40,5,1239,0,1448,6457
0.043,17,2,182,1,44,0,44,72,1,82,0,82,110
1281.002,6,94,5726,51,26,25619,26,3064,43,26,30499,26,2662
2.938,6,2,88,2,0,0,0,88,0,0,0,0,0
126.504,6,9,504,4,112,42160,112,280,5,0,31622,0,224
12.982,6,1973,1785554,1261,1362,10,1420,1752699,712,475,18,1883,32855
1799.852,6,310,21733,133,54,13408,577,11103,177,47,10226,142,10630
366.496,6,25,1651,17,177,22906,177,1117,8,110,9168,110,534
0.057,6,12,3702,6,170,11,170,490,6,964,9,1448,3212
1787.17,6,104,8308,68,64,26674,64,4896,36,58,51058,58,3412
313.096,6,87,12636,42,172,6576,1189,4276,45,284,7115,1926,8360
0.167,17,5,1757,5,323,41,354,1757,0,0,0,0,0
377.19,6,21,1422,15,180,26942,180,992,6,110,12238,110,430
28.336,6,48,14009,23,289,1288,721,3533,25,676,1138,1440,10476
237.843,1,6,336,6,28,47568,28,336,0,0,0,0,0
240.337,6,42,8869,20,197,12646,751,2429,22,528,11442,2381,6440
8.615,17,6,528,3,48,4298,48,228,3,72,4295,72,300
251.62,2,2,64,2,8,251620,8,64,0,0,0,0,0
31.278,6,37,9634,19,268,1737,721,3457,18,778,1779,1440,6177
9.413,6,80,24970,39,568,247,1152,19189,41,413,228,1152,5781
601.608,2,7,224,7,8,100268,8,224,0,0,0,0,0
3.376,17,3,228,2,48,3047,48,152,1,48,0,48,76
7.006,6,39,7562,20,224,368,314,3716,19,513,375,1179,3846
76.276,17,8,704,4,48,25422,48,304,4,72,25422,72,400
0.015,17,2,148,1,38,0,38,66,1,54,0,54,82
997.444,17,196,14896,196,48,5115,48,14896,0,0,0,0,0
22.195,6,20,5924,12,267,2017,501,1285,8,719,141,1420,4639
0.097,6,9,1148,5,145,24,145,349,4,635,24,635,799
1748.232,6,103,7755,66,38,26895,205,4663,37,33,48550,98,3092
1799.728,17,449,39928,404,35,4465,288,25708,45,288,40018,288,14220
280.554,6,30,7432,13,158,23379,267,1317,17,543,17526,1400,6115
0.035,6,2,129,1,0,0,0,40,1,37,0,37,89
1798.489,17,447,39296,404,35,4462,288,25708,43,288,41923,288,13588
57.13,6,27,7339,7,165,9521,267,949,20,371,3003,1452,6390
1786.56,6,104,8308,68,64,26665,64,4896,36,58,51041,58,3412
0.041,6,10,1514,5,503,10,503,771,5,475,10,475,743
0.271,17,2,152,1,48,0,48,76,1,48,0,48,76
4.353,6,38,7229,19,218,241,314,3383,19,513,227,1179,3846
154.405,2,4,128,4,8,51468,8,128,0,0,0,0,0
114.804,6,47,12998,24,890,710,1360,7276,23,435,5210,2667,5722
240.692,6,47,7814,24,139,10464,346,2114,23,408,10940,1408,5700
33.999,6,31,5107,15,154,2428,722,1872,16,342,2253,1408,3235
1.368,6,47,18635,27,853,52,1360,13059,20,529,62,4075,5576
465.829,6,39,2512,22,42,22173,208,1553,17,31,29102,31,959
30.95,6,4265,4008733,2782,1362,11,1408,3926953,1483,931,20,2816,81780
1794.267,17,80,3354,79,14,23003,14,3318,1,8,0,8,36
1.762,17,19,7564,9,501,220,1350,4769,10,251,189,1350,2795
240.207,6,54,18102,29,802,8578,1418,15160,25,204,10008,580,2942
1.675,17,2,154,1,33,0,33,61,1,65,0,65,93
7.773,6,467,372193,272,1300,27,1368,357377,195,776,38,1473,14816
36.434,1,3,489,3,135,18217,142,489,0,0,0,0,0
2.542,17,2,178,1,29,0,29,57,1,93,0,93,121
1786.685,6,102,8296,68,65,26666,65,4930,34,59,54139,59,3366
58.978,17,28,2339,26,30,2358,37,1515,2,384,342,463,824
0.485,17,2,157,1,31,0,31,59,1,70,0,70,98
1793.418,17,140,11200,70,48,25991,48,5320,70,56,25991,56,5880
1789.955,6,358,22738,208,69,8647,69,12460,150,69,12013,69,10278
0.812,6,7,295,4,0,270,0,164,3,7,252,7,131
1.238,6,49,19835,28,871,45,1360,14219,21,433,53,1360,5616
6.788,6,712,609270,429,1342,15,1368,587310,283,776,23,2736,21960
1680.939,1,15,840,15,28,120067,28,840,0,0,0,0,0
0.507,17,3,543,2,39,31,39,134,1,381,0,381,409
550.513,2,9,288,9,8,68814,8,288,0,0,0,0,0
1766.742,6,184,32684,122,302,14601,302,24472,62,83,28962,83,8212
33.573,6,31,5095,15,154,2398,722,1859,16,342,2226,1402,3236
1793.774,17,144,11520,72,48,25264,48,5472,72,56,25264,56,6048
29.188,6,18,788,8,0,4169,0,348,10,0,2450,0,440
10.65,6,1394,1285167,859,1417,12,1448,1252683,535,776,19,1448,32484
1.391,6,11,1427,6,145,278,145,389,5,830,296,830,1038
0.941,17,2,116,2,30,941,30,116,0,0,0,0,0
6.083,6,21,5275,13,197,504,358,1511,8,688,862,1380,3764
408.997,6,80628,66997589,38095,683,10,1396,2115162,42533,1476,9,11168,64882427
1.277,6,10,1687,7,100,212,100,384,3,1179,510,1179,1303
1778.825,17,142,11360,71,48,25411,48,5396,71,56,25411,56,5964
1798.22,17,83,3480,82,14,22200,14,3444,1,8,0,8,36
41.92,17,48,7056,24,48,1822,48,1824,24,190,1822,308,5232
1784.643,17,142,11360,71,48,25494,48,5396,71,56,25494,56,5964
1000.436,6,105,11254,56,84,18186,722,5204,49,102,20838,1408,6050
300.592,6,37,8526,19,315,16699,882,2053,18,478,497,2720,6473
0.049,6,10,1512,5,503,12,503,771,5,473,12,473,741
125.422,6,16,3890,8,92,17917,92,528,8,490,17889,2026,3362
1747.65,6,95,7203,63,38,28187,205,4476,32,33,56365,98,2727
1793.165,17,83,3480,82,14,22137,14,3444,1,8,0,8,36
0.194,6,24,7176,12,155,17,267,1261,12,775,16,4200,5915
0.675,6,4,184,2,0,6,0,104,2,0,41,0,80
17.13,17,4,352,2,60,17126,60,176,2,60,17128,60,176
1750.502,17,12,498,11,14,175050,14,462,1,8,0,8,36
0.05,17,8,2750,8,315,7,354,2750,0,0,0,0,0
1755.538,17,12,498,11,14,175553,14,462,1,8,0,8,36
21.374,6,1084,949721,660,1359,32,1368,920801,424,776,50,2736,28920
36.105,17,6,456,6,48,7221,48,456,0,0,0,0,0
0.689,6,15,1785,7,288,79,288,600,8,426,68,434,1185
1794.829,17,87,3648,86,14,21115,14,3612,1,8,0,8,36
61.684,6,60,38168,37,1116,1713,1448,28769,23,819,2793,1448,9399
5.034,17,4,288,2,36,5005,36,128,2,52,5002,52,160
2.682,17,23,7928,9,272,335,1350,2705,14,345,123,1350,5223
1630.311,1,7,392,7,28,271718,28,392,0,0,0,0,0
3.396,6,16,3276,5,92,849,92,348,11,464,319,1448,2928
1785.758,6,102,8296,68,65,26653,65,4930,34,59,54111,59,3366
62.628,6,20,4926,11,305,6237,517,1070,9,696,7796,1420,3856
39.24,6,14,3185,5,92,9810,92,348,9,1164,4878,1440,2837
1771.231,6,101,9344,66,65,27249,65,5577,35,59,52091,59,3767
5.397,6,38,7229,19,218,299,314,3383,19,513,284,1179,3846
8.712,2,3,96,3,8,4356,8,96,0,0,0,0,0
1.305,6,2,87,1,0,0,0,40,1,7,0,7,47
1.966,1,30,2520,30,56,67,56,2520,0,0,0,0,0
0.89,6,30,18589,18,702,52,1360,4967,12,1641,65,4887,13622
68.656,6,49,16351,26,950,373,1360,10584,23,371,3111,1360,5767
0.048,17,2,144,1,36,0,36,64,1,52,0,52,80
4.294,17,29,7737,12,329,390,1350,4286,17,175,185,1350,3451
1781.76,6,360,24156,210,88,8525,469,13878,150,69,11958,69,10278
0.009,17,2,2144,2,1044,9,1044,2144,0,0,0,0,0
0.103,6,9,1340,5,145,25,145,349,4,827,29,827,991
1786.481,6,362,24774,211,94,8507,469,14387,151,69,11908,69,10387
10.936,17,4,824,2,48,10916,48,152,2,308,10890,308,672
1.582,6,48,18575,27,846,60,1360,12959,21,433,68,1360,5616
300.799,2,5,160,5,8,75199,8,160,0,0,0,0,0
1729.213,6,63,4601,41,33,43230,33,2825,22,31,82333,31,1776
18.823,6,22,4426,12,213,1711,597,1689,10,552,2050,1767,2737
1.635,6,25,8018,15,285,116,587,1459,10,879,162,1420,6559
615.924,6,145,24857,58,231,10805,1360,11234,87,155,7160,4649,13623
37.83,6,13,8328,4,92,12610,92,296,9,1259,4702,1448,8032
17.695,6,2367,2191207,1444,1433,12,1448,2134363,923,776,18,1448,56844
0.011,17,2,672,2,308,11,308,672,0,0,0,0,0
30.585,6,522,439949,309,1351,99,1368,423035,213,749,143,1368,16914
1778.439,17,138,11040,69,48,26152,48,5244,69,56,26152,56,5796
37.985,17,22,1672,22,48,1808,48,1672,0,0,0,0,0
3.065,17,8,688,4,47,1017,47,300,4,69,1015,75,388
5.03,17,3,208,2,36,5009,36,128,1,52,0,52,80
157.289,17,4,352,2,60,157288,60,176,2,60,157288,60,176
1772.172,6,180,15480,120,69,14892,69,8940,60,69,30032,69,6540
0.661,6,10,1514,5,503,165,503,771,5,475,165,475,743
0.111,6,10,1841,5,658,27,658,926,5,647,27,647,915
1799.216,1,57,4788,57,56,32128,56,4788,0,0,0,0,0
1797.013,17,447,39864,402,35,4481,288,25644,45,288,40017,288,14220
5.055,6,35,17575,20,348,266,619,3138,15,1240,351,2518,14437
1786.206,6,373,29238,217,133,8269,1189,17474,156,81,11523,485,11764
0.839,6,5,248,3,0,419,0,144,2,0,585,0,104
14.261,6,2797,2631349,1811,1376,7,1408,2575413,986,931,14,2801,55936
0.012,17,2,410,1,30,0,30,58,1,324,0,324,352
4.131,6,40,7309,20,218,217,314,3423,20,440,204,1152,3886
1790.679,6,355,22618,205,69,8777,69,12340,150,69,12017,69,10278
823.381,17,10,4180,10,390,91486,1445,4180,0,0,0,0,0
299.686,6,6,364,4,31,99895,31,222,2,31,299660,31,142
1754.038,6,97,6302,62,47,28754,208,4003,35,31,51576,31,2299
280.296,6,30,7432,13,158,23358,267,1317,17,543,17516,1400,6115
2.099,6,29,5964,14,111,161,267,1459,15,650,137,1380,4505
0.339,6,4,222,2,31,339,31,111,2,31,0,31,111
5.45,1,7,3602,7,486,908,548,3602,0,0,0,0,0
630.07,2,4,128,4,8,210023,8,128,0,0,0,0,0
1771.898,6,180,15480,120,69,14889,69,8940,60,69,30031,69,6540
1745.576,6,95,7203,63,38,28154,205,4476,32,33,56300,98,2727
0.123,6,9,1343,5,145,30,145,349,4,830,37,830,994
68.535,17,8,1176,4,48,22842,48,304,4,190,22841,308,872
1787.524,17,142,11360,71,48,25535,48,5396,71,56,25535,56,5964
240.649,2,5,160,5,8,60162,8,160,0,0,0,0,0
0.277,17,2,214,1,39,0,39,67,1,119,0,119,147
31.263,17,36,5292,18,48,1838,48,1368,18,190,1838,308,3924
0.62,6,15,1785,8,288,64,288,640,7,426,71,434,1145
1680.21,17,12,498,11,14,168021,14,462,1,8,0,8,36
2.897,17,2,154,1,33,0,33,61,1,65,0,65,93
127.41,6,30,7432,13,158,10617,267,1317,17,543,7961,1400,6115
206.138,6,33,2413,14,73,15846,309,1222,19,47,11444,78,1191
1794.224,17,149,33449,149,196,12123,358,33449,0,0,0,0,0
17.77,6,27,6174,14,275,1366,275,1122,13,902,1265,1440,5052
25.259,17,4,1344,4,308,8419,308,1344,0,0,0,0,0
3.024,6,14,3602,7,75,504,75,467,7,1373,504,1448,3135
1781.137,1,74,6216,0,0,0,0,0,74,56,24399,56,6216
0.795,17,2,178,1,29,0,29,57,1,93,0,93,121
1773.458,6,180,15480,120,69,14903,69,8940,60,69,30056,69,6540
1.809,6,44,15106,24,776,78,1360,9530,20,476,85,2715,5576
169.012,17,2,672,2,308,169012,308,672,0,0,0,0,0
0.103,17,2,152,1,48,0,48,76,1,48,0,48,76
1771.282,6,101,9410,66,66,27250,66,5610,35,60,52093,60,3800
0.63,6,26,10757,13,746,52,1360,3537,13,836,37,1360,7220
0.017,6,10,1514,5,503,3,503,771,5,475,3,475,743
5.046,17,4,288,2,36,5003,36,128,2,52,5002,52,160
55.721,6,28,7352,13,158,4643,267,1317,15,775,3976,3465,6035
1.549,6,26,7212,14,656,119,1418,5334,12,249,139,580,1878
0.104,17,2,231,1,34,0,34,62,1,141,0,141,169
2.804,17,2,685,1,308,0,308,336,1,321,0,321,349
1.368,6,44,11555,24,547,59,1360,5934,20,437,62,2715,5621
902.124,17,60,20165,60,308,15290,329,20165,0,0,0,0,0
7.775,6,16,4050,9,275,971,275,918,7,1420,1002,1420,3132
0.47,6,13,1693,7,288,74,288,588,6,426,52,434,1105
1.682,6,13,2311,8,188,240,245,700,5,1407,358,1407,1611
0.064,6,10,1512,5,503,16,503,771,5,473,16,473,741
154.752,6,23,10009,12,531,62,1360,2637,11,1384,15461,3934,7372
0.904,6,27,8942,13,232,74,569,1614,14,941,68,1438,7328
1794.966,17,66,2766,65,14,28046,14,2730,1,8,0,8,36
7.05,6,71,21710,36,559,201,1152,16542,35,470,199,1179,5168
3.52,17,10,785,5,31,871,31,295,5,70,864,70,490
120.471,6,8,480,2,112,120460,112,200,6,0,24091,0,280
366.629,6,27,1767,18,177,21566,177,1181,9,110,9144,110,586
170.272,17,4,352,2,60,170271,60,176,2,60,170269,60,176
0.991,6,16,2256,8,288,121,288,652,8,424,117,434,1604
0.34,6,27,8942,14,232,26,569,1666,13,941,27,1402,7276
1687.264,17,17,4373,17,229,105454,1209,4373,0,0,0,0,0
2.516,6,22,3473,12,162,228,293,1458,10,537,250,1179,2015
10.875,6,83,25090,42,550,265,1152,19309,41,459,265,1179,5781
21.988,17,47,14595,23,420,997,1350,10314,24,150,954,1350,4281
1758.755,1,8,448,8,28,251250,28,448,0,0,0,0,0
1769.709,6,99,9306,66,66,27226,66,5610,33,60,55299,60,3696
1797.74,6,121,12205,77,62,23654,722,6403,44,97,41801,2329,5802
16.634,6,14,1025,7,222,2771,222,506,7,231,2771,231,519
1786.43,6,102,8296,68,65,26663,65,4930,34,59,54131,59,3366
0.167,6,26,7256,13,155,13,267,1301,13,678,13,4200,5955
1772.393,6,180,15480,120,69,14894,69,8940,60,69,30035,69,6540
251.783,2,2,64,2,8,251783,8,64,0,0,0,0,0
39.54,17,22,1936,11,48,3952,48,836,11,72,3952,72,1100
1795.743,1,249,13944,249,28,7240,28,13944,0,0,0,0,0
1.407,6,50,21555,28,983,52,1460,15899,22,476,57,2615,5656
1747.21,6,97,7307,63,38,28180,205,4476,34,33,52932,98,2831
1797.053,1,58,4872,58,56,31527,56,4872,0,0,0,0,0
148.981,6,22,8510,11,333,89,692,1473,11,940,14884,1460,7037
1786.391,1,342,28728,342,56,5238,56,28728,0,0,0,0,0
0.002,17,2,912,1,308,0,308,336,1,548,0,548,576
0.806,6,134,93498,77,1289,10,1432,86927,57,475,14,1871,6571
0.198,1,2,112,2,28,198,28,112,0,0,0,0,0
3.14,17,2,134,2,39,3140,39,134,0,0,0,0,0
7.05,6,20,12763,5,112,1762,112,320,15,910,487,1460,12443
1681.737,17,14,1036,7,30,280280,30,406,7,62,280281,62,630
5.025,17,4,288,2,36,5003,36,128,2,52,5008,52,160
137.131,17,10,760,10,48,15236,48,760,0,0,0,0,0
1113.727,17,210,15960,210,48,5328,48,15960,0,0,0,0,0
1799.999,6,1316,272237,677,185,2618,1360,133999,639,658,2821,6800,138238
1442.109,1,7,392,7,28,240351,28,392,0,0,0,0,0
107.665,6,539,422959,335,1327,90,1360,407767,204,206,529,2667,15192
1795.628,17,449,39928,404,35,4455,288,25708,45,288,40019,288,14220
9.243,6,33,9061,14,158,711,267,1357,19,578,508,1400,7704
310.711,6,27,6971,11,158,31067,267,1237,16,565,20711,1380,5734
1755.898,6,105,6270,60,27,29760,27,3525,45,27,39905,27,2745
11.052,6,7,380,4,0,3684,0,216,3,0,5518,0,164
51.489,17,132,73828,71,895,735,1350,65573,61,107,857,1350,8255
61.653,6,15,1400,8,180,8807,180,808,7,110,10244,110,592
0.011,17,4,284,2,32,7,32,120,2,54,6,60,164
0.681,17,8,2750,8,315,97,354,2750,0,0,0,0,0
0.399,17,3,663,2,39,394,39,134,1,501,0,501,529
27.282,6,55,14424,34,145,826,159,3967,21,623,1363,1669,10457
0.081,17,2,180,1,30,0,30,58,1,94,0,94,122
1750.625,17,12,498,11,14,175062,14,462,1,8,0,8,36
0.81,2,2,96,2,24,810,24,96,0,0,0,0,0
1738.16,1,73,6132,73,56,24141,56,6132,0,0,0,0,0
2.758,17,3,1170,3,362,1379,362,1170,0,0,0,0,0
2.022,17,3,174,3,30,1011,30,174,0,0,0,0,0
0.385,17,2,136,1,32,0,32,60,1,48,0,48,76
6.307,1,4,224,4,28,2102,28,224,0,0,0,0,0
1770.74,6,99,9240,66,65,27242,65,5577,33,59,55332,59,3663
10.172,6,16,3911,9,275,1271,275,643,7,992,874,1440,3268
1772.999,6,180,15480,120,69,14899,69,8940,60,69,30048,69,6540
0.016,17,4,350,2,34,2,34,124,2,85,0,91,226
0.503,17,8,2750,8,315,71,354,2750,0,0,0,0,0
1773.145,6,180,15480,120,69,14900,69,8940,60,69,30046,69,6540
1.425,17,12,7429,7,751,237,1350,5454,5,367,266,1350,1975
301.111,6,1308,1193674,881,1335,342,1360,1167646,427,185,706,1360,26028
3.193,6,58,20084,32,942,103,1460,13625,26,337,112,1460,6459
1795.288,17,449,39928,404,35,4454,288,25708,45,288,40014,288,14220
1782.464,17,83,3480,82,14,22005,14,3444,1,8,0,8,36
9.341,2,2,64,2,8,9341,8,64,0,0,0,0,0
11.799,6,25,8453,13,275,983,275,1078,12,983,848,1420,7375
1738.491,6,91,6604,59,31,29973,31,3998,32,31,56079,31,2606
371.384,6,25,1639,16,177,24758,177,1053,9,110,9761,110,586
9.637,6,1500,1330101,942,1359,10,1420,1303194,558,427,17,1420,26907
50.332,6,8,432,5,0,12583,0,268,3,0,25050,0,164
1684.19,1,15,840,15,28,120299,28,840,0,0,0,0,0
0.906,6,19,9056,11,499,90,1193,1971,8,1350,96,3639,7085
4.576,6,24,4530,13,213,381,597,1741,11,441,440,1440,2789
29.495,17,27,16447,13,619,2457,1350,8422,14,545,33,1350,8025
1790.416,17,144,11520,72,48,25216,48,5472,72,56,25216,56,6048
812.151,6,48,3904,32,65,26198,65,2320,16,59,54136,59,1584
0.0,17,1,58,1,30,0,30,58,0,0,0,0,0
1.629,6,48,18873,27,867,62,1360,13257,21,433,72,1360,5616
0.446,6,19,5892,10,273,47,517,1620,9,759,53,1448,4272
1672.175,1,78,4368,78,28,21716,28,4368,0,0,0,0,0
280.255,6,30,7432,13,158,23354,267,1317,17,543,17512,1400,6115
0.332,6,19,5839,11,280,33,517,1703,8,742,43,1448,4136
1796.165,17,140,11200,70,48,26031,48,5320,70,56,26031,56,5880
214.777,6,28,8792,13,158,17898,267,1317,15,858,15336,2045,7475
1786.551,6,105,8416,68,65,26664,65,4930,37,59,49624,59,3486
0.619,6,15,2638,8,288,78,288,640,7,568,73,853,1998
10.791,6,84,25130,43,568,256,1152,19349,41,459,263,1179,5781
1786.713,6,104,8435,69,65,26275,65,4970,35,59,52547,59,3465
0.208,17,2,157,1,31,0,31,59,1,70,0,70,98
81.762,6,36,8393,12,155,7432,267,1266,24,324,3551,1420,7127
0.433,17,4,240,2,32,432,32,120,2,32,432,32,120
0.967,6,2,1175,1,0,0,0,40,1,1095,0,1095,1135
0.048,17,2,154,2,49,48,49,154,0,0,0,0,0
280.209,6,29,7392,14,158,21554,267,1357,15,678,20010,3436,6035
1.371,6,39,8292,19,320,76,1162,2716,20,433,62,1460,5576
11.565,6,21,6825,12,275,1051,275,1038,9,1353,818,1440,5787
3.303,6,21,6964,12,185,300,275,1041,9,794,276,2840,5923
1793.445,17,144,11520,72,48,25259,48,5472,72,56,25259,56,6048
4.056,17,4,352,4,60,1352,60,352,0,0,0,0,0
6.387,17,4,304,3,48,3049,48,228,1,48,0,48,76
1798.88,6,356,22520,208,69,8690,69,12460,148,69,12237,69,10060
300.766,6,52,20317,29,1023,10741,1360,14533,23,346,402,1360,5784
33.662,6,33,5210,16,154,2232,722,1923,17,299,2093,1448,3287
1799.475,1,16,896,16,28,119965,28,896,0,0,0,0,0
300.623,6,29,8624,13,272,25051,750,1798,16,498,18166,1408,6826
125.407,6,16,3249,8,92,17915,92,504,8,387,17888,1408,2745
1.26,6,45,14842,24,748,54,1360,9226,21,476,54,2715,5616
233.664,17,4,352,2,60,233663,60,176,2,60,233663,60,176
1772.235,6,180,15480,120,69,14892,69,8940,60,69,30031,69,6540
20.307,6,22,5482,12,107,1846,159,1074,10,967,2251,1709,4408
4.322,6,38,7229,19,218,240,314,3383,19,440,225,1152,3846
256.404,17,6,360,3,32,128201,32,180,3,32,128201,32,180
117.144,6,22,900,9,0,6157,0,364,13,0,9761,0,536
299.57,6,6,364,4,31,99856,31,222,2,31,299544,31,142
1625.432,1,7,392,7,28,270905,28,392,0,0,0,0,0
56.731,6,44,8992,21,410,755,917,2164,23,346,2572,1928,6828
0.181,17,2,154,1,33,0,33,61,1,65,0,65,93
1746.132,6,90,6540,60,31,29595,31,4050,30,31,60204,31,2490
1648.226,1,7,392,7,28,274704,28,392,0,0,0,0,0
1.32,6,47,19519,27,916,50,1460,13943,20,433,60,1460,5576
280.609,6,29,7392,13,158,23384,267,1317,16,603,18701,2036,6075
1775.472,17,138,11040,69,48,26109,48,5244,69,56,26109,56,5796
24.621,6,31,5676,18,174,1448,517,2350,13,440,2050,499,3326
1799.085,17,448,39384,403,35,4475,288,25412,45,282,40017,288,13972
164.331,6,21,8748,11,314,69,634,1451,10,1147,18243,2720,7297
1699.452,17,12,498,11,14,169945,14,462,1,8,0,8,36
1790.452,6,356,22520,208,69,8649,69,12460,148,69,12179,69,10060
1792.072,17,83,3480,82,14,22124,14,3444,1,8,0,8,36
248.223,6,50,6486,23,279,11282,686,3218,27,142,9546,580,3268
10.921,6,1743,1510286,1066,1364,10,1380,1478973,677,467,16,1923,31313
240.169,6,64,22451,33,824,7505,1408,18257,31,230,8005,580,4194
1789.852,1,62,5208,62,56,29341,56,5208,0,0,0,0,0
0.662,6,10,924,5,283,116,283,551,5,105,116,105,373
1680.651,17,12,498,11,14,168065,14,462,1,8,0,8,36
0.68,6,4,1577,1,1333,0,1333,1385,3,0,340,0,192
1738.609,1,56,4704,56,56,31611,56,4704,0,0,0,0,0
74.534,17,5,1692,5,310,18633,320,1692,0,0,0,0,0
233.207,6,5,293,4,31,77735,31,222,1,31,0,31,71
3.242,6,27,11042,10,185,360,275,961,17,783,190,1440,10081
1680.099,1,15,840,15,28,120007,28,840,0,0,0,0,0
2.918,17,4,624,4,128,972,128,624,0,0,0,0,0
261.691,17,6,2016,6,308,52338,308,2016,0,0,0,0,0
1798.449,6,371,25410,215,93,8403,469,14754,156,69,11602,69,10656
1783.496,17,83,3480,82,14,22018,14,3444,1,8,0,8,36
0.262,6,22,5040,10,137,29,267,1092,12,577,22,1400,3948
1740.032,17,29,2407,29,55,62144,55,2407,0,0,0,0,0
1771.565,6,80,4250,40,26,45423,26,2132,40,26,45423,26,2118
55.728,6,24,4671,11,256,5572,722,1592,13,299,4613,1408,3079
0.389,17,2,152,1,48,0,48,76,1,48,0,48,76
280.221,6,30,7432,13,158,23351,267,1317,17,543,17511,1300,6115
1744.679,2,29,928,29,8,62309,8,928,0,0,0,0,0
1771.686,6,101,9410,66,66,27256,66,5610,35,60,52105,60,3800
3.262,6,13,3096,4,92,1087,92,296,9,464,374,1408,2800
1786.315,17,87,3648,86,14,21015,14,3612,1,8,0,8,36
1782.595,6,356,22520,208,69,8611,69,12460,148,69,12126,69,10060
1700.145,17,12,498,11,14,170014,14,462,1,8,0,8,36
19.234,17,2,152,2,48,19234,48,152,0,0,0,0,0
1799.395,1,58,4872,58,56,31568,56,4872,0,0,0,0,0
6.76,6,11,5498,4,106,2253,106,274,7,987,1085,1460,5224
2.077,6,30,10405,18,367,122,833,1825,12,1012,180,1420,8580
1.218,6,51,19594,28,906,45,1360,13853,23,437,47,2715,5741
5.198,17,4,352,2,60,5197,60,176,2,60,5196,60,176
1739.184,6,87,6322,58,31,30512,31,3915,29,31,62112,31,2407
0.579,17,4,288,2,36,547,36,128,2,52,547,52,160
125.786,6,16,3970,8,407,17969,722,1226,8,464,17916,1448,2744
19.087,17,33,6754,16,210,1270,1350,3815,17,144,1190,1350,2939
1797.235,17,142,11360,71,48,25674,48,5396,71,56,25674,56,5964
919.049,6,135,24776,51,278,18380,1460,11029,84,172,11071,1629,13747
0.015,17,2,493,1,46,0,46,74,1,391,0,391,419
1.84,17,9,3257,9,333,230,359,3257,0,0,0,0,0
10.102,6,6,383,3,131,5051,131,255,3,0,2617,0,128
56.26,6,11,1583,11,127,5626,127,1583,0,0,0,0,0
0.52,6,28,9213,14,216,40,688,1831,14,947,37,1368,7382
367.049,6,25,1651,17,177,22940,177,1117,8,110,9231,110,534
1799.047,17,142,11360,71,48,25700,48,5396,71,56,25700,56,5964
1741.697,1,8,848,8,78,248813,78,848,0,0,0,0,0
52.127,6,35,7980,15,155,3723,267,1381,20,386,2703,1400,6599
1735.355,1,106,5936,106,28,16527,28,5936,0,0,0,0,0
0.022,6,6,716,3,302,9,302,458,3,102,9,102,258
1.479,17,6,552,3,32,733,32,180,3,96,714,96,372
1.356,6,39,9889,20,503,71,1460,4353,19,433,65,1460,5536
4.182,6,39,7269,20,218,220,314,3423,19,513,218,1179,3846
175.336,17,7,532,7,48,29222,48,532,0,0,0,0,0
1.561,6,41,9968,21,440,78,1360,4392,20,433,71,1360,5576
31.696,6,7,308,1,0,0,0,44,6,0,6290,0,264
0.862,6,20,5948,11,281,86,544,1288,9,716,96,1420,4660
3.643,6,2,88,2,0,0,0,88,0,0,0,0,0
1771.611,6,99,9306,66,66,27255,66,5610,33,60,55360,60,3696
53.399,6,47,10407,23,541,650,910,3179,24,347,2316,3488,7228
29.931,17,18,1584,9,48,3740,48,684,9,72,3739,72,900
26.97,6,46,9121,23,172,1225,721,2652,23,504,1216,1414,6469
1786.845,6,102,8296,68,65,26669,65,4930,34,59,54142,59,3366
11.477,6,91,27205,46,561,255,1152,20923,45,407,254,1152,6282
271.525,1,2,112,2,28,271525,28,112,0,0,0,0,0
292.426,1,4,224,4,28,97475,28,224,0,0,0,0,0
124.895,17,4,352,2,60,124894,60,176,2,60,124893,60,176
0.586,6,2,100,1,0,0,0,60,1,0,0,0,40
11.058,6,19,4362,11,275,1105,275,998,8,1010,893,2840,3364
0.117,17,2,2344,2,1144,117,1258,2344,0,0,0,0,0
35.916,6,9,540,0,0,0,0,0,9,0,0,0,540
1.622,6,24,6040,13,108,135,147,959,11,772,140,1608,5081
0.781,6,15,1785,8,288,87,288,640,7,426,99,434,1145
0.266,6,22,4442,11,165,26,456,1394,11,493,25,888,3048
1791.618,17,180,14040,180,50,10009,50,14040,0,0,0,0,0
1771.967,6,101,9344,66,65,27261,65,5577,35,59,52114,59,3767
316.757,6,107,37031,55,587,5865,1460,26322,52,297,6208,1629,10709
20.005,17,4,352,2,60,20004,60,176,2,60,20004,60,176
179.45,17,20,1760,10,48,19937,48,760,10,72,19937,72,1000
1667.605,1,7,392,7,28,277934,28,392,0,0,0,0,0
0.043,17,2,164,1,46,0,46,74,1,62,0,62,90
105.143,6,30,7432,13,158,8761,267,1317,17,543,6569,1400,6115
317.395,6,75,19856,36,393,9068,1360,10131,39,339,8347,1360,9725
0.147,6,43,19679,25,1055,6,1420,14738,18,467,8,1883,4941
0.372,17,8,2758,8,316,53,355,2758,0,0,0,0,0
11.627,6,1839,1602842,1112,1386,10,1420,1569541,727,467,16,1883,33301
8.287,6,39,9933,18,533,487,910,2887,21,364,407,2128,7046
1.468,6,35,12222,18,518,86,1360,3366,17,742,71,1360,8856
1742.874,6,94,7151,62,38,28571,205,4424,32,33,56208,98,2727
11.628,6,1786,1604667,1132,1366,10,1380,1574121,654,383,17,1380,30546
1681.315,17,18,4718,9,30,210163,37,529,9,437,210163,463,4189
0.06,6,9,1346,5,145,15,145,349,4,833,15,833,997
1.596,6,25,9554,14,410,122,922,1822,11,1040,145,1456,7732
2.805,6,22,5231,12,351,255,1382,2242,10,517,310,2433,2989
1798.718,17,142,11360,71,48,25695,48,5396,71,56,25695,56,5964
1786.313,17,87,3648,86,14,21015,14,3612,1,8,0,8,36
720.403,1,10,959,10,67,80044,91,959,0,0,0,0,0
1789.034,17,142,11360,71,48,25557,48,5396,71,56,25557,56,5964
0.131,17,2,279,1,36,0,36,64,1,187,0,187,215
10.395,6,24,8249,13,371,866,832,1799,11,838,1029,2523,6450
1795.47,6,388,26153,220,84,8198,1189,14819,168,74,10750,405,11334
0.251,17,2,1920,2,932,251,932,1920,0,0,0,0,0
0.029,6,12,3705,6,171,4,171,491,6,964,5,1448,3214
20.751,6,14,2195,8,329,2964,595,1083,6,396,4105,580,1112
42.973,1,3,168,3,28,21486,28,168,0,0,0,0,0
0.844,17,6,654,3,33,419,33,183,3,129,418,145,471
0.398,6,13,1693,7,288,65,288,588,6,426,42,434,1105
60.487,6,34,5120,20,134,3183,174,1608,14,368,3557,1452,3512
128.199,17,4,352,2,60,128198,60,176,2,60,128198,60,176
240.207,6,57,20287,28,876,8896,1418,17243,29,191,8578,580,3044
0.015,6,10,1865,6,649,2,1141,1542,4,159,4,159,323
4.278,6,35,6225,19,206,237,314,2824,16,551,268,1179,3401
1.387,6,30,6427,15,164,99,267,1922,15,780,87,1460,4505
1772.292,6,180,15480,120,69,14893,69,8940,60,69,30037,69,6540
50.049,6,29,7392,13,158,4170,267,1317,16,603,3334,2800,6075
366.155,6,19,1303,14,177,28165,177,925,5,110,17661,110,378
0.401,6,5,200,2,0,269,0,80,3,0,153,0,120
1774.997,6,284,36400,116,142,15433,1360,17184,168,146,10627,2720,19216
14.355,6,23,4817,9,204,1794,722,1487,14,324,1088,1408,3330
0.049,6,10,1863,5,105,12,105,325,5,1326,12,1326,1538
0.021,1,10,840,10,56,2,56,840,0,0,0,0,0
257.036,6,66,17550,38,724,6946,1230,11404,28,186,9519,1296,6146
300.578,6,44,10387,24,622,13060,1360,4740,20,371,15810,1360,5647
1.336,6,25,8056,12,164,103,267,1288,13,869,95,1368,6768
1772.383,6,180,15480,120,69,14893,69,8940,60,69,30033,69,6540
0.434,6,12,1653,6,288,82,288,548,6,426,47,434,1105
1793.779,6,284,33738,116,136,15596,1460,16440,168,125,10740,1642,17298
0.701,6,28,5842,13,135,58,267,1337,15,650,45,1420,4505
1785.648,6,416,24920,208,69,8626,69,12460,208,34,8626,64,12460
16.331,17,12,5828,6,584,3259,1350,3674,6,331,3259,1350,2154
1445.511,6,87,6900,52,64,26542,64,3744,35,51,42512,58,3156
288.727,1,4,224,4,28,96242,28,224,0,0,0,0,0
100.151,6,39,10145,15,327,7153,1189,2575,24,330,4353,1997,7570
8.253,6,24,7148,8,154,1179,267,792,16,519,536,1440,6356
0.236,17,2,152,1,48,0,48,76,1,48,0,48,76
1787.92,6,355,22480,207,69,8679,69,12420,148,69,12162,69,10060
101.363,6,138,65255,74,820,22,1440,51415,64,363,1606,1698,13840
38.889,17,22,1672,22,48,1851,48,1672,0,0,0,0,0
0.111,6,11,1566,6,503,22,503,823,5,475,27,475,743
1773.608,6,180,15480,120,69,14904,69,8940,60,69,30052,69,6540
17.179,6,21,2704,9,304,2147,304,1688,12,83,1545,83,1016
18.936,6,21,6575,6,154,3787,267,712,15,477,1336,1452,5863
1443.851,2,15,480,15,8,103132,8,480,0,0,0,0,0
0.052,17,2,201,1,50,0,50,78,1,95,0,95,123
27.486,17,16,1408,8,48,3924,48,608,8,72,3924,72,800
20.402,6,29,8832,13,158,1700,267,1317,16,763,1357,1781,7515
240.176,6,58,20652,32,808,7747,1408,17834,26,182,9606,580,2818
0.014,17,2,394,1,37,0,37,65,1,301,0,301,329
0.111,6,2,116,2,0,0,0,116,0,0,0,0,0
77.251,6,9,468,9,0,0,0,468,0,0,0,0,0
0.117,6,13,1997,7,329,19,500,1030,6,323,23,500,967
11.374,6,2328,2173327,1489,1381,7,1408,2125035,839,931,13,2816,48292
5.276,6,39,7269,19,218,293,314,3383,20,513,261,1179,3886
137.148,6,24,8206,12,201,56,290,1115,12,824,12455,2720,7091
1111.495,17,17,5732,17,309,69468,326,5732,0,0,0,0,0
0.856,6,2,1134,1,0,0,0,40,1,1054,0,1054,1094
6.528,17,31,9473,15,388,464,1350,6243,16,173,433,1350,3230
1799.915,17,142,11360,71,48,25712,48,5396,71,56,25712,56,5964
25.625,6,24,6231,14,117,1971,159,1337,10,727,2846,1418,4894
6.061,17,12,1242,6,50,1211,50,468,6,101,1211,107,774
1771.841,6,99,9240,66,65,27259,65,5577,33,59,55366,59,3663
1767.969,6,78,4108,39,26,46524,26,2054,39,26,46524,26,2054
14.57,2,5,224,5,20,3642,32,224,0,0,0,0,0
240.189,6,53,18060,28,801,8895,1402,15095,25,207,10007,580,2965
0.035,17,4,820,2,36,30,36,128,2,318,31,318,692
0.842,6,20,5948,11,281,84,544,1288,9,716,94,1420,4660
0.106,6,41,27079,23,273,4,517,2173,18,1711,5,4224,24906
15.115,17,18,11078,10,871,1676,1350,8993,8,232,2155,1350,2085
551.042,17,12,4093,12,313,50094,342,4093,0,0,0,0,0
1776.115,6,80,4212,40,26,45540,26,2106,40,26,45540,26,2106
60.572,6,29,11234,15,631,4326,1448,3969,14,724,4651,1448,7265
2.091,17,3,1170,3,362,1045,362,1170,0,0,0,0,0
16.596,6,34,8248,19,367,922,786,1894,15,574,642,4848,6354
239.199,17,4,352,2,60,239197,60,176,2,60,239198,60,176
0.281,17,2,602,1,46,0,46,74,1,500,0,500,528
1792.986,17,87,3648,86,14,21093,14,3612,1,8,0,8,36
280.477,6,30,7432,13,158,23373,267,1317,17,543,17516,1400,6115
8.048,17,16,18228,2,723,4049,1350,1503,14,1166,616,1350,16725
87.13,6,51,12025,22,200,2735,955,3340,29,357,3106,2720,8685
16.306,17,32,13348,14,477,1251,1350,7082,18,320,957,1350,6266
186.292,17,4,352,2,60,186291,60,176,2,60,186291,60,176
184.095,17,4,530,2,36,184091,36,128,2,173,184091,187,402
23.976,17,16,7120,7,425,3990,1350,3171,9,410,2992,1350,3949
0.105,1,2,112,2,28,105,28,112,0,0,0,0,0
0.033,17,2,231,1,34,0,34,62,1,141,0,141,169
0.422,6,9,527,5,43,105,43,311,4,0,98,0,216
0.503,17,3,451,2,39,443,39,134,1,289,0,289,317
1772.344,6,180,15480,120,69,14893,69,8940,60,69,30031,69,6540
30.321,1,4,224,4,28,10107,28,224,0,0,0,0,0
0.756,6,49,19227,26,997,30,1380,14065,23,421,30,1923,5162
0.344,6,4,1037,2,0,217,0,104,2,853,128,853,933
684.321,6,143,10536,70,79,9902,86,4069,73,39,9494,63,6467
1783.202,6,119,13736,78,81,23158,501,6070,41,154,44576,1420,7666
1786.55,1,17,2495,17,118,111659,351,2495,0,0,0,0,0
300.234,6,26,7058,15,147,21445,240,1376,11,850,24018,1592,5682
3.536,6,75,18707,38,551,95,1429,5520,37,417,90,1460,13187
1790.129,6,354,22440,206,69,8732,69,12380,148,69,12177,69,10060
1.132,6,10,924,5,283,239,283,551,5,105,239,105,373
157.507,6,23,9329,11,330,72,682,1463,12,1053,14306,1440,7866
1779.864,1,342,28728,342,56,5219,56,28728,0,0,0,0,0
1400.957,17,14,3692,7,31,233492,37,413,7,440,233492,463,3279
280.332,6,29,7392,13,158,23361,267,1317,16,603,18687,2036,6075
1773.247,6,181,15589,120,69,14901,69,8940,61,69,29551,69,6649
1793.133,1,69,5796,69,56,26369,56,5796,0,0,0,0,0
0.118,17,2,176,1,60,0,60,88,1,60,0,60,88
35.177,17,40,5880,20,48,1851,48,1520,20,190,1850,308,4360
1700.471,17,12,498,11,14,170047,14,462,1,8,0,8,36
8.625,17,6,528,3,48,4301,48,228,3,72,4299,72,300
1741.117,6,87,6322,58,31,30545,31,3915,29,31,62179,31,2407
0.0,6,2,192,2,112,0,112,192,0,0,0,0,0
0.434,17,14,10918,8,748,62,1350,6208,6,757,44,1350,4710
3.383,17,29,10069,15,299,239,1350,4911,14,340,257,1350,5158
1771.824,6,101,9344,66,65,27258,65,5577,35,59,52109,59,3767
8.271,6,17,5331,9,275,1033,275,643,8,1089,841,1420,4688
1796.615,17,87,3648,86,14,21136,14,3612,1,8,0,8,36
1772.619,6,181,15589,120,69,14895,69,8940,61,69,29542,69,6649
1782.223,17,83,3480,82,14,22002,14,3444,1,8,0,8,36
0.507,6,23,4531,11,165,50,456,1394,12,498,42,888,3137
0.856,17,2,780,2,362,856,362,780,0,0,0,0,0
1680.601,17,12,498,11,14,168060,14,462,1,8,0,8,36
1779.647,6,357,22629,208,69,8597,69,12529,149,69,12024,69,10100
0.036,17,2,510,1,37,0,37,65,1,417,0,417,445
215.879,17,6,698,6,88,43175,300,698,0,0,0,0,0
0.096,17,2,586,1,46,0,46,74,1,484,0,484,512
27.804,6,46,8913,22,401,775,889,2200,24,441,1203,1360,6713
240.747,6,43,8089,19,248,13373,517,2750,24,452,10464,1457,5339
39.028,17,44,6468,22,48,1858,48,1672,22,190,1858,308,4796
43.924,6,651,423153,326,337,135,338,26500,325,1236,135,1460,396653
2.556,17,3,1167,3,361,1278,361,1167,0,0,0,0,0
5.576,6,581,505029,362,1328,14,1368,488977,219,776,24,1473,16052
0.063,17,2,154,1,33,0,33,61,1,65,0,65,93
30.562,17,6,456,6,48,6112,48,456,0,0,0,0,0
63.234,6,8,474,2,106,63216,106,194,6,0,12643,0,280
10.334,6,38,7484,19,239,574,314,3638,19,513,560,1179,3846
0.35,17,2,154,1,33,0,33,61,1,65,0,65,93
5.959,6,5,220,5,0,0,0,220,0,0,0,0,0
0.505,17,2,144,1,36,0,36,64,1,52,0,52,80
280.193,6,29,7392,13,158,23349,267,1317,16,603,18677,2600,6075
1795.992,17,449,39928,404,35,4456,288,25708,45,288,40018,288,14220
1799.198,6,380,24032,216,69,8368,69,13332,164,69,11037,69,10700
1.699,17,6,360,3,32,849,32,180,3,32,849,32,180
1745.321,1,8,448,8,28,249331,28,448,0,0,0,0,0
299.531,6,6,364,4,31,99843,31,222,2,31,299519,31,142
0.769,6,10,1687,7,100,128,100,384,3,1179,258,1179,1303
0.344,6,28,9123,13,247,28,624,1672,15,832,23,1408,7451
2.789,17,2,677,1,300,0,300,328,1,321,0,321,349
0.469,6,3,258,1,0,0,0,40,2,69,468,69,218
2.225,17,2,677,1,300,0,300,328,1,321,0,321,349
240.367,6,44,8939,21,519,12018,1402,5776,23,217,10925,617,3163
0.016,17,2,158,1,34,0,34,62,1,68,0,68,96
1.172,17,2,237,1,72,0,72,100,1,109,0,109,137
3.005,17,3,1021,2,308,2004,308,672,1,321,0,321,349
26.087,6,35,8463,18,410,514,882,2030,17,521,1620,3488,6433
36.146,17,38,5468,19,48,2007,48,1444,19,183,2007,308,4024
8.518,6,14,5267,6,275,1703,275,519,8,1104,749,1440,4748
2.96,6,9,527,5,43,740,43,311,4,0,735,0,216
1795.89,17,449,39928,404,35,4456,288,25708,45,288,40016,288,14220
0.011,17,3,474,2,36,4,36,128,1,318,0,318,346
1787.806,6,363,23007,211,69,8513,69,12787,152,69,11837,69,10220
0.042,17,2,248,1,40,0,40,68,1,152,0,152,180
10.856,6,20,8440,10,275,1206,275,958,10,1414,987,1414,7482
0.629,17,19,11059,9,631,75,1350,5931,10,484,65,1350,5128
0.266,6,23,5482,13,125,21,212,1026,10,675,29,1420,4456
158.96,6,43,10250,13,231,13245,1189,2840,30,295,5481,1420,7410
1783.488,17,83,3480,82,14,22018,14,3444,1,8,0,8,36
36.374,1,4,224,4,28,12124,28,224,0,0,0,0,0
10.797,6,20,4442,11,275,1079,275,998,9,768,749,1440,3444
0.011,6,2,80,1,0,0,0,40,1,0,0,0,40
1792.786,6,117,7620,68,49,26758,208,4606,49,31,37341,31,3014
1787.671,6,206,14302,75,46,24156,46,5980,131,46,13750,46,8322
1.285,6,50,19561,27,910,49,1460,13865,23,433,50,1460,5696
1740.523,17,30,7050,30,207,60018,207,7050,0,0,0,0,0
1769.97,6,101,9344,66,65,27230,65,5577,35,59,52054,59,3767
11.459,6,1791,1574253,1114,1362,10,1380,1541008,677,511,16,1923,33245
1.657,6,13,2311,8,188,236,245,700,5,1407,351,1407,1611
42.534,17,24,1824,24,48,1849,48,1824,0,0,0,0,0
1772.521,6,180,15480,120,69,14895,69,8940,60,69,30037,69,6540
8.59,6,11,676,3,106,4290,106,234,8,90,1225,90,442
65.132,6,27,7177,13,155,5427,267,1306,14,530,5009,3417,5871
17.644,6,42,9403,22,361,840,768,2019,20,469,511,1460,7384
2.793,6,2,88,2,0,0,0,88,0,0,0,0,0
7.427,6,1713,1590679,1086,1387,6,1408,1553411,627,931,11,2816,37268
6.559,6,47,8489,24,227,285,314,4142,23,489,284,1179,4347
0.007,17,2,515,1,40,0,40,68,1,419,0,419,447
217.991,6,30,8872,14,158,16768,267,1357,16,763,14529,2036,7515
240.197,6,53,17626,28,786,8896,1408,14842,25,184,10008,580,2784
1773.472,6,180,15480,120,69,14903,69,8940,60,69,30057,69,6540
188.943,6,56,14557,22,228,5953,1189,3398,34,376,5725,1460,11159
1742.219,1,12,696,12,30,158383,30,696,0,0,0,0,0
131.249,6,16,4690,5,92,32812,92,360,11,469,13100,2026,4330
9.602,6,57,21687,28,971,355,1440,15727,29,433,336,1440,5960
1775.165,17,142,11360,71,48,25359,48,5396,71,56,25359,56,5964
8.408,6,22,3384,11,256,836,256,1724,11,304,835,304,1660
280.508,17,4,296,2,30,280467,30,116,2,62,280431,62,180
1784.965,6,364,23047,211,69,8499,69,12787,153,69,11740,69,10260
11.964,6,25,8473,13,275,997,275,1078,12,986,849,1440,7395
1781.191,6,181,15589,121,69,14843,69,9049,60,69,30180,69,6540
28.772,6,48,12904,23,191,1307,721,2453,25,629,1155,1420,10451
20.662,6,3427,3313449,2290,1371,8,1408,3249661,1137,776,18,1408,63788
106.059,6,112,85531,72,1277,1493,1448,75307,40,625,2712,1448,10224
282.316,17,4,296,2,30,282096,30,116,2,62,281999,62,180
1.642,17,2,144,1,36,0,36,64,1,52,0,52,80
240.38,6,44,8447,22,449,11446,1402,5648,22,205,11446,580,2799
1782.605,17,331,71361,331,187,5401,361,71361,0,0,0,0,0
1775.579,17,130,10400,65,48,27743,48,4940,65,56,27743,56,5460
8.751,6,78,24645,40,560,224,1152,18968,38,461,229,1179,5677
10.935,17,30,7858,13,293,911,1350,4174,17,188,675,1350,3684
60.869,17,8,704,4,48,20287,48,304,4,72,20286,72,400
0.187,6,2,80,1,0,0,0,40,1,0,0,0,40
1787.894,6,356,22520,208,69,8637,69,12460,148,69,12162,69,10060
1.348,6,37,8212,19,320,74,1162,2716,18,476,68,2920,5496
12.68,2,2,64,2,8,12680,8,64,0,0,0,0,0
1773.9,6,182,15698,120,69,14906,69,8940,62,69,29072,69,6758
93.884,6,23,10009,12,531,64,1360,2637,11,1384,9374,3934,7372
290.265,6,36,3657,18,324,17074,585,1653,18,153,17074,580,2004
64.827,6,98,65191,57,1205,1157,1368,56020,41,751,1614,2519,9171
1323.598,2,13,416,13,8,110299,8,416,0,0,0,0,0
1008.331,2,9,288,9,8,126041,8,288,0,0,0,0,0
1032.004,6,54,3881,35,31,30353,31,2335,19,31,57332,31,1546
523.738,17,14,1232,7,48,87288,48,532,7,72,87288,72,700
34.435,17,40,5880,20,48,1811,48,1520,20,190,1811,308,4360
3.589,6,14,2351,8,188,512,245,700,6,703,651,1152,1651
4.544,6,37,7205,19,218,252,314,3383,18,516,251,1179,3822
1.452,6,48,19163,26,956,58,1460,13507,22,433,59,1460,5656
1787.444,6,359,22709,209,69,8593,69,12569,150,69,11995,69,10140
1720.688,17,13,534,11,14,172051,14,462,2,8,1720510,8,72
61.248,6,26,7144,13,142,5104,174,950,13,708,5092,1420,6194
280.49,6,29,7392,12,158,25499,267,1277,17,603,17527,1400,6115
240.229,6,58,20089,29,853,8579,1418,16872,29,212,8579,580,3217
0.047,17,4,284,2,32,40,32,120,2,54,8,60,164
1790.754,6,131,8072,70,26,25952,26,4228,61,26,29845,26,3844
116.936,1,4,224,4,28,38978,28,224,0,0,0,0,0
240.451,6,58,18343,28,774,8903,1418,15406,30,171,8289,580,2937
1786.916,6,104,8444,68,66,26670,66,4964,36,60,51052,60,3480
34.441,17,3,228,3,48,17220,48,228,0,0,0,0,0
1797.408,6,375,26577,217,104,8321,469,15772,158,69,11448,69,10805
12.386,6,90,26637,45,562,281,1152,20355,45,447,275,1179,6282
252.455,2,2,64,2,8,252455,8,64,0,0,0,0,0
0.515,17,3,451,2,39,437,39,134,1,289,0,289,317
1.11,6,26,9564,13,164,79,267,1388,13,1070,79,2816,8176
20.141,6,21,6076,12,147,1831,318,1233,9,873,2516,1675,4843
0.093,6,2,84,1,0,0,0,44,1,0,0,0,40
3.556,17,5,290,5,30,889,30,290,0,0,0,0,0
10.799,6,20,4442,11,275,1079,275,998,9,768,750,1440,3444
11.651,6,2170,2079559,1388,1420,8,1448,2034219,782,776,14,1448,45340
0.432,6,7,371,4,0,144,0,204,3,7,124,7,167
0.118,17,2,572,1,39,0,39,67,1,477,0,477,505
1746.169,6,95,7203,63,38,28164,205,4476,32,33,56316,98,2727
8.349,6,77,24637,39,561,219,1152,18976,38,413,218,1152,5661
1782.649,17,83,3480,82,14,22008,14,3444,1,8,0,8,36
34.037,17,10,760,10,48,3781,48,760,0,0,0,0,0
0.239,6,25,7216,13,155,19,267,1301,12,775,19,4836,5915
1.169,6,32,6084,16,111,77,267,1539,16,650,69,1452,4545
0.056,17,2,602,1,46,0,46,74,1,500,0,500,528
0.538,6,119,87305,57,131,9,232,2809,62,1464,8,5720,84496
0.322,6,26,8903,13,234,26,575,1620,13,1099,26,2816,7283
1799.355,17,449,39928,404,35,4464,288,25708,45,288,40020,288,14220
1740.738,17,30,7050,30,207,60025,207,7050,0,0,0,0,0
46.37,6,44,10172,21,706,857,1460,4450,23,399,2099,1460,5722
98.43,17,4318,5186683,547,63,180,1350,50220,3771,1334,26,1350,5136463
0.038,6,2,92,1,0,0,0,40,1,0,0,0,52
15.651,17,17,6613,8,483,2219,1350,4095,9,251,1949,1350,2518
15.125,6,2,1175,1,0,0,0,40,1,1095,0,1095,1135
1648.458,1,7,392,7,28,274743,28,392,0,0,0,0,0
0.019,17,4,424,2,46,0,46,148,2,110,0,110,276
33.587,6,31,5103,15,180,2399,722,1858,16,301,2225,1448,3245
41.164,6,5578,5269614,3639,1369,11,1408,5164122,1939,931,21,2801,105492
0.307,6,27,9042,13,247,25,624,1672,14,947,23,1448,7370
669.639,6,42,7697,24,126,16451,518,2230,18,296,39385,1420,5467
2.196,6,13,2311,8,188,313,245,700,5,1407,483,1407,1611
20.428,6,18,1380,10,283,2251,283,827,8,105,2894,105,553
1797.507,17,447,39580,403,35,4471,288,25676,44,288,40950,288,13904
1797.06,6,343,29910,196,76,9215,267,13021,147,148,12308,1997,16889
11.145,17,15,16767,15,1089,796,1451,16767,0,0,0,0,0
9.726,1,3,667,3,194,4863,232,667,0,0,0,0,0
1794.673,6,357,22629,208,69,8669,69,12460,149,69,12126,69,10169
1.333,6,46,19457,27,914,51,1360,13921,19,476,64,2715,5536
1787.396,17,87,3648,86,14,21028,14,3612,1,8,0,8,36
1799.254,6,356,22520,208,69,8692,69,12460,148,69,12239,69,10060
1790.93,6,353,22400,205,69,8779,69,12340,148,69,12182,69,10060
1781.762,6,365,23087,211,69,8484,69,12787,154,69,11645,69,10300
0.353,6,27,9069,13,261,29,683,1728,14,943,25,1438,7341
156.273,6,1425,720280,790,843,198,1152,688011,635,403,246,1179,32269
0.507,6,12,1653,6,288,97,288,548,6,426,56,434,1105
0.094,17,2,1922,2,933,94,933,1922,0,0,0,0,0
200.532,6,14,3205,3,245,128,245,369,11,299,20029,299,2836
280.196,6,30,7432,14,158,21553,267,1357,16,603,18677,2800,6075
5.549,6,40,7325,20,218,292,314,3423,20,516,278,1179,3902
0.008,6,2,111,1,0,0,0,40,1,31,0,31,71
0.968,6,26,6029,14,154,74,267,1644,12,650,82,1420,4385
280.197,6,29,7392,13,158,23349,267,1317,16,603,18678,1400,6075
1.383,6,51,19725,29,912,49,1460,14024,22,480,57,4075,5701
0.411,6,27,9107,13,263,34,691,1736,14,829,30,1448,7371
0.028,6,2,80,1,0,0,0,40,1,0,0,0,40
282.579,6,33,8257,15,158,20184,267,1397,18,613,16618,2085,6860
14.102,6,6,328,4,0,4700,0,216,2,0,13880,0,112
31.964,6,28,8320,15,259,2283,517,2072,13,618,2577,3107,6248
120.296,6,69,49443,46,1185,2673,1408,41513,23,960,2801,3847,7930
240.211,6,54,17707,29,774,8578,1402,14683,25,214,10008,580,3024
0.01,17,2,198,1,39,0,39,67,1,103,0,103,131
0.043,6,4,3618,4,864,14,1460,3618,0,0,0,0,0
136.518,17,8,2688,8,308,19502,308,2688,0,0,0,0,0
1740.084,17,30,2490,30,55,60002,55,2490,0,0,0,0,0
282.228,6,32,7603,14,158,21709,267,1357,18,552,16599,2076,6246
0.004,6,2,350,1,0,0,0,40,1,258,0,258,310
1561.035,6,327,23084,186,102,8437,469,13580,141,69,11150,69,9504
1629.68,17,26,1086,25,14,67903,14,1050,1,8,0,8,36
1778.273,6,79,4160,40,26,45595,26,2106,39,26,46795,26,2054
1783.235,6,361,22858,210,69,8532,69,12678,151,69,11887,69,10180
240.543,6,60,18914,31,796,8017,1418,15961,29,179,8590,580,2953
1783.811,6,369,24723,214,87,8374,469,14176,155,69,11583,69,10547
61.939,17,70,48030,42,908,1510,1350,39315,28,283,2293,1350,8715
1.268,6,47,18729,27,860,48,1360,13153,20,433,57,1360,5576
18.65,17,12,1056,6,48,3726,48,456,6,72,3727,72,600
120.391,2,3,96,3,8,60195,8,96,0,0,0,0,0
11.586,6,1816,1603598,1112,1387,10,1420,1571073,704,467,16,1883,32525
1786.79,6,356,22520,208,69,8631,69,12460,148,69,12154,69,10060
0.11,6,10,1677,6,555,21,951,1354,4,159,36,159,323
56.685,6,44,9020,20,419,791,944,2151,24,327,2458,1460,6869
1799.451,1,57,4788,57,56,32133,56,4788,0,0,0,0,0
191.155,6,10,628,4,106,63715,106,274,6,90,38228,90,354
0.108,6,12,1955,6,105,21,105,377,6,1326,21,1326,1578
1746.976,6,100,7256,64,31,27729,31,4356,36,31,49913,31,2900
1742.755,6,95,7203,63,38,28108,205,4476,32,33,56212,98,2727
1.263,6,52,23666,30,986,43,1360,18010,22,476,52,2715,5656
12.558,6,1953,1734251,1223,1362,10,1420,1700664,730,427,17,1420,33587
1799.504,1,288,30528,288,78,6270,78,30528,0,0,0,0,0
33.489,6,31,5106,15,180,2379,722,1870,16,342,2221,1448,3236
133.12,6,21,7640,11,366,13312,517,1666,10,1086,14775,1368,5974
5.007,17,4,542,2,36,4999,36,128,2,179,5003,187,414
29.736,6,16,660,9,0,3717,0,364,7,0,3989,0,296
0.037,17,2,254,1,47,0,47,75,1,151,0,151,179
0.467,6,13,1693,6,288,91,288,548,7,426,43,434,1145
280.231,6,28,7352,13,158,23352,267,1317,15,678,20013,4200,6035
1.796,6,25,8703,15,275,128,557,1429,10,981,177,1420,7274
0.309,6,27,9093,13,252,25,646,1694,14,832,23,1402,7399
901.504,6,107,13530,57,96,16095,721,5478,50,216,18394,1414,8052
22.606,6,41,17365,16,335,1507,1024,4043,25,769,934,2134,13322
0.062,6,13,3514,7,75,10,75,447,6,1373,12,1448,3067
300.274,6,52,29913,20,190,15803,444,1809,32,1057,9685,1461,28104
1798.851,17,346,26296,346,48,5214,48,26296,0,0,0,0,0
1.335,17,2,136,1,32,0,32,60,1,48,0,48,76
489.478,6,50,7148,19,127,18113,516,2035,31,154,16313,1452,5113
1786.06,17,132,10560,66,48,27477,48,5016,66,56,27477,56,5544
1789.205,1,58,4872,58,56,31389,56,4872,0,0,0,0,0
280.52,6,30,7432,13,158,23376,267,1317,17,603,17530,2076,6115
1740.225,6,87,6322,58,31,30530,31,3915,29,31,62150,31,2407
0.189,17,2,218,1,65,0,65,93,1,97,0,97,125
0.089,6,9,1342,5,145,22,145,349,4,829,25,829,993
1797.796,1,345,28980,345,56,5226,56,28980,0,0,0,0,0
0.007,17,2,157,1,31,0,31,59,1,70,0,70,98
83.824,6,30,7435,11,155,743,267,1226,19,388,4639,1460,6209
1798.335,6,359,22709,209,69,8645,69,12569,150,69,12068,69,10140
280.562,6,30,7432,13,158,23380,267,1317,17,603,17532,2076,6115
18.2,17,24,12714,14,716,1397,1350,10428,10,200,2018,1350,2286
376.044,6,18,1242,14,180,28926,180,916,4,110,20069,110,326
3.834,17,2,656,2,300,3834,300,656,0,0,0,0,0
0.16,6,9,1338,5,145,40,145,349,4,825,39,825,989
0.281,17,12,4897,5,432,70,1350,2301,7,342,36,1350,2596
1.293,6,39,10474,21,513,64,1460,4978,18,433,65,1460,5496
1.296,6,45,18081,26,882,51,1460,12545,19,433,62,1460,5536
5.129,6,37,6289,20,206,269,314,2864,17,548,304,1179,3425
4.171,17,5,295,5,31,1042,31,295,0,0,0,0,0
0.208,6,28,7336,13,155,17,267,1301,15,543,14,1400,6035
280.518,6,29,7392,13,158,23376,267,1317,16,678,18697,3456,6075
135.405,6,31,13276,15,488,339,1440,3075,16,954,9017,1440,10201
8.611,17,4,1344,4,308,2870,308,1344,0,0,0,0,0
2.012,17,6,402,3,31,1005,31,177,3,47,1005,47,225
0.004,6,10,13540,1,0,0,0,40,9,1448,0,1448,13500
40.663,17,17,1292,17,48,2541,48,1292,0,0,0,0,0
64.108,6,45,11125,22,867,441,1360,5310,23,348,2906,2720,5815
1771.424,6,103,9448,66,65,27252,65,5577,37,59,49203,59,3871
1772.289,6,180,15480,120,69,14893,69,8940,60,69,30035,69,6540
1781.354,6,363,23007,210,69,8523,69,12747,153,69,11719,69,10260
302.98,6,28,6990,13,158,25248,267,1317,15,633,21637,2076,5673
3.496,6,10,1102,6,483,699,483,803,4,83,1161,83,299
0.96,6,23,6511,13,333,79,1005,2191,10,979,106,2840,4320
33.787,6,30,5041,15,154,2413,722,1859,15,399,2399,1448,3182
1787.005,6,104,8376,68,65,26671,65,4930,36,59,51053,59,3446
371.505,6,21,1419,15,177,26536,177,989,6,110,12242,110,430
1785.79,6,379,92389,176,427,10203,1360,63088,203,220,8839,4662,29301
92.966,17,4,3855,4,935,30988,1438,3855,0,0,0,0,0
1797.414,17,449,39928,404,35,4460,288,25708,45,288,40025,288,14220
1799.375,17,449,39928,404,35,4464,288,25708,45,288,40017,288,14220
144.553,6,35,23905,19,840,35,1360,5835,16,1935,9627,6800,18070
42.28,17,4,352,2,60,42278,60,176,2,60,42279,60,176
0.044,6,3,120,2,0,44,0,80,1,0,0,0,40
1785.865,6,356,22520,208,69,8627,69,12460,148,69,12148,69,10060
0.108,17,2,2754,2,1349,108,1349,2754,0,0,0,0,0
1728.691,17,327,56197,327,143,5302,385,56197,0,0,0,0,0
1793.264,1,252,26712,252,78,7144,78,26712,0,0,0,0,0
1785.687,6,364,23047,211,69,8503,69,12718,153,69,11747,69,10329
11.933,6,1884,1648443,1149,1381,10,1420,1614822,735,467,16,1883,33621
0.38,17,2,152,1,48,0,48,76,1,48,0,48,76
0.648,6,28,17584,12,289,58,517,1499,16,1270,32,1448,16085
1772.51,6,204,22399,130,75,13740,267,10057,74,133,24276,1997,12342
27.888,6,4406,4133107,2857,1368,9,1408,4047895,1549,931,17,2801,85212
9.677,6,2254,1926772,1251,1440,7,1448,1858162,1003,792,9,1448,68610
135.95,17,8,2688,8,308,19421,308,2688,0,0,0,0,0
280.483,6,30,7432,14,158,21575,267,1357,16,678,18692,3456,6075
1787.694,6,115,13683,75,81,24158,504,5920,40,162,45835,1452,7763
0.607,6,23,4531,11,165,60,456,1394,12,498,51,888,3137
1777.764,17,140,11200,70,48,25764,48,5320,70,56,25764,56,5880
12.909,6,37,8409,19,369,717,792,1936,18,441,503,1360,6473
18.361,6,1583,1426640,959,1404,18,1448,1388164,624,776,28,1448,38476
55.119,6,27,7183,13,156,4593,267,1312,14,530,4239,3417,5871
1.859,17,4,580,2,40,1827,40,136,2,194,1711,194,444
240.332,6,44,8447,22,449,11444,1402,5648,22,205,11444,580,2799
1575.917,6,103,12989,59,92,21509,502,4960,44,152,36647,1452,8029
0.0,1,2,222,2,83,0,89,222,0,0,0,0,0
2.382,6,4,222,0,0,0,0,0,4,31,794,31,222
1.418,17,3,1173,3,363,709,363,1173,0,0,0,0,0
4.797,6,15,2233,8,324,685,585,1061,7,396,795,580,1172
1700.615,17,12,498,11,14,170061,14,462,1,8,0,8,36
0.186,6,13,1175,7,146,30,146,430,6,250,36,499,745
0.321,6,22,4442,11,165,32,456,1394,11,493,30,888,3048
0.444,6,13,1693,6,288,87,288,548,7,426,39,434,1145
1794.451,6,366,23196,212,69,8504,69,12896,154,69,11727,69,10300
1.52,6,48,19162,27,888,58,1360,13546,21,476,65,2715,5616
0.288,6,26,6066,13,164,24,453,1494,13,555,22,1542,4572
113.269,6,142,106922,86,1305,1329,1448,95857,56,741,2051,2359,11065
5.012,17,4,558,2,36,5003,36,128,2,187,5002,187,430
3.742,6,2,88,2,0,0,0,88,0,0,0,0,0
3.074,6,43,12208,22,612,146,1360,6496,21,405,143,1360,5712
1275.449,1,18,1008,18,28,75026,28,1008,0,0,0,0,0
480.407,17,122,11288,109,37,4446,288,7180,13,288,40019,288,4108
19.561,17,36,8471,17,277,1220,1350,5193,19,144,1084,1350,3278
0.096,6,9,1002,5,213,24,213,417,4,421,27,421,585
132.078,17,4,288,2,36,132077,36,128,2,52,132077,52,160
11.278,6,1787,1558674,1082,1387,10,1420,1526253,705,467,16,1883,32421
1795.399,17,142,11360,71,48,25648,48,5396,71,56,25648,56,5964
1794.412,17,142,11360,71,48,25634,48,5396,71,56,25634,56,5964
256.698,17,4,240,2,32,256697,32,120,2,32,256697,32,120
0.149,17,4,1116,2,32,145,32,120,2,470,6,470,996
0.107,6,2,104,1,0,0,0,40,1,0,0,0,64
1.435,6,11,988,5,283,314,283,563,6,105,251,105,425
0.02,17,2,120,1,32,0,32,60,1,32,0,32,60
1788.621,1,150,8400,150,28,12004,28,8400,0,0,0,0,0
5.079,6,5,1640,2,0,254,0,80,3,1440,2499,1440,1560
14.512,17,4,352,2,48,14504,48,152,2,72,14504,72,200
0.062,6,10,767,5,186,13,186,454,5,45,14,45,313
0.063,17,2,588,1,39,0,39,67,1,493,0,493,521
1794.002,17,86,3606,85,14,21357,14,3570,1,8,0,8,36
0.7,6,133,97991,80,1299,8,1432,91571,53,389,13,1432,6420
1352.106,1,38,2128,38,28,36543,28,2128,0,0,0,0,0
218.179,1,38,2128,38,28,5896,28,2128,0,0,0,0,0
11.952,6,1915,1650654,1165,1363,10,1380,1616412,750,468,15,3303,34242
0.295,6,10,1840,5,901,73,901,1169,5,403,73,403,671
300.595,6,18,1227,5,177,75105,177,445,13,110,25035,110,782
1788.468,17,87,3648,86,14,21040,14,3612,1,8,0,8,36
3.006,6,11,2235,5,188,751,245,580,6,1407,548,1407,1655
35.38,6,21,6672,6,156,7076,267,718,15,486,2517,1460,5954
0.481,6,20,7165,12,318,43,599,1905,8,1209,67,1906,5260
128.919,1,4,395,4,70,42973,88,395,0,0,0,0,0
280.774,6,30,7432,13,158,23397,267,1317,17,603,17545,2760,6115
204.765,6,27,7312,12,158,18615,267,1277,15,678,14623,2800,6035
1744.71,2,30,960,30,8,60162,8,960,0,0,0,0,0
182.956,6,27,13843,13,534,68,1288,2154,14,1235,14059,3069,11689
1.714,6,25,8755,15,283,122,583,1455,10,985,170,1420,7300
1786.242,17,87,3648,86,14,21014,14,3612,1,8,0,8,36
0.007,17,3,600,2,64,5,64,184,1,388,0,388,416
17.432,17,31,7537,14,296,1338,1350,4540,17,148,1087,1350,2997
1788.997,17,142,11360,71,48,25557,48,5396,71,56,25557,56,5964
1203.189,2,11,352,11,8,120318,8,352,0,0,0,0,0
1777.977,17,138,11040,69,48,26146,48,5244,69,56,26146,56,5796
0.47,6,6,324,4,0,156,0,216,2,0,241,0,108
1794.154,1,62,5208,62,56,29412,56,5208,0,0,0,0,0
0.949,17,18,7018,8,447,135,1350,3801,10,293,90,1350,3217
1679.577,17,12,498,11,14,167957,14,462,1,8,0,8,36
8.069,6,69,21162,36,522,230,1152,16074,33,470,242,1179,5088
0.004,17,8,3220,8,374,0,403,3220,0,0,0,0,0
0.016,6,9,1547,5,515,3,515,783,4,548,5,548,764
0.423,6,26,9013,13,257,35,669,1714,13,945,33,1438,7299
504.317,2,5,160,5,8,126079,8,160,0,0,0,0,0
19.685,6,1309,1193068,866,1305,22,1368,1165368,443,776,44,2736,27700
11.224,6,83,25074,42,568,273,1152,19293,41,459,274,1179,5781
31.948,1,3,168,3,28,15974,28,168,0,0,0,0,0
0.031,6,7,8980,1,0,0,0,40,6,1438,0,1438,8940
0.004,17,2,245,1,32,0,32,60,1,157,0,157,185
0.222,17,5,1631,5,298,55,333,1631,0,0,0,0,0
1791.16,1,58,4872,58,56,31423,56,4872,0,0,0,0,0
6.367,6,9,1647,5,100,1591,100,304,4,589,2036,1152,1343
1.701,6,202,137620,100,944,17,1360,19214,102,1299,15,1848,118406
281.275,6,29,7392,13,158,23439,267,1317,16,603,18739,2036,6075
1323.574,2,10,320,10,8,147063,8,320,0,0,0,0,0
32.897,17,6,528,3,60,16448,60,264,3,60,16447,60,264
899.259,6,14,839,9,31,112407,31,484,5,31,224804,31,355
1799.073,17,180,14040,180,50,10050,50,14040,0,0,0,0,0
23.15,6,31,8015,15,188,1653,721,1922,16,778,1529,2840,6093
4.783,17,19,12770,11,912,478,1350,10347,8,274,636,1350,2423
3.699,6,39,8397,21,320,184,1162,2856,18,480,189,4075,5541
0.427,6,21,7203,12,318,37,600,1906,9,964,52,1471,5297
96.118,6,3,366,2,214,96118,214,314,1,0,0,0,52
1789.351,6,356,22520,208,69,8644,69,12460,148,69,12172,69,10060
1160.849,1,10,560,10,28,128983,28,560,0,0,0,0,0
315.911,6,112,21973,54,289,5960,1360,10982,58,227,5539,4649,10991
1727.299,1,8,448,8,28,246757,28,448,0,0,0,0,0
169.862,6,24,10049,12,531,60,1360,2637,12,1153,15430,2574,7412
1787.862,17,87,3648,86,14,21033,14,3612,1,8,0,8,36
0.472,6,22,4467,11,165,47,456,1394,11,498,42,888,3073
229.222,6,30,8872,14,158,17632,267,1357,16,763,15279,2045,7515
1794.424,6,227,19682,84,77,21617,337,8893,143,70,12635,1062,10789
147.8,17,4,352,2,60,147799,60,176,2,60,147799,60,176
2.178,6,24,5755,13,158,179,370,1315,11,999,216,1691,4440
94.959,6,21,9086,12,304,70,597,1425,9,1457,11848,4441,7661
299.316,1,4,224,4,28,99772,28,224,0,0,0,0,0
1783.906,17,73,3060,72,14,25125,14,3024,1,8,0,8,36
1798.268,6,382,26995,219,103,8248,469,15990,163,69,11098,69,11005
0.457,6,5,1564,3,413,228,413,946,2,269,197,269,618
2.099,6,20,3833,11,234,209,564,1504,9,463,239,1343,2329
202.06,17,4,352,2,60,202059,60,176,2,60,202059,60,176
1797.714,6,377,26726,217,104,8322,469,15772,160,69,11303,69,10954
392.116,1,18,1008,18,28,23065,28,1008,0,0,0,0,0
0.033,17,2,227,1,32,0,32,60,1,139,0,139,167
1795.166,17,80,3354,79,14,23014,14,3318,1,8,0,8,36
258.695,17,4,352,2,60,258694,60,176,2,60,258694,60,176
1795.455,17,449,40212,403,35,4466,288,25676,46,288,39129,288,14536
1.656,6,27,10173,16,284,110,584,1496,11,1029,149,1420,8677
0.063,17,2,241,1,44,0,44,72,1,141,0,141,169
1.25,17,6,849,3,31,618,31,177,3,196,620,196,672
3.759,17,4,240,4,32,1253,32,240,0,0,0,0,0
0.01,6,3,1144,2,512,3,768,1104,1,0,0,0,40
300.529,6,16,1123,6,177,60071,177,497,10,110,33372,110,626
661.79,2,7,224,7,8,110298,8,224,0,0,0,0,0
0.739,6,20,7238,13,335,61,668,2026,7,1210,116,2736,5212
768.808,6,117,14749,62,101,12516,721,6632,55,328,14233,1440,8117
1772.402,6,180,15480,120,69,14894,69,8940,60,69,30036,69,6540
1780.21,6,369,26573,216,108,8280,965,15552,153,74,11711,256,11021
0.066,17,2,211,1,40,0,40,68,1,115,0,115,143
0.038,17,2,472,1,60,0,60,88,1,356,0,356,384
1797.717,1,234,24804,234,78,7715,78,24804,0,0,0,0,0
1769.358,6,99,9306,66,66,27220,66,5610,33,60,55288,60,3696
300.562,6,11,863,5,177,75096,177,445,6,110,60077,110,418
0.29,17,8,2742,8,314,41,353,2742,0,0,0,0,0
280.378,6,29,7392,13,158,23364,267,1317,16,603,18685,1400,6075
0.001,6,4,196,1,0,0,0,40,3,0,0,0,156
116.665,6,37,15001,19,206,153,299,1886,18,952,6852,1460,13115
1601.143,6,194,14655,73,66,22236,295,6910,121,48,13341,78,7745
0.165,6,46,21711,27,1042,6,1420,16730,19,467,8,1883,4981
1.17,6,4,184,2,0,1170,0,88,2,0,1016,0,96
1.087,6,61,25154,32,964,35,1380,19636,29,421,37,1923,5518
0.885,6,20,5997,11,287,88,561,1305,9,721,98,1452,4692
0.231,17,2,152,1,48,0,48,76,1,48,0,48,76
0.61,17,3,451,2,39,379,39,134,1,289,0,289,317
0.068,17,6,912,3,60,26,60,264,3,188,20,188,648
652.827,6,71,6221,43,72,15543,138,3307,28,69,24178,69,2914
8.27,6,17,5331,9,275,1033,275,643,8,1089,839,1420,4688
0.442,6,4,3577,1,0,0,0,40,3,1139,0,1420,3537
126.115,6,266,279573,63,234,2034,909,5390,203,1358,624,1418,274183
5.998,6,2,120,2,0,0,0,120,0,0,0,0,0
34.269,17,40,5880,20,48,1803,48,1520,20,190,1803,308,4360
0.989,6,10,1687,7,100,164,100,384,3,1179,363,1179,1303
22.949,6,18,2501,12,211,2085,211,1102,6,545,4585,904,1399
93.201,6,25,6318,9,272,91,516,1180,16,345,6207,1452,5138
16.285,17,37,13822,18,535,955,1350,10142,19,165,902,1350,3680
2.761,6,32,18635,19,777,153,1360,6246,13,1693,218,3934,12389
1788.437,6,103,6812,65,51,27944,208,4362,38,31,48322,31,2450
1.116,6,30,12906,14,529,85,1440,3250,16,818,62,1440,9656
2.845,17,2,1430,2,687,2845,687,1430,0,0,0,0,0
1.066,17,21,14424,12,968,96,1350,11956,9,246,128,1350,2468
300.346,6,53,30030,30,190,10356,444,2413,23,1553,10996,4224,27617
1.263,6,41,11378,22,547,60,1360,5842,19,476,61,2715,5536
0.3,6,26,9019,13,247,25,624,1672,13,951,24,2816,7347
61.729,6,64,43225,40,1183,1582,1448,35222,24,749,2674,1448,8003
0.367,6,27,9047,13,252,30,647,1692,14,945,26,1408,7355
1776.142,1,69,5796,69,56,26119,56,5796,0,0,0,0,0
48.348,1,4,424,4,78,16116,78,424,0,0,0,0,0
0.914,17,4,826,2,39,900,39,134,2,318,904,332,692
48.302,6,28,7217,13,155,4025,267,1306,15,482,3449,1997,5911
0.028,6,8,458,5,106,6,106,322,3,0,8,0,136
1.018,6,10,1185,6,279,203,279,587,4,191,122,272,598
0.168,17,2,198,1,37,0,37,65,1,105,0,105,133
32.119,6,3,208,3,26,16059,26,208,0,0,0,0,0
1797.803,17,87,3648,86,14,21150,14,3612,1,8,0,8,36
1692.528,1,7,392,7,28,282088,28,392,0,0,0,0,0
0.599,17,4,624,2,64,385,64,184,2,192,333,192,440
291.49,6,6,364,4,31,97163,31,222,2,31,291478,31,142
1774.95,17,142,11360,71,48,25356,48,5396,71,56,25356,56,5964
1794.669,17,144,11520,72,48,25276,48,5472,72,56,25276,56,6048
1734.255,17,154,24844,154,133,11335,405,24844,0,0,0,0,0
0.742,6,12,3044,6,92,148,92,412,6,579,61,1448,2632
289.606,6,120,91005,77,1256,3810,1408,80644,43,811,2478,3847,10361
0.306,17,15,7264,7,531,51,1350,3916,8,390,25,1350,3348
371.958,6,18,1239,14,177,28612,177,913,4,110,20061,110,326
0.448,6,11,818,6,185,71,185,505,5,45,80,45,313
240.335,6,48,8706,25,449,10013,1408,5816,23,187,10924,580,2890
0.221,6,19,4286,11,165,22,456,1394,8,493,29,888,2892
1787.633,17,83,3480,82,14,22069,14,3444,1,8,0,8,36
1795.157,17,447,59917,217,173,8310,1350,43650,230,42,7832,1350,16267
0.275,6,19,5982,11,316,26,592,1846,8,928,38,1891,4136
240.234,6,54,17514,29,724,8579,1418,14558,25,206,10008,580,2956
0.367,6,30,9261,15,252,26,647,1808,15,831,25,1438,7453
0.058,17,8,2454,8,278,8,317,2454,0,0,0,0,0
17.683,17,4,352,2,60,17682,60,176,2,60,17682,60,176
1752.284,6,186,11385,93,47,19046,208,6766,93,31,19043,31,4619
288.868,1,4,326,4,53,96289,78,326,0,0,0,0,0
33.663,6,33,5196,16,154,2244,722,1910,17,299,2091,1448,3286
1.312,6,38,9904,20,510,69,1460,4408,18,476,66,2615,5496
11.858,6,1873,1642213,1160,1363,10,1380,1609463,713,421,16,1923,32750
0.075,6,9,1002,5,213,18,213,417,4,421,19,421,585
0.266,17,4,352,2,60,265,60,176,2,60,264,60,176
1783.814,6,371,25879,215,98,8335,469,15223,156,69,11508,69,10656
1769.34,17,185,42730,185,202,9615,356,42730,0,0,0,0,0
352.587,6,24,1808,10,63,23892,63,715,14,41,27115,57,1093
1786.57,6,112,9774,72,77,25162,292,5674,40,69,45807,247,4100
18.256,6,2935,2764120,1900,1377,9,1408,2705636,1035,776,17,1408,58484
1680.27,1,15,840,15,28,120019,28,840,0,0,0,0,0
75.774,6,31,7613,12,155,28,267,1266,19,398,4209,3417,6347
1791.027,6,386,29638,222,129,8104,469,18317,164,69,10986,69,11321
1746.012,6,95,7203,63,38,28161,205,4476,32,33,56310,98,2727
61.022,6,27,7177,13,155,5085,267,1306,14,530,4693,3417,5871
10.093,6,2373,2218809,1524,1378,6,1408,2169899,849,792,11,1408,48910
26.831,6,35,8320,17,378,539,786,1846,18,478,1570,1968,6474
0.981,6,11,1727,7,100,163,100,384,4,589,242,1152,1343
1769.954,6,99,9240,66,65,27230,65,5577,33,59,55307,59,3663
1795.877,17,142,11360,71,48,25655,48,5396,71,56,25655,56,5964
0.0,17,1,86,1,58,0,58,86,0,0,0,0,0
1.336,6,25,8056,12,164,103,267,1288,13,869,95,1408,6768
1797.568,17,448,39896,403,35,4471,288,25676,45,288,40020,288,14220
1773.384,6,180,15480,120,69,14902,69,8940,60,69,30053,69,6540
6.531,17,28,6710,12,253,590,1350,3383,16,179,432,1350,3327
1773.656,6,180,15480,120,69,14904,69,8940,60,69,30055,69,6540
1781.765,6,370,24832,214,87,8365,469,14314,156,69,11495,69,10518
1784.853,1,8,848,8,78,254979,78,848,0,0,0,0,0
1778.535,17,140,11200,70,48,25775,48,5320,70,56,25775,56,5880
1787.902,6,360,24156,210,88,8554,469,13878,150,69,11999,69,10278
0.04,6,2,92,1,0,0,0,40,1,0,0,0,52
0.397,6,10,968,5,256,97,256,460,5,304,97,304,508
29.182,17,4,1312,4,300,9727,300,1312,0,0,0,0,0
1795.093,17,80,3354,79,14,23014,14,3318,1,8,0,8,36
1787.34,6,106,8515,69,65,26284,65,4970,37,59,49645,59,3545
1770.677,6,101,9410,66,66,27241,66,5610,35,60,52075,60,3800
1741.132,1,16,896,16,28,116075,28,896,0,0,0,0,0
28.104,6,27,7183,13,156,2342,267,1312,14,530,2161,3417,5871
1740.93,6,96,6919,61,31,29015,31,4164,35,31,51197,31,2755
1787.661,17,142,11360,71,48,25537,48,5396,71,56,25537,56,5964
521.829,6,19,1511,12,63,24633,63,858,7,53,86959,57,653
0.024,6,10,1514,5,503,5,503,771,5,475,5,475,743
9.833,17,4,5484,4,1343,3277,1348,5484,0,0,0,0,0
0.014,17,2,410,1,36,0,36,64,1,318,0,318,346
1.829,6,25,6448,13,297,152,830,2011,12,790,165,1420,4437
280.44,6,28,7352,14,158,21572,267,1357,14,678,21568,3456,5995
17.385,17,8,704,4,48,5790,48,304,4,72,5790,72,400
125.395,6,14,3144,7,92,20899,92,452,7,464,20868,1408,2692
80.276,6,25,10208,12,549,55,1360,2709,13,995,6679,1360,7499
0.116,17,2,602,1,46,0,46,74,1,500,0,500,528
300.302,6,47,29682,25,190,12512,444,2117,22,1650,11583,5608,27565
1797.683,17,449,39928,404,35,4460,288,25708,45,288,40017,288,14220
280.165,6,27,7312,13,158,23347,267,1317,14,775,21550,4836,5995
0.024,17,4,300,3,39,3,39,201,1,71,0,71,99
1772.498,6,240,17880,120,69,14894,69,8940,120,34,14894,64,8940
5.618,6,46,8449,23,227,255,314,4102,23,427,243,1152,4347
1771.218,6,99,9306,66,66,27249,66,5610,33,60,55348,60,3696
300.285,6,29,7893,12,286,27298,832,1778,17,872,18767,2529,6115
0.279,6,12,3462,6,75,55,75,395,6,1373,55,1448,3067
0.029,17,8,1670,8,180,4,219,1670,0,0,0,0,0
1771.422,6,99,9306,66,66,27252,66,5610,33,60,55354,60,3696
0.486,6,12,1653,6,288,94,288,548,6,426,56,434,1105
42.428,17,44,6468,22,48,2019,48,1672,22,190,2019,308,4796
0.241,17,2,204,1,34,0,34,62,1,114,0,114,142
10.984,6,22,4526,12,275,998,275,1038,10,768,715,1440,3488
1680.471,1,15,840,15,28,120033,28,840,0,0,0,0,0
39.983,6,30,7149,14,181,2029,267,1292,16,521,2665,1400,5857
5.005,17,4,288,2,36,5003,36,128,2,52,4992,52,160
5.511,6,18,9130,8,275,787,275,599,10,1015,298,2760,8531
198.075,17,4,352,2,60,198074,60,176,2,60,198074,60,176
0.994,17,4,240,2,32,993,32,120,2,32,993,32,120
1776.0,17,140,11200,70,48,25739,48,5320,70,56,25739,56,5880
0.057,17,2,144,1,36,0,36,64,1,52,0,52,80
7.987,6,17,5313,9,275,998,275,643,8,1084,686,1414,4670
291.593,1,4,224,4,28,97197,28,224,0,0,0,0,0
41.411,17,21,1836,11,48,4137,48,836,10,72,4596,72,1000
1772.137,6,180,15480,120,69,14891,69,8940,60,69,30031,69,6540
1.093,6,36,8345,19,277,60,761,1900,17,478,56,2128,6445
6.961,17,4,240,2,32,6960,32,120,2,32,6960,32,120
90.858,6,60,39975,39,1158,2391,1408,32144,21,747,3070,1408,7831
1752.796,1,60,5040,60,56,29708,56,5040,0,0,0,0,0
280.432,6,28,7352,13,158,23369,267,1317,15,678,20028,2760,6035
1795.893,17,447,39296,404,35,4456,288,25708,43,288,41924,288,13588
18.836,6,22,7312,13,428,1569,641,1980,9,809,1887,1846,5332
1796.632,17,448,39896,403,35,4469,288,25676,45,288,40017,288,14220
0.012,17,2,450,1,100,0,100,128,1,294,0,294,322
0.367,6,27,9076,13,252,30,647,1692,14,831,27,1448,7384
30.071,6,12,1317,7,174,5011,174,546,5,251,7515,476,771
0.467,6,4,1037,2,0,222,0,104,2,853,250,853,933
1.324,6,50,19543,29,904,47,1360,13882,21,400,57,1360,5661
1790.537,6,359,22778,209,69,8608,69,12500,150,69,12016,69,10278
5.052,17,4,502,2,36,5047,36,128,2,159,5047,159,374
2.996,17,4,268,4,39,998,39,268,0,0,0,0,0
172.358,17,4,352,2,60,172357,60,176,2,60,172357,60,176
1797.246,17,448,39896,403,35,4470,288,25676,45,288,40022,288,14220
1792.199,6,356,22520,208,69,8657,69,12460,148,69,12191,69,10060
1783.806,6,359,22778,208,69,8617,69,12529,151,69,11892,69,10249
0.341,17,8,2766,8,317,48,356,2766,0,0,0,0,0
5.067,6,40,7309,20,218,266,314,3423,20,513,251,1179,3886
20.336,6,20,2484,10,189,2259,517,1298,10,323,2253,499,1186
1775.016,6,182,15698,121,69,14791,69,9049,61,69,29579,69,6649
200.392,17,4,352,2,60,200391,60,176,2,60,200390,60,176
0.244,6,2,92,1,0,0,0,52,1,0,0,0,40
0.012,6,10,1794,6,613,2,1070,1471,4,159,4,159,323
1795.523,1,214,11984,214,28,8429,28,11984,0,0,0,0,0
574.39,1,6,336,6,28,114878,28,336,0,0,0,0,0
1772.54,6,180,15480,120,69,14895,69,8940,60,69,30035,69,6540
1746.708,6,95,7203,63,38,28172,205,4476,32,33,56337,98,2727
9.811,6,32,8952,14,158,754,267,1357,18,624,574,1400,7595
1797.332,6,356,22520,208,69,8682,69,12460,148,69,12223,69,10060
1793.856,6,356,22520,208,69,8665,69,12460,148,69,12202,69,10060
300.534,6,21,1443,10,177,33374,177,765,11,110,30036,110,678
38.799,6,41,10756,17,819,48,1360,4808,24,292,1679,2667,5948
0.699,17,4,334,2,39,373,39,134,2,72,0,72,200
0.009,17,2,904,2,424,9,548,904,0,0,0,0,0
1780.238,17,140,11200,70,48,25800,48,5320,70,56,25800,56,5880
342.229,17,5,1694,5,310,85557,322,1694,0,0,0,0,0
71.096,6,30,7435,13,155,5924,267,1306,17,453,4442,3417,6129
1789.954,6,368,25621,214,99,8403,469,15045,154,69,11699,69,10576
22.517,6,2671,2503311,1699,1393,13,1448,2448103,972,776,23,1448,55208
282.015,17,4,352,2,60,282014,60,176,2,60,282014,60,176
1772.017,6,99,9240,66,65,27261,65,5577,33,59,55372,59,3663
0.486,6,18,3238,9,416,60,593,1726,9,334,55,580,1512
1740.556,17,30,20190,30,645,60019,645,20190,0,0,0,0,0
0.065,6,9,1346,5,145,16,145,349,4,833,13,833,997
1668.911,1,7,742,7,78,278151,78,742,0,0,0,0,0
6.288,6,1361,1264663,866,1384,7,1408,1234259,495,931,12,2816,30404
5.364,6,39,7269,19,218,298,314,3383,20,440,267,1152,3886
1.392,6,48,18643,26,916,55,1460,12987,22,433,57,1460,5656
1342.996,6,269,17039,156,69,8664,69,9414,113,69,11991,69,7625
221.285,6,20,5113,6,272,1155,516,1060,14,290,17014,1452,4053
0.638,6,10,887,5,248,150,248,452,5,231,150,231,435
1787.022,6,104,8376,68,65,26671,65,4930,36,59,51054,59,3446
0.022,17,2,904,1,548,0,548,576,1,300,0,300,328
4.038,6,9,527,5,43,1009,43,311,4,0,1343,0,216
131.911,6,25,9968,12,549,62,1440,2709,13,961,10981,1440,7259
1786.883,6,104,8441,69,65,26277,65,5035,35,59,52549,59,3406
1777.66,17,140,11200,70,48,25763,48,5320,70,56,25763,56,5880
105.257,17,4,240,2,32,105256,32,120,2,32,105256,32,120
1.103,6,24,8016,12,164,85,267,1300,12,1014,85,2411,6716
280.355,6,29,7392,13,158,23362,267,1317,16,603,18683,1400,6075
0.606,6,20,4960,10,137,67,267,1092,10,692,57,1467,3868
1744.985,6,95,7203,63,38,28144,205,4476,32,33,56281,98,2727
1789.888,17,87,3648,86,14,21057,14,3612,1,8,0,8,36
5.024,17,4,288,2,36,5008,36,128,2,52,5004,52,160
1737.706,1,56,4704,56,56,31594,56,4704,0,0,0,0,0
1764.009,2,16,512,16,8,117600,8,512,0,0,0,0,0
0.162,6,3,160,2,0,162,0,100,1,0,0,0,60
280.467,6,29,7392,13,158,23372,267,1317,16,678,18692,3456,6075
1.932,6,14,2351,8,188,276,245,700,6,703,336,1152,1651
1770.928,6,99,9240,66,65,27245,65,5577,33,59,55337,59,3663
126.725,17,4,332,2,31,126662,33,118,2,79,126677,93,214
550.138,6,92,13469,53,304,10579,304,9488,39,83,14476,83,3981
0.191,6,3,182,2,31,191,31,111,1,31,0,31,71
1744.708,2,28,896,28,8,64618,8,896,0,0,0,0,0
0.041,6,13,3980,7,88,6,88,388,6,1670,8,1880,3592
1740.439,17,29,6815,29,207,62158,207,6815,0,0,0,0,0
15.645,17,3,228,3,48,7822,48,228,0,0,0,0,0
0.248,17,2,144,1,36,0,36,64,1,52,0,52,80
1.509,6,49,22008,28,1016,55,1460,16392,21,476,65,2615,5616
136.907,6,21,7979,11,525,86,1237,2048,10,919,15191,1591,5931
0.259,17,2,241,1,36,0,36,64,1,149,0,149,177
116.019,17,4,352,2,60,116017,60,176,2,60,116018,60,176
1771.909,6,180,15480,120,69,14889,69,8940,60,69,30030,69,6540
0.175,6,46,22060,27,1065,6,1420,17079,19,467,9,1883,4981
1681.401,17,14,1036,7,30,280229,30,406,7,62,280230,62,630
0.087,17,2,152,1,48,0,48,76,1,48,0,48,76
3.367,17,5,290,5,30,841,30,290,0,0,0,0,0
1769.801,6,101,9278,66,64,27227,64,5544,35,58,52050,58,3734
1.407,6,38,8324,19,332,78,1234,2788,19,433,68,1440,5536
1621.439,1,7,392,7,28,270239,28,392,0,0,0,0,0
1737.803,2,13,416,13,8,144816,8,416,0,0,0,0,0
7.207,6,1732,1565821,1070,1383,6,1408,1526733,662,931,10,2801,39088
1741.292,6,87,6322,58,31,30548,31,3915,29,31,62188,31,2407
10.979,6,2112,1956793,1346,1375,8,1408,1912297,766,931,14,2816,44496
22.118,6,51,15711,27,571,850,1152,11937,24,468,948,1179,3774
1749.253,6,95,7203,63,38,28213,205,4476,32,33,56416,98,2727
1770.676,6,101,9410,66,66,27241,66,5610,35,60,52076,60,3800
155.08,17,14,1120,7,48,25844,48,532,7,56,25821,56,588
1798.419,17,312,69533,312,194,5782,422,69533,0,0,0,0,0
280.417,6,30,7432,13,158,23368,267,1317,17,603,17522,2760,6115
121.228,17,5,380,5,48,30307,48,380,0,0,0,0,0
1799.413,1,59,4956,59,56,31024,56,4956,0,0,0,0,0
1.123,6,3,239,1,0,0,0,40,2,83,873,83,199
0.012,17,2,320,1,32,0,32,60,1,232,0,232,260
5.32,6,41,7349,21,218,266,314,3463,20,513,266,1179,3886
1.91,17,2,134,2,39,1910,39,134,0,0,0,0,0
1684.573,2,24,768,24,8,73242,8,768,0,0,0,0,0
108.983,17,4,240,2,32,108982,32,120,2,32,108982,32,120
26.061,6,3534,3276757,2276,1361,11,1408,3206579,1258,950,20,2801,70178
167.726,6,28,13952,13,549,65,1460,2761,15,1175,11970,1460,11191
14.548,6,91,27829,45,562,330,1152,21507,46,447,316,1179,6322
0.408,6,52,21748,28,1026,15,1380,16546,24,421,16,1923,5202
0.206,17,2,178,1,29,0,29,57,1,93,0,93,121
325.517,6,122,90009,76,1258,4340,1408,79496,46,811,1902,3847,10513
0.069,6,2,1532,1,0,0,0,40,1,1452,0,1452,1492
136.39,6,12,858,12,26,12399,26,858,0,0,0,0,0
296.461,17,4,352,2,60,296460,60,176,2,60,296460,60,176
21.441,17,12,1056,6,48,4285,48,456,6,72,4285,72,600
299.701,6,6,364,4,31,99900,31,222,2,31,299677,31,142
64.497,6,27,7177,13,155,5374,267,1306,14,530,4960,3417,5871
0.119,6,9,1340,5,145,29,145,349,4,827,31,827,991
0.01,17,2,350,1,37,0,37,65,1,257,0,257,285
1744.795,6,92,6985,61,38,29079,205,4341,31,33,58148,98,2644
10.765,6,18,4226,10,275,1196,275,958,8,978,856,1420,3268
2.116,6,11,1727,7,100,352,100,384,4,1179,595,1179,1343
1.379,6,47,18161,26,882,55,1360,12545,21,476,58,2715,5616
0.115,17,2,167,1,39,0,39,67,1,72,0,72,100
297.585,17,4,240,2,32,297584,32,120,2,32,297584,32,120
0.135,17,2,2756,2,1350,135,1350,2756,0,0,0,0,0
1790.603,1,219,12264,219,28,8213,28,12264,0,0,0,0,0
4.017,6,38,14359,19,444,223,1460,3934,19,877,187,1547,10425
0.156,17,2,182,1,39,0,39,67,1,87,0,87,115
1792.09,6,110,8864,72,65,25240,65,5220,38,59,48432,59,3644
281.479,6,32,7650,13,158,23456,267,1317,19,506,15618,2076,6333
0.307,6,21,5000,10,137,34,267,1092,11,692,30,1467,3908
300.375,6,116,154059,63,162,4844,230,4094,53,2944,5776,11216,149965
0.194,17,2,212,1,46,0,46,74,1,110,0,110,138
0.059,6,12,3488,6,101,11,101,421,6,1373,11,1448,3067
183.403,6,53,11445,24,126,7974,267,2358,29,329,6545,1460,9087
205.053,17,4,352,2,60,205051,60,176,2,60,205052,60,176
3.771,6,33,6129,17,206,235,314,2744,16,548,234,1179,3385
0.304,17,2,152,1,48,0,48,76,1,48,0,48,76
1783.808,6,361,22858,210,69,8534,69,12678,151,69,11892,69,10180
14.562,6,11,676,4,106,4850,106,274,7,90,2425,90,402
194.656,17,4,240,2,32,194655,32,120,2,32,194655,32,120
0.729,17,2,178,1,29,0,29,57,1,93,0,93,121
1624.697,1,7,392,7,28,270782,28,392,0,0,0,0,0
1744.647,2,27,864,27,8,67101,8,864,0,0,0,0,0
27.405,17,2,904,1,300,0,300,328,1,548,0,548,576
1681.298,17,14,3843,7,30,280215,30,406,7,463,280215,463,3437
10.526,6,18,4266,10,275,1169,275,958,8,992,804,1440,3308
1760.505,6,197,12927,98,59,18149,208,8006,99,31,17962,31,4921
1794.9,1,204,11424,204,28,8841,28,11424,0,0,0,0,0
1799.845,17,769,46366,769,32,2343,37,46366,0,0,0,0,0
1744.613,2,27,864,27,8,67100,8,864,0,0,0,0,0
1787.532,6,104,8376,68,65,26679,65,4930,36,59,51068,59,3446
1792.121,6,252,33410,155,158,11637,485,18574,97,119,18663,453,14836
180.131,2,2,64,2,8,180131,8,64,0,0,0,0,0
0.129,17,2,212,1,46,0,46,74,1,110,0,110,138
381.593,6,23,1535,16,177,25439,177,1053,7,110,10479,110,482
360.944,2,6,192,6,8,72188,8,192,0,0,0,0,0
277.249,6,27,7312,12,158,25204,267,1277,15,678,19797,2800,6035
5.453,6,39,7285,19,218,302,314,3383,20,516,272,1179,3902
104.944,6,22,8361,11,532,90,1257,2068,11,973,10476,2720,6293
1.292,6,10,1687,7,100,215,100,384,3,1179,514,1179,1303
66.639,6,36,26468,21,130,3331,139,1523,15,2027,4757,4380,24945
1799.864,17,770,46480,770,32,2340,37,46480,0,0,0,0,0
1786.026,17,353,55680,353,129,5073,391,55680,0,0,0,0,0
0.019,6,9,1878,5,666,4,666,934,4,728,6,728,944
22.955,6,24,6231,14,117,1765,159,1337,10,727,2549,1418,4894
4.835,6,38,7245,19,218,268,314,3383,19,516,253,1179,3862
114.054,1,4,224,4,28,38018,28,224,0,0,0,0,0
213.401,17,4,352,2,60,213399,60,176,2,60,213400,60,176
5.007,17,4,288,2,36,5003,36,128,2,52,4964,52,160
0.448,6,23,6024,12,181,40,537,1526,11,651,39,1368,4498
240.306,6,43,9061,21,524,12014,1418,5818,22,232,11442,618,3243
1318.799,17,2556,122688,1279,20,1031,20,61392,1277,20,1033,20,61296
0.279,17,2,422,1,72,0,72,100,1,294,0,294,322
505.861,17,12,4016,12,306,45987,308,4016,0,0,0,0,0
19.908,1,8,832,0,0,0,0,0,8,76,2844,76,832
242.113,17,4,352,2,60,242112,60,176,2,60,242112,60,176
0.682,6,13,1175,7,146,112,146,430,6,250,135,499,745
220.296,6,23,7014,11,181,22029,267,1168,12,766,20022,2045,5846
240.165,6,50,16719,26,782,9606,1408,13877,24,198,10441,580,2842
0.053,6,9,1002,5,213,13,213,417,4,421,14,421,585
1741.448,17,30,7050,30,207,60049,207,7050,0,0,0,0,0
95.343,6,16,2966,6,127,1126,127,463,10,485,10535,1448,2503
0.18,17,4,865,2,47,168,47,150,2,329,171,341,715
78.908,6,23,9976,12,665,78,1360,3174,11,1270,7872,3595,6802
0.264,1,2,112,2,28,264,28,112,0,0,0,0,0
1773.716,6,282,34741,115,147,15557,1440,17493,167,127,10684,1440,17248
1635.917,1,7,392,7,28,272652,28,392,0,0,0,0,0
515.439,17,76,5776,76,48,6872,48,5776,0,0,0,0,0
321.137,6,35,2987,23,69,14597,69,1679,12,69,29192,69,1308
0.497,17,3,451,2,39,85,39,134,1,289,0,289,317
781.322,2,10,320,10,8,86813,8,320,0,0,0,0,0
56.779,6,31,7560,11,165,34,267,1109,20,352,2987,1997,6451
1779.636,1,342,28728,342,56,5218,56,28728,0,0,0,0,0
21.927,1,4,224,4,28,7309,28,224,0,0,0,0,0
0.008,17,2,350,1,33,0,33,61,1,261,0,261,289
1772.243,6,180,15480,120,69,14892,69,8940,60,69,30037,69,6540
1795.554,17,449,39928,404,35,4455,288,25708,45,288,40020,288,14220
0.14,17,10,6149,5,767,35,1350,3975,5,406,25,1350,2174
0.423,6,51,21489,28,1012,15,1380,16339,23,421,17,1923,5150
0.403,6,12,1653,6,288,77,288,548,6,426,41,434,1105
0.011,17,2,144,1,44,0,44,72,1,44,0,44,72
3.002,17,8,720,4,30,1000,30,232,4,94,1000,94,488
0.008,17,2,279,1,36,0,36,64,1,187,0,187,215
0.332,6,26,8995,13,252,27,647,1692,13,945,27,1408,7303
19.559,17,43,7005,19,146,1084,1350,3311,24,125,848,1350,3694
240.247,6,51,10584,25,208,10009,517,2766,26,461,9609,1498,7818
0.751,6,18,5172,10,150,83,174,704,8,828,94,1420,4468
1787.198,6,102,8296,68,65,26674,65,4930,34,59,54154,59,3366
19.552,6,83,25654,42,696,476,1440,14373,41,437,483,1440,11281
240.243,6,54,17788,29,746,8579,1418,14944,25,192,10009,580,2844
0.019,17,2,2200,2,1072,19,1072,2200,0,0,0,0,0
0.012,17,2,160,1,48,0,48,76,1,56,0,56,84
0.006,17,2,394,1,36,0,36,64,1,302,0,302,330
1741.728,17,30,20190,30,645,60059,645,20190,0,0,0,0,0
326.636,6,298,248098,193,1311,1701,1368,230338,105,585,1448,1368,17760
3.607,6,13,3116,8,49,515,92,535,5,772,50,2026,2581
2.781,17,91,120461,90,1310,31,1472,120421,1,12,0,12,40
135.199,6,181,139708,112,1339,1218,1448,125051,69,553,1985,1448,14657
0.512,17,3,451,2,39,28,39,134,1,289,0,289,317
1772.809,6,180,15480,120,69,14897,69,8940,60,69,30046,69,6540
16.616,6,15,3210,8,210,2373,210,856,7,664,2768,904,2354
280.312,6,28,7352,12,158,25482,267,1277,16,603,18683,1400,6075
1798.124,17,449,39928,404,35,4461,288,25708,45,288,40017,288,14220
1772.799,6,180,15480,120,69,14897,69,8940,60,69,30039,69,6540
1.778,17,4,314,2,31,1028,31,118,2,70,23,70,196
99.606,6,25,9849,12,531,72,1440,2637,13,954,8289,1440,7212
2.761,6,38,9917,20,512,145,1460,4421,18,433,140,1460,5496
1776.329,17,140,11200,70,48,25743,48,5320,70,56,25743,56,5880
55.069,6,27,9005,8,149,285,267,1223,19,501,3057,3457,7782
0.931,6,29,9014,15,203,66,458,1458,14,776,58,1460,7556
132.704,1,6,336,6,28,26540,28,336,0,0,0,0,0
39.867,17,44,6468,22,48,1898,48,1672,22,190,1898,308,4796
0.35,17,2,144,1,36,0,36,64,1,52,0,52,80
62.808,17,4,240,2,32,62806,32,120,2,32,62807,32,120
71.339,6,38,10191,13,155,5944,267,1306,25,375,2962,1420,8885
1798.741,6,358,22669,208,69,8689,69,12529,150,69,12070,69,10140
39.499,6,45,9016,22,401,639,889,2188,23,368,1789,3488,6828
3.93,17,8,1856,4,60,1305,60,352,4,348,1301,356,1504
1787.187,6,106,8524,68,66,26674,66,4964,38,60,48299,60,3560
60.342,6,32,8952,14,158,4641,267,1357,18,624,3546,1400,7595
305.635,6,34,7034,21,288,15275,327,3745,13,275,25458,276,3289
1790.013,17,87,3648,86,14,21058,14,3612,1,8,0,8,36
8.672,6,76,25178,39,579,228,1152,19541,37,461,233,1179,5637
1786.594,6,131,18075,82,220,22056,1302,12338,49,92,37218,268,5737
2.731,6,15,1143,8,181,390,181,601,7,77,300,133,542
1.414,6,48,19412,27,906,54,1360,13796,21,476,61,2720,5616
1777.403,17,73,3060,72,14,25033,14,3024,1,8,0,8,36
0.08,17,4,352,2,37,0,37,130,2,83,40,89,222
1.201,6,10,1687,7,100,200,100,384,3,1179,474,1179,1303
1.669,6,25,8711,15,276,119,561,1433,10,982,166,1420,7278
240.24,6,51,17850,27,800,9239,1402,15025,24,196,10445,580,2825
2.124,6,29,10365,17,367,132,833,1785,12,1012,185,1420,8580
0.333,17,2,152,1,48,0,48,76,1,48,0,48,76
0.009,17,2,178,1,29,0,29,57,1,93,0,93,121
13.477,6,19,6745,10,275,1497,275,958,9,1353,1372,1440,5787
0.025,6,10,1823,6,108,5,108,428,4,1179,6,1179,1395
4.621,6,37,7189,19,218,256,314,3383,18,513,255,1179,3806
1773.659,6,209,22599,130,75,13749,267,10057,79,132,22737,1460,12542
1760.774,6,202,22250,125,75,13588,267,9719,77,133,23167,1917,12531
519.92,17,42,3360,21,48,25995,48,1596,21,56,25995,56,1764
99.993,6,24,9022,12,661,87,1360,3156,12,895,9073,1747,5866
15.127,6,12,3069,6,92,3025,92,400,6,2329,2983,2329,2669
233.837,6,51,9816,20,117,6573,267,1862,31,257,7794,1452,7954
280.271,6,30,7432,13,158,23355,267,1317,17,543,17514,1300,6115
0.36,6,13,1693,7,288,60,288,588,6,284,35,434,1105
1.393,6,49,19523,27,911,53,1360,13867,22,476,57,2715,5656
4.563,6,38,7245,20,218,240,314,3423,18,516,251,1179,3822
9.277,6,17,3501,7,92,1546,92,476,10,312,1007,2026,3025
134.172,6,15,796,13,0,11181,0,684,2,0,10170,0,112
92.655,6,34,17448,17,1005,91,1460,8771,17,887,5772,1460,8677
750.15,17,9,999,9,83,93768,355,999,0,0,0,0,0
1798.407,17,142,11360,71,48,25691,48,5396,71,56,25691,56,5964
5.787,6,41,7349,21,218,289,314,3463,20,513,289,1179,3886
33.532,6,29,4990,14,180,2579,722,1808,15,342,2381,1440,3182
0.227,17,2,152,1,48,0,48,76,1,48,0,48,76
8.522,17,27,8510,12,416,772,1350,5339,15,183,606,1350,3171
1743.452,6,91,6933,60,38,29550,205,4289,31,33,58103,98,2644
1754.095,6,184,11097,92,45,19275,208,6518,92,31,19273,31,4579
240.799,6,41,8910,20,574,12673,1418,5644,21,270,12039,651,3266
21.098,17,36,13863,17,224,1316,1350,4296,19,475,1170,1350,9567
90.317,17,4,352,2,60,90316,60,176,2,60,90315,60,176
5.616,6,34,6185,19,206,312,314,2824,15,551,382,1179,3361
0.649,6,23,7437,14,274,49,668,2109,9,1210,76,1946,5328
166.004,6,22,8450,11,313,73,632,1413,11,940,16586,1460,7037
0.244,6,10,1673,6,553,48,949,1350,4,159,81,159,323
113.824,17,4,352,2,60,113823,60,176,2,60,113823,60,176
1798.992,17,448,39896,403,35,4475,288,25676,45,288,40019,288,14220
1799.125,1,58,4872,0,0,0,0,0,58,56,31563,56,4872
3.743,17,5,290,5,30,935,30,290,0,0,0,0,0
1.269,6,47,19101,27,886,48,1360,13525,20,476,57,2720,5576
1797.537,17,180,14040,180,50,10042,50,14040,0,0,0,0,0
240.208,6,56,20645,30,843,8282,1418,17597,26,211,9607,580,3048
1786.332,17,87,3648,86,14,21015,14,3612,1,8,0,8,36
317.036,6,80,19933,40,328,8129,1360,10168,40,326,8125,1360,9765
156.018,17,4,240,2,32,156017,32,120,2,32,156017,32,120
1.19,17,2,334,1,39,0,39,67,1,239,0,239,267
89.628,6,11,966,1,0,0,0,40,10,65,9958,69,926
1781.743,6,278,34236,115,140,15628,1360,16828,163,135,10997,4662,17408
1788.566,17,87,3648,86,14,21041,14,3612,1,8,0,8,36
253.198,6,26,2213,17,69,15824,69,1232,9,69,31648,69,981
1789.452,17,83,3480,82,14,22092,14,3444,1,8,0,8,36
1742.382,6,95,7203,63,38,28102,205,4476,32,33,56194,98,2727
246.758,6,498,450332,193,207,1285,894,13421,305,1451,811,2836,436911
0.257,17,3,234,2,39,33,39,134,1,72,0,72,100
1792.189,6,361,22789,209,69,8615,69,12569,152,69,11868,69,10220
0.024,17,2,2380,2,1162,24,1162,2380,0,0,0,0,0
287.367,6,30,3661,16,324,19157,585,1501,14,357,22104,580,2160
1797.479,17,246,64455,246,234,7336,422,64455,0,0,0,0,0
1792.782,17,128,25208,128,168,14116,373,25208,0,0,0,0,0
235.674,6,124,94306,79,1265,3021,1408,83844,45,737,2460,2439,10462
694.54,1,32,1792,32,28,22404,28,1792,0,0,0,0,0
7.45,6,48,9211,25,231,310,314,4475,23,423,327,1152,4736
20.143,17,2,152,2,48,20143,48,152,0,0,0,0,0
1787.049,17,142,11360,71,48,25528,48,5396,71,56,25528,56,5964
4.073,17,5,337,4,33,1356,33,244,1,65,0,65,93
744.814,17,84,7049,78,30,9671,37,4545,6,389,136608,463,2504
16.658,6,11,990,5,304,4161,304,576,6,102,3328,102,414
627.261,17,481,34136,411,40,1529,41,28216,70,56,611,57,5920
5.028,17,3,208,2,36,5005,36,128,1,52,0,52,80
1753.163,6,185,11314,93,47,19056,208,6735,92,31,19262,31,4579
0.018,6,12,4862,6,100,3,100,420,6,1030,3,1448,4442
152.429,6,37,6420,16,143,10161,516,1790,21,236,7599,1452,4630
0.855,17,2,144,1,36,0,36,64,1,52,0,52,80
20.979,17,4,352,2,60,20977,60,176,2,60,20978,60,176
1.954,17,22,5698,22,231,93,388,5698,0,0,0,0,0
81.547,6,20,820,9,0,6201,0,364,11,0,8152,0,456
219.064,17,4,352,2,60,219063,60,176,2,60,219062,60,176
297.339,17,22,3633,11,40,29733,40,748,11,234,29732,249,2885
199.479,17,4,5496,4,1346,66493,1346,5496,0,0,0,0,0
0.993,17,2,685,1,308,0,308,336,1,321,0,321,349
1680.583,17,12,498,11,14,168058,14,462,1,8,0,8,36
481.297,2,7,224,7,8,80216,8,224,0,0,0,0,0
1.221,6,28,11076,14,164,80,267,1440,14,1112,80,2816,9636
1785.61,1,55,4620,0,0,0,0,0,55,56,33066,56,4620
6.452,6,18,3378,10,210,716,210,972,8,664,921,904,2406
0.055,6,9,1612,5,636,13,636,904,4,492,18,492,708
1741.278,17,28,6468,28,203,64491,203,6468,0,0,0,0,0
108.264,6,34,23865,19,840,40,1360,5835,15,2177,7722,5440,18030
31.816,6,24,7285,4,189,1380,189,578,20,420,1662,1928,6707
28.397,6,1390,1203352,874,1298,32,1368,1169552,516,776,54,2736,33800
25.159,6,13,3782,6,106,4971,106,468,7,1008,4131,2920,3314
7.828,6,80,24485,39,552,206,1152,18704,41,459,189,1179,5781
1.25,6,25,8056,12,164,97,267,1288,13,869,88,1448,6768
36.971,6,45,13749,23,315,1680,721,3463,22,783,1310,1414,10286
3.702,17,2,690,2,317,3702,317,690,0,0,0,0,0
481.208,2,6,192,6,8,96241,8,192,0,0,0,0,0
0.04,17,4,284,2,32,1,32,120,2,54,20,60,164
280.186,6,28,7352,13,158,23348,267,1317,15,678,20010,4200,6035
0.082,6,10,1512,5,503,20,503,771,5,473,20,473,741
1790.864,17,179,13962,179,50,10061,50,13962,0,0,0,0,0
1.116,17,20,7101,8,303,159,1350,2650,12,342,70,1350,4451
59.143,17,28,2355,26,30,2362,37,1515,2,392,427,463,840
0.015,17,3,704,2,60,1,60,176,1,500,0,500,528
2.983,6,3,180,3,0,0,0,180,0,0,0,0,0
1753.154,6,182,11017,91,45,19479,208,6447,91,31,19476,31,4570
10.426,6,20,6462,11,275,1042,275,723,9,1073,676,1440,5739
61.851,6,73,49310,45,1175,1405,1448,41125,28,746,2281,1448,8185
0.228,6,20,4960,10,137,25,267,1092,10,692,23,1467,3868
1791.186,6,103,8404,68,66,26734,66,4964,35,60,52679,60,3440
0.018,17,2,160,1,44,0,44,72,1,60,0,60,88
1310.004,17,242,18392,242,48,5435,48,18392,0,0,0,0,0
0.035,6,2,421,1,0,0,0,40,1,341,0,341,381
1786.24,6,105,8406,68,64,26660,64,4896,37,58,49615,58,3510
1786.976,6,102,8228,68,64,26671,64,4896,34,58,54148,58,3332
1783.81,6,419,25109,209,69,8576,69,12569,210,34,8534,64,12540
1799.379,6,2097,2215002,773,144,2330,844,50698,1324,1677,1360,7090,2164304
0.582,6,15,3660,8,101,83,101,533,7,1373,97,1448,3127
1799.855,17,450,39960,405,35,4455,288,25740,45,288,40017,288,14220
1795.931,6,420,25602,222,69,8126,69,13158,198,42,9116,69,12444
0.892,6,172,124340,98,1315,9,1420,117080,74,428,12,1883,7260
1791.808,1,58,4872,58,56,31435,56,4872,0,0,0,0,0
1797.803,17,449,39416,404,34,4461,288,25444,45,282,40021,288,13972
1780.421,17,141,11276,71,48,25434,48,5396,70,56,25803,56,5880
0.131,17,2,410,1,46,0,46,74,1,308,0,308,336
0.014,17,2,152,2,48,14,48,152,0,0,0,0,0
30.249,6,43,8823,21,367,811,787,2034,22,368,1433,3488,6789
280.495,6,30,7432,13,158,23374,267,1317,17,603,17524,2760,6115
4.877,6,41,7349,21,218,243,314,3463,20,440,243,1152,3886
1795.761,17,83,3480,82,14,22169,14,3444,1,8,0,8,36
1680.928,1,15,840,15,28,120066,28,840,0,0,0,0,0
8.841,17,4,240,2,32,8840,32,120,2,32,8840,32,120
1770.265,6,101,9410,66,66,27234,66,5610,35,60,52063,60,3800
1772.124,6,180,15480,120,69,14891,69,8940,60,69,30032,69,6540
8.084,6,1567,1397324,917,1438,8,1448,1356916,650,776,12,1448,40408
0.035,17,2,399,1,35,0,35,63,1,308,0,308,336
0.042,17,2,921,1,317,0,317,345,1,548,0,548,576
1790.696,6,356,22520,208,69,8650,69,12460,148,69,12178,69,10060
25.501,6,3708,3606076,2544,1344,9,1368,3540884,1164,776,21,2736,65192
0.335,17,2,694,2,319,335,354,694,0,0,0,0,0
0.377,17,6,2047,6,313,75,354,2047,0,0,0,0,0
240.259,6,41,5263,20,235,12642,751,2710,21,161,12011,541,2553
23.808,17,5,1912,5,354,5952,548,1912,0,0,0,0,0
1791.281,17,144,11520,72,48,25228,48,5472,72,56,25229,56,6048
0.101,6,13,1749,8,253,14,500,930,5,551,25,551,819
0.088,6,10,1326,5,299,18,299,567,5,245,16,458,759
5.867,6,41,7365,22,218,279,314,3503,19,516,311,1179,3862
1577.196,6,194,14661,74,66,21603,297,6956,120,48,13253,78,7705
28.774,6,14,1686,11,222,2877,222,1554,3,0,1694,0,132
79.896,17,4,240,2,32,79895,32,120,2,32,79895,32,120
7.188,6,1709,1656495,1135,1385,6,1408,1621983,574,776,12,1408,34512
1770.183,6,947,279609,467,268,3798,1360,113234,480,804,3695,2720,166375
0.153,17,2,586,1,46,0,46,74,1,484,0,484,512
2.838,6,21,6352,9,262,349,517,1264,12,744,254,1418,5088
0.111,17,2,157,1,31,0,31,59,1,70,0,70,98
23.245,6,3382,3129597,2073,1425,11,1448,3051969,1309,776,17,1448,77628
0.101,17,2,348,1,39,0,39,67,1,253,0,253,281
0.857,6,20,5942,11,281,85,544,1288,9,715,95,1414,4654
0.004,17,2,904,1,300,0,300,328,1,548,0,548,576
11.634,17,8,704,4,48,3873,48,304,4,72,3873,72,400
828.73,1,46,2576,46,28,18416,28,2576,0,0,0,0,0
280.19,6,27,7312,12,158,25471,267,1277,15,678,20011,2045,6035
15.052,17,5,5394,5,1050,3763,1061,5394,0,0,0,0,0
1786.917,6,102,8364,68,66,26670,66,4964,34,60,54145,60,3400
231.03,17,4,240,2,32,231029,32,120,2,32,231029,32,120
1772.716,6,180,15480,120,69,14896,69,8940,60,69,30037,69,6540
48.67,6,27,7177,13,155,4055,267,1306,14,530,3743,3417,5871
11.631,1,17,1768,0,0,0,0,0,17,76,726,76,1768
1180.591,17,793,55560,723,40,1635,41,49640,70,56,528,57,5920
0.341,6,25,8832,13,236,28,585,1630,12,1095,28,2804,7202
1788.579,17,87,3648,86,14,21042,14,3612,1,8,0,8,36
0.619,6,9,878,3,179,309,267,478,6,53,82,85,400
1789.957,6,369,24723,214,87,8403,469,14176,155,69,11623,69,10547
1796.178,6,100,7587,61,38,28153,205,4341,39,32,47263,98,3246
1498.152,2,13,416,13,8,124846,8,416,0,0,0,0,0
8.088,6,15,6285,4,186,2692,267,541,11,662,807,2006,5744
1.318,6,50,19206,27,885,50,1360,13510,23,476,52,2715,5696
5.016,17,3,208,2,36,4994,36,128,1,52,0,52,80
1.92,6,50,20205,27,956,73,1460,14509,23,433,75,1460,5696
280.232,6,28,7352,13,158,23352,267,1317,15,678,20014,3436,6035
0.913,6,10,1687,7,100,152,100,384,3,1179,323,1179,1303
1773.439,6,180,15480,120,69,14902,69,8940,60,69,30050,69,6540
5.194,6,2,149,0,0,0,0,0,2,69,5194,69,149
1786.452,6,102,8296,68,65,26663,65,4930,34,59,54132,59,3366
176.346,17,4,352,2,60,176345,60,176,2,60,176345,60,176
162.744,17,4,240,2,32,162743,32,120,2,32,162743,32,120
1772.538,6,242,18008,121,69,14771,69,8980,121,34,14771,48,9028
300.082,6,51,13749,27,840,11535,1360,7894,24,325,13039,1360,5855
1780.734,17,140,11200,70,48,25807,48,5320,70,56,25807,56,5880
1786.871,6,106,8524,68,66,26669,66,4964,38,60,48291,60,3560
1.583,6,38,9848,21,440,79,1360,4392,17,476,85,2715,5456
8.885,6,85,25537,42,534,216,1152,19319,43,449,205,1179,6218
300.248,6,38,12434,21,592,15012,1408,4724,17,681,15117,1578,7710
1797.879,6,385,29667,222,129,8135,469,18317,163,69,11096,69,11350
0.052,6,10,1495,5,507,13,507,727,5,556,13,556,768
1783.811,6,366,25072,214,94,8374,469,14576,152,69,11813,69,10496
1796.74,17,90,29760,30,308,60029,308,10080,60,300,29490,300,19680
32.069,6,9,396,2,0,3428,0,88,7,0,5330,0,308
35.962,17,4,244,2,33,35960,33,122,2,33,35960,33,122
0.022,17,2,254,1,34,0,34,62,1,164,0,164,192
0.44,6,23,7352,12,325,39,626,1932,11,968,42,1475,5420
462.435,6,32,3185,19,324,25690,585,1645,13,282,20068,580,1540
12.593,6,70,20286,36,520,359,1152,15499,34,489,373,1179,4787
0.026,6,12,3704,6,171,3,171,491,6,964,5,1448,3213
369.819,6,27,1767,18,177,21754,177,1181,9,110,8605,110,586
242.046,17,4,352,2,60,242045,60,176,2,60,242045,60,176
1.487,17,2,214,1,39,0,39,67,1,119,0,119,147
1775.75,17,73,3060,72,14,25010,14,3024,1,8,0,8,36
241.37,6,46,8967,24,519,10494,1402,5938,22,232,11493,618,3029
10.206,17,3,2046,3,654,5103,654,2046,0,0,0,0,0
61.969,6,71,46526,43,1164,1475,1368,38333,28,841,2286,2736,8193
1789.501,17,142,11360,71,48,25564,48,5396,71,56,25564,56,5964
240.276,6,57,18277,29,759,8580,1418,15190,28,202,8898,580,3087
1.511,17,2,586,1,41,0,41,69,1,489,0,489,517
1787.756,6,102,8296,68,65,26682,65,4930,34,59,54171,59,3366
1740.083,6,87,6322,58,31,30527,31,3915,29,31,62145,31,2407
102.912,6,81,57204,51,1217,2058,1368,48909,30,840,2132,2519,8295
95.139,17,8,704,4,48,31710,48,304,4,72,31710,72,400
1795.206,6,356,22520,208,69,8672,69,12460,148,69,12212,69,10060
661.833,2,7,224,7,8,110305,8,224,0,0,0,0,0
1743.348,6,95,6910,62,31,28579,31,4247,33,31,54478,31,2663
0.97,6,37,8232,19,241,53,619,1758,18,441,48,1460,6474
8.204,6,68,20686,35,559,241,1152,15939,33,427,248,1152,4747
1770.778,6,101,9410,66,66,27242,66,5610,35,60,52078,60,3800
79.235,6,22,9936,11,380,89,832,1613,11,1124,7906,1360,8323
0.207,17,2,136,1,32,0,32,60,1,48,0,48,76
0.415,6,28,7038,17,242,25,646,2384,11,701,40,1728,4654
0.357,17,2,168,1,48,0,48,76,1,64,0,64,92
1791.437,6,175,29457,103,483,17562,483,22776,72,83,25230,83,6681
382.944,6,12,1308,12,69,34813,69,1308,0,0,0,0,0
1787.16,6,102,8364,68,66,26674,66,4964,34,60,54151,60,3400
1789.954,6,370,25839,215,100,8364,469,15016,155,69,11623,69,10823
1121.11,17,10,740,5,30,280273,30,290,5,62,280273,62,450
207.402,17,4,352,2,60,207401,60,176,2,60,207401,60,176
0.915,6,26,9002,13,208,76,475,1386,13,1012,60,1360,7616
73.287,17,10,880,5,48,18318,48,380,5,72,18318,72,500
0.04,17,2,454,2,199,40,352,454,0,0,0,0,0
6.566,6,2,1520,1,0,0,0,40,1,1440,0,1440,1480
1778.224,6,102,8228,68,64,26540,64,4896,34,58,53879,58,3332
1797.396,1,345,28980,345,56,5224,56,28980,0,0,0,0,0
1679.949,1,8,448,8,28,239992,28,448,0,0,0,0,0
1794.644,17,306,64773,306,183,5884,422,64773,0,0,0,0,0
460.197,6,62,4430,25,58,19169,296,2105,37,46,12779,78,2325
188.775,17,3,1008,3,308,94387,308,1008,0,0,0,0,0
1.108,6,28,8609,15,236,65,625,2049,13,1004,75,2720,6560
22.948,6,14,1246,3,106,11474,106,234,11,90,2283,90,1012
0.04,17,4,566,2,31,28,31,118,2,196,29,196,448
92.444,6,28,7352,13,158,7703,267,1317,15,678,6600,3436,6035
1.387,6,23,5564,13,151,115,380,1281,10,969,153,1731,4283
3.758,6,28,7543,13,248,309,517,1723,15,629,265,1418,5820
280.297,6,28,7352,12,158,25481,267,1277,16,603,18682,1400,6075
278.637,6,42,7150,26,154,11145,481,3210,16,258,18569,1440,3940
3.209,6,54,36544,33,734,100,1360,6539,21,2429,153,8347,30005
336.237,6,173,30084,111,304,3056,304,22500,62,83,5505,83,7584
1781.522,6,102,9588,68,66,26589,66,5780,34,60,53982,60,3808
8.927,6,17,3338,10,210,989,210,984,7,664,1487,904,2354
1744.601,6,97,7307,63,38,28138,205,4476,34,33,52856,98,2831
972.102,17,12,969,6,31,194408,37,355,6,74,194408,136,614
0.133,17,4,352,2,37,0,37,130,2,83,125,89,222
1744.143,6,95,7203,63,38,28131,205,4476,32,33,56255,98,2727
14.516,6,15,5673,4,106,4826,106,274,11,823,1449,1452,5399
0.011,17,7,2438,7,320,1,354,2438,0,0,0,0,0
0.807,6,10,1687,7,100,134,100,384,3,1179,274,1179,1303
240.642,6,28,10399,14,449,49,1368,2547,14,790,18507,1368,7852
1788.909,1,224,12544,224,28,8022,28,12544,0,0,0,0,0
1792.914,17,137,10948,70,48,25981,48,5320,67,56,27165,56,5628
15.901,6,8,506,0,0,0,0,0,8,31,2271,31,506
1383.73,2,16,512,16,8,92248,8,512,0,0,0,0,0
1798.819,17,449,39928,404,35,4463,288,25708,45,288,40021,288,14220
1754.779,6,196,25564,108,304,16399,304,17576,88,83,20165,83,7988
1798.688,1,345,28980,345,56,5228,56,28980,0,0,0,0,0
0.155,6,2,1003,1,0,0,0,40,1,911,0,911,963
32.878,17,10,760,10,48,3653,48,760,0,0,0,0,0
1740.832,17,30,7050,30,207,60028,207,7050,0,0,0,0,0
912.804,17,24,2181,12,32,82980,37,731,12,92,82980,136,1450
1795.675,17,446,39548,402,35,4477,288,25644,44,288,40948,288,13904
0.953,6,11,1727,7,100,158,100,384,4,589,228,1152,1343
1635.325,1,8,448,8,28,233617,28,448,0,0,0,0,0
1203.177,2,11,352,11,8,120317,8,352,0,0,0,0,0
240.193,6,55,19578,30,793,8282,1408,16650,25,202,10007,580,2928
0.014,17,2,341,1,37,0,37,65,1,248,0,248,276
372.363,6,21,1419,15,177,26597,177,989,6,110,14347,110,430
1.26,6,45,18085,26,882,50,1360,12549,19,433,60,1360,5536
1594.847,1,8,448,8,28,227835,28,448,0,0,0,0,0
1354.734,1,30,1680,30,28,46714,28,1680,0,0,0,0,0
369.628,6,18,1242,14,180,28432,180,916,4,110,20059,110,326
0.402,6,3,182,2,31,402,31,111,1,31,0,31,71
97.612,17,4,352,2,60,97611,60,176,2,60,97611,60,176
0.071,17,2,348,1,39,0,39,67,1,253,0,253,281
161.753,6,23,7976,11,511,200,1196,2007,12,782,14687,1460,5969
0.805,6,27,5720,14,121,61,267,1295,13,650,60,1420,4425
1790.858,1,342,28728,342,56,5251,56,28728,0,0,0,0,0
1787.431,6,102,8296,68,65,26678,65,4930,34,59,54160,59,3366
300.693,6,36,8572,20,336,15825,999,2178,16,522,568,2720,6394
998.893,6,63,5000,41,65,24972,65,2940,22,59,47561,59,2060
1767.165,1,58,4872,0,0,0,0,0,58,56,31002,56,4872
0.504,6,24,7461,13,334,42,663,2033,11,967,46,1471,5428
280.261,6,28,7352,12,158,25478,267,1277,16,603,18682,1400,6075
65.075,17,4,352,2,60,65074,60,176,2,60,65074,60,176
1786.75,6,120,13490,76,161,23823,1285,9033,44,69,41550,191,4457
1740.838,6,96,6962,62,31,28538,31,4209,34,31,52752,31,2753
311.306,6,359,254167,176,233,1778,517,13078,183,1330,1710,2736,241089
101.597,6,33,10392,14,158,7815,267,1357,19,689,5643,1400,9035
3.349,17,5,290,5,30,837,30,290,0,0,0,0,0
0.297,6,10,887,5,248,71,248,452,5,231,71,231,435
0.486,6,50,21873,28,1039,18,1380,16751,22,421,20,1923,5122
1744.709,2,30,960,30,8,60162,8,960,0,0,0,0,0
1780.78,1,342,28728,342,56,5222,56,28728,0,0,0,0,0
0.038,6,12,4310,7,127,5,127,499,5,1771,6,3378,3811
1740.462,17,29,6815,29,207,62159,207,6815,0,0,0,0,0
0.469,6,13,1693,7,288,73,288,588,6,426,49,434,1105
1773.084,6,180,15480,120,69,14899,69,8940,60,69,30049,69,6540
1.16,6,27,9632,14,350,89,1041,1992,13,1015,81,1460,7640
673.634,6,182,81758,88,91,7742,517,6996,94,1269,7243,7040,74762
280.286,6,30,7432,13,158,23357,267,1317,17,543,17516,1400,6115
1681.733,1,15,840,15,28,120123,28,840,0,0,0,0,0
0.765,6,26,5649,12,140,69,267,1184,14,650,54,1420,4465
531.042,6,34,3224,21,72,26552,159,1879,13,55,44242,58,1345
0.429,6,12,1653,6,288,79,288,548,6,426,49,434,1105
0.503,17,2,776,2,360,503,360,776,0,0,0,0,0
4.071,17,4,240,2,32,4070,32,120,2,32,4070,32,120
240.321,6,46,8551,22,449,11443,1402,5648,24,205,10448,580,2903
0.733,6,31,8256,17,308,45,885,1944,14,574,46,4848,6312
11.571,17,8,608,8,48,1653,48,608,0,0,0,0,0
0.102,1,2,112,2,28,102,28,112,0,0,0,0,0
12.289,6,1966,1692736,1192,1364,10,1380,1657555,774,420,15,1380,35181
1.344,6,50,20050,27,945,51,1460,14354,23,433,53,1460,5696
42.383,17,14,1064,14,48,3260,48,1064,0,0,0,0,0
6.278,6,35,22434,17,239,392,340,1839,18,1310,367,2896,20595
12.046,6,42,9286,20,393,634,833,2069,22,420,554,2128,7217
1788.662,17,83,3480,82,14,22082,14,3444,1,8,0,8,36
1793.348,17,179,13962,179,50,10074,50,13962,0,0,0,0,0
6.017,17,4,1370,2,308,5024,308,672,2,321,5020,321,698
0.072,6,7,423,4,43,11,43,259,3,0,35,0,164
1786.556,6,104,8504,69,66,26272,66,5004,35,60,52543,60,3500
205.731,6,77,14185,31,170,6857,517,4680,46,284,4570,1408,9505
1782.566,6,354,22440,207,69,8653,69,12420,147,69,12209,69,10020
20.137,6,22,5470,13,107,1678,159,1126,9,967,2514,1659,4344
1.29,6,46,18124,26,882,51,1360,12548,20,476,58,2715,5576
301.15,6,43,17077,22,755,14340,1402,7999,21,722,12060,1402,9078
299.863,17,4,352,2,60,299862,60,176,2,60,299861,60,176
377.219,6,27,1767,18,177,22189,177,1181,9,110,8717,110,586
50.582,6,39,12220,19,627,2810,1408,9154,20,201,2613,580,3066
1786.373,6,102,8364,68,66,26662,66,4964,34,60,54129,60,3400
129.261,1,3,1092,3,336,64630,336,1092,0,0,0,0,0
0.6,6,10,1669,6,551,120,947,1346,4,159,199,159,323
10.877,6,84,24565,44,516,252,1152,18824,40,459,271,1179,5741
1.343,6,42,11091,21,575,67,1360,5475,21,433,58,1360,5616
1786.761,6,104,8376,68,65,26668,65,4930,36,59,51046,59,3446
301.044,6,52,23243,30,1088,10380,1440,17561,22,399,423,1440,5682
3.955,6,2,88,2,0,0,0,88,0,0,0,0,0
0.466,6,20,7229,13,334,38,663,2021,7,1209,72,1946,5208
0.01,17,2,159,1,33,0,33,61,1,70,0,70,98
1.283,6,49,19875,28,873,47,1360,14259,21,433,55,1360,5616
0.104,6,4,222,2,31,104,31,111,2,31,0,31,111
280.222,6,27,7312,13,158,23351,267,1317,14,775,21554,4836,5995
299.092,1,4,224,4,28,99697,28,224,0,0,0,0,0
1792.547,17,178,11392,178,36,10127,36,11392,0,0,0,0,0
29.335,6,3,134,0,0,0,0,0,3,7,14667,7,134
1773.079,6,181,15589,120,69,14899,69,8940,61,69,29547,69,6649
1794.92,6,383,24221,217,69,8309,69,13441,166,69,10878,69,10780
1772.632,17,417,116041,417,250,4261,422,116041,0,0,0,0,0
1786.343,17,87,3648,86,14,21015,14,3612,1,8,0,8,36
1793.085,6,356,22520,208,69,8662,69,12460,148,69,12197,69,10060
1787.327,6,355,22549,206,69,8718,69,12380,149,69,12073,69,10169
22.106,6,12,1233,5,585,5525,585,865,7,0,3683,0,368
22.324,6,1316,1131717,829,1290,26,1368,1101729,487,776,45,1473,29988
1680.552,1,15,840,15,28,120039,28,840,0,0,0,0,0
4.047,17,8,8457,2,723,4047,1350,1503,6,1131,783,1350,6954
12.411,6,1893,1707259,1208,1363,10,1380,1675572,685,387,18,1923,31687
0.012,17,2,116,1,30,0,30,58,1,30,0,30,58
29.687,1,2,112,2,28,29687,28,112,0,0,0,0,0
1781.763,6,361,24196,211,88,8484,469,13918,150,69,11958,69,10278
5.003,6,41,7349,22,218,238,314,3503,19,513,264,1179,3846
1769.292,1,58,4872,58,56,31040,56,4872,0,0,0,0,0
917.476,17,282,35332,131,162,6668,1350,25007,151,40,6116,1350,10325
1.176,17,4,368,2,32,991,32,120,2,96,911,96,248
35.841,17,22,1672,22,48,1706,48,1672,0,0,0,0,0
1.343,6,51,19610,27,911,51,1460,13874,24,433,50,1460,5736
1.271,6,41,9968,21,440,63,1360,4392,20,476,57,2715,5576
825.388,1,4,224,4,28,275129,28,224,0,0,0,0,0
1790.448,6,360,22818,209,69,8607,69,12569,151,69,11933,69,10249
5.256,6,39,7269,19,218,292,314,3383,20,513,260,1179,3886
1.849,6,9,527,5,43,462,43,311,4,0,614,0,216
35.242,17,4,352,2,60,35241,60,176,2,60,35241,60,176
5.582,6,39,7269,21,218,279,314,3463,18,513,312,1179,3806
0.867,6,15,2224,7,288,114,288,620,8,424,98,434,1604
0.106,17,2,2378,2,1161,106,1161,2378,0,0,0,0,0
1779.413,17,142,11360,71,48,25420,48,5396,71,56,25420,56,5964
280.461,6,31,7472,13,158,23371,267,1317,18,543,16492,1380,6155
1.236,6,585,550122,230,151,5,287,12573,355,1478,3,2896,537549
72.763,6,7381,6935572,4526,1445,15,1448,6765572,2855,776,25,1448,170000
0.044,17,2,378,1,30,0,30,58,1,292,0,292,320
55.971,17,3,228,3,48,27985,48,228,0,0,0,0,0
1.588,6,53,22507,29,973,56,1460,16771,24,433,60,1460,5736
0.417,6,13,1693,7,288,69,288,588,6,426,45,434,1105
322.771,6,14,752,11,0,32188,0,596,3,0,498,0,156
1.499,6,47,18721,26,925,59,1460,13105,21,476,65,2615,5616
1.05,17,4,580,2,40,1018,40,136,2,194,1016,194,444
0.065,17,3,234,2,39,43,39,134,1,72,0,72,100
0.092,17,2,2382,2,1163,92,1163,2382,0,0,0,0,0
1.232,6,27,8172,14,164,80,267,1404,13,869,87,1408,6768
0.346,17,4,352,2,60,345,60,176,2,60,343,60,176
0.13,6,12,3462,6,75,26,75,395,6,1373,25,1448,3067
1772.932,6,180,15480,120,69,14898,69,8940,60,69,30045,69,6540
1783.947,17,142,11360,71,48,25484,48,5396,71,56,25484,56,5964
251.815,2,2,64,2,8,251815,8,64,0,0,0,0,0
1.944,6,34,12274,19,525,108,1360,3430,15,823,118,1380,8844
1775.649,6,276,34367,115,142,15574,1360,17039,161,135,11097,4662,17328
1798.663,17,144,11520,72,48,25333,48,5472,72,56,25333,56,6048
680.746,1,10,560,10,28,75638,28,560,0,0,0,0,0
12.608,6,12,1355,7,284,2101,517,940,5,147,3150,147,415
2.939,17,2,312,2,128,2939,128,312,0,0,0,0,0
2.318,6,14,2351,8,188,331,245,700,6,703,410,1152,1651
33.838,6,32,5147,15,154,2417,722,1860,17,299,2103,1448,3287
1798.332,1,60,5040,60,56,30480,56,5040,0,0,0,0,0
0.283,17,2,152,1,48,0,48,76,1,48,0,48,76
41.566,17,44,6468,22,48,1978,48,1672,22,190,1978,308,4796
10.429,17,4,352,2,48,10420,48,152,2,72,10418,72,200
0.991,6,26,9145,14,290,76,802,1753,12,985,71,1360,7392
0.06,17,2,176,1,60,0,60,88,1,60,0,60,88
0.135,17,2,904,2,424,135,548,904,0,0,0,0,0
149.722,6,148,22533,78,304,1944,304,15480,70,83,2149,83,7053
13.79,6,19,8472,7,106,2298,106,394,12,759,1252,3417,8078
133.742,6,203,162791,129,1294,1044,1368,149135,74,679,1755,2519,13656
0.015,17,2,230,1,55,0,55,83,1,119,0,119,147
4.637,6,35,6209,17,206,289,314,2744,18,548,256,1179,3465
3.581,6,12,1634,6,503,716,503,831,6,475,716,475,803
0.691,6,27,14648,15,662,49,1360,3968,12,1273,46,2720,10680
155.073,6,21,8134,11,520,85,1223,2034,10,948,17211,1631,6100
1794.365,1,58,4872,58,56,31480,56,4872,0,0,0,0,0
10.782,17,15,17678,15,1150,770,1451,17678,0,0,0,0,0
40.049,17,41,3117,22,40,1907,41,1509,19,56,2224,57,1608
240.511,6,39,4458,18,178,14146,585,2016,21,191,12022,580,2442
257.337,1,4,224,4,28,85779,28,224,0,0,0,0,0
0.297,6,7,466,5,43,65,43,354,2,0,287,0,112
1.993,17,4,300,2,39,1992,39,134,2,55,1992,55,166
1763.735,6,168,10572,89,49,20042,208,6451,79,31,22611,31,4121
154.281,6,11,452,3,0,606,0,124,8,0,22039,0,328
1.375,6,24,8004,12,164,107,267,1288,12,1014,106,2491,6716
49.376,6,98,89001,59,213,851,517,4000,39,2440,1299,8448,85001
0.071,1,2,112,2,28,71,28,112,0,0,0,0,0
0.276,17,2,1922,2,933,276,933,1922,0,0,0,0,0
0.0,17,2,800,2,372,0,372,800,0,0,0,0,0
0.006,17,3,370,2,34,2,34,124,1,218,0,218,246
20.803,17,45,10635,21,268,1038,1350,6232,24,155,903,1350,4403
1787.309,6,102,8296,68,65,26676,65,4930,34,59,54157,59,3366
12.585,6,14,3589,7,129,2073,136,672,7,1316,2066,1430,2917
1799.483,2,27,864,27,8,69210,8,864,0,0,0,0,0
18.961,6,18,6967,10,290,2106,517,1121,8,1355,2707,2421,5846
1775.574,17,126,10080,63,48,28638,48,4788,63,56,28638,56,5292
0.038,6,10,1512,5,503,9,503,771,5,473,9,473,741
1778.643,6,127,15192,79,91,22803,504,6647,48,165,37841,1420,8545
1.452,6,38,8252,19,320,80,1162,2716,19,433,69,1460,5536
4.265,6,35,6209,19,206,236,314,2824,16,456,266,1152,3385
88.574,6,23,7518,12,216,8052,501,1350,11,715,8848,1420,6168
2.314,6,2,1520,1,0,0,0,40,1,1440,0,1440,1480
727.427,6,44,3175,24,31,31619,31,1620,20,31,38276,31,1555
1770.706,6,113,10310,70,64,25662,64,5904,43,58,42157,58,4406
25.061,6,38,9332,20,260,1319,467,1625,18,536,521,2128,7707
280.342,6,30,7432,13,158,23361,267,1317,17,543,17516,1400,6115
0.396,6,8,335,4,0,132,0,164,4,7,65,7,171
1796.701,6,374,23654,214,69,8435,69,13114,160,69,11299,69,10540
83.542,6,43,8909,20,410,778,882,2098,23,367,3789,2720,6811
188.491,6,9,522,2,106,188480,106,194,7,0,31413,0,328
3.106,17,2,280,1,48,0,48,76,1,176,0,176,204
0.642,6,10,924,5,283,107,283,551,5,105,107,105,373
0.257,6,23,4519,11,165,25,456,1394,12,498,21,888,3125
0.329,17,4,920,2,64,325,64,184,2,340,322,340,736
58.703,6,32,8952,14,158,4515,267,1357,18,624,3449,1400,7595
0.038,6,6,718,2,304,31,304,408,4,102,10,102,310
0.033,6,11,3653,6,171,6,171,491,5,1447,8,2676,3162
1783.391,17,83,3480,82,14,22017,14,3444,1,8,0,8,36
13.728,17,8,704,4,48,4571,48,304,4,72,4571,72,400
1783.753,1,61,5124,61,56,29729,56,5124,0,0,0,0,0
39.282,17,43,6368,22,48,1869,48,1672,21,195,1961,308,4696
0.046,6,6,716,3,302,16,302,458,3,102,9,102,258
33.427,6,27,4910,14,180,2571,722,1831,13,479,2769,2026,3079
1335.03,6,168,13073,65,75,20391,365,6462,103,48,13088,78,6611
104.265,6,31,22472,17,549,54,1360,2920,14,2372,8008,6085,19552
1771.094,6,108,9856,68,65,26434,65,5758,40,59,45410,59,4098
3.531,6,24,10978,14,143,271,253,1322,10,1304,377,3649,9656
65.159,1,16,1664,0,0,0,0,0,16,76,4343,76,1664
1770.222,6,101,9344,66,65,27234,65,5577,35,59,52061,59,3767
1794.033,6,356,22520,208,69,8666,69,12460,148,69,12203,69,10060
0.499,17,3,451,2,39,110,39,134,1,289,0,289,317
1792.702,6,93,7816,44,36,41689,36,2576,49,444,37346,445,5240
16.071,17,29,6185,13,205,1336,1350,3036,16,168,1069,1350,3149
12.859,6,8,460,3,0,6429,0,160,5,0,1802,0,300
0.995,6,27,5927,14,156,76,267,1502,13,650,72,1452,4425
1720.614,17,13,534,11,14,172043,14,462,2,8,1720437,8,72
1796.254,17,449,39928,404,35,4457,288,25708,45,288,40016,288,14220
240.528,6,51,8905,27,449,9250,1418,5932,24,171,10457,580,2973
1798.509,17,448,39896,403,35,4473,288,25676,45,288,40018,288,14220
0.011,6,2,100,1,0,0,0,60,1,0,0,0,40
1773.487,6,181,15589,120,69,14903,69,8940,61,69,29553,69,6649
1744.638,2,29,928,29,8,62308,8,928,0,0,0,0,0
0.021,17,4,608,2,60,1,60,176,2,188,0,188,432
0.012,17,2,459,1,40,0,40,68,1,363,0,363,391
531.907,6,45,7608,22,262,25326,517,1940,23,744,24175,1418,5668
9.719,17,4,2731,4,654,3239,655,2731,0,0,0,0,0
1781.762,6,416,24920,208,69,8607,69,12460,208,34,8607,48,12460
1740.247,17,30,1710,30,29,60008,29,1710,0,0,0,0,0
1787.108,6,104,8444,68,66,26673,66,4964,36,60,51057,60,3480
11.095,6,18,5610,10,275,1232,275,958,8,1440,858,1440,4652
64.657,6,50,10495,23,533,705,910,3147,27,312,2481,1460,7348
1770.657,6,103,9448,66,65,27240,65,5577,37,59,49180,59,3871
1.201,17,2,322,1,33,0,33,61,1,233,0,233,261
250.761,6,31,4932,15,138,4242,174,1156,16,261,16711,1452,3776
1720.49,17,12,498,11,14,172049,14,462,1,8,0,8,36
1682.8,17,14,1036,7,30,280459,30,406,7,62,280456,62,630
194.978,17,265,227391,223,984,878,1252,225711,42,12,4702,12,1680
1798.426,17,448,39896,403,35,4473,288,25676,45,288,40017,288,14220
1789.407,1,267,14952,267,28,6727,28,14952,0,0,0,0,0
1791.324,6,356,22520,208,69,8653,69,12460,148,69,12185,69,10060
1791.601,17,180,14040,180,50,10008,50,14040,0,0,0,0,0
1775.198,1,58,4872,58,56,31143,56,4872,0,0,0,0,0
267.907,6,82,30552,41,582,6697,1402,10872,41,762,6697,1402,19680
1.553,6,38,8252,19,320,86,1162,2716,19,433,75,1360,5536
1763.538,2,16,512,16,8,117569,8,512,0,0,0,0,0
1525.672,17,120,9600,60,48,25858,48,4560,60,56,25858,56,5040
1744.952,6,95,7203,63,38,28144,205,4476,32,33,56275,98,2727
1782.849,1,228,12768,228,28,7853,28,12768,0,0,0,0,0
5.033,17,4,288,2,36,5014,36,128,2,52,5018,52,160
1.766,6,48,19234,27,893,67,1360,13618,21,433,78,1360,5616
7.42,17,378,75280,372,172,20,172,74400,6,118,1010,172,880
299.561,6,6,364,4,31,99853,31,222,2,31,299542,31,142
0.011,17,4,276,3,33,1,33,183,1,65,0,65,93
0.189,17,2,283,1,31,0,31,59,1,196,0,196,224
0.887,17,2,122,2,33,887,33,122,0,0,0,0,0
5.529,6,19,8672,8,275,789,275,599,11,847,286,1380,8073
376.088,6,18,1242,14,180,28929,180,916,4,110,20066,110,326
0.864,6,3,127,1,0,0,0,40,2,7,1,7,87
1798.957,6,212,27720,113,304,16062,304,18776,99,83,18356,83,8944
1793.183,17,83,3480,82,14,22138,14,3444,1,8,0,8,36
1.593,6,47,20397,26,979,63,1440,14781,21,433,69,1440,5616
0.009,17,2,170,1,49,0,49,77,1,65,0,65,93
55.913,6,34,5261,20,154,2942,722,2130,14,399,1189,2026,3131
12.399,6,1848,1698166,1146,1402,10,1448,1656986,702,776,17,1448,41180
240.621,2,4,128,4,8,80207,8,128,0,0,0,0,0
1785.467,6,107,9016,70,70,25876,273,5283,37,64,49593,247,3733
0.164,6,43,19770,25,1062,6,1420,14829,18,467,9,1883,4941
0.243,6,36,18003,16,173,16,319,1532,20,1186,11,1438,16471
317.036,6,74,19256,37,325,8806,1360,9657,37,337,8802,1360,9599
280.688,6,25,7094,11,181,28068,267,1168,14,595,21571,1400,5926
1740.451,17,29,6815,29,207,62158,207,6815,0,0,0,0,0
22.243,6,613,448021,332,1116,67,1440,141700,281,1317,78,1864,306321
6.474,6,9,588,3,106,3211,106,234,6,90,1292,90,354
3.993,6,33,9733,17,380,249,1408,3172,16,572,256,1639,6561
3.997,17,5,1165,5,205,999,205,1165,0,0,0,0,0
1777.256,17,73,3060,72,14,25031,14,3024,1,8,0,8,36
295.885,17,42,10878,42,231,7216,388,10878,0,0,0,0,0
177.985,6,10,555,2,0,16518,0,112,8,7,25400,7,443
1598.168,1,8,448,8,28,228309,28,448,0,0,0,0,0
1780.51,17,140,11200,70,48,25804,48,5320,70,56,25804,56,5880
125.812,2,2,64,2,8,125812,8,64,0,0,0,0,0
1.38,6,48,18641,27,850,53,1360,13025,21,476,58,2715,5616
0.717,6,28,7336,13,155,59,267,1301,15,543,42,1400,6035
1795.246,17,448,39896,403,35,4465,288,25676,45,288,40017,288,14220
256.939,6,27,6921,13,229,160,498,1672,14,425,19758,2642,5249
3.219,2,2,64,2,8,3219,8,64,0,0,0,0,0
0.611,6,10,861,5,222,149,222,426,5,231,149,231,435
1787.159,6,107,8561,69,65,26281,65,5035,38,59,48298,59,3526
0.469,6,20,7151,12,318,42,600,1906,8,964,63,1471,5245
1755.665,6,211,14912,105,72,16881,208,9742,106,31,16718,31,5170
2.745,17,25,19297,15,842,193,1350,13054,10,596,301,1350,6243
0.093,17,3,634,2,32,89,32,120,1,486,0,486,514
8.406,6,76,24613,39,561,221,1152,18976,37,461,226,1179,5637
1795.935,17,447,39580,403,35,4467,288,25676,44,288,40949,288,13904
1783.114,17,142,11360,71,48,25472,48,5396,71,56,25472,56,5964
107.846,17,4,232,4,30,35948,30,232,0,0,0,0,0
1782.59,1,158,8848,158,28,11354,28,8848,0,0,0,0,0
1794.606,17,140,11200,70,48,26008,48,5320,70,56,26008,56,5880
0.29,6,25,8816,13,227,24,547,1592,12,1098,26,2816,7224
78.032,6,52,13000,28,538,2890,1230,7941,24,249,3345,1296,5059
0.542,6,28,7336,13,155,45,267,1301,15,543,37,1400,6035
18.875,17,38,9525,19,294,1047,1350,6124,19,151,1046,1350,3401
1.291,17,6,552,3,32,500,32,180,3,96,484,96,372
240.327,6,43,9092,21,524,12015,1418,5817,22,235,11443,617,3275
300.551,6,45,8944,23,286,13661,766,2156,22,346,579,2720,6788
0.008,17,2,422,1,61,0,61,89,1,305,0,305,333
28.75,17,2,122,2,33,28750,33,122,0,0,0,0,0
0.418,6,10,968,5,256,101,256,460,5,304,101,304,508
358.882,6,49,11018,31,320,11962,1360,5451,18,402,508,2667,5567
0.143,17,2,683,1,306,0,306,334,1,321,0,321,349
1781.761,6,364,24854,213,94,8404,469,14467,151,69,11878,69,10387
404.673,6,41,7413,20,142,6628,518,1942,21,330,20229,1420,5471
1.296,6,50,21361,28,970,48,1460,15705,22,433,53,1460,5656
1786.952,6,104,8444,68,66,26670,66,4964,36,60,51052,60,3480
33.679,6,31,5093,15,154,2405,722,1859,16,342,2233,1448,3234
277.935,6,26,7134,12,181,25266,267,1208,14,595,21365,1400,5926
0.35,17,8,2742,8,314,50,353,2742,0,0,0,0,0
0.168,17,2,2754,2,1349,168,1349,2754,0,0,0,0,0
0.284,17,2,154,1,33,0,33,61,1,65,0,65,93
50.038,6,21,11490,9,275,6254,275,918,12,1440,4453,1440,10572
1771.869,6,180,15480,120,69,14889,69,8940,60,69,30031,69,6540
1795.008,1,268,15008,268,28,6722,28,15008,0,0,0,0,0
0.963,6,24,6635,13,350,79,1088,2275,11,783,95,1420,4360
1.353,17,16,8451,9,631,169,1350,5936,7,331,167,1350,2515
280.735,6,28,7352,13,158,23394,267,1317,15,603,20043,2036,6035
1.193,6,129,123969,53,145,22,230,3332,76,1620,15,5472,120637
0.173,17,2,152,1,48,0,48,76,1,48,0,48,76
1744.607,6,100,7897,65,45,27259,205,4850,35,35,51305,98,3047
1.583,6,47,19085,27,885,60,1360,13509,20,476,72,2715,5576
0.089,17,2,132,1,30,0,30,58,1,46,0,46,74
0.018,17,2,136,1,32,0,32,60,1,48,0,48,76
1778.403,1,54,4536,54,56,33554,56,4536,0,0,0,0,0
1797.122,6,357,22629,208,69,8681,69,12460,149,69,12142,69,10169
0.34,17,8,2766,8,317,48,356,2766,0,0,0,0,0
1771.742,6,101,9344,66,65,27257,65,5577,35,59,52107,59,3767
15.28,17,17,8556,8,439,2178,1350,3736,9,507,1906,1350,4820
1684.566,2,14,448,14,8,129582,8,448,0,0,0,0,0
109.415,6,66,19347,33,275,3414,1440,7109,33,839,3413,2103,12238
1.129,17,7,667,4,33,358,33,244,3,113,520,145,423
2.242,6,13,2311,8,188,320,245,700,5,1407,493,1407,1611
0.041,6,2,168,2,64,41,64,168,0,0,0,0,0
0.514,17,4,768,2,39,503,39,134,2,289,15,289,634
1.084,17,19,8227,9,476,130,1350,4542,10,340,114,1350,3685
280.334,6,23,7014,11,181,28033,267,1168,12,766,25469,2600,5846
279.801,6,244,37945,130,304,2169,304,26184,114,83,2464,83,11761
5.99,6,41,7349,21,218,299,314,3463,20,513,300,1179,3886
0.281,6,3,3040,3,1460,140,1460,3040,0,0,0,0,0
0.366,17,3,543,2,39,361,39,134,1,381,0,381,409
1773.697,6,284,36530,117,142,15289,1360,17217,167,148,10684,4662,19313
41.548,1,45,4680,0,0,0,0,0,45,76,944,76,4680
1783.812,6,364,23047,211,69,8494,69,12787,153,69,11735,69,10260
0.227,6,4,208,3,0,0,0,156,1,0,0,0,52
375.958,6,18,1242,14,180,28919,180,916,4,110,20077,110,326
1780.97,1,215,12040,215,28,8322,28,12040,0,0,0,0,0
1773.312,6,180,15480,120,69,14901,69,8940,60,69,30051,69,6540
1746.105,6,95,7203,63,38,28162,205,4476,32,33,56315,98,2727
1.222,6,8,342,4,0,407,0,164,4,7,254,7,178
692.429,6,146,20385,74,162,9485,721,11396,72,243,9740,1414,8989
67.759,6,28,7750,15,321,4839,517,1479,13,558,5490,1408,6271
10.771,6,20,4402,11,275,1077,275,998,9,758,749,1420,3404
383.634,6,18,1242,14,180,29510,180,916,4,110,20060,110,326
1.18,6,52,21291,29,900,42,1360,15595,23,433,46,1360,5696
29.529,6,16,660,9,0,3691,0,364,7,0,3938,0,296
1.576,2,2,64,2,8,1576,8,64,0,0,0,0,0
0.506,17,2,685,1,308,0,308,336,1,321,0,321,349
1789.587,6,361,22858,209,69,8603,69,12569,152,69,11849,69,10289
1786.61,6,104,8444,68,66,26665,66,4964,36,60,51043,60,3480
380.894,6,48,11885,20,336,20045,1189,4507,28,328,14098,1926,7378
0.039,6,11,911,6,181,7,181,489,5,77,8,133,422
11.015,6,20,4442,11,275,1101,275,998,9,768,777,1440,3444
5.936,17,3,1008,3,308,2968,308,1008,0,0,0,0,0
0.005,17,2,470,1,45,0,45,73,1,369,0,369,397
209.354,6,9,663,3,275,104677,275,399,6,0,6297,0,264
11.627,6,1792,1605167,1090,1418,10,1432,1572866,702,420,16,1432,32301
0.94,6,10,1687,7,100,156,100,384,3,1179,337,1179,1303
0.856,6,114,88343,50,131,17,232,2529,64,1411,13,2860,85814
67.144,17,3,2910,3,942,33572,1444,2910,0,0,0,0,0
0.319,6,2,1073,1,0,0,0,40,1,993,0,993,1033
19.323,17,41,15538,19,567,1071,1350,11317,22,163,918,1350,4221
1789.724,17,134,10720,67,48,27116,48,5092,67,56,27116,56,5628
1793.892,17,83,3480,82,14,22146,14,3444,1,8,0,8,36
33.594,6,28,4938,14,180,2584,722,1807,14,399,2570,1402,3131
120.604,17,8,1248,8,128,17229,128,1248,0,0,0,0,0
240.274,6,61,21008,33,797,7508,1418,17691,28,185,8898,580,3317
4.43,6,16,4148,9,88,553,88,504,7,1670,738,1880,3644
0.207,6,23,6012,12,181,18,537,1526,11,558,19,1402,4486
1799.523,6,390,27591,222,101,8142,469,16386,168,69,10773,69,11205
6.229,6,1470,1359799,928,1388,6,1408,1326951,542,931,11,2801,32848
0.088,6,10,1495,5,507,21,507,727,5,556,21,556,768
24.955,17,14,1232,7,48,4157,48,532,7,72,4156,72,700
0.356,17,2,204,1,34,0,34,62,1,114,0,114,142
0.0,17,2,154,1,33,0,33,61,1,65,0,65,93
61.889,6,79,54436,48,1210,1316,1448,46071,31,843,2054,2896,8365
11.165,6,27,11355,13,275,930,275,1078,14,1078,787,1414,10277
0.075,17,3,618,2,32,59,32,120,1,470,0,470,498
1783.811,6,370,25770,214,99,8374,469,15114,156,69,11508,69,10656
0.038,17,2,664,1,308,0,308,336,1,300,0,300,328
1.365,6,24,8004,12,164,106,267,1288,12,1014,103,2331,6716
1782.232,6,102,8296,68,65,26600,65,4930,34,59,54004,59,3366
1.161,6,28,8609,15,236,69,625,2049,13,1004,79,2720,6560
1785.881,6,150,24780,90,483,20066,483,19170,60,83,30269,83,5610
0.124,17,2,211,1,34,0,34,62,1,121,0,121,149
0.201,17,2,157,1,31,0,31,59,1,70,0,70,98
1781.248,1,58,3248,58,28,31249,28,3248,0,0,0,0,0
0.428,6,46,20561,27,1031,16,1380,15571,19,421,21,1923,4990
0.021,17,2,168,1,48,0,48,76,1,64,0,64,92
280.38,6,30,7432,13,158,23365,267,1317,17,543,17518,1400,6115
186.413,6,18,5476,18,302,10965,1402,5476,0,0,0,0,0
1.515,6,42,11511,24,547,65,1360,5970,18,437,77,2715,5541
681.888,17,14,1198,7,32,113645,37,420,7,83,113643,136,778
15.176,17,16,8467,7,494,2524,1350,3657,9,506,1893,1350,4810
316.879,6,45,8721,17,127,19804,267,1833,28,303,11733,1460,6888
0.05,17,2,166,1,39,0,39,67,1,71,0,71,99
7.264,6,1194,1004099,713,1360,10,1380,980617,481,421,15,1923,23482
1.591,6,38,9896,21,440,79,1360,4440,17,529,83,4075,5456
1794.715,17,67,2802,65,14,28042,14,2730,2,8,28548,8,72
0.153,6,7,423,4,43,37,43,259,3,0,27,0,164
0.189,6,9,1050,5,261,47,261,465,4,421,53,421,585
11.277,6,1755,1557615,1081,1388,10,1420,1526422,674,467,16,1883,31193
280.549,6,29,7392,13,158,23379,267,1317,16,603,18695,2076,6075
64.697,6,29,8832,14,158,4976,267,1357,15,858,4619,3436,7475
3.289,17,4,304,2,48,3062,48,152,2,48,3060,48,152
1.184,17,19,10295,9,420,148,1350,4040,10,597,108,1350,6255
240.221,6,53,17989,28,804,8896,1402,15137,25,193,10008,580,2852
592.205,1,6,336,6,28,118441,28,336,0,0,0,0,0
192.859,17,8,1648,4,48,64282,48,304,4,308,64281,308,1344
1771.358,6,102,9462,66,66,27251,66,5610,36,60,50607,60,3852
0.153,6,43,18704,25,980,6,1420,13763,18,467,8,1883,4941
111.379,2,2,64,2,8,111379,8,64,0,0,0,0,0
1742.206,1,58,4872,58,56,30565,56,4872,0,0,0,0,0
1771.907,6,180,15480,120,69,14889,69,8940,60,69,30031,69,6540
1789.162,6,356,22520,208,69,8643,69,12460,148,69,12171,69,10060
77.924,6,51,33885,34,1021,2356,1408,26302,17,957,4859,2439,7583
0.667,17,2,152,1,48,0,48,76,1,48,0,48,76
9.782,6,1400,1161290,768,1415,12,1448,1116886,632,776,15,1448,44404
1680.75,17,13,534,11,14,168056,14,462,2,8,1680565,8,72
11.932,6,1766,1625813,1148,1365,10,1432,1596709,618,434,19,1871,29104
62.138,6,6,240,0,0,0,0,0,6,0,0,0,240
21.205,6,3235,3001996,2068,1372,10,1408,2936648,1167,931,18,2816,65348
221.471,17,4,240,2,32,221470,32,120,2,32,221470,32,120
0.978,6,9,1647,6,100,195,100,344,3,1179,351,1179,1303
14.332,6,14,2181,8,322,2047,581,1069,6,396,2724,580,1112
11.734,6,1856,1621289,1099,1420,10,1432,1586776,757,467,15,1871,34513
152.947,17,4,352,2,60,152946,60,176,2,60,152946,60,176
0.194,6,4,493,2,241,194,241,321,2,92,2,92,172
1778.297,1,67,5628,67,56,26943,56,5628,0,0,0,0,0
0.005,17,3,618,2,32,2,32,120,1,470,0,470,498
7.24,17,16,3460,8,47,1031,47,600,8,329,1032,341,2860
4.151,6,36,6249,19,206,230,314,2824,17,456,243,1152,3425
1.483,6,24,8004,12,164,115,267,1288,12,1014,114,2491,6716
0.864,6,26,8380,14,266,55,540,1924,12,1192,64,3151,6456
31.09,6,42,14292,22,972,420,1460,8690,20,399,1626,1460,5602
356.838,17,28,2194,14,40,27447,41,962,14,60,27447,80,1232
280.31,17,8,3020,8,349,40044,357,3020,0,0,0,0,0
177.29,17,4,352,2,60,177288,60,176,2,60,177288,60,176
51.063,6,53,13075,30,143,1760,159,3477,23,597,2320,1418,9598
1791.512,6,125,12404,79,62,22968,722,6510,46,92,39805,2026,5894
1.009,6,23,8725,13,290,84,802,1713,10,1100,91,2370,7012
80.629,6,44,14307,22,964,429,1360,8625,22,399,3829,1360,5682
1796.065,17,446,39548,402,35,4478,288,25644,44,288,40950,288,13904
16.532,17,4,824,2,48,16524,48,152,2,308,16522,308,672
2.098,6,50,20052,27,946,80,1440,14356,23,433,86,1440,5696
0.453,6,9,1340,5,145,113,145,349,4,827,148,827,991
398.573,6,64,10388,34,96,10039,267,2911,30,250,13743,1997,7477
17.292,17,26,13730,12,439,1569,1350,5614,14,551,1327,1350,8116
17.682,6,42,9628,21,259,884,464,1698,21,471,876,2920,7930
21.928,6,23,6677,11,181,2192,267,1172,12,836,1992,2045,5505
47.428,17,6,528,3,60,23713,60,264,3,60,23713,60,264
1772.125,6,180,15480,120,69,14891,69,8940,60,69,30032,69,6540
1749.856,17,13,534,11,14,174958,14,462,2,8,1749669,8,72
4.286,17,58,42106,23,327,194,1350,8187,35,941,120,1350,33919
1786.573,6,104,8444,68,66,26665,66,4964,36,60,51042,60,3480
0.974,6,23,6393,13,309,80,887,2073,10,979,107,1791,4320
1.883,17,2,148,2,46,1883,46,148,0,0,0,0,0
66.276,6,21,8171,12,434,6025,661,1936,9,959,8257,2688,6235
1740.148,6,87,6322,58,31,30528,31,3915,29,31,62147,31,2407
1773.515,6,204,22399,130,75,13748,267,10057,74,133,24292,1917,12342
0.003,6,3,187,2,43,0,43,147,1,0,0,0,40
0.186,6,10,2026,6,729,37,1302,1703,4,159,61,159,323
1774.737,17,140,11200,70,48,25720,48,5320,70,56,25720,56,5880
282.007,6,30,7432,13,158,23500,267,1317,17,543,17606,1400,6115
280.449,6,30,7432,13,158,23370,267,1317,17,603,17523,2076,6115
12.392,17,4,1328,4,304,4130,308,1328,0,0,0,0,0
0.433,6,13,1693,7,288,72,288,588,6,284,41,434,1105
44.19,6,633,530558,382,1432,73,1460,512281,251,195,176,1460,18277
1754.232,6,107,8037,68,38,26182,205,4798,39,32,46153,98,3239
1798.142,1,240,13440,240,28,7523,28,13440,0,0,0,0,0
1.634,6,40,9984,20,510,86,1440,4408,20,433,76,1440,5576
1749.544,17,12,498,11,14,174954,14,462,1,8,0,8,36
0.039,17,2,144,1,36,0,36,64,1,52,0,52,80
300.855,6,42,15311,25,879,12535,1360,9829,17,479,542,4027,5482
1786.578,6,104,8308,68,64,26665,64,4896,36,58,51042,58,3412
3.976,17,8,1248,4,64,1322,64,368,4,192,1323,192,880
206.437,17,4,352,2,60,206436,60,176,2,60,206436,60,176
0.294,17,4,334,2,39,120,39,134,2,72,0,72,200
0.036,17,8,2454,8,278,5,317,2454,0,0,0,0,0
0.045,17,4,308,2,33,0,33,122,2,65,0,65,186
1742.684,2,20,640,20,8,91720,8,640,0,0,0,0,0
1790.303,1,342,28728,342,56,5250,56,28728,0,0,0,0,0
1797.576,17,449,39416,404,34,4460,288,25444,45,282,40026,288,13972
2.131,17,2,334,1,39,0,39,67,1,239,0,239,267
1787.45,6,106,8456,68,65,26678,65,4930,38,59,48304,59,3526
333.258,6,68,46393,44,1164,7750,1368,38410,24,747,2695,1368,7983
663.555,17,124,9424,124,48,5394,48,9424,0,0,0,0,0
27.348,6,48,13180,24,176,1189,721,2724,24,791,1175,2840,10456
113.646,6,24,11037,12,740,79,1360,3473,12,1178,10317,2580,7564
0.196,17,2,152,1,48,0,48,76,1,48,0,48,76
2.18,6,41,9968,21,440,109,1360,4392,20,433,102,1360,5576
1.489,17,13,3216,13,219,124,389,3216,0,0,0,0,0
64.984,6,40,6864,18,156,87,189,1389,22,286,3086,1360,5475
1.666,17,2,144,1,36,0,36,64,1,52,0,52,80
1.024,17,19,13154,11,944,102,1350,10694,8,279,141,1350,2460
0.731,6,4,220,2,0,731,0,100,2,0,306,0,120
8.097,6,1905,1794899,1227,1385,6,1408,1754979,678,931,11,2816,39920
90.081,6,23,10241,11,433,76,990,1783,12,995,8176,1360,8458
10.767,6,101,33837,50,616,219,1152,27299,51,449,210,1179,6538
1598.185,1,8,448,8,28,228312,28,448,0,0,0,0,0
1781.659,6,112,9250,69,66,26200,66,5070,43,60,42418,60,4180
842.273,2,11,352,11,8,84227,8,352,0,0,0,0,0
1.166,17,398,421167,88,142,13,1350,15012,310,1282,3,1350,406155
1787.326,6,102,8364,68,66,26676,66,4964,34,60,54158,60,3400
6.468,6,848,765017,534,1357,11,1368,741709,314,776,19,1473,23308
1764.074,2,14,448,14,8,135698,8,448,0,0,0,0,0
19.631,17,12,1056,6,48,3924,48,456,6,72,3923,72,600
0.249,17,3,123,2,11,249,14,79,1,16,0,16,44
61.337,6,37,15983,22,805,2920,1440,9205,15,665,4362,1440,6778
4.909,6,34,6169,19,206,272,314,2824,15,548,332,1179,3345
1683.7,17,14,1036,7,30,280607,30,406,7,62,280610,62,630
0.081,17,4,360,2,30,1,30,116,2,94,47,94,244
1792.788,1,58,4872,58,56,31452,56,4872,0,0,0,0,0
1782.383,17,246,52314,246,184,7275,422,52314,0,0,0,0,0
564.994,6,74,11106,39,108,14868,267,3843,35,325,6256,1926,7263
42.252,6,41,5831,18,154,2485,721,2062,23,197,1911,2026,3769
1787.083,6,109,8770,70,66,25899,66,5110,39,60,47025,60,3660
0.059,6,11,924,7,181,9,181,553,4,77,5,134,371
1789.861,1,160,8960,160,28,11256,28,8960,0,0,0,0,0
137.427,6,22,8484,11,325,69,634,1447,11,940,13728,1460,7037
16.52,2,3,96,3,8,8260,8,96,0,0,0,0,0
204.392,17,4,240,2,32,204391,32,120,2,32,204391,32,120
1789.492,6,356,22520,208,69,8644,69,12460,148,69,12173,69,10060
1784.59,17,140,11200,70,48,25863,48,5320,70,56,25863,56,5880
17.38,17,8,704,4,48,5789,48,304,4,72,5789,72,400
10.71,6,1537,1236677,821,1409,12,1448,1190169,716,776,14,1448,46508
0.646,6,117,77165,64,1286,10,1432,70754,53,427,12,1432,6411
38.835,6,11,2396,3,92,19417,92,244,8,431,5478,1448,2152
1795.095,17,144,11520,72,48,25282,48,5472,72,56,25282,56,6048
281.679,6,30,7432,13,158,23473,267,1317,17,543,17588,1400,6115
0.519,17,3,543,2,39,417,39,134,1,381,0,381,409
0.4,6,46,18142,25,1000,16,1380,13060,21,421,18,1923,5082
77.685,6,13,540,6,0,2923,0,244,7,0,12946,0,296
1082.887,2,9,288,9,8,135360,8,288,0,0,0,0,0
11.362,6,2111,2039196,1402,1379,7,1408,1997664,709,776,15,1408,41532
1123.962,17,220,16720,220,48,5132,48,16720,0,0,0,0,0
1787.931,17,22,7035,22,291,85139,1269,7035,0,0,0,0,0
795.773,6,65,9903,35,121,15937,500,3353,30,213,27437,1420,6550
2.595,6,9,1878,5,666,648,666,934,4,728,864,728,944
17.939,17,4,1344,4,308,5979,308,1344,0,0,0,0,0
57.303,17,4,352,2,60,57302,60,176,2,60,57302,60,176
1.443,6,52,21332,29,902,51,1360,15636,23,476,56,2715,5696
23.073,6,47,8897,22,345,611,720,2019,25,345,955,1460,6878
3.936,6,6,340,3,0,1968,0,160,3,0,956,0,180
375.899,6,23,1538,16,180,25059,180,1056,7,110,10396,110,482
39.576,6,2270,1921474,1336,1375,29,1380,1874292,934,459,42,1923,47182
314.473,6,252,203730,160,1339,1977,1448,185146,92,574,2024,1448,18584
16.107,6,86,28969,44,610,374,1152,23148,42,459,385,1179,5821
1370.79,6,274,17377,159,69,8675,69,9603,115,69,12024,69,7774
1795.665,17,448,39896,403,35,4466,288,25676,45,288,40019,288,14220
6.486,6,54,14770,26,506,259,1440,5686,28,441,232,1440,9084
0.161,6,7,423,4,43,41,43,259,3,0,23,0,164
135.138,6,32,8178,16,371,3002,766,1785,16,521,9000,2720,6393
209.138,17,4,352,2,60,209137,60,176,2,60,209137,60,176
1788.993,17,142,11360,71,48,25556,48,5396,71,56,25556,56,5964
50.578,6,27,7177,13,155,4214,267,1306,14,530,3890,3417,5871
0.674,17,4,1344,4,308,224,308,1344,0,0,0,0,0
1394.232,6,160,11046,58,46,24460,46,4620,102,46,13804,46,6426
0.059,6,2,123,1,0,0,0,40,1,31,0,31,83
379.782,6,24,2351,17,141,23736,141,865,7,398,3907,419,1486
61.407,6,46,9978,22,642,631,1360,4185,24,370,2662,1360,5793
0.549,6,26,8890,13,232,45,569,1614,13,941,44,1438,7276
270.579,6,25,6286,9,271,110,515,1179,16,371,18032,1452,5107
1.125,6,51,13865,24,551,48,1429,4876,27,464,42,1986,8989
1720.564,17,12,498,11,14,172056,14,462,1,8,0,8,36
240.162,6,53,29538,25,183,10006,517,2418,28,1509,8894,5672,27120
1787.335,17,87,3648,86,14,21027,14,3612,1,8,0,8,36
0.159,17,2,312,1,64,0,64,92,1,192,0,192,220
163.769,17,3,1170,3,362,81884,372,1170,0,0,0,0,0
0.434,6,107,90504,67,165,6,253,4391,40,2270,11,8448,86113
1.07,17,4,314,2,31,1024,31,118,2,70,1038,70,196
0.127,6,9,1343,5,145,31,145,349,4,830,37,830,994
16.445,17,21,9142,9,274,2051,1350,2721,12,507,1492,1350,6421
240.265,6,57,20369,31,833,8008,1418,17452,26,194,9610,580,2917
82.512,6,19,3042,10,411,9168,585,1762,9,396,10285,580,1280
0.267,17,3,451,2,39,168,39,134,1,289,0,289,317
0.528,6,53,22873,29,1029,18,1380,17659,24,421,21,1923,5214
1740.44,17,28,29568,28,1028,64460,1028,29568,0,0,0,0,0
1795.94,17,144,11520,72,48,25294,48,5472,72,56,25294,56,6048
11.892,6,17,4322,8,275,1698,275,878,9,768,1383,1440,3444
1772.607,6,180,15480,120,69,14895,69,8940,60,69,30039,69,6540
2.06,17,3,468,3,128,1030,128,468,0,0,0,0,0
0.076,6,11,1535,6,507,15,507,767,5,556,18,556,768
0.035,6,2,846,1,0,0,0,40,1,754,0,754,806
1772.741,6,180,15480,120,69,14896,69,8940,60,69,30039,69,6540
300.338,6,53,36426,34,1195,9101,1408,30462,19,828,1642,1491,5964
598.395,2,6,192,6,8,119679,8,192,0,0,0,0,0
1764.594,1,60,3360,60,28,29908,28,3360,0,0,0,0,0
0.045,17,4,352,2,60,44,60,176,2,60,40,60,176
27.469,17,32,4704,16,48,1830,48,1216,16,190,1830,308,3488
94.393,1,20,560,20,0,0,0,560,0,0,0,0,0
0.432,6,27,8963,13,237,36,590,1635,14,941,31,1408,7328
38.801,17,11,836,11,48,3880,48,836,0,0,0,0,0
11.721,6,94,27085,49,537,244,1152,20787,45,449,260,1179,6298
0.056,17,2,632,1,288,0,288,316,1,288,0,288,316
208.479,6,37,7597,15,219,702,293,2366,22,361,9916,1152,5231
2.788,6,22,6422,10,268,304,517,1333,12,744,249,1418,5089
5.002,6,39,7285,21,218,250,314,3463,18,516,279,1179,3822
7.84,1,12,1248,0,0,0,0,0,12,76,712,76,1248
1743.542,6,95,7203,63,38,28121,205,4476,32,33,56230,98,2727
0.692,6,24,7437,13,334,57,663,2021,11,967,61,1471,5416
11.503,6,1869,1765961,1210,1383,9,1408,1727017,659,931,17,2801,38944
3.532,17,24,7784,9,252,441,1350,2525,15,322,230,1350,5259
0.089,17,2,152,1,48,0,48,76,1,48,0,48,76
9.101,6,1438,1250148,870,1385,10,1420,1223195,568,467,16,1883,26953
541.425,2,4,128,4,8,180475,8,128,0,0,0,0,0
1786.568,6,102,8296,68,65,26665,65,4930,34,59,54135,59,3366
1740.518,17,29,30624,29,1028,62161,1028,30624,0,0,0,0,0
1787.011,6,102,8296,68,65,26671,65,4930,34,59,54148,59,3366
3.914,17,2,656,2,300,3914,300,656,0,0,0,0,0
1273.712,6,77,11149,38,268,34422,517,3337,39,723,33516,2451,7812
1770.766,6,101,9410,66,66,27242,66,5610,35,60,52078,60,3800
0.057,1,2,112,2,28,57,28,112,0,0,0,0,0
64.823,6,31,7534,15,162,4630,267,1583,16,530,4297,3377,5951
0.068,17,2,212,1,46,0,46,74,1,110,0,110,138
1.352,6,39,8294,19,321,75,1164,2718,20,433,61,1460,5576
109.074,6,106,18252,69,304,1604,304,13652,37,83,3013,83,4600
0.819,6,20,5952,11,282,81,548,1292,9,716,91,1420,4660
369.796,6,23,1535,16,177,24653,177,1053,7,110,10377,110,482
0.052,17,4,368,2,32,0,32,120,2,96,0,96,248
0.016,17,2,400,1,34,0,34,62,1,310,0,310,338
1.191,6,15,2638,7,288,194,288,600,8,568,145,853,2038
530.004,6,65,4644,24,58,21739,294,2067,41,46,13250,78,2577
1.153,6,23,7952,12,164,88,267,1288,11,1216,97,3819,6664
366.043,6,27,1767,18,177,21531,177,1181,9,110,8752,110,586
19.045,17,36,15339,20,594,1000,1350,12458,16,152,1267,1350,2881
1.024,6,12,1767,8,100,146,100,424,4,589,252,1152,1343
1729.205,6,68,4947,43,33,41171,33,2953,25,31,72042,31,1994
32.384,17,4,240,2,32,32383,32,120,2,32,32383,32,120
389.625,6,94303,98744469,38605,346,10,351,2133497,55698,1684,6,12312,96610972
375.999,6,18,1242,14,180,28923,180,916,4,110,20078,110,326
0.175,6,10,690,6,71,35,71,391,4,83,43,83,299
1.243,6,25,8068,12,164,96,267,1300,13,869,88,1408,6768
1786.309,1,342,28728,342,56,5238,56,28728,0,0,0,0,0
1770.082,6,103,9448,66,65,27232,65,5577,37,59,49166,59,3871
25.141,6,18,3381,10,211,2727,211,974,8,665,3591,904,2407
1700.654,17,13,534,11,14,170047,14,462,2,8,1700478,8,72
153.221,17,14,1120,7,48,25535,48,532,7,56,25536,56,588
5.189,17,5,320,5,36,1297,36,320,0,0,0,0,0
0.526,6,10,1669,6,551,105,947,1346,4,159,175,159,323
1795.981,6,397,26850,217,99,8314,469,15165,180,48,10033,69,11685
0.137,17,2,152,1,48,0,48,76,1,48,0,48,76
141.799,17,6,528,3,60,70899,60,264,3,60,70899,60,264
259.434,17,4,352,2,60,259433,60,176,2,60,259433,60,176
0.608,6,10,767,5,186,151,186,454,5,45,123,45,313
1772.959,6,180,15480,120,69,14898,69,8940,60,69,30041,69,6540
1739.323,6,96,6962,62,31,28513,31,4209,34,31,52706,31,2753
1798.969,17,760,45872,760,32,2370,37,45872,0,0,0,0,0
0.016,17,4,284,2,32,11,32,120,2,54,10,60,164
0.0,17,1,91,1,63,0,63,91,0,0,0,0,0
0.018,6,13,3980,7,88,2,88,388,6,1670,3,2920,3592
240.312,6,43,9092,21,523,12015,1408,5808,22,236,11443,619,3284
1787.225,6,109,9116,70,71,25901,293,5303,39,64,47030,247,3813
0.021,17,2,206,1,44,0,44,72,1,106,0,106,134
153.098,17,4,240,2,32,153097,32,120,2,32,153096,32,120
532.149,1,6,336,6,28,106429,28,336,0,0,0,0,0
0.038,17,2,212,1,46,0,46,74,1,110,0,110,138
1787.416,6,102,8364,68,66,26677,66,4964,34,60,54160,60,3400
12.426,6,2076,1792868,1184,1423,10,1448,1736540,892,776,13,1448,56328
1773.338,6,181,15589,120,69,14902,69,8940,61,69,29550,69,6649
9.475,6,1712,1562462,1073,1377,8,1408,1524570,639,931,14,2816,37892
1794.565,6,356,22520,208,69,8669,69,12460,148,69,12206,69,10060
185.074,6,101,69963,62,1255,3034,1448,59738,39,629,2525,1448,10225
6.038,6,1650,1534164,1046,1389,5,1408,1498092,604,931,9,2816,36072
246.255,17,4,352,2,60,246253,60,176,2,60,246253,60,176
1.821,6,28,8892,17,286,113,591,1543,11,863,161,1380,7349
1759.698,6,80,3200,40,0,45120,0,1600,40,0,45120,0,1600
94.608,17,4,352,2,60,94607,60,176,2,60,94607,60,176
2.158,6,57,20742,32,881,69,1360,14574,25,368,82,1360,6168
143.495,6,20,9025,5,167,4601,243,603,15,1259,10237,1448,8422
1.068,6,32,13242,17,522,66,1360,3338,15,929,63,2720,9904
0.281,6,27,9071,13,247,23,624,1672,14,832,20,1448,7399
1786.303,6,106,8456,68,65,26661,65,4930,38,59,48275,59,3526
1741.413,17,30,31680,30,1028,60048,1028,31680,0,0,0,0,0
38.521,17,20,1760,10,48,4279,48,760,10,72,4279,72,1000
1764.512,2,23,736,23,8,80205,8,736,0,0,0,0,0
1.308,6,50,20434,27,973,50,1440,14738,23,433,51,1440,5696
1777.605,17,73,3060,72,14,25036,14,3024,1,8,0,8,36
1794.32,6,357,22629,208,69,8668,69,12460,149,69,12123,69,10169
1786.027,6,102,8364,68,66,26657,66,4964,34,60,54119,60,3400
2.141,17,2,672,2,308,2141,308,672,0,0,0,0,0
84.226,17,33,2314,30,40,2902,41,2060,3,56,976,57,254
1798.102,17,449,39928,404,35,4461,288,25708,45,288,40018,288,14220
1797.099,17,448,39896,403,35,4470,288,25676,45,288,40017,288,14220
0.152,6,7,423,4,43,39,43,259,3,0,25,0,164
0.911,17,4,918,2,40,900,40,136,2,363,897,363,782
0.356,6,20,7238,12,335,31,668,1974,8,1210,49,2816,5264
14.77,6,23,4574,12,275,1342,275,1042,11,768,999,1440,3532
7.606,6,39,7273,19,218,422,314,3383,20,513,386,1179,3890
1786.426,6,106,8515,69,65,26270,65,4970,37,59,49619,59,3545
68.523,17,4,240,2,32,68522,32,120,2,32,68522,32,120
161.37,17,2,908,2,426,161370,687,908,0,0,0,0,0
1795.434,17,449,39928,404,35,4455,288,25708,45,288,40022,288,14220
3.177,17,4,1564,4,363,1059,363,1564,0,0,0,0,0
335.683,6,89,31027,45,586,7628,1402,11154,44,798,7806,2804,19873
16.635,6,54,20781,25,575,693,1440,6858,29,671,437,1440,13923
0.56,6,24,7458,13,335,46,668,2038,11,968,55,1906,5420
916.271,6,173,21358,68,96,13675,658,6321,105,137,8808,1360,15037
169.428,6,1563,795159,881,840,192,1152,760328,682,377,248,1152,34831
26.656,6,4224,4009167,2653,1428,9,1448,3917935,1571,776,16,1448,91232
1740.984,6,87,6322,58,31,30543,31,3915,29,31,62177,31,2407
0.042,6,9,1612,5,636,10,636,904,4,492,13,492,708
0.01,17,2,180,1,30,0,30,58,1,94,0,94,122
0.19,17,4,304,2,37,186,37,130,2,59,186,65,174
1769.632,6,106,9752,68,65,26412,65,5758,38,59,47825,59,3994
12.362,6,6,328,4,0,4120,0,216,2,0,12344,0,112
49.388,6,35,14068,17,174,3086,254,1775,18,1030,2898,1438,12293
1700.576,17,13,534,11,14,170040,14,462,2,8,1700402,8,72
12.457,6,11,676,3,106,6216,106,234,8,90,1775,90,442
15.311,6,21,6825,12,275,1391,275,1038,9,1353,1297,1440,5787
4.309,6,39,7269,19,218,239,314,3383,20,513,213,1179,3886
0.182,17,2,152,1,48,0,48,76,1,48,0,48,76
121.239,6,24,2827,8,183,17319,517,1353,16,323,8082,499,1474
4.974,17,4,288,2,36,4973,36,128,2,52,4972,52,160
149.639,17,48,7292,24,48,6502,48,1824,24,199,6503,308,5468
0.098,17,4,588,2,48,88,48,152,2,190,86,308,436
1793.597,1,290,30740,290,78,6206,78,30740,0,0,0,0,0
48.512,17,17,18292,17,1048,3032,1451,18292,0,0,0,0,0
300.632,6,48,9206,24,318,13070,927,2337,24,327,656,1460,6869
0.296,6,26,8990,13,247,24,624,1672,13,947,23,1448,7318
105.108,6,26,6053,10,152,11678,267,862,16,413,6990,1179,5191
2.269,6,27,8827,16,282,151,578,1490,11,984,208,1452,7337
0.906,6,10,924,5,283,181,283,551,5,105,181,105,373
0.621,17,4,284,2,32,296,32,120,2,54,326,60,164
1797.748,6,370,25839,215,99,8400,469,15154,155,69,11671,69,10685
0.116,17,2,152,1,48,0,48,76,1,48,0,48,76
68.815,17,4,352,2,60,68814,60,176,2,60,68814,60,176
1147.148,6,232,14795,130,69,8892,69,7822,102,68,11357,69,6973
1793.672,17,29,9512,29,300,64059,300,9512,0,0,0,0,0
3.088,17,6,540,3,30,1521,30,174,3,94,1521,94,366
1.388,6,50,20113,28,887,51,1360,14457,22,433,57,1360,5656
10.763,6,19,4350,10,275,1195,275,958,9,755,743,1414,3392
1788.077,6,369,25261,214,93,8394,469,14714,155,69,11610,69,10547
1.324,6,41,11378,22,547,63,1360,5842,19,476,63,2715,5536
0.396,17,2,152,1,48,0,48,76,1,48,0,48,76
0.082,6,3,144,2,0,2,0,92,1,0,0,0,52
27.704,6,28,7557,10,155,9,267,1186,18,403,1629,3426,6371
0.005,6,2,80,1,0,0,0,40,1,0,0,0,40
0.472,17,2,384,1,39,0,39,67,1,289,0,289,317
0.286,6,28,9150,13,261,23,683,1728,15,829,20,1408,7422
0.061,17,2,912,1,308,0,308,336,1,548,0,548,576
79.477,17,4,240,2,32,79475,32,120,2,32,79476,32,120
0.552,6,16,1825,8,288,54,288,640,8,284,54,434,1185
1.277,6,51,21344,29,906,45,1360,15688,22,476,52,2715,5656
120.525,6,12,8679,3,100,133,100,224,9,1155,15033,1179,8455
1785.404,1,184,10304,184,28,9756,28,10304,0,0,0,0,0
1773.048,6,181,15589,120,69,14899,69,8940,61,69,29548,69,6649
1680.159,1,15,840,15,28,120011,28,840,0,0,0,0,0
1.056,6,142,98591,79,1342,13,1432,91771,63,428,16,1871,6820
393.427,6,76,11850,35,287,11571,1111,5846,41,203,9835,1408,6004
1792.52,1,35,4083,35,88,52721,173,4083,0,0,0,0,0
16.763,6,26,4702,14,275,1289,275,1126,12,768,1090,1440,3576
10.017,17,3,223,2,41,10013,41,138,1,57,0,57,85
1.441,6,52,22108,31,947,48,1360,16447,21,437,62,2715,5661
1783.276,17,83,3480,82,14,22015,14,3444,1,8,0,8,36
0.412,17,4,424,2,46,391,46,148,2,110,0,110,276
0.04,17,8,1670,8,180,5,219,1670,0,0,0,0,0
0.079,17,2,152,1,48,0,48,76,1,48,0,48,76
2.286,6,14,2351,8,188,326,245,700,6,703,406,1152,1651
0.174,6,7,380,4,0,58,0,216,3,0,81,0,164
1773.341,6,186,15996,121,69,14777,69,9049,65,69,27703,69,6947
4.993,6,39,7285,20,218,262,314,3423,19,516,263,1179,3862
1751.682,17,22,7317,22,304,83413,1438,7317,0,0,0,0,0
1788.745,17,82,3438,81,14,22359,14,3402,1,8,0,8,36
0.336,6,23,7291,11,257,33,748,1635,12,837,30,1408,5656
0.999,17,4,300,2,39,998,39,134,2,55,998,55,166
58.341,17,4,352,2,60,58340,60,176,2,60,58340,60,176
0.005,6,2,92,1,0,0,0,40,1,0,0,0,52
1740.457,1,57,4788,57,56,31079,56,4788,0,0,0,0,0
437.999,6,77,19966,39,325,11526,1360,10051,38,335,11833,1360,9915
2.055,17,4,580,2,40,2033,40,136,2,194,2004,194,444
744.735,17,84,7033,78,30,9671,37,4545,6,386,136590,463,2488
300.009,17,4,1344,4,308,100003,308,1344,0,0,0,0,0
1743.425,6,95,7203,63,38,28119,205,4476,32,33,56232,98,2727
1792.335,1,58,4872,58,56,31444,56,4872,0,0,0,0,0
1780.657,1,342,28728,342,56,5221,56,28728,0,0,0,0,0
1788.97,17,87,3648,86,14,21046,14,3612,1,8,0,8,36
0.108,17,2,304,1,60,0,60,88,1,188,0,188,216
22.249,17,4,240,2,32,22248,32,120,2,32,22248,32,120
0.583,6,25,7380,12,257,52,748,1663,13,837,48,1408,5717
1786.468,6,126,9948,78,66,23200,66,5628,48,60,38008,60,4320
0.04,6,11,911,6,181,8,181,489,5,77,9,133,422
173.323,17,2,2187,2,1065,173323,1444,2187,0,0,0,0,0
240.279,6,54,18331,29,784,8581,1402,15641,25,172,10011,580,2690
1795.195,17,448,39896,403,35,4465,288,25676,45,288,40023,288,14220
1.323,6,49,18614,27,846,50,1360,12958,22,476,54,2715,5656
125.146,17,4,288,2,36,125121,36,128,2,52,125121,52,160
334.887,6,361,300703,234,1314,1437,1408,279033,127,579,2279,2439,21670
74.609,6,10,576,2,0,34480,0,112,8,0,10657,0,464
1799.991,6,216,18624,79,75,22692,339,8249,137,69,13234,1062,10375
1782.555,6,416,24920,208,69,8611,69,12460,208,34,8611,48,12460
1782.326,6,196,45558,114,491,15772,1285,31577,82,187,22002,1420,13981
15.859,6,2591,2478595,1627,1442,9,1448,2421843,964,776,15,1448,56752
1022.7,2,12,384,12,8,92972,8,384,0,0,0,0,0
15.189,6,10,728,3,92,7484,92,256,7,92,2501,92,472
1673.855,1,8,448,8,28,239122,28,448,0,0,0,0,0
1792.26,17,87,3648,86,14,21085,14,3612,1,8,0,8,36
0.281,17,2,685,1,308,0,308,336,1,321,0,321,349
0.991,17,3,196,2,32,952,32,120,1,48,0,48,76
1797.344,6,370,25908,215,98,8398,469,15223,155,69,11670,69,10685
7.228,6,1438,1170917,766,1428,9,1448,1123897,672,776,10,1448,47020
2.119,17,4,314,2,31,2103,31,118,2,70,2103,70,196
1.21,6,24,8004,12,164,93,267,1288,12,1014,93,2804,6716
1636.052,1,8,448,8,28,233721,28,448,0,0,0,0,0
0.227,17,8,2750,8,315,32,354,2750,0,0,0,0,0
240.195,6,53,17639,28,779,8895,1418,14714,25,202,10007,580,2925
0.477,6,10,1840,5,901,119,901,1169,5,403,119,403,671
1791.697,6,356,22520,208,69,8655,69,12460,148,69,12187,69,10060
6.1,6,46,8449,22,227,290,314,4062,24,427,253,1152,4387
146.068,17,4,1344,4,308,48689,308,1344,0,0,0,0,0
18.764,6,2899,2718886,1880,1369,9,1408,2661222,1019,931,18,2816,57664
22.269,6,9,520,3,0,11134,0,160,6,0,3423,0,360
1774.929,17,140,11200,70,48,25723,48,5320,70,56,25723,56,5880
1790.495,6,356,22520,208,69,8649,69,12460,148,69,12178,69,10060
8.864,6,40,9334,20,448,466,739,2650,20,419,455,1360,6684
280.036,6,27,7312,13,158,23336,267,1317,14,775,21538,2800,5995
27.995,17,4,332,2,41,27949,45,138,2,69,27876,77,194
4.099,17,3,186,3,34,2049,34,186,0,0,0,0,0
1254.039,6,96,10366,55,75,23222,722,4905,41,107,31335,1408,5461
1786.785,6,359,22778,208,69,8631,69,12529,151,69,11911,69,10249
1751.536,17,210,46049,210,191,8380,371,46049,0,0,0,0,0
0.377,17,2,144,1,36,0,36,64,1,52,0,52,80
0.179,1,2,112,2,28,179,28,112,0,0,0,0,0
13.965,6,21,6825,12,275,1269,275,1038,9,1353,1118,1440,5787
601.631,2,6,192,6,8,120326,8,192,0,0,0,0,0
1791.513,1,65,5460,0,0,0,0,0,65,56,27992,56,5460
0.787,6,10,1687,7,100,131,100,384,3,1179,266,1179,1303
1794.082,1,58,4872,58,56,31475,56,4872,0,0,0,0,0
5.008,17,4,558,2,36,5000,36,128,2,187,5003,187,430
1795.983,17,449,39928,404,35,4456,288,25708,45,288,40020,288,14220
1785.937,6,102,8296,68,65,26655,65,4930,34,59,54116,59,3366
300.755,2,3,96,3,8,150377,8,96,0,0,0,0,0
9.426,6,21,7942,11,275,942,275,723,10,1134,914,1440,7219
1785.893,6,365,23087,211,69,8504,69,12787,154,69,11672,69,10300
60.078,17,11,11915,11,1055,6007,1060,11915,0,0,0,0,0
1763.698,2,16,512,16,8,117579,8,512,0,0,0,0,0
0.783,6,20,5948,11,281,78,544,1288,9,716,88,1420,4660
1710.444,17,12,498,11,14,171044,14,462,1,8,0,8,36
2.809,17,4,624,4,128,936,128,624,0,0,0,0,0
240.363,6,40,8967,17,315,15022,1002,3100,23,518,10925,1691,5867
369.899,6,25,1651,17,177,23118,177,1117,8,110,9822,110,534
1786.758,1,194,10864,194,28,9257,28,10864,0,0,0,0,0
0.032,17,4,284,2,32,25,32,120,2,54,24,60,164
304.833,1,12,1008,12,56,27712,56,1008,0,0,0,0,0
1118.684,17,220,16720,220,48,5108,48,16720,0,0,0,0,0
0.488,6,3,120,1,0,0,0,40,2,0,488,0,80
12.436,6,2407,2264784,1557,1377,7,1408,2215920,850,931,14,2816,48864
1785.214,6,420,25149,210,69,8541,69,12540,210,34,8541,64,12609
317.026,6,38,11481,22,267,15096,1305,3316,16,751,21126,4649,8165
1787.908,6,367,23236,212,69,8473,69,12896,155,69,11609,69,10340
1782.482,6,102,8296,68,65,26604,65,4930,34,59,54011,59,3366
0.241,6,21,4415,12,165,21,456,1446,9,415,28,888,2969
112.267,6,21,8197,11,512,92,1197,2008,10,1155,12455,3151,6189
0.217,1,5,420,5,56,54,56,420,0,0,0,0,0
0.05,17,2,219,1,50,0,50,78,1,113,0,113,141
285.791,6,23,1621,12,330,25980,330,962,11,83,28578,83,659
1797.144,1,280,15680,280,28,6441,28,15680,0,0,0,0,0
1.406,6,42,10077,23,440,63,1360,4496,19,480,67,4075,5581
630.462,2,5,160,5,8,157615,8,160,0,0,0,0,0
4.205,6,23,6481,10,268,462,517,1333,13,744,346,1418,5148
1.625,17,5,716,3,64,803,64,276,2,192,930,192,440
3.173,17,5,295,5,31,793,31,295,0,0,0,0,0
30.341,6,31,7682,12,155,2758,267,1266,19,376,1685,3417,6416
188.94,6,11,766,4,106,62980,106,274,7,90,31464,90,492
1787.228,6,102,8364,68,66,26675,66,4964,34,60,54153,60,3400
41.782,17,4,352,2,48,41773,48,152,2,72,41771,72,200
366.475,6,27,1767,18,177,21557,177,1181,9,110,8526,110,586
137.774,17,2,908,2,426,137774,687,908,0,0,0,0,0
144.1,6,226,170594,128,940,70,1360,15196,98,1664,1483,5440,155398
7.393,17,25,10722,12,587,671,1350,7388,13,228,612,1350,3334
10.179,6,88,26733,45,550,231,1152,20531,43,447,235,1179,6202
38.029,17,11,836,11,48,3802,48,836,0,0,0,0,0
1787.001,6,106,8388,68,64,26671,64,4896,38,58,48293,58,3492
300.35,6,27,8640,14,413,23103,1098,2402,13,694,2898,1503,6238
4.982,17,4,288,2,36,4966,36,128,2,52,4974,52,160
0.58,1,2,112,2,28,580,28,112,0,0,0,0,0
10.918,6,16,3911,9,275,1364,275,643,7,992,991,1440,3268
0.182,1,2,112,2,28,182,28,112,0,0,0,0,0
1786.653,6,106,8524,68,66,26666,66,4964,38,60,48285,60,3560
240.182,6,54,17900,29,798,8577,1418,15088,25,188,10007,580,2812
287.774,6,35,3537,17,324,17985,585,1589,18,169,16927,580,1948
1753.579,17,368,123648,368,308,4778,308,123648,0,0,0,0,0
0.119,17,2,417,1,44,0,44,72,1,317,0,317,345
35.725,17,22,1936,11,48,3565,48,836,11,72,3565,72,1100
0.078,17,4,288,2,33,0,33,122,2,55,68,61,166
1564.134,2,13,416,13,8,130344,8,416,0,0,0,0,0
0.068,17,2,154,1,33,0,33,61,1,65,0,65,93
10.502,6,12,1037,6,191,2066,259,623,6,58,2065,110,414
1797.649,17,448,39896,403,35,4471,288,25676,45,288,40020,288,14220
1285.387,17,98,7824,51,48,25707,48,3876,47,56,25721,56,3948
1773.024,6,180,15480,120,69,14899,69,8940,60,69,30048,69,6540
1786.892,6,104,8376,68,65,26670,65,4930,36,59,51051,59,3446
1798.042,1,58,4872,0,0,0,0,0,58,56,31544,56,4872
0.048,1,3,180,3,32,24,32,180,0,0,0,0,0
0.553,6,22,7368,13,337,46,674,2032,9,1212,62,1946,5336
15.147,6,5,752,3,46,7573,46,166,2,506,14967,506,586
27.264,17,24,13142,10,596,3025,1350,6245,14,464,2094,1350,6897
1786.313,17,140,11200,70,48,25888,48,5320,70,56,25888,56,5880
1794.668,6,355,22480,207,69,8711,69,12420,148,69,12208,69,10060
7.109,6,67,20534,34,554,215,1152,15771,33,491,214,1179,4763
0.046,17,2,384,1,39,0,39,67,1,289,0,289,317
1722.132,17,112,37600,112,307,15514,308,37600,0,0,0,0,0
2.839,17,6,462,3,33,1419,33,183,3,65,1418,65,279
3.011,17,7,552,4,34,1000,34,248,3,73,1500,84,304
15.983,6,2690,2598681,1797,1371,8,1408,2547581,893,931,17,2801,51100
98.23,17,4,352,2,60,98229,60,176,2,60,98229,60,176
1773.424,6,180,15480,120,69,14902,69,8940,60,69,30055,69,6540
1786.049,17,142,11360,71,48,25514,48,5396,71,56,25514,56,5964
1.099,6,28,8472,15,222,67,540,1976,13,994,76,1791,6496
0.853,6,24,6624,13,340,71,1045,2227,11,988,84,1731,4397
1.28,6,10,947,5,304,320,304,580,5,83,315,83,367
0.145,6,10,766,5,185,34,185,453,5,45,35,45,313
1790.618,17,81,3396,80,14,22666,14,3360,1,8,0,8,36
1786.508,6,104,8308,68,64,26664,64,4896,36,58,51040,58,3412
1.571,6,29,10365,17,367,98,833,1785,12,1012,134,1420,8580
72.637,6,13,1028,4,226,167,226,442,9,110,9048,110,586
369.552,6,18,1242,14,180,28427,180,916,4,110,20065,110,326
0.272,1,2,112,2,28,272,28,112,0,0,0,0,0
107.825,17,10,13726,10,1344,11980,1347,13726,0,0,0,0,0
0.511,17,2,384,1,39,0,39,67,1,289,0,289,317
1775.254,6,180,15480,120,69,14918,69,8940,60,69,30081,69,6540
15.463,6,6,264,1,0,0,0,44,5,0,3841,0,220
0.04,17,8,2750,8,315,5,354,2750,0,0,0,0,0
1682.629,17,14,1036,7,30,280428,30,406,7,62,280430,62,630
4.75,6,39,7269,21,218,237,314,3463,18,513,263,1179,3806
0.377,6,7,295,4,0,125,0,164,3,7,94,7,131
0.279,6,25,6098,12,181,25,537,1526,13,555,22,1448,4572
1787.905,6,449,27023,223,69,8053,69,13267,226,35,7946,48,13756
1618.878,1,7,392,7,28,269813,28,392,0,0,0,0,0
63.16,6,7,420,7,0,0,0,420,0,0,0,0,0
1779.839,17,142,11360,71,48,25426,48,5396,71,56,25426,56,5964
3.603,6,14,3144,8,49,514,92,511,6,579,43,1448,2633
1.998,17,2,672,2,308,1998,308,672,0,0,0,0,0
1780.539,17,142,11360,71,48,25436,48,5396,71,56,25436,56,5964
382.362,6,18,1239,14,177,29412,177,913,4,110,20071,110,326
1767.503,1,224,12544,224,28,7926,28,12544,0,0,0,0,0
156.361,17,4,352,2,60,156360,60,176,2,60,156360,60,176
1.493,6,48,18598,26,913,59,1460,12942,22,433,61,1460,5656
0.997,6,10,1687,7,100,166,100,384,3,1179,367,1179,1303
28.2,17,32,4704,16,48,1879,48,1216,16,190,1879,308,3488
1786.553,6,102,8296,68,65,26664,65,4930,34,59,54135,59,3366
1783.785,6,104,8435,69,65,26232,65,4970,35,59,52461,59,3465
280.502,6,29,7392,13,158,23375,267,1317,16,603,18696,2076,6075
67.944,6,17,704,8,0,5283,0,328,9,0,8491,0,376
1699.482,17,12,498,11,14,169948,14,462,1,8,0,8,36
750.842,17,20,1760,10,48,83425,48,760,10,72,83425,72,1000
240.362,6,42,9146,20,523,12650,1408,5756,22,248,11445,618,3390
1778.747,6,227,22049,109,87,16469,721,10844,118,154,15200,1440,11205
300.823,6,45,12222,24,779,13079,1440,6487,21,325,753,1440,5735
148.557,17,5,380,5,48,37139,48,380,0,0,0,0,0
96.225,6,31,7746,10,141,3663,267,1255,21,331,4810,1460,6491
0.569,6,26,9039,13,266,47,705,1750,13,943,43,1438,7289
300.564,6,36,8486,20,315,15819,882,2093,16,521,562,2720,6393
1798.285,6,367,25181,214,94,8442,469,14576,153,69,11830,69,10605
1781.394,6,104,8250,68,63,26587,64,4867,36,57,50894,58,3383
1799.714,6,366,25610,213,99,8489,469,15005,153,69,11840,69,10605
0.045,17,4,284,2,32,36,32,120,2,54,39,60,164
1744.1,6,95,7203,63,38,28130,205,4476,32,33,56253,98,2727
280.443,6,32,7512,14,158,21572,267,1357,18,603,16494,2076,6155
280.336,6,29,7392,13,158,23361,267,1317,16,603,18682,1400,6075
1740.49,17,29,30624,29,1028,62160,1028,30624,0,0,0,0,0
10.159,6,16,2358,10,210,1128,210,960,6,545,2028,904,1398
44.174,17,14,7739,8,655,6310,1350,5466,6,350,3023,1350,2273
139.014,6,52,39394,32,1204,26,1360,29007,20,1196,7307,2720,10387
0.004,17,3,436,2,46,2,46,148,1,260,0,260,288
85.197,6,50,13655,19,140,3495,267,1753,31,443,2839,1420,11902
0.663,17,4,1006,2,40,653,40,136,2,407,648,407,870
20.26,6,10,1209,6,95,4052,159,502,4,499,6708,499,707
1746.122,6,97,7307,63,38,28163,205,4476,34,33,52901,98,2831
1787.259,6,104,8504,69,66,26283,66,5004,35,60,52562,60,3500
1.534,6,50,18910,27,864,59,1360,13214,23,433,52,1360,5696
1.982,17,2,152,1,48,0,48,76,1,48,0,48,76
5.451,6,39,7285,20,218,286,314,3423,19,516,288,1179,3862
16.238,17,4,3100,4,747,5412,1451,3100,0,0,0,0,0
1778.239,6,98,7421,65,38,27784,205,4611,33,33,55557,98,2810
196.945,6,27,6578,10,220,7247,516,1285,17,329,12303,1452,5293
408.977,17,51,4388,47,30,8889,37,2740,4,384,116416,463,1648
42.573,17,27,6681,16,40,2837,41,1097,11,479,4256,505,5584
1535.835,1,16,896,16,28,102389,28,896,0,0,0,0,0
4.377,17,4,240,2,32,4376,32,120,2,32,4376,32,120
573.139,1,14,784,14,28,44087,28,784,0,0,0,0,0
39.416,17,22,1672,22,48,1876,48,1672,0,0,0,0,0
7.48,6,18,2498,12,210,679,210,1100,6,545,1484,904,1398
0.18,17,2,348,1,39,0,39,67,1,253,0,253,281
20.14,6,21,5417,12,107,1830,159,1074,9,966,2516,1668,4343
0.103,17,2,245,1,32,0,32,60,1,157,0,157,185
64.496,6,34,9067,14,327,141,1189,2535,20,477,3393,1460,6532
1746.071,6,95,7203,63,38,28162,205,4476,32,33,56312,98,2727
1.367,6,49,19694,27,923,52,1460,14038,22,433,56,1460,5656
0.0,1,1,326,1,298,0,298,326,0,0,0,0,0
0.012,6,9,1930,5,666,2,666,934,4,780,4,780,996
0.952,6,23,4980,13,227,79,549,1810,10,528,96,1448,3170
0.783,6,22,5442,12,125,70,212,986,10,675,85,1420,4456
1792.53,6,385,29799,220,75,8185,267,13886,165,138,10929,4837,15913
16.264,17,16,5001,7,359,2705,1350,2715,9,226,2029,1350,2286
0.121,17,2,176,1,48,0,48,76,1,72,0,72,100
122.307,6,22,9613,12,386,63,844,1672,10,1505,13574,3117,7941
5.294,17,28,20488,13,619,441,1350,8413,15,777,168,1350,12075
0.372,17,2,152,1,48,0,48,76,1,48,0,48,76
0.792,6,20,5950,11,282,79,546,1290,9,716,89,1420,4660
1778.389,17,73,3060,72,14,25047,14,3024,1,8,0,8,36
1783.833,6,354,22440,205,69,8744,69,12271,149,69,12052,69,10169
280.48,6,29,7392,13,158,23373,267,1317,16,775,18693,4836,6075
1738.84,6,134,8632,75,50,23497,208,5280,59,31,29976,31,3352
1796.855,1,342,28728,342,56,5269,56,28728,0,0,0,0,0
40.924,6,53,16996,24,960,1117,1360,10607,29,273,1455,2667,6389
1787.312,6,102,8364,68,66,26676,66,4964,34,60,54157,60,3400
71.386,6,9270,8695164,6056,1356,11,1402,8523372,3214,776,22,1405,171792
1793.764,6,243,36050,151,302,11958,302,26274,92,83,19711,83,9776
1740.664,17,30,7050,30,207,60022,207,7050,0,0,0,0,0
4.458,17,24,12358,10,403,495,1350,4318,14,546,222,1350,8040
126.313,17,4,352,2,60,126312,60,176,2,60,126312,60,176
0.247,6,24,6064,12,181,22,537,1526,12,781,21,2224,4538
240.185,6,55,17930,30,752,8282,1402,15119,25,187,10007,580,2811
1794.21,6,354,22302,207,69,8709,69,12351,147,69,12245,69,9951
0.602,17,2,136,1,32,0,32,60,1,48,0,48,76
0.099,6,11,913,6,182,19,182,490,5,77,23,134,423
1798.49,17,449,39928,404,35,4462,288,25708,45,288,40021,288,14220
24.721,6,21,4515,9,341,3090,722,1488,12,299,2226,1408,3027
1681.542,17,14,1036,7,30,280255,30,406,7,62,280255,62,630
3.22,6,5,232,2,0,3220,0,88,3,0,1523,0,144
1297.561,6,264,16882,149,70,8767,138,9065,115,67,11382,69,7817
1.487,17,19,6738,8,375,212,1350,3228,11,291,80,1350,3510
66.08,6,27,7177,13,155,5506,267,1306,14,530,5082,3417,5871
240.199,6,55,18458,29,819,8578,1418,15450,26,206,9607,580,3008
2.016,17,2,778,2,361,2016,361,778,0,0,0,0,0
280.417,6,29,7392,13,158,23368,267,1317,16,603,18692,2076,6075
0.003,6,4,3048,1,0,0,0,40,3,1444,1,1460,3008
0.416,6,14,1733,7,288,65,288,588,7,284,36,434,1145
0.007,17,2,428,1,64,0,64,92,1,308,0,308,336
0.057,17,4,420,2,33,12,33,122,2,121,46,145,298
5.007,17,4,514,2,36,5002,36,128,2,165,5002,187,386
111.295,6,63,13938,27,351,2428,1189,6007,36,270,3179,1420,7931
1401.215,17,14,3692,7,31,233522,37,413,7,440,233533,463,3279
2.911,17,3,468,3,128,1455,128,468,0,0,0,0,0
1787.844,17,142,11360,71,48,25540,48,5396,71,56,25539,56,5964
222.08,1,3,346,3,87,111040,93,346,0,0,0,0,0
330.23,6,897,764383,572,1332,578,1360,742459,325,189,117,2667,21924
0.067,6,2,87,1,0,0,0,40,1,7,0,7,47
3.897,17,5,295,5,31,974,31,295,0,0,0,0,0
1.027,17,5,952,3,32,510,32,180,2,358,6,470,772
1.62,6,48,19322,27,899,62,1360,13706,21,433,69,1360,5616
5.051,17,4,288,2,36,4997,36,128,2,52,5004,52,160
1773.394,6,180,15480,120,69,14902,69,8940,60,69,30052,69,6540
240.222,6,54,18074,29,804,8579,1408,15190,25,197,10009,580,2884
1791.76,6,158,9663,82,44,22120,208,5631,76,31,23885,31,4032
138.684,6,22,9860,11,433,71,990,1771,11,1091,13855,1460,8089
0.145,17,2,362,1,32,0,32,60,1,274,0,274,302
6.251,6,35,7056,17,231,375,314,3234,18,516,353,1179,3822
0.438,6,7,716,4,226,146,226,442,3,110,121,110,274
5.471,17,40,11505,20,246,285,1350,5490,20,272,285,1350,6015
0.983,6,2,120,2,0,0,0,120,0,0,0,0,0
236.934,17,4,352,2,60,236933,60,176,2,60,236933,60,176
0.233,6,48,21521,27,1095,8,1420,16451,21,421,11,1883,5070
1798.98,2,28,896,28,8,66628,8,896,0,0,0,0,0
55.191,17,2,72,1,8,0,8,36,1,8,0,8,36
115.142,6,22,9860,11,433,70,990,1771,11,1091,11500,1460,8089
2.926,17,4,304,2,48,2904,48,152,2,48,2905,48,152
1770.114,6,99,9240,66,65,27232,65,5577,33,59,55313,59,3663
1.147,6,12,3671,6,125,226,125,445,6,968,228,1448,3226
100.803,6,112,80822,70,1238,1460,1368,70510,42,676,2158,1368,10312
2.801,6,3,144,2,0,2801,0,92,1,0,0,0,52
1745.765,6,95,7203,63,38,28157,205,4476,32,33,56302,98,2727
1772.188,6,180,15480,120,69,14892,69,8940,60,69,30034,69,6540
5.518,6,42,7405,22,201,262,314,3503,20,516,276,1179,3902
10.079,6,83,24877,41,561,251,1152,19056,42,413,239,1152,5821
1773.165,6,182,15629,121,69,14776,69,8980,61,69,29551,69,6649
24.009,6,2581,2465270,948,336,25,337,55621,1633,1433,14,2876,2409649
1794.424,6,359,22709,209,69,8627,69,12569,150,69,12043,69,10140
7.911,6,14,2570,9,275,988,275,918,5,1440,1466,1440,1652
15.246,6,13,5593,4,106,5078,106,274,9,988,1904,1997,5319
6.764,6,32,7584,13,155,563,267,1306,19,367,375,1420,6278
0.053,6,2,133,1,0,0,0,40,1,53,0,53,93
0.011,17,2,467,1,41,0,41,69,1,370,0,370,398
61.661,6,40,8718,19,401,848,888,2031,21,389,3076,2128,6687
1782.155,6,366,25541,213,100,8406,469,14936,153,69,11722,69,10605
5.211,6,32,8317,17,520,325,1418,5577,15,244,369,638,2740
149.351,6,123,20235,66,304,2297,304,14700,57,83,2636,83,5535
137.93,6,33,26087,17,745,40,1360,3706,16,2172,9187,5440,22381
13.368,6,24,4603,12,205,1173,722,1657,12,579,1198,1448,2946
1772.216,6,180,15480,120,69,14892,69,8940,60,69,30034,69,6540
26.869,6,23,6180,14,117,2066,159,1337,9,873,3357,1675,4843
127.855,6,18,4087,8,407,18265,722,1238,10,387,14159,1448,2849
240.614,6,59,20427,31,827,8018,1418,17342,28,202,8907,580,3085
1789.936,6,4983,4118429,2295,127,780,335,132347,2688,1467,666,4224,3986082
1.213,17,6,1377,3,40,600,40,204,3,363,601,363,1173
23.136,6,31,8017,15,188,1652,721,1924,16,778,1530,2840,6093
0.166,6,46,22065,27,1065,6,1420,17084,19,467,8,1883,4981
2.353,6,14,2351,8,188,336,245,700,6,703,420,1152,1651
3.475,6,11,1727,7,100,579,100,384,4,1179,1079,1179,1343
0.014,6,10,1853,5,127,3,127,395,5,1190,3,1190,1458
1749.532,17,12,498,11,14,174953,14,462,1,8,0,8,36
1731.611,1,52,2912,52,28,33953,28,2912,0,0,0,0,0
2.565,6,28,6205,14,108,197,147,999,14,773,164,1608,5206
280.228,6,29,7392,13,158,23352,267,1317,16,603,18680,1400,6075
1796.309,17,770,46424,770,32,2335,37,46424,0,0,0,0,0
106.689,6,41,17292,24,690,116,1360,7218,17,938,6659,3729,10074
10.928,6,20,4442,10,275,1214,275,958,10,768,1184,1440,3484
280.221,6,28,7352,12,158,25474,267,1277,16,603,18677,1400,6075
1684.477,2,17,544,17,8,105279,8,544,0,0,0,0,0
280.035,17,4,352,2,60,280034,60,176,2,60,280033,60,176
10.143,6,25,5997,14,232,779,517,1898,11,502,1013,1408,4099
1788.259,6,365,23087,211,69,8515,69,12787,154,69,11685,69,10300
0.024,6,2,149,1,0,0,0,40,1,69,0,69,109
17.581,17,13,6699,7,613,2918,1350,4488,6,340,3502,1350,2211
1787.366,6,108,8654,70,65,25903,65,5010,38,59,48304,59,3644
1680.797,17,12,498,11,14,168079,14,462,1,8,0,8,36
576.006,6,8,2356,8,254,82286,301,2356,0,0,0,0,0
1786.976,6,102,8364,68,66,26671,66,4964,34,60,54147,60,3400
1797.543,17,449,39928,404,35,4460,288,25708,45,288,40019,288,14220
285.917,17,4,352,2,60,285916,60,176,2,60,285915,60,176
1680.61,17,12,498,11,14,168061,14,462,1,8,0,8,36
1776.331,17,73,3060,72,14,25018,14,3024,1,8,0,8,36
0.024,17,2,495,1,39,0,39,67,1,400,0,400,428
0.185,6,3,2595,2,1237,1,1360,2555,1,0,0,0,40
2.342,17,4,610,3,39,913,39,201,1,381,0,381,409
1791.77,6,365,23087,211,69,8532,69,12787,154,69,11710,69,10300
10.771,6,20,4442,11,275,1077,275,998,9,768,781,1440,3444
1796.816,6,243,24963,99,67,18333,594,9241,144,138,12564,4658,15722
1700.491,17,12,498,11,14,170049,14,462,1,8,0,8,36
1789.867,1,251,14056,251,28,7159,28,14056,0,0,0,0,0
270.946,1,2,112,2,28,270946,28,112,0,0,0,0,0
10.843,6,18,5610,10,275,1204,275,958,8,1440,833,1440,4652
0.068,17,3,233,2,39,39,39,134,1,71,0,71,99
200.041,17,4,352,2,60,200040,60,176,2,60,200040,60,176
2.561,17,21,14080,12,924,231,1350,11434,9,266,314,1350,2646
1742.158,6,104,7550,66,31,26802,31,4503,38,31,47085,31,3047
286.121,17,4,352,2,60,286119,60,176,2,60,286120,60,176
1.118,6,10,968,5,256,277,256,460,5,304,277,304,508
0.041,6,3,120,2,0,41,0,80,1,0,0,0,40
15.617,17,16,6604,8,484,2220,1350,4097,8,285,2218,1350,2507
280.23,6,27,7312,12,158,25475,267,1277,15,678,20011,2045,6035
0.005,17,2,369,1,34,0,34,62,1,279,0,279,307
11.667,6,21,6825,12,275,1060,275,1038,9,1353,820,1440,5787
1797.429,17,342,25992,342,48,5271,48,25992,0,0,0,0,0
1.056,17,4,314,2,31,1007,31,118,2,70,1022,70,196
0.273,6,36,19963,16,173,18,319,1532,20,1241,13,1438,18431
1789.53,17,142,11360,71,48,25564,48,5396,71,56,25564,56,5964
10.373,17,4,3100,4,747,3457,1451,3100,0,0,0,0,0
1797.177,17,447,39580,403,35,4470,288,25676,44,288,40953,288,13904
5.544,6,40,7309,21,218,277,314,3463,19,513,294,1179,3846
279.314,17,16,5312,16,304,18620,308,5312,0,0,0,0,0
1796.598,17,448,39896,403,35,4469,288,25676,45,288,40021,288,14220
100.481,17,4,1344,4,308,33493,308,1344,0,0,0,0,0
10.769,6,20,4402,11,275,1076,275,998,9,758,751,1420,3404
1751.257,6,186,11385,93,47,19035,208,6766,93,31,19029,31,4619
0.031,17,3,244,2,32,1,32,120,1,96,0,96,124
1.904,6,30,22447,19,222,105,517,1920,11,3324,189,8412,20527
0.017,17,4,809,2,33,1,33,122,2,315,6,327,687
14.615,6,13,892,0,0,0,0,0,13,24,1217,24,892
240.274,6,38,7466,19,134,13346,305,1803,19,583,13345,2381,5663
1771.692,6,280,33757,113,141,15817,1460,16589,167,126,10672,1460,17168
5.006,6,39,7269,20,218,263,314,3423,19,513,263,1179,3846
1790.523,17,29,9512,29,300,63947,300,9512,0,0,0,0,0
13.164,17,4,352,2,48,13140,48,152,2,72,13140,72,200
704.813,17,23,7898,23,315,32036,548,7898,0,0,0,0,0
144.362,6,52,9292,25,344,1527,685,2228,27,298,5546,1360,7064
95.464,6,946,468330,516,843,185,1152,445657,430,390,221,1152,22673
20.248,6,36,8455,17,410,551,882,1942,19,441,1117,1440,6513
0.319,17,2,172,1,50,0,50,78,1,66,0,66,94
1759.193,6,4209,3984905,1469,148,1198,923,87857,2740,1407,642,2836,3897048
3.657,17,5,290,5,30,914,30,290,0,0,0,0,0
0.164,6,24,7176,12,155,14,267,1261,12,775,13,3445,5915
0.0,17,1,1479,1,1451,0,1451,1479,0,0,0,0,0
20.143,6,21,5577,12,115,1831,159,1221,9,773,2516,1402,4356
620.631,17,12,4032,12,308,56421,308,4032,0,0,0,0,0
1794.518,17,68,2847,66,13,27605,14,2767,2,12,1794280,16,80
1561.275,6,327,20481,169,69,9293,69,10210,158,48,9944,69,10271
4.511,6,38,7229,18,218,265,314,3343,20,513,224,1179,3886
11.851,6,25,8473,13,275,987,275,1078,12,986,860,1440,7395
1796.118,17,342,109418,342,291,5267,422,109418,0,0,0,0,0
504.364,2,4,128,4,8,168121,8,128,0,0,0,0,0
1.689,6,12,1163,6,222,336,222,688,6,231,336,231,475
0.367,6,12,1653,6,288,69,288,548,6,426,41,434,1105
0.104,17,6,1296,3,64,49,64,276,3,312,49,312,1020
1.291,6,48,18794,26,928,51,1460,13138,22,433,52,1460,5656
1788.701,17,83,3480,82,14,22082,14,3444,1,8,0,8,36
755.792,2,5,160,5,8,188948,8,160,0,0,0,0,0
18.894,6,2733,2507970,1743,1360,10,1408,2451826,990,931,18,2801,56144
1797.774,17,448,39896,403,35,4472,288,25676,45,288,40016,288,14220
1741.407,6,89,6457,59,31,30024,31,3998,30,31,60047,31,2459
1786.81,6,117,13832,75,81,24146,506,5955,42,162,43578,1452,7877
244.77,6,60,7791,27,210,9414,585,3773,33,152,7648,580,4018
284.346,6,36,8354,16,158,18956,267,1437,20,555,14965,2036,6917
1.393,6,41,8431,21,321,69,1164,2810,20,400,64,1360,5621
0.469,6,10,968,5,256,106,256,460,5,304,102,304,508
4.002,17,4,248,4,34,1334,34,248,0,0,0,0,0
0.153,6,10,1378,5,145,38,145,349,5,825,31,825,1029
0.241,17,2,544,1,39,0,39,67,1,449,0,449,477
378.081,2,3,96,3,8,189040,8,96,0,0,0,0,0
1793.658,17,66,2766,65,14,28025,14,2730,1,8,0,8,36
1791.044,1,220,12320,220,28,8178,28,12320,0,0,0,0,0
63.257,17,44,3344,22,48,3000,48,1672,22,48,3000,48,1672
69.086,6,26,7137,12,155,6280,267,1266,14,530,5313,2006,5871
1793.737,6,278,33838,114,144,15872,1460,16744,164,126,11003,1642,17094
1793.695,17,144,11520,72,48,25263,48,5472,72,56,25263,56,6048
10.849,6,2228,2089027,1433,1380,7,1408,2043023,795,776,13,1408,46004
1542.356,6,117,11764,66,67,23728,721,5610,51,87,29237,1448,6154
280.477,6,30,7432,13,158,23373,267,1317,17,603,17526,2076,6115
281.298,6,32,7650,13,158,23441,267,1317,19,464,15603,1400,6333
1.304,6,52,22284,29,962,46,1440,16588,23,433,50,1440,5696
376.059,6,18,1242,14,180,28927,180,916,4,110,20074,110,326
754.462,6,48,3736,31,48,25148,205,2285,17,35,47139,98,1451
299.123,1,4,224,4,28,99707,28,224,0,0,0,0,0
965.276,17,660,46307,597,40,1619,41,40984,63,56,638,57,5323
0.365,6,13,1096,7,256,59,256,544,6,304,70,304,552
1782.943,1,58,4872,0,0,0,0,0,58,56,31279,56,4872
0.163,1,2,112,2,28,163,28,112,0,0,0,0,0
263.218,6,612,483180,283,1108,483,1460,43534,329,1380,802,1594,439646
84.962,17,4,352,2,60,84961,60,176,2,60,84961,60,176
1784.942,6,283,37243,113,152,15935,1360,17804,170,145,10560,2720,19439
98.557,1,12,672,12,28,8959,28,672,0,0,0,0,0
1799.895,17,448,39896,403,35,4477,288,25676,45,288,40016,288,14220
1.66,6,11,1727,7,100,276,100,384,4,589,465,1152,1343
58.147,2,4,160,4,16,19382,16,160,0,0,0,0,0
0.496,17,3,451,2,39,481,39,134,1,289,0,289,317
175.114,17,4,352,2,60,175113,60,176,2,60,175113,60,176
0.405,6,105,87256,60,131,6,232,2929,45,2063,9,5411,84327
0.267,17,3,451,2,39,106,39,134,1,289,0,289,317
999.305,17,195,14820,195,48,5151,48,14820,0,0,0,0,0
0.002,6,2,1151,1,0,0,0,40,1,1059,0,1059,1111
415.306,6,41,6146,25,125,17304,501,2260,16,269,27669,1420,3886
13.42,6,2295,2150178,1439,1414,9,1448,2100990,856,776,15,1448,49188
893.814,6,150,17914,80,132,11314,1189,7305,70,216,8992,1460,10609
1.66,6,13,2311,8,188,237,245,700,5,1407,352,1407,1611
148.548,6,52,6959,22,145,2414,722,2610,30,154,5116,1408,4349
1786.266,6,104,8376,68,65,26660,65,4930,36,59,51033,59,3446
0.169,1,6,624,0,0,0,0,0,6,76,33,76,624
1.395,6,24,8004,12,164,108,267,1288,12,1014,106,2331,6716
0.391,6,10,968,5,256,95,256,460,5,304,95,304,508
9.093,6,2145,2022092,1384,1384,6,1408,1977856,761,931,11,2816,44236
120.217,2,2,64,2,8,120217,8,64,0,0,0,0,0
1745.434,1,56,4704,0,0,0,0,0,56,56,31735,56,4704
0.023,17,2,150,1,39,0,39,67,1,55,0,55,83
1797.192,1,272,15232,272,28,6631,28,15232,0,0,0,0,0
367.02,6,18,1242,14,180,28232,180,916,4,110,20064,110,326
49.678,6,26,7137,12,155,4516,267,1266,14,530,3820,2006,5871
0.093,17,2,152,1,48,0,48,76,1,48,0,48,76
382.236,6,35,3779,22,141,18201,141,1266,13,492,2498,775,2513
0.335,17,7,2438,7,320,55,354,2438,0,0,0,0,0
139.22,6,20,8239,11,525,97,1237,2048,9,1163,17377,2720,6191
240.179,6,54,18302,29,806,8577,1402,15229,25,220,10007,580,3073
0.903,6,57,29398,33,1141,28,1380,24172,24,421,37,1923,5226
1799.346,1,156,16536,156,78,11608,78,16536,0,0,0,0,0
4.713,6,39,7269,19,218,261,314,3383,20,513,234,1179,3886
0.024,17,2,235,1,36,0,36,64,1,143,0,143,171
579.631,17,10,957,10,67,64403,73,957,0,0,0,0,0
151.123,6,221,36800,125,304,1218,304,26936,96,83,1590,83,9864
0.098,6,12,3705,6,171,7,171,491,6,964,18,1448,3214
5.98,6,49,29734,27,856,230,1360,10570,22,1405,276,2720,19164
1780.913,17,142,11360,71,48,25440,48,5396,71,56,25440,56,5964
356.68,6,17,1190,13,180,29723,180,864,4,110,20087,110,326
1783.426,17,142,11360,71,48,25476,48,5396,71,56,25476,56,5964
1793.911,17,144,11520,72,48,25266,48,5472,72,56,25266,56,6048
7.765,6,16,1310,10,275,862,275,958,6,96,1182,96,352
0.0,6,2,92,0,0,0,0,0,2,0,0,0,92
0.534,6,14,1745,7,288,62,288,600,7,426,60,434,1145
20.057,6,14,2185,8,324,2865,585,1073,6,396,4000,580,1112
16.357,17,20,2940,10,48,1815,48,760,10,190,1815,308,2180
0.06,17,2,190,1,59,0,59,87,1,75,0,75,103
280.433,6,28,7352,12,158,25493,267,1277,16,678,18691,2760,6075
0.044,1,2,112,2,28,44,28,112,0,0,0,0,0
1786.328,6,115,9196,73,66,24810,66,5296,42,60,43566,60,3900
14.042,6,949,857007,603,1348,22,1368,833727,346,776,40,2736,23280
295.335,17,4,1383,1,308,0,308,336,3,321,147167,321,1047
1783.174,17,83,3480,82,14,22014,14,3444,1,8,0,8,36
77.895,6,80,58989,53,1202,1497,1368,50850,27,961,2378,3887,8139
1.85,6,27,8849,16,286,123,590,1502,11,862,164,1380,7347
1795.447,17,447,39864,402,35,4477,288,25644,45,288,40015,288,14220
280.354,6,30,7432,13,158,23362,267,1317,17,543,17515,1400,6115
9.45,17,23,12730,10,692,1050,1350,7202,13,397,784,1350,5528
1785.655,6,102,8364,68,66,26651,66,4964,34,60,54108,60,3400
1.16,6,29,6180,16,138,77,267,1755,13,650,84,1420,4425
0.172,17,2,279,1,36,0,36,64,1,187,0,187,215
61.839,17,6,456,6,48,12367,48,456,0,0,0,0,0
1749.211,6,94,7151,62,38,28675,205,4424,32,33,56416,98,2727
0.012,17,2,417,1,56,0,56,84,1,305,0,305,333
503.972,2,4,128,4,8,167990,8,128,0,0,0,0,0
1740.334,6,91,6604,59,31,30005,31,3998,32,31,56138,31,2606
1798.91,17,449,39928,404,35,4463,288,25708,45,288,40017,288,14220
0.344,6,20,7151,12,318,30,600,1906,8,1205,48,1891,5245
240.261,6,58,17779,27,778,9240,1408,14645,31,189,8008,580,3134
240.431,6,58,23673,26,549,9616,1418,6301,32,826,7755,1418,17372
0.765,17,4,352,2,60,764,60,176,2,60,762,60,176
17.183,17,25,9373,11,348,1714,1350,4138,14,345,1317,1350,5235
5.139,17,74,87714,72,1189,64,1472,87634,2,12,5010,12,80
135.542,6,11,614,3,0,67771,0,152,8,7,19338,7,462
1.967,17,4,694,3,32,973,32,180,1,486,0,486,514
0.959,6,24,6550,13,333,79,1004,2190,11,783,95,1420,4360
39.03,17,22,1936,11,48,3902,48,836,11,72,3902,72,1100
1799.743,6,363,25090,209,94,8652,469,14376,154,69,11763,69,10714
280.287,6,29,7392,13,158,23357,267,1317,16,543,18684,1400,6075
100.458,17,46,6880,23,48,4565,48,1748,23,195,4565,308,5132
0.13,17,2,2382,2,1163,130,1163,2382,0,0,0,0,0
0.168,6,10,1379,5,145,42,145,349,5,826,30,826,1030
255.979,6,55,10070,29,116,9142,721,3267,26,443,10230,1414,6803
240.176,6,53,17743,28,786,8895,1402,14829,25,200,10007,580,2914
2.999,17,3,186,3,34,1499,34,186,0,0,0,0,0
280.381,6,30,7432,13,158,23365,267,1317,17,543,17515,1400,6115
0.782,17,2,672,2,308,782,308,672,0,0,0,0,0
103.41,6,33,8308,17,401,1305,888,1916,16,521,6884,3488,6392
109.118,17,4,352,2,60,109117,60,176,2,60,109113,60,176
0.049,6,11,911,6,181,9,181,489,5,77,3,133,422
1.298,6,10,1671,6,552,259,948,1348,4,159,432,159,323
1773.092,6,180,15480,120,69,14899,69,8940,60,69,30049,69,6540
65.722,6,88,30581,45,681,1488,1152,24976,43,431,1558,1179,5605
0.615,17,15,5678,6,430,123,1350,2748,9,297,61,1350,2930
15.463,17,4,352,2,48,15451,48,152,2,72,15446,72,200
0.007,17,2,424,1,60,0,60,88,1,308,0,308,336
300.567,6,19,1279,6,177,60077,177,497,13,110,25032,110,782
39.675,17,42,24089,13,512,481,1350,7027,29,560,1415,1350,17062
0.958,6,27,5740,13,125,79,267,1275,14,650,67,1420,4465
37.389,6,12,849,5,88,9347,128,445,7,0,6200,0,404
0.956,6,11,3080,6,337,191,337,645,5,1083,212,1368,2435
0.02,6,14,4020,8,88,2,88,428,6,1670,3,1880,3592
366.545,17,103,9618,48,105,7766,1350,6429,55,29,6756,60,3189
0.91,6,11,1727,7,100,151,100,384,4,589,214,1152,1343
0.653,6,107,87318,52,131,12,232,2609,55,1683,11,5520,84709
0.03,17,2,154,1,33,0,33,61,1,65,0,65,93
1774.871,6,252,19845,85,55,21128,131,6081,167,54,10691,276,13764
316.942,6,99,35538,48,662,6743,1360,24469,51,300,6336,1360,11069
1787.568,6,369,25192,213,93,8431,469,14605,156,69,11531,69,10587
1787.263,6,106,8456,68,65,26675,65,4930,38,59,48301,59,3526
0.023,6,15,5964,8,88,3,88,452,7,1740,3,1880,5512
0.495,17,3,451,2,39,228,39,134,1,289,0,289,317
6.708,6,14,2658,7,164,1077,293,1104,7,635,1077,1179,1554
0.24,6,24,4571,12,165,21,456,1446,12,415,21,888,3125
2.881,17,3,183,3,33,1440,33,183,0,0,0,0,0
3.719,17,2,136,1,32,0,32,60,1,48,0,48,76
0.115,17,2,136,1,32,0,32,60,1,48,0,48,76
1401.492,17,12,888,6,30,280295,30,348,6,62,280295,62,540
1772.136,6,180,15480,120,69,14891,69,8940,60,69,30035,69,6540
0.073,6,6,462,3,222,14,222,342,3,0,31,0,120
0.231,17,2,2730,2,1337,231,1337,2730,0,0,0,0,0
1792.354,1,238,25228,238,78,7562,78,25228,0,0,0,0,0
1744.637,2,15,480,15,8,124616,8,480,0,0,0,0,0
240.864,6,48,9207,25,523,10035,1418,6022,23,219,10947,617,3185
2.954,17,8,1852,4,40,980,40,272,4,367,980,379,1580
2.877,6,17,4712,7,288,455,288,876,10,682,299,853,3836
1.308,6,38,8252,19,320,72,1162,2716,19,433,62,1360,5536
1789.811,1,294,31164,294,78,6108,78,31164,0,0,0,0,0
4.506,6,2,88,2,0,0,0,88,0,0,0,0,0
125.805,17,4,352,2,60,125804,60,176,2,60,125804,60,176
277.829,6,20,8062,3,106,1918,106,234,17,548,17363,1460,7828
0.058,6,7,423,4,43,6,43,259,3,0,28,0,164
24.838,17,4,240,2,32,24838,32,120,2,32,24837,32,120
1029.251,6,73,8933,46,94,22872,516,3914,27,171,39582,1452,5019
11.443,6,22,6817,12,275,1040,275,1038,10,1073,716,1440,5779
106.864,6,15,9513,4,133,3586,133,297,11,1460,10677,1460,9216
1793.301,1,56,4704,56,56,32605,56,4704,0,0,0,0,0
1.171,6,25,8056,12,164,90,267,1288,13,869,82,1408,6768
4.017,17,4,300,3,39,1990,39,201,1,71,0,71,99
0.265,6,23,5080,11,137,26,267,1132,12,577,22,1400,3948
70.857,6,53,8919,24,269,3080,1056,4267,29,196,2529,580,4652
1.378,6,280,200596,148,1368,9,1432,190668,132,428,9,1871,9928
300.829,6,35,10660,20,558,15833,1408,3838,15,603,616,2816,6822
0.422,17,2,128,1,28,0,28,56,1,44,0,44,72
9.855,6,37,17802,20,930,518,1360,12949,17,1026,604,2720,4853
1771.649,6,101,9410,66,66,27256,66,5610,35,60,52104,60,3800
1780.338,1,342,28728,342,56,5220,56,28728,0,0,0,0,0
72.6,6,15,1212,3,106,36300,106,234,12,90,6584,90,978
1788.743,17,87,3648,86,14,21044,14,3612,1,8,0,8,36
3.17,6,27,11061,14,185,243,275,1121,13,1345,249,1414,9940
1.63,6,49,19815,28,869,60,1360,14199,21,433,70,1360,5616
0.067,6,10,2047,6,740,13,1323,1724,4,159,21,159,323
3.517,17,10,707,5,31,871,31,295,5,54,867,70,412
410.815,6,43,2672,24,42,17857,208,1633,19,31,22814,31,1039
0.975,6,55,14490,27,549,37,1429,4992,28,464,35,1986,9498
0.021,17,3,215,2,33,1,33,122,1,65,0,65,93
366.995,6,18,1242,14,180,28230,180,916,4,110,20063,110,326
1775.084,17,139,11116,70,48,25725,48,5320,69,56,26104,56,5796
7.441,6,23,9346,13,121,620,121,829,10,1141,48,1448,8517
664.241,17,50,3984,27,48,25547,48,2052,23,56,25563,56,1932
1796.348,17,449,39928,404,35,4457,288,25708,45,288,40020,288,14220
1791.226,6,767,61343,383,47,4689,1448,29128,384,62,4676,1983,32215
1.215,6,6,328,4,0,405,0,216,2,0,1195,0,112
0.457,6,12,1653,6,288,90,288,548,6,426,50,434,1105
0.317,6,24,5980,12,164,28,453,1442,12,781,27,2224,4538
51.926,17,4,320,2,48,51918,48,152,2,56,51917,56,168
1.66,6,275,216690,162,1333,10,1420,207867,113,475,14,1883,8823
316.993,6,71,19138,38,325,8567,1360,9699,33,386,9902,4649,9439
180.942,17,4,352,2,60,180941,60,176,2,60,180940,60,176
11.006,6,20,4442,11,275,1100,275,998,9,768,763,1440,3444
120.333,2,2,64,2,8,120333,8,64,0,0,0,0,0
1776.911,6,105,8406,68,64,26521,64,4896,37,58,49356,58,3510
0.294,6,26,8991,13,247,24,624,1672,13,947,23,1438,7319
9.574,6,11,640,5,0,2393,0,280,6,0,1399,0,360
1.647,6,14,2351,8,188,235,245,700,6,703,278,1152,1651
1796.395,17,448,39896,403,35,4468,288,25676,45,288,40018,288,14220
0.054,6,3,144,2,0,54,0,92,1,0,0,0,52
0.007,17,2,386,1,59,0,59,87,1,271,0,271,299
16.681,17,6,362,3,32,8340,33,181,3,32,8340,33,181
0.32,17,2,178,1,29,0,29,57,1,93,0,93,121
21.247,6,28,6506,16,103,1416,159,1496,12,727,1926,1368,5010
1795.638,17,448,39896,403,35,4466,288,25676,45,288,40022,288,14220
3.344,6,39,14291,19,225,176,561,2229,20,937,166,1440,12062
156.819,6,35,26980,19,667,56,1360,4130,16,2018,10442,5440,22850
4.003,6,11,460,6,0,800,0,248,5,0,742,0,212
175.281,17,2,72,1,8,0,8,36,1,8,0,8,36
1798.051,17,449,39928,404,35,4461,288,25708,45,288,40021,288,14220
0.442,6,7,295,4,0,147,0,164,3,7,110,7,131
1778.314,6,119,13952,76,82,23710,519,6008,43,159,42338,1420,7944
281.078,6,56,10329,23,107,12776,267,2327,33,256,8778,1460,8002
1792.673,6,356,22520,208,69,8660,69,12460,148,69,12194,69,10060
0.134,17,2,362,1,46,0,46,74,1,260,0,260,288
1777.687,17,79,3312,78,14,23086,14,3276,1,8,0,8,36
0.021,6,14,4308,7,85,3,85,457,7,869,3,1448,3851
8.366,6,1810,1565156,1021,1438,8,1448,1511988,789,776,10,1448,53168
0.598,6,7,295,4,0,199,0,164,3,7,201,7,131
1780.648,17,73,3060,72,14,25079,14,3024,1,8,0,8,36
1740.278,6,87,6322,58,31,30531,31,3915,29,31,62150,31,2407
1798.104,17,448,39896,403,35,4472,288,25676,45,288,40020,288,14220
1763.569,2,14,448,14,8,135659,8,448,0,0,0,0,0
102.595,6,30,7432,13,158,8549,267,1317,17,543,6411,1400,6115
316.511,6,30,6672,14,189,4501,519,1513,16,376,21095,1420,5159
0.078,6,9,1148,5,145,19,145,349,4,635,22,635,799
213.957,6,42,6026,18,148,12585,722,2122,24,176,9293,1440,3904
124.847,17,4,352,2,60,124846,60,176,2,60,124846,60,176
284.694,1,4,224,4,28,94898,28,224,0,0,0,0,0
1772.076,6,180,15480,120,69,14891,69,8940,60,69,30032,69,6540
64.34,6,24,6896,6,154,12868,267,712,18,419,3764,1452,6184
1769.395,6,99,9240,66,65,27221,65,5577,33,59,55289,59,3663
0.415,6,21,5000,11,137,41,267,1132,10,866,42,2867,3868
715.889,17,8,673,4,31,238624,37,239,4,80,238624,136,434
1797.695,6,356,22520,208,69,8684,69,12460,148,69,12229,69,10060
1.579,6,52,33662,31,1192,52,1440,26665,21,842,70,1440,6997
1.28,6,48,19351,27,901,49,1360,13735,21,433,55,1360,5616
1.403,6,52,21180,28,1056,51,1380,15966,24,421,58,1923,5214
329.515,6,32,7378,20,118,17342,267,1873,12,717,17,2036,5505
1777.906,6,102,8296,68,65,26535,65,4930,34,59,53872,59,3366
0.163,6,6,897,3,483,39,483,639,3,102,43,102,258
1.168,6,11,1727,7,100,194,100,384,4,589,307,1152,1343
11.047,6,64,25168,36,843,315,1360,19191,28,480,400,4075,5977
1772.321,6,180,15480,120,69,14893,69,8940,60,69,30032,69,6540
1680.707,17,12,498,11,14,168070,14,462,1,8,0,8,36
17.348,17,26,6030,13,238,1442,1350,3466,13,169,1442,1350,2564
0.0,17,1,336,1,308,0,308,336,0,0,0,0,0
1772.855,6,180,15480,120,69,14897,69,8940,60,69,30040,69,6540
1779.891,1,76,8056,76,78,23731,78,8056,0,0,0,0,0
2.21,6,13,2311,8,188,315,245,700,5,1407,488,1407,1611
0.788,6,27,8976,14,232,60,569,1666,13,946,65,2804,7310
5.989,17,3,1008,3,308,2994,308,1008,0,0,0,0,0
3.39,17,10,1030,5,44,837,44,360,5,106,838,106,670
123.425,17,6,528,3,60,61712,60,264,3,60,61711,60,264
5.446,6,43,8329,21,227,272,314,4022,22,427,246,1152,4307
1575.44,1,8,448,8,28,225062,28,448,0,0,0,0,0
0.354,17,8,2774,8,318,50,357,2774,0,0,0,0,0
1771.503,1,8,448,8,28,253071,28,448,0,0,0,0,0
56.402,6,48,10587,24,474,446,685,3422,24,387,2446,3488,7165
0.575,6,34,24757,19,884,31,1360,6097,15,1640,31,4702,18660
10.228,6,83,24845,42,560,249,1152,19048,41,461,249,1179,5797
1798.44,17,357,56955,357,131,5051,363,56955,0,0,0,0,0
0.016,17,2,212,1,46,0,46,74,1,110,0,110,138
0.816,6,2,84,1,0,0,0,40,1,0,0,0,44
2.065,6,2,111,2,31,2065,31,111,0,0,0,0,0
1748.983,6,182,23581,95,78,18606,721,8219,87,289,20333,1420,15362
0.074,17,2,376,1,39,0,39,67,1,281,0,281,309
1750.551,17,12,498,11,14,175055,14,462,1,8,0,8,36
1798.552,17,142,11360,71,48,25693,48,5396,71,56,25693,56,5964
1741.409,17,30,31680,30,1028,60048,1028,31680,0,0,0,0,0
1.312,6,49,20152,27,956,50,1440,14496,22,433,54,1440,5656
1795.25,17,448,39896,403,35,4465,288,25676,45,288,40250,288,14220
16.602,17,15,3480,15,204,1185,204,3480,0,0,0,0,0
24.151,6,30,8872,14,158,1857,267,1357,16,763,1605,2036,7515
0.045,17,2,503,1,40,0,40,68,1,407,0,407,435
238.186,17,4,352,2,60,238185,60,176,2,60,238185,60,176
31.688,6,7,312,4,0,10562,0,168,3,0,1514,0,144
1789.392,17,87,3648,86,14,21051,14,3612,1,8,0,8,36
63.44,6,11,5498,4,106,21146,106,274,7,987,10539,1452,5224
16.018,6,25,5457,12,180,1408,722,1738,13,506,1293,1448,3719
371.089,6,27,1767,18,177,21828,177,1181,9,110,8924,110,586
0.061,6,2,99,1,0,0,0,40,1,7,0,7,59
0.017,17,4,768,2,39,9,39,134,2,289,13,289,634
0.519,17,3,451,2,39,369,39,134,1,289,0,289,317
990.516,6,61,3640,35,26,29132,26,2054,26,26,39617,26,1586
472.282,1,3,168,3,28,236141,28,168,0,0,0,0,0
31.604,6,7,336,1,0,0,0,48,6,0,6317,0,288
374.705,6,18,1242,14,180,28823,180,916,4,110,20070,110,326
0.011,17,2,128,1,36,0,36,64,1,36,0,36,64
1585.99,6,335,28128,170,77,9384,267,11387,165,123,9670,1460,16741
1786.758,6,159,25854,94,483,19212,483,19881,65,83,27917,83,5973
130.698,17,25,9725,25,361,5445,361,9725,0,0,0,0,0
1740.785,6,87,6322,58,31,30540,31,3915,29,31,62170,31,2407
1798.667,1,345,28980,345,56,5228,56,28980,0,0,0,0,0
1784.743,1,61,5124,61,56,29745,56,5124,0,0,0,0,0
486.676,6,34,2718,22,65,23175,65,1530,12,59,44235,59,1188
0.234,17,2,225,1,37,0,37,65,1,132,0,132,160
1797.038,1,259,14504,259,28,6965,28,14504,0,0,0,0,0
3.269,2,2,64,2,8,3269,8,64,0,0,0,0,0
1.404,6,48,19027,26,946,56,1460,13371,22,433,56,1460,5656
1.696,6,14,2351,8,188,242,245,700,6,703,287,1152,1651
0.036,17,4,624,2,36,0,36,128,2,220,11,292,496
1799.68,17,449,39928,404,35,4465,288,25708,45,288,40020,288,14220
1771.911,6,99,9240,66,65,27260,65,5577,33,59,55369,59,3663
240.187,6,51,17671,27,795,9237,1402,14931,24,212,10442,580,2740
0.872,6,27,5927,13,156,72,267,1462,14,650,60,1420,4465
8.8,6,84,26317,43,559,209,1152,20179,41,449,213,1179,6138
293.171,1,4,224,4,28,97723,28,224,0,0,0,0,0
10.409,6,1747,1614792,1114,1374,9,1408,1577212,633,931,16,2816,37580
4.423,6,697,607264,434,1359,10,1432,592429,263,427,16,1432,14835
4.883,6,39,7269,20,218,257,314,3423,19,513,257,1179,3846
289.783,6,210,179191,143,1300,2040,1408,164805,67,680,2633,3847,14386
1787.952,17,87,3648,86,14,21034,14,3612,1,8,0,8,36
15.098,1,20,2080,0,0,0,0,0,20,76,794,76,2080
1.253,6,11,1727,7,100,208,100,384,4,589,328,1152,1343
14.766,6,32,6238,15,237,1054,335,2744,17,401,907,1152,3494
1.939,17,2,120,2,32,1939,32,120,0,0,0,0,0
0.404,6,7,295,4,0,134,0,164,3,7,105,7,131
20.666,17,4,824,2,48,20641,48,152,2,308,20644,308,672
1798.015,17,449,39928,404,35,4461,288,25708,45,288,40021,288,14220
0.053,17,4,284,2,32,42,32,120,2,54,42,60,164
280.207,6,30,7432,13,158,23350,267,1317,17,543,17510,1400,6115
1783.81,6,394,26592,216,100,8296,469,15056,178,49,10078,69,11536
1787.668,6,154,25004,92,483,19644,483,19282,62,83,29305,83,5722
0.044,17,2,588,1,39,0,39,67,1,493,0,493,521
7.601,6,7,300,3,0,3800,0,124,4,0,2399,0,176
0.058,17,2,338,1,33,0,33,61,1,249,0,249,277
0.766,17,2,144,1,36,0,36,64,1,52,0,52,80
1789.395,6,359,22778,209,69,8602,69,12500,150,69,12009,69,10278
1.494,6,52,21421,28,968,55,1460,15685,24,433,56,1460,5736
0.304,17,2,198,1,39,0,39,67,1,103,0,103,131
3.013,6,15,3646,8,75,430,75,519,7,1373,502,1448,3127
1746.67,6,145,16235,88,122,20076,205,11442,57,32,31184,33,4793
0.1,17,2,373,1,34,0,34,62,1,283,0,283,311
0.248,17,3,451,2,39,76,39,134,1,289,0,289,317
300.843,2,5,160,5,8,75210,8,160,0,0,0,0,0
1.035,6,29,8303,15,225,60,561,1985,14,820,65,1440,6318
1.838,6,27,8824,16,281,122,577,1489,11,984,166,1452,7335
1.407,6,41,11435,21,623,70,1460,5859,20,476,64,2615,5576
369.58,6,18,1242,14,180,28429,180,916,4,110,20060,110,326
0.344,6,3,453,2,241,344,241,321,1,92,0,92,132
4.713,6,35,6209,18,206,277,314,2784,17,548,277,1179,3425
16.756,17,50,36991,21,419,835,1350,9397,29,923,597,1350,27594
39.67,17,38,15296,18,544,2331,1350,10300,20,221,2085,1350,4996
2.845,17,30,13173,13,517,237,1350,7091,17,329,120,1350,6082
1756.838,6,116,7037,65,27,27449,27,3875,51,27,35135,27,3162
243.314,6,39,5545,20,302,12806,302,3766,19,83,13511,83,1779
8.436,6,1896,1734955,1187,1382,6,1408,1693423,709,931,11,2816,41532
616.298,6,59,8901,27,114,18841,500,2460,32,206,19877,1420,6441
1787.385,6,102,8296,68,65,26677,65,4930,34,59,54160,59,3366
1741.979,1,16,896,16,28,116131,28,896,0,0,0,0,0
0.136,6,9,1050,5,261,34,261,465,4,421,38,421,585
393.5,6,40,6058,24,483,17108,483,4637,16,83,26233,83,1421
1681.528,17,14,1036,7,30,280249,30,406,7,62,280249,62,630
217.922,17,4,240,2,32,217921,32,120,2,32,217921,32,120
1785.982,1,8,448,8,28,255140,28,448,0,0,0,0,0
0.022,17,2,136,1,32,0,32,60,1,48,0,48,76
240.124,6,39,5077,19,205,13340,517,2433,20,198,12637,851,2644
30.929,6,6,360,0,0,0,0,0,6,0,0,0,360
79.424,6,49,10198,20,297,4180,1189,2892,29,341,2834,1917,7306
0.503,6,50,22152,28,1058,18,1380,17030,22,421,21,1923,5122
280.352,6,30,7432,13,158,23362,267,1317,17,543,17520,1400,6115
1771.273,1,60,5040,0,0,0,0,0,60,56,30021,56,5040
0.185,17,2,304,1,60,0,60,88,1,188,0,188,216
240.37,6,44,8448,22,449,11445,1418,5648,22,206,11445,580,2800
169.049,6,51,11897,21,336,4931,1189,4211,30,308,5828,3386,7686
840.705,17,8,2196,4,30,280231,30,232,4,463,280229,463,1964
1795.383,17,447,39864,402,35,4477,288,25644,45,288,40016,288,14220
280.512,6,30,7432,13,158,23376,267,1317,17,603,17528,2076,6115
10.412,17,20,12166,11,857,1037,1350,9739,9,241,1297,1350,2427
1783.314,6,355,22549,207,69,8656,69,12420,148,69,12131,69,10129
202.303,6,244,192965,150,1301,1357,1368,177058,94,611,2000,3887,15907
0.024,17,2,238,1,44,0,44,72,1,138,0,138,166
252.537,2,3,96,3,8,126268,8,96,0,0,0,0,0
1792.565,6,84,4496,42,26,43720,26,2248,42,26,43720,26,2248
41.554,17,4,352,2,60,41553,60,176,2,60,41553,60,176
7.4,6,6,280,2,0,7400,0,88,4,0,2403,0,192
286.134,6,30,3141,15,324,20437,585,1461,15,226,20437,580,1680
1.413,6,24,8004,12,164,110,267,1288,12,1014,109,2736,6716
149.31,17,4,352,2,60,149309,60,176,2,60,149309,60,176
41.63,17,6,1236,3,48,20808,48,228,3,308,20808,308,1008
0.49,17,2,152,1,48,0,48,76,1,48,0,48,76
1.293,17,3,451,2,39,978,39,134,1,289,0,289,317
1.53,6,48,19742,27,929,58,1460,14126,21,433,66,1460,5616
0.161,6,9,1002,5,213,40,213,417,4,421,47,421,585
0.805,6,23,6429,13,314,66,909,2095,10,982,88,1737,4334
7.277,6,13,2193,7,211,1212,211,794,6,545,1455,904,1399
280.267,6,30,7432,14,158,21559,267,1357,16,603,18677,2800,6075
1680.594,1,15,840,15,28,120042,28,840,0,0,0,0,0
300.747,6,37,8465,20,299,15828,852,2031,17,478,531,2128,6434
1798.16,17,449,39928,404,35,4461,288,25708,45,288,40022,288,14220
0.802,6,20,5952,11,282,80,548,1292,9,716,90,1420,4660
1746.382,6,101,7918,65,45,27287,205,4850,36,35,49885,98,3068
1120.789,17,10,2745,5,30,280196,30,290,5,463,280196,463,2455
240.195,6,53,16059,28,695,8895,1402,13283,25,183,10007,580,2776
1741.166,6,87,6322,58,31,30546,31,3915,29,31,62184,31,2407
1773.105,6,180,15480,120,69,14900,69,8940,60,69,30049,69,6540
0.5,17,4,368,2,32,168,32,120,2,96,125,96,248
695.063,1,24,2016,24,56,30220,56,2016,0,0,0,0,0
1786.779,17,87,3648,86,14,21020,14,3612,1,8,0,8,36
1.301,6,41,11378,21,616,65,1460,5802,20,433,58,1460,5576
1680.503,17,29,6699,29,203,60017,203,6699,0,0,0,0,0
300.134,6,49,14974,26,896,11998,1360,9190,23,373,13634,2720,5784
0.004,17,2,191,1,36,0,36,64,1,99,0,99,127
37.446,6,17,3165,9,324,4680,585,1149,8,396,5269,580,2016
57.635,6,27,7177,13,155,4802,267,1306,14,530,4432,3417,5871
240.674,2,3,96,3,8,120337,8,96,0,0,0,0,0
281.507,6,32,7650,14,158,21654,267,1357,18,556,16540,3456,6293
125.894,2,2,64,2,8,125894,8,64,0,0,0,0,0
1783.578,17,84,3516,82,14,22016,14,3444,2,8,1783361,8,72
0.67,6,30,11585,18,681,39,1188,7746,12,534,52,1188,3839
0.065,6,9,1348,5,145,16,145,349,4,835,16,835,999
218.149,6,40,8384,12,164,15525,499,1472,28,241,8076,1420,6912
0.08,17,2,702,2,323,80,329,702,0,0,0,0,0
2.789,17,4,624,4,128,929,128,624,0,0,0,0,0
41.406,17,22,1936,11,48,4136,48,836,11,72,4135,72,1100
1772.705,1,126,7056,126,28,14181,28,7056,0,0,0,0,0
69.088,6,29,7263,13,156,5757,267,1312,16,441,4605,1420,5951
1022.805,2,10,320,10,8,113645,8,320,0,0,0,0,0
1.536,6,47,19118,27,887,59,1360,13542,20,433,70,1360,5576
276.256,6,31,7472,14,158,21250,267,1357,17,543,17263,1400,6115
15.951,6,10,560,5,0,3944,0,300,5,0,3944,0,260
1.3,6,45,10197,23,440,59,1360,4496,22,400,53,1360,5701
240.245,6,56,20746,30,856,8283,1418,17834,26,194,9609,580,2912
1792.411,17,142,11360,71,48,25605,48,5396,71,56,25605,56,5964
15.455,6,29,5019,15,154,1065,722,1919,14,394,1152,2026,3100
11.334,6,38,8336,20,239,596,613,1791,18,447,511,1460,6545
1.379,6,24,8004,12,164,107,267,1288,12,1014,106,2491,6716
315.964,6,71,13384,35,131,9293,615,3976,36,361,9023,3289,9408
280.304,6,31,7733,14,175,21561,267,1618,17,603,17514,2036,6115
0.83,17,2,384,1,39,0,39,67,1,289,0,289,317
5.994,17,4,406,2,46,5971,46,148,2,101,5985,101,258
1787.75,6,103,8404,68,66,26682,66,4964,35,60,52568,60,3440
0.595,6,25,6056,13,108,49,147,959,12,768,53,1581,5097
0.246,6,26,7256,13,155,20,267,1301,13,678,19,2045,5955
1720.605,17,13,534,11,14,172042,14,462,2,8,1720428,8,72
63.099,6,29,7257,14,155,4853,267,1346,15,482,4506,2840,5911
17.03,17,24,5778,12,256,1544,1350,3415,12,168,1544,1350,2363
0.438,17,4,377,2,33,406,37,123,2,99,407,136,254
1787.372,17,31,7285,31,207,59579,207,7285,0,0,0,0,0
1782.632,17,142,11360,71,48,25466,48,5396,71,56,25466,56,5964
60.241,6,23,10494,13,744,5020,1448,3675,10,898,6688,1448,6819
1796.477,17,448,39896,403,35,4468,288,25676,45,288,40017,288,14220
317.036,6,65,18707,38,335,8568,1360,9968,27,588,12188,2720,8739
0.284,6,3,156,2,0,284,0,100,1,0,0,0,56
37.699,6,32,5153,16,154,2513,722,1918,16,342,2302,1448,3235
277.349,17,10,3360,10,308,30816,308,3360,0,0,0,0,0
1681.848,17,14,1036,7,30,280302,30,406,7,62,280302,62,630
1799.062,1,345,28980,345,56,5229,56,28980,0,0,0,0,0
1794.41,17,179,11456,179,36,10080,36,11456,0,0,0,0,0
0.887,6,34,13805,20,837,46,1440,7543,14,632,54,1440,6262
15.283,17,3,213,2,43,15239,43,142,1,43,0,43,71
271.612,17,4,352,2,60,271611,60,176,2,60,271611,60,176
0.499,6,10,967,5,256,121,256,460,5,303,121,303,507
1788.912,6,123,14579,79,85,22934,516,6404,44,160,41600,1420,8175
1769.39,6,99,9240,66,65,27221,65,5577,33,59,55289,59,3663
17.313,6,2942,2684829,1779,1424,9,1448,2616073,1163,776,14,1448,68756
0.283,6,27,8949,13,227,23,547,1592,14,945,21,2816,7357
16.85,17,24,14662,13,821,1398,1350,11037,11,301,1677,1350,3625
20.41,6,25,6272,15,117,1457,159,1377,10,727,2266,1402,4895
1772.903,6,180,15480,120,69,14898,69,8940,60,69,30041,69,6540
1.42,6,39,8298,19,321,78,1168,2722,20,433,63,1460,5576
1.332,6,50,19126,27,879,51,1360,13430,23,433,52,1360,5696
0.64,6,11,976,5,283,108,283,551,6,105,88,105,425
75.463,6,20,820,9,0,6053,0,364,11,0,7545,0,456
0.395,6,10,968,5,256,95,256,460,5,304,95,304,508
240.225,6,54,19034,29,821,8579,1408,16299,25,178,10009,580,2735
14.05,6,123,44031,61,665,234,1152,37053,62,449,226,1179,6978
11.038,6,21,9378,10,275,1226,275,683,11,1373,868,1414,8695
3.635,17,5,295,5,31,908,31,295,0,0,0,0,0
1772.355,6,180,15480,120,69,14893,69,8940,60,69,30039,69,6540
0.305,1,2,112,2,28,305,28,112,0,0,0,0,0
573.307,6,96,9499,38,98,15494,375,4102,58,99,10055,1062,5397
1759.773,17,211,52260,211,219,8379,422,52260,0,0,0,0,0
0.056,17,4,865,2,47,2,47,150,2,329,9,341,715
29.305,17,4,240,2,32,29304,32,120,2,32,29304,32,120
356.028,6,42,8878,25,122,14834,787,2382,17,446,472,3488,6496
1797.75,6,358,22669,209,69,8643,69,12500,149,69,12146,69,10169
1793.934,17,64,21504,64,308,28475,308,21504,0,0,0,0,0
76.639,6,8,520,5,92,19121,92,360,3,0,38237,0,160
1786.829,6,102,8296,68,65,26669,65,4930,34,59,54143,59,3366
32.054,6,395,415796,113,138,286,336,6290,282,1420,114,2836,409506
0.049,6,2,80,1,0,0,0,40,1,0,0,0,40
0.319,17,2,225,1,37,0,37,65,1,132,0,132,160
13.894,6,17,1769,9,304,1736,304,1080,8,83,1757,83,689
54.741,17,4,352,2,60,54740,60,176,2,60,54740,60,176
776.673,1,14,784,14,28,59744,28,784,0,0,0,0,0
2.241,17,2,322,1,33,0,33,61,1,233,0,233,261
41.371,17,5,664,5,104,10342,336,664,0,0,0,0,0
39.313,6,27,7177,13,155,3276,267,1306,14,530,3023,3417,5871
0.075,1,2,163,2,53,75,78,163,0,0,0,0,0
0.05,17,4,588,2,48,44,48,152,2,190,42,308,436
0.267,6,3,160,2,0,267,0,100,1,0,0,0,60
0.031,17,2,602,1,46,0,46,74,1,500,0,500,528
199.565,17,6,528,3,60,99782,60,264,3,60,99782,60,264
0.038,17,2,912,1,308,0,308,336,1,548,0,548,576
45.646,17,4,1344,4,308,15215,308,1344,0,0,0,0,0
3.057,17,4,786,2,33,3043,33,122,2,304,3043,304,664
0.379,6,10,968,5,256,94,256,460,5,304,94,304,508
24.029,1,6,336,6,28,4805,28,336,0,0,0,0,0
1443.871,2,11,352,11,8,144387,8,352,0,0,0,0,0
1777.749,17,73,3060,72,14,25038,14,3024,1,8,0,8,36
0.08,17,4,284,2,32,42,32,120,2,54,39,60,164
1741.04,17,30,7050,30,207,60035,207,7050,0,0,0,0,0
1792.199,6,766,51981,383,31,4691,31,26209,383,31,4690,31,25772
1777.786,17,81,3401,79,14,22792,15,3319,2,13,960135,18,82
0.011,6,3,180,2,0,1,0,128,1,0,0,0,52
1748.572,6,97,7307,63,38,28202,205,4476,34,33,52977,98,2831
21.02,6,21,3182,12,183,1910,517,1561,9,381,2625,499,1621
0.339,6,2,1346,2,1242,339,1242,1346,0,0,0,0,0
1797.947,6,409,24832,221,69,8172,69,12980,188,43,9614,69,11852
34.348,17,40,5880,20,48,1807,48,1520,20,190,1807,308,4360
1647.597,6,128,12700,71,64,21973,722,5966,57,80,29417,1448,6734
101.054,6,25,10094,12,532,53,1360,2642,13,988,8410,1360,7452
300.795,6,33,8352,19,204,16710,467,1872,14,522,5051,1408,6480
0.038,17,2,672,2,308,38,308,672,0,0,0,0,0
1795.853,17,447,39864,402,35,4478,288,25644,45,288,40023,288,14220
1383.722,2,14,448,14,8,106440,8,448,0,0,0,0,0
170.282,17,4,352,2,60,170280,60,176,2,60,170280,60,176
1.438,6,47,19098,26,954,57,1460,13482,21,476,61,2615,5616
125.702,2,2,64,2,8,125702,8,64,0,0,0,0,0
10.994,6,20,4442,11,275,1099,275,998,9,768,794,1440,3444
0.232,17,2,2380,2,1162,232,1162,2380,0,0,0,0,0
8.279,6,79,24717,40,561,212,1152,19016,39,413,210,1152,5701
31.438,6,8,348,2,0,16,0,84,6,0,6285,0,264
152.911,6,9,558,6,43,30582,43,394,3,0,76452,0,164
7.518,6,677,610413,434,1339,16,1368,593113,243,776,30,1473,17300
239.293,6,31,6759,13,186,9146,501,1455,18,305,14070,1420,5304
300.314,6,49,33592,31,1240,10010,1440,27680,18,828,1470,1440,5912
11.163,6,26,12230,13,275,930,275,1078,13,1327,891,1380,11152
3.642,17,2,656,2,300,3642,300,656,0,0,0,0,0
1729.196,6,61,4452,40,33,44338,33,2740,21,31,86450,31,1712
0.014,17,2,456,1,60,0,60,88,1,340,0,340,368
9.307,6,1335,1178201,560,332,16,333,32705,775,1433,11,1438,1145496
1.284,6,48,18859,26,933,51,1460,13203,22,433,52,1460,5656
13.383,6,32,7659,13,156,1115,267,1312,19,398,742,3417,6347
1011.016,6,65,9987,41,106,19007,498,3669,24,243,43953,1420,6318
0.084,17,2,152,1,48,0,48,76,1,48,0,48,76
4.967,6,35,6209,19,206,275,314,2824,16,548,313,1179,3385
5.287,6,41,7349,21,218,264,314,3463,20,513,264,1179,3886
209.429,6,57,9798,30,657,7221,1418,6276,27,100,8054,580,3522
148.212,17,4,352,2,60,148211,60,176,2,60,148211,60,176
1755.933,6,100,7702,66,40,27014,205,4730,34,35,53203,108,2972
1771.948,6,180,15480,120,69,14890,69,8940,60,69,30032,69,6540
61.318,6,35,15801,22,797,2919,1408,9127,13,855,5089,3847,6674
1794.36,17,279,58070,279,180,6454,422,58070,0,0,0,0,0
1740.741,17,30,7050,30,207,60025,207,7050,0,0,0,0,0
0.182,17,8,1670,8,180,26,219,1670,0,0,0,0,0
1681.287,17,16,1265,8,30,240181,37,471,8,71,240181,136,794
243.546,6,46,6556,21,331,12177,1056,3467,25,148,10147,580,3089
1743.604,6,97,7307,63,38,28122,205,4476,34,33,52823,98,2831
403.156,6,51,10312,27,88,15506,464,2169,24,377,856,2128,8143
1796.852,6,368,30602,177,75,10209,267,12213,191,88,9456,1452,18389
1684.523,2,18,576,18,8,99089,8,576,0,0,0,0,0
36.752,17,14,1064,14,48,2827,48,1064,0,0,0,0,0
7.669,6,14,1247,7,222,1274,222,728,7,231,1275,231,519
1707.28,1,8,448,8,28,243897,28,448,0,0,0,0,0
0.562,6,57,24311,30,1043,19,1380,18989,27,421,19,1923,5322
2.049,6,9,871,5,304,512,304,572,4,83,676,83,299
1.66,6,50,22698,30,934,57,1360,17122,20,476,70,2715,5576
0.878,6,7,4144,1,0,0,0,40,6,966,4,1414,4104
46.442,6,47,27672,28,1034,1720,1368,21111,19,795,2563,1368,6561
5.837,6,40,7325,21,218,291,314,3463,19,442,309,1152,3862
169.213,1,3,351,3,89,84606,91,351,0,0,0,0,0
0.184,17,2,136,1,32,0,32,60,1,48,0,48,76
0.096,6,4,160,4,0,0,0,160,0,0,0,0,0
1743.88,6,95,7203,63,38,28127,205,4476,32,33,56245,98,2727
0.162,6,23,7608,12,176,14,334,1339,11,1137,15,1648,6269
1.37,6,37,8212,19,320,76,1162,2716,18,476,69,2720,5496
1785.162,17,87,3648,86,14,21001,14,3612,1,8,0,8,36
0.067,17,2,904,2,424,67,548,904,0,0,0,0,0
1781.763,6,283,35116,114,136,15766,1460,16298,169,141,10604,1642,18818
2.617,17,4,1568,4,364,872,364,1568,0,0,0,0,0
280.201,6,28,7352,13,158,23350,267,1317,15,678,20012,2045,6035
1.44,6,49,19817,28,869,53,1360,14201,21,476,62,2715,5616
0.019,6,12,3940,7,88,3,88,388,5,3340,4,3340,3552
1741.24,6,87,6322,58,31,30548,31,3915,29,31,62184,31,2407
0.015,1,2,112,2,28,15,28,112,0,0,0,0,0
300.776,6,37,8346,20,270,15830,734,1913,17,521,538,3488,6433
1786.42,6,102,8364,68,66,26662,66,4964,34,60,54131,60,3400
785.581,17,10,821,5,31,196391,37,297,5,76,196391,136,524
1.365,6,38,8252,19,320,75,1162,2716,19,433,64,1460,5536
1772.348,6,180,15480,120,69,14893,69,8940,60,69,30038,69,6540
6.796,6,29,7464,12,155,617,267,1266,17,423,424,3417,6198
6.718,6,40,7714,20,218,353,314,3423,20,498,339,1179,4291
289.83,17,4,614,4,125,96610,355,614,0,0,0,0,0
2.427,6,15,2391,9,125,303,245,740,6,1407,435,1407,1651
0.942,17,4,1038,2,40,931,40,136,2,423,929,423,902
5.122,17,3,250,2,50,5005,50,156,1,66,0,66,94
33.705,6,30,5042,15,154,2407,722,1858,15,400,2393,1448,3184
65.378,17,65,17794,28,371,2420,1350,11183,37,150,1815,1350,6611
1793.078,1,152,8512,152,28,11874,28,8512,0,0,0,0,0
280.092,17,4,240,2,32,280091,32,120,2,32,280091,32,120
12.049,6,4,367,1,0,0,0,40,3,69,5998,69,327
1740.435,17,28,6580,28,207,64460,207,6580,0,0,0,0,0
1795.48,17,447,39864,402,35,4477,288,25644,45,288,40015,288,14220
0.087,17,2,152,1,48,0,48,76,1,48,0,48,76
9.223,17,8,1572,4,33,3069,33,244,4,304,3069,304,1328
6.909,6,21,4374,12,213,628,597,1689,9,552,840,1767,2685
300.704,6,37,8431,20,291,15826,786,1997,17,478,534,2128,6434
1794.754,1,138,7728,138,28,13100,28,7728,0,0,0,0,0
43.776,17,4,304,4,48,14592,48,304,0,0,0,0,0
80.392,6,45,12370,16,327,849,1189,2615,29,408,2870,1420,9755
11.558,6,1687,1576965,1114,1365,10,1432,1549745,573,389,20,1432,27220
240.328,6,44,8898,22,515,11443,1402,5791,22,217,11443,618,3107
0.126,1,2,112,2,28,126,28,112,0,0,0,0,0
125.576,2,2,64,2,8,125576,8,64,0,0,0,0,0
1746.492,6,104,7807,67,38,26462,205,4715,37,33,48504,98,3092
315.691,6,87,14247,55,304,5846,304,10480,32,83,10183,83,3767
1772.145,6,180,15480,120,69,14891,69,8940,60,69,30033,69,6540
1770.259,17,328,76597,328,205,5413,422,76597,0,0,0,0,0
1787.43,6,102,8296,68,65,26678,65,4930,34,59,54161,59,3366
300.987,6,42,11060,21,515,15049,1018,3747,21,414,2207,1491,7313
560.613,17,6,1647,3,30,280304,30,174,3,463,280304,463,1473
11.182,6,44,9415,22,218,532,314,3503,22,558,518,1179,5912
1.394,6,30,6220,15,138,99,267,1715,15,650,89,1452,4505
0.114,17,2,200,1,64,0,64,92,1,80,0,80,108
166.132,6,33,11899,20,360,8743,555,3352,13,1001,13834,3932,8547
19.957,6,16,2431,7,188,1055,245,660,9,1407,2461,1407,1771
43.023,6,12,516,4,0,14201,0,168,8,0,6071,0,348
0.378,6,12,1653,6,288,68,288,548,6,426,42,434,1105
1.356,6,35,11720,19,405,75,1360,3645,16,1060,79,3942,8075
1.464,6,16,4459,10,327,161,634,1836,6,767,289,1328,2623
0.011,17,2,278,1,36,0,36,64,1,186,0,186,214
1784.759,6,459,27753,228,69,7862,69,13605,231,36,7759,48,14148
575.776,17,25,1044,24,14,25033,14,1008,1,8,0,8,36
1.417,6,24,8004,12,164,110,267,1288,12,1014,111,2491,6716
1796.927,1,58,4872,58,56,31525,56,4872,0,0,0,0,0
10.003,6,44,21354,22,712,476,1408,8289,22,850,119,1408,13065
243.179,6,2,172,2,46,243179,46,172,0,0,0,0,0
1668.262,1,7,392,7,28,278043,28,392,0,0,0,0,0
78.741,6,25,11098,13,745,46,1360,3534,12,1010,7147,1360,7564
33.888,6,33,5242,16,154,2259,721,1909,17,305,2103,1368,3333
1787.563,6,102,8296,68,65,26680,65,4930,34,59,54164,59,3366
1.348,6,57,17994,28,707,49,1360,8925,29,438,47,1360,9069
234.374,6,29,7392,13,158,19531,267,1317,16,603,15622,2036,6075
1772.172,6,180,15480,120,69,14892,69,8940,60,69,30035,69,6540
11.435,6,1956,1780612,1225,1374,9,1408,1737936,731,931,15,2816,42676
124.413,17,4,352,2,60,124411,60,176,2,60,124412,60,176
1782.372,6,354,22440,207,69,8652,69,12420,147,69,12207,69,10020
5.629,6,41,7349,21,218,281,314,3463,20,513,280,1179,3886
65.95,6,22,8233,12,434,5995,659,1946,10,822,7302,1408,6287
0.491,6,124,87800,57,131,8,232,2809,67,1327,7,1430,84991
89.099,6,40,12891,21,922,455,1360,7329,19,435,4938,2667,5562
571.673,1,20,1120,20,28,30088,28,1120,0,0,0,0,0
0.004,17,2,570,1,30,0,30,58,1,484,0,484,512
0.047,17,2,194,1,42,0,42,70,1,96,0,96,124
1797.515,17,448,39896,403,35,4471,288,25676,45,288,40017,288,14220
144.617,6,38,8233,14,141,11124,267,1415,24,307,6287,1460,6818
314.422,6,26,5635,9,133,39302,159,887,17,967,19651,1669,4748
92.135,6,52,11528,24,324,4005,1189,4538,28,418,3411,1420,6990
1782.404,6,367,25581,213,99,8407,469,15005,154,69,11649,69,10576
300.635,6,39,8568,21,291,15031,786,2049,18,445,496,2128,6519
0.071,17,2,154,1,33,0,33,61,1,65,0,65,93
1786.93,17,305,61468,305,173,5878,353,61468,0,0,0,0,0
369.663,6,21,1419,15,177,26404,177,989,6,110,12457,110,430
10.851,17,15,17706,15,1152,775,1449,17706,0,0,0,0,0
84.721,6,40,8513,20,363,593,775,1959,20,574,4452,4848,6554
1.859,17,30,14083,14,704,143,1350,10251,16,211,121,1350,3832
1787.137,6,104,8308,68,64,26673,64,4896,36,58,51057,58,3412
4.025,17,4,244,4,33,1341,33,244,0,0,0,0,0
1772.489,6,202,22250,130,75,13740,267,10057,72,136,24961,2840,12193
191.652,6,6158,5950489,2230,377,85,420,126546,3928,1432,48,2876,5823943
116.962,6,24,980,10,0,6048,0,404,14,0,8993,0,576
1789.344,6,369,23592,213,69,8440,69,12867,156,69,11544,69,10725
106.119,17,4,240,2,32,106118,32,120,2,32,106117,32,120
1794.108,17,144,11520,72,48,25269,48,5472,72,56,25269,56,6048
2.192,17,3,174,3,30,1096,30,174,0,0,0,0,0
2.985,17,2,868,2,406,2985,646,868,0,0,0,0,0
4.108,6,39,7269,20,218,216,314,3423,19,440,214,1152,3846
1.377,6,24,8004,12,164,107,267,1288,12,1014,103,2331,6716
2.639,6,1713,2003565,634,212,4,230,34687,1079,1779,2,14020,1968878
5.28,6,5,264,3,0,2640,0,160,2,0,998,0,104
756.252,2,6,192,6,8,151250,8,192,0,0,0,0,0
1.338,6,53,22895,30,939,46,1360,17199,23,433,52,1360,5696
1734.532,1,8,848,8,78,247790,78,848,0,0,0,0,0
372.171,6,18,1242,14,180,28628,180,916,4,110,20065,110,326
368.729,6,27,1767,18,177,21689,177,1181,9,110,8785,110,586
1681.572,17,14,1036,7,30,280260,30,406,7,62,280259,62,630
1770.911,6,109,10126,70,66,25665,66,5974,39,60,46600,60,4152
314.817,6,25,6093,10,133,34979,159,951,15,873,22486,2816,5142
16.191,17,24,9491,12,441,1468,1350,5636,12,293,1468,1350,3855
1796.165,17,449,39928,404,35,4456,288,25708,45,288,40018,288,14220
103.467,6,25,6318,9,272,114,516,1180,16,345,6891,1452,5138
1.037,17,8,568,4,32,343,32,240,4,54,342,60,328
5.769,6,45,8409,23,227,262,314,4102,22,489,262,1179,4307
11.694,6,2248,2106750,1406,1418,8,1448,2057382,842,776,13,1448,49368
21.293,17,4,240,2,32,21292,32,120,2,32,21292,32,120
1787.833,1,272,15232,272,28,6597,28,15232,0,0,0,0,0
299.529,6,6,364,4,31,99843,31,222,2,31,299516,31,142
866.573,6,107,8618,57,88,15338,270,6184,50,33,17681,62,2434
1760.285,1,94,5264,94,28,18927,28,5264,0,0,0,0,0
463.743,1,12,672,12,28,42158,28,672,0,0,0,0,0
197.1,6,23,6836,6,154,39420,267,712,17,453,12309,1420,6124
7.998,6,16,1310,10,275,888,275,958,6,96,1168,96,352
1308.149,17,88,17088,88,166,15036,362,17088,0,0,0,0,0
261.703,17,3,2563,3,826,130851,1451,2563,0,0,0,0,0
0.168,6,10,2046,6,739,31,1322,1723,4,159,54,159,323
0.436,17,8,2750,8,315,62,354,2750,0,0,0,0,0
0.442,6,12,1653,6,288,88,288,548,6,426,49,434,1105
0.012,17,2,453,1,36,0,36,64,1,361,0,361,389
0.529,17,2,152,1,48,0,48,76,1,48,0,48,76
1136.648,1,6,336,6,28,227329,28,336,0,0,0,0,0
1.924,6,48,15888,25,758,80,1360,10141,23,401,80,2715,5747
837.142,1,12,672,12,28,76103,28,672,0,0,0,0,0
5.036,17,4,288,2,36,5005,36,128,2,52,5003,52,160
2.428,6,33,14891,17,518,151,1360,3326,16,909,105,1360,11565
1799.973,6,206,14266,76,46,23999,46,6076,130,46,13952,46,8190
240.983,6,56,9904,27,145,9268,517,2915,29,364,8606,1508,6989
0.584,6,24,6015,13,108,48,147,959,11,922,53,2602,5056
1144.737,1,9,1044,9,88,143092,88,1044,0,0,0,0,0
0.019,17,2,384,1,32,0,32,60,1,296,0,296,324
33.662,6,29,4991,14,154,2589,722,1808,15,399,2388,1402,3183
1792.027,6,364,25392,212,100,8491,469,14896,152,69,11864,69,10496
108.761,6,18,5839,10,784,12084,1360,3538,8,247,15503,272,2301
344.038,17,3,126,3,14,172019,14,126,0,0,0,0,0
300.618,6,37,8410,19,286,16701,797,1936,18,478,496,2128,6474
5.961,17,63,49608,25,357,248,1350,9646,38,1023,143,1350,39962
52.793,6,15,4214,8,351,7541,722,1467,7,793,8739,1448,2747
6.92,17,6,528,3,48,3453,48,228,3,72,3453,72,300
1793.006,17,180,11520,180,36,10016,36,11520,0,0,0,0,0
174.277,6,2,80,2,0,0,0,80,0,0,0,0,0
33.888,6,31,5093,15,154,2420,722,1859,16,342,2245,1448,3234
120.383,2,2,64,2,8,120383,8,64,0,0,0,0,0
882.78,2,6,192,6,8,176556,8,192,0,0,0,0,0
353.538,6,37,7408,22,134,16835,519,2093,15,392,24562,1420,5315
26.479,17,3,550,2,128,26479,128,312,1,210,0,210,238
1.16,17,4,644,2,36,1155,36,128,2,230,1155,230,516
21.314,6,1837,1654511,1121,1419,19,1432,1619364,716,475,29,1871,35147
0.054,17,8,2454,8,278,7,317,2454,0,0,0,0,0
13.937,17,8,608,8,48,1991,48,608,0,0,0,0,0
1729.19,6,62,4504,40,33,44338,33,2740,22,31,82329,31,1764
1743.814,6,97,7307,63,38,28126,205,4476,34,33,52832,98,2831
0.3,1,2,112,2,28,300,28,112,0,0,0,0,0
1719.686,17,13,534,11,14,171948,14,462,2,8,1719491,8,72
2.057,17,4,1568,4,364,685,364,1568,0,0,0,0,0
1797.579,17,448,39896,403,35,4471,288,25676,45,288,40023,288,14220
1.118,6,23,7952,12,164,86,267,1288,11,1216,95,3819,6664
1757.176,6,185,11345,93,47,19099,208,6735,92,31,19306,31,4610
0.815,6,66,34868,39,1172,21,1380,27458,27,515,29,1923,7410
1795.079,6,363,29173,206,75,8756,267,13304,157,129,11506,1460,15869
133.052,6,40,13256,18,535,7826,1440,4514,22,461,6320,1440,8742
48.572,6,27,7177,12,155,4415,267,1266,15,482,3468,1420,5911
0.063,6,3,132,2,0,63,0,92,1,0,0,0,40
1793.242,1,57,4788,57,56,32022,56,4788,0,0,0,0,0
0.021,17,2,152,2,48,21,48,152,0,0,0,0,0
300.862,6,46,9006,24,322,13080,941,2328,22,445,501,2920,6678
1799.883,1,178,18868,178,78,10168,78,18868,0,0,0,0,0
1786.884,1,58,4872,0,0,0,0,0,58,56,31348,56,4872
1777.346,17,73,3060,72,14,25033,14,3024,1,8,0,8,36
0.082,17,4,284,2,32,34,32,120,2,54,69,60,164
13.774,6,20,4406,12,275,1252,275,1042,8,1010,892,2840,3364
0.24,17,2,384,1,39,0,39,67,1,289,0,289,317
1.566,6,13,2311,8,188,223,245,700,5,1407,327,1407,1611
280.465,6,27,7312,12,158,25496,267,1277,15,678,20030,2760,6035
14.444,6,2329,2144405,1479,1371,9,1408,2095541,850,931,16,2816,48864
1223.612,6,87,7213,56,53,22247,183,4308,31,41,40774,144,2905
1771.152,6,119,11018,75,66,23934,66,6402,44,60,41187,60,4616
1772.217,6,181,15589,120,69,14892,69,8940,61,69,29534,69,6649
280.194,6,28,7352,12,158,25472,267,1277,16,603,18677,1400,6075
19.618,6,8,633,0,0,0,0,0,8,31,2802,31,633
4.527,6,3,132,3,0,0,0,132,0,0,0,0,0
52.214,6,10,400,4,0,12312,0,160,6,0,10439,0,240
1.43,6,50,19694,27,920,55,1460,13998,23,433,56,1460,5696
1786.766,6,107,8564,68,66,26668,66,4964,39,60,47017,60,3600
46.611,17,4,1344,4,308,15537,308,1344,0,0,0,0,0
126.282,2,3,96,3,8,63141,8,96,0,0,0,0,0
240.08,6,28,3618,14,180,18467,595,1804,14,269,18466,580,1814
0.301,6,26,8995,13,252,25,647,1692,13,945,24,1408,7303
161.312,6,25,5146,11,189,11055,516,1392,14,289,12400,1452,3754
313.853,6,25,1720,9,321,39230,321,809,16,83,20923,83,911
1788.801,17,87,3648,86,14,21044,14,3612,1,8,0,8,36
0.033,17,2,246,1,67,0,67,95,1,123,0,123,151
0.698,17,17,6072,8,395,99,1350,3386,9,270,83,1350,2686
1799.925,6,366,24603,213,87,8490,469,14136,153,69,11839,69,10467
0.842,6,21,5988,12,281,76,544,1328,9,716,94,1420,4660
3.19,17,5,290,5,30,797,30,290,0,0,0,0,0
62.509,6,35,8260,15,140,4464,267,1593,20,418,3288,1460,6667
1.117,6,6,248,4,0,372,0,164,2,0,921,0,84
476.854,2,4,128,4,8,158951,8,128,0,0,0,0,0
1.365,6,49,20485,27,979,52,1460,14829,22,476,56,2615,5656
5.019,17,4,558,2,36,5009,36,128,2,187,5009,187,430
1.062,6,31,5931,15,111,75,267,1386,16,650,62,1380,4545
0.017,17,4,680,2,33,0,33,122,2,251,10,323,558
12.887,6,8,440,5,0,3221,0,268,3,0,6271,0,172
1798.383,6,375,26646,217,104,8325,469,15703,158,69,11453,69,10943
0.47,6,2,80,1,0,0,0,40,1,0,0,0,40
300.665,6,50,9091,25,266,12527,720,2182,25,327,632,1460,6909
0.172,17,2,2754,2,1349,172,1349,2754,0,0,0,0,0
147.78,17,6,528,3,60,73889,60,264,3,60,73889,60,264
1681.52,17,16,1265,8,30,240209,37,471,8,71,240211,136,794
0.044,17,2,904,1,300,0,300,328,1,548,0,548,576
116.626,17,7,532,7,48,19437,48,532,0,0,0,0,0
0.056,17,2,237,1,72,0,72,100,1,109,0,109,137
280.011,6,28,7352,14,158,21539,267,1357,14,775,21536,4836,5995
1729.212,6,69,5003,43,33,41171,33,2995,26,31,69160,31,2008
280.271,6,31,7472,15,158,20019,267,1397,16,603,18682,2036,6075
1793.396,17,87,3648,86,14,21098,14,3612,1,8,0,8,36
7.836,6,1259,1081447,758,1378,10,1420,1057186,501,420,15,1420,24261
1791.808,17,142,11360,71,48,25597,48,5396,71,56,25597,56,5964
0.0,17,1,1098,1,1070,0,1070,1098,0,0,0,0,0
284.752,17,4,352,2,60,284751,60,176,2,60,284751,60,176
0.178,6,2,111,1,31,0,31,71,1,0,0,0,40
2.021,17,3,1480,1,300,0,300,328,2,548,90,548,1152
0.073,17,2,650,1,308,0,308,336,1,286,0,286,314
0.411,6,21,7248,12,325,36,626,1932,9,968,50,1475,5316
0.34,6,20,7229,12,334,30,663,1969,8,1209,47,1906,5260
1740.525,17,30,7050,30,207,60018,207,7050,0,0,0,0,0
0.018,17,2,156,1,42,0,42,70,1,58,0,58,86
1790.08,6,372,23574,214,69,8404,69,12976,158,69,11401,69,10598
76.393,6,17,9196,5,174,19098,174,378,12,1387,6530,1420,8818
0.718,17,19,12862,11,911,71,1350,10332,8,288,98,1350,2530
77.06,6,21,9221,11,514,82,1236,2014,10,1132,8543,2279,7207
0.88,6,23,6429,13,314,72,909,2095,10,982,96,1731,4334
1794.18,17,180,11520,180,36,10023,36,11520,0,0,0,0,0
52.824,6,92,17127,44,141,1228,1190,6295,48,347,1123,2816,10832
23.915,6,7,380,4,0,7971,0,216,3,0,11945,0,164
1.208,6,7,295,4,0,402,0,164,3,7,503,7,131
0.754,17,4,1148,2,32,739,32,120,2,486,740,486,1028
157.136,6,26,9823,13,653,67,1460,3166,13,875,13079,1460,6657
1771.035,6,99,9240,66,65,27246,65,5577,33,59,55342,59,3663
1744.641,2,27,864,27,8,67101,8,864,0,0,0,0,0
40.037,1,3,279,3,65,20018,88,279,0,0,0,0,0
28.079,6,29,7323,13,158,2339,267,1317,16,670,1869,1380,6006
182.402,17,110,8350,63,40,2941,41,4324,47,57,3963,80,4026
13.696,6,15,2263,8,329,1956,595,1083,7,396,2273,580,1180
27.482,17,6,528,3,48,13737,48,228,3,72,13736,72,300
0.116,17,2,263,1,36,0,36,64,1,171,0,171,199
1690.81,17,17,3332,17,168,105675,168,3332,0,0,0,0,0
334.435,1,18,1908,18,78,19672,78,1908,0,0,0,0,0
64.67,6,8531,8928568,3000,650,21,652,185198,5531,1529,11,8688,8743370
1785.202,6,132,20156,82,271,22039,1291,14429,50,90,36430,241,5727
0.016,17,2,188,1,58,0,58,86,1,74,0,74,102
1789.012,17,87,3648,86,14,21047,14,3612,1,8,0,8,36
3.618,17,15,8309,8,705,516,1350,5871,7,320,594,1350,2438
1683.878,17,18,4762,9,30,210482,37,529,9,442,210483,463,4233
1795.492,17,80,3354,79,14,23019,14,3318,1,8,0,8,36
29.5,17,4,240,2,32,29499,32,120,2,32,29499,32,120
1796.606,17,142,11360,71,48,25665,48,5396,71,56,25665,56,5964
1791.583,17,142,11360,71,48,25593,48,5396,71,56,25593,56,5964
143.384,1,12,1272,12,78,13034,78,1272,0,0,0,0,0
0.873,17,2,421,1,47,0,47,75,1,318,0,318,346
1323.54,2,11,352,11,8,132354,8,352,0,0,0,0,0
18.051,17,38,13950,19,511,1001,1350,10245,19,167,1001,1350,3705
175.256,17,2,72,1,8,0,8,36,1,8,0,8,36
0.559,6,10,924,5,283,96,283,551,5,105,95,105,373
69.458,6,65,57394,42,249,1694,431,3001,23,2532,3149,11264,54393
300.722,6,46,8907,23,266,13669,720,2078,23,327,586,1460,6829
1797.02,1,345,28980,345,56,5223,56,28980,0,0,0,0,0
168.419,6,24,11438,12,397,76,884,1717,12,1153,15297,2720,9721
0.099,17,4,352,2,60,98,60,176,2,60,98,60,176
1338.334,1,28,1568,28,28,49567,28,1568,0,0,0,0,0
242.131,6,50,9831,22,228,11529,630,2585,28,413,8967,1418,7246
1684.458,2,20,640,20,8,88655,8,640,0,0,0,0,0
75.875,6,31,7613,11,155,31,267,1226,20,371,3993,1420,6387
1799.776,17,144,11520,72,48,25348,48,5472,72,56,25348,56,6048
1785.79,6,359,22709,209,69,8585,69,12569,150,69,11984,69,10140
40.738,17,44,6468,22,48,1939,48,1672,22,190,1939,308,4796
300.691,6,42,8821,20,283,15825,787,2001,22,348,1064,3488,6820
0.464,6,22,5040,11,137,46,267,1132,11,692,44,1467,3908
105.529,6,97,71176,61,1261,1758,1448,61201,36,674,3008,1448,9975
11.662,6,1910,1609133,1134,1363,10,1380,1573851,776,421,15,1923,35282
106.907,6,28,5011,16,220,7127,516,1525,12,375,9710,1452,3486
3.759,6,14,3144,8,49,537,92,511,6,579,40,1408,2633
0.4,6,19,7099,12,318,36,600,1906,7,1205,63,1851,5193
7.324,6,24,3475,13,151,610,267,1431,11,400,702,1179,2044
1789.849,1,83,10851,83,102,21827,351,10851,0,0,0,0,0
2.115,17,25,6158,10,264,235,1350,2921,15,187,111,1350,3237
1785.415,17,134,10720,67,48,27051,48,5092,67,56,27051,56,5628
2.829,17,4,624,4,128,943,128,624,0,0,0,0,0
1772.267,6,180,15480,120,69,14893,69,8940,60,69,30033,69,6540
0.171,6,3,132,2,0,61,0,92,1,0,0,0,40
0.278,17,2,168,1,48,0,48,76,1,64,0,64,92
1799.245,6,356,22520,208,69,8692,69,12460,148,69,12239,69,10060
504.784,6,29,5321,13,166,13564,501,1520,16,242,33646,1420,3801
1692.483,17,14,1036,7,30,282078,30,406,7,62,282078,62,630
14.45,17,3,2389,3,768,7225,1444,2389,0,0,0,0,0
1796.539,17,373,75159,373,173,4829,342,75159,0,0,0,0,0
27.899,6,3868,3642349,2524,1365,10,1408,3567797,1344,776,20,1408,74552
4.4,6,36,7165,18,218,258,314,3343,18,516,243,1179,3822
38.685,6,27,6412,15,117,2763,159,1413,12,727,3515,1408,4999
142.869,6,10,543,3,0,71434,0,152,7,7,23780,7,391
483.878,6,99,6301,47,69,10519,69,2915,52,45,9486,69,3386
9.128,6,10,2934,4,92,3042,92,296,6,772,1747,2026,2638
1798.359,6,356,22520,208,69,8687,69,12460,148,69,12233,69,10060
1.787,6,25,8759,15,284,127,585,1457,10,985,179,1420,7302
36.455,17,20,1760,10,48,4049,48,760,10,72,4049,72,1000
8.02,6,40,7309,21,218,401,314,3463,19,513,431,1179,3846
1796.433,17,448,39612,404,35,4457,288,25708,44,288,40946,288,13904
599.669,6,28,1585,15,31,42833,31,786,13,31,49971,31,799
20.371,6,24,8389,12,275,1851,275,1038,12,1371,1755,1440,7351
0.264,17,2,157,1,31,0,31,59,1,70,0,70,98
0.136,6,10,1671,6,552,27,948,1348,4,159,45,159,323
34.708,17,20,1760,10,48,3855,48,760,10,72,3855,72,1000
1786.613,6,102,8296,68,65,26665,65,4930,34,59,54136,59,3366
0.07,6,12,3462,6,75,13,75,395,6,1373,14,1448,3067
415.056,17,5,380,5,48,103764,48,380,0,0,0,0,0
0.06,6,9,1346,5,145,15,145,349,4,833,13,833,997
1789.109,1,266,14896,266,28,6751,28,14896,0,0,0,0,0
4.117,17,4,1344,4,308,1372,308,1344,0,0,0,0,0
0.398,6,51,21854,28,1036,14,1380,16692,23,421,16,1923,5162
1792.806,6,355,22480,207,69,8702,69,12420,148,69,12195,69,10060
0.054,17,2,433,2,188,54,219,433,0,0,0,0,0
8.201,6,39,7557,20,231,431,314,3354,19,491,424,1179,4203
1777.843,17,73,3060,72,14,25040,14,3024,1,8,0,8,36
12.34,6,10,5124,3,100,6170,100,224,7,1152,1995,1152,4900
0.264,6,24,5937,12,164,24,453,1442,12,643,22,1402,4495
125.386,6,15,3195,7,92,20897,92,452,8,387,17884,1408,2743
1.483,6,46,19023,26,951,59,1460,13447,20,476,67,2615,5576
10.259,6,84,26365,42,561,250,1152,20203,42,447,243,1179,6162
3.321,6,3,180,3,0,0,0,180,0,0,0,0,0
11.383,6,1789,1571898,1091,1387,10,1420,1539757,698,420,16,1420,32141
1681.31,17,14,3771,7,30,280217,30,406,7,452,280217,463,3365
64.152,6,14,1070,7,180,10692,180,588,7,110,10399,110,482
1.25,6,212,194628,75,291,16,928,5654,137,1377,9,2836,188974
1756.516,6,100,7866,66,45,27023,205,4902,34,35,53218,98,2964
250.249,6,30,5283,14,189,9083,516,1510,16,240,16677,1452,3773
590.367,6,47,7711,23,262,26832,517,1992,24,744,25666,1418,5719
327.259,6,263,42923,153,304,2153,304,30628,110,83,3002,83,12295
1772.511,6,180,15480,120,69,14895,69,8940,60,69,30037,69,6540
5.691,6,3,210,0,0,0,0,0,3,45,2845,59,210
0.557,17,2,384,1,39,0,39,67,1,289,0,289,317
4.871,6,16,3272,6,92,974,92,400,10,464,506,1408,2872
295.542,6,9,577,4,31,98514,31,222,5,31,73876,31,355
1729.203,6,62,4504,40,33,44338,33,2740,22,31,82334,31,1764
0.421,17,4,624,2,64,419,64,184,2,192,303,192,440
20.17,17,4,240,2,32,20169,32,120,2,32,20169,32,120
294.442,6,34,7011,15,166,11721,502,1604,19,290,16352,1420,5407
0.137,17,2,136,1,32,0,32,60,1,48,0,48,76
3.053,17,6,1277,3,37,1522,37,195,3,332,1522,348,1082
1797.342,17,345,26220,345,48,5224,48,26220,0,0,0,0,0
0.055,17,2,245,1,32,0,32,60,1,157,0,157,185
1779.982,6,362,22967,210,69,8516,69,12747,152,69,11787,69,10220
1775.491,6,423,28140,208,46,8559,46,13016,215,46,8296,46,15124
1768.873,1,54,4536,0,0,0,0,0,54,56,33374,56,4536
1757.698,6,95,7203,63,38,28349,205,4476,32,33,56689,98,2727
1783.326,6,354,22440,207,69,8656,69,12420,147,69,12214,69,10020
1786.446,6,104,8444,68,66,26663,66,4964,36,60,51038,60,3480
1324.875,2,12,384,12,8,120443,8,384,0,0,0,0,0
1.312,6,24,9512,13,350,109,1041,1952,11,1015,107,1460,7560
1.259,6,49,18978,29,868,44,1360,13357,20,400,57,1360,5621
1799.844,1,57,4788,57,56,32140,56,4788,0,0,0,0,0
0.609,6,122,89625,74,1298,8,1420,83484,48,526,12,3303,6141
0.402,6,12,1653,6,288,73,288,548,6,426,42,434,1105
7.253,6,9,484,4,31,2152,31,253,5,31,1812,31,231
4.914,1,10,280,10,0,0,0,280,0,0,0,0,0
10.296,6,78,56320,47,1199,223,1368,48004,31,956,335,2519,8316
42.028,6,26,7137,13,155,3502,267,1306,13,589,3501,4837,5831
0.001,17,3,1564,3,493,0,521,1564,0,0,0,0,0
378.164,2,3,96,3,8,189082,8,96,0,0,0,0,0
0.138,17,4,420,2,33,135,33,122,2,121,134,145,298
5.308,6,39,7269,20,218,279,314,3423,19,513,280,1179,3846
1789.209,1,339,28476,339,56,5293,56,28476,0,0,0,0,0
0.383,6,10,1514,5,503,95,503,771,5,475,95,475,743
0.294,6,22,7342,12,335,26,668,1974,10,1210,32,1906,5368
11.017,6,20,4442,11,275,1101,275,998,9,768,735,1440,3444
86.445,6,42,8877,20,401,609,889,2120,22,366,4109,2720,6757
650.524,6,45,2783,24,43,24237,208,1571,21,31,32517,31,1212
1680.212,1,15,840,15,28,120015,28,840,0,0,0,0,0
0.156,6,46,22279,27,1079,6,1420,17298,19,467,8,1883,4981
61.309,6,37,15947,22,800,2919,1408,9169,15,665,4361,1408,6778
1786.969,6,102,8296,68,65,26671,65,4930,34,59,54147,59,3366
1778.422,17,140,11200,70,48,25774,48,5320,70,56,25774,56,5880
1772.805,6,180,15480,120,69,14897,69,8940,60,69,30042,69,6540
0.034,17,3,238,2,30,0,30,116,1,94,0,94,122
5.263,6,862,731048,513,1381,10,1420,712867,349,420,15,1420,18181
1772.348,6,180,15480,120,69,14893,69,8940,60,69,30031,69,6540
1.815,6,4,220,2,0,1815,0,100,2,0,1049,0,120
1795.197,17,80,3354,79,14,23015,14,3318,1,8,0,8,36
374.645,6,18,1242,14,180,28818,180,916,4,110,20061,110,326
0.019,17,2,554,1,30,0,30,58,1,468,0,468,496
246.055,6,49,5611,25,181,10252,517,2459,24,158,10697,851,3152
1786.888,6,103,8336,68,65,26669,65,4930,35,59,52552,59,3406
300.869,6,38,9598,21,540,15043,1360,4116,17,435,537,2667,5482
34.191,17,20,1760,10,48,3798,48,760,10,72,3797,72,1000
1772.847,6,181,15589,120,69,14897,69,8940,61,69,29547,69,6649
1.3,6,47,18165,26,882,52,1360,12549,21,433,56,1360,5616
281.32,6,32,7650,13,158,23443,267,1317,19,464,15606,1400,6333
1744.679,2,27,864,27,8,67103,8,864,0,0,0,0,0
89.858,6,17,1232,5,69,22463,69,269,12,69,8168,69,963
1750.684,17,13,534,11,14,175050,14,462,2,8,1750501,8,72
38.733,6,12,1144,2,65,1188,65,210,10,59,4293,90,934
1778.08,17,141,11276,71,48,25366,48,5396,70,56,25766,56,5880
0.149,6,46,20889,26,1057,5,1420,15868,20,467,7,1883,5021
127.512,6,9,522,3,106,63756,106,234,6,0,6284,0,288
355.59,6,22,11267,4,112,209,112,280,18,641,20913,1420,10987
1786.006,6,106,8584,69,66,26264,66,5004,37,60,49608,60,3580
317.007,6,62,18630,36,367,9057,1360,9931,26,546,12674,1360,8699
53.891,6,27,7177,13,155,4490,267,1306,14,530,4144,3417,5871
1798.26,17,448,39328,404,34,4462,288,25424,44,288,40950,288,13904
0.38,6,20,7151,12,318,33,600,1906,8,1205,53,1891,5245
438.157,6,101,13692,40,100,10120,267,3619,61,173,7302,1452,10073
324.366,6,23,4849,10,220,6399,516,1286,13,303,26998,1452,3563
23.334,17,32,20280,14,553,1792,1350,8141,18,646,1370,1350,12139
1684.054,17,14,1036,7,30,280670,30,406,7,62,280670,62,630
1209.07,17,25,8392,25,307,50377,308,8392,0,0,0,0,0
300.94,6,48,16780,27,996,11574,1460,11093,21,371,431,1460,5687
13.697,6,23,4660,12,154,1225,722,1715,11,789,1352,1402,2945
607.447,2,5,160,5,8,151861,8,160,0,0,0,0,0
1771.211,6,101,9410,66,66,27249,66,5610,35,60,52091,60,3800
7.273,1,7,3609,7,487,1212,548,3609,0,0,0,0,0
8.132,6,1731,1592705,1092,1380,7,1408,1554813,639,931,12,2816,37892
4.587,6,37,7189,19,218,254,314,3383,18,513,254,1179,3806
17.828,17,40,11358,19,272,989,1350,5706,21,241,889,1350,5652
37.866,6,29,5027,14,154,2912,722,1808,15,347,2673,1448,3219
15.668,6,34,7544,16,230,1044,314,2715,18,456,906,1179,4829
17.081,17,6,456,6,48,3416,48,456,0,0,0,0,0
1795.032,6,239,26561,123,120,14713,721,15285,116,144,15152,1414,11276
27.438,17,16,1216,16,48,1829,48,1216,0,0,0,0,0
363.65,6,21,1419,15,177,25975,177,989,6,110,12222,110,430
4.981,17,25,10320,11,332,498,1350,3963,14,426,206,1350,6357
280.253,6,29,7392,13,158,23354,267,1317,16,603,18680,2800,6075
0.357,17,2,633,2,288,357,293,633,0,0,0,0,0
53.667,6,10,568,10,21,5963,21,568,0,0,0,0,0
0.045,17,2,186,1,36,0,36,64,1,94,0,94,122
95.135,6,35,5314,21,154,4756,721,2182,14,400,1194,2026,3132
962.633,2,9,288,9,8,120329,8,288,0,0,0,0,0
25.8,6,15,880,6,0,5160,0,340,9,0,2904,0,540
3.363,17,10,772,5,30,835,30,290,5,68,832,94,482
0.934,6,10,1687,7,100,155,100,384,3,1179,342,1179,1303
1744.706,2,25,800,25,8,72696,8,800,0,0,0,0,0
0.039,6,7,349,5,69,9,69,269,2,0,1,0,80
1787.057,6,182,15629,121,69,14892,69,8980,61,69,29782,69,6649
1.032,6,25,9552,14,350,79,1041,1992,11,1015,84,1460,7560
1675.116,1,7,392,7,28,279186,28,392,0,0,0,0,0
102.636,17,4,352,2,60,102635,60,176,2,60,102635,60,176
0.292,17,2,178,1,29,0,29,57,1,93,0,93,121
849.129,1,8,448,8,28,121304,28,448,0,0,0,0,0
1745.318,6,95,7203,63,38,28150,205,4476,32,33,56291,98,2727
20.749,17,8,704,4,48,6909,48,304,4,72,6900,72,400
1.705,6,47,19269,27,898,65,1360,13693,20,433,77,1360,5576
0.532,17,3,451,2,39,439,39,134,1,289,0,289,317
0.106,17,2,602,1,46,0,46,74,1,500,0,500,528
1787.285,6,104,8308,68,64,26675,64,4896,36,58,51062,58,3412
0.008,17,2,330,1,30,0,30,58,1,244,0,244,272
0.216,17,3,618,2,32,20,32,120,1,470,0,470,498
1681.684,1,14,784,14,28,129360,28,784,0,0,0,0,0
99.759,6,21,8224,11,549,80,1309,2120,10,948,11065,1591,6104
1390.182,17,64,2688,64,14,22066,14,2688,0,0,0,0,0
1741.586,6,90,6521,59,31,30027,31,3998,31,31,58051,31,2523
1772.1,6,180,15480,120,69,14891,69,8940,60,69,30030,69,6540
61.777,6,69,48307,44,1186,1436,1408,40273,25,960,2564,3847,8034
629.851,2,4,128,4,8,209950,8,128,0,0,0,0,0
3.491,6,3361,2740580,1566,183,2,230,84025,1795,1429,1,4224,2656555
1799.235,17,450,39960,405,35,4453,288,25740,45,288,40017,288,14220
1792.455,6,794,54127,393,31,4572,31,26994,401,31,4480,31,27133
1.027,6,11,1424,5,145,256,145,349,6,831,147,831,1075
110.834,6,955,457702,506,839,219,1152,434269,449,420,246,1179,23433
1.259,6,39,11298,22,547,59,1360,5842,17,476,68,2715,5456
9.988,17,4,352,2,60,9987,60,176,2,60,9987,60,176
6.026,6,658,566058,401,1336,14,1368,546174,257,776,22,2736,19884
24.279,17,4,352,2,60,24278,60,176,2,60,24278,60,176
3.539,6,17,5608,9,171,440,171,830,8,1085,504,1448,4778
0.198,17,2,144,1,36,0,36,64,1,52,0,52,80
18.871,17,4,240,2,32,18870,32,120,2,32,18870,32,120
0.005,17,4,284,2,32,0,32,120,2,54,1,60,164
34.12,6,26,6706,9,154,4265,267,832,17,518,2104,1460,5874
434.058,17,8,3080,8,357,62008,357,3080,0,0,0,0,0
1741.446,6,87,6322,58,31,30551,31,3915,29,31,62193,31,2407
0.007,17,3,422,2,32,0,32,120,1,274,0,274,302
1771.45,6,100,9357,67,65,26840,65,5694,33,59,55354,59,3663
365.452,1,8,448,8,28,52207,28,448,0,0,0,0,0
4.839,6,38,7229,20,218,254,314,3423,18,513,270,1179,3806
255.058,6,9,635,2,63,90,63,143,7,35,42495,57,492
245.444,17,4,352,2,60,245443,60,176,2,60,245443,60,176
160.681,6,1469,743751,808,852,199,1152,710085,661,401,243,1179,33666
1740.742,17,28,29568,28,1028,64471,1028,29568,0,0,0,0,0
0.133,17,2,2754,2,1349,133,1349,2754,0,0,0,0,0
1798.372,6,370,25839,215,99,8403,469,15154,155,69,11676,69,10685
46.132,1,24,2496,0,0,0,0,0,24,76,2005,76,2496
299.396,6,40,7571,18,134,12704,519,1933,22,297,14252,2642,5638
0.604,6,12,1653,6,288,114,288,548,6,426,65,434,1105
1773.076,6,250,19719,126,83,14184,965,10145,124,37,14415,261,9574
300.926,6,42,14323,24,867,13083,1360,8801,18,435,513,2667,5522
0.03,17,2,362,1,46,0,46,74,1,260,0,260,288
13.41,6,33,9106,17,440,838,721,2889,16,695,870,1420,6217
2.043,17,2,136,1,32,0,32,60,1,48,0,48,76
1741.475,17,29,30624,29,1028,62195,1028,30624,0,0,0,0,0
307.673,6,48,15337,16,883,20511,1360,7762,32,261,815,1360,7575
1681.312,17,14,1045,7,30,280215,30,406,7,63,280215,71,639
0.798,17,2,776,2,360,798,360,776,0,0,0,0,0
481.227,2,6,192,6,8,96245,8,192,0,0,0,0,0
61.849,6,68,47258,43,1192,1472,1408,39224,25,960,2567,3847,8034
1787.073,6,102,8296,68,65,26672,65,4930,34,59,54150,59,3366
1773.677,6,206,22479,131,75,13643,267,10097,75,132,23965,1460,12382
198.341,17,4,304,2,48,198340,64,152,2,48,198338,64,152
1.328,6,53,20166,30,877,45,1360,14425,23,400,52,1360,5741
280.21,6,28,7352,13,158,23350,267,1317,15,678,20012,3436,6035
1795.237,17,80,3354,79,14,23015,14,3318,1,8,0,8,36
1797.89,1,345,28980,345,56,5226,56,28980,0,0,0,0,0
1779.668,6,371,23306,210,69,8515,69,12678,161,58,11122,69,10628
1744.705,6,95,7203,63,38,28140,205,4476,32,33,56267,98,2727
1771.552,6,101,9278,66,64,27254,64,5544,35,58,52102,58,3734
1786.242,17,84,3522,83,14,21783,14,3486,1,8,0,8,36
1.402,6,42,8471,21,321,70,1164,2810,21,400,60,1360,5661
0.027,17,2,279,1,36,0,36,64,1,187,0,187,215
0.009,17,2,2176,2,1060,9,1060,2176,0,0,0,0,0
0.011,17,2,294,1,36,0,36,64,1,202,0,202,230
0.931,6,9,1647,6,100,186,100,344,3,1179,334,1179,1303
1783.809,6,362,24774,211,94,8494,469,14387,151,69,11892,69,10387
1782.808,17,13,3386,13,232,148567,1030,3386,0,0,0,0,0
280.419,6,29,7392,13,158,23368,267,1317,16,678,18692,2760,6075
240.188,6,54,17576,29,741,8577,1402,14855,25,176,10007,580,2721
378.02,2,4,128,4,8,126006,8,128,0,0,0,0,0
2.134,17,3,1170,3,362,1067,362,1170,0,0,0,0,0
0.398,6,9,527,5,43,99,43,311,4,0,128,0,216
1787.471,6,104,8308,68,64,26678,64,4896,36,58,51066,58,3412
4.481,6,35,6209,18,206,263,314,2784,17,548,261,1179,3425
9.625,6,82,24805,41,560,240,1152,19008,41,461,234,1179,5797
48.096,17,8,800,8,72,6870,75,800,0,0,0,0,0
1772.139,6,180,15480,120,69,14891,69,8940,60,69,30031,69,6540
9.334,6,22,3629,14,211,717,211,1214,8,665,1102,904,2415
0.936,6,3,127,1,0,0,0,40,2,7,1,7,87
7.993,6,18,6767,9,275,999,275,643,9,1150,640,1414,6124
280.517,6,30,7432,13,158,23376,267,1317,17,678,17528,4140,6115
25.395,17,620,616212,611,979,40,1252,615808,9,16,3173,56,404
0.351,1,10,840,10,56,39,56,840,0,0,0,0,0
300.101,6,43,9896,23,547,13633,1440,4249,20,371,15785,1440,5647
3.118,17,3,186,3,34,1559,34,186,0,0,0,0,0
280.824,6,30,7432,13,158,23402,267,1317,17,543,17549,1400,6115
1.709,6,25,9487,14,333,131,976,1927,11,1015,128,1460,7560
1267.083,6,82,6439,47,65,24595,65,3375,35,52,37264,59,3064
0.664,17,2,204,1,34,0,34,62,1,114,0,114,142
4.043,17,27,6622,13,294,334,1350,4188,14,145,308,1350,2434
1.642,17,22,15081,12,1004,148,1350,12390,10,241,178,1350,2691
0.834,6,20,5948,11,281,83,544,1288,9,716,93,1420,4660
242.773,17,4,352,2,60,242772,60,176,2,60,242771,60,176
0.026,17,2,904,1,548,0,548,576,1,300,0,300,328
1.321,6,24,8004,12,164,103,267,1288,12,1014,103,2491,6716
1.353,6,42,10594,21,513,67,1460,4978,21,433,57,1460,5616
1.992,6,29,6305,15,154,142,267,1840,14,650,132,1380,4465
1771.589,6,101,9410,66,66,27255,66,5610,35,60,52102,60,3800
1788.984,6,359,22709,209,69,8600,69,12569,150,69,12006,69,10140
362.119,6,38,10353,25,256,15088,1448,4688,13,711,5136,1448,5665
333.513,6,85,14249,42,195,8134,469,6183,43,243,7940,1452,8066
1772.605,6,181,15589,120,69,14895,69,8940,61,69,29535,69,6649
96.323,6,34,7871,13,155,8026,267,1306,21,357,4815,3417,6565
218.352,1,12,672,12,28,19850,28,672,0,0,0,0,0
264.286,6,21,4614,9,272,159,516,1180,12,327,24006,1452,3434
1.578,17,6,432,3,36,765,36,192,3,52,753,52,240
0.01,17,2,195,1,32,0,32,60,1,107,0,107,135
1.232,6,27,8120,14,266,79,540,1924,13,944,84,1591,6196
0.068,17,2,2756,2,1350,68,1350,2756,0,0,0,0,0
15.46,6,6,288,1,0,0,0,48,5,0,3862,0,240
0.894,17,2,454,1,46,0,46,74,1,352,0,352,380
1773.271,6,180,15480,120,69,14901,69,8940,60,69,30050,69,6540
180.494,2,3,96,3,8,90247,8,96,0,0,0,0,0
0.605,6,20,7238,12,335,54,668,1974,8,1210,85,1906,5264
628.509,17,24,3528,12,48,57136,48,912,12,190,57136,308,2616
0.697,6,23,5959,14,164,53,453,1570,9,652,78,2201,4389
1.31,6,42,17198,26,595,52,1360,9405,16,793,77,4649,7793
300.703,6,29,10889,15,599,21470,1360,3629,14,836,23121,1360,7260
1002.859,17,80,6400,40,48,25714,48,3040,40,56,25714,56,3360
240.199,6,53,17833,28,802,8895,1418,15108,25,177,10007,580,2725
962.555,2,7,224,7,8,160425,8,224,0,0,0,0,0
0.833,6,57,25204,30,1096,28,1380,19870,27,383,30,1380,5334
0.256,17,2,136,1,32,0,32,60,1,48,0,48,76
10.945,6,92,29047,46,580,243,1152,22725,46,447,236,1179,6322
182.219,17,6,528,3,60,91109,60,264,3,60,91108,60,264
3.917,17,3,264,3,60,1958,60,264,0,0,0,0,0
7.93,6,550,471584,342,1312,22,1368,456104,208,776,37,1473,15480
0.263,17,3,234,2,39,175,39,134,1,72,0,72,100
0.037,6,10,859,6,181,7,181,489,4,77,4,133,370
1.413,6,47,19656,27,926,54,1360,14080,20,476,64,2715,5576
59.072,17,27,2281,25,30,2461,37,1457,2,384,361,463,824
0.566,6,23,7397,13,334,47,663,2021,10,967,53,1471,5376
0.746,6,3,144,2,0,730,0,104,1,0,0,0,40
11.321,6,24,3320,12,256,1028,256,2532,12,304,1028,304,788
5.298,17,3,3249,3,1055,2649,1055,3249,0,0,0,0,0
0.042,17,4,368,2,32,3,32,120,2,96,0,96,248
4.376,6,35,6209,17,206,273,314,2744,18,456,241,1152,3465
6.163,17,318,63440,309,172,20,172,61800,9,154,40,172,1640
15.111,17,12,5192,6,489,3015,1350,3107,6,319,3016,1350,2085
1.265,6,50,19226,27,887,48,1360,13530,23,433,49,1360,5696
7.78,17,4,240,2,32,7780,32,120,2,32,7779,32,120
1.428,6,48,19834,27,936,54,1460,14218,21,433,62,1460,5616
0.008,17,2,304,1,60,0,60,88,1,188,0,188,216
5.2,17,28,6833,11,236,520,1350,2911,17,202,199,1350,3922
0.45,6,2,100,1,0,0,0,60,1,0,0,0,40
1.34,6,41,9968,21,440,67,1360,4392,20,433,61,1360,5576
162.771,6,1639,1566976,556,138,293,891,33191,1083,1396,150,2816,1533785
0.998,17,14,8825,7,899,161,1350,6492,7,305,161,1350,2333
246.482,6,64,15273,27,127,5306,722,3323,37,385,6841,1408,11950
68.72,6,40,25829,19,840,39,1460,5847,21,1195,3429,1460,19982
280.701,6,30,7523,12,158,25518,267,1277,18,502,16505,1400,6246
1797.15,1,268,15008,268,28,6730,28,15008,0,0,0,0,0
55.648,6,31,7731,11,156,10,267,1232,20,355,2928,3417,6499
1797.892,17,764,46076,764,32,2356,37,46076,0,0,0,0,0
0.06,17,2,144,1,36,0,36,64,1,52,0,52,80
286.818,17,4,352,2,60,286817,60,176,2,60,286817,60,176
1794.277,17,343,79782,343,204,5246,422,79782,0,0,0,0,0
5.849,6,40,7309,21,201,292,314,3463,19,513,310,1179,3846
1776.906,17,140,11200,70,48,25752,48,5320,70,56,25752,56,5880
1.061,17,2,456,1,60,0,60,88,1,340,0,340,368
261.69,17,4,352,2,60,261689,60,176,2,60,261689,60,176
0.012,17,2,254,1,34,0,34,62,1,164,0,164,192
0.328,17,2,144,1,36,0,36,64,1,52,0,52,80
1787.299,17,369,122494,369,303,4856,438,122494,0,0,0,0,0
0.025,17,2,527,1,39,0,39,67,1,432,0,432,460
11.166,6,27,11355,13,275,930,275,1078,14,1078,803,1414,10277
0.459,6,9,1346,5,145,114,145,349,4,833,114,833,997
59.082,17,28,2339,26,30,2363,37,1515,2,384,357,463,824
1799.79,17,450,39960,405,35,4454,288,25740,45,288,40020,288,14220
1797.213,6,356,22520,208,69,8682,69,12460,148,69,12225,69,10060
0.458,6,3,144,2,0,2,0,92,1,0,0,0,52
1757.981,17,270,53077,270,168,6535,356,53077,0,0,0,0,0
1772.342,1,58,4872,58,56,31093,56,4872,0,0,0,0,0
0.038,6,13,3980,7,88,6,88,388,6,1670,7,2920,3592
1772.404,6,180,15480,120,69,14894,69,8940,60,69,30038,69,6540
110.228,1,6,336,6,28,22045,28,336,0,0,0,0,0
1700.686,17,12,498,11,14,170068,14,462,1,8,0,8,36
36.838,1,42,4368,0,0,0,0,0,42,76,898,76,4368
10.7,6,18,5610,10,275,1188,275,958,8,1440,794,1440,4652
300.055,6,34,7937,13,158,25004,267,1317,21,412,14989,2036,6620
287.532,17,4,240,2,32,287531,32,120,2,32,287530,32,120
0.491,17,3,451,2,39,56,39,134,1,289,0,289,317
1775.806,6,77,4056,39,26,46730,26,2054,38,26,47993,26,2002
154.768,6,20,9181,11,514,88,1236,2014,9,1359,19322,3639,7167
1.403,6,50,18744,27,852,53,1360,13048,23,433,55,1360,5696
61.307,6,35,15827,22,800,2919,1408,9153,13,855,5089,3847,6674
1793.558,17,87,3648,86,14,21100,14,3612,1,8,0,8,36
1.374,6,10,1687,7,100,229,100,384,3,1179,557,1179,1303
0.008,1,2,112,2,28,8,28,112,0,0,0,0,0
65.985,1,2,232,2,88,65985,88,232,0,0,0,0,0
0.39,6,7,371,4,0,130,0,204,3,7,107,7,167
5.011,17,4,542,2,36,5006,36,128,2,179,5001,187,414
6.78,6,30,8848,13,155,565,267,1306,17,527,423,2840,7542
1791.96,6,376,26355,216,98,8334,469,15263,160,69,11269,69,11092
0.52,6,12,1653,6,288,99,288,548,6,426,56,434,1105
0.759,6,10,1687,7,100,126,100,384,3,1179,256,1179,1303
0.317,17,8,2774,8,318,45,357,2774,0,0,0,0,0
0.004,17,2,150,1,33,0,33,61,1,61,0,61,89
21.283,17,27,16143,13,516,1770,1350,7078,14,619,1633,1350,9065
5.135,6,41,7349,21,218,256,314,3463,20,513,256,1179,3886
0.383,6,4,235,1,0,0,0,40,3,27,188,27,195
655.996,2,6,192,6,8,131199,8,192,0,0,0,0,0
84.762,6,25,9849,12,531,62,1440,2637,13,954,7052,1440,7212
0.826,6,11,1727,7,100,137,100,384,4,589,184,1152,1343
122.619,6,5,293,4,31,40873,31,222,1,31,0,31,71
236.134,6,121,91417,77,1262,3107,1408,81005,44,811,1932,3847,10412
281.512,6,33,7690,13,158,23459,267,1317,20,464,14800,1380,6373
1780.813,6,239,24769,96,67,18744,616,9131,143,139,12540,4658,15638
2.412,6,14,2351,8,188,344,245,700,6,703,430,1152,1651
3.013,6,2,144,1,0,0,0,40,1,64,0,64,104
1789.82,6,356,22520,208,69,8646,69,12460,148,69,12175,69,10060
1788.676,17,142,11360,71,48,25551,48,5396,71,56,25551,56,5964
38.535,17,44,6468,22,48,1834,48,1672,22,190,1834,308,4796
1795.228,17,449,39928,404,35,4454,288,25708,45,288,40022,288,14220
1.349,6,38,8252,19,320,74,1162,2716,19,476,65,2720,5536
15.545,17,17,7850,9,593,1938,1350,5592,8,254,2215,1350,2258
1081.255,1,5,530,5,78,270313,78,530,0,0,0,0,0
6.546,6,1385,1238246,814,1435,7,1448,1201046,571,776,11,1448,37200
1.301,6,50,19435,29,897,46,1360,13774,21,400,56,1360,5661
4.993,17,2,128,2,36,4993,36,128,0,0,0,0,0
1670.317,1,8,448,8,28,238616,28,448,0,0,0,0,0
127.047,17,47,19228,21,430,6352,1350,9636,26,340,4773,1350,9592
6.407,1,4,224,4,28,2135,28,224,0,0,0,0,0
11.858,6,2186,2035949,1361,1416,8,1448,1988373,825,776,14,1448,47576
1772.915,6,180,15480,120,69,14898,69,8940,60,69,30045,69,6540
0.186,1,2,112,2,28,186,28,112,0,0,0,0,0
61.949,6,63,45562,42,1184,1510,1368,37733,21,841,3085,2736,7829
1745.656,6,96,7286,63,38,28155,205,4476,33,33,54546,98,2810
1787.144,6,106,8456,68,65,26673,65,4930,38,59,48297,59,3526
0.546,6,28,9234,13,268,45,710,1770,15,833,36,1368,7464
962.576,2,7,224,7,8,160429,8,224,0,0,0,0,0
0.017,17,2,466,1,72,0,72,100,1,338,0,338,366
1799.554,17,449,39928,404,35,4465,288,25708,45,288,40017,288,14220
0.051,6,2,92,1,0,0,0,52,1,0,0,0,40
42.374,17,24,2112,12,48,3845,48,912,12,72,3850,72,1200
1787.702,6,104,8376,68,65,26682,65,4930,36,59,51072,59,3446
184.24,17,4,240,2,32,184239,32,120,2,32,184239,32,120
0.087,6,10,1495,5,507,21,507,727,5,556,21,556,768
1.274,6,50,20881,28,938,47,1460,15225,22,433,52,1460,5656
1.165,6,23,7952,12,164,90,267,1288,11,1216,99,3819,6664
0.032,17,8,1670,8,180,4,219,1670,0,0,0,0,0
1786.711,6,104,8376,68,65,26667,65,4930,36,59,51046,59,3446
1740.188,6,109,7853,67,31,26366,31,4586,42,31,42443,31,3267
1745.98,6,95,7203,63,38,28160,205,4476,32,33,56312,98,2727
252.32,2,2,64,2,8,252320,8,64,0,0,0,0,0
1171.704,6,162,23554,93,146,11220,597,10737,69,159,17230,1917,12817
1793.122,1,57,4788,0,0,0,0,0,57,56,32020,56,4788
82.83,6,56,16521,30,1031,454,1360,10603,26,374,3306,2667,5918
4.269,6,106,83560,67,803,64,1360,8375,39,2300,108,6800,75185
280.386,6,28,7352,13,158,23365,267,1317,15,678,20017,3436,6035
1798.375,17,449,39928,404,35,4462,288,25708,45,288,40020,288,14220
1784.209,6,356,22520,208,69,8619,69,12460,148,69,12137,69,10060
1083.638,6,72,10627,45,100,18932,498,4018,27,221,41675,1420,6609
62.172,17,28,2339,26,30,2486,37,1515,2,384,385,463,824
1.26,6,14,3592,7,150,210,174,584,7,681,194,1452,3008
5.504,6,31,12738,14,413,423,721,2631,17,785,286,1414,10107
228.114,6,25,7232,12,158,20737,267,1277,13,905,19005,4845,5955
187.076,17,16,17875,16,1089,12471,1451,17875,0,0,0,0,0
1680.736,17,28,29568,28,1028,62249,1028,29568,0,0,0,0,0
0.89,6,10,1687,7,100,148,100,384,3,1179,321,1179,1303
143.65,17,14,2884,7,48,23939,48,532,7,308,23939,308,2352
29.252,6,21,3182,12,183,2659,517,1561,9,381,3655,499,1621
43.602,6,37,9431,14,296,148,1189,2641,23,418,1981,1420,6790
0.632,6,25,7678,14,292,48,663,2199,11,977,62,1906,5479
1745.143,6,101,7912,65,45,27267,205,4844,36,35,49854,98,3068
1681.497,17,14,1036,7,30,280244,30,406,7,62,280244,62,630
1744.628,2,29,928,29,8,62308,8,928,0,0,0,0,0
2.202,6,23,6752,10,257,239,517,1569,13,642,179,1418,5183
6.142,6,1923,1776183,1211,1388,4,1408,1734495,712,931,8,2816,41688
1772.629,6,180,15480,120,69,14896,69,8940,60,69,30041,69,6540
1786.522,6,103,8268,68,64,26664,64,4896,35,58,52542,58,3372
1740.427,6,87,6322,58,31,30533,31,3915,29,31,62156,31,2407
0.46,17,2,144,1,36,0,36,64,1,52,0,52,80
4.717,17,4,352,2,60,4716,60,176,2,60,4716,60,176
20.313,6,20,2484,10,189,2257,517,1298,10,323,2249,499,1186
0.837,17,4,624,2,64,836,64,184,2,192,718,192,440
180.502,2,2,64,2,8,180502,8,64,0,0,0,0,0
57.15,6,30,7432,13,158,4762,267,1317,17,543,3569,1400,6115
1.273,6,48,17093,26,796,50,1360,11437,22,433,51,1360,5656
60.361,6,42,20567,22,131,2874,134,1676,20,991,3173,1448,18891
0.672,6,26,8903,13,234,56,575,1620,13,942,50,1438,7283
0.335,6,26,8995,13,252,27,647,1692,13,1103,26,2816,7303
269.599,6,31,3213,16,324,17973,585,1513,15,226,17391,580,1700
2.633,6,22,6403,10,262,287,517,1316,12,744,235,1418,5087
30.26,6,9,529,5,45,7565,45,313,4,0,10046,0,216
0.045,6,9,1339,5,145,11,145,349,4,826,12,826,990
96.22,6,42,18869,21,849,68,1460,9368,21,576,4804,1460,9501
0.096,6,11,1535,6,507,19,507,767,5,556,24,556,768
1776.088,1,58,4872,58,56,31159,56,4872,0,0,0,0,0
191.344,6,6,394,3,122,72,122,262,3,0,95601,0,132
8.453,17,4,352,2,60,8452,60,176,2,60,8452,60,176
294.109,2,2,64,2,8,294109,8,64,0,0,0,0,0
0.041,17,2,347,1,29,0,29,57,1,262,0,262,290
1.472,6,47,18728,26,926,58,1460,13112,21,433,63,1460,5616
100.243,6,43,9766,19,265,5569,722,3153,24,434,4265,1380,6613
1790.895,1,342,28728,342,56,5251,56,28728,0,0,0,0,0
1730.153,6,63,4601,41,33,43253,33,2825,22,31,82379,31,1776
1682.91,17,14,1036,7,30,280476,30,406,7,62,280476,62,630
1740.708,17,308,51542,308,139,5670,366,51542,0,0,0,0,0
227.552,17,4,240,2,32,227551,32,120,2,32,227551,32,120
141.486,6,50,16940,14,327,968,1189,2535,36,462,4042,1420,14405
0.0,1,1,389,1,361,0,361,389,0,0,0,0,0
1796.014,17,447,39864,402,35,4478,288,25644,45,288,40017,288,14220
113.806,6,72,52080,48,1188,2421,1368,44094,24,961,2697,3887,7986
0.87,6,20,7151,12,318,79,600,1906,8,964,101,1851,5245
1.49,17,6,360,3,32,743,32,180,3,32,744,32,180
33.836,6,35,5347,16,154,2255,721,1910,19,271,1867,1368,3437
1785.085,6,102,8228,68,64,26643,64,4896,34,58,54090,58,3332
34.341,17,4,240,2,32,34339,32,120,2,32,34339,32,120
372.178,6,18,1242,14,180,28629,180,916,4,110,20071,110,326
97.251,6,926,431484,479,835,203,1152,407742,447,418,217,1179,23742
180.878,6,30,8872,13,158,15073,267,1317,17,687,11299,1400,7555
7.204,6,5,240,1,0,0,0,48,4,0,2398,0,192
12.871,6,105,35794,55,616,238,1152,29312,50,447,257,1179,6482
10.808,6,2305,1971022,1288,1432,8,1448,1902502,1017,776,10,1448,68520
1772.971,6,180,15480,120,69,14898,69,8940,60,69,30048,69,6540
0.579,1,9,756,9,56,72,56,756,0,0,0,0,0
1681.521,17,14,1036,7,30,280248,30,406,7,62,280248,62,630
0.033,17,2,172,1,50,0,50,78,1,66,0,66,94
1788.482,17,87,3648,86,14,21040,14,3612,1,8,0,8,36
1786.438,6,102,8228,68,64,26663,64,4896,34,58,54130,58,3332
0.957,17,4,317,2,39,956,39,134,2,63,942,72,183
30.532,6,12,5535,4,112,10173,112,280,8,985,4360,1420,5255
1739.54,1,56,4704,0,0,0,0,0,56,56,31628,56,4704
37.816,17,44,6468,22,48,1800,48,1672,22,190,1800,308,4796
1784.973,6,102,8364,68,66,26641,66,4964,34,60,54087,60,3400
5.0,17,4,558,2,36,4991,36,128,2,187,4989,187,430
1745.185,6,95,7203,63,38,28148,205,4476,32,33,56289,98,2727
1796.296,17,449,39928,404,35,4457,288,25708,45,288,40020,288,14220
0.006,17,2,279,1,36,0,36,64,1,187,0,187,215
0.308,17,2,152,1,48,0,48,76,1,48,0,48,76
280.285,6,30,7432,13,158,23357,267,1317,17,543,17515,1300,6115
11.689,6,1838,1614811,1122,1385,10,1420,1581938,716,467,16,1883,32873
2.181,17,6,432,3,36,1070,36,192,3,52,22,52,240
0.367,6,21,5000,10,137,40,267,1092,11,577,33,1400,3908
5.873,6,17,3320,6,92,1174,92,400,11,463,513,1448,2920
1795.898,17,142,11360,71,48,25655,48,5396,71,56,25655,56,5964
126.382,2,3,96,3,8,63191,8,96,0,0,0,0,0
60.99,6,13,5586,4,106,20330,106,274,9,822,7560,1452,5312
176.071,17,4,288,2,36,176070,36,128,2,52,176071,52,160
739.64,1,4,224,4,28,246546,28,224,0,0,0,0,0
2.268,17,25,6401,10,261,252,1350,2890,15,206,111,1350,3511
1.423,6,24,8004,12,164,111,267,1288,12,1014,110,2491,6716
1774.736,6,180,15480,120,69,14913,69,8940,60,69,30073,69,6540
1783.479,6,355,22480,207,69,8657,69,12420,148,69,12132,69,10060
0.0,17,2,150,1,33,0,33,61,1,61,0,61,89
1792.758,1,68,5712,68,56,26757,56,5712,0,0,0,0,0
1679.562,1,8,448,8,28,239937,28,448,0,0,0,0,0
1.341,6,50,18834,29,854,47,1360,13173,21,437,58,2715,5661
5.072,17,4,304,4,48,1690,48,304,0,0,0,0,0
33.207,17,4,352,2,60,33205,60,176,2,60,33206,60,176
1748.879,1,80,6720,0,0,0,0,0,80,56,22137,56,6720
251.492,2,3,96,3,8,125746,8,96,0,0,0,0,0
2.319,6,11,3652,6,171,451,171,491,5,1446,574,2675,3161
71.089,6,32,7515,13,155,5924,267,1306,19,388,3949,1420,6209
1772.243,6,180,15480,120,69,14892,69,8940,60,69,30033,69,6540
249.153,17,14,1940,7,48,41524,48,532,7,173,41523,308,1408
10.943,6,1666,1495140,1058,1360,10,1420,1466421,608,475,18,1883,28719
280.201,6,28,7352,13,158,23350,267,1317,15,678,20010,3436,6035
1789.953,6,371,25948,213,99,8443,469,15074,158,69,11400,69,10874
0.479,17,3,451,2,39,86,39,134,1,289,0,289,317
4.885,17,5,320,5,36,1221,36,320,0,0,0,0,0
5.03,17,4,288,2,36,5002,36,128,2,52,5010,52,160
4.217,17,10,2459,5,40,1050,40,340,5,395,1051,423,2119
5.499,6,40,7325,21,218,274,314,3463,19,516,290,1179,3862
1771.418,6,102,9467,66,65,27252,65,5589,36,59,50609,59,3878
0.319,6,27,8963,13,237,26,590,1635,14,941,23,1408,7328
0.029,6,13,3514,7,75,4,75,447,6,1373,5,1448,3067
66.722,17,4,352,2,60,66721,60,176,2,60,66721,60,176
0.698,17,4,284,2,32,348,32,120,2,54,351,60,164
1792.51,6,357,22698,209,69,8617,69,12638,148,69,12193,69,10060
10.641,6,1715,1615362,1083,1414,9,1448,1577810,632,776,16,1448,37552
1.08,17,2,144,1,36,0,36,64,1,52,0,52,80
61.188,17,4,333,2,41,61139,45,138,2,69,61137,86,195
1680.998,1,14,784,14,28,129307,28,784,0,0,0,0,0
1746.851,6,97,7338,64,38,27727,205,4528,33,33,54576,98,2810
43.605,2,4,128,4,8,14535,8,128,0,0,0,0,0
5.987,6,1628,1512731,1031,1390,5,1408,1477023,597,931,9,2816,35708
1797.292,17,446,39832,401,35,4493,288,25612,45,288,40018,288,14220
1739.851,6,87,6322,58,31,30523,31,3915,29,31,62137,31,2407
1750.503,17,12,498,11,14,175050,14,462,1,8,0,8,36
0.425,17,2,778,2,361,425,361,778,0,0,0,0,0
1.518,6,29,8832,14,158,116,267,1357,15,858,105,2800,7475
1.459,17,18,8937,8,413,198,1350,3531,10,512,154,1350,5406
0.008,17,2,334,1,39,0,39,67,1,239,0,239,267
4.913,6,3,120,1,0,0,0,40,2,0,4783,0,80
1.356,6,47,18550,26,912,54,1440,12934,21,433,59,1440,5616
0.161,6,28,7336,14,155,12,267,1341,14,543,11,1400,5995
128.194,6,100,69418,60,1273,2172,1448,59165,40,679,2141,1448,10253
0.004,1,2,112,2,28,4,28,112,0,0,0,0,0
0.529,6,23,6390,13,309,43,884,2070,10,979,58,2840,4320
1335.336,6,19,1132,12,31,121394,31,666,7,31,222551,31,466
1795.808,17,448,39896,403,35,4467,288,25676,45,288,40020,288,14220
0.562,17,5,1692,5,310,140,355,1692,0,0,0,0,0
3.036,6,32,17600,20,143,159,253,1646,12,1702,275,4224,15954
31.912,6,9,396,2,0,3483,0,88,7,0,5303,0,308
126.308,1,10,840,10,56,14034,56,840,0,0,0,0,0
8.822,2,2,64,2,8,8822,8,64,0,0,0,0,0
1741.47,6,87,6322,58,31,30552,31,3915,29,31,62195,31,2407
0.05,6,2,92,1,0,0,0,40,1,0,0,0,52
5.0,17,4,288,2,36,4999,36,128,2,52,4998,52,160
1795.682,17,303,54124,303,150,5945,385,54124,0,0,0,0,0
6.354,6,1749,1740657,1162,1425,5,1448,1705469,587,776,10,1448,35188
28.455,6,6037,6726471,3344,303,8,303,214679,2693,2369,10,9814,6511792
0.013,6,9,1547,5,515,3,515,783,4,548,4,548,764
0.642,6,23,5370,13,113,52,162,976,10,798,69,1691,4394
1795.761,6,360,22999,207,69,8717,69,12420,153,67,11814,69,10579
1751.545,6,95,7203,63,38,28250,205,4476,32,33,56492,98,2727
1798.388,6,346,21982,200,69,9037,69,12071,146,69,12402,69,9911
0.08,6,9,1340,5,145,20,145,349,4,827,17,827,991
802.428,6,252,55898,115,379,7038,1360,31332,137,250,5898,1360,24566
0.308,6,27,8942,14,232,23,569,1666,13,941,25,1402,7276
0.026,17,2,446,1,38,0,38,66,1,352,0,352,380
0.164,6,47,20220,26,1007,6,1420,15159,21,420,7,1420,5061
3.861,17,4,1628,4,379,1287,379,1628,0,0,0,0,0
15.847,17,13,6557,7,613,2629,1350,4488,6,316,3154,1350,2069
1770.886,6,99,9108,66,63,27244,63,5511,33,57,55337,57,3597
274.515,17,4,304,2,48,274514,64,152,2,48,274514,64,152
5.184,6,16,1331,8,222,739,222,768,8,231,739,231,563
0.009,6,3,478,2,179,0,267,438,1,0,0,0,40
1.436,6,31,6467,15,164,102,267,1922,16,780,84,1460,4545
0.078,6,10,1510,5,657,19,657,925,5,317,19,317,585
173.111,6,34,2892,14,116,11818,375,1604,20,54,9111,143,1288
0.195,6,29,7376,14,155,15,267,1341,15,543,13,1400,6035
1789.194,1,267,28302,267,78,6726,78,28302,0,0,0,0,0
0.569,6,10,924,5,283,95,283,551,5,105,95,105,373
95.185,6,38,8441,12,137,2848,267,1452,26,297,3806,1460,6989
0.187,6,26,7256,13,155,15,267,1301,13,603,14,2800,5955
41.019,17,2,672,2,308,41019,308,672,0,0,0,0,0
1.371,6,44,15054,24,771,59,1360,9478,20,433,62,1360,5576
0.306,6,13,1182,7,146,49,146,430,6,254,59,506,752
0.499,6,6,248,4,0,166,0,164,2,0,259,0,84
13.37,17,4,352,2,48,13361,48,152,2,72,13361,72,200
0.362,6,27,8963,13,237,30,590,1635,14,941,25,1408,7328
1764.189,2,15,480,15,8,126013,8,480,0,0,0,0,0
164.818,17,8,2688,8,308,23545,308,2688,0,0,0,0,0
3.357,17,10,1472,5,40,835,40,340,5,198,835,216,1132
621.102,6,127,8047,73,69,8626,69,4438,54,69,11718,69,3609
1796.992,17,448,39896,403,35,4470,288,25676,45,288,40017,288,14220
3.403,6,2,88,2,0,0,0,88,0,0,0,0,0
2.834,6,26,13013,15,771,202,1360,6035,11,1087,265,1360,6978
1776.176,17,73,3060,72,14,25016,14,3024,1,8,0,8,36
1740.464,1,15,870,15,30,124318,30,870,0,0,0,0,0
0.341,17,7,2429,7,319,56,354,2429,0,0,0,0,0
1773.987,1,59,4956,0,0,0,0,0,59,56,30585,56,4956
14.208,6,1444,1308805,893,1387,15,1448,1275489,551,776,25,1448,33316
131.075,17,4,240,2,32,131073,32,120,2,32,131074,32,120
17.19,6,177,74759,97,726,179,1152,66395,80,396,214,1152,8364
0.31,6,3,120,2,0,310,0,80,1,0,0,0,40
1624.39,2,17,544,17,8,101524,8,544,0,0,0,0,0
8.912,6,20,4272,7,92,1485,92,464,13,284,726,1402,3808
215.473,1,3,365,3,93,107736,105,365,0,0,0,0,0
0.037,17,2,227,1,31,0,31,59,1,140,0,140,168
280.612,6,27,7403,12,158,25510,267,1277,15,690,20042,4200,6126
0.374,6,27,9090,13,262,31,690,1735,14,945,28,1408,7355
31.552,1,4,224,4,28,10517,28,224,0,0,0,0,0
1772.725,6,180,15480,120,69,14896,69,8940,60,69,30038,69,6540
1741.61,17,30,31680,30,1028,60055,1028,31680,0,0,0,0,0
37.441,17,11,836,11,48,3744,48,836,0,0,0,0,0
1787.534,6,104,8308,68,64,26679,64,4896,36,58,51070,58,3412
0.022,6,10,2046,6,739,4,1322,1723,4,159,7,159,323
1772.399,6,180,15480,120,69,14894,69,8940,60,69,30039,69,6540
1786.328,17,87,3648,86,14,21015,14,3612,1,8,0,8,36
1786.868,6,102,8364,68,66,26669,66,4964,34,60,54144,60,3400
0.016,6,7,9040,1,0,0,0,40,6,1448,0,1448,9000
20.683,6,24,5827,14,107,1591,159,1190,10,684,2296,1418,4637
92.007,6,75,51012,47,1187,2000,1408,42823,28,960,2283,3847,8189
11.864,6,25,8473,13,275,988,275,1078,12,986,854,1440,7395
4.069,17,4,240,4,32,1356,32,240,0,0,0,0,0
5.013,17,4,558,2,36,5003,36,128,2,187,5001,187,430
1796.878,17,448,39896,403,35,4469,288,25676,45,288,40022,288,14220
1796.966,17,336,25536,336,48,5364,48,25536,0,0,0,0,0
39.821,6,626,654188,399,146,100,228,21847,227,2782,45,25344,632341
10.477,6,2307,2269119,1562,1378,6,1408,2225715,745,931,13,2801,43404
0.015,17,2,350,1,33,0,33,61,1,261,0,261,289
0.325,17,2,290,1,40,0,40,68,1,194,0,194,222
1763.446,17,168,14066,156,30,11377,37,9090,12,386,154884,463,4976
1800.0,6,226,19682,83,78,21585,339,8847,143,70,12676,1062,10835
1786.813,6,104,8252,68,63,26668,64,4868,36,57,51048,58,3384
1795.972,17,142,11360,71,48,25656,48,5396,71,56,25656,56,5964
0.208,1,2,112,2,28,208,28,112,0,0,0,0,0
20.389,6,24,6232,14,117,1568,159,1337,10,727,2264,1418,4895
1205.951,17,236,17936,236,48,5131,48,17936,0,0,0,0,0
72.078,6,32,7584,13,155,6006,267,1306,19,393,4003,1997,6278
2.518,17,2,170,1,37,0,37,65,1,77,0,77,105
46.992,6,42,8776,20,367,531,787,2018,22,366,2231,2720,6758
124.79,6,34,7797,13,155,10399,267,1306,21,352,6239,1997,6491
0.328,6,20,7229,13,334,27,663,2021,7,1209,53,1906,5208
1783.81,6,364,25392,212,100,8454,469,14896,152,69,11813,69,10496
1786.945,6,102,8296,68,65,26670,65,4930,34,59,54144,59,3366
1.216,6,23,6000,12,108,110,147,919,11,927,103,1608,5081
240.355,6,43,8909,21,523,12017,1408,5809,22,216,11445,638,3100
1786.766,6,102,8364,68,66,26668,66,4964,34,60,54141,60,3400
1739.956,1,15,840,15,28,124282,28,840,0,0,0,0,0
1785.982,6,104,8149,68,42,26656,205,4932,36,37,51019,108,3217
280.262,6,29,7392,13,158,23355,267,1317,16,543,18683,1400,6075
61.353,6,37,15942,22,801,2921,1448,9163,15,665,4361,1448,6779
0.059,17,2,558,1,32,0,32,60,1,470,0,470,498
1773.067,6,182,15629,121,69,14775,69,9049,61,69,29548,69,6580
1.046,17,4,454,3,32,517,32,180,1,246,0,246,274
1781.776,6,369,23454,213,69,8404,69,13074,156,69,11494,69,10380
1777.01,1,58,4872,58,56,31175,56,4872,0,0,0,0,0
1.94,17,2,176,2,60,1940,60,176,0,0,0,0,0
0.325,6,3,168,1,0,0,0,52,2,0,325,0,116
240.797,6,58,17843,30,738,8302,1418,14865,28,188,8918,580,2978
0.897,17,4,918,2,40,886,40,136,2,363,884,363,782
1786.312,6,106,8456,68,65,26661,65,4930,38,59,48275,59,3526
395.283,6,110,15476,49,175,7788,469,6018,61,184,6587,1420,9458
1745.727,1,56,4704,0,0,0,0,0,56,56,31740,56,4704
119.241,6,12,1250,4,283,39747,283,511,8,105,1692,105,739
280.296,17,4,296,2,30,280282,30,116,2,62,280280,62,180
8.998,6,3,180,3,0,0,0,180,0,0,0,0,0
0.094,6,11,2017,7,324,15,585,1009,4,396,28,580,1008
344.835,6,81,17607,49,134,7184,517,5656,32,446,11121,2688,11951
182.419,6,27,6640,10,201,6491,516,1412,17,378,11383,2642,5228
1.241,6,8,342,4,0,413,0,164,4,7,275,7,178
10.56,6,96,34471,46,662,234,1152,28362,50,410,210,1152,6109
681.88,6,66,12159,31,184,22729,721,4939,35,363,12366,1440,7220
0.478,17,18,11331,8,638,68,1350,5328,10,572,49,1350,6003
158.135,6,23,8843,11,301,102,595,1376,12,871,14364,1460,7467
1794.446,17,144,11520,72,48,25273,48,5472,72,56,25273,56,6048
1789.882,1,120,12720,120,78,15041,78,12720,0,0,0,0,0
5.572,6,39,7269,21,218,278,314,3463,18,513,313,1179,3806
1795.935,2,27,864,27,8,69074,8,864,0,0,0,0,0
1794.288,1,58,4872,0,0,0,0,0,58,56,31478,56,4872
1.309,6,13,5851,4,189,433,267,547,9,822,162,1420,5304
0.112,17,2,588,1,39,0,39,67,1,493,0,493,521
1795.802,17,447,39864,402,35,4478,288,25644,45,288,40022,288,14220
5.441,17,4,288,2,36,5006,36,128,2,52,0,52,160
1772.429,6,180,15480,120,69,14894,69,8940,60,69,30037,69,6540
158.44,1,4,224,4,28,52813,28,224,0,0,0,0,0
64.848,6,24,6536,8,154,9264,267,792,16,566,4321,1420,5744
91.197,6,22,8993,11,524,83,1236,2046,11,927,9101,1460,6947
0.74,17,7,2375,7,311,123,355,2375,0,0,0,0,0
200.109,17,4,352,2,60,200108,60,176,2,60,200108,60,176
3.068,17,8,688,4,47,1020,47,300,4,69,1020,75,388
6.65,6,9,588,3,106,3320,106,234,6,90,1328,90,354
1768.139,1,58,4872,58,56,31019,56,4872,0,0,0,0,0
546.244,1,10,560,10,28,60693,28,560,0,0,0,0,0
0.064,6,12,3462,6,75,12,75,395,6,1373,12,1448,3067
300.336,6,44,29385,23,190,13651,444,1965,21,1645,12013,4206,27420
288.605,17,4,352,2,60,288604,60,176,2,60,288604,60,176
0.155,17,8,2758,8,316,22,355,2758,0,0,0,0,0
0.283,6,28,9140,13,252,23,647,1704,15,831,19,1408,7436
139.907,6,23,10009,12,531,62,1360,2637,11,1384,13976,3934,7372
125.238,6,33,7826,12,155,29,267,1266,21,357,6261,3417,6560
9.942,6,1583,1374485,958,1382,10,1420,1345264,625,467,15,1883,29221
53.051,17,4,240,2,32,53050,32,120,2,32,53049,32,120
5.95,6,39,7285,19,218,330,314,3383,20,516,299,1179,3902
0.116,6,9,1339,5,145,29,145,349,4,826,26,826,990
1784.023,17,137,10956,69,48,26235,48,5244,68,56,26627,56,5712
0.02,17,4,360,3,46,1,46,222,1,110,0,110,138
311.08,6,90,30928,45,594,7069,1418,11269,45,692,7069,1418,19659
3.213,17,4,304,2,48,3042,48,152,2,48,3042,48,152
1.162,6,202,153177,117,1328,10,1420,145486,85,427,13,1420,7691
0.185,6,6,716,3,302,89,302,458,3,102,88,102,258
39.467,17,4,352,2,60,39466,60,176,2,60,39466,60,176
1680.414,1,15,840,15,28,120029,28,840,0,0,0,0,0
1786.269,6,106,8584,68,66,26660,66,4964,38,60,48275,60,3620
1797.353,17,180,14040,180,50,10041,50,14040,0,0,0,0,0
229.671,17,4,352,2,60,229669,60,176,2,60,229670,60,176
1051.17,17,206,15656,206,48,5127,48,15656,0,0,0,0,0
0.417,6,26,8862,13,231,34,563,1608,13,938,33,1438,7254
34.269,17,10,760,10,48,3807,48,760,0,0,0,0,0
280.449,6,30,7773,14,158,21573,267,1357,16,641,18695,2045,6416
1786.146,6,369,25730,214,99,8385,469,15114,155,69,11598,69,10616
3.277,17,6,958,4,39,1007,39,268,2,317,725,345,690
0.368,6,3,120,2,0,368,0,80,1,0,0,0,40
2.776,6,57,21879,32,963,89,1460,15807,25,361,101,1460,6072
0.881,6,29,8524,15,222,53,540,1988,14,852,55,1360,6536
0.06,17,4,420,2,33,1,33,122,2,121,10,145,298
11.219,6,97,31086,50,582,228,1152,24724,47,447,237,1179,6362
1777.285,6,140,9394,74,26,24346,26,4464,66,59,27337,427,4930
5.262,6,71,25328,34,763,159,1440,14413,37,518,141,1440,10915
132.271,6,20,9181,11,514,83,1236,2014,9,1359,16512,3639,7167
0.38,6,21,7203,13,318,31,600,1958,8,964,51,1471,5245
1.404,6,39,9888,21,440,70,1360,4392,18,529,70,4075,5496
0.052,6,14,4334,7,111,8,111,483,7,869,8,1448,3851
0.476,6,16,5837,8,290,68,517,1005,8,1102,60,1408,4832
4.24,17,5,340,5,40,1060,40,340,0,0,0,0,0
0.17,6,46,20946,26,1061,6,1420,15925,20,467,8,1883,5021
1798.112,17,142,11360,71,48,25687,48,5396,71,56,25687,56,5964
0.033,17,2,308,1,34,0,34,62,1,218,0,218,246
1681.385,1,15,840,15,28,120098,28,840,0,0,0,0,0
4.177,1,5,420,5,56,1044,56,420,0,0,0,0,0
1682.643,17,14,1036,7,30,280431,30,406,7,62,280435,62,630
1783.786,17,81,3390,79,14,22866,14,3318,2,8,1783603,8,72
1.449,6,48,19649,27,922,55,1460,14033,21,433,63,1460,5616
1.486,6,50,18994,27,870,57,1360,13298,23,433,59,1360,5696
0.464,6,52,20055,28,913,17,1380,14853,24,383,17,1380,5202
280.04,6,30,7432,14,158,21541,267,1357,16,603,18666,2236,6075
141.942,6,31,7699,9,155,794,267,1146,22,333,6758,1460,6553
2.201,6,13,2311,8,188,314,245,700,5,1407,460,1407,1611
1.777,6,43,11535,24,547,77,1360,5954,19,437,88,2715,5581
60.856,6,15,1657,9,177,7607,177,1007,6,110,12126,110,650
1784.982,6,77,4056,39,26,46972,26,2054,38,26,48241,26,2002
1788.828,6,356,22520,208,69,8641,69,12460,148,69,12165,69,10060
4.0,17,37,20831,19,579,220,1350,11534,18,488,232,1350,9297
240.202,6,57,17781,29,736,8578,1402,14764,28,194,8896,580,3017
208.133,6,17,3305,6,94,2196,100,526,11,1165,20788,1179,2779
12.195,6,1827,1651587,1164,1366,10,1380,1619861,663,421,18,1923,31726
0.096,6,9,1339,5,145,24,145,349,4,826,29,826,990
1772.59,6,180,15480,120,69,14895,69,8940,60,69,30036,69,6540
0.911,6,50,13789,24,551,39,1429,4840,26,438,35,1460,8949
61.993,6,12,3044,6,92,12398,92,400,6,2328,12289,2328,2644
0.09,17,2,152,1,48,0,48,76,1,48,0,48,76
4.131,6,636,608770,429,1356,9,1368,593342,207,931,19,2736,15428
2.166,17,20,14353,12,971,196,1350,11998,8,266,304,1350,2355
1781.274,6,356,23003,202,69,8862,69,12220,154,69,11641,69,10783
2.182,6,24,8004,12,164,167,267,1288,12,1014,168,2331,6716
1769.063,6,97,7369,64,38,28080,205,4559,33,33,55270,98,2810
0.389,17,14,7750,7,747,64,1350,5425,7,304,45,1350,2325
931.41,6,49,3540,32,31,30045,31,2160,17,31,58211,31,1380
15.618,17,16,6565,8,479,2220,1350,4060,8,285,2218,1350,2505
1681.539,17,14,1036,7,30,280255,30,406,7,62,280254,62,630
1787.078,6,106,8456,68,65,26672,65,4930,38,59,48296,59,3526
0.009,17,2,366,1,32,0,32,60,1,278,0,278,306
3.934,17,10,1319,5,31,980,31,295,5,176,979,196,1024
1680.884,1,7,392,7,28,280147,28,392,0,0,0,0,0
1770.456,6,103,9448,66,65,27237,65,5577,37,59,49176,59,3871
142.946,6,24,6248,9,272,106,516,1180,15,372,10203,1452,5068
122.597,1,16,1696,16,78,8173,78,1696,0,0,0,0,0
7.26,6,1538,1448521,962,1428,7,1448,1413893,576,776,12,1448,34628
1796.071,6,142,10430,79,77,23026,208,6980,63,31,28964,31,3450
0.37,6,9,1098,5,309,92,309,513,4,421,107,421,585
65.988,6,30,16655,17,1014,4124,1448,9006,13,870,5485,1448,7649
0.142,17,2,672,2,308,142,308,672,0,0,0,0,0
1740.638,17,30,31680,30,1028,60022,1028,31680,0,0,0,0,0
1796.458,17,448,39896,403,35,4468,288,25676,45,288,40019,288,14220
1741.85,6,114,6867,64,40,27648,208,4092,50,31,35539,31,2775
1671.458,1,8,448,8,28,238779,28,448,0,0,0,0,0
1790.911,1,255,14280,255,28,7050,28,14280,0,0,0,0,0
3.242,17,4,1344,4,308,1080,308,1344,0,0,0,0,0
1786.295,6,82,4354,41,26,44656,26,2184,41,26,44656,26,2170
317.475,6,99,34072,57,506,5669,1360,23593,42,418,7739,3289,10479
0.704,6,38,11070,22,534,33,1188,7023,16,356,40,758,4047
4.969,17,4,288,2,36,4938,36,128,2,52,4936,52,160
5.042,17,3,208,2,36,5008,36,128,1,52,0,52,80
1782.291,17,83,3480,82,14,22003,14,3444,1,8,0,8,36
1742.915,6,96,7286,63,38,28111,205,4476,33,33,54458,98,2810
14.778,6,1860,1692596,1189,1372,12,1380,1658077,671,434,22,1380,34519
1785.858,6,375,26108,216,98,8306,469,15332,159,69,11302,69,10776
174.073,6,31,8912,14,158,13390,267,1357,17,687,10872,1781,7555
0.018,6,14,4308,7,85,2,85,457,7,869,2,1448,3851
2.449,17,5,5182,5,1008,612,1451,5182,0,0,0,0,0
0.265,6,3,128,2,0,265,0,84,1,0,0,0,44
1.6,6,48,18633,27,850,61,1360,13017,21,433,69,1360,5616
0.212,6,27,7296,14,155,16,267,1341,13,678,16,3436,5955
41.9,17,6,528,3,48,20939,48,228,3,72,20943,72,300
996.063,17,12,969,6,31,199209,37,355,6,74,199210,136,614
1.326,6,25,7938,14,319,102,602,2024,11,1066,127,1906,5914
0.103,6,9,1340,5,145,25,145,349,4,827,32,827,991
11.606,6,24,8413,13,275,967,275,1078,11,1147,839,2840,7335
240.196,6,53,15285,28,679,8895,1402,12391,25,198,10007,580,2894
8.187,17,3,1008,3,308,4093,308,1008,0,0,0,0,0
300.6,6,36,8486,19,315,16700,882,2053,17,478,529,2128,6433
999.149,6,233,13943,116,69,8688,69,6986,117,34,8613,48,6957
0.682,6,25,10201,14,522,52,1259,2183,11,1080,55,3614,8018
1.396,6,48,20259,27,966,53,1460,14643,21,433,60,1460,5616
240.343,6,42,8893,21,519,12016,1402,5776,21,252,12016,618,3117
97.881,6,41,10032,15,290,6991,1189,2644,26,288,3914,1420,7388
0.577,6,133,98043,70,131,8,232,3329,63,1617,9,5680,94714
1773.359,1,59,4956,0,0,0,0,0,59,56,30575,56,4956
0.173,6,40,14770,22,892,8,1420,9829,18,467,9,1883,4941
7.796,6,735,697610,499,1333,15,1368,680674,236,931,32,2841,16936
0.018,6,2,80,1,0,0,0,40,1,0,0,0,40
3.999,17,14,16719,7,1170,666,1350,8387,7,1162,369,1350,8332
1.01,17,19,7800,9,442,122,1350,4233,10,328,108,1350,3567
31.933,6,381,435222,133,132,241,318,7312,248,1700,129,4224,427910
1772.114,1,58,4872,58,56,31089,56,4872,0,0,0,0,0
1791.906,1,58,4872,58,56,31436,56,4872,0,0,0,0,0
1786.589,6,102,8296,68,65,26665,65,4930,34,59,54136,59,3366
630.074,2,5,160,5,8,157518,8,160,0,0,0,0,0
1786.573,6,3715,3668966,1206,129,1456,353,69858,2509,1425,712,5672,3599108
0.0,1,2,282,2,113,0,119,282,0,0,0,0,0
3.118,17,3,228,2,48,3048,48,152,1,48,0,48,76
0.081,17,3,660,2,46,3,46,148,1,484,0,484,512
4.223,17,5,290,5,30,1055,30,290,0,0,0,0,0
0.363,6,125,119852,87,194,4,230,5455,38,3122,8,11264,114397
15.136,17,16,5138,7,358,2516,1350,2707,9,242,1887,1350,2431
1793.826,17,144,11520,72,48,25265,48,5472,72,56,25265,56,6048
1779.719,6,104,8376,68,65,26562,65,4930,36,59,50846,59,3446
1782.724,17,138,11040,69,48,26216,48,5244,69,56,26216,56,5796
1.008,1,2,112,2,28,1008,28,112,0,0,0,0,0
26.581,6,44,13587,21,330,1329,721,3160,23,678,1185,1440,10427
0.021,6,10,1888,5,130,5,130,350,5,1326,5,1326,1538
0.397,17,14,6828,8,557,56,1350,4686,6,329,61,1350,2142
1794.238,1,242,13552,242,28,7444,28,13552,0,0,0,0,0
1.084,17,4,624,2,64,969,64,184,2,192,1017,192,440
7.966,6,17,2694,10,275,885,275,958,7,1440,996,1440,1736
0.123,17,2,144,1,36,0,36,64,1,52,0,52,80
126.002,6,16,3248,8,92,18000,92,504,8,387,17927,1448,2744
12.039,17,4,830,2,34,12033,34,124,2,325,12032,325,706
1700.154,6,24,3624,16,241,113343,241,2568,8,92,242854,92,1056
1772.932,6,180,15480,120,69,14898,69,8940,60,69,30042,69,6540
891.13,6,12,728,8,31,127304,31,444,4,31,297035,31,284
0.138,6,3,120,1,0,0,0,40,2,0,76,0,80
0.013,17,2,330,1,30,0,30,58,1,244,0,244,272
367.57,6,54,6865,26,109,14695,721,2672,28,152,13606,1448,4193
7.849,6,742,674644,477,1346,16,1368,656200,265,776,28,1473,18444
283.182,6,28,8237,11,181,28318,267,1168,17,532,17637,1400,7069
1.342,6,46,19552,27,921,51,1360,14016,19,529,64,4075,5536
1777.273,1,342,28728,342,56,5211,56,28728,0,0,0,0,0
1.349,6,55,13877,27,535,51,1301,4848,28,438,48,1460,9029
1.327,6,49,18604,27,845,51,1360,12948,22,476,54,2715,5656
6.718,17,2,154,1,33,0,33,61,1,65,0,65,93
349.957,6,135,101076,86,1272,4117,1408,89755,49,626,2054,2439,11321
1770.151,6,252,27975,99,166,18061,1360,17309,153,59,11645,224,10666
4.521,6,33,6129,17,206,282,314,2744,16,548,282,1179,3385
178.241,6,24,6246,9,271,115,515,1179,15,371,12724,1452,5067
1790.457,1,58,4872,0,0,0,0,0,58,56,31411,56,4872
280.42,6,29,7392,13,158,23368,267,1317,16,603,18692,2760,6075
0.916,17,2,176,2,60,916,60,176,0,0,0,0,0
74.91,6,19,780,9,0,6088,0,364,10,0,8322,0,416
6.5,6,46,8449,23,227,295,314,4102,23,489,281,1179,4347
23.216,6,22,9724,9,263,2902,722,1519,13,1075,1916,1408,8205
1790.725,6,356,22520,208,69,8650,69,12460,148,69,12179,69,10060
73.331,17,4,240,2,32,73330,32,120,2,32,73330,32,120
1795.109,6,356,22520,208,69,8672,69,12460,148,69,12211,69,10060
1740.803,17,29,30732,29,1031,62171,1064,30732,0,0,0,0,0
0.993,6,2,120,2,0,0,0,120,0,0,0,0,0
719.088,1,52,5512,52,78,14099,78,5512,0,0,0,0,0
20.29,6,19,2463,10,157,2254,517,1329,9,323,2528,499,1134
1742.584,6,95,7203,63,38,28106,205,4476,32,33,56202,98,2727
1789.126,17,144,11520,72,48,25198,48,5472,72,56,25198,56,6048
100.399,6,39,8762,16,410,2071,917,1904,23,348,4557,3488,6858
1798.146,17,144,11520,72,48,25325,48,5472,72,56,25325,56,6048
1779.95,6,355,22549,207,69,8640,69,12420,148,69,12108,69,10129
1783.317,17,369,103823,369,253,4845,422,103823,0,0,0,0,0
57.407,6,6,332,3,0,28701,0,172,3,0,27018,0,160
1783.86,6,356,22520,208,69,8617,69,12460,148,69,12135,69,10060
1796.858,6,360,22818,209,69,8638,69,12569,151,69,11978,69,10249
1794.565,17,140,11200,70,48,26008,48,5320,70,56,26008,56,5880
6.799,6,1683,1411696,919,1439,7,1448,1360944,764,776,8,1448,50752
366.147,6,21,1419,15,177,26153,177,989,6,110,12231,110,430
3.34,17,4,1556,4,361,1113,361,1556,0,0,0,0,0
52.735,2,2,64,2,8,52735,8,64,0,0,0,0,0
11.828,6,1761,1613785,1113,1372,10,1408,1575425,648,931,17,2801,38360
0.062,17,2,702,2,323,62,329,702,0,0,0,0,0
3.724,17,2,656,2,300,3724,300,656,0,0,0,0,0
1744.659,2,25,800,25,8,72694,8,800,0,0,0,0,0
0.238,6,24,7659,12,176,21,334,1339,12,948,20,1438,6320
19.323,6,2968,2788406,1872,1409,10,1448,2726750,1096,776,17,1448,61656
1.278,6,48,19844,28,872,47,1360,14268,20,433,58,1360,5576
11.539,6,1837,1590964,1124,1363,10,1380,1556279,713,558,16,1923,34685
0.002,6,2,442,1,362,0,362,402,1,0,0,0,40
178.701,6,15235,15835100,5118,813,34,1448,294877,10117,1487,17,8688,15540223
601.616,2,5,160,5,8,150404,8,160,0,0,0,0,0
0.086,17,2,166,1,39,0,39,67,1,71,0,71,99
1739.352,6,87,6322,58,31,30514,31,3915,29,31,62119,31,2407
12.051,17,20,1440,10,33,1338,33,610,10,55,1338,61,830
112.5,6,7,426,2,106,112490,106,194,5,0,28122,0,232
250.175,17,3,991,3,302,125087,323,991,0,0,0,0,0
0.099,17,2,290,1,40,0,40,68,1,194,0,194,222
55.663,17,4,304,4,48,18554,48,304,0,0,0,0,0
6.215,6,1465,1363250,933,1384,6,1408,1330922,532,776,11,1408,32328
8.657,6,40,7666,22,218,412,314,3503,18,491,438,1179,4163
35.283,6,4820,4653209,3228,1365,10,1408,4565761,1592,776,22,1408,87448
190.643,6,65,12531,26,312,5066,1189,4480,39,281,5016,1420,8051
11.687,6,26,10944,10,353,1298,721,1818,16,771,649,1420,9126
1785.468,6,415,24880,207,69,8667,69,12420,208,34,8625,48,12460
1772.458,6,180,15480,120,69,14894,69,8940,60,69,30040,69,6540
81.004,6,122,93452,78,1273,1052,1408,83039,44,811,1748,3847,10413
1767.325,1,54,4536,54,56,33345,56,4536,0,0,0,0,0
1740.49,6,87,6322,58,31,30534,31,3915,29,31,62158,31,2407
1.39,6,46,18937,26,945,55,1460,13361,20,476,63,2615,5576
1795.42,17,447,39864,402,35,4477,288,25644,45,288,40019,288,14220
12.775,2,2,64,2,8,12775,8,64,0,0,0,0,0
1763.563,17,170,14464,157,30,11304,37,9155,13,380,141984,463,5309
0.324,17,8,2758,8,316,46,355,2758,0,0,0,0,0
4.709,6,37,7189,19,218,261,314,3383,18,513,261,1179,3806
1791.942,6,374,23654,214,69,8412,69,13114,160,69,11269,69,10540
240.216,6,56,20462,30,842,8283,1408,17566,26,192,9608,580,2896
35.888,6,24,3409,12,180,3262,595,1712,12,266,3227,580,1697
1789.164,17,83,3480,82,14,22088,14,3444,1,8,0,8,36
1.329,6,49,21362,29,912,47,1360,15786,20,529,60,4075,5576
141.262,6,73,48845,45,1196,3210,1408,40656,28,840,2281,2439,8189
1.15,6,25,5609,13,140,95,267,1224,12,650,98,1420,4385
1740.269,6,87,6322,58,31,30531,31,3915,29,31,62152,31,2407
1795.19,17,448,39384,403,35,4465,288,25412,45,282,40020,288,13972
240.232,6,57,18683,29,791,8579,1418,15755,28,183,8897,580,2928
2.957,17,2,778,2,361,2957,361,778,0,0,0,0,0
0.357,6,4,1037,2,0,221,0,104,2,853,138,853,933
29.08,6,41,9461,21,321,1454,721,3098,20,616,1476,1440,6363
11.29,6,23,9462,12,275,1026,275,763,11,1178,1089,1440,8699
0.057,17,4,284,2,32,53,32,120,2,54,52,60,164
136.178,6,27,9992,11,487,81,1448,2528,16,1104,9066,1448,7464
1798.312,17,445,38664,402,34,4484,288,25076,43,288,41923,288,13588
158.614,17,62,16058,62,231,2600,388,16058,0,0,0,0,0
1670.79,1,8,848,8,78,238684,78,848,0,0,0,0,0
30.505,17,18,1584,9,48,3811,48,684,9,72,3811,72,900
1740.583,17,30,20190,30,645,60020,645,20190,0,0,0,0,0
204.145,17,4,352,2,60,204143,60,176,2,60,204144,60,176
618.045,6,76,14255,32,133,19936,615,3990,44,257,14362,1629,10265
212.8,17,4,352,2,60,212798,60,176,2,60,212799,60,176
1771.949,6,99,9174,66,64,27260,64,5544,33,58,55370,58,3630
280.46,17,4,296,2,30,280444,30,116,2,62,280444,62,180
16.549,17,17,9126,9,750,2063,1350,7006,8,237,2352,1350,2120
1.806,17,3,696,3,204,903,204,696,0,0,0,0,0
240.253,6,53,15252,28,680,8897,1418,12359,25,198,10008,580,2893
0.321,6,24,7678,12,178,29,340,1345,12,1140,26,1648,6333
1017.496,17,26,8784,26,309,40699,376,8784,0,0,0,0,0
0.034,17,2,152,1,48,0,48,76,1,48,0,48,76
0.014,17,2,468,1,41,0,41,69,1,371,0,371,399
134.361,17,4,352,2,60,134359,60,176,2,60,134360,60,176
0.645,6,213,258971,94,183,6,230,5445,119,2113,3,8448,253526
1774.379,17,134,10720,67,48,26884,48,5092,67,56,26884,56,5628
1.026,17,20,5190,20,231,54,389,5190,0,0,0,0,0
1785.398,6,142,21794,87,199,20760,1285,11876,55,171,33061,1420,9918
1787.363,6,104,8444,68,66,26677,66,4964,36,60,51064,60,3480
15.52,17,4,4400,4,1072,5173,1072,4400,0,0,0,0,0
5.96,17,12,2539,6,45,1189,45,438,6,322,1184,339,2101
2.181,6,55,14329,26,464,87,1429,5236,29,438,77,1460,9093
84.989,17,4,240,2,32,84988,32,120,2,32,84988,32,120
187.123,17,4,352,2,60,187122,60,176,2,60,187122,60,176
1.292,6,23,7952,12,164,99,267,1288,11,1216,110,3779,6664
468.292,6,68,22240,18,600,8840,1360,9171,50,332,9554,1360,13069
1745.564,6,95,7203,63,38,28154,205,4476,32,33,56300,98,2727
5.003,17,4,288,2,36,5001,36,128,2,52,5002,52,160
5.013,17,4,288,2,36,4997,36,128,2,52,4996,52,160
0.017,17,2,1152,1,548,0,548,576,1,548,0,548,576
5.01,17,4,558,2,36,5002,36,128,2,187,5006,187,430
1793.601,6,121,11119,81,78,22420,138,6828,40,69,27096,69,4291
1787.34,6,104,8376,68,65,26676,65,4930,36,59,51062,59,3446
1799.709,1,345,28980,345,56,5231,56,28980,0,0,0,0,0
10.942,6,82,24501,42,550,266,1152,18760,40,459,273,1179,5741
0.362,1,2,112,2,28,362,28,112,0,0,0,0,0
14.704,6,123,44292,63,658,237,1152,37410,60,447,244,1179,6882
117.891,6,93,68431,59,1259,2032,1448,58503,34,679,3557,1448,9928
180.509,6,27,6850,15,238,12893,517,1969,12,472,16400,1408,4881
1.016,17,2,120,2,32,1016,32,120,0,0,0,0,0
0.009,17,2,417,1,34,0,34,62,1,327,0,327,355
120.089,6,56,34187,31,1167,3998,1448,27298,25,466,4998,1559,6889
1681.156,17,14,3843,7,30,280191,30,406,7,463,280192,463,3437
0.048,17,2,180,1,30,0,30,58,1,94,0,94,122
1.45,6,47,19017,26,948,58,1460,13401,21,433,63,1460,5616
1746.836,6,95,7203,63,38,28174,205,4476,32,33,56339,98,2727
1780.149,6,136,8389,73,27,24723,27,4432,63,27,28711,27,3957
2.93,17,3,264,3,60,1465,60,264,0,0,0,0,0
0.072,6,10,1514,5,503,18,503,771,5,475,18,475,743
0.02,17,2,179,1,43,0,43,71,1,80,0,80,108
1771.138,6,98,7421,65,38,27674,205,4611,33,33,55334,98,2810
892.122,2,8,256,8,8,127446,8,256,0,0,0,0,0
47.283,17,26,2288,13,48,3939,48,988,13,72,3939,72,1300
1787.003,6,104,8376,68,65,26671,65,4930,36,59,51053,59,3446
0.291,17,2,180,1,30,0,30,58,1,94,0,94,122
65.813,6,25,12723,15,955,4700,1408,7479,10,943,7292,1698,5244
0.122,1,10,840,10,56,13,56,840,0,0,0,0,0
0.157,6,10,1671,6,552,31,948,1348,4,159,38,159,323
1.675,6,57,24118,32,998,54,1460,18297,25,400,62,1460,5821
0.169,6,2,92,1,0,0,0,52,1,0,0,0,40
1780.068,6,354,22440,207,69,8641,69,12420,147,69,12192,69,10020
8.383,6,3,156,2,0,8383,0,104,1,0,0,0,52
188.804,17,4,240,2,32,188803,32,120,2,32,188803,32,120
1323.537,2,14,448,14,8,101810,8,448,0,0,0,0,0
75.321,6,21,860,10,0,6079,0,404,11,0,7531,0,456
1773.014,6,204,22330,130,75,13744,267,10057,74,132,24281,1452,12273
240.324,6,42,8860,21,523,12015,1418,5815,21,243,12015,619,3045
1.383,6,24,8004,12,164,107,267,1288,12,1014,107,2491,6716
240.159,6,54,18456,29,813,8577,1408,15348,25,225,10006,580,3108
1794.682,17,144,11520,72,48,25277,48,5472,72,56,25277,56,6048
299.549,6,7,404,4,31,99849,31,222,3,31,149768,31,182
20.124,6,21,4527,11,211,2012,722,1623,10,793,2194,1448,2904
725.661,6,188,22962,86,258,8487,1460,16132,102,50,7183,224,6830
240.487,6,43,8841,21,522,12020,1418,5803,22,209,11450,640,3038
1622.143,6,211,17866,79,73,20794,301,7838,132,70,12382,1062,10028
240.199,6,54,19706,29,843,8578,1418,16698,25,212,10007,580,3008
0.014,17,2,672,2,308,14,308,672,0,0,0,0,0
1748.803,6,95,7203,63,38,28206,205,4476,32,33,56404,98,2727
0.675,6,3,189,1,0,0,0,40,2,69,543,69,149
1798.162,17,448,39896,403,35,4473,288,25676,45,288,40017,288,14220
28.756,6,20,3130,12,183,2614,517,1561,8,381,4106,499,1569
11.261,6,2,1175,1,0,0,0,40,1,1095,0,1095,1135
0.305,6,22,7333,12,334,27,663,1969,10,806,33,1402,5364
0.512,1,2,689,2,316,512,327,689,0,0,0,0,0
1792.331,1,94,5264,94,28,19272,28,5264,0,0,0,0,0
1.289,6,38,8252,19,320,71,1162,2716,19,476,62,2715,5536
0.201,6,3,120,1,0,0,0,40,2,0,201,0,80
1.483,17,6,990,3,30,735,30,174,3,244,735,244,816
0.391,17,2,198,1,39,0,39,67,1,103,0,103,131
1.86,17,25,6203,11,269,182,1350,3269,14,181,140,1350,2934
21.659,6,21,5742,10,275,2406,275,962,11,1440,1609,1440,4780
178.579,6,22,8174,11,520,87,1223,2034,11,812,17839,1440,6140
1.409,6,39,8407,19,339,78,1277,2831,20,433,64,1460,5576
0.108,6,10,583,5,43,27,43,311,5,0,26,0,272
4.19,6,37,7189,19,218,232,314,3383,18,513,231,1179,3806
56.374,6,13,772,4,106,18789,106,274,9,90,7046,90,498
1738.317,1,56,4704,56,56,31605,56,4704,0,0,0,0,0
1782.886,6,130,15213,81,84,22286,516,6610,49,150,37141,1420,8603
1799.723,17,449,39928,404,35,4465,288,25708,45,288,40025,288,14220
1740.7,17,29,30624,29,1028,62167,1028,30624,0,0,0,0,0
1740.533,17,29,6815,29,207,62161,207,6815,0,0,0,0,0
13.761,6,18,2510,12,210,1250,210,1112,6,545,2741,904,1398
0.504,17,2,148,1,32,0,32,60,1,60,0,60,88
5.019,17,4,530,2,36,5007,36,128,2,173,5009,187,402
3.012,17,4,824,2,33,3004,33,122,2,323,2883,323,702
180.585,2,4,128,4,8,60195,8,128,0,0,0,0,0
1796.406,17,449,39928,404,35,4457,288,25708,45,288,40019,288,14220
12.322,6,435,342552,241,1347,51,1368,326530,194,749,62,1368,16022
1770.662,6,102,9779,68,70,26427,234,5948,34,60,53653,83,3831
1795.647,17,448,39612,404,35,4455,288,25708,44,288,40952,288,13904
1787.373,6,104,8376,68,65,26677,65,4930,36,59,51064,59,3446
1787.546,6,104,8376,68,65,26679,65,4930,36,59,51069,59,3446
260.137,17,4,288,2,36,260105,36,128,2,52,260105,52,160
1764.974,6,110,7340,70,48,25579,208,4748,40,31,45245,31,2592
1796.682,17,142,11360,71,48,25666,48,5396,71,56,25666,56,5964
1793.336,17,144,11520,72,48,25258,48,5472,72,56,25258,56,6048
0.003,17,3,819,1,137,0,137,165,2,299,2,299,654
1.425,6,36,8174,19,321,79,1164,2718,17,529,77,4075,5456
302.293,6,67,38190,36,1216,8636,1448,29857,31,335,3830,1448,8333
75.749,6,30,7573,12,155,6886,267,1266,18,429,4455,3426,6307
140.4,17,33,5977,25,40,5850,41,1713,8,505,2284,505,4264
0.589,6,27,9198,14,232,45,769,1897,13,1100,45,2736,7301
265.571,6,82,12707,33,188,6672,1189,3778,49,210,5532,1420,8929
1747.189,6,101,7912,65,45,27299,205,4844,36,35,49913,98,3068
1266.654,17,14,1117,7,31,211100,37,413,7,72,211100,136,704
0.024,6,3,120,2,0,24,0,80,1,0,0,0,40
0.772,6,15,2638,8,288,96,288,640,7,568,99,853,1998
0.093,6,9,1339,5,145,23,145,349,4,826,27,826,990
2.667,6,22,5232,12,351,242,1382,2242,10,517,295,2434,2990
1783.36,6,428,74721,259,304,6912,304,54540,169,83,10615,83,20181
1.588,6,43,16022,25,791,66,1360,10526,18,476,81,2715,5496
75.375,6,74,46380,43,1192,1794,1408,38025,31,841,2052,2439,8355
1796.828,1,82,6888,82,56,22183,56,6888,0,0,0,0,0
1795.532,17,448,39896,403,35,4466,288,25676,45,288,40018,288,14220
15.209,1,21,2184,0,0,0,0,0,21,76,760,76,2184
39.372,6,13,876,5,92,9843,92,348,8,92,5589,92,528
64.112,6,30,10390,11,129,6411,267,1094,19,710,3557,1460,9296
1682.849,17,14,1036,7,30,280462,30,406,7,62,280466,62,630
1799.613,17,4142,198816,2071,20,869,20,99408,2071,20,869,20,99408
0.095,17,2,279,1,36,0,36,64,1,187,0,187,215
699.569,6,12,728,8,31,99938,31,444,4,31,233186,31,284
1681.357,17,13,534,11,14,168095,14,462,2,8,1681174,8,72
1181.691,17,537,58808,251,36,4433,288,16072,286,121,4110,308,42736
1781.022,6,353,22400,206,69,8687,69,12380,147,69,12198,69,10020
19.184,6,18,3214,10,411,2131,585,1774,8,334,2738,580,1440
1790.874,17,292,56880,292,166,6154,358,56880,0,0,0,0,0
7.437,6,983,852850,569,1416,12,1448,825514,414,776,17,1448,27336
1745.545,6,106,7973,67,38,26447,205,4715,39,32,45926,98,3258
0.079,17,2,212,1,46,0,46,74,1,110,0,110,138
1741.132,6,87,6322,58,31,30546,31,3915,29,31,62183,31,2407
0.119,17,2,396,1,39,0,39,67,1,301,0,301,329
0.495,17,3,451,2,39,492,39,134,1,289,0,289,317
15.399,6,26,5029,13,197,1283,314,2105,13,600,1253,1179,2924
225.077,17,4,352,2,60,225076,60,176,2,60,225076,60,176
1775.126,1,58,4872,0,0,0,0,0,58,56,31142,56,4872
309.955,6,20,2429,7,242,51658,517,1111,13,323,25829,499,1318
1798.69,17,449,39928,404,35,4463,288,25708,45,288,40019,288,14220
0.018,6,10,1514,5,503,4,503,771,5,475,4,475,743
91.584,6,875,443730,494,836,185,1152,423699,381,398,240,1152,20031
0.156,6,4,227,3,31,0,31,187,1,0,0,0,40
1798.345,17,449,39928,404,35,4462,288,25708,45,288,40014,288,14220
316.813,6,57,12478,30,141,10924,615,3660,27,482,12179,2720,8818
1745.299,6,96,7255,62,38,28611,205,4424,34,33,52877,98,2831
0.036,6,13,3980,7,88,6,88,388,6,1670,7,1880,3592
374.729,6,18,1242,14,180,28825,180,916,4,110,20067,110,326
1790.831,6,358,22738,210,69,8568,69,12678,148,69,12182,69,10060
1797.195,1,345,28980,345,56,5224,56,28980,0,0,0,0,0
9.579,6,84,24917,43,561,228,1152,19136,41,413,232,1152,5781
1629.571,1,7,392,7,28,271595,28,392,0,0,0,0,0
8.226,6,1413,1259353,870,1367,9,1408,1226453,543,931,14,2816,32900
89.932,1,4,224,4,28,29977,28,224,0,0,0,0,0
0.137,17,4,364,2,52,0,52,160,2,74,84,80,204
765.176,6,98,7276,38,64,20677,329,3447,60,47,12969,78,3829
0.088,17,2,245,1,32,0,32,60,1,157,0,157,185
184.303,6,137,189343,76,199,2457,227,4083,61,3264,3070,16060,185260
240.181,6,56,19347,30,778,8281,1408,16367,26,202,9607,580,2980
7.368,6,1531,1415192,941,1424,7,1448,1379848,590,776,12,1448,35344
1650.058,1,7,392,7,28,275009,28,392,0,0,0,0,0
11.646,6,1851,1604159,1133,1362,10,1380,1569094,718,558,16,1923,35065
374.697,6,18,1242,14,180,28822,180,916,4,110,20063,110,326
1.09,6,9,508,5,0,272,0,276,4,0,359,0,232
1780.195,6,362,22967,210,69,8517,69,12747,152,69,11789,69,10220
6.782,6,516,440718,317,1324,20,1368,425694,199,931,33,2736,15024
21.402,6,9,1929,7,241,3567,241,1726,2,61,5770,92,203
1787.117,6,102,8296,68,65,26673,65,4930,34,59,54151,59,3366
1745.815,6,94,7151,62,38,28619,205,4424,32,33,56307,98,2727
9.514,6,25,5798,15,158,662,370,1399,10,998,636,1691,4399
1741.015,6,87,6322,58,31,30544,31,3915,29,31,62178,31,2407
1799.904,6,358,22600,208,69,8695,69,12460,150,69,12079,69,10140
0.101,6,9,878,3,179,50,267,478,6,53,0,85,400
280.194,6,28,7352,13,158,23349,267,1317,15,678,20011,3436,6035
1796.482,17,449,39928,404,35,4457,288,25708,45,288,40019,288,14220
1694.249,1,7,392,7,28,282374,28,392,0,0,0,0,0
3.697,17,3,468,3,128,1848,128,468,0,0,0,0,0
373.734,6,25,1651,17,177,23358,177,1117,8,110,9253,110,534
14.947,6,1954,1757928,1152,1437,12,1448,1706944,802,776,18,1448,50984
1.273,6,50,18874,27,861,48,1360,13178,23,433,49,1360,5696
15.457,6,2699,2384513,1572,1425,9,1448,2311997,1127,776,13,1448,72516
1772.501,6,205,22439,130,75,13740,267,10057,75,132,23950,1460,12382
1758.34,6,92,6742,62,33,28825,96,4250,30,31,60543,33,2492
25.82,17,4,240,2,32,25819,32,120,2,32,25819,32,120
1800.0,17,144,11520,72,48,25352,48,5472,72,56,25352,56,6048
1735.572,1,8,848,8,78,247938,78,848,0,0,0,0,0
280.478,6,30,7432,13,158,23373,267,1317,17,543,17524,1400,6115
238.021,17,4,304,2,48,238020,64,152,2,48,238020,64,152
7.629,6,66,20542,35,556,224,1152,15875,31,489,245,1179,4667
6.272,6,1559,1271254,828,1434,7,1448,1220878,731,776,8,1448,50376
1705.139,1,8,448,8,28,243591,28,448,0,0,0,0,0
6.657,6,595,504614,361,1328,17,1368,487782,234,776,27,1473,16832
376.045,6,25,1654,17,180,23502,180,1120,8,110,9267,110,534
2.4,6,14,2351,8,188,342,245,700,6,703,424,1152,1651
1784.675,17,142,11360,71,48,25495,48,5396,71,56,25495,56,5964
1.763,6,51,18790,28,914,65,1460,13049,23,400,69,1460,5741
1783.065,6,106,8456,68,65,26612,65,4930,38,59,48186,59,3526
1.483,17,6,552,3,32,707,32,180,3,96,733,96,372
9.955,6,30,17578,18,708,585,1360,4294,12,1827,893,4887,13284
15.27,17,34,24819,20,937,802,1350,19301,14,366,1172,1350,5518
217.638,2,5,160,5,8,54409,8,160,0,0,0,0,0
1.996,6,27,8849,16,286,133,590,1502,11,862,177,1380,7347
1744.599,2,27,864,27,8,67099,8,864,0,0,0,0,0
1263.389,2,12,384,12,8,114853,8,384,0,0,0,0,0
261.144,1,5,1820,5,336,65286,336,1820,0,0,0,0,0
5.664,6,39,7269,20,218,298,314,3423,19,513,300,1179,3846
1796.831,1,345,28980,345,56,5223,56,28980,0,0,0,0,0
0.107,6,10,1380,5,145,26,145,349,5,827,21,827,1031
1740.304,6,87,6322,58,31,30531,31,3915,29,31,62151,31,2407
0.07,17,2,180,1,30,0,30,58,1,94,0,94,122
1797.339,17,142,11360,71,48,25676,48,5396,71,56,25676,56,5964
1740.679,17,30,31680,30,1028,60023,1028,31680,0,0,0,0,0
94.387,6,13,1079,12,43,8580,43,1019,1,0,0,0,60
98.385,17,8,2676,8,306,14055,314,2676,0,0,0,0,0
1786.725,6,4111,4237427,1404,127,1273,351,86023,2707,1522,660,4206,4151404
6.908,6,29,7464,12,155,628,267,1266,17,423,431,3417,6198
1780.325,1,342,28728,342,56,5220,56,28728,0,0,0,0,0
1772.233,6,180,15480,120,69,14892,69,8940,60,69,30031,69,6540
0.314,17,2,152,1,48,0,48,76,1,48,0,48,76
12.538,17,8,1176,4,48,4176,48,304,4,190,4176,308,872
1797.299,6,361,22858,210,69,8599,69,12678,151,69,11980,69,10180
0.011,17,2,586,1,32,0,32,60,1,498,0,498,526
9.497,6,1517,1318411,933,1359,10,1420,1290628,584,427,16,1420,27783
1680.365,1,15,840,15,28,120026,28,840,0,0,0,0,0
0.16,6,27,6583,13,126,13,517,1821,14,503,11,1509,4762
124.863,6,23,7999,10,100,586,100,516,13,991,10385,1152,7483
1790.637,6,356,22520,208,69,8650,69,12460,148,69,12180,69,10060
92.836,1,12,1248,0,0,0,0,0,12,76,8439,76,1248
0.261,17,4,334,2,39,243,39,134,2,72,245,72,200
1.633,6,25,8080,12,164,131,267,1312,13,869,119,1408,6768
241.172,6,46,5736,23,330,10962,999,2891,23,149,10962,455,2845
0.522,6,52,22121,28,1051,19,1380,16919,24,421,19,1923,5202
0.735,17,2,144,1,36,0,36,64,1,52,0,52,80
1.088,6,22,7900,11,164,92,267,1236,11,1216,92,3819,6664
369.543,6,19,1306,14,180,28426,180,928,5,110,15164,110,378
1769.643,17,49,16408,49,306,36867,308,16408,0,0,0,0,0
0.42,6,6,324,4,0,140,0,216,2,0,231,0,108
48.145,6,22,2242,11,444,4813,666,1332,11,231,4812,231,910
29.492,6,39,9450,18,269,1734,721,3153,21,544,1413,1420,6297
39.3,6,38,8419,18,371,510,797,1865,20,441,2061,1460,6554
462.129,2,9,288,9,8,57766,8,288,0,0,0,0,0
1775.968,1,208,22048,208,78,8579,78,22048,0,0,0,0,0
5.012,17,4,558,2,36,5007,36,128,2,187,5006,187,430
1795.469,17,448,39896,403,35,4466,288,25676,45,288,40015,288,14220
31.528,6,7,308,1,0,0,0,44,6,0,6286,0,264
1744.664,6,101,7515,63,38,28139,205,4476,38,33,47141,98,3039
953.528,6,66,4104,32,26,30758,26,1910,34,25,28893,26,2194
1710.885,1,64,6784,64,78,27156,78,6784,0,0,0,0,0
0.91,17,4,886,2,40,900,40,136,2,347,899,347,750
0.88,17,2,179,1,43,0,43,71,1,80,0,80,108
1719.467,17,12,498,11,14,171946,14,462,1,8,0,8,36
1746.614,17,360,59315,360,136,4865,391,59315,0,0,0,0,0
0.751,17,4,580,2,40,737,40,136,2,194,739,194,444
1795.474,17,80,3354,79,14,23018,14,3318,1,8,0,8,36
198.784,17,178,24506,150,40,1334,41,10286,28,479,2766,505,14220
7.278,6,1153,1090492,747,1384,9,1408,1064704,406,931,17,2816,25788
279.781,1,2,112,2,28,279781,28,112,0,0,0,0,0
1771.364,6,254,43441,135,262,13219,1034,25689,119,148,15010,625,17752
65.523,6,32,7358,11,156,734,267,926,21,371,3275,1420,6432
74.646,6,33,16582,19,606,140,832,4429,14,1158,5731,3928,12153
4.999,17,4,240,2,32,4999,32,120,2,32,4998,32,120
0.643,17,2,685,1,308,0,308,336,1,321,0,321,349
1777.088,17,140,11200,70,48,25754,48,5320,70,56,25754,56,5880
1740.584,2,23,736,23,8,79117,8,736,0,0,0,0,0
235.826,1,4,424,4,78,78608,78,424,0,0,0,0,0
1793.487,17,140,11184,72,48,25260,48,5472,68,56,26763,56,5712
1.339,6,53,22597,29,979,47,1440,16861,24,433,50,1440,5736
1786.349,6,154,19574,92,302,19630,302,13852,62,83,29284,83,5722
0.639,6,14,1745,7,288,74,288,600,7,426,74,434,1145
1772.597,6,180,15480,120,69,14895,69,8940,60,69,30039,69,6540
20.921,6,22,3982,12,210,1901,210,1286,10,545,2324,904,2696
248.5,6,78,21199,34,172,7530,267,3613,44,585,5776,1400,17586
72.707,17,10,760,10,48,8078,48,760,0,0,0,0,0
1744.423,6,97,7307,63,38,28135,205,4476,34,33,52851,98,2831
1789.506,6,368,25690,215,99,8362,469,15085,153,69,11772,69,10605
0.519,6,27,9140,13,268,43,710,1758,14,947,37,1368,7382
11.106,6,1329,1255816,872,1366,12,1408,1227388,457,776,23,1408,28428
332.654,6,20,1636,15,180,23761,180,1148,5,110,15102,110,488
1071.987,6,2230,1747628,1306,1331,821,1368,1678223,924,75,1161,303,69405
2.48,17,2,238,1,59,0,59,87,1,123,0,123,151
84.951,1,12,1272,12,78,7722,78,1272,0,0,0,0,0
688.037,17,19,6248,19,300,38224,308,6248,0,0,0,0,0
148.306,17,18,3236,9,48,18537,48,684,9,255,18536,308,2552
53.465,1,4,224,4,28,17821,28,224,0,0,0,0,0
1772.515,6,180,15480,120,69,14895,69,8940,60,69,30038,69,6540
1799.45,1,252,26712,252,78,7169,78,26712,0,0,0,0,0
1654.284,1,17,1712,17,72,103392,173,1712,0,0,0,0,0
1799.207,17,142,11360,71,48,25702,48,5396,71,56,25702,56,5964
1763.682,1,64,3584,64,28,27994,28,3584,0,0,0,0,0
1789.247,6,312,33994,159,160,11324,239,26789,153,31,11769,31,7205
5.187,6,7,400,3,0,2593,0,160,4,0,1015,0,240
178.251,6,8503,7987511,5620,1340,31,1368,7817339,2883,776,61,2736,170172
1.11,6,30,12083,16,525,74,1360,3310,14,820,64,1380,8773
1.296,6,50,19041,27,872,49,1360,13345,23,433,50,1360,5696
42.206,17,24,2112,12,48,3836,48,912,12,72,3835,72,1200
132.848,6,22,9783,12,410,49,922,1742,10,1271,14747,4416,8041
301.084,6,41,11859,22,574,14337,1448,4670,19,442,492,2246,7189
0.709,6,2,80,1,0,0,0,40,1,0,0,0,40
497.67,6,27,1962,18,31,29274,31,1215,9,31,62207,31,747
392.699,6,18,1242,14,180,30207,180,916,4,110,20070,110,326
1757.333,1,198,11088,198,28,8920,28,11088,0,0,0,0,0
0.421,6,92,75546,37,208,11,250,2998,55,1314,7,1440,72548
1.143,6,27,8591,14,283,73,625,2009,13,1008,78,1791,6582
0.008,17,2,220,1,34,0,34,62,1,130,0,130,158
2.929,6,12,1036,6,283,550,283,603,6,105,550,105,433
0.023,17,2,389,1,34,0,34,62,1,299,0,299,327
2.941,17,2,116,2,30,2941,30,116,0,0,0,0,0
0.821,17,2,412,1,33,0,33,61,1,323,0,323,351
240.238,6,57,20940,31,863,8007,1418,18017,26,195,9609,580,2923
122.099,6,23,9131,11,376,66,794,1601,12,879,11087,1440,7530
105.946,17,4,352,2,60,105945,60,176,2,60,105944,60,176
1798.367,1,265,14840,265,28,6811,28,14840,0,0,0,0,0
1742.326,6,95,7203,63,38,28102,205,4476,32,33,56194,98,2727
1791.819,1,94,9964,94,78,19266,78,9964,0,0,0,0,0
143.123,17,8,2688,8,308,20446,308,2688,0,0,0,0,0
1788.061,6,356,22520,208,69,8637,69,12460,148,69,12163,69,10060
62.228,6,29,7257,14,155,4786,267,1346,15,482,4444,1997,5911
1.452,6,38,9848,20,502,76,1440,4352,18,433,75,1440,5496
1.106,6,23,7952,12,164,85,267,1288,11,1216,94,3819,6664
0.23,17,2,572,1,39,0,39,67,1,477,0,477,505
1798.155,6,357,22629,208,69,8686,69,12460,149,69,12149,69,10169
234.381,6,50,7086,20,148,6775,722,2537,30,142,8075,1448,4549
1797.192,1,282,29892,282,78,6395,78,29892,0,0,0,0,0
240.188,6,43,5854,21,235,12009,833,2998,22,211,11437,712,2856
1785.505,6,105,8593,68,65,26649,65,4930,37,59,49594,59,3663
1788.203,6,105,8544,69,66,26297,66,5004,36,60,51082,60,3540
350.236,6,381,324657,253,1316,1389,1408,301540,128,587,1906,3847,23117
1.089,6,25,8068,12,164,84,267,1300,13,869,77,1408,6768
0.379,17,8,2774,8,318,54,357,2774,0,0,0,0,0
1.009,6,24,8663,14,264,77,700,1651,10,1100,90,2370,7012
1745.177,6,96,7255,62,38,28609,205,4424,34,33,52873,98,2831
1757.275,6,95,7203,63,38,28343,205,4476,32,33,56677,98,2727
666.373,17,169,15176,150,36,4472,288,9668,19,261,35508,288,5508
299.547,6,6,364,4,31,99849,31,222,2,31,299528,31,142
300.654,6,36,23976,21,724,15026,1360,5946,15,1741,21467,5440,18030
19.518,6,10,7165,4,92,6506,92,296,6,1310,3861,1408,6869
2.918,17,25,6265,10,257,324,1350,2852,15,199,114,1350,3413
301.377,6,104,78720,67,1340,4566,1440,72438,37,399,254,1440,6282
12.135,17,10,680,5,32,3032,32,300,5,48,3032,48,380
4.641,6,38,7229,19,218,257,314,3383,19,513,243,1179,3846
232.418,17,4,240,2,32,232417,32,120,2,32,232417,32,120
0.084,17,4,588,2,48,70,48,152,2,190,60,308,436
213.982,6,37,8257,11,141,6350,267,1295,26,268,8558,1452,6962
1787.247,6,122,14114,76,112,23829,1230,7220,46,126,39714,1420,6894
0.393,17,2,144,1,36,0,36,64,1,52,0,52,80
0.309,6,27,9093,13,261,25,683,1752,14,943,23,1408,7341
2.328,6,13,2311,8,188,332,245,700,5,1407,518,1407,1611
1786.618,1,67,5628,67,56,27069,56,5628,0,0,0,0,0
1.005,17,2,685,1,308,0,308,336,1,321,0,321,349
1771.253,6,99,9174,66,64,27250,64,5544,33,58,55349,58,3630
309.739,6,65,18686,39,628,8151,1460,12292,26,296,397,1460,6394
3.507,6,69,26745,35,964,103,1440,15987,34,521,100,1440,10758
0.955,6,31,13360,17,511,59,1360,3279,14,1056,59,2561,10081
1784.371,6,354,22440,207,69,8661,69,12420,147,69,12221,69,10020
1.189,6,24,8016,12,164,91,267,1300,12,1014,91,2411,6716
899.109,6,12,728,8,31,128444,31,444,4,31,299695,31,284
2.481,6,34,11490,16,289,165,669,2881,18,953,144,1438,8609
341.544,6,44,7799,31,155,11384,267,2250,13,836,28460,2045,5549
1.286,6,47,18907,27,872,49,1360,13331,20,433,58,1360,5576
22.402,6,3149,3001831,2032,1399,10,1440,2939083,1117,776,19,1440,62748
4.718,6,43,22269,25,942,196,1360,11407,18,1266,267,2720,10862
1782.302,6,368,25152,213,93,8407,469,14605,155,69,11572,69,10547
0.067,6,12,3705,6,171,12,171,491,6,964,12,1448,3214
1740.629,1,66,5544,66,56,26778,56,5544,0,0,0,0,0
1245.6,17,310,32922,136,137,9207,1350,22529,174,31,7198,60,10393
228.98,17,12,1056,6,48,45794,48,456,6,72,45793,72,600
300.654,6,36,8261,21,258,15032,688,1907,15,574,604,4848,6354
4.154,6,39,7269,20,218,218,314,3423,19,513,217,1179,3846
1778.325,17,140,11200,70,48,25772,48,5320,70,56,25772,56,5880
2.016,17,2,677,1,300,0,300,328,1,321,0,321,349
1773.126,1,58,4872,0,0,0,0,0,58,56,31107,56,4872
1770.881,6,104,9644,67,66,26831,66,5728,37,60,49188,60,3916
1.115,6,25,8080,12,164,86,267,1312,13,869,79,1408,6768
0.145,17,2,196,1,62,0,62,90,1,78,0,78,106
240.27,6,43,9168,21,524,12013,1402,5821,22,243,11441,618,3347
15.276,6,6,288,1,0,0,0,48,5,0,3816,0,240
1.26,6,8,342,4,0,420,0,164,4,7,304,7,178
7.915,2,2,64,2,8,7915,8,64,0,0,0,0,0
3.93,17,4,244,4,33,1310,33,244,0,0,0,0,0
1.827,17,3,451,2,39,1314,39,134,1,289,0,289,317
64.035,6,37,8400,18,378,516,786,1886,19,441,3549,1360,6514
238.311,2,3,96,3,8,119155,8,96,0,0,0,0,0
1779.617,17,140,11200,70,48,25791,48,5320,70,56,25791,56,5880
0.302,17,4,950,2,40,292,40,136,2,379,291,379,814
1784.608,6,124,14435,79,82,22879,516,6224,45,156,40556,1452,8211
3.814,6,32,6105,17,206,238,314,2744,15,551,253,1179,3361
0.823,6,20,5984,11,282,82,548,1292,9,721,92,1452,4692
10.822,6,45,9104,23,339,491,701,2029,22,386,496,1928,7075
7.182,6,25,7511,14,266,552,626,2067,11,968,714,1946,5444
31.39,6,7,336,1,0,0,0,48,6,0,6275,0,288
0.791,6,24,5755,13,158,64,370,1315,11,799,77,1460,4440
4.119,1,7,3609,7,487,686,548,3609,0,0,0,0,0
1782.643,6,354,22509,206,69,8695,69,12380,148,69,12126,69,10129
240.23,6,56,20273,30,825,8283,1418,17261,26,206,9608,580,3012
174.483,6,23,8812,12,532,105,1360,2654,11,951,17432,1360,6158
15.29,6,6,288,1,0,0,0,48,5,0,3820,0,240
1787.014,6,330,21273,191,69,9405,69,11573,139,69,12949,69,9700
1796.758,6,370,23425,213,69,8475,69,13005,157,69,11516,69,10420
1770.336,6,101,9410,66,66,27235,66,5610,35,60,52066,60,3800
1773.115,6,180,15480,120,69,14900,69,8940,60,69,30049,69,6540
19.257,17,29,5568,20,40,1013,41,1371,9,438,2154,505,4197
6.554,17,9,3309,9,339,819,361,3309,0,0,0,0,0
7.801,17,6,528,3,48,3895,48,228,3,72,3894,72,300
5.145,6,38,7229,19,218,285,314,3383,19,513,271,1179,3846
1796.436,17,142,11360,71,48,25663,48,5396,71,56,25663,56,5964
0.061,17,2,212,1,46,0,46,74,1,110,0,110,138
2.684,6,4,191,1,0,0,0,40,3,31,1342,31,151
7.588,6,13,2193,7,211,1264,211,794,6,545,1506,904,1399
139.724,17,4,352,2,60,139722,60,176,2,60,139723,60,176
1798.576,17,450,39960,405,35,4451,288,25740,45,288,40022,288,14220
215.955,17,4,604,4,123,71985,348,604,0,0,0,0,0
241.165,17,4,240,2,32,241164,32,120,2,32,241164,32,120
9.445,6,16,3911,9,275,1180,275,643,7,992,749,1440,3268
1787.533,6,111,10096,70,98,25906,1249,6259,41,62,44681,191,3837
1785.426,17,87,3648,86,14,21005,14,3612,1,8,0,8,36
1.578,17,2,144,1,36,0,36,64,1,52,0,52,80
1729.162,6,62,4504,40,33,44337,33,2740,22,31,82333,31,1764
7.123,6,1391,1283024,882,1378,7,1408,1251892,509,776,13,1408,31132
1.905,6,51,18739,28,882,70,1460,12660,23,428,78,2615,6079
0.206,6,44,19938,25,1072,8,1432,14957,19,420,10,1432,4981
0.844,6,27,7296,13,155,70,267,1301,14,543,63,1400,5995
661.748,2,8,256,8,8,94535,8,256,0,0,0,0,0
5.057,6,41,7349,20,218,266,314,3423,21,440,238,1152,3926
10.977,6,19,4350,10,275,1219,275,958,9,755,769,1414,3392
15.839,6,8,559,1,0,0,0,40,7,31,733,31,519
240.196,6,54,18107,29,800,8578,1418,15130,25,208,10007,580,2977
0.544,6,23,7428,14,273,41,663,2104,9,1209,62,1946,5324
317.097,6,84,19452,44,327,7374,1460,10041,40,311,8125,1629,9411
1.322,6,28,6109,14,154,101,267,1644,14,780,88,1460,4465
320.035,6,24,1788,12,173,28970,173,978,12,83,29093,83,810
11.981,6,5,240,5,0,0,0,240,0,0,0,0,0
0.13,17,2,152,2,48,130,48,152,0,0,0,0,0
2.545,6,26,7960,13,275,208,517,1811,13,780,208,1408,6149
11.642,6,1854,1607279,1120,1379,10,1420,1573698,734,467,15,1883,33581
1786.642,6,105,8484,68,66,26666,66,4964,37,60,49626,60,3520
1787.146,6,104,8376,68,65,26673,65,4930,36,59,51058,59,3446
18.513,17,23,15191,13,970,1537,1350,12979,10,193,2045,1350,2212
1783.204,17,83,3480,82,14,22014,14,3444,1,8,0,8,36
8.195,6,18,6767,9,275,1024,275,643,9,1150,716,1414,6124
642.179,1,15,1791,15,91,45869,125,1791,0,0,0,0,0
10.942,6,2,1175,1,0,0,0,40,1,1095,0,1095,1135
0.321,17,2,152,1,48,0,48,76,1,48,0,48,76
256.01,6,272,216271,171,1305,1505,1368,199447,101,577,1907,2519,16824
0.062,17,2,152,1,48,0,48,76,1,48,0,48,76
84.298,6,33,7762,13,155,7024,267,1306,20,376,4426,3417,6456
1760.334,6,107,7694,66,31,27082,31,4579,41,31,44007,31,3115
0.966,6,28,8503,15,225,57,561,1985,13,997,66,2720,6518
3.424,17,5,340,5,40,856,40,340,0,0,0,0,0
1.665,6,72,54623,45,1284,37,1440,47314,27,842,57,1440,7309
27.554,6,38,8555,19,190,1530,721,2291,19,611,1519,2840,6264
1772.518,6,180,15480,120,69,14895,69,8940,60,69,30036,69,6540
0.189,17,2,170,1,37,0,37,65,1,77,0,77,105
15.066,6,21,8002,11,275,1506,275,727,10,1713,1562,2535,7275
1790.261,6,364,25392,212,100,8484,469,14896,152,69,11854,69,10496
1741.094,6,92,6687,61,31,29018,31,4164,31,31,58035,31,2523
1775.803,17,138,11040,69,48,26114,48,5244,69,56,26114,56,5796
355.094,1,14,784,14,28,27314,28,784,0,0,0,0,0
1.176,17,4,644,2,36,1171,36,128,2,230,1172,230,516
1330.174,6,134,11501,88,69,15289,69,6625,46,69,29558,69,4876
96.605,6,38,9573,11,155,873,267,1226,27,329,3715,1420,8347
1799.173,17,80,3354,79,14,23066,14,3318,1,8,0,8,36
1745.424,6,103,7619,63,38,28152,205,4476,40,33,44744,98,3143
1.325,6,48,20185,27,961,50,1460,14569,21,433,57,1460,5616
11.231,6,6,328,4,0,3743,0,216,2,0,11011,0,112
3.821,17,4,268,4,39,1273,39,268,0,0,0,0,0
9.196,6,84,25130,42,568,224,1152,19309,42,413,217,1152,5821
0.867,6,28,9274,16,203,57,458,1498,12,1040,63,3926,7776
1.038,17,3,1176,3,364,519,364,1176,0,0,0,0,0
38.797,17,11,836,11,48,3879,48,836,0,0,0,0,0
1772.7,6,181,15589,120,69,14896,69,8940,61,69,29543,69,6649
280.216,6,28,7352,12,158,25474,267,1277,16,603,18678,2036,6075
421.125,2,5,160,5,8,105281,8,160,0,0,0,0,0
240.204,6,52,18125,28,807,8896,1418,15186,24,240,10443,580,2939
1750.577,17,12,498,11,14,175057,14,462,1,8,0,8,36
270.254,17,4,356,2,29,270253,29,114,2,93,270240,93,242
1779.997,6,104,8444,68,66,26567,66,4964,36,60,50854,60,3480
1064.907,6,68,10227,43,104,19384,498,3812,25,235,44367,1420,6415
1780.202,17,140,11200,70,48,25799,48,5320,70,56,25799,56,5880
177.769,6,151,121459,100,1299,1795,1408,107875,51,682,3551,3847,13584
1745.382,6,95,7203,63,38,28151,205,4476,32,33,56291,98,2727
0.047,6,2,100,1,0,0,0,60,1,0,0,0,40
1.67,6,46,18694,27,860,64,1360,13158,19,476,81,2715,5536
74.972,6,29,15611,14,634,65,1360,3129,15,1318,5344,2568,12482
0.067,6,14,5023,8,133,9,159,835,6,967,12,1669,4188
33.548,6,31,5107,16,154,2236,722,1924,15,342,1111,2026,3183
62.85,17,4,352,2,60,62849,60,176,2,60,62849,60,176
240.26,6,60,18937,33,744,7507,1418,15889,27,181,9240,580,3048
0.125,6,23,15068,12,195,11,309,1218,11,1474,11,3655,13850
43.904,17,7,2352,7,308,7317,308,2352,0,0,0,0,0
0.035,6,2,92,1,0,0,0,40,1,0,0,0,52
0.013,17,2,366,1,36,0,36,64,1,274,0,274,302
245.164,6,35,2320,14,46,18858,46,1020,21,46,12251,46,1300
1789.135,6,4704,4364469,1911,121,936,332,115989,2793,1507,640,5632,4248480
2.493,17,4,610,3,39,976,39,201,1,381,0,381,409
374.296,6,8,475,6,31,74859,31,333,2,31,297870,31,142
14.985,6,24,6993,13,275,1248,275,1078,11,910,995,1440,5915
1.283,6,18,4942,11,193,127,358,1218,7,860,212,1420,3724
1798.229,1,274,15344,274,28,6586,28,15344,0,0,0,0,0
27.734,17,37,15271,17,613,1731,1350,10899,20,190,1458,1350,4372
1745.145,6,99,7442,64,38,27700,205,4528,35,33,51314,98,2914
1612.751,1,9,504,9,28,201593,28,504,0,0,0,0,0
11.763,6,1868,1622170,1145,1363,10,1380,1587085,723,558,16,1923,35085
73.098,6,3,864,3,248,36549,248,864,0,0,0,0,0
2.488,17,2,925,1,548,0,548,576,1,321,0,321,349
1800.0,6,212,16540,79,71,23076,330,7946,133,48,13636,78,8594
6.331,6,40,7325,21,218,316,314,3463,19,516,337,1179,3862
280.453,6,28,7352,13,158,23371,267,1317,15,775,20028,3465,6035
79.974,17,4,824,2,48,79967,48,152,2,308,79964,308,672
64.298,6,9,372,4,0,3904,0,164,5,0,16072,0,208
1740.827,6,87,6322,58,31,30540,31,3915,29,31,62172,31,2407
45.154,17,46,6644,23,48,2052,48,1748,23,184,2051,308,4896
0.877,17,2,312,2,128,877,128,312,0,0,0,0,0
1772.573,6,180,15480,120,69,14895,69,8940,60,69,30039,69,6540
19.29,6,11,785,4,177,6430,177,393,7,0,2902,0,392
39.949,17,22,1936,11,48,3993,48,836,11,72,3993,72,1100
33.339,6,30,7432,13,158,2778,267,1317,17,543,2083,1400,6115
0.18,6,46,20755,26,1048,7,1420,15734,20,467,9,1883,5021
0.522,6,6,324,4,0,174,0,216,2,0,227,0,108
2.494,17,52,37706,21,356,124,1350,8072,31,927,76,1350,29634
209.74,6,25,4458,8,407,18059,722,1238,17,333,13097,1408,3220
798.671,17,10,2594,5,31,199664,37,297,5,431,199664,463,2297
100.522,6,44,8976,21,401,753,889,2148,23,368,4563,3488,6828
23.271,6,34,8137,16,188,1551,721,1964,18,605,1358,1440,6173
41.506,6,43,8756,21,345,780,721,1968,22,368,1970,3488,6788
15.495,17,15,7408,7,505,2575,1350,3732,8,431,2157,1350,3676
14.598,6,34,7958,19,456,811,1418,5560,15,230,1041,580,2398
22.658,17,49,14527,24,410,983,1350,10535,25,131,942,1350,3992
1738.779,6,87,6322,58,31,30504,31,3915,29,31,62098,31,2407
11.904,6,83,24541,44,533,276,1152,18840,39,459,305,1179,5701
30.98,17,6,638,6,78,6196,84,638,0,0,0,0,0
2.537,6,32,9506,15,277,181,747,1904,17,743,156,1368,7602
1755.407,1,18,1981,18,82,103259,105,1981,0,0,0,0,0
2.373,17,3,329,2,39,2102,39,134,1,167,0,167,195
20.148,6,22,5629,12,115,1831,159,1221,10,773,2237,1408,4408
4.972,17,4,288,2,36,4971,36,128,2,52,4971,52,160
15.355,6,2669,2491962,1714,1375,8,1408,2437638,955,931,15,2801,54324
4.008,17,8,1936,4,39,1332,39,268,4,389,1305,477,1668
1786.887,6,367,23236,212,69,8468,69,12896,155,69,11603,69,10340
1798.965,1,132,7392,132,28,13732,28,7392,0,0,0,0,0
2.827,6,40,22613,24,763,122,1360,6423,16,1726,179,6191,16190
11.026,6,18,5610,10,275,1225,275,958,8,1440,863,1440,4652
1082.887,2,13,416,13,8,90240,8,416,0,0,0,0,0
300.605,6,108,101864,33,199,9393,517,2521,75,1363,3243,1408,99343
1.133,6,25,8056,13,164,80,267,1340,12,1014,87,2804,6716
1772.835,6,180,15480,120,69,14897,69,8940,60,69,30043,69,6540
1796.305,17,442,38852,400,35,4502,288,25580,42,288,42951,288,13272
1780.053,6,119,9596,74,66,24384,66,5336,45,60,40453,60,4260
1763.516,2,15,480,15,8,125965,8,480,0,0,0,0,0
1796.019,17,86,3606,85,14,21381,14,3570,1,8,0,8,36
20.684,6,26,4781,12,256,1880,722,1645,14,300,1487,1408,3136
142.942,6,25,10089,12,531,60,1360,2637,13,988,11900,1360,7452
23.247,6,37,8337,17,175,1452,721,2084,20,544,1212,1414,6253
368.308,6,18,1242,14,180,28331,180,916,4,110,20063,110,326
1740.944,6,92,6668,60,31,29507,31,4062,32,31,56159,31,2606
532.536,6,71,9489,35,92,15661,517,2889,36,313,15214,1418,6600
8.207,17,14,12844,4,708,1382,1350,2945,10,961,906,1350,9899
1795.924,1,60,5040,60,56,30439,56,5040,0,0,0,0,0
166.309,6,28,6562,11,220,6310,516,1325,17,325,10388,1452,5237
0.01,17,2,394,1,63,0,63,91,1,275,0,275,303
541.491,2,9,288,9,8,67686,8,288,0,0,0,0,0
1772.505,6,204,22330,131,75,13634,267,10097,73,134,24612,1997,12233
1509.402,6,203,17875,76,82,20123,338,8134,127,72,11978,1062,9741
458.401,17,68,5168,68,48,6841,48,5168,0,0,0,0,0
1792.918,17,86,3606,85,14,21344,14,3570,1,8,0,8,36
1768.969,1,58,4872,0,0,0,0,0,58,56,31034,56,4872
1772.756,6,180,15480,120,69,14897,69,8940,60,69,30046,69,6540
102.923,6,11,2994,6,92,20584,92,400,5,1165,25653,1408,2594
0.03,17,4,284,2,32,23,32,120,2,54,22,60,164
6.274,6,1106,906950,599,1416,10,1448,869894,507,776,12,1448,37056
0.343,6,10,1568,5,121,85,121,389,5,911,85,911,1179
0.297,17,2,218,1,65,0,65,93,1,97,0,97,125
575.176,1,65,24487,65,348,8987,374,24487,0,0,0,0,0
7.082,6,66,20478,34,554,214,1152,15771,32,427,220,1152,4707
118.703,6,24,10212,11,347,161,832,1860,13,977,9880,1360,8352
0.654,6,25,8091,14,334,50,663,2085,11,1082,61,1946,6006
72.342,6,22,3261,11,324,7234,585,1253,11,285,7232,580,2008
1782.895,17,73,3060,72,14,25111,14,3024,1,8,0,8,36
4.992,17,2,130,2,37,4992,37,130,0,0,0,0,0
237.294,17,4,1328,4,304,79098,308,1328,0,0,0,0,0
1783.213,6,192,20277,126,107,14265,1221,11835,66,87,27430,485,8442
0.606,6,7,371,3,0,303,0,152,4,7,122,7,219
71.975,6,36,10073,13,294,180,1189,2586,23,385,3266,1926,7487
1728.751,17,14,5665,14,376,132980,1444,5665,0,0,0,0,0
240.331,6,10,562,3,106,120161,106,234,7,0,40050,0,328
227.108,17,6,360,3,32,113553,32,180,3,32,113553,32,180
1785.568,6,365,23087,211,69,8502,69,12787,154,69,11670,69,10300
0.2,6,10,1514,5,503,50,503,771,5,475,50,475,743
1.235,6,6,248,4,0,411,0,164,2,0,200,0,84
645.314,6,12,728,8,31,92187,31,444,4,31,215100,31,284
0.859,6,20,5948,11,281,85,544,1288,9,716,96,1420,4660
152.382,17,4,352,2,60,152381,60,176,2,60,152381,60,176
275.069,1,20,1680,20,56,14477,56,1680,0,0,0,0,0
1785.86,6,356,22520,208,69,8627,69,12460,148,69,12148,69,10060
364.453,6,18,1242,14,180,28034,180,916,4,110,20055,110,326
57.047,6,48,13380,24,926,414,1360,7525,24,325,2472,1360,5855
3.903,17,4,368,4,64,1301,64,368,0,0,0,0,0
0.059,17,5,425,4,32,1,32,240,1,157,0,157,185
371.086,6,19,1303,14,177,28545,177,925,5,110,15164,110,378
1740.938,6,89,6426,58,31,30542,31,3915,31,31,58031,31,2511
1753.441,6,187,11425,94,47,18854,208,6806,93,31,19056,31,4619
1794.487,17,142,11360,71,48,25635,48,5396,71,56,25635,56,5964
1720.793,1,8,448,8,28,245827,28,448,0,0,0,0,0
7.987,6,14,2242,8,210,1140,210,844,6,545,1588,904,1398
1775.664,6,181,15589,120,69,14921,69,8940,61,69,29589,69,6649
1.612,6,49,18896,27,866,62,1360,13240,22,433,66,1360,5656
7.764,6,76,23433,38,573,209,1152,18145,38,470,202,1179,5288
43.732,17,7,2352,7,308,7288,308,2352,0,0,0,0,0
15.845,6,6,328,4,0,5281,0,216,2,0,15833,0,112
1.319,6,54,23928,30,997,45,1360,18192,24,476,49,2720,5736
1770.618,1,89,4984,89,28,20120,28,4984,0,0,0,0,0
280.055,6,29,7392,14,158,21542,267,1357,15,678,19999,3436,6035
605.831,6,441,407626,145,133,4207,332,9147,296,1413,2053,2804,398479
106.046,17,4,240,2,32,106045,32,120,2,32,106045,32,120
1751.349,17,12,498,11,14,175134,14,462,1,8,0,8,36
35.467,6,23,3376,14,210,2726,210,1822,9,545,4424,904,1554
1690.988,17,17,4017,17,208,105686,853,4017,0,0,0,0,0
54.607,6,15,1582,6,302,10921,302,912,9,83,6823,83,670
101.729,6,3380,3017139,2081,1365,48,1368,2939213,1299,899,78,1473,77926
1.173,6,23,7952,12,164,90,267,1288,11,1216,99,3819,6664
2.327,6,30,10406,18,367,136,833,1825,12,1012,203,1420,8581
1.419,6,38,8252,19,320,78,1162,2716,19,433,68,1460,5536
371.471,6,25,1651,17,177,23216,177,1117,8,110,9230,110,534
0.088,6,9,1348,5,145,22,145,349,4,835,26,835,999
1796.876,6,23,1385,15,31,128348,31,817,8,31,256694,31,568
61.416,6,18,3014,10,183,6823,517,1457,8,381,8772,499,1557
232.389,6,32,8952,14,158,17876,267,1357,18,624,13663,1400,7595
1748.952,6,94,6810,62,31,28671,31,4154,32,31,56405,31,2656
1.022,6,11,1727,7,100,170,100,384,4,589,234,1152,1343
0.385,6,10,968,5,256,92,256,460,5,304,92,304,508
11.835,6,25,8473,13,275,986,275,1078,12,986,857,1440,7395
132.488,17,8,1176,4,48,44160,48,304,4,190,44159,308,872
1786.607,6,106,8456,68,65,26665,65,4930,38,59,48284,59,3526
1.674,6,14,2351,8,188,239,245,700,6,703,285,1152,1651
15.66,6,6,280,2,0,15660,0,88,4,0,3766,0,192
1795.076,17,80,3354,79,14,23013,14,3318,1,8,0,8,36
252.577,2,2,64,2,8,252577,8,64,0,0,0,0,0
2.015,17,4,496,3,64,998,64,276,1,192,0,192,220
1752.693,1,141,7896,141,28,12519,28,7896,0,0,0,0,0
21.724,17,4,240,2,32,21723,32,120,2,32,21723,32,120
0.122,17,2,157,1,31,0,31,59,1,70,0,70,98
1798.084,17,749,45178,749,32,2403,37,45178,0,0,0,0,0
1788.211,1,342,28728,342,56,5244,56,28728,0,0,0,0,0
842.224,2,8,256,8,8,120317,8,256,0,0,0,0,0
273.432,6,80,38228,35,239,8042,950,5174,45,1180,6214,4224,33054
1779.776,6,191,16334,124,69,14469,69,9238,67,69,26958,69,7096
2.656,6,14,5731,9,290,332,517,1057,5,1468,471,2424,4674
0.328,6,9,1050,5,261,82,261,465,4,421,93,421,585
240.21,6,52,18130,27,820,9238,1402,15355,25,183,10008,580,2775
1781.101,17,142,11360,71,48,25444,48,5396,71,56,25444,56,5964
1.938,17,3,1167,3,361,969,361,1167,0,0,0,0,0
1774.121,6,180,15480,120,69,14908,69,8940,60,69,30068,69,6540
240.231,6,55,18172,30,750,8283,1418,15068,25,224,10009,580,3104
1679.384,1,47,4982,47,78,36508,78,4982,0,0,0,0,0
0.194,17,2,2386,2,1165,194,1165,2386,0,0,0,0,0
1788.911,6,357,22629,208,69,8642,69,12460,149,69,12086,69,10169
599.057,6,9,546,6,31,119811,31,333,3,31,299521,31,213
292.947,1,4,326,4,53,97649,78,326,0,0,0,0,0
2.83,17,4,1568,4,364,943,364,1568,0,0,0,0,0
1795.744,6,356,22520,208,69,8675,69,12460,148,69,12215,69,10060
1.1,6,23,7952,12,164,85,267,1288,11,1216,93,3825,6664
0.252,17,3,451,2,39,92,39,134,1,289,0,289,317
1794.992,17,448,39896,403,35,4465,288,25676,45,288,40014,288,14220
1726.314,17,304,63606,304,181,5697,422,63606,0,0,0,0,0
1781.963,6,131,14955,78,82,23142,516,6184,53,147,34266,1452,8771
1785.313,6,108,8536,68,65,26646,65,4930,40,59,45775,59,3606
984.18,6,73,9948,47,93,21395,500,3854,26,219,39363,1420,6094
1791.932,6,197,17653,100,124,18100,208,12719,97,31,18663,31,4934
1146.392,17,779,54582,710,40,1616,41,48747,69,56,553,57,5835
4.52,6,38,6453,19,112,251,267,1780,19,650,241,1420,4673
0.198,6,24,5962,13,164,16,453,1494,11,555,19,1542,4468
3.54,6,36,6249,18,206,208,314,2784,18,456,193,1152,3465
97.207,6,56,18164,31,469,3240,1152,12991,25,463,4040,1179,5173
1799.736,6,355,22480,207,69,8736,69,12420,148,69,12242,69,10060
3.262,6,2,88,2,0,0,0,88,0,0,0,0,0
0.03,17,2,206,1,44,0,44,72,1,106,0,106,134
1777.912,17,79,3312,78,14,23089,14,3276,1,8,0,8,36
8.872,6,78,24890,40,568,227,1152,19229,38,459,232,1179,5661
0.629,6,15,1785,8,288,77,288,640,7,426,75,434,1145
1797.232,6,354,22440,207,69,8724,69,12420,147,69,12309,69,10020
33.799,6,31,5094,15,154,2414,722,1859,16,342,2240,1408,3235
1798.969,17,449,39928,404,35,4463,288,25708,45,288,40017,288,14220
76.649,17,4,352,2,60,76648,60,176,2,60,76648,60,176
11.831,6,1733,1615751,1136,1373,10,1432,1587371,597,389,19,1432,28380
618.035,6,94,21603,42,300,15074,1360,10438,52,259,12115,1929,11165
0.947,6,23,6448,13,320,78,942,2128,10,979,104,1791,4320
1783.126,17,83,3480,82,14,22013,14,3444,1,8,0,8,36
1624.326,2,18,576,18,8,95548,8,576,0,0,0,0,0
280.18,6,29,7392,13,158,23348,267,1317,16,603,18677,2036,6075
1790.453,17,140,11200,70,48,25948,48,5320,70,56,25948,56,5880
1789.113,17,142,11360,71,48,25558,48,5396,71,56,25558,56,5964
0.025,17,2,412,1,48,0,48,76,1,308,0,308,336
1.51,6,49,19684,27,922,58,1360,14028,22,433,62,1360,5656
122.76,6,37,8700,18,144,7208,721,2310,19,625,6809,2840,6390
1.428,6,46,19049,26,953,57,1460,13473,20,476,64,2920,5576
0.891,17,2,154,1,33,0,33,61,1,65,0,65,93
280.161,6,29,7392,13,158,23346,267,1317,16,603,18676,2036,6075
1796.812,17,448,39612,404,35,4458,288,25708,44,288,40949,288,13904
0.634,17,8,2750,8,315,90,354,2750,0,0,0,0,0
1772.715,1,58,4872,58,56,31100,56,4872,0,0,0,0,0
5.42,6,39,7269,21,218,271,314,3463,18,513,303,1179,3806
134.273,6,23,10278,12,433,72,990,1859,11,1138,13414,2720,8419
6.719,6,67,21083,33,575,209,1152,16296,34,489,195,1179,4787
0.243,6,23,5910,13,164,20,453,1494,10,555,25,1542,4416
0.132,17,2,602,1,46,0,46,74,1,500,0,500,528
2.959,17,2,1430,2,687,2959,687,1430,0,0,0,0,0
4.396,6,38,7229,19,218,244,314,3383,19,513,229,1179,3846
10.763,6,18,5610,10,275,1195,275,958,8,1440,797,1440,4652
92.348,6,901,429355,472,844,196,1152,406349,429,389,215,1152,23006
1796.649,17,142,11360,71,48,25666,48,5396,71,56,25666,56,5964
6.529,17,12,13737,12,1116,593,1449,13737,0,0,0,0,0
1798.087,17,449,39928,404,35,4461,288,25708,45,288,40019,288,14220
12.875,6,21,5862,10,275,1430,275,958,11,890,1212,1420,4904
1788.482,17,83,3480,82,14,22080,14,3444,1,8,0,8,36
0.017,17,2,664,1,308,0,308,336,1,300,0,300,328
1776.958,17,73,3060,72,14,25027,14,3024,1,8,0,8,36
3.168,6,13,2311,7,188,528,245,660,6,1407,582,1407,1651
881.833,2,5,160,5,8,220458,8,160,0,0,0,0,0
11.958,6,1876,1653972,1144,1392,10,1414,1620471,732,420,16,1414,33501
3.879,6,49,15039,21,292,193,1162,2994,28,574,136,1440,12045
0.528,6,23,7428,14,273,40,663,2104,9,1209,61,1946,5324
1.934,6,20,3833,11,234,193,564,1504,9,463,220,1343,2329
1792.052,1,206,21836,206,78,8741,78,21836,0,0,0,0,0
539.787,17,10,3296,10,301,59976,308,3296,0,0,0,0,0
2.887,17,4,268,4,39,962,39,268,0,0,0,0,0
2.022,6,2,111,1,0,0,0,40,1,31,0,31,71
1797.098,17,142,11360,71,48,25672,48,5396,71,56,25672,56,5964
1756.225,1,71,5964,0,0,0,0,0,71,56,25088,56,5964
3.09,17,3,1167,3,361,1545,361,1167,0,0,0,0,0
2.663,17,4,518,3,39,850,39,201,1,289,0,289,317
1764.192,2,13,416,13,8,147016,8,416,0,0,0,0,0
280.453,6,28,7352,13,158,23371,267,1317,15,775,20028,4140,6035
1773.026,6,180,15480,120,69,14899,69,8940,60,69,30046,69,6540
4.757,6,37,7189,19,218,264,314,3383,18,513,264,1179,3806
4.086,17,5,290,5,30,1021,30,290,0,0,0,0,0
1798.34,6,373,26028,217,99,8325,469,15234,156,69,11601,69,10794
1745.869,6,94,7151,62,38,28620,205,4424,32,33,56306,98,2727
371.971,6,25,1651,17,177,23248,177,1117,8,110,9252,110,534
1764.392,2,16,512,16,8,117626,8,512,0,0,0,0,0
280.303,6,29,7392,13,158,23358,267,1317,16,603,18681,1400,6075
661.762,2,6,192,6,8,132352,8,192,0,0,0,0,0
1.346,6,38,8252,19,320,74,1162,2716,19,476,64,2715,5536
68.155,6,45,10411,23,736,516,1360,4684,22,402,3237,2667,5727
280.285,6,29,7392,13,158,23357,267,1317,16,603,18681,2036,6075
15.5,6,7,328,2,0,15500,0,88,5,0,3823,0,240
15.801,17,12,5203,6,490,3145,1350,3109,6,321,3145,1350,2094
840.903,17,8,592,4,30,280285,30,232,4,62,280278,62,360
252.166,2,2,64,2,8,252166,8,64,0,0,0,0,0
0.515,17,3,507,2,39,239,39,134,1,345,0,345,373
1799.697,17,180,14040,180,50,10054,50,14040,0,0,0,0,0
1.894,17,3,1173,3,363,947,363,1173,0,0,0,0,0
1723.102,1,74,7844,74,78,23604,78,7844,0,0,0,0,0
91.865,6,30,7432,13,158,7655,267,1317,17,543,5739,1400,6115
0.118,6,9,1340,5,145,29,145,349,4,827,34,827,991
1773.549,6,180,15480,120,69,14903,69,8940,60,69,30051,69,6540
1.695,6,26,8799,16,284,113,585,1497,10,985,168,1414,7302
0.012,6,14,4020,7,88,2,88,388,7,1113,2,1460,3632
1.305,6,46,18843,26,938,52,1460,13267,20,433,59,1460,5576
747.937,2,10,320,10,8,83104,8,320,0,0,0,0,0
280.151,6,27,7312,12,158,25468,267,1277,15,678,20010,2800,6035
0.029,17,2,904,2,424,29,548,904,0,0,0,0,0
0.321,6,26,8995,13,252,26,647,1692,13,1103,26,2816,7303
663.725,6,42,12504,24,455,28857,1360,5100,18,556,39031,2720,7404
114.863,6,32,8952,14,158,8835,267,1357,18,624,6752,1400,7595
755.838,2,4,128,4,8,251946,8,128,0,0,0,0,0
0.172,6,3,510,2,195,1,195,470,1,0,0,0,40
3.763,17,5,290,5,30,940,30,290,0,0,0,0,0
1763.7,17,44,14784,44,308,41016,308,14784,0,0,0,0,0
0.712,17,21,13711,12,905,61,1350,11205,9,250,84,1350,2506
3.794,17,5,295,5,31,948,31,295,0,0,0,0,0
1791.913,6,356,22520,208,69,8656,69,12460,148,69,12189,69,10060
1787.151,6,103,8268,68,64,26673,64,4896,35,58,52560,58,3372
1131.256,6,57,3483,28,31,41895,36,1518,29,234,40399,445,1965
177.134,6,25,11646,12,408,80,916,1761,13,1039,14748,1360,9885
0.126,17,4,420,2,33,0,33,122,2,121,0,145,298
1798.968,17,449,39928,404,35,4463,288,25708,45,288,40019,288,14220
1337.154,6,120,14711,68,82,19345,503,5542,52,161,26217,1420,9169
1323.559,2,10,320,10,8,147062,8,320,0,0,0,0,0
0.22,17,2,1920,2,932,220,932,1920,0,0,0,0,0
1798.366,17,87,3648,86,14,21157,14,3612,1,8,0,8,36
1740.604,17,29,30624,29,1028,62164,1028,30624,0,0,0,0,0
0.776,6,10,1687,7,100,129,100,384,3,1179,262,1179,1303
1773.264,6,181,15589,120,69,14901,69,8940,61,69,29553,69,6649
316.812,6,837,529603,459,1205,691,1360,488413,378,269,840,1929,41190
1.39,6,48,19309,27,898,53,1460,13693,21,529,60,4075,5616
20.247,6,19,2432,10,189,2249,517,1298,9,323,2524,499,1134
1799.997,6,205,14272,73,46,24593,46,5910,132,46,13740,46,8362
0.008,17,2,531,1,40,0,40,68,1,435,0,435,463
0.062,17,2,167,1,39,0,39,67,1,72,0,72,100
125.846,2,2,64,2,8,125846,8,64,0,0,0,0,0
240.27,6,54,17905,28,788,8897,1418,14863,26,210,9610,580,3042
6.631,6,553,476341,341,1334,18,1368,460641,212,776,30,1473,15700
1.332,6,37,8214,19,321,74,1164,2718,18,476,67,2715,5496
1799.825,6,128,12524,78,62,23374,721,6422,50,89,36726,1448,6102
5.168,6,13,1253,5,304,1292,304,572,8,83,571,83,681
137.104,17,4,1344,4,308,45701,308,1344,0,0,0,0,0
120.964,17,4,352,2,60,120963,60,176,2,60,120963,60,176
244.539,6,24,10927,12,165,22230,165,962,12,1166,22222,1368,9965
1.559,6,50,21403,28,973,57,1460,15747,22,433,65,1460,5656
12.529,6,94,27017,48,567,266,1152,20671,46,408,272,1152,6346
0.298,6,10,1090,5,261,74,261,465,5,421,62,421,625
2.128,6,14,2351,8,188,304,245,700,6,703,374,1152,1651
1.236,6,54,21470,31,902,41,1360,15729,23,437,48,2715,5741
170.485,6,41,18904,20,488,273,1460,3335,21,981,8500,1460,15569
12.12,6,88,26141,44,549,281,1152,19899,44,447,275,1179,6242
47.498,6,27,7177,13,155,3958,267,1306,14,530,3653,3417,5871
2.366,6,23,6489,10,268,257,517,1333,13,744,193,1418,5156
1793.123,17,174,11136,174,36,10364,36,11136,0,0,0,0,0
126.102,17,4,240,2,32,126101,32,120,2,32,126101,32,120
6.327,1,8,672,8,56,903,56,672,0,0,0,0,0
1618.773,2,17,544,17,8,101173,8,544,0,0,0,0,0
46.904,2,2,64,2,8,46904,8,64,0,0,0,0,0
3.269,6,11,467,6,0,653,0,248,5,7,751,7,219
37.651,6,26,6336,15,117,2689,159,1389,11,727,3763,1418,4947
1786.933,6,102,8364,68,66,26670,66,4964,34,60,54145,60,3400
8.502,6,79,24669,40,560,218,1152,18968,39,459,217,1179,5701
0.906,6,24,5755,14,158,69,370,1355,10,999,99,1737,4400
70.963,17,4,1344,4,308,23654,308,1344,0,0,0,0,0
373.396,6,18,1242,14,180,28722,180,916,4,110,20068,110,326
140.629,17,4,352,2,60,140628,60,176,2,60,140627,60,176
0.023,6,14,4044,8,88,3,88,452,6,1670,4,1880,3592
33.031,6,18,3378,11,210,3300,210,1024,7,664,5504,904,2354
0.15,17,2,162,1,36,0,36,64,1,70,0,70,98
280.256,6,29,7392,13,158,23354,267,1317,16,603,18681,2036,6075
1.51,6,10,1687,7,100,251,100,384,3,1179,624,1179,1303
1.484,6,7,487,3,138,681,138,258,4,34,492,48,229
1740.467,17,28,6580,28,207,64461,207,6580,0,0,0,0,0
1776.752,6,276,33602,111,141,16151,1460,16514,165,126,10833,1460,17088
280.239,6,29,7392,14,158,21556,267,1357,15,678,20011,3536,6035
256.295,17,4,240,2,32,256294,32,120,2,32,256294,32,120
41.631,6,5497,5054439,3336,1427,12,1448,4925435,2161,776,19,1448,129004
0.396,6,12,1653,6,288,74,288,548,6,426,43,434,1105
11.944,17,2,154,2,49,11944,49,154,0,0,0,0,0
24.469,6,34,8218,16,175,1631,721,2045,18,681,1427,1440,6173
168.254,6,22,9152,12,703,79,1360,3324,10,1354,18677,4473,5828
20.155,6,18,2368,10,189,2239,517,1298,8,323,2874,499,1070
300.474,6,42,26172,26,1117,12018,1440,20364,16,828,4095,1440,5808
1788.728,6,132,15635,84,90,21550,502,6883,48,155,38056,1420,8752
1.999,6,28,7335,15,158,142,370,1395,13,902,165,1420,5940
0.044,17,4,344,2,47,0,47,150,2,69,11,75,194
1.781,6,25,8759,15,284,127,585,1457,10,985,176,1414,7302
2.216,17,4,1635,4,380,738,392,1635,0,0,0,0,0
300.784,6,36,8192,20,241,15830,619,1798,16,522,574,3488,6394
1799.347,17,448,39896,403,35,4475,288,25676,45,288,40021,288,14220
89.547,6,21,8279,11,525,89,1237,2048,10,1163,9931,3151,6231
1.142,6,25,8080,12,164,88,267,1312,13,869,81,1408,6768
1141.243,2,7,224,7,8,190207,8,224,0,0,0,0,0
1274.067,17,102,8160,51,48,25481,48,3876,51,56,25481,56,4284
240.252,6,55,17107,28,753,8897,1418,14275,27,177,9239,580,2832
2.134,6,15,3636,7,150,355,174,584,8,681,286,1420,3052
0.132,17,2,588,1,39,0,39,67,1,493,0,493,521
1.097,6,23,7952,12,164,84,267,1288,11,1216,93,3819,6664
11.969,6,39,8291,18,247,704,335,3450,21,499,564,1179,4841
1786.07,6,100,7525,65,38,27907,205,4611,35,33,52522,98,2914
1741.709,6,99,7814,65,45,27214,205,4850,34,35,52770,98,2964
16.11,6,14,2242,8,210,2301,210,844,6,545,3220,904,1398
0.083,17,2,586,1,46,0,46,74,1,484,0,484,512
25.468,6,37,8347,18,360,510,734,1834,19,441,1407,1440,6513
10.101,1,9,756,9,56,1262,56,756,0,0,0,0,0
127.437,6,29,7392,13,158,10619,267,1317,16,603,8494,1400,6075
3.181,6,9,1339,5,145,795,145,349,4,826,1040,826,990
1780.213,17,84,3522,83,14,21709,14,3486,1,8,0,8,36
244.949,6,31,11858,18,442,14408,1440,4487,13,835,20368,1440,7371
0.1,17,2,166,1,39,0,39,67,1,71,0,71,99
5.383,17,29,20881,13,619,448,1350,8413,16,751,355,1350,12468
1.785,6,15,1291,8,222,253,222,772,7,231,295,231,519
43.293,6,36,9568,15,327,107,1189,2575,21,438,2163,1460,6993
0.103,6,9,1340,5,145,25,145,349,4,827,21,827,991
10.81,6,20,4442,11,275,1081,275,998,9,768,754,1440,3444
36.614,6,2240,1900114,1324,1374,27,1380,1854760,916,421,39,1923,45354
132.278,6,28,7352,13,158,11023,267,1317,15,678,9444,3456,6035
1558.238,1,7,392,7,28,259706,28,392,0,0,0,0,0
1785.615,6,104,8376,68,65,26650,65,4930,36,59,51014,59,3446
1789.153,17,216,53293,216,218,8321,422,53293,0,0,0,0,0
1564.155,2,16,512,16,8,104277,8,512,0,0,0,0,0
237.328,17,4,304,2,48,237311,48,152,2,48,237310,48,152
31.438,6,4,192,1,0,0,0,48,3,0,12073,0,144
0.695,6,14,2598,7,288,80,288,600,7,568,81,853,1998
4.117,6,565,455919,319,1406,12,1432,440410,246,363,16,1432,15509
1.298,17,3,1170,3,362,649,362,1170,0,0,0,0,0
368.952,6,27,1767,18,177,21703,177,1181,9,110,9138,110,586
10.957,6,1568,1422454,962,1399,11,1448,1386266,606,776,17,1448,36188
0.016,17,3,1007,1,137,0,137,165,2,393,16,393,842
0.111,17,2,152,1,48,0,48,76,1,48,0,48,76
10.456,6,16,5255,9,275,1307,275,643,7,1440,906,1440,4612
1797.533,17,448,39896,403,35,4471,288,25676,45,288,40020,288,14220
6.994,17,26,10535,11,329,699,1350,3934,15,412,391,1350,6601
1790.274,6,313,26663,185,126,9729,938,16506,128,69,14095,69,10157
1795.794,17,448,39896,403,35,4467,288,25676,45,288,40016,288,14220
0.012,17,2,427,1,36,0,36,64,1,335,0,335,363
0.248,17,2,152,1,48,0,48,76,1,48,0,48,76
9.02,6,16,1402,8,275,1288,275,878,8,96,1135,96,524
0.772,17,2,178,1,29,0,29,57,1,93,0,93,121
1.446,6,38,8254,19,321,80,1164,2718,19,433,70,1440,5536
8.0,6,64,20963,34,575,242,1152,16336,30,489,266,1179,4627
368.531,6,56,9156,28,109,13643,722,2813,28,271,13643,2026,6343
4.016,6,591,456915,317,1410,12,1432,440182,274,363,14,1432,16733
146.944,17,4,244,2,33,146942,33,122,2,33,146942,33,122
1741.418,6,90,6521,59,31,30024,31,3998,31,31,58044,31,2523
1787.916,1,164,9184,164,28,10968,28,9184,0,0,0,0,0
1772.405,6,180,15480,120,69,14894,69,8940,60,69,30033,69,6540
1.351,6,52,21605,29,919,48,1360,15909,23,433,53,1360,5696
1772.45,6,180,15480,120,69,14894,69,8940,60,69,30033,69,6540
127.26,6,35,20019,20,541,35,1360,2996,15,1823,9080,8160,17023
11.27,6,27,11355,13,275,939,275,1078,14,1078,831,1414,10277
1781.008,6,360,22818,209,69,8562,69,12638,151,69,11873,69,10180
10.568,6,18,4266,10,275,1174,275,958,8,992,828,1440,3308
1746.191,6,94,7151,62,38,28626,205,4424,32,33,56317,98,2727
1795.187,6,357,22629,209,69,8630,69,12569,148,69,12210,69,10060
1740.507,1,16,896,16,28,116033,28,896,0,0,0,0,0
0.404,1,2,112,2,28,404,28,112,0,0,0,0,0
1770.979,6,114,10596,72,66,24943,66,6156,42,60,43192,60,4440
1798.306,17,449,39928,404,35,4462,288,25708,45,288,40026,288,14220
1786.207,6,110,8901,68,66,26659,66,4964,42,55,43559,60,3937
0.334,17,2,152,1,48,0,48,76,1,48,0,48,76
1628.39,1,7,392,7,28,271398,28,392,0,0,0,0,0
0.04,17,2,184,1,32,0,32,60,1,96,0,96,124
1787.542,6,102,8296,68,65,26679,65,4930,34,59,54164,59,3366
1770.968,6,106,9876,69,65,26043,65,5875,37,59,49189,59,4001
251.663,2,2,64,2,8,251663,8,64,0,0,0,0,0
2.272,6,24,6550,13,333,188,1004,2190,11,783,225,1452,4360
0.311,6,3,199,1,31,0,31,83,2,0,311,0,116
1799.673,17,450,39960,405,35,4454,288,25740,45,288,40021,288,14220
0.003,17,4,368,2,32,1,32,120,2,96,1,96,248
1.309,6,49,18891,26,932,52,1460,13195,23,433,51,1460,5696
1.994,17,25,10241,11,485,199,1350,5649,14,300,132,1350,4592
1090.769,17,216,16416,216,48,5073,48,16416,0,0,0,0,0
0.088,17,2,268,1,33,0,33,61,1,179,0,179,207
1.326,6,11,1727,7,100,221,100,384,4,589,357,1152,1343
128.009,6,27,8313,9,132,16001,267,1029,18,655,7528,1460,7284
0.006,17,2,362,1,46,0,46,74,1,260,0,260,288
6.991,6,65,20166,34,543,211,1152,15499,31,489,224,1179,4667
0.071,17,2,243,1,53,0,53,81,1,134,0,134,162
1.644,6,49,19746,29,920,58,1360,14125,20,437,75,2715,5621
1788.68,17,142,11360,71,48,25552,48,5396,71,56,25552,56,5964
0.169,17,2,157,1,31,0,31,59,1,70,0,70,98
1.302,17,4,931,2,33,1297,37,123,2,376,1293,447,808
1.898,17,2,195,1,44,0,44,72,1,95,0,95,123
3.492,17,10,1263,5,31,870,31,295,5,165,870,196,968
0.41,6,28,7038,17,242,25,646,2384,11,701,40,1728,4654
0.489,6,22,7333,12,334,43,663,1969,10,1209,53,1906,5364
1772.732,6,180,15480,120,69,14896,69,8940,60,69,30042,69,6540
2.802,6,30,10414,18,368,164,837,1829,12,1012,247,1420,8585
317.684,6,50,6564,24,116,13805,722,2538,26,167,12700,1408,4026
1746.792,6,95,7203,63,38,28174,205,4476,32,33,56334,98,2727
0.03,6,13,3980,7,88,5,88,388,6,1670,5,2920,3592
10.925,6,85,25522,45,561,248,1152,19781,40,459,273,1179,5741
3.248,17,4,240,4,32,1082,32,240,0,0,0,0,0
26.697,17,6,360,3,32,13348,32,180,3,32,13348,32,180
14.528,6,10,1569,5,627,3632,627,895,5,406,3631,406,674
1745.507,6,100,7866,66,45,26853,205,4902,34,35,52880,98,2964
1.896,17,18,12185,10,944,210,1350,9728,8,279,236,1350,2457
0.307,17,2,241,1,36,0,36,64,1,149,0,149,177
0.434,6,13,1693,7,288,66,288,588,6,426,48,434,1105
2.137,6,13,1387,7,283,332,283,950,6,105,391,105,437
0.172,6,31,8025,16,297,11,517,1849,15,505,11,1420,6176
6.148,6,1939,1830701,1248,1391,4,1408,1790105,691,931,8,2816,40596
2.956,6,6,1257,4,327,985,414,815,2,181,2767,270,442
101.49,17,4,352,2,60,101488,60,176,2,60,101489,60,176
0.28,6,11,913,6,182,56,182,490,5,77,67,134,423
0.108,6,12,3462,6,75,21,75,395,6,1373,21,1448,3067
1783.533,17,142,11360,71,48,25478,48,5396,71,56,25478,56,5964
28.181,17,4,352,2,60,28180,60,176,2,60,28179,60,176
300.635,6,46,8952,23,286,13665,797,2156,23,344,583,1360,6796
5.039,6,9,527,5,43,1259,43,311,4,0,1678,0,216
54.424,1,2,738,2,341,54424,346,738,0,0,0,0,0
1.668,6,13,2311,8,188,238,245,700,5,1407,353,1407,1611
0.051,17,2,157,1,31,0,31,59,1,70,0,70,98
1726.445,17,12,498,11,14,172644,14,462,1,8,0,8,36
1792.241,17,177,11328,177,36,10183,36,11328,0,0,0,0,0
7.055,6,1529,1418507,973,1382,7,1408,1384931,556,931,12,2816,33576
24.545,6,3442,3309473,2301,1362,10,1408,3245477,1141,776,21,1408,63996
69.117,6,31,8776,15,290,4936,965,2351,16,481,4607,3417,6425
0.036,6,11,1566,6,503,7,503,823,5,475,9,475,743
11.218,6,40,24103,21,840,560,1360,5915,19,1451,613,2720,18188
1740.423,17,29,6815,29,207,62157,207,6815,0,0,0,0,0
1.154,6,30,5840,15,121,82,267,1335,15,650,76,1380,4505
1681.664,17,14,1036,7,30,280274,30,406,7,62,280275,62,630
0.064,6,9,1339,5,145,16,145,349,4,826,15,826,990
377.634,6,27,1767,18,177,22213,177,1181,9,110,8941,110,586
1767.877,6,111,13564,70,88,21995,498,5711,41,167,44194,1420,7853
300.679,6,43,8802,22,315,14318,882,2209,21,441,518,1440,6593
369.694,6,19,1303,14,177,28438,177,925,5,110,15181,110,378
7.4,6,13,5585,4,106,2461,106,274,9,823,923,1452,5311
1.117,6,24,6435,13,310,92,889,2075,11,783,110,1420,4360
1783.738,6,268,33202,110,141,16363,1360,16175,158,135,11360,4080,17027
560.692,17,6,444,3,30,280334,30,174,3,62,280339,62,270
0.061,17,2,156,1,42,0,42,70,1,58,0,58,86
1684.047,17,14,3843,7,30,280672,30,406,7,463,280672,463,3437
181.409,1,13,728,13,28,15117,28,728,0,0,0,0,0
3.287,6,4,1600,2,0,3287,0,80,2,1440,1962,1440,1520
1798.656,17,449,39928,404,35,4463,288,25708,45,288,40018,288,14220
10.049,6,46,8460,25,217,418,314,4273,21,477,479,1179,4187
0.263,17,2,476,1,39,0,39,67,1,381,0,381,409
280.383,6,30,7432,13,158,23365,267,1317,17,543,17522,1300,6115
0.241,17,2,384,1,39,0,39,67,1,289,0,289,317
1.317,6,42,11282,23,592,59,1360,5701,19,437,64,2715,5581
0.258,6,23,7136,13,155,21,267,1301,10,905,26,4845,5835
1799.372,1,59,4956,59,56,31023,56,4956,0,0,0,0,0
300.654,6,41,12123,20,286,15823,797,1976,21,619,425,1440,10147
0.226,6,25,4623,12,165,20,456,1446,13,415,18,888,3177
0.079,6,9,1340,5,145,19,145,349,4,827,20,827,991
366.966,6,27,1767,18,177,21586,177,1181,9,110,8708,110,586
60.349,6,12,3766,7,407,10058,722,1174,5,2328,15044,2328,2592
369.636,6,27,1767,18,177,21743,177,1181,9,110,9223,110,586
0.51,6,24,7480,14,273,39,663,2104,10,967,52,1471,5376
0.072,17,8,2750,8,315,10,354,2750,0,0,0,0,0
0.018,6,14,5639,8,134,2,134,474,6,2456,3,3453,5165
0.305,6,26,8990,13,247,25,624,1672,13,1105,22,2816,7318
1785.86,6,360,22818,209,69,8585,69,12638,151,69,11905,69,10180
19.907,17,5,1680,5,308,4976,308,1680,0,0,0,0,0
1770.023,6,99,9240,66,65,27231,65,5577,33,59,55309,59,3663
3.29,6,5,712,2,91,3290,91,171,3,421,358,421,541
0.115,6,9,1343,5,145,28,145,349,4,830,33,830,994
0.392,6,10,1677,6,555,77,951,1354,4,159,130,159,323
1774.461,1,14,784,14,28,136497,28,784,0,0,0,0,0
175.212,17,4,304,4,48,58404,48,304,0,0,0,0,0
8.003,6,12,5538,4,106,2667,106,274,8,822,1090,1452,5264
15.891,6,2824,2452796,1598,1437,9,1448,2370018,1226,792,12,1448,82778
1794.401,17,362,58257,362,132,4970,386,58257,0,0,0,0,0
1799.464,1,266,14896,266,28,6790,28,14896,0,0,0,0,0
313.15,17,4,2304,4,548,104383,548,2304,0,0,0,0,0
628.478,17,12,1056,6,48,125693,48,456,6,72,125693,72,600
2.963,17,4,944,2,60,2944,60,176,2,356,2931,372,768
0.508,17,3,451,2,39,230,39,134,1,289,0,289,317
0.123,6,41,19559,24,1052,5,1420,14658,17,526,7,3303,4901
3.365,17,5,295,5,31,841,31,295,0,0,0,0,0
9.52,17,2,152,2,48,9520,48,152,0,0,0,0,0
1.198,6,48,20226,28,898,44,1360,14650,20,476,53,2720,5576
1.473,6,46,18690,27,860,56,1360,13154,19,476,70,2715,5536
266.792,6,27,9821,14,241,20522,241,861,13,649,22211,966,8960
0.445,17,5,1701,5,312,111,355,1701,0,0,0,0,0
2.323,6,14,2351,8,188,331,245,700,6,703,411,1152,1651
224.468,6,29,6610,11,217,6068,502,1312,18,304,13198,1420,5298
281.003,6,30,7432,13,158,23416,267,1317,17,543,17560,1400,6115
0.033,17,4,284,2,32,23,32,120,2,54,12,60,164
7.788,6,15,4050,8,275,1112,275,878,7,1440,971,1440,3172
0.079,6,3,120,2,0,29,0,80,1,0,0,0,40
1797.352,17,449,39928,404,35,4459,288,25708,45,288,40020,288,14220
1791.846,6,356,22520,208,69,8656,69,12460,148,69,12189,69,10060
21.198,6,30,7297,14,155,1630,267,1346,16,441,1412,1420,5951
1.303,17,2,186,1,41,0,41,69,1,89,0,89,117
104.512,6,96,60864,56,1212,1900,1448,51407,40,614,2496,1448,9457
9.473,6,2192,2075626,1418,1386,6,1408,2030714,774,931,12,2816,44912
11.493,6,1849,1705653,1178,1370,9,1408,1666097,671,931,16,2801,39556
1.358,6,49,21276,28,967,50,1440,15660,21,433,59,1440,5616
0.052,17,2,118,1,31,0,31,59,1,31,0,31,59
0.067,1,2,163,2,53,67,78,163,0,0,0,0,0
0.045,17,2,912,1,308,0,308,336,1,548,0,548,576
0.008,17,2,352,1,36,0,36,64,1,260,0,260,288
1796.332,6,361,22858,210,69,8594,69,12678,151,69,11975,69,10180
0.079,17,2,602,1,46,0,46,74,1,500,0,500,528
1786.303,6,104,8444,68,66,26661,66,4964,36,60,51034,60,3480
201.201,1,8,848,8,78,28743,78,848,0,0,0,0,0
1796.655,6,359,22709,209,69,8637,69,12569,150,69,12057,69,10140
1734.825,1,8,448,8,28,247832,28,448,0,0,0,0,0
1203.164,2,11,352,11,8,120316,8,352,0,0,0,0,0
1771.068,6,99,9116,66,63,27247,64,5515,33,57,55343,58,3601
1778.402,17,79,3312,78,14,23096,14,3276,1,8,0,8,36
5.009,17,4,530,2,36,5005,36,128,2,173,5004,187,402
0.021,6,10,1510,5,657,5,657,925,5,317,5,317,585
1794.262,17,80,3354,79,14,23003,14,3318,1,8,0,8,36
1.077,6,24,7992,13,164,89,267,1328,11,1014,89,2331,6664
1772.149,1,58,4872,58,56,31090,56,4872,0,0,0,0,0
1.706,6,13,2311,8,188,243,245,700,5,1407,360,1407,1611
0.359,6,9,527,5,43,89,43,311,4,0,108,0,216
342.106,17,4,1344,4,308,114035,308,1344,0,0,0,0,0
1772.778,6,181,15589,120,69,14897,69,8940,61,69,29545,69,6649
3.49,17,4,240,2,32,3489,32,120,2,32,3489,32,120
300.973,6,51,10566,24,433,13085,910,3218,27,312,514,1460,7348
280.256,6,27,7312,12,158,25477,267,1277,15,678,20015,2045,6035
1.684,6,13,2311,8,188,240,245,700,5,1407,356,1407,1611
116.663,6,30,7642,9,141,6342,267,1215,21,348,5832,1452,6427
1.776,6,303,244682,181,1342,9,1420,235511,122,534,14,3303,9171
28.65,17,4,352,2,60,28649,60,176,2,60,28648,60,176
1624.336,2,14,448,14,8,124948,8,448,0,0,0,0,0
1797.654,6,370,27423,214,98,8439,1093,14779,156,94,11597,533,12644
1741.429,17,28,6580,28,207,64497,207,6580,0,0,0,0,0
1742.322,6,95,7203,63,38,28101,205,4476,32,33,56193,98,2727
1.015,17,4,288,2,36,968,36,128,2,52,967,52,160
1.463,6,49,20175,27,957,56,1460,14519,22,476,61,2615,5656
0.051,17,2,537,1,32,0,32,60,1,449,0,449,477
9.005,6,2054,1969791,1321,1412,6,1440,1926913,733,792,12,1440,42878
1787.293,17,87,3648,86,14,21026,14,3612,1,8,0,8,36
33.479,6,18,4185,9,296,4184,722,1365,9,587,4161,1408,2820
280.338,6,30,7432,13,158,23361,267,1317,17,543,17512,1400,6115
30.896,6,25,4060,14,179,2376,517,1824,11,411,3085,499,2236
1701.596,17,12,498,11,14,170159,14,462,1,8,0,8,36
123.053,6,33,18709,18,702,46,1360,4967,15,1313,8780,3527,13742
1764.386,6,336,59413,213,304,8322,304,44004,123,83,14462,83,15409
902.396,2,8,256,8,8,128913,8,256,0,0,0,0,0
2.437,6,14,2351,8,188,348,245,700,6,1407,436,1407,1651
10.559,6,18,5610,10,275,1173,275,958,8,1440,791,1440,4652
928.468,17,329,111090,329,309,2830,382,111090,0,0,0,0,0
0.036,17,2,664,1,308,0,308,336,1,300,0,300,328
1782.222,6,369,23385,212,69,8446,69,12965,157,69,11424,69,10420
23.938,6,6,328,4,0,7979,0,216,2,0,23915,0,112
1787.945,6,356,22520,208,69,8637,69,12460,148,69,12162,69,10060
26.357,6,45,8850,22,299,722,584,1883,23,377,1192,3488,6967
0.02,6,15,5964,8,88,2,88,452,7,1740,3,1880,5512
1797.118,17,142,11360,71,48,25672,48,5396,71,56,25672,56,5964
75.602,6,41,8833,20,412,633,889,2116,21,391,3773,3488,6717
570.856,6,96,13409,50,112,11650,721,5828,46,358,12660,2007,7581
90.859,17,10,760,10,48,10095,48,760,0,0,0,0,0
0.0,17,1,1192,1,1164,0,1164,1192,0,0,0,0,0
0.03,6,10,1723,6,578,5,997,1400,4,159,8,159,323
1743.792,6,96,7286,63,38,28125,205,4476,33,33,54485,98,2810
15.552,17,2,152,2,48,15552,48,152,0,0,0,0,0
1744.333,6,94,7151,62,38,28595,205,4424,32,33,56263,98,2727
0.055,6,12,3704,6,171,10,171,491,6,964,4,1448,3213
1788.95,17,83,3480,82,14,22085,14,3444,1,8,0,8,36
280.331,6,30,7432,13,158,23360,267,1317,17,543,17515,1400,6115
0.04,6,3,120,2,0,40,0,80,1,0,0,0,40
1772.093,6,180,15480,120,69,14891,69,8940,60,69,30035,69,6540
1745.636,6,96,7286,63,38,28155,205,4476,33,33,54542,98,2810
134.619,6,9,487,3,0,67309,0,152,6,7,26881,7,335
0.087,17,5,1757,5,323,21,354,1757,0,0,0,0,0
8.392,6,1148,947745,632,1409,13,1448,913509,516,776,15,1448,34236
280.539,6,30,7432,13,158,23378,267,1317,17,543,17528,1400,6115
84.831,6,14,3163,8,49,12118,92,511,6,778,13040,1448,2652
0.502,17,3,451,2,39,394,39,134,1,289,0,289,317
0.018,17,2,381,1,48,0,48,76,1,277,0,277,305
108.195,6,981,477533,535,825,202,1152,454220,446,420,242,1179,23313
47.354,6,45,14504,23,973,403,1460,8760,22,346,2246,1460,5744
1776.234,1,129,13674,129,78,13876,78,13674,0,0,0,0,0
76.344,6,31,7544,12,155,56,267,1266,19,393,4240,1420,6278
0.015,17,2,554,1,30,0,30,58,1,468,0,468,496
60.567,6,35,5160,21,134,3028,174,1648,14,368,3083,1452,3512
0.473,6,120,87194,63,131,7,232,3049,57,1605,8,5372,84145
70.446,6,20,812,9,0,6609,0,364,11,0,7041,0,448
0.123,17,2,144,1,36,0,36,64,1,52,0,52,80
1747.7,1,55,4620,55,56,32364,56,4620,0,0,0,0,0
75.759,6,31,7613,12,155,29,267,1266,19,398,4208,2840,6347
0.205,17,2,241,1,36,0,36,64,1,149,0,149,177
1.413,6,44,18571,26,923,56,1460,13075,18,476,71,2615,5496
38.501,17,22,1936,11,48,3846,48,836,11,72,3842,72,1100
11.896,6,93,29039,49,578,247,1152,22797,44,447,269,1179,6242
1787.888,6,369,23523,211,69,8513,69,12787,158,69,11387,69,10736
0.634,6,10,861,5,222,153,222,426,5,231,154,231,435
38.141,1,44,4576,0,0,0,0,0,44,76,887,76,4576
3.997,6,12,507,6,0,799,0,248,6,7,594,7,259
1772.591,6,180,15480,120,69,14895,69,8940,60,69,30041,69,6540
4.962,17,4,288,2,36,4926,36,128,2,52,4911,52,160
0.06,17,4,480,3,60,11,60,264,1,188,0,188,216
1794.364,17,144,11520,72,48,25272,48,5472,72,56,25272,56,6048
26.63,6,64,20443,31,797,887,1440,14058,33,377,816,1440,6385
902.425,2,10,320,10,8,100269,8,320,0,0,0,0,0
4.692,6,17,3502,10,210,521,210,948,7,545,776,905,2554
0.079,6,12,965,7,182,13,182,542,5,77,6,134,423
112.798,17,4,352,2,60,112796,60,176,2,60,112797,60,176
242.147,6,55,14564,26,386,9685,1360,6477,29,406,8641,1360,8087
42.445,6,5254,5005260,3388,1398,12,1448,4903564,1866,776,22,1448,101696
1681.371,17,14,1045,7,30,280221,30,406,7,63,280225,71,639
0.346,17,2,382,1,32,0,32,60,1,294,0,294,322
0.102,17,2,184,1,32,0,32,60,1,96,0,96,124
1771.845,1,59,4956,0,0,0,0,0,59,56,30549,56,4956
580.88,17,129,50052,129,360,4538,360,50052,0,0,0,0,0
1764.197,2,14,448,14,8,135707,8,448,0,0,0,0,0
291.025,17,4,240,2,32,291024,32,120,2,32,291024,32,120
61.94,6,45,9085,21,438,728,999,2247,24,345,2687,1460,6838
2.72,6,62,37157,37,711,75,1408,6271,25,1739,113,3724,30886
1798.401,1,16,896,16,28,119893,28,896,0,0,0,0,0
0.237,17,2,152,1,48,0,48,76,1,48,0,48,76
1745.843,6,96,7255,62,38,28620,205,4424,34,33,52894,98,2831
1786.55,6,102,8364,68,66,26664,66,4964,34,60,54135,60,3400
299.55,6,6,364,4,31,99850,31,222,2,31,299524,31,142
11.504,6,21,6825,12,275,1045,275,1038,9,1353,812,1440,5787
0.11,6,9,1148,5,145,27,145,349,4,635,27,635,799
1680.704,17,13,534,11,14,168051,14,462,2,8,1680518,8,72
0.03,17,2,554,1,30,0,30,58,1,468,0,468,496
6.9,17,12,1056,6,37,1379,37,390,6,83,1379,89,666
116.158,17,6,609,3,43,58072,43,213,3,104,58071,104,396
1.52,6,10,2191,5,125,380,245,580,5,1407,270,1407,1611
11.52,6,1654,1534734,1032,1408,11,1448,1497726,622,776,18,1448,37008
301.328,6,62,17759,34,955,9131,1460,11022,28,280,336,1460,6737
0.175,17,2,152,1,48,0,48,76,1,48,0,48,76
1796.236,6,378,26435,219,98,8239,469,15383,159,69,11365,69,11052
3.953,17,10,785,5,31,980,31,295,5,70,977,70,490
1775.255,17,138,11040,69,48,26106,48,5244,69,56,26106,56,5796
0.092,17,2,558,1,46,0,46,74,1,456,0,456,484
1748.097,6,110,8858,71,65,24972,65,5115,39,60,46000,118,3743
17.341,6,1832,1670972,1172,1373,14,1380,1638446,660,421,26,1923,32526
280.463,6,29,7392,14,158,21574,267,1357,15,678,20030,3456,6035
51.309,6,37,8315,18,350,510,734,1802,19,441,2843,1460,6513
241.157,6,49,9790,23,168,10961,346,2432,26,460,9646,1408,7358
1795.323,6,240,46440,150,483,12049,483,36780,90,83,20172,83,9660
11.626,6,99,29924,51,565,232,1152,23522,48,447,241,1179,6402
1.252,6,10,1687,7,100,208,100,384,3,1179,502,1179,1303
14.518,17,4,352,2,48,14509,48,152,2,72,14509,72,200
150.094,6,96,67272,58,1227,2633,1368,58268,38,841,1683,2519,9004
31.423,6,32,8952,14,158,2417,267,1357,18,624,1844,1400,7595
1747.353,6,160,10420,84,56,21052,208,6481,76,31,23291,31,3939
0.461,6,66,44411,33,269,14,517,2838,33,1374,13,1596,41573
0.671,17,4,950,2,40,333,40,136,2,379,0,379,814
300.644,6,36,8348,20,280,15823,775,1954,16,522,566,3488,6394
14.514,6,2771,2586278,1778,1376,8,1408,2529978,993,931,14,2816,56300
1.378,6,48,19522,27,913,53,1440,13906,21,433,59,1440,5616
1796.049,17,449,39928,404,35,4456,288,25708,45,288,40021,288,14220
289.376,17,4,352,2,60,289375,60,176,2,60,289375,60,176
4.822,17,5,4754,5,922,1205,1451,4754,0,0,0,0,0
0.163,6,28,7336,14,155,12,267,1341,14,603,12,2800,5995
11.878,17,15,17706,15,1152,848,1449,17706,0,0,0,0,0
4.929,6,40,7325,21,218,246,314,3463,19,516,259,1179,3862
144.093,6,114,83970,70,1262,2088,1368,74405,44,751,1527,2736,9565
368.95,1,5,475,5,67,92237,121,475,0,0,0,0,0
167.24,6,28,7352,12,158,15203,267,1277,16,603,11146,1400,6075
1.34,6,50,20414,27,971,51,1460,14718,23,433,52,1460,5696
0.158,17,2,588,1,39,0,39,67,1,493,0,493,521
1750.578,17,12,498,11,14,175057,14,462,1,8,0,8,36
5.013,17,4,288,2,36,5001,36,128,2,52,5012,52,160
369.572,6,25,1651,17,177,23098,177,1117,8,110,9253,110,534
1701.131,1,8,448,8,28,243018,28,448,0,0,0,0,0
1788.802,1,242,25652,242,78,7422,78,25652,0,0,0,0,0
22.96,6,34,8136,16,188,1530,721,1963,18,605,1339,1440,6173
1744.665,2,30,960,30,8,60160,8,960,0,0,0,0,0
16.927,6,1180,1024574,738,1311,22,1368,995518,442,776,37,1473,29056
1741.332,17,27,28512,27,1028,66974,1028,28512,0,0,0,0,0
0.481,6,22,5040,11,137,48,267,1132,11,692,43,1467,3908
10.618,6,6,328,4,0,3539,0,216,2,0,10388,0,112
306.182,6,73,10604,29,97,8736,267,2636,44,269,7120,2840,7968
882.163,2,6,192,6,8,176432,8,192,0,0,0,0,0
1.334,6,47,19146,27,889,51,1360,13570,20,529,60,4075,5576
72.135,6,31,7544,13,155,6011,267,1306,18,423,4242,3417,6238
21.328,6,7,376,2,0,21032,0,112,5,0,5290,0,264
0.074,6,10,1823,6,628,14,1099,1500,4,159,24,159,323
0.115,6,3,151,2,31,7,31,111,1,0,0,0,40
1.951,17,3,468,3,128,975,128,468,0,0,0,0,0
1.912,17,3,468,3,128,956,128,468,0,0,0,0,0
1.205,6,41,11378,22,547,57,1360,5842,19,476,58,2715,5536
219.113,17,4,240,2,32,219112,32,120,2,32,219112,32,120
2.185,6,66,25422,34,959,66,1440,14899,32,543,64,1440,10523
280.459,6,29,7392,13,158,23371,267,1317,16,603,18695,2036,6075
90.374,6,124,95444,80,1263,1143,1368,85028,44,738,2059,2519,10416
378.372,2,3,96,3,8,189186,8,96,0,0,0,0,0
1.286,6,28,8631,15,236,77,625,2049,13,1008,90,2720,6582
912.466,6,121,16092,64,304,14483,304,10708,57,83,16279,83,5384
0.067,6,2,123,1,0,0,0,40,1,31,0,31,83
1793.082,17,66,2766,65,14,28016,14,2730,1,8,0,8,36
1786.913,6,356,22520,208,69,8632,69,12460,148,69,12155,69,10060
1795.877,17,447,39864,402,35,4478,288,25644,45,288,40020,288,14220
61.829,6,67,45381,42,1171,1508,1408,37347,25,960,2566,3847,8034
1.268,6,47,19068,27,884,48,1360,13492,20,476,57,2715,5576
1.652,6,12,1163,6,222,326,222,688,6,231,327,231,475
5.77,6,37,5145,19,206,320,314,2828,18,317,317,741,2317
1794.407,17,144,11520,72,48,25273,48,5472,72,56,25273,56,6048
120.787,6,14,9263,3,188,254,245,500,11,1188,12054,1407,8763
59.849,6,8,432,5,0,14962,0,268,3,0,29915,0,164
1788.681,17,87,3648,86,14,21043,14,3612,1,8,0,8,36
15.321,17,19,10783,10,818,1699,1350,8462,9,229,1911,1350,2321
1681.336,17,16,4241,8,30,240189,37,471,8,443,240189,463,3770
3.989,17,15,9083,6,396,797,1350,2544,9,698,486,1350,6539
1799.83,17,332,25232,332,48,5437,48,25232,0,0,0,0,0
300.836,6,72,53487,46,1242,6685,1368,47122,26,715,1395,1571,6365
35.17,6,26,7233,9,156,4396,267,1152,17,414,2185,1420,6081
1780.675,17,142,11360,71,48,25437,48,5396,71,56,25437,56,5964
1744.419,6,97,7307,63,38,28135,205,4476,34,33,52852,98,2831
17.726,17,32,13810,15,629,1264,1350,9869,17,203,1106,1350,3941
20.163,6,34,8321,18,391,1186,860,1927,16,522,1334,3488,6394
1742.981,6,94,7151,62,38,28573,205,4424,32,33,56213,98,2727
20.129,6,18,3026,10,229,2236,517,1457,8,381,2874,499,1569
6.107,17,12,2595,6,47,1220,47,450,6,329,1220,341,2145
1.165,6,27,9616,13,164,83,267,1388,14,1070,76,2816,8228
595.398,1,24,1344,24,28,25886,28,1344,0,0,0,0,0
164.306,6,22,7994,11,511,86,1194,2005,11,791,16412,1440,5989
1.601,6,20,5873,12,266,144,517,1696,8,938,227,1906,4177
1.439,6,48,17607,26,877,57,1380,12473,22,421,67,1923,5134
9.502,6,82,24805,41,542,237,1152,19008,41,461,230,1179,5797
58.835,6,11,1589,11,113,5883,113,1589,0,0,0,0,0
1627.425,1,8,448,8,28,232489,28,448,0,0,0,0,0
1770.759,6,104,9566,66,66,27242,66,5610,38,60,47855,60,3956
336.159,6,49,3613,19,67,18666,363,1706,30,47,11591,78,1907
277.199,2,10,480,10,24,30799,32,480,0,0,0,0,0
20.17,6,20,5365,12,107,1833,159,1074,8,966,2880,1658,4291
15.933,17,25,5893,11,235,1586,1350,2893,14,186,1219,1350,3000
0.03,17,2,327,1,35,0,35,63,1,236,0,236,264
100.885,6,23,9821,12,399,77,657,2146,11,1031,10076,2720,7675
27.863,6,35,8617,17,176,1741,721,2444,18,908,1627,2840,6173
18.665,1,24,2496,0,0,0,0,0,24,76,811,76,2496
1799.517,6,365,24563,213,88,8488,469,14067,152,69,11917,69,10496
7.187,6,1311,1190656,818,1376,8,1408,1160356,493,931,14,2816,30300
3.042,6,4,192,1,0,0,0,48,3,0,1513,0,144
1740.5,17,30,7050,30,207,60017,207,7050,0,0,0,0,0
185.424,6,33,6397,17,286,11589,1314,2405,16,334,12360,1420,3992
1797.002,1,58,4872,58,56,31526,56,4872,0,0,0,0,0
0.242,6,4,1037,2,0,215,0,104,2,853,28,853,933
0.526,17,8,2750,8,315,75,354,2750,0,0,0,0,0
300.606,6,48,9044,24,278,13069,766,2176,24,327,648,1460,6868
2.69,6,29,6175,15,338,192,1314,2294,14,368,206,1420,3881
1797.592,17,209,50211,209,212,8642,422,50211,0,0,0,0,0
81.854,6,20,9714,4,106,939,106,274,16,675,5456,1420,9440
98.738,17,4,352,2,60,98737,60,176,2,60,98736,60,176
143.239,6,25,10829,12,380,74,832,1665,13,959,11925,1440,9164
0.276,17,2,194,1,61,0,61,89,1,77,0,77,105
24.288,6,11,2176,4,92,8096,92,296,7,750,4014,1408,1880
68.396,6,28,7352,13,158,5699,267,1317,15,678,4882,2045,6035
0.051,17,3,244,2,32,34,32,120,1,96,0,96,124
9.022,17,8,552,4,33,3003,33,244,4,49,3004,49,308
1772.742,6,180,15480,120,69,14896,69,8940,60,69,30040,69,6540
1789.438,17,142,11360,71,48,25563,48,5396,71,56,25563,56,5964
8.787,2,2,64,2,8,8787,8,64,0,0,0,0,0
1.26,6,53,19546,29,897,45,1360,13765,24,400,47,1360,5781
346.358,6,40,7518,20,143,9615,516,1950,20,280,18224,1452,5568
149.424,6,73,48211,45,1177,3396,1448,40025,28,746,2282,1448,8186
0.312,17,2,152,1,48,0,48,76,1,48,0,48,76
0.526,17,3,451,2,39,365,39,134,1,289,0,289,317
8.109,6,17,6591,9,275,1013,275,643,8,1404,1010,2760,5948
1797.95,6,80,4160,40,0,46094,0,2080,40,0,46094,0,2080
1.179,6,221,159350,120,1353,9,1432,151010,101,389,10,1432,8340
37.358,1,43,4472,0,0,0,0,0,43,76,889,76,4472
881.974,2,7,224,7,8,146995,8,224,0,0,0,0,0
865.25,1,8,448,8,28,123607,28,448,0,0,0,0,0
31.211,17,18,1584,9,48,3899,48,684,9,72,3899,72,900
11.648,6,1821,1601595,1108,1390,10,1420,1568854,713,467,16,1883,32741
0.474,6,22,7342,13,335,39,668,2026,9,1210,52,1946,5316
615.848,17,18,6044,18,307,36226,314,6044,0,0,0,0,0
17.69,6,8,506,0,0,0,0,0,8,31,2527,31,506
1783.803,1,59,4956,0,0,0,0,0,59,56,30755,56,4956
904.51,6,170,11423,102,74,8955,138,6771,68,69,13499,69,4652
0.079,17,2,338,1,33,0,33,61,1,249,0,249,277
280.475,6,28,7352,13,158,23372,267,1317,15,775,20025,2760,6035
79.114,6,37,7125,19,282,4395,681,3020,18,316,4649,1107,4105
11.504,6,21,6825,12,275,1045,275,1038,9,1353,810,1440,5787
1.407,6,51,19190,27,881,54,1440,13454,24,433,53,1440,5736
0.004,17,2,366,1,36,0,36,64,1,274,0,274,302
1706.657,1,8,448,8,28,243808,28,448,0,0,0,0,0
1799.806,17,144,11520,72,48,25349,48,5472,72,56,25349,56,6048
1785.052,6,214,16396,80,68,22595,294,7762,134,48,13421,78,8634
1739.286,6,87,6322,58,31,30513,31,3915,29,31,62116,31,2407
1783.804,6,355,22480,207,69,8659,69,12420,148,69,12134,69,10060
10.091,6,85,24925,44,560,234,1152,19128,41,461,245,1179,5797
281.473,6,32,8194,13,158,23456,267,1317,19,555,15632,2760,6877
20.667,6,22,2732,12,304,1878,304,1860,10,83,2292,83,872
1798.609,17,449,39928,404,35,4463,288,25708,45,288,40020,288,14220
1.629,6,30,10405,18,367,95,833,1825,12,1012,140,1420,8580
1742.722,1,182,19292,182,78,9628,78,19292,0,0,0,0,0
1800.0,6,217,17005,80,72,22405,336,8102,137,49,13235,143,8903
1740.215,6,87,6322,58,31,30530,31,3915,29,31,62148,31,2407
0.054,1,2,668,2,306,54,306,668,0,0,0,0,0
0.493,17,3,451,2,39,375,39,134,1,289,0,289,317
1795.165,17,80,3354,79,14,23014,14,3318,1,8,0,8,36
271.703,17,4,352,2,60,271702,60,176,2,60,271702,60,176
63.198,6,14,5617,4,106,21062,106,274,10,985,7020,1420,5343
240.509,6,58,18543,31,776,8014,1418,15589,27,192,9248,580,2954
0.663,6,126,99339,81,1324,8,1420,93318,45,467,14,2840,6021
449.505,1,19,1596,0,0,0,0,0,19,56,24972,56,1596
99.009,6,54,15629,25,721,4125,1440,6192,29,432,3528,1440,9437
1184.492,6,258,17077,145,70,8225,138,9181,113,68,10568,69,7896
196.511,6,1593,782573,847,851,232,1152,744857,746,393,263,1179,37716
1798.441,17,449,39928,404,35,4462,288,25708,45,288,40017,288,14220
1558.281,1,7,392,7,28,259713,28,392,0,0,0,0,0
0.001,6,2,84,1,0,0,0,44,1,0,0,0,40
0.412,17,4,304,2,48,410,64,152,2,48,411,64,152
1786.5,6,102,8296,68,65,26664,65,4930,34,59,54133,59,3366
81.252,6,23,7659,7,272,355,516,1100,16,455,5410,1452,6559
83.803,6,21,3796,12,211,7618,211,1325,9,665,10466,904,2471
287.047,17,8,2688,8,308,41006,308,2688,0,0,0,0,0
1783.584,17,83,3480,82,14,22019,14,3444,1,8,0,8,36
381.792,6,24,1551,14,177,29368,177,913,10,110,13982,110,638
1764.261,6,270,48690,180,302,9856,302,36540,90,83,19823,83,12150
364.577,6,27,1767,18,177,21445,177,1181,9,110,8511,110,586
0.066,6,9,1340,5,145,16,145,349,4,827,20,827,991
1793.813,6,356,22520,208,69,8665,69,12460,148,69,12202,69,10060
171.938,6,22,10202,12,433,76,990,1823,10,1327,19090,2720,8379
15.334,17,10,880,5,48,3830,48,380,5,72,3830,72,500
1771.11,6,101,9344,66,65,27247,65,5577,35,59,52088,59,3767
0.009,6,2,80,1,0,0,0,40,1,0,0,0,40
1721.989,1,24,1344,24,28,74869,28,1344,0,0,0,0,0
1.268,6,45,17983,26,875,50,1360,12447,19,476,60,2720,5536
11.67,6,1879,1633150,1133,1386,10,1420,1598645,746,467,15,1883,34505
0.814,6,645,641152,408,206,2,230,23635,237,2575,3,14080,617517
1796.656,1,238,13328,238,28,7580,28,13328,0,0,0,0,0
782.722,2,7,224,7,8,130453,8,224,0,0,0,0,0
1794.052,1,288,16128,288,28,6251,28,16128,0,0,0,0,0
1799.772,17,448,39612,404,35,4465,288,25708,44,288,40951,288,13904
0.547,17,4,768,2,39,536,39,134,2,289,19,289,634
10.793,6,83,24829,43,560,256,1152,19088,40,459,270,1179,5741
10.861,6,20,4442,11,275,1086,275,998,9,768,747,1440,3444
1799.179,6,352,33071,202,124,8951,693,17275,150,127,12074,1452,15796
1773.434,6,181,15589,120,69,14902,69,8940,61,69,29551,69,6649
1772.498,6,203,22290,130,75,13740,267,10057,73,134,24613,1997,12233
1795.291,17,448,39896,403,35,4465,288,25676,45,288,40022,288,14220
416.384,2,4,128,4,8,138794,8,128,0,0,0,0,0
1.585,6,50,19706,27,921,60,1360,14010,23,433,63,1360,5696
1598.517,1,8,848,8,78,228359,78,848,0,0,0,0,0
41.792,6,37,9367,17,762,55,1420,4525,20,268,2189,3020,4842
93.588,6,60,31376,32,1046,251,1360,13963,28,904,3459,3933,17413
10.853,6,20,4442,11,275,1085,275,998,9,768,759,1440,3444
39.028,17,22,1936,11,48,3902,48,836,11,72,3901,72,1100
1796.38,17,132,10560,66,48,27636,48,5016,66,56,27636,56,5544
1.315,6,10,1687,7,100,219,100,384,3,1179,527,1179,1303
702.333,1,4,224,4,28,234111,28,224,0,0,0,0,0
6.697,6,47,8489,25,211,279,314,4182,22,489,305,1179,4307
0.104,6,67,69575,16,190,6,283,1411,51,1393,1,1438,68164
1795.014,6,415,42505,234,156,7703,1189,20806,181,166,9970,1420,21699
0.834,6,29,13576,15,986,59,1440,6551,14,806,49,1485,7025
36.725,6,19,1447,10,222,4078,222,848,9,231,4588,231,599
1771.295,6,101,9410,66,66,27250,66,5610,35,60,52094,60,3800
20.253,6,30,7110,14,99,1554,228,1430,16,605,1349,1448,5680
280.462,6,29,7392,13,158,23371,267,1317,16,678,18694,3456,6075
32.882,17,20,1760,10,48,3651,48,760,10,72,3645,72,1000
0.251,17,3,451,2,39,118,39,134,1,289,0,289,317
1661.689,17,62,2604,62,14,27240,14,2604,0,0,0,0,0
352.531,6,23,6162,4,112,426,112,280,19,300,19584,1460,5882
40.307,17,24,2112,12,48,3660,48,912,12,72,3662,72,1200
1777.717,17,140,11200,70,48,25763,48,5320,70,56,25763,56,5880
1786.678,6,104,8435,69,65,26274,65,4970,35,59,52546,59,3465
1741.509,1,33,3498,33,78,54422,78,3498,0,0,0,0,0
0.169,17,2,136,1,32,0,32,60,1,48,0,48,76
37.883,17,22,1672,22,48,1803,48,1672,0,0,0,0,0
97.862,6,53,20696,28,1042,582,1360,14770,25,307,4070,1360,5926
64.731,6,12,976,4,226,116,226,442,8,110,9222,110,534
263.844,6,281,225267,179,1321,1482,1408,204845,102,581,2593,2816,20422
1787.535,1,340,28560,340,56,5272,56,28560,0,0,0,0,0
4.072,17,5,290,5,30,1018,30,290,0,0,0,0,0
1.463,6,49,19700,27,923,56,1440,14044,22,433,61,1440,5656
0.036,6,15,4534,8,135,5,136,695,7,869,5,1448,3839
168.211,17,4,352,2,60,168210,60,176,2,60,168210,60,176
1793.077,6,417,33517,233,90,7728,1189,16078,184,132,9798,1460,17439
3.851,17,15,9790,7,871,640,1350,6299,8,408,544,1350,3491
126.285,2,2,64,2,8,126285,8,64,0,0,0,0,0
11.981,6,1885,1654021,1144,1392,10,1420,1620160,741,467,16,1883,33861
0.016,6,14,1104,9,181,2,181,681,5,77,3,134,423
1773.49,6,204,22330,130,75,13747,267,10057,74,132,24287,1460,12273
0.192,1,10,840,10,56,21,56,840,0,0,0,0,0
0.023,17,7,2438,7,320,3,354,2438,0,0,0,0,0
1787.786,6,103,8268,68,64,26683,64,4896,35,58,52579,58,3372
1680.619,1,15,840,15,28,120044,28,840,0,0,0,0,0
3.485,6,2,88,2,0,0,0,88,0,0,0,0,0
225.555,17,4,352,2,60,225554,60,176,2,60,225554,60,176
1795.547,6,356,22520,208,69,8674,69,12460,148,69,12213,69,10060
6.109,6,922,832218,593,1359,10,1432,814755,329,475,18,1871,17463
232.91,6,79,12088,39,183,6129,1189,4135,40,302,5967,1917,7953
0.052,17,2,136,1,32,0,32,60,1,48,0,48,76
240.228,6,54,17552,29,773,8579,1402,14671,25,196,10009,580,2881
0.205,6,24,6713,11,181,16,267,1168,13,627,16,1400,5545
3.525,17,4,244,4,33,1175,33,244,0,0,0,0,0
0.042,6,10,1514,5,503,10,503,771,5,475,10,475,743
10.474,6,12,524,6,0,2094,0,260,6,0,1198,0,264
62.356,17,4,240,2,32,62355,32,120,2,32,62355,32,120
1738.805,17,17,4162,17,216,108675,1030,4162,0,0,0,0,0
1774.587,6,180,15480,120,69,14912,69,8940,60,69,30072,69,6540
1640.638,1,7,392,7,28,273439,28,392,0,0,0,0,0
0.004,6,17,25488,1,0,0,0,40,16,1538,0,2896,25448
1741.338,6,93,6751,61,31,29022,31,4145,32,31,56171,31,2606
82.297,6,17,692,7,0,8307,0,284,10,0,9142,0,408
4.675,17,4,947,2,33,4670,37,123,2,384,4670,463,824
13.418,6,16,4090,8,275,1916,275,878,8,1440,1376,1440,3212
1793.8,6,440,38180,204,67,8835,659,14728,236,85,7632,1360,23452
6.054,6,1473,1354562,925,1387,6,1408,1321402,548,931,10,2801,33160
0.013,17,2,495,1,41,0,41,69,1,398,0,398,426
1793.358,6,362,22898,210,69,8580,69,12678,152,69,11874,69,10220
0.382,17,8,2774,8,318,54,357,2774,0,0,0,0,0
1743.044,6,95,7203,63,38,28113,205,4476,32,33,56216,98,2727
354.815,17,6,456,6,48,70963,48,456,0,0,0,0,0
1.17,6,10,1687,7,100,195,100,384,3,1179,452,1179,1303
1.168,6,23,7952,12,164,91,267,1288,11,1216,100,3819,6664
1099.149,6,135,10017,52,63,21549,293,4730,83,47,13402,78,5287
281.43,6,33,7552,14,158,21648,267,1357,19,543,15634,1400,6195
23.069,6,69,73164,10,195,2563,195,739,59,1234,397,2024,72425
1776.049,6,102,8228,68,64,26508,64,4896,34,58,53817,58,3332
280.028,6,28,7352,13,158,23335,267,1317,15,678,19999,4200,6035
1754.984,1,104,5824,104,28,17038,28,5824,0,0,0,0,0
4.296,6,40,7309,19,218,238,314,3383,21,440,201,1152,3926
1745.135,1,57,4788,57,56,31163,56,4788,0,0,0,0,0
11.019,6,20,4350,11,275,1101,275,998,9,992,768,1440,3352
0.051,17,2,144,1,36,0,36,64,1,52,0,52,80
280.088,6,27,7312,13,158,23340,267,1317,14,775,21538,3445,5995
0.901,6,10,1677,6,555,143,951,1354,4,159,266,159,323
1744.586,2,28,896,28,8,64614,8,896,0,0,0,0,0
5.012,17,4,558,2,36,5002,36,128,2,187,4999,187,430
85.722,6,25,9183,12,366,72,795,1622,13,781,7132,1460,7561
1783.226,17,138,11040,69,48,26223,48,5244,69,56,26223,56,5796
0.504,17,3,451,2,39,454,39,134,1,289,0,289,317
1798.78,6,390,26666,214,99,8444,469,15045,176,52,10278,69,11621
1772.695,6,180,15480,120,69,14896,69,8940,60,69,30039,69,6540
0.119,6,6,328,4,0,39,0,216,2,0,35,0,112
280.216,6,28,7352,12,158,25474,267,1277,16,603,18680,1400,6075
1.238,6,52,20097,28,879,45,1360,14361,24,433,46,1360,5736
0.169,6,43,17479,24,959,7,1420,12498,19,467,9,1883,4981
1737.885,1,56,4704,56,56,31597,56,4704,0,0,0,0,0
1.782,6,27,10177,16,284,118,586,1498,11,1029,160,1420,8679
95.229,6,934,448709,495,840,192,1152,424962,439,386,216,1152,23747
1772.391,6,180,15480,120,69,14894,69,8940,60,69,30037,69,6540
12.378,6,1982,1781099,1227,1371,9,1408,1736663,755,931,16,2816,44436
31.75,6,7,308,1,0,0,0,44,6,0,6298,0,264
25.055,6,8,424,4,36,1,42,233,4,31,8351,31,191
0.009,17,2,348,1,39,0,39,67,1,253,0,253,281
373.703,6,25,1651,17,177,23356,177,1117,8,110,9244,110,534
0.05,17,4,624,2,36,1,36,128,2,220,0,292,496
0.034,17,2,136,1,32,0,32,60,1,48,0,48,76
12.154,17,10,2105,5,47,3035,47,375,5,318,3034,318,1730
1771.291,6,99,9240,66,65,27250,65,5577,33,59,55350,59,3663
0.456,17,2,144,1,36,0,36,64,1,52,0,52,80
1796.83,17,760,45886,760,32,2367,37,45886,0,0,0,0,0
0.952,6,11,1727,7,100,158,100,384,4,589,230,1152,1343
1681.191,1,15,840,15,28,120085,28,840,0,0,0,0,0
679.148,6,50,14607,32,369,21908,1360,7231,18,604,39939,3494,7376
1779.31,17,140,11200,70,48,25786,48,5320,70,56,25786,56,5880
213.486,6,46,8834,23,108,9703,267,2120,23,340,9703,2840,6714
378.087,2,3,96,3,8,189043,8,96,0,0,0,0,0
1564.184,2,12,384,12,8,142198,8,384,0,0,0,0,0
11.888,6,1876,1641708,1143,1382,10,1420,1608167,733,467,16,1883,33541
1744.828,6,95,7203,63,38,28142,205,4476,32,33,56274,98,2727
10.146,17,31,15395,14,417,780,1350,6236,17,510,416,1350,9159
1770.34,6,99,9306,66,66,27236,66,5610,33,60,55320,60,3696
0.32,17,6,1042,6,145,64,357,1042,0,0,0,0,0
38.832,17,22,1936,11,48,3882,48,836,11,72,3882,72,1100
1798.866,17,449,39928,404,35,4463,288,25708,45,288,40019,288,14220
280.453,6,29,7392,13,158,23371,267,1317,16,543,18694,1380,6075
1790.832,17,140,11200,70,48,25954,48,5320,70,56,25953,56,5880
11.85,6,2070,1937195,1301,1410,8,1448,1892543,769,776,15,1448,44652
251.634,2,2,64,2,8,251634,8,64,0,0,0,0,0
15.116,17,17,5834,7,371,2514,1350,2796,10,275,1675,1350,3038
8.469,6,49,13222,24,194,368,721,2715,25,633,310,1440,10507
1797.578,1,58,4872,58,56,31536,56,4872,0,0,0,0,0
1788.15,6,194,22047,126,125,14305,965,12971,68,93,26686,485,9076
1785.869,6,473,27200,265,69,6764,69,14740,208,34,8627,64,12460
1799.89,1,16,896,16,28,119992,28,896,0,0,0,0,0
3.864,6,6,340,3,0,1932,0,160,3,0,962,0,180
2.255,17,56,42697,23,328,102,1350,8197,33,1017,60,1350,34500
0.142,1,2,112,2,28,142,28,112,0,0,0,0,0
1787.124,1,342,28728,342,56,5240,56,28728,0,0,0,0,0
1771.95,6,180,15480,120,69,14890,69,8940,60,69,30031,69,6540
0.142,6,10,1669,6,551,28,947,1346,4,159,47,159,323
1795.363,17,449,39928,404,35,4454,288,25708,45,288,40019,288,14220
11.018,6,18,5610,10,275,1224,275,958,8,1440,859,1440,4652
1.35,6,47,18895,26,939,54,1460,13279,21,433,58,1460,5616
1775.854,1,58,4872,58,56,31155,56,4872,0,0,0,0,0
6.481,6,914,772381,536,1363,11,1408,748061,378,931,16,2801,24320
0.254,6,9,1002,5,213,63,213,417,4,421,60,421,585
1738.346,1,56,4704,0,0,0,0,0,56,56,31606,56,4704
1720.438,17,12,498,11,14,172043,14,462,1,8,0,8,36
137.514,6,29,7698,7,156,1110,267,1072,22,337,6547,1460,6626
296.183,6,6,364,4,31,98727,31,222,2,31,295828,31,142
0.089,17,2,640,2,292,89,298,640,0,0,0,0,0
12.033,6,19,4362,11,275,1203,275,998,8,758,1593,1420,3364
3.029,6,2,111,0,0,0,0,0,2,31,3029,31,111
8.166,6,80,24821,39,563,214,1152,19040,41,459,197,1179,5781
1.42,6,46,18650,25,923,59,1460,13034,21,433,61,1460,5616
2.653,6,6,458,4,105,881,105,374,2,0,2645,0,84
7.222,6,1655,1525704,1041,1387,6,1408,1489112,614,931,11,2816,36592
20.718,6,28,7217,13,155,1726,267,1306,15,482,1479,1997,5911
0.488,6,13,1693,6,288,93,288,548,7,426,45,434,1145
120.509,6,12,8679,3,100,129,100,224,9,1155,15032,1179,8455
1789.567,6,366,25541,213,100,8441,469,14936,153,69,11771,69,10605
3.978,17,8,736,4,32,1322,32,240,4,96,1322,96,496
0.907,17,8,2750,8,315,129,354,2750,0,0,0,0,0
45.329,6,14,3149,6,92,9065,92,400,8,579,6448,1408,2749
7.881,6,27,7794,14,214,606,721,1852,13,903,460,2840,5942
1.352,6,50,19344,27,895,52,1460,13648,23,433,53,1460,5696
1788.555,6,423,36709,235,119,7643,1189,18757,188,128,9564,1420,17952
1786.338,6,117,13863,75,82,24139,502,5984,42,163,43566,1420,7879
280.472,6,30,7432,13,158,23372,267,1317,17,543,17526,1380,6115
5.132,17,3,208,2,36,5060,36,128,1,52,0,52,80
1751.561,6,95,7203,63,38,28250,205,4476,32,33,56495,98,2727
0.058,17,2,912,1,308,0,308,336,1,548,0,548,576
10.667,6,46,8449,24,227,453,314,4142,22,489,496,1179,4307
60.095,6,6,328,4,0,20031,0,216,2,0,60084,0,112
352.72,6,19,6393,3,106,176360,106,234,16,393,23502,1460,6159
1.299,6,47,19024,26,948,51,1460,13408,21,433,56,1460,5616
4.98,17,4,558,2,36,4976,36,128,2,187,4975,187,430
1787.302,6,160,20365,94,304,19218,304,14332,66,83,27496,83,6033
0.967,17,5,1176,3,32,481,32,180,2,470,7,470,996
0.498,6,123,74790,65,1285,7,1420,68228,58,421,8,1883,6562
0.039,17,4,284,2,32,20,32,120,2,54,26,60,164
0.051,17,2,152,1,48,0,48,76,1,48,0,48,76
0.269,17,2,290,1,40,0,40,68,1,194,0,194,222
1772.193,6,180,15480,120,69,14892,69,8940,60,69,30036,69,6540
5.384,6,7,434,4,122,1720,122,302,3,0,2631,0,132
299.009,1,4,326,4,53,99669,78,326,0,0,0,0,0
0.091,6,9,2063,6,591,18,1026,1426,3,513,45,513,637
78.515,6,34,7888,11,144,94,267,1317,23,331,3568,1460,6571
0.211,6,23,6673,10,181,17,267,1128,13,627,16,1400,5545
1684.536,2,12,384,12,8,153139,8,384,0,0,0,0,0
240.183,6,51,15761,27,706,9237,1402,12709,24,224,10442,580,3052
64.296,6,28,7217,13,155,5358,267,1306,15,482,4591,1997,5911
0.664,17,2,144,1,36,0,36,64,1,52,0,52,80
0.042,17,4,288,2,33,0,33,122,2,55,35,61,166
1787.532,6,123,14556,79,84,22917,498,6386,44,160,41568,1420,8170
240.314,6,44,8447,24,449,10448,1402,5752,20,205,12647,580,2695
0.706,17,2,136,1,32,0,32,60,1,48,0,48,76
0.535,17,12,7482,6,890,107,1350,5513,6,300,21,1350,1969
227.485,6,37,10098,18,213,7818,721,2222,19,646,12628,4260,7876
1798.581,6,367,25650,214,99,8444,469,15045,153,69,11830,69,10605
1.412,17,25,6917,10,300,153,1350,3285,15,214,98,1350,3632
1771.075,6,103,9448,66,65,27247,65,5577,37,59,49194,59,3871
1.259,6,45,16077,25,788,52,1360,10501,20,476,57,2715,5576
1741.336,6,87,6322,58,31,30549,31,3915,29,31,62188,31,2407
1775.859,17,140,11200,70,48,25737,48,5320,70,56,25737,56,5880
361.366,6,52,17892,34,607,10950,1360,12334,18,402,535,1360,5558
116.016,17,8,2712,8,311,16573,326,2712,0,0,0,0,0
8.48,2,4,128,4,8,2826,8,128,0,0,0,0,0
1700.571,17,12,498,11,14,170057,14,462,1,8,0,8,36
0.959,6,29,12051,16,528,63,1360,3338,13,909,64,2561,8713
11.253,6,37,8860,20,398,592,1216,2426,17,478,537,2720,6434
0.552,6,3,151,1,0,0,0,40,2,31,0,31,111
1780.229,1,58,4872,58,56,31232,56,4872,0,0,0,0,0
28.399,17,36,8222,15,260,2026,1350,4323,21,157,1418,1350,3899
0.177,17,2,136,1,32,0,32,60,1,48,0,48,76
0.474,6,12,1653,6,288,89,288,548,6,426,46,434,1105
739.443,6,50,3952,27,49,28434,205,2046,23,34,33603,98,1906
1772.244,6,180,15480,120,69,14892,69,8940,60,69,30033,69,6540
0.196,6,10,1379,5,145,49,145,349,5,826,37,826,1030
106.334,6,24,10168,12,549,60,1360,2709,12,1161,9655,2720,7459
138.135,17,6,456,3,48,69059,48,228,3,48,69059,48,228
252.138,6,11,5041,6,744,50427,1247,1728,5,1037,63033,1661,3313
0.479,6,3,144,2,0,479,0,92,1,0,0,0,52
58.192,17,4,352,2,60,58190,60,176,2,60,58191,60,176
1795.444,1,57,4788,57,56,32061,56,4788,0,0,0,0,0
1794.274,1,58,4872,58,56,31478,56,4872,0,0,0,0,0
0.014,17,3,1007,1,137,0,137,165,2,393,14,393,842
0.109,17,2,588,1,39,0,39,67,1,493,0,493,521
247.604,6,19,1709,8,187,35371,187,647,11,247,24759,462,1062
1794.245,1,252,14112,252,28,7148,28,14112,0,0,0,0,0
240.217,6,56,21349,30,886,8283,1418,18402,26,198,9608,580,2947
8.515,6,29,6175,15,338,608,1314,2294,14,368,645,1460,3881
1646.687,1,8,448,8,28,235241,28,448,0,0,0,0,0
1796.4,17,316,49872,316,129,5702,391,49872,0,0,0,0,0
0.442,6,8,335,4,0,147,0,164,4,7,90,7,171
1763.637,2,16,512,16,8,117575,8,512,0,0,0,0,0
0.169,17,2,148,1,32,0,32,60,1,60,0,60,88
8.178,17,12,1764,6,48,1632,48,456,6,190,1632,308,1308
0.002,6,2,87,1,0,0,0,40,1,7,0,7,47
1780.368,17,140,11200,70,48,25802,48,5320,70,56,25802,56,5880
1091.082,17,216,16416,216,48,5074,48,16416,0,0,0,0,0
1772.639,6,180,15480,120,69,14896,69,8940,60,69,30039,69,6540
1787.198,6,106,8524,68,66,26674,66,4964,38,60,48298,60,3560
91.17,17,8,2688,8,308,13024,308,2688,0,0,0,0,0
0.048,17,2,214,1,39,0,39,67,1,119,0,119,147
63.261,6,25,4561,9,296,2623,722,1365,16,214,4205,1408,3196
1786.558,6,102,8228,68,64,26665,64,4896,34,58,54135,58,3332
0.126,6,9,1002,5,213,31,213,417,4,421,35,421,585
0.086,17,2,376,1,39,0,39,67,1,281,0,281,309
1784.737,6,444,27024,221,69,8112,69,13394,223,36,8039,69,13630
20.443,6,23,6180,14,117,1572,159,1337,9,873,2554,1675,4843
0.146,17,2,180,1,30,0,30,58,1,94,0,94,122
0.337,17,4,1305,4,298,112,332,1305,0,0,0,0,0
1799.377,1,170,18020,170,78,10647,78,18020,0,0,0,0,0
1070.518,17,210,15960,210,48,5122,48,15960,0,0,0,0,0
0.851,6,26,7256,12,155,77,267,1261,14,603,62,1400,5995
0.9,6,10,1687,7,100,150,100,384,3,1179,322,1179,1303
1729.212,6,60,4400,40,33,44338,33,2740,20,31,91001,31,1660
303.439,6,60,41033,40,1154,7780,1408,33258,20,961,3233,3847,7775
306.112,6,923,807187,372,707,825,1418,35143,551,1394,556,1418,772044
3.51,17,4,240,4,32,1170,32,240,0,0,0,0,0
2.065,6,3,156,2,0,2065,0,104,1,0,0,0,52
1740.507,17,24,5544,24,203,75674,203,5544,0,0,0,0,0
255.88,17,4,352,2,60,255879,60,176,2,60,255879,60,176
65.85,6,27,7177,13,155,5487,267,1306,14,530,5064,3417,5871
1749.495,6,95,7203,63,38,28217,205,4476,32,33,56421,98,2727
8.615,17,4,240,2,32,8614,32,120,2,32,8615,32,120
1799.671,17,142,11360,71,48,25709,48,5396,71,56,25709,56,5964
81.671,6,956,881106,537,139,152,213,30248,419,2007,195,16896,850858
280.253,6,27,7312,13,158,23354,267,1317,14,775,21556,4836,5995
94.714,6,21,8184,11,511,85,1194,2017,10,959,10505,1791,6167
426.404,6,38,9017,18,141,16022,505,1854,20,353,22438,1420,7163
1.257,6,28,8160,15,222,76,540,1964,13,944,88,1591,6196
1.13,6,25,8068,12,164,87,267,1300,13,869,80,1408,6768
22.739,6,16,3722,3,92,131,92,256,13,253,1879,1408,3466
280.213,6,27,7312,12,158,25473,267,1277,15,678,20011,2800,6035
72.909,6,31,16995,15,648,55,1460,3236,16,1310,4850,2920,13759
6.93,6,536,472176,343,1312,19,1368,457476,193,776,34,1473,14700
4.098,6,184,155284,77,279,53,859,5689,107,1411,36,4254,149595
1799.706,17,3532,169536,1759,20,1023,20,84432,1773,20,1015,20,85104
1797.137,17,447,39864,402,35,4481,288,25644,45,288,40019,288,14220
124.0,6,34,7935,12,155,28,267,1266,22,340,5904,3417,6669
12.856,6,9,3346,5,30,3213,30,314,4,1418,4089,1418,3032
1789.168,6,109,8655,70,64,25929,64,5040,39,58,47081,83,3615
0.972,6,22,5960,12,108,88,147,919,10,927,96,1608,5041
1798.669,17,342,84813,342,219,5274,422,84813,0,0,0,0,0
83.957,6,781,362066,402,837,209,1152,341060,379,417,221,1179,21006
1794.196,6,354,22509,206,69,8752,69,12380,148,69,12205,69,10129
1.232,6,26,8108,13,164,87,267,1340,13,869,87,1408,6768
104.716,6,9688,9794810,3230,194,32,429,181006,6458,1437,16,2880,9613804
0.594,6,2,104,1,0,0,0,40,1,0,0,0,64
1792.058,6,358,22669,209,69,8615,69,12569,149,69,12108,69,10100
1786.931,6,102,8228,68,64,26670,64,4896,34,58,54146,58,3332
145.19,6,36,19787,17,651,9073,1396,4823,19,1997,8065,3836,14964
0.251,6,26,8581,14,219,19,531,1613,12,1056,22,1408,6968
1797.034,17,448,39896,403,35,4470,288,25676,45,288,40018,288,14220
1773.223,6,182,15698,120,69,14901,69,8940,62,69,29063,69,6758
1.026,17,3,286,2,46,1000,46,148,1,110,0,110,138
56.236,17,4,240,2,32,56235,32,120,2,32,56235,32,120
1795.439,1,166,9296,166,28,10881,28,9296,0,0,0,0,0
1.658,17,2,144,1,36,0,36,64,1,52,0,52,80
6.796,6,507,444180,319,1328,20,1368,429740,188,776,35,2736,14440
20.147,6,21,6047,12,147,1831,318,1233,9,867,2516,1418,4814
1625.001,6,221,18869,85,77,18987,339,8529,136,71,12037,1062,10340
306.157,6,17,1616,2,106,7420,106,194,15,79,21867,90,1422
1.213,6,178,152729,117,1346,10,1432,146068,61,420,19,1432,6661
0.384,6,10,1992,5,288,89,288,508,5,424,54,434,1484
328.4,6,32,7802,17,275,20525,275,1238,15,992,2025,1440,6564
151.617,6,94,68855,61,1240,2526,1408,58998,33,739,3432,2439,9857
6.207,6,1484,1420957,971,1389,6,1408,1389617,513,931,11,2801,31340
96.619,6,29,7666,7,155,431,267,1066,22,317,4600,1460,6600
0.386,6,12,1653,6,288,71,288,548,6,426,43,434,1105
1782.212,6,84,4496,42,26,43467,26,2248,42,26,43467,26,2248
0.353,6,14,5618,6,106,70,106,354,8,822,9,1420,5264
0.261,17,2,420,1,39,0,39,67,1,325,0,325,353
1.148,6,25,8080,12,164,88,267,1312,13,869,81,1408,6768
8.184,6,19,8221,9,275,1023,275,643,10,1194,847,1414,7578
1786.209,6,113,8906,72,64,25157,64,5120,41,58,44652,58,3786
1734.772,1,56,4704,56,56,31541,56,4704,0,0,0,0,0
3.012,17,4,338,2,34,3003,34,124,2,79,3003,79,214
95.95,6,36,7882,15,141,6853,267,1455,21,348,4788,1460,6427
1763.979,2,13,416,13,8,146998,8,416,0,0,0,0,0
1.169,6,23,7952,12,164,90,267,1288,11,1216,99,4224,6664
0.15,6,9,527,5,43,37,43,311,4,0,45,0,216
5.133,6,92,81133,59,174,88,281,3982,33,2514,160,7040,77151
1560.427,17,70,2940,70,14,22614,14,2940,0,0,0,0,0
5.044,6,35,6209,18,206,296,314,2784,17,548,297,1179,3425
1785.801,6,104,8308,68,64,26653,64,4896,36,58,51020,58,3412
999.52,1,6,336,6,28,199904,28,336,0,0,0,0,0
1786.614,6,103,8395,68,65,26665,65,4930,35,59,52544,59,3465
281.314,6,31,7610,12,158,25574,267,1277,19,464,15605,1400,6333
1405.229,6,279,17715,162,69,8728,69,9792,117,69,12113,69,7923
0.046,17,2,462,2,203,46,360,462,0,0,0,0,0
16.208,17,19,11276,9,538,2022,1350,5095,10,590,1797,1350,6181
19.254,6,835,702508,488,1357,39,1368,676852,347,776,55,1473,25656
1770.165,6,218,14796,88,46,20344,46,6606,130,46,13722,46,8190
49.639,6,24,7025,11,312,4959,517,1841,13,750,4133,2409,5184
2.064,17,4,314,2,31,2031,31,118,2,70,2021,70,196
362.688,6,37,15291,24,168,15769,1287,2841,13,1324,52,4080,12450
0.922,6,11,1727,7,100,153,100,384,4,589,215,1152,1343
0.004,17,2,173,1,39,0,39,67,1,78,0,78,106
40.906,6,885,768799,535,1358,76,1368,742665,350,838,116,1368,26134
1750.144,6,95,7203,63,38,28228,205,4476,32,33,56449,98,2727
1740.288,6,90,6521,59,31,30004,31,3998,31,31,58008,31,2523
1793.097,1,244,13664,244,28,7379,28,13664,0,0,0,0,0
3.67,6,5,260,2,0,924,0,104,3,0,1835,0,156
1799.468,17,4256,204288,2128,20,846,20,102144,2128,20,846,20,102144
0.702,17,4,288,2,36,654,36,128,2,52,654,52,160
0.172,6,3,120,1,0,0,0,40,2,0,172,0,80
1772.498,6,180,15480,120,69,14894,69,8940,60,69,30034,69,6540
375.01,6,27,1767,18,177,22059,177,1181,9,110,8773,110,586
1787.902,6,374,26206,213,98,8433,469,15143,161,69,11174,69,11063
13.302,6,2441,2253195,1549,1375,8,1408,2202147,892,931,14,2816,51048
1744.563,6,95,7203,63,38,28138,205,4476,32,33,56266,98,2727
1789.394,6,364,25392,212,100,8480,469,14896,152,69,11848,69,10496
1771.225,6,99,9174,66,64,27249,64,5544,33,58,55347,58,3630
11.018,6,22,4526,12,275,1001,275,1038,10,768,692,1440,3488
1772.159,6,180,15480,120,69,14892,69,8940,60,69,30033,69,6540
1794.815,17,66,2766,65,14,28043,14,2730,1,8,0,8,36
0.177,17,3,2906,3,940,88,1451,2906,0,0,0,0,0
0.14,6,5,310,3,31,70,31,175,2,31,0,31,135
3.003,1,3,318,3,78,1501,78,318,0,0,0,0,0
1791.844,6,362,22898,210,69,8573,69,12678,152,69,11866,69,10220
1619.61,6,30,4313,19,241,89978,241,2953,11,92,161918,92,1360
2.997,17,7,710,4,46,998,46,296,3,110,1492,110,414
15.04,6,2690,2518776,1683,1416,8,1448,2461180,1007,776,14,1448,57596
1680.919,1,15,840,15,28,120065,28,840,0,0,0,0,0
2.237,6,32,6433,18,154,131,267,1964,14,780,151,1460,4469
3.771,17,2,152,2,48,3771,48,152,0,0,0,0,0
1798.747,17,449,39928,404,35,4463,288,25708,45,288,40020,288,14220
129.245,6,178,138609,113,1274,1153,1408,125719,65,730,1973,3847,12890
251.422,2,2,64,2,8,251422,8,64,0,0,0,0,0
365.76,6,18,1242,14,180,28135,180,916,4,110,20063,110,326
2.288,6,109,68420,61,1299,38,1432,58385,48,506,42,1432,10035
35.07,6,29,4990,14,180,2697,722,1807,15,342,2467,1448,3183
374.703,6,18,1242,14,180,28823,180,916,4,110,20065,110,326
1782.491,6,357,22629,208,69,8611,69,12529,149,69,12043,69,10100
1796.45,17,449,39928,404,35,4457,288,25708,45,288,40019,288,14220
700.489,6,44,3497,25,50,25208,205,1911,19,35,38904,98,1586
1.253,6,49,20132,28,890,46,1360,14516,21,433,54,1360,5616
1740.639,6,87,6322,58,31,30537,31,3915,29,31,62164,31,2407
0.01,17,2,453,1,58,0,58,86,1,339,0,339,367
33.559,6,29,5002,14,180,2581,722,1819,15,342,2383,1408,3183
756.048,2,6,192,6,8,151209,8,192,0,0,0,0,0
1782.407,17,83,3480,82,14,22005,14,3444,1,8,0,8,36
1669.901,1,8,448,8,28,238557,28,448,0,0,0,0,0
1749.406,6,94,7151,62,38,28678,205,4424,32,33,56419,98,2727
11.329,17,6,528,3,48,5658,48,228,3,72,5657,72,300
0.202,1,2,112,2,28,202,28,112,0,0,0,0,0
2.15,17,19,5088,19,239,119,389,5088,0,0,0,0,0
128.396,6,49,11615,22,303,6114,1189,4527,27,352,2623,1460,7088
503.606,2,5,160,5,8,125901,8,160,0,0,0,0,0
2.509,6,14,2351,8,188,358,245,700,6,703,451,1152,1651
1791.706,6,362,22967,211,69,8531,69,12787,151,69,11943,69,10180
74.451,6,5656,5310289,3884,1292,19,1408,5212298,1772,1148,41,2411,97991
1788.243,6,361,22858,210,69,8556,69,12609,151,69,11921,69,10249
14.865,6,24,6993,13,275,1238,275,1078,11,910,986,1440,5915
8.175,6,13,5668,4,106,2725,106,274,9,718,980,1460,5394
1797.065,17,448,39896,403,35,4470,288,25676,45,288,40015,288,14220
2.391,6,2,1520,1,0,0,0,40,1,1440,0,1440,1480
1783.719,6,103,8404,68,66,26622,66,4964,35,60,52459,60,3440
1790.823,6,243,25050,97,68,18652,681,9248,146,136,12349,2720,15802
13.626,6,24,6993,13,275,1135,275,1078,11,910,861,1440,5915
5.876,17,38,20316,19,573,326,1350,11425,19,439,269,1350,8891
1793.644,6,374,23654,214,69,8420,69,13114,160,69,11280,69,10540
3.29,6,22,8470,12,337,299,673,1557,10,928,338,2720,6913
0.647,6,30,11616,14,227,49,547,1676,16,1011,42,1408,9940
1790.672,6,356,22520,208,69,8650,69,12460,148,69,12181,69,10060
1781.306,6,352,22360,205,69,8731,69,12340,147,69,12200,69,10020
1786.638,1,66,5544,66,56,27486,56,5544,0,0,0,0,0
3.313,17,2,778,2,361,3313,361,778,0,0,0,0,0
27.266,17,6,888,5,129,6816,136,788,1,72,0,72,100
146.185,6,22,8961,11,514,83,1236,2014,11,927,14600,1460,6947
5.383,6,37,7189,19,218,299,314,3383,18,513,298,1179,3806
236.65,17,4,272,2,32,236638,32,120,2,48,236636,48,152
3.476,17,5,290,5,30,869,30,290,0,0,0,0,0
1779.725,17,142,11360,71,48,25424,48,5396,71,56,25423,56,5964
1.527,6,48,18728,27,857,58,1360,13112,21,476,65,2715,5616
1770.731,6,106,9604,66,65,27242,65,5577,40,59,45401,59,4027
300.548,6,38,8676,20,336,15818,999,2202,18,441,495,1360,6474
0.01,6,3,120,2,0,10,0,80,1,0,0,0,40
0.417,6,12,1653,6,288,82,288,548,6,426,49,434,1105
1783.58,6,104,8444,68,66,26620,66,4964,36,60,50949,60,3480
1797.704,17,448,39612,404,35,4460,288,25708,44,288,40947,288,13904
26.416,1,2,112,2,28,26416,28,112,0,0,0,0,0
301.229,6,41,26083,25,1185,12551,1440,20275,16,828,2022,1440,5808
1787.905,6,355,22549,207,69,8679,69,12420,148,69,12162,69,10129
72.581,17,4,352,2,60,72580,60,176,2,60,72580,60,176
1774.956,1,124,6944,124,28,14430,28,6944,0,0,0,0,0
138.262,17,4,272,2,40,138261,47,136,2,40,138261,47,136
32.371,6,41,10406,20,769,827,1360,4702,21,346,1607,1360,5704
1795.585,17,447,39580,403,35,4466,288,25676,44,288,40952,288,13904
0.865,6,10,1687,7,100,144,100,384,3,1179,307,1179,1303
1776.536,17,73,3060,72,14,25021,14,3024,1,8,0,8,36
1771.398,6,106,9892,69,66,26049,66,5856,37,60,49202,60,4036
238.996,2,2,64,2,8,238996,8,64,0,0,0,0,0
4.54,17,2,656,2,300,4540,300,656,0,0,0,0,0
503.858,2,5,160,5,8,125964,8,160,0,0,0,0,0
2.143,6,5,338,3,138,1071,138,258,2,0,0,0,80
1.591,6,50,18737,27,852,61,1360,13041,23,433,62,1360,5696
1783.81,6,359,22709,209,69,8576,69,12569,150,69,11971,69,10140
240.268,6,43,8986,21,523,12013,1408,5810,22,224,11441,617,3176
5.82,6,36,6249,19,206,323,314,2824,17,548,345,1179,3425
0.021,17,8,1670,8,180,3,219,1670,0,0,0,0,0
365.913,6,18,1239,14,177,28147,177,913,4,110,20055,110,326
4.204,17,5,295,5,31,1051,31,295,0,0,0,0,0
45.941,6,26,6797,12,181,4176,267,1212,14,627,3533,1400,5585
0.538,6,23,7397,13,334,44,663,2021,10,967,56,1471,5376
248.522,6,9,528,2,112,248510,112,200,7,0,41418,0,328
1799.746,1,188,10528,188,28,9624,28,10528,0,0,0,0,0
1.372,6,46,19301,27,903,52,1360,13765,19,529,66,4075,5536
0.406,6,12,1653,6,288,77,288,548,6,426,42,434,1105
81.052,6,22,900,10,0,5283,0,404,12,0,7367,0,496
383.151,6,23,1723,17,31,23946,31,1225,6,31,60176,31,498
0.949,6,52,13869,24,551,41,1429,4840,28,438,34,1460,9029
448.922,6,40,7553,24,127,19518,516,2242,16,388,25235,1452,5311
1735.475,1,56,4704,56,56,31554,56,4704,0,0,0,0,0
0.013,17,2,499,1,47,0,47,75,1,396,0,396,424
1776.889,17,142,11360,71,48,25383,48,5396,71,56,25383,56,5964
6.021,17,5,562,4,32,1332,32,240,1,294,0,294,322
280.278,6,27,7312,12,158,25479,267,1277,15,678,20014,2045,6035
1795.082,6,306,32922,154,156,11732,208,25881,152,31,11885,31,7041
1.357,6,46,19160,27,893,52,1360,13624,19,476,65,2715,5536
125.325,6,40,25118,23,884,30,1360,6341,17,1808,7823,4416,18777
0.847,17,4,624,2,64,845,64,184,2,192,730,192,440
1786.683,6,103,8470,69,66,26274,66,5070,34,60,54134,60,3400
0.332,6,27,9112,13,271,27,726,1771,14,943,24,1402,7341
511.924,1,16,896,16,28,34128,28,896,0,0,0,0,0
1788.709,6,126,12421,77,62,23535,722,6371,49,89,37259,1448,6050
0.477,6,29,7078,17,242,29,646,2384,12,701,41,1688,4694
104.334,6,23,10009,12,531,64,1360,2637,11,1384,10419,3934,7372
1783.81,6,364,24454,211,88,8494,469,13987,153,69,11735,69,10467
124.814,6,37,8055,13,155,26,267,1306,24,304,5426,1420,6749
0.456,17,3,1164,3,360,228,360,1164,0,0,0,0,0
13.848,6,2127,1945568,1310,1404,10,1448,1898420,817,776,16,1448,47148
0.982,6,25,9321,14,290,75,803,1754,11,1185,80,2570,7567
1773.466,1,57,4788,0,0,0,0,0,57,56,31669,56,4788
373.618,6,23,1535,16,177,24907,177,1053,7,110,10396,110,482
0.566,6,7,371,4,0,188,0,204,3,7,122,7,167
1786.703,6,106,8524,68,66,26667,66,4964,38,60,48286,60,3560
1744.633,2,27,864,27,8,67101,8,864,0,0,0,0,0
1768.571,1,61,5124,0,0,0,0,0,61,56,29476,56,5124
185.033,6,97,71943,63,1250,2984,1408,62038,34,739,3425,2439,9905
1799.063,17,755,45554,755,32,2386,37,45554,0,0,0,0,0
0.871,17,3,1167,3,361,435,361,1167,0,0,0,0,0
1772.32,6,180,15480,120,69,14893,69,8940,60,69,30038,69,6540
1789.2,6,380,30205,215,75,8360,267,13733,165,137,10909,1452,16472
1788.953,17,87,3648,86,14,21046,14,3612,1,8,0,8,36
280.831,6,32,7853,14,158,21602,267,1357,18,524,16518,1400,6496
1772.544,6,180,15480,120,69,14895,69,8940,60,69,30040,69,6540
1793.495,17,180,11520,180,36,10019,36,11520,0,0,0,0,0
1789.041,17,142,11360,71,48,25557,48,5396,71,56,25557,56,5964
0.941,6,2,80,1,0,0,0,40,1,0,0,0,40
1741.955,6,126,11196,71,90,24885,205,7132,55,31,32253,33,4064
4.281,17,5,295,5,31,1070,31,295,0,0,0,0,0
842.43,2,8,256,8,8,120347,8,256,0,0,0,0,0
2.877,6,2,88,2,0,0,0,88,0,0,0,0,0
1790.331,17,311,51217,311,136,5775,389,51217,0,0,0,0,0
188.094,6,29,8832,14,158,14468,267,1357,15,858,13430,2045,7475
1218.046,6,1116,1165198,455,155,2682,873,31325,661,1799,1845,11344,1133873
734.462,6,161,10304,85,69,8094,69,5401,76,69,9792,69,4903
1787.333,6,104,8435,69,65,26284,65,4970,35,59,52564,59,3465
3.12,1,5,420,5,56,780,56,420,0,0,0,0,0
5.982,6,642,594430,420,1345,13,1368,576250,222,776,26,1473,18180
7.059,6,6,240,0,0,0,0,0,6,0,0,0,240
1.315,6,24,8004,12,164,101,267,1288,12,1014,101,2331,6716
0.015,17,2,144,1,36,0,36,64,1,52,0,52,80
0.576,17,8,2934,8,338,82,361,2934,0,0,0,0,0
46.406,6,14,2871,6,105,9281,105,458,8,298,6628,341,2413
0.159,6,2,142,1,62,0,62,102,1,0,0,0,40
1789.945,6,378,25897,215,92,8364,469,14892,163,69,11049,69,11005
299.222,17,4,240,2,32,299221,32,120,2,32,299221,32,120
1783.177,17,83,3480,82,14,22014,14,3444,1,8,0,8,36
1.645,6,13,2311,8,188,235,245,700,5,1407,350,1407,1611
301.974,1,6,336,6,28,60394,28,336,0,0,0,0,0
1112.346,17,218,16568,218,48,5126,48,16568,0,0,0,0,0
73.385,6,34,10942,19,589,4076,1408,4567,15,558,5217,1408,6375
1745.288,6,95,7203,63,38,28149,205,4476,32,33,56286,98,2727
0.543,6,20,7229,13,334,45,663,2021,7,1209,82,1946,5208
0.171,6,9,1343,5,145,42,145,349,4,830,51,830,994
148.264,17,14,1232,7,48,24709,48,532,7,72,24709,72,700
1624.36,2,17,544,17,8,101522,8,544,0,0,0,0,0
283.042,6,33,7063,15,168,11845,516,1615,18,314,16644,1452,5448
180.364,6,32,8952,14,158,13874,267,1357,18,624,10604,1400,7595
0.394,1,2,112,2,28,394,28,112,0,0,0,0,0
1664.233,17,398,42748,190,133,8793,1350,30611,208,30,8039,60,12137
0.093,17,2,588,1,39,0,39,67,1,493,0,493,521
1790.933,1,106,5936,106,28,17056,28,5936,0,0,0,0,0
1.625,17,16,6596,8,479,232,1350,4062,8,288,197,1350,2534
0.479,6,21,7217,12,318,42,599,1905,9,967,56,1471,5312
4.072,17,5,295,5,31,1018,31,295,0,0,0,0,0
3.02,17,3,174,3,30,1510,30,174,0,0,0,0,0
0.308,6,22,5040,10,137,34,267,1092,12,577,26,1400,3948
36.106,6,39,8562,16,333,45,685,1672,23,331,1634,3488,6890
1.245,6,25,8056,12,164,95,267,1288,13,869,87,1408,6768
156.182,6,50,10352,31,266,5206,1360,4745,19,402,480,2667,5607
25.953,6,28,7352,13,158,2162,267,1317,15,678,1851,3436,6035
0.707,2,2,80,2,16,707,16,80,0,0,0,0,0
240.294,6,43,9046,21,519,12014,1402,5776,22,235,11442,618,3270
1781.961,1,56,4704,0,0,0,0,0,56,56,32399,56,4704
1786.702,6,109,8771,71,65,25524,65,5245,38,59,48286,59,3526
280.409,6,30,7432,13,158,23367,267,1317,17,543,17518,1400,6115
223.304,17,4,352,2,60,223303,60,176,2,60,223302,60,176
0.335,6,26,8913,13,242,27,610,1655,13,939,27,1408,7258
1795.766,6,356,22520,208,69,8675,69,12460,148,69,12215,69,10060
5.367,6,22,4522,12,226,487,597,1753,10,560,574,1767,2769
1795.073,17,448,39896,403,35,4465,288,25676,45,288,40021,288,14220
0.514,6,4,220,2,0,514,0,100,2,0,303,0,120
1790.803,1,342,28728,342,56,5251,56,28728,0,0,0,0,0
1794.708,17,142,11360,71,48,25638,48,5396,71,56,25638,56,5964
3.495,17,5,290,5,30,873,30,290,0,0,0,0,0
1783.858,6,338,29869,191,75,9388,267,12635,147,145,12218,3417,17234
250.67,17,8,5015,8,598,35810,1238,5015,0,0,0,0,0
1799.695,1,345,28980,345,56,5231,56,28980,0,0,0,0,0
7.071,6,528,471102,342,1314,20,1368,456766,186,776,37,2736,14336
1.387,6,47,18543,26,911,55,1460,12927,21,433,60,1460,5616
2.088,17,3,660,2,46,998,46,148,1,484,0,484,512
0.14,17,2,152,1,48,0,48,76,1,48,0,48,76
0.152,17,2,198,1,39,0,39,67,1,103,0,103,131
1772.616,6,180,15480,120,69,14895,69,8940,60,69,30035,69,6540
10.604,6,20,4442,11,275,1060,275,998,9,768,728,1440,3444
0.3,6,21,5000,10,137,33,267,1092,11,692,27,1467,3908
3.721,17,5,588,4,64,1124,64,368,1,192,0,192,220
1794.902,6,84,4472,43,26,42734,26,2288,41,26,44871,26,2184
71.076,6,9,576,2,64,70912,64,176,7,0,11818,0,400
1787.558,6,104,8308,68,64,26679,64,4896,36,58,51070,58,3412
0.118,17,2,348,1,39,0,39,67,1,253,0,253,281
293.355,6,260,41694,140,304,2110,304,29052,120,83,2462,83,12642
383.769,6,18,1242,14,180,29520,180,916,4,110,20063,110,326
1383.642,2,10,320,10,8,153738,8,320,0,0,0,0,0
4.0,17,12,13963,6,1140,800,1350,7009,6,1131,620,1350,6954
3.187,17,5,290,5,30,796,30,290,0,0,0,0,0
12.51,6,30,8022,13,273,1042,721,1889,17,495,693,1420,6133
60.462,6,26,7137,12,155,5496,267,1266,14,530,4650,2006,5871
280.539,6,27,7312,13,158,23378,267,1317,14,775,21571,4836,5995
135.027,6,134,100400,82,1292,1667,1448,89580,52,675,1587,1448,10820
0.066,1,2,112,2,28,66,28,112,0,0,0,0,0
1797.759,6,356,22952,208,76,8684,501,12892,148,69,12229,69,10060
2.748,17,2,136,1,32,0,32,60,1,48,0,48,76
1.935,17,3,1170,3,362,967,362,1170,0,0,0,0,0
108.213,6,36,8249,11,142,3434,267,1301,25,282,4508,1420,6948
5.032,17,4,288,2,36,5000,36,128,2,52,5000,52,160
378.795,6,23,1499,14,177,29138,177,913,9,110,11780,110,586
1785.861,6,388,26904,221,96,8117,469,15808,167,69,10758,69,11096
114.854,17,6,496,3,48,57419,48,228,3,61,57417,72,268
1796.891,6,940,168527,620,304,2902,304,126208,320,83,5632,83,42319
1.118,6,16,4459,9,327,134,634,1784,7,767,180,1328,2675
1740.551,6,87,6322,58,31,30535,31,3915,29,31,62161,31,2407
178.605,17,4,3382,4,817,59535,1447,3382,0,0,0,0,0
1786.281,6,104,8504,69,66,26268,66,5004,35,60,52535,60,3500
0.039,17,2,417,1,45,0,45,73,1,316,0,316,344
0.0,17,1,382,1,354,0,354,382,0,0,0,0,0
280.487,6,30,7432,13,158,23373,267,1317,17,603,17524,2076,6115
16.466,6,1946,1761096,1231,1375,13,1380,1725118,715,468,23,3303,35978
65.563,17,4,1344,4,308,21854,308,1344,0,0,0,0,0
0.083,6,10,1514,5,503,20,503,771,5,475,20,475,743
230.622,17,4,352,2,60,230620,60,176,2,60,230621,60,176
300.881,6,46,17333,26,969,12035,1460,11731,20,399,458,1460,5602
1744.18,6,95,7203,63,38,28131,205,4476,32,33,56251,98,2727
1784.869,6,102,8364,68,66,26639,66,4964,34,60,54083,60,3400
21.68,6,26,7084,12,275,1970,275,1038,14,781,1100,1440,6046
1799.066,6,358,22669,209,69,8649,69,12500,149,69,12155,69,10169
1.307,6,46,18658,27,857,50,1360,13122,19,476,62,2715,5536
55.189,6,10,799,10,31,6132,31,799,0,0,0,0,0
240.181,6,52,16040,28,693,8895,1402,13259,24,217,10442,580,2781
271.135,17,6,360,3,32,135567,32,180,3,32,135566,32,180
0.012,17,2,440,1,60,0,60,88,1,324,0,324,352
1773.111,6,180,15480,120,69,14900,69,8940,60,69,30048,69,6540
0.022,6,2,84,1,0,0,0,44,1,0,0,0,40
8.964,6,1329,1221664,865,1363,10,1432,1198801,464,427,19,1432,22863
0.323,17,2,184,1,32,0,32,60,1,96,0,96,124
1799.884,6,205,14180,75,46,23918,46,5990,130,46,13952,46,8190
0.244,6,9,1050,5,261,61,261,465,4,421,67,421,585
240.55,6,6,280,2,0,240550,0,88,4,0,2373,0,192
1624.306,2,15,480,15,8,116021,8,480,0,0,0,0,0
0.749,6,22,7342,13,335,62,668,2026,9,1210,86,1946,5316
12.365,6,1905,1704041,1154,1421,10,1432,1669780,751,420,16,1432,34261
280.471,6,29,7392,13,158,23372,267,1317,16,603,18695,2076,6075
0.788,6,10,1687,7,100,131,100,384,3,1179,263,1179,1303
240.197,6,53,18151,28,811,8896,1408,15259,25,198,10008,580,2892
33.66,17,20,1760,10,48,3738,48,760,10,72,3738,72,1000
1745.576,6,94,7151,62,38,28616,205,4424,32,33,56299,98,2727
0.354,6,26,8903,13,234,29,575,1620,13,942,28,1438,7283
7.089,6,1773,1615410,1075,1421,6,1448,1574450,698,776,9,1448,40960
1.207,6,12,1423,6,279,205,279,611,6,164,205,272,812
1763.827,2,14,448,14,8,135679,8,448,0,0,0,0,0
280.47,6,29,7392,13,158,23372,267,1317,16,678,18695,3456,6075
1787.904,6,355,22480,207,69,8679,69,12420,148,69,12162,69,10060
2.979,17,26,10289,11,485,297,1350,5649,15,281,121,1350,4640
1798.838,17,449,39928,404,35,4463,288,25708,45,288,40014,288,14220
1.155,6,208,159810,122,1336,9,1420,151974,86,438,13,3303,7836
1785.754,6,416,24920,208,69,8626,69,12460,208,34,8626,64,12460
1638.144,2,9,288,9,8,204768,8,288,0,0,0,0,0
0.061,6,20,10021,12,125,5,125,793,8,2201,8,3012,9228
3.171,17,10,1450,5,40,772,40,340,5,194,778,194,1110
0.998,6,25,9552,14,350,76,1041,1992,11,1015,81,1460,7560
0.302,6,25,8810,13,231,25,563,1608,12,1095,27,2816,7202
1753.415,1,207,11592,207,28,8511,28,11592,0,0,0,0,0
993.067,6,54,4268,30,65,26112,65,2175,24,49,43172,59,2093
18.779,17,39,14669,19,529,1041,1350,10592,20,175,986,1350,4077
1797.144,1,212,11872,212,28,8517,28,11872,0,0,0,0,0
4.42,6,35,6209,19,206,245,314,2824,16,548,278,1179,3385
1785.839,6,115,12244,74,135,24463,1253,7969,41,71,44643,247,4275
9.084,6,24,10942,12,275,825,275,763,12,1210,738,1440,10179
10.792,6,18,5610,10,275,1199,275,958,8,1440,825,1440,4652
280.296,6,28,7352,12,158,25481,267,1277,16,603,18685,1400,6075
1789.341,17,83,3480,82,14,22090,14,3444,1,8,0,8,36
172.13,6,1580,777829,857,841,201,1152,741001,723,395,238,1179,36828
16.746,6,12,1601,7,106,1493,106,606,5,393,4173,697,995
281.529,6,29,7392,13,158,23460,267,1317,16,603,18746,2036,6075
1788.323,17,331,76460,331,202,5419,422,76460,0,0,0,0,0
1799.912,17,144,11520,72,48,25350,48,5472,72,56,25350,56,6048
155.859,1,11,1980,11,152,15585,152,1980,0,0,0,0,0
1787.721,6,359,22709,209,69,8594,69,12569,150,69,11995,69,10140
1653.48,1,7,742,7,78,275580,78,742,0,0,0,0,0
33.724,6,31,5096,15,154,2408,722,1860,16,342,2235,1408,3236
3.303,17,3,228,2,48,3048,48,152,1,48,0,48,76
1740.514,6,87,6322,58,31,30535,31,3915,29,31,62160,31,2407
3.127,6,4,176,1,0,0,0,44,3,0,1518,0,132
280.475,6,30,7432,14,158,21575,267,1357,16,678,18696,3456,6075
8.823,6,3,180,3,0,0,0,180,0,0,0,0,0
11.374,6,1813,1572444,1097,1379,10,1420,1539583,716,467,15,1883,32861
5.207,6,40,7325,21,201,260,314,3463,19,516,275,1179,3862
1740.672,6,87,6322,58,31,30538,31,3915,29,31,62166,31,2407
1680.488,1,15,840,15,28,120034,28,840,0,0,0,0,0
5.259,6,40,7309,21,218,262,314,3463,19,440,277,1152,3846
28.483,6,48,13310,23,188,1294,721,2808,25,730,1144,1414,10502
133.793,6,3495,3135871,1798,378,74,426,103978,1697,1740,74,15488,3031893
1676.318,17,15,3426,15,200,119737,682,3426,0,0,0,0,0
8.056,6,735,655256,467,1331,16,1368,635544,268,776,29,1473,19712
1.013,17,13,6081,6,551,193,1350,3478,7,343,156,1350,2603
0.265,6,24,6064,12,181,24,537,1526,12,651,23,1408,4538
0.88,6,11,1727,7,100,146,100,384,4,589,211,1152,1343
1791.224,6,118,13861,77,80,23568,512,6072,41,157,44777,1380,7789
280.384,6,30,7432,13,158,23365,267,1317,17,543,17514,1400,6115
1774.763,1,8,848,8,78,253537,78,848,0,0,0,0,0
1708.078,1,113,6328,113,28,15250,28,6328,0,0,0,0,0
1786.125,6,110,8728,69,64,26266,64,5000,41,58,44650,58,3728
2.542,17,3,1176,3,364,1271,364,1176,0,0,0,0,0
109.0,6,342,293520,136,288,807,912,8824,206,1356,531,1804,284696
1.024,6,29,8200,15,222,61,540,1964,14,944,64,1591,6236
107.631,6,943,463094,512,837,210,1152,441063,431,435,249,1179,22031
126.052,2,2,64,2,8,126052,8,64,0,0,0,0,0
1782.202,6,209,16709,134,69,13400,69,9569,75,69,24083,69,7140
1794.318,17,313,63965,313,176,5751,422,63965,0,0,0,0,0
0.039,17,4,768,2,39,35,39,134,2,289,34,289,634
1740.971,6,88,6374,58,31,30543,31,3915,30,31,60033,31,2459
0.102,17,2,904,2,424,102,548,904,0,0,0,0,0
1793.307,6,407,24858,197,69,9149,69,12020,210,36,8580,69,12838
1773.451,6,180,15480,120,69,14902,69,8940,60,69,30052,69,6540
2.209,17,4,1560,4,362,736,362,1560,0,0,0,0,0
280.029,6,30,7432,13,158,23335,267,1317,17,543,17500,1400,6115
0.758,6,22,7342,13,335,63,668,2026,9,1210,90,2736,5316
2.688,6,25,8091,11,330,264,517,1914,14,777,203,1418,6177
1.957,17,28,16962,16,867,130,1350,14327,12,191,146,1350,2635
1786.009,6,125,14081,81,80,22325,500,6156,44,146,41532,1420,7925
1.286,6,221,170822,130,1336,9,1420,162891,91,475,14,1883,7931
280.341,6,29,7392,13,158,23361,267,1317,16,603,18684,1400,6075
244.322,17,4,352,2,60,244321,60,176,2,60,244321,60,176
1772.202,6,180,15480,120,69,14892,69,8940,60,69,30032,69,6540
11.776,6,1879,1626646,1147,1362,10,1380,1592720,732,421,16,1923,33926
0.72,17,4,1116,2,32,715,32,120,2,470,646,470,996
3.351,17,8,1012,4,31,1112,31,236,4,166,1112,196,776
0.143,6,10,1184,5,145,35,145,349,5,631,26,631,835
172.269,17,5,380,5,48,43067,48,380,0,0,0,0,0
0.081,6,6,897,3,483,21,483,639,3,102,20,102,258
1794.21,6,356,22520,208,69,8667,69,12460,148,69,12205,69,10060
1770.921,6,99,9240,66,65,27244,65,5577,33,59,55338,59,3663
8.807,6,34,8211,16,199,587,721,2038,18,544,457,1414,6173
61.417,6,17,6356,9,170,7677,170,646,8,1057,8741,1408,5710
14.364,6,14,3372,7,151,2363,210,674,7,579,2363,1408,2698
0.362,17,4,608,2,60,66,60,176,2,188,60,188,432
0.644,17,15,7242,7,605,104,1350,4434,8,323,85,1350,2808
1681.365,17,12,498,11,14,168136,14,462,1,8,0,8,36
1.072,6,52,13906,25,553,44,1429,4908,27,416,36,1460,8998
16.777,6,2875,2683573,1844,1376,9,1408,2625297,1031,776,16,1408,58276
0.901,17,2,782,2,363,901,363,782,0,0,0,0,0
9.186,17,8,552,4,33,3059,33,244,4,49,3059,49,308
4.263,6,38,7229,19,218,236,314,3383,19,513,222,1179,3846
1643.228,1,7,392,7,28,273871,28,392,0,0,0,0,0
378.867,2,4,128,4,8,126289,8,128,0,0,0,0,0
0.034,6,10,2046,6,739,6,1322,1723,4,159,10,159,323
5.584,6,38,7229,20,218,293,314,3423,18,513,312,1179,3806
1792.021,6,355,22480,207,69,8699,69,12420,148,69,12190,69,10060
11.2,6,1776,1715897,1167,1396,9,1408,1679013,609,738,18,2801,36884
429.505,6,88,12996,49,304,8948,304,9548,39,83,11288,83,3448
186.523,17,4,352,2,60,186522,60,176,2,60,186519,60,176
0.284,6,23,6012,12,181,25,537,1526,11,781,27,2224,4486
0.03,6,12,3656,6,124,5,124,444,6,964,5,1448,3212
24.056,6,116,49837,60,798,407,1152,45519,56,346,319,373,4318
1779.534,1,132,7392,132,28,13584,28,7392,0,0,0,0,0
1787.113,6,102,8296,68,65,26673,65,4930,34,59,54150,59,3366
1791.229,6,362,22898,210,69,8570,69,12678,152,69,11862,69,10220
1797.093,17,448,39612,404,35,4459,288,25708,44,288,40950,288,13904
1630.191,1,8,448,8,28,232884,28,448,0,0,0,0,0
4.488,6,38,7245,19,218,249,314,3383,19,516,234,1179,3862
240.382,6,45,8872,24,523,10450,1418,5971,21,200,12018,618,2901
28.115,6,25,8072,14,381,2162,547,1880,11,801,504,2688,6192
39.256,17,43,19728,21,450,1961,1350,10048,22,412,1867,1350,9680
74.586,6,31,8912,14,158,5737,267,1357,17,687,4653,1781,7555
1776.362,17,140,11200,70,48,25744,48,5320,70,56,25744,56,5880
15.424,6,21,6825,12,275,1402,275,1038,9,1353,1302,1440,5787
1782.258,6,359,22709,209,69,8568,69,12569,150,69,11959,69,10140
147.425,6,28,6519,11,217,6317,502,1312,17,323,9208,1420,5207
4.657,6,39,7269,20,218,245,314,3423,19,513,243,1179,3846
1739.938,1,56,4704,0,0,0,0,0,56,56,31635,56,4704
478.785,2,5,160,5,8,119696,8,160,0,0,0,0,0
82.765,17,4,352,2,60,82761,60,176,2,60,82764,60,176
769.77,1,26,2184,26,56,30790,56,2184,0,0,0,0,0
1778.894,17,138,11040,69,48,26160,48,5244,69,56,26160,56,5796
1.097,6,24,8004,12,164,85,267,1288,12,1014,84,2816,6716
1.323,6,24,8004,12,164,103,267,1288,12,1014,102,2331,6716
1746.975,6,95,7203,63,38,28177,205,4476,32,33,56346,98,2727
1745.453,6,95,7203,63,38,28152,205,4476,32,33,56294,98,2727
1760.222,1,204,11424,204,28,8671,28,11424,0,0,0,0,0
45.836,6,20,2866,9,152,5729,267,822,11,320,4553,1152,2044
1789.023,17,83,3480,82,14,22086,14,3444,1,8,0,8,36
5.704,6,40,7309,21,218,285,314,3463,19,513,302,1179,3846
1785.175,17,87,3648,86,14,21002,14,3612,1,8,0,8,36
1741.052,6,91,6604,59,31,30018,31,3998,32,31,56162,31,2606
4.261,6,2,88,2,0,0,0,88,0,0,0,0,0
28.511,6,37,8532,17,401,910,888,1916,20,386,1493,1440,6616
1796.986,17,448,39896,403,35,4470,288,25676,45,288,40019,288,14220
1779.09,17,140,11200,70,48,25783,48,5320,70,56,25783,56,5880
48.046,1,4,224,4,28,16015,28,224,0,0,0,0,0
2.556,6,12,3462,6,75,511,75,395,6,1373,511,1448,3067
33.536,6,28,4962,14,180,2579,721,1831,14,399,2563,2026,3131
10.599,17,2,152,2,48,10599,48,152,0,0,0,0,0
1.634,6,47,18718,27,859,62,1360,13142,20,476,74,2720,5576
7.099,6,6,312,6,0,0,0,312,0,0,0,0,0
33.507,6,30,5055,15,180,2381,722,1871,15,342,2380,1448,3184
1721.778,1,158,8848,158,28,10966,28,8848,0,0,0,0,0
1799.656,6,380,27329,212,103,8529,469,15641,168,69,10775,69,11688
1770.621,6,101,9344,66,65,27240,65,5577,35,59,52074,59,3767
2.009,17,2,120,2,32,2009,32,120,0,0,0,0,0
186.415,6,7066,6367734,4380,1366,42,1368,6203360,2686,749,69,1368,164374
300.317,6,57,30245,26,190,12012,444,2181,31,1057,8129,1461,28064
6.024,6,1661,1558041,1037,1424,5,1448,1520929,624,776,9,1448,37112
1779.142,1,60,5040,60,56,30154,56,5040,0,0,0,0,0
0.484,6,57,26098,32,1009,15,1380,17553,25,626,18,3303,8545
62.027,6,26,10985,15,688,4430,1408,4921,11,783,6092,1408,6064
0.274,6,23,5080,11,137,27,267,1132,12,577,23,1400,3948
240.54,6,43,8980,21,521,12023,1418,5789,22,226,11450,619,3191
1785.999,6,356,22520,208,69,8628,69,12460,148,69,12148,69,10060
4.451,6,56,21239,28,940,164,1440,15259,28,433,152,1440,5980
300.838,6,47,13076,25,773,12534,1360,7270,22,327,491,2667,5806
0.04,6,12,3462,6,75,8,75,395,6,1373,8,1448,3067
1786.512,6,103,8404,68,66,26664,66,4964,35,60,52541,60,3440
1783.809,6,369,25192,214,93,8374,469,14645,155,69,11583,69,10547
1799.302,17,142,11360,71,48,25704,48,5396,71,56,25704,56,5964
20.352,17,29,7854,12,218,1847,1350,2955,17,260,1270,1350,4899
1787.389,17,87,3648,86,14,21028,14,3612,1,8,0,8,36
300.778,6,38,8576,20,317,15830,923,2102,18,441,508,1360,6474
1785.422,17,140,11200,70,48,25875,48,5320,70,56,25875,56,5880
1743.987,17,315,83234,315,236,5554,422,83234,0,0,0,0,0
300.813,6,48,13190,25,888,12533,1460,7313,23,290,657,1460,5877
7.395,6,6,614,2,210,7395,210,290,4,82,2122,82,324
375.232,6,23,1511,14,177,28864,177,925,9,110,9164,110,586
1799.962,17,450,39960,405,35,4455,288,25740,45,288,40016,288,14220
22.301,17,4,240,2,32,22300,32,120,2,32,22300,32,120
1.893,17,3,468,3,128,946,128,468,0,0,0,0,0
1792.716,17,140,11200,70,48,25981,48,5320,70,56,25981,56,5880
289.701,6,53,9730,23,105,9677,267,2189,30,243,9989,2840,7541
1781.114,17,142,11360,71,48,25444,48,5396,71,56,25444,56,5964
11.907,6,88,27458,45,572,270,1152,21256,43,447,277,1179,6202
89.41,6,23,8403,11,525,97,1237,2092,12,831,8110,1360,6311
280.437,6,29,7392,13,158,23369,267,1317,16,678,18691,3456,6075
197.624,17,4,352,2,60,197623,60,176,2,60,197623,60,176
69.531,6,28,7286,13,155,5794,267,1306,15,488,4966,3417,5980
0.102,6,3,128,2,0,102,0,84,1,0,0,0,44
20.003,6,2304,2087200,1443,1366,13,1408,2037731,861,937,23,2801,49469
1787.02,6,106,8456,68,65,26671,65,4930,38,59,48294,59,3526
280.465,6,28,7352,13,158,23372,267,1317,15,775,20030,4836,6035
1785.272,6,104,8444,68,66,26645,66,4964,36,60,51005,60,3480
1.628,17,27,12699,13,667,135,1350,9035,14,233,121,1350,3664
0.953,17,2,312,2,128,953,128,312,0,0,0,0,0
0.566,6,7,376,4,0,188,0,216,3,0,112,0,160
1799.97,1,16,896,16,28,119998,28,896,0,0,0,0,0
1774.612,6,184,15778,122,69,14666,69,9158,62,69,29086,69,6620
0.908,6,32,10982,18,666,53,1460,4760,14,627,56,1460,6222
1799.813,1,57,4788,0,0,0,0,0,57,56,32139,56,4788
243.614,6,52,8605,27,124,9369,346,2356,25,379,10150,2800,6249
1.316,6,25,8056,12,164,103,267,1288,13,869,94,1448,6768
1773.47,6,180,15480,120,69,14903,69,8940,60,69,30050,69,6540
0.385,6,12,1653,6,288,77,288,548,6,426,42,434,1105
35.733,17,11,836,11,48,3573,48,836,0,0,0,0,0
0.796,6,381,348487,222,238,3,256,15473,159,2068,4,11264,333014
0.069,17,2,384,1,32,0,32,60,1,296,0,296,324
0.858,6,20,5948,11,281,85,544,1288,9,716,96,1420,4660
0.275,6,12,3704,6,171,53,171,491,6,964,54,1448,3213
39.852,6,47,9039,22,378,731,787,2130,25,346,1653,2720,6909
68.904,6,30,13959,18,854,4053,1360,6730,12,1347,6247,3085,7229
29.865,17,3,2954,3,956,14932,1442,2954,0,0,0,0,0
0.039,6,9,1340,5,145,9,145,349,4,827,10,827,991
374.691,6,33,2771,21,141,18734,141,1085,12,398,2893,419,1686
1798.997,6,366,24603,213,87,8485,469,14136,153,69,11834,69,10467
1535.285,17,16,4213,8,30,219324,37,471,8,439,219324,463,3742
31.615,6,7,308,1,0,0,0,44,6,0,6273,0,264
252.096,2,2,64,2,8,252096,8,64,0,0,0,0,0
99.659,6,15,1928,9,483,12457,483,1442,6,83,19928,83,486
1795.695,6,283,34018,116,133,15613,1360,16404,167,131,10816,1942,17614
11.712,6,4,484,0,0,0,0,0,4,92,3904,92,484
15.115,17,15,10110,9,863,1885,1350,8025,6,319,3016,1350,2085
96.104,6,11,719,11,31,9610,31,719,0,0,0,0,0
22.898,6,19,2541,10,211,2544,211,986,9,545,2859,904,1555
300.839,6,39,10109,21,619,15041,1440,4587,18,399,509,1440,5522
1745.698,6,97,7338,64,38,27709,205,4528,33,33,54542,98,2810
1.912,17,3,383,2,33,1861,33,122,1,233,0,233,261
0.333,17,4,284,2,32,0,32,120,2,54,3,60,164
66.365,17,4,352,2,60,66363,60,176,2,60,66363,60,176
0.01,6,2,127,1,35,0,35,87,1,0,0,0,40
0.054,17,2,245,1,32,0,32,60,1,157,0,157,185
1777.627,1,67,5628,67,56,26933,56,5628,0,0,0,0,0
300.639,6,38,8566,20,315,15823,882,2093,18,478,499,2720,6473
1682.648,17,14,1036,7,30,280433,30,406,7,62,280432,62,630
0.317,17,2,212,1,46,0,46,74,1,110,0,110,138
280.475,6,30,7432,13,158,23372,267,1317,17,603,17522,2760,6115
1795.817,17,447,39296,404,35,4456,288,25708,43,288,41916,288,13588
0.245,17,8,2750,8,315,35,354,2750,0,0,0,0,0
1798.837,6,239,16432,93,46,19497,46,6958,146,46,12405,46,9474
0.271,17,2,154,1,33,0,33,61,1,65,0,65,93
5.389,6,390,368529,140,334,38,334,9626,250,1411,20,1438,358903
80.97,6,20,820,9,0,5334,0,364,11,0,8095,0,456
0.001,6,2,80,0,0,0,0,0,2,0,0,0,80
9.437,17,2,128,2,36,9437,36,128,0,0,0,0,0
300.203,6,46,15841,25,916,12500,1460,10199,21,399,15001,1460,5642
1596.029,1,24,1344,24,28,69392,28,1344,0,0,0,0,0
0.013,6,4,222,2,31,13,31,111,2,31,2,31,111
11.729,6,1871,1621385,1124,1388,10,1420,1587284,747,467,15,1883,34101
266.173,17,9,3708,9,384,33271,394,3708,0,0,0,0,0
3.994,17,4,232,4,30,1331,30,232,0,0,0,0,0
1700.592,17,13,534,11,14,170041,14,462,2,8,1700415,8,72
1.673,6,13,2311,8,188,239,245,700,5,1407,355,1407,1611
1744.403,1,8,448,8,28,249200,28,448,0,0,0,0,0
3.2,17,2,322,1,33,0,33,61,1,233,0,233,261
1729.216,6,60,4400,40,33,44338,33,2740,20,31,91002,31,1660
1774.728,6,180,15480,120,69,14913,69,8940,60,69,30078,69,6540
1770.475,6,99,9306,66,66,27238,66,5610,33,60,55324,60,3696
1796.159,6,380,23480,208,69,8677,69,12460,172,49,10503,69,11020
1799.227,17,449,39928,404,35,4464,288,25708,45,288,40020,288,14220
2.218,17,4,1568,4,364,739,364,1568,0,0,0,0,0
34.697,2,2,64,2,8,34697,8,64,0,0,0,0,0
6.126,6,40,7325,20,218,322,314,3423,20,516,307,1179,3902
242.636,6,37,4175,19,181,13478,595,2094,18,224,14272,580,2081
61.319,6,37,15935,22,800,2919,1440,9157,15,665,4361,1440,6778
17.383,17,34,17780,17,716,1084,1350,12651,17,273,1084,1350,5129
1742.491,6,96,6962,62,31,28565,31,4247,34,31,52801,31,2715
0.0,17,1,1101,1,1073,0,1073,1101,0,0,0,0,0
281.149,6,30,7432,13,158,23429,267,1317,17,543,17566,1400,6115
376.66,6,23,1535,16,177,25110,177,1053,7,110,10413,110,482
1740.515,17,30,31680,30,1028,60017,1028,31680,0,0,0,0,0
1586.707,6,369,22143,184,69,8670,69,11086,185,34,8623,48,11057
1.036,17,6,552,3,64,517,64,276,3,64,517,64,276
0.376,17,3,543,2,39,371,39,134,1,381,0,381,409
109.155,17,4,352,2,60,109153,60,176,2,60,109154,60,176
60.096,6,26,11393,12,275,5463,275,1038,14,1087,4301,1440,10355
369.81,6,20,1355,14,177,28446,177,925,6,110,12282,110,430
0.81,6,16,1845,8,288,88,288,660,8,426,88,434,1185
1772.876,6,180,15480,120,69,14898,69,8940,60,69,30040,69,6540
11.613,6,1842,1602369,1117,1379,10,1420,1569148,725,467,16,1883,33221
1769.165,6,24,3624,16,241,117944,241,2568,8,92,252710,92,1056
0.256,6,22,4442,11,165,25,456,1394,11,493,22,888,3048
0.018,17,4,368,2,32,16,32,120,2,96,5,96,248
1737.448,1,56,4704,56,56,31589,56,4704,0,0,0,0,0
1764.346,17,166,13962,154,30,11531,37,8974,12,387,155056,463,4988
5.814,6,39,7285,21,218,290,314,3463,18,516,326,1179,3822
0.108,6,13,2042,7,329,18,500,1030,6,346,21,500,1012
1787.291,17,83,3480,82,14,22065,14,3444,1,8,0,8,36
64.922,6,12,927,4,177,124,177,393,8,110,9248,110,534
39.521,6,37,8503,18,413,511,923,1991,19,441,2188,1460,6512
1635.128,1,7,392,7,28,272521,28,392,0,0,0,0,0
21.426,6,27,7697,8,154,102,267,792,19,409,1189,1420,6905
0.746,6,15,4864,9,290,93,517,1045,6,1166,101,1501,3819
8.279,6,20,6851,10,275,919,275,683,10,1150,858,1414,6168
1746.619,6,99,7411,63,38,28171,205,4476,36,33,49893,98,2935
324.204,6,49,19280,26,523,12968,779,5585,23,892,12007,1368,13695
0.476,6,10,967,6,256,95,256,500,4,303,102,303,467
0.307,6,9,1340,5,145,76,145,349,4,827,90,827,991
300.598,6,38,8581,20,318,15820,928,2107,18,441,498,1440,6474
870.446,17,172,13072,172,48,5090,48,13072,0,0,0,0,0
1.601,6,17,1897,9,288,177,288,700,8,426,202,434,1197
1787.793,6,363,24414,212,88,8472,469,14027,151,69,11918,69,10387
0.004,17,2,279,1,33,0,33,61,1,190,0,190,218
1.057,6,5,248,3,0,528,0,144,2,0,428,0,104
94.214,6,25,6014,14,220,7247,516,1445,11,515,9407,1452,4569
42.87,6,26,7180,9,159,5358,267,1167,17,484,2657,1460,6013
1797.985,6,371,26279,215,105,8401,469,15554,156,69,11599,69,10725
1785.86,6,355,22480,208,69,8627,69,12529,147,69,12231,69,9951
0.021,17,4,352,2,37,14,37,130,2,83,12,89,222
240.194,6,52,18033,27,808,9238,1402,15151,25,196,10007,580,2882
320.749,17,23,8075,23,323,14579,464,8075,0,0,0,0,0
6.244,6,14,1855,6,100,1248,100,344,8,589,854,1152,1511
1798.473,17,140,11200,70,48,26064,48,5320,70,56,26064,56,5880
11.289,6,816,691651,480,1357,23,1368,665865,336,899,33,1473,25786
234.192,17,4,1344,4,308,78064,308,1344,0,0,0,0,0
280.156,6,29,7392,14,158,21550,267,1357,15,678,20003,3436,6035
0.033,17,2,602,1,46,0,46,74,1,500,0,500,528
0.359,6,13,3754,7,170,58,170,542,6,964,61,1448,3212
1773.13,6,181,15589,120,69,14900,69,8940,61,69,29546,69,6649
127.031,17,4,352,2,60,127030,60,176,2,60,127030,60,176
1744.685,2,30,960,30,8,60161,8,960,0,0,0,0,0
978.198,17,191,14516,191,48,5148,48,14516,0,0,0,0,0
300.781,6,49,10322,25,550,12532,1360,4405,24,290,655,1360,5917
12.375,6,83,26210,43,585,294,1152,20469,40,459,310,1179,5741
1787.812,6,356,22520,208,69,8636,69,12460,148,69,12161,69,10060
465.671,6,92,6776,42,86,11279,86,2354,50,39,9503,63,4422
1.506,17,6,552,3,64,751,64,276,3,64,752,64,276
252.798,6,128,34728,63,344,4077,1408,14994,65,398,3949,1408,19734
250.327,6,125,93431,78,1270,3251,1408,82859,47,812,2656,3847,10572
6.115,6,26,6094,13,336,509,515,2543,13,432,491,1452,3551
10.201,6,91,27818,46,579,226,1152,21536,45,407,226,1152,6282
4.565,6,37,7189,19,218,253,314,3383,18,513,253,1179,3806
1.01,17,3,246,3,54,505,54,246,0,0,0,0,0
782.094,2,7,224,7,8,130349,8,224,0,0,0,0,0
0.089,6,33,8043,17,131,5,131,1023,16,441,5,500,7020
90.204,6,23,5706,14,168,6938,517,1736,9,873,11274,1402,3970
4.953,17,2,656,2,300,4953,300,656,0,0,0,0,0
1782.818,6,356,22520,208,69,8612,69,12460,148,69,12127,69,10060
2.162,6,46,17610,26,839,86,1360,11989,20,437,104,2720,5621
1.227,6,3,172,1,0,0,0,60,2,0,1033,0,112
5.008,17,4,288,2,36,4965,36,128,2,52,4969,52,160
52.459,6,43,8956,21,412,742,889,2168,22,368,2492,3488,6788
0.213,6,24,5962,13,164,17,453,1494,11,555,20,1542,4468
1638.676,2,15,480,15,8,117048,8,480,0,0,0,0,0
1793.766,17,180,11520,180,36,10021,36,11520,0,0,0,0,0
0.619,6,12,1653,6,288,117,288,548,6,426,68,434,1105
1787.51,6,370,24832,214,87,8392,469,14176,156,69,11530,69,10656
0.03,17,2,154,1,33,0,33,61,1,65,0,65,93
1.292,6,44,14039,23,747,58,1460,8423,21,433,55,1460,5616
1198.239,6,92,12026,58,94,21021,498,4790,34,202,36308,2642,7236
245.781,1,4,427,4,78,81927,87,427,0,0,0,0,0
1774.013,6,204,22330,130,75,13752,267,10057,74,132,24300,1452,12273
1737.171,1,56,4704,56,56,31584,56,4704,0,0,0,0,0
9.598,6,83,24845,42,560,234,1152,19048,41,461,233,1179,5797
1790.759,17,153,9792,153,36,11781,36,9792,0,0,0,0,0
1799.965,6,222,17590,86,74,21176,337,8695,136,50,13332,143,8895
0.023,17,4,522,3,60,0,60,264,1,230,0,230,258
1757.947,6,96,7255,62,38,28818,205,4424,34,33,53264,98,2831
1787.72,17,85,3569,83,14,21801,15,3487,2,13,626654,18,82
1797.824,17,448,39896,403,35,4472,288,25676,45,288,40016,288,14220
0.014,6,2,92,1,0,0,0,40,1,0,0,0,52
75.906,17,4,240,2,32,75905,32,120,2,32,75905,32,120
0.136,6,12,3705,6,171,25,171,491,6,964,26,1448,3214
1772.316,6,180,15480,120,69,14893,69,8940,60,69,30031,69,6540
1772.082,6,180,15480,120,69,14891,69,8940,60,69,30032,69,6540
1775.675,6,184,15985,119,69,15048,69,8900,65,69,27738,69,7085
2.169,6,13,2311,8,188,309,245,700,5,1407,477,1407,1611
30.078,17,4,352,2,60,30077,60,176,2,60,30077,60,176
10.248,6,18,1482,10,275,1138,275,958,8,96,1113,96,524
1769.827,6,105,9690,68,64,26415,64,5724,37,58,49159,58,3966
0.045,17,2,180,1,30,0,30,58,1,94,0,94,122
0.322,17,2,152,1,48,0,48,76,1,48,0,48,76
1789.457,1,139,14734,139,78,12967,78,14734,0,0,0,0,0
0.222,17,8,2750,8,315,31,354,2750,0,0,0,0,0
1797.054,17,449,39928,404,35,4459,288,25708,45,288,40025,288,14220
1750.566,17,12,498,11,14,175056,14,462,1,8,0,8,36
0.005,17,2,329,1,36,0,36,64,1,237,0,237,265
0.185,6,9,1343,5,145,46,145,349,4,830,31,830,994
147.175,17,3,228,3,48,73587,48,228,0,0,0,0,0
3.055,6,39,21264,22,779,145,1360,6401,17,1574,181,3934,14863
1777.557,1,348,29232,348,56,5122,56,29232,0,0,0,0,0
368.527,6,9,604,5,106,92120,106,420,4,0,122839,0,184
7.864,6,18,10943,6,189,1571,267,627,12,1092,714,1460,10316
0.004,17,2,321,1,48,0,48,76,1,217,0,217,245
0.005,6,3,184,1,0,0,0,40,2,32,0,33,144
377.342,6,17,1236,13,226,31445,226,910,4,110,20130,110,326
374.767,6,25,1651,17,177,23422,177,1117,8,110,9275,110,534
257.218,6,28,6961,13,229,163,498,1672,15,390,18366,1420,5289
1023.476,17,17,5829,17,314,63967,696,5829,0,0,0,0,0
398.3,6,37,7658,17,182,6837,502,1960,20,287,20959,1420,5698
1773.006,6,202,22319,129,75,13851,267,10017,73,135,24621,1926,12302
0.177,6,10,1380,5,145,44,145,349,5,827,29,827,1031
4.686,6,38,7245,19,218,260,314,3383,19,516,246,1179,3862
1782.395,6,367,23236,211,69,8487,69,12856,156,69,11499,69,10380
1.882,6,62,26029,33,960,58,1380,18692,29,511,66,1923,7337
0.04,17,2,255,1,43,0,43,71,1,156,0,156,184
27.462,6,177,74499,90,759,308,1152,65114,87,453,316,1179,9385
0.429,6,13,1693,7,288,69,288,588,6,426,49,434,1105
4.787,6,40,7309,21,218,239,314,3463,19,440,251,1152,3846
1789.876,6,357,22629,208,69,8646,69,12460,149,69,12093,69,10169
1718.283,1,8,448,8,28,245469,28,448,0,0,0,0,0
1753.501,17,322,64231,322,171,5462,364,64231,0,0,0,0,0
0.042,6,3,156,2,0,42,0,104,1,0,0,0,52
0.038,6,9,1339,5,145,9,145,349,4,826,10,826,990
1782.826,1,67,5628,67,56,27012,56,5628,0,0,0,0,0
7.037,6,187,203817,123,133,57,201,5595,64,3260,109,27512,198222
0.571,6,27,9145,13,277,47,747,1792,14,943,40,1368,7353
0.181,6,32,7838,17,271,11,517,1785,15,494,11,1432,6053
10.721,6,61,33869,33,716,335,1408,6071,28,1316,396,2816,27798
143.298,6,36,7994,12,155,76,267,1266,24,303,6229,1420,6728
34.047,6,35,6788,17,154,2127,722,1999,18,427,1991,1440,4789
121.949,6,25,6318,9,272,93,516,1180,16,345,8124,1452,5138
2.11,6,14,2351,8,188,301,245,700,6,703,371,1152,1651
14.219,6,24,6993,13,275,1184,275,1078,11,910,920,1440,5915
340.749,6,11,912,6,226,68116,226,546,5,110,85145,110,366
300.636,6,44,8842,22,315,14316,882,2209,22,441,487,1440,6633
0.269,6,26,6150,13,181,22,537,1578,13,555,21,1542,4572
1781.821,17,142,11360,71,48,25454,48,5396,71,56,25453,56,5964
192.052,6,223,172933,136,1293,1422,1368,158361,87,731,1549,3887,14572
5.994,1,2,72,2,8,5994,8,72,0,0,0,0,0
240.367,6,53,17993,28,803,8901,1418,15131,25,194,10014,580,2862
1773.288,6,180,15480,120,69,14901,69,8940,60,69,30047,69,6540
1.723,17,4,1576,4,366,574,548,1576,0,0,0,0,0
1.159,6,10,1687,7,100,193,100,384,3,1179,445,1179,1303
1792.75,17,180,11520,180,36,10015,36,11520,0,0,0,0,0
7.841,6,27,8752,13,158,653,267,1317,14,981,601,2800,7435
2.479,6,8,1607,6,100,495,100,344,2,1179,316,1179,1263
3.326,17,10,1472,5,40,828,40,340,5,198,828,216,1132
7.056,6,1524,1434070,985,1381,7,1408,1401378,539,931,12,2816,32692
0.112,17,2,198,1,39,0,39,67,1,103,0,103,131
23.159,17,3,228,3,48,11579,48,228,0,0,0,0,0
96.44,17,4,240,2,32,96439,32,120,2,32,96439,32,120
1763.447,2,13,416,13,8,146953,8,416,0,0,0,0,0
144.298,6,16819,16106634,11219,1358,12,1408,15810770,5600,776,25,1408,295864
7.007,17,3,1012,3,309,3503,312,1012,0,0,0,0,0
11.728,6,1881,1624023,1131,1381,10,1420,1589790,750,467,15,1883,34233
181.06,6,12,1767,5,100,132,100,304,7,1179,30135,1179,1463
0.37,17,2,304,1,60,0,60,88,1,188,0,188,216
1.38,6,50,19243,27,888,53,1360,13547,23,433,54,1360,5696
40.46,17,24,2112,12,48,3674,48,912,12,72,3676,72,1200
1791.991,1,342,28728,342,56,5255,56,28728,0,0,0,0,0
1777.657,17,140,11200,70,48,25762,48,5320,70,56,25762,56,5880
2.728,6,2,88,2,0,0,0,88,0,0,0,0,0
59.706,6,46,10156,22,533,494,910,3083,24,435,2590,2720,7073
61.279,6,35,15823,22,799,2918,1408,9149,13,855,5086,3847,6674
0.531,17,2,656,2,300,531,300,656,0,0,0,0,0
2.68,6,3,187,2,31,1574,31,147,1,0,0,0,40
1785.627,6,365,25501,212,100,8462,469,14896,153,69,11745,69,10605
0.134,17,4,352,2,37,0,37,130,2,83,0,89,222
17.302,17,26,15059,12,527,1570,1350,6663,14,571,1328,1350,8396
0.821,6,24,6015,12,108,74,147,919,12,922,71,1581,5096
10.625,6,106,35242,55,602,196,1152,28720,51,447,207,1179,6522
4.603,6,440,420449,296,934,15,1360,24304,144,2913,31,21760,396145
0.012,17,2,586,1,46,0,46,74,1,484,0,484,512
75.011,1,2,728,2,336,75011,336,728,0,0,0,0,0
0.875,6,11,1727,7,100,145,100,384,4,589,208,1152,1343
11.623,6,102,37721,54,662,219,1152,31303,48,449,241,1179,6418
1792.005,6,355,22480,207,69,8699,69,12420,148,69,12190,69,10060
0.073,17,4,588,2,48,54,48,152,2,190,66,308,436
0.975,17,2,694,2,319,975,354,694,0,0,0,0,0
0.809,17,2,672,2,308,809,308,672,0,0,0,0,0
1.398,6,46,18144,26,882,55,1360,12568,20,433,63,1360,5576
1.837,17,2,179,1,43,0,43,71,1,80,0,80,108
1798.196,1,184,10304,184,28,9826,28,10304,0,0,0,0,0
61.307,6,37,16031,22,810,2919,1440,9252,15,665,4361,1440,6779
61.671,6,50,29108,31,1039,2055,1448,21367,19,843,3413,2359,7741
0.181,6,14,4577,8,290,25,517,993,6,1088,33,1418,3584
1776.179,17,142,11360,71,48,25373,48,5396,71,56,25373,56,5964
2.35,6,21,3465,12,167,213,293,1490,9,537,261,1179,1975
5.395,6,39,7269,19,218,299,314,3383,20,513,269,1179,3886
0.241,6,6,328,4,0,80,0,216,2,0,235,0,112
300.652,6,43,8792,22,283,14316,787,2105,21,364,422,1360,6687
1790.13,6,355,22480,207,69,8689,69,12420,148,69,12177,69,10060
40.873,17,11,836,11,48,4087,48,836,0,0,0,0,0
0.035,17,5,428,3,32,0,32,180,2,96,19,96,248
1.023,17,4,764,2,32,1018,32,120,2,294,15,294,644
1789.167,17,142,11360,71,48,25559,48,5396,71,56,25559,56,5964
16.141,6,2946,2856076,1967,1376,8,1408,2800504,979,931,16,2801,55572
0.071,17,3,507,2,39,66,39,134,1,345,0,345,373
0.043,17,2,201,1,50,0,50,78,1,95,0,95,123
1121.658,17,10,740,5,30,280411,30,290,5,62,280410,62,450
1.281,6,46,18499,27,845,49,1360,12963,19,476,61,2715,5536
72.718,17,20,1760,10,48,8078,48,760,10,72,8079,72,1000
1681.568,17,14,1036,7,30,280259,30,406,7,62,280258,62,630
1.21,6,27,9624,13,164,85,267,1396,14,936,79,1408,8228
0.011,17,2,523,1,40,0,40,68,1,427,0,427,455
61.846,6,69,47353,43,1194,1472,1448,39272,26,746,2464,1448,8081
1741.237,17,30,7050,30,207,60042,207,7050,0,0,0,0,0
1772.427,6,180,15480,120,69,14894,69,8940,60,69,30032,69,6540
5.034,6,38,7229,19,218,279,314,3383,19,513,261,1179,3846
26.662,17,4,1344,4,308,8887,308,1344,0,0,0,0,0
1769.348,6,99,9240,66,65,27220,65,5577,33,59,55286,59,3663
0.409,6,17,4511,10,327,44,634,1836,7,575,66,1328,2675
327.625,6,18,952,9,0,40952,0,488,9,0,40952,0,464
240.651,2,4,128,4,8,80217,8,128,0,0,0,0,0
0.923,6,10,1687,7,100,153,100,384,3,1179,327,1179,1303
1771.977,6,294,39935,122,167,14642,1360,20467,172,147,10361,2720,19468
1783.122,6,104,8376,68,65,26613,65,4930,36,59,50943,59,3446
287.565,6,32,7853,14,158,22120,267,1357,18,577,16912,2076,6496
1785.965,6,108,8724,70,66,25883,66,5044,38,60,48266,60,3680
280.292,6,29,7392,13,158,23357,267,1317,16,603,18683,1400,6075
0.86,6,2,1235,1,0,0,0,40,1,1155,0,1155,1195
0.195,6,27,7296,14,155,15,267,1341,13,678,15,3436,5955
9.479,6,43,7429,23,218,430,314,3543,20,513,483,1179,3886
67.867,6,27,7177,13,155,5655,267,1306,14,530,5219,3417,5871
38.648,6,20,1487,10,222,4292,222,848,10,231,4292,231,639
0.161,6,13,3980,7,88,26,88,388,6,1670,32,1880,3592
21.442,17,2,904,1,300,0,300,328,1,548,0,548,576
2.995,6,17,3504,10,211,332,211,950,7,545,492,904,2554
157.466,17,4,240,2,32,157464,32,120,2,32,157465,32,120
1415.487,1,7,392,7,28,235914,28,392,0,0,0,0,0
0.143,17,2,672,2,308,143,308,672,0,0,0,0,0
280.431,6,30,7432,14,158,21571,267,1357,16,678,18692,3456,6075
250.275,17,4,240,2,32,250273,32,120,2,32,250273,32,120
0.365,6,10,968,5,256,88,256,460,5,304,88,304,508
1780.401,17,290,63844,290,192,6160,422,63844,0,0,0,0,0
1741.214,6,127,7843,72,43,24524,208,4744,55,31,32240,31,3099
23.456,6,32,8056,16,188,1563,721,1963,16,778,1550,2840,6093
1755.393,6,2017,1877016,706,123,2489,352,45000,1311,1429,1339,2836,1832016
1720.787,17,13,534,11,14,172060,14,462,2,8,1719033,8,72
0.233,6,42,17350,24,952,10,1420,12409,18,467,12,1883,4941
1796.986,17,80,3354,79,14,23038,14,3318,1,8,0,8,36
1.68,6,116,87175,51,131,33,232,2569,65,1366,23,1430,84606
1781.765,6,366,25541,213,100,8404,469,14936,153,69,11722,69,10605
11.213,6,27,11433,13,275,934,275,1078,14,1087,827,1440,10355
1775.88,1,67,5628,67,56,26907,56,5628,0,0,0,0,0
0.263,6,9,527,5,43,65,43,311,4,0,86,0,216
1783.097,6,356,22520,208,69,8613,69,12460,148,69,12129,69,10060
0.134,6,3,973,1,0,0,0,40,2,853,0,853,933
0.206,17,2,2386,2,1165,206,1165,2386,0,0,0,0,0
106.243,6,32,5287,16,165,7082,722,1985,16,308,7069,1448,3302
1794.096,17,80,3354,79,14,23001,14,3318,1,8,0,8,36
371.322,6,25,1651,17,177,23207,177,1117,8,110,9230,110,534
1793.812,17,66,2766,65,14,28028,14,2730,1,8,0,8,36
1.504,17,4,524,2,39,1456,39,134,2,167,1472,167,390
2.604,6,7,388,4,0,868,0,216,3,0,1288,0,172
1794.65,6,123,7984,71,49,25635,208,4726,52,31,35185,31,3258
10.402,17,3,3300,3,1072,5201,1072,3300,0,0,0,0,0
1775.723,6,181,15589,120,69,14922,69,8940,61,69,29589,69,6649
1349.191,6,161,11040,60,46,22867,46,4654,101,46,13491,46,6386
1742.95,6,97,7307,63,38,28112,205,4476,34,33,52806,98,2831
293.035,6,43,8722,20,129,15420,517,1969,23,504,13317,1418,6753
9.792,6,16,3911,9,275,1224,275,643,7,992,832,1440,3268
0.631,6,39,12377,23,592,28,1188,8301,16,359,36,758,4076
0.644,17,4,944,2,60,120,60,176,2,356,0,356,768
1742.958,6,169,11643,89,66,19806,208,7544,80,31,22059,31,4099
178.67,2,3,96,3,8,89335,8,96,0,0,0,0,0
1.301,6,54,22896,30,936,44,1360,17160,24,476,49,2715,5736
0.33,6,26,9060,13,271,27,726,1771,13,943,26,1402,7289
0.643,17,2,204,1,34,0,34,62,1,114,0,114,142
280.495,6,27,7312,12,158,25499,267,1277,15,775,20031,3465,6035
0.151,17,4,624,2,64,119,64,184,2,192,120,192,440
0.0,17,1,64,1,36,0,36,64,0,0,0,0,0
0.005,17,4,248,2,34,4,34,124,2,34,3,34,124
32.72,6,26,6587,15,117,2337,159,1401,11,658,3268,1418,5186
0.155,6,7,423,4,43,38,43,259,3,0,27,0,164
121.539,6,20,820,9,0,15192,0,364,11,0,12137,0,456
23.191,17,4,272,2,40,23190,47,136,2,40,23190,47,136
1784.704,1,342,28728,342,56,5233,56,28728,0,0,0,0,0
0.007,17,2,352,1,36,0,36,64,1,260,0,260,288
301.041,6,44,16145,25,955,12543,1460,10583,19,435,490,2920,5562
135.257,6,1116,543492,594,847,228,1152,516425,522,412,259,1179,27067
0.011,17,2,604,1,37,0,37,65,1,511,0,511,539
36.1,6,1490,1308444,906,1361,39,1368,1269324,584,776,61,1473,39120
175.048,17,4,352,2,60,175047,60,176,2,60,175047,60,176
3.903,17,10,1255,5,31,973,31,295,5,164,972,164,960
0.027,17,8,2438,8,276,3,315,2438,0,0,0,0,0
69.397,6,9,468,9,0,0,0,468,0,0,0,0,0
1.532,6,46,18668,27,858,58,1360,13132,19,476,74,2715,5536
75.353,6,29,7125,12,474,6850,841,2050,17,320,4109,1550,5075
1798.575,17,449,39928,404,35,4462,288,25708,45,288,40019,288,14220
589.466,17,7,532,7,48,98244,48,532,0,0,0,0,0
1771.778,6,101,9344,66,65,27258,65,5577,35,59,52108,59,3767
659.236,17,18,5969,18,303,38778,308,5969,0,0,0,0,0
0.186,6,31,7961,17,289,11,517,1857,14,553,13,1871,6104
1772.281,6,180,15480,120,69,14893,69,8940,60,69,30038,69,6540
0.31,6,27,9069,13,246,25,622,1670,14,832,23,1448,7399
19.174,6,92,29832,46,585,426,1152,23510,46,447,419,1179,6322
0.064,17,4,304,2,37,0,37,130,2,59,20,65,174
107.017,6,20,820,8,0,6975,0,328,12,0,9727,0,492
1797.093,17,448,39896,403,35,4470,288,25676,45,288,40018,288,14220
0.453,6,3,168,1,0,0,0,52,2,0,453,0,116
125.368,6,15,3232,8,92,17909,92,540,7,464,20863,2026,2692
1780.828,6,354,22440,207,69,8644,69,12420,147,69,12197,69,10020
240.192,6,55,18633,30,786,8282,1418,15721,25,200,10007,580,2912
1767.135,1,58,4872,0,0,0,0,0,58,56,31002,56,4872
14.881,6,666,577353,405,1351,36,1368,557597,261,776,56,2736,19756
251.744,2,3,96,3,8,125872,8,96,0,0,0,0,0
165.125,6,21,8544,11,556,94,1329,2140,10,998,18323,1791,6404
367.402,6,25,1651,17,177,22962,177,1117,8,110,9171,110,534
252.381,2,2,64,2,8,252381,8,64,0,0,0,0,0
0.787,6,11,1727,7,100,131,100,384,4,589,175,1152,1343
1680.623,1,15,840,15,28,120044,28,840,0,0,0,0,0
0.085,1,2,112,2,28,85,28,112,0,0,0,0,0
40.209,17,4,352,2,60,40208,60,176,2,60,40208,60,176
5.021,17,4,558,2,36,5006,36,128,2,187,5004,187,430
1656.07,1,7,392,7,28,276011,28,392,0,0,0,0,0
1787.862,17,83,3480,82,14,22072,14,3444,1,8,0,8,36
0.388,6,24,6064,12,181,35,537,1526,12,651,33,1448,4538
0.0,1,2,112,2,28,0,28,112,0,0,0,0,0
83.396,6,25,11047,13,410,61,922,1842,12,1089,7569,4080,9205
1.023,6,6,248,4,0,341,0,164,2,0,848,0,84
75.352,6,13,540,6,0,2462,0,244,7,0,12557,0,296
822.18,6,12,728,8,31,117454,31,444,4,31,274056,31,284
2.151,17,2,144,1,36,0,36,64,1,52,0,52,80
13.824,6,32,6936,17,225,864,335,3159,15,634,969,1179,3777
5.069,6,8,9356,7,1290,714,1360,9316,1,0,0,0,40
14.272,17,4,352,2,48,14264,48,152,2,72,14262,72,200
79.301,6,2,166,2,31,79301,31,166,0,0,0,0,0
1770.584,6,99,9306,66,66,27239,66,5610,33,60,55327,60,3696
11.832,6,1879,1630191,1150,1363,10,1380,1596777,729,421,16,1923,33414
2.109,17,20,10710,10,795,230,1350,8232,10,219,230,1350,2478
0.497,6,12,1653,6,288,94,288,548,6,426,64,434,1105
0.022,6,11,1864,6,262,4,517,844,5,752,5,752,1020
15.492,6,9,594,3,112,7740,112,240,6,90,3096,90,354
1795.982,6,356,22520,208,69,8676,69,12460,148,69,12214,69,10060
1799.965,17,448,39896,403,35,4477,288,25676,45,288,40017,288,14220
225.589,6,122,108932,46,144,5013,255,2976,76,1397,3007,1448,105956
0.716,6,10,1102,6,483,143,483,803,4,83,230,83,299
28.206,17,4,1312,4,300,9402,300,1312,0,0,0,0,0
1.133,17,15,8100,7,657,188,1350,4796,8,385,156,1350,3304
300.787,6,36,8454,20,307,15830,882,2061,16,521,573,3488,6393
14.272,6,2454,2155744,1424,1424,9,1448,2092860,1030,776,13,1448,62884
157.832,6,183,29545,99,304,1610,304,20756,84,83,1893,83,8789
0.243,6,20,9028,10,124,27,124,652,10,1121,26,1448,8376
1773.218,6,182,15629,121,69,14776,69,8980,61,69,29551,69,6649
15.885,17,14,7560,8,665,2258,1350,5545,6,307,3160,1350,2015
0.002,6,2,99,1,0,0,0,40,1,7,0,7,59
1771.947,6,180,15480,120,69,14890,69,8940,60,69,30032,69,6540
0.262,17,2,2380,2,1162,262,1162,2380,0,0,0,0,0
8.12,6,30,11532,15,275,580,275,1154,15,814,404,1440,10378
4.123,6,38,7229,19,218,229,314,3383,19,440,215,1152,3846
1215.467,6,102,10833,54,76,22930,722,4801,48,98,25857,1408,6032
1.427,6,53,21636,29,919,50,1360,15900,24,433,53,1360,5736
1791.672,1,247,13832,247,28,7283,28,13832,0,0,0,0,0
2.027,6,65,46629,43,1171,48,1408,39728,22,1149,88,3847,6901
1.38,6,47,19091,26,954,55,1460,13475,21,433,59,1460,5616
0.891,6,12,1767,8,100,127,100,424,4,589,216,1152,1343
4.667,17,4,824,2,48,4661,48,152,2,308,4659,308,672
0.158,6,9,1340,5,145,39,145,349,4,827,49,827,991
0.07,17,4,588,2,48,64,48,152,2,190,63,308,436
1740.554,17,30,31680,30,1028,60019,1028,31680,0,0,0,0,0
9.968,6,89,28654,45,562,226,1152,22071,44,438,226,1179,6583
1788.203,6,359,22709,209,69,8597,69,12569,150,69,12001,69,10140
1786.356,6,102,8364,68,66,26662,66,4964,34,60,54129,60,3400
1776.14,17,73,3060,72,14,25016,14,3024,1,8,0,8,36
4.767,6,20,3425,10,167,529,293,1410,10,537,500,1179,2015
165.187,17,4,352,2,60,165186,60,176,2,60,165186,60,176
2.59,6,32,8839,16,252,160,561,2441,16,820,160,1440,6398
1582.206,1,26,1456,26,28,63288,28,1456,0,0,0,0,0
13.933,17,4,4282,4,1042,4644,1258,4282,0,0,0,0,0
0.007,17,2,362,1,39,0,39,67,1,267,0,267,295
4.455,6,37,7205,19,218,247,314,3383,18,516,246,1179,3822
280.201,6,26,7272,12,158,25472,267,1277,14,775,21549,3445,5995
61.308,6,35,15923,22,809,2919,1408,9249,13,855,5089,3847,6674
1797.192,17,140,11200,70,48,26046,48,5320,70,56,26046,56,5880
33.27,6,9,396,2,0,3391,0,88,7,0,5530,0,308
0.362,6,25,6014,12,164,32,453,1442,13,555,28,1440,4572
0.131,17,2,193,1,46,0,46,74,1,91,0,91,119
1708.64,1,8,448,8,28,244091,28,448,0,0,0,0,0
72.541,17,8,10988,8,1345,10363,1348,10988,0,0,0,0,0
254.612,1,10,840,0,0,0,0,0,10,56,28290,56,840
1720.162,17,12,498,11,14,172016,14,462,1,8,0,8,36
0.019,6,10,1723,6,578,3,997,1400,4,159,5,159,323
13.8,6,28,7493,11,155,1380,267,1226,17,429,862,3426,6267
0.016,17,2,554,1,30,0,30,58,1,468,0,468,496
1748.118,6,110,8212,70,38,25335,205,4871,40,32,44813,98,3341
1.273,6,49,20244,28,898,47,1360,14628,21,476,54,2715,5616
0.203,17,2,265,1,45,0,45,73,1,164,0,164,192
316.379,6,101,33919,58,506,5550,1360,23630,43,534,7529,3289,10289
1744.474,6,97,7307,63,38,28136,205,4476,34,33,52855,98,2831
126.032,2,2,64,2,8,126032,8,64,0,0,0,0,0
115.687,6,25,7693,8,267,1156,502,1126,17,420,7224,1420,6567
3.783,6,24,6513,11,262,374,517,1368,13,744,311,1418,5145
5.966,6,895,830367,592,1363,10,1432,812085,303,559,19,1871,18282
1689.137,6,183,12788,63,45,27242,46,5197,120,45,14194,46,7591
1785.235,17,87,3648,86,14,21002,14,3612,1,8,0,8,36
0.194,6,48,23008,27,1122,7,1420,17935,21,467,9,2840,5073
1744.994,6,97,7307,63,38,28145,205,4476,34,33,52866,98,2831
286.188,6,27,2913,14,328,22010,593,1393,13,282,23844,580,1520
105.981,1,4,224,4,28,35327,28,224,0,0,0,0,0
185.022,2,2,64,2,8,185022,8,64,0,0,0,0,0
1.437,6,50,18981,27,867,55,1360,13285,23,433,56,1360,5696
1773.172,6,180,15480,120,69,14900,69,8940,60,69,30052,69,6540
807.299,1,26,1456,26,28,32291,28,1456,0,0,0,0,0
1740.968,1,57,4788,57,56,31088,56,4788,0,0,0,0,0
105.015,6,25,7770,8,272,285,516,1140,17,424,6558,1452,6630
1.404,6,52,22028,29,946,50,1360,16332,23,433,55,1360,5696
3.479,6,4,176,1,0,0,0,44,3,0,1712,0,132
2.774,17,3,1167,3,361,1387,361,1167,0,0,0,0,0
36.13,17,74,48707,43,987,858,1350,43678,31,134,1202,1350,5029
2.733,6,65,23980,33,963,85,1440,14897,32,486,82,1440,9083
9.224,17,4,352,2,48,9202,48,152,2,72,9199,72,200
1787.498,6,104,8444,68,66,26679,66,4964,36,60,51068,60,3480
0.003,17,2,2728,2,1336,3,1336,2728,0,0,0,0,0
249.146,6,33,10461,16,448,16609,1072,2245,17,733,15571,2816,8216
240.074,6,34,4098,17,170,15004,599,2085,17,224,15004,580,2013
6.252,17,4,240,2,32,6251,32,120,2,32,6251,32,120
53.452,6,7105,6658258,4599,1365,11,1368,6509926,2506,776,21,2736,148332
402.545,6,64,11111,33,175,12579,721,4134,31,337,13412,1420,6977
1.27,6,24,8004,13,164,90,267,1340,11,1216,108,3819,6664
1789.951,6,371,23465,213,69,8443,69,13005,158,69,11400,69,10460
68.212,6,63,32713,35,826,87,1360,11423,28,1119,2521,3756,21290
124.623,6,34,7935,12,155,28,267,1266,22,340,5934,3417,6669
223.115,17,4,406,2,43,223101,43,142,2,104,223103,104,264
1771.54,6,99,9306,66,66,27254,66,5610,33,60,55357,60,3696
10.555,6,35,8136,19,316,586,634,1742,16,522,591,3388,6394
1785.043,6,356,22520,208,69,8623,69,12460,148,69,12140,69,10060
0.023,17,2,152,1,48,0,48,76,1,48,0,48,76
16.538,6,24,3238,14,210,1263,210,1592,10,545,1484,904,1646
1775.406,1,34,3604,34,78,53800,78,3604,0,0,0,0,0
0.101,6,4,160,2,0,101,0,80,2,0,1,0,80
131.498,6,66,20965,31,634,238,1152,16479,35,440,3860,1152,4486
155.038,6,24,10054,12,532,56,1360,2642,12,1153,14083,2720,7412
377.872,2,4,128,4,8,125957,8,128,0,0,0,0,0
0.166,6,16,6056,9,70,19,133,504,7,1756,26,2440,5552
1.319,6,6,248,4,0,439,0,164,2,0,216,0,84
1681.629,17,14,1036,7,30,280263,30,406,7,62,280263,62,630
11.258,6,16,2300,9,410,1396,584,1708,7,212,1854,212,592
67.274,17,4,352,2,60,67273,60,176,2,60,67272,60,176
26.858,6,37,12203,18,219,1579,721,2043,19,939,1468,2840,10160
1401.047,6,143,12275,94,69,15064,69,7072,49,69,29188,69,5203
1775.005,6,180,15480,120,69,14916,69,8940,60,69,30076,69,6540
1.534,6,13,2311,8,188,219,245,700,5,1407,318,1407,1611
12.43,6,1954,1710768,1208,1362,10,1380,1676686,746,383,16,1380,34082
1793.45,17,87,3648,86,14,21099,14,3612,1,8,0,8,36
5.318,17,10,1654,5,36,1327,36,320,5,238,1328,318,1334
3.065,17,6,471,3,31,1515,31,177,3,70,1516,70,294
77.74,6,67,39075,36,1147,2216,1408,30579,31,529,2585,2439,8496
0.037,17,5,1032,3,60,13,60,264,2,356,23,356,768
3.896,17,2,152,2,48,3896,48,152,0,0,0,0,0
243.656,2,4,128,4,8,81218,8,128,0,0,0,0,0
5.003,17,4,558,2,36,4993,36,128,2,187,4989,187,430
1637.593,1,30,1680,30,28,56468,28,1680,0,0,0,0,0
0.998,17,2,677,1,300,0,300,328,1,321,0,321,349
1798.445,17,448,39896,403,35,4473,288,25676,45,288,40022,288,14220
104.418,17,4,240,2,32,104417,32,120,2,32,104417,32,120
31.237,6,4311,4113567,2764,1408,11,1448,4027695,1547,776,20,1448,85872
0.423,6,13,1693,7,288,69,288,588,6,426,47,434,1105
1.554,6,48,19032,26,946,62,1460,13376,22,433,63,1460,5656
0.176,6,8,9687,7,1338,0,1360,9647,1,0,0,0,40
1794.909,17,87,3648,86,14,21116,14,3612,1,8,0,8,36
0.249,6,23,5080,11,137,24,267,1132,12,577,21,1400,3948
9.475,6,78,22422,40,523,242,1152,16777,38,457,249,1179,5645
3.971,6,11,467,6,0,794,0,248,5,7,734,7,219
0.763,17,4,947,2,33,751,37,123,2,384,748,463,824
1791.748,6,356,22520,208,69,8655,69,12460,148,69,12188,69,10060
180.203,17,4,756,2,33,180192,34,123,2,288,180193,299,633
58.965,6,51,9355,24,401,868,889,2336,27,311,2262,1360,7019
14.463,6,27,4866,13,154,1178,722,1767,14,394,1084,1448,3099
82.097,6,45,8947,22,378,667,787,2118,23,368,3725,2720,6829
0.312,17,4,368,2,32,311,32,120,2,96,46,96,248
1771.941,6,99,9264,66,65,27260,66,5589,33,59,55370,60,3675
3.779,17,5,295,5,31,944,31,295,0,0,0,0,0
0.016,17,2,152,1,40,0,40,68,1,56,0,56,84
1745.342,2,24,768,24,8,75884,8,768,0,0,0,0,0
1741.95,1,8,448,8,28,248850,28,448,0,0,0,0,0
1789.482,6,357,22629,208,69,8644,69,12460,149,69,12091,69,10169
13.602,6,2625,2443073,1597,1442,8,1448,2378915,1028,792,12,1448,64158
3.981,17,8,668,4,39,1315,39,268,4,72,1316,72,400
4.872,6,39,7269,19,218,270,314,3383,20,513,240,1179,3886
65.194,17,4,304,4,48,21731,48,304,0,0,0,0,0
1.063,6,3,156,2,0,960,0,104,1,0,0,0,52
1789.954,6,366,25610,212,100,8483,469,14896,154,69,11699,69,10714
1671.014,1,8,448,8,28,238716,28,448,0,0,0,0,0
1.077,6,24,6439,13,311,88,893,2079,11,783,104,1460,4360
16.344,17,13,6726,7,613,2718,1350,4487,6,345,3261,1350,2239
0.46,6,5,272,2,0,460,0,104,3,0,129,0,168
61.669,6,51,30738,32,1066,1989,1448,23000,19,842,3413,2359,7738
617.978,6,142,39046,61,511,10299,1360,25489,81,206,7722,2720,13557
1748.463,6,106,6786,65,45,27319,208,4247,41,31,43703,31,2539
0.0,17,1,1052,1,1024,0,1024,1052,0,0,0,0,0
0.181,6,5,5661,4,1365,0,1460,5621,1,0,0,0,40
1739.412,6,87,6322,58,31,30516,31,3915,29,31,62121,31,2407
1770.659,6,99,9306,66,66,27240,66,5610,33,60,55330,60,3696
4.004,17,8,1288,4,33,1333,33,244,4,233,1333,233,1044
1795.966,17,449,39928,404,35,4456,288,25708,45,288,40016,288,14220
3.308,17,5,295,5,31,827,31,295,0,0,0,0,0
112.501,6,29,8832,13,158,9375,267,1317,16,763,7496,1781,7515
7.655,17,6,528,3,48,3822,48,228,3,72,3822,72,300
1766.425,6,91,8569,42,36,43082,36,2448,49,446,36799,458,6121
2.397,17,4,360,2,30,2061,30,116,2,94,2058,94,244
1784.863,6,123,14556,79,84,22882,498,6386,44,160,41506,1420,8170
1796.024,6,308,20738,183,69,9868,69,11529,125,69,14483,69,9209
0.016,17,4,624,2,64,14,64,184,2,192,2,192,440
5.977,17,2,672,2,308,5977,308,672,0,0,0,0,0
1.047,17,4,918,2,40,945,40,136,2,363,0,363,782
1799.483,17,80,3354,79,14,23070,14,3318,1,8,0,8,36
1771.362,6,99,9174,66,64,27251,64,5544,33,58,55351,58,3630
1792.218,17,180,14040,180,50,10012,50,14040,0,0,0,0,0
1790.711,1,252,14112,252,28,7134,28,14112,0,0,0,0,0
1.698,6,14,2351,8,188,242,245,700,6,703,286,1152,1651
1799.661,17,208,20072,104,75,17472,136,10808,104,61,17472,72,9264
1744.72,2,25,800,25,8,72696,8,800,0,0,0,0,0
1097.699,17,12,969,6,31,219530,37,355,6,74,219528,136,614
1790.646,6,368,23276,212,69,8486,69,12896,156,69,11552,69,10380
655.48,6,89,12556,48,88,11510,267,3954,41,193,16386,1420,8602
10.85,6,727,617199,451,1297,23,1368,598183,276,776,38,1473,19016
0.023,6,10,1677,6,555,4,951,1354,4,159,5,159,323
13.826,6,18,3405,11,211,1382,211,1050,7,665,2303,904,2355
231.654,17,716,382719,703,515,329,1252,382155,13,15,4193,56,564
39.855,17,42,10899,42,231,972,389,10899,0,0,0,0,0
673.838,1,9,1080,9,92,84229,103,1080,0,0,0,0,0
1788.194,17,74,3096,72,14,25183,14,3024,2,8,1787991,8,72
1756.908,6,95,7203,63,38,28337,205,4476,32,33,56666,98,2727
0.323,17,2,157,1,31,0,31,59,1,70,0,70,98
0.019,17,2,330,1,30,0,30,58,1,244,0,244,272
4.947,17,26,9198,11,400,494,1350,4717,15,270,224,1350,4481
102.494,6,67,25028,29,951,862,1440,15503,38,394,2765,1440,9525
300.622,6,30,8260,15,173,21471,385,1507,15,747,21471,1438,6753
19.806,17,74,66277,51,1152,395,1350,60226,23,235,898,1350,6051
0.948,6,10,1102,6,483,189,483,803,4,83,313,83,299
0.192,6,10,1840,5,901,47,901,1169,5,403,47,403,671
137.952,6,27,5017,15,204,9853,517,1637,12,1342,3420,1408,3380
251.859,6,32,8952,14,158,19373,267,1357,18,624,14806,1400,7595
342.204,6,22,1720,14,65,26323,65,1015,8,55,48872,59,705
230.089,17,2,1084,2,514,230089,514,1084,0,0,0,0,0
46.684,6,33,5211,18,154,2746,722,2027,15,400,1245,1448,3184
0.437,6,6,324,4,0,145,0,216,2,0,256,0,108
1788.908,17,142,11360,71,48,25555,48,5396,71,56,25555,56,5964
270.815,6,20,1520,12,63,24619,63,858,8,57,38674,57,662
12.029,6,1852,1651182,1168,1360,10,1420,1619411,684,427,17,1420,31771
0.012,17,3,544,2,60,9,60,176,1,340,0,340,368
1798.617,6,368,26228,214,105,8444,469,15514,154,69,11752,69,10714
0.116,1,2,112,2,28,116,28,112,0,0,0,0,0
1796.025,17,449,39928,404,35,4456,288,25708,45,288,40017,288,14220
1772.64,6,180,15480,120,69,14896,69,8940,60,69,30043,69,6540
0.028,17,3,716,2,64,22,64,184,1,504,0,504,532
3.258,6,7,400,3,0,1629,0,160,4,0,1011,0,240
242.794,6,32,8876,12,158,22072,267,1277,20,522,12771,1400,7599
0.081,17,2,176,1,60,0,60,88,1,60,0,60,88
0.537,1,10,280,10,0,0,0,280,0,0,0,0,0
3.888,17,4,352,4,60,1296,60,352,0,0,0,0,0
0.01,17,2,352,1,34,0,34,62,1,262,0,262,290
5.078,6,41,7349,20,201,267,314,3423,21,440,241,1152,3926
0.213,6,4,160,2,0,154,0,80,2,0,212,0,80
3.45,6,13,5764,3,112,1725,112,240,10,639,361,1420,5524
1763.137,6,76,3952,38,0,47648,0,1976,38,0,47646,0,1976
1787.905,6,368,23483,210,69,8554,69,12954,158,69,11387,69,10529
1776.704,17,140,11200,70,48,25749,48,5320,70,56,25749,56,5880
17.389,6,19,2505,8,211,2483,211,846,11,545,1700,904,1659
0.997,17,2,677,1,300,0,300,328,1,321,0,321,349
1793.388,1,276,15456,276,28,6521,28,15456,0,0,0,0,0
12.134,17,20,1440,10,33,1347,33,610,10,55,1347,61,830
1.092,6,16,5663,9,267,136,501,1165,7,842,158,1420,4498
1786.821,6,110,8816,70,66,25895,66,5176,40,60,45813,60,3640
26.236,6,36,8429,18,401,515,888,1955,18,478,1535,1928,6474
214.955,1,6,336,6,28,42991,28,336,0,0,0,0,0
123.517,17,4,240,2,32,123516,32,120,2,32,123516,32,120
374.662,6,25,1651,17,177,23416,177,1117,8,110,9243,110,534
1741.373,17,30,31680,30,1028,60047,1028,31680,0,0,0,0,0
1773.297,6,180,15480,120,69,14901,69,8940,60,69,30049,69,6540
76.885,6,19,9280,7,174,12814,174,462,12,1387,6980,1420,8818
3.805,6,32,6105,17,206,237,314,2744,15,551,252,1179,3361
3.437,17,3,1167,3,361,1718,361,1167,0,0,0,0,0
0.077,17,2,279,1,36,0,36,64,1,187,0,187,215
1787.438,6,104,8376,68,65,26678,65,4930,36,59,51065,59,3446
80.638,17,7,532,7,48,13439,48,532,0,0,0,0,0
25.751,6,41,8792,22,181,1226,267,1604,19,494,1429,1400,7188
165.27,17,39,2190,17,25,10329,29,905,22,30,7866,41,1285
0.015,17,2,454,1,37,0,37,65,1,361,0,361,389
1028.46,6,88,5570,46,49,22851,208,3270,42,31,25080,31,2300
1798.543,17,450,39960,405,35,4451,288,25740,45,288,40017,288,14220
1776.684,17,126,10080,63,48,28656,48,4788,63,56,28656,56,5292
2.11,6,31,6518,15,164,150,267,1922,16,658,128,1460,4596
0.555,17,27,17791,13,722,45,1350,9754,14,546,39,1350,8037
0.919,17,4,820,2,36,908,36,128,2,318,908,318,692
11.077,6,6,328,4,0,3692,0,216,2,0,11022,0,112
2.969,17,4,624,4,128,989,128,624,0,0,0,0,0
1781.105,17,142,11360,71,48,25444,48,5396,71,56,25444,56,5964
1773.68,6,207,24411,132,89,13539,981,11118,75,144,23968,1926,13293
2.07,17,2,303,1,45,0,45,73,1,202,0,202,230
377.59,6,62,18519,30,523,13020,1360,9634,32,345,9758,1360,8885
1788.014,17,83,3480,82,14,22074,14,3444,1,8,0,8,36
1797.698,17,448,39896,403,35,4471,288,25676,45,288,40015,288,14220
1715.739,1,137,14522,137,78,12615,78,14522,0,0,0,0,0
1.02,17,2,677,1,300,0,300,328,1,321,0,321,349
1786.183,6,104,8444,68,66,26659,66,4964,36,60,51031,60,3480
280.253,6,30,7432,13,158,23354,267,1317,17,543,17515,1400,6115
292.137,17,4,240,2,32,292136,32,120,2,32,292136,32,120
1740.718,17,29,19517,29,645,62168,645,19517,0,0,0,0,0
0.182,6,20,9028,10,124,20,124,652,10,1121,20,1448,8376
1783.824,6,415,24901,206,69,8701,69,12380,209,34,8576,48,12521
0.018,17,2,431,1,65,0,65,93,1,310,0,310,338
0.085,6,12,3462,6,75,17,75,395,6,1373,16,1448,3067
90.392,17,4,1344,4,308,30130,308,1344,0,0,0,0,0
64.064,17,4,240,2,32,64063,32,120,2,32,64063,32,120
3.423,6,2,88,2,0,0,0,88,0,0,0,0,0
1751.939,17,367,59073,367,132,4786,376,59073,0,0,0,0,0
143.338,17,6,528,3,60,71668,60,264,3,60,71668,60,264
1771.515,6,99,9174,66,64,27254,64,5544,33,58,55357,58,3630
0.147,17,2,2382,2,1163,147,1163,2382,0,0,0,0,0
0.07,17,2,338,1,33,0,33,61,1,249,0,249,277
3.119,17,2,178,1,47,0,47,75,1,75,0,75,103
1795.784,17,447,39296,404,35,4456,288,25708,43,288,41925,288,13588
1667.597,1,7,392,7,28,277932,28,392,0,0,0,0,0
633.066,6,37,2606,23,31,28767,31,1537,14,31,48683,31,1069
0.131,17,2,672,2,308,131,308,672,0,0,0,0,0
1786.17,6,111,8970,72,66,25157,66,5190,39,60,46999,60,3780
0.087,17,2,152,1,48,0,48,76,1,48,0,48,76
0.921,6,4,298,1,0,0,0,40,3,69,374,69,258
1773.227,6,183,15738,121,69,14776,69,8980,62,69,29063,69,6758
1754.442,6,107,8832,70,66,24577,66,5308,37,56,48729,60,3524
5.033,17,4,288,2,36,5001,36,128,2,52,5000,52,160
280.415,6,30,7432,13,158,23367,267,1317,17,603,17523,2076,6115
24.982,17,4,320,2,48,24974,48,152,2,56,24973,56,168
1747.027,6,95,7203,63,38,28177,205,4476,32,33,56340,98,2727
0.016,6,10,1800,6,616,3,1076,1477,4,159,4,159,323
1741.352,17,30,7050,30,207,60046,207,7050,0,0,0,0,0
240.256,6,54,19745,29,855,8580,1418,16921,25,189,10010,580,2824
59.075,6,27,7177,13,155,4922,267,1306,14,530,4543,3417,5871
0.055,17,2,392,1,40,0,40,68,1,296,0,296,324
1744.312,6,95,7203,63,38,28134,205,4476,32,33,56261,98,2727
107.314,17,4,352,2,60,107313,60,176,2,60,107313,60,176
157.994,6,48,7480,20,144,8306,722,2636,28,188,5845,1408,4844
1747.266,17,45,39814,45,856,39710,1451,39814,0,0,0,0,0
114.635,17,26,8736,26,308,4585,308,8736,0,0,0,0,0
4.28,6,2,88,2,0,0,0,88,0,0,0,0,0
1785.855,6,365,23087,211,69,8504,69,12787,154,69,11672,69,10300
33.995,17,10,760,10,48,3777,48,760,0,0,0,0,0
138.924,6,24,11318,12,433,72,990,1823,12,1125,12617,2568,9495
0.172,17,2,2384,2,1164,172,1164,2384,0,0,0,0,0
0.364,6,27,9136,13,271,30,726,1795,14,943,27,1408,7341
138.072,17,4,558,2,36,138067,36,128,2,187,138068,187,430
23.895,6,43,12934,19,889,82,1460,7017,24,290,1025,1460,5917
13.77,6,11,2033,7,326,2295,589,1025,4,396,30,580,1008
0.133,6,9,1340,5,145,33,145,349,4,827,41,827,991
10.866,6,20,4442,11,275,1086,275,998,9,768,728,1440,3444
6.538,6,24,6806,12,275,594,275,759,12,617,497,1440,6047
1772.226,6,146,10183,79,67,22720,208,6418,67,31,26847,31,3765
308.396,6,59,11925,30,162,10634,1189,4141,29,264,7691,1917,7784
1.847,17,3,468,3,128,923,128,468,0,0,0,0,0
1792.859,17,169,10816,169,36,10671,36,10816,0,0,0,0,0
160.913,6,22,10186,11,304,84,597,1385,11,1192,16074,1460,8801
1750.612,17,12,498,11,14,175061,14,462,1,8,0,8,36
127.073,2,2,64,2,8,127073,8,64,0,0,0,0,0
0.326,17,8,2742,8,314,46,353,2742,0,0,0,0,0
252.053,2,3,96,3,8,126026,8,96,0,0,0,0,0
995.209,6,51,3706,34,31,30157,31,2295,17,31,62199,31,1411
7.271,6,1629,1512807,1037,1381,6,1408,1477359,592,931,12,2801,35448
585.783,1,18,1008,18,28,34457,28,1008,0,0,0,0,0
60.096,17,4,1006,2,34,60082,34,124,2,413,60083,427,882
5.062,6,40,7309,21,218,253,314,3463,19,513,266,1179,3846
1796.639,17,449,39928,404,35,4458,288,25708,45,288,40018,288,14220
188.672,6,29,7392,13,158,15722,267,1317,16,603,12576,1400,6075
0.059,6,12,3462,6,75,11,75,395,6,1373,11,1448,3067
37.349,6,26,7137,12,155,3395,267,1266,14,530,2872,2006,5871
1.005,6,10,1687,7,100,167,100,384,3,1179,375,1179,1303
0.435,6,9,1346,5,145,108,145,349,4,833,137,833,997
1.534,6,3,144,2,0,1534,0,92,1,0,0,0,52
1.858,6,13,3399,4,288,619,288,468,9,511,116,853,2931
43.192,6,27,7177,13,155,3599,267,1306,14,530,3321,2840,5871
240.947,6,48,11983,24,473,10475,1402,5557,24,517,10475,1514,6426
0.081,17,4,588,2,48,76,48,152,2,190,73,308,436
1788.023,6,5080,4598025,1969,126,908,352,122873,3111,1421,574,2836,4475152
0.082,6,9,3908,5,517,20,517,773,4,1459,21,1501,3135
286.139,17,4,240,2,32,286138,32,120,2,32,286138,32,120
1793.337,1,224,12544,224,28,8041,28,12544,0,0,0,0,0
280.204,6,28,7352,13,158,23350,267,1317,15,678,20011,2800,6035
316.97,6,88,35098,41,833,7924,1360,24189,47,310,6887,2720,10909
61.028,6,12,984,11,43,6102,43,924,1,0,0,0,60
15.173,6,5,706,3,46,7586,46,166,2,460,14978,460,540
64.829,17,76,19722,76,231,864,389,19722,0,0,0,0,0
0.566,6,54,23751,30,995,19,1380,15246,24,683,22,3303,8505
1734.86,1,48,2688,48,28,36911,28,2688,0,0,0,0,0
1772.84,6,80,4212,40,26,45456,26,2106,40,26,45456,26,2106
0.559,6,116,87072,62,131,9,232,3009,54,1671,10,5372,84063
2.512,6,37,8218,18,321,147,1168,2682,19,433,125,1440,5536
0.125,17,2,194,1,61,0,61,89,1,77,0,77,105
3.377,17,5,290,5,30,844,30,290,0,0,0,0,0
1744.505,6,95,7203,63,38,28137,205,4476,32,33,56264,98,2727
352.505,17,12,2472,6,48,70499,48,456,6,308,70498,308,2016
1791.63,6,361,22858,210,69,8572,69,12678,151,69,11942,69,10180
0.277,6,10,861,5,222,65,222,426,5,231,65,231,435
0.977,6,24,5157,12,77,88,147,1031,12,870,73,1709,4126
1.114,6,24,8004,12,164,86,267,1288,12,1014,86,2816,6716
11.716,6,1858,1617760,1125,1384,10,1420,1584219,733,467,15,1883,33541
1796.022,2,29,928,29,8,64143,8,928,0,0,0,0,0
0.365,6,7,371,4,0,121,0,204,3,7,90,7,167
111.195,17,4,240,2,32,111194,32,120,2,32,111194,32,120
15.568,6,47,22891,25,382,648,986,3315,22,1150,739,2736,19576
367.06,6,18,1242,14,180,28235,180,916,4,110,20069,110,326
280.564,6,29,7392,13,158,23380,267,1317,16,603,18699,2800,6075
1750.816,17,13,534,11,14,175063,14,462,2,8,1750631,8,72
317.026,6,111,34693,56,506,5764,1360,23556,55,330,5867,1360,11137
20.601,17,6,456,6,48,4120,48,456,0,0,0,0,0
12.63,6,2187,2103757,1453,1373,8,1408,2060925,734,931,17,2801,42832
24.392,6,3903,3687837,2548,1369,9,1408,3612713,1355,931,17,2816,75124
0.061,17,2,152,1,48,0,48,76,1,48,0,48,76
1772.968,6,180,15480,120,69,14898,69,8940,60,69,30046,69,6540
0.506,6,28,9224,14,221,38,710,1841,14,947,35,1368,7383
0.011,17,2,330,1,30,0,30,58,1,244,0,244,272
1799.785,6,370,25839,215,99,8410,469,15154,155,69,11684,69,10685
0.065,17,2,219,1,50,0,50,78,1,113,0,113,141
26.982,17,2,672,2,308,26982,308,672,0,0,0,0,0
240.254,6,67,21017,33,828,7507,1418,17477,34,196,7280,580,3540
0.113,17,3,1167,3,361,56,361,1167,0,0,0,0,0
0.014,17,2,192,1,37,0,37,65,1,99,0,99,127
0.442,17,5,1696,5,311,110,354,1696,0,0,0,0,0
0.533,17,2,672,2,308,533,308,672,0,0,0,0,0
1792.192,17,87,3648,86,14,21084,14,3612,1,8,0,8,36
0.373,17,4,304,2,48,188,48,152,2,48,188,48,152
280.442,6,29,7392,13,158,23370,267,1317,16,603,18691,2076,6075
445.363,17,8,2688,8,308,63623,308,2688,0,0,0,0,0
1788.353,6,103,8268,68,64,26691,64,4896,35,58,52596,58,3372
0.292,17,2,225,1,37,0,37,65,1,132,0,132,160
370.874,6,18,1242,14,180,28528,180,916,4,110,20067,110,326
36.594,17,4,1344,4,308,12198,308,1344,0,0,0,0,0
5.682,6,61,20094,34,793,172,1360,14136,27,347,211,2715,5958
1781.765,6,366,25541,213,99,8404,469,15005,153,69,11722,69,10536
1799.997,6,214,16410,79,68,22692,295,7736,135,48,13432,78,8674
121.087,6,31,8912,14,158,9314,267,1357,17,687,7565,1400,7555
0.354,6,27,9047,13,252,29,647,1692,14,945,24,1408,7355
0.402,6,12,1653,6,288,74,288,548,6,426,46,434,1105
0.302,6,26,9039,13,266,25,705,1750,13,1100,24,2804,7289
4.56,6,40,7309,20,218,240,314,3423,20,440,227,1152,3886
60.898,6,15,1666,9,180,7612,180,1016,6,110,12132,110,650
0.019,17,6,1612,3,40,0,41,206,3,440,3,441,1406
1681.538,17,14,1036,7,30,280253,30,406,7,62,280254,62,630
7.454,17,41,14355,15,585,532,1350,9201,26,170,296,1350,5154
0.0,17,2,912,1,308,0,308,336,1,548,0,548,576
1.376,6,25,8056,12,164,105,267,1288,13,869,97,1368,6768
1696.644,17,16,1265,8,30,242373,37,471,8,71,242373,136,794
1785.165,6,370,25770,214,99,8381,469,15114,156,69,11514,69,10656
1797.091,17,448,39896,403,35,4470,288,25676,45,288,40019,288,14220
66.071,6,27,7177,13,155,5505,267,1306,14,530,5081,3417,5871
1796.773,1,342,28728,342,56,5269,56,28728,0,0,0,0,0
53.165,6,26,7137,12,155,4833,267,1266,14,530,4088,2006,5871
1080.891,6,79,9887,47,302,23497,302,6970,32,83,34867,83,2917
0.021,6,2,92,1,0,0,0,40,1,0,0,0,52
1799.636,1,58,4872,58,56,31572,56,4872,0,0,0,0,0
1799.357,17,442,38284,402,35,4487,288,25644,40,288,45118,288,12640
1.829,17,6,360,3,32,914,32,180,3,32,911,32,180
9.89,6,23,5271,12,351,899,1382,2242,11,430,986,1460,3029
1793.566,17,65,2730,65,14,28024,14,2730,0,0,0,0,0
0.018,17,2,251,1,36,0,36,64,1,159,0,159,187
1786.816,6,102,8296,68,65,26668,65,4930,34,59,54141,59,3366
23.658,17,23,6676,10,389,2625,1350,4173,13,164,1968,1350,2503
0.187,6,41,16919,23,1003,8,1420,11978,18,420,10,1420,4941
1756.267,6,128,12889,79,68,22516,722,6738,49,92,36584,2026,6151
1.272,6,38,9848,20,502,66,1460,4352,18,433,63,1460,5496
1782.583,17,83,3480,82,14,22007,14,3444,1,8,0,8,36
26.333,6,33,8148,16,171,1755,721,2015,17,778,1581,2840,6133
0.014,17,2,559,1,67,0,67,95,1,436,0,436,464
7.593,6,2015,1914182,1307,1387,5,1408,1872604,708,792,10,1408,41578
0.759,6,20,7151,12,318,69,600,1906,8,964,94,1471,5245
0.18,17,2,180,1,30,0,30,58,1,94,0,94,122
1751.91,1,58,4872,0,0,0,0,0,58,56,30735,56,4872
271.758,17,4,240,2,32,271757,32,120,2,32,271757,32,120
34.577,17,10,760,10,48,3841,48,760,0,0,0,0,0
299.972,6,24,6782,12,158,27269,267,1277,12,836,27269,3436,5505
1798.711,17,449,39928,404,35,4463,288,25708,45,288,40020,288,14220
0.138,6,10,766,6,185,27,185,505,4,45,33,45,261
0.544,6,51,21656,29,958,19,1380,16534,22,421,23,2760,5122
59.803,6,28,7217,13,155,4983,267,1306,15,482,4271,1420,5911
1787.732,6,102,8228,68,64,26682,64,4896,34,58,54171,58,3332
34.272,17,4,240,2,32,34271,32,120,2,32,34270,32,120
0.131,17,4,284,2,32,0,32,120,2,54,127,60,164
1.52,6,49,19863,28,873,56,1360,14247,21,476,64,2715,5616
1775.771,1,48,2688,48,28,37782,28,2688,0,0,0,0,0
120.171,17,4,302,2,39,120164,47,135,2,55,120163,63,167
1795.837,17,447,39864,402,35,4478,288,25644,45,288,40021,288,14220
7.877,17,6,456,6,48,1575,48,456,0,0,0,0,0
5.171,17,27,11767,12,558,470,1350,7037,15,287,203,1350,4730
1772.317,6,180,15480,120,69,14893,69,8940,60,69,30032,69,6540
1786.648,6,104,8444,68,66,26666,66,4964,36,60,51044,60,3480
34.21,6,23,6656,7,154,5701,267,752,16,525,2263,1420,5904
1787.828,6,415,29196,222,117,8089,1189,16485,193,48,9311,192,12711
1797.678,6,272,33241,112,136,16194,1360,16134,160,135,11305,2720,17107
1687.09,17,14,1036,7,30,281178,30,406,7,62,281158,62,630
1720.46,17,12,498,11,14,172046,14,462,1,8,0,8,36
4.352,17,4,824,2,48,4296,48,152,2,308,4322,308,672
103.27,6,15,3928,8,127,14752,127,467,7,792,17205,1460,3461
1787.097,6,110,8924,70,66,25899,66,5044,40,60,45820,60,3880
1793.741,17,144,11520,72,48,25263,48,5472,72,56,25263,56,6048
1786.943,6,356,22520,208,69,8632,69,12460,148,69,12153,69,10060
0.841,6,21,5988,12,281,76,544,1328,9,716,94,1420,4660
2.023,17,49,37456,20,439,106,1350,9344,29,941,66,1350,28112
1794.355,1,58,4872,58,56,31479,56,4872,0,0,0,0,0
11.5,6,19,8530,10,275,1277,275,958,9,1440,1360,1440,7572
1789.963,6,357,22698,207,69,8689,69,12489,150,69,11858,69,10209
1.382,6,52,21201,28,953,51,1360,15453,24,476,52,2715,5748
1.015,6,59,29530,32,1134,32,1380,23992,27,421,37,1923,5538
5.903,6,39,7285,20,218,310,314,3423,19,516,313,1179,3862
0.013,17,4,865,2,47,1,47,150,2,329,2,341,715
150.531,6,24,8953,12,333,83,692,1525,12,867,13670,1360,7428
433.81,6,61,7678,29,113,15493,722,3100,32,132,13987,1448,4578
0.28,6,25,6123,12,181,25,537,1526,13,652,22,1408,4597
0.026,17,2,568,1,64,0,64,92,1,448,0,448,476
0.013,6,12,976,7,181,2,181,553,5,77,2,134,423
1786.696,6,104,8376,68,65,26667,65,4930,36,59,51044,59,3446
1794.083,6,356,22520,208,69,8667,69,12460,148,69,12204,69,10060
1779.115,17,142,11360,71,48,25415,48,5396,71,56,25415,56,5964
7.934,6,18,3144,9,199,991,245,1365,9,703,909,1152,1779
1.069,6,28,8503,15,225,64,561,1985,13,1197,73,3151,6518
0.074,17,2,376,1,39,0,39,67,1,281,0,281,309
1770.414,6,101,9410,66,66,27237,66,5610,35,60,52068,60,3800
1.843,6,29,11365,13,265,153,764,1795,16,970,122,2373,9570
71.967,6,14,572,7,0,11994,0,284,7,0,11844,0,288
121.983,6,1128,564579,621,843,196,1152,539167,507,427,240,1179,25412
0.388,17,2,234,1,41,0,41,69,1,137,0,137,165
1.078,6,12,1653,6,288,210,288,548,6,426,111,434,1105
1792.309,6,356,22520,208,69,8658,69,12460,148,69,12192,69,10060
3.812,17,5,295,5,31,953,31,295,0,0,0,0,0
60.98,6,15,1657,9,177,7622,177,1007,6,110,12150,110,650
1788.75,6,243,24628,97,67,18631,659,9226,146,130,12333,3098,15402
11.276,6,20,7130,11,275,1127,275,998,9,1440,783,1440,6132
2.039,17,3,1796,3,570,1019,1030,1796,0,0,0,0,0
1143.214,1,62,3472,62,28,18741,28,3472,0,0,0,0,0
0.105,17,2,130,1,29,0,29,57,1,45,0,45,73
144.026,6,22,9860,11,433,115,990,1771,11,1091,14389,1460,8089
1.611,6,50,20564,28,917,59,1360,14908,22,433,66,1360,5656
1.189,6,24,5755,13,158,98,370,1315,11,799,118,1420,4440
5.314,6,2,149,0,0,0,0,0,2,69,5314,69,149
7.794,6,16,1402,9,275,974,275,918,7,96,985,96,484
125.409,6,23,10428,11,275,12540,275,719,12,922,11379,2840,9709
216.769,17,4,3621,4,877,72256,1451,3621,0,0,0,0,0
4.984,6,39,7269,21,218,249,314,3463,18,513,262,1179,3806
2.193,6,13,2311,8,188,313,245,700,5,1407,484,1407,1611
12.314,6,39,11148,20,340,648,707,1878,19,607,473,1527,9270
0.055,17,2,158,1,34,0,34,62,1,68,0,68,96
89.999,17,45,12386,18,394,5294,1350,7602,27,149,3460,1350,4784
0.021,6,10,1810,5,655,5,655,923,5,619,5,619,887
1752.793,6,95,7203,63,38,28270,205,4476,32,33,56531,98,2727
0.228,6,25,7216,13,155,19,267,1301,12,775,19,4836,5915
115.738,6,42,15260,23,971,411,1360,9698,19,435,6418,2720,5562
0.513,17,3,451,2,39,129,39,134,1,289,0,289,317
1746.744,6,95,7203,63,38,28173,205,4476,32,33,56335,98,2727
10.503,17,4,352,2,48,10483,48,152,2,72,10481,72,200
708.387,6,167,18182,83,124,8089,1189,6930,84,179,8534,1420,11252
1.47,6,48,18678,26,919,58,1460,13022,22,433,60,1460,5656
280.687,6,31,7813,14,158,21591,267,1357,17,524,17541,1400,6456
1699.315,6,99,6444,58,48,28142,208,3812,41,31,42477,31,2632
1793.749,17,354,118944,354,308,5081,308,118944,0,0,0,0,0
126.152,2,2,64,2,8,126152,8,64,0,0,0,0,0
127.744,6,33,5210,20,180,6723,722,2131,13,479,1451,1408,3079
1659.856,6,90,6912,62,38,27210,205,4517,28,33,55763,98,2395
56.887,17,4,352,2,60,56885,60,176,2,60,56885,60,176
1783.521,1,186,10416,186,28,9640,28,10416,0,0,0,0,0
5.015,17,4,542,2,36,5005,36,128,2,179,5005,187,414
4.287,6,2,202,1,0,0,0,40,1,110,0,110,162
9.844,6,67,20250,32,565,317,1152,15419,35,427,282,1152,4831
4.855,6,38,7245,20,218,255,314,3423,18,516,270,1179,3822
69.736,6,34,8207,12,169,6339,267,1671,22,332,3313,1460,6536
300.788,6,30,8198,15,204,21484,467,1604,15,483,8566,2808,6594
82.432,6,17,692,7,0,8027,0,284,10,0,9153,0,408
0.253,6,26,6150,12,181,23,537,1526,14,555,18,1402,4624
0.043,17,2,550,2,247,43,247,550,0,0,0,0,0
160.751,17,4,240,2,32,160750,32,120,2,32,160749,32,120
180.493,2,4,128,4,8,60164,8,128,0,0,0,0,0
1780.727,6,111,8851,71,65,25438,65,5245,40,59,45620,59,3606
1663.801,1,7,392,7,28,277300,28,392,0,0,0,0,0
117.869,17,6,8248,6,1346,23573,1350,8248,0,0,0,0,0
1789.18,6,476,44935,253,149,7099,1189,25514,223,129,8057,1917,19421
1756.104,6,94,7151,62,38,28788,205,4424,32,33,56641,98,2727
1799.936,17,449,39928,404,35,4466,288,25708,45,288,40017,288,14220
1786.686,6,167,21915,96,316,18807,316,15440,71,83,25524,83,6475
1786.508,6,102,8364,68,66,26664,66,4964,34,60,54133,60,3400
1780.675,17,141,11276,71,48,25435,48,5396,70,56,25804,56,5880
2.095,6,13,2311,8,188,299,245,700,5,1407,462,1407,1611
1786.726,6,104,8510,69,66,26275,66,5070,35,60,52547,60,3440
19.041,17,29,12563,13,516,1584,1350,7083,16,314,1267,1350,5480
8.716,6,34,8248,18,367,512,787,1854,16,522,569,3488,6394
0.009,17,2,459,1,40,0,40,68,1,363,0,363,391
1.313,6,51,19785,28,924,48,1360,14089,23,433,51,1360,5696
100.642,6,46,11032,15,294,1721,1189,2666,31,355,3354,1420,8366
31.619,6,7,396,1,0,0,0,60,6,0,6287,0,336
367.221,6,25,1651,17,177,22951,177,1117,8,110,9173,110,534
1772.411,6,180,15480,120,69,14894,69,8940,60,69,30034,69,6540
381.429,6,22,1447,13,177,31785,177,861,9,110,10710,110,586
1790.274,17,142,11360,71,48,25575,48,5396,71,56,25575,56,5964
882.779,2,8,256,8,8,126111,8,256,0,0,0,0,0
11.764,6,2065,1932125,1300,1407,8,1448,1887681,765,776,15,1448,44444
1787.97,6,360,24156,210,88,8554,469,13878,150,69,11999,69,10278
1797.241,1,186,10416,186,28,9714,28,10416,0,0,0,0,0
5.114,6,80,46347,40,1066,131,1360,17634,40,1178,124,1394,28713
0.018,17,2,912,1,308,0,308,336,1,548,0,548,576
1795.655,17,448,39896,403,35,4466,288,25676,45,288,40020,288,14220
1799.844,17,449,39928,404,35,4466,288,25708,45,288,40020,288,14220
2.018,6,42,15843,22,563,96,1360,4374,20,761,92,1360,11469
2.645,6,40,14608,20,455,139,1460,3600,20,784,121,1460,11008
1.869,6,26,8257,13,150,155,374,1275,13,922,155,1420,6982
3.064,17,4,386,2,46,3057,46,148,2,91,3057,91,238
57.207,1,5,280,5,28,14301,28,280,0,0,0,0,0
300.828,6,48,10446,24,433,13079,910,3218,24,329,553,2720,7228
1787.171,17,140,11200,70,48,25900,48,5320,70,56,25900,56,5880
10.765,6,18,5610,10,275,1196,275,958,8,1440,841,1440,4652
0.013,17,2,152,1,48,0,48,76,1,48,0,48,76
26.772,6,39,8516,19,378,582,786,1962,20,478,1401,2720,6554
81.81,17,12,1056,6,48,16359,48,456,6,72,16359,72,600
280.244,6,31,7472,14,158,21557,267,1357,17,543,17512,1400,6115
1794.734,17,142,11360,71,48,25638,48,5396,71,56,25638,56,5964
1.814,6,9,527,5,43,453,43,311,4,0,602,0,216
1786.478,6,102,8364,68,66,26663,66,4964,34,60,54132,60,3400
1785.859,6,357,22629,209,69,8585,69,12569,148,69,12148,69,10060
421.126,2,5,160,5,8,105281,8,160,0,0,0,0,0
1796.584,17,448,39896,403,35,4469,288,25676,45,288,40018,288,14220
0.948,17,2,152,1,48,0,48,76,1,48,0,48,76
0.219,6,7,423,4,43,46,43,259,3,0,44,0,164
176.478,17,4,352,2,60,176476,60,176,2,60,176477,60,176
240.185,6,53,17810,28,794,8895,1402,14966,25,192,10007,580,2844
85.903,6,1676,1498497,1030,1434,56,1460,1461870,646,165,132,1460,36627
0.012,17,2,442,1,35,0,35,63,1,351,0,351,379
73.695,6,12,2568,3,256,44,256,380,9,304,9210,304,2188
1203.178,2,13,416,13,8,100264,8,416,0,0,0,0,0
0.943,6,10,1687,7,100,157,100,384,3,1179,346,1179,1303
192.503,17,6,528,3,60,96251,60,264,3,60,96251,60,264
49.226,17,40,10380,40,231,1262,389,10380,0,0,0,0,0
0.164,6,7,423,4,43,40,43,259,3,0,27,0,164
1773.038,1,58,4872,58,56,31105,56,4872,0,0,0,0,0
0.026,17,4,352,2,60,24,60,176,2,60,25,60,176
10.726,6,57,42745,38,1186,289,1368,36389,19,1072,584,2736,6356
8.713,6,18,1851,9,222,1082,222,1252,9,231,1082,231,599
1787.298,17,87,3648,86,14,21027,14,3612,1,8,0,8,36
66.038,17,4,558,2,36,66033,36,128,2,187,66033,187,430
379.821,6,22,2259,16,141,25321,141,813,6,398,4655,419,1446
0.464,6,12,1653,6,288,86,288,548,6,426,50,434,1105
4.91,17,10,1962,5,36,1226,36,320,5,300,1226,318,1642
36.77,17,22,1936,11,48,3674,48,836,11,72,3674,72,1100
1.556,6,49,19124,26,950,62,1460,13428,23,433,60,1460,5696
2.786,6,15,4479,8,517,398,517,1454,7,1316,429,1418,3025
1793.949,6,356,22727,205,69,8793,69,12340,151,69,11959,69,10387
3.073,6,24,7420,11,357,307,721,1515,13,672,240,1414,5905
3.624,17,28,8506,14,277,275,1350,4282,14,273,276,1350,4224
1789.845,6,354,22440,206,69,8730,69,12380,148,69,12175,69,10060
1674.408,1,8,448,8,28,239201,28,448,0,0,0,0,0
5.396,17,16,5507,7,355,899,1350,2683,9,285,629,1350,2824
11.147,6,83,24829,42,542,271,1152,19048,41,459,271,1179,5781
12.064,6,23,9410,12,275,1096,275,763,11,1170,986,1414,8647
1788.42,17,87,3648,86,14,21040,14,3612,1,8,0,8,36
0.473,6,222,395316,128,194,3,230,7443,94,4162,3,15422,387873
1794.022,17,142,11360,71,48,25628,48,5396,71,56,25628,56,5964
1773.596,1,58,4872,0,0,0,0,0,58,56,31115,56,4872
1772.332,6,180,15480,120,69,14893,69,8940,60,69,30034,69,6540
1776.312,1,60,5040,0,0,0,0,0,60,56,30106,56,5040
1751.387,6,186,11385,93,47,19036,208,6766,93,31,19034,31,4619
1793.76,6,355,22480,207,69,8707,69,12420,148,69,12202,69,10060
4.276,6,38,7229,20,218,225,314,3423,18,513,236,1179,3806
5.926,6,654,577452,408,1343,14,1368,558516,246,776,23,1473,18936
277.093,17,4,240,2,32,277092,32,120,2,32,277092,32,120
3.507,17,5,295,5,31,876,31,295,0,0,0,0,0
128.446,6,25,6369,8,272,206,516,1140,17,324,8022,1452,5229
1363.318,17,107,8548,55,48,25246,48,4180,52,56,26725,56,4368
1740.56,17,30,31650,30,1027,60019,1027,31650,0,0,0,0,0
39.061,17,22,1936,11,48,3905,48,836,11,72,3905,72,1100
1798.345,17,449,39928,404,35,4462,288,25708,45,288,40019,288,14220
1782.076,1,74,6216,74,56,24412,56,6216,0,0,0,0,0
8.884,6,82,24587,42,584,216,1152,19219,40,418,221,1152,5368
1799.919,6,356,22520,208,69,8695,69,12460,148,69,12243,69,10060
0.314,6,3,120,1,0,0,0,40,2,0,314,0,80
66.158,6,62,34030,35,1045,1945,1448,25874,27,843,2523,2359,8156
0.155,6,7,423,4,43,38,43,259,3,0,23,0,164
312.708,6,381,345369,142,713,2217,982,15273,239,1399,1313,1440,330096
1169.42,6,94,9810,53,68,22488,721,4479,41,99,27253,1448,5331
38.471,17,22,1936,11,48,3846,48,836,11,72,3846,72,1100
0.538,17,4,768,2,39,521,39,134,2,289,20,289,634
1790.642,1,222,12432,222,28,8102,28,12432,0,0,0,0,0
1745.833,6,96,7286,63,38,28158,205,4476,33,33,54549,98,2810
37.952,17,22,1936,11,48,3794,48,836,11,72,3794,72,1100
64.701,2,2,64,2,8,64701,8,64,0,0,0,0,0
74.709,6,9,680,6,92,14941,92,504,3,0,1110,0,176
1.301,6,48,19114,27,884,50,1360,13498,21,433,56,1360,5616
22.822,17,81,56577,47,939,495,1350,45486,34,298,690,1350,11091
0.338,6,27,8949,13,227,28,547,1592,14,827,25,1438,7357
2.132,6,19,3359,10,485,236,1344,2363,9,312,264,468,996
1789.959,6,354,22440,207,69,8689,69,12420,147,69,12259,69,10020
1184.625,17,34,11984,34,324,35897,548,11984,0,0,0,0,0
240.221,6,53,17993,28,813,8896,1418,15298,25,173,10008,580,2695
86.946,6,34,14810,18,488,288,1360,3207,16,995,5787,1360,11603
0.487,17,2,144,1,36,0,36,64,1,52,0,52,80
167.985,6,7,379,3,0,83992,0,152,4,7,55924,7,227
1788.016,6,361,22858,210,69,8555,69,12678,151,69,11920,69,10180
11.253,6,26,11958,13,275,937,275,1078,13,1293,901,1414,10880
33.781,6,34,5297,16,154,2252,722,1912,18,271,1975,1440,3385
240.286,6,42,8922,20,523,12646,1408,5760,22,223,11442,618,3162
1785.509,6,232,31693,143,143,12574,1221,16025,89,145,20286,3417,15668
8.89,6,22,9370,11,275,889,275,723,11,1170,822,1414,8647
1.157,6,23,7952,12,164,89,267,1288,11,1216,98,3819,6664
17.228,6,2920,2741029,1867,1389,9,1408,2681549,1053,776,16,1408,59480
3.833,6,12,3704,6,171,757,171,491,6,964,749,1448,3213
4.609,6,41,7349,22,218,219,314,3503,19,513,242,1179,3846
245.286,6,56,14407,26,387,9811,1360,6124,30,392,8452,1360,8283
621.644,17,12,4032,12,308,56513,308,4032,0,0,0,0,0
1797.362,17,448,39896,403,35,4471,288,25676,45,288,40015,288,14220
7.599,6,7,300,3,0,3799,0,124,4,0,2505,0,176
1745.656,6,97,7307,63,38,28155,205,4476,34,33,52887,98,2831
273.632,17,4,240,2,32,273631,32,120,2,32,273631,32,120
256.491,6,32,8952,14,158,19730,267,1357,18,624,15082,1400,7595
60.568,6,14,4518,2,92,304,92,204,12,368,5489,1408,4314
61.288,6,37,16153,22,819,2918,1408,9375,15,665,4360,1408,6778
1794.43,17,165,10560,165,36,10941,36,10560,0,0,0,0,0
0.115,6,13,4282,7,111,19,111,483,6,1159,22,2896,3799
0.371,6,22,7342,12,335,33,668,1974,10,1210,40,1906,5368
1795.114,17,449,39928,404,35,4454,288,25708,45,288,40018,288,14220
358.752,6,46,10135,29,266,12812,1360,4653,17,435,536,2667,5482
1797.686,17,446,39264,402,35,4483,288,25360,44,288,40948,288,13904
1.49,6,24,8004,11,164,121,267,1236,13,869,98,1448,6768
1786.825,6,104,8376,68,65,26669,65,4930,36,59,51049,59,3446
1793.317,1,58,4872,0,0,0,0,0,58,56,31461,56,4872
2.271,6,14,2351,8,188,324,245,700,6,703,400,1152,1651
75.106,6,21,860,10,0,6001,0,404,11,0,7509,0,456
66.528,6,47,22048,26,920,2656,1408,12519,21,496,3320,1408,9529
146.528,6,24,11718,13,741,55,1460,3518,11,1291,14638,2868,8200
2.415,6,35,8257,18,345,142,720,1823,17,478,142,2720,6434
841.514,17,8,592,4,30,280451,30,232,4,62,280488,62,360
67.731,6,34,17692,18,708,3984,1360,4294,16,1158,4506,1696,13398
0.893,17,3,215,2,33,887,33,122,1,65,0,65,93
3.227,17,4,304,2,48,3051,48,152,2,48,2972,48,152
1786.7,6,107,8496,68,65,26667,65,4930,39,59,47016,59,3566
0.574,17,4,724,2,32,564,32,120,2,274,564,274,604
121.114,6,24,6230,9,266,110,500,1164,15,371,8644,2642,5066
14.717,6,24,6993,13,275,1226,275,1078,11,910,970,1440,5915
1737.359,1,57,6651,57,88,31024,320,6651,0,0,0,0,0
1765.472,6,88,7147,58,65,26584,65,4205,30,58,60875,59,2942
280.278,6,28,7352,13,158,23356,267,1317,15,603,20018,1400,6035
1772.531,6,180,15480,120,69,14895,69,8940,60,69,30035,69,6540
1789.028,1,341,28644,341,56,5261,56,28644,0,0,0,0,0
1797.998,17,447,39864,402,35,4483,288,25644,45,288,40018,288,14220
1.032,17,2,136,1,32,0,32,60,1,48,0,48,76
1671.979,1,7,392,7,28,278663,28,392,0,0,0,0,0
1612.681,1,7,742,7,78,268780,78,742,0,0,0,0,0
1783.853,6,374,24054,214,75,8374,469,13514,160,69,11218,69,10540
5.862,17,22,12521,11,837,586,1350,9518,11,245,416,1350,3003
6.705,6,51,9501,26,233,268,314,4781,25,464,269,1179,4720
1791.291,17,469,53454,210,153,8549,1350,38124,259,31,6942,61,15330
18.335,6,28,7352,12,158,1666,267,1277,16,603,1220,1400,6075
14.67,17,2,244,2,94,14670,94,244,0,0,0,0,0
1682.098,17,14,1054,7,30,280345,30,406,7,64,280345,71,648
379.581,1,14,1176,0,0,0,0,0,14,56,29198,56,1176
0.015,6,10,1806,6,619,2,1079,1483,4,159,4,159,323
0.068,6,20,9188,10,127,7,127,655,10,1143,5,1448,8533
1727.846,6,114,10701,82,78,21331,138,7213,32,69,30043,69,3488
0.996,17,4,368,2,64,995,64,184,2,64,995,64,184
2.811,6,11,975,6,304,562,304,624,5,83,698,83,351
0.528,17,2,167,1,39,0,39,67,1,72,0,72,100
1.986,6,35,13116,18,525,116,1440,3410,17,818,113,1440,9706
35.551,17,4,240,2,32,35550,32,120,2,32,35549,32,120
1797.122,17,443,39168,399,35,4515,288,25264,44,288,40951,288,13904
85.867,6,47,10459,22,706,707,1360,4502,25,290,3570,1360,5957
240.279,6,42,9077,21,523,12013,1408,5808,21,241,12013,619,3269
12.413,6,1930,1702555,1197,1366,10,1380,1667286,733,526,16,3303,35269
180.792,6,21,1806,14,69,13907,69,1043,7,69,30048,69,763
1797.979,6,356,22520,208,69,8685,69,12460,148,69,12230,69,10060
0.361,17,4,420,2,33,358,33,122,2,121,356,145,298
25.552,6,37,9539,22,136,1216,159,2389,15,706,1824,1674,7150
0.832,6,24,6420,13,299,69,842,2023,11,988,82,1791,4397
240.576,6,58,24684,27,534,9252,1418,6225,31,935,8018,1418,18459
2.241,6,14,2351,8,188,320,245,700,6,703,395,1152,1651
1773.85,6,183,15807,120,69,14906,69,8940,63,69,28602,69,6867
1620.4,1,7,392,7,28,270066,28,392,0,0,0,0,0
1787.242,17,87,3648,86,14,21026,14,3612,1,8,0,8,36
63.381,6,10,648,10,31,7042,31,648,0,0,0,0,0
1400.362,2,11,352,11,8,140036,8,352,0,0,0,0,0
1787.109,6,102,9356,48,36,38018,36,2940,54,445,33713,445,6416
1796.491,17,142,11360,71,48,25664,48,5396,71,56,25664,56,5964
1794.049,6,365,24894,212,94,8502,469,14427,153,69,11802,69,10467
340.467,17,6,2000,6,305,68093,308,2000,0,0,0,0,0
1756.713,6,2081,1978170,797,154,2206,880,53663,1284,1536,1369,7090,1924507
300.396,6,44,23591,27,1083,11553,1408,17694,17,715,1724,1491,5897
1.321,6,14,4944,7,125,219,125,497,7,1018,219,1448,4447
28.164,6,6,1257,4,327,9388,414,815,2,181,27961,270,442
1.62,6,38,9107,20,397,85,1360,3611,18,433,82,1360,5496
1795.536,17,448,39896,403,35,4466,288,25676,45,288,40019,288,14220
237.258,6,198,34832,128,304,1868,304,25844,70,83,3437,83,8988
1.717,6,69,46301,40,1226,44,1408,38888,29,1179,54,3819,7413
26.597,17,4,352,2,60,26596,60,176,2,60,26596,60,176
167.312,17,8,2688,8,308,23901,308,2688,0,0,0,0,0
481.298,2,5,160,5,8,120324,8,160,0,0,0,0,0
11.032,6,20,4442,11,275,1103,275,998,9,768,781,1440,3444
292.72,1,4,224,4,28,97573,28,224,0,0,0,0,0
1744.659,2,28,896,28,8,64617,8,896,0,0,0,0,0
0.246,17,6,2056,6,314,49,354,2056,0,0,0,0,0
0.095,6,14,4424,9,290,11,517,1057,5,1033,20,2541,3367
1789.953,6,372,27395,216,116,8325,469,16463,156,69,11548,69,10932
0.053,1,2,112,2,28,53,28,112,0,0,0,0,0
23.606,6,3231,3043364,2016,1427,11,1448,2973108,1215,776,19,1448,70256
0.118,17,2,152,1,48,0,48,76,1,48,0,48,76
383.126,6,36,3208,18,69,14143,69,1341,18,67,22536,69,1867
33.913,6,31,5095,15,154,2422,721,1859,16,342,2246,1368,3236
0.077,17,2,390,1,46,0,46,74,1,288,0,288,316
1787.543,6,104,8376,68,65,26679,65,4930,36,59,51069,59,3446
1770.981,6,3728,3512382,1293,143,1370,898,76224,2435,1402,727,2836,3436158
1772.84,6,122,13755,77,123,23326,817,8730,45,68,40285,191,5025
0.273,6,26,8894,13,232,22,567,1636,13,1095,22,2816,7258
280.419,6,30,7432,13,158,23368,267,1317,17,543,17524,1400,6115
2.931,6,14,2351,8,188,418,245,700,6,703,536,1152,1651
8.936,6,14,1247,7,222,1487,222,728,7,231,1487,231,519
1773.964,6,180,15480,120,69,14907,69,8940,60,69,30064,69,6540
1771.384,6,102,9711,68,69,26438,233,5914,34,59,53675,82,3797
1150.191,6,13,1348,13,69,95849,69,1348,0,0,0,0,0
384.515,6,28,8285,16,122,25634,267,1393,12,913,5887,1460,6892
1.02,17,2,116,2,30,1020,30,116,0,0,0,0,0
76.76,6,9420,9047001,6318,1355,12,1408,8881033,3102,776,24,1408,165968
240.507,6,51,9865,25,202,10021,835,2963,26,460,9620,2338,6902
3.022,6,3,168,3,0,0,0,168,0,0,0,0,0
300.262,6,65,41902,37,145,8340,230,2572,28,1577,11120,4224,39330
1783.805,6,356,22520,208,69,8617,69,12460,148,69,12134,69,10060
0.129,6,16,5848,9,290,16,517,1069,7,1101,20,1408,4779
1.685,6,65,45358,40,1243,43,1440,38153,25,842,62,1440,7205
1786.576,6,102,8228,68,64,26665,64,4896,34,58,54135,58,3332
1787.011,6,107,8564,68,66,26671,66,4964,39,60,47024,60,3600
375.959,6,18,1242,14,180,28919,180,916,4,110,20065,110,326
12.152,6,97,28298,50,553,248,1152,21936,47,447,258,1179,6362
4.007,6,40,7309,21,218,200,314,3463,19,513,209,1179,3846
3.967,17,4,240,4,32,1322,32,240,0,0,0,0,0
11.452,6,1800,1581258,1095,1389,10,1420,1548837,705,467,16,1883,32421
100.301,6,16,5095,6,289,20060,722,1767,10,398,1826,2026,3328
1.698,6,53,13930,25,551,70,1429,4892,28,439,58,1986,9038
36.683,6,2850,2749776,1866,1396,19,1408,2693896,984,931,37,2816,55880
66.002,6,25,8901,11,607,119,1179,2402,14,480,5061,1368,6499
369.641,6,18,1242,14,180,28433,180,916,4,110,20059,110,326
0.497,6,22,7354,13,335,41,668,2026,9,1210,57,1946,5328
280.223,6,27,7312,12,158,25474,267,1277,15,678,20010,2045,6035
0.055,17,2,602,1,46,0,46,74,1,500,0,500,528
3.301,6,28,4645,14,195,253,293,2129,14,390,234,1152,2516
19.676,6,16,2357,9,211,2455,211,898,7,545,3250,904,1459
0.049,6,3,136,2,0,49,0,88,1,0,0,0,48
1620.973,6,172,18320,92,79,17812,721,8878,80,201,14814,2007,9442
3.584,6,34,9488,15,327,183,1189,2575,19,438,198,1420,6913
240.205,6,41,7775,20,156,12642,517,2145,21,503,12009,1515,5630
1121.105,17,10,740,5,30,280272,30,290,5,62,280273,62,450
12.207,6,899,771712,558,1312,21,1368,749316,341,776,35,2736,22396
0.166,6,25,7216,13,155,13,267,1301,12,678,14,2045,5915
1.015,6,190,133400,103,1320,9,1432,125617,87,475,11,1871,7783
34.686,6,32,6014,16,154,2312,721,1922,16,465,2298,2026,4092
50.406,17,4,352,2,60,50405,60,176,2,60,50404,60,176
75.176,6,19,780,9,0,6044,0,364,10,0,8351,0,416
1749.546,17,12,498,11,14,174954,14,462,1,8,0,8,36
599.14,6,74,8524,41,96,14974,722,3877,33,133,18717,1408,4647
760.025,6,49,3819,30,48,26207,205,2233,19,35,38577,98,1586
67.079,6,25,7097,12,155,6098,267,1266,13,589,5589,3426,5831
1772.192,6,180,15480,120,69,14892,69,8940,60,69,30034,69,6540
0.11,17,2,640,2,292,110,298,640,0,0,0,0,0
0.259,6,13,2117,7,322,43,581,1005,6,396,50,580,1112
275.707,1,6,336,6,28,55141,28,336,0,0,0,0,0
67.093,6,27,7177,13,155,5591,267,1306,14,530,5160,3417,5871
601.789,17,63,4788,63,48,9706,48,4788,0,0,0,0,0
0.49,17,3,451,2,39,270,39,134,1,289,0,289,317
0.573,6,10,1689,5,288,98,288,556,5,432,98,446,1133
0.872,6,12,1352,6,256,172,256,500,6,304,172,304,852
0.954,17,2,144,1,36,0,36,64,1,52,0,52,80
1799.546,6,367,25650,214,99,8448,469,15045,153,69,11839,69,10605
12.019,6,17,2413,10,211,1335,211,962,7,545,2001,904,1451
1788.785,17,87,3648,86,14,21044,14,3612,1,8,0,8,36
60.811,6,11,967,11,47,6081,62,967,0,0,0,0,0
1.368,6,52,20283,30,889,47,1360,14582,22,437,56,2715,5701
1.476,6,50,22153,29,959,52,1360,16537,21,476,64,2715,5616
2.045,17,6,460,3,40,990,41,206,3,56,1016,57,254
29.395,6,35,9386,17,315,1837,721,3209,18,778,1717,2840,6177
5.026,17,3,208,2,36,5002,36,128,1,52,0,52,80
64.763,6,28,7217,13,155,5396,267,1306,15,482,4625,1997,5911
4.731,6,38,7229,20,218,249,314,3423,18,513,263,1179,3806
252.52,6,8,450,6,106,50504,106,354,2,0,1021,0,96
3.143,17,27,12901,13,687,261,1350,9299,14,229,124,1350,3602
1789.892,6,356,22520,208,69,8646,69,12460,148,69,12176,69,10060
0.228,6,46,21361,26,1091,9,1420,16340,20,467,11,1883,5021
1744.677,2,29,928,29,8,62309,8,928,0,0,0,0,0
280.218,6,30,7432,14,158,21555,267,1357,16,603,18678,2036,6075
280.248,6,29,7392,13,158,23354,267,1317,16,603,18681,2236,6075
0.148,6,12,3462,6,75,29,75,395,6,1373,29,1448,3067
280.226,6,30,7432,13,158,23352,267,1317,17,543,17513,1400,6115
156.197,6,43,8645,17,117,9761,267,1742,26,292,6247,1452,6903
1792.217,1,74,6216,0,0,0,0,0,74,56,24550,56,6216
1799.228,1,58,4872,58,56,31565,56,4872,0,0,0,0,0
0.014,17,2,471,1,36,0,36,64,1,379,0,379,407
240.305,6,43,8825,22,523,11442,1408,5862,21,207,12015,617,2963
1751.447,1,58,4872,58,56,30727,56,4872,0,0,0,0,0
15.464,17,16,6373,8,479,2199,1350,4058,8,261,2198,1350,2315
305.611,6,33,6397,17,286,19100,1314,2405,16,334,20373,1420,3992
0.947,6,24,8963,14,264,72,700,1651,10,1380,85,3930,7312
0.456,6,23,7321,12,318,40,599,1905,11,967,44,1471,5416
1795.193,17,448,39896,403,35,4465,288,25676,45,288,40018,288,14220
293.746,17,4,352,2,60,293745,60,176,2,60,293745,60,176
5.513,6,38,7229,20,218,290,314,3423,18,513,308,1179,3806
0.254,17,2,206,1,44,0,44,72,1,106,0,106,134
1740.516,6,87,6322,58,31,30535,31,3915,29,31,62159,31,2407
72.208,6,30,7504,12,155,6564,267,1266,18,423,4246,2006,6238
0.021,17,4,764,2,32,16,32,120,2,294,16,294,644
1787.241,1,180,10080,180,28,9984,28,10080,0,0,0,0,0
0.058,6,15,7317,8,273,8,517,1245,7,1900,8,4130,6072
6.0,6,36,6249,18,206,352,314,2784,18,456,336,1152,3465
5.365,6,39,7269,20,218,282,314,3423,19,513,284,1179,3846
1775.559,17,140,11200,70,48,25732,48,5320,70,56,25732,56,5880
280.212,6,30,7432,13,158,23351,267,1317,17,543,17512,1300,6115
1772.959,6,180,15480,120,69,14898,69,8940,60,69,30049,69,6540
1777.398,17,140,11200,70,48,25759,48,5320,70,56,25759,56,5880
0.079,17,8,2758,8,316,11,355,2758,0,0,0,0,0
4.686,6,307,270482,197,1023,23,1360,21283,110,2376,41,13600,249199
371.52,6,25,1651,17,177,23220,177,1117,8,110,9212,110,534
0.428,6,21,7217,12,318,38,599,1905,9,967,52,1471,5312
3.121,6,88,68581,56,876,56,1360,9398,32,2315,96,6800,59183
1773.215,6,180,15480,120,69,14900,69,8940,60,69,30046,69,6540
1682.402,1,15,840,15,28,120171,28,840,0,0,0,0,0
206.704,1,4,604,4,123,68901,123,604,0,0,0,0,0
1415.028,1,16,896,16,28,94335,28,896,0,0,0,0,0
2.57,6,45,26322,22,286,122,901,2883,23,1307,114,2816,23439
0.908,6,156,116079,91,1319,10,1432,109188,65,427,13,1432,6891
61.659,6,51,29334,31,1049,2055,1408,21553,20,961,3233,3847,7781
1.46,6,46,18843,26,938,58,1440,13267,20,433,66,1440,5576
110.453,17,10,880,5,48,27610,48,380,5,72,27610,72,500
38.104,1,43,4472,0,0,0,0,0,43,76,907,76,4472
0.531,17,3,451,2,39,510,39,134,1,289,0,289,317
1678.002,1,7,392,7,28,279667,28,392,0,0,0,0,0
56.171,6,112,104409,38,164,1518,232,2018,74,1400,745,2860,102391
1793.433,17,180,14040,180,50,10019,50,14040,0,0,0,0,0
154.687,6,15,612,5,0,5611,0,204,10,0,17186,0,408
5.915,6,2,80,1,0,0,0,40,1,0,0,0,40
9.09,17,16,1408,8,37,1298,37,520,8,83,1297,89,888
1759.033,6,132,10454,80,48,22266,199,6020,52,37,34485,98,4434
0.51,6,24,6041,13,108,42,147,959,11,773,47,1608,5082
29.178,1,4,224,4,28,9726,28,224,0,0,0,0,0
242.743,6,21,2625,10,324,26971,585,1189,11,282,24255,580,1436
1786.309,17,87,3648,86,14,21015,14,3612,1,8,0,8,36
1789.259,1,340,28560,340,56,5278,56,28560,0,0,0,0,0
0.029,17,2,341,1,64,0,64,92,1,221,0,221,249
28.831,2,2,64,2,8,28831,8,64,0,0,0,0,0
2.005,6,48,19291,27,897,77,1440,13675,21,433,84,1440,5616
83.467,17,4,352,2,60,83466,60,176,2,60,83466,60,176
0.381,17,2,144,1,36,0,36,64,1,52,0,52,80
0.751,6,26,8990,13,247,62,624,1672,13,947,49,1438,7318
247.549,17,3,2145,3,687,123774,687,2145,0,0,0,0,0
241.318,6,54,20334,29,1013,8618,1418,16771,25,205,10054,653,3563
17.74,1,4,224,4,28,5913,28,224,0,0,0,0,0
1.299,17,6,552,3,32,626,32,180,3,96,633,96,372
302.44,6,82,58643,46,598,6720,1338,5555,36,1651,1021,6858,53088
27.279,6,4100,3863052,2680,1363,10,1408,3784548,1420,931,19,2816,78504
25.832,6,56,14626,31,481,861,1152,10873,25,456,967,1152,3753
0.868,6,11,1727,7,100,144,100,384,4,589,206,1152,1343
0.959,6,26,9892,14,350,73,1041,1992,12,1058,70,1360,7900
0.01,6,9,1547,5,515,2,515,783,4,548,3,548,764
44.738,17,8,2872,8,331,6391,548,2872,0,0,0,0,0
1789.648,6,356,22520,208,69,8645,69,12460,148,69,12174,69,10060
0.231,6,4,1037,2,0,218,0,104,2,853,16,853,933
1796.379,6,358,22807,207,69,8720,69,12420,151,69,11975,69,10387
534.508,17,19,1444,19,48,29694,48,1444,0,0,0,0,0
13.414,17,3,1000,3,305,6707,308,1000,0,0,0,0,0
12.558,6,25,8453,13,275,1046,275,1078,12,983,1055,1420,7375
23.404,17,8,704,4,48,7798,48,304,4,72,7798,72,400
153.163,17,4,352,2,60,153162,60,176,2,60,153162,60,176
36.269,17,20,1760,10,48,4028,48,760,10,72,4028,72,1000
4.37,6,34,8110,18,313,257,624,1716,16,522,280,2720,6394
10.794,6,1583,1471666,1039,1365,10,1432,1445615,544,475,19,1871,26051
0.285,17,2,157,1,31,0,31,59,1,70,0,70,98
1.353,6,48,18200,26,882,54,1360,12544,22,476,55,2715,5656
1.41,6,44,22313,26,396,56,986,2945,18,1534,79,2939,19368
1742.406,2,21,672,21,8,87120,8,672,0,0,0,0,0
1794.143,17,80,3354,79,14,23001,14,3318,1,8,0,8,36
62.55,17,4,352,2,60,62549,60,176,2,60,62549,60,176
0.244,17,2,2750,2,1347,244,1347,2750,0,0,0,0,0
1771.99,6,102,9540,67,66,26848,66,5728,35,60,52114,60,3812
0.063,6,2,116,1,0,0,0,64,1,0,0,0,52
1792.317,17,180,14040,180,50,10012,50,14040,0,0,0,0,0
280.486,6,29,7392,13,158,23373,267,1317,16,603,18693,2076,6075
300.785,2,3,96,3,8,150392,8,96,0,0,0,0,0
61.339,6,37,15984,22,805,2920,1408,9206,15,665,4364,1408,6778
12.751,6,1805,1647270,1157,1370,11,1432,1616331,648,427,19,1432,30939
1799.46,17,448,39896,403,35,4476,288,25676,45,288,40018,288,14220
1789.902,17,87,3648,86,14,21057,14,3612,1,8,0,8,36
17.753,6,29,5530,14,332,1365,1056,3061,15,240,1266,580,2469
1753.687,17,28,29568,28,1028,64951,1028,29568,0,0,0,0,0
1779.746,17,140,11200,70,48,25793,48,5320,70,56,25793,56,5880
217.426,17,24,5448,24,199,9453,208,5448,0,0,0,0,0
1742.944,6,95,7203,63,38,28112,205,4476,32,33,56217,98,2727
68.576,6,78,28616,40,721,1753,1440,20406,38,556,1848,1440,8210
216.142,17,4,352,2,60,216141,60,176,2,60,216141,60,176
0.911,6,32,8952,14,158,70,267,1357,18,624,52,1400,7595
1763.768,2,14,448,14,8,135674,8,448,0,0,0,0,0
6.275,6,1317,1181478,809,1381,7,1408,1150398,508,931,12,2816,31080
48.167,6,22,3753,5,49,913,92,367,17,178,2999,1408,3386
0.402,2,2,112,2,32,402,32,112,0,0,0,0,0
85.168,6,77,51384,47,1195,1851,1408,43091,30,960,2123,3847,8293
0.147,1,2,163,2,53,147,78,163,0,0,0,0,0
1771.513,6,101,9344,66,65,27254,65,5577,35,59,52100,59,3767
1345.213,6,107,11069,67,65,20379,722,5763,40,104,34488,2026,5306
0.522,6,20,7229,13,334,43,663,2021,7,1209,79,1946,5208
629.656,2,4,128,4,8,209885,8,128,0,0,0,0,0
4.999,17,3,505,2,40,4993,40,136,1,341,0,341,369
9.354,6,2019,1858784,1275,1379,7,1408,1815432,744,931,12,2816,43352
0.573,17,8,1618,4,33,187,33,244,4,315,177,327,1374
0.678,17,2,152,1,48,0,48,76,1,48,0,48,76
0.022,17,2,2166,2,1055,22,1055,2166,0,0,0,0,0
2.231,6,29,10366,17,367,139,833,1785,12,1012,196,1420,8581
36.595,17,11,836,11,48,3659,48,836,0,0,0,0,0
64.803,6,15,1394,6,177,216,177,686,9,110,8078,110,708
240.368,6,423,395484,149,225,1624,748,9334,274,1408,880,4254,386150
0.297,1,2,112,2,28,297,28,112,0,0,0,0,0
22.224,6,2865,2677277,1807,1402,12,1448,2617585,1058,776,20,1448,59692
4.793,6,40,7309,21,218,239,314,3463,19,513,252,1179,3846
300.625,6,38,8581,20,318,15822,928,2107,18,441,498,1360,6474
1794.016,1,261,14616,261,28,6900,28,14616,0,0,0,0,0
1799.34,17,142,11360,71,48,25704,48,5396,71,56,25704,56,5964
3.372,17,28,6353,14,235,256,1350,3690,14,162,256,1350,2663
0.007,17,2,283,1,31,0,31,59,1,196,0,196,224
113.992,6,92,63492,44,726,60,1460,5414,48,1369,2422,1514,58078
1771.27,6,102,9473,67,65,26837,65,5694,35,59,52093,59,3779
1.462,6,57,24105,32,997,47,1460,18284,25,400,53,1460,5821
1.114,17,403,393930,121,86,9,1350,13875,282,1319,3,1350,380055
1775.095,6,180,15480,120,69,14916,69,8940,60,69,30081,69,6540
134.155,17,45,11498,45,227,3048,388,11498,0,0,0,0,0
5.024,17,4,288,2,36,5006,36,128,2,52,5009,52,160
0.196,17,2,180,1,30,0,30,58,1,94,0,94,122
0.316,6,24,7446,12,335,28,668,1974,12,806,28,1408,5472
77.056,6,25,1799,18,43,4525,43,1399,7,0,12354,0,400
56.739,17,9,3016,9,307,7092,308,3016,0,0,0,0,0
300.602,6,36,8391,20,291,15821,786,1997,16,522,564,2720,6394
1.165,6,23,7952,12,164,90,267,1288,11,1216,99,3825,6664
3.327,17,5,290,5,30,831,30,290,0,0,0,0,0
1737.646,1,19,2204,19,88,96535,88,2204,0,0,0,0,0
132.147,6,40,8478,13,142,2950,267,1381,27,273,5082,1452,7097
3.12,6,21,6360,9,262,384,517,1264,12,744,279,1418,5096
106.073,6,1088,528259,593,829,179,1152,498862,495,383,214,1179,29397
1714.947,1,8,448,8,28,244992,28,448,0,0,0,0,0
4.026,6,591,536655,385,1360,10,1432,524124,206,475,19,1871,12531
1.301,6,12,3336,4,92,433,92,308,8,434,153,1408,3028
1784.953,6,102,8296,68,65,26641,65,4930,34,59,54086,59,3366
0.02,17,2,152,1,48,0,48,76,1,48,0,48,76
1770.734,6,99,9174,66,64,27242,64,5544,33,58,55331,58,3630
9.978,6,79,24365,39,550,262,1152,18624,40,459,248,1179,5741
126.67,17,10,880,5,48,31665,48,380,5,72,31665,72,500
1786.84,6,106,8584,69,66,26277,66,5004,37,60,49627,60,3580
180.48,2,3,96,3,8,90240,8,96,0,0,0,0,0
5.882,6,16,3265,6,92,1176,92,400,10,463,625,1408,2865
1.045,6,29,8521,15,225,61,561,1985,14,852,65,1360,6536
1623.48,1,7,392,7,28,270580,28,392,0,0,0,0,0
9.198,6,78,24309,39,549,242,1152,18608,39,459,234,1179,5701
280.482,6,30,7432,13,158,23373,267,1317,17,603,17526,2760,6115
3.596,6,12,2275,6,188,719,245,620,6,1407,661,1407,1655
38.905,1,8,832,0,0,0,0,0,8,76,5557,76,832
113.965,1,30,2520,30,56,3929,56,2520,0,0,0,0,0
2.036,17,6,460,3,40,1005,41,206,3,56,1004,57,254
1792.041,17,140,11200,70,48,25971,48,5320,70,56,25971,56,5880
0.0,17,1,1465,1,1437,0,1437,1465,0,0,0,0,0
0.087,17,4,284,2,32,6,32,120,2,54,82,60,164
1784.973,6,356,22520,208,69,8623,69,12460,148,69,12140,69,10060
280.275,6,30,7432,13,158,23356,267,1317,17,543,17513,1400,6115
6.478,6,6,493,4,245,2159,245,409,2,0,254,0,84
10.382,6,85,24957,44,561,241,1152,19176,41,413,253,1152,5781
0.588,6,24,4571,12,165,53,456,1446,12,415,48,888,3125
1789.919,6,356,22520,208,69,8646,69,12460,148,69,12174,69,10060
1770.274,6,99,9240,66,65,27234,65,5577,33,59,55318,59,3663
260.171,17,7,4873,7,668,43361,1445,4873,0,0,0,0,0
118.486,17,4,352,2,60,118485,60,176,2,60,118485,60,176
1773.812,6,181,15589,120,69,14905,69,8940,61,69,29555,69,6649
1789.321,17,87,3648,86,14,21050,14,3612,1,8,0,8,36
0.984,6,25,8693,14,203,75,458,1406,11,976,80,1440,7287
1745.652,6,95,7203,63,38,28155,205,4476,32,33,56302,98,2727
0.525,17,2,152,1,48,0,48,76,1,48,0,48,76
34.078,6,36,5411,17,154,2116,721,1974,19,271,1881,1368,3437
1799.554,17,757,45677,757,32,2380,37,45677,0,0,0,0,0
144.097,17,4,240,2,32,144096,32,120,2,32,144096,32,120
1747.761,1,64,3584,64,28,27742,28,3584,0,0,0,0,0
0.126,17,2,166,1,39,0,39,67,1,71,0,71,99
0.602,17,8,2750,8,315,86,354,2750,0,0,0,0,0
73.376,6,71,48442,45,1187,1667,1408,40356,26,960,2465,3847,8086
1793.771,17,29,9686,29,306,64063,306,9686,0,0,0,0,0
1790.59,6,381,34193,212,117,8486,1189,17078,169,130,10658,1420,17115
0.904,6,10,1687,7,100,150,100,384,3,1179,321,1179,1303
239.405,6,143,80068,93,901,1782,1360,62341,50,628,4882,3940,17727
1793.172,1,342,28728,342,56,5258,56,28728,0,0,0,0,0
295.495,1,4,224,4,28,98498,28,224,0,0,0,0,0
178.446,6,6,1257,4,327,59482,414,815,2,181,178239,270,442
1788.687,6,120,14020,76,82,23849,515,6004,44,160,41595,1452,8016
19.892,6,26,7137,8,133,2841,267,861,18,426,1166,1917,6276
1.451,6,48,19082,27,882,55,1360,13466,21,476,61,2715,5616
1737.376,1,56,4704,0,0,0,0,0,56,56,31588,56,4704
0.15,6,7,423,4,43,39,43,259,3,0,22,0,164
1750.59,17,12,498,11,14,175059,14,462,1,8,0,8,36
14.116,17,1093,1299203,156,87,91,1350,18069,937,1339,15,1350,1281134
736.993,6,31,2491,20,64,25593,64,1440,11,55,73690,58,1051
0.153,1,2,112,2,28,153,28,112,0,0,0,0,0
1799.733,1,15,840,15,28,128552,28,840,0,0,0,0,0
1730.061,1,8,448,8,28,247151,28,448,0,0,0,0,0
1771.668,6,101,9344,66,65,27256,65,5577,35,59,52105,59,3767
0.0,17,1,312,1,284,0,284,312,0,0,0,0,0
297.778,17,4,240,2,32,297777,32,120,2,32,297777,32,120
19.135,17,6,2016,6,308,3827,308,2016,0,0,0,0,0
1784.249,6,116,10302,72,77,25130,275,5674,44,71,41492,341,4628
1799.495,17,450,39960,405,35,4454,288,25740,45,288,40017,288,14220
1.355,6,50,20053,28,883,50,1360,14397,22,433,55,1360,5656
2.83,6,69,31956,38,1050,76,1360,25723,31,400,87,1360,6233
128.533,6,115,86301,74,1244,1760,1408,76047,41,811,2793,3847,10254
0.016,17,4,668,2,32,10,32,120,2,246,9,246,548
1720.545,17,12,498,11,14,172054,14,462,1,8,0,8,36
1.019,17,21,15543,13,970,83,1350,12974,8,293,140,1350,2569
0.541,17,2,384,1,39,0,39,67,1,289,0,289,317
11.962,6,91,27253,47,546,260,1152,20995,44,449,272,1179,6258
4.508,6,27,6135,14,108,346,147,999,13,768,306,1581,5136
64.672,6,12,927,4,177,120,177,393,8,110,9213,110,534
5.533,6,42,8289,21,227,276,314,4022,21,489,263,1179,4267
1783.366,17,77,3228,76,14,23778,14,3192,1,8,0,8,36
0.0,1,1,60,1,32,0,32,60,0,0,0,0,0
1796.299,6,389,27082,222,96,8128,469,15917,167,69,10820,69,11165
240.207,6,57,20529,31,846,8006,1418,17700,26,183,9607,580,2829
37.314,17,3,1008,3,308,18657,308,1008,0,0,0,0,0
61.389,6,10,648,10,31,6821,31,648,0,0,0,0,0
10.945,6,87,26741,42,568,266,1152,20459,45,407,242,1152,6282
0.985,6,27,8506,15,229,59,583,2007,12,1201,73,3151,6499
300.535,6,11,912,6,226,60073,226,546,5,110,75091,110,366
1796.424,6,1504,204799,742,171,2424,1448,109805,762,152,2360,1283,94994
39.49,17,22,1672,22,48,1880,48,1672,0,0,0,0,0
35.063,6,38,8640,20,410,480,882,2122,18,526,2053,4848,6518
7.375,6,5,220,1,0,0,0,44,4,0,2430,0,176
1656.396,1,7,742,7,78,276066,78,742,0,0,0,0,0
0.017,17,2,456,1,50,0,50,78,1,350,0,350,378
38.852,6,44,14370,22,966,420,1460,8657,22,370,1842,1460,5713
29.966,6,12,1313,7,185,4994,185,557,5,244,7488,476,756
3.121,6,11,3005,5,92,780,92,348,6,1164,552,1448,2657
1739.32,6,87,6322,58,31,30514,31,3915,29,31,62117,31,2407
0.13,17,2,572,1,39,0,39,67,1,477,0,477,505
0.365,6,22,6062,12,272,33,517,1723,10,762,39,1440,4339
48.371,17,4,352,2,60,48370,60,176,2,60,48370,60,176
300.855,6,50,10526,25,433,12535,910,3258,25,312,540,1360,7268
17.811,17,32,14215,17,634,1111,1350,11264,15,168,1271,1350,2951
342.145,17,8,2688,8,308,48877,308,2688,0,0,0,0,0
1783.478,17,83,3480,82,14,22018,14,3444,1,8,0,8,36
240.266,6,43,8993,21,519,12013,1402,5776,22,229,11440,617,3217
1789.5,1,59,4956,59,56,30853,56,4956,0,0,0,0,0
240.312,6,44,8447,22,449,11443,1408,5648,22,205,11443,580,2799
0.003,6,2,84,1,0,0,0,44,1,0,0,0,40
9.25,17,4,5484,4,1343,3083,1348,5484,0,0,0,0,0
6.269,6,1456,1358807,929,1386,6,1408,1326739,527,931,11,2801,32068
3.186,17,21,6014,8,276,455,1350,2435,13,247,134,1350,3579
35.858,17,40,5880,20,48,1886,48,1520,20,190,1886,308,4360
3.92,1,8,832,0,0,0,0,0,8,76,560,76,832
280.482,6,30,7432,13,158,23373,267,1317,17,543,17520,1400,6115
11.679,6,1854,1613699,1121,1385,10,1420,1580158,733,467,15,1883,33541
1681.634,17,16,1265,8,30,240231,37,471,8,71,240231,136,794
1770.62,6,122,12213,74,64,24252,722,6185,48,95,37668,2328,6028
143.364,6,27,6484,14,186,11028,501,1495,13,446,11939,1420,4989
1.368,6,11,988,5,283,297,283,563,6,105,237,105,425
0.498,17,14,8263,8,704,71,1350,5863,6,372,88,1350,2400
13.724,17,4,352,2,48,13708,48,152,2,72,13698,72,200
2.148,6,39,8449,19,321,119,1164,2718,20,409,102,1360,5731
2.824,6,2,88,2,0,0,0,88,0,0,0,0,0
0.411,6,51,22252,28,1061,15,1380,17078,23,421,17,1923,5174
12.156,6,84,24581,42,550,296,1152,18760,42,459,289,1179,5821
1797.231,17,141,11276,71,48,25674,48,5396,70,56,26046,56,5880
97.769,6,22,8779,11,323,63,661,1442,11,983,9763,1360,7337
0.469,17,3,2906,3,940,234,1451,2906,0,0,0,0,0
656.627,17,699,52990,387,40,1700,41,26568,312,56,2111,57,26422
1.115,6,14,2205,6,324,223,585,969,8,396,152,580,1236
503.618,2,4,128,4,8,167872,8,128,0,0,0,0,0
104.877,6,29,7392,13,158,8739,267,1317,16,603,6990,2036,6075
1681.297,17,14,3771,7,30,280214,30,406,7,452,280214,463,3365
0.005,17,2,169,1,34,0,34,62,1,79,0,79,107
300.61,6,45,8944,23,286,13664,766,2156,22,346,619,1928,6788
0.017,17,2,225,1,37,0,37,65,1,132,0,132,160
1.328,6,20,5362,12,125,120,212,986,8,1013,188,3151,4376
131.993,17,4,240,2,32,131992,32,120,2,32,131992,32,120
1796.687,17,439,38472,396,34,4548,288,24884,43,288,41926,288,13588
5.042,6,35,6209,19,206,280,314,2824,16,548,317,1179,3385
1797.896,6,194,18868,127,99,14269,469,11565,67,69,27237,69,7303
3.952,17,8,668,4,39,1306,39,268,4,72,734,72,400
22.271,17,3,228,3,48,11135,48,228,0,0,0,0,0
67.045,6,156,129831,98,430,691,647,6490,58,2187,1164,8448,123341
1787.414,6,102,8296,68,65,26677,65,4930,34,59,54159,59,3366
280.216,6,30,7432,13,158,23351,267,1317,17,543,17511,1400,6115
1770.57,6,103,9448,66,65,27239,65,5577,37,59,49179,59,3871
1749.767,6,96,7286,63,38,28222,205,4476,33,33,54673,98,2810
241.296,6,65,10613,29,286,8616,823,5270,36,228,6893,1299,5343
1681.304,17,14,1036,7,30,280213,30,406,7,62,280213,62,630
300.781,6,42,10000,23,571,13671,1360,4393,19,371,477,1360,5607
2.089,6,13,2311,8,188,298,245,700,5,1407,455,1407,1611
0.273,6,27,9083,13,247,22,624,1684,14,832,20,1408,7399
240.684,6,464,389923,185,460,1308,1418,13324,279,1361,865,2836,376599
294.684,6,52,9520,24,141,12810,517,2437,28,431,10912,1418,7083
3.411,17,35,12047,16,276,225,1350,4876,19,349,187,1350,7171
300.743,2,4,128,4,8,100247,8,128,0,0,0,0,0
8.747,6,36,8368,18,341,514,708,1776,18,450,502,1360,6592
204.53,6,79,35143,44,675,1339,1360,11367,35,1016,6012,4432,23776
6.877,6,67,20246,35,543,202,1152,15539,32,489,213,1179,4707
1787.432,17,87,3648,86,14,21028,14,3612,1,8,0,8,36
0.117,6,17,4088,10,101,13,101,629,7,771,19,1500,3459
93.07,17,10,880,5,48,23265,48,380,5,72,23265,72,500
0.315,17,2,241,1,36,0,36,64,1,149,0,149,177
154.629,6,64,35918,39,1064,4069,1408,28647,25,426,6437,3047,7271
2.09,6,63,47311,40,1266,53,1402,40076,23,1005,86,2423,7235
19.751,6,3142,2966709,1989,1412,9,1448,2902077,1153,776,16,1448,64632
1779.18,1,342,28728,342,56,5217,56,28728,0,0,0,0,0
1.008,17,2,685,1,308,0,308,336,1,321,0,321,349
20.278,6,3409,3158508,2176,1372,9,1408,3089728,1233,931,16,2816,68780
1781.946,6,362,22898,210,69,8526,69,12678,152,69,11800,69,10220
3.188,17,16,2048,16,100,212,355,2048,0,0,0,0,0
1772.023,6,180,15480,120,69,14890,69,8940,60,69,30032,69,6540
317.014,6,83,19417,44,315,7372,1460,10046,39,324,8338,3089,9371
1.515,6,38,9848,21,440,75,1360,4392,17,476,81,2715,5456
2.729,6,14,2351,8,188,389,245,700,6,703,493,1152,1651
0.004,6,21,29840,1,0,0,0,40,20,1438,0,1438,29800
0.489,17,3,451,2,39,82,39,134,1,289,0,289,317
1781.199,17,133,10636,67,48,26987,48,5092,66,56,27402,56,5544
1770.154,6,99,9174,66,64,27233,64,5544,33,58,55313,58,3630
1782.752,6,268,32453,108,137,16659,1460,15746,160,127,11211,1460,16707
300.584,6,18,1275,9,177,37551,177,701,9,110,37551,110,574
0.166,6,9,1339,5,145,41,145,349,4,826,36,826,990
389.497,6,23,1499,14,177,29961,177,913,9,110,12171,110,586
75.903,6,31,7613,12,155,30,267,1266,19,398,4216,3417,6347
40.049,17,5,320,5,36,10012,36,320,0,0,0,0,0
0.294,17,3,1167,3,361,147,371,1167,0,0,0,0,0
0.487,17,3,451,2,39,464,39,134,1,289,0,289,317
0.774,6,29,5882,14,135,59,267,1377,15,650,50,1420,4505
0.595,17,20,13167,11,928,55,1350,10524,9,265,63,1350,2643
1.419,6,34,12901,19,695,78,1460,5670,15,661,88,1460,7231
166.763,17,4,352,2,60,166762,60,176,2,60,166762,60,176
1773.335,6,180,15480,120,69,14901,69,8940,60,69,30048,69,6540
379.476,1,4,240,4,32,126492,32,240,0,0,0,0,0
1.134,17,4,1116,2,32,924,32,120,2,470,0,470,996
154.321,6,52,10818,22,218,7346,1189,3291,30,315,5319,3457,7527
1.521,6,6,340,3,0,760,0,160,3,0,504,0,180
770.916,17,152,11552,152,48,5105,48,11552,0,0,0,0,0
6.889,6,1400,1407416,986,1358,6,1368,1381224,414,931,16,2736,26192
0.057,17,3,234,2,39,5,39,134,1,72,0,72,100
1786.99,6,288,37147,118,145,15273,1360,17708,170,146,10572,3302,19439
2.152,17,14,5083,14,335,165,361,5083,0,0,0,0,0
416.131,6,54,3881,21,60,20800,293,1808,33,47,13000,78,2073
0.011,17,2,186,1,41,0,41,69,1,89,0,89,117
20.785,17,4,588,2,48,20764,48,152,2,190,20769,308,436
1.883,6,13,2311,8,188,269,245,700,5,1407,408,1407,1611
5.121,6,614,516756,269,976,19,1440,22572,345,1451,14,8640,494184
1773.289,6,180,15480,120,69,14901,69,8940,60,69,30053,69,6540
106.12,17,4,352,2,60,106119,60,176,2,60,106119,60,176
1791.407,6,355,22549,206,69,8738,69,12380,149,69,12103,69,10169
1779.16,6,145,8749,78,41,23103,208,5170,67,31,26954,31,3579
0.514,17,3,451,2,39,398,39,134,1,289,0,289,317
240.335,6,45,8499,24,449,10449,1402,5752,21,205,12016,580,2747
1740.659,17,30,7050,30,207,60022,207,7050,0,0,0,0,0
0.005,17,3,612,2,30,0,30,116,1,468,0,468,496
13.716,17,8,704,4,48,4568,48,304,4,72,4568,72,400
298.418,17,4,352,2,60,298417,60,176,2,60,298417,60,176
1760.855,6,218,15493,108,73,16456,208,10132,110,31,16152,31,5361
1742.175,1,58,4872,58,56,30564,56,4872,0,0,0,0,0
0.008,17,2,180,1,30,0,30,58,1,94,0,94,122
0.46,17,18,7502,9,502,57,1350,4773,9,275,49,1350,2729
41.095,6,5362,5104782,3466,1393,11,1440,5001526,1896,776,21,1440,103256
1790.299,6,356,22520,208,69,8648,69,12460,148,69,12178,69,10060
30.013,6,48,9182,24,182,1304,722,2614,24,559,1294,1380,6568
135.882,17,4,352,2,60,135880,60,176,2,60,135881,60,176
0.318,6,9,1002,5,213,79,213,417,4,421,88,421,585
1756.444,6,184,11305,92,47,19301,208,6695,92,31,19298,31,4610
8.558,17,30,8206,12,332,778,1350,4324,18,187,276,1350,3882
12.596,6,52,11150,25,233,524,314,4741,27,532,474,1179,6409
0.28,6,24,5962,12,164,25,453,1442,12,648,24,1408,4520
12.98,6,95,26833,48,545,276,1152,20463,47,407,275,1152,6370
1776.888,17,140,11200,70,48,25751,48,5320,70,56,25751,56,5880
0.232,17,2,136,1,32,0,32,60,1,48,0,48,76
128.401,6,31,8789,8,154,18343,267,792,23,372,5833,1460,7997
0.158,17,4,420,2,33,25,33,122,2,121,147,145,298
1248.192,17,14,1117,7,31,208026,37,413,7,72,208026,136,704
1.494,6,35,9747,16,703,99,1408,6500,19,223,82,580,3247
1772.219,6,180,15480,120,69,14892,69,8940,60,69,30032,69,6540
240.231,6,54,18379,29,815,8579,1418,15372,25,212,10008,580,3007
1.046,6,28,9973,14,350,80,1042,1993,14,1058,66,1360,7980
1778.561,6,122,12878,71,82,24811,515,5739,51,118,35569,1452,7139
0.174,17,4,368,2,32,3,32,120,2,96,0,96,248
1.374,6,48,19749,28,868,50,1360,14173,20,476,61,2720,5576
1786.78,6,104,8308,68,64,26668,64,4896,36,58,51048,58,3412
1785.859,6,364,23185,211,69,8504,69,12718,153,69,11749,69,10467
0.016,17,2,463,1,29,0,29,57,1,378,0,378,406
121.76,17,4,240,2,32,121759,32,120,2,32,121759,32,120
1771.655,6,99,9306,66,66,27256,66,5610,33,60,55361,60,3696
1030.789,17,52,2181,51,13,20615,14,2137,1,16,0,16,44
17.155,17,4,352,2,60,17153,60,176,2,60,17153,60,176
1.454,17,27,17234,12,604,131,1350,7584,15,615,101,1350,9650
1728.669,17,12,498,11,14,172866,14,462,1,8,0,8,36
21.845,6,14,2676,6,821,4367,1420,1886,8,231,3119,231,790
1775.905,17,140,11200,70,48,25737,48,5320,70,56,25737,56,5880
1786.659,6,107,8750,69,66,26274,66,5070,38,60,48285,60,3680
3.164,17,2,136,1,32,0,32,60,1,48,0,48,76
4.271,6,26,10889,15,353,305,584,2555,11,1550,412,2393,8334
7.47,6,6,280,2,0,7470,0,88,4,0,2432,0,192
280.423,6,31,7472,13,158,23368,267,1317,18,543,16492,1380,6155
0.815,6,10,1687,7,100,135,100,384,3,1179,276,1179,1303
1.583,6,25,8056,12,164,128,267,1288,13,869,117,1408,6768
40.32,6,16,5762,8,272,5760,516,1140,8,716,379,1452,4622
234.192,17,4,240,2,32,234191,32,120,2,32,234191,32,120
1.329,6,49,20394,28,908,49,1360,14778,21,433,56,1360,5616
0.043,17,2,602,1,46,0,46,74,1,500,0,500,528
128.723,6,25,6271,9,267,98,501,1165,16,343,8575,1420,5106
0.05,17,2,146,1,37,0,37,65,1,53,0,53,81
1796.771,1,345,28980,345,56,5223,56,28980,0,0,0,0,0
0.615,6,12,2084,6,288,84,288,560,6,424,84,434,1524
280.193,6,27,7312,13,158,23349,267,1317,14,775,21550,3445,5995
132.58,6,19,4208,9,296,16572,722,1353,10,388,14709,1408,2855
0.24,6,7,707,2,267,240,267,347,5,53,0,85,360
1795.685,17,446,39264,403,35,4466,288,25676,43,288,41930,288,13588
71.356,6,24,10402,12,397,96,884,1717,12,1024,6472,1503,8685
3.901,17,5,514,4,32,1295,32,240,1,246,0,246,274
2.308,6,6,340,3,0,1154,0,160,3,0,1013,0,180
367.157,6,23,1511,14,177,28242,177,925,9,110,9554,110,586
0.128,17,2,152,1,48,0,48,76,1,48,0,48,76
1.026,17,2,782,2,363,1026,363,782,0,0,0,0,0
1.926,6,30,6223,15,154,137,267,1684,15,562,127,1452,4539
240.188,6,52,18504,29,795,8577,1402,15834,23,209,10917,580,2670
0.456,17,2,152,1,48,0,48,76,1,48,0,48,76
282.285,6,32,7719,12,158,25489,267,1277,20,469,14854,2076,6442
239.883,1,2,212,2,78,239883,78,212,0,0,0,0,0
4.658,17,39,7685,17,186,289,1350,3641,22,155,220,1350,4044
367.394,6,25,1651,17,177,22962,177,1117,8,110,9173,110,534
64.639,6,7,424,7,0,0,0,424,0,0,0,0,0
1798.416,17,449,39928,404,35,4462,288,25708,45,288,40022,288,14220
3.138,6,52,13874,25,549,130,1429,4876,27,439,106,1986,8998
1684.48,2,13,416,13,8,140373,8,416,0,0,0,0,0
2.034,17,6,460,3,40,1004,41,206,3,56,1004,57,254
0.548,17,3,507,2,39,400,39,134,1,345,0,345,373
20.617,6,3116,2962662,1998,1405,10,1448,2899862,1118,776,18,1448,62800
1781.577,6,82,4392,41,26,44538,26,2196,41,26,44538,26,2196
127.88,6,32,9021,14,158,9836,267,1357,18,578,7521,1400,7664
0.773,6,9,492,5,0,193,0,268,4,0,253,0,224
61.648,17,16,2352,8,48,8805,48,608,8,190,8805,308,1744
280.499,6,29,7392,13,158,23374,267,1317,16,603,18691,2036,6075
1.404,6,46,18690,26,926,56,1460,13114,20,476,63,2615,5576
0.083,6,23,14098,13,127,6,127,811,10,1822,7,4344,13287
0.106,1,2,163,2,53,106,78,163,0,0,0,0,0
1784.696,17,142,11360,71,48,25495,48,5396,71,56,25495,56,5964
0.58,6,36,11485,21,637,29,1188,7461,15,359,36,1048,4024
0.053,17,4,420,2,33,34,33,122,2,121,37,145,298
1798.321,1,288,16128,288,28,6265,28,16128,0,0,0,0,0
0.422,6,50,21927,28,1043,15,1380,16805,22,468,18,3303,5122
1785.321,17,206,51977,206,224,8708,422,51977,0,0,0,0,0
0.482,6,5,1564,3,413,241,413,946,2,269,236,269,618
0.05,17,4,320,4,52,16,52,320,0,0,0,0,0
1.135,6,57,17994,28,707,42,1360,8925,29,438,40,1360,9069
3.365,17,5,290,5,30,841,30,290,0,0,0,0,0
42.411,6,44,8902,22,401,464,889,2176,22,416,2012,3488,6726
1776.924,17,73,3060,72,14,25027,14,3024,1,8,0,8,36
103.648,6,23,10009,12,531,63,1360,2637,11,1384,10350,3934,7372
870.221,6,65,9651,33,105,18994,501,2905,32,188,28068,1420,6746
72.185,6,29,7464,12,155,6562,267,1266,17,459,4511,3426,6198
95.707,6,40,8441,13,143,7974,267,1543,27,305,3680,1460,6898
280.198,6,25,7232,11,158,28019,267,1237,14,678,21551,2045,5995
0.049,17,2,144,1,36,0,36,64,1,52,0,52,80
0.536,6,23,7385,13,334,44,663,2021,10,967,53,1946,5364
1.678,6,47,19030,26,949,67,1460,13414,21,433,73,1460,5616
240.198,6,57,18843,29,800,8578,1418,15916,28,182,8895,580,2927
1772.238,6,180,15480,120,69,14892,69,8940,60,69,30031,69,6540
1762.463,17,169,14131,157,30,11297,37,9155,12,386,154790,463,4976
1784.818,17,142,11360,71,48,25496,48,5396,71,56,25496,56,5964
40.301,6,11,588,4,0,13433,0,216,7,0,6715,0,372
1772.619,6,180,15480,120,69,14895,69,8940,60,69,30036,69,6540
1744.554,6,94,7151,62,38,28599,205,4424,32,33,56264,98,2727
1.206,6,6,333,3,31,105,31,182,3,31,601,31,151
135.352,17,4,1344,4,308,45117,308,1344,0,0,0,0,0
11.569,6,25,8453,13,275,964,275,1078,12,983,751,1420,7375
752.348,6,38,2739,25,31,31347,31,1660,13,31,62680,31,1079
0.686,6,23,5715,13,158,56,370,1315,10,999,75,1731,4400
154.199,6,28,9592,15,552,211,1318,2325,13,841,12836,3151,7267
1795.643,6,356,22589,207,69,8716,69,12420,149,69,12132,69,10169
1777.986,1,62,3472,62,28,29147,28,3472,0,0,0,0,0
3.565,17,29,13874,13,517,297,1350,7092,16,395,168,1350,6782
0.931,6,51,13813,24,549,40,1429,4824,27,464,35,2920,8989
86.584,6,24,11262,12,421,144,956,1789,12,1122,7858,2368,9473
368.279,6,18,1242,14,180,28329,180,916,4,110,20069,110,326
0.428,6,12,1653,6,288,78,288,548,6,426,51,434,1105
0.74,6,4,232,1,0,0,0,52,3,0,370,0,180
0.021,17,2,664,1,308,0,308,336,1,300,0,300,328
1741.335,6,145,9134,79,48,22324,208,5595,66,31,26786,31,3539
317.0,6,83,19650,38,330,8567,1460,9809,45,250,7201,1460,9841
1741.384,6,90,6521,59,31,30023,31,3998,31,31,58045,31,2523
0.308,17,4,352,2,37,301,37,130,2,83,299,89,222
128.747,6,24,11318,12,433,92,990,1823,12,1125,11688,2568,9495
4.805,6,44,8369,22,227,228,314,4062,22,489,217,1179,4307
1786.539,6,102,8296,68,65,26664,65,4930,34,59,54134,59,3366
1.004,17,4,368,2,64,1002,64,184,2,64,1003,64,184
33.863,6,31,5095,15,154,2418,722,1860,16,342,2243,1408,3235
399.816,17,5,3790,5,730,99954,1123,3790,0,0,0,0,0
1724.123,1,15,840,15,28,123151,28,840,0,0,0,0,0
1741.753,6,97,7307,63,38,28092,205,4476,34,33,52767,98,2831
82.421,6,102,36200,51,813,1648,1440,21706,51,454,1644,1702,14494
280.633,6,29,7392,13,158,23386,267,1317,16,603,18703,1400,6075
2.795,6,2,88,2,0,0,0,88,0,0,0,0,0
2.808,6,14,2351,8,188,401,245,700,6,703,513,1152,1651
504.278,2,3,96,3,8,252139,8,96,0,0,0,0,0
40.434,6,71,17752,38,472,658,1008,4077,33,536,1259,3488,13675
300.782,2,3,96,3,8,150391,8,96,0,0,0,0,0
0.112,17,8,2750,8,315,16,354,2750,0,0,0,0,0
1744.504,6,95,7203,63,38,28137,205,4476,32,33,56260,98,2727
1.363,6,47,19191,27,893,52,1440,13615,20,433,62,1440,5576
372.134,6,27,1767,18,177,21890,177,1181,9,110,8895,110,586
3.373,17,2,778,2,361,3373,361,778,0,0,0,0,0
280.475,6,29,7392,13,158,23372,267,1317,16,678,18692,3456,6075
1780.515,17,134,10720,67,48,26977,48,5092,67,56,26977,56,5628
1774.882,17,142,11360,71,48,25354,48,5396,71,56,25352,56,5964
0.512,6,10,968,5,256,124,256,460,5,304,124,304,508
562.888,1,58,3248,58,28,9875,28,3248,0,0,0,0,0
128.169,17,4,3100,4,747,42723,1437,3100,0,0,0,0,0
35.386,17,6,528,3,48,17569,48,228,3,72,17562,72,300
0.037,17,2,190,1,59,0,59,87,1,75,0,75,103
3.031,6,31,6255,16,338,202,1314,2334,15,331,214,1420,3921
5.67,6,41,7642,21,224,283,314,3756,20,440,285,1152,3886
106.405,6,48,13131,25,890,405,1360,7316,23,348,4829,2667,5815
679.904,6,58,10413,34,102,20603,500,3001,24,322,29142,1420,7412
1772.192,6,180,15480,120,69,14892,69,8940,60,69,30033,69,6540
0.012,2,2,80,2,16,12,16,80,0,0,0,0,0
0.998,6,11,1727,7,100,166,100,384,4,589,244,1152,1343
4.706,6,38,7245,19,218,261,314,3383,19,516,246,1179,3862
1682.796,17,14,1036,7,30,280457,30,406,7,62,280458,62,630
13.498,6,16,2886,9,411,1687,585,1710,7,396,2211,580,1176
7.369,6,5,220,1,0,0,0,44,4,0,2431,0,176
1271.059,6,126,14915,69,93,18689,721,6402,57,188,22694,2840,8513
4.735,6,40,7309,21,218,236,314,3463,19,513,249,1179,3846
39.641,17,22,1672,22,48,1887,48,1672,0,0,0,0,0
62.428,6,88,57547,51,1191,1248,1448,47947,37,765,1727,1448,9600
1772.614,6,180,15480,120,69,14895,69,8940,60,69,30039,69,6540
280.239,6,28,7352,13,158,23353,267,1317,15,678,20011,2800,6035
15.562,17,15,5042,7,360,2581,1350,2717,8,262,2211,1350,2325
0.142,17,2,256,1,50,0,50,78,1,150,0,150,178
1783.811,6,361,23065,207,69,8659,69,12489,154,69,11658,69,10576
10.772,6,20,4442,11,275,1077,275,998,9,768,765,1440,3444
1793.107,17,142,11360,71,48,25615,48,5396,71,56,25615,56,5964
1799.829,1,57,4788,57,56,32139,56,4788,0,0,0,0,0
0.112,17,2,214,1,39,0,39,67,1,119,0,119,147
0.093,6,3,151,1,0,0,0,40,2,31,69,31,111
0.038,17,4,368,2,32,29,32,120,2,96,0,96,248
484.899,1,12,672,12,28,44081,28,672,0,0,0,0,0
245.002,1,6,636,6,78,49000,78,636,0,0,0,0,0
1775.142,6,202,17119,129,69,13868,69,9576,73,69,24653,69,7543
1772.378,6,180,15480,120,69,14893,69,8940,60,69,30033,69,6540
11.67,6,1862,1605971,1133,1363,10,1380,1572569,729,421,15,1923,33402
300.641,6,37,8526,20,315,15823,882,2093,17,478,528,2128,6433
218.074,6,29,6611,12,216,5070,501,1350,17,326,13624,1420,5261
1798.055,17,450,39960,405,35,4450,288,25740,45,288,40014,288,14220
1787.093,6,102,8296,68,65,26673,65,4930,34,59,54151,59,3366
0.092,17,2,363,1,29,0,29,57,1,278,0,278,306
102.877,17,3,1026,1,300,0,300,328,2,321,101884,321,698
1688.371,1,8,448,8,28,241195,28,448,0,0,0,0,0
0.825,6,26,7256,12,155,75,267,1261,14,603,58,1400,5995
1764.316,2,15,480,15,8,126022,8,480,0,0,0,0,0
1787.381,6,106,8456,68,65,26677,65,4930,38,59,48304,59,3526
300.785,6,44,10787,24,682,13077,1360,5109,20,374,455,2667,5678
1774.595,6,180,15480,120,69,14912,69,8940,60,69,30071,69,6540
581.432,6,38,2708,18,31,34191,31,1215,20,31,30592,31,1493
1789.008,17,142,11360,71,48,25557,48,5396,71,56,25557,56,5964
5.999,6,7,487,3,69,1305,69,189,4,69,1999,69,298
3.847,17,10,785,5,31,953,31,295,5,70,948,70,490
0.136,6,10,1388,6,145,27,145,389,4,835,43,835,999
17.237,17,15,5017,7,360,2854,1350,2717,8,259,2447,1350,2300
373.811,6,21,1419,15,177,26700,177,989,6,110,12250,110,430
0.112,17,2,2382,2,1163,112,1163,2382,0,0,0,0,0
1787.073,6,359,22778,209,69,8591,69,12500,150,69,11993,69,10278
352.321,6,19,6483,3,106,151,106,234,16,400,23486,1926,6249
1.573,6,62,15845,31,539,52,1429,5609,31,427,51,1460,10236
3.171,6,19,6263,9,268,388,517,1282,10,744,343,1368,4981
1768.482,1,58,4872,0,0,0,0,0,58,56,31026,56,4872
1787.514,6,104,8308,68,64,26679,64,4896,36,58,51069,58,3412
1.006,6,3,160,2,0,967,0,120,1,0,0,0,40
1.188,6,24,8004,12,164,92,267,1288,12,1014,92,2804,6716
1771.284,1,59,4956,59,56,30539,56,4956,0,0,0,0,0
0.011,17,4,420,2,33,0,33,122,2,121,0,145,298
59.082,6,7934,7644402,5322,1359,11,1408,7503914,2612,776,22,1408,140488
1786.283,6,107,9103,70,72,25888,292,5336,37,65,49616,247,3767
15.371,6,9,456,5,0,3842,0,248,4,0,2971,0,208
171.995,6,34,6096,23,321,7817,517,1895,11,517,6188,1871,4201
12.547,6,11,676,3,106,6250,106,234,8,90,1790,90,442
1784.731,6,356,22520,208,69,8621,69,12460,148,69,12140,69,10060
0.852,6,11,1686,6,131,170,131,451,5,967,213,967,1235
27.475,6,15,2294,9,210,3433,210,896,6,545,5494,904,1398
282.966,6,29,7392,13,158,23580,267,1317,16,603,18861,2036,6075
1775.868,17,140,11200,70,48,25737,48,5320,70,56,25737,56,5880
1.124,6,24,8004,12,164,86,267,1288,12,1014,86,2816,6716
1790.665,6,458,26664,249,69,7220,69,14100,209,34,8608,64,12564
0.011,17,4,288,2,33,0,33,122,2,55,2,61,166
1.273,6,23,7952,12,164,97,267,1288,11,1216,108,3779,6664
13.051,6,66,20126,35,540,383,1152,15459,31,489,421,1179,4667
1793.699,17,87,3648,86,14,21102,14,3612,1,8,0,8,36
1263.37,2,10,320,10,8,140374,8,320,0,0,0,0,0
1680.758,1,15,840,15,28,120054,28,840,0,0,0,0,0
95.506,6,928,437857,484,835,197,1152,412887,444,400,215,1179,24970
0.508,6,21,7304,13,337,42,674,2032,8,969,68,1946,5272
0.327,6,26,8905,13,241,27,606,1651,13,938,26,1408,7254
1.32,6,42,11637,22,572,62,1360,6061,20,433,59,1360,5576
0.98,17,2,148,2,46,980,46,148,0,0,0,0,0
1776.373,17,140,11200,70,48,25744,48,5320,70,56,25744,56,5880
1.274,6,38,8258,19,321,70,1168,2722,19,433,61,1360,5536
1626.836,6,367,31144,204,107,7731,469,15449,163,136,10041,1460,15695
0.955,17,27,8959,13,310,79,1350,4406,14,297,68,1350,4553
268.562,6,50,9740,26,143,10742,459,2129,24,473,11658,1440,7611
1749.846,1,234,13104,234,28,7510,28,13104,0,0,0,0,0
1798.198,17,450,39960,405,35,4450,288,25740,45,288,40017,288,14220
1779.812,1,98,10388,98,78,18348,78,10388,0,0,0,0,0
280.495,6,29,7392,13,158,23374,267,1317,16,603,18697,2076,6075
12.251,17,20,1720,10,47,1360,47,750,10,69,1360,75,970
11.795,6,1851,1629504,1129,1389,10,1420,1596403,722,467,16,1883,33101
0.007,17,2,251,1,31,0,31,59,1,164,0,164,192
0.001,6,2,1230,1,1150,0,1150,1190,1,0,0,0,40
377.991,2,4,128,4,8,125997,8,128,0,0,0,0,0
280.374,6,29,7392,13,158,23364,267,1317,16,775,18688,4836,6075
386.641,6,118,21162,51,258,7732,1360,9826,67,227,5856,1360,11336
630.134,2,4,128,4,8,210044,8,128,0,0,0,0,0
88.773,6,761,382040,427,829,208,1152,363889,334,435,265,1179,18151
301.251,6,43,8572,22,257,14345,685,1979,21,441,592,1460,6593
8.274,6,18,7283,6,498,1623,721,1240,12,694,737,1420,6043
280.468,6,30,7432,14,158,21574,267,1357,16,678,18695,3456,6075
260.444,17,88,3520,54,12,4913,12,2160,34,12,4431,12,1360
169.034,6,31,14158,16,493,151,832,2669,15,988,12064,2720,11489
4.511,6,38,7245,19,218,250,314,3383,19,516,236,1179,3862
0.073,17,4,284,2,32,0,32,120,2,54,69,60,164
0.011,17,4,304,2,37,4,37,130,2,59,2,65,174
5.01,17,4,542,2,36,5006,36,128,2,179,5005,187,414
288.077,6,29,8874,11,181,28807,267,1168,18,537,16944,2036,7706
1.249,6,23,7952,13,164,88,267,1340,10,1216,118,3819,6612
0.583,6,10,1110,6,177,116,177,674,4,110,135,110,436
290.53,17,4,352,2,60,290529,60,176,2,60,290529,60,176
119.346,6,12,3125,2,245,253,245,329,10,299,13234,299,2796
34.857,17,10,760,10,48,3873,48,760,0,0,0,0,0
1787.206,6,105,8484,68,66,26674,66,4964,37,60,49642,60,3520
0.98,17,2,134,2,39,980,39,134,0,0,0,0,0
73.351,17,4,352,2,60,73350,60,176,2,60,73349,60,176
1750.698,17,12,498,11,14,175069,14,462,1,8,0,8,36
0.56,6,10,924,5,283,94,283,551,5,105,95,105,373
0.019,17,4,352,2,37,15,37,130,2,83,13,89,222
2.456,6,13,2311,8,188,350,245,700,5,1407,553,1407,1611
3.44,6,2,88,2,0,0,0,88,0,0,0,0,0
1771.054,6,103,9584,67,65,26834,65,5694,36,59,50599,59,3890
1787.681,6,4521,4710239,1590,125,1125,333,93395,2931,1560,610,4206,4616844
0.195,17,2,214,1,39,0,39,67,1,119,0,119,147
1.28,6,13,1182,7,146,212,146,430,6,254,254,506,752
2.035,17,3,180,3,32,1017,32,180,0,0,0,0,0
2.954,17,3,468,3,128,1477,128,468,0,0,0,0,0
1791.238,1,342,28728,342,56,5252,56,28728,0,0,0,0,0
81.557,6,16,660,7,0,4199,0,284,9,0,10192,0,376
572.131,17,111,8436,111,48,5201,48,8436,0,0,0,0,0
31.723,6,6,360,0,0,0,0,0,6,0,0,0,360
65.058,6,27,7177,13,155,5421,267,1306,14,530,5003,3417,5871
115.084,17,4,1628,4,379,38361,379,1628,0,0,0,0,0
0.14,6,14,4308,7,85,23,85,457,7,869,23,1448,3851
4.241,6,35,13160,18,674,249,1360,5486,17,581,141,1360,7674
182.497,17,4,352,2,60,182496,60,176,2,60,182496,60,176
0.054,17,2,198,1,37,0,37,65,1,105,0,105,133
140.693,6,16777,16227288,11308,1358,12,1408,15938236,5469,931,25,2801,289052
300.316,6,84,14669,38,309,8116,1408,7547,46,214,6673,1408,7122
87.785,6,31,18649,15,708,46,1460,4174,16,1256,5843,1460,14475
0.084,6,10,767,5,186,20,186,454,5,45,16,45,313
55.317,6,36,8333,18,369,520,792,1860,18,478,3243,2720,6473
3.872,6,2,88,2,0,0,0,88,0,0,0,0,0
0.048,17,2,290,1,40,0,40,68,1,194,0,194,222
0.064,6,2,80,2,0,0,0,80,0,0,0,0,0
139.845,6,21,9086,12,304,74,597,1425,9,1457,17459,4441,7661
13.08,17,15,17718,15,1153,934,1452,17718,0,0,0,0,0
0.339,6,24,4571,12,165,30,456,1446,12,415,29,888,3125
1.229,6,48,19349,27,901,47,1360,13733,21,476,53,2715,5616
1739.547,1,56,4704,56,56,31628,56,4704,0,0,0,0,0
1785.856,6,364,23323,208,69,8577,69,12529,156,69,11521,69,10794
223.238,1,39,1092,39,0,0,0,1092,0,0,0,0,0
3.303,17,19,13947,10,622,367,1350,6500,9,799,209,1350,7447
110.686,6,25,10600,12,458,72,1067,1887,13,909,9212,1360,8713
75.869,6,36,5496,17,144,4741,722,2037,19,246,4205,1408,3459
280.504,6,31,7472,13,158,23375,267,1317,18,603,16494,2760,6155
1792.024,6,341,22058,200,69,9005,69,12278,141,69,12800,69,9780
1772.406,6,180,15480,120,69,14894,69,8940,60,69,30032,69,6540
1.024,1,3,1191,3,369,512,378,1191,0,0,0,0,0
1782.298,17,142,11360,71,48,25460,48,5396,71,56,25460,56,5964
1780.387,17,140,11200,70,48,25802,48,5320,70,56,25802,56,5880
0.044,17,2,158,1,34,0,34,62,1,68,0,68,96
1784.657,6,102,8296,68,65,26636,65,4930,34,59,54077,59,3366
188.946,6,12,852,5,92,47236,92,452,7,0,7495,0,400
370.875,6,18,1242,14,180,28528,180,916,4,110,20060,110,326
46.5,17,4,240,2,32,46499,32,120,2,32,46499,32,120
280.039,6,30,7432,14,158,21541,267,1357,16,603,18666,2036,6075
71.544,17,4,352,2,60,71543,60,176,2,60,71542,60,176
5.651,6,40,7309,21,218,282,314,3463,19,440,299,1152,3846
7.327,6,41,7349,22,218,348,314,3503,19,513,392,1179,3846
302.942,6,60,26949,34,1082,9180,1360,20878,26,358,428,1360,6071
185.271,17,8,2688,8,308,26467,308,2688,0,0,0,0,0
0.091,17,2,574,1,32,0,32,60,1,486,0,486,514
24.648,1,4,224,4,28,8216,28,224,0,0,0,0,0
1683.811,17,14,1036,7,30,280622,30,406,7,62,280627,62,630
7.083,6,131,197198,78,133,91,201,3687,53,4071,132,25452,193511
1785.276,6,102,8296,68,65,26645,65,4930,34,59,54096,59,3366
1785.673,6,102,8364,68,66,26651,66,4964,34,60,54108,60,3400
3.218,6,13,3097,4,92,1072,92,296,9,465,342,1408,2801
23.536,6,33,8898,16,303,1569,721,2765,17,681,1458,2840,6133
1751.208,17,344,76224,344,193,5105,422,76224,0,0,0,0,0
0.295,6,3,120,1,0,0,0,40,2,0,294,0,80
275.143,17,4,240,2,32,275142,32,120,2,32,275142,32,120
68.133,17,36,2172,36,32,1946,37,2172,0,0,0,0,0
380.72,6,79,12185,39,302,10018,1366,6289,40,199,9761,1354,5896
3.798,17,5,295,5,31,949,31,295,0,0,0,0,0
47.137,17,81,37254,45,697,1070,1350,32625,36,100,1345,1350,4629
1788.835,17,87,3648,86,14,21045,14,3612,1,8,0,8,36
1785.677,6,105,8544,68,66,26651,66,4964,37,60,49599,60,3580
169.681,6,24,4856,11,220,5639,515,1324,13,300,14131,1452,3532
14.348,6,2,1175,1,0,0,0,40,1,1095,0,1095,1135
240.276,6,56,17713,30,732,8285,1402,14762,26,198,9610,580,2951
1798.628,6,361,24872,211,94,8564,469,14456,150,69,12070,69,10416
1.68,6,25,8785,15,288,120,598,1470,10,987,166,1452,7315
810.844,6,81,9185,44,85,16546,722,4131,37,115,22518,2026,5054
0.785,6,20,5948,11,281,78,544,1288,9,716,89,1420,4660
171.112,6,20,2199,12,302,15555,302,1526,8,83,23590,83,673
280.714,6,30,7432,13,158,23392,267,1317,17,543,17542,1400,6115
124.93,1,3,419,3,111,62465,121,419,0,0,0,0,0
481.325,2,6,192,6,8,96265,8,192,0,0,0,0,0
36.425,1,4,224,4,28,12141,28,224,0,0,0,0,0
1775.941,17,140,11200,70,48,25738,48,5320,70,56,25738,56,5880
280.204,6,27,7312,12,158,25473,267,1277,15,678,20012,2800,6035
1798.273,17,449,39928,404,35,4462,288,25708,45,288,40021,288,14220
3.13,17,4,256,2,28,3030,28,112,2,44,3124,44,144
3.104,6,56,14115,27,549,119,1429,4968,29,398,100,1460,9147
1.026,6,24,6412,13,298,85,834,2015,11,988,101,1731,4397
63.045,6,34,5263,20,154,3318,722,2132,14,399,1192,1448,3131
280.586,6,27,7312,12,158,25507,267,1277,15,678,20029,2085,6035
8.63,6,36,8275,18,350,507,734,1802,18,441,497,1360,6473
0.24,6,10,1042,5,213,60,213,417,5,421,50,421,625
0.552,17,2,461,1,31,0,31,59,1,374,0,374,402
64.423,6,21,7874,7,156,10737,267,758,14,727,4952,1452,7116
292.489,6,50,8386,23,141,13292,517,2361,27,418,11247,1418,6025
1.498,6,37,9808,20,502,78,1460,4352,17,476,80,2615,5456
0.011,17,3,430,2,36,3,36,128,1,274,0,274,302
0.004,17,2,160,1,44,0,44,72,1,60,0,60,88
0.972,6,2,111,1,0,0,0,40,1,31,0,31,71
661.741,2,8,256,8,8,94534,8,256,0,0,0,0,0
1.099,6,23,7952,11,164,93,267,1236,12,1014,84,2804,6716
1799.171,6,80,4264,41,26,44979,26,2184,39,26,47345,26,2080
15.393,17,23,13451,10,522,1702,1350,5502,13,583,1277,1350,7949
1681.647,17,14,1036,7,30,280269,30,406,7,62,280269,62,630
185.935,6,49,10492,22,119,8854,267,2080,27,332,7149,1460,8412
28.375,6,46,13863,22,315,1351,721,3407,24,678,1188,1420,10456
280.078,6,27,7312,13,158,23339,267,1317,14,775,21538,4836,5995
68.015,17,2,152,2,48,68015,48,152,0,0,0,0,0
180.212,6,24,9022,12,661,80,1360,3156,12,895,16367,1747,5866
3.45,17,4,368,4,64,1150,64,368,0,0,0,0,0
1.374,6,26,7191,14,656,105,1418,5334,12,245,123,580,1857
1628.108,1,8,848,8,78,232586,78,848,0,0,0,0,0
46.893,6,19,836,7,0,2832,0,308,12,0,4246,0,528
100.144,17,2,1084,2,514,100144,514,1084,0,0,0,0,0
247.462,6,45,8932,19,108,13747,267,1960,26,296,9898,1997,6972
67.242,6,11,1346,6,302,13448,302,912,5,83,16806,83,434
1796.468,6,423,40359,233,155,7743,1189,22059,190,125,9504,1380,18300
280.464,6,29,7392,13,158,23372,267,1317,16,603,18694,2076,6075
455.195,17,4,1838,4,431,151731,1444,1838,0,0,0,0,0
1770.122,6,99,9306,66,66,27232,66,5610,33,60,55313,60,3696
3.639,17,5,295,5,31,909,31,295,0,0,0,0,0
4.176,6,34,6169,18,206,245,314,2784,16,548,261,1179,3385
1.77,17,6,1142,3,36,883,36,192,3,288,882,318,950
297.491,17,4,240,2,32,297489,32,120,2,32,297489,32,120
0.022,17,2,383,1,33,0,33,61,1,294,0,294,322
12.163,17,10,1965,5,33,3037,33,305,5,304,3037,304,1660
1789.051,6,395,43032,199,157,9034,208,34200,196,31,9173,31,8832
1783.731,17,142,11360,71,48,25481,48,5396,71,56,25481,56,5964
71.238,6,38,7872,16,149,4749,267,1543,22,453,3386,3417,6329
0.013,6,11,3410,6,75,2,75,395,5,2747,3,2747,3015
193.865,6,62,39897,39,1150,5101,1448,31946,23,749,2792,1448,7951
1.396,6,52,20036,29,931,49,1460,14295,23,480,55,4075,5741
1772.802,1,96,10176,96,78,18661,78,10176,0,0,0,0,0
259.773,17,6,528,3,60,129886,60,264,3,60,129886,60,264
62.318,6,23,10883,11,410,61,922,1702,12,1086,5653,1460,9181
0.424,6,21,7302,12,335,37,668,1986,9,968,52,1475,5316
1792.556,1,138,14628,138,78,13084,78,14628,0,0,0,0,0
1750.243,6,95,7203,63,38,28229,205,4476,32,33,56451,98,2727
3.074,17,8,568,4,32,1022,32,240,4,54,1022,60,328
178.073,6,31,11928,17,833,78,1460,5712,14,705,13684,1553,6216
4.379,6,38,7245,19,218,243,314,3383,19,516,228,1179,3862
1.778,6,12,1767,7,100,296,100,384,5,589,378,1152,1383
0.377,6,27,9047,13,252,31,647,1692,14,945,27,1448,7355
0.011,17,3,394,2,32,0,32,120,1,246,0,246,274
0.032,6,3,120,2,0,32,0,80,1,0,0,0,40
5.69,6,39,7269,21,218,284,314,3463,18,513,318,1179,3806
188.01,6,48,10472,19,117,10444,267,1822,29,325,6714,1997,8650
1719.313,1,122,6832,122,28,14209,28,6832,0,0,0,0,0
125.753,6,33,13464,15,542,8982,721,3317,18,785,7365,1414,10147
3.825,17,2,152,2,48,3825,48,152,0,0,0,0,0
964.537,1,44,4664,44,78,22431,78,4664,0,0,0,0,0
4.01,17,4,232,4,30,1336,30,232,0,0,0,0,0
0.01,17,4,632,3,64,1,64,276,1,328,0,328,356
1796.172,17,448,39100,404,34,4457,288,25444,44,282,40953,288,13656
1.317,6,41,11378,21,616,65,1460,5802,20,433,60,1460,5576
3.914,17,5,295,5,31,978,31,295,0,0,0,0,0
1761.338,17,329,51822,329,129,5369,389,51822,0,0,0,0,0
1035.035,1,18,1008,18,28,60884,28,1008,0,0,0,0,0
35.571,6,18,2469,10,211,3934,211,958,8,545,5047,904,1511
1799.789,17,144,11520,72,48,25349,48,5472,72,56,25349,56,6048
0.104,17,4,420,2,33,93,33,122,2,121,96,145,298
1796.713,1,58,4872,58,56,31521,56,4872,0,0,0,0,0
0.045,17,2,148,1,32,0,32,60,1,60,0,60,88
0.099,6,9,1339,5,145,24,145,349,4,826,30,826,990
1797.162,17,448,39896,403,35,4470,288,25676,45,288,40024,288,14220
7.392,6,22,7037,8,138,1056,267,883,14,558,567,1452,6154
151.881,6,21,9221,11,514,93,1236,2014,10,1359,16854,4080,7207
1783.663,1,58,4872,58,56,31292,56,4872,0,0,0,0,0
1789.314,17,140,11200,70,48,25931,48,5320,70,56,25931,56,5880
240.504,6,54,17982,28,797,8904,1418,15018,26,200,9617,580,2964
3.969,6,11,2985,3,92,1984,92,244,8,463,422,1408,2741
300.66,6,37,8526,20,315,15824,882,2093,17,478,527,2128,6433
0.867,6,3,151,1,0,0,0,40,2,31,0,31,111
1787.388,17,86,3606,85,14,21278,14,3570,1,8,0,8,36
9.516,17,2,152,2,48,9516,48,152,0,0,0,0,0
11.622,6,118,42173,60,672,196,1152,35371,58,407,199,1152,6802
1799.309,6,364,24359,212,83,8527,965,13585,152,73,11915,229,10774
1.382,6,24,8004,12,164,107,267,1288,12,1014,108,2491,6716
280.301,6,29,7392,13,158,23358,267,1317,16,603,18684,2036,6075
0.469,17,4,288,2,36,422,36,128,2,52,422,52,160
1787.454,6,108,8595,69,65,26286,65,4970,39,59,47035,59,3625
154.634,17,4,352,2,60,154633,60,176,2,60,154633,60,176
1764.295,2,15,480,15,8,126021,8,480,0,0,0,0,0
364.789,6,23,1535,16,177,24319,177,1053,7,110,10355,110,482
10.932,6,18,3943,10,275,1214,275,683,8,974,858,1414,3260
7.921,6,705,596779,427,1325,18,1368,577659,278,776,27,1473,19120
0.447,17,5,1653,5,302,111,355,1653,0,0,0,0,0
1782.134,1,254,14224,254,28,7044,28,14224,0,0,0,0,0
4.923,17,32,14377,13,522,410,1350,7157,19,352,205,1350,7220
0.27,17,2,172,1,50,0,50,78,1,66,0,66,94
1799.621,1,342,28728,342,56,5277,56,28728,0,0,0,0,0
1782.654,6,102,8296,68,65,26606,65,4930,34,59,54017,59,3366
1791.391,17,88,3687,86,13,21070,14,3607,2,12,1791092,16,80
0.109,17,7,2368,7,310,18,354,2368,0,0,0,0,0
0.006,17,2,350,1,33,0,33,61,1,261,0,261,289
1787.115,17,79,3312,78,14,23209,14,3276,1,8,0,8,36
1784.204,17,84,3516,82,14,22024,14,3444,2,8,1784021,8,72
1786.207,6,106,8456,68,65,26659,65,4930,38,59,48272,59,3526
1.556,6,28,10325,17,367,97,833,1785,11,1156,146,2840,8540
1.518,6,50,19219,28,950,56,1460,13518,22,437,62,2615,5701
1.519,17,3,1167,3,361,759,361,1167,0,0,0,0,0
20.565,6,30,7860,18,129,1209,159,1863,12,766,1868,1675,5997
1783.511,17,83,3480,82,14,22018,14,3444,1,8,0,8,36
3.846,1,8,832,0,0,0,0,0,8,76,549,76,832
142.168,6,24,10727,13,726,5187,1329,3457,11,974,14197,2720,7270
185.248,6,63,25857,32,1044,724,1360,14974,31,506,6168,1360,10883
1786.217,6,360,22818,210,69,8546,69,12540,150,69,11987,69,10278
13.573,2,2,64,2,8,13573,8,64,0,0,0,0,0
0.038,6,10,1609,5,106,9,106,374,5,967,9,967,1235
1773.181,6,180,15480,120,69,14900,69,8940,60,69,30045,69,6540
115.744,6,17,924,4,0,38581,0,216,13,0,9120,0,708
213.695,6,49,10714,22,114,10175,267,2149,27,339,8218,3417,8565
4.035,17,9,9835,2,723,4035,1350,1503,7,1162,449,1350,8332
300.854,6,38,9915,21,593,15042,1360,4433,17,435,540,2667,5482
125.839,2,2,64,2,8,125839,8,64,0,0,0,0,0
1796.407,17,449,39928,404,35,4457,288,25708,45,288,40018,288,14220
24.028,6,17,3056,9,183,3003,183,599,8,531,3404,853,2457
66.469,6,24,1739,17,43,4144,43,1339,7,0,11077,0,400
556.269,1,6,336,6,28,111253,28,336,0,0,0,0,0
11.296,6,1799,1559875,1089,1378,10,1420,1527254,710,467,15,1883,32621
294.731,1,4,326,4,53,98243,78,326,0,0,0,0,0
280.525,6,29,7392,13,158,23377,267,1317,16,603,18697,2076,6075
1791.824,17,82,3438,81,14,22397,14,3402,1,8,0,8,36
11.872,17,8,608,8,48,1696,48,608,0,0,0,0,0
293.321,6,50,8173,24,129,12751,517,2201,26,384,11730,1418,5972
280.59,6,8,416,8,0,0,0,416,0,0,0,0,0
258.163,17,4,352,2,60,258162,60,176,2,60,258162,60,176
1747.633,6,100,7866,66,45,26886,205,4902,34,35,52950,98,2964
1790.043,6,367,23236,212,69,8483,69,12896,155,69,11621,69,10340
1.31,6,46,15079,24,766,56,1460,9423,22,433,54,1460,5656
0.936,6,11,1727,7,100,156,100,384,4,589,229,1152,1343
14.113,17,2,152,2,48,14113,48,152,0,0,0,0,0
1744.129,6,98,7390,64,38,27684,205,4559,34,33,52843,98,2831
2.01,17,4,360,2,30,1995,30,116,2,94,1991,94,244
0.78,17,2,144,1,36,0,36,64,1,52,0,52,80
6.052,17,4,390,2,44,6003,44,144,2,95,6007,95,246
7.73,17,6,528,3,48,3857,48,228,3,72,3859,72,300
96.199,6,11,719,11,31,9619,31,719,0,0,0,0,0
0.001,6,2,80,2,0,0,0,80,0,0,0,0,0
1.576,17,4,496,3,64,774,64,276,1,192,0,192,220
89.799,6,11204,10542294,7333,1358,12,1408,10336338,3871,931,23,2816,205956
298.925,1,4,224,4,28,99641,28,224,0,0,0,0,0
1772.417,6,180,15480,120,69,14894,69,8940,60,69,30037,69,6540
287.693,17,4,352,2,60,287692,60,176,2,60,287692,60,176
0.281,17,2,196,1,62,0,62,90,1,78,0,78,106
0.816,6,5,248,3,0,408,0,144,2,0,452,0,104
745.33,6,63,9681,37,97,20703,502,3342,26,240,26471,1420,6339
10.507,17,8,1176,4,48,3499,48,304,4,190,3498,308,872
0.013,17,2,262,1,62,0,62,90,1,144,0,144,172
1787.087,6,103,8326,68,64,26672,64,4896,35,58,52558,58,3430
1779.569,17,142,11360,71,48,25422,48,5396,71,56,25422,56,5964
0.016,17,4,865,2,47,11,47,150,2,329,11,341,715
0.278,17,3,451,2,39,225,39,134,1,289,0,289,317
20.133,6,25,6757,12,181,1830,267,1212,13,717,1675,2036,5545
1772.31,6,180,15480,120,69,14893,69,8940,60,69,30032,69,6540
19.463,6,2795,2576317,1790,1360,10,1408,2519393,1005,931,19,2801,56924
0.013,17,2,540,1,40,0,40,68,1,444,0,444,472
84.529,6,53,14862,27,964,414,1360,8896,26,327,3374,2667,5966
280.301,6,30,7432,13,158,23358,267,1317,17,543,17516,1400,6115
1680.423,17,20,7481,20,346,88443,1267,7481,0,0,0,0,0
50.603,6,30,8872,14,158,3892,267,1357,16,763,3365,2036,7515
50.336,6,2429,2288637,1586,1363,31,1368,2234281,843,931,59,2736,54356
112.355,6,7,426,2,106,112345,106,194,5,0,28086,0,232
1793.319,1,282,15792,282,28,6381,28,15792,0,0,0,0,0
372.153,6,27,1767,18,177,21891,177,1181,9,110,8897,110,586
1794.248,17,246,51506,246,181,7323,358,51506,0,0,0,0,0
1.144,17,8,688,4,47,379,47,300,4,69,378,75,388
31.607,6,6,288,1,0,0,0,48,5,0,7899,0,240
0.031,6,3,120,1,0,0,0,40,2,0,2,0,80
1799.38,6,359,23675,195,69,9275,69,12078,164,69,11039,69,11597
1791.228,1,58,4872,58,56,31425,56,4872,0,0,0,0,0
1720.405,6,70,4698,34,36,52132,36,1912,36,445,49153,445,2786
11.204,17,4,304,4,48,3734,48,304,0,0,0,0,0
1774.146,6,182,15698,120,69,14908,69,8940,62,69,29084,69,6758
2.207,6,28,10417,16,368,147,837,1749,12,1023,193,1420,8668
1787.289,6,102,8296,68,65,26675,65,4930,34,59,54156,59,3366
0.961,17,5,980,3,32,478,32,180,2,372,4,470,800
1741.986,1,14,784,14,28,133998,28,784,0,0,0,0,0
0.0,1,1,36,1,8,0,8,36,0,0,0,0,0
7.417,6,4,239,2,31,20,31,135,2,0,7417,0,104
1.071,6,12,1653,6,288,208,288,548,6,426,110,434,1105
1799.805,17,142,11360,71,48,25711,48,5396,71,56,25711,56,5964
5.333,6,38,7245,20,218,280,314,3423,18,516,298,1179,3822
0.067,6,37,31903,22,181,3,253,1731,15,2260,3,9856,30172
3.039,6,29,7802,15,657,217,1418,5399,14,238,232,580,2403
1793.474,17,140,11200,70,48,25992,48,5320,70,56,25992,56,5880
280.308,6,30,7432,13,158,23359,267,1317,17,543,17518,1400,6115
11.723,6,1861,1619628,1130,1379,10,1420,1586167,731,467,16,1883,33461
1.682,6,20,3833,11,234,168,564,1504,9,463,187,1343,2329
1787.9,6,360,24156,210,88,8554,469,13878,150,69,11999,69,10278
9.209,6,15,3203,6,92,1841,92,400,9,576,1103,1408,2803
0.19,17,2,140,1,34,0,34,62,1,50,0,50,78
0.009,17,2,292,1,53,0,53,81,1,183,0,183,211
18.552,17,34,7356,15,160,1322,1350,2820,19,210,1028,1350,4536
1798.549,17,144,11520,72,48,25331,48,5472,72,56,25331,56,6048
66.303,6,10,799,10,31,7367,31,799,0,0,0,0,0
0.26,6,23,5080,11,137,26,267,1132,12,577,23,1400,3948
0.784,6,10,1687,7,100,130,100,384,3,1179,268,1179,1303
1793.019,1,60,5040,60,56,30390,56,5040,0,0,0,0,0
1745.392,6,95,7203,63,38,28151,205,4476,32,33,56292,98,2727
1.692,6,25,8777,15,287,120,594,1466,10,986,168,1420,7311
31.753,1,2,120,2,32,31753,32,120,0,0,0,0,0
1796.222,17,448,39896,403,35,4468,288,25676,45,288,40019,288,14220
0.404,6,10,1669,6,551,80,947,1346,4,159,134,159,323
17.7,6,13,944,4,106,5900,106,274,9,90,2188,90,670
289.968,6,100,13274,45,181,5323,1189,4349,55,172,5368,1460,8925
24.345,6,41,8123,20,180,1281,267,2251,21,502,1022,1491,5872
541.439,2,5,160,5,8,135359,8,160,0,0,0,0,0
299.534,6,6,364,4,31,99844,31,222,2,31,299524,31,142
1778.442,17,140,11200,70,48,25774,48,5320,70,56,25774,56,5880
237.367,6,28,5290,11,189,7307,516,1390,17,229,14830,1452,3900
25.141,6,40,8593,20,345,531,720,1915,20,419,1316,4848,6678
99.012,17,2,672,2,308,99012,308,672,0,0,0,0,0
198.181,6,1886,950085,1049,840,189,1152,905580,837,380,236,1179,44505
1775.776,6,102,8228,68,64,26504,64,4896,34,58,53808,58,3332
8.981,6,4,240,4,0,0,0,240,0,0,0,0,0
1795.632,6,104,8570,69,66,26406,66,5070,35,60,52809,60,3500
62.401,6,24,10022,12,524,78,1360,2610,12,1153,5655,2574,7412
1740.522,17,30,7050,30,207,60018,207,7050,0,0,0,0,0
10.159,6,1592,1391488,957,1400,10,1432,1361867,635,420,16,1432,29621
1080.608,17,112,9444,104,30,10490,37,6060,8,395,145995,463,3384
1743.691,6,95,7203,63,38,28124,205,4476,32,33,56236,98,2727
293.894,6,34,7025,16,262,19589,517,1628,18,744,17285,1418,5397
0.173,17,2,204,1,34,0,34,62,1,114,0,114,142
2.109,6,10,1102,6,483,421,483,803,4,83,700,83,299
1792.583,17,175,11200,175,36,10302,36,11200,0,0,0,0,0
1799.993,6,33,5681,22,272,85713,413,3875,11,124,179976,269,1806
0.273,1,2,163,2,53,273,78,163,0,0,0,0,0
1772.123,6,180,15480,120,69,14891,69,8940,60,69,30035,69,6540
0.007,6,3,168,2,24,5,24,128,1,0,0,0,40
38.688,6,10,552,6,0,7706,0,328,4,0,12843,0,224
0.264,17,2,384,1,36,0,36,64,1,292,0,292,320
10.688,6,18,5610,10,275,1187,275,958,8,1440,811,1440,4652
1781.245,1,342,28728,342,56,5223,56,28728,0,0,0,0,0
1.779,6,105,122515,41,289,44,916,3874,64,1954,27,5632,118641
1777.547,17,140,11200,70,48,25761,48,5320,70,56,25761,56,5880
1798.254,17,449,39928,404,35,4462,288,25708,45,288,40020,288,14220
280.547,6,28,7352,13,158,23378,267,1317,15,678,20034,2045,6035
8.778,6,28,7352,13,158,731,267,1317,15,678,621,3436,6035
6.445,6,4,240,4,0,0,0,240,0,0,0,0,0
8.12,17,12,1764,6,48,1621,48,456,6,190,1621,308,1308
1792.12,6,356,22520,208,69,8657,69,12460,148,69,12191,69,10060
69.339,17,4,1344,4,308,23113,308,1344,0,0,0,0,0
1.949,6,55,23473,30,963,67,1360,17605,25,476,71,2715,5868
8.718,6,22,2019,11,222,866,222,1332,11,231,868,231,687
259.078,17,4,352,2,60,259077,60,176,2,60,259077,60,176
1.506,6,47,19227,27,895,57,1360,13651,20,476,68,2715,5576
23.439,6,3857,3636918,2510,1371,9,1408,3562210,1347,931,17,2816,74708
1.615,6,73,51985,44,1242,37,1408,44572,29,842,51,1408,7413
0.066,17,4,284,2,32,49,32,120,2,54,52,60,164
27.418,6,2208,1994410,1382,1364,19,1408,1946952,826,1124,33,2801,47458
252.273,6,41,8583,17,642,15766,1418,5400,24,148,10967,580,3183
175.149,6,41,26134,17,740,47,1440,3673,24,1193,7609,1440,22461
172.932,1,16,896,16,28,11528,28,896,0,0,0,0,0
6.21,6,41,7365,21,218,310,314,3463,20,516,313,1179,3902
1742.946,6,137,8336,75,42,23553,208,4957,62,31,28569,31,3379
504.241,2,3,96,3,8,252120,8,96,0,0,0,0,0
0.072,6,10,1495,5,507,18,507,727,5,556,17,556,768
280.402,6,31,7472,13,158,23366,267,1317,18,603,16491,2076,6155
1770.399,6,99,9174,66,64,27236,64,5544,33,58,55322,58,3630
0.012,17,2,358,1,30,0,30,58,1,272,0,272,300
11.369,6,29,13402,12,354,1033,721,1902,17,901,698,2840,11500
1799.379,6,130,8379,74,51,24649,208,5209,56,31,32708,31,3170
23.498,17,8,1176,4,48,7828,48,304,4,190,7828,308,872
0.019,6,9,1930,5,666,4,666,934,4,780,6,780,996
1.103,6,25,8080,12,164,85,267,1312,13,869,77,1408,6768
0.217,6,6,328,4,0,72,0,216,2,0,134,0,112
1794.236,1,222,12432,222,28,8118,28,12432,0,0,0,0,0
297.36,17,4,240,2,32,297359,32,120,2,32,297359,32,120
1792.457,17,87,3648,86,14,21087,14,3612,1,8,0,8,36
61.879,6,76,49091,44,1200,1439,1448,40697,32,746,1988,1448,8394
185.453,6,21,2398,14,133,14265,208,2025,7,31,30876,31,373
384.815,6,331,258703,201,1353,1924,1448,235143,130,537,2719,1448,23560
215.022,17,4,352,2,60,215021,60,176,2,60,215020,60,176
108.102,6,45,9783,20,263,3447,1189,2913,25,390,4502,1460,6870
1798.658,1,342,28728,342,56,5274,56,28728,0,0,0,0,0
27.186,17,16,1408,8,48,3874,48,608,8,72,3869,72,800
31.029,6,20,3130,12,183,2820,517,1561,8,381,4428,499,1569
2.232,6,14,2351,8,188,318,245,700,6,703,397,1152,1651
0.044,17,2,362,1,41,0,41,69,1,265,0,265,293
281.341,6,30,6738,13,189,4667,516,1472,17,352,17577,1452,5266
0.588,17,3,1015,3,310,294,354,1015,0,0,0,0,0
47.257,6,29,7257,13,155,3938,267,1306,16,441,3149,1420,5951
15.376,6,103,33587,53,624,295,1152,27105,50,447,308,1179,6482
291.455,6,25,6271,9,267,95,501,1165,16,343,19424,1420,5106
1750.054,6,99,7411,63,38,28226,205,4476,36,33,49991,98,2935
1558.891,17,29,9744,29,308,55674,308,9744,0,0,0,0,0
240.261,6,49,13809,25,693,10010,1418,11021,24,191,10444,580,2788
3.972,17,5,340,5,40,993,40,340,0,0,0,0,0
154.365,17,4,352,2,60,154364,60,176,2,60,154363,60,176
0.304,1,2,112,2,28,304,28,112,0,0,0,0,0
0.201,6,26,7256,13,155,16,267,1301,13,603,15,2036,5955
280.439,6,31,7472,14,158,21572,267,1357,17,678,17525,3456,6115
0.274,17,4,304,2,48,0,48,152,2,48,2,48,152
1774.755,6,131,8051,71,27,25353,27,4289,60,27,30079,27,3762
0.033,17,2,241,1,44,0,44,72,1,141,0,141,169
1082.141,17,212,16112,212,48,5128,48,16112,0,0,0,0,0
240.089,6,217,197300,137,179,1765,179,7723,80,2407,3038,8448,189577
63.389,6,10,648,10,31,7043,31,648,0,0,0,0,0
1744.696,2,30,960,30,8,60161,8,960,0,0,0,0,0
26.226,6,48,10529,23,706,639,1360,4554,25,291,1085,1360,5975
0.837,6,10,1687,7,100,139,100,384,3,1179,297,1179,1303
1764.74,2,15,480,15,8,126052,8,480,0,0,0,0,0
8.521,6,11,668,4,106,2836,106,274,7,90,1418,90,394
1786.381,17,343,55076,343,132,5223,389,55076,0,0,0,0,0
240.819,6,55,17820,29,731,8596,1418,14687,26,221,9629,580,3133
8.012,17,12,1764,6,48,1599,48,456,6,190,1599,308,1308
0.189,6,4,1462,3,1290,0,1290,1422,1,0,0,0,40
0.199,17,3,3140,3,1018,99,1438,3140,0,0,0,0,0
118.897,6,25,6354,10,220,7182,516,1286,15,405,8485,2642,5068
1790.027,1,270,15120,270,28,6654,28,15120,0,0,0,0,0
4.108,6,34,6169,17,206,256,314,2744,17,548,238,1179,3425
1.287,6,46,18779,26,933,51,1460,13203,20,433,58,1460,5576
0.206,17,4,352,2,60,204,60,176,2,60,199,60,176
1786.694,1,178,9968,178,28,10094,28,9968,0,0,0,0,0
7.011,6,1609,1465331,1001,1385,6,1408,1429051,608,931,11,2816,36280
195.088,17,4,352,2,60,195087,60,176,2,60,195087,60,176
1679.386,1,15,840,15,28,119956,28,840,0,0,0,0,0
1799.876,17,144,11520,72,48,25350,48,5472,72,56,25350,56,6048
1797.854,6,380,29508,218,75,8285,267,13646,162,135,11166,3417,15862
1443.843,2,10,320,10,8,160427,8,320,0,0,0,0,0
1769.472,6,99,9240,66,65,27222,65,5577,33,59,55291,59,3663
9.673,6,9,527,5,43,2418,43,311,4,0,3220,0,216
1745.141,6,95,7203,63,38,28147,205,4476,32,33,56283,98,2727
47.812,6,45,9993,22,635,602,1360,4147,23,327,2165,2667,5846
1.765,6,2,142,1,0,0,0,40,1,62,0,62,102
11.618,6,1842,1605847,1119,1381,10,1420,1572706,723,467,16,1883,33141
0.021,6,18,6108,10,88,2,88,556,8,1305,2,1880,5552
47.476,6,6,328,4,0,15825,0,216,2,0,47340,0,112
0.148,1,2,112,2,28,148,28,112,0,0,0,0,0
1107.681,17,324,49352,153,202,7287,1350,35253,171,54,6513,1350,14099
1796.096,6,478,29104,234,69,7708,69,14052,244,36,7391,48,15052
1793.803,17,170,10880,170,36,10614,36,10880,0,0,0,0,0
1.248,6,30,8540,17,222,77,540,2044,13,1192,88,3151,6496
64.307,6,15,612,7,0,8114,0,284,8,0,9184,0,328
8.425,6,8,460,3,0,4212,0,160,5,0,1768,0,300
1797.219,1,345,28980,345,56,5224,56,28980,0,0,0,0,0
0.011,17,4,350,2,34,7,34,124,2,85,5,91,226
5.915,17,3,1008,3,308,2957,308,1008,0,0,0,0,0
0.304,6,27,8992,13,237,25,590,1635,14,945,22,2804,7357
0.011,1,2,112,2,28,11,28,112,0,0,0,0,0
0.054,6,7,426,3,31,27,31,175,4,31,3,31,251
0.564,17,3,543,2,39,540,39,134,1,381,0,381,409
2.898,17,19,12823,11,932,286,1350,10563,8,254,409,1350,2260
13.045,6,91,26997,45,555,296,1152,20675,46,447,283,1179,6322
1772.235,6,180,15480,120,69,14892,69,8940,60,69,30036,69,6540
1771.27,6,99,9240,66,65,27250,65,5577,33,59,55348,59,3663
4.072,6,38,7229,19,218,226,314,3383,19,440,212,1152,3846
252.274,2,2,64,2,8,252274,8,64,0,0,0,0,0
0.752,17,8,2750,8,315,107,354,2750,0,0,0,0,0
0.9,6,8,1607,5,100,225,100,304,3,1179,326,1179,1303
0.0,6,1,1460,0,0,0,0,0,1,1420,0,1420,1460
27.555,17,4,1576,4,366,9185,548,1576,0,0,0,0,0
11.8,6,1908,1612565,1140,1362,10,1380,1574015,768,630,15,3303,38550
0.281,6,9,1340,5,145,70,145,349,4,827,35,827,991
1.373,6,50,19610,27,914,52,1440,13914,23,433,53,1440,5696
42.536,6,836,708758,494,1356,85,1368,684774,342,665,124,1368,23984
2.619,6,30,7560,17,306,163,1087,2826,13,601,217,1420,4734
0.108,17,2,152,2,48,108,48,152,0,0,0,0,0
99.521,6,26,6657,11,220,5596,516,1326,15,363,7098,1452,5331
4.045,17,5,295,5,31,1011,31,295,0,0,0,0,0
160.081,6,21,11264,21,565,8004,1402,11264,0,0,0,0,0
104.512,6,21,8172,11,511,89,1194,2005,10,1151,11593,3151,6167
0.163,6,39,16545,22,976,7,1420,11644,17,467,9,1883,4901
240.967,6,39,5669,18,215,14155,586,2236,21,259,12039,870,3433
214.885,17,14,4718,14,309,16529,329,4718,0,0,0,0,0
1785.484,6,104,8252,68,63,26649,64,4868,36,57,51011,58,3384
8.49,6,12,945,6,222,1695,222,466,6,231,1695,231,479
75.937,17,5,1688,5,309,18984,316,1688,0,0,0,0,0
12.508,6,1919,1668579,1175,1364,10,1380,1633129,744,421,16,1923,35450
23.458,6,32,8860,15,303,1675,722,2727,17,681,1452,1380,6133
18.763,17,62,44256,25,302,780,1350,8274,37,944,519,1350,35982
1.311,6,38,8221,19,320,72,1162,2716,19,473,63,1360,5505
280.203,6,29,7392,13,158,23350,267,1317,16,603,18678,2036,6075
1777.977,17,79,3312,78,14,23090,14,3276,1,8,0,8,36
1789.038,1,201,11256,201,28,8945,28,11256,0,0,0,0,0
1772.279,6,180,15480,120,69,14893,69,8940,60,69,30031,69,6540
0.018,17,2,251,1,31,0,31,59,1,164,0,164,192
1.518,6,12,1304,6,256,301,256,756,6,304,301,304,548
0.394,6,26,9026,13,263,32,691,1736,13,943,29,1448,7290
16.999,6,1973,1800668,1260,1374,13,1380,1764198,713,421,23,1923,36470
3.53,17,10,900,5,30,871,30,290,5,94,874,94,610
1786.789,1,186,10416,186,28,9658,28,10416,0,0,0,0,0
280.059,6,30,7432,14,158,21543,267,1357,16,603,18666,2800,6075
1740.194,6,82,5984,50,33,35514,33,3485,32,31,56129,31,2499
1799.247,1,57,4788,0,0,0,0,0,57,56,32129,56,4788
371.913,6,25,1651,17,177,23244,177,1117,8,110,9247,110,534
4.659,6,38,7245,19,218,258,314,3383,19,516,244,1179,3862
1795.214,17,80,3354,79,14,23015,14,3318,1,8,0,8,36
0.885,6,2,1175,1,0,0,0,40,1,1095,0,1095,1135
0.138,17,4,624,2,64,136,64,184,2,192,16,192,440
0.518,6,20,7229,13,334,43,663,2021,7,1209,80,1946,5208
280.348,6,29,7392,13,158,23362,267,1317,16,603,18688,2036,6075
1749.549,17,12,498,11,14,174954,14,462,1,8,0,8,36
1741.703,17,29,30624,29,1028,62203,1028,30624,0,0,0,0,0
1.379,6,14,4944,7,125,228,125,497,7,1018,229,1448,4447
1735.372,1,8,448,8,28,247910,28,448,0,0,0,0,0
46.929,6,171,70189,87,744,545,1152,63061,84,418,561,1152,7128
1781.763,6,363,22938,210,69,8525,69,12678,153,69,11722,69,10260
74.833,6,19,780,9,0,4416,0,364,10,0,8308,0,416
11.152,6,1776,1523463,1075,1363,10,1380,1491181,701,421,15,1923,32282
0.014,6,4,4540,3,1448,0,1448,4500,1,0,0,0,40
280.179,6,28,7352,13,158,23348,267,1317,15,678,20010,2600,6035
0.509,6,22,7345,13,334,42,663,2021,9,1209,57,2736,5324
56.456,17,4,352,2,60,56455,60,176,2,60,56455,60,176
0.363,6,17,3016,9,282,45,531,1606,8,493,50,828,1410
0.184,17,2,2380,2,1162,184,1162,2380,0,0,0,0,0
288.632,6,31,3133,15,324,20615,585,1449,16,282,19240,580,1684
300.287,6,45,29535,24,190,13055,444,2053,21,1758,12047,6443,27482
6.923,6,688,642649,461,1332,14,1368,626181,227,776,29,1473,16468
86.744,6,13,1079,12,43,7885,43,1019,1,0,0,0,60
1779.922,6,125,12412,77,62,23420,722,6403,48,94,37863,1408,6009
26.109,6,45,12893,22,199,1243,721,2477,23,730,1177,2840,10416
1790.917,1,341,28644,341,56,5267,56,28644,0,0,0,0,0
3.168,17,26,15737,13,648,261,1350,8793,13,506,261,1350,6944
1772.223,6,180,15480,120,69,14892,69,8940,60,69,30031,69,6540
1065.663,6,83,11287,44,75,24782,722,3952,39,220,23782,1448,7335
0.962,6,27,8420,15,222,57,540,1964,12,1192,71,3151,6456
2.747,17,4,624,4,128,915,128,624,0,0,0,0,0
1774.672,6,180,15480,120,69,14913,69,8940,60,69,30077,69,6540
213.805,6,66,14582,39,335,5626,1324,6387,27,323,8222,1328,8195
0.137,1,5,420,5,56,34,56,420,0,0,0,0,0
1.124,6,24,8004,12,164,87,267,1288,12,1014,87,2816,6716
1798.296,17,449,39928,404,35,4462,288,25708,45,288,40017,288,14220
1797.855,17,446,39832,401,35,4494,288,25612,45,288,40019,288,14220
141.392,17,4,352,2,60,141391,60,176,2,60,141391,60,176
0.334,6,47,17925,26,904,13,1380,12831,21,421,15,1923,5094
1794.281,17,180,14040,180,50,10023,50,14040,0,0,0,0,0
0.508,6,11,3472,6,113,101,113,357,5,970,45,1304,3115
369.598,6,27,1767,18,177,21741,177,1181,9,110,8609,110,586
14.84,6,1904,1744414,1222,1373,12,1380,1709580,682,421,21,1923,34834
3.27,6,2,88,2,0,0,0,88,0,0,0,0,0
4.151,17,2,124,2,34,4151,34,124,0,0,0,0,0
300.876,6,41,14716,24,915,13081,1360,9234,17,435,542,2667,5482
214.743,6,32,2358,14,80,16517,138,1043,18,66,12631,69,1315
11.912,6,1910,1648329,1164,1363,10,1380,1612288,746,514,15,1923,36041
1791.924,17,144,11520,72,48,25236,48,5472,72,56,25238,56,6048
15.529,17,21,7238,10,408,1722,1350,4369,11,232,1550,1350,2869
57.994,17,12,1764,6,48,11597,48,456,6,190,11596,308,1308
0.096,6,12,3462,6,75,19,75,395,6,1373,19,1448,3067
1799.713,1,104,5824,104,28,17472,28,5824,0,0,0,0,0
360.997,2,4,128,4,8,120332,8,128,0,0,0,0,0
962.548,2,10,320,10,8,106949,8,320,0,0,0,0,0
240.168,6,52,16806,28,744,8894,1402,14115,24,205,10441,580,2691
280.225,6,30,7432,13,158,23352,267,1317,17,543,17512,1300,6115
1682.826,17,14,1036,7,30,280450,30,406,7,62,280466,62,630
0.067,17,2,198,1,39,0,39,67,1,103,0,103,131
1790.867,1,342,28728,342,56,5251,56,28728,0,0,0,0,0
1790.119,6,366,25541,213,99,8443,469,15005,153,69,11776,69,10536
25.302,6,37,8368,17,175,1581,721,2084,20,548,1318,1420,6284
0.037,17,2,334,1,32,0,32,60,1,246,0,246,274
1682.684,17,16,1265,8,30,240377,37,471,8,71,240378,136,794
1.249,6,47,19441,27,910,48,1360,13865,20,529,57,4075,5576
1741.41,6,84,6104,56,31,31662,31,3780,28,31,64495,31,2324
1792.76,6,357,22629,208,69,8660,69,12460,149,69,12113,69,10169
82.291,6,38,10069,10,155,9143,267,1186,28,323,3046,1420,8883
1.477,6,20,3833,11,234,147,564,1504,9,463,161,1343,2329
1787.963,6,356,22520,208,69,8637,69,12460,148,69,12162,69,10060
0.179,6,5,303,2,0,3,0,104,3,31,89,31,199
16.401,6,757,656778,460,1355,35,1368,635306,297,776,54,1473,21472
1772.201,6,181,15589,120,69,14892,69,8940,61,69,29532,69,6649
1787.543,6,104,8376,68,65,26679,65,4930,36,59,51068,59,3446
1741.292,6,91,6604,59,31,30022,31,3998,32,31,56169,31,2606
812.683,17,160,12160,160,48,5111,48,12160,0,0,0,0,0
33.826,6,32,5147,16,154,2255,721,1911,16,342,2242,1408,3236
5.21,6,38,7229,20,218,274,314,3423,18,513,290,1179,3806
0.253,17,2,136,1,32,0,32,60,1,48,0,48,76
1706.071,1,8,848,8,78,243724,78,848,0,0,0,0,0
281.32,6,31,7813,14,158,21640,267,1357,17,577,17575,2036,6456
2.23,6,14,2351,8,188,318,245,700,6,703,394,1152,1651
0.216,17,17,11121,10,849,24,1350,8776,7,307,25,1350,2345
1788.558,1,54,3024,54,28,33746,28,3024,0,0,0,0,0
237.446,17,42,10899,42,231,5791,389,10899,0,0,0,0,0
105.135,6,15,1554,9,302,13141,302,1068,6,83,21025,83,486
1793.03,6,356,22520,208,69,8661,69,12460,148,69,12197,69,10060
0.068,17,2,322,1,33,0,33,61,1,233,0,233,261
1738.762,1,15,840,15,28,124197,28,840,0,0,0,0,0
0.023,6,14,4020,7,88,3,88,388,7,1113,3,1460,3632
34.634,6,5043,4763732,3292,1368,10,1408,4668004,1751,931,19,2801,95728
27.17,6,53,15203,32,170,876,287,4247,21,616,1353,2736,10956
0.23,2,2,112,2,32,230,32,112,0,0,0,0,0
0.335,17,2,136,1,32,0,32,60,1,48,0,48,76
127.308,6,23,10242,12,433,71,990,1823,11,1138,12717,2568,8419
31.993,6,9,396,2,0,3468,0,88,7,0,5317,0,308
0.29,1,2,112,2,28,290,28,112,0,0,0,0,0
0.359,17,2,152,1,48,0,48,76,1,48,0,48,76
347.604,6,52,6651,28,116,12874,722,2747,24,176,15105,1408,3904
39.946,17,24,2112,12,48,3630,48,912,12,72,3624,72,1200
12.093,6,1910,1663463,1161,1377,10,1420,1629282,749,467,16,1883,34181
19.154,6,37,8470,18,401,513,888,1956,19,441,1056,1440,6514
1776.625,17,73,3060,72,14,25022,14,3024,1,8,0,8,36
601.604,2,5,160,5,8,150401,8,160,0,0,0,0,0
1769.708,6,101,9212,66,63,27226,63,5511,35,57,52047,57,3701
0.108,6,11,1971,6,451,21,500,1222,5,481,26,481,749
1771.44,1,226,12656,226,28,7873,28,12656,0,0,0,0,0
80.77,6,8,444,2,0,15587,0,112,6,0,16119,0,332
14.035,6,24,6993,13,275,1169,275,1078,11,910,901,1440,5915
1741.325,17,30,20190,30,645,60045,645,20190,0,0,0,0,0
240.198,6,56,21136,30,877,8282,1418,18243,26,191,9607,580,2893
1773.678,6,180,15480,120,69,14904,69,8940,60,69,30054,69,6540
34.698,17,20,1520,20,48,1826,48,1520,0,0,0,0,0
1.474,6,37,8214,19,321,81,1164,2718,18,476,75,2715,5496
240.36,6,48,8655,24,449,10449,1418,5752,24,205,10449,580,2903
23.643,17,37,11146,18,380,1389,1350,7358,19,171,1311,1350,3788
36.461,6,42,9854,21,289,1823,721,3457,21,693,1715,1420,6397
0.04,17,4,368,2,32,39,32,120,2,96,1,96,248
0.065,17,4,368,2,32,53,32,120,2,96,0,96,248
1799.165,17,770,46424,770,32,2339,37,46424,0,0,0,0,0
38.971,17,4,240,2,32,38970,32,120,2,32,38970,32,120
1799.578,17,448,39896,403,35,4476,288,25676,45,288,40018,288,14220
0.08,6,10,1669,6,551,15,947,1346,4,159,26,159,323
599.124,6,9,546,6,31,119824,31,333,3,31,299527,31,213
0.013,17,4,865,2,47,3,47,150,2,329,2,341,715
1550.13,6,200,17139,75,75,20946,339,7542,125,71,12501,1062,9597
60.286,6,34,5045,20,135,3172,174,1482,14,333,4233,1452,3563
0.06,17,2,256,1,49,0,49,77,1,151,0,151,179
294.155,17,4,352,2,60,294153,60,176,2,60,294154,60,176
0.096,17,4,284,2,32,0,32,120,2,54,85,60,164
69.101,6,27,7177,13,155,5758,267,1306,14,530,5314,2840,5871
0.021,17,4,344,2,47,1,47,150,2,69,0,75,194
1787.425,17,312,71965,312,202,5747,422,71965,0,0,0,0,0
1799.848,17,449,39928,404,35,4466,288,25708,45,288,40025,288,14220
1.402,6,24,8004,12,164,108,267,1288,12,1014,109,2491,6716
14.868,17,4,352,2,48,14846,48,152,2,72,14847,72,200
1787.426,6,182,15629,121,69,14895,69,8980,61,69,29784,69,6649
280.301,6,30,7432,13,158,23358,267,1317,17,543,17512,1400,6115
1727.117,1,62,6572,62,78,28313,78,6572,0,0,0,0,0
1713.183,17,59,2475,58,13,30055,14,2431,1,16,0,16,44
32.198,6,256,266176,73,134,447,324,4198,183,1410,176,1418,261978
1798.75,6,157,15738,94,76,19341,722,8264,63,80,29006,1408,7474
135.54,17,4,304,2,48,135539,64,152,2,48,135539,64,152
0.012,17,2,322,1,33,0,33,61,1,233,0,233,261
300.81,6,41,8682,22,299,14324,852,2123,19,413,480,1460,6559
1.112,17,6,552,3,64,555,64,276,3,64,555,64,276
0.117,17,2,1922,2,933,117,933,1922,0,0,0,0,0
0.225,6,4,1037,2,0,219,0,104,2,853,8,853,933
842.221,2,9,288,9,8,105277,8,288,0,0,0,0,0
16.73,17,4,824,2,48,16722,48,152,2,308,16720,308,672
1799.578,17,450,39960,405,35,4454,288,25740,45,288,40023,288,14220
1.379,6,19,3781,10,234,153,564,1452,9,463,150,1343,2329
0.011,6,3,120,2,0,0,0,80,1,0,0,0,40
1792.99,17,142,11360,71,48,25614,48,5396,71,56,25614,56,5964
1784.136,17,140,11200,70,48,25856,48,5320,70,56,25856,56,5880
72.493,6,73,52365,48,1194,1542,1408,44322,25,841,2566,2439,8043
0.031,17,2,399,1,39,0,39,67,1,304,0,304,332
141.189,6,23,9202,12,304,74,597,1461,11,1041,14101,2720,7741
1799.756,1,266,14896,266,28,6791,28,14896,0,0,0,0,0
1790.866,6,359,22709,209,69,8609,69,12569,150,69,12019,69,10140
1377.028,6,103,10834,62,71,22574,721,5373,41,107,32788,1448,5461
0.908,17,4,1344,4,308,302,308,1344,0,0,0,0,0
1785.874,6,369,25730,214,99,8384,469,15114,155,69,11596,69,10616
1781.311,6,189,11567,94,47,19152,208,6837,95,31,18948,31,4730
1795.23,17,80,3354,79,14,23015,14,3318,1,8,0,8,36
1740.696,1,14,812,14,30,133899,30,812,0,0,0,0,0
377.266,6,18,1242,14,180,29020,180,916,4,110,20063,110,326
5.008,17,4,530,2,36,5004,36,128,2,173,5004,187,402
6.149,6,1290,1196057,819,1382,7,1408,1166901,471,931,12,2816,29156
1762.765,1,50,4200,50,56,35974,56,4200,0,0,0,0,0
2.205,6,9,527,5,43,551,43,311,4,0,715,0,216
55.57,17,2,152,2,48,55570,48,152,0,0,0,0,0
1798.291,17,314,69308,314,192,5745,422,69308,0,0,0,0,0
0.6,6,15,1785,8,288,70,288,640,7,426,70,434,1145
168.208,6,24,10065,12,380,112,832,1673,12,987,15277,1360,8392
1.17,6,11,5498,3,106,585,106,234,8,822,64,1460,5264
1682.055,1,15,870,15,30,120146,30,870,0,0,0,0,0
3.584,17,5,290,5,30,896,30,290,0,0,0,0,0
1799.606,6,357,22767,207,69,8735,69,12489,150,69,12077,69,10278
1756.015,6,100,7537,65,38,27437,205,4611,35,33,51641,98,2926
0.659,6,3,156,1,0,0,0,64,2,0,503,0,92
1771.589,6,99,9240,66,65,27255,65,5577,33,59,55359,59,3663
114.057,6,102,73787,63,1256,1839,1448,63595,39,679,2987,1448,10192
0.359,17,4,284,2,32,241,32,120,2,54,125,60,164
0.152,17,2,245,1,32,0,32,60,1,157,0,157,185
0.175,6,5,260,0,0,0,0,0,5,0,0,0,260
75.92,6,29,7533,11,155,32,267,1226,18,429,4465,3426,6307
300.76,6,46,10275,23,571,13670,1360,4429,23,307,496,1360,5846
280.237,6,29,7392,13,158,23353,267,1317,16,603,18679,2036,6075
0.012,17,2,166,1,39,0,39,67,1,71,0,71,99
1.067,6,4,220,4,24,355,24,220,0,0,0,0,0
5.057,6,40,7309,19,218,280,314,3383,21,440,239,1152,3926
0.169,6,2,80,1,0,0,0,40,1,0,0,0,40
0.284,6,3,182,2,31,284,31,111,1,31,0,31,71
0.146,6,2,104,1,0,0,0,40,1,0,0,0,64
12.697,17,4,352,2,48,12677,48,152,2,72,12675,72,200
740.464,6,45,2969,30,41,25533,208,1997,15,31,44172,31,972
1793.367,1,285,15960,285,28,6314,28,15960,0,0,0,0,0
0.234,6,8,530,5,43,58,43,354,3,0,116,0,176
1783.002,17,285,63041,285,193,6278,422,63041,0,0,0,0,0
1684.054,17,16,1184,8,30,240574,30,464,8,62,240574,62,720
0.012,17,2,602,1,46,0,46,74,1,500,0,500,528
1795.352,17,448,39896,403,35,4466,288,25676,45,288,40015,288,14220
32.036,6,9,396,2,0,3482,0,88,7,0,5323,0,308
1316.203,2,8,256,8,8,188029,8,256,0,0,0,0,0
18.886,6,7,380,4,0,6295,0,216,3,0,9433,0,164
317.04,6,106,35818,55,549,5871,1360,24749,51,300,6337,1360,11069
1.602,6,47,18607,26,916,64,1460,12991,21,433,70,1460,5616
1785.86,6,359,22709,209,69,8585,69,12569,150,69,11985,69,10140
0.737,17,4,820,2,36,726,36,128,2,318,732,318,692
1.313,6,2,92,1,0,0,0,40,1,0,0,0,52
0.881,6,11,1727,7,100,146,100,384,4,589,211,1152,1343
1259.87,2,8,256,8,8,179981,8,256,0,0,0,0,0
9.087,6,37,9962,19,614,504,1360,3250,18,498,516,2142,6712
0.864,6,10,1687,7,100,144,100,384,3,1179,308,1179,1303
17.989,6,14,2187,8,325,2569,587,1075,6,396,3476,580,1112
0.133,17,2,158,1,34,0,34,62,1,68,0,68,96
1790.141,17,83,3480,82,14,22100,14,3444,1,8,0,8,36
2.23,6,29,10372,17,368,139,837,1789,12,1012,194,1420,8583
1789.959,6,368,23276,209,69,8605,69,12845,159,69,11328,69,10431
279.571,1,4,224,4,28,93190,28,224,0,0,0,0,0
1795.453,17,83,3480,82,14,22166,14,3444,1,8,0,8,36
22.108,6,16,2796,6,837,4418,1452,1918,10,231,2454,231,878
0.324,17,2,152,1,48,0,48,76,1,48,0,48,76
44.436,6,33,8958,14,327,115,1189,2535,19,471,2468,1420,6423
8.724,6,1660,1538828,1029,1416,8,1448,1501340,631,776,13,1448,37488
3.994,17,3,180,3,32,1997,32,180,0,0,0,0,0
0.181,6,4,160,2,0,3,0,80,2,0,0,0,80
1.713,6,25,8702,15,274,122,556,1428,10,981,170,1420,7274
300.239,6,36,12221,20,592,15802,1408,4649,16,748,16121,2816,7572
1764.758,6,101,7763,60,38,28539,205,4289,41,32,44083,98,3474
112.289,6,25,8315,12,224,51,359,1184,13,733,9347,1360,7131
6.338,6,36,8227,20,188,333,721,2126,16,778,410,1420,6101
300.841,6,34,8435,20,204,15833,467,1924,14,525,5325,2688,6511
0.042,17,4,284,2,32,25,32,120,2,54,22,60,164
280.892,6,29,7392,13,158,23407,267,1317,16,603,18718,2036,6075
0.445,17,24,4857,24,174,19,220,4857,0,0,0,0,0
145.245,6,83,49958,43,830,98,1460,16698,40,989,3720,1548,33260
371.01,6,25,1651,17,177,23188,177,1117,8,110,9231,110,534
12.179,6,1878,1630027,1140,1375,10,1432,1596123,738,434,16,1871,33904
1777.329,17,29,30624,29,1028,63476,1028,30624,0,0,0,0,0
1772.233,6,180,15480,120,69,14892,69,8940,60,69,30035,69,6540
88.367,6,29,7392,13,158,7363,267,1317,16,603,5887,1400,6075
1771.753,6,99,9240,66,65,27257,65,5577,33,59,55363,59,3663
1794.582,17,87,3648,86,14,21112,14,3612,1,8,0,8,36
56.605,6,27,8752,13,158,4717,267,1317,14,981,4352,2800,7435
64.427,17,4,352,2,60,64426,60,176,2,60,64426,60,176
0.006,17,2,350,1,37,0,37,65,1,257,0,257,285
1742.636,6,87,6322,58,31,30572,31,3915,29,31,62236,31,2407
0.68,6,24,4583,12,165,61,456,1446,12,498,58,888,3137
1783.442,17,77,3228,76,14,23779,14,3192,1,8,0,8,36
1772.785,6,180,15480,120,69,14897,69,8940,60,69,30044,69,6540
1786.777,17,140,11200,70,48,25895,48,5320,70,56,25895,56,5880
197.174,6,8351,7563347,5207,1365,37,1368,7372141,3144,899,62,1473,191206
0.101,17,2,178,1,29,0,29,57,1,93,0,93,121
0.654,17,2,2523,2,1233,654,1437,2523,0,0,0,0,0
280.224,6,31,7472,14,158,21555,267,1357,17,543,17511,1400,6115
1743.713,6,95,7215,63,38,28124,205,4488,32,33,56235,98,2727
123.315,6,66,10429,29,207,4404,841,3478,37,171,3422,1547,6951
55.262,17,2,72,1,8,0,8,36,1,8,0,8,36
240.864,6,61,18415,31,796,8028,1418,15170,30,186,8305,580,3245
0.533,6,20,7229,13,334,44,663,2021,7,1209,79,1946,5208
1.101,6,23,7952,13,164,78,267,1340,10,1216,104,3819,6612
1797.074,17,449,39928,404,35,4459,288,25708,45,288,40018,288,14220
645.832,6,128,15357,69,83,9497,267,5616,59,175,11020,1460,9741
1786.514,6,104,8444,68,66,26664,66,4964,36,60,51040,60,3480
305.098,1,9,2822,9,285,38137,333,2822,0,0,0,0,0
1767.851,6,46,2392,23,0,80349,0,1196,23,0,80352,0,1196
0.051,17,2,136,1,32,0,32,60,1,48,0,48,76
846.864,17,13,4831,13,343,70572,1297,4831,0,0,0,0,0
1797.924,6,407,37536,213,119,8480,1189,17454,194,126,9315,1420,20082
3.912,6,33,6129,17,206,244,314,2744,16,548,243,1179,3385
7.77,6,2,1175,1,0,0,0,40,1,1095,0,1095,1135
4.005,17,4,244,4,33,1335,33,244,0,0,0,0,0
1784.08,1,148,8288,148,28,12136,28,8288,0,0,0,0,0
0.245,17,2,588,1,39,0,39,67,1,493,0,493,521
1.801,6,52,13869,24,551,78,1429,4840,28,438,64,1460,9029
53.452,6,47,8971,24,369,400,792,2160,23,367,2422,2128,6811
1741.427,17,30,20190,30,645,60049,645,20190,0,0,0,0,0
848.368,17,14,1036,7,30,141298,30,406,7,62,141386,62,630
0.443,6,48,22028,28,1056,16,1380,16998,20,421,21,1923,5030
1773.024,6,180,15480,120,69,14899,69,8940,60,69,30043,69,6540
1771.789,6,99,9240,66,65,27258,65,5577,33,59,55365,59,3663
3.107,17,4,934,2,40,3096,40,136,2,371,3092,379,798
244.601,6,87,22935,41,520,6114,1418,13618,46,345,5435,1418,9317
1793.332,1,58,4872,58,56,31461,56,4872,0,0,0,0,0
0.282,6,24,6064,12,181,25,537,1526,12,781,24,2224,4538
1772.617,6,180,15480,120,69,14895,69,8940,60,69,30036,69,6540
280.218,6,24,7054,11,181,28021,267,1168,13,670,23349,1400,5886
1786.169,6,186,39311,108,461,16693,1302,29231,78,128,23195,297,10080
1794.769,6,379,23701,217,69,8309,69,12820,162,59,11147,69,10881
1.134,6,24,8004,12,164,87,267,1288,12,1014,87,2411,6716
14.001,17,2,668,2,306,14001,312,668,0,0,0,0,0
45.582,6,31,8947,13,327,201,1189,2495,18,520,2680,1926,6452
0.334,6,21,7290,13,335,27,668,2026,8,1210,46,1906,5264
1.32,6,28,5967,14,156,101,267,1502,14,650,96,1420,4465
11.664,6,1858,1611679,1127,1376,10,1420,1578218,731,467,15,1883,33461
0.495,6,14,1733,7,288,78,288,588,7,284,48,434,1145
140.654,6,22,9317,11,524,94,1236,2070,11,1132,14047,2279,7247
299.742,17,4,352,2,60,299740,60,176,2,60,299741,60,176
1744.706,2,30,960,30,8,60162,8,960,0,0,0,0,0
1791.258,6,370,23425,213,69,8449,69,13005,157,69,11480,69,10420
1772.79,6,180,15480,120,69,14897,69,8940,60,69,30039,69,6540
855.494,1,7,392,7,28,142582,28,392,0,0,0,0,0
1772.017,6,103,9514,66,66,27261,66,5610,37,60,49220,60,3904
240.345,6,43,9251,21,523,12016,1418,5815,22,253,11444,618,3436
1772.179,6,182,15629,121,69,14768,69,8980,61,69,29533,69,6649
1743.06,6,97,7307,63,38,28113,205,4476,34,33,52810,98,2831
1784.961,6,362,24374,211,88,8499,469,13987,151,69,11899,69,10387
0.092,17,2,128,1,28,0,28,56,1,44,0,44,72
1504.042,2,18,576,18,8,88473,8,576,0,0,0,0,0
0.115,17,8,2758,8,316,16,355,2758,0,0,0,0,0
1798.707,6,273,33456,111,141,16350,1460,16488,162,127,11171,1642,16968
117.607,17,2,136,2,40,117607,47,136,0,0,0,0,0
5.007,17,4,288,2,36,4990,36,128,2,52,4986,52,160
0.196,6,23,7325,12,177,17,337,1342,11,1080,18,1588,5983
73.829,6,23,11016,12,745,56,1360,3492,11,1414,7370,3940,7524
0.262,1,10,840,10,56,29,56,840,0,0,0,0,0
1787.777,6,102,8296,68,65,26683,65,4930,34,59,54171,59,3366
175.931,6,24,10205,12,702,85,1360,3320,12,1065,15977,2241,6885
15.61,6,49,10253,24,793,678,1460,4251,25,277,642,1460,6002
10.867,2,2,64,2,8,10867,8,64,0,0,0,0,0
0.041,17,4,1375,4,315,13,354,1375,0,0,0,0,0
1.342,6,50,19819,28,867,49,1360,14163,22,433,55,1360,5656
7.899,6,775,644555,457,1335,16,1368,623343,318,776,24,2736,21212
396.932,17,6,750,6,97,79386,352,750,0,0,0,0,0
0.98,6,29,8303,15,225,57,561,1985,14,820,61,1440,6318
35.055,6,3765,3300450,2218,1396,15,1448,3203732,1547,792,22,1448,96718
0.574,6,15,1785,8,288,62,288,640,7,426,66,434,1145
91.952,17,4,352,2,60,91951,60,176,2,60,91951,60,176
0.38,17,8,2750,8,315,54,354,2750,0,0,0,0,0
0.0,17,1,359,1,331,0,331,359,0,0,0,0,0
1772.417,6,180,15480,120,69,14894,69,8940,60,69,30039,69,6540
1786.605,6,102,8364,68,66,26665,66,4964,34,60,54136,60,3400
1.827,6,38,9848,20,502,96,1460,4352,18,433,93,1460,5496
1.275,6,23,7952,12,164,98,267,1288,11,1216,108,3819,6664
0.087,6,2,92,1,0,0,0,40,1,0,0,0,52
1.307,6,33,12144,18,518,76,1360,3366,15,742,81,1360,8778
0.835,6,24,6014,12,108,75,147,919,12,922,71,1581,5095
365.385,17,5,4354,5,842,91346,1451,4354,0,0,0,0,0
1.111,6,10,1677,6,555,215,951,1354,4,159,317,159,323
33.776,6,28,4936,14,180,2598,722,1806,14,399,2580,1408,3130
383.628,1,3,312,3,76,191814,76,312,0,0,0,0,0
1784.375,1,142,15052,142,78,12655,78,15052,0,0,0,0,0
1.444,6,14,1640,7,256,238,256,1052,7,304,238,304,588
2.882,17,4,624,4,128,960,128,624,0,0,0,0,0
5.005,17,4,1108,2,47,4999,47,150,2,451,4999,451,958
280.402,6,29,7392,13,158,23366,267,1317,16,603,18691,2036,6075
0.124,6,9,1340,5,145,31,145,349,4,827,32,827,991
36.435,2,2,64,2,8,36435,8,64,0,0,0,0,0
240.177,6,53,18019,28,807,8895,1418,15198,25,189,10006,580,2821
438.806,6,173,49912,83,816,5349,1418,41886,90,86,4927,580,8026
5.002,17,4,558,2,36,4998,36,128,2,187,4997,187,430
1778.472,17,140,11200,70,48,25774,48,5320,70,56,25774,56,5880
4.451,6,33,6129,17,206,278,314,2744,16,548,280,1179,3385
1786.016,6,102,8228,68,64,26656,64,4896,34,58,54119,58,3332
234.122,17,3,514,3,143,117061,336,514,0,0,0,0,0
0.0,6,1,792,1,752,0,752,792,0,0,0,0,0
0.09,6,117,122152,32,141,2,347,2089,85,1410,0,2804,120063
0.875,6,2,1520,1,0,0,0,40,1,1440,0,1440,1480
1704.947,1,8,448,8,28,243563,28,448,0,0,0,0,0
1783.392,17,83,3480,82,14,22017,14,3444,1,8,0,8,36
1.392,6,43,16659,25,844,58,1360,11163,18,529,71,4075,5496
0.457,17,2,776,2,360,457,360,776,0,0,0,0,0
5.002,17,4,288,2,36,4989,36,128,2,52,4978,52,160
1776.133,17,73,3060,72,14,25015,14,3024,1,8,0,8,36
1797.302,17,140,11200,70,48,26047,48,5320,70,56,26047,56,5880
1799.975,6,382,27768,205,97,8823,469,15099,177,69,10225,69,12669
1786.255,1,342,28728,342,56,5238,56,28728,0,0,0,0,0
1.463,6,42,9344,22,399,69,1460,3723,20,400,66,1460,5621
113.84,2,2,64,2,8,113840,8,64,0,0,0,0,0
3.88,6,16,4681,9,49,485,92,587,7,745,106,1408,4094
122.351,17,52,11079,24,297,5317,1350,7807,28,88,4530,1350,3272
1781.767,6,364,25461,211,100,8484,469,14856,153,69,11722,69,10605
0.568,6,12,1653,6,288,109,288,548,6,426,79,434,1105
0.063,17,2,382,1,32,0,32,60,1,294,0,294,322
0.057,17,2,212,1,46,0,46,74,1,110,0,110,138
280.201,6,26,7272,12,158,25472,267,1277,14,775,21551,3445,5995
204.358,17,4,352,2,60,204356,60,176,2,60,204357,60,176
1.422,6,37,8212,19,320,79,1162,2716,18,476,72,2720,5496
0.281,17,14,5210,6,447,52,1350,2854,8,266,35,1350,2356
381.51,6,22,2380,16,184,25434,184,856,6,424,4665,434,1524
1.603,6,38,8258,19,321,89,1168,2722,19,433,77,1360,5536
1773.548,6,180,15480,120,69,14903,69,8940,60,69,30053,69,6540
2.045,6,25,5795,13,158,168,370,1315,12,799,184,1460,4480
20.273,6,21,5417,12,107,1843,159,1074,9,773,2531,1418,4343
2.505,6,102,88280,36,284,71,887,3585,66,1354,38,2836,84695
11.795,6,1742,1615510,1142,1364,10,1432,1585336,600,559,19,1871,30174
1770.732,6,103,9514,66,66,27242,66,5610,37,60,49184,60,3904
1.04,6,28,8484,15,222,63,540,1988,13,994,71,1791,6496
0.062,17,2,602,1,46,0,46,74,1,500,0,500,528
49.733,6,30,8049,11,280,4973,517,1422,19,402,2760,1408,6627
1747.055,6,94,7151,62,38,28640,205,4424,32,33,56348,98,2727
0.47,6,10,968,5,256,104,256,460,5,304,105,304,508
895.759,17,176,13376,176,48,5118,48,13376,0,0,0,0,0
225.659,6,208,170111,135,1313,1684,1408,155413,73,680,2285,3847,14698
391.383,17,8,2688,8,308,55911,308,2688,0,0,0,0,0
1798.797,6,315,23846,186,98,9723,469,14132,129,69,14053,69,9714
1794.448,1,148,15688,148,78,12207,78,15688,0,0,0,0,0
1773.575,6,181,15589,120,69,14903,69,8940,61,69,29552,69,6649
1745.518,6,95,7203,63,38,28153,205,4476,32,33,56293,98,2727
1700.498,17,12,498,11,14,170049,14,462,1,8,0,8,36
19.108,6,6,328,4,0,6369,0,216,2,0,19091,0,112
3.648,17,5,290,5,30,912,30,290,0,0,0,0,0
0.576,6,29,7519,17,305,35,1086,2825,12,701,51,1728,4694
0.074,17,2,152,1,48,0,48,76,1,48,0,48,76
0.237,6,20,4960,10,137,26,267,1092,10,692,24,1467,3868
1786.259,6,104,8444,68,66,26660,66,4964,36,60,51033,60,3480
15.653,17,12,5313,6,490,3115,1350,3110,6,339,3114,1350,2203
1794.183,6,240,35580,150,302,12041,302,25920,90,83,20159,83,9660
1770.233,6,99,9306,66,66,27234,66,5610,33,60,55306,60,3696
1007.14,2,6,192,6,8,201428,8,192,0,0,0,0,0
76.063,6,21,868,10,0,5526,0,408,11,0,7604,0,460
1739.986,1,56,4704,0,0,0,0,0,56,56,31636,56,4704
0.976,6,23,6509,13,333,81,1003,2189,10,979,107,1731,4320
1784.796,6,998,313783,439,921,4074,1418,252728,559,98,3198,1418,61055
300.674,6,39,8576,20,302,15824,861,2064,19,441,474,1360,6512
1019.535,17,78,6240,39,48,26829,48,2964,39,56,26829,56,3276
1749.762,17,12,498,11,14,174976,14,462,1,8,0,8,36
1790.216,17,180,11520,180,36,10001,36,11520,0,0,0,0,0
0.921,6,11,1727,7,100,153,100,384,4,589,223,1152,1343
9.024,17,6,534,3,37,4510,37,195,3,85,4510,89,339
0.123,17,2,417,1,34,0,34,62,1,327,0,327,355
1776.675,17,141,11276,71,48,25380,48,5396,70,56,25748,56,5880
4.385,6,13,1383,6,283,840,283,886,7,105,700,105,497
5.104,17,50,19948,25,630,212,1350,16456,25,111,167,1350,3492
1798.502,17,142,11360,71,48,25692,48,5396,71,56,25692,56,5964
153.668,6,22,9557,12,372,67,802,1630,10,1503,17058,4477,7927
0.996,17,27,14849,13,619,83,1350,8421,14,431,56,1350,6428
2.7,17,59,49221,23,443,122,1350,10847,36,1037,61,1350,38374
1787.378,6,102,8296,68,65,26677,65,4930,34,59,54159,59,3366
79.051,6,81,56014,42,1329,55,1448,47402,39,547,2079,1448,8612
256.425,6,6,1257,4,327,85475,414,815,2,181,256248,270,442
120.291,6,23,11725,12,367,88,783,1626,11,1378,12012,2720,10099
151.411,6,84,57668,51,1225,3028,1368,49215,33,747,1943,1368,8453
280.221,6,27,7312,13,158,23351,267,1317,14,775,21552,4836,5995
46.259,17,4,352,2,60,46258,60,176,2,60,46258,60,176
39.018,17,4,240,2,32,39016,32,120,2,32,39017,32,120
15.116,17,17,10642,10,822,1676,1350,8505,7,277,2514,1350,2137
1.019,6,22,9538,11,411,101,897,1707,11,1054,83,1410,7831
1795.676,17,447,39864,402,35,4477,288,25644,45,288,40016,288,14220
962.114,2,9,288,9,8,120264,8,288,0,0,0,0,0
7.439,6,7,420,2,0,1057,0,120,5,0,1817,0,300
18.419,17,34,6288,16,168,1225,1350,3144,18,146,1081,1350,3144
368.769,6,23,1535,16,177,24584,177,1053,7,110,10376,110,482
1797.809,1,345,28980,345,56,5226,56,28980,0,0,0,0,0
1772.522,6,180,15480,120,69,14895,69,8940,60,69,30034,69,6540
0.308,6,22,7342,12,335,27,668,1974,10,1210,33,1906,5368
42.539,6,13,1225,6,517,8506,517,849,7,0,7088,0,376
1772.398,6,180,15480,120,69,14894,69,8940,60,69,30035,69,6540
128.497,6,28,7120,7,154,21416,267,752,21,345,6423,1420,6368
0.34,17,2,152,1,48,0,48,76,1,48,0,48,76
0.118,17,3,3140,3,1018,59,1438,3140,0,0,0,0,0
0.137,6,12,4225,7,127,22,127,499,5,1729,31,3293,3726
0.81,6,29,13419,15,960,57,1440,6393,14,806,47,1485,7026
0.021,6,14,4044,8,88,3,88,452,6,1670,4,1880,3592
16.164,6,1655,1501231,1053,1371,15,1380,1466162,602,511,26,1923,35069
0.005,17,2,437,1,48,0,48,76,1,333,0,333,361
1783.923,6,364,25392,212,100,8454,469,14896,152,69,11814,69,10496
1022.715,2,8,256,8,8,146102,8,256,0,0,0,0,0
8.356,6,23,4490,12,213,759,597,1701,11,441,816,1408,2789
0.077,6,10,1514,5,503,19,503,771,5,475,19,475,743
296.86,17,4,240,2,32,296859,32,120,2,32,296859,32,120
5.082,6,41,7349,20,218,267,314,3423,21,440,240,1152,3926
1742.398,6,97,7307,63,38,28103,205,4476,34,33,52787,98,2831
3.903,17,25,11243,11,349,390,1350,4153,14,478,204,1350,7090
0.258,6,22,5040,11,137,25,267,1132,11,692,24,2800,3908
114.861,6,34,8202,12,159,2912,267,1602,22,317,5469,1460,6600
0.063,6,10,766,5,185,12,185,453,5,45,15,45,313
2.997,17,4,356,2,47,2990,47,150,2,75,2989,75,206
0.498,6,110,75312,64,1280,7,1432,69181,46,427,10,1432,6131
467.069,17,6,528,3,60,233534,60,264,3,60,233534,60,264
76.735,17,6,1361,3,34,38361,37,188,3,363,38361,463,1173
280.18,6,28,7352,13,158,23348,267,1317,15,678,20011,4200,6035
0.1,17,4,284,2,32,68,32,120,2,54,34,60,164
240.213,6,56,18309,30,801,8282,1402,15197,26,250,9608,580,3112
17.674,6,7,380,4,0,5891,0,216,3,0,8823,0,164
5.401,6,40,7309,20,218,284,314,3423,20,513,269,1179,3886
240.335,6,49,15645,26,725,9613,1402,12966,23,184,10924,580,2679
1.995,6,14,2351,8,188,285,245,700,6,703,348,1152,1651
37.558,6,29,7209,13,159,3129,267,1327,16,475,2500,1420,5882
3.942,17,5,295,5,31,985,31,295,0,0,0,0,0
1784.666,6,287,35657,120,142,14996,1360,17908,167,133,10750,3302,17749
23.766,6,1948,1779268,1246,1373,19,1380,1743470,702,421,33,1923,35798
0.027,6,2,421,1,0,0,0,40,1,341,0,341,381
1.98,17,15,7367,8,586,282,1350,4917,7,322,324,1350,2450
3.103,17,4,396,2,39,3101,39,134,2,103,3101,103,262
14.843,17,4,352,2,60,14841,60,176,2,60,14842,60,176
10.418,6,31,12697,12,139,932,416,1361,19,960,569,1440,11336
0.014,6,2,364,1,0,0,0,40,1,272,0,272,324
1789.834,6,355,22480,207,69,8688,69,12420,148,69,12175,69,10060
1640.298,1,7,742,7,78,273383,78,742,0,0,0,0,0
0.127,1,2,373,2,158,127,219,373,0,0,0,0,0
24.963,17,4,240,2,32,24962,32,120,2,32,24961,32,120
16.216,17,10,880,5,48,4052,48,380,5,72,4051,72,500
1791.779,1,342,28728,342,56,5254,56,28728,0,0,0,0,0
1787.252,6,102,8228,68,64,26675,64,4896,34,58,54156,58,3332
1772.13,6,180,15480,120,69,14891,69,8940,60,69,30034,69,6540
0.528,17,3,634,2,32,522,32,120,1,486,0,486,514
1644.249,1,7,392,7,28,274041,28,392,0,0,0,0,0
11.593,6,25,8453,13,275,966,275,1078,12,983,754,1420,7375
43.796,17,8,1648,4,48,14595,48,304,4,308,14594,308,1344
1776.705,17,142,11360,71,48,25380,48,5396,71,56,25380,56,5964
0.401,6,3,210,1,0,0,0,40,2,90,215,90,170
155.032,17,4,240,2,32,155031,32,120,2,32,155031,32,120
1113.824,17,220,16720,220,48,5085,48,16720,0,0,0,0,0
1420.971,17,14,3676,7,31,236826,37,413,7,438,236826,463,3263
1.534,6,46,18120,26,882,61,1360,12544,20,433,70,1360,5576
1740.633,17,30,31680,30,1028,60021,1028,31680,0,0,0,0,0
0.085,17,2,212,1,46,0,46,74,1,110,0,110,138
7.09,6,66,20478,34,554,214,1152,15771,32,427,219,1152,4707
1790.066,17,83,3480,82,14,22099,14,3444,1,8,0,8,36
421.125,2,4,128,4,8,140375,8,128,0,0,0,0,0
1.253,6,25,8056,12,164,97,267,1288,13,869,88,1448,6768
2.385,17,4,610,3,39,609,39,201,1,381,0,381,409
0.102,17,2,152,1,48,0,48,76,1,48,0,48,76
0.002,17,3,821,1,137,0,137,165,2,300,0,300,656
240.194,6,54,18039,29,748,8578,1408,14993,25,217,10007,580,3046
704.23,2,8,256,8,8,100604,8,256,0,0,0,0,0
378.9,6,27,1767,18,177,22288,177,1181,9,110,8939,110,586
3.09,17,4,1560,4,362,1030,362,1560,0,0,0,0,0
1769.93,1,58,4872,0,0,0,0,0,58,56,31051,56,4872
83.152,6,47,21648,26,681,158,818,7882,21,860,4150,1335,13766
0.462,6,20,7229,12,334,41,663,1969,8,1209,64,1906,5260
1797.179,17,459,42724,406,36,4437,288,26100,53,285,34278,308,16624
240.328,6,43,8777,21,519,12016,1402,5776,22,205,11443,619,3001
1797.997,6,365,25501,212,100,8521,469,14896,153,69,11828,69,10605
1796.719,6,98,7421,65,38,28073,205,4611,33,33,56138,98,2810
10.841,6,1619,1494491,1017,1419,10,1432,1466190,602,420,18,1432,28301
1782.145,6,218,17817,83,82,21730,368,9008,135,50,13298,143,8809
60.891,17,6,1236,3,48,30441,48,228,3,308,30440,308,1008
1795.717,1,204,21624,204,78,8845,78,21624,0,0,0,0,0
172.565,6,34,19217,16,708,48,1460,4226,18,1096,10143,1460,14991
298.367,17,4,352,2,60,298366,60,176,2,60,298366,60,176
0.078,6,9,1340,5,145,19,145,349,4,827,22,827,991
0.006,6,10,12766,9,1362,0,1408,12726,1,0,0,0,40
1786.2,17,87,3648,86,14,21014,14,3612,1,8,0,8,36
1.37,6,50,20003,28,879,50,1360,14347,22,476,57,2715,5656
1784.658,6,104,8376,68,65,26636,65,4930,36,59,50987,59,3446
1.346,6,49,21181,28,960,49,1440,15565,21,433,58,1440,5616
0.128,17,2,136,1,32,0,32,60,1,48,0,48,76
38.047,17,22,1936,11,48,3803,48,836,11,72,3803,72,1100
0.246,17,2,144,1,36,0,36,64,1,52,0,52,80
1.102,17,6,360,3,32,550,32,180,3,32,550,32,180
5.035,17,2,64,2,4,5035,4,64,0,0,0,0,0
1794.27,17,257,47649,257,157,7008,353,47649,0,0,0,0,0
334.526,6,102,13926,48,160,7117,1189,4654,54,222,6311,1997,9272
4.463,6,40,7325,20,218,234,314,3423,20,442,221,1152,3902
213.709,17,4,352,2,60,213708,60,176,2,60,213708,60,176
181.231,2,3,96,3,8,90615,8,96,0,0,0,0,0
0.478,6,22,5960,12,108,43,147,919,10,927,51,1608,5041
13.138,17,2,152,2,48,13138,48,152,0,0,0,0,0
1753.306,6,95,7203,63,38,28279,205,4476,32,33,56548,98,2727
0.329,6,27,8920,13,227,27,547,1592,14,941,25,1408,7328
367.216,6,27,1767,18,177,21600,177,1181,9,110,8548,110,586
0.075,1,2,112,2,28,75,28,112,0,0,0,0,0
2.903,6,9,527,5,43,725,43,311,4,0,948,0,216
1798.747,17,466,41684,405,35,4452,288,25784,61,232,29564,308,15900
0.01,6,3,175,1,0,0,0,40,2,31,1,31,135
701.491,1,10,1672,10,139,77943,351,1672,0,0,0,0,0
1741.382,17,29,6815,29,207,62192,207,6815,0,0,0,0,0
1683.782,2,22,704,22,8,80180,8,704,0,0,0,0,0
611.478,6,77,8764,42,96,14910,722,3966,35,129,17979,2026,4798
1.417,6,37,8214,19,321,78,1164,2718,18,433,72,1460,5496
0.348,6,27,9071,13,247,29,624,1672,14,832,24,1448,7399
0.011,6,3,144,2,0,0,0,104,1,0,0,0,40
1769.728,6,99,9240,66,65,27226,65,5577,33,59,55301,59,3663
0.062,17,2,288,1,59,0,59,87,1,173,0,173,201
151.007,6,69,47515,44,1199,3511,1408,39481,25,960,2567,3847,8034
0.033,6,11,1566,6,503,6,503,823,5,475,8,475,743
0.023,6,10,860,6,181,4,181,489,4,77,5,134,371
0.004,17,4,308,2,38,0,38,132,2,60,0,66,176
1352.946,6,137,11759,90,69,15201,69,6774,47,69,29411,69,4985
15.498,17,34,26067,17,1029,964,1350,17969,17,448,964,1350,8098
0.421,6,12,1653,7,288,70,288,588,5,426,57,434,1065
240.175,6,54,17579,29,776,8577,1408,14720,25,193,10007,580,2859
1092.271,17,216,16416,216,48,5080,48,16416,0,0,0,0,0
0.9,6,10,1687,7,100,150,100,384,3,1179,319,1179,1303
645.581,1,16,896,16,28,43038,28,896,0,0,0,0,0
31.887,6,38,9030,21,114,1594,317,1799,17,594,353,1642,7231
60.848,6,28,7217,13,155,5070,267,1306,15,482,4345,1997,5911
1794.326,6,356,22520,208,69,8668,69,12460,148,69,12205,69,10060
5.8,6,42,7405,22,218,276,314,3503,20,516,291,1179,3902
2.869,17,3,468,3,128,1434,128,468,0,0,0,0,0
1773.214,6,180,15480,120,69,14900,69,8940,60,69,30048,69,6540
0.162,6,12,1938,7,209,27,209,581,5,544,39,891,1357
5.102,6,41,7349,20,218,268,314,3423,21,440,242,1152,3926
1774.219,17,142,11360,71,48,25345,48,5396,71,56,25345,56,5964
1772.682,6,180,15480,120,69,14896,69,8940,60,69,30039,69,6540
20.119,6,18,3026,10,229,2235,517,1457,8,381,2871,499,1569
1582.113,6,24,3624,16,241,105474,241,2568,8,92,225987,92,1056
1798.994,1,16,896,16,28,119932,28,896,0,0,0,0,0
1776.898,17,142,11360,71,48,25383,48,5396,71,56,25383,56,5964
1787.232,6,422,25229,210,69,8551,69,12540,212,34,8470,48,12689
1791.857,17,138,11016,72,48,25237,48,5472,66,56,27566,56,5544
1681.207,1,15,840,15,28,120086,28,840,0,0,0,0,0
1782.33,6,365,23156,211,69,8487,69,12856,154,69,11649,69,10300
188.671,17,4,352,2,60,188670,60,176,2,60,188670,60,176
87.244,17,4,304,2,48,87237,48,152,2,48,87236,48,152
1715.354,1,8,448,8,28,245050,28,448,0,0,0,0,0
0.166,17,4,588,2,48,144,48,152,2,190,146,308,436
1783.109,17,140,11200,70,48,25841,48,5320,70,56,25841,56,5880
1771.578,6,99,9306,66,66,27255,66,5610,33,60,55358,60,3696
0.86,6,20,5948,11,281,86,544,1288,9,716,95,1420,4660
1770.246,6,79,4160,40,26,45389,26,2106,39,26,46584,26,2054
1411.884,17,26,5945,13,34,117656,37,810,13,367,117656,463,5135
29.323,6,32,8952,14,158,2255,267,1357,18,624,1722,1400,7595
0.764,6,10,1687,7,100,127,100,384,3,1179,256,1179,1303
280.275,6,28,7352,12,158,25479,267,1277,16,603,18683,1400,6075
1.314,6,48,18200,26,882,52,1460,12544,22,433,54,1460,5656
1786.021,6,104,8376,68,65,26657,65,4930,36,59,51026,59,3446
0.586,17,4,624,2,64,584,64,184,2,192,468,192,440
0.616,6,7,371,3,0,308,0,152,4,7,95,7,219
316.994,6,82,20113,40,309,8128,1360,10314,42,337,7728,1360,9799
127.438,6,25,10541,12,666,82,1440,3177,13,976,10605,1440,7364
0.399,6,3,144,2,0,399,0,92,1,0,0,0,52
1797.986,17,427,46987,199,140,9080,1350,33595,228,30,7905,60,13392
46.804,6,3,617,3,165,23402,241,617,0,0,0,0,0
0.307,6,22,7342,12,335,27,668,1974,10,1210,33,2816,5368
1795.893,17,80,3354,79,14,23024,14,3318,1,8,0,8,36
0.328,6,23,7307,13,318,27,600,1958,10,964,35,1471,5349
4.7,17,2,656,2,300,4700,300,656,0,0,0,0,0
1755.811,1,8,448,8,28,250830,28,448,0,0,0,0,0
1.115,6,119,87834,53,131,21,232,2649,66,1353,16,1430,85185
1750.718,17,12,498,11,14,175071,14,462,1,8,0,8,36
280.323,6,30,7432,13,158,23360,267,1317,17,543,17517,1400,6115
1796.865,17,448,39896,403,35,4469,288,25676,45,288,40020,288,14220
0.386,6,24,6015,13,108,32,147,959,11,768,38,2602,5056
121.112,6,23,944,8,0,6972,0,324,15,0,8650,0,620
0.55,17,3,451,2,39,535,39,134,1,289,0,289,317
1772.29,6,180,15480,120,69,14893,69,8940,60,69,30034,69,6540
28.0,17,16,1408,8,48,3998,48,608,8,72,3998,72,800
1740.555,17,29,19517,29,645,62162,645,19517,0,0,0,0,0
1.985,17,3,180,3,32,992,32,180,0,0,0,0,0
1387.076,6,140,12017,92,69,15242,69,6923,48,69,29512,69,5094
1744.715,6,108,8120,67,38,26435,205,4746,41,32,43613,98,3374
0.05,17,2,912,1,308,0,308,336,1,548,0,548,576
0.049,17,2,334,1,32,0,32,60,1,246,0,246,274
0.993,6,27,5956,13,161,82,267,1491,14,650,70,1414,4465
1700.473,17,12,498,11,14,170047,14,462,1,8,0,8,36
0.164,6,25,7216,13,155,13,267,1301,12,678,14,2800,5915
300.904,6,49,13896,26,881,12036,1460,8174,23,399,592,1460,5722
0.406,6,10,968,5,256,99,256,460,5,304,98,304,508
1770.126,6,99,9240,66,65,27232,65,5577,33,59,55312,59,3663
4.167,6,3,509,1,0,0,0,40,2,389,4155,389,469
1779.193,6,933,138288,458,195,3892,1460,99666,475,175,3753,1062,38622
1746.114,6,95,7203,63,38,28163,205,4476,32,33,56313,98,2727
8.335,6,79,24381,39,550,219,1152,18640,40,459,207,1179,5741
1797.249,6,368,23276,212,69,8517,69,12896,156,69,11593,69,10380
1784.213,1,342,28728,342,56,5232,56,28728,0,0,0,0,0
0.061,17,4,352,2,37,0,37,130,2,83,12,89,222
0.41,6,20,7151,12,318,37,600,1906,8,964,53,1471,5245
1.054,17,17,6122,8,397,150,1350,3403,9,274,127,1350,2719
105.497,6,23,10005,11,380,64,832,1613,12,987,9578,1360,8392
0.071,6,13,3980,7,88,11,88,388,6,1670,14,1880,3592
1.239,6,49,19765,27,927,47,1360,14109,22,433,50,1360,5656
0.031,17,2,158,1,34,0,34,62,1,68,0,68,96
1791.212,17,378,61468,378,134,4751,363,61468,0,0,0,0,0
1671.306,17,415,51683,197,161,8527,1350,37403,218,37,7690,1350,14280
1795.087,17,80,3354,79,14,23013,14,3318,1,8,0,8,36
1786.859,6,363,23007,210,69,8549,69,12747,153,69,11755,69,10260
1744.202,6,95,7203,63,38,28132,205,4476,32,33,56257,98,2727
12.415,6,16,2358,9,210,1550,210,908,7,545,2052,904,1450
1.102,17,4,560,2,64,966,64,184,2,160,777,160,376
1786.607,6,102,8364,68,66,26665,66,4964,34,60,54136,60,3400
265.914,17,4,352,2,60,265912,60,176,2,60,265913,60,176
121.74,6,45,8595,19,131,6763,267,1822,26,317,4863,1460,6773
0.013,17,2,570,1,30,0,30,58,1,484,0,484,512
1792.958,1,58,4872,58,56,31455,56,4872,0,0,0,0,0
3.476,6,2,88,2,0,0,0,88,0,0,0,0,0
0.278,17,2,152,1,48,0,48,76,1,48,0,48,76
2.1,1,2,212,2,78,2100,78,212,0,0,0,0,0
0.18,17,2,1918,2,931,180,931,1918,0,0,0,0,0
10.954,6,18,4214,10,275,1217,275,958,8,974,881,1414,3256
1792.972,17,290,67364,290,204,6204,422,67364,0,0,0,0,0
1.705,6,14,2351,8,188,243,245,700,6,703,288,1152,1651
1683.627,17,14,1036,7,30,280593,30,406,7,62,280582,62,630
1778.424,17,142,11360,71,48,25405,48,5396,71,56,25405,56,5964
0.019,17,2,724,1,40,0,40,68,1,628,0,628,656
23.996,1,4,224,4,28,7998,28,224,0,0,0,0,0
7.548,6,15,1073,7,222,1256,222,506,8,231,1076,231,567
11.802,17,8,608,8,48,1686,48,608,0,0,0,0,0
620.905,6,75,12952,43,129,14783,876,5221,32,288,20028,4029,7731
0.029,17,2,167,1,39,0,39,67,1,72,0,72,100
5.234,6,21,6984,13,323,436,525,1978,8,1142,719,1820,5006
240.212,6,56,18572,29,783,8578,1402,15612,27,193,9238,580,2960
4.041,17,6,1337,3,39,2013,39,201,3,350,2014,380,1136
1785.617,17,87,3648,86,14,21007,14,3612,1,8,0,8,36
1.42,6,43,10105,23,440,64,1360,4484,20,437,64,2715,5621
1789.344,17,142,11360,71,48,25561,48,5396,71,56,25561,56,5964
4.855,6,39,7269,19,218,269,314,3383,20,513,240,1179,3886
277.382,17,4,240,2,32,277381,32,120,2,32,277381,32,120
17.671,6,14,2243,8,210,2523,210,844,6,545,3532,905,1399
0.472,17,2,152,1,48,0,48,76,1,48,0,48,76
1743.735,1,79,6636,0,0,0,0,0,79,56,22355,56,6636
69.462,17,4,352,2,60,69461,60,176,2,60,69461,60,176
42.209,1,16,1664,0,0,0,0,0,16,76,2813,76,1664
5.979,17,3,1008,3,308,2989,308,1008,0,0,0,0,0
1.959,6,29,9050,17,371,122,845,1797,12,846,168,1380,7253
0.488,6,21,5000,11,137,48,267,1132,10,692,48,1467,3868
0.197,17,2,162,1,45,0,45,73,1,61,0,61,89
5.268,6,40,7309,20,218,277,314,3423,20,513,262,1179,3886
4.948,6,39,7269,19,218,274,314,3383,20,513,245,1179,3886
17.627,6,2381,2230096,1461,1441,11,1448,2171800,920,776,18,1448,58296
1790.114,6,363,25352,211,100,8524,469,14856,152,69,11855,69,10496
280.474,6,28,7352,12,158,25497,267,1277,16,603,18696,1400,6075
1744.676,2,16,512,16,8,116311,8,512,0,0,0,0,0
1793.71,6,358,22669,209,69,8623,69,12569,149,69,12119,69,10100
15.928,6,28,5036,13,165,1327,722,1829,15,342,1110,1448,3207
240.513,6,59,17749,30,779,8290,1418,14824,29,176,8588,580,2925
0.271,17,2,152,1,48,0,48,76,1,48,0,48,76
893.299,6,81,10183,43,101,21267,517,3488,38,313,24141,1418,6695
339.782,1,7,1000,7,114,56630,207,1000,0,0,0,0,0
123.41,1,6,336,6,28,24682,28,336,0,0,0,0,0
1796.242,17,87,3648,86,14,21132,14,3612,1,8,0,8,36
8.905,6,4,240,4,0,0,0,240,0,0,0,0,0
280.526,6,30,7432,13,158,23377,267,1317,17,603,17530,2076,6115
0.024,17,2,251,1,36,0,36,64,1,159,0,159,187
0.135,6,2,100,1,0,0,0,60,1,0,0,0,40
283.644,17,4,304,2,48,283643,64,152,2,48,283643,64,152
368.468,6,23,1511,14,177,28343,177,925,9,110,9157,110,586
15.167,17,15,8551,6,570,3027,1350,3589,9,523,1891,1350,4962
61.712,6,12,1000,6,226,12342,226,570,6,110,12250,110,430
3.349,17,21,15135,11,846,334,1350,9615,10,524,366,1350,5520
57.664,6,2,3000,2,1460,57664,1460,3000,0,0,0,0,0
2.054,17,4,580,2,40,2033,40,136,2,194,2007,194,444
1772.281,6,182,15629,121,69,14769,69,8980,61,69,29530,69,6649
294.716,1,4,224,4,28,98238,28,224,0,0,0,0,0
115.869,17,4,1344,4,308,38623,308,1344,0,0,0,0,0
1.632,6,14,2351,8,188,233,245,700,6,703,277,1152,1651
18.112,17,4,352,2,60,18110,60,176,2,60,18111,60,176
1.499,6,26,7495,16,302,99,693,2761,10,721,164,1452,4734
1779.854,17,140,11200,70,48,25794,48,5320,70,56,25794,56,5880
1773.43,6,180,15480,120,69,14902,69,8940,60,69,30049,69,6540
0.147,17,5,1696,5,311,36,354,1696,0,0,0,0,0
0.049,1,2,112,2,28,49,28,112,0,0,0,0,0
33.727,6,31,5094,15,154,2409,722,1859,16,342,2235,1448,3235
51.084,6,11,1003,6,332,10216,332,652,5,83,12763,83,351
160.053,1,8,448,8,28,22864,28,448,0,0,0,0,0
61.309,6,28,7217,13,155,5109,267,1306,15,482,4378,1997,5911
10.99,6,20,4442,11,275,1099,275,998,9,768,770,1440,3444
3.112,6,160,115940,81,179,38,179,6107,79,1372,39,2736,109833
20.31,6,20,2484,10,189,2256,517,1298,10,323,2251,499,1186
240.626,6,60,19671,31,776,8018,1418,16367,29,214,8591,580,3304
8.074,6,28,7217,13,155,672,267,1306,15,482,575,1420,5911
792.943,1,30,1680,30,28,27342,28,1680,0,0,0,0,0
0.008,17,2,787,2,365,8,373,787,0,0,0,0,0
2.069,17,6,1674,3,32,763,32,180,3,470,0,470,1494
0.373,6,20,7151,11,318,36,600,1854,9,964,45,1471,5297
1.531,6,18,1423,9,222,190,222,816,9,231,190,231,607
0.26,17,2,144,1,36,0,36,64,1,52,0,52,80
19.234,17,4,824,2,48,19220,48,152,2,308,19221,308,672
12.068,17,4,824,2,48,12037,48,152,2,308,12044,308,672
240.297,6,59,18549,28,775,8898,1418,15416,31,189,8009,580,3133
1.222,1,10,840,10,56,135,56,840,0,0,0,0,0
10.891,6,81,24461,41,550,272,1152,18720,40,459,272,1179,5741
1795.587,17,448,39896,403,35,4466,288,25676,45,288,40016,288,14220
1772.009,6,180,15480,120,69,14890,69,8940,60,69,30032,69,6540
4.248,6,38,7245,19,218,236,314,3383,19,516,217,1179,3862
1792.239,17,180,14040,180,50,10012,50,14040,0,0,0,0,0
4.265,6,40,7309,19,218,236,314,3383,21,440,200,1152,3926
126.014,2,2,64,2,8,126014,8,64,0,0,0,0,0
172.533,6,141,111709,92,1299,1895,1408,99621,49,680,2211,2439,12088
0.668,6,10,1671,6,552,133,948,1348,4,159,222,159,323
1.316,6,47,20126,28,895,48,1360,14590,19,476,62,2715,5536
15.123,17,11,4855,5,504,3771,1350,2664,6,337,3017,1350,2191
2.002,1,2,208,2,76,2002,76,208,0,0,0,0,0
1.424,6,46,17176,25,877,59,1460,11560,21,476,60,2920,5616
3.168,6,47,19360,27,905,121,1460,13784,20,476,144,2615,5576
1.737,6,13,2311,8,188,248,245,700,5,1407,371,1407,1611
35.994,17,20,1760,10,48,3998,48,760,10,72,3998,72,1000
0.03,17,2,152,1,48,0,48,76,1,48,0,48,76
1.456,6,47,18771,26,929,58,1440,13155,21,433,62,1440,5616
77.197,6,9,515,5,43,19299,43,299,4,0,25731,0,216
1791.983,17,142,11360,71,48,25599,48,5396,71,56,25599,56,5964
1.668,6,25,8761,15,284,119,586,1458,10,985,165,1420,7303
0.635,17,4,624,2,64,634,64,184,2,192,520,192,440
28.686,6,30,7451,11,165,2868,267,1109,19,371,1593,1997,6342
64.659,6,18,1813,8,177,134,177,955,10,110,7165,110,858
1798.384,1,137,7672,137,28,13223,28,7672,0,0,0,0,0
11.865,6,24,8413,13,275,988,275,1078,11,1147,954,2840,7335
1786.949,6,104,8308,68,64,26670,64,4896,36,58,51052,58,3412
1772.502,6,205,22439,131,75,13634,267,10097,74,133,24274,1997,12342
1783.223,6,102,8364,68,66,26615,66,4964,34,60,54031,60,3400
0.164,6,27,7296,13,155,13,267,1301,14,603,12,2800,5995
11.434,6,1869,1573070,1108,1363,10,1380,1537608,761,421,14,1923,35462
0.877,6,28,11875,16,511,58,1360,3227,12,1019,64,2561,8648
3.159,6,51,26883,26,965,126,1360,11691,25,1181,124,1477,15192
1.196,6,23,7976,11,164,101,267,1260,12,1014,92,2411,6716
1.2,6,24,8966,12,254,109,658,1517,12,993,92,1360,7449
0.321,6,26,8991,13,247,26,624,1672,13,947,24,1438,7319
0.292,6,9,1002,5,213,73,213,417,4,421,80,421,585
0.432,6,3,199,1,31,0,31,83,2,0,432,0,116
0.017,17,2,422,1,72,0,72,100,1,294,0,294,322
0.226,6,4,263,1,31,0,31,83,3,0,113,0,180
2.019,17,3,1004,3,306,1009,308,1004,0,0,0,0,0
699.692,6,74,8799,38,94,16133,722,3691,36,129,19986,1448,5108
1772.388,6,180,15480,120,69,14894,69,8940,60,69,30035,69,6540
1.381,6,37,8238,19,321,76,1164,2742,18,476,70,2715,5496
1788.052,6,244,46664,152,483,11841,483,36892,92,83,19648,83,9772
1772.299,6,181,15589,120,69,14893,69,8940,61,69,29534,69,6649
1621.356,1,8,448,8,28,231622,28,448,0,0,0,0,0
1448.725,1,22,1232,22,28,68986,28,1232,0,0,0,0,0
1089.596,6,83,10912,50,91,22234,500,4104,33,203,34047,1420,6808
0.781,6,28,5967,13,156,65,267,1462,15,650,50,1304,4505
0.494,6,21,7217,12,318,44,599,1905,9,967,60,1906,5312
1768.381,6,149,9325,81,48,22104,208,5706,68,31,26390,31,3619
23.627,6,23,3310,14,183,1817,517,1681,9,381,2517,499,1629
1751.338,6,95,7203,63,38,28247,205,4476,32,33,56482,98,2727
196.533,6,32,8952,14,158,15117,267,1357,18,624,11556,1400,7595
10.036,6,1519,1380981,977,1362,10,1420,1354950,542,475,18,1883,26031
1.219,6,10,1687,7,100,203,100,384,3,1179,486,1179,1303
19.521,17,27,9563,12,217,1771,1350,2944,15,413,1392,1350,6619
69.087,6,27,7177,13,155,5757,267,1306,14,530,5313,3417,5871
1792.404,1,58,4872,0,0,0,0,0,58,56,31445,56,4872
661.83,2,6,192,6,8,132366,8,192,0,0,0,0,0
20.755,6,14,2185,8,324,2965,585,1073,6,396,4147,580,1112
0.972,17,2,677,1,300,0,300,328,1,321,0,321,349
5.738,6,15,3217,5,92,1434,92,348,10,579,582,1448,2869
207.513,6,36,12050,16,143,13834,267,1506,20,749,10919,1781,10544
240.837,17,4,240,2,32,240836,32,120,2,32,240836,32,120
240.302,6,46,9112,24,519,10447,1402,5930,22,225,11442,617,3182
62.929,6,34,8282,13,155,5244,267,1924,21,393,3143,1460,6358
280.213,6,29,7392,13,158,23351,267,1317,16,603,18677,2036,6075
421.182,2,4,128,4,8,140394,8,128,0,0,0,0,0
61.657,6,50,11642,25,615,576,921,4170,25,430,2563,3488,7472
0.15,6,16,2993,9,282,18,531,1606,7,338,23,777,1387
237.02,6,15,3750,15,330,16930,330,3750,0,0,0,0,0
1783.802,6,354,22440,207,69,8659,69,12420,147,69,12217,69,10020
0.277,17,2,144,1,36,0,36,64,1,52,0,52,80
1797.368,17,449,39928,404,35,4459,288,25708,45,288,40018,288,14220
849.316,1,8,652,8,53,121330,78,652,0,0,0,0,0
11.115,17,17,18044,17,1033,694,1450,18044,0,0,0,0,0
365.685,6,18,1242,14,180,28129,180,916,4,110,20055,110,326
456.091,6,91,30805,45,592,10365,1408,11254,46,745,10135,1408,19551
0.012,17,2,437,1,52,0,52,80,1,329,0,329,357
366.32,6,24,1563,15,177,26165,177,977,9,110,9130,110,586
12.802,6,2037,1751219,1234,1363,10,1380,1714857,803,421,15,1923,36362
615.981,6,184,42401,90,446,6921,1460,28402,94,162,6621,3089,13999
0.871,17,22,15211,10,678,95,1350,7062,12,651,75,1350,8149
126.698,6,15,3211,7,92,21116,92,452,8,389,18051,1408,2759
0.464,6,12,1975,6,288,86,288,548,6,293,52,434,1427
1798.906,6,356,22520,208,69,8690,69,12460,148,69,12237,69,10060
4.308,6,23,4490,12,213,391,597,1701,11,441,415,1408,2789
1776.636,17,140,11200,70,48,25748,48,5320,70,56,25748,56,5880
122.489,6,183,181057,58,634,2147,1448,6829,125,1445,986,2896,174228
0.468,6,13,1693,7,288,78,288,588,6,284,50,434,1105
297.242,6,24,3377,7,324,126,585,1033,17,132,18577,580,2344
1756.427,1,65,3640,65,28,27444,28,3640,0,0,0,0,0
61.299,6,37,15878,22,794,2919,1408,9100,15,665,4360,1408,6778
7.091,6,1525,1399648,961,1379,7,1408,1365656,564,931,12,2801,33992
1.481,17,34,14105,14,413,111,1350,6174,20,368,76,1350,7931
0.049,17,2,136,1,32,0,32,60,1,48,0,48,76
246.994,6,106,86942,53,346,41,392,6929,53,1884,4749,7381,80013
240.216,6,55,15972,30,671,8283,1402,12975,25,211,10008,580,2997
0.019,17,2,672,2,308,19,308,672,0,0,0,0,0
0.018,6,2,92,1,0,0,0,40,1,0,0,0,52
0.178,6,43,19879,25,1070,7,1420,14938,18,467,10,1883,4941
0.02,6,2,100,1,0,0,0,60,1,0,0,0,40
0.442,6,21,5921,11,275,44,517,1681,10,742,46,1448,4240
1789.812,6,361,24383,211,87,8522,1189,13769,150,74,12011,405,10614
6.019,17,12,2571,6,45,1201,45,438,6,327,1195,339,2133
0.183,6,46,21625,27,1036,7,1420,16644,19,467,9,1883,4981
0.996,6,25,6535,14,322,76,949,2175,11,979,99,1731,4360
34.684,6,31,8912,14,158,2668,267,1357,17,687,2163,1781,7555
256.603,6,29,7089,14,229,152,498,1712,15,397,18322,1420,5377
0.1,17,2,144,1,36,0,36,64,1,52,0,52,80
1781.76,6,376,26148,216,98,8287,469,15332,160,69,11206,69,10816
1073.776,1,14,784,14,28,82598,28,784,0,0,0,0,0
247.835,6,41,8291,21,449,12391,1418,5596,20,205,13043,580,2695
2.643,17,4,352,2,60,2642,60,176,2,60,2642,60,176
316.901,6,101,35621,53,577,6094,1360,24672,48,322,6739,3289,10949
377.694,2,3,96,3,8,188847,8,96,0,0,0,0,0
0.089,17,4,352,2,37,25,37,130,2,83,65,89,222
0.245,6,9,1050,5,261,61,261,465,4,421,57,421,585
0.975,17,4,768,2,39,971,39,134,2,289,726,289,634
7.341,17,4,1566,4,363,2447,371,1566,0,0,0,0,0
978.681,17,192,14592,192,48,5123,48,14592,0,0,0,0,0
1786.921,6,416,24920,208,69,8632,69,12460,208,34,8632,64,12460
1783.81,6,386,23720,209,69,8576,69,12500,177,46,10135,69,11220
1787.623,17,87,3648,86,14,21030,14,3612,1,8,0,8,36
1786.566,6,102,8296,68,65,26665,65,4930,34,59,54135,59,3366
1.24,6,25,8056,12,164,96,267,1288,13,869,88,1440,6768
25.904,6,36,8297,19,345,1439,721,1864,17,478,535,2720,6433
1680.47,1,15,840,15,28,120033,28,840,0,0,0,0,0
1.391,6,47,19574,26,920,55,1460,13958,21,433,60,1460,5616
300.735,6,44,8997,18,308,17682,889,1987,26,297,12024,1360,7010
0.181,6,27,7296,13,155,15,267,1301,14,603,12,2036,5995
1799.69,17,142,11360,71,48,25709,48,5396,71,56,25709,56,5964
187.128,6,27,6663,13,262,15590,517,1472,14,744,14391,1418,5191
112.572,6,45,10254,22,681,884,1360,4377,23,309,5108,2667,5877
150.603,1,6,336,6,28,30120,28,336,0,0,0,0,0
1738.988,1,56,4704,0,0,0,0,0,56,56,31617,56,4704
2.964,6,2,88,2,0,0,0,88,0,0,0,0,0
2.795,6,38,22032,20,775,147,1360,6261,18,1253,156,1680,15771
58.266,17,6,528,3,48,29128,48,228,3,72,29128,72,300
400.898,17,56,4634,52,30,7860,37,3030,4,373,113713,463,1604
1795.354,17,80,3354,79,14,23017,14,3318,1,8,0,8,36
30.293,6,41,8305,22,218,1434,417,2519,19,385,1672,1460,5786
1463.772,17,14,3648,7,31,243959,37,413,7,434,243959,463,3235
1215.907,6,248,26604,92,81,13361,658,8072,156,105,7790,1360,18532
32.116,6,9,396,2,0,3482,0,88,7,0,5330,0,308
10.963,6,20,4442,11,275,1096,275,998,9,768,768,1440,3444
133.917,6,19,2153,10,304,14879,304,1428,9,83,16738,83,725
0.005,17,8,1670,8,180,0,219,1670,0,0,0,0,0
0.106,17,4,284,2,32,93,32,120,2,54,14,60,164
0.031,6,2,92,1,0,0,0,40,1,0,0,0,52
18.27,6,17,9615,7,275,3045,275,563,10,1440,1379,1440,9052
1772.208,6,180,15480,120,69,14892,69,8940,60,69,30036,69,6540
2.18,17,6,552,3,32,771,32,180,3,96,0,96,372
241.272,6,55,14438,27,661,9278,1368,11345,28,203,8934,580,3093
1747.708,6,98,7390,63,38,28188,205,4476,35,33,51391,98,2914
0.014,6,2,80,1,0,0,0,40,1,0,0,0,40
0.0,17,3,1066,3,327,0,355,1066,0,0,0,0,0
1729.692,1,76,4256,76,28,23062,28,4256,0,0,0,0,0
0.267,6,27,9072,13,247,22,624,1672,14,952,20,2816,7400
7.4,6,1250,1117276,762,1389,9,1408,1087212,488,776,14,1408,30064
2.443,6,12,1323,6,283,454,283,886,6,105,454,105,437
1774.747,6,182,15629,121,69,14789,69,8980,61,69,29573,69,6649
11.07,6,869,761868,504,1428,21,1448,736124,365,776,29,1448,25744
161.028,6,39,8136,15,142,11501,267,1469,24,316,7000,1420,6667
1770.957,6,107,9656,66,65,27245,65,5577,41,59,44271,59,4079
1.295,6,10,1687,7,100,215,100,384,3,1179,515,1179,1303
2.128,6,13,2311,8,188,304,245,700,5,1407,466,1407,1611
107.367,6,32,8952,14,158,8259,267,1357,18,624,6313,1400,7595
17.86,6,9,515,0,0,0,0,0,9,31,2232,31,515
259.293,6,77,55770,50,1216,5291,1368,47632,27,840,2383,2736,8138
301.813,6,46,16282,27,920,11608,1372,8822,19,430,3793,2688,7460
1789.759,1,318,26712,318,56,5645,56,26712,0,0,0,0,0
11.731,17,4,824,2,48,11713,48,152,2,308,11718,308,672
131.903,6,20,9097,11,500,95,1194,1972,9,1350,16465,3639,7125
0.075,6,3,151,2,31,0,31,111,1,0,0,0,40
0.477,6,13,1693,6,288,92,288,548,7,426,44,434,1145
1796.613,6,358,22669,209,69,8637,69,12569,149,69,12139,69,10100
0.525,6,9,526,5,42,131,42,310,4,0,173,0,216
0.138,17,2,212,1,46,0,46,74,1,110,0,110,138
64.413,6,23,7741,10,261,107,467,1313,13,522,5350,1368,6428
16.864,17,3,228,3,48,8432,48,228,0,0,0,0,0
1.544,6,46,18980,27,880,59,1360,13444,19,476,73,2715,5536
1798.776,1,84,4704,84,28,21672,28,4704,0,0,0,0,0
57.443,6,68,24904,33,849,1795,1440,14167,35,538,1684,1440,10737
4.939,6,39,7269,20,218,259,314,3423,19,513,260,1179,3846
0.199,1,2,112,2,28,199,28,112,0,0,0,0,0
1795.578,17,449,39928,404,35,4455,288,25708,45,288,40016,288,14220
4.099,17,5,295,5,31,1024,31,295,0,0,0,0,0
1771.775,17,46,15440,46,307,39372,308,15440,0,0,0,0,0
0.313,6,27,9059,13,252,26,647,1704,14,945,23,1408,7355
5.108,6,13,2187,7,209,851,209,790,6,544,1021,891,1397
2.136,2,2,64,2,8,2136,8,64,0,0,0,0,0
0.347,6,25,6123,12,181,31,537,1526,13,559,27,1448,4597
0.486,17,3,451,2,39,107,39,134,1,289,0,289,317
5.405,6,44,8369,22,227,257,314,4062,22,489,245,1179,4307
1786.65,6,102,8364,68,66,26666,66,4964,34,60,54138,60,3400
6.014,17,4,332,2,47,6010,47,150,2,63,6010,63,182
4.088,17,5,290,5,30,1022,30,290,0,0,0,0,0
1786.393,6,102,8364,68,66,26662,66,4964,34,60,54129,60,3400
273.129,1,4,224,4,28,91043,28,224,0,0,0,0,0
1790.818,17,144,11520,72,48,25222,48,5472,72,56,25222,56,6048
1795.623,17,449,39928,404,35,4455,288,25708,45,288,40019,288,14220
368.452,6,27,1767,18,177,21673,177,1181,9,110,8915,110,586
5.03,17,3,208,2,36,5003,36,128,1,52,0,52,80
6.09,17,3,228,2,48,5954,48,152,1,48,0,48,76
244.996,6,83,21813,40,543,6276,1418,13503,43,356,5828,1418,8310
1780.409,6,104,8376,68,65,26573,65,4930,36,59,50866,59,3446
2.441,6,8,349,3,0,109,0,124,5,7,558,7,225
1788.788,6,365,23087,211,69,8518,69,12787,154,69,11690,69,10300
8.694,6,34,8263,18,372,511,802,1869,16,522,567,3488,6394
1786.021,6,102,8296,68,65,26657,65,4930,34,59,54119,59,3366
0.541,17,2,476,1,39,0,39,67,1,381,0,381,409
23.711,17,4,1313,4,300,7903,301,1313,0,0,0,0,0
1797.799,17,449,39928,404,35,4461,288,25708,45,288,40019,288,14220
20.18,6,41,10713,13,360,1681,766,1685,28,343,618,1360,9028
1110.727,17,220,16720,220,48,5071,48,16720,0,0,0,0,0
0.5,17,3,451,2,39,461,39,134,1,289,0,289,317
6.366,6,45,8425,23,227,289,314,4102,22,491,290,1179,4323
0.075,6,9,1346,5,145,18,145,349,4,833,21,833,997
1.341,6,51,21169,28,954,49,1460,15473,23,433,52,1460,5696
1794.318,17,162,15632,81,79,22428,952,8668,81,57,22428,72,6964
1781.764,6,374,25999,216,98,8287,469,15263,158,69,11348,69,10736
4.9,6,34,6185,18,206,288,314,2784,16,551,309,1179,3401
42.768,17,6,528,3,60,21383,60,264,3,60,21383,60,264
1779.851,6,354,22440,207,69,8640,69,12420,147,69,12190,69,10020
9.833,6,81,25010,41,568,245,1152,19269,40,413,245,1152,5741
24.498,2,2,64,2,8,24498,8,64,0,0,0,0,0
0.368,6,10,968,5,256,90,256,460,5,304,90,304,508
1778.178,1,68,5712,68,56,26539,56,5712,0,0,0,0,0
1792.157,6,356,22520,208,69,8657,69,12460,148,69,12191,69,10060
1785.504,6,356,22520,208,69,8625,69,12460,148,69,12146,69,10060
111.296,6,23,8276,11,511,94,1194,2029,12,822,10101,1360,6247
18.734,6,23,6777,6,154,3746,267,712,17,447,1159,1460,6065
41.367,17,3,228,3,48,20683,48,228,0,0,0,0,0
0.041,17,4,288,2,33,0,33,122,2,55,34,61,166
9.139,6,32,8296,17,410,571,917,1944,15,574,638,4848,6352
240.523,6,53,17783,28,796,8905,1418,14998,25,184,10018,580,2785
126.287,17,4,352,2,60,126286,60,176,2,60,126286,60,176
240.175,6,58,18016,32,782,7747,1402,14992,26,184,9606,580,3024
1.385,6,47,18986,26,946,55,1460,13370,21,433,60,1460,5616
1758.943,6,101,7918,65,45,27483,205,4850,36,35,50244,98,3068
0.174,17,2,180,1,30,0,30,58,1,94,0,94,122
168.526,6,26,6429,15,186,12037,501,1535,11,494,11252,1420,4894
1795.01,17,1614,122478,887,40,2025,41,60903,727,56,2472,57,61575
3.86,17,4,352,2,48,3850,48,152,2,72,3849,72,200
28.406,6,37,6172,18,126,1670,517,2486,19,440,1531,499,3686
317.262,6,70,18694,36,339,9064,1460,9615,34,367,9609,4549,9079
1736.889,1,56,4704,0,0,0,0,0,56,56,31579,56,4704
120.4,6,21,8279,11,525,81,1237,2048,10,969,13358,1791,6231
94.03,6,25,6318,9,272,133,516,1180,16,345,6262,1452,5138
221.57,6,62,14126,34,181,6707,267,2860,28,596,8203,2036,11266
1739.326,6,87,6322,58,31,30514,31,3915,29,31,62118,31,2407
1783.988,1,192,20352,192,78,9340,78,20352,0,0,0,0,0
0.139,17,2,152,1,48,0,48,76,1,48,0,48,76
0.05,17,2,390,1,48,0,48,76,1,286,0,286,314
0.802,6,105,87452,59,131,13,232,2889,46,2017,17,5440,84563
6.012,17,4,304,3,48,2976,48,228,1,48,0,48,76
207.822,1,2,235,2,89,207822,91,235,0,0,0,0,0
1749.714,6,99,7411,63,38,28221,205,4476,36,33,49984,98,2935
300.624,6,81,16833,39,337,7911,1108,6786,42,373,7332,2348,10047
4.022,6,40,7309,21,218,201,314,3463,19,513,209,1179,3846
3.723,17,5,556,4,64,1232,64,368,1,160,0,160,188
301.693,6,51,19034,29,917,10774,1360,13123,22,386,453,2667,5911
1619.64,1,7,742,7,78,269940,78,742,0,0,0,0,0
7.817,17,3,228,3,48,3908,48,228,0,0,0,0,0
5.038,17,3,208,2,36,5006,36,128,1,52,0,52,80
0.007,17,2,393,1,32,0,32,60,1,305,0,305,333
0.128,17,4,1375,4,315,42,354,1375,0,0,0,0,0
3.28,6,20,6924,11,185,328,275,1001,9,794,257,2760,5923
3.837,6,16,3247,9,49,479,92,563,7,463,36,1408,2684
0.289,6,28,9152,13,252,24,647,1716,15,831,20,1408,7436
24.314,6,24,6293,9,288,3024,288,988,15,583,1723,853,5305
0.595,6,20,7049,12,164,54,267,1124,8,1833,73,3819,5925
1770.314,6,99,9306,66,66,27235,66,5610,33,60,55319,60,3696
358.139,6,66,29210,34,169,10852,1130,3812,32,878,2895,1553,25398
0.011,6,11,3410,6,75,2,75,395,5,2747,2,2747,3015
1.204,6,23,7952,12,164,93,267,1288,11,1216,102,3819,6664
280.329,6,30,7432,13,158,23360,267,1317,17,543,17514,1400,6115
1793.61,17,144,11520,72,48,25257,48,5472,72,56,25256,56,6048
1784.991,6,83,4885,41,29,44624,36,2220,42,234,43534,443,2665
0.615,6,10,861,5,222,150,222,426,5,231,150,231,435
0.369,6,82,54811,49,1242,7,1432,49200,33,427,10,1432,5611
1792.112,17,180,14040,180,50,10011,50,14040,0,0,0,0,0
84.991,6,41,11241,17,287,1961,1189,2991,24,485,3694,1420,8250
300.846,6,51,10578,25,433,12535,910,3270,26,312,605,1460,7308
1792.726,17,142,11360,71,48,25610,48,5396,71,56,25610,56,5964
41.797,17,6,360,3,32,20898,32,180,3,32,20898,32,180
1799.144,17,445,39800,400,35,4509,288,25580,45,288,40020,288,14220
2.031,17,3,174,3,30,1015,30,174,0,0,0,0,0
6.87,6,47,8489,24,211,298,314,4142,23,489,287,1179,4347
0.085,17,2,672,2,308,85,308,672,0,0,0,0,0
1772.127,6,180,15480,120,69,14891,69,8940,60,69,30033,69,6540
346.73,6,19,6566,3,106,28,106,234,16,406,23114,2006,6332
0.537,6,8,1303,4,145,179,145,309,4,830,144,830,994
1751.074,6,120,8683,73,31,24320,31,5008,47,31,38066,31,3675
0.444,6,26,8890,13,232,37,569,1614,13,941,35,1438,7276
0.007,6,2,149,1,69,0,69,109,1,0,0,0,40
885.941,1,8,448,8,28,126563,28,448,0,0,0,0,0
1786.331,6,155,19721,92,302,19629,302,13864,63,83,28811,83,5857
12.187,6,15,3756,4,92,4062,92,296,11,320,1195,1368,3460
5.992,6,17,2620,9,210,731,210,1106,8,545,855,904,1514
615.952,6,151,19287,63,103,9934,621,5988,88,152,7078,4080,13299
10.475,6,1789,1635994,1133,1366,9,1408,1597218,656,931,15,2816,38776
1.25,6,41,9968,21,440,62,1360,4392,20,433,56,1360,5576
16.09,6,1070,987264,700,1340,22,1368,961008,370,776,43,2736,26256
1682.473,17,14,1036,7,30,280410,30,406,7,62,280410,62,630
0.243,17,4,588,2,48,234,48,152,2,190,234,308,436
1.709,6,13,2311,8,188,244,245,700,5,1407,360,1407,1611
175.246,17,2,72,1,8,0,8,36,1,8,0,8,36
1794.435,17,29,9512,29,300,64086,300,9512,0,0,0,0,0
66.386,6,29,8832,14,158,5106,267,1357,15,858,4741,2800,7475
5.089,6,41,7349,21,218,254,314,3463,20,513,254,1179,3886
2.017,6,14,2351,8,188,288,245,700,6,703,352,1152,1651
1784.136,6,356,22520,208,69,8619,69,12460,148,69,12136,69,10060
1787.614,6,102,8228,68,64,26680,64,4896,34,58,54167,58,3332
1730.381,17,151,15895,151,77,11535,362,15895,0,0,0,0,0
386.136,6,27,7991,10,188,15086,517,1347,17,495,24129,1420,6644
1798.628,1,59,4956,59,56,31010,56,4956,0,0,0,0,0
1799.483,17,448,39896,403,35,4476,288,25676,45,288,40020,288,14220
72.239,6,29,7597,9,155,199,267,1146,20,352,3801,3417,6451
1787.418,6,383,30654,223,142,8051,1189,18870,160,74,11239,485,11784
1771.881,6,99,9306,66,66,27259,66,5610,33,60,55368,60,3696
10.983,6,20,4442,11,275,1098,275,998,9,768,774,1440,3444
2.069,17,2,144,1,36,0,36,64,1,52,0,52,80
182.315,6,23,8401,11,532,97,1257,2068,12,973,16557,2720,6333
0.745,6,2,86,1,0,0,0,40,1,6,0,6,46
33.264,17,4,352,2,60,33263,60,176,2,60,33263,60,176
1739.976,1,66,3696,66,28,26768,28,3696,0,0,0,0,0
58.592,1,4,224,4,28,19530,28,224,0,0,0,0,0
1.306,6,49,20631,28,924,48,1360,15015,21,433,56,1360,5616
1.291,6,47,15329,26,780,51,1460,9668,21,400,55,1460,5661
1794.138,17,272,43931,272,133,6620,391,43931,0,0,0,0,0
5.335,6,14,1990,8,192,762,192,544,6,398,1033,419,1446
240.244,6,54,19397,28,876,8897,1418,16362,26,209,9609,580,3035
0.389,6,7,423,5,43,97,43,311,2,0,315,0,112
321.498,1,4,612,4,125,107166,173,612,0,0,0,0,0
23.789,6,17,8072,6,150,4757,174,544,11,1011,2369,1452,7528
195.165,6,34,2503,14,74,15008,313,1226,20,47,10271,78,1277
1792.176,17,87,3648,86,14,21084,14,3612,1,8,0,8,36
3.351,6,21,5091,11,129,335,267,1223,10,692,365,1467,3868
5.231,6,41,7349,22,218,249,314,3503,19,440,276,1152,3846
3.384,17,2,776,2,360,3384,360,776,0,0,0,0,0
25.435,6,20,3130,12,183,2312,517,1561,8,381,3631,499,1569
70.42,6,29,7395,13,155,5868,267,1306,16,453,4692,3417,6089
0.038,17,2,338,1,33,0,33,61,1,249,0,249,277
4.94,6,40,7309,21,218,247,314,3463,19,513,260,1179,3846
1.0,17,2,122,2,33,1000,33,122,0,0,0,0,0
1797.271,6,365,23087,211,69,8558,69,12787,154,69,11746,69,10300
240.253,6,51,14601,28,640,8897,1418,11719,23,209,10918,580,2882
0.941,6,359,373806,115,194,8,230,6991,244,1463,3,5792,366815
13.595,6,2,80,1,0,0,0,40,1,0,0,0,40
1784.189,1,58,4872,0,0,0,0,0,58,56,31301,56,4872
1799.627,17,347,59478,347,143,5201,381,59478,0,0,0,0,0
0.106,17,2,136,1,32,0,32,60,1,48,0,48,76
65.993,6,35,9005,16,290,4399,965,2391,19,389,3665,1420,6614
1796.239,1,296,16576,296,28,6088,28,16576,0,0,0,0,0
87.399,6,34,15467,17,304,86,597,1685,17,1006,5451,1360,13782
11.707,6,1907,1610503,1135,1363,10,1380,1575045,772,421,15,1923,35458
1799.716,6,109,8765,71,65,25710,65,5180,38,59,48636,59,3585
2.959,6,11,467,6,0,591,0,248,5,7,690,7,219
1785.131,6,104,8376,68,65,26643,65,4930,36,59,51001,59,3446
0.793,17,3,1170,3,362,396,362,1170,0,0,0,0,0
350.13,17,6,360,3,32,175064,32,180,3,32,175064,32,180
61.319,6,35,15930,22,810,2919,1408,9255,13,855,5089,3847,6675
0.945,6,50,13773,24,549,41,1429,4824,26,493,37,2920,8949
1764.092,2,14,448,14,8,135699,8,448,0,0,0,0,0
58.113,6,25,7097,12,155,5283,267,1266,13,589,4842,3426,5831
1793.556,6,244,35804,152,302,11877,302,26032,92,83,19709,83,9772
82.658,6,36,7882,14,155,6358,267,1346,22,332,3935,1420,6536
251.208,17,4,240,2,32,251207,32,120,2,32,251206,32,120
3.508,17,3,1173,3,363,1754,363,1173,0,0,0,0,0
1786.635,6,102,8296,68,65,26666,65,4930,34,59,54137,59,3366
1771.32,6,99,9240,66,65,27251,65,5577,33,59,55350,59,3663
0.179,6,3,218,2,31,179,31,135,1,31,0,31,83
0.172,6,46,20754,26,1048,6,1420,15733,20,467,8,1883,5021
3.122,17,4,1356,4,311,1040,336,1356,0,0,0,0,0
57.677,6,35,8415,17,410,551,882,1942,18,478,3382,2128,6473
85.284,6,16,2286,9,323,10660,582,1122,7,396,14205,580,1164
1.436,6,55,21227,30,943,49,1440,15394,25,400,52,1440,5833
1.399,6,13,1344,7,256,232,256,796,6,304,278,304,548
20.146,6,20,2460,11,189,2014,517,1338,9,323,2517,499,1122
179.918,1,4,224,4,28,59972,28,224,0,0,0,0,0
1049.609,17,205,15580,205,48,5145,48,15580,0,0,0,0,0
1.073,6,29,9352,16,208,71,475,1518,13,912,73,2720,7834
208.103,17,4,352,2,60,208102,60,176,2,60,208102,60,176
2.037,6,14,5045,7,170,335,170,554,7,1029,338,1448,4491
18.71,17,4,352,2,60,18709,60,176,2,60,18709,60,176
196.228,17,4,304,2,48,196211,48,152,2,48,196210,48,152
0.367,6,20,13942,13,127,24,127,811,7,3189,42,5792,13131
1795.009,6,368,27215,214,117,8427,1189,16165,154,74,11730,405,11050
376.354,6,25,1651,17,177,23522,177,1117,8,110,9285,110,534
0.964,6,36,8215,19,247,53,643,1781,17,478,52,2128,6434
0.036,6,12,1843,7,138,6,138,510,5,532,8,891,1333
109.892,6,40,17343,24,871,4777,1272,7973,16,966,7317,3209,9370
53.649,6,11,4061,11,317,5364,416,4061,0,0,0,0,0
113.827,6,940,465070,515,838,221,1152,443263,425,436,267,1179,21807
119.792,6,30,7432,13,158,9982,267,1317,17,543,7484,1400,6115
10.93,6,1920,1781774,1214,1389,8,1408,1740374,706,931,15,2816,41400
0.087,17,2,407,1,32,0,32,60,1,319,0,319,347
0.174,6,2,104,1,0,0,0,52,1,0,0,0,52
1.36,6,49,19655,27,920,52,1360,13999,22,433,55,1360,5656
1783.809,6,355,22480,207,69,8659,69,12420,148,69,12134,69,10060
107.885,6,27,9121,13,468,90,1067,2006,14,727,8285,1360,7115
1790.349,6,356,22520,208,69,8649,69,12460,148,69,12176,69,10060
1740.473,17,25,26350,25,1026,72519,1026,26350,0,0,0,0,0
8.77,6,33,8223,18,372,515,802,1869,15,574,612,4848,6354
835.749,1,8,448,8,28,119392,28,448,0,0,0,0,0
15.92,17,36,24234,18,694,932,1350,13009,18,595,932,1350,11225
4.477,6,37,7205,19,218,248,314,3383,18,516,247,1179,3822
44.795,6,36,8455,17,410,542,882,1942,19,441,2480,1460,6513
0.441,6,21,7203,12,318,38,600,1906,9,964,52,1471,5297
10.834,6,18,5610,10,275,1203,275,958,8,1440,829,1440,4652
1764.127,2,15,480,15,8,126009,8,480,0,0,0,0,0
1780.081,1,342,28728,342,56,5220,56,28728,0,0,0,0,0
0.3,17,8,2758,8,316,42,355,2758,0,0,0,0,0
570.263,1,6,336,6,28,114052,28,336,0,0,0,0,0
8.415,6,76,24810,39,568,221,1152,19189,37,459,226,1179,5621
1762.172,6,76,3952,38,0,47621,0,1976,38,0,47621,0,1976
0.949,6,10,1687,7,100,158,100,384,3,1179,344,1179,1303
0.032,6,3,182,2,31,32,31,111,1,31,0,31,71
0.004,17,4,240,2,32,1,32,120,2,32,3,32,120
8.175,6,19,9695,9,275,1021,275,643,10,1440,805,1440,9052
1.116,6,25,8056,12,164,86,267,1288,13,869,78,1408,6768
1780.221,17,140,11200,70,48,25800,48,5320,70,56,25800,56,5880
368.556,6,29,1883,19,177,20475,177,1245,10,110,8594,110,638
573.059,6,28,2285,18,66,28666,66,1314,10,57,63663,60,971
280.471,6,28,7352,13,158,23372,267,1317,15,678,20030,3456,6035
1785.071,6,417,24981,209,69,8582,69,12500,208,34,8623,69,12481
1786.49,6,102,8228,68,64,26664,64,4896,34,58,54133,58,3332
3.213,17,2,204,1,34,0,34,62,1,114,0,114,142
1631.08,6,95,7172,62,38,26739,205,4393,33,33,50950,98,2779
385.019,6,15,6016,7,154,64169,267,752,8,1234,9611,1926,5264
1781.411,1,200,21200,200,78,8951,78,21200,0,0,0,0,0
1796.223,17,364,45114,173,166,10443,1350,33594,191,32,9452,61,11520
178.73,17,4,272,2,40,178729,47,136,2,40,178729,47,136
1323.514,2,15,480,15,8,94536,8,480,0,0,0,0,0
0.623,6,25,6627,12,137,56,267,1172,13,704,51,1467,5455
14.72,6,2,142,2,31,14720,31,142,0,0,0,0,0
0.052,6,10,1514,5,503,13,503,771,5,475,12,475,743
1681.282,17,14,1036,7,30,280210,30,406,7,62,280208,62,630
6.868,17,4,1344,4,308,2289,308,1344,0,0,0,0,0
0.093,6,44,40674,13,273,7,517,1504,31,1390,2,1438,39170
35.234,17,33,19382,16,524,2347,1350,8840,17,592,2200,1350,10542
0.651,6,2,1175,1,0,0,0,40,1,1095,0,1095,1135
939.818,6,52,3758,31,31,31327,31,2077,21,31,44393,31,1681
92.108,6,19,5994,10,290,10234,517,1109,9,1102,11512,1418,4885
0.067,17,2,378,1,50,0,50,78,1,272,0,272,300
0.149,17,4,414,2,50,77,50,156,2,101,76,107,258
858.866,6,26,3707,14,186,66066,517,2429,12,323,6209,499,1278
1091.079,17,216,16416,216,48,5074,48,16416,0,0,0,0,0
1282.556,6,91098,90577664,31558,335,40,338,1726443,59540,1440,21,4314,88851221
1786.622,6,424,25437,212,69,8467,69,12620,212,34,8467,64,12817
3.06,17,27,17308,12,420,278,1350,5379,15,767,213,1350,11929
0.33,17,2,152,1,48,0,48,76,1,48,0,48,76
5.671,6,22,13198,7,122,945,122,568,15,1201,387,1360,12630
1.821,6,13,2311,8,188,260,245,700,5,1407,380,1407,1611
0.072,17,4,284,2,32,34,32,120,2,54,39,60,164
7.398,6,24,6813,8,140,1056,267,889,16,527,492,1420,5924
1.353,6,54,18847,29,844,48,1360,13026,25,400,48,1360,5821
1787.502,6,104,8252,68,63,26679,64,4868,36,57,51069,58,3384
280.219,6,27,7312,13,158,23351,267,1317,14,775,21552,4836,5995
0.024,17,2,626,1,58,0,58,86,1,512,0,512,540
300.106,6,47,17053,21,1012,14997,1360,10994,26,278,11997,2720,6059
1441.304,17,106,8472,54,48,27194,48,4104,52,56,28260,56,4368
60.462,6,23,6677,11,181,6046,267,1172,12,836,5495,2045,5505
1786.446,6,102,8296,68,65,26663,65,4930,34,59,54132,59,3366
1779.595,1,58,4872,58,56,31220,56,4872,0,0,0,0,0
0.024,17,6,816,3,60,6,60,264,3,156,6,156,552
300.6,6,44,8830,23,286,13663,766,2144,21,388,460,2720,6686
64.262,17,5,1935,5,359,16065,371,1935,0,0,0,0,0
300.388,6,231,215397,82,162,3708,230,5070,149,1397,2029,2896,210327
0.723,6,17,5132,9,150,90,174,664,8,828,91,1420,4468
0.262,17,2,144,1,36,0,36,64,1,52,0,52,80
5.076,17,3,208,2,36,5007,36,128,1,52,0,52,80
0.3,17,2,2380,2,1162,300,1162,2380,0,0,0,0,0
0.055,17,2,290,1,40,0,40,68,1,194,0,194,222
1771.392,6,101,9410,66,66,27252,66,5610,35,60,52097,60,3800
1681.743,17,14,1036,7,30,280289,30,406,7,62,280288,62,630
213.516,6,28,7352,13,158,17793,267,1317,15,678,15248,2800,6035
193.633,1,6,336,6,28,38726,28,336,0,0,0,0,0
1.025,17,8,568,4,32,340,32,240,4,54,340,60,328
341.177,6,53,10087,22,105,16245,267,2149,31,257,11372,1452,7938
1770.807,6,99,9306,66,66,27243,66,5610,33,60,55335,60,3696
1.294,6,25,8056,12,164,98,267,1288,13,869,92,1448,6768
2.911,6,54,19985,29,925,103,1460,14164,25,400,104,1460,5821
33.408,1,4,224,4,28,11136,28,224,0,0,0,0,0
1751.785,6,194,12537,97,57,18247,208,7758,97,31,18245,31,4779
300.633,6,37,8526,20,315,15822,882,2093,17,478,527,2720,6433
1790.937,1,342,28728,342,56,5252,56,28728,0,0,0,0,0
8.988,6,2004,1533138,936,1183,9,1360,78531,1068,1357,8,4080,1454607
377.201,6,23,1538,16,180,25146,180,1056,7,110,10424,110,482
280.421,6,29,7392,13,158,23368,267,1317,16,678,18692,3456,6075
168.269,17,4,240,2,32,168268,32,120,2,32,168268,32,120
280.271,6,29,7392,12,158,25479,267,1277,17,543,17511,1400,6115
1798.335,17,449,39928,404,35,4462,288,25708,45,288,40023,288,14220
2.87,17,4,624,4,128,956,128,624,0,0,0,0,0
11.898,6,1958,1657258,1169,1363,10,1380,1619521,789,558,15,1923,37737
110.604,6,17,1362,15,46,6735,62,1251,2,31,1999,31,111
4.596,17,400,432594,95,210,48,1350,22653,305,1316,14,1350,409941
1762.754,6,27,4077,18,241,103691,241,2889,9,92,220321,92,1188
356.274,17,6,528,3,60,178136,60,264,3,60,178136,60,264
1680.445,1,15,840,15,28,120031,28,840,0,0,0,0,0
0.005,17,2,353,1,36,0,36,64,1,261,0,261,289
5.477,6,42,7389,21,218,273,314,3463,21,440,261,1152,3926
280.359,6,23,7014,10,181,31151,267,1128,13,670,23357,1400,5886
1786.277,6,102,8364,68,66,26660,66,4964,34,60,54126,60,3400
14.498,6,30,7432,13,158,1208,267,1317,17,543,904,1400,6115
8.083,6,562,489582,345,1346,22,1368,471642,217,1164,36,4209,17940
0.185,17,2,2754,2,1349,185,1349,2754,0,0,0,0,0
351.324,17,7,2312,7,302,58554,308,2312,0,0,0,0,0
2.763,6,32,16413,19,1038,153,1360,9100,13,1130,216,4445,7313
0.023,17,4,284,2,32,0,32,120,2,54,11,60,164
0.399,6,21,7203,12,318,36,600,1906,9,964,47,1471,5297
650.377,17,78,5928,78,48,8446,48,5928,0,0,0,0,0
1756.997,6,117,8484,72,31,24746,31,4944,45,31,39931,31,3540
0.128,6,18,6276,9,103,16,103,579,9,1044,16,1448,5697
0.88,6,24,9065,14,290,67,802,1753,10,1380,79,3930,7312
190.147,17,4,240,2,32,190146,32,120,2,32,190146,32,120
139.8,6,26,10737,13,741,54,1360,3517,13,955,11639,1708,7220
0.042,17,2,152,1,48,0,48,76,1,48,0,48,76
0.154,17,13,6733,7,609,21,1350,4461,6,350,24,1350,2272
136.179,17,4,240,2,32,136177,32,120,2,32,136178,32,120
1557.084,2,15,480,15,8,111220,8,480,0,0,0,0,0
0.02,6,2,149,1,0,0,0,40,1,69,0,69,109
281.599,17,4,240,2,32,281598,32,120,2,32,281598,32,120
35.523,17,4,352,2,60,35522,60,176,2,60,35522,60,176
0.055,6,12,3462,6,75,10,75,395,6,1373,11,1448,3067
19.674,1,7,2332,7,305,3279,310,2332,0,0,0,0,0
1720.404,17,12,498,11,14,172040,14,462,1,8,0,8,36
74.964,6,649,303239,344,822,218,1152,285177,305,418,245,1179,18062
5.256,6,39,7269,19,218,292,314,3383,20,513,262,1179,3886
0.965,6,27,8463,14,270,61,561,1945,13,997,65,2720,6518
8.191,6,1781,1641464,1123,1383,7,1408,1602584,658,931,12,2801,38880
102.271,17,8,2688,8,308,14610,308,2688,0,0,0,0,0
113.494,6,21,8523,11,549,86,1308,2119,10,998,12590,1791,6404
1769.03,1,58,4872,0,0,0,0,0,58,56,31035,56,4872
0.263,6,23,4494,11,165,26,456,1394,12,493,22,888,3100
212.307,6,32,9219,15,176,15164,267,1664,17,763,13265,2076,7555
73.151,6,127,26531,59,310,1261,1440,13316,68,306,1085,1440,13215
7.169,6,2,142,0,0,0,0,0,2,31,7169,31,142
1741.11,6,87,6322,58,31,30545,31,3915,29,31,62180,31,2407
0.039,17,2,912,1,308,0,308,336,1,548,0,548,576
1796.403,17,447,39580,403,35,4468,288,25676,44,288,40950,288,13904
300.017,1,12,1164,12,69,27274,69,1164,0,0,0,0,0
1780.346,6,232,39399,113,932,15895,1402,28314,119,51,15087,70,11085
882.193,2,5,160,5,8,220548,8,160,0,0,0,0,0
0.991,17,2,685,1,308,0,308,336,1,321,0,321,349
1.97,6,4,208,4,0,0,0,208,0,0,0,0,0
1778.511,1,57,4788,57,56,31759,56,4788,0,0,0,0,0
36.692,6,1173,1028712,714,1361,51,1368,998166,459,1124,79,2841,30546
10.968,6,26,11315,12,275,997,275,1038,14,1078,757,1414,10277
1171.62,1,236,24544,0,0,0,0,0,236,76,4985,76,24544
14.103,6,13,1108,4,106,4701,106,274,9,90,1728,90,834
1793.256,17,66,2766,65,14,28019,14,2730,1,8,0,8,36
1793.119,1,285,30210,285,78,6313,78,30210,0,0,0,0,0
261.196,17,4,352,2,60,261195,60,176,2,60,261195,60,176
8.631,17,4,288,2,36,4999,36,128,2,52,0,52,160
1797.508,17,449,39928,404,35,4460,288,25708,45,288,40018,288,14220
0.659,17,4,240,2,32,657,32,120,2,32,658,32,120
5.351,6,39,7285,20,218,281,314,3423,19,516,282,1179,3862
11.063,17,2,268,1,54,0,54,82,1,158,0,158,186
0.005,17,2,554,2,249,5,249,554,0,0,0,0,0
89.246,6,28,7352,13,158,7437,267,1317,15,678,6372,2800,6035
1.74,6,10,1476,6,279,348,279,878,4,191,243,272,598
1.263,6,10,1687,7,100,210,100,384,3,1179,497,1179,1303
5.443,2,2,64,2,8,5443,8,64,0,0,0,0,0
5.554,6,45,8409,22,227,264,314,4062,23,427,240,1152,4347
0.265,6,20,7238,12,335,23,668,1974,8,1210,37,2816,5264
0.529,17,4,240,2,32,528,32,120,2,32,528,32,120
283.662,6,32,7788,13,158,23347,267,1317,19,475,15758,3436,6471
37.442,17,11,836,11,48,3744,48,836,0,0,0,0,0
0.618,6,21,7203,13,318,51,600,1958,8,964,76,1471,5245
1699.426,17,18,1494,9,31,212423,37,536,9,78,212420,136,958
12.035,6,1758,1628768,1150,1365,10,1432,1600145,608,427,19,1432,28623
8.605,1,9,756,0,0,0,0,0,9,56,1075,56,756
65.633,17,4,352,2,60,65632,60,176,2,60,65632,60,176
1779.493,17,79,3312,78,14,23110,14,3276,1,8,0,8,36
280.189,6,30,7432,13,158,23349,267,1317,17,543,17510,1400,6115
50.95,2,2,64,2,8,50950,8,64,0,0,0,0,0
1745.842,1,56,4704,56,56,31742,56,4704,0,0,0,0,0
1.725,6,51,19005,29,861,61,1360,13292,22,437,69,2715,5713
0.159,17,3,2906,3,940,79,1451,2906,0,0,0,0,0
4.865,6,31,9744,18,318,286,591,2316,13,863,388,1380,7428
185.67,6,90,54419,52,826,3640,1408,10176,38,1565,5017,5870,44243
1781.318,6,223,19070,83,74,21721,301,8491,140,70,12814,1062,10579
4.77,6,13,5216,6,171,953,171,503,7,1085,794,1448,4713
5.545,6,39,7285,21,218,277,314,3463,18,516,310,1179,3822
1761.541,1,59,4956,59,56,30371,56,4956,0,0,0,0,0
81.401,6,103,78311,66,1295,1252,1448,68224,37,741,2238,2359,10087
1784.65,1,342,28728,342,56,5233,56,28728,0,0,0,0,0
1788.501,17,83,3480,82,14,22080,14,3444,1,8,0,8,36
63.186,6,11,676,5,106,15796,106,314,6,90,12632,90,362
152.176,17,4,352,2,60,152175,60,176,2,60,152174,60,176
1764.29,2,13,416,13,8,147024,8,416,0,0,0,0,0
280.051,6,28,7352,13,158,23337,267,1317,15,678,20000,2800,6035
1795.316,17,80,3354,79,14,23016,14,3318,1,8,0,8,36
1749.486,6,108,7910,63,38,28217,205,4476,45,33,39752,98,3434
1794.065,6,356,22520,208,69,8666,69,12460,148,69,12203,69,10060
3.792,6,14,2355,8,188,541,245,700,6,1407,705,1407,1655
0.182,6,25,7216,12,155,16,267,1261,13,603,14,1400,5955
280.459,6,31,7472,13,158,23371,267,1317,18,543,16494,1380,6155
15.535,6,82,26276,41,609,388,1152,20527,41,456,381,1179,5749
1.152,2,2,64,2,8,1152,8,64,0,0,0,0,0
240.19,6,54,17582,29,788,8578,1402,14926,25,168,10007,580,2656
387.605,6,18,1242,14,180,29815,180,916,4,110,20075,110,326
280.495,6,30,7773,13,158,23374,267,1317,17,641,17529,2045,6456
1787.161,6,102,8296,68,65,26674,65,4930,34,59,54152,59,3366
16.908,6,44,8728,21,378,838,786,2054,23,478,762,2720,6674
1787.901,6,366,25541,213,100,8433,469,14936,153,69,11762,69,10605
280.254,6,27,7312,13,158,23354,267,1317,14,775,21554,2800,5995
2.693,17,35,19123,16,750,179,1350,12463,19,322,117,1350,6660
839.483,1,14,784,14,28,64575,28,784,0,0,0,0,0
1764.41,2,14,448,14,8,135723,8,448,0,0,0,0,0
240.585,6,46,8552,22,449,11454,1418,5648,24,206,10457,580,2904
73.942,6,74,54938,50,1198,1509,1368,46954,24,841,2695,2519,7984
1.284,17,3,451,2,39,959,39,134,1,289,0,289,317
113.541,6,43,10225,21,706,490,1360,4450,22,348,5398,2667,5775
1331.75,6,3346,3119061,1203,150,1107,358,73344,2143,1407,621,2836,3045717
149.659,1,55,5720,0,0,0,0,0,55,76,2771,76,5720
36.972,17,44,6468,22,48,1760,48,1672,22,190,1760,308,4796
92.968,6,36,8218,15,169,6640,267,1791,21,398,4640,3417,6427
3.503,6,21,6349,10,262,384,517,1316,11,744,345,1418,5033
1.117,2,3,96,3,8,558,8,96,0,0,0,0,0
0.088,17,2,268,1,33,0,33,61,1,179,0,179,207
1.741,6,13,2311,8,188,248,245,700,5,1407,369,1407,1611
0.524,17,3,543,2,39,69,39,134,1,381,0,381,409
0.307,6,22,7342,11,277,30,828,1691,11,1014,30,2371,5651
1785.334,17,140,11200,70,48,25874,48,5320,70,56,25874,56,5880
1796.119,6,363,23145,209,69,8635,69,12569,154,69,11739,69,10576
273.86,6,76,10815,33,99,8558,267,2818,43,241,6516,1452,7997
5.631,6,14,2351,8,188,804,245,700,6,1407,1074,1407,1651
0.041,17,2,198,1,39,0,39,67,1,103,0,103,131
29.491,6,46,9083,23,186,1340,722,2606,23,693,1328,2760,6477
0.581,6,22,7345,13,334,48,663,2021,9,1209,65,1946,5324
0.436,6,5,224,4,0,145,0,184,1,0,0,0,40
240.894,6,45,9187,22,519,11470,1402,5827,23,238,10949,618,3360
61.804,6,42,8836,20,410,474,882,2110,22,388,2937,2720,6726
2.011,6,51,13383,26,332,80,1234,3140,25,543,76,1440,10243
1786.642,6,103,8336,68,65,26666,65,4930,35,59,52544,59,3406
1781.762,6,361,24196,211,88,8484,469,13918,150,69,11958,69,10278
68.96,6,14,1887,8,302,9851,302,1318,6,83,13789,83,569
53.226,17,4,352,2,60,53225,60,176,2,60,53225,60,176
249.088,17,10,880,5,48,62269,48,380,5,72,62268,72,500
0.888,6,10,1687,7,100,148,100,384,3,1179,316,1179,1303
1797.706,1,345,28980,345,56,5225,56,28980,0,0,0,0,0
0.058,17,3,244,2,32,32,32,120,1,96,0,96,124
1772.776,6,180,15480,120,69,14897,69,8940,60,69,30045,69,6540
0.411,6,14,1733,7,288,62,288,588,7,284,38,434,1145
5.01,17,3,343,2,36,5003,36,128,1,187,0,187,215
208.525,6,71,47360,44,1191,4849,1408,39223,27,960,2370,3847,8137
1788.278,6,369,25730,214,99,8395,469,15045,155,69,11610,69,10685
2.079,17,3,1167,3,361,1039,361,1167,0,0,0,0,0
1798.449,17,450,39960,405,35,4451,288,25740,45,288,40019,288,14220
1.402,6,20,3833,11,234,140,564,1504,9,463,152,1343,2329
1792.225,17,81,3396,80,14,22686,14,3360,1,8,0,8,36
1770.936,6,101,9344,66,65,27245,65,5577,35,59,52083,59,3767
6.253,6,12,1775,5,100,1563,100,304,7,1179,998,1179,1471
1744.632,2,29,928,29,8,62308,8,928,0,0,0,0,0
1786.948,6,104,8376,68,65,26670,65,4930,36,59,51051,59,3446
32.054,6,9,396,2,0,3512,0,88,7,0,5326,0,308
1.353,6,24,6635,13,350,112,1088,2275,11,783,134,1420,4360
1786.604,6,106,8456,68,65,26665,65,4930,38,59,48284,59,3526
6.353,6,1245,1138968,782,1380,7,1408,1110228,463,931,13,2816,28740
39.172,17,12,912,12,48,3561,48,912,0,0,0,0,0
1799.497,1,15,870,15,30,128535,30,870,0,0,0,0,0
240.17,6,53,17843,28,791,8895,1402,14921,25,201,10006,580,2922
1740.315,6,90,6521,59,31,30005,31,3998,31,31,58008,31,2523
23.445,6,35,8176,18,188,1379,721,2043,17,681,1446,2840,6133
179.918,2,3,96,3,8,89959,8,96,0,0,0,0,0
1793.53,17,167,10688,167,36,10804,36,10688,0,0,0,0,0
33.771,6,30,5041,15,154,2412,722,1859,15,399,2399,1408,3182
5.825,6,556,480474,343,1334,16,1368,464734,213,776,26,1473,15740
1794.348,17,144,11520,72,48,25272,48,5472,72,56,25272,56,6048
76.985,6,27,5754,12,107,6998,159,1110,15,967,5498,1669,4644
1744.698,2,28,896,28,8,64618,8,896,0,0,0,0,0
0.174,17,4,588,2,48,161,48,152,2,190,159,308,436
883.05,2,6,192,6,8,176610,8,192,0,0,0,0,0
28.459,6,48,11788,22,533,700,910,3151,26,399,1132,2128,8637
1795.314,6,367,23374,211,69,8549,69,12787,156,69,11582,69,10587
1799.978,6,191,13390,67,46,27272,46,5578,124,46,14632,46,7812
0.105,17,2,2730,2,1337,105,1337,2730,0,0,0,0,0
0.119,17,2,184,1,32,0,32,60,1,96,0,96,124
1792.709,1,58,4872,0,0,0,0,0,58,56,31451,56,4872
1771.391,6,112,10336,70,65,25672,65,5992,42,59,43202,59,4344
1763.675,2,15,480,15,8,125976,8,480,0,0,0,0,0
1741.355,17,30,7050,30,207,60046,207,7050,0,0,0,0,0
27.436,6,27,6899,15,117,1959,159,1401,12,695,2491,1418,5498
1745.887,6,95,7203,63,38,28159,205,4476,32,33,56306,98,2727
376.469,6,25,1651,17,177,23529,177,1117,8,110,9265,110,534
0.166,6,10,1669,6,551,33,947,1346,4,159,55,159,323
7.396,6,599,537477,388,1320,18,1368,521841,211,776,34,2736,15636
1.064,6,29,9077,16,434,70,1440,2855,13,632,66,1440,6222
1772.132,6,180,15480,120,69,14891,69,8940,60,69,30031,69,6540
5.738,6,42,7389,21,218,286,314,3463,21,440,274,1152,3926
8.699,6,22,9370,11,275,869,275,723,11,1170,763,1414,8647
2.963,17,2,1430,2,687,2963,687,1430,0,0,0,0,0
25.811,6,22,7612,12,413,2346,597,1860,10,746,2863,1368,5752
1743.864,6,127,8113,72,47,24561,208,4890,55,31,32286,31,3223
1.386,6,25,8056,12,164,107,267,1288,13,1014,98,2491,6768
7.541,17,6,528,3,48,3763,48,228,3,72,3764,72,300
71.009,17,12,4032,12,308,6455,308,4032,0,0,0,0,0
3.884,6,24,6530,11,268,383,517,1386,13,744,319,1418,5144
1791.706,1,58,4872,0,0,0,0,0,58,56,31433,56,4872
5.028,17,4,558,2,36,5006,36,128,2,187,5012,187,430
0.078,1,6,624,0,0,0,0,0,6,76,15,76,624
5.002,17,2,124,2,34,5002,34,124,0,0,0,0,0
23.656,6,11,686,3,214,11759,214,354,8,0,3359,0,332
13.691,6,23,5822,13,275,1140,275,1082,10,1440,969,1440,4740
1.881,17,3,451,2,39,907,39,134,1,289,0,289,317
106.374,6,35,13280,17,468,517,1237,4058,18,943,6247,1591,9222
1773.163,6,180,15480,120,69,14900,69,8940,60,69,30047,69,6540
0.327,6,28,9162,13,261,27,683,1740,15,829,22,1408,7422
0.901,6,29,8569,16,263,49,586,2250,13,826,61,3132,6319
30.008,17,4,240,2,32,30007,32,120,2,32,30007,32,120
280.468,6,31,7472,13,158,23372,267,1317,18,603,16495,2076,6155
20.407,1,2,746,2,345,20407,353,746,0,0,0,0,0
38.644,17,44,6468,22,48,1839,48,1672,22,190,1839,308,4796
1791.965,17,140,11200,70,48,25970,48,5320,70,56,25970,56,5880
16.441,6,2245,2000185,1330,1416,12,1448,1942877,915,776,17,1448,57308
1.252,6,25,8080,12,164,97,267,1312,13,869,89,1408,6768
1789.965,6,356,22520,208,69,8647,69,12460,148,69,12176,69,10060
1770.571,6,106,9919,68,69,26426,233,5914,38,59,47850,82,4005
0.057,17,2,247,1,36,0,36,64,1,155,0,155,183
0.844,17,2,134,2,39,844,39,134,0,0,0,0,0
1771.698,1,58,4872,58,56,31082,56,4872,0,0,0,0,0
1740.476,17,30,31752,30,1030,60016,1064,31752,0,0,0,0,0
66.459,6,18,1016,8,0,9494,0,448,10,0,7338,0,568
1.323,6,23,7952,12,164,102,267,1288,11,1014,113,2736,6664
1.397,6,49,19697,27,923,53,1440,14041,22,433,55,1440,5656
1776.694,17,142,11360,71,48,25380,48,5396,71,56,25378,56,5964
1.725,17,4,808,3,64,847,64,276,1,504,0,504,532
0.253,6,22,5040,10,137,28,267,1092,12,577,21,1400,3948
15.493,6,7,534,4,222,5050,222,402,3,0,7678,0,132
0.481,6,27,7296,13,155,40,267,1301,14,603,32,1400,5995
1782.683,17,85,3564,84,14,21478,14,3528,1,8,0,8,36
60.116,2,2,64,2,8,60116,8,64,0,0,0,0,0
70.464,6,76,56067,51,1194,1409,1368,48033,25,840,2579,2519,8034
1637.469,1,8,448,8,28,233924,28,448,0,0,0,0,0
1750.774,17,12,498,11,14,175077,14,462,1,8,0,8,36
1799.691,17,4018,192864,2009,20,896,20,96432,2009,20,896,20,96432
0.009,17,2,335,1,33,0,33,61,1,246,0,246,274
1797.068,6,244,35804,152,302,11901,302,26032,92,83,19747,83,9772
1793.433,6,356,22520,208,69,8663,69,12460,148,69,12200,69,10060
64.65,6,14,5885,4,186,21546,267,541,10,822,7182,1420,5344
1790.945,1,342,28728,342,56,5252,56,28728,0,0,0,0,0
0.888,6,26,5887,13,156,74,267,1462,13,650,68,1420,4425
4.429,6,37,7189,19,218,246,314,3383,18,513,244,1179,3806
1798.935,17,449,39928,404,35,4463,288,25708,45,288,40015,288,14220
0.125,17,2,366,1,37,0,37,65,1,273,0,273,301
0.1,17,4,304,2,37,0,37,130,2,59,39,65,174
3.64,17,5,295,5,31,910,31,295,0,0,0,0,0
1.608,6,26,4222,13,240,134,630,2127,13,201,132,580,2095
1786.374,6,102,8364,68,66,26662,66,4964,34,60,54129,60,3400
1720.999,17,12,498,11,14,172099,14,462,1,8,0,8,36
0.101,17,2,166,1,47,0,47,75,1,63,0,63,91
1797.433,6,361,22858,210,69,8600,69,12678,151,69,11982,69,10180
1744.968,6,99,7411,63,38,28144,205,4476,36,33,49849,98,2935
134.817,6,30,14650,16,488,330,1360,3127,14,1368,10360,3928,11523
298.246,6,2877,1489660,1640,843,181,1152,1425841,1237,367,241,1179,63819
1.283,6,24,8004,12,164,99,267,1288,12,1014,98,2331,6716
0.874,6,54,13970,26,551,34,1429,4932,28,439,31,1986,9038
1.554,6,34,9440,18,393,91,1440,3506,16,660,89,1440,5934
0.09,17,2,904,2,424,90,548,904,0,0,0,0,0
52.53,17,4,240,2,32,52529,32,120,2,32,52529,32,120
36.467,17,20,1760,10,48,4051,48,760,10,72,4050,72,1000
15.344,6,2489,2317984,1556,1409,9,1448,2264792,933,776,16,1448,53192
1771.466,6,99,9240,66,65,27253,65,5577,33,59,55355,59,3663
11.419,17,4,352,2,48,11397,48,152,2,72,11399,72,200
0.337,6,10,968,5,256,82,256,460,5,304,82,304,508
0.351,17,4,284,2,32,148,32,120,2,54,206,60,164
367.031,6,18,1242,14,180,28233,180,916,4,110,20058,110,326
1790.849,6,356,22520,208,69,8651,69,12460,148,69,12182,69,10060
67.776,6,35,16915,19,1006,3765,1448,9087,16,776,4471,1448,7828
280.757,17,4,240,2,32,280755,32,120,2,32,280756,32,120
1.373,6,50,19570,27,911,52,1360,13874,23,433,54,1360,5696
1798.457,17,142,11360,71,48,25692,48,5396,71,56,25692,56,5964
537.222,6,126,16280,59,136,8519,1189,5508,67,224,8139,1420,10772
8.127,17,12,1764,6,48,1622,48,456,6,190,1622,308,1308
0.109,17,2,206,1,44,0,44,72,1,106,0,106,134
61.155,6,13,1388,6,226,429,226,784,7,110,10165,110,604
1.737,17,6,1450,3,32,866,32,180,3,395,866,470,1270
121.402,6,22,8943,11,356,79,767,1542,11,992,12122,1460,7401
137.046,6,30,7432,13,158,11420,267,1317,17,543,8561,1400,6115
76.384,17,4,240,2,32,76382,32,120,2,32,76383,32,120
33.439,6,29,4989,14,180,2572,722,1806,15,342,2374,1408,3183
0.826,6,10,1755,5,657,206,657,925,5,562,206,562,830
1681.31,17,14,1036,7,30,280215,30,406,7,62,280215,62,630
1771.411,6,99,9240,66,65,27252,65,5577,33,59,55352,59,3663
0.359,17,18,5548,8,318,51,1350,2768,10,250,33,1350,2780
105.313,6,951,491536,545,842,193,1152,470164,406,427,259,1179,21372
1799.499,1,16,896,16,28,119966,28,896,0,0,0,0,0
1740.833,6,87,6322,58,31,30540,31,3915,29,31,62172,31,2407
7.998,6,19,8351,9,275,999,275,643,10,1216,805,1440,7708
300.534,6,15,2100,8,184,42909,184,536,7,424,50060,434,1564
0.238,17,2,136,1,32,0,32,60,1,48,0,48,76
0.04,17,2,152,1,48,0,48,76,1,48,0,48,76
1787.706,17,87,3648,86,14,21031,14,3612,1,8,0,8,36
4.959,17,6,1392,6,204,991,204,1392,0,0,0,0,0
280.46,6,30,7432,14,158,21573,267,1357,16,678,18694,3456,6075
240.324,6,47,9287,24,519,10448,1402,5946,23,237,10923,618,3341
26.095,6,14,1522,7,302,4349,302,964,7,83,4272,83,558
239.905,17,10,760,10,48,26656,48,760,0,0,0,0,0
1795.338,1,58,4872,58,56,31497,56,4872,0,0,0,0,0
0.363,6,12,1653,6,288,68,288,548,6,426,40,434,1105
0.021,17,2,152,1,48,0,48,76,1,48,0,48,76
0.434,6,24,6071,12,181,39,537,1526,12,652,37,1448,4545
1533.277,1,18,1008,18,28,90192,28,1008,0,0,0,0,0
0.191,6,46,21203,26,1080,7,1420,16182,20,467,9,2840,5021
4.052,17,8,616,4,33,1350,33,244,4,65,1345,65,372
1777.664,6,180,15480,120,69,14938,69,8940,60,69,30120,69,6540
87.863,6,74,48202,45,1175,1996,1408,39961,29,960,2199,3847,8241
1.007,17,5,1192,3,32,500,32,180,2,478,5,486,1012
300.641,6,44,8903,23,286,13665,797,2156,21,368,636,3488,6747
1761.738,1,72,6048,0,0,0,0,0,72,56,24813,56,6048
1786.277,6,104,8444,68,66,26660,66,4964,36,60,51031,60,3480
26.97,17,4,240,2,32,26969,32,120,2,32,26969,32,120
1792.739,17,157,10048,157,36,11491,36,10048,0,0,0,0,0
1795.798,17,448,39896,403,35,4467,288,25676,45,288,40019,288,14220
280.229,6,28,7352,13,158,23352,267,1317,15,678,20015,2045,6035
240.213,6,53,19296,27,869,9238,1418,16190,26,218,9608,580,3106
1798.309,6,355,22480,207,69,8729,69,12420,148,69,12233,69,10060
6.287,6,1296,1160246,796,1379,7,1408,1129582,500,931,12,2816,30664
280.228,6,28,7352,13,158,23352,267,1317,15,678,20013,2800,6035
373.662,6,18,1239,14,177,28743,177,913,4,110,20062,110,326
52.336,6,60,16778,31,677,305,1460,6119,29,451,1862,1460,10659
13.717,6,2059,1894257,1306,1372,10,1408,1850437,753,931,18,2816,43820
8.638,6,84,26573,43,567,205,1152,20451,41,407,209,1152,6122
1.469,6,57,24104,32,997,47,1460,18283,25,400,53,1460,5821
40.966,6,22,1353,11,222,4095,222,666,11,231,4095,231,687
1743.842,6,95,7203,63,38,28126,205,4476,32,33,56243,98,2727
241.145,6,60,16198,29,696,8611,1368,12704,31,187,8036,580,3494
0.006,17,2,367,1,39,0,39,67,1,272,0,272,300
59.411,6,28,7217,13,155,4950,267,1306,15,482,4243,2840,5911
6.812,6,398,325140,213,1017,32,1360,35291,185,1701,36,7288,289849
1.379,6,26,8108,12,164,106,267,1288,14,869,90,1368,6820
1.254,6,10,1687,7,100,209,100,384,3,1179,499,1179,1303
0.816,6,12,1941,6,288,159,288,836,6,426,126,434,1105
113.03,17,4,1344,4,308,37676,308,1344,0,0,0,0,0
1791.715,17,179,13962,179,50,10065,50,13962,0,0,0,0,0
1795.161,17,80,3354,79,14,23014,14,3318,1,8,0,8,36
0.427,6,10,967,5,256,105,256,460,5,303,104,303,507
321.413,17,6,2028,6,310,64282,320,2028,0,0,0,0,0
7.865,6,769,673670,477,1338,16,1368,652558,292,776,26,1473,21112
133.631,17,4,352,2,60,133630,60,176,2,60,133630,60,176
2.681,6,3,211,1,0,0,0,40,2,91,2664,91,171
84.059,6,55,31881,33,863,149,1360,12582,22,1314,3996,4116,19299
14.921,6,2597,2499050,1722,1375,8,1408,2448886,875,776,16,1408,50164
5.022,17,4,514,2,36,5009,36,128,2,165,5010,187,386
1.075,6,31,13239,15,529,76,1360,3290,16,845,59,1360,9949
1748.93,6,95,7203,63,38,28208,205,4476,32,33,56407,98,2727
61.568,6,47,26707,29,1030,2198,1408,19027,18,842,3606,2816,7680
3.218,6,10,2946,4,92,1072,92,296,6,1165,603,1448,2650
1.266,6,11,1727,7,100,211,100,384,4,589,335,1152,1343
4.702,2,2,64,2,8,4702,8,64,0,0,0,0,0
0.005,17,2,396,1,39,0,39,67,1,301,0,301,329
1618.806,1,8,448,8,28,231258,28,448,0,0,0,0,0
1777.169,17,73,3060,72,14,25030,14,3024,1,8,0,8,36
15.976,6,2450,2174464,1441,1422,10,1448,2115340,1009,776,15,1448,59124
1760.262,6,122,12193,75,63,23787,721,6267,47,96,38261,1448,5926
3.82,17,4,352,4,60,1273,60,352,0,0,0,0,0
0.006,6,2,99,1,0,0,0,40,1,7,0,7,59
1779.655,17,140,11200,70,48,25791,48,5320,70,56,25792,56,5880
1773.523,17,140,11200,70,48,25703,48,5320,70,56,25703,56,5880
1787.663,6,105,8280,68,63,26681,63,4862,37,57,49654,57,3418
2.084,17,6,460,3,40,1033,41,206,3,56,1033,57,254
181.612,17,3,1026,1,300,0,300,328,2,321,180618,321,698
755.882,2,7,224,7,8,125980,8,224,0,0,0,0,0
1798.79,17,448,39896,403,35,4474,288,25676,45,288,40020,288,14220
0.257,17,2,304,1,60,0,60,88,1,188,0,188,216
1774.632,1,74,6216,0,0,0,0,0,74,56,24310,56,6216
575.981,6,8,692,8,46,82283,62,692,0,0,0,0,0
1.137,6,25,8056,12,164,87,267,1288,13,869,80,1440,6768
1785.857,6,371,23465,213,69,8423,69,13005,158,69,11374,69,10460
8.45,6,1809,1685361,1153,1384,7,1408,1646585,656,776,12,1408,38776
0.157,17,9,1137,9,98,19,220,1137,0,0,0,0,0
1680.22,17,12,498,11,14,168022,14,462,1,8,0,8,36
588.103,6,93,13107,42,141,12310,722,4944,51,235,11757,1380,8163
226.099,17,6,2016,6,308,45219,308,2016,0,0,0,0,0
12.86,6,15,6014,4,106,4286,106,274,11,588,1263,1917,5740
77.323,6,40,10327,17,366,4824,1361,3092,23,335,3508,2804,7235
13.442,6,998,875128,623,1327,21,1368,849016,375,776,35,1473,26112
1.513,6,51,20262,29,894,54,1360,14606,22,433,63,1360,5656
1794.498,17,87,3648,86,14,21111,14,3612,1,8,0,8,36
1744.889,6,95,7203,63,38,28143,205,4476,32,33,56274,98,2727
34.297,1,38,3952,0,0,0,0,0,38,76,926,76,3952
5.436,6,632,541017,382,1344,14,1368,521513,250,776,20,1473,19504
280.566,6,29,7392,13,158,23380,267,1317,16,603,18699,2036,6075
17.144,17,30,14701,15,700,1221,1350,10934,15,223,1221,1350,3767
28.383,6,17,5890,10,290,3153,517,1109,7,1102,4728,1408,4781
0.298,6,21,7281,12,334,26,663,1969,9,967,36,1906,5312
1783.338,17,140,11200,70,48,25845,48,5320,70,56,25845,56,5880
3.161,6,22,6404,10,262,346,517,1316,12,744,283,1418,5088
49.505,6,27,7177,13,155,4125,267,1306,14,530,3807,3417,5871
17.825,6,43,27537,21,884,891,1460,6189,22,1363,839,2920,21348
13.425,6,639,1104052,367,232,36,517,21501,272,3986,49,28160,1082551
8.669,6,14,2242,8,210,1229,210,844,6,545,1727,904,1398
0.245,6,50,23524,28,1079,9,1420,18411,22,467,11,1883,5113
0.247,17,2,178,1,35,0,35,63,1,87,0,87,115
1757.43,17,23,7233,23,286,79883,1123,7233,0,0,0,0,0
1677.566,1,7,392,7,28,279594,28,392,0,0,0,0,0
1666.385,1,60,5040,60,56,28243,56,5040,0,0,0,0,0
1768.002,6,100,7525,65,38,27625,205,4611,35,33,51991,98,2914
1787.575,6,102,8228,68,64,26680,64,4896,34,58,54166,58,3332
1796.393,17,80,3354,79,14,23030,14,3318,1,8,0,8,36
360.964,2,5,160,5,8,90241,8,160,0,0,0,0,0
0.287,6,10,1514,5,503,71,503,771,5,475,71,475,743
0.026,17,2,560,1,60,0,60,88,1,444,0,444,472
14.006,6,105,34653,54,633,264,1152,28131,51,447,274,1179,6522
240.197,6,59,19776,30,797,8282,1408,16722,29,192,8578,580,3054
0.928,6,11,1727,7,100,154,100,384,4,589,219,1152,1343
1798.897,1,58,4872,58,56,31559,56,4872,0,0,0,0,0
0.116,6,2,753,1,673,0,673,713,1,0,0,0,40
1727.007,17,344,78674,344,200,5035,422,78674,0,0,0,0,0
0.392,6,27,8920,14,227,30,547,1644,13,941,30,1448,7276
26.958,6,3380,3212772,2161,1407,12,1448,3144672,1219,776,21,1448,68100
0.556,6,15,1785,8,288,55,288,640,7,426,64,434,1145
1791.663,17,140,11200,70,48,25966,48,5320,70,56,25966,56,5880
0.069,6,2,92,1,0,0,0,52,1,0,0,0,40
0.046,17,2,1152,1,548,0,548,576,1,548,0,548,576
1786.71,6,115,11948,72,134,25164,1291,7706,43,70,42538,241,4242
12.246,17,10,845,5,34,3059,34,310,5,79,3051,79,535
1259.795,2,10,320,10,8,139977,8,320,0,0,0,0,0
1790.101,17,180,11520,180,36,10000,36,11520,0,0,0,0,0
0.211,6,41,16602,23,974,9,1420,11661,18,420,11,1420,4941
1794.173,1,68,5712,68,56,26778,56,5712,0,0,0,0,0
126.231,6,23,10096,12,541,62,1360,2677,11,1393,12609,3934,7419
782.074,2,7,224,7,8,130345,8,224,0,0,0,0,0
1778.608,6,384,34169,171,67,10461,616,12969,213,90,8389,1698,21200
13.904,6,1899,1745126,1179,1400,11,1448,1703010,720,776,19,1448,42116
280.58,6,27,7312,13,158,23381,267,1317,14,775,21580,3445,5995
15.162,17,15,8939,6,618,3026,1350,3880,9,534,1891,1350,5059
1763.905,2,14,448,14,8,135685,8,448,0,0,0,0,0
1745.615,1,74,4144,74,28,23912,28,4144,0,0,0,0,0
0.48,6,22,7345,13,334,40,663,2021,9,1209,56,1946,5324
11.014,6,51,12055,29,136,393,426,2567,22,614,516,2720,9488
280.474,6,28,7352,13,158,23372,267,1317,15,678,20028,2085,6035
1786.418,6,117,13969,76,83,23818,516,6038,41,161,44657,1452,7931
38.55,1,43,4472,0,0,0,0,0,43,76,917,76,4472
32.245,6,9,396,2,0,1495,0,88,7,0,5332,0,308
0.12,17,2,266,1,41,0,41,69,1,169,0,169,197
8.098,1,9,756,0,0,0,0,0,9,56,1012,56,756
701.288,1,7,667,7,67,116881,91,667,0,0,0,0,0
1790.715,6,356,22520,208,69,8650,69,12460,148,69,12181,69,10060
6.579,6,733,634863,454,1327,14,1368,615691,279,931,22,2841,19172
10.874,6,49,20153,28,1027,396,1360,14511,21,435,535,2667,5642
1642.801,1,8,448,8,28,234685,28,448,0,0,0,0,0
257.454,17,4,240,2,32,257453,32,120,2,32,257453,32,120
721.923,2,8,256,8,8,103131,8,256,0,0,0,0,0
1.295,6,51,21546,28,979,47,1440,15850,23,433,50,1440,5696
66.833,6,27,7177,13,155,5569,267,1306,14,530,5140,3417,5871
317.589,1,5,280,5,28,79397,28,280,0,0,0,0,0
22.416,6,31,8912,14,158,1724,267,1357,17,763,1395,2076,7555
481.35,2,4,128,4,8,160450,8,128,0,0,0,0,0
1720.447,17,12,498,11,14,172044,14,462,1,8,0,8,36
0.534,6,26,9039,13,266,44,705,1750,13,943,43,1402,7289
8.658,6,35,8298,17,371,541,797,1825,18,441,498,1360,6473
1785.862,6,365,23087,211,69,8504,69,12787,154,69,11672,69,10300
0.263,17,3,451,2,39,181,39,134,1,289,0,289,317
0.444,6,12,1653,6,288,86,288,548,6,426,53,434,1105
14.454,6,1852,1641857,1154,1369,12,1380,1608239,698,421,20,1923,33618
0.021,17,5,1000,3,60,6,60,264,2,340,10,340,736
3.134,17,3,201,3,39,1567,39,201,0,0,0,0,0
280.445,6,29,7392,13,158,23370,267,1317,16,678,18692,2760,6075
280.18,6,28,7352,13,158,23348,267,1317,15,678,20009,3436,6035
1.104,17,2,142,1,35,0,35,63,1,51,0,51,79
1746.615,6,95,7203,63,38,28171,205,4476,32,33,56334,98,2727
22.855,6,14,1025,7,222,3807,222,506,7,231,3806,231,519
0.33,17,8,2758,8,316,47,355,2758,0,0,0,0,0
1796.62,17,449,39928,404,35,4458,288,25708,45,288,40017,288,14220
1.86,17,2,192,1,60,0,60,88,1,76,0,76,104
208.696,6,18,5839,10,784,23188,1360,3538,8,247,29777,272,2301
1783.828,6,372,25919,215,98,8335,469,15223,157,69,11434,69,10696
8.346,6,1380,1264812,837,1431,9,1448,1231288,543,776,15,1448,33524
144.498,17,6,456,6,48,28899,48,456,0,0,0,0,0
122.413,6,9,515,5,43,30603,43,299,4,0,40802,0,216
1143.083,2,7,224,7,8,190513,8,224,0,0,0,0,0
1744.167,6,97,7307,63,38,28131,205,4476,34,33,52845,98,2831
1799.195,6,127,8051,72,47,25337,208,4921,55,31,33314,31,3130
63.983,6,25,7180,6,154,12796,267,712,19,380,3550,1926,6468
182.911,6,6,1257,4,327,60970,414,815,2,181,182667,270,442
1783.19,6,102,8296,68,65,26614,65,4930,34,59,54033,59,3366
1746.238,6,97,7369,63,38,28165,205,4476,34,33,52909,98,2893
5.849,6,39,7285,20,218,307,314,3423,19,442,310,1152,3862
300.035,1,4,224,4,28,100011,28,224,0,0,0,0,0
15.813,6,2519,2428462,1679,1371,9,1408,2380118,840,776,18,1408,48344
4.016,17,8,1288,4,33,1335,33,244,4,233,1334,233,1044
1787.228,6,104,8424,68,64,26675,64,4896,36,58,51061,58,3528
0.287,6,9,1002,5,213,71,213,417,4,421,73,421,585
1740.583,17,30,31650,30,1027,60020,1027,31650,0,0,0,0,0
0.266,17,2,776,2,360,266,360,776,0,0,0,0,0
1799.859,2,15,480,15,8,128561,8,480,0,0,0,0,0
0.043,17,8,2454,8,278,6,317,2454,0,0,0,0,0
51.222,17,6,528,3,48,25607,48,228,3,72,25606,72,300
19.935,17,32,10343,14,389,1531,1350,5847,18,221,1170,1350,4496
1790.731,17,274,55850,274,175,6559,356,55850,0,0,0,0,0
282.343,6,30,8077,13,158,23528,267,1317,17,607,17645,1400,6760
1782.342,17,83,3480,82,14,22004,14,3444,1,8,0,8,36
1787.105,6,102,8364,68,66,26673,66,4964,34,60,54151,60,3400
47.246,17,26,2288,13,48,3936,48,988,13,72,3936,72,1300
0.555,6,20,7183,12,271,49,517,1718,8,1260,78,1891,5465
1797.791,6,373,26028,216,98,8361,469,15263,157,69,11521,69,10765
300.761,6,44,11344,24,586,13076,1408,4262,20,548,661,2126,7082
712.381,2,7,224,7,8,118730,8,224,0,0,0,0,0
1795.266,1,160,16960,160,78,11290,78,16960,0,0,0,0,0
1.23,17,6,840,3,64,511,64,276,3,160,512,160,564
310.785,17,6,360,3,32,155392,32,180,3,32,155391,32,180
123.396,17,4,352,2,48,123387,48,152,2,72,123386,72,200
1772.412,6,180,15480,120,69,14894,69,8940,60,69,30034,69,6540
1744.093,6,95,7203,63,38,28130,205,4476,32,33,56248,98,2727
67.147,6,22,8406,12,327,60,673,1493,10,1083,7445,4080,6913
0.062,6,9,1243,5,145,15,145,349,4,730,16,730,894
1740.968,6,102,7970,66,45,26784,205,4902,36,35,49737,98,3068
1796.032,1,250,26500,250,78,7212,78,26500,0,0,0,0,0
58.187,6,136,49980,71,664,831,1360,36768,65,392,907,1360,13212
1795.209,6,416,25016,209,69,8630,69,12500,207,35,8714,69,12516
0.284,6,20,4960,10,137,31,267,1092,10,692,30,1467,3868
0.009,1,2,212,2,78,9,78,212,0,0,0,0,0
0.419,17,8,2750,8,315,59,354,2750,0,0,0,0,0
0.135,17,2,138,1,33,0,33,61,1,49,0,49,77
1.022,17,5,880,4,60,332,60,352,1,500,0,500,528
25.113,6,24,6231,14,117,1931,159,1337,10,727,2788,1418,4894
1.696,6,40,8389,21,320,84,1162,2808,19,437,82,2715,5581
1.976,6,32,9045,19,285,109,588,1620,13,862,147,1380,7425
210.525,6,166,134496,110,1305,1931,1408,120651,56,642,3390,2439,13845
1681.314,17,16,1265,8,30,240184,37,471,8,71,240184,136,794
402.798,6,18,1242,14,180,30984,180,916,4,110,20063,110,326
300.744,6,42,8879,22,315,14321,916,2234,20,388,806,2128,6645
29.077,6,14,6006,4,92,1495,92,308,10,1715,3211,2330,5698
0.516,6,25,7887,16,364,34,1125,3193,9,721,63,1420,4694
0.33,6,27,9042,13,247,27,624,1672,14,947,24,1448,7370
0.325,17,4,280,2,34,324,34,124,2,50,323,50,156
1797.726,6,375,26646,217,104,8322,469,15772,158,69,11447,69,10874
1751.603,1,8,448,8,28,250229,28,448,0,0,0,0,0
375.067,6,23,1535,16,177,25004,177,1053,7,110,10402,110,482
1410.667,6,121,7625,64,48,22391,208,4508,57,31,25186,31,3117
0.446,6,20,7238,13,335,37,668,2026,7,1210,69,1946,5212
27.181,17,16,1408,8,48,3874,48,608,8,72,3869,72,800
1794.301,17,83,3480,82,14,22151,14,3444,1,8,0,8,36
1.412,6,50,20016,28,878,52,1360,14360,22,433,58,1360,5656
405.974,1,4,224,4,28,135324,28,224,0,0,0,0,0
0.264,17,3,451,2,39,206,39,134,1,289,0,289,317
144.676,6,30,17578,16,708,46,1360,4214,14,1421,11117,3527,13364
1795.911,6,389,27013,222,96,8126,469,15848,167,69,10817,69,11165
0.763,6,26,5649,12,140,69,267,1184,14,650,53,1420,4465
1795.168,17,449,39928,404,35,4454,288,25708,45,288,40022,288,14220
1791.602,1,261,14616,261,28,6890,28,14616,0,0,0,0,0
4.132,2,2,64,2,8,4132,8,64,0,0,0,0,0
1795.138,6,247,36274,153,302,11810,302,26386,94,83,19302,83,9888
1669.111,1,8,448,8,28,238444,28,448,0,0,0,0,0
12.137,17,20,4295,10,37,1347,37,650,10,336,1347,348,3645
1794.87,6,359,22709,209,69,8629,69,12569,150,69,12046,69,10140
512.701,17,10,3360,10,308,56966,308,3360,0,0,0,0,0
240.29,6,46,9051,24,519,10447,1402,5930,22,218,11442,617,3121
842.332,6,119,9137,59,139,14514,516,3874,60,39,14276,63,5263
1682.78,17,14,1036,7,30,280455,30,406,7,62,280456,62,630
0.044,6,2,84,1,0,0,0,44,1,0,0,0,40
1.647,6,13,2311,8,188,235,245,700,5,1407,349,1407,1611
1781.346,17,66,2766,65,14,27833,14,2730,1,8,0,8,36
280.236,6,29,7392,13,158,23353,267,1317,16,603,18678,1400,6075
1681.63,17,16,1265,8,30,240228,37,471,8,71,240226,136,794
2.036,6,7,295,4,0,678,0,164,3,7,475,7,131
1798.455,17,774,46656,774,32,2326,37,46656,0,0,0,0,0
1.884,17,2,144,1,36,0,36,64,1,52,0,52,80
1628.143,1,39,2184,39,28,42845,28,2184,0,0,0,0,0
39.206,6,52,18453,27,273,1502,754,3416,25,824,1627,1440,15037
300.831,6,37,11372,21,566,15041,1402,4498,16,548,577,2804,6874
300.758,6,27,15915,16,195,20050,431,1644,11,1521,12060,5632,14271
1.981,17,35,25574,17,901,123,1350,15796,18,515,114,1350,9778
2.122,17,6,1449,3,40,1054,40,204,3,387,999,407,1245
205.935,17,4,352,2,60,205934,60,176,2,60,205934,60,176
1.234,6,3,182,1,0,0,0,40,2,31,979,31,142
1.476,6,49,18691,28,910,54,1460,13030,21,437,64,2615,5661
484.136,1,3,168,3,28,242068,28,168,0,0,0,0,0
381.27,17,8,704,4,48,127086,48,304,4,72,127086,72,400
5.226,6,20,6738,10,275,580,275,679,10,706,490,2840,6059
5.425,6,12,2271,7,188,904,245,660,5,1407,1293,1407,1611
0.116,17,2,227,1,32,0,32,60,1,139,0,139,167
1253.916,6,75,5948,48,65,26679,65,3480,27,57,48224,59,2468
61.809,6,71,50079,45,1201,1404,1408,41992,26,961,2463,3847,8087
1741.336,17,30,6930,30,203,60046,203,6930,0,0,0,0,0
11.654,6,1742,1595950,1129,1362,10,1420,1567079,613,475,19,1883,28871
695.346,6,76,9574,38,135,18793,722,4944,38,165,18788,1408,4630
240.311,6,43,9032,21,523,12015,1408,5811,22,229,11443,618,3221
1680.548,17,12,498,11,14,168054,14,462,1,8,0,8,36
0.051,17,2,176,1,48,0,48,76,1,72,0,72,100
1754.945,6,4053,4426246,1316,149,1334,877,79403,2737,1578,641,8412,4346843
252.684,2,2,64,2,8,252684,8,64,0,0,0,0,0
1683.555,17,18,1494,9,31,210440,37,536,9,78,210412,136,958
1775.313,17,140,11200,70,48,25729,48,5320,70,56,25729,56,5880
1.258,17,6,1010,3,36,626,36,192,3,244,627,274,818
0.007,6,2,149,1,69,0,69,109,1,0,0,0,40
280.317,6,30,7432,13,158,23359,267,1317,17,543,17518,1400,6115
1795.583,17,449,39928,404,35,4455,288,25708,45,288,40015,288,14220
327.122,6,90,30604,46,581,7269,1402,11127,44,715,7607,1402,19477
126.98,17,10,3345,10,306,14108,308,3345,0,0,0,0,0
0.063,17,4,284,2,32,50,32,120,2,54,15,60,164
1.049,17,4,668,2,39,960,39,134,2,239,0,239,534
1772.253,6,180,15480,120,69,14892,69,8940,60,69,30031,69,6540
7.071,6,63,20310,33,552,220,1152,15683,30,489,232,1179,4627
0.073,17,2,250,1,49,0,49,77,1,145,0,145,173
0.037,6,3,151,2,31,0,31,111,1,0,0,0,40
65.723,6,17,1770,8,180,398,180,964,9,110,8193,110,806
381.004,6,27,1770,18,180,22412,180,1184,9,110,8680,110,586
0.688,17,21,9924,10,433,73,1350,4610,11,455,65,1350,5314
0.134,6,9,1340,5,145,33,145,349,4,827,41,827,991
0.442,6,3,132,2,0,36,0,92,1,0,0,0,40
215.501,6,32,8952,14,158,16577,267,1357,18,624,12674,1400,7595
0.354,6,10,968,5,256,85,256,460,5,304,85,304,508
1789.954,6,366,25541,213,100,8443,469,14936,153,69,11775,69,10605
1.032,6,27,8506,15,229,61,583,2007,12,1201,77,3151,6499
4.037,6,2,88,2,0,0,0,88,0,0,0,0,0
1770.232,6,106,10681,68,88,26421,818,6532,38,63,47839,193,4149
2.919,17,3,468,3,128,1459,128,468,0,0,0,0,0
75.086,17,4,530,2,36,75075,36,128,2,173,75076,187,402
1.981,6,54,22039,29,938,70,1360,16215,25,476,74,2715,5824
2.068,1,2,112,2,28,2068,28,112,0,0,0,0,0
4.774,6,39,7285,20,218,251,314,3423,19,516,250,1179,3862
0.0,17,1,67,1,39,0,39,67,0,0,0,0,0
0.034,17,4,420,2,33,0,33,122,2,121,9,145,298
0.078,17,4,1184,2,64,64,64,184,2,472,53,472,1000
1.698,17,2,312,2,128,1698,128,312,0,0,0,0,0
0.184,17,2,154,1,33,0,33,61,1,65,0,65,93
1776.991,17,74,24672,74,305,24342,308,24672,0,0,0,0,0
0.178,1,2,112,2,28,178,28,112,0,0,0,0,0
1786.743,6,102,8228,68,64,26667,64,4896,34,58,54141,58,3332
1798.115,6,296,28880,146,136,12399,208,21888,150,31,12066,31,6992
1798.967,17,142,11360,71,48,25699,48,5396,71,56,25699,56,5964
1740.661,17,29,6815,29,207,62166,207,6815,0,0,0,0,0
1783.125,17,140,11200,70,48,25842,48,5320,70,56,25842,56,5880
107.159,6,57,32877,36,1071,3061,1448,24379,21,672,5345,2359,8498
11.015,6,20,4442,11,275,1101,275,998,9,768,776,1440,3444
22.536,6,3289,3120188,2157,1369,10,1408,3056660,1132,931,19,2816,63528
372.204,6,18,1242,14,180,28631,180,916,4,110,20073,110,326
0.737,6,10,968,5,256,182,256,460,5,304,181,304,508
300.797,6,46,10129,23,648,13672,1460,4252,23,290,667,1460,5877
5.016,17,4,558,2,36,5005,36,128,2,187,5006,187,430
0.711,6,14,1745,7,288,102,288,600,7,426,89,434,1145
21.427,17,4,824,2,48,21405,48,152,2,308,21415,308,672
280.259,6,29,7392,14,158,21558,267,1357,15,678,20013,3436,6035
315.136,6,20,2429,7,242,52521,517,1111,13,323,26260,499,1318
0.064,6,10,1514,5,503,16,503,771,5,475,16,475,743
393.245,6,26,3910,19,342,21846,342,2490,7,225,124,233,1420
37.115,17,22,1672,22,48,1767,48,1672,0,0,0,0,0
1120.87,17,10,2745,5,30,280212,30,290,5,463,280214,463,2455
0.013,17,2,460,1,39,0,39,67,1,365,0,365,393
1789.755,1,74,4144,74,28,24517,28,4144,0,0,0,0,0
11.186,6,29,15043,13,499,912,722,3518,16,1209,731,1380,11525
0.073,6,9,1339,5,145,18,145,349,4,826,22,826,990
11.852,6,1903,1629153,1150,1363,10,1380,1594791,753,421,15,1923,34362
1773.326,6,204,22399,130,75,13746,267,10057,74,133,24287,1997,12342
9.294,6,23,6752,7,156,1549,267,758,16,486,617,1452,5994
1.411,6,24,8004,12,164,109,267,1288,12,1216,108,4104,6716
0.676,6,21,5000,11,137,67,267,1132,10,692,62,1467,3868
27.913,6,18,2401,8,328,3987,593,1081,10,396,3086,580,1320
0.005,1,2,112,2,28,5,28,112,0,0,0,0,0
94.755,6,33,5208,20,180,4987,722,2130,13,399,1268,1408,3078
4.177,6,2,88,2,0,0,0,88,0,0,0,0,0
0.214,6,12,3704,6,171,41,171,491,6,964,42,1448,3213
0.277,17,4,916,2,39,19,39,134,2,363,263,381,782
122.733,6,23,9218,12,304,70,597,1425,11,1048,12257,1721,7793
1771.299,6,103,9448,66,65,27250,65,5577,37,59,49200,59,3871
438.852,17,64,71446,64,1088,6965,1451,71446,0,0,0,0,0
240.341,6,44,8786,22,515,11444,1402,5795,22,204,11444,617,2991
0.479,6,54,22879,29,1027,17,1380,17637,25,421,17,1923,5242
1791.706,1,236,13216,236,28,7624,28,13216,0,0,0,0,0
0.387,6,13,1693,7,288,60,288,588,6,426,42,434,1105
13.357,17,2,152,2,48,13357,48,152,0,0,0,0,0
280.377,6,30,7432,13,158,23364,267,1317,17,603,17521,2036,6115
6.083,17,3,228,3,48,3041,48,228,0,0,0,0,0
1.249,6,46,18712,27,861,48,1360,13176,19,476,60,2715,5536
165.71,6,51,7445,24,151,7204,722,3074,27,174,5552,1448,4371
1656.552,1,8,448,8,28,236650,28,448,0,0,0,0,0
388.787,6,18,1242,14,180,29906,180,916,4,110,20075,110,326
1.535,6,50,19384,27,898,59,1460,13688,23,433,60,1460,5696
1770.599,1,58,4872,0,0,0,0,0,58,56,31063,56,4872
0.245,17,2,152,1,48,0,48,76,1,48,0,48,76
1592.999,1,64,3584,64,28,25285,28,3584,0,0,0,0,0
32.367,6,27,7177,13,155,2697,267,1306,14,530,2489,2840,5871
1743.861,6,95,7203,63,38,28126,205,4476,32,33,56246,98,2727
280.025,6,30,7432,13,158,23335,267,1317,17,543,17500,1400,6115
0.035,6,5,200,2,0,0,0,80,3,0,17,0,120
1796.719,17,447,39864,402,35,4480,288,25644,45,288,40021,288,14220
0.375,17,2,144,1,36,0,36,64,1,52,0,52,80
41.406,6,16,4887,10,290,4600,517,1109,6,1152,8277,1460,3778
1.91,17,2,672,2,308,1910,308,672,0,0,0,0,0
11.524,6,1572,1321986,881,1410,12,1448,1277578,691,776,16,1448,44408
0.001,17,2,777,2,360,1,368,777,0,0,0,0,0
300.235,6,37,12280,20,593,15801,1408,4656,17,673,15118,1578,7624
11.238,6,27,11373,13,275,936,275,1078,14,1080,828,1420,10295
1756.6,6,110,6576,62,26,28796,26,3652,48,26,37373,26,2924
240.404,6,63,20912,32,802,7754,1418,17729,31,195,8013,580,3183
4.164,6,33,9061,14,158,320,267,1357,19,578,230,1400,7704
19.62,6,1304,1225314,853,1360,22,1368,1194034,451,776,43,2736,31280
0.131,6,9,1343,5,145,32,145,349,4,830,29,830,994
1.449,6,47,18957,27,876,55,1360,13381,20,476,67,2715,5576
481.3,2,4,128,4,8,160433,8,128,0,0,0,0,0
392.874,6,18,1242,14,180,30221,180,916,4,110,20082,110,326
0.903,17,4,308,2,33,902,33,122,2,65,891,65,186
29.309,6,46,9081,23,186,1332,722,2604,23,616,1322,1380,6477
2.036,6,31,7399,17,244,127,656,2394,14,555,155,1420,5005
832.331,6,125,16104,60,87,12811,267,5108,65,142,13004,1460,10996
407.332,6,108,6321,59,69,7022,69,3395,49,34,8486,64,2926
2.082,6,23,6360,12,295,188,822,1963,11,988,111,1731,4397
1.343,6,50,18741,27,852,51,1360,13045,23,433,52,1360,5696
3.468,17,2,136,1,32,0,32,60,1,48,0,48,76
5.876,6,18,3381,10,211,647,211,974,8,665,838,904,2407
0.77,17,4,352,2,60,769,60,176,2,60,763,60,176
5.377,6,16,6585,4,275,1732,275,439,12,566,472,1440,6146
0.692,6,6,1117,3,0,346,0,144,3,853,236,853,973
240.678,6,49,10630,23,192,10939,752,2776,26,540,9626,2348,7854
48.717,6,19,6889,6,165,4793,204,650,13,692,4058,1438,6239
20.109,6,18,2368,10,189,2234,517,1298,8,323,2870,499,1070
2.911,6,19,6086,9,267,363,501,1165,10,564,309,1420,4921
0.024,17,4,608,2,60,9,60,176,2,188,11,188,432
1787.361,6,149,26104,90,356,20082,1256,19626,59,91,30814,192,6478
5.113,6,42,7389,22,218,243,314,3503,20,440,256,1152,3886
351.91,17,23,6546,23,256,15995,464,6546,0,0,0,0,0
42.983,6,36,8455,18,410,504,882,1982,18,478,2521,2128,6473
0.097,17,4,976,2,60,87,60,176,2,372,84,372,800
0.028,17,2,412,1,48,0,48,76,1,308,0,308,336
25.341,6,60,14186,33,250,791,1321,6360,27,561,922,1440,7826
240.135,6,39,9292,17,205,15008,517,2127,22,668,11434,2424,7165
0.173,6,27,7296,13,155,14,267,1301,14,603,12,2036,5995
1784.135,17,219,58433,219,238,8184,422,58433,0,0,0,0,0
1764.752,2,15,480,15,8,126053,8,480,0,0,0,0,0
0.246,6,46,22394,27,1087,9,1420,17413,19,467,13,1883,4981
0.19,6,10,1671,6,552,37,948,1348,4,159,62,159,323
5.228,6,25,7542,11,286,522,721,1590,14,598,337,1414,5952
1792.004,6,359,22709,209,69,8615,69,12569,150,69,12026,69,10140
1.179,6,10,1687,7,100,196,100,384,3,1179,462,1179,1303
1787.197,17,87,3648,86,14,21025,14,3612,1,8,0,8,36
274.829,1,2,120,2,32,274829,32,120,0,0,0,0,0
0.346,17,8,2758,8,316,49,355,2758,0,0,0,0,0
1682.899,17,16,1184,8,30,240408,30,464,8,62,240409,62,720
0.217,17,2,148,1,32,0,32,60,1,60,0,60,88
0.01,17,3,628,2,30,0,30,116,1,484,0,484,512
33.542,6,30,5252,15,180,2381,721,1870,15,371,2381,1368,3382
0.641,6,23,7788,12,257,58,745,1660,11,924,58,1418,6128
1740.477,17,26,6006,26,203,69619,203,6006,0,0,0,0,0
0.052,6,7,423,4,43,6,43,259,3,0,23,0,164
1781.243,17,276,65455,276,209,6477,422,65455,0,0,0,0,0
239.28,6,29,7392,13,158,19940,267,1317,16,603,15950,1400,6075
0.404,6,12,1653,6,288,76,288,548,6,426,47,434,1105
1.263,6,49,20615,28,923,46,1360,14999,21,433,54,1360,5616
0.951,17,3,404,2,64,937,64,184,1,192,0,192,220
2.799,6,2,88,2,0,0,0,88,0,0,0,0,0
1740.535,17,30,31680,30,1028,60018,1028,31680,0,0,0,0,0
1795.2,17,80,3354,79,14,23015,14,3318,1,8,0,8,36
1765.271,17,298,70506,298,208,5943,356,70506,0,0,0,0,0
1771.425,6,131,11990,78,66,23005,66,6702,53,60,34063,60,5288
0.518,17,19,11666,9,665,64,1350,6242,10,514,53,1350,5424
32.106,6,48,9047,23,367,635,787,2138,25,346,1331,2128,6909
0.311,6,25,8965,13,261,25,683,1728,12,1100,27,2816,7237
125.472,2,2,64,2,8,125472,8,64,0,0,0,0,0
1786.856,6,103,8464,68,66,26669,66,4964,35,60,52551,60,3500
64.329,6,29,7661,10,149,7147,267,1452,19,388,3561,1420,6209
1.187,17,6,552,3,64,592,64,276,3,64,593,64,276
8.29,6,7,384,3,0,4145,0,160,4,0,1495,0,224
1799.14,17,449,39928,404,35,4464,288,25708,45,288,40022,288,14220
1787.353,6,363,24345,211,88,8511,469,13987,152,69,11834,69,10358
1790.013,17,178,11392,178,36,10113,36,11392,0,0,0,0,0
5.724,6,43,8329,22,227,272,314,4062,21,489,273,1179,4267
1720.51,17,12,498,11,14,172051,14,462,1,8,0,8,36
0.132,6,13,2100,7,329,21,500,1030,6,375,26,500,1070
1786.752,6,102,8296,68,65,26667,65,4930,34,59,54141,59,3366
0.179,17,2,152,1,48,0,48,76,1,48,0,48,76
1.169,6,45,18084,26,882,46,1360,12548,19,476,56,2715,5536
1788.546,17,87,3648,86,14,21041,14,3612,1,8,0,8,36
11.809,6,1748,1619867,1144,1365,10,1432,1591404,604,427,19,1432,28463
280.403,6,29,7392,13,158,23366,267,1317,16,678,18690,3536,6075
126.926,6,25,6418,7,273,1214,519,1103,18,382,7461,1420,5315
77.943,6,25,10089,12,531,54,1360,2637,13,988,6484,1360,7452
0.246,17,2,225,1,37,0,37,65,1,132,0,132,160
0.014,17,2,338,1,33,0,33,61,1,249,0,249,277
19.793,6,31,6255,16,338,1319,1314,2334,15,331,1394,1460,3921
5.047,17,4,288,2,36,5003,36,128,2,52,5003,52,160
0.308,6,25,6098,12,181,28,537,1526,13,555,23,1448,4572
171.383,6,31,7813,14,158,13183,267,1357,17,577,10708,1400,6456
0.206,6,25,7216,13,155,17,267,1301,12,678,18,2045,5915
1740.527,6,87,6322,58,31,30535,31,3915,29,31,62161,31,2407
2.733,17,3,1167,3,361,1366,361,1167,0,0,0,0,0
3.191,17,2,322,1,33,0,33,61,1,233,0,233,261
35.472,6,1918,1732053,1214,1374,29,1380,1693967,704,475,50,1923,38086
1751.934,6,95,7203,63,38,28257,205,4476,32,33,56500,98,2727
14.42,6,2332,2168650,1493,1374,9,1408,2120358,839,931,16,2816,48292
7.972,6,35,9207,19,259,442,464,1570,16,582,488,2128,7637
0.065,17,13,10041,7,742,10,1350,5390,6,747,4,1350,4651
257.497,17,3,1623,3,513,128748,687,1623,0,0,0,0,0
0.109,17,8,2758,8,316,15,355,2758,0,0,0,0,0
263.346,17,7,2434,7,319,43891,376,2434,0,0,0,0,0
5.717,6,44,8369,21,227,285,314,4022,23,489,247,1179,4347
1.278,6,47,19177,27,892,49,1360,13601,20,529,58,4075,5576
0.834,17,22,16160,11,727,83,1350,8307,11,685,72,1350,7853
23.855,6,35,8333,17,184,1490,721,2160,18,681,1392,1440,6173
63.028,6,57,37214,36,1145,1800,1448,29368,21,843,3125,2359,7846
0.315,6,26,9017,13,261,26,683,1728,13,943,25,1438,7289
0.342,6,28,9128,13,252,28,647,1692,15,831,23,1438,7436
1788.39,17,83,3480,82,14,22078,14,3444,1,8,0,8,36
0.274,17,2,167,1,39,0,39,67,1,72,0,72,100
1787.902,6,357,22629,208,69,8637,69,12460,149,69,12080,69,10169
240.314,6,56,17481,29,725,8582,1402,14569,27,187,9242,580,2912
27.874,17,6,456,6,48,5574,48,456,0,0,0,0,0
1744.275,6,95,7203,63,38,28133,205,4476,32,33,56260,98,2727
1.613,6,22,5961,12,108,146,147,919,10,927,152,1608,5042
280.24,6,25,7094,11,181,28024,267,1168,14,595,21554,1400,5926
1.035,17,4,580,2,40,1004,40,136,2,194,989,194,444
0.019,17,2,166,1,33,0,33,61,1,77,0,77,105
1799.728,1,342,28728,342,56,5277,56,28728,0,0,0,0,0
1798.103,2,25,800,25,8,74920,8,800,0,0,0,0,0
154.345,6,13,532,4,0,3905,0,164,9,0,19291,0,368
0.005,17,2,202,1,30,0,30,58,1,116,0,116,144
1781.878,6,106,8515,68,65,26595,65,4930,38,59,48156,59,3585
0.978,6,29,8200,15,222,58,540,1964,14,944,60,1591,6236
1.616,6,48,19119,27,885,62,1360,13503,21,433,70,1360,5616
21.579,6,6,531,2,275,21527,275,359,4,0,7123,0,172
942.338,6,54,3912,30,31,32488,31,2025,24,31,40963,31,1887
1.378,1,2,112,2,28,1378,28,112,0,0,0,0,0
0.02,6,13,3980,7,88,3,88,388,6,1670,3,1880,3592
417.398,6,21,1080,11,0,41733,0,572,10,0,46369,0,508
1.369,6,48,17901,26,859,54,1360,12245,22,433,56,1360,5656
1770.134,6,210,16152,78,68,22987,294,7644,132,48,13512,78,8508
299.943,6,6,364,4,31,99981,31,222,2,31,299665,31,142
0.776,6,11,1727,7,100,129,100,384,4,589,171,1152,1343
1794.2,1,58,4872,0,0,0,0,0,58,56,31477,56,4872
39.83,17,11,836,11,48,3983,48,836,0,0,0,0,0
0.43,6,10,968,5,256,105,256,460,5,304,105,304,508
105.183,6,29,6480,12,117,9561,159,1233,17,873,6573,1669,5247
2.371,6,30,10413,18,368,139,837,1829,12,1012,207,1420,8584
1757.563,6,4518,3724150,2132,149,824,924,126913,2386,1497,736,5632,3597237
248.69,17,3,1008,3,308,124345,308,1008,0,0,0,0,0
0.17,17,2,144,1,36,0,36,64,1,52,0,52,80
1776.155,17,73,3060,72,14,25016,14,3024,1,8,0,8,36
14.823,6,9,484,4,0,4941,0,216,5,0,3577,0,268
5.008,17,6,1392,6,204,1001,204,1392,0,0,0,0,0
67.84,6,41,10561,14,320,5218,1189,2808,27,317,2597,1420,7753
0.018,17,2,182,1,42,0,42,70,1,84,0,84,112
26.832,6,28,9881,7,154,578,267,752,21,517,1341,1420,9129
301.016,6,52,23243,30,1088,10379,1440,17561,22,399,421,1440,5682
302.511,17,42,10878,42,231,7378,388,10878,0,0,0,0,0
162.831,2,3,96,3,8,81415,8,96,0,0,0,0,0
1795.918,17,447,39296,404,35,4456,288,25708,43,288,40970,288,13588
0.104,6,7,423,4,43,22,43,259,3,0,22,0,164
1.796,6,16,3315,8,503,256,503,1454,8,475,256,475,1861
0.509,17,3,543,2,39,323,39,134,1,381,0,381,409
1732.141,1,69,5796,0,0,0,0,0,69,56,25472,56,5796
0.035,17,2,212,1,46,0,46,74,1,110,0,110,138
2.439,17,30,17121,15,632,171,1350,9900,15,453,171,1350,7221
3.933,17,5,514,4,32,1304,32,240,1,246,0,246,274
1787.59,6,102,8296,68,65,26680,65,4930,34,59,54165,59,3366
1757.009,6,109,6552,60,26,29779,26,3510,49,26,36603,26,3042
78.057,6,11,1003,6,332,15611,332,652,5,83,19496,83,351
1775.334,1,86,4816,86,28,20886,28,4816,0,0,0,0,0
1777.21,1,59,4956,59,56,30641,56,4956,0,0,0,0,0
0.051,17,2,421,1,47,0,47,75,1,318,0,318,346
1729.144,6,60,4400,40,33,44337,33,2740,20,31,90995,31,1660
0.523,17,3,451,2,39,514,39,134,1,289,0,289,317
1.003,17,5,728,3,32,499,32,180,2,246,5,246,548
1783.81,6,367,25512,213,99,8414,469,15005,154,69,11658,69,10507
1771.96,6,180,15480,120,69,14890,69,8940,60,69,30032,69,6540
280.296,6,30,7432,14,158,21561,267,1357,16,603,18679,2800,6075
114.032,17,2,148,2,46,114032,46,148,0,0,0,0,0
1787.908,6,365,25432,213,100,8433,469,14936,152,69,11840,69,10496
1.369,6,46,18601,27,853,52,1360,13065,19,476,66,2715,5536
1.085,6,25,8056,12,164,83,267,1288,13,869,76,1402,6768
0.293,6,26,9063,13,262,24,690,1735,13,949,24,2816,7328
1783.321,17,83,3480,82,14,22016,14,3444,1,8,0,8,36
3.601,17,2,656,2,300,3601,300,656,0,0,0,0,0
6.79,6,9,588,3,106,3248,106,234,6,90,1319,90,354
0.018,17,2,2756,2,1350,18,1350,2756,0,0,0,0,0
1785.15,17,87,3648,86,14,21001,14,3612,1,8,0,8,36
13.794,6,15,3220,6,92,2758,92,400,9,581,1693,1408,2820
5.016,17,4,558,2,36,5007,36,128,2,187,5006,187,430
615.916,6,191,41201,79,392,7896,1360,25254,112,139,5547,3289,15947
601.6,2,6,192,6,8,120320,8,192,0,0,0,0,0
388.663,6,83,19757,49,259,6828,1360,10830,34,419,11773,4649,8927
1795.729,6,244,35804,152,302,11892,302,26032,92,83,19733,83,9772
1788.365,17,280,58214,280,179,6409,422,58214,0,0,0,0,0
1.393,6,16,1472,9,256,137,256,880,7,304,181,304,592
1681.743,17,14,1036,7,30,280285,30,406,7,62,280284,62,630
0.139,17,2,685,1,308,0,308,336,1,321,0,321,349
1790.914,6,358,22669,209,69,8610,69,12500,149,69,12100,69,10169
1.491,6,2,88,2,0,0,0,88,0,0,0,0,0
0.075,1,2,112,2,28,75,28,112,0,0,0,0,0
0.472,17,2,184,1,32,0,32,60,1,96,0,96,124
151.501,6,23,9166,12,304,74,597,1425,11,1041,15132,1721,7741
0.337,6,26,9034,13,262,28,690,1735,13,1102,27,2804,7299
1620.13,1,7,392,7,28,270021,28,392,0,0,0,0,0
677.499,1,8,652,8,53,96785,78,652,0,0,0,0,0
1799.63,17,448,39896,403,35,4476,288,25676,45,288,40019,288,14220
0.008,6,2,421,1,0,0,0,40,1,341,0,341,381
282.477,6,28,7613,13,175,23539,267,1578,15,603,20171,1400,6035
96.836,6,29,14193,15,836,68,1460,5663,14,884,7435,1460,8530
1771.427,6,102,9487,66,66,27252,66,5610,36,60,50609,85,3877
74.181,6,29,7392,13,158,6181,267,1317,16,603,4942,2076,6075
0.918,6,25,10044,13,658,76,1440,3184,12,909,62,1485,6860
0.032,17,2,136,1,32,0,32,60,1,48,0,48,76
1791.961,1,56,4704,56,56,32581,56,4704,0,0,0,0,0
58.122,6,26,7143,12,156,5283,267,1272,14,530,4468,2840,5871
1745.287,6,100,7860,66,45,26850,205,4896,34,35,52875,98,2964
50.362,6,40,9675,20,631,813,1360,4011,20,373,2639,2667,5664
1679.575,17,12,498,11,14,167957,14,462,1,8,0,8,36
503.865,2,4,128,4,8,167955,8,128,0,0,0,0,0
23.818,6,16,1549,8,333,3400,444,990,8,231,3400,231,559
11.213,6,21,6825,12,275,1019,275,1038,9,1353,773,1440,5787
34.64,17,22,1936,11,48,3458,48,836,11,72,3462,72,1100
1771.847,6,99,9174,66,64,27259,64,5544,33,58,55367,58,3630
1793.342,17,66,2766,65,14,28020,14,2730,1,8,0,8,36
240.768,6,64,19382,31,752,8025,1418,15923,33,215,7523,580,3459
1120.931,17,10,2745,5,30,280229,30,290,5,463,280229,463,2455
20.249,6,17,2316,10,189,2249,517,1298,7,323,3365,499,1018
1797.744,1,59,4956,59,56,30995,56,4956,0,0,0,0,0
16.259,6,32,5197,16,179,1083,722,1939,16,342,1049,2026,3258
39.386,6,14,932,5,92,9846,92,348,9,92,4890,92,584
584.064,1,6,336,6,28,116812,28,336,0,0,0,0,0
8.159,1,9,756,0,0,0,0,0,9,56,1019,56,756
12.656,17,12,1764,6,48,2528,48,456,6,190,2528,308,1308
1799.941,17,448,39896,403,35,4477,288,25676,45,288,40015,288,14220
132.005,1,2,112,2,28,132005,28,112,0,0,0,0,0
0.102,6,9,2074,6,596,19,1033,1437,3,513,48,513,637
130.442,6,27,7308,5,154,32607,267,672,22,338,6210,1460,6636
1778.848,6,111,8826,72,64,25054,64,5120,39,58,46809,58,3706
69.413,6,40,22730,19,549,171,1360,3012,21,1257,3463,1427,19718
143.234,6,29,7392,13,158,11936,267,1317,16,603,9544,2036,6075
146.501,6,22,10814,11,410,65,922,1702,11,1237,14636,1460,9112
258.199,6,55,4030,26,86,10114,86,1498,29,40,9221,63,2532
0.494,6,21,7203,13,318,41,600,1958,8,964,67,1471,5245
7.99,6,39,17415,23,536,363,928,5255,16,959,523,1577,12160
0.449,6,27,8955,13,234,37,575,1620,14,942,33,1438,7335
66.282,6,39,12176,17,290,4142,1189,2724,22,570,3149,1420,9452
168.791,17,4,352,2,60,168790,60,176,2,60,168790,60,176
280.53,6,27,7312,12,158,25502,267,1277,15,678,20027,2085,6035
0.055,6,9,1002,5,213,13,213,417,4,421,16,421,585
1741.408,17,29,6815,29,207,62193,207,6815,0,0,0,0,0
1772.537,6,180,15480,120,69,14895,69,8940,60,69,30034,69,6540
111.456,6,45,8841,21,367,465,787,2034,24,364,4840,1360,6807
1764.218,2,15,480,15,8,126015,8,480,0,0,0,0,0
13.107,6,24,6993,13,275,1092,275,1078,11,910,810,1440,5915
0.057,6,11,818,6,185,11,185,505,5,45,12,45,313
2.088,17,21,10468,10,663,232,1350,6915,11,295,164,1350,3553
1788.648,6,134,19557,85,170,21293,1287,10413,49,163,37261,1414,9144
0.031,17,6,460,3,40,2,41,206,3,56,7,57,254
366.928,6,96,12996,52,166,7194,1189,4745,44,294,8531,1926,8251
1776.608,1,62,5208,62,56,29124,56,5208,0,0,0,0,0
7.096,6,504,424510,307,1316,22,1368,409602,197,776,35,1473,14908
1799.373,6,356,22520,208,69,8692,69,12460,148,69,12240,69,10060
6.734,17,42,16879,17,319,420,1350,5915,25,410,278,1350,10964
1789.953,6,361,22858,210,69,8564,69,12540,151,69,11933,69,10318
383.496,6,16,1104,11,106,38349,106,872,5,0,95870,0,232
42.857,6,26,8760,15,299,3061,718,2286,11,842,4285,3903,6474
11.98,17,4,352,2,60,11979,60,176,2,60,11979,60,176
106.936,6,26,8574,11,181,10693,267,1168,15,680,7632,1400,7406
3.04,17,3,186,3,34,1520,34,186,0,0,0,0,0
0.343,1,10,280,10,0,0,0,280,0,0,0,0,0
280.452,6,30,7432,13,158,23371,267,1317,17,603,17526,2076,6115
1786.588,6,313,32094,180,115,9980,1189,16005,133,126,13534,1917,16089
0.174,6,26,7256,13,155,14,267,1301,13,678,13,3436,5955
200.369,17,4,1344,4,308,66789,308,1344,0,0,0,0,0
0.464,6,12,1653,6,288,84,288,548,6,426,52,434,1105
2.156,6,528,731996,193,236,11,257,15938,335,2110,6,14080,716058
280.455,6,29,7392,12,158,25495,267,1277,17,603,17522,1380,6115
0.671,17,17,6784,7,342,111,1350,2594,10,391,62,1350,4190
0.212,17,2,144,1,36,0,36,64,1,52,0,52,80
0.735,6,2,149,1,0,0,0,40,1,69,0,69,109
0.023,6,3,132,1,0,0,0,52,2,0,0,0,80
1.688,6,25,8777,15,287,120,594,1466,10,986,167,1420,7311
1744.603,6,95,7203,63,38,28138,205,4476,32,33,56269,98,2727
1798.364,1,345,28980,345,56,5227,56,28980,0,0,0,0,0
0.011,17,2,243,1,49,0,49,77,1,138,0,138,166
0.208,17,2,152,1,48,0,48,76,1,48,0,48,76
3.845,6,2,1175,1,0,0,0,40,1,1095,0,1095,1135
0.538,17,2,476,1,39,0,39,67,1,381,0,381,409
1710.123,1,8,448,8,28,244303,28,448,0,0,0,0,0
0.203,1,2,163,2,53,203,78,163,0,0,0,0,0
0.122,17,2,362,1,46,0,46,74,1,260,0,260,288
209.108,17,4,377,2,33,209092,37,123,2,99,209088,136,254
1797.503,1,228,12768,228,28,7918,28,12768,0,0,0,0,0
1798.136,1,243,25758,243,78,7430,78,25758,0,0,0,0,0
0.028,17,4,352,2,37,23,37,130,2,83,24,89,222
84.347,17,4,352,2,60,84346,60,176,2,60,84346,60,176
2.484,17,3,543,2,39,981,39,134,1,381,0,381,409
0.897,6,10,1687,7,100,149,100,384,3,1179,322,1179,1303
9.412,17,6,804,3,54,3168,54,246,3,158,4432,158,558
1.682,6,10,1687,7,100,280,100,384,3,1179,711,1179,1303
448.594,6,69,10853,34,96,10014,267,2905,35,218,13193,1420,7948
280.188,6,28,7352,13,158,23349,267,1317,15,678,20010,2800,6035
300.956,6,25,16477,16,195,20052,431,1620,9,2398,37598,7637,14857
75.166,6,15,620,7,0,4028,0,284,8,0,10736,0,336
57.58,6,6,328,4,0,19193,0,216,2,0,57507,0,112
4.936,6,40,7309,20,218,259,314,3423,20,440,245,1152,3886
380.011,1,14,1176,0,0,0,0,0,14,56,29231,56,1176
67.559,6,24,9801,9,186,8443,267,741,15,939,4825,1420,9060
4.395,6,36,18212,19,636,244,1360,3987,17,1127,266,2720,14225
4.879,6,40,7309,21,218,243,314,3463,19,513,256,1179,3846
1.721,6,28,10409,16,367,114,833,1745,12,1022,148,1420,8664
12.426,6,16,1327,8,222,1772,222,768,8,231,1773,231,559
1794.059,6,372,23548,205,69,8794,69,12409,167,57,10807,69,11139
9.991,17,2,130,2,37,9991,37,130,0,0,0,0,0
0.28,17,2,167,1,39,0,39,67,1,72,0,72,100
1784.596,1,110,6160,110,28,16372,28,6160,0,0,0,0,0
12.261,17,10,690,5,33,3063,33,305,5,49,3063,49,385
0.044,17,2,154,1,41,0,41,69,1,57,0,57,85
9.102,17,8,1792,4,46,3029,46,296,4,346,3029,346,1496
5.7,17,8,688,4,47,1004,47,300,4,69,1024,75,388
0.907,17,4,916,2,33,893,33,122,2,369,894,393,794
300.263,6,30,11852,17,592,18766,1402,4444,13,960,20019,2804,7408
1776.384,17,73,3060,72,14,25019,14,3024,1,8,0,8,36
10.969,6,18,5610,10,275,1218,275,958,8,1440,858,1440,4652
0.056,17,4,284,2,32,1,32,120,2,54,21,60,164
1639.047,2,12,384,12,8,149004,8,384,0,0,0,0,0
0.004,17,2,383,1,36,0,36,64,1,291,0,291,319
1770.567,1,63,5292,0,0,0,0,0,63,56,28557,56,5292
0.687,6,26,8868,13,227,57,547,1592,13,941,51,1438,7276
283.725,6,29,7392,13,158,23643,267,1317,16,678,18910,3456,6075
0.413,6,12,1653,6,288,81,288,548,6,426,46,434,1105
1.472,6,18,5235,9,150,184,174,664,9,701,125,1452,4571
78.03,6,101,75991,64,1276,1238,1448,65902,37,679,2161,1448,10089
1795.242,17,80,3354,79,14,23015,14,3318,1,8,0,8,36
0.009,17,2,419,1,44,0,44,72,1,319,0,319,347
1.401,6,10,1687,7,100,233,100,384,3,1179,570,1179,1303
0.179,6,26,7256,13,155,14,267,1301,13,603,13,2800,5955
300.005,1,4,224,4,28,100001,28,224,0,0,0,0,0
378.478,6,53,9730,20,108,19919,267,2000,33,237,11827,1997,7730
262.33,6,30,6651,13,216,4793,501,1390,17,326,16391,1420,5261
137.892,6,29,7392,13,158,11491,267,1317,16,603,9190,2036,6075
1796.845,17,448,39612,404,35,4458,288,25708,44,288,40946,288,13904
9.937,17,22,10806,12,666,900,1350,8334,10,219,1100,1350,2472
1791.628,6,355,22480,207,69,8697,69,12420,148,69,12187,69,10060
187.638,17,4,352,2,60,187637,60,176,2,60,187637,60,176
0.015,6,9,1930,5,666,3,666,934,4,780,4,780,996
2.96,17,3,183,3,33,1480,33,183,0,0,0,0,0
268.2,17,4,240,2,32,268199,32,120,2,32,268199,32,120
1738.945,6,127,8197,72,51,24492,208,5098,55,31,32193,31,3099
834.21,1,8,448,8,28,119172,28,448,0,0,0,0,0
0.025,17,2,664,1,308,0,308,336,1,300,0,300,328
1723.887,17,12,498,11,14,172388,14,462,1,8,0,8,36
1.43,17,3,660,2,46,1000,46,148,1,484,0,484,512
6.096,17,4,352,2,60,6095,60,176,2,60,6095,60,176
1783.809,6,362,22967,210,69,8534,69,12609,152,69,11813,69,10358
0.201,6,9,1002,5,213,50,213,417,4,421,48,421,585
1743.474,6,145,9134,79,49,22352,208,5564,66,31,26819,31,3570
1785.478,6,102,8296,68,65,26648,65,4930,34,59,54102,59,3366
55.095,6,10,1954,4,595,10103,595,1406,6,212,11017,212,548
4.819,6,1830,1716937,930,249,5,256,62784,900,1797,5,14080,1654153
0.082,17,2,572,1,39,0,39,67,1,477,0,477,505
0.481,6,49,19641,27,957,18,1380,14519,22,421,20,1923,5122
1692.014,17,20,1561,10,30,187998,37,587,10,69,187997,136,974
6.015,6,1456,1312991,896,1386,6,1408,1279207,560,931,10,2801,33784
12.636,6,2250,2058668,1358,1430,9,1448,2003564,892,776,13,1448,55104
31.677,6,7,308,1,0,0,0,44,6,0,6089,0,264
107.815,6,24,9846,12,410,72,922,1742,12,1085,9785,1696,8104
21.501,17,14,5857,7,499,3578,1350,3692,7,281,3578,1350,2165
125.622,2,2,64,2,8,125622,8,64,0,0,0,0,0
9.196,17,35,9223,16,206,608,1350,3749,19,260,508,1350,5474
1786.534,6,356,22520,208,69,8630,69,12460,148,69,12153,69,10060
1.13,6,24,8004,11,164,95,267,1236,13,869,79,1448,6768
1797.411,6,377,26257,218,98,8283,469,15412,159,69,11374,69,10845
280.435,6,27,7312,12,158,25494,267,1277,15,775,20027,2760,6035
3.19,17,4,1552,4,360,1063,360,1552,0,0,0,0,0
13.37,6,29,5181,13,180,1095,722,1778,16,285,879,1402,3403
0.048,17,2,588,1,39,0,39,67,1,493,0,493,521
4.745,6,34,6169,18,206,279,314,2784,16,548,298,1179,3385
1796.327,17,142,11360,71,48,25661,48,5396,71,56,25661,56,5964
1762.825,6,100,7866,66,45,27120,205,4902,34,35,53408,98,2964
0.047,17,2,176,1,48,0,48,76,1,72,0,72,100
61.298,6,36,16028,22,814,2918,1402,9301,14,748,4697,2451,6727
301.314,6,52,19321,29,936,10755,1360,13370,23,386,13688,2667,5951
1792.488,17,87,3648,86,14,21088,14,3612,1,8,0,8,36
1796.032,17,449,39928,404,35,4456,288,25708,45,288,40023,288,14220
0.041,17,2,189,1,37,0,37,65,1,96,0,96,124
225.572,17,11,2378,11,188,22557,362,2378,0,0,0,0,0
41.373,17,46,6644,23,48,1877,48,1748,23,184,1877,308,4896
435.67,6,49,6694,22,119,12369,722,2466,27,176,16749,2330,4228
15.562,17,5,380,5,48,3890,48,380,0,0,0,0,0
2.466,6,58,32873,34,711,74,1408,6103,24,1700,106,5335,26770
134.163,6,67,46741,44,1177,3120,1368,38807,23,841,2832,2519,7934
37.518,17,11,836,11,48,3751,48,836,0,0,0,0,0
0.076,6,3,973,1,0,0,0,40,2,853,65,853,933
0.256,17,2,201,1,50,0,50,78,1,95,0,95,123
251.904,2,2,64,2,8,251904,8,64,0,0,0,0,0
66.488,6,35,7618,15,311,4749,342,2187,20,307,3468,1384,5431
4.236,6,17,1790,7,219,706,219,758,10,152,436,152,1032
30.704,17,4,304,2,48,30703,64,152,2,48,30703,64,152
1787.436,6,102,8364,68,66,26678,66,4964,34,60,54161,60,3400
0.094,6,11,911,6,181,18,181,489,5,77,20,133,422
1795.906,17,447,39864,402,35,4478,288,25644,45,288,40017,288,14220
30.403,6,6,644,1,0,0,0,40,5,83,6742,83,604
1788.929,1,271,15176,271,28,6625,28,15176,0,0,0,0,0
1799.998,6,212,16312,80,67,22784,292,7804,132,48,13738,78,8508
1770.026,1,58,4872,58,56,31053,56,4872,0,0,0,0,0
13.822,6,44,11686,21,155,691,267,1621,23,537,576,1400,10065
0.555,6,29,7520,17,306,34,1087,2826,12,701,49,1728,4694
280.379,6,29,7392,13,158,23364,267,1317,16,603,18689,1400,6075
19.571,6,25,7097,12,155,1779,267,1266,13,589,1630,3426,5831
1750.87,17,85,3564,84,14,21094,14,3528,1,8,0,8,36
0.254,17,2,146,1,37,0,37,65,1,53,0,53,81
0.22,6,22,5040,11,137,22,267,1132,11,692,21,1467,3908
1.708,6,13,2311,8,188,244,245,700,5,1407,363,1407,1611
0.019,17,2,235,1,36,0,36,64,1,143,0,143,171
1789.385,6,155,19658,90,302,20105,302,13764,65,83,27958,83,5894
1.614,6,24,6042,13,108,134,147,959,11,773,137,1608,5083
16.469,6,11,9560,2,92,331,92,204,9,1269,2036,1408,9356
0.024,17,2,362,1,46,0,46,74,1,260,0,260,288
82.57,6,17,692,7,0,5823,0,284,10,0,9172,0,408
822.566,17,30,4292,15,48,58753,48,1140,15,182,58753,308,3152
1773.289,6,180,15480,120,69,14901,69,8940,60,69,30054,69,6540
1742.972,6,119,12039,75,63,23553,722,6267,44,96,40528,1408,5772
0.171,6,25,7216,13,155,14,267,1301,12,678,14,2045,5915
0.511,17,3,451,2,39,213,39,134,1,289,0,289,317
5.043,17,4,288,2,36,5006,36,128,2,52,5012,52,160
1775.91,17,73,3060,72,14,25012,14,3024,1,8,0,8,36
1740.621,17,30,31680,30,1028,60021,1028,31680,0,0,0,0,0
1798.862,1,58,4872,58,56,31558,56,4872,0,0,0,0,0
1796.214,17,448,39896,403,35,4468,288,25676,45,288,40020,288,14220
0.007,17,2,335,1,33,0,33,61,1,246,0,246,274
240.21,6,53,17669,28,789,8896,1402,14892,25,183,10008,580,2777
6.112,6,40,7325,22,218,291,314,3503,18,516,344,1179,3822
1.35,6,22,4442,11,165,135,456,1394,11,493,117,888,3048
0.088,6,9,1340,5,145,22,145,349,4,827,26,827,991
300.869,6,51,20290,30,1027,10374,1360,14603,21,402,436,2720,5687
340.379,6,4332,3517436,2564,1344,132,1360,3430501,1768,145,27,1360,86935
89.911,1,9,3386,9,348,11238,368,3386,0,0,0,0,0
963.218,6,51,3706,34,31,29188,31,2295,17,31,60177,31,1411
57.605,1,16,1664,0,0,0,0,0,16,76,3840,76,1664
3.182,17,3,228,2,48,3022,48,152,1,48,0,48,76
30.824,1,4,224,4,28,10274,28,224,0,0,0,0,0
1747.104,6,94,7151,62,38,28641,205,4424,32,33,56351,98,2727
0.283,17,2,154,1,33,0,33,61,1,65,0,65,93
0.003,6,4,8404,1,0,0,0,40,3,2736,0,4104,8364
0.64,6,122,95459,77,1328,8,1432,89438,45,420,14,1432,6021
39.629,17,10,760,10,48,4403,48,760,0,0,0,0,0
1792.006,1,302,32012,302,78,5953,78,32012,0,0,0,0,0
1759.053,17,301,66572,301,193,5863,422,66572,0,0,0,0,0
1787.907,6,355,22549,206,69,8721,69,12380,149,69,12080,69,10169
1792.062,1,58,4872,58,56,31439,56,4872,0,0,0,0,0
1.411,6,50,21222,29,900,50,1360,15606,21,476,61,2715,5616
7.377,6,12,716,4,106,2455,106,274,8,90,1052,90,442
1787.616,17,142,11360,71,48,25536,48,5396,71,56,25536,56,5964
12.599,6,32,12039,10,153,1399,267,1330,22,577,596,1460,10709
40.929,6,5665,5300259,3665,1367,11,1408,5191595,2000,776,20,1408,108664
376.353,6,12,814,10,106,41815,106,726,2,0,376340,0,88
299.523,6,6,364,4,31,99841,31,222,2,31,299514,31,142
2.007,6,8,340,5,0,501,0,208,3,0,727,0,132
0.127,17,2,199,1,37,0,37,65,1,106,0,106,134
10.221,6,1623,1414571,982,1388,10,1420,1384710,641,420,15,1420,29861
0.316,17,4,420,2,33,0,33,122,2,121,0,145,298
1772.082,6,99,9306,66,66,27262,66,5610,33,60,55374,60,3696
102.98,6,749,350793,396,820,260,1152,331882,353,435,291,1179,18911
5.554,6,40,7325,22,218,264,314,3503,18,516,311,1179,3822
1771.323,6,99,9306,66,66,27251,66,5610,33,60,55351,60,3696
428.193,17,6,456,6,48,85638,48,456,0,0,0,0,0
1798.119,17,449,39928,404,35,4461,288,25708,45,288,40020,288,14220
1781.47,6,454,82057,301,304,5938,304,61556,153,83,11720,83,20501
16.031,6,32,8952,14,158,1233,267,1357,18,624,940,1400,7595
247.589,17,3,181,3,32,123794,33,181,0,0,0,0,0
1783.847,6,356,22520,208,69,8617,69,12460,148,69,12134,69,10060
367.07,6,19,1306,14,180,28236,180,928,5,110,15158,110,378
0.912,6,10,1687,7,100,152,100,384,3,1179,334,1179,1303
0.092,6,10,1865,6,649,18,1141,1542,4,159,30,159,323
285.943,17,6,528,3,60,142970,60,264,3,60,142971,60,264
1783.807,6,364,23047,211,69,8494,69,12718,153,69,11735,69,10329
240.237,6,53,15764,28,671,8897,1402,12883,25,196,10009,580,2881
0.076,17,2,586,1,46,0,46,74,1,484,0,484,512
476.133,6,98,31130,47,586,10350,1402,11259,51,688,9522,1402,19871
1.566,6,3,144,2,0,1518,0,104,1,0,0,0,40
62.423,6,477,214294,245,815,255,1152,200532,232,407,269,1152,13762
1788.645,17,83,3480,82,14,22082,14,3444,1,8,0,8,36
0.002,6,2,381,2,150,2,208,381,0,0,0,0,0
28.458,6,3045,2860394,1874,1442,15,1448,2790094,1171,776,24,1448,70300
374.631,6,23,1511,14,177,28817,177,925,9,110,8679,110,586
0.299,6,20,7252,12,337,26,674,1980,8,1212,41,2816,5272
0.02,17,2,451,1,41,0,41,69,1,354,0,354,382
1770.418,6,103,9670,68,66,26424,66,5846,35,60,52060,60,3824
0.083,17,4,284,2,32,46,32,120,2,54,38,60,164
1796.708,17,449,39928,404,35,4458,288,25708,45,288,40021,288,14220
7.828,6,2,80,1,0,0,0,40,1,0,0,0,40
1745.531,6,99,7442,64,38,27706,205,4559,35,33,51331,98,2883
0.082,17,2,2750,2,1347,82,1347,2750,0,0,0,0,0
280.512,6,30,7432,13,158,23376,267,1317,17,603,17528,2760,6115
0.062,17,2,290,1,40,0,40,68,1,194,0,194,222
240.222,6,56,18874,29,787,8579,1418,15695,27,220,9238,580,3179
0.277,17,2,440,1,39,0,39,67,1,345,0,345,373
6.151,6,1552,1410771,964,1384,6,1408,1375531,588,931,10,2816,35240
2.048,6,2,1520,1,0,0,0,40,1,1440,0,1440,1480
1750.262,6,109,8799,70,52,25366,205,5411,39,36,46051,98,3388
1.851,17,4,240,2,32,1850,32,120,2,32,1850,32,120
1795.012,17,144,11520,72,48,25281,48,5472,72,56,25281,56,6048
31.531,6,7,336,1,0,0,0,48,6,0,6304,0,288
281.354,6,32,7650,13,158,23446,267,1317,19,464,15605,1400,6333
1789.452,17,144,11520,72,48,25203,48,5472,72,56,25203,56,6048
331.832,6,54,10719,32,281,10704,1360,5037,22,399,618,1360,5682
166.98,6,23,10689,13,663,74,1360,3205,10,1414,18533,3957,7484
1795.188,17,80,3354,79,14,23015,14,3318,1,8,0,8,36
300.776,6,42,13650,23,892,13671,1360,8088,19,399,478,1360,5562
1773.268,6,180,15480,120,69,14901,69,8940,60,69,30051,69,6540
0.016,17,2,912,1,308,0,308,336,1,548,0,548,576
1681.203,17,14,3843,7,30,280198,30,406,7,463,280198,463,3437
1794.51,17,270,55579,270,177,6671,377,55579,0,0,0,0,0
240.217,6,55,17613,30,760,8283,1408,14493,25,226,10008,580,3120
0.06,17,8,2438,8,276,8,315,2438,0,0,0,0,0
240.21,6,56,19460,30,793,8282,1418,16636,26,183,9608,580,2824
1795.175,17,447,39580,403,35,4465,288,25676,44,288,40016,288,13904
1796.006,6,247,37638,150,174,12053,1205,19482,97,156,18708,2018,18156
1796.329,6,368,25690,215,99,8394,469,15085,153,69,11816,69,10605
100.058,6,45,24908,28,1053,3705,1448,17269,17,843,3821,2359,7639
22.614,6,9,577,0,0,0,0,0,9,31,2826,31,577
1787.896,6,386,27293,221,101,8126,469,16277,165,69,10901,69,11016
300.641,6,36,8470,20,308,15823,885,2076,16,522,564,3488,6394
1777.097,6,180,15480,120,69,14933,69,8940,60,69,30112,69,6540
45.081,6,7,364,7,0,0,0,364,0,0,0,0,0
560.713,17,6,444,3,30,280350,30,174,3,62,280349,62,270
0.013,6,2,100,1,0,0,0,40,1,0,0,0,60
0.405,6,10,1992,5,288,95,288,508,5,424,56,434,1484
1.309,6,38,8252,19,320,72,1162,2716,19,433,63,1440,5536
1749.625,17,12,498,11,14,174962,14,462,1,8,0,8,36
0.173,6,3,367,2,111,10,127,327,1,0,0,0,40
35.153,6,5,752,3,46,17576,46,166,2,506,34950,506,586
1786.759,6,102,8296,68,65,26668,65,4930,34,59,54141,59,3366
1772.214,6,180,15480,120,69,14892,69,8940,60,69,30034,69,6540
0.426,6,52,21794,29,965,15,1380,16632,23,383,17,1380,5162
11.964,6,1893,1653112,1148,1386,10,1420,1619091,745,467,16,1883,34021
0.016,6,10,1896,5,899,4,899,1167,5,461,4,461,729
0.007,17,4,352,2,37,3,37,130,2,83,1,89,222
1788.52,6,356,22520,208,69,8640,69,12460,148,69,12166,69,10060
1673.896,1,7,392,7,28,278982,28,392,0,0,0,0,0
3.164,17,4,292,2,37,3161,37,130,2,53,3160,53,162
1792.743,6,356,22520,208,69,8660,69,12460,148,69,12195,69,10060
0.292,17,2,167,1,39,0,39,67,1,72,0,72,100
9.121,6,85,27498,43,576,217,1152,21336,42,447,216,1179,6162
1255.715,6,89,5376,48,26,26716,26,2870,41,26,31391,26,2506
1740.814,17,30,31680,30,1028,60028,1028,31680,0,0,0,0,0
1772.433,6,180,15480,120,69,14894,69,8940,60,69,30036,69,6540
1771.01,6,100,9358,66,66,27246,66,5610,34,60,53663,60,3748
1786.861,6,104,8376,68,65,26669,65,4930,36,59,51049,59,3446
280.196,6,28,7352,13,158,23349,267,1317,15,678,20011,3536,6035
1754.09,1,8,448,8,28,250584,28,448,0,0,0,0,0
6.069,6,49,12536,26,493,242,1152,8946,23,380,263,1152,3590
8.679,2,2,64,2,8,8679,8,64,0,0,0,0,0
1.1,6,25,8056,12,164,85,267,1288,13,869,77,1408,6768
1772.224,6,180,15480,120,69,14892,69,8940,60,69,30034,69,6540
0.076,17,2,390,1,46,0,46,74,1,288,0,288,316
1789.812,17,87,3648,86,14,21056,14,3612,1,8,0,8,36
2.322,17,5,1680,5,308,580,308,1680,0,0,0,0,0
2.927,6,31,6307,17,108,182,147,1123,14,768,146,1581,5184
58.116,17,10,880,5,48,14527,48,380,5,72,14526,72,500
1.045,6,27,8120,14,266,67,540,1924,13,944,71,1591,6196
1786.765,6,105,8484,68,66,26668,66,4964,37,60,49629,60,3520
7.356,17,6,528,3,48,3666,48,228,3,72,3668,72,300
1771.161,6,99,9240,66,65,27248,65,5577,33,59,55345,59,3663
5.131,17,4,304,4,48,1710,48,304,0,0,0,0,0
58.717,6,11,1589,11,113,5871,113,1589,0,0,0,0,0
1774.972,6,288,36118,116,140,15433,1460,17039,172,140,10379,1642,19079
191.22,1,2,208,2,76,191220,76,208,0,0,0,0,0
1740.471,17,29,30624,29,1028,62159,1028,30624,0,0,0,0,0
0.886,17,4,344,2,47,872,47,150,2,69,872,75,194
107.504,6,31,7010,15,207,7673,517,1643,16,504,7162,1418,5367
1776.951,6,137,8721,76,49,23692,208,5382,61,31,29611,31,3339
19.693,6,18,3394,6,92,3938,92,400,12,579,1770,1448,2994
1760.709,6,105,6270,60,27,29842,27,3525,45,27,40000,27,2745
425.546,6,83,12290,42,129,10375,721,4783,41,279,10634,1414,7507
1.283,17,55,26374,31,714,42,1350,23012,24,112,48,1350,3362
1744.048,6,95,7203,63,38,28129,205,4476,32,33,56246,98,2727
254.971,6,18,5839,10,784,28330,1360,3538,8,247,36390,272,2301
1506.093,6,131,17879,71,85,21515,501,5656,60,181,25485,1420,12223
280.264,17,4,296,2,30,280251,30,116,2,62,280250,62,180
280.204,6,29,7392,13,158,23350,267,1317,16,603,18676,2036,6075
240.357,6,44,8447,22,449,11445,1418,5648,22,205,11445,580,2799
1645.418,1,7,392,7,28,274236,28,392,0,0,0,0,0
220.781,6,30,7432,13,158,18398,267,1317,17,543,13793,1400,6115
1738.575,6,87,6322,58,31,30501,31,3915,29,31,62091,31,2407
284.662,6,44,11863,19,158,15814,267,1557,25,581,11851,1400,10306
1787.32,6,102,8296,68,65,26676,65,4930,34,59,54157,59,3366
1760.019,1,9,964,9,79,220002,88,964,0,0,0,0,0
0.348,17,8,2774,8,318,49,357,2774,0,0,0,0,0
11.004,6,82,24837,41,561,275,1152,19056,41,413,268,1152,5781
300.674,6,38,8372,20,266,15824,721,1899,18,441,498,1460,6473
1759.763,6,160,8320,80,0,22275,0,4160,80,0,22275,0,4160
39.989,2,4,128,4,8,13329,8,128,0,0,0,0,0
1767.458,17,204,46793,204,201,8706,422,46793,0,0,0,0,0
15.806,6,2392,2175887,1505,1366,10,1408,2125099,887,931,17,2801,50788
0.03,17,4,368,2,32,9,32,120,2,96,12,96,248
2.972,6,16,1335,8,222,423,222,772,8,231,423,231,563
0.164,6,9,1339,5,145,41,145,349,4,826,39,826,990
1796.959,17,448,39896,403,35,4470,288,25676,45,288,40021,288,14220
1787.925,6,368,23276,212,69,8473,69,12896,156,69,11534,69,10380
10.86,6,20,4442,11,275,1086,275,998,9,768,766,1440,3444
280.215,6,28,7352,12,158,25474,267,1277,16,603,18677,1400,6075
703.957,1,18,1008,18,28,41409,28,1008,0,0,0,0,0
1770.922,6,142,8734,75,26,23930,26,4568,67,26,26831,26,4166
0.923,6,23,6509,13,333,76,1003,2189,10,979,101,1731,4320
315.336,6,20,2429,7,242,52555,517,1111,13,323,26277,499,1318
1743.91,6,95,7203,63,38,28127,205,4476,32,33,56247,98,2727
0.544,17,4,768,2,39,530,39,134,2,289,20,289,634
0.091,6,9,1345,5,145,22,145,349,4,832,24,832,996
66.755,6,42,14770,19,671,87,1408,7038,23,384,3026,2688,7732
0.106,6,11,911,6,181,21,181,489,5,77,25,133,422
274.44,6,24,6229,10,266,137,500,1204,14,405,21103,1420,5025
11.611,6,21,6825,12,275,1055,275,1038,9,1353,825,1440,5787
1.261,6,47,19314,27,901,48,1360,13738,20,476,56,2715,5576
0.1,17,2,152,1,48,0,48,76,1,48,0,48,76
1.561,17,4,401,3,31,778,31,177,1,196,0,196,224
7.204,6,540,403134,295,1290,23,1368,385730,245,776,28,1473,17404
41.396,17,24,2112,12,48,3756,48,912,12,72,3757,72,1200
1777.634,17,142,11360,71,48,25394,48,5396,71,56,25394,56,5964
3.322,17,16,2058,16,100,221,360,2058,0,0,0,0,0
0.516,6,6,248,4,0,172,0,164,2,0,320,0,84
290.45,17,4,352,2,60,290448,60,176,2,60,290449,60,176
175.592,17,4,2351,4,559,58530,582,2351,0,0,0,0,0
23.532,6,3164,2923097,1958,1410,11,1448,2852837,1206,776,19,1448,70260
1755.292,6,97,7307,63,38,28311,205,4476,34,33,53178,98,2831
11.825,6,1877,1628659,1149,1363,10,1380,1595297,728,421,16,1923,33362
2.086,6,24,5754,13,158,170,370,1315,11,998,206,1691,4439
2.039,17,6,1377,3,40,1013,40,204,3,363,1014,363,1173
1.574,6,49,19134,27,879,60,1360,13478,22,529,64,4075,5656
273.724,6,27,7312,13,158,22810,267,1317,14,775,21052,4836,5995
2.227,17,23,13572,11,606,222,1350,6974,12,521,157,1350,6598
1797.049,6,367,23443,210,69,8598,69,12747,157,69,11519,69,10696
9.017,6,36,16468,19,918,500,1360,8201,17,757,553,1360,8267
125.393,6,13,3117,7,92,20898,92,476,6,581,25037,2026,2641
300.556,6,19,1279,6,177,60077,177,497,13,110,25032,110,782
1.237,6,58,15103,28,553,45,1429,5040,30,442,41,1460,10063
5.019,17,4,558,2,36,5005,36,128,2,187,5006,187,430
1.859,6,26,6125,14,108,143,147,999,12,773,139,1608,5126
2.248,6,56,14131,27,551,86,1429,4984,29,419,74,1986,9147
1093.043,6,141,11071,54,76,20057,374,5443,87,49,12709,143,5628
1.316,6,49,18686,27,851,50,1360,13030,22,476,54,2715,5656
3.354,17,5,290,5,30,838,30,290,0,0,0,0,0
0.752,6,23,5715,13,158,61,370,1315,10,999,82,1699,4400
0.027,17,2,408,1,36,0,36,64,1,316,0,316,344
33.823,6,35,5358,17,154,2101,721,1973,18,305,1977,1368,3385
125.353,6,15,3196,7,92,20892,92,452,8,387,17881,1408,2744
1773.063,6,180,15480,120,69,14899,69,8940,60,69,30050,69,6540
281.335,17,4,352,2,60,281334,60,176,2,60,281334,60,176
1798.854,6,359,24323,205,88,8817,469,13747,154,69,11754,69,10576
1.069,6,25,8044,13,164,89,267,1328,12,869,76,1440,6716
1770.684,6,113,10335,71,65,25295,65,6003,42,59,43185,59,4332
240.137,6,43,7600,21,139,12006,346,1934,22,451,11434,1408,5666
1739.217,6,87,6322,58,31,30512,31,3915,29,31,62113,31,2407
1764.827,2,15,480,15,8,126059,8,480,0,0,0,0,0
1770.511,6,101,9410,66,66,27238,66,5610,35,60,52069,60,3800
0.026,17,2,147,1,32,0,32,60,1,59,0,59,87
1624.387,2,15,480,15,8,116027,8,480,0,0,0,0,0
0.954,6,27,11938,16,524,63,1360,3306,11,1022,77,3921,8632
131.928,6,25,9968,12,549,59,1440,2709,13,961,10983,1440,7259
7.987,6,19,8351,9,275,998,275,643,10,1216,837,1440,7708
1783.819,6,358,22738,208,69,8617,69,12460,150,69,11971,69,10278
0.32,6,26,9089,13,271,26,726,1771,13,947,26,2804,7318
0.511,6,28,7336,13,155,42,267,1301,15,543,30,1400,6035
3.826,17,5,1160,5,204,956,204,1160,0,0,0,0,0
66.279,6,3165,2909730,2059,1334,32,1368,2843346,1106,776,59,2736,66384
1756.212,6,105,6270,59,27,30278,27,3473,46,27,39025,27,2797
280.195,6,28,7352,13,158,23349,267,1317,15,678,20011,4200,6035
280.375,6,30,7432,13,158,23364,267,1317,17,543,17516,1400,6115
126.031,2,2,64,2,8,126031,8,64,0,0,0,0,0
1748.517,6,97,7307,63,38,28201,205,4476,34,33,52976,98,2831
1799.47,6,361,22927,209,69,8651,69,12638,152,69,11915,69,10289
38.856,17,4,4117,4,1001,12952,1258,4117,0,0,0,0,0
27.289,17,4,1312,4,300,9096,300,1312,0,0,0,0,0
0.0,17,3,1552,3,489,0,517,1552,0,0,0,0,0
145.288,17,4,240,2,32,145287,32,120,2,32,145287,32,120
1.097,6,11,1727,7,100,182,100,384,4,589,282,1152,1343
10.16,6,16,6278,5,112,2537,112,320,11,915,1014,1460,5958
1.629,6,29,10365,17,367,101,833,1785,12,1012,140,1420,8580
4.67,6,40,7309,21,218,233,314,3463,19,513,245,1179,3846
5.698,6,39,7269,20,218,299,314,3423,19,513,302,1179,3846
0.412,6,13,1693,7,288,66,288,588,6,426,43,434,1105
1720.45,17,12,498,11,14,172045,14,462,1,8,0,8,36
302.558,6,83,26734,42,906,7379,1101,15326,41,271,259,2128,11408
0.019,17,4,284,2,32,4,32,120,2,54,2,60,164
1785.859,6,373,26428,215,105,8345,469,15554,158,69,11374,69,10874
535.927,6,59,7311,29,98,19134,722,2890,30,130,18474,1408,4421
1775.169,17,140,11200,70,48,25726,48,5320,70,56,25726,56,5880
1783.144,17,83,3480,82,14,22014,14,3444,1,8,0,8,36
240.539,6,42,10791,20,472,12659,1418,5301,22,542,11453,1500,5490
101.038,6,10,400,10,0,0,0,400,0,0,0,0,0
94.748,6,55,23894,28,995,148,1460,12134,27,626,3637,1460,11760
33.76,6,33,5199,16,154,2250,722,1912,17,299,2097,1448,3287
11.0,6,23,8392,12,498,1000,721,2478,11,1093,893,1440,5914
11.617,6,6,328,4,0,3872,0,216,2,0,11608,0,112
18.588,6,1581,1438306,944,1437,19,1448,1396242,637,776,28,1448,42064
1.314,6,48,18857,26,933,52,1460,13201,22,433,54,1460,5656
2.088,17,2,677,1,300,0,300,328,1,321,0,321,349
1.351,17,2,268,1,54,0,54,82,1,158,0,158,186
1791.517,1,80,4480,80,28,22677,28,4480,0,0,0,0,0
76.935,17,6,2016,6,308,15387,308,2016,0,0,0,0,0
12.584,6,1985,1732556,1208,1378,10,1420,1697255,777,467,16,1883,35301
0.307,17,2,312,1,64,0,64,92,1,192,0,192,220
133.025,6,107,78006,67,1259,2015,1448,67762,40,679,3075,1448,10244
3.334,6,3,962,1,0,0,0,40,2,421,3324,421,922
298.63,17,6,528,3,60,149314,60,264,3,60,149314,60,264
1321.769,2,18,576,18,8,77751,8,576,0,0,0,0,0
1775.31,17,136,10880,68,48,26497,48,5168,68,56,26497,56,5712
1791.263,6,370,23425,213,69,8449,69,13005,157,69,11479,69,10420
1776.774,17,71,2976,70,14,25750,14,2940,1,8,0,8,36
1784.948,6,105,8475,68,65,26641,65,4930,37,59,49579,59,3545
0.122,17,2,339,1,33,0,33,61,1,250,0,250,278
94.444,6,37,8257,13,140,7696,267,1513,24,320,4105,4837,6744
0.92,6,10,1687,7,100,153,100,384,3,1179,327,1179,1303
2.987,6,2,88,2,0,0,0,88,0,0,0,0,0
0.034,17,2,2754,2,1349,34,1349,2754,0,0,0,0,0
0.863,6,23,5715,13,158,70,370,1315,10,999,91,1691,4400
0.329,6,7,466,5,43,72,43,354,2,0,284,0,112
9.997,2,2,64,2,8,9997,8,64,0,0,0,0,0
2.517,6,5,280,2,0,2517,0,100,3,0,1183,0,180
299.533,6,6,364,4,31,99844,31,222,2,31,299524,31,142
4.558,6,25,6056,13,108,379,147,959,12,768,414,1581,5097
0.179,6,9,902,5,201,44,201,405,4,333,40,333,497
265.843,6,24,6167,10,267,89,501,1205,14,399,20443,1420,4962
1.502,1,2,112,2,28,1502,28,112,0,0,0,0,0
625.628,6,60,3631,30,39,21573,208,1997,30,31,21566,31,1634
0.168,6,26,7256,13,155,14,267,1301,13,678,12,2045,5955
0.006,17,4,1097,2,36,0,36,128,2,456,1,499,969
16.858,17,23,5461,11,237,1685,1350,2920,12,183,1529,1350,2541
35.267,6,25,6283,15,117,2519,159,1389,10,873,3917,1674,4894
280.37,6,29,7392,13,158,23364,267,1317,16,603,18682,1400,6075
285.208,17,4,352,2,60,285207,60,176,2,60,285207,60,176
11.021,6,1803,1520413,1073,1363,10,1380,1486959,730,421,15,1923,33454
1773.901,6,183,15807,120,69,14906,69,8940,63,69,28604,69,6867
0.573,6,15,1785,8,288,64,288,640,7,426,66,434,1145
0.512,17,4,768,2,39,502,39,134,2,289,17,289,634
0.293,17,2,136,1,32,0,32,60,1,48,0,48,76
10.958,6,18,4266,10,275,1217,275,958,8,992,881,1440,3308
36.975,17,44,6468,22,48,1760,48,1672,22,190,1760,308,4796
1783.264,6,359,22709,209,69,8573,69,12569,150,69,11968,69,10140
1681.427,1,15,870,15,30,120101,30,870,0,0,0,0,0
1797.128,17,448,39896,403,35,4470,288,25676,45,288,40022,288,14220
290.801,17,4,352,2,60,290800,60,176,2,60,290800,60,176
0.014,17,2,502,1,34,0,34,62,1,412,0,412,440
0.332,6,8,320,4,0,110,0,160,4,0,99,0,160
0.919,6,8,1607,5,100,229,100,304,3,1179,327,1179,1303
331.019,6,49,13470,22,181,15762,267,2340,27,627,12730,1400,11130
1786.791,17,87,3648,86,14,21021,14,3612,1,8,0,8,36
27.485,6,25,3240,17,105,1717,105,1104,8,258,3923,341,2136
2.015,17,3,276,3,64,1007,64,276,0,0,0,0,0
280.19,6,28,7352,13,158,23349,267,1317,15,678,20011,3436,6035
0.178,6,32,8360,16,277,11,517,1771,16,494,10,1432,6589
468.47,1,4,421,4,77,156156,81,421,0,0,0,0,0
49.234,6,69,38764,34,624,1491,1354,3688,35,1230,1438,1408,35076
0.47,6,23,7307,12,318,41,600,1906,11,964,44,1471,5401
4.927,6,39,7269,20,218,259,314,3423,19,513,259,1179,3846
280.323,6,24,7054,11,181,28032,267,1168,13,670,23355,2800,5886
1779.823,17,140,11200,70,48,25794,48,5320,70,56,25794,56,5880
0.167,17,2,152,1,48,0,48,76,1,48,0,48,76
2.04,17,4,566,2,31,2030,31,118,2,196,2023,196,448
1788.198,6,123,14636,80,85,22635,516,6444,43,157,42574,1420,8192
0.275,17,8,2750,8,315,39,354,2750,0,0,0,0,0
4.52,6,8,352,3,0,2257,0,132,5,0,1128,0,220
16.1,17,4,352,2,60,16098,60,176,2,60,16099,60,176
3.125,17,4,1556,4,361,1041,361,1556,0,0,0,0,0
0.217,17,2,146,1,37,0,37,65,1,53,0,53,81
240.166,6,55,20031,30,855,8281,1408,16959,25,220,10006,580,3072
67.184,6,40,5750,20,238,3536,832,3194,20,150,3533,580,2556
1770.942,6,102,9394,67,64,26832,64,5660,35,58,52083,58,3734
0.63,6,27,17458,16,708,42,1360,4214,11,1827,48,4887,13244
1764.656,17,169,14131,157,30,11311,37,9155,12,386,155080,463,4976
371.042,6,25,1651,17,177,23190,177,1117,8,110,9222,110,534
171.453,17,4,240,2,32,171452,32,120,2,32,171451,32,120
0.059,6,2,80,1,0,0,0,40,1,0,0,0,40
1783.452,17,83,3480,82,14,22017,14,3444,1,8,0,8,36
0.102,17,2,1920,2,932,102,932,1920,0,0,0,0,0
13.472,6,1792,1666263,1172,1371,11,1380,1636445,620,383,21,1380,29818
1.02,17,2,124,2,34,1020,34,124,0,0,0,0,0
1770.438,6,101,9344,66,65,27237,65,5577,35,59,52069,59,3767
1773.202,6,180,15480,120,69,14900,69,8940,60,69,30046,69,6540
336.323,6,17,1187,13,177,28026,177,861,4,110,20062,110,326
2.028,17,4,644,2,33,1910,33,122,2,233,0,233,522
300.806,6,51,10578,25,433,12533,910,3270,26,312,621,1460,7308
1679.694,1,7,392,7,28,279949,28,392,0,0,0,0,0
0.087,17,4,336,2,34,0,34,124,2,78,83,84,212
71.377,6,667,313800,347,834,206,1152,295154,320,417,222,1179,18646
21.413,6,25,7256,13,321,1763,517,1339,12,755,1923,1520,5917
0.264,6,25,6116,12,181,24,537,1526,13,558,20,1448,4590
33.859,6,31,5121,15,154,2418,722,1871,16,301,929,1408,3250
1800.0,6,219,18555,80,71,22405,301,8061,139,69,13043,1062,10494
375.014,6,21,1419,15,177,26786,177,989,6,110,12248,110,430
1760.653,6,102,8032,67,45,26676,205,4985,35,35,51772,98,3047
377.766,2,3,96,3,8,188883,8,96,0,0,0,0,0
1790.355,17,140,11200,70,48,25947,48,5320,70,56,25946,56,5880
5.359,17,24,10389,10,384,595,1350,4128,14,419,277,1350,6261
1788.67,6,358,22669,209,69,8599,69,12569,149,69,12085,69,10100
0.002,6,2,165,1,85,0,85,125,1,0,0,0,40
1299.716,1,6,636,6,78,259943,78,636,0,0,0,0,0
2.99,17,2,148,2,46,2990,46,148,0,0,0,0,0
0.09,17,3,639,2,39,0,39,134,1,477,0,477,505
0.54,6,22,7368,13,337,45,674,2032,9,1212,58,1946,5336
2.475,6,20,3833,11,234,247,564,1504,9,463,286,1343,2329
4.199,17,10,2399,5,40,1047,40,340,5,383,1047,423,2059
0.406,6,2,80,1,0,0,0,40,1,0,0,0,40
280.497,6,26,7272,12,158,25499,267,1277,14,775,21573,3465,5995
377.351,17,6,366,3,33,188675,33,183,3,33,188675,33,183
1680.734,17,13,534,11,14,168054,14,462,2,8,1680542,8,72
1777.566,6,103,8464,68,66,26530,66,4964,35,60,52278,60,3500
3.306,6,61,24040,32,979,106,1460,17971,29,400,103,1460,6069
1.514,6,27,8945,14,288,116,796,1747,13,952,105,1460,7198
280.417,6,30,7432,13,158,23368,267,1317,17,543,17516,1400,6115
1773.59,6,180,15480,120,69,14904,69,8940,60,69,30057,69,6540
0.731,17,4,1108,2,30,720,30,116,2,468,712,468,992
1729.162,6,60,4400,40,33,44337,33,2740,20,31,90999,31,1660
3.356,17,4,1568,4,364,1118,364,1568,0,0,0,0,0
15.88,6,2569,2455564,1651,1409,9,1448,2403152,918,776,17,1448,52412
280.296,6,30,7432,13,158,23358,267,1317,17,543,17512,1400,6115
0.031,6,12,3462,6,75,6,75,395,6,1373,5,1448,3067
369.708,6,27,1767,18,177,21747,177,1181,9,110,8587,110,586
16.521,17,22,14832,13,935,1373,1350,12519,9,229,2060,1350,2313
20.937,6,14,2245,8,211,2986,211,846,6,545,4180,904,1399
369.493,6,19,1303,14,177,28422,177,925,5,110,15163,110,378
1.131,6,23,7952,11,164,95,267,1236,12,1014,87,2804,6716
1783.976,6,108,8584,70,64,25854,64,4976,38,58,48213,58,3608
0.181,17,2,2756,2,1350,181,1350,2756,0,0,0,0,0
1672.757,1,7,392,7,28,278792,28,392,0,0,0,0,0
1786.172,6,364,24923,212,94,8465,469,14496,152,69,11826,69,10427
1638.245,2,10,320,10,8,182027,8,320,0,0,0,0,0
283.774,6,32,10994,12,158,25797,267,1277,20,685,14927,1400,9717
2.024,17,18,10619,9,734,253,1350,6859,9,389,149,1350,3760
0.014,17,2,572,1,39,0,39,67,1,477,0,477,505
1700.273,2,20,640,20,8,89488,8,640,0,0,0,0,0
6.852,6,1860,1797450,1251,1363,5,1368,1761118,609,776,10,2736,36332
3.143,17,4,304,2,48,3129,48,152,2,48,3121,48,152
271.895,6,76,12463,32,194,6964,1189,4005,44,257,6322,1917,8458
1775.279,6,210,24110,133,89,13449,981,11158,77,137,23355,2760,12952
59.166,6,27,7177,13,155,4930,267,1306,14,530,4550,3417,5871
32.029,6,389,388115,125,126,258,300,6878,264,1413,121,2836,381237
289.687,6,36,3657,18,324,17039,585,1653,18,153,17039,580,2004
39.547,17,44,6468,22,48,1882,48,1672,22,190,1882,308,4796
1789.559,17,83,3480,82,14,22093,14,3444,1,8,0,8,36
0.042,17,4,368,2,32,26,32,120,2,96,24,96,248
1784.197,6,362,23243,206,69,8703,69,12518,156,69,11510,69,10725
1797.688,17,138,11032,70,48,26052,48,5320,68,56,26830,56,5712
0.017,1,5,420,5,56,4,56,420,0,0,0,0,0
5.018,17,4,558,2,36,5004,36,128,2,187,5008,187,430
1680.567,17,12,498,11,14,168056,14,462,1,8,0,8,36
1797.447,6,375,26177,217,98,8321,469,15372,158,69,11448,69,10805
88.029,6,25,10829,12,380,111,832,1665,13,959,7324,1440,9164
170.494,6,30,7432,14,158,13114,267,1357,16,603,11363,2036,6075
1786.653,6,102,8364,68,66,26666,66,4964,34,60,54137,60,3400
1.02,6,28,8160,15,222,61,540,1964,13,944,70,1591,6196
273.43,17,4,240,2,32,273428,32,120,2,32,273429,32,120
1745.461,6,95,7203,63,38,28152,205,4476,32,33,56293,98,2727
1776.223,17,73,3060,72,14,25017,14,3024,1,8,0,8,36
0.016,17,2,475,1,40,0,40,68,1,379,0,379,407
42.937,6,37,11341,16,320,70,1189,2888,21,585,2145,1917,8453
0.982,17,2,780,2,362,982,362,780,0,0,0,0,0
3.982,17,5,295,5,31,995,31,295,0,0,0,0,0
13.588,6,28,5117,14,154,1028,722,1818,14,427,1031,2026,3299
3.523,17,3,1167,3,361,1761,361,1167,0,0,0,0,0
8.922,6,76,24245,39,550,234,1152,18624,37,459,240,1179,5621
1790.465,1,62,3472,62,28,29351,28,3472,0,0,0,0,0
6.77,6,1661,1592444,1085,1392,6,1408,1557828,576,931,11,2801,34616
55.354,17,2,672,2,308,55354,308,672,0,0,0,0,0
1798.245,6,160,12095,88,83,20669,208,8223,72,31,25323,31,3872
0.213,17,4,240,2,32,212,32,120,2,32,212,32,120
2.183,6,34,15652,18,887,128,1360,6101,16,889,132,3639,9551
0.132,17,2,158,1,34,0,34,62,1,68,0,68,96
0.017,6,15,5964,8,88,2,88,452,7,1740,2,1880,5512
298.455,17,4,352,2,60,298454,60,176,2,60,298454,60,176
0.072,17,2,185,1,45,0,45,73,1,84,0,84,112
1.665,6,40,8427,21,321,83,1164,2846,19,437,80,2715,5581
5.183,6,40,7309,21,218,259,314,3463,19,513,273,1179,3846
1741.363,17,30,31680,30,1028,60047,1028,31680,0,0,0,0,0
16.476,6,22,5866,11,275,1647,275,998,11,1104,1573,1440,4868
1740.714,17,29,30624,29,1028,62168,1028,30624,0,0,0,0,0
358.887,6,64,18511,39,596,9444,1360,12387,25,319,378,2667,6124
256.64,6,30,8872,14,158,19741,267,1357,16,858,17102,3456,7515
61.003,17,4,352,2,60,61002,60,176,2,60,61002,60,176
0.522,6,8,335,4,0,174,0,164,4,7,76,7,171
21.947,6,83,26628,42,903,535,1101,15282,41,276,299,1460,11346
240.351,6,46,8551,24,449,10449,1418,5752,22,205,11444,580,2799
1.323,6,4,172,2,0,1323,0,84,2,0,1009,0,88
280.32,6,28,7352,12,158,25483,267,1277,16,603,18683,1400,6075
11.074,6,81,24461,41,550,276,1152,18720,40,459,276,1179,5741
93.07,6,10,632,3,92,46461,92,256,7,0,15485,0,376
0.069,17,4,588,2,48,49,48,152,2,190,55,308,436
111.803,6,43,8823,21,367,683,787,2034,22,368,5317,3488,6789
1026.134,6,137,10859,52,78,20117,337,5357,85,50,12215,143,5502
1685.889,17,12,498,11,14,168588,14,462,1,8,0,8,36
0.265,17,2,685,1,308,0,308,336,1,321,0,321,349
32.174,17,4,352,2,60,32173,60,176,2,60,32173,60,176
301.026,6,45,13745,25,881,12542,1460,8098,20,402,463,2920,5647
1685.539,17,12,498,11,14,168553,14,462,1,8,0,8,36
2.609,6,28,11444,12,278,237,813,1792,16,881,173,1408,9652
1793.926,1,58,4872,58,56,31472,56,4872,0,0,0,0,0
1799.068,17,475,64274,217,179,8328,1350,44957,258,46,7000,1350,19317
2.121,6,20,5641,12,608,192,1408,3066,8,537,210,1548,2575
17.743,17,34,9754,16,348,1181,1350,6020,18,179,1041,1350,3734
1.311,6,48,20698,28,931,48,1360,15122,20,476,59,2715,5576
31.319,6,8,348,2,0,29,0,84,6,0,6259,0,264
1781.138,17,86,3606,85,14,21204,14,3570,1,8,0,8,36
299.61,6,24,13405,4,106,147,106,274,20,684,15768,1420,13131
7.409,6,66,20126,34,540,224,1152,15419,32,489,228,1179,4707
0.151,6,2,116,1,0,0,0,52,1,0,0,0,64
1797.506,6,1848,1935777,695,149,2590,872,46592,1153,1696,1560,8508,1889185
280.266,6,30,7432,13,158,23355,267,1317,17,543,17510,1400,6115
7.551,6,29,7402,16,380,503,885,3491,13,645,613,1767,3911
31.615,6,7,308,1,0,0,0,44,6,0,6308,0,264
1.051,6,29,12011,16,525,70,1360,3298,13,909,71,1380,8713
1744.727,2,27,864,27,8,67104,8,864,0,0,0,0,0
1.645,17,2,784,2,364,1645,364,784,0,0,0,0,0
87.915,6,27,11073,13,367,245,783,1674,14,1101,6751,1360,9399
1798.665,17,179,13962,179,50,10104,50,13962,0,0,0,0,0
11.976,6,18,5706,10,275,1330,275,958,8,1104,1453,1440,4748
386.53,6,21,1419,15,177,27609,177,989,6,110,12268,110,430
51.08,6,27,7177,13,155,4256,267,1306,14,530,3928,3417,5871
1.186,6,24,6636,13,350,98,1089,2276,11,783,117,1420,4360
1.787,6,50,19694,27,920,68,1460,13998,23,433,70,1460,5696
1786.56,6,106,8524,68,66,26665,66,4964,38,60,48281,60,3560
11.38,17,4,352,2,60,11378,60,176,2,60,11379,60,176
373.796,6,21,1419,15,177,26699,177,989,6,110,12248,110,430
23.074,17,4,1344,4,308,7691,308,1344,0,0,0,0,0
70.405,17,4,352,2,60,70403,60,176,2,60,70404,60,176
1796.841,17,443,39168,399,35,4514,288,25264,44,288,40951,288,13904
265.855,6,2702,1383953,1517,845,175,1152,1322896,1185,369,224,1179,61057
1745.554,6,95,7203,63,38,28154,205,4476,32,33,56300,98,2727
60.161,2,2,64,2,8,60161,8,64,0,0,0,0,0
1.544,6,48,18201,26,882,61,1360,12545,22,433,64,1360,5656
35.03,6,30,5042,15,180,2502,722,1859,15,342,2466,1448,3183
1724.162,1,113,6328,113,28,15394,28,6328,0,0,0,0,0
0.166,17,4,368,2,32,165,32,120,2,96,113,96,248
1794.084,17,80,3354,79,14,23001,14,3318,1,8,0,8,36
0.365,17,2,164,1,46,0,46,74,1,62,0,62,90
1786.531,6,104,8376,68,65,26664,65,4930,36,59,51041,59,3446
218.02,6,23,2841,10,125,555,245,910,13,703,18047,1152,1931
1773.372,6,180,15480,120,69,14902,69,8940,60,69,30049,69,6540
1773.303,17,140,11200,70,48,25699,48,5320,70,56,25699,56,5880
7.014,6,1775,1670306,1142,1386,5,1408,1632726,633,931,10,2801,37580
1.398,6,9,527,5,43,349,43,311,4,0,460,0,216
1786.52,17,87,3648,86,14,21017,14,3612,1,8,0,8,36
176.835,6,25,6320,9,272,111,517,1181,16,345,11782,1452,5139
17.276,6,50,14125,27,510,664,1152,10785,23,604,453,1179,3340
1789.75,6,390,23997,211,69,8522,69,12580,179,46,10054,69,11417
0.011,6,2,421,1,0,0,0,40,1,341,0,341,381
0.627,6,3,120,2,0,627,0,80,1,0,0,0,40
6.425,6,41,7365,22,218,305,314,3503,19,516,342,1179,3862
0.021,17,2,366,1,37,0,37,65,1,273,0,273,301
0.001,1,5,2396,5,451,0,548,2396,0,0,0,0,0
1789.943,6,356,22520,208,69,8647,69,12460,148,69,12176,69,10060
1787.101,6,104,8504,69,66,26280,66,5004,35,60,52557,60,3500
2.85,17,6,1300,3,37,1419,37,195,3,340,1420,348,1105
155.096,17,4,304,4,48,51698,48,304,0,0,0,0,0
1.307,6,46,18509,27,847,50,1360,12973,19,476,63,2715,5536
0.162,17,2,189,1,37,0,37,65,1,96,0,96,124
1798.587,17,447,39864,402,35,4485,288,25644,45,288,40021,288,14220
0.007,6,14,4439,7,92,1,92,464,7,900,1,1448,3975
0.786,6,47,10828,25,167,32,603,3374,22,656,31,1460,7454
15.333,17,29,16683,9,354,1916,1350,3443,20,634,769,1350,13240
280.171,6,28,7352,13,158,23347,267,1317,15,678,20011,3436,6035
62.489,6,89,57371,46,291,1388,976,4501,43,1332,1487,1828,52870
1.618,17,2,603,1,43,0,43,71,1,504,0,504,532
0.382,6,13,1693,7,288,60,288,588,6,426,43,434,1105
193.959,17,4,352,2,60,193958,60,176,2,60,193957,60,176
0.091,17,4,284,2,32,78,32,120,2,54,78,60,164
1794.146,1,58,4872,58,56,31476,56,4872,0,0,0,0,0
1775.105,17,140,11200,70,48,25726,48,5320,70,56,25726,56,5880
0.512,17,3,451,2,39,423,39,134,1,289,0,289,317
0.479,6,53,22804,29,1030,17,1380,15679,24,511,19,1923,7125
0.022,17,2,904,1,300,0,300,328,1,548,0,548,576
1679.84,2,21,672,21,8,83992,8,672,0,0,0,0,0
1793.937,17,144,11520,72,48,25266,48,5472,72,56,25266,56,6048
73.109,6,24,1759,18,43,4300,43,1399,6,0,14020,0,360
0.059,17,4,284,2,32,1,32,120,2,54,21,60,164
1750.531,17,12,498,11,14,175053,14,462,1,8,0,8,36
316.581,6,52,13026,23,253,14390,1343,3507,29,379,11300,1360,9519
4.937,6,39,7269,21,218,246,314,3463,18,513,275,1179,3806
61.433,6,27,7177,13,155,5119,267,1306,14,530,4724,3417,5871
240.337,6,44,8447,22,449,11444,1402,5648,22,205,11444,580,2799
298.876,1,4,326,4,53,99625,78,326,0,0,0,0,0
10.025,6,85,25170,42,534,244,1152,19309,43,413,232,1152,5861
4.924,6,41,7349,21,218,246,314,3463,20,440,246,1152,3886
0.129,6,8,962,4,213,43,213,377,4,421,37,421,585
1716.092,1,8,448,8,28,245156,28,448,0,0,0,0,0
0.175,17,2,136,1,32,0,32,60,1,48,0,48,76
0.162,17,2,144,1,36,0,36,64,1,52,0,52,80
0.689,6,61,32091,35,1094,20,1380,26629,26,421,26,1923,5462
713.668,6,56,9619,26,149,28544,517,2256,30,644,24606,1368,7363
24.485,6,185,76951,97,740,255,1152,68267,88,430,278,1179,8684
1786.554,6,102,8296,68,65,26664,65,4930,34,59,54135,59,3366
1681.817,17,14,1036,7,30,280300,30,406,7,62,280300,62,630
0.44,17,13,8658,6,831,80,1350,5156,7,472,66,1350,3502
125.139,2,2,64,2,8,125139,8,64,0,0,0,0,0
14.864,17,4,352,2,48,14846,48,152,2,72,14842,72,200
62.614,6,25,7097,12,155,5692,267,1266,13,589,5217,3426,5831
3.557,17,30,14014,14,698,273,1350,10174,16,212,220,1350,3840
0.675,6,10,861,5,222,166,222,426,5,231,166,231,435
0.32,6,10,767,5,186,78,186,454,5,45,77,45,313
12.088,6,1893,1659314,1151,1386,10,1420,1625413,742,467,16,2840,33901
0.329,6,24,5980,12,164,29,453,1442,12,651,27,1448,4538
33.748,6,30,5042,15,154,2410,722,1859,15,399,2396,2026,3183
240.862,6,32,6946,14,169,9148,516,1578,18,309,14161,1452,5368
1.179,6,25,8056,12,164,91,267,1288,13,869,84,1408,6768
180.532,6,33,19494,19,702,40,1360,5019,14,1544,13878,4870,14475
17.926,6,1284,1175137,827,1344,21,1368,1144349,457,776,38,1473,30788
66.335,6,13,1079,12,43,6030,43,1019,1,0,0,0,60
75.527,6,497,218257,249,813,304,1152,202832,248,423,304,1179,15425
0.002,6,3,151,1,0,0,0,40,2,31,0,31,111
8.635,6,1735,1608827,1102,1382,7,1408,1571235,633,931,13,2801,37592
1.595,6,3,182,1,31,0,31,71,2,31,1595,31,111
1783.568,17,83,3480,82,14,22019,14,3444,1,8,0,8,36
0.411,17,4,624,2,64,388,64,184,2,192,110,192,440
11.843,17,3,1167,3,361,5921,361,1167,0,0,0,0,0
280.435,6,30,7432,13,158,23369,267,1317,17,603,17523,2760,6115
1787.323,6,354,22440,207,69,8676,69,12420,147,69,12241,69,10020
0.435,6,24,6040,13,108,36,147,959,11,772,42,1608,5081
7.739,6,3,180,3,0,0,0,180,0,0,0,0,0
64.583,6,27,7177,13,155,5381,267,1306,14,530,4966,3417,5871
0.538,17,8,2750,8,315,76,354,2750,0,0,0,0,0
66.778,6,30,7297,14,155,5136,267,1346,16,441,4451,1420,5951
1799.643,17,142,11360,71,48,25709,48,5396,71,56,25709,56,5964
0.671,6,10,924,5,283,117,283,551,5,105,115,105,373
1799.143,6,367,25857,211,99,8567,469,14925,156,69,11605,69,10932
64.555,6,17,700,8,0,7075,0,328,9,0,8067,0,372
314.801,1,8,448,8,28,44971,28,448,0,0,0,0,0
0.507,17,3,451,2,39,134,39,134,1,289,0,289,317
1.059,17,2,122,2,33,1059,33,122,0,0,0,0,0
0.387,6,2,92,1,0,0,0,40,1,0,0,0,52
280.371,6,29,7392,13,158,23364,267,1317,16,543,18690,1400,6075
11.557,17,26,8676,11,401,1155,1350,4724,15,235,728,1350,3952
1763.823,1,8,448,8,28,251974,28,448,0,0,0,0,0
317.021,6,67,19325,38,345,8568,1360,10184,29,442,11317,4649,9141
0.23,6,16,4180,9,124,28,124,736,7,1530,38,1612,3444
1621.483,1,7,392,7,28,270247,28,392,0,0,0,0,0
23.35,6,33,8097,16,188,1556,721,1964,17,681,1446,2840,6133
0.561,6,10,924,5,283,96,283,551,5,105,95,105,373
12.117,1,4,224,4,28,4039,28,224,0,0,0,0,0
0.583,17,2,782,2,363,583,363,782,0,0,0,0,0
1.668,6,29,10370,17,367,104,835,1787,12,1012,143,1420,8583
5.779,6,39,7285,19,218,321,314,3383,20,516,291,1179,3902
1.403,6,50,18904,29,859,50,1360,13243,21,437,61,2715,5661
1795.758,17,140,11200,70,48,26025,48,5320,70,56,26025,56,5880
6.025,6,9,520,4,0,2008,0,220,5,0,772,0,300
41.643,17,6,528,3,48,20817,48,228,3,72,20816,72,300
0.451,17,2,166,1,47,0,47,75,1,63,0,63,91
287.327,6,27,8794,10,181,31925,267,1128,17,581,17957,2045,7666
1786.91,6,365,25501,212,100,8468,469,14896,153,69,11752,69,10605
2.526,17,4,1560,4,362,842,362,1560,0,0,0,0,0
171.454,1,18,1008,18,28,10085,28,1008,0,0,0,0,0
84.196,6,45,8927,21,367,831,787,2058,24,327,3654,1360,6869
33.378,6,5,200,0,0,0,0,0,5,0,0,0,200
0.125,17,3,404,2,64,89,64,184,1,192,0,192,220
0.603,6,9,878,3,179,301,267,478,6,53,104,85,400
26.766,6,4,440,1,126,0,126,178,3,82,13383,82,262
1789.047,1,273,15288,273,28,6577,28,15288,0,0,0,0,0
1.294,6,43,15082,24,777,56,1460,9546,19,433,62,1460,5536
1764.389,2,15,480,15,8,126027,8,480,0,0,0,0,0
366.976,6,25,1654,17,180,22936,180,1120,8,110,9226,110,534
5.486,6,39,7285,21,218,274,314,3463,18,516,307,1179,3822
1.486,6,47,19018,26,948,59,1460,13402,21,476,63,2615,5616
1797.948,17,140,11192,71,48,25684,48,5396,69,56,26440,56,5796
0.411,6,28,9172,13,266,34,705,1750,15,829,28,1438,7422
0.083,6,13,3980,7,88,13,88,388,6,1670,16,2920,3592
2.258,17,4,580,2,40,2209,40,136,2,194,2222,194,444
1741.235,6,87,6322,58,31,30547,31,3915,29,31,62186,31,2407
0.445,6,38,19530,22,171,21,313,1850,16,1871,28,6088,17680
2.326,6,30,10405,18,367,136,833,1825,12,1012,203,1420,8580
17.443,17,16,1212,9,40,2175,41,618,7,56,2859,57,594
282.178,6,30,7432,13,158,23514,267,1317,17,543,17610,1400,6115
0.471,6,49,21874,27,1041,18,1380,16749,22,467,20,1923,5125
18.606,6,11,2042,7,331,3101,598,1034,4,396,32,580,1008
1773.273,17,140,11200,70,48,25699,48,5320,70,56,25699,56,5880
1.592,6,50,21302,28,905,58,1360,15646,22,433,67,1360,5656
154.741,6,19,772,7,0,8350,0,284,12,0,14066,0,488
1504.466,17,16,1265,8,30,214922,37,471,8,71,214921,136,794
7.246,6,270,539288,200,1113,36,1360,26973,70,8635,103,65280,512315
1796.924,17,431,38216,389,36,4631,288,24944,42,288,42949,288,13272
1684.582,17,14,1036,7,30,280757,30,406,7,62,280754,62,630
0.112,17,2,193,1,34,0,34,62,1,103,0,103,131
300.769,6,38,8822,20,303,15829,868,2047,18,464,504,1360,6775
17.609,6,52,21911,26,1054,704,1440,15858,26,357,697,1440,6053
4.115,17,2,134,2,39,4115,39,134,0,0,0,0,0
2.415,6,6,340,3,0,1114,0,164,3,0,1111,0,176
1786.473,6,181,15589,121,69,14887,69,9049,60,69,30275,69,6540
6.266,6,944,858409,572,1424,10,1448,834401,372,776,16,1448,24008
0.012,6,2,149,1,69,0,69,109,1,0,0,0,40
1740.506,6,87,6322,58,31,30535,31,3915,29,31,62160,31,2407
0.118,6,7,423,4,43,20,43,259,3,0,56,0,164
11.185,6,27,11433,13,275,932,275,1078,14,1087,770,1440,10355
186.298,17,39,13104,39,308,4902,308,13104,0,0,0,0,0
0.011,17,2,180,1,30,0,30,58,1,94,0,94,122
9.705,2,2,64,2,8,9705,8,64,0,0,0,0,0
6.183,6,43,7429,22,218,294,314,3503,21,513,294,1179,3926
129.94,6,20,3484,8,92,18562,92,504,12,261,11779,2026,2980
1774.574,17,140,11200,70,48,25718,48,5320,70,56,25718,56,5880
1710.044,1,8,448,8,28,244292,28,448,0,0,0,0,0
0.12,17,2,152,2,48,120,48,152,0,0,0,0,0
1797.366,6,356,22520,208,69,8682,69,12460,148,69,12226,69,10060
42.373,17,46,6644,23,48,1922,48,1748,23,184,1925,308,4896
1780.835,6,179,15440,120,69,14965,69,9009,59,69,30702,69,6431
33.562,6,46,10686,23,783,570,1360,4919,23,371,1517,1360,5767
0.518,6,24,6076,12,181,47,537,1526,12,781,41,2224,4550
439.601,1,34,1904,34,28,13321,28,1904,0,0,0,0,0
280.289,6,28,7352,13,158,23357,267,1317,15,678,20017,2800,6035
53.467,6,32,8952,14,158,4112,267,1357,18,624,3139,1400,7595
142.503,6,52,22244,27,1010,799,1460,11253,25,623,5923,1460,10991
300.57,6,18,1275,9,177,37548,177,701,9,110,37549,110,574
1780.354,6,127,13737,78,64,23121,722,6518,49,113,37084,1408,7219
26.845,6,1188,1094200,768,1355,34,1368,1067636,420,776,63,2736,26564
1787.502,6,107,8561,69,65,26286,65,5035,38,59,48307,59,3526
2.844,17,7,1062,4,32,5,32,240,3,246,0,246,822
0.464,17,21,10031,11,532,46,1350,6163,10,358,45,1350,3868
1765.831,1,51,4284,0,0,0,0,0,51,56,35316,56,4284
1.267,6,9,1647,6,100,253,100,344,3,1179,504,1179,1303
1700.49,17,12,498,11,14,170049,14,462,1,8,0,8,36
123.812,6,34,7935,12,155,27,267,1266,22,340,5895,3417,6669
125.982,6,17,3307,8,92,17997,92,504,9,333,15723,1448,2803
1780.451,17,140,11200,70,48,25803,48,5320,70,56,25803,56,5880
1.614,17,6,360,3,32,806,32,180,3,32,806,32,180
0.25,17,2,707,2,325,250,356,707,0,0,0,0,0
1792.487,17,140,11200,70,48,25977,48,5320,70,56,25977,56,5880
0.331,17,4,272,2,32,330,32,120,2,48,330,48,152
175.278,17,2,72,1,8,0,8,36,1,8,0,8,36
0.011,17,4,320,4,52,3,52,320,0,0,0,0,0
7.737,6,41,7349,21,218,386,314,3463,20,513,392,1179,3886
8.907,6,16,5351,8,275,1272,275,603,8,1104,859,1440,4748
2.551,17,28,13715,13,735,212,1350,9919,15,225,112,1350,3796
15.286,17,4,2728,4,654,5095,654,2728,0,0,0,0,0
31.887,17,4,352,2,60,31886,60,176,2,60,31885,60,176
1744.541,6,95,7203,63,38,28137,205,4476,32,33,56267,98,2727
0.371,6,3,144,2,0,127,0,104,1,0,0,0,40
1443.913,2,11,352,11,8,144391,8,352,0,0,0,0,0
0.793,17,2,136,1,32,0,32,60,1,48,0,48,76
0.031,17,2,656,2,300,31,300,656,0,0,0,0,0
0.298,6,28,7336,13,155,24,267,1301,15,543,20,1400,6035
1771.111,6,101,9278,66,64,27247,64,5544,35,58,52089,58,3734
5.713,6,40,7309,20,218,300,314,3423,20,513,285,1179,3886
14.066,17,4,352,2,60,14065,60,176,2,60,14065,60,176
12.439,6,83,24525,41,550,310,1152,18704,42,459,295,1179,5821
134.298,6,133,43135,78,616,1744,1368,31181,55,274,2483,2736,11954
12.202,17,20,3400,10,33,1355,33,610,10,251,1355,323,2790
1.883,6,28,9172,13,266,156,705,1750,15,829,132,1438,7422
1781.155,17,73,3060,72,14,25086,14,3024,1,8,0,8,36
1780.749,6,188,18838,124,97,14477,965,11030,64,82,28265,485,7808
1772.728,6,180,15480,120,69,14896,69,8940,60,69,30037,69,6540
1791.565,1,255,14280,255,28,7053,28,14280,0,0,0,0,0
181.111,6,135,128603,84,430,2182,647,5750,51,2731,1385,14080,122853
1787.867,6,104,8240,68,63,26684,63,4862,36,57,51079,57,3378
3.366,17,4,1556,4,361,1122,361,1556,0,0,0,0,0
297.375,1,8,448,8,28,42482,28,448,0,0,0,0,0
13.894,6,5,260,2,0,10430,0,104,3,0,6947,0,156
173.004,6,24,1528,9,43,17874,46,621,15,43,12357,46,907
9.973,6,78,24629,40,560,255,1152,18968,38,459,262,1179,5661
317.075,6,106,34527,57,494,5662,1360,23584,49,332,6602,4080,10943
5.379,6,41,7349,21,218,268,314,3463,20,440,270,1152,3886
1786.96,6,102,8296,68,65,26671,65,4930,34,59,54147,59,3366
55.274,17,2,72,1,8,0,8,36,1,8,0,8,36
73.473,17,6,528,3,60,36735,60,264,3,60,36736,60,264
0.201,6,12,3702,6,170,33,170,490,6,964,19,1448,3212
0.387,6,13,1693,7,288,63,288,588,6,426,42,434,1105
52.507,17,17,2437,17,115,3281,357,2437,0,0,0,0,0
0.999,6,28,8160,15,222,60,540,1964,13,944,68,1591,6196
1624.347,2,18,576,18,8,95549,8,576,0,0,0,0,0
343.009,1,8,448,8,28,49001,28,448,0,0,0,0,0
8.986,6,1804,1650249,1130,1381,7,1408,1610537,674,931,13,2801,39712
16.141,17,27,19185,16,853,1072,1350,14111,11,433,1606,1350,5074
127.601,17,16,21956,16,1344,8506,1348,21956,0,0,0,0,0
12.255,17,20,4045,10,33,1361,33,610,10,315,1361,327,3435
65.733,6,67,45052,43,1160,1565,1408,37071,24,747,2675,1408,7981
1.292,6,11,1727,7,100,215,100,384,4,589,347,1152,1343
1515.919,6,335,51522,149,299,10242,1360,29579,186,108,8193,3289,21943
0.054,17,2,213,1,54,0,54,82,1,103,0,103,131
1739.474,2,25,800,25,8,72478,8,800,0,0,0,0,0
173.209,6,24,10290,13,579,53,1360,2871,11,1161,17308,2574,7419
4.845,6,31,8912,14,158,372,267,1357,17,687,296,2036,7555
5.177,17,4,288,2,36,5003,36,128,2,52,5061,52,160
5.598,6,39,7285,21,218,279,314,3463,18,516,313,1179,3822
0.179,6,10,1671,6,552,35,948,1348,4,159,59,159,323
2.142,6,11,1731,7,100,357,100,384,4,1179,629,1179,1347
61.551,6,12,790,6,31,12310,31,395,6,38,11362,62,395
17.59,6,6,328,4,0,5863,0,216,2,0,17558,0,112
0.477,6,20,7229,13,334,39,663,2021,7,1209,72,1946,5208
289.601,1,4,224,4,28,96533,28,224,0,0,0,0,0
0.632,6,48,21141,27,1067,24,1380,16059,21,468,28,3303,5082
779.137,17,12,504,12,14,70830,14,504,0,0,0,0,0
0.058,17,4,368,2,32,57,32,120,2,96,1,96,248
33.479,6,31,5094,15,154,2391,722,1860,16,342,2218,1448,3234
87.584,6,11760,15370833,1852,205,47,294,100312,9908,1491,8,4314,15270521
9.292,6,2043,1927346,1325,1378,6,1408,1885346,718,776,12,1408,42000
1776.197,17,73,3060,72,14,25016,14,3024,1,8,0,8,36
266.407,17,4,352,2,60,266406,60,176,2,60,266406,60,176
0.967,17,4,300,2,39,965,39,134,2,55,965,55,166
10.504,6,10,1343,3,299,5242,299,463,7,246,1747,459,880
370.892,6,18,1242,14,180,28530,180,916,4,110,20060,110,326
82.193,6,18,748,8,0,11741,0,328,10,0,9123,0,420
1792.636,17,142,11360,71,48,25608,48,5396,71,56,25608,56,5964
128.714,17,4,240,2,32,128713,32,120,2,32,128713,32,120
10.215,6,66,20206,33,565,319,1152,15459,33,489,311,1179,4747
4.686,6,37,7189,19,218,260,314,3383,18,513,260,1179,3806
1128.089,17,22,5315,11,32,112808,37,666,11,394,112807,463,4649
1771.335,6,99,9306,66,66,27251,66,5610,33,60,55351,60,3696
31.72,6,7,396,1,0,0,0,60,6,0,6307,0,336
1504.024,2,15,480,15,8,107430,8,480,0,0,0,0,0
611.838,6,68,20769,25,569,1865,1360,9580,43,324,14563,1360,11189
0.043,17,4,608,2,60,30,60,176,2,188,27,188,432
75.852,6,31,7613,12,155,32,267,1266,19,398,4213,3417,6347
0.43,17,4,300,2,39,429,39,134,2,55,429,55,166
0.33,6,5,276,3,0,165,0,164,2,0,128,0,112
3.914,6,10,2929,4,92,1304,92,296,6,579,628,1448,2633
0.063,6,2,111,1,0,0,0,40,1,31,0,31,71
0.592,6,12,1304,6,256,117,256,756,6,304,116,304,548
3.336,6,14,1758,7,503,555,503,895,7,475,555,475,863
1684.854,17,14,1036,7,30,280802,30,406,7,62,280745,62,630
29.086,2,2,64,2,8,29086,8,64,0,0,0,0,0
318.039,6,67,18574,33,407,9938,1460,9495,34,335,9632,1629,9079
1773.144,6,180,15480,120,69,14900,69,8940,60,69,30047,69,6540
5.024,17,4,288,2,36,5006,36,128,2,52,4964,52,160
3.64,6,33,6129,17,206,227,314,2744,16,456,225,1152,3385
1784.091,6,102,8228,68,64,26628,64,4896,34,58,54060,58,3332
4.999,17,4,542,2,36,4994,36,128,2,179,4994,187,414
1769.555,1,88,4928,88,28,20339,28,4928,0,0,0,0,0
1786.549,6,102,8228,68,64,26664,64,4896,34,58,54134,58,3332
19.53,6,23,6504,9,154,2441,267,832,14,566,1485,1460,5672
0.32,6,27,9055,13,247,26,624,1684,14,947,24,1408,7371
13.495,17,4,1370,2,308,13495,308,672,2,321,1012,321,698
0.421,6,26,7751,16,339,28,949,3017,10,721,45,1420,4734
178.862,6,140,22064,79,304,2293,304,15760,61,83,2980,83,6304
0.316,6,20,4960,10,137,35,267,1092,10,692,34,1467,3868
1797.428,17,449,39928,404,35,4460,288,25708,45,288,40020,288,14220
34.738,17,20,1760,10,48,3852,48,760,10,72,3848,72,1000
1679.976,1,15,840,15,28,119998,28,840,0,0,0,0,0
12.332,6,1955,1633517,1150,1363,10,1380,1596103,805,383,15,1380,37414
0.623,17,2,152,1,48,0,48,76,1,48,0,48,76
0.979,17,4,624,2,64,977,64,184,2,192,839,192,440
372.465,6,27,1767,18,177,21909,177,1181,9,110,8936,110,586
1.208,17,3,1176,3,364,604,364,1176,0,0,0,0,0
0.046,6,13,1028,7,181,7,181,553,6,77,8,134,475
1677.682,1,7,392,7,28,279613,28,392,0,0,0,0,0
1775.186,6,121,14030,78,86,23054,483,7277,43,115,42264,1440,6753
1798.611,6,382,26595,220,97,8212,469,15630,162,69,11168,69,10965
126.94,6,34,15190,19,887,64,1360,6129,15,938,9054,2720,9061
10.838,6,18,4214,10,275,1204,275,958,8,974,865,1414,3256
0.472,17,4,314,2,31,429,31,118,2,70,433,70,196
1787.494,6,361,23065,207,69,8677,69,12489,154,69,11680,69,10576
1708.161,17,16,4484,16,252,113877,1030,4484,0,0,0,0,0
55.607,6,21,6458,12,333,5055,516,1816,9,713,6938,1452,4642
240.744,6,55,17833,29,751,8597,1402,15042,26,177,9629,580,2791
12.066,6,87,24994,46,526,268,1152,19213,41,459,294,1179,5781
56.249,6,1301,1113027,770,1361,73,1368,1077677,531,899,105,1473,35350
0.058,17,12,918,6,40,7,41,411,6,56,7,57,507
1785.813,17,142,11360,71,48,25511,48,5396,71,56,25511,56,5964
18.101,6,67,45066,41,718,452,1408,6582,26,2062,723,5632,38484
195.024,6,63,42628,41,1153,4875,1408,33343,22,903,2926,2816,9285
330.812,6,17,896,9,0,41350,0,476,8,0,47257,0,420
291.623,6,32,3329,17,324,18226,585,1593,15,192,20438,580,1736
0.879,6,10,1687,7,100,146,100,384,3,1179,311,1179,1303
1.045,17,24,10457,11,419,104,1350,4925,13,397,66,1350,5532
3.331,6,2,88,2,0,0,0,88,0,0,0,0,0
1771.92,1,58,4872,58,56,31086,56,4872,0,0,0,0,0
5.935,6,752,645558,453,1352,12,1368,625346,299,776,19,2736,20212
11.333,6,22,6817,12,275,1030,275,1038,10,1073,700,1440,5779
1046.503,17,12,2992,6,32,209298,37,362,6,410,209298,463,2630
0.908,17,2,134,2,39,908,39,134,0,0,0,0,0
479.103,6,104,34952,50,648,9777,1418,11727,54,657,9039,1418,23225
8.379,6,1167,1010387,682,1400,12,1448,980503,485,776,16,1448,29884
1.683,6,14,2351,8,188,240,245,700,6,703,287,1152,1651
0.977,6,29,6040,14,161,75,267,1535,15,650,48,1420,4505
1786.638,6,106,8518,68,65,26666,66,4961,38,59,48284,60,3557
50.057,6,261,212821,174,1282,288,1360,203165,87,268,579,2667,9656
18.565,17,4,352,2,60,18563,60,176,2,60,18564,60,176
1786.648,6,104,8376,68,65,26666,65,4930,36,59,51044,59,3446
1.325,6,51,20210,29,950,47,1460,14509,22,400,54,1460,5701
160.02,6,30,7432,13,158,13335,267,1317,17,543,9996,1400,6115
41.95,6,41,12478,21,633,2097,1360,4699,20,535,2187,1360,7779
0.469,6,21,4402,11,165,46,456,1394,10,493,43,888,3008
0.068,17,2,245,1,32,0,32,60,1,157,0,157,185
12.074,6,40,12816,20,700,635,1360,5093,20,493,528,1360,7723
1798.595,17,448,39896,403,35,4474,288,25676,45,288,40023,288,14220
0.02,17,2,122,1,33,0,33,61,1,33,0,33,61
181.905,17,4,308,4,49,60635,49,308,0,0,0,0,0
1785.86,6,371,23348,212,69,8463,69,12827,159,64,11302,69,10521
0.008,17,2,382,1,33,0,33,61,1,293,0,293,321
280.488,6,29,7392,13,158,23374,267,1317,16,678,18693,3456,6075
3.292,6,13,3095,4,92,1097,92,296,9,464,365,1448,2799
8.326,6,34,6169,18,206,489,314,2784,16,548,537,1179,3385
1759.161,6,150,9750,81,54,21989,208,6091,69,31,25866,31,3659
8.739,6,1172,935292,623,1406,13,1448,897526,549,702,15,1448,37766
0.002,17,2,136,1,32,0,32,60,1,48,0,48,76
242.007,6,82,51678,47,1180,5261,1408,40308,35,867,1812,1408,11370
3.33,17,16,2052,16,100,222,357,2052,0,0,0,0,0
0.994,6,24,6435,13,310,82,889,2075,11,783,98,1420,4360
0.989,6,29,8200,15,222,59,540,1964,14,809,62,1460,6236
32.282,6,504,444974,208,125,155,299,12501,296,1428,109,2836,432473
5.16,6,5,232,2,0,5160,0,88,3,0,1499,0,144
1783.288,17,83,3480,82,14,22015,14,3444,1,8,0,8,36
15.741,17,21,15381,13,994,1306,1350,13292,8,233,2237,1350,2089
150.585,6,24,10054,12,532,61,1360,2642,12,1153,13677,2720,7412
0.311,6,26,8991,13,247,25,624,1672,13,1105,25,2816,7319
181.252,17,5,4444,5,860,45313,1451,4444,0,0,0,0,0
374.13,6,27,1767,18,177,22007,177,1181,9,110,8904,110,586
0.453,17,3,543,2,39,448,39,134,1,381,0,381,409
447.985,6,48,7155,22,121,19024,516,2220,26,169,17915,1452,4935
0.28,17,2,148,1,38,0,38,66,1,54,0,54,82
1791.781,1,58,4872,58,56,31434,56,4872,0,0,0,0,0
1782.131,17,79,3312,78,14,23144,14,3276,1,8,0,8,36
1794.123,17,73,3060,72,14,25269,14,3024,1,8,0,8,36
1771.318,6,99,9306,66,66,27251,66,5610,33,60,55350,60,3696
0.004,17,2,271,1,60,0,60,88,1,155,0,155,183
1757.1,1,126,7056,126,28,14056,28,7056,0,0,0,0,0
280.187,6,29,7392,13,158,23348,267,1317,16,603,18678,2036,6075
22.611,6,3544,3422790,2371,1367,9,1408,3357032,1173,950,19,2801,65758
1784.115,6,104,8376,68,65,26628,65,4930,36,59,50972,59,3446
15.759,17,17,4760,8,278,2245,1350,2450,9,228,1964,1350,2310
25.454,6,14,2242,8,210,3635,210,844,6,545,5090,904,1398
1796.619,6,436,26311,217,69,8317,69,13027,219,35,8241,69,13284
5.875,6,494,426625,308,1325,18,1368,412289,186,931,30,2736,14336
1720.473,17,12,498,11,14,172047,14,462,1,8,0,8,36
3.778,17,5,295,5,31,944,31,295,0,0,0,0,0
507.773,1,14,392,14,0,0,0,392,0,0,0,0,0
3.232,17,5,290,5,30,808,30,290,0,0,0,0,0
0.053,6,2,80,1,0,0,0,40,1,0,0,0,40
15.477,17,34,23058,20,989,812,1350,20357,14,164,1187,1350,2701
39.282,17,44,6468,22,48,1869,48,1672,22,190,1868,308,4796
1.857,6,53,20448,29,961,66,1460,14667,24,400,72,1460,5781
1328.443,17,247,18772,247,48,5400,48,18772,0,0,0,0,0
6.548,6,540,485852,351,1320,18,1368,471360,189,931,33,2736,14492
1319.126,2,9,288,9,8,164890,8,288,0,0,0,0,0
2.84,17,2,1430,2,687,2840,687,1430,0,0,0,0,0
1796.281,17,124,9920,62,48,29447,48,4712,62,56,29447,56,5208
1799.91,17,450,39960,405,35,4455,288,25740,45,288,40018,288,14220
1799.928,1,241,13496,241,28,7499,28,13496,0,0,0,0,0
565.968,17,42,3344,23,48,25725,48,1748,19,56,25677,56,1596
66.204,6,28,7352,13,158,5517,267,1317,15,678,4726,2800,6035
1786.525,17,87,3648,86,14,21017,14,3612,1,8,0,8,36
174.175,17,4,240,2,32,174174,32,120,2,32,174174,32,120
1740.556,6,87,6322,58,31,30536,31,3915,29,31,62160,31,2407
40.356,6,86,73277,35,987,1186,1392,8737,51,1508,730,4188,64540
29.9,6,16,1105,8,222,4269,222,546,8,231,4269,231,559
317.018,6,57,12744,29,143,11322,658,3639,28,419,11736,4649,9105
76.302,17,8,608,8,48,10900,48,608,0,0,0,0,0
0.286,6,25,6116,12,181,26,537,1526,13,651,22,1440,4590
8.651,6,37,8454,19,367,480,787,1918,18,446,498,2720,6536
1.926,6,23,5715,13,158,160,370,1315,10,999,213,1731,4400
2.692,6,15,1491,8,283,360,283,1002,7,105,420,105,489
19.452,6,2764,2608096,1751,1410,11,1448,2550756,1013,776,19,1448,57340
0.655,6,192,182825,86,194,7,230,5283,106,1670,5,4104,177542
353.37,1,5,442,5,60,88342,88,442,0,0,0,0,0
83.559,6,3769,2808910,1875,221,44,230,117747,1894,1371,44,2736,2691163
368.521,6,23,1535,16,177,24568,177,1053,7,110,10375,110,482
168.363,17,4,288,2,36,168350,36,128,2,52,168351,52,160
11.025,6,32,8952,14,158,848,267,1357,18,624,645,1400,7595
0.915,6,12,2069,7,324,152,585,1009,5,396,127,580,1060
1.685,6,53,19543,29,896,60,1360,13750,24,400,63,1360,5793
115.257,17,2,72,1,8,0,8,36,1,8,0,8,36
45.466,6,32,8918,13,327,166,1189,2495,19,471,2525,1420,6423
0.163,6,46,21609,27,1035,6,1420,16628,19,467,8,1883,4981
1798.21,6,339,21219,198,69,9127,69,11784,141,69,12844,69,9435
1792.084,6,362,23036,209,69,8579,69,12707,153,69,11789,69,10329
1.381,6,44,10731,23,513,62,1360,5070,21,400,59,1360,5661
2.787,17,4,624,4,128,929,128,624,0,0,0,0,0
1787.612,17,86,3606,85,14,21281,14,3570,1,8,0,8,36
7.278,6,70,21202,35,541,214,1152,16018,35,472,206,1179,5184
0.843,6,22,5835,13,282,70,546,1370,9,683,94,1420,4465
1782.119,17,83,3480,82,14,22001,14,3444,1,8,0,8,36
35.599,6,26,11398,14,433,2738,990,1903,12,1125,3223,2720,9495
0.016,17,2,142,1,35,0,35,63,1,51,0,51,79
23.375,17,36,17823,18,696,1375,1350,13038,18,237,1363,1350,4785
0.215,17,2,212,1,46,0,46,74,1,110,0,110,138
278.052,17,4,240,2,32,278050,32,120,2,32,278051,32,120
221.983,17,4,352,2,60,221982,60,176,2,60,221982,60,176
41.449,6,40,10236,22,383,1973,836,2083,18,617,598,2128,8153
539.176,6,68,4898,26,56,21561,294,2235,42,46,13150,78,2663
1793.468,17,140,11200,70,48,25992,48,5320,70,56,25992,56,5880
1.261,6,24,8004,12,164,97,267,1288,12,1014,97,2804,6716
0.01,17,2,245,1,32,0,32,60,1,157,0,157,185
1263.397,2,12,384,12,8,114854,8,384,0,0,0,0,0
11.601,6,56,42693,38,1186,313,1368,36389,18,1072,670,2519,6304
1.045,6,41,17071,25,907,43,1360,11929,16,561,57,2744,5142
1785.995,6,324,20550,189,69,9499,69,11355,135,69,13328,69,9195
19.122,6,9,392,4,0,6374,0,172,5,0,1130,0,220
387.483,1,5,280,5,28,96870,28,280,0,0,0,0,0
0.373,6,27,9065,14,252,28,646,1746,13,947,29,1438,7319
4.994,17,4,288,2,36,4993,36,128,2,52,4993,52,160
3.874,17,2,152,2,48,3874,48,152,0,0,0,0,0
1773.277,17,140,11200,70,48,25699,48,5320,70,56,25699,56,5880
225.35,6,90,16368,45,102,5121,593,4328,45,323,5121,3903,12040
188.973,6,9,592,3,92,94486,92,256,6,0,6320,0,336
0.053,17,4,368,2,32,40,32,120,2,96,0,96,248
0.389,17,2,136,1,32,0,32,60,1,48,0,48,76
0.514,17,2,448,1,39,0,39,67,1,353,0,353,381
1798.736,17,449,39928,404,35,4463,288,25708,45,288,40019,288,14220
83.089,6,18,740,8,0,5379,0,328,10,0,9230,0,412
1.325,6,37,8214,19,321,73,1164,2718,18,476,67,2715,5496
3.059,17,2,150,2,47,3059,47,150,0,0,0,0,0
35.234,6,33,9177,19,131,1957,418,1710,14,861,1113,4662,7467
1748.477,1,56,4704,56,56,31790,56,4704,0,0,0,0,0
71.32,6,71,46121,45,1141,1620,1448,36604,26,741,2844,2359,9517
1443.825,2,11,352,11,8,144382,8,352,0,0,0,0,0
1799.417,6,355,22480,208,69,8692,69,12529,147,69,12232,69,9951
0.47,17,8,2750,8,315,67,354,2750,0,0,0,0,0
0.244,17,2,384,1,39,0,39,67,1,289,0,289,317
1726.64,17,329,54722,329,138,5264,363,54722,0,0,0,0,0
0.193,6,46,21640,27,1037,7,1420,16659,19,467,10,1883,4981
1799.083,6,356,22520,208,69,8691,69,12460,148,69,12238,69,10060
1695.52,1,7,392,7,28,282586,28,392,0,0,0,0,0
1.068,6,24,6636,13,350,88,1089,2276,11,783,105,1420,4360
177.825,17,4,352,2,60,177824,60,176,2,60,177824,60,176
1773.577,6,180,15480,120,69,14904,69,8940,60,69,30057,69,6540
240.217,6,56,18365,28,776,8896,1418,15445,28,182,8896,580,2920
0.21,6,12,976,8,181,30,181,605,4,77,46,134,371
1793.889,6,356,22520,208,69,8666,69,12460,148,69,12203,69,10060
0.01,17,2,220,1,34,0,34,62,1,130,0,130,158
61.359,6,37,15888,22,795,2921,1440,9109,15,665,4364,1440,6779
34.97,17,4,352,2,60,34969,60,176,2,60,34968,60,176
3.727,17,5,290,5,30,931,30,290,0,0,0,0,0
0.53,17,3,451,2,39,330,39,134,1,289,0,289,317
6.918,6,50,9509,25,233,288,314,4741,25,470,277,1179,4768
1798.983,6,363,25358,211,89,8566,965,14014,152,82,11913,917,11344
22.68,6,8,506,0,0,0,0,0,8,31,3240,31,506
0.44,17,2,144,1,36,0,36,64,1,52,0,52,80
215.755,17,4,240,2,32,215754,32,120,2,32,215753,32,120
252.374,2,2,64,2,8,252374,8,64,0,0,0,0,0
38.11,2,2,64,2,8,38110,8,64,0,0,0,0,0
300.614,6,43,8843,22,291,14314,786,2125,21,366,482,2128,6718
1745.51,1,8,448,8,28,249358,28,448,0,0,0,0,0
0.918,6,18,6649,11,169,91,325,1161,7,1039,144,2676,5488
1798.835,17,180,14040,180,50,10049,50,14040,0,0,0,0,0
72.709,17,20,1760,10,48,8077,48,760,10,72,8077,72,1000
1787.486,17,87,3648,86,14,21029,14,3612,1,8,0,8,36
1.334,6,51,18377,28,882,49,1460,12636,23,400,52,1460,5741
1771.836,6,148,18755,88,150,20365,817,11209,60,98,30029,239,7546
3.316,6,11,764,5,92,829,92,348,6,92,623,92,416
0.021,17,4,284,2,32,12,32,120,2,54,11,60,164
0.231,6,10,1671,6,552,46,948,1348,4,159,77,159,323
0.009,17,2,358,1,30,0,30,58,1,272,0,272,300
3.64,17,18,8601,10,569,401,1350,5974,8,300,514,1350,2627
1792.803,6,374,23654,213,69,8456,69,13074,161,69,11204,69,10580
1.227,6,49,21084,28,954,45,1360,15468,21,476,53,2715,5616
3.36,17,5,290,5,30,840,30,290,0,0,0,0,0
280.605,6,28,7352,12,158,25509,267,1277,16,603,18697,1400,6075
2.752,6,10,2839,6,100,550,100,344,4,1165,830,1179,2495
66.447,6,14,1067,7,177,11074,177,585,7,110,10589,110,482
0.848,6,11,913,6,182,169,182,490,5,77,144,134,423
1679.704,17,13,534,11,14,167951,14,462,2,8,1679512,8,72
1795.092,17,452,39624,405,35,4443,288,25516,47,272,38287,288,14108
1783.811,6,379,26475,218,99,8220,469,15274,161,69,11148,69,11201
1769.562,6,99,9306,66,66,27224,66,5610,33,60,55296,60,3696
300.948,6,29,9875,16,344,20063,1029,2243,13,992,20071,2816,7632
244.603,6,839,624246,459,1342,533,1360,602183,380,228,644,1360,22063
1720.029,6,123,12247,75,63,23243,722,6267,48,96,36591,1440,5980
1791.805,17,144,11520,72,48,25236,48,5472,72,56,25236,56,6048
137.725,6,211,168260,135,1295,1027,1408,153409,76,680,1796,3847,14851
1.669,6,38,8254,19,321,92,1164,2718,19,433,80,1360,5536
3.5,6,2,88,2,0,0,0,88,0,0,0,0,0
1787.494,6,102,8296,68,65,26679,65,4930,34,59,54161,59,3366
56.898,6,48,10485,24,723,770,1360,4692,24,370,2466,1360,5793
252.388,2,3,96,3,8,126194,8,96,0,0,0,0,0
1787.905,6,362,22898,210,69,8554,69,12678,152,69,11840,69,10220
339.569,6,33,2207,16,332,22637,332,1244,17,83,21222,83,963
297.98,1,4,224,4,28,99326,28,224,0,0,0,0,0
1792.198,6,365,22949,209,69,8616,69,12569,156,69,11562,69,10380
1771.81,6,99,9306,66,66,27258,66,5610,33,60,55365,60,3696
23.937,6,9,520,3,0,11968,0,160,6,0,3270,0,360
6.0,6,41,7349,21,218,300,314,3463,20,513,302,1179,3886
0.0,17,3,1248,3,388,0,415,1248,0,0,0,0,0
1.389,6,50,19422,27,901,53,1460,13726,23,476,54,2615,5696
1740.487,17,29,19517,29,645,62160,645,19517,0,0,0,0,0
2.963,17,29,13805,13,517,246,1350,7086,16,391,172,1350,6719
291.289,1,4,326,4,53,97096,78,326,0,0,0,0,0
629.147,17,6,2051,6,313,125829,322,2051,0,0,0,0,0
1789.638,17,142,11360,71,48,25565,48,5396,71,56,25565,56,5964
0.468,6,24,6076,12,181,42,537,1526,12,781,38,2224,4550
10.04,17,4,328,2,46,10030,46,148,2,62,10028,62,180
1772.255,6,180,15480,120,69,14892,69,8940,60,69,30036,69,6540
4.934,17,4,288,2,36,4902,36,128,2,52,4902,52,160
101.102,6,37,25858,18,746,40,1360,3738,19,1642,5609,4725,22120
1681.402,17,14,3843,7,30,280232,30,406,7,463,280231,463,3437
25.81,6,9,527,5,43,6452,43,311,4,0,8578,0,216
178.02,6,15,5852,4,112,59340,112,280,11,639,17786,1460,5572
1.435,6,24,8004,12,164,112,267,1288,12,1014,112,2411,6716
10.388,17,4,352,2,48,10380,48,152,2,72,10379,72,200
0.269,17,2,304,1,60,0,60,88,1,188,0,188,216
0.061,17,2,214,1,39,0,39,67,1,119,0,119,147
1752.044,6,197,19793,103,87,17176,721,9668,94,171,18835,1414,10125
1799.989,1,123,6888,123,28,14754,28,6888,0,0,0,0,0
2.22,17,13,6976,7,613,370,1350,4492,6,386,389,1350,2484
1681.398,17,14,3815,7,30,280231,30,406,7,459,280231,463,3409
63.2,6,232,160454,118,690,538,1448,16507,114,1394,558,7240,143947
1673.69,1,8,448,8,28,239098,28,448,0,0,0,0,0
1795.129,17,398,49532,187,169,9651,1350,36939,211,31,8547,60,12593
87.105,6,840,415375,465,830,187,1152,395584,375,398,232,1152,19791
1550.351,1,24,1344,24,28,67406,28,1344,0,0,0,0,0
300.909,6,39,9679,21,547,15045,1360,4157,18,435,508,2720,5522
0.52,17,3,451,2,39,469,39,134,1,289,0,289,317
133.228,6,67,46054,44,1155,3098,1408,38123,23,961,2801,3847,7931
50.234,17,4,352,2,60,50233,60,176,2,60,50233,60,176
300.584,6,143,161942,86,198,3536,253,6054,57,2831,5367,12618,155888
7.663,17,6,456,6,48,1532,48,456,0,0,0,0,0
156.387,6,195,31437,107,304,1475,304,22108,88,83,1794,83,9329
0.129,17,2,672,2,308,129,308,672,0,0,0,0,0
2.944,17,2,778,2,361,2944,361,778,0,0,0,0,0
161.155,1,12,1248,0,0,0,0,0,12,76,14650,76,1248
0.261,6,22,5040,11,137,26,267,1132,11,577,25,1400,3908
280.161,6,27,7312,13,158,23346,267,1317,14,775,21550,3445,5995
0.56,17,4,368,2,32,428,32,120,2,96,381,96,248
1680.718,1,15,840,15,28,120051,28,840,0,0,0,0,0
1798.973,17,449,39928,404,35,4463,288,25708,45,288,40020,288,14220
4.738,17,5,320,5,36,1184,36,320,0,0,0,0,0
54.021,6,49,14403,20,232,2833,721,2198,29,525,1922,1420,12205
0.38,6,27,8920,13,227,31,547,1592,14,941,26,1448,7328
30.833,17,16,1216,16,48,2055,48,1216,0,0,0,0,0
0.312,6,25,8938,13,247,26,624,1672,12,1105,26,2816,7266
280.171,6,28,7352,13,158,23347,267,1317,15,678,20010,3436,6035
5.038,6,43,7429,22,201,239,314,3503,21,440,239,1152,3926
280.229,6,29,7392,13,158,23352,267,1317,16,603,18679,2036,6075
1.724,17,23,7960,9,272,215,1350,2705,14,347,121,1350,5255
16.883,6,1194,1018316,717,1368,23,1380,991982,477,421,35,1923,26334
182.295,6,46,19618,25,548,262,1194,5514,21,1019,9105,3151,14104
1797.091,17,448,39896,403,35,4470,288,25676,45,288,40015,288,14220
1750.211,6,95,7234,62,38,28691,205,4424,33,33,54683,98,2810
98.382,17,21,8148,21,360,4919,360,8148,0,0,0,0,0
6.058,6,390,348033,202,1041,30,1360,29579,188,1807,31,12240,318454
1.037,1,5,420,5,56,259,56,420,0,0,0,0,0
0.291,17,2,212,1,46,0,46,74,1,110,0,110,138
0.441,6,26,7256,12,155,40,267,1261,14,775,29,2760,5995
1795.819,1,58,4872,0,0,0,0,0,58,56,31505,56,4872
1742.942,1,57,4788,57,56,31123,56,4788,0,0,0,0,0
8.229,6,39,8312,20,241,433,619,1798,19,441,445,1460,6514
198.092,17,4,288,2,36,198091,36,128,2,52,198092,52,160
1780.761,17,142,11360,71,48,25439,48,5396,71,56,25439,56,5964
225.596,17,4,240,2,32,225595,32,120,2,32,225595,32,120
280.072,6,30,7432,13,158,23339,267,1317,17,543,17499,1400,6115
57.502,2,2,64,2,8,57502,8,64,0,0,0,0,0
300.172,6,48,14620,25,864,12500,1360,8836,23,346,13636,1360,5784
401.392,17,10,880,5,48,100346,48,380,5,72,100345,72,500
279.5,17,4,288,2,36,279468,36,128,2,52,279469,52,160
563.241,1,6,336,6,28,112648,28,336,0,0,0,0,0
0.992,17,2,144,1,36,0,36,64,1,52,0,52,80
3.621,17,5,340,5,40,905,40,340,0,0,0,0,0
1795.968,17,449,39928,404,35,4456,288,25708,45,288,40018,288,14220
17.693,17,32,15709,16,710,1177,1350,11810,16,215,1177,1350,3899
0.059,17,2,218,1,65,0,65,93,1,97,0,97,125
1800.0,6,224,19280,83,76,21585,318,8615,141,69,12857,1062,10665
0.005,6,2,84,1,0,0,0,44,1,0,0,0,40
240.232,6,53,17643,28,784,8897,1408,14795,25,192,10009,580,2848
17.012,17,26,6578,11,239,1698,1350,2942,15,214,1212,1350,3636
33.551,6,147,133859,52,143,657,351,3133,95,1397,356,1418,130726
0.873,6,11,1727,7,100,145,100,384,4,589,206,1152,1343
0.582,6,16,1825,8,288,59,288,640,8,284,59,434,1185
0.852,6,10,1687,7,100,142,100,384,3,1179,303,1179,1303
8.09,6,19,6917,6,138,1618,267,803,13,620,672,1452,6114
1789.971,6,359,22709,209,69,8605,69,12569,150,69,12010,69,10140
1682.082,17,14,1036,7,30,280340,30,406,7,62,280341,62,630
1793.105,17,83,3480,82,14,22137,14,3444,1,8,0,8,36
23.212,6,36,8216,17,188,1450,722,2003,19,605,1277,1380,6213
1775.524,6,206,23881,132,89,13553,981,11118,74,139,24318,3457,12763
0.819,6,20,5952,11,282,81,548,1292,9,716,92,1420,4660
196.955,17,4,352,2,60,196954,60,176,2,60,196954,60,176
0.251,6,9,1338,5,145,62,145,349,4,825,59,825,989
167.226,6,23,6177,9,272,135,516,1180,14,403,12856,1452,4997
1.38,6,39,8294,19,321,76,1164,2718,20,433,63,1460,5576
0.277,6,20,7229,12,334,24,663,1969,8,1209,38,1906,5260
1.386,6,49,19170,27,885,53,1440,13514,22,433,57,1440,5656
407.888,17,8,5336,8,639,58269,1451,5336,0,0,0,0,0
0.306,6,29,9183,14,252,23,647,1768,15,945,21,1408,7415
0.26,17,2,152,1,48,0,48,76,1,48,0,48,76
11.886,6,1872,1641604,1140,1386,10,1420,1608103,732,467,16,1883,33501
1.349,6,40,10514,21,513,67,1360,4978,19,476,64,2715,5536
2.763,17,4,518,3,39,616,39,201,1,289,0,289,317
1787.202,6,102,8364,68,66,26674,66,4964,34,60,54152,60,3400
1787.229,6,106,8446,69,64,26282,64,4936,37,58,49641,58,3510
1781.37,17,142,11360,71,48,25448,48,5396,71,56,25448,56,5964
0.938,17,22,10405,8,494,134,1350,4183,14,416,65,1350,6222
7.83,17,4,352,2,48,7820,48,152,2,72,7819,72,200
4.0,17,6,594,3,39,1999,39,201,3,103,1999,103,393
1792.543,17,142,11360,71,48,25606,48,5396,71,56,25606,56,5964
0.081,6,10,766,5,185,19,185,453,5,45,20,45,313
1.392,6,47,18537,27,846,53,1360,12961,20,476,63,2715,5576
1789.842,6,269,26754,112,67,16123,659,10004,157,123,11472,1938,16750
0.646,6,22,7272,13,319,53,602,1960,9,1209,76,1946,5312
1787.307,6,152,24979,91,483,19858,483,19234,61,83,29787,83,5745
252.265,6,29,8832,13,158,21022,267,1317,16,763,16814,1781,7515
0.913,17,2,122,2,33,913,33,122,0,0,0,0,0
1.653,6,14,2351,8,188,236,245,700,6,703,281,1152,1651
1760.121,6,145,8974,76,27,23467,27,4669,69,27,25883,27,4305
0.25,17,2,384,1,39,0,39,67,1,289,0,289,317
1771.424,6,101,9344,66,65,27252,65,5577,35,59,52097,59,3767
9.34,6,19,7687,9,154,1167,267,832,10,1074,1002,4837,6855
1796.247,17,449,39928,404,35,4457,288,25708,45,288,40024,288,14220
1742.728,6,131,8242,74,47,23872,208,5032,57,31,31116,31,3210
0.496,6,12,1653,6,288,97,288,548,6,426,59,434,1105
1798.432,17,449,39928,404,35,4462,288,25708,45,288,40023,288,14220
0.016,17,2,180,1,30,0,30,58,1,94,0,94,122
432.04,17,13,4433,13,313,36003,376,4433,0,0,0,0,0
5.839,6,42,7389,22,218,278,314,3503,20,440,293,1152,3886
3.195,17,2,136,1,32,0,32,60,1,48,0,48,76
443.178,1,3,180,3,32,221589,32,180,0,0,0,0,0
209.157,17,4,352,2,60,209156,60,176,2,60,209156,60,176
1259.484,2,9,288,9,8,157435,8,288,0,0,0,0,0
0.047,17,2,154,1,33,0,33,61,1,65,0,65,93
78.906,6,17,2349,10,324,8767,585,1177,7,396,13126,580,1172
296.082,6,40,8874,18,326,17414,517,2261,22,779,14097,1418,6613
31.625,6,7,308,1,0,0,0,44,6,0,6307,0,264
1797.902,6,371,27404,216,117,8362,1189,16245,155,74,11673,405,11159
368.477,6,25,1651,17,177,23029,177,1117,8,110,9211,110,534
3.22,6,20,6317,9,268,397,517,1281,11,744,317,1418,5036
45.073,6,28,7352,13,158,3756,267,1317,15,603,3215,2076,6035
171.502,6,33,6397,17,286,10718,1314,2405,16,334,11433,1420,3992
0.939,6,11,1727,7,100,156,100,384,4,589,225,1152,1343
4.977,6,822,693001,497,1357,10,1380,675759,325,421,15,1923,17242
13.121,6,29,5303,14,183,1009,314,2214,15,497,919,1179,3089
1772.922,6,180,15480,120,69,14898,69,8940,60,69,30044,69,6540
0.519,17,2,476,1,39,0,39,67,1,381,0,381,409
11.139,6,977,889965,619,1358,17,1368,862373,358,776,30,1473,27592
99.233,6,21,8247,11,514,80,1237,2016,10,969,11007,1791,6231
0.008,17,2,456,2,200,8,353,456,0,0,0,0,0
0.001,17,2,550,2,247,1,247,550,0,0,0,0,0
273.383,6,6,364,4,31,91127,31,222,2,31,273373,31,142
1788.369,6,366,23265,211,69,8516,69,12718,155,69,11612,69,10547
3.72,6,10,1102,6,483,744,483,803,4,83,1232,83,299
1681.709,17,14,1036,7,30,280279,30,406,7,62,280281,62,630
240.343,6,41,8828,20,522,12649,1408,5754,21,219,12016,638,3074
10.77,6,2133,1988318,1333,1412,7,1448,1942054,800,776,13,1448,46264
1683.192,1,15,870,15,30,120228,30,870,0,0,0,0,0
0.006,6,5,248,4,0,0,0,208,1,0,0,0,40
0.006,17,2,394,1,32,0,32,60,1,306,0,306,334
0.025,17,4,284,2,32,21,32,120,2,54,22,60,164
0.033,1,2,112,2,28,33,28,112,0,0,0,0,0
1740.935,6,87,6322,58,31,30542,31,3915,29,31,62175,31,2407
1572.699,1,16,896,16,28,104846,28,896,0,0,0,0,0
280.032,6,31,7472,15,158,20002,267,1397,16,603,18666,2800,6075
1795.706,17,447,39864,402,35,4478,288,25644,45,288,40019,288,14220
280.181,6,26,7272,13,158,23348,267,1317,13,905,23345,4845,5955
1782.131,17,73,3060,72,14,25100,14,3024,1,8,0,8,36
1792.713,17,178,11392,178,36,10128,36,11392,0,0,0,0,0
296.855,6,42,4772,17,180,18552,595,1972,25,124,12368,580,2800
92.049,6,123,95140,79,1259,1180,1368,84728,44,737,2135,2519,10412
1794.896,6,4718,3895396,2144,134,837,362,127668,2574,1452,697,2816,3767728
36.977,17,44,6468,22,48,1759,48,1672,22,190,1759,308,4796
1751.723,6,180,11083,91,48,19463,208,6624,89,31,19903,31,4459
0.049,6,2,251,1,159,0,159,211,1,0,0,0,40
1740.489,17,30,31680,30,1028,60016,1028,31680,0,0,0,0,0
56.703,17,4,352,2,48,56694,48,152,2,72,56694,72,200
158.923,6,23,9977,12,523,53,1360,2605,11,1384,15879,3934,7372
0.005,1,2,112,2,28,5,28,112,0,0,0,0,0
0.141,6,6,374,3,31,70,31,187,3,31,40,31,187
1401.281,17,12,888,6,30,280249,30,348,6,62,280249,62,540
1775.096,6,180,15480,120,69,14916,69,8940,60,69,30078,69,6540
3.465,17,29,11905,11,400,346,1350,4716,18,371,192,1350,7189
0.239,17,4,588,2,48,197,48,152,2,190,200,308,436
1794.204,17,144,11520,72,48,25270,48,5472,72,56,25270,56,6048
0.351,17,2,144,1,36,0,36,64,1,52,0,52,80
58.905,6,19,5814,10,267,6545,501,1205,9,707,7351,1420,4609
1783.396,6,104,8376,68,65,26617,65,4930,36,59,50951,59,3446
4.793,6,37,7189,19,218,266,314,3383,18,513,266,1179,3806
1796.162,17,449,39928,404,35,4456,288,25708,45,288,40020,288,14220
61.741,6,62,37362,36,1140,1764,1448,29256,26,843,2459,2359,8106
0.725,6,29,6149,15,154,51,267,1684,14,650,50,1420,4465
372.38,6,97,13906,43,158,8866,1189,4730,54,233,7022,1420,9176
3.804,6,11,4063,6,517,760,517,837,5,986,164,1418,3226
1766.942,1,8,448,8,28,252420,28,448,0,0,0,0,0
0.592,6,28,7336,13,155,49,267,1301,15,543,39,1400,6035
0.009,17,4,724,2,32,4,32,120,2,274,4,274,604
101.368,6,74,28416,37,938,2815,1440,17564,37,514,2747,1440,10852
190.898,6,9,981,9,69,23862,69,981,0,0,0,0,0
0.108,6,3,144,0,0,0,0,0,3,0,0,0,144
91.697,6,40,26154,18,840,42,1460,5807,22,1297,4359,1460,20347
53.713,6,10,648,10,31,5968,31,648,0,0,0,0,0
1.473,6,50,19687,27,919,56,1360,13991,23,433,58,1360,5696
354.907,17,14,2176,7,48,59150,48,532,7,206,59149,308,1644
1777.469,17,142,11360,71,48,25391,48,5396,71,56,25391,56,5964
1796.407,17,142,11360,71,48,25662,48,5396,71,56,25662,56,5964
28.201,6,5,293,4,31,9400,31,222,1,31,0,31,71
1704.008,1,8,448,8,28,243429,28,448,0,0,0,0,0
164.025,17,4,240,2,32,164024,32,120,2,32,164024,32,120
1.853,6,34,10766,17,386,115,1305,3049,17,701,104,1360,7717
69.942,6,10,412,5,0,17485,0,204,5,0,16158,0,208
2.838,6,2,80,1,0,0,0,40,1,0,0,0,40
19.977,6,42,18912,25,579,832,928,6251,17,997,1228,4416,12661
96.066,6,50,18976,25,389,4002,1360,3869,25,938,3996,1360,15107
7.967,6,29,7190,12,147,724,267,1224,17,479,496,1420,5966
196.092,17,4,240,2,32,196090,32,120,2,32,196090,32,120
381.689,6,24,1575,15,177,27263,177,989,9,110,9130,110,586
1682.76,17,14,1036,7,30,280450,30,406,7,62,280453,62,630
10.536,6,90,25738,46,544,234,1152,19821,44,415,239,1152,5917
1.187,6,23,7952,12,164,93,267,1288,11,1216,102,3819,6664
11.065,6,22,4486,12,275,1005,275,1038,10,758,694,1420,3448
30.752,6,18,3756,8,854,4391,1452,2886,10,231,3415,231,870
1758.65,6,4251,3946416,1556,152,1130,965,95153,2695,1414,652,3190,3851263
10.1,6,79,24381,39,550,265,1152,18640,40,459,251,1179,5741
41.643,17,16,1216,16,48,2776,48,1216,0,0,0,0,0
4.992,17,4,558,2,36,4976,36,128,2,187,4982,187,430
0.481,6,49,19738,27,962,18,1380,14616,22,421,20,1923,5122
61.819,6,76,51569,46,1201,1373,1408,43275,30,747,2123,1408,8294
1.486,6,34,12203,16,219,99,705,2182,18,1005,85,1438,10021
338.557,6,9,468,9,0,0,0,468,0,0,0,0,0
240.227,6,54,18095,29,804,8579,1418,15200,25,198,10008,580,2895
1361.614,1,14,784,14,28,104739,28,784,0,0,0,0,0
0.435,6,12,1653,6,288,86,288,548,6,426,47,434,1105
0.003,17,3,1007,1,137,0,137,165,2,393,3,393,842
1786.807,6,102,8228,68,64,26668,64,4896,34,58,54143,58,3332
1780.712,17,142,11360,71,48,25438,48,5396,71,56,25438,56,5964
1771.589,6,109,10103,69,65,26052,65,5875,40,59,45416,59,4228
1755.824,6,3647,3608042,1156,150,1520,958,67693,2491,1411,705,2836,3540349
0.384,17,7,2438,7,320,64,354,2438,0,0,0,0,0
1680.465,1,15,840,15,28,120033,28,840,0,0,0,0,0
105.413,17,4,352,2,60,105412,60,176,2,60,105412,60,176
0.696,17,8,2758,8,316,99,355,2758,0,0,0,0,0
203.568,17,14,4704,14,308,15659,308,4704,0,0,0,0,0
39.039,1,45,4680,0,0,0,0,0,45,76,887,76,4680
1790.48,1,206,11536,206,28,8734,28,11536,0,0,0,0,0
31.403,1,4,424,4,78,10467,78,424,0,0,0,0,0
2.418,17,3,1176,3,364,1209,364,1176,0,0,0,0,0
5.35,6,41,7365,21,201,267,314,3463,20,516,268,1179,3902
970.923,6,90,9805,46,84,18692,722,4263,44,101,22575,1408,5542
1797.255,17,29,9512,29,300,64187,300,9512,0,0,0,0,0
1.687,17,23,8149,11,451,168,1350,5274,12,211,132,1350,2875
1775.827,17,140,11200,70,48,25736,48,5320,70,56,25736,56,5880
1681.546,17,14,1036,7,30,280255,30,406,7,62,280254,62,630
1.932,17,4,240,2,32,1931,32,120,2,32,1931,32,120
0.027,6,13,3980,7,88,4,88,388,6,1670,5,1880,3592
100.939,6,22,8264,11,549,85,1309,2120,11,813,10076,1460,6144
240.371,6,46,9272,24,523,10450,1408,5965,22,239,11446,618,3307
0.939,17,2,685,1,308,0,308,336,1,321,0,321,349
132.021,6,21,8279,11,525,101,1237,2048,10,969,14646,1791,6231
354.898,17,14,2176,7,48,59148,48,532,7,206,59148,308,1644
0.514,17,3,543,2,39,101,39,134,1,381,0,381,409
4.451,17,31,14172,14,681,342,1350,9937,17,221,200,1350,4235
1.403,6,1154,1214630,739,206,1,230,41707,415,2787,3,18304,1172923
11.548,6,24,9480,13,275,962,275,1078,11,1325,916,1440,8402
4.453,17,25,11377,11,349,445,1350,4149,14,488,236,1350,7228
1615.981,17,163,21566,163,104,9975,346,21566,0,0,0,0,0
7.655,6,16,1549,8,222,1091,222,990,8,231,1091,231,559
1783.812,6,480,27613,269,69,6656,69,14969,211,34,8494,64,12644
13.186,6,840,730468,483,1429,26,1448,705608,357,776,35,1448,24860
1772.131,6,180,15480,120,69,14891,69,8940,60,69,30033,69,6540
25.705,6,19,1389,10,182,2856,182,726,9,77,1830,134,663
0.011,17,2,519,1,40,0,40,68,1,423,0,423,451
181.672,6,30,7432,13,158,15139,267,1317,17,543,11350,1400,6115
1624.325,2,14,448,14,8,124948,8,448,0,0,0,0,0
300.275,6,42,26780,26,1153,12011,1440,20972,16,828,1710,1440,5808
240.296,6,42,8797,21,524,12014,1418,5818,21,234,12014,618,2979
5.452,6,511,448296,321,1332,16,1368,433740,190,931,27,2736,14556
3.17,2,2,64,2,8,3170,8,64,0,0,0,0,0
368.285,6,18,1242,14,180,28329,180,916,4,110,20068,110,326
0.785,17,19,10653,10,795,84,1350,8232,9,241,90,1350,2421
6.622,6,65,20566,34,559,200,1152,15899,31,489,212,1179,4667
180.041,6,24,10402,12,397,69,884,1717,12,1024,16355,2720,8685
1794.377,17,281,58812,281,181,6408,422,58812,0,0,0,0,0
0.369,17,4,350,2,34,361,34,124,2,85,359,91,226
3.008,17,4,332,2,47,3001,47,150,2,63,3000,63,182
1787.981,1,272,15232,272,28,6597,28,15232,0,0,0,0,0
1767.767,1,59,4956,59,56,30478,56,4956,0,0,0,0,0
61.779,6,65,44163,41,1173,1544,1448,36163,24,843,2676,2359,8000
379.815,6,18,1242,14,180,29216,180,916,4,110,20062,110,326
1769.2,6,114,9554,72,58,24918,205,5779,42,39,43139,98,3775
1787.51,6,104,8376,68,65,26679,65,4930,36,59,51067,59,3446
1746.96,6,95,7203,63,38,28176,205,4476,32,33,56344,98,2727
1798.049,6,133,8300,74,43,24630,208,4793,59,31,30997,31,3507
280.299,17,4,296,2,30,280268,30,116,2,62,280286,62,180
241.089,6,46,5724,24,247,10481,834,3025,22,154,11480,544,2699
1.334,6,54,21451,31,901,44,1360,15710,23,437,52,2715,5741
1684.508,2,19,608,19,8,93583,8,608,0,0,0,0,0
172.02,17,2,84,2,14,172020,14,84,0,0,0,0,0
280.283,6,28,7352,13,158,23356,267,1317,15,678,20015,2045,6035
1.343,6,50,18711,27,850,51,1360,13015,23,433,52,1360,5696
0.074,17,2,776,2,360,74,360,776,0,0,0,0,0
0.278,6,21,7302,12,335,24,668,1986,9,968,33,1475,5316
74.086,6,23,9076,11,378,66,799,1606,12,872,6723,1460,7470
1788.49,17,140,11200,70,48,25920,48,5320,70,56,25920,56,5880
7.54,6,1154,1034620,735,1361,10,1420,1013521,419,427,18,1420,21099
0.01,17,3,474,2,36,1,36,128,1,318,0,318,346
1772.751,6,240,17880,120,69,14897,69,8940,120,34,14896,64,8940
569.98,1,6,336,6,28,113996,28,336,0,0,0,0,0
1798.462,1,342,28728,342,56,5274,56,28728,0,0,0,0,0
1795.21,6,369,29147,214,133,8428,1189,17354,155,78,11657,256,11793
1779.16,17,140,11200,70,48,25784,48,5320,70,56,25784,56,5880
32.92,6,26,7074,9,130,4115,267,1020,17,536,2029,3457,6054
1746.151,6,97,7307,63,38,28163,205,4476,34,33,52904,98,2831
0.57,17,4,588,2,48,562,48,152,2,190,561,308,436
120.329,2,3,96,3,8,60164,8,96,0,0,0,0,0
0.247,17,2,213,1,44,0,44,72,1,113,0,113,141
1764.671,2,17,544,17,8,110291,8,544,0,0,0,0,0
1761.084,6,127,7765,69,27,25897,27,4161,58,27,30895,27,3604
915.97,6,208,43723,88,382,10528,1360,26950,120,140,7695,4649,16773
0.45,6,21,7217,13,318,37,599,1957,8,1209,63,1906,5260
236.335,6,44,7282,23,193,10741,517,2297,21,459,11813,1611,4985
2.092,6,2,92,1,0,0,0,40,1,0,0,0,52
1771.294,6,128,11695,79,65,22708,65,6621,49,59,36896,59,5074
1.681,17,2,784,2,364,1681,364,784,0,0,0,0,0
0.105,6,11,1971,6,451,20,500,1222,5,481,26,481,749
1049.141,6,128,9558,48,64,22318,292,4437,80,48,13280,78,5121
0.219,17,2,152,1,48,0,48,76,1,48,0,48,76
0.117,17,4,284,2,32,84,32,120,2,54,34,60,164
0.407,6,49,20961,27,1051,15,1380,15839,22,421,17,1923,5122
0.388,6,10,968,5,256,95,256,460,5,304,95,304,508
1786.813,6,107,9936,70,98,25895,1249,6259,37,62,49630,191,3677
268.771,1,4,224,4,28,89590,28,224,0,0,0,0,0
252.347,6,12,854,2,66,92,66,146,10,34,28028,60,708
0.021,17,2,142,1,35,0,35,63,1,51,0,51,79
1796.447,17,449,39928,404,35,4457,288,25708,45,288,40019,288,14220
15.822,17,18,7707,8,484,2254,1350,4103,10,332,1753,1350,3604
2.483,6,29,6175,15,338,177,1314,2294,14,368,189,1414,3881
0.651,6,22,5833,12,164,59,453,1442,10,551,62,1448,4391
1740.461,17,30,31680,30,1028,60015,1028,31680,0,0,0,0,0
0.174,6,9,1343,5,145,43,145,349,4,830,35,830,994
0.749,17,4,288,2,36,716,36,128,2,52,703,52,160
1772.522,6,180,15480,120,69,14895,69,8940,60,69,30038,69,6540
1793.629,17,87,3648,86,14,21101,14,3612,1,8,0,8,36
0.619,6,24,6239,13,268,51,679,1865,11,786,61,1420,4374
1794.092,6,356,22520,208,69,8667,69,12460,148,69,12202,69,10060
76.533,6,29,7539,11,156,38,267,1232,18,429,4501,3426,6307
154.997,6,31,6682,11,220,5568,516,1325,20,325,8153,1452,5357
1772.714,6,200,13888,72,46,24951,46,5824,128,46,13958,46,8064
23.08,17,4,352,2,48,23072,48,152,2,72,23070,72,200
371.425,6,25,1651,17,177,23214,177,1117,8,110,9216,110,534
0.327,6,28,9111,14,252,25,647,1744,14,945,24,1408,7367
240.238,6,57,18522,29,773,8579,1418,15434,28,203,8897,580,3088
599.562,6,11,657,7,31,99927,31,373,4,31,199806,31,284
0.028,17,2,263,1,36,0,36,64,1,171,0,171,199
112.616,6,75,50031,46,1192,2502,1408,41789,29,840,2201,2439,8242
1682.763,17,14,1036,7,30,280449,30,406,7,62,280452,62,630
1743.589,1,73,6132,0,0,0,0,0,73,56,24216,56,6132
1.345,6,38,8266,19,321,74,1164,2730,19,433,64,1360,5536
1741.463,6,87,6322,58,31,30551,31,3915,29,31,62194,31,2407
1772.096,6,180,15480,120,69,14891,69,8940,60,69,30031,69,6540
1682.773,17,14,1036,7,30,280454,30,406,7,62,280456,62,630
27.183,17,16,1408,8,48,3874,48,608,8,72,3869,72,800
1778.813,6,108,8724,70,66,25779,66,5044,38,60,48073,60,3680
50.474,6,13,1844,4,321,16824,722,1160,9,51,6278,51,684
1776.189,17,140,11200,70,48,25741,48,5320,70,56,25741,56,5880
1744.689,2,24,768,24,8,75856,8,768,0,0,0,0,0
0.017,17,4,420,2,33,9,33,122,2,121,10,145,298
1555.576,1,24,1344,24,28,67633,28,1344,0,0,0,0,0
1794.449,6,225,17750,86,75,21109,337,8689,139,50,13002,143,9061
0.063,6,10,766,5,185,14,185,453,5,45,15,45,313
1754.027,6,262,26887,133,145,13288,416,20642,129,31,13469,31,6245
1787.158,6,102,8364,68,66,26674,66,4964,34,60,54153,60,3400
7.554,2,2,64,2,8,7554,8,64,0,0,0,0,0
0.769,1,2,112,2,28,769,28,112,0,0,0,0,0
0.073,6,12,3656,6,124,13,124,444,6,964,11,1448,3212
1741.282,6,88,6405,59,31,30022,31,3998,29,31,62185,31,2407
1786.571,6,102,8364,68,66,26665,66,4964,34,60,54135,60,3400
9.642,6,84,24549,43,549,229,1152,18768,41,459,234,1179,5781
1760.521,1,170,9520,170,28,10417,28,9520,0,0,0,0,0
440.773,17,27,9072,27,308,16952,308,9072,0,0,0,0,0
8.422,17,4,352,2,60,8421,60,176,2,60,8421,60,176
0.251,6,11,911,6,181,50,181,489,5,77,46,133,422
1.468,6,3,120,1,0,0,0,40,2,0,1336,0,80
0.136,17,3,1170,3,362,68,362,1170,0,0,0,0,0
1282.063,6,84,6864,50,66,26164,66,3584,34,60,36321,60,3280
0.351,17,2,136,1,32,0,32,60,1,48,0,48,76
232.989,17,2,386,2,165,232989,165,386,0,0,0,0,0
476.845,6,33,2542,19,64,26373,64,1336,14,49,36674,58,1206
1744.7,2,28,896,28,8,64618,8,896,0,0,0,0,0
854.032,6,10,1390,10,110,94892,110,1390,0,0,0,0,0
3.071,17,4,240,2,32,3069,32,120,2,32,3070,32,120
0.068,17,2,180,1,30,0,30,58,1,94,0,94,122
168.102,17,4,558,2,36,168097,36,128,2,187,168097,187,430
85.479,6,98,69240,59,1272,1473,1448,59054,39,679,2243,1448,10186
0.611,6,12,1653,6,288,118,288,548,6,426,66,434,1105
1790.042,6,317,82166,188,716,9572,722,55686,129,159,13984,316,26480
1.716,6,29,7380,13,155,143,267,1301,16,543,110,1400,6079
1.164,6,12,3671,6,125,230,125,445,6,968,228,1448,3226
17.407,17,25,6187,10,260,1930,1350,2889,15,191,1241,1350,3298
8.615,17,6,528,3,48,4298,48,228,3,72,4300,72,300
1797.908,17,447,39296,403,35,4472,288,25392,44,288,40948,288,13904
184.382,1,4,224,4,28,61460,28,224,0,0,0,0,0
1798.234,17,449,39416,404,34,4462,288,25444,45,282,40014,288,13972
1079.158,2,12,384,12,8,98105,8,384,0,0,0,0,0
8.129,6,17,4130,9,275,1016,275,918,8,1440,1087,1440,3212
2.88,6,12,1636,6,503,576,503,835,6,473,576,473,801
0.143,6,9,1340,5,145,35,145,349,4,827,42,827,991
4.034,17,6,5701,2,723,4034,1350,1503,4,1021,754,1350,4198
1752.806,6,95,7203,63,38,28271,205,4476,32,33,56530,98,2727
106.425,17,8,2688,8,308,15203,308,2688,0,0,0,0,0
1744.433,6,95,7203,63,38,28136,205,4476,32,33,56262,98,2727
1259.81,2,8,256,8,8,179972,8,256,0,0,0,0,0
253.17,6,21,10849,7,791,42195,1408,3550,14,813,19464,1408,7299
7.343,6,1663,1415230,928,1434,7,1448,1369122,735,776,9,1448,46108
1781.737,6,118,13894,75,81,24077,501,5950,43,159,42419,1420,7944
16.077,6,61,9208,31,256,534,256,7392,30,304,553,304,1816
300.778,6,67,39019,40,461,7712,1290,4041,27,1525,2645,8266,34978
94.269,6,95,69352,60,1249,1597,1448,59371,35,679,2761,1448,9981
10.824,6,78,22422,39,534,284,1152,17078,39,472,278,1179,5344
1785.954,6,102,8296,68,65,26656,65,4930,34,59,54117,59,3366
24.82,6,1076,945549,658,1422,37,1460,921060,418,187,54,1460,24489
0.082,6,7,423,4,43,12,43,259,3,0,40,0,164
1732.639,1,124,6944,124,28,14086,28,6944,0,0,0,0,0
310.358,6,21,1545,8,31,44313,31,540,13,31,25849,31,1005
1776.968,17,142,11360,71,48,25384,48,5396,71,56,25384,56,5964
299.321,1,4,224,4,28,99773,28,224,0,0,0,0,0
10.868,6,20,4390,11,275,1086,275,998,9,755,766,1414,3392
1797.586,17,448,39896,403,35,4471,288,25676,45,288,40019,288,14220
1.845,6,13,2311,8,188,263,245,700,5,1407,400,1407,1611
1383.733,2,15,480,15,8,98838,8,480,0,0,0,0,0
1743.321,6,94,7151,62,38,28579,205,4424,32,33,56222,98,2727
124.35,1,16,896,0,0,0,0,0,16,28,8290,28,896
842.874,6,45,3270,30,31,29064,31,2025,15,31,60187,31,1245
0.961,6,10,1687,7,100,160,100,384,3,1179,350,1179,1303
9.054,17,5,407,3,47,4525,47,225,2,63,2991,63,182
1281.261,6,80,11187,51,97,20623,498,4384,29,208,45756,1420,6803
20.316,6,20,5365,12,107,1846,159,1074,8,966,2900,1658,4291
1786.133,17,87,3648,86,14,21013,14,3612,1,8,0,8,36
5.006,17,4,542,2,36,5001,36,128,2,179,5002,187,414
1686.422,1,7,392,7,28,281070,28,392,0,0,0,0,0
1.798,17,6,432,3,36,882,36,192,3,52,882,52,240
0.413,6,7,295,4,0,137,0,164,3,7,110,7,131
1.76,6,25,8056,12,164,135,267,1288,13,869,123,1448,6768
1799.421,6,401,27838,226,96,7997,469,16146,175,69,10340,69,11692
1784.603,17,83,3480,82,14,22032,14,3444,1,8,0,8,36
0.007,17,2,475,1,40,0,40,68,1,379,0,379,407
0.014,1,2,552,2,248,14,248,552,0,0,0,0,0
6.103,6,1518,1423717,972,1388,6,1408,1390661,546,931,10,2801,33056
491.791,17,7,2356,7,308,81965,312,2356,0,0,0,0,0
1792.586,1,67,5628,67,56,27160,56,5628,0,0,0,0,0
0.375,6,27,8963,13,237,31,590,1635,14,941,28,1408,7328
1.345,6,42,10032,21,440,67,1360,4416,21,433,57,1360,5616
181.363,6,189,29148,103,304,1778,304,20172,86,83,2124,83,8976
124.181,6,33,7055,17,139,7761,501,1800,16,384,8272,1420,5255
0.662,6,22,7333,13,334,55,663,2021,9,1209,77,1946,5312
1740.694,6,114,8242,70,31,25227,31,4797,44,31,40480,31,3445
1773.434,6,180,15480,120,69,14902,69,8940,60,69,30049,69,6540
1800.0,6,224,19595,83,80,21585,376,8840,141,70,12857,1062,10755
0.436,6,10,968,5,256,107,256,460,5,304,107,304,508
0.0,17,1,1444,1,1416,0,1416,1444,0,0,0,0,0
0.169,6,3,175,2,31,28,31,135,1,0,0,0,40
7.982,6,15,1362,8,275,1140,275,878,7,96,995,96,484
1777.156,1,62,5208,0,0,0,0,0,62,56,29133,56,5208
1789.162,6,78,4108,40,26,45874,26,2106,38,26,48354,26,2002
11.444,6,26,9953,13,275,953,275,1078,13,1042,881,1440,8875
1776.264,17,140,11200,70,48,25742,48,5320,70,56,25742,56,5880
1795.477,6,367,25650,214,99,8429,469,15045,153,69,11809,69,10605
1694.808,17,75,6992,38,33,45804,37,2330,37,98,47077,136,4662
1769.677,1,59,4956,0,0,0,0,0,59,56,30511,56,4956
1786.888,6,458,48415,257,159,6980,1189,23834,201,174,8934,3466,24581
0.087,17,2,1848,2,896,87,1451,1848,0,0,0,0,0
1.239,6,31,6044,16,111,82,267,1539,15,780,78,1460,4505
0.005,17,2,170,1,37,0,37,65,1,77,0,77,105
0.007,17,2,2166,2,1055,7,1055,2166,0,0,0,0,0
0.384,6,10,1992,5,288,90,288,508,5,424,52,434,1484
120.464,17,4,352,2,60,120463,60,176,2,60,120463,60,176
3.883,17,6,519,5,31,970,31,295,1,196,0,196,224
1792.859,1,130,7280,130,28,13898,28,7280,0,0,0,0,0
0.024,6,12,1843,7,138,4,138,510,5,532,5,891,1333
280.459,6,29,7392,13,158,23371,267,1317,16,603,18693,2760,6075
1788.795,1,256,27136,256,78,7014,78,27136,0,0,0,0,0
0.008,6,2,92,1,0,0,0,40,1,0,0,0,52
3.866,17,4,304,4,48,1288,48,304,0,0,0,0,0
1787.277,6,104,8308,68,64,26675,64,4896,36,58,51062,58,3412
257.667,6,37,7247,21,134,12883,516,2056,16,454,12802,1452,5191
1770.36,6,103,9514,66,66,27236,66,5610,37,60,49174,60,3904
1115.838,6,113,9695,74,69,15285,69,5582,39,69,29363,69,4113
1781.77,6,366,25541,213,100,8404,469,14936,153,69,11722,69,10605
0.208,6,19,4311,11,165,20,456,1394,8,498,25,888,2917
8.38,6,84,61755,46,338,184,338,2882,38,1625,225,2736,58873
134.334,17,23,1748,23,48,6106,48,1748,0,0,0,0,0
113.342,6,23,8371,11,525,95,1237,2060,12,831,10287,1360,6311
0.008,17,2,554,1,30,0,30,58,1,468,0,468,496
22.946,6,3357,3179171,2114,1423,10,1448,3106779,1243,776,18,1448,72392
280.268,6,29,7392,12,158,25478,267,1277,17,543,17514,1400,6115
123.906,6,21,8279,11,525,110,1237,2048,10,969,13744,2720,6231
1795.704,17,448,39896,403,35,4466,288,25676,45,288,40016,288,14220
1788.384,17,87,3648,86,14,21039,14,3612,1,8,0,8,36
0.849,6,2,1175,1,0,0,0,40,1,1095,0,1095,1135
0.007,17,2,2200,2,1072,7,1072,2200,0,0,0,0,0
125.841,6,1049,508559,568,833,221,1152,484528,481,435,261,1179,24031
0.066,6,11,913,6,182,13,182,490,5,77,16,134,423
8.052,6,59,36499,33,1203,251,1360,29027,26,1070,314,2260,7472
17.347,17,4,304,4,48,5782,48,304,0,0,0,0,0
1014.606,17,12,5900,12,463,92236,1451,5900,0,0,0,0,0
1796.733,17,448,39896,403,35,4469,288,25676,45,288,40032,288,14220
1105.225,6,245,43480,157,316,7084,316,32540,88,83,12703,83,10940
110.061,6,1058,522798,574,843,192,1152,498647,484,435,227,1179,24151
4.804,6,12,1310,7,182,800,182,554,5,244,1196,476,756
166.263,6,32,8952,14,158,12789,267,1357,18,624,9769,1400,7595
0.295,17,2,255,1,43,0,43,71,1,156,0,156,184
1778.468,17,79,3312,78,14,23096,14,3276,1,8,0,8,36
23.839,6,36,8349,19,175,1324,721,2165,17,687,1477,2840,6184
280.483,6,28,7352,13,158,23373,267,1317,15,678,20031,2085,6035
1741.732,6,87,6322,58,31,30556,31,3915,29,31,62204,31,2407
0.024,17,2,152,1,48,0,48,76,1,48,0,48,76
1701.799,1,8,448,8,28,243114,28,448,0,0,0,0,0
0.913,17,3,1164,3,360,456,360,1164,0,0,0,0,0
8.622,6,35,8416,19,410,479,917,2024,16,521,562,3488,6392
18.916,1,4,224,4,28,6305,28,224,0,0,0,0,0
1.003,17,5,784,3,32,499,32,180,2,274,5,274,604
1.702,6,10,861,6,182,340,182,490,4,77,347,134,371
1785.103,6,106,8456,68,65,26643,65,4930,38,59,48243,59,3526
64.582,1,4,1529,4,354,21527,399,1529,0,0,0,0,0
1800.0,6,211,16465,78,71,22987,332,7871,133,48,13636,78,8594
1.626,6,25,8056,12,164,125,267,1288,13,869,114,1448,6768
29.448,6,13,5929,4,92,9816,92,296,9,1715,3636,2329,5633
0.077,6,12,965,6,182,15,182,490,6,77,14,134,475
280.049,6,26,7272,12,158,25459,267,1277,14,775,21538,4200,5995
7.122,6,17,3623,9,188,890,245,740,8,1279,982,1407,2883
1786.759,6,102,8228,68,64,26668,64,4896,34,58,54141,58,3332
3.818,17,2,170,1,37,0,37,65,1,77,0,77,105
1.871,6,2,87,1,0,0,0,40,1,7,0,7,47
1775.543,17,140,11200,70,48,25732,48,5320,70,56,25732,56,5880
0.872,6,51,13829,24,551,37,1429,4840,27,464,31,1986,8989
0.016,17,2,350,1,37,0,37,65,1,257,0,257,285
0.002,17,8,2750,8,315,0,354,2750,0,0,0,0,0
1763.291,6,27,4077,18,241,103723,241,2889,9,92,220383,92,1188
2.827,17,3,468,3,128,1413,128,468,0,0,0,0,0
12.4,6,862,750185,535,1329,22,1368,728517,327,776,37,2736,21668
8.981,6,14,1247,7,222,1495,222,728,7,231,1495,231,519
280.488,6,29,7392,13,158,23374,267,1317,16,678,18692,3456,6075
1763.849,2,14,448,14,8,135680,8,448,0,0,0,0,0
1780.455,6,102,8296,68,65,26573,65,4930,34,59,53950,59,3366
1785.233,17,87,3648,86,14,21002,14,3612,1,8,0,8,36
6.591,6,15,2522,9,169,823,245,871,6,703,1261,1152,1651
91.865,17,4,240,2,32,91864,32,120,2,32,91864,32,120
304.42,6,7,418,4,106,101473,106,274,3,0,1519,0,144
5.458,6,43,8329,21,227,272,314,4022,22,489,247,1179,4307
1.082,17,4,566,2,31,1070,31,118,2,196,1068,196,448
35.382,6,36,8455,17,410,540,882,1942,19,441,1958,1440,6513
240.189,6,62,18374,30,799,8282,1402,15172,32,170,7747,580,3202
1787.671,6,749,218491,341,812,5257,1418,185941,408,65,4392,580,32550
0.26,1,2,112,2,28,260,28,112,0,0,0,0,0
5.511,6,44,8385,23,227,250,314,4102,21,491,262,1179,4283
280.528,6,29,7392,12,158,25502,267,1277,17,603,17529,2076,6115
88.653,17,4,352,2,60,88651,60,176,2,60,88652,60,176
1.798,6,14,2351,8,188,256,245,700,6,703,308,1152,1651
1777.747,6,275,33453,112,138,16014,1460,16445,163,129,10972,3102,17008
0.005,17,2,442,1,34,0,34,62,1,352,0,352,380
61.319,6,37,15941,22,801,2919,1448,9163,15,665,4360,1448,6778
10.823,6,18,5610,10,275,1202,275,958,8,1440,828,1440,4652
373.579,6,21,1419,15,177,26684,177,989,6,110,15655,110,430
1684.687,2,26,832,26,8,67387,8,832,0,0,0,0,0
0.482,6,24,6040,13,108,40,147,959,11,927,46,2600,5081
29.879,6,37,11578,21,615,1493,1380,5786,16,514,1987,1380,5792
2.063,17,4,1556,4,361,687,361,1556,0,0,0,0,0
1770.498,6,101,9410,66,66,27238,66,5610,35,60,52070,60,3800
0.531,1,10,840,10,56,59,56,840,0,0,0,0,0
370.968,6,18,1242,14,180,28536,180,916,4,110,20059,110,326
966.9,17,74,5904,39,48,25444,48,2964,35,56,25463,56,2940
0.074,17,2,548,2,246,74,246,548,0,0,0,0,0
0.281,17,3,1170,3,362,140,362,1170,0,0,0,0,0
240.628,6,58,20090,31,815,8020,1418,17114,27,194,9254,580,2976
230.999,17,4,352,2,60,230998,60,176,2,60,230997,60,176
1798.962,1,244,13664,244,28,7403,28,13664,0,0,0,0,0
661.701,2,9,288,9,8,82712,8,288,0,0,0,0,0
1.671,6,13,2311,8,188,238,245,700,5,1407,354,1407,1611
252.154,2,3,96,3,8,126077,8,96,0,0,0,0,0
0.013,17,3,612,2,30,2,30,116,1,468,0,468,496
70.423,6,32,7515,14,155,5417,267,1346,18,388,4142,1420,6169
0.052,17,2,136,1,40,0,40,68,1,40,0,40,68
9.213,6,7,1453,4,0,3071,0,160,3,391,3344,391,1293
1.316,6,54,14243,25,549,54,1429,4888,29,430,46,1986,9355
343.476,6,67,10647,25,105,14311,267,2269,42,185,8377,1452,8378
1744.933,6,101,7515,63,38,28144,205,4476,38,33,47150,98,3039
0.034,6,10,1514,5,503,8,503,771,5,475,8,475,743
0.136,6,10,1514,5,503,33,503,771,5,475,34,475,743
1769.743,6,99,9306,66,66,27226,66,5610,33,60,55301,60,3696
1.258,6,49,19696,27,923,48,1360,14040,22,476,51,2715,5656
57.595,6,30,7297,14,155,4430,267,1346,16,441,3839,1420,5951
246.93,6,14,1000,4,173,9,173,389,10,83,27435,83,611
237.133,17,6,360,3,32,118566,32,180,3,32,118566,32,180
1.326,6,37,8214,19,321,73,1164,2718,18,476,67,2720,5496
0.008,6,3,156,2,0,4,0,116,1,0,0,0,40
0.062,6,14,4020,8,88,8,88,428,6,1670,12,1880,3592
1007.701,2,7,224,7,8,167950,8,224,0,0,0,0,0
1.055,6,28,8503,15,225,64,561,1985,13,997,72,1791,6518
0.254,17,2,220,1,34,0,34,62,1,130,0,130,158
2.636,6,4,222,1,31,0,31,71,3,31,1318,31,151
1773.072,6,180,15480,120,69,14899,69,8940,60,69,30051,69,6540
1560.875,2,10,320,10,8,173430,8,320,0,0,0,0,0
60.028,17,4,240,2,32,60027,32,120,2,32,60027,32,120
62.007,6,40,16186,23,800,2818,1408,9273,17,602,3865,1408,6913
1.379,6,48,19257,27,894,53,1360,13641,21,433,60,1360,5616
139.869,17,6,456,6,48,27973,48,456,0,0,0,0,0
155.497,2,4,128,4,8,51832,8,128,0,0,0,0,0
1787.263,17,87,3648,86,14,21026,14,3612,1,8,0,8,36
5.889,6,42,7389,22,218,280,314,3503,20,513,296,1179,3886
34.768,17,20,1760,10,48,3861,48,760,10,72,3861,72,1000
23.386,6,8,440,4,0,7795,0,216,4,0,7780,0,224
1.572,6,27,10182,16,285,104,588,1500,11,1029,141,1420,8682
0.664,17,2,778,2,361,664,361,778,0,0,0,0,0
17.064,6,6,364,4,31,5688,31,222,2,31,17050,31,142
0.474,17,3,238,2,30,436,30,116,1,94,0,94,122
13.993,6,32,8952,14,158,1076,267,1357,18,624,822,1400,7595
1796.259,17,759,45786,759,32,2369,37,45786,0,0,0,0,0
303.827,6,88,16654,45,276,6905,1109,6262,43,353,7233,2348,10392
240.184,6,54,18382,30,823,8282,1402,15574,24,194,10442,580,2808
1799.034,17,448,39896,403,35,4475,288,25676,45,288,40021,288,14220
1683.105,6,26,3945,17,241,105188,241,2849,9,92,210365,92,1096
1795.286,6,240,35580,150,302,12048,302,25920,90,83,20171,83,9660
0.047,6,9,1343,5,145,11,145,349,4,830,12,830,994
1793.448,6,356,22589,208,69,8663,69,12460,148,69,12197,69,10129
0.02,17,4,368,2,32,2,32,120,2,96,0,96,248
1788.471,6,354,22440,206,69,8724,69,12380,148,69,12166,69,10060
60.029,6,16,1138,0,0,0,0,0,16,26,4001,26,1138
131.797,6,33,16068,15,630,56,1440,3165,18,1014,7744,1440,12903
299.905,6,6,364,4,31,99968,31,222,2,31,299682,31,142
1.139,6,56,13906,28,530,42,1301,4868,28,439,41,2186,9038
1789.321,17,142,11360,71,48,25561,48,5396,71,56,25561,56,5964
0.437,17,2,152,1,48,0,48,76,1,48,0,48,76
1776.029,6,182,15698,121,69,14800,69,9049,61,69,29594,69,6649
1684.615,17,16,1265,8,30,240657,37,471,8,71,240655,136,794
1749.411,6,95,7234,62,38,28678,205,4424,33,33,54659,98,2810
0.946,6,9,1647,6,100,189,100,344,3,1179,346,1179,1303
16.899,6,28,4879,13,170,1408,722,1696,15,342,1179,1408,3183
1781.714,1,216,12096,216,28,8287,28,12096,0,0,0,0,0
0.197,6,25,7216,12,155,17,267,1261,13,603,15,1400,5955
97.239,6,11459,10976672,7415,1400,13,1448,10761696,4044,776,24,1448,214976
0.045,17,4,336,2,45,0,45,146,2,67,9,73,190
1785.168,17,87,3648,86,14,21001,14,3612,1,8,0,8,36
1772.435,6,180,15480,120,69,14894,69,8940,60,69,30040,69,6540
1737.072,1,56,4704,56,56,31583,56,4704,0,0,0,0,0
96.396,6,22,9860,11,433,73,990,1771,11,1091,9625,1460,8089
11.281,17,9,10152,9,1100,1410,1451,10152,0,0,0,0,0
1793.968,6,756,51246,378,31,4758,31,25794,378,31,4757,31,25452
5.17,6,5,224,3,0,2585,0,128,2,0,1026,0,96
31.187,17,36,5292,18,48,1833,48,1368,18,190,1833,308,3924
281.839,6,29,7392,13,158,23486,267,1317,16,603,18766,2036,6075
0.135,17,2,304,1,60,0,60,88,1,188,0,188,216
978.678,17,192,14592,192,48,5123,48,14592,0,0,0,0,0
5.518,6,44,8369,22,227,262,314,4062,22,489,250,1179,4307
1797.384,17,449,39928,404,35,4460,288,25708,45,288,40020,288,14220
1738.995,6,87,6322,58,31,30508,31,3915,29,31,62106,31,2407
3.305,6,44,16425,23,559,150,1440,4382,21,746,148,1440,12043
1792.382,6,356,22520,208,69,8658,69,12460,148,69,12192,69,10060
1792.515,6,208,26730,113,304,16004,304,18176,95,83,19069,83,8554
28.177,6,40,8474,21,175,1408,721,2253,19,778,1555,1440,6221
1797.648,17,180,14040,180,50,10042,50,14040,0,0,0,0,0
280.039,6,31,7472,14,158,21541,267,1357,17,543,17500,1400,6115
79.011,17,6,8236,6,1344,15802,1348,8236,0,0,0,0,0
504.218,2,3,96,3,8,252109,8,96,0,0,0,0,0
3.365,17,3,1176,3,364,1682,364,1176,0,0,0,0,0
258.552,6,2,80,1,0,0,0,40,1,0,0,0,40
1787.724,6,103,8336,68,65,26682,65,4930,35,59,52577,59,3406
240.351,6,63,18812,32,812,7753,1408,15492,31,188,8011,580,3320
280.482,6,29,7392,13,158,23373,267,1317,16,678,18695,2085,6075
0.038,17,2,586,1,46,0,46,74,1,484,0,484,512
1786.222,17,87,3648,86,14,21014,14,3612,1,8,0,8,36
290.73,6,33,6976,16,262,19379,517,1628,17,744,18167,1418,5348
9.174,6,81,25010,40,568,235,1152,19229,41,459,223,1179,5781
1793.393,17,142,11360,71,48,25619,48,5396,71,56,25619,56,5964
38.841,17,22,1936,11,48,3883,48,836,11,72,3882,72,1100
1089.143,17,209,15884,209,48,5236,48,15884,0,0,0,0,0
1790.239,6,362,24774,211,94,8524,469,14387,151,69,11934,69,10387
6.704,17,23,11144,12,588,606,1350,7400,11,312,666,1350,3744
32.344,17,4,352,2,60,32343,60,176,2,60,32343,60,176
280.436,6,30,7432,13,158,23369,267,1317,17,543,17525,1380,6115
1787.762,6,102,8228,68,64,26683,64,4896,34,58,54172,58,3332
1738.701,6,87,6322,58,31,30503,31,3915,29,31,62096,31,2407
1.397,17,3,1170,3,362,698,362,1170,0,0,0,0,0
1786.578,6,102,8296,68,65,26665,65,4930,34,59,54135,59,3366
1741.4,17,28,6580,28,207,64496,207,6580,0,0,0,0,0
167.168,17,16,1216,16,48,11144,48,1216,0,0,0,0,0
0.406,6,9,871,5,304,101,304,572,4,83,129,83,299
18.252,6,27,5194,18,210,1072,210,1646,9,616,2281,904,3548
289.905,1,4,224,4,28,96635,28,224,0,0,0,0,0
0.021,6,10,2031,6,732,3,1304,1708,4,159,5,159,323
36.924,17,40,5880,20,48,1942,48,1520,20,190,1942,308,4360
16.827,6,2516,2306159,1598,1364,10,1408,2253759,918,931,18,2816,52400
1798.92,17,449,39928,404,35,4463,288,25708,45,288,40018,288,14220
1796.546,17,450,40244,404,35,4457,288,25708,46,288,39129,288,14536
1.535,6,50,19301,27,892,59,1360,13605,23,433,59,1360,5696
0.997,6,28,9543,16,212,66,495,1535,12,1073,73,3926,8008
1.012,6,29,12336,15,525,72,1440,3258,14,850,63,1440,9078
12.418,6,21,6825,12,275,1128,275,1038,9,1353,925,1440,5787
0.353,6,3,168,3,0,0,0,168,0,0,0,0,0
3.197,6,17,1768,9,256,398,256,1136,8,304,455,304,632
19.848,17,12,1056,6,48,3967,48,456,6,72,3967,72,600
0.23,17,2,152,1,48,0,48,76,1,48,0,48,76
1770.302,17,325,54361,325,139,5463,386,54361,0,0,0,0,0
1772.707,6,180,15480,120,69,14896,69,8940,60,69,30039,69,6540
723.313,1,4,224,4,28,241104,28,224,0,0,0,0,0
254.084,6,72,8750,31,151,8469,630,3515,41,133,6351,580,5235
240.281,6,54,17532,29,735,8581,1418,14746,25,184,10011,580,2786
121.255,17,4,352,2,60,121254,60,176,2,60,121254,60,176
1799.956,17,83,3480,82,14,22221,14,3444,1,8,0,8,36
0.008,17,2,322,1,33,0,33,61,1,233,0,233,261
0.007,17,2,442,1,43,0,43,71,1,343,0,343,371
50.58,6,29,8832,14,158,3890,267,1357,15,858,3609,3436,7475
1780.138,17,46,15688,46,313,39558,548,15688,0,0,0,0,0
323.276,6,27,8854,10,170,35919,267,1600,17,505,728,1420,7254
190.379,6,12,1767,5,100,131,100,304,7,1179,31689,1179,1463
0.177,17,4,588,2,48,168,48,152,2,190,167,308,436
0.083,17,2,2380,2,1162,83,1162,2380,0,0,0,0,0
1785.278,17,1882,142932,1027,40,1740,41,70516,855,56,2090,57,72416
9.431,6,66,21384,35,575,277,1152,16376,31,470,305,1179,5008
1797.07,6,344,53544,215,304,8397,304,39168,129,83,14039,83,14376
0.009,17,2,445,1,34,0,34,62,1,355,0,355,383
2.548,6,13,2311,8,188,364,245,700,5,1407,571,1407,1611
1634.143,17,16,4241,8,30,233447,37,471,8,443,233447,463,3770
8.716,6,37,8463,19,399,484,882,1990,18,441,501,1360,6473
15.114,17,25,13552,13,785,1256,1350,10573,12,220,1370,1350,2979
1.372,6,10,1254,5,304,342,304,880,5,102,341,102,374
68.258,6,31,18612,18,702,45,1360,4967,13,1639,5678,4416,13645
1.019,17,4,1108,2,30,830,30,116,2,468,0,468,992
240.197,6,54,18164,29,797,8578,1408,15072,25,223,10008,580,3092
0.001,6,2,100,1,0,0,0,60,1,0,0,0,40
1.216,6,38,8278,19,321,67,1164,2742,19,433,58,1360,5536
365.934,6,24,1587,16,177,24395,177,1053,8,110,9159,110,534
33.254,17,45,10735,21,254,1662,1350,5929,24,172,1441,1350,4806
1793.546,17,87,3648,86,14,21100,14,3612,1,8,0,8,36
183.575,6,36,7925,14,141,2422,267,1415,22,330,8741,1420,6510
1.082,17,2,685,1,308,0,308,336,1,321,0,321,349
2.893,17,6,870,3,40,1430,40,204,3,194,1314,194,666
1777.384,17,79,3312,78,14,23082,14,3276,1,8,0,8,36
57.23,6,30,7499,11,165,5723,267,1109,19,374,3178,3417,6390
92.134,6,29,9550,15,542,72,1287,2318,14,740,7074,1791,7232
0.262,6,6,328,4,0,87,0,216,2,0,205,0,112
0.509,6,24,7480,14,273,39,663,2104,10,967,48,1946,5376
0.727,6,8,440,4,0,242,0,216,4,0,237,0,224
1790.512,1,181,10136,181,28,9947,28,10136,0,0,0,0,0
78.922,6,708,350978,388,843,203,1152,334485,320,409,246,1179,16493
300.084,6,66,32962,38,1211,8105,1460,26995,28,371,11107,1460,5967
1791.23,1,342,28728,342,56,5252,56,28728,0,0,0,0,0
0.909,17,4,352,2,60,908,60,176,2,60,906,60,176
10.963,6,20,4442,11,275,1096,275,998,9,768,773,1440,3444
11.013,6,18,5610,10,275,1223,275,958,8,1440,856,1440,4652
1785.273,6,89,6457,58,31,31320,31,3915,31,31,59507,31,2542
4.044,1,5,520,5,76,1011,76,520,0,0,0,0,0
3.99,17,48,38935,21,484,197,1350,10756,27,1015,151,1350,28179
560.428,17,6,444,3,30,280203,30,174,3,62,280203,62,270
1776.035,1,58,4872,58,56,31158,56,4872,0,0,0,0,0
59.851,6,7905,7493111,5191,1365,11,1408,7347319,2714,931,21,2801,145792
4.499,6,37,7189,19,218,249,314,3383,18,513,248,1179,3806
1786.678,6,98,7952,64,66,28359,66,4672,34,60,54138,60,3280
25.149,2,3,96,3,8,12574,8,96,0,0,0,0,0
15.515,17,13,6723,7,613,2580,1350,4487,6,344,3096,1350,2236
401.067,17,12,4032,12,308,36460,308,4032,0,0,0,0,0
1794.695,1,178,9968,178,28,10139,28,9968,0,0,0,0,0
1793.244,17,180,14040,180,50,10018,50,14040,0,0,0,0,0
0.151,17,2,180,1,30,0,30,58,1,94,0,94,122
1772.458,6,180,15480,120,69,14894,69,8940,60,69,30033,69,6540
1798.086,17,449,39928,404,35,4461,288,25708,45,288,40020,288,14220
248.007,6,139,106775,89,1285,2818,1408,94641,50,680,2658,2439,12134
128.115,6,26,6311,10,267,208,501,1205,16,343,8534,1420,5106
18.093,17,25,8704,12,370,1641,1350,4783,13,273,1505,1350,3921
83.891,6,20,10080,11,433,63,990,1771,9,1587,10469,3928,8309
8.187,6,29,7110,14,164,629,267,1398,15,728,582,2760,5712
1.679,6,27,10181,16,285,111,588,1500,11,1029,150,1420,8681
1681.476,17,14,1036,7,30,280244,30,406,7,62,280243,62,630
1776.117,1,58,4872,58,56,31159,56,4872,0,0,0,0,0
1774.15,6,181,15589,121,69,14784,69,9049,60,69,30062,69,6540
145.037,6,22,9638,11,368,64,794,1577,11,1087,14490,1360,8061
0.012,6,10,1903,5,657,3,657,925,5,710,3,710,978
1143.067,2,12,384,12,8,103915,8,384,0,0,0,0,0
0.136,6,2,92,1,0,0,0,52,1,0,0,0,40
16.212,17,21,13310,12,900,1467,1350,11147,9,212,2018,1350,2163
4.175,17,10,2339,5,40,1040,40,340,5,371,1040,391,1999
736.178,6,10,1390,10,110,81797,110,1390,0,0,0,0,0
279.213,1,4,224,4,28,93071,28,224,0,0,0,0,0
322.389,17,7,2352,7,308,53731,308,2352,0,0,0,0,0
0.26,6,24,5937,12,164,23,453,1442,12,643,22,1402,4495
1799.724,17,449,39928,404,35,4465,288,25708,45,288,40024,288,14220
120.365,17,4,352,2,60,120364,60,176,2,60,120364,60,176
10.721,6,12,2832,6,202,2107,241,882,6,570,2095,959,1950
1784.127,6,381,26486,218,97,8221,469,15550,163,69,11012,69,10936
4.519,6,5,260,5,0,0,0,260,0,0,0,0,0
0.581,17,2,154,1,33,0,33,61,1,65,0,65,93
1784.777,17,142,11360,71,48,25495,48,5396,71,56,25496,56,5964
1740.447,17,30,31680,30,1028,60015,1028,31680,0,0,0,0,0
0.538,6,10,924,5,283,90,283,551,5,105,90,105,373
4.186,6,26,7659,12,268,377,517,1462,14,780,319,1408,6197
0.062,6,9,1169,5,191,15,191,459,4,247,13,462,710
1797.057,17,449,39928,404,35,4459,288,25708,45,288,40025,288,14220
0.047,6,18,6108,10,88,5,88,556,8,1305,6,1880,5552
1.076,6,23,7952,12,164,83,267,1288,11,1014,91,2804,6664
0.334,6,23,7385,13,334,27,663,2021,10,1209,36,1906,5364
0.186,6,9,1340,5,145,46,145,349,4,827,58,827,991
0.53,6,12,1653,6,288,102,288,548,6,426,56,434,1105
155.234,6,19,772,7,0,8065,0,284,12,0,14111,0,488
216.025,6,55,15573,34,663,6546,1230,10421,21,225,10801,1280,5152
0.006,17,2,439,1,39,0,39,67,1,344,0,344,372
541.39,2,4,128,4,8,180463,8,128,0,0,0,0,0
120.312,2,3,96,3,8,60156,8,96,0,0,0,0,0
0.058,6,2,328,1,248,0,248,288,1,0,0,0,40
1791.97,17,140,11200,70,48,25970,48,5320,70,56,25970,56,5880
170.893,6,23,9823,12,410,53,922,1742,11,1089,17076,3056,8081
0.05,17,2,206,1,44,0,44,72,1,106,0,106,134
0.499,6,20,7229,13,334,41,663,2021,7,1209,78,1946,5208
0.381,6,10,968,5,256,91,256,460,5,304,92,304,508
1778.22,17,142,11360,71,48,25402,48,5396,71,56,25402,56,5964
0.076,17,2,212,1,46,0,46,74,1,110,0,110,138
236.4,6,28,8792,14,158,18184,267,1357,14,981,18183,4200,7435
1.401,6,12,1463,6,145,280,145,389,6,830,149,830,1074
280.302,6,29,7392,13,158,23358,267,1317,16,603,18680,1400,6075
1.481,17,17,7020,8,526,211,1350,4435,9,259,136,1350,2585
5.127,17,3,3135,3,1017,2563,1041,3135,0,0,0,0,0
1684.938,17,15,2940,15,168,120352,168,2940,0,0,0,0,0
241.535,6,63,8071,29,192,8626,585,3502,34,174,7319,580,4569
1742.814,6,95,7203,63,38,28109,205,4476,32,33,56207,98,2727
0.044,6,13,3980,7,88,7,88,388,6,1670,8,1880,3592
0.615,6,23,7394,12,335,55,668,1974,11,968,60,1906,5420
23.344,17,36,20689,17,660,1457,1350,11698,19,445,1295,1350,8991
1411.063,6,280,17755,162,69,8764,69,9792,118,69,12060,69,7963
1634.19,6,256,30314,131,105,12570,721,15123,125,275,13170,2007,15191
1743.21,1,117,12402,117,78,15027,78,12402,0,0,0,0,0
1798.445,1,345,28980,345,56,5228,56,28980,0,0,0,0,0
5.135,17,3,208,2,36,4999,36,128,1,52,0,52,80
282.189,6,31,7733,14,175,21706,267,1618,17,603,17632,2076,6115
1782.28,17,332,56308,332,141,5384,391,56308,0,0,0,0,0
280.473,6,28,7352,13,158,23372,267,1317,15,775,20030,3465,6035
1.253,17,18,7385,9,507,156,1350,4819,9,257,149,1350,2566
0.903,17,4,288,2,36,858,36,128,2,52,859,52,160
77.977,6,23,8422,12,525,130,1237,2100,11,838,7776,1791,6322
1.003,17,2,116,2,30,1003,30,116,0,0,0,0,0
17.923,6,2811,2729798,1890,1369,9,1408,2677242,921,776,19,1408,52556
0.523,17,3,451,2,39,21,39,134,1,289,0,289,317
1634.584,1,8,448,8,28,233512,28,448,0,0,0,0,0
1.364,6,11,1727,7,100,227,100,384,4,589,369,1152,1343
369.792,6,18,1239,14,177,28445,177,913,4,110,20058,110,326
1.342,6,38,9848,21,440,67,1360,4392,17,476,72,2715,5456
1.006,17,3,372,2,64,987,64,184,1,160,0,160,188
1.121,6,24,5755,13,158,92,370,1315,11,799,111,1420,4440
0.152,17,2,372,1,34,0,34,62,1,282,0,282,310
4.006,17,8,1288,4,33,1332,33,244,4,233,1329,233,1044
2.678,6,27,8863,16,356,178,802,1714,11,838,255,1380,7149
4.954,17,671,280005,442,551,11,1108,256010,229,76,21,598,23995
0.931,6,23,4772,13,207,77,518,1709,10,507,93,1408,3063
48.285,6,11,676,4,106,16091,106,274,7,90,8045,90,402
1791.169,1,246,13776,246,28,7310,28,13776,0,0,0,0,0
141.919,6,29,13335,17,468,62,1360,3054,12,1398,12890,3928,10281
43.307,17,31,8476,14,291,3331,1350,4477,17,207,2677,1350,3999
3.123,17,4,288,4,44,1041,44,288,0,0,0,0,0
209.142,6,30,10632,6,154,41828,267,712,24,496,9036,1420,9920
1779.622,6,355,22549,207,69,8638,69,12420,148,69,12106,69,10129
0.782,6,23,6627,13,353,64,1106,2293,10,982,86,1731,4334
291.433,6,40,8910,18,326,17140,517,2273,22,685,13875,1418,6637
1781.755,6,362,22898,210,69,8525,69,12678,152,69,11799,69,10220
28.547,6,12,724,3,106,14240,106,234,9,90,3558,90,490
0.142,17,2,279,1,36,0,36,64,1,187,0,187,215
1.736,6,12,1771,8,100,248,100,424,4,1179,494,1179,1347
1.014,17,2,685,1,308,0,308,336,1,321,0,321,349
1.65,6,62,42036,37,1218,45,1448,34831,25,842,61,1448,7205
8.459,6,40,8103,18,218,497,314,3343,22,484,390,1179,4760
1.635,17,6,552,3,32,817,32,180,3,96,795,96,372
4.208,17,5,295,5,31,1052,31,295,0,0,0,0,0
1.678,6,13,2311,8,188,239,245,700,5,1407,354,1407,1611
0.004,17,2,181,1,32,0,32,60,1,93,0,93,121
282.335,6,32,7719,12,158,25489,267,1277,20,469,14857,2760,6442
100.576,6,30,13489,15,488,349,1360,3087,15,1087,7174,2720,10402
224.596,2,4,128,4,8,74865,8,128,0,0,0,0,0
1793.893,1,236,25016,236,78,7633,78,25016,0,0,0,0,0
0.959,6,10,1687,7,100,159,100,384,3,1179,351,1179,1303
1729.265,6,60,4400,40,33,44340,33,2740,20,31,91003,31,1660
1.33,6,50,19461,27,903,51,1460,13765,23,433,52,1460,5696
1744.756,2,27,864,27,8,67106,8,864,0,0,0,0,0
1.922,6,51,19536,29,902,68,1360,13835,22,400,80,1360,5701
1796.351,1,142,15052,142,78,12740,78,15052,0,0,0,0,0
0.797,6,23,6428,13,314,65,908,2094,10,982,87,1699,4334
280.24,6,25,7232,12,158,25476,267,1277,13,905,23351,4845,5955
1771.502,6,103,9382,66,64,27253,64,5544,37,58,49205,58,3838
374.195,6,23,1535,16,177,24946,177,1053,7,110,10403,110,482
149.705,17,6,528,3,60,74852,60,264,3,60,74852,60,264
1776.963,17,73,3060,72,14,25027,14,3024,1,8,0,8,36
4.941,6,41,7349,21,218,247,314,3463,20,440,247,1152,3886
1796.181,17,448,39896,403,35,4468,288,25676,45,288,40020,288,14220
0.272,6,24,5980,12,164,24,453,1442,12,651,23,1440,4538
11.623,6,1912,1628164,1150,1363,10,1380,1590094,762,630,15,3303,38070
2.003,17,3,468,3,128,1001,128,468,0,0,0,0,0
592.307,6,56,8655,28,114,16004,500,2496,28,218,21934,1420,6159
1789.684,17,144,11520,72,48,25206,48,5472,72,56,25204,56,6048
41.6,6,22,11567,13,712,3466,1306,3400,9,1299,5178,3639,8167
152.273,6,21,8321,11,532,82,1257,2068,10,973,16900,2720,6253
55.434,6,28,7217,13,155,4619,267,1306,15,482,3959,2840,5911
1681.68,17,16,1265,8,30,240233,37,471,8,71,240237,136,794
130.242,17,4,240,2,32,130241,32,120,2,32,130241,32,120
739.308,6,176,10763,88,69,8497,69,5107,88,41,8495,69,5656
0.084,17,2,376,1,39,0,39,67,1,281,0,281,309
22.937,6,9,392,3,0,10752,0,128,6,0,1726,0,264
0.012,6,4,208,2,0,5,0,104,2,0,6,0,104
2.933,17,2,136,1,32,0,32,60,1,48,0,48,76
1.883,6,16,5092,9,150,235,174,664,7,1036,293,2642,4428
4.932,6,38,7229,19,218,274,314,3383,19,513,259,1179,3846
0.541,6,20,7229,13,334,45,663,2021,7,1209,85,1946,5208
0.305,17,2,152,1,48,0,48,76,1,48,0,48,76
0.014,17,2,602,1,46,0,46,74,1,500,0,500,528
1775.694,6,194,19199,127,105,14092,469,12034,67,69,26897,69,7165
8.063,17,12,1764,6,48,1610,48,456,6,190,1610,308,1308
125.311,17,4,352,2,60,125310,60,176,2,60,125310,60,176
1.027,6,30,13101,17,517,64,1360,3312,13,1157,70,3921,9789
280.442,6,29,7392,13,158,23370,267,1317,16,678,18694,2760,6075
100.189,6,11,719,11,31,10018,31,719,0,0,0,0,0
721.929,2,7,224,7,8,120321,8,224,0,0,0,0,0
1787.409,6,102,8228,68,64,26677,64,4896,34,58,54161,58,3332
6.217,6,37,7205,19,218,345,314,3383,18,516,350,1179,3822
136.625,17,4,352,2,60,136624,60,176,2,60,136624,60,176
0.022,17,2,554,1,30,0,30,58,1,468,0,468,496
1740.508,17,27,6345,27,207,66942,207,6345,0,0,0,0,0
3.641,6,187,177945,118,209,31,253,8380,69,2634,53,9856,169565
8.306,6,1739,1627606,1117,1380,7,1408,1590500,622,950,13,2801,37106
24.292,6,21,4515,9,255,3036,722,1487,12,342,2149,1448,3028
3.579,17,3,1176,3,364,1789,364,1176,0,0,0,0,0
0.968,17,20,5936,8,280,138,1350,2471,12,260,71,1350,3465
0.308,17,2,212,1,46,0,46,74,1,110,0,110,138
1.312,6,48,19109,26,952,52,1460,13453,22,433,54,1460,5656
1742.405,6,95,7203,63,38,28103,205,4476,32,33,56200,98,2727
9.562,6,16,3655,4,92,3187,92,296,12,273,852,1408,3359
0.074,17,2,152,2,48,74,48,152,0,0,0,0,0
1.095,6,24,8004,12,164,99,267,1288,12,869,81,1448,6716
0.409,6,22,5040,10,137,45,267,1092,12,577,33,1400,3948
1143.038,2,11,352,11,8,114303,8,352,0,0,0,0,0
40.791,6,42,10000,20,671,814,1360,4225,22,325,1934,1360,5775
0.529,6,43,20936,22,171,25,313,1838,21,1199,25,1438,19098
221.424,6,325,282604,213,1362,1044,1448,263126,112,568,1805,1448,19478
1.094,6,23,7952,12,164,84,267,1288,11,1216,93,4224,6664
37.536,6,28,7217,13,155,3128,267,1306,15,482,2680,1420,5911
1795.286,17,449,39928,404,35,4454,288,25708,45,288,40016,288,14220
1775.921,17,73,3060,72,14,25012,14,3024,1,8,0,8,36
1795.922,17,448,39896,403,35,4467,288,25676,45,288,40014,288,14220
2.132,6,13,2311,8,188,304,245,700,5,1407,469,1407,1611
0.458,6,13,1693,6,288,90,288,548,7,426,45,434,1145
1785.861,6,370,25770,214,99,8384,469,15114,156,69,11521,69,10656
2.296,17,8,576,4,33,763,33,244,4,55,763,61,332
1789.919,17,87,3648,86,14,21057,14,3612,1,8,0,8,36
0.076,17,3,634,2,32,0,32,120,1,486,0,486,514
1788.742,6,420,25170,210,69,8558,69,12540,210,34,8558,69,12630
1.843,6,9,379,5,0,460,0,204,4,7,513,7,175
4.174,17,5,340,5,40,1043,40,340,0,0,0,0,0
0.001,1,4,416,0,0,0,0,0,4,76,0,76,416
1782.623,6,104,8376,68,65,26606,65,4930,36,59,50929,59,3446
0.04,17,4,420,2,33,0,33,122,2,121,35,145,298
1770.026,6,120,7323,67,27,26818,27,4003,53,27,34038,27,3320
0.04,17,2,136,1,32,0,32,60,1,48,0,48,76
0.338,17,2,212,1,46,0,46,74,1,110,0,110,138
1.501,17,4,524,2,39,1489,39,134,2,167,1487,167,390
0.488,6,20,7229,13,334,40,663,2021,7,1209,76,1946,5208
75.822,6,22,10167,11,397,60,884,1665,11,1150,7570,1503,8502
1788.553,17,142,11360,71,48,25550,48,5396,71,56,25550,56,5964
0.015,17,2,570,1,30,0,30,58,1,484,0,484,512
1740.951,6,87,6322,58,31,30543,31,3915,29,31,62175,31,2407
1.825,1,30,840,30,0,0,0,840,0,0,0,0,0
6.567,6,13,1807,6,100,1313,100,344,7,589,1053,1152,1463
0.249,17,4,588,2,48,243,48,152,2,190,241,308,436
75.995,6,776,358006,397,834,191,1152,337000,379,389,200,1152,21006
1360.094,17,132,8448,132,36,10382,36,8448,0,0,0,0,0
1.538,6,170,155352,121,1321,12,1360,148890,49,561,27,2744,6462
1790.117,6,357,22560,208,69,8647,69,12460,149,69,12095,69,10100
1740.777,17,29,6815,29,207,62170,207,6815,0,0,0,0,0
90.875,6,49,10455,23,533,700,910,3147,26,312,3628,1360,7308
0.048,6,16,4272,9,128,6,128,604,7,824,6,1405,3668
159.605,6,30,14094,15,519,65,884,2721,15,978,11389,1360,11373
1796.91,17,142,11360,71,48,25669,48,5396,71,56,25669,56,5964
1739.462,6,87,6322,58,31,30516,31,3915,29,31,62122,31,2407
366.523,17,8,2688,8,308,52360,308,2688,0,0,0,0,0
0.326,6,22,7753,11,265,32,779,1642,11,1106,32,2374,6111
201.814,6,12,2531,2,245,1482,245,329,10,299,22396,299,2202
311.571,6,33,2907,18,69,14193,69,1341,15,69,22248,69,1566
60.242,6,24,2168,11,322,6023,580,1284,13,212,5019,212,884
1786.377,6,365,25501,212,100,8466,469,14896,153,69,11751,69,10605
0.027,17,2,235,1,36,0,36,64,1,143,0,143,171
18.61,6,24,9966,11,290,1859,517,1205,13,1344,1549,1418,8761
0.925,6,50,13773,24,549,40,1429,4824,26,464,36,1986,8949
1765.396,1,178,9968,178,28,9973,28,9968,0,0,0,0,0
1096.487,17,216,16416,216,48,5099,48,16416,0,0,0,0,0
0.907,17,2,685,1,308,0,308,336,1,321,0,321,349
280.028,6,27,7312,13,158,23335,267,1317,14,775,21537,2800,5995
11.88,6,1914,1642283,1159,1363,10,1380,1607841,755,421,15,2760,34442
5.734,6,40,7309,21,218,286,314,3463,19,513,304,1179,3846
321.6,6,20,6504,5,98,80400,112,502,15,489,9258,1420,6002
1782.331,17,293,61535,293,182,6103,422,61535,0,0,0,0,0
168.759,6,24,9942,12,282,107,546,1372,12,1154,15324,3931,8570
122.872,6,206,79674,93,1017,1335,1408,68001,113,99,1093,580,11673
0.158,6,9,1002,5,213,39,213,417,4,421,41,421,585
144.72,6,10,543,3,0,72360,0,152,7,7,24077,7,391
1779.777,6,133,10977,74,26,24380,26,4440,59,138,30591,427,6537
0.084,17,2,383,1,39,0,39,67,1,288,0,288,316
14.949,6,1891,1623458,1147,1363,13,1380,1589327,744,387,20,1923,34131
1795.46,6,415,24880,207,69,8715,69,12420,208,34,8673,64,12460
83.563,6,30,7432,13,158,6963,267,1317,17,543,5218,1400,6115
0.069,17,2,157,1,31,0,31,59,1,70,0,70,98
1.693,6,10,767,5,186,423,186,454,5,45,416,45,313
406.643,6,49,29366,19,271,22591,493,1809,30,1082,8413,2876,27557
1771.038,6,101,9410,66,66,27246,66,5610,35,60,52086,60,3800
62.442,1,6,336,6,28,12488,28,336,0,0,0,0,0
0.17,6,46,21046,26,1068,6,1420,16025,20,467,8,1883,5021
1550.51,1,14,1141,14,53,119270,78,1141,0,0,0,0,0
1674.374,1,8,448,8,28,239196,28,448,0,0,0,0,0
142.99,6,31,5324,14,154,10999,722,1807,17,292,8924,1408,3517
606.53,6,145,23434,63,170,9782,1189,7133,82,282,7487,1997,16301
89.751,6,22,9920,11,433,80,990,1771,11,1099,8960,1440,8149
0.016,6,10,1514,5,503,4,503,771,5,475,4,475,743
10.912,6,20,1495,10,222,1208,222,848,10,231,1207,231,647
136.35,6,169,128048,105,1276,1311,1408,115212,64,730,2041,3847,12836
317.015,6,72,19367,39,349,8342,1360,9974,33,424,9902,4649,9393
1776.483,17,140,11200,70,48,25745,48,5320,70,56,25745,56,5880
240.769,6,49,18172,23,197,10935,517,2391,26,1030,9626,2836,15781
1739.367,6,87,6322,58,31,30515,31,3915,29,31,62119,31,2407
1781.757,6,363,24814,212,94,8444,469,14427,151,69,11878,69,10387
0.026,17,4,284,2,32,20,32,120,2,54,19,60,164
544.368,6,1271,1274077,467,182,1168,892,29444,804,1542,664,4206,1244633
599.658,1,3,168,3,28,299829,28,168,0,0,0,0,0
297.653,1,4,224,4,28,99217,28,224,0,0,0,0,0
1788.171,6,104,8308,68,64,26689,64,4896,36,58,51088,58,3412
0.012,17,2,255,1,46,0,46,74,1,153,0,153,181
0.086,17,2,572,1,39,0,39,67,1,477,0,477,505
74.065,6,6,1255,4,327,24688,413,814,2,180,73877,269,441
176.799,2,4,128,4,8,58933,8,128,0,0,0,0,0
0.187,6,47,21054,26,1065,7,1414,15981,21,420,8,1414,5073
120.034,6,58,30781,34,1006,3636,1408,23945,24,430,5213,1408,6836
1779.175,17,142,11360,71,48,25416,48,5396,71,56,25416,56,5964
0.262,6,26,6084,12,164,23,453,1442,14,558,19,1408,4642
1.118,6,55,14070,26,551,44,1429,4932,29,419,39,1460,9138
10.349,6,375,129710,189,351,55,351,13291,186,580,55,1368,116419
1687.172,6,24,3624,16,241,112478,241,2568,8,92,240991,92,1056
68.795,6,133,128389,84,430,828,647,5786,49,2609,1421,11264,122603
1798.504,1,345,28980,345,56,5228,56,28980,0,0,0,0,0
7.122,6,5,240,1,0,0,0,48,4,0,2370,0,192
4.017,17,4,240,4,32,1339,32,240,0,0,0,0,0
1684.648,2,16,512,16,8,112309,8,512,0,0,0,0,0
280.413,6,29,7392,13,158,23367,267,1317,16,603,18689,2076,6075
126.853,2,3,96,3,8,63426,8,96,0,0,0,0,0
280.197,6,29,7392,13,158,23349,267,1317,16,603,18679,1400,6075
290.955,1,4,326,4,53,96985,78,326,0,0,0,0,0
1.286,6,38,9848,21,440,64,1360,4392,17,476,68,2720,5456
2.037,6,30,10317,18,368,119,837,1829,12,1000,178,1452,8488
149.222,6,46,10404,29,286,5329,1360,4922,17,435,536,2667,5482
16.334,17,28,11450,13,316,1358,1350,4476,15,436,1164,1350,6974
0.005,17,2,181,1,32,0,32,60,1,93,0,93,121
0.622,17,2,241,1,36,0,36,64,1,149,0,149,177
1771.774,1,100,5600,100,28,17896,28,5600,0,0,0,0,0
16.737,17,8,608,8,48,2391,48,608,0,0,0,0,0
1785.205,6,218,17431,81,76,22315,337,8542,137,50,13126,143,8889
0.268,17,2,632,1,288,0,288,316,1,288,0,288,316
14.458,17,17,18217,17,1043,903,1448,18217,0,0,0,0,0
14.763,6,17,1185,8,0,6,0,500,9,31,1840,31,685
286.078,6,37,9209,17,158,17879,267,1481,20,628,15049,1400,7728
0.553,6,25,7216,12,155,50,267,1261,13,603,44,1400,5955
1681.329,17,16,4241,8,30,240188,37,471,8,443,240188,463,3770
4.164,1,3,168,3,28,2082,28,168,0,0,0,0,0
0.167,6,10,1669,6,551,33,947,1346,4,159,55,159,323
0.002,6,3,184,1,0,0,0,40,2,0,1,0,144
1799.799,17,449,39928,404,35,4466,288,25708,45,288,40019,288,14220
1.502,17,16,5351,8,371,208,1350,3194,8,241,209,1350,2157
0.068,6,2,128,1,0,0,0,40,1,48,0,48,88
1558.425,2,14,448,14,8,119878,8,448,0,0,0,0,0
299.797,6,6,364,4,31,99932,31,222,2,31,299637,31,142
240.173,6,53,17713,28,783,8895,1408,14780,25,203,10007,580,2933
1.511,6,10,1687,7,100,251,100,384,3,1179,630,1179,1303
1.316,6,46,19114,27,890,50,1360,13578,19,476,62,2715,5536
0.192,6,2,126,1,0,0,0,40,1,46,0,46,86
0.117,6,13,3278,7,226,17,226,598,6,1180,21,1440,2680
0.017,17,2,231,1,34,0,34,62,1,141,0,141,169
1792.973,17,142,11360,71,48,25613,48,5396,71,56,25613,56,5964
1787.336,17,87,3648,86,14,21027,14,3612,1,8,0,8,36
0.094,17,2,258,1,60,0,60,88,1,142,0,142,170
0.511,6,7,295,4,0,170,0,164,3,7,142,7,131
0.116,1,2,112,2,28,116,28,112,0,0,0,0,0
21.411,6,26,6589,15,117,1529,159,1401,11,658,2139,1418,5188
1.302,6,45,18700,27,863,50,1360,13204,18,476,66,2715,5496
186.67,17,4,240,2,32,186668,32,120,2,32,186669,32,120
0.005,17,3,821,1,137,0,137,165,2,300,5,300,656
1740.997,1,14,784,14,28,133922,28,784,0,0,0,0,0
3.877,6,2,88,2,0,0,0,88,0,0,0,0,0
1776.391,17,140,11200,70,48,25744,48,5320,70,56,25744,56,5880
0.695,6,4,253,2,31,695,31,111,2,31,553,31,142
1770.556,6,101,9344,66,65,27239,65,5577,35,59,52072,59,3767
0.07,6,11,819,6,186,11,186,506,5,45,17,45,313
1.612,6,48,18128,26,876,64,1360,12472,22,433,65,1360,5656
11.881,6,1890,1646606,1140,1389,10,1414,1612097,750,467,15,1889,34509
1774.577,6,182,15629,121,69,14788,69,8980,61,69,29574,69,6649
1772.612,6,180,15480,120,69,14895,69,8940,60,69,30038,69,6540
1781.76,6,365,24494,212,87,8444,469,14096,153,69,11722,69,10398
1798.181,17,144,11520,72,48,25326,48,5472,72,56,25326,56,6048
4.067,6,39,7269,19,218,225,314,3383,20,513,201,1179,3886
0.31,6,9,526,5,42,77,42,310,4,0,102,0,216
1769.807,1,58,4872,58,56,31049,56,4872,0,0,0,0,0
164.776,17,4,240,2,32,164775,32,120,2,32,164775,32,120
5.708,6,556,505581,363,1333,15,1368,490881,193,776,28,1473,14700
240.154,6,185,192883,88,197,2760,581,6432,97,2134,2501,5608,186451
351.869,6,18,1128,6,33,36436,33,411,12,31,31971,31,717
300.811,6,43,13714,23,892,13673,1360,8112,20,399,454,1360,5602
1791.02,6,356,22520,208,69,8652,69,12460,148,69,12183,69,10060
22.224,17,3,228,3,48,11112,48,228,0,0,0,0,0
0.014,17,2,379,1,39,0,39,67,1,284,0,284,312
83.785,17,4,352,2,60,83782,60,176,2,60,83783,60,176
0.004,17,4,240,2,32,1,32,120,2,32,2,32,120
0.851,6,2,1253,1,0,0,0,40,1,1173,0,1173,1213
0.298,17,4,580,2,40,266,40,136,2,194,252,194,444
1760.809,6,189,32968,125,302,14200,302,24636,64,83,27949,83,8332
300.698,6,38,8269,20,241,15826,618,1797,18,441,502,1360,6472
10.791,17,15,17718,15,1153,770,1452,17718,0,0,0,0,0
0.208,17,4,352,2,60,207,60,176,2,60,207,60,176
197.118,17,4,240,2,32,197117,32,120,2,32,197117,32,120
0.932,6,10,1687,7,100,155,100,384,3,1179,339,1179,1303
1772.136,6,180,15480,120,69,14891,69,8940,60,69,30032,69,6540
1762.409,17,168,14050,156,30,11370,37,9090,12,385,154700,463,4960
9.894,6,1531,1350807,955,1367,10,1380,1320821,576,475,17,1923,29986
1745.826,6,214,19674,108,129,16316,208,14318,106,31,16622,31,5356
27.124,6,3813,3518430,2441,1362,11,1408,3442422,1372,931,19,2816,76008
12.911,6,235,164210,135,803,96,1226,11873,100,1582,130,4104,152337
7.187,6,9,376,5,0,1796,0,204,4,0,1746,0,172
0.992,6,27,8456,15,222,59,540,2000,12,1192,73,2720,6456
1798.519,17,670,210287,670,285,2688,425,210287,0,0,0,0,0
1784.821,6,359,22709,209,69,8580,69,12569,150,69,11978,69,10140
1726.919,17,58,5021,29,32,61674,37,1745,29,84,61674,136,3276
1781.757,6,355,22480,207,69,8649,69,12420,148,69,12120,69,10060
0.969,6,13,2546,5,288,198,288,508,8,568,113,853,2038
5.992,17,4,272,2,32,5985,32,120,2,48,5985,48,152
1795.31,17,447,39864,402,35,4477,288,25644,45,288,40021,288,14220
0.013,17,2,438,1,30,0,30,58,1,352,0,352,380
112.944,6,21,1565,11,39,11294,39,647,10,49,12549,63,918
126.408,6,25,6273,9,267,97,502,1166,16,343,8421,1420,5107
125.792,2,2,64,2,8,125792,8,64,0,0,0,0,0
301.168,6,52,16369,29,931,10756,1460,10540,23,349,403,2920,5829
42.369,17,24,2112,12,48,3851,48,912,12,72,3850,72,1200
1783.884,6,362,22898,210,69,8535,69,12678,152,69,11811,69,10220
0.11,17,2,245,1,32,0,32,60,1,157,0,157,185
1782.834,6,356,22520,208,69,8612,69,12460,148,69,12128,69,10060
0.015,17,2,152,1,48,0,48,76,1,48,0,48,76
2.117,17,6,1712,3,40,996,41,206,3,474,1051,505,1506
0.371,6,10,968,5,256,90,256,460,5,304,90,304,508
0.262,17,2,152,1,48,0,48,76,1,48,0,48,76
1790.763,6,363,23352,206,69,8735,69,12518,157,69,11479,69,10834
0.004,17,2,904,2,424,4,548,904,0,0,0,0,0
1744.599,6,94,7151,62,38,28599,205,4424,32,33,56263,98,2727
1745.342,6,95,7203,63,38,28150,205,4476,32,33,56288,98,2727
1.034,17,4,884,2,30,1029,30,116,2,356,1030,468,768
1778.788,6,205,12348,171,64,10463,64,9016,34,58,53900,58,3332
0.114,6,9,1002,5,213,28,213,417,4,421,33,421,585
6.262,6,35,8288,18,367,368,787,1854,17,478,381,2128,6434
1.501,6,3,120,2,0,1501,0,80,1,0,0,0,40
9.772,6,16,6695,8,275,1396,275,603,8,1440,1204,1440,6092
1742.045,1,56,4704,56,56,31673,56,4704,0,0,0,0,0
1654.803,1,8,848,8,78,236400,78,848,0,0,0,0,0
150.504,6,20,8672,11,314,63,634,1415,9,1377,18798,3928,7257
279.5,1,6,336,6,28,55900,28,336,0,0,0,0,0
1.377,6,48,18827,26,930,55,1460,13171,22,433,56,1460,5656
31.68,17,4,352,2,60,31678,60,176,2,60,31679,60,176
0.047,17,4,284,2,32,31,32,120,2,54,36,60,164
1799.807,17,142,11360,71,48,25711,48,5396,71,56,25711,56,5964
2.088,17,4,734,3,46,1000,46,222,1,484,0,484,512
64.907,6,15,612,7,0,8198,0,284,8,0,9270,0,328
1791.648,1,342,28728,342,56,5254,56,28728,0,0,0,0,0
0.379,17,3,663,2,39,374,39,134,1,501,0,501,529
1745.572,6,97,7307,63,38,28154,205,4476,34,33,52888,98,2831
1797.913,1,345,28980,345,56,5226,56,28980,0,0,0,0,0
3.643,17,5,335,5,39,910,39,335,0,0,0,0,0
1785.459,6,102,8160,68,63,26648,63,4862,34,57,54102,57,3298
240.157,6,57,19885,31,812,8005,1408,17057,26,183,9606,580,2828
71.5,17,4,352,2,60,71499,60,176,2,60,71499,60,176
62.524,6,41,10299,21,371,3120,1387,3374,20,453,3284,3047,6925
300.771,6,43,21202,21,501,15038,1082,3607,22,967,1552,1448,17595
1796.776,17,448,39896,403,35,4469,288,25676,45,288,40018,288,14220
0.966,6,28,8460,15,222,58,540,1964,13,994,66,1791,6496
0.931,17,15,5125,7,355,155,1350,2686,8,276,123,1350,2439
1681.591,17,16,1265,8,30,240225,37,471,8,71,240225,136,794
0.25,6,12,3462,6,75,50,75,395,6,1373,49,1448,3067
1.493,6,29,10365,17,367,93,833,1785,12,1012,129,1420,8580
1799.236,17,448,39612,404,35,4464,288,25708,44,288,40951,288,13904
0.477,17,4,624,2,64,347,64,184,2,192,354,192,440
1.348,6,24,6504,13,324,111,958,2144,11,783,134,1420,4360
0.017,17,2,192,1,37,0,37,65,1,99,0,99,127
132.41,17,2,152,2,48,132410,48,152,0,0,0,0,0
1.623,6,41,9968,21,440,81,1360,4392,20,433,73,1360,5576
1785.664,6,104,8376,68,65,26651,65,4930,36,59,51015,59,3446
0.393,6,10,968,5,256,94,256,460,5,304,90,304,508
1796.647,17,439,38756,396,35,4548,288,25168,43,288,41926,288,13588
16.533,17,2,672,2,308,16533,308,672,0,0,0,0,0
1709.492,17,12,498,11,14,170949,14,462,1,8,0,8,36
0.244,6,9,1340,5,145,61,145,349,4,827,38,827,991
51.732,17,3,228,3,48,25866,48,228,0,0,0,0,0
280.448,6,28,7352,12,158,25495,267,1277,16,678,18693,2085,6075
70.386,6,29,7395,13,155,5865,267,1306,16,453,4691,3417,6089
11.917,6,1883,1643022,1161,1363,10,1380,1607977,722,558,16,1923,35045
2.839,17,3,174,3,30,1419,30,174,0,0,0,0,0
1794.109,1,59,4956,59,56,30932,56,4956,0,0,0,0,0
0.014,17,2,439,1,43,0,43,71,1,340,0,340,368
300.84,6,44,16556,25,905,12535,1360,10994,19,435,477,2667,5562
1793.74,1,58,4872,58,56,31469,56,4872,0,0,0,0,0
1.444,6,45,18880,27,876,55,1360,13384,18,476,73,2715,5496
1771.159,1,58,4872,58,56,31072,56,4872,0,0,0,0,0
142.652,17,4,352,2,60,142651,60,176,2,60,142651,60,176
1798.062,6,376,26217,218,98,8285,469,15412,158,69,11451,69,10805
481.639,17,10,2443,5,32,120407,37,304,5,399,120407,463,2139
1753.531,6,95,7203,63,38,28282,205,4476,32,33,56558,98,2727
0.42,6,3,120,0,0,0,0,0,3,0,0,0,120
1797.557,17,449,39928,404,35,4460,288,25708,45,288,40018,288,14220
1799.868,1,58,4872,58,56,31576,56,4872,0,0,0,0,0
1773.115,6,180,15480,120,69,14900,69,8940,60,69,30048,69,6540
0.524,17,2,672,2,308,524,308,672,0,0,0,0,0
292.489,17,4,240,2,32,292488,32,120,2,32,292488,32,120
1796.467,17,449,39928,404,35,4457,288,25708,45,288,40022,288,14220
1780.822,6,106,8456,68,65,26579,65,4930,38,59,48127,59,3526
1797.954,17,448,39896,403,35,4472,288,25676,45,288,40018,288,14220
283.419,6,206,152975,121,1325,2361,1448,137514,85,609,2510,1448,15461
0.113,6,9,1340,5,145,28,145,349,4,827,29,827,991
331.097,6,116,88436,76,1237,4414,1408,78236,40,811,2379,3847,10200
5.148,6,38,7229,19,218,286,314,3383,19,513,271,1179,3846
1744.486,6,150,9365,80,48,22082,208,5666,70,31,25278,31,3699
1766.381,6,102,7970,66,45,27175,205,4902,36,35,50462,98,3068
3.843,17,29,10347,15,476,272,1350,7567,14,170,293,1350,2780
1.479,6,48,18688,26,920,59,1460,13032,22,433,61,1460,5656
92.927,6,10,632,3,92,46378,92,256,7,0,15459,0,376
122.699,17,4,352,2,60,122698,60,176,2,60,122698,60,176
3.173,6,13,547,7,0,528,0,288,6,7,568,7,259
301.568,6,42,9882,22,547,14360,1360,4229,20,345,494,1360,5653
3.582,6,29,11897,12,424,325,722,1756,17,788,207,1380,10141
1790.219,6,371,27542,215,116,8365,1189,16274,156,73,11549,405,11268
1794.169,17,144,11520,72,48,25269,48,5472,72,56,25269,56,6048
0.013,17,2,476,1,39,0,39,67,1,381,0,381,409
1443.857,2,11,352,11,8,144385,8,352,0,0,0,0,0
1744.69,6,148,9139,78,45,22658,208,5316,70,31,25281,31,3823
5.498,6,37,6289,20,206,289,314,2864,17,548,328,1179,3425
1.933,17,3,468,3,128,966,128,468,0,0,0,0,0
365.047,6,564,393499,264,302,315,1408,21914,300,1303,1220,4224,371585
1795.905,6,362,23036,211,69,8551,69,12649,151,69,11970,69,10387
1781.769,6,364,25392,212,100,8444,469,14896,152,69,11799,69,10496
1.882,6,25,8755,15,283,134,583,1455,10,985,187,1420,7300
9.207,6,977,1561656,666,1114,13,1360,54530,311,5154,29,43520,1507126
0.087,17,2,283,1,31,0,31,59,1,196,0,196,224
10.932,6,20,4442,11,275,1093,275,998,9,768,748,1440,3444
1796.919,17,293,49988,293,142,6153,392,49988,0,0,0,0,0
75.66,6,28,9023,7,155,12610,267,1066,21,418,3775,1420,7957
0.771,6,22,5330,13,113,60,162,976,9,997,93,3151,4354
0.085,17,2,158,1,34,0,34,62,1,68,0,68,96
1482.449,6,119,12542,60,74,25125,517,4581,59,241,25558,1408,7961
1759.649,1,98,5488,98,28,18140,28,5488,0,0,0,0,0
2.004,17,3,468,3,128,1002,128,468,0,0,0,0,0
1773.604,6,180,15480,120,69,14904,69,8940,60,69,30056,69,6540
5.628,2,2,64,2,8,5628,8,64,0,0,0,0,0
286.65,6,39,9702,18,251,16861,1173,2992,21,418,264,1917,6710
0.323,17,2,412,1,33,0,33,61,1,323,0,323,351
11.474,6,27,11433,13,275,956,275,1078,14,1087,857,1440,10355
1799.553,17,140,11200,70,48,26080,48,5320,70,56,26080,56,5880
1797.186,1,345,28980,345,56,5224,56,28980,0,0,0,0,0
280.072,6,27,7312,13,158,23339,267,1317,14,775,21538,4200,5995
1786.531,6,102,8296,68,65,26664,65,4930,34,59,54134,59,3366
12.021,6,1938,1636184,1152,1364,10,1380,1599746,786,421,15,1923,36438
240.303,6,42,8802,21,519,12014,1402,5772,21,241,12014,618,3030
1694.518,17,18,3528,18,168,99677,168,3528,0,0,0,0,0
280.487,6,30,7432,13,158,23373,267,1317,17,603,17527,2760,6115
151.463,17,4,352,2,60,151461,60,176,2,60,151461,60,176
40.857,17,22,1936,11,48,4083,48,836,11,72,4084,72,1100
1749.185,1,60,5040,0,0,0,0,0,60,56,29647,56,5040
0.93,6,10,1687,7,100,155,100,384,3,1179,342,1179,1303
0.139,17,4,420,2,33,0,33,122,2,121,91,145,298
1791.667,1,114,6384,114,28,15855,28,6384,0,0,0,0,0
1758.416,17,182,40711,182,195,9715,342,40711,0,0,0,0,0
1772.35,6,180,15480,120,69,14893,69,8940,60,69,30035,69,6540
4.523,6,23,3545,13,167,376,293,1530,10,537,475,1179,2015
0.016,6,11,1971,6,451,3,500,1222,5,481,4,481,749
0.022,6,11,3285,6,80,4,80,400,5,872,5,1448,2885
1.984,17,35,15984,17,687,122,1350,12167,18,184,114,1350,3817
2.307,17,4,518,3,39,902,39,201,1,289,0,289,317
372.14,6,21,1422,15,180,26581,180,992,6,110,12287,110,430
23.238,17,4,352,2,60,23237,60,176,2,60,23237,60,176
7.375,6,15,2309,8,211,1053,211,858,7,545,1228,904,1451
1.018,17,8,568,4,32,336,32,240,4,54,336,60,328
1798.488,17,450,39960,405,35,4451,288,25740,45,288,40021,288,14220
0.788,6,10,1687,7,100,131,100,384,3,1179,266,1179,1303
364.179,17,26,2064,15,48,26012,48,1140,11,56,26135,56,924
1786.486,6,104,8435,69,65,26271,65,4970,35,59,52539,59,3465
1783.81,6,355,22480,207,69,8659,69,12420,148,69,12134,69,10060
1741.32,17,29,30566,29,1026,62190,1026,30566,0,0,0,0,0
1.074,6,25,9552,14,350,82,1041,1992,11,1015,88,1460,7560
1774.082,6,217,17400,81,78,22174,375,8551,136,50,13140,143,8849
3.729,17,4,240,4,32,1243,32,240,0,0,0,0,0
1795.556,17,448,39896,403,35,4466,288,25676,45,288,40021,288,14220
7.436,6,3,328,1,0,0,0,40,2,92,7424,92,288
0.226,6,28,7336,13,155,18,267,1301,15,543,14,1400,6035
1774.87,17,142,11360,71,48,25354,48,5396,71,56,25354,56,5964
30.15,6,5,2148,1,0,0,0,40,4,475,10032,618,2108
146.209,17,4,240,2,32,146208,32,120,2,32,146208,32,120
1770.802,6,102,9711,68,69,26429,233,5914,34,59,53657,82,3797
72.498,6,1336,1211173,873,1412,34,1460,1181897,463,167,156,1460,29276
0.257,1,10,280,10,0,0,0,280,0,0,0,0,0
60.083,6,30,7303,14,156,4621,267,1352,16,441,4005,1420,5951
1786.165,6,341,22058,199,69,9021,69,12169,142,69,12667,69,9889
298.0,1,4,326,4,53,99333,78,326,0,0,0,0,0
1.13,6,24,8004,12,164,87,267,1288,12,1014,87,2804,6716
159.835,6,6902,6202050,4301,1356,37,1368,6045002,2601,776,61,1473,157048
1796.098,6,358,22600,208,69,8676,69,12460,150,69,12054,69,10140
5.997,6,681,589592,417,1343,13,1368,571200,264,931,22,2736,18392
156.59,6,67,33539,37,833,95,1360,12344,30,999,5395,2720,21195
0.038,6,3,144,1,0,0,0,52,2,0,38,0,92
1797.503,1,58,4872,58,56,31535,56,4872,0,0,0,0,0
125.645,6,34,7935,12,155,30,267,1266,22,340,5982,3417,6669
1786.295,6,356,22520,208,69,8629,69,12460,148,69,12151,69,10060
1782.894,6,419,25109,209,69,8571,69,12500,210,34,8530,48,12609
31.159,6,29,7392,13,158,2596,267,1317,16,603,2074,2236,6075
1737.871,6,24,3624,16,241,115858,241,2568,8,92,248241,92,1056
21.685,6,3316,3169665,2136,1405,10,1448,3103641,1180,776,18,1448,66024
0.162,17,2,142,1,35,0,35,63,1,51,0,51,79
1793.25,6,361,22858,210,69,8580,69,12678,151,69,11953,69,10180
0.176,6,25,7216,13,155,14,267,1301,12,678,14,3436,5915
339.452,17,14,1232,7,48,56574,48,532,7,72,56572,72,700
1589.399,1,7,392,7,28,264899,28,392,0,0,0,0,0
5.103,6,16898,15825158,8377,148,0,275,448226,8521,1753,0,14080,15376932
0.029,17,8,2446,8,277,4,316,2446,0,0,0,0,0
1773.129,6,180,15480,120,69,14900,69,8940,60,69,30049,69,6540
1.303,6,11,1727,7,100,217,100,384,4,589,352,1152,1343
228.824,6,24,2713,13,324,19068,585,1333,11,396,22880,580,1380
1721.522,17,12,498,11,14,172152,14,462,1,8,0,8,36
158.17,6,40,12156,21,543,7908,1360,4687,19,558,8776,1360,7469
0.355,6,21,7281,12,334,30,663,1969,9,967,43,1906,5312
9.104,6,54,9962,27,237,350,314,5114,27,470,339,1179,4848
104.35,17,4,240,2,32,104349,32,120,2,32,104349,32,120
1383.73,2,11,352,11,8,138373,8,352,0,0,0,0,0
12.651,6,119,54926,63,293,204,444,5170,56,918,229,1536,49756
6.942,6,1501,1386056,951,1377,7,1408,1352694,550,950,12,2801,33362
0.185,17,2,152,1,48,0,48,76,1,48,0,48,76
1792.232,1,276,15456,276,28,6517,28,15456,0,0,0,0,0
0.009,17,2,184,1,32,0,32,60,1,96,0,96,124
0.166,17,2,146,1,37,0,37,65,1,53,0,53,81
1795.315,17,448,39896,403,35,4465,288,25676,45,288,40022,288,14220
0.999,17,367,387260,77,84,13,1350,8641,290,1277,3,1350,378619
1787.209,6,105,8481,69,65,26282,65,5035,36,59,51059,59,3446
0.009,17,2,357,1,41,0,41,69,1,260,0,260,288
1.246,6,27,8945,14,288,95,796,1747,13,952,87,1460,7198
0.113,17,2,245,1,32,0,32,60,1,157,0,157,185
0.279,6,27,9047,13,252,23,647,1692,14,945,20,1408,7355
42.367,17,4,240,2,32,42365,32,120,2,32,42366,32,120
252.632,17,4,240,2,32,252631,32,120,2,32,252631,32,120
3.974,2,2,64,2,8,3974,8,64,0,0,0,0,0
4.208,6,39,7269,19,218,233,314,3383,20,440,208,1152,3886
1775.89,6,180,15480,120,69,14923,69,8940,60,69,30091,69,6540
0.125,1,10,840,10,56,13,56,840,0,0,0,0,0
1740.637,17,30,7050,30,207,60021,207,7050,0,0,0,0,0
0.905,6,27,9612,14,164,69,267,1436,13,936,61,1408,8176
10.844,6,48,26587,28,980,401,1368,20104,20,901,560,2519,6483
1798.474,6,375,23694,214,69,8443,69,13114,161,69,11240,69,10580
1746.761,6,95,7203,63,38,28173,205,4476,32,33,56332,98,2727
2.303,17,4,314,2,31,2033,31,118,2,70,1,70,196
6.963,17,5,738,4,32,1330,32,240,1,470,0,470,498
31.773,6,9,577,0,0,0,0,0,9,31,3971,31,577
1792.32,6,362,24774,211,94,8534,469,14387,151,69,11946,69,10387
180.354,2,2,64,2,8,180354,8,64,0,0,0,0,0
0.098,6,9,1340,5,145,24,145,349,4,827,30,827,991
0.012,17,2,283,1,31,0,31,59,1,196,0,196,224
0.417,17,3,234,2,39,55,39,134,1,72,0,72,100
109.83,6,172,134304,108,1287,1026,1408,121465,64,731,1739,3847,12839
6.782,6,470,427597,310,1319,21,1368,414613,160,776,41,2736,12984
1516.006,6,220,31453,87,186,17627,1360,13690,133,130,11483,4649,17763
12.238,6,1883,1671704,1180,1363,10,1380,1639018,703,468,17,3303,32686
7.372,6,1377,1264249,844,1419,8,1448,1231869,533,776,13,1448,32380
1789.951,17,142,11360,71,48,25570,48,5396,71,56,25569,56,5964
0.001,17,2,180,1,30,0,30,58,1,94,0,94,122
19.052,6,63,13331,35,238,560,314,7356,28,441,650,1179,5975
1.574,6,10,1687,7,100,262,100,384,3,1179,655,1179,1303
4.012,6,13,2311,8,188,573,245,700,5,1407,936,1407,1611
4.318,2,2,64,2,8,4318,8,64,0,0,0,0,0
251.226,2,2,64,2,8,251226,8,64,0,0,0,0,0
63.742,6,37,5086,19,138,3541,174,1320,18,303,3740,1452,3766
1786.747,6,102,8364,68,66,26667,66,4964,34,60,54140,60,3400
1741.68,6,81,5886,54,31,32861,31,3645,27,31,66985,31,2241
2.013,17,6,460,3,40,994,41,206,3,56,998,57,254
1.621,6,38,8258,19,321,90,1168,2722,19,433,78,1360,5536
1777.943,1,62,5208,0,0,0,0,0,62,56,29146,56,5208
0.871,17,2,136,1,32,0,32,60,1,48,0,48,76
366.339,6,27,1767,18,177,21549,177,1181,9,110,8892,110,586
0.12,17,2,672,2,308,120,308,672,0,0,0,0,0
75.653,6,31,7613,12,155,28,267,1266,19,398,4202,3417,6347
1794.24,17,187,48275,187,230,9646,422,48275,0,0,0,0,0
1701.236,17,20,4937,10,32,189024,37,601,10,405,189025,463,4336
0.109,17,2,241,1,36,0,36,64,1,149,0,149,177
0.136,6,10,1671,6,552,26,948,1348,4,159,44,159,323
248.825,6,565,420760,256,737,975,1418,33649,309,1329,807,1418,387111
1795.543,17,446,39264,403,35,4466,288,25676,43,288,41926,288,13588
280.275,6,28,7352,12,158,25479,267,1277,16,603,18678,1400,6075
300.723,6,39,8352,20,241,15827,618,1809,19,412,473,1440,6543
1772.676,6,180,15480,120,69,14896,69,8940,60,69,30038,69,6540
1708.236,1,78,4368,78,28,22184,28,4368,0,0,0,0,0
560.163,6,72,8454,39,181,14739,469,6099,33,69,6592,69,2355
10.186,6,84,24885,43,560,242,1152,19088,41,461,248,1179,5797
0.06,17,2,158,1,34,0,34,62,1,68,0,68,96
0.05,6,12,3702,6,170,8,170,490,6,964,9,1448,3212
0.03,17,2,116,1,30,0,30,58,1,30,0,30,58
18.26,17,31,8516,15,274,1302,1350,4533,16,220,1215,1350,3983
300.574,6,126,94523,71,145,4293,230,4436,55,1710,5566,5632,90087
6.463,6,14,2242,8,210,923,210,844,6,545,1287,904,1398
4.66,6,40,7309,20,218,245,314,3423,20,513,230,1179,3886
0.039,6,31,7939,17,131,2,131,1023,14,515,2,1000,6916
0.031,17,2,904,2,424,31,548,904,0,0,0,0,0
0.092,17,4,284,2,32,1,32,120,2,54,35,60,164
1.385,17,2,677,1,300,0,300,328,1,321,0,321,349
0.019,17,2,188,1,39,0,39,67,1,93,0,93,121
361.682,2,3,96,3,8,180841,8,96,0,0,0,0,0
1.48,6,50,19681,27,919,56,1360,13985,23,433,58,1360,5696
1742.516,6,95,7203,63,38,28105,205,4476,32,33,56196,98,2727
1681.925,17,14,1036,7,30,280315,30,406,7,62,280315,62,630
1788.444,6,356,22520,208,69,8639,69,12460,148,69,12166,69,10060
0.311,6,2,92,1,0,0,0,52,1,0,0,0,40
5.896,6,7,533,4,245,1877,245,409,3,0,2816,0,124
240.294,17,6,8256,6,1348,48058,1348,8256,0,0,0,0,0
0.883,6,25,9105,14,290,67,802,1753,11,1150,71,2570,7352
0.891,6,21,9222,11,514,89,1237,2015,10,970,72,1360,7207
0.877,17,4,624,2,64,876,64,184,2,192,751,192,440
0.501,17,3,451,2,39,261,39,134,1,289,0,289,317
31.614,6,7,396,1,0,0,0,60,6,0,6285,0,336
0.53,6,25,6056,13,108,44,147,959,12,768,44,1581,5097
0.41,6,14,1733,7,288,67,288,588,7,284,37,434,1145
1787.124,6,114,9156,73,66,24821,66,5296,41,60,44675,60,3860
1788.603,1,342,28728,342,56,5245,56,28728,0,0,0,0,0
1.411,6,54,23941,30,998,48,1360,18205,24,476,53,2715,5736
390.166,6,89,19686,41,291,9754,1460,9541,48,248,8298,1629,10145
0.069,17,2,219,1,50,0,50,78,1,113,0,113,141
353.983,6,64,45147,43,1169,8428,1408,37320,21,961,3076,3847,7827
0.035,17,2,136,1,32,0,32,60,1,48,0,48,76
1796.116,17,449,39928,404,35,4456,288,25708,45,288,40019,288,14220
2.017,6,3,160,2,0,2017,0,100,1,0,0,0,60
134.097,6,7,309,2,0,864,0,84,5,7,33480,7,225
215.016,6,164,132185,109,1268,1990,1408,119816,55,730,2008,3847,12369
14.803,6,2516,2362486,1607,1391,9,1408,2310530,909,931,16,2801,51956
1772.366,6,180,15480,120,69,14893,69,8940,60,69,30033,69,6540
840.689,17,8,2180,4,30,280226,30,232,4,459,280226,463,1948
279.353,1,4,224,4,28,93117,28,224,0,0,0,0,0
2.486,6,31,8159,18,337,146,1420,3425,13,701,206,1728,4734
50.479,6,44,13810,21,529,2523,1152,8781,23,456,2154,1179,5029
541.469,2,7,224,7,8,90244,8,224,0,0,0,0,0
0.582,6,24,6015,13,108,48,147,959,11,768,54,1581,5056
2.026,6,2,1520,1,0,0,0,40,1,1440,0,1440,1480
1788.136,6,358,22669,209,69,8596,69,12569,149,69,12081,69,10100
0.018,17,3,265,2,39,1,39,134,1,103,0,103,131
1783.479,17,83,3480,82,14,22018,14,3444,1,8,0,8,36
1752.326,17,57,19120,57,307,31291,308,19120,0,0,0,0,0
0.055,17,2,588,1,39,0,39,67,1,493,0,493,521
23.748,6,3342,3129304,2166,1366,10,1408,3063488,1176,931,20,2801,65816
2.467,6,11,976,5,283,574,283,551,6,105,459,105,425
1741.497,6,87,6322,58,31,30552,31,3915,29,31,62190,31,2407
0.018,17,3,392,2,60,1,60,176,1,188,0,188,216
0.004,6,2,129,1,0,0,0,40,1,37,0,37,89
0.168,6,14,4308,7,85,28,85,457,7,869,27,1448,3851
1.038,17,3,286,2,46,999,46,148,1,110,0,110,138
58.742,17,4,548,2,32,58717,33,121,2,185,58719,323,427
98.706,6,77,51063,47,1185,2145,1408,42771,30,747,2124,1408,8292
1794.489,6,359,22709,209,69,8627,69,12569,150,69,12040,69,10140
106.607,17,4,240,2,32,106606,32,120,2,32,106605,32,120
142.924,17,5,1692,5,310,35731,312,1692,0,0,0,0,0
303.858,6,42,9317,22,251,14469,847,2432,20,467,614,2720,6885
105.401,6,41,9724,21,638,454,1360,4077,20,371,5535,1360,5647
20.455,6,17,2316,10,189,2272,517,1298,7,323,3405,499,1018
0.326,6,27,8984,13,234,27,575,1620,14,828,24,1408,7364
545.116,1,22,2332,22,78,25957,78,2332,0,0,0,0,0
295.449,1,4,224,4,28,98483,28,224,0,0,0,0,0
341.994,6,1129,551762,597,850,371,1152,520629,532,378,643,1152,31133
3.43,17,2,154,1,33,0,33,61,1,65,0,65,93
60.708,6,24,10569,13,756,5059,1448,3732,11,893,6059,1448,6837
15.302,17,15,4930,7,360,2539,1350,2721,8,248,2175,1350,2209
280.272,6,30,7432,13,158,23356,267,1317,17,603,17514,2036,6115
1786.771,6,104,8376,68,65,26668,65,4930,36,59,51047,59,3446
1.573,6,11,1727,7,100,262,100,384,4,589,434,1152,1343
1.391,6,40,9928,21,502,69,1460,4392,19,433,67,1460,5536
301.796,17,6,528,3,60,150897,60,264,3,60,150897,60,264
0.416,17,4,624,2,64,414,64,184,2,192,291,192,440
60.423,6,30,4712,18,138,3554,174,1276,12,368,3928,1420,3436
266.09,17,4,352,2,60,266088,60,176,2,60,266089,60,176
1796.362,1,282,15792,282,28,6392,28,15792,0,0,0,0,0
1781.05,6,354,22440,207,69,8645,69,12420,147,69,12198,69,10020
20.193,6,24,6503,14,117,1553,159,1349,10,771,2242,1668,5154
1743.071,6,104,7550,66,31,26816,31,4503,38,31,47109,31,3047
60.101,6,8,432,5,0,15025,0,268,3,0,30041,0,164
1779.427,6,102,8228,68,64,26558,64,4896,34,58,53919,58,3332
1787.914,17,87,3648,86,14,21034,14,3612,1,8,0,8,36
1779.821,6,373,23614,213,69,8395,69,13074,160,69,11193,69,10540
1776.979,17,140,11200,70,48,25753,48,5320,70,56,25753,56,5880
0.039,17,2,396,1,58,0,58,86,1,282,0,282,310
1739.919,6,87,6322,58,31,30524,31,3915,29,31,62139,31,2407
67.188,17,4,352,2,60,67187,60,176,2,60,67186,60,176
1685.188,17,14,1036,7,30,280856,30,406,7,62,280857,62,630
1.516,6,51,19264,29,880,54,1360,13563,22,437,62,2715,5701
0.042,6,3,120,2,0,42,0,80,1,0,0,0,40
1795.583,17,449,39928,404,35,4455,288,25708,45,288,40016,288,14220
3.9,17,2,124,2,34,3900,34,124,0,0,0,0,0
0.238,6,4,1037,2,0,238,0,104,2,853,1,853,933
1772.915,6,180,15480,120,69,14898,69,8940,60,69,30044,69,6540
249.264,17,4,240,2,32,249263,32,120,2,32,249263,32,120
5.599,6,3,180,3,0,0,0,180,0,0,0,0,0
1798.935,17,768,46392,768,32,2345,37,46392,0,0,0,0,0
1797.491,17,449,39928,404,35,4460,288,25708,45,288,40018,288,14220
4.61,17,5,4754,5,922,1152,1451,4754,0,0,0,0,0
62.959,6,28,7217,13,155,5246,267,1306,15,482,4496,1997,5911
41.955,6,37,16174,20,634,2208,1460,3381,17,1008,2591,1460,12793
1.085,6,25,8044,13,164,90,267,1328,12,1014,80,2411,6716
7.124,6,1283,1148230,792,1371,8,1408,1118034,491,931,14,2801,30196
0.317,6,21,7281,13,334,25,663,2021,8,1209,44,1906,5260
1.406,6,50,21090,28,952,52,1460,15434,22,433,58,1460,5656
1.353,6,8,342,4,0,451,0,164,4,7,286,7,178
150.118,6,25,9936,12,541,62,1440,2677,13,961,12498,1440,7259
0.006,17,2,523,1,43,0,43,71,1,424,0,424,452
280.086,6,30,7432,14,158,21545,267,1357,16,603,18666,2800,6075
1777.757,17,73,3060,72,14,25038,14,3024,1,8,0,8,36
583.106,17,9,5341,9,565,72888,1451,5341,0,0,0,0,0
2.731,17,4,610,3,39,898,39,201,1,381,0,381,409
8.177,6,18,6871,9,275,1022,275,643,9,1171,729,1440,6228
1.067,6,27,8432,14,266,68,540,1936,13,994,73,1791,6496
10.762,6,18,5610,10,275,1195,275,958,8,1440,824,1440,4652
1.482,6,48,19648,27,922,57,1360,14032,21,433,65,1360,5616
1038.51,6,44,2288,22,0,49445,0,1144,22,0,49445,0,1144
1.145,6,53,14426,25,551,47,1429,4928,28,464,41,1986,9498
1795.71,17,449,39928,404,35,4455,288,25708,45,288,40016,288,14220
0.417,6,7,288,4,0,139,0,164,3,0,101,0,124
318.05,6,63,18988,32,469,10259,1360,9813,31,396,10596,1360,9175
1746.761,6,142,15694,86,116,20550,205,10990,56,32,31752,33,4704
1786.301,6,104,8308,68,64,26661,64,4896,36,58,51034,58,3412
753.683,6,134,18295,68,144,11249,721,9661,66,260,11538,2007,8634
36.71,6,34,5344,16,145,2447,721,1994,18,342,2147,1368,3350
1747.619,6,94,7151,62,38,28649,205,4424,32,33,56361,98,2727
177.432,17,4,352,2,60,177430,60,176,2,60,177431,60,176
9.449,6,1897,1734598,1194,1374,7,1408,1693378,703,931,13,2816,41220
240.171,6,54,18360,29,818,8577,1402,15432,25,202,10006,580,2928
0.085,6,12,3705,6,171,14,171,491,6,964,14,1448,3214
3.741,17,2,152,2,48,3741,48,152,0,0,0,0,0
125.88,2,2,64,2,8,125880,8,64,0,0,0,0,0
1796.809,17,448,39896,403,35,4469,288,25676,45,288,40019,288,14220
3.59,6,14,2482,9,169,448,245,871,5,1407,827,1407,1611
1789.161,6,356,22520,208,69,8643,69,12460,148,69,12171,69,10060
241.203,6,45,9099,22,524,11485,1418,5869,23,225,10963,619,3230
23.21,6,22,2250,11,444,2319,666,1332,11,231,2318,231,918
1.333,6,40,10514,21,513,66,1460,4978,19,433,64,1460,5536
22.791,6,29,7935,14,219,1753,721,1882,15,778,1613,2840,6053
1.328,6,9,382,4,0,442,0,164,5,7,264,7,218
0.196,6,3,144,2,0,196,0,92,1,0,0,0,52
1771.233,6,99,9306,66,66,27249,66,5610,33,60,55348,60,3696
8.586,6,69,20262,35,520,252,1152,15459,34,491,252,1179,4803
19.535,6,163,68177,88,738,224,1152,60354,75,438,259,1179,7823
160.21,6,152,24359,80,304,2027,304,16716,72,83,2238,83,7643
6.245,6,1642,1523223,1041,1386,5,1408,1487307,601,931,10,2801,35916
0.011,17,2,290,1,40,0,40,68,1,194,0,194,222
217.54,6,36,8206,14,187,8550,505,1499,22,306,10355,1420,6707
1799.156,1,345,28980,345,56,5230,56,28980,0,0,0,0,0
192.323,6,72,42462,41,1183,4808,1448,34098,31,749,2062,1448,8364
1780.401,17,138,11040,69,48,26182,48,5244,69,56,26182,56,5796
67.913,17,4,352,2,60,67912,60,176,2,60,67912,60,176
1799.669,17,3833,183984,1916,20,939,20,91968,1917,20,938,20,92016
1.577,6,49,18703,26,853,63,1360,13007,23,433,63,1360,5696
0.041,6,4,160,2,0,41,0,80,2,0,0,0,80
316.067,6,74,19406,39,334,8317,1360,9979,35,381,9291,1360,9427
0.703,17,2,778,2,361,703,361,778,0,0,0,0,0
0.043,17,4,284,2,32,38,32,120,2,54,38,60,164
51.815,17,16,18199,16,1109,3454,1451,18199,0,0,0,0,0
1796.849,6,250,37001,154,302,11744,302,26756,96,83,18914,83,10245
1722.669,6,173,15131,113,71,15380,138,8660,60,69,28134,69,6471
1740.823,6,85,6187,57,31,31086,31,3863,28,31,64473,31,2324
0.027,6,14,4020,7,88,4,88,388,7,1670,4,1880,3632
3.319,17,20,7260,9,465,410,1350,4439,11,228,328,1350,2821
105.635,6,70,46984,44,1180,2456,1448,38903,26,746,2463,1448,8081
3.769,6,7,400,3,0,1884,0,160,4,0,1022,0,240
3.553,17,2,154,1,33,0,33,61,1,65,0,65,93
1788.563,17,348,26448,348,48,5154,48,26448,0,0,0,0,0
363.085,6,70,4456,39,69,9554,69,2319,31,69,12093,69,2137
1786.611,6,102,8364,68,66,26665,66,4964,34,60,54137,60,3400
1797.468,6,356,22520,208,69,8683,69,12460,148,69,12225,69,10060
4.824,6,57,22245,29,947,172,1440,16349,28,433,156,1440,5896
1145.033,17,88,7024,46,48,25445,48,3496,42,56,25427,56,3528
3.003,6,35,7940,18,352,176,1432,2484,17,477,175,1473,5456
1.224,6,25,8056,12,164,95,267,1288,13,869,86,1448,6768
1681.397,17,14,3843,7,30,280231,30,406,7,463,280230,463,3437
0.032,17,3,244,2,32,7,32,120,1,96,0,96,124
17.982,6,18,5802,8,275,1610,275,878,10,902,1946,1440,4924
48.138,17,4,240,2,32,48137,32,120,2,32,48137,32,120
1795.704,17,448,39896,403,35,4466,288,25676,45,288,40022,288,14220
0.343,17,2,166,1,39,0,39,67,1,71,0,71,99
1659.87,1,8,448,8,28,237124,28,448,0,0,0,0,0
7.967,6,266,202569,121,133,66,201,5407,145,1347,54,1432,197162
1.962,17,2,672,2,308,1962,308,672,0,0,0,0,0
1740.594,17,30,31680,30,1028,60020,1028,31680,0,0,0,0,0
309.986,1,4,522,4,102,103328,117,522,0,0,0,0,0
1799.759,1,208,22048,208,78,8694,78,22048,0,0,0,0,0
1.362,6,40,8389,21,320,68,1162,2808,19,437,66,2715,5581
1141.78,6,103,12074,56,107,20759,722,6235,47,99,24817,2330,5839
0.056,17,4,284,2,32,0,32,120,2,54,20,60,164
189.385,6,121,93877,79,1261,2428,1408,83570,42,811,1937,3847,10307
0.761,6,28,5760,14,121,58,267,1295,14,650,53,1420,4465
1798.218,1,324,27216,324,56,5567,56,27216,0,0,0,0,0
1798.462,17,448,39612,404,35,4462,288,25708,44,288,40956,288,13904
28.348,6,31,7677,12,155,2577,267,1266,19,376,1574,3417,6411
1786.885,6,104,8444,68,66,26669,66,4964,36,60,51051,60,3480
1741.02,1,75,6300,0,0,0,0,0,75,56,23527,56,6300
1785.863,6,356,22520,208,69,8627,69,12460,148,69,12148,69,10060
240.403,6,47,10009,23,523,10926,1418,5950,24,254,10451,619,4059
1799.614,1,327,27468,327,56,5520,56,27468,0,0,0,0,0
15.429,6,6,288,1,0,0,0,48,5,0,3853,0,240
0.447,6,22,7255,13,318,36,600,1958,9,964,53,1471,5297
0.234,17,2,152,1,48,0,48,76,1,48,0,48,76
4.021,6,12,6126,4,92,1340,92,296,8,901,329,1448,5830
0.029,17,8,2454,8,278,4,317,2454,0,0,0,0,0
44.729,17,4,352,2,60,44728,60,176,2,60,44727,60,176
0.826,17,17,5863,7,316,137,1350,2413,10,317,47,1350,3450
0.63,6,58,46150,37,143,17,253,2530,21,2362,31,4224,43620
28.778,6,45,13913,20,289,1514,721,3411,25,678,1156,1414,10502
169.289,6,33,5459,17,152,10580,722,2114,16,358,11260,1448,3345
1773.322,1,58,4872,58,56,31110,56,4872,0,0,0,0,0
0.006,6,2,658,1,0,0,0,40,1,578,0,578,618
0.104,17,2,672,2,308,104,308,672,0,0,0,0,0
240.883,6,48,8655,24,449,10469,1418,5752,24,205,10467,580,2903
64.063,6,16,10466,5,174,16015,174,378,11,1377,6393,1452,10088
0.994,6,29,12011,16,525,66,1360,3298,13,909,68,1379,8713
0.22,17,2,2380,2,1162,220,1162,2380,0,0,0,0,0
4.428,17,2,656,2,300,4428,300,656,0,0,0,0,0
16.421,17,53,35799,22,401,780,1350,9451,31,821,546,1350,26348
1772.59,6,180,15480,120,69,14895,69,8940,60,69,30040,69,6540
104.734,17,6,480,3,48,52361,48,228,3,56,52361,56,252
1773.17,6,180,15480,120,69,14900,69,8940,60,69,30051,69,6540
1221.294,17,176,13376,176,48,6978,48,13376,0,0,0,0,0
18.052,17,4,240,2,32,18051,32,120,2,32,18051,32,120
0.081,17,2,390,1,46,0,46,74,1,288,0,288,316
24.146,6,3519,3386477,2349,1365,10,1408,3320973,1170,931,20,2801,65504
1763.958,2,14,448,14,8,135689,8,448,0,0,0,0,0
1795.277,17,80,3354,79,14,23016,14,3318,1,8,0,8,36
439.321,6,54,12736,25,455,11330,1301,6012,29,252,15686,1452,6724
1759.003,6,100,7866,66,45,27061,205,4902,34,35,53297,98,2964
1772.93,17,333,25308,333,48,5340,48,25308,0,0,0,0,0
0.422,6,25,6056,13,108,35,147,959,12,768,38,1581,5097
2.462,17,2,778,2,361,2462,361,778,0,0,0,0,0
5.035,17,4,558,2,36,5021,36,128,2,187,5021,187,430
3.904,17,5,290,5,30,976,30,290,0,0,0,0,0
244.087,17,4,352,2,60,244086,60,176,2,60,244086,60,176
1681.602,17,14,1036,7,30,280265,30,406,7,62,280264,62,630
217.735,6,79,53454,48,1217,4632,1368,45105,31,841,2066,2519,8349
126.501,2,2,64,2,8,126501,8,64,0,0,0,0,0
191.932,6,25,7996,10,154,21325,267,872,15,651,13707,1420,7124
1.863,6,13,2311,8,188,266,245,700,5,1407,384,1407,1611
0.042,17,2,158,1,34,0,34,62,1,68,0,68,96
1781.265,6,88,5576,43,32,42408,36,2334,45,304,40481,445,3242
1789.003,1,226,12656,226,28,7951,28,12656,0,0,0,0,0
1740.633,6,87,6322,58,31,30537,31,3915,29,31,62165,31,2407
0.121,17,2,158,1,34,0,34,62,1,68,0,68,96
280.436,6,30,7432,13,158,23369,267,1317,17,543,17519,1400,6115
1754.175,1,54,4536,54,56,33097,56,4536,0,0,0,0,0
232.933,6,28,8564,11,348,23293,735,1624,17,465,14383,2527,6940
317.942,6,110,34696,57,506,5677,1360,23593,53,358,6111,3289,11103
1798.106,17,449,39928,404,35,4461,288,25708,45,288,40018,288,14220
1771.533,6,99,9240,66,65,27254,65,5577,33,59,55357,59,3663
0.116,6,9,1343,5,145,29,145,349,4,830,34,830,994
76.62,17,4,352,2,60,76619,60,176,2,60,76619,60,176
43.556,6,27,7177,13,155,3629,267,1306,14,530,3349,3417,5871
1729.186,6,63,4601,41,33,43229,33,2825,22,31,82333,31,1776
1138.165,17,787,55292,708,40,1609,41,48610,79,56,714,57,6682
0.004,17,4,384,2,36,0,36,128,2,100,0,106,256
973.036,6,58,4619,38,66,26298,66,2708,20,58,51206,60,1911
60.472,6,42,8973,16,419,43,944,1931,26,285,2413,1440,7042
5.617,6,39,7269,21,218,280,314,3463,18,513,314,1179,3806
3.989,17,3,183,3,33,1994,33,183,0,0,0,0,0
1740.499,6,91,6604,59,31,30008,31,3998,32,31,56143,31,2606
1783.81,6,420,25208,210,69,8534,69,12540,210,34,8534,64,12668
0.096,17,4,344,2,47,57,47,150,2,69,40,75,194
0.348,17,2,136,1,32,0,32,60,1,48,0,48,76
1581.905,6,140,25898,78,404,19493,1290,18895,62,96,25932,241,7003
8.521,17,4,240,2,32,8520,32,120,2,32,8519,32,120
300.537,6,17,1187,6,177,60072,177,509,11,110,30036,110,678
179.068,17,6,528,3,60,89533,60,264,3,60,89533,60,264
3.496,6,8,1611,4,100,1165,100,264,4,1179,1076,1179,1347
1786.953,6,104,8308,68,64,26670,64,4896,36,58,51053,58,3412
1741.386,17,29,30624,29,1028,62192,1028,30624,0,0,0,0,0
0.254,17,2,340,1,39,0,39,67,1,245,0,245,273
82.66,17,4,240,2,32,82659,32,120,2,32,82659,32,120
1.299,6,40,9929,21,440,64,1360,4393,19,476,62,2720,5536
1799.171,17,420,141120,420,308,4293,308,141120,0,0,0,0,0
1788.07,6,370,23632,210,69,8555,69,12954,160,69,11244,69,10678
0.232,6,3,160,2,0,232,0,100,1,0,0,0,60
285.717,6,28,2965,14,324,21977,585,1385,14,282,21977,580,1580
69.176,6,11,1346,6,302,13835,302,912,5,83,17290,83,434
1786.623,6,96,7808,64,65,28359,65,4640,32,59,57629,59,3168
0.047,17,2,650,1,308,0,308,336,1,286,0,286,314
1795.696,6,279,34420,114,140,15889,1360,16854,165,133,10948,3302,17566
240.208,6,54,17917,29,791,8578,1402,14965,25,205,10008,580,2952
4.2,6,2,88,2,0,0,0,88,0,0,0,0,0
371.609,1,5,280,5,28,92902,28,280,0,0,0,0,0
6.942,6,47,8489,25,227,289,314,4182,22,489,317,1179,4307
280.159,6,26,7272,12,158,25469,267,1277,14,775,21549,2800,5995
0.0,1,1,104,0,0,0,0,0,1,76,0,76,104
1770.161,6,99,9240,66,65,27233,65,5577,33,59,55314,59,3663
6.015,6,11,471,5,0,1503,0,208,6,7,610,7,263
1790.563,6,370,25839,215,99,8367,469,15154,155,69,11625,69,10685
31.289,6,14,5625,4,106,10425,106,274,10,823,3475,1460,5351
15.656,17,20,14091,12,957,1419,1350,11827,8,255,2230,1350,2264
360.959,6,4,600,4,110,120319,110,600,0,0,0,0,0
0.899,6,29,8605,16,263,55,586,2286,13,723,60,2720,6319
1741.179,1,56,4704,56,56,31657,56,4704,0,0,0,0,0
1.462,6,3,120,2,0,1462,0,80,1,0,0,0,40
0.035,17,2,262,1,39,0,39,67,1,167,0,167,195
122.412,6,30,8337,16,714,8160,1380,6554,14,151,9416,472,1783
1798.069,17,434,38596,391,35,4610,288,25008,43,288,41925,288,13588
4.394,6,38,7245,19,218,244,314,3383,19,516,229,1179,3862
38.826,17,22,1936,11,48,3881,48,836,11,72,3881,72,1100
34.765,6,35,5370,18,180,2045,722,2074,17,267,2150,2026,3296
1742.834,6,98,7390,63,38,28110,205,4476,35,33,51252,98,2914
1740.613,17,30,31620,30,1026,60021,1026,31620,0,0,0,0,0
1663.265,1,8,448,8,28,237609,28,448,0,0,0,0,0
24.039,17,2,136,2,40,24039,47,136,0,0,0,0,0
189.862,17,4,352,2,60,189861,60,176,2,60,189861,60,176
0.044,17,4,368,2,32,1,32,120,2,96,0,96,248
1771.201,6,110,10250,71,66,25302,66,6038,39,60,46608,60,4212
215.481,1,12,1272,12,78,19589,78,1272,0,0,0,0,0
99.281,6,70,50247,46,1200,2206,1408,40858,24,1016,2677,4224,9389
222.146,17,6,1969,6,300,44429,301,1969,0,0,0,0,0
93.603,6,150,229665,66,283,1440,881,5129,84,2786,1088,7010,224536
1799.387,17,140,11200,70,48,26077,48,5320,70,56,26077,56,5880
280.19,6,26,7272,12,158,25471,267,1277,14,775,21549,3445,5995
0.01,6,2,129,1,37,0,37,89,1,0,0,0,40
4.446,2,2,64,2,8,4446,8,64,0,0,0,0,0
0.989,6,26,9892,14,350,76,1041,1992,12,1058,73,1360,7900
179.118,17,4,240,2,32,179117,32,120,2,32,179117,32,120
8.246,17,2,672,2,308,8246,308,672,0,0,0,0,0
1790.097,17,136,10880,68,48,26717,48,5168,68,56,26717,56,5712
126.904,17,4,352,2,60,126903,60,176,2,60,126903,60,176
0.068,17,8,2454,8,278,9,317,2454,0,0,0,0,0
9.833,6,16,3911,9,275,1229,275,643,7,992,843,1440,3268
3.707,1,9,936,0,0,0,0,0,9,76,463,76,936
1720.43,17,12,498,11,14,172043,14,462,1,8,0,8,36
174.689,17,4,352,2,60,174688,60,176,2,60,174688,60,176
0.655,6,14,1745,7,288,79,288,600,7,426,78,434,1145
142.356,17,4,352,2,60,142355,60,176,2,60,142354,60,176
1311.91,6,312,18765,156,69,8463,69,9345,156,34,8463,48,9420
6.484,6,40,7416,21,218,324,314,3463,19,455,345,1179,3953
1639.488,2,13,416,13,8,136624,8,416,0,0,0,0,0
1799.944,1,57,4788,0,0,0,0,0,57,56,32141,56,4788
16.225,6,12,672,5,0,4056,0,280,7,0,2185,0,392
0.046,17,6,912,3,60,10,60,264,3,188,4,188,648
0.14,17,2,152,1,48,0,48,76,1,48,0,48,76
608.014,6,36,6665,20,229,32000,1314,2642,16,337,40518,2673,4023
1796.341,17,447,39296,404,35,4457,288,25708,43,288,41931,288,13588
1263.532,6,67,4977,44,31,29383,33,2972,23,36,57432,158,2005
95.067,6,2951,2650812,1828,1365,52,1368,2579870,1123,899,84,1473,70942
781.321,2,8,256,8,8,111617,8,256,0,0,0,0,0
1745.014,6,95,7203,63,38,28145,205,4476,32,33,56281,98,2727
1785.269,17,380,49825,181,181,9918,1350,37961,199,31,9014,87,11864
1796.505,17,449,39928,404,35,4457,288,25708,45,288,40019,288,14220
1744.307,6,95,7203,63,38,28133,205,4476,32,33,56260,98,2727
166.268,6,12,3073,2,92,39071,92,204,10,775,18454,1448,2869
0.705,6,12,1653,6,288,137,288,548,6,426,77,434,1105
742.953,6,62,9264,36,102,21227,501,3090,26,244,29714,1420,6174
1797.928,6,367,25650,214,99,8440,469,15045,153,69,11827,69,10605
1.531,6,40,9928,21,440,76,1360,4392,19,433,73,1360,5536
599.424,6,11,657,6,31,119884,31,333,5,31,149841,31,324
0.455,6,25,8441,12,285,41,763,1774,13,995,35,1368,6667
1787.785,17,87,3648,86,14,21032,14,3612,1,8,0,8,36
1796.709,1,9,504,9,28,224588,28,504,0,0,0,0,0
0.16,6,27,7296,14,155,12,267,1341,13,678,12,3436,5955
0.072,17,2,152,2,48,72,48,152,0,0,0,0,0
113.615,6,15,2311,7,339,133,752,1318,8,330,16212,509,993
1.616,6,18,3257,10,99,157,182,924,8,477,202,1343,2333
1781.711,6,354,22440,207,69,8649,69,12420,147,69,12203,69,10020
1744.586,2,26,832,26,8,69783,8,832,0,0,0,0,0
83.52,6,23,9823,12,410,61,922,1742,11,1089,8336,2720,8081
1740.202,1,68,3808,68,28,25973,28,3808,0,0,0,0,0
195.727,2,5,160,5,8,48931,8,160,0,0,0,0,0
1788.408,17,87,3648,86,14,21040,14,3612,1,8,0,8,36
388.367,6,24,1551,14,177,29874,177,913,10,110,9341,110,638
300.836,6,25,10824,13,297,25059,844,1743,12,1227,27336,1460,9081
300.662,6,39,8524,21,286,15033,797,2052,18,478,501,1928,6472
90.175,6,9,472,5,0,22543,0,256,4,0,30057,0,216
1799.757,6,289,36740,116,142,15648,1360,17362,173,144,10462,1360,19378
10.043,17,4,336,2,48,10011,48,152,2,64,10011,64,184
1791.137,1,242,25652,242,78,7432,78,25652,0,0,0,0,0
1.074,17,4,360,2,30,1013,30,116,2,94,1029,94,244
1259.41,2,11,352,11,8,125941,8,352,0,0,0,0,0
1756.108,6,105,6240,60,26,29763,26,3510,45,26,39908,26,2730
3.735,17,8,1838,4,46,1225,46,296,4,357,1241,369,1542
0.353,17,2,2728,2,1336,353,1336,2728,0,0,0,0,0
1740.739,17,29,19517,29,645,62169,645,19517,0,0,0,0,0
1785.398,6,147,13992,82,55,22039,205,6331,65,67,27893,170,7661
67.145,6,15,1928,9,483,8393,483,1442,6,83,13425,83,486
1771.448,6,101,9410,66,66,27253,66,5610,35,60,52098,60,3800
1.476,6,53,20878,29,926,52,1460,15097,24,437,55,2615,5781
896.416,17,70,5600,35,48,26364,48,2660,35,56,26364,56,2940
1796.089,17,142,11360,71,48,25658,48,5396,71,56,25658,56,5964
1744.253,6,97,7307,63,38,28133,205,4476,34,33,52847,98,2831
11.01,6,37,14233,18,156,647,187,1442,19,1090,567,3494,12791
0.049,17,2,246,1,67,0,67,95,1,123,0,123,151
1786.43,6,104,8444,68,66,26663,66,4964,36,60,51038,60,3480
8.893,6,32,8952,14,158,684,267,1357,18,624,519,1400,7595
816.086,6,175,13485,101,129,8160,469,8317,74,69,11159,69,5168
1.818,6,9,527,5,43,454,43,311,4,0,598,0,216
0.047,17,2,412,1,33,0,33,61,1,323,0,323,351
327.247,6,28,6562,11,220,5598,516,1325,17,325,20447,1452,5237
243.473,17,2,136,2,40,243473,47,136,0,0,0,0,0
2.986,17,4,624,4,128,995,128,624,0,0,0,0,0
0.003,6,7,12664,1,0,0,0,40,6,2052,0,2736,12624
1769.962,6,99,9240,66,65,27230,65,5577,33,59,55308,59,3663
777.506,1,20,1120,20,28,40921,28,1120,0,0,0,0,0
1.536,6,13,2311,8,188,219,245,700,5,1407,321,1407,1611
5.551,6,39,7269,21,218,277,314,3463,18,513,311,1179,3806
314.521,6,38,7410,21,142,15726,516,1985,17,338,19651,1452,5425
1681.508,1,7,392,7,28,280251,28,392,0,0,0,0,0
0.434,6,123,87749,56,131,7,232,2769,67,1327,6,1420,84980
3.874,17,8,1864,4,32,1290,32,240,4,378,1289,470,1624
3.634,17,10,1970,5,30,904,30,290,5,308,905,468,1680
14.446,6,16,884,9,0,1804,0,492,7,0,2405,0,392
0.014,6,9,1547,5,515,3,515,783,4,548,4,548,764
12.0,6,20,4442,10,275,1333,275,958,10,768,1205,1440,3484
1689.901,17,286,65138,286,199,5929,422,65138,0,0,0,0,0
45.854,17,62,16089,62,231,751,389,16089,0,0,0,0,0
0.926,6,34,13957,20,861,48,1460,7735,14,627,57,1460,6222
1798.634,6,1262,136436,522,115,3452,327,61926,740,110,2433,110,74510
40.306,6,41,9288,24,538,1752,1228,5551,17,203,2519,1282,3737
0.202,17,2,198,1,39,0,39,67,1,103,0,103,131
0.37,6,10,1185,6,279,74,279,587,4,191,59,272,598
649.392,1,53,2968,53,28,12488,28,2968,0,0,0,0,0
4.714,6,40,7325,21,218,235,314,3463,19,516,247,1179,3862
1773.01,17,203,47608,203,206,8777,422,47608,0,0,0,0,0
1.378,6,24,8004,12,164,107,267,1288,12,1014,105,2491,6716
126.66,2,2,64,2,8,126660,8,64,0,0,0,0,0
32.833,6,105,35687,51,633,656,1152,28656,54,442,614,1179,7031
130.528,17,6,1984,6,302,26105,308,1984,0,0,0,0,0
121.088,6,21,3037,13,302,10090,302,2190,8,83,17297,83,847
26.809,6,2,300,2,110,26809,110,300,0,0,0,0,0
280.777,6,25,7094,11,181,28077,267,1168,14,595,21576,1400,5926
0.023,1,6,1956,6,298,4,298,1956,0,0,0,0,0
11.636,6,25,8453,13,275,969,275,1078,12,983,773,1420,7375
1772.965,6,180,15480,120,69,14898,69,8940,60,69,30042,69,6540
0.464,6,14,1733,7,288,74,288,588,7,284,42,434,1145
556.382,6,121,13379,64,87,8149,267,4663,57,229,9935,1460,8716
1.161,6,11,1727,7,100,193,100,384,4,589,305,1152,1343
370.847,6,18,1242,14,180,28526,180,916,4,110,20062,110,326
12.014,17,4,1344,4,308,4004,308,1344,0,0,0,0,0
0.827,17,4,288,2,36,779,36,128,2,52,769,52,160
1263.399,2,12,384,12,8,114854,8,384,0,0,0,0,0
20.271,6,23,5534,13,107,1689,159,1126,10,967,2244,1709,4408
1794.567,1,136,7616,136,28,13293,28,7616,0,0,0,0,0
1771.336,6,99,9306,66,66,27251,66,5610,33,60,55351,60,3696
11.822,6,1908,1620840,1143,1363,10,1380,1585998,765,383,15,1380,34842
176.637,6,25,9794,13,532,53,1460,2682,12,945,16045,1460,7112
290.805,1,4,224,4,28,96935,28,224,0,0,0,0,0
1753.29,6,186,11385,94,47,18852,208,6775,92,31,19264,31,4610
280.315,6,29,7392,13,158,23359,267,1317,16,603,18685,1400,6075
40.478,6,25,7097,12,155,3679,267,1266,13,589,3372,3426,5831
2.91,17,3,1176,3,364,1455,364,1176,0,0,0,0,0
1770.412,6,143,8824,76,26,23604,26,4632,67,26,26823,26,4192
0.005,17,2,284,1,32,0,32,60,1,196,0,196,224
0.842,6,45,24075,25,154,35,265,1927,20,1623,43,2804,22148
1.323,6,52,21399,29,906,47,1360,15703,23,476,52,2715,5696
1.668,6,27,10176,16,284,111,585,1497,11,1029,149,1420,8679
0.03,17,4,284,2,32,15,32,120,2,54,18,60,164
0.156,6,23,7136,12,155,14,267,1261,11,905,14,4845,5875
1786.395,6,113,9050,72,66,25160,66,5190,41,60,44656,60,3860
0.596,6,10,924,5,283,103,283,551,5,105,101,105,373
1700.971,1,8,848,8,78,242995,78,848,0,0,0,0,0
0.081,6,10,1510,5,657,20,657,925,5,317,20,317,585
1796.466,6,363,23076,210,69,8595,69,12609,153,69,11817,69,10467
1.961,6,4,239,2,31,14,31,135,2,0,1961,0,104
0.121,6,3,151,2,31,0,31,111,1,0,0,0,40
1773.302,6,182,15698,120,69,14901,69,8940,62,69,29062,69,6758
1.469,6,50,21300,28,966,54,1460,15644,22,433,60,1460,5656
1764.238,2,15,480,15,8,126017,8,480,0,0,0,0,0
116.15,1,6,336,6,28,23230,28,336,0,0,0,0,0
1794.553,17,180,14040,180,50,10025,50,14040,0,0,0,0,0
0.145,17,4,336,2,34,0,34,124,2,78,124,84,212
1771.119,6,101,9344,66,65,27247,65,5577,35,59,52089,59,3767
37.928,6,2048,1755388,1276,1294,29,1368,1708164,772,776,48,1473,47224
0.014,17,3,265,2,39,0,39,134,1,103,0,103,131
0.141,17,2,182,1,39,0,39,67,1,87,0,87,115
1.252,6,23,7952,12,164,96,267,1288,11,1216,106,3819,6664
0.029,17,4,314,2,31,1,31,118,2,70,3,70,196
23.012,6,3473,3334375,2307,1369,9,1408,3269079,1166,931,19,2801,65296
1770.915,6,104,9815,68,69,26431,233,5914,36,59,50594,82,3901
19.253,6,3192,3074275,2124,1371,8,1408,3014075,1068,931,17,2801,60200
41.687,17,4,240,2,32,41686,32,120,2,32,41685,32,120
0.23,6,23,4494,11,165,23,456,1394,12,493,20,888,3100
0.104,6,9,1340,5,145,26,145,349,4,827,24,827,991
409.222,17,11,836,11,48,40922,48,836,0,0,0,0,0
4.989,17,4,288,2,36,4988,36,128,2,52,4988,52,160
260.938,17,4,240,2,32,260937,32,120,2,32,260937,32,120
17.987,17,41,31476,20,671,945,1350,13988,21,804,897,1350,17488
368.545,6,25,1651,17,177,23034,177,1117,8,110,9194,110,534
114.88,17,4,240,2,32,114879,32,120,2,32,114879,32,120
1599.481,1,8,848,8,78,228497,78,848,0,0,0,0,0
281.333,6,33,7552,14,158,21641,267,1357,19,543,15629,1400,6195
50.278,17,4,352,2,60,50277,60,176,2,60,50277,60,176
0.242,6,33,7949,17,278,15,517,1815,16,548,15,1883,6134
0.004,17,4,284,2,32,0,32,120,2,54,1,60,164
169.475,6,23,10128,12,549,68,1360,2709,11,1393,16932,3934,7419
1.026,17,5,980,3,32,510,32,180,2,372,4,470,800
0.015,17,2,372,1,39,0,39,67,1,277,0,277,305
1785.678,6,102,8296,68,65,26651,65,4930,34,59,54108,59,3366
378.505,2,4,128,4,8,126168,8,128,0,0,0,0,0
367.257,6,19,1303,14,177,28250,177,925,5,110,15162,110,378
0.05,6,2,80,1,0,0,0,40,1,0,0,0,40
36.547,17,22,1936,11,48,3646,48,836,11,72,3653,72,1100
1.127,6,10,1687,7,100,187,100,384,3,1179,430,1179,1303
1798.81,17,448,39896,403,35,4474,288,25676,45,288,40016,288,14220
279.804,1,4,224,4,28,93268,28,224,0,0,0,0,0
53.981,6,28,7217,13,155,4498,267,1306,15,482,3855,1997,5911
1779.603,17,87,3642,85,14,21185,14,3570,2,8,21041,8,72
371.515,6,23,1499,14,177,28578,177,913,9,110,8626,110,586
1682.271,17,16,1265,8,30,240319,37,471,8,71,240319,136,794
178.83,6,1649,813091,885,847,202,1152,774964,764,398,234,1179,38127
0.037,17,2,263,1,36,0,36,64,1,171,0,171,199
3.282,6,5,216,2,0,3282,0,84,3,0,1516,0,132
280.544,6,28,7352,12,158,25504,267,1277,16,603,18696,1400,6075
30.419,1,15,1560,0,0,0,0,0,15,76,2172,76,1560
1.37,6,48,19967,27,945,52,1440,14351,21,433,58,1440,5616
49.226,6,29,6911,14,147,3783,517,1619,15,641,3512,1418,5292
1784.112,6,358,22669,209,69,8577,69,12569,149,69,12054,69,10100
23.864,6,30,8872,14,158,1835,267,1357,16,858,1584,3456,7515
0.004,17,2,243,1,49,0,49,77,1,138,0,138,166
6.558,6,38,7229,20,218,345,314,3423,18,513,367,1179,3806
266.175,17,4,240,2,32,266174,32,120,2,32,266174,32,120
1797.847,17,112,8960,56,48,32687,48,4256,56,56,32687,56,4704
64.731,6,25,12219,7,267,7364,502,1086,18,693,3803,1420,11133
1739.337,6,87,6322,58,31,30514,31,3915,29,31,62118,31,2407
1780.106,1,342,28728,342,56,5220,56,28728,0,0,0,0,0
1681.217,17,14,3843,7,30,280202,30,406,7,463,280202,463,3437
11.674,6,2,80,1,0,0,0,40,1,0,0,0,40
1794.543,6,369,25937,213,99,8464,469,15005,156,69,11577,69,10932
13.631,17,4,824,2,48,13616,48,152,2,308,13613,308,672
280.516,6,29,7392,13,158,23376,267,1317,16,678,18696,3536,6075
0.099,17,2,448,1,64,0,64,92,1,328,0,328,356
1754.254,6,121,12143,75,63,23706,722,6268,46,96,38974,1448,5875
0.34,17,4,1016,2,64,335,64,184,2,388,334,388,832
60.394,6,15,4031,8,307,8627,722,1333,7,1165,10035,1408,2698
1786.801,6,102,8228,68,64,26668,64,4896,34,58,54143,58,3332
0.052,6,2,80,1,0,0,0,40,1,0,0,0,40
10.774,6,20,4442,11,275,1077,275,998,9,768,756,1440,3444
75.138,6,17,700,7,0,7080,0,284,10,0,8347,0,416
1772.422,6,180,15480,120,69,14894,69,8940,60,69,30035,69,6540
0.315,17,2,166,1,39,0,39,67,1,71,0,71,99
1767.07,17,46,15440,46,307,39268,308,15440,0,0,0,0,0
11.862,6,1872,1638303,1137,1387,10,1420,1604682,735,467,16,1883,33621
31.516,6,7,308,1,0,0,0,44,6,0,6284,0,264
1786.525,6,102,8296,68,65,26664,65,4930,34,59,54134,59,3366
1787.343,17,87,3648,86,14,21027,14,3612,1,8,0,8,36
0.308,17,2,180,1,30,0,30,58,1,94,0,94,122
0.092,6,2,80,1,0,0,0,40,1,0,0,0,40
156.317,17,4,352,2,60,156315,60,176,2,60,156316,60,176
0.105,6,12,1969,6,127,20,127,459,6,1190,21,1190,1510
1.005,17,2,677,1,300,0,300,328,1,321,0,321,349
112.647,6,48,7761,19,145,6248,722,2320,29,206,4016,2026,5441
2.993,6,35,18095,18,767,176,1460,6124,17,1127,177,1460,11971
1115.24,1,130,7280,130,28,8645,28,7280,0,0,0,0,0
16.687,17,17,6452,8,483,2374,1350,4094,9,234,2076,1350,2358
3.913,17,10,1415,5,31,977,31,295,5,196,977,196,1120
64.144,6,80534,98769885,24268,146,2,214,1307164,56266,1681,1,8448,97462721
290.628,1,4,326,4,53,96876,78,326,0,0,0,0,0
250.903,17,4,352,2,60,250902,60,176,2,60,250902,60,176
240.262,6,57,19689,31,839,8008,1418,16749,26,175,9609,580,2940
962.594,2,8,256,8,8,137513,8,256,0,0,0,0,0
11.837,6,1721,1622692,1134,1380,10,1432,1594720,587,389,20,1432,27972
1798.889,17,66,2766,65,14,28107,14,2730,1,8,0,8,36
1.078,17,2,154,1,33,0,33,61,1,65,0,65,93
383.982,6,6,861,6,103,76796,138,861,0,0,0,0,0
2.989,6,2,88,2,0,0,0,88,0,0,0,0,0
39.82,17,44,6468,22,48,1895,48,1672,22,190,1895,308,4796
854.165,6,120,11242,44,83,19861,339,4781,76,87,11388,1062,6461
1786.1,6,362,24774,211,94,8505,469,14387,151,69,11906,69,10387
2.457,6,13,2311,8,188,351,245,700,5,1407,551,1407,1611
1772.009,6,180,15480,120,69,14890,69,8940,60,69,30033,69,6540
280.323,6,29,7392,13,158,23360,267,1317,16,603,18684,2036,6075
294.08,2,3,96,3,8,147040,8,96,0,0,0,0,0
6.268,6,1248,1126474,773,1379,7,1408,1097110,475,931,12,2816,29364
281.078,6,30,7773,13,158,23423,267,1317,17,577,17553,1400,6456
1789.18,17,83,3480,82,14,22088,14,3444,1,8,0,8,36
12.272,6,22,11812,8,275,1753,275,599,14,1064,843,2840,11213
1772.853,6,105,6270,60,27,30047,27,3525,45,27,40290,27,2745
373.036,6,7,280,7,0,0,0,280,0,0,0,0,0
280.227,6,27,7312,13,158,23352,267,1317,14,775,21554,4836,5995
1771.15,1,67,5628,0,0,0,0,0,67,56,26835,56,5628
0.013,17,2,383,1,47,0,47,75,1,280,0,280,308
195.585,6,31,8912,14,158,15045,267,1357,17,687,12219,1781,7555
123.646,17,4,352,2,60,123645,60,176,2,60,123644,60,176
4.175,17,5,290,5,30,1043,30,290,0,0,0,0,0
1015.596,6,188,12626,97,69,10133,69,6157,91,69,11284,69,6469
240.163,6,56,18744,30,745,8281,1408,15739,26,205,9606,580,3005
46.22,6,51,13663,25,937,649,1460,7666,26,290,1841,1460,5997
1800.0,6,329,22610,140,46,12696,46,9300,189,46,9574,46,13310
0.029,17,2,200,1,64,0,64,92,1,80,0,80,108
124.53,6,59,11171,24,222,5414,1189,3418,35,288,3661,1420,7753
0.161,1,2,112,2,28,161,28,112,0,0,0,0,0
1791.547,17,144,11520,72,48,25232,48,5472,72,56,25232,56,6048
0.179,1,2,112,2,28,179,28,112,0,0,0,0,0
39.62,17,22,1936,11,48,3961,48,836,11,72,3960,72,1100
0.799,17,2,134,2,39,799,39,134,0,0,0,0,0
0.017,17,2,178,1,29,0,29,57,1,93,0,93,121
240.199,6,54,17953,29,758,8578,1408,15173,25,184,10008,580,2780
15.279,6,1689,1550698,1018,1440,14,1448,1509178,671,776,22,1448,41520
1.674,6,52,18911,29,854,59,1360,13170,23,400,65,1360,5741
0.492,17,4,368,2,32,187,32,120,2,96,149,96,248
0.779,6,11,1727,7,100,129,100,384,4,589,174,1152,1343
1.339,6,50,21113,28,953,49,1460,15457,22,433,55,1460,5656
1639.931,1,8,448,8,28,234275,28,448,0,0,0,0,0
1476.185,17,272,61461,272,197,5447,361,61461,0,0,0,0,0
184.12,17,4,352,2,60,184119,60,176,2,60,184119,60,176
224.354,17,4,240,2,32,224353,32,120,2,32,224353,32,120
1796.788,17,445,39232,401,35,4491,288,25328,44,288,40016,288,13904
14.683,6,23,8325,13,275,1223,275,1078,10,1367,1075,1420,7247
1798.375,17,450,39960,405,35,4451,288,25740,45,288,40018,288,14220
1791.072,6,889,187029,461,425,3893,1455,91990,428,234,4193,1610,95039
1764.35,2,13,416,13,8,147029,8,416,0,0,0,0,0
0.199,6,4,480,3,288,99,288,428,1,0,0,0,52
193.772,17,4,1635,4,380,64590,392,1635,0,0,0,0,0
0.089,6,12,3462,6,75,17,75,395,6,1373,17,1448,3067
1789.273,17,142,11360,71,48,25560,48,5396,71,56,25560,56,5964
280.752,6,29,7392,13,158,23396,267,1317,16,603,18710,2036,6075
0.753,17,2,136,1,32,0,32,60,1,48,0,48,76
33.605,6,32,5348,16,154,2240,722,1912,16,371,2227,2026,3436
0.033,6,12,3462,6,75,6,75,395,6,1373,6,1448,3067
1749.509,6,193,12497,97,57,18224,208,7727,96,31,18413,31,4770
755.724,2,5,160,5,8,188931,8,160,0,0,0,0,0
6.097,6,17,2660,11,211,609,211,1249,6,545,1148,904,1411
1.003,17,5,968,3,32,499,32,180,2,366,6,486,788
0.673,6,2,92,1,0,0,0,40,1,0,0,0,52
175.23,17,2,72,1,8,0,8,36,1,8,0,8,36
289.562,1,4,224,4,28,96520,28,224,0,0,0,0,0
1799.989,1,16,896,16,28,119999,28,896,0,0,0,0,0
1.39,6,53,23889,30,997,47,1460,18193,23,433,54,1460,5696
0.371,17,23,15473,13,959,30,1350,12843,10,235,37,1350,2630
2.838,6,36,18336,19,768,157,1360,6181,17,1432,168,3132,12155
0.014,17,4,632,3,60,6,60,264,1,340,0,340,368
0.608,6,31,8912,14,158,46,267,1357,17,687,33,1400,7555
20.16,6,21,5577,12,115,1832,159,1221,9,967,2518,1675,4356
1739.21,6,87,6322,58,31,30512,31,3915,29,31,62113,31,2407
66.894,6,27,7177,13,155,5574,267,1306,14,530,5144,3417,5871
1789.779,17,142,11360,71,48,25567,48,5396,71,56,25567,56,5964
1.274,6,10,1687,7,100,212,100,384,3,1179,510,1179,1303
0.011,6,3,144,2,0,6,0,104,1,0,0,0,40
88.755,6,24,9042,12,666,97,1360,3176,12,895,8052,1747,5866
1749.066,6,97,7338,64,38,27762,205,4528,33,33,54475,98,2810
1740.634,17,29,6815,29,207,62165,207,6815,0,0,0,0,0
280.777,6,29,7392,13,158,23398,267,1317,16,603,18715,2036,6075
50.332,6,49,23112,28,1165,335,1360,17470,21,435,2508,2667,5642
1771.699,6,101,9278,66,64,27256,64,5544,35,58,52104,58,3734
0.604,6,12,1048,6,256,119,256,500,6,304,119,304,548
0.204,6,10,1755,5,657,51,657,925,5,562,51,562,830
1740.768,17,29,6699,29,203,62170,203,6699,0,0,0,0,0
17.068,6,2710,2606495,1801,1371,9,1408,2554563,909,776,18,1408,51932
1.322,6,5,260,2,0,990,0,104,3,0,661,0,156
368.712,6,23,1535,16,177,24580,177,1053,7,110,10372,110,482
282.251,6,30,7432,13,158,23520,267,1317,17,543,17622,1400,6115
2.76,17,26,10933,12,556,250,1350,7010,14,252,161,1350,3923
0.111,17,4,284,2,32,60,32,120,2,54,55,60,164
1773.538,6,208,24030,132,89,13538,981,11118,76,137,23642,1917,12912
280.226,6,30,7432,13,158,23352,267,1317,17,543,17510,1400,6115
343.986,6,87,30709,43,589,8188,1418,11080,44,722,7998,1418,19629
1789.177,6,355,22480,207,69,8685,69,12420,148,69,12171,69,10060
16.286,17,21,5066,10,248,1806,1350,2761,11,181,1625,1350,2305
2.045,6,322,273916,202,1344,10,1432,264825,120,427,16,1432,9091
3.506,6,31,11977,16,424,233,722,1916,15,945,235,2760,10061
1793.984,6,239,24776,96,68,18882,659,9140,143,135,12632,2720,15636
155.274,2,4,128,4,8,51758,8,128,0,0,0,0,0
142.085,17,12,2000,6,48,28415,48,456,6,229,28415,308,1544
7.31,6,47,8580,24,227,317,314,4142,23,439,320,1179,4438
1785.855,6,366,23196,212,69,8463,69,12896,154,69,11672,69,10300
0.323,6,27,9112,13,271,26,726,1771,14,943,24,1408,7341
1.438,6,52,20987,28,939,53,1460,15251,24,433,54,1460,5736
0.395,6,10,968,5,256,97,256,460,5,304,97,304,508
0.232,17,4,350,2,34,1,34,124,2,85,38,91,226
140.296,6,25,9789,12,531,69,1460,2637,13,945,11680,1460,7152
1.14,6,22,7900,11,164,96,267,1236,11,1216,96,3819,6664
0.861,6,11,1727,7,100,143,100,384,4,589,205,1152,1343
7.289,6,1329,1205731,807,1414,8,1448,1173923,522,776,13,1448,31808
118.387,6,23,6168,13,186,9865,502,1458,10,615,13132,1420,4710
31.903,6,263,246262,129,127,249,304,7314,134,1784,239,4224,238948
7.819,6,2,1175,1,0,0,0,40,1,1095,0,1095,1135
0.027,17,4,344,2,47,12,47,150,2,69,15,75,194
113.152,6,35,23880,19,840,34,1360,5835,16,1932,7534,8160,18045
1798.327,6,288,36116,117,141,15502,1360,16728,171,142,10577,1360,19388
8.352,6,1735,1599463,1098,1379,7,1408,1561675,637,931,12,2816,37788
8.118,6,41,7349,21,218,405,314,3463,20,440,413,1152,3886
35.676,17,40,5880,20,48,1877,48,1520,20,190,1877,308,4360
1773.188,6,180,15480,120,69,14900,69,8940,60,69,30046,69,6540
1.942,17,2,312,2,128,1942,128,312,0,0,0,0,0
0.874,6,10,1687,7,100,145,100,384,3,1179,316,1179,1303
1772.529,6,177,15153,118,69,15149,69,8722,59,69,30560,69,6431
0.017,6,16,6662,8,138,2,138,562,8,1136,2,1448,6100
626.614,6,39,3079,25,65,26108,65,1780,14,56,48193,59,1299
0.114,17,2,672,2,308,114,308,672,0,0,0,0,0
1785.862,6,376,26548,216,104,8306,469,15732,160,69,11231,69,10816
1792.639,17,77,3238,74,14,24556,15,3110,3,14,345514,18,128
46.989,6,42,10255,21,736,439,1360,4568,21,371,2341,1360,5687
9.413,17,4,5484,4,1343,3137,1348,5484,0,0,0,0,0
21.144,6,39,8767,16,412,46,889,1908,23,329,954,1928,6859
383.191,6,12,864,6,112,76635,112,584,6,0,76636,0,280
160.461,17,4,240,2,32,160460,32,120,2,32,160460,32,120
12.356,6,1840,1655309,1165,1368,10,1380,1623191,675,421,18,1923,32118
0.0,17,2,120,1,32,0,32,60,1,32,0,32,60
1795.663,6,390,27991,222,107,8125,469,16717,168,69,10749,69,11274
20.188,6,21,5418,12,107,1835,159,1074,9,773,2515,1418,4344
1794.422,1,176,9856,176,28,10253,28,9856,0,0,0,0,0
310.615,6,18,1308,12,31,28237,31,810,6,31,62117,31,498
60.977,17,3,181,3,32,30488,33,181,0,0,0,0,0
1797.684,6,370,25908,215,99,8400,469,15085,155,69,11670,69,10823
363.739,6,16,1138,12,180,33067,180,812,4,110,20112,110,326
145.766,1,20,1680,20,56,7671,56,1680,0,0,0,0,0
8.678,6,46,9617,22,227,413,314,4062,24,573,365,1179,5555
0.282,6,25,8960,13,252,23,646,1694,12,1105,25,2804,7266
7.76,6,14,1226,9,275,970,275,918,5,96,1434,96,308
1.241,6,10,3600,4,171,408,171,387,6,964,247,1448,3213
0.249,6,22,5040,11,137,24,267,1132,11,577,24,1400,3908
37.561,17,4,352,2,60,37560,60,176,2,60,37560,60,176
1787.193,6,102,8296,68,65,26674,65,4930,34,59,54154,59,3366
1775.194,17,73,3060,72,14,25002,14,3024,1,8,0,8,36
280.246,6,28,7352,13,158,23353,267,1317,15,678,20014,2800,6035
3.246,6,35,18960,20,707,170,1360,5795,15,1394,220,2720,13165
0.088,17,2,672,2,308,88,308,672,0,0,0,0,0
31.371,6,37,8310,21,175,1568,517,2326,16,570,2071,1418,5984
61.893,6,71,50929,46,1191,1375,1408,42898,25,960,2569,3847,8031
0.059,17,4,284,2,32,52,32,120,2,54,52,60,164
11.835,6,1869,1635207,1110,1418,10,1432,1600614,759,420,15,1432,34593
240.221,6,57,17994,29,746,8578,1418,14960,28,196,8896,580,3034
1772.389,6,180,15480,120,69,14894,69,8940,60,69,30032,69,6540
16.227,6,11,674,4,112,5403,112,280,7,90,2701,90,394
62.549,6,77,52630,47,1196,1359,1368,44334,30,841,2148,2519,8296
2.23,17,3,180,3,32,1115,32,180,0,0,0,0,0
0.31,17,8,2758,8,316,44,355,2758,0,0,0,0,0
1745.164,1,8,448,8,28,249309,28,448,0,0,0,0,0
315.224,6,9,468,9,0,0,0,468,0,0,0,0,0
130.043,17,4,352,2,60,130042,60,176,2,60,130042,60,176
1772.654,6,180,15480,120,69,14896,69,8940,60,69,30041,69,6540
67.505,17,4,304,2,48,67503,64,152,2,48,67504,64,152
1794.285,17,66,2766,65,14,28035,14,2730,1,8,0,8,36
1774.035,1,58,4872,58,56,31123,56,4872,0,0,0,0,0
2.367,6,26,10016,15,284,169,585,1457,11,1014,217,1420,8559
1776.916,17,140,11200,70,48,25752,48,5320,70,56,25752,56,5880
2.026,17,4,314,2,31,2014,31,118,2,70,2015,70,196
1.278,6,50,19453,27,902,49,1360,13757,23,433,50,1360,5696
276.798,6,42,7651,21,147,13837,517,1995,21,456,13837,1418,5656
1740.551,6,87,6322,58,31,30535,31,3915,29,31,62162,31,2407
2.618,6,131,89354,66,131,40,232,3169,65,1393,35,2755,86185
1784.896,6,357,22629,208,69,8622,69,12460,149,69,12057,69,10169
5.438,6,39,8421,20,218,286,314,3423,19,604,288,1179,4998
1774.442,6,170,18547,88,67,20395,722,6991,82,188,21901,1380,11556
3.197,17,5,295,5,31,799,31,295,0,0,0,0,0
31.652,6,7,308,1,0,0,0,44,6,0,6311,0,264
2.086,17,4,706,3,39,1000,39,201,1,477,0,477,505
925.314,6,61,8647,30,248,31905,517,2563,31,744,30841,1368,6084
1468.435,17,116,9280,58,48,25761,48,4408,58,56,25761,56,4872
0.19,17,2,154,1,33,0,33,61,1,65,0,65,93
52.497,6,27,7177,13,155,4374,267,1306,14,530,4037,3417,5871
3.139,17,18,9941,9,735,392,1350,6869,9,313,273,1350,3072
1787.227,17,87,3648,86,14,21026,14,3612,1,8,0,8,36
0.094,6,12,3631,6,99,18,99,419,6,964,15,1448,3212
0.387,17,4,284,2,32,0,32,120,2,54,0,60,164
281.542,6,31,7733,15,175,20110,267,1658,16,678,18767,3456,6075
1082.988,6,63,5082,42,64,26414,64,3024,21,58,54144,58,2058
1750.536,17,12,498,11,14,175053,14,462,1,8,0,8,36
1783.444,17,83,3480,82,14,22017,14,3444,1,8,0,8,36
1773.17,1,60,5040,0,0,0,0,0,60,56,30053,56,5040
475.442,6,49,8425,19,139,17791,516,2157,30,220,16391,1452,6268
4.903,17,5,4754,5,922,1225,1451,4754,0,0,0,0,0
0.181,17,2,152,1,48,0,48,76,1,48,0,48,76
17.97,6,7,308,7,0,0,0,308,0,0,0,0,0
0.119,17,4,284,2,32,65,32,120,2,54,57,60,164
1035.45,2,13,416,13,8,86287,8,416,0,0,0,0,0
1773.475,6,180,15480,120,69,14903,69,8940,60,69,30051,69,6540
84.582,17,4,240,2,32,84581,32,120,2,32,84581,32,120
3.66,17,5,290,5,30,915,30,290,0,0,0,0,0
0.037,6,13,3980,7,88,6,88,388,6,1670,7,1880,3592
1770.262,6,101,9344,66,65,27234,65,5577,35,59,52062,59,3767
2.379,17,3,543,2,39,1841,39,134,1,381,0,381,409
371.067,6,21,1419,15,177,26504,177,989,6,110,12250,110,430
1613.349,17,438,44937,203,126,7972,1350,31385,235,29,6878,60,13552
502.212,17,6,525,3,32,251098,37,181,3,86,251102,136,344
38.966,6,29,7257,14,155,2997,267,1346,15,482,2782,1997,5911
1773.583,6,180,15480,120,69,14904,69,8940,60,69,30058,69,6540
180.001,17,2,672,2,308,180001,308,672,0,0,0,0,0
40.545,17,6,528,3,48,20268,48,228,3,72,20267,72,300
1770.532,6,128,7816,70,26,25659,26,4192,58,26,31061,26,3624
1772.231,6,180,15480,120,69,14892,69,8940,60,69,30035,69,6540
1.353,6,50,21339,29,908,48,1360,15723,21,476,57,2720,5616
105.715,6,98,71775,63,1245,1705,1408,61815,35,739,2679,2439,9960
0.576,6,10,1386,5,145,144,145,349,5,833,76,833,1037
1780.039,17,142,11360,71,48,25429,48,5396,71,56,25428,56,5964
176.233,17,4,352,2,60,176232,60,176,2,60,176232,60,176
3.196,6,2,88,2,0,0,0,88,0,0,0,0,0
358.974,6,50,6535,27,109,13806,722,2714,23,174,16308,1440,3821
1786.899,6,104,8376,68,65,26670,65,4930,36,59,51050,59,3446
12.581,17,6,528,3,48,6283,48,228,3,72,6283,72,300
271.829,17,4,352,2,60,271828,60,176,2,60,271828,60,176
3.38,17,28,16666,12,442,307,1350,5640,16,661,217,1350,11026
1784.551,6,356,22520,208,69,8621,69,12460,148,69,12138,69,10060
1798.517,17,448,39896,403,35,4473,288,25676,45,288,40022,288,14220
1.473,1,9,756,9,56,184,56,756,0,0,0,0,0
1769.665,6,99,9306,66,66,27225,66,5610,33,60,55297,60,3696
20.706,6,3007,2699990,1775,1433,11,1448,2625198,1232,776,16,1448,74792
532.437,6,58,4512,32,65,17175,65,2320,26,60,21291,118,2192
0.413,6,37,8012,20,350,21,1414,2556,17,477,25,1491,5456
96.936,6,14,839,8,31,13824,31,506,6,31,15863,31,333
0.215,6,40,14547,22,870,10,1420,9606,18,420,12,1420,4941
280.835,6,32,7603,14,158,21602,267,1357,18,552,16513,2076,6246
1782.299,17,280,56913,280,175,6388,422,56913,0,0,0,0,0
300.302,6,106,119347,51,145,6005,230,3252,55,2177,5561,5608,116095
1794.075,17,87,3648,86,14,21106,14,3612,1,8,0,8,36
1788.41,17,87,3648,86,14,21040,14,3612,1,8,0,8,36
202.016,6,91,66399,57,1244,3607,1368,57751,34,841,1925,2736,8648
1772.428,6,180,15480,120,69,14894,69,8940,60,69,30038,69,6540
0.232,6,18,6970,11,249,23,517,1482,7,1039,37,2676,5488
1740.744,6,143,9824,76,64,23209,208,6121,67,31,26372,31,3703
3.336,6,58,22825,29,981,119,1440,16889,29,433,112,1440,5936
1724.787,1,8,448,8,28,246398,28,448,0,0,0,0,0
1679.691,1,7,392,7,28,279948,28,392,0,0,0,0,0
1.128,6,25,8056,12,164,87,267,1288,13,869,79,1440,6768
0.018,17,2,214,1,39,0,39,67,1,119,0,119,147
0.152,17,2,362,1,46,0,46,74,1,260,0,260,288
26.142,6,1422,1246913,917,1285,28,1368,1215989,505,776,51,1473,30924
126.452,2,2,64,2,8,126452,8,64,0,0,0,0,0
1682.686,17,14,1036,7,30,280438,30,406,7,62,280438,62,630
1723.96,1,19,1802,19,66,95775,100,1802,0,0,0,0,0
1744.584,2,15,480,15,8,124613,8,480,0,0,0,0,0
240.258,6,60,18938,31,744,8008,1418,15765,29,207,8580,580,3173
97.384,6,25,6271,9,267,89,501,1165,16,343,6487,1420,5106
303.226,6,338,285278,221,1316,1378,1360,274880,117,300,95,2667,10398
1790.892,6,262,24719,159,75,11334,267,11286,103,134,17557,1997,13433
1798.49,17,449,39928,404,35,4462,288,25708,45,288,40015,288,14220
135.99,6,19,8625,10,316,84,639,1368,9,1377,16983,2720,7257
201.995,6,3,449,2,152,201825,177,409,1,0,0,0,40
5.961,17,3,1008,3,308,2980,308,1008,0,0,0,0,0
377.207,6,18,1242,14,180,29015,180,916,4,110,20056,110,326
1747.47,6,95,7203,63,38,28185,205,4476,32,33,56359,98,2727
54.01,6,6842,6459878,4478,1364,12,1408,6332262,2364,931,22,2816,127616
0.412,6,13,1693,7,288,68,288,588,6,284,42,434,1105
1747.785,6,93,7037,61,38,29129,205,4341,32,33,56372,98,2696
0.226,6,10,2046,6,739,44,1322,1723,4,159,75,159,323
0.705,6,121,87437,54,131,13,232,2689,67,1345,9,1420,84748
114.682,17,20,1520,20,48,6035,48,1520,0,0,0,0,0
1794.474,6,375,23694,214,69,8424,69,13114,161,69,11215,69,10580
1680.09,1,7,392,7,28,280015,28,392,0,0,0,0,0
22.727,17,4,240,2,32,22726,32,120,2,32,22726,32,120
1771.512,1,58,4872,0,0,0,0,0,58,56,31079,56,4872
343.609,6,73,5054,36,74,9817,138,2337,37,65,9540,69,2717
1773.017,6,181,15589,120,69,14899,69,8940,61,69,29535,69,6649
367.298,6,25,1651,17,177,22956,177,1117,8,110,9174,110,534
298.893,1,4,224,4,28,99631,28,224,0,0,0,0,0
516.253,17,5,204,4,14,172020,14,168,1,8,0,8,36
1750.225,6,183,11234,92,47,19233,208,6695,91,31,19444,31,4539
1788.931,1,278,29468,278,78,6458,78,29468,0,0,0,0,0
1756.605,6,110,6530,60,27,29772,27,3525,50,27,35848,27,3005
1787.273,17,87,3648,86,14,21026,14,3612,1,8,0,8,36
0.419,6,6,324,4,0,139,0,216,2,0,226,0,108
1203.209,2,12,384,12,8,109382,8,384,0,0,0,0,0
35.731,6,27,10305,15,681,2552,1360,3369,12,1074,3222,3601,6936
251.85,2,2,64,2,8,251850,8,64,0,0,0,0,0
0.312,6,12,3704,6,171,57,171,491,6,964,53,1448,3213
0.215,6,3,804,2,414,215,414,494,1,270,0,270,310
1701.554,17,12,498,11,14,170155,14,462,1,8,0,8,36
1785.373,6,299,20879,179,75,10030,501,11870,120,69,15002,69,9009
0.053,17,2,180,1,30,0,30,58,1,94,0,94,122
2.173,17,3,201,3,39,1086,39,201,0,0,0,0,0
8.346,6,1937,1664680,1085,1438,7,1448,1606976,852,776,9,1448,57704
272.59,6,25,1743,9,332,34071,332,820,16,83,18171,83,923
0.0,17,1,1058,1,1030,0,1030,1058,0,0,0,0,0
71.955,6,48,15616,24,707,111,1408,7648,24,372,3120,1408,7968
121.217,6,22,9157,11,201,63,290,1075,11,1090,12108,1460,8082
3.921,6,28,7336,13,155,326,267,1301,15,543,272,1400,6035
0.316,6,27,8992,13,237,26,590,1635,14,945,23,2816,7357
400.993,6,108,16053,43,192,9547,1189,6164,65,186,6261,1460,9889
353.689,6,21,6571,2,106,1679,106,194,19,350,19648,1420,6377
11.575,6,25,8453,13,275,964,275,1078,12,983,752,1420,7375
0.037,17,6,912,3,60,6,60,264,3,188,10,188,648
77.011,17,24,8778,24,337,3348,360,8778,0,0,0,0,0
2.012,6,10,913,5,39,502,39,307,5,338,502,338,606
4.32,6,13,3463,6,188,864,245,620,7,853,676,1152,2843
1786.472,6,115,13715,75,81,24141,501,5950,40,162,45804,1420,7765
993.454,6,53,3829,35,31,29219,31,2335,18,31,58428,31,1494
8.281,6,77,24834,39,568,217,1152,19173,38,459,216,1179,5661
0.012,6,17,7212,9,132,1,132,608,8,1236,1,1734,6604
0.052,6,12,3704,6,171,9,171,491,6,964,4,1448,3213
4.926,17,2,656,2,300,4926,300,656,0,0,0,0,0
1788.754,17,87,3648,86,14,21044,14,3612,1,8,0,8,36
873.572,6,112,14510,68,83,13038,267,5576,44,188,20314,1460,8934
1.256,6,27,9624,13,164,89,267,1396,14,936,82,1408,8228
0.538,17,4,368,2,32,522,32,120,2,96,517,96,248
0.224,17,2,204,1,34,0,34,62,1,114,0,114,142
0.895,6,10,1687,7,100,149,100,384,3,1179,319,1179,1303
0.016,17,2,170,1,37,0,37,65,1,77,0,77,105
0.63,6,21,5000,11,137,63,267,1132,10,692,56,1467,3868
1.678,6,25,6448,13,297,139,830,2011,12,790,151,1420,4437
46.674,6,33,7807,18,449,2745,1402,5428,15,227,3234,580,2379
1798.233,17,449,39928,404,35,4462,288,25708,45,288,40022,288,14220
9.963,6,81,24445,40,533,255,1152,18664,41,459,242,1179,5781
1796.091,17,447,39580,403,35,4467,288,25676,44,288,40951,288,13904
0.014,17,2,208,1,60,0,60,88,1,92,0,92,120
0.169,17,2,268,1,54,0,54,82,1,158,0,158,186
21.843,6,18,2474,11,210,2180,210,1016,7,545,2947,904,1458
1780.437,1,58,4872,58,56,31235,56,4872,0,0,0,0,0
1795.854,6,754,51099,377,31,4776,31,25654,377,31,4775,31,25445
280.256,6,23,7014,10,181,31139,267,1128,13,670,23348,1400,5886
0.606,17,2,204,1,34,0,34,62,1,114,0,114,142
1681.599,17,14,3843,7,30,280265,30,406,7,463,280265,463,3437
240.323,6,46,8551,24,449,10448,1418,5752,22,205,11443,580,2799
1782.321,17,83,3480,82,14,22003,14,3444,1,8,0,8,36
1746.723,6,95,7203,63,38,28172,205,4476,32,33,56332,98,2727
192.629,1,8,1041,8,102,27518,117,1041,0,0,0,0,0
300.843,6,48,13193,25,783,12535,1360,7347,23,307,492,1360,5846
1776.159,17,73,3060,72,14,25016,14,3024,1,8,0,8,36
6.022,6,1781,1668110,1139,1387,5,1408,1630062,642,776,9,1408,38048
31.444,6,7,336,1,0,0,0,48,6,0,6286,0,288
4.555,6,9,6638,2,92,341,92,204,7,1213,728,1408,6434
2.699,6,25,6565,12,262,241,517,1420,13,744,221,1418,5145
38.342,17,22,1672,22,48,1825,48,1672,0,0,0,0,0
7.761,6,2,166,2,31,7761,31,166,0,0,0,0,0
1782.739,6,132,8052,67,27,27010,27,4030,65,27,27854,27,4022
4.123,17,8,1248,4,36,1372,36,256,4,220,1371,292,992
5.393,6,42,7389,22,218,256,314,3503,20,513,270,1179,3886
33.568,6,30,5042,15,154,2397,722,1859,15,399,2385,1408,3183
4.07,6,466,476018,168,996,24,1460,22704,298,1543,13,4380,453314
7.314,6,5,240,1,0,0,0,48,4,0,2434,0,192
62.947,6,50,11614,20,615,71,910,3921,30,270,2165,1360,7693
65.402,6,47,18159,26,662,2616,1420,8359,21,639,3266,1420,9800
1792.514,17,331,70975,331,186,5431,364,70975,0,0,0,0,0
345.292,17,3,126,3,14,172646,14,126,0,0,0,0,0
371.36,6,23,1535,16,177,24757,177,1053,7,110,10381,110,482
0.277,6,22,4442,11,165,27,456,1394,11,493,26,888,3048
516.049,6,136,18381,69,179,7588,1189,7432,67,250,7818,2760,10949
122.701,6,32,13665,16,489,342,1360,3132,16,988,8171,1498,10533
0.354,17,2,168,1,48,0,48,76,1,64,0,64,92
1.429,17,4,560,2,64,1062,64,184,2,160,1089,160,376
0.856,6,16,5825,9,290,107,517,1045,7,1102,114,1418,4780
240.845,6,46,8549,22,523,11468,1408,5890,24,175,10471,580,2659
390.402,6,30,6740,13,189,9878,516,1472,17,327,24394,1452,5268
300.56,6,17,1187,6,177,60077,177,509,11,110,30038,110,678
0.041,6,2,1494,1,0,0,0,40,1,1414,0,1414,1454
98.773,2,2,64,2,8,98773,8,64,0,0,0,0,0
1.566,1,10,840,10,56,174,56,840,0,0,0,0,0
0.576,6,7,423,4,43,175,43,259,3,0,28,0,164
1.137,6,2,92,2,0,0,0,92,0,0,0,0,0
1799.978,17,142,11360,71,48,25713,48,5396,71,56,25713,56,5964
16.46,6,22,6546,8,154,2351,267,792,14,576,1262,1420,5754
0.006,17,2,554,2,249,6,249,554,0,0,0,0,0
1786.7,6,102,8364,68,66,26667,66,4964,34,60,54139,60,3400
1787.412,6,102,8296,68,65,26677,65,4930,34,59,54161,59,3366
37.131,6,25,4048,14,179,2856,517,1824,11,411,3712,499,2224
1.35,6,50,19386,27,898,51,1360,13690,23,433,53,1360,5696
1741.311,17,29,6699,29,203,62189,203,6699,0,0,0,0,0
1.887,6,2,80,1,0,0,0,40,1,0,0,0,40
0.013,17,3,310,2,31,0,31,118,1,164,0,164,192
10.022,6,2143,2061075,1408,1388,7,1408,2018191,735,931,13,2801,42884
1742.835,6,95,7203,63,38,28110,205,4476,32,33,56210,98,2727
156.373,17,4,304,2,48,156372,64,152,2,48,156372,64,152
96.074,6,22,8319,11,525,99,1237,2048,11,969,9590,1791,6271
11.264,6,2,166,0,0,0,0,0,2,31,11264,31,166
390.971,6,23,1499,14,177,30074,177,913,9,110,10092,110,586
1.808,6,2,87,1,0,0,0,40,1,7,0,7,47
6.371,6,31,19535,22,963,303,1368,13663,9,1340,765,4104,5872
0.637,6,11,976,5,283,109,283,551,6,105,87,105,425
7.289,6,1556,1415141,947,1414,7,1448,1378809,609,776,11,1448,36332
122.162,17,4,352,2,60,122161,60,176,2,60,122161,60,176
0.049,17,4,284,2,32,34,32,120,2,54,35,60,164
66.764,6,27,7177,13,155,5563,267,1306,14,530,5135,3417,5871
3.959,6,2,88,2,0,0,0,88,0,0,0,0,0
1786.554,6,104,8444,68,66,26664,66,4964,36,60,51041,60,3480
1766.506,6,215,27695,116,304,15360,304,18672,99,83,18015,83,9023
4.168,6,35,6209,19,206,231,314,2824,16,456,260,1152,3385
11.537,6,94,28370,48,543,245,1152,22048,46,447,249,1179,6322
118.685,2,2,64,2,8,118685,8,64,0,0,0,0,0
32.094,6,15,3543,5,188,1515,245,580,10,1279,3537,1407,2963
180.487,2,2,64,2,8,180487,8,64,0,0,0,0,0
23.863,6,36,8217,16,188,1590,722,1964,20,544,1244,1380,6253
316.349,6,43,5427,23,302,14379,302,3620,20,83,16629,83,1807
1657.491,1,7,392,7,28,276248,28,392,0,0,0,0,0
0.68,17,2,677,1,300,0,300,328,1,321,0,321,349
247.825,17,4,352,2,60,247824,60,176,2,60,247824,60,176
1798.974,17,142,11360,71,48,25699,48,5396,71,56,25699,56,5964
1.31,6,47,19183,27,892,50,1360,13607,20,476,59,2715,5576
1741.85,6,135,8433,75,46,23538,208,5134,60,31,29518,31,3299
1799.874,17,144,11520,72,48,25350,48,5472,72,56,25350,56,6048
334.133,1,14,784,14,28,25702,28,784,0,0,0,0,0
67.996,6,35,8320,18,378,516,786,1886,17,522,4240,3488,6434
1007.579,2,7,224,7,8,167929,8,224,0,0,0,0,0
173.979,1,4,224,4,28,57993,28,224,0,0,0,0,0
1681.487,17,14,3843,7,30,280246,30,406,7,463,280246,463,3437
300.171,6,39,10521,20,687,15789,1360,4959,19,435,16666,2667,5562
53.64,17,6,528,3,48,26815,48,228,3,72,26815,72,300
1780.641,6,106,8584,69,66,26185,66,5004,37,60,49453,60,3580
0.741,6,10,1687,7,100,123,100,384,3,1179,250,1179,1303
31.311,6,9,388,3,0,15655,0,124,6,0,6244,0,264
0.391,6,28,9159,13,263,32,691,1736,15,829,26,1448,7423
11.787,6,1906,1637201,1156,1363,10,1380,1602959,750,421,15,1923,34242
1787.883,1,74,6216,74,56,24491,56,6216,0,0,0,0,0
0.012,17,2,491,1,40,0,40,68,1,395,0,395,423
242.422,17,4,352,2,60,242421,60,176,2,60,242421,60,176
0.325,6,5,272,4,0,0,0,220,1,0,0,0,52
377.501,6,20,1355,15,177,26964,177,977,5,110,15174,110,378
0.332,17,8,2742,8,314,47,353,2742,0,0,0,0,0
1796.149,17,449,39928,404,35,4456,288,25708,45,288,40021,288,14220
230.489,17,4,240,2,32,230488,32,120,2,32,230488,32,120
129.025,2,3,96,3,8,64512,8,96,0,0,0,0,0
80.678,17,4,240,2,32,80677,32,120,2,32,80677,32,120
0.007,17,2,227,1,31,0,31,59,1,140,0,140,168
1782.983,6,358,23021,209,69,8572,69,12500,149,74,12047,421,10521
142.572,6,17,1572,6,69,12031,69,447,11,68,14256,69,1125
1796.089,17,447,39864,402,35,4479,288,25644,45,288,40018,288,14220
1665.41,1,8,448,8,28,237915,28,448,0,0,0,0,0
64.37,6,15,4042,6,307,12874,722,1241,9,2329,8023,2329,2801
169.535,17,28,2128,28,48,6279,48,2128,0,0,0,0,0
0.121,17,4,1375,4,315,40,354,1375,0,0,0,0,0
0.419,17,12,4377,12,336,38,359,4377,0,0,0,0,0
1740.377,6,87,6322,58,31,30532,31,3915,29,31,62155,31,2407
4.479,6,40,7309,21,218,223,314,3463,19,513,233,1179,3846
1740.032,1,11,638,11,30,174003,30,638,0,0,0,0,0
5.146,6,38,7229,20,218,270,314,3423,18,513,287,1179,3806
0.753,17,3,238,2,30,726,30,116,1,94,0,94,122
1783.417,17,74,3096,72,14,25116,14,3024,2,8,1783244,8,72
300.174,6,43,10172,23,593,13636,1360,4525,20,402,15790,2720,5647
0.023,17,2,262,1,39,0,39,67,1,167,0,167,195
1795.585,17,87,3648,86,14,21124,14,3612,1,8,0,8,36
61.869,6,63,45601,42,1186,1509,1408,37775,21,960,3081,3847,7826
16.113,6,4,505,3,115,8053,138,465,1,0,0,0,40
1784.789,6,272,30266,139,125,12933,721,18364,133,168,13519,2828,11902
11.133,6,76,66000,47,138,242,228,3078,29,2361,387,7040,62922
69.084,6,27,7177,13,155,5757,267,1306,14,530,5313,3417,5871
0.524,17,3,451,2,39,185,39,134,1,289,0,289,317
300.68,6,38,8285,20,245,15825,633,1812,18,441,502,1440,6473
23.041,6,17,2425,9,211,2877,211,922,8,545,3290,904,1503
1772.662,6,180,15480,120,69,14896,69,8940,60,69,30043,69,6540
0.164,6,2,99,1,0,0,0,40,1,7,0,7,59
1662.859,1,7,392,7,28,277143,28,392,0,0,0,0,0
15.25,17,26,6245,11,239,1522,1350,2937,15,192,1087,1350,3308
28.57,17,4,352,2,60,28569,60,176,2,60,28568,60,176
3.689,6,34,6169,17,206,230,314,2744,17,456,215,1152,3425
0.149,17,2,152,1,48,0,48,76,1,48,0,48,76
77.89,17,2,136,2,40,77890,47,136,0,0,0,0,0
1787.901,6,367,26050,214,105,8393,469,15445,153,69,11762,69,10605
1741.295,17,30,7050,30,207,60044,207,7050,0,0,0,0,0
178.123,1,9,504,9,28,22265,28,504,0,0,0,0,0
300.965,6,32,8447,13,193,25066,398,1456,19,400,16710,1448,6991
1789.676,6,355,22480,207,69,8687,69,12420,148,69,12174,69,10060
12.458,17,3,984,3,300,6229,300,984,0,0,0,0,0
299.563,6,6,364,4,31,99854,31,222,2,31,299543,31,142
4.099,6,4,208,4,0,0,0,208,0,0,0,0,0
1796.259,17,448,39896,403,35,4468,288,25676,45,288,40018,288,14220
2.25,6,27,8827,16,282,150,578,1490,11,984,206,1452,7337
0.085,6,2,123,1,0,0,0,40,1,31,0,31,83
1787.518,6,104,8376,68,65,26679,65,4930,36,59,51068,59,3446
0.103,17,2,237,1,72,0,72,100,1,109,0,109,137
5.015,17,4,542,2,36,5010,36,128,2,179,5010,187,414
280.597,6,32,7853,14,158,21584,267,1357,18,524,16504,1400,6496
0.013,17,2,363,2,153,13,158,363,0,0,0,0,0
28.711,17,4,244,2,33,28710,33,122,2,33,28710,33,122
1772.512,6,204,22399,130,75,13740,267,10057,74,133,24275,1997,12342
176.99,17,4,352,2,60,176988,60,176,2,60,176989,60,176
21.902,6,3347,3162829,2174,1376,9,1408,3096917,1173,776,18,1408,65912
0.076,6,10,1512,5,503,19,503,771,5,473,19,473,741
134.44,17,6,2016,6,308,26888,308,2016,0,0,0,0,0
0.184,17,7,2368,7,310,30,354,2368,0,0,0,0,0
31.126,17,18,1584,9,48,3889,48,684,9,72,3889,72,900
3.838,6,2,88,2,0,0,0,88,0,0,0,0,0
1.699,6,14,2351,8,188,242,245,700,6,703,282,1152,1651
280.427,6,26,7272,12,158,25493,267,1277,14,775,21569,2800,5995
0.294,17,5,1801,5,332,73,355,1801,0,0,0,0,0
0.15,17,4,608,2,60,47,60,176,2,188,51,188,432
0.958,6,20,5948,11,281,95,544,1288,9,716,108,1420,4660
1786.539,6,102,8364,68,66,26664,66,4964,34,60,54133,60,3400
1788.253,6,99,6444,63,47,28842,208,4074,36,31,51086,31,2370
366.318,6,25,1651,17,177,22894,177,1117,8,110,9167,110,534
1797.317,17,448,39896,403,35,4470,288,25676,45,288,40018,288,14220
1.434,6,24,9050,13,422,119,1205,2374,11,1219,123,2491,6676
4.022,17,8,1288,4,33,1336,33,244,4,233,1337,233,1044
280.629,6,32,7853,14,158,21586,267,1357,18,524,16506,1400,6496
26.751,6,3965,3746388,2586,1370,10,1408,3670016,1379,931,19,2816,76372
181.676,6,47,6224,21,135,9075,722,2320,26,213,7259,1448,3904
277.577,6,32,5484,18,153,16328,516,1800,14,312,21322,1452,3684
0.503,17,3,451,2,39,188,39,134,1,289,0,289,317
8.41,6,21,9342,11,275,841,275,723,10,1367,805,2840,8619
1784.94,6,104,8444,68,66,26640,66,4964,36,60,50995,60,3480
0.917,6,19,7099,12,318,83,600,1906,7,1205,133,1851,5193
280.517,6,30,7432,13,158,23376,267,1317,17,603,17528,2760,6115
1774.005,6,183,15807,120,69,14907,69,8940,63,69,28610,69,6867
0.0,17,1,542,1,514,0,514,542,0,0,0,0,0
0.054,1,2,112,2,28,54,28,112,0,0,0,0,0
0.163,6,2,113,1,21,0,21,73,1,0,0,0,40
1788.833,17,87,3648,86,14,21045,14,3612,1,8,0,8,36
83.304,1,19,7703,19,377,4628,519,7703,0,0,0,0,0
384.45,6,21,8454,9,129,48056,267,1014,12,772,11686,1917,7440
0.385,6,24,6064,12,181,35,537,1526,12,651,32,1448,4538
0.617,6,22,5935,12,108,56,147,919,10,922,67,1581,5016
3.99,17,4,268,4,39,1330,39,268,0,0,0,0,0
377.364,6,25,1651,17,177,23585,177,1117,8,110,9285,110,534
134.037,6,28,9231,10,267,478,501,1205,18,486,7879,1420,8026
60.608,6,20,5901,11,272,6060,516,1260,9,712,7563,1452,4641
0.698,6,114,87694,53,131,13,232,2649,61,1475,11,4140,85045
1.455,6,47,19249,27,897,55,1360,13673,20,433,64,1360,5576
1.71,17,26,6596,11,269,167,1350,3276,15,193,119,1350,3320
38.655,17,44,6468,22,48,1840,48,1672,22,190,1840,308,4796
0.071,6,12,3644,6,99,10,99,419,6,968,10,1448,3225
280.56,6,28,7352,13,158,23380,267,1317,15,678,20035,2045,6035
4.173,17,4,352,2,60,4172,60,176,2,60,4172,60,176
892.346,1,15,840,15,28,63739,28,840,0,0,0,0,0
0.474,6,22,7345,13,334,39,663,2021,9,1209,54,1946,5324
78.313,6,14,1080,4,226,121,226,442,10,110,8681,110,638
1790.248,6,361,22927,210,69,8565,69,12678,151,69,11931,69,10249
255.53,6,4,176,3,0,127765,0,128,1,0,0,0,48
0.123,17,2,154,1,33,0,33,61,1,65,0,65,93
0.531,6,22,7345,13,334,44,663,2021,9,1209,60,2736,5324
240.183,6,53,17784,28,787,8895,1402,14853,25,202,10007,580,2931
2.37,6,5,574,1,180,0,180,232,4,110,790,110,342
12.462,6,11,616,5,0,3115,0,280,6,0,1741,0,336
1.394,6,53,20195,29,943,49,1440,14414,24,400,52,1440,5781
128.371,6,27,10456,6,154,25674,267,712,21,556,6416,1420,9744
1786.444,6,157,20044,93,302,19417,302,14206,64,83,28356,83,5838
1788.248,6,364,24923,212,94,8475,469,14427,152,69,11839,69,10496
367.036,6,18,1288,14,226,28233,226,962,4,110,20057,110,326
1786.422,6,107,9086,70,71,25890,275,5319,37,65,49620,247,3767
288.751,6,69,15099,32,162,9309,721,4048,37,531,8016,1440,11051
31.513,6,7,336,1,0,0,0,48,6,0,6300,0,288
31.486,6,6,280,2,0,31486,0,88,4,0,8810,0,192
1773.907,1,55,4620,0,0,0,0,0,55,56,32850,56,4620
2.351,17,2,178,1,29,0,29,57,1,93,0,93,121
0.855,17,14,6978,7,613,133,1350,4493,7,327,130,1350,2485
0.054,6,5,260,2,0,39,0,104,3,0,27,0,156
1773.353,6,180,15480,120,69,14902,69,8940,60,69,30049,69,6540
0.448,6,6,324,4,0,149,0,216,2,0,275,0,108
0.387,6,10,968,5,256,94,256,460,5,304,94,304,508
0.011,17,2,154,1,33,0,33,61,1,65,0,65,93
1763.71,6,27,4077,18,241,103747,241,2889,9,92,220432,92,1188
21.421,6,25,12798,9,158,2677,174,838,16,1028,1410,1452,11960
1790.823,6,3812,3514377,1388,127,1291,344,80272,2424,1407,739,2836,3434105
0.504,6,11,2032,6,288,97,288,548,5,424,74,434,1484
64.401,6,11,452,5,0,6031,0,204,6,0,12875,0,248
0.23,17,8,2750,8,315,32,354,2750,0,0,0,0,0
1.042,17,13,7029,7,614,173,1350,4494,6,394,127,1350,2535
1795.827,6,307,37194,128,134,14139,1440,17577,179,136,10088,1440,19617
0.009,17,2,180,1,30,0,30,58,1,94,0,94,122
1.243,6,48,19283,27,896,47,1360,13667,21,433,53,1360,5616
0.057,6,11,913,7,182,9,182,542,4,77,5,134,371
280.26,17,4,296,2,30,280248,30,116,2,62,280245,62,180
0.422,6,48,19210,26,1001,16,1380,14088,22,383,18,1380,5122
300.317,6,54,48900,28,145,11122,230,2044,26,2068,12012,4224,46856
0.896,17,6,522,3,47,444,47,225,3,71,444,75,297
1.247,6,34,8389,17,269,77,780,2106,17,698,65,2720,6283
4.973,17,4,624,4,128,1657,128,624,0,0,0,0,0
280.2,6,26,7272,12,158,25472,267,1277,14,775,21549,2800,5995
0.984,17,4,352,2,60,983,60,176,2,60,981,60,176
5.012,6,13,2311,8,188,716,245,700,5,1407,1182,1407,1611
1.634,17,28,16160,14,877,125,1350,12672,14,221,73,1350,3488
20.4,17,4,304,4,48,6800,48,304,0,0,0,0,0
12.408,6,31,14908,12,114,1113,187,904,19,1016,680,1460,14004
620.642,1,21,1176,21,28,31032,28,1176,0,0,0,0,0
76.35,6,44,15322,21,922,83,1448,7557,23,345,3462,1448,7765
1.365,6,48,19153,27,887,52,1360,13537,21,476,59,2715,5616
0.006,17,4,272,2,29,1,29,114,2,51,0,57,158
41.7,6,28,7217,13,155,3475,267,1306,15,482,2977,1997,5911
0.414,6,12,1653,6,288,78,288,548,6,426,48,434,1105
1.385,6,37,8212,19,320,76,1162,2716,18,476,69,2720,5496
0.139,17,2,290,1,40,0,40,68,1,194,0,194,222
1798.26,6,367,25650,214,99,8442,469,15045,153,69,11830,69,10605
98.33,17,4,1344,4,308,32776,308,1344,0,0,0,0,0
0.316,6,26,8886,13,231,26,563,1632,13,938,25,1408,7254
1797.255,6,245,28480,124,137,14611,721,17049,121,164,14431,2840,11431
692.765,17,1157,673598,642,853,1080,1350,566182,515,180,1347,1350,107416
1799.652,17,450,39960,405,35,4454,288,25740,45,288,40020,288,14220
2.501,17,3,543,2,39,1975,39,134,1,381,0,381,409
1.522,6,13,2311,8,188,217,245,700,5,1407,313,1407,1611
5.009,17,4,558,2,36,5005,36,128,2,187,5004,187,430
22.332,17,40,7305,17,161,1393,1350,3217,23,149,1013,1350,4088
1744.679,2,14,448,14,8,134206,8,448,0,0,0,0,0
0.241,6,2,80,1,0,0,0,40,1,0,0,0,40
241.425,6,51,5956,26,235,9656,752,3059,25,144,10059,540,2897
1796.486,6,366,25610,214,99,8434,469,15045,152,69,11895,69,10565
280.23,6,29,7392,14,158,21556,267,1357,15,678,20013,3436,6035
251.76,2,2,64,2,8,251760,8,64,0,0,0,0,0
9.357,6,2,80,1,0,0,0,40,1,0,0,0,40
1.912,17,4,308,2,33,1910,33,122,2,65,1910,65,186
293.08,1,4,326,4,53,97693,78,326,0,0,0,0,0
149.569,6,174,141378,114,1279,1323,1368,128742,60,679,2530,2736,12636
0.268,6,28,9123,13,247,22,624,1672,15,832,18,1408,7451
276.454,6,22,6974,10,181,30717,267,1128,12,766,25131,2045,5846
1798.604,6,98,7421,65,38,28103,205,4611,33,33,56198,98,2810
1530.244,17,94,6016,94,36,16454,36,6016,0,0,0,0,0
1.952,6,3,120,1,0,0,0,40,2,0,1823,0,80
371.067,6,30,2700,16,184,24737,184,856,14,424,4146,434,1844
1794.084,17,66,2766,65,14,28032,14,2730,1,8,0,8,36
0.042,17,2,167,1,39,0,39,67,1,72,0,72,100
0.051,17,4,284,2,32,36,32,120,2,54,36,60,164
0.017,17,4,942,2,45,10,45,146,2,370,8,418,796
0.012,17,2,154,1,33,0,33,61,1,65,0,65,93
300.677,6,38,8566,20,315,15825,882,2093,18,441,501,1440,6473
0.931,6,28,13141,16,529,62,1360,3330,12,1164,69,3921,9811
1797.909,17,449,39928,404,35,4461,288,25708,45,288,40017,288,14220
0.276,17,2,384,1,39,0,39,67,1,289,0,289,317
1789.375,17,266,52337,266,168,6752,422,52337,0,0,0,0,0
1783.53,17,83,3480,82,14,22018,14,3444,1,8,0,8,36
0.106,17,4,284,2,32,16,32,120,2,54,92,60,164
2.087,17,2,214,1,39,0,39,67,1,119,0,119,147
541.428,2,6,192,6,8,108285,8,192,0,0,0,0,0
0.682,6,53,23241,29,1052,24,1380,18027,24,421,27,1923,5214
248.509,17,22,1928,22,59,11833,346,1928,0,0,0,0,0
5.611,6,40,7309,20,218,295,314,3423,20,440,281,1152,3886
84.37,17,4,1344,4,308,28123,308,1344,0,0,0,0,0
0.002,6,2,129,1,0,0,0,40,1,37,0,37,89
0.41,6,7,295,4,0,136,0,164,3,7,105,7,131
209.051,6,32,4142,21,173,10452,196,2496,11,398,2716,419,1646
31.618,6,7,396,1,0,0,0,60,6,0,6289,0,336
297.691,2,3,96,3,8,148845,8,96,0,0,0,0,0
0.033,6,32,7991,17,131,2,131,1023,15,475,2,1000,6968
0.677,6,16,7127,10,321,75,517,1159,6,1412,97,3913,5968
1.058,17,3,696,3,204,529,204,696,0,0,0,0,0
0.607,17,2,144,1,36,0,36,64,1,52,0,52,80
5.218,6,41,7349,20,218,274,314,3423,21,440,248,1152,3926
1784.56,6,122,12676,75,79,24115,498,5944,47,121,38793,1420,6732
0.385,6,7,376,4,0,128,0,216,3,0,93,0,160
240.222,6,56,15944,29,678,8578,1418,13047,27,185,9238,580,2897
1790.315,1,58,4872,58,56,31409,56,4872,0,0,0,0,0
300.934,6,38,15730,15,195,21483,431,1568,23,682,13671,1551,14162
240.202,6,54,17643,29,774,8578,1408,14687,25,206,10008,580,2956
16.248,6,75,55953,50,748,331,1360,8022,25,2345,671,9520,47931
41.106,17,12,1764,6,48,8219,48,456,6,190,8219,308,1308
1383.19,6,163,11212,60,46,23443,46,4746,103,46,13560,46,6466
0.897,6,36,8204,20,241,47,619,1810,16,522,50,2720,6394
0.186,6,25,7216,13,155,15,267,1301,12,775,15,4836,5915
6.81,6,533,459751,331,1323,20,1368,444583,202,776,32,2736,15168
1784.068,6,364,23047,211,69,8495,69,12787,153,69,11737,69,10260
9.048,6,7,435,7,31,1508,31,435,0,0,0,0,0
1790.607,17,279,61543,279,192,6441,422,61543,0,0,0,0,0
96.345,6,11,719,11,31,9634,31,719,0,0,0,0,0
0.026,17,2,158,1,34,0,34,62,1,68,0,68,96
145.408,17,4,240,2,32,145407,32,120,2,32,145407,32,120
0.073,17,2,198,1,37,0,37,65,1,105,0,105,133
1742.172,1,16,896,16,28,116144,28,896,0,0,0,0,0
16.629,17,4,352,2,60,16628,60,176,2,60,16628,60,176
280.197,6,27,7312,13,158,23349,267,1317,14,775,21550,2800,5995
33.669,6,29,5189,14,180,2589,722,1807,15,371,2389,1402,3382
0.085,17,4,588,2,48,76,48,152,2,190,75,308,436
1796.039,1,166,17596,166,78,10885,78,17596,0,0,0,0,0
250.037,1,2,112,2,28,250037,28,112,0,0,0,0,0
0.246,6,24,5980,12,164,22,453,1442,12,651,21,1402,4538
0.317,6,28,9001,13,227,26,547,1592,15,827,21,1408,7409
292.885,6,49,8095,24,129,12732,517,2189,25,417,12201,1418,5906
41.698,17,44,6468,22,48,1982,48,1672,22,190,1979,308,4796
1.289,6,39,11068,21,587,64,1460,5572,18,433,65,1460,5496
1776.644,17,73,3060,72,14,25023,14,3024,1,8,0,8,36
1.444,6,25,7390,14,350,110,1089,2316,11,926,143,1731,5074
5.434,6,45,8409,22,227,258,314,4062,23,427,235,1152,4347
5.356,6,44,8385,21,227,267,314,4022,23,491,231,1179,4363
0.405,6,7,295,4,0,135,0,164,3,7,104,7,131
45.268,17,12,912,12,48,4115,48,912,0,0,0,0,0
0.104,6,10,1514,5,503,25,503,771,5,475,26,475,743
0.017,6,2,80,1,0,0,0,40,1,0,0,0,40
1690.77,2,16,512,16,8,112718,8,512,0,0,0,0,0
121.236,6,24,9932,13,644,63,1360,3130,11,1058,12106,2235,6802
0.18,6,24,7176,12,155,16,267,1261,12,775,14,3445,5915
1793.098,6,444,26104,235,69,7662,69,13540,209,34,8620,64,12564
1772.248,6,180,15480,120,69,14892,69,8940,60,69,30035,69,6540
0.166,6,45,20271,26,1016,6,1420,15290,19,526,8,3303,4981
16.593,6,998,890487,624,1349,26,1368,863795,374,776,43,1473,26692
5.0,17,2,2144,2,1044,5000,1044,2144,0,0,0,0,0
0.305,17,3,1170,3,362,152,362,1170,0,0,0,0,0
2.105,6,13,2311,8,188,300,245,700,5,1407,464,1407,1611
299.514,6,6,364,4,31,99838,31,222,2,31,299504,31,142
293.948,1,4,224,4,28,97982,28,224,0,0,0,0,0
222.925,6,24,2064,16,69,14861,69,1192,8,69,31832,69,872
1682.87,1,15,840,15,28,120205,28,840,0,0,0,0,0
1786.072,6,173,34774,101,436,17860,1302,25882,72,117,25154,297,8892
174.56,6,22,8866,11,299,104,597,1369,11,1006,17438,1460,7497
0.412,6,10,1992,5,288,96,288,508,5,424,58,434,1484
1786.284,6,359,22709,209,69,8587,69,12569,150,69,11987,69,10140
280.25,6,30,7432,13,158,23354,267,1317,17,543,17510,1400,6115
5.014,17,4,288,2,36,5003,36,128,2,52,5002,52,160
1787.531,17,140,11200,70,48,25906,48,5320,70,56,25906,56,5880
1739.292,6,87,6322,58,31,30513,31,3915,29,31,62116,31,2407
1780.899,6,379,24061,216,69,8283,69,13401,163,69,10992,69,10660
142.399,17,4,352,2,60,142398,60,176,2,60,142398,60,176
234.464,6,45,13045,25,403,9769,1360,5870,20,530,12330,1360,7175
0.411,6,12,1653,6,288,81,288,548,6,426,44,434,1105
1784.062,6,396,24141,209,69,8577,69,12500,187,42,9591,69,11641
1.103,6,24,8004,12,164,85,267,1288,12,1014,85,2411,6716
1649.852,1,7,742,7,78,274975,78,742,0,0,0,0,0
0.314,6,20,7229,12,334,28,663,1969,8,1209,44,1906,5260
1793.548,1,296,16576,296,28,6079,28,16576,0,0,0,0,0
677.716,2,6,192,6,8,135543,8,192,0,0,0,0,0
4.983,17,4,558,2,36,4973,36,128,2,187,4973,187,430
1759.368,6,143,13801,74,59,24100,517,5243,69,213,25872,1408,8558
280.523,6,28,7352,13,158,23376,267,1317,15,678,20030,2760,6035
1795.818,6,265,32487,108,131,16782,1360,15500,157,137,11510,4662,16987
0.623,17,2,152,1,48,0,48,76,1,48,0,48,76
1798.697,17,762,45960,762,32,2363,37,45960,0,0,0,0,0
1772.865,6,180,15480,120,69,14898,69,8940,60,69,30047,69,6540
0.012,17,2,386,1,54,0,54,82,1,276,0,276,304
0.018,17,2,384,1,39,0,39,67,1,289,0,289,317
37.367,6,29,11721,14,510,2874,1440,4306,15,1104,2607,1440,7415
0.019,17,2,355,1,33,0,33,61,1,266,0,266,294
0.31,6,28,7336,13,155,25,267,1301,15,543,19,1400,6035
378.106,2,4,128,4,8,126035,8,128,0,0,0,0,0
300.725,6,41,8777,18,291,17682,787,1917,23,348,13663,3488,6860
0.648,17,4,608,2,60,273,60,176,2,188,300,188,432
14.96,6,6,328,4,0,4986,0,216,2,0,14671,0,112
4.448,6,39,7269,19,218,247,314,3383,20,513,221,1179,3886
1782.891,6,102,8296,68,65,26610,65,4930,34,59,54024,59,3366
0.072,17,5,1000,3,60,31,60,264,2,340,61,340,736
9.059,6,87,26949,43,558,215,1152,20707,44,447,204,1179,6242
0.012,6,3,327,2,103,0,138,287,1,0,0,0,40
1716.328,1,62,6572,62,78,28136,78,6572,0,0,0,0,0
7.637,17,3,228,3,48,3818,48,228,0,0,0,0,0
0.531,6,22,7345,13,334,44,663,2021,9,1209,61,1946,5324
373.729,6,27,1767,18,177,21984,177,1181,9,110,9574,110,586
31.011,17,6,468,6,50,6202,50,468,0,0,0,0,0
0.203,17,2,152,1,48,0,48,76,1,48,0,48,76
299.526,6,7,404,4,31,99842,31,222,3,31,149758,31,182
1770.405,6,101,9344,66,65,27237,65,5577,35,59,52067,59,3767
10.38,6,41,12829,20,241,546,721,2493,21,730,438,1440,10336
1795.417,17,144,11520,72,48,25287,48,5472,72,56,25287,56,6048
0.004,17,2,415,1,49,0,49,77,1,310,0,310,338
70.411,6,30,7435,13,155,5867,267,1306,17,418,4400,2840,6129
188.666,2,2,64,2,8,188666,8,64,0,0,0,0,0
1740.421,17,29,6815,29,207,62157,207,6815,0,0,0,0,0
0.221,6,22,5040,11,137,22,267,1132,11,577,21,1400,3908
1797.649,17,450,39960,405,35,4449,288,25740,45,288,40020,288,14220
3.82,6,32,6089,17,206,238,314,2744,15,548,254,1179,3345
1.014,6,11,1727,7,100,169,100,384,4,589,254,1152,1343
8.228,6,70,20302,36,541,235,1152,15515,34,489,241,1179,4787
1784.568,17,141,11276,71,48,25493,48,5396,70,56,25862,56,5880
1.63,6,5,200,1,0,0,0,40,4,0,521,0,160
1792.046,6,359,22709,209,69,8615,69,12569,150,69,12027,69,10140
127.434,6,74,54540,49,1219,2654,1368,46456,25,841,2592,2736,8084
243.066,6,44,8967,21,516,12152,1368,5750,23,223,11045,640,3217
0.944,6,22,7900,12,164,85,267,1288,10,1216,85,3819,6612
62.143,6,15,1666,9,180,7767,180,1016,6,110,12383,110,650
8.893,6,36,8341,18,363,523,775,1867,18,441,512,1360,6474
11.383,6,6,328,4,0,3794,0,216,2,0,11157,0,112
286.149,6,30,3141,15,324,20438,585,1461,15,226,20438,580,1680
240.871,2,3,96,3,8,120435,8,96,0,0,0,0,0
74.443,6,16,3396,7,524,152,1309,1873,9,575,9284,999,1523
1789.957,6,374,29006,216,108,8325,485,15552,158,101,11400,453,13454
1772.884,6,181,15589,120,69,14898,69,8940,61,69,29547,69,6649
3.881,6,33,6129,17,206,242,314,2744,16,548,241,1179,3385
1787.959,6,362,22898,210,69,8554,69,12678,152,69,11840,69,10220
1780.374,1,37,2072,37,28,49454,28,2072,0,0,0,0,0
240.265,6,54,18437,29,771,8580,1418,15400,25,216,10010,580,3037
1798.219,1,58,4872,0,0,0,0,0,58,56,31547,56,4872
170.728,6,24,10136,13,541,71,1360,2717,11,1161,17055,2574,7419
11.821,6,24,4530,13,213,985,597,1741,11,441,1163,1440,2789
0.438,17,4,624,2,64,436,64,184,2,192,317,192,440
1.203,6,24,8004,12,164,93,267,1288,12,1014,93,2804,6716
26.376,17,8,608,8,48,3768,48,608,0,0,0,0,0
9.475,6,18,1415,9,222,1183,222,808,9,231,1183,231,607
1772.489,6,180,15480,120,69,14894,69,8940,60,69,30037,69,6540
702.755,6,75,9627,35,135,17836,722,4800,40,161,18014,2026,4827
0.497,6,20,7252,13,337,41,674,2032,7,1212,75,1946,5220
122.845,6,31,8912,14,158,9449,267,1357,17,687,7675,1781,7555
1798.429,6,368,25759,214,99,8443,469,15045,154,69,11754,69,10714
7.456,6,5,284,1,0,0,0,60,4,0,2427,0,224
1787.173,6,102,8296,68,65,26674,65,4930,34,59,54152,59,3366
0.367,6,26,8862,13,231,30,563,1608,13,938,29,1448,7254
0.396,6,13,1693,7,288,63,288,588,6,426,44,434,1105
0.0,17,1,417,1,389,0,389,417,0,0,0,0,0
48.527,17,74,32966,41,671,1212,1350,28667,33,102,1515,1350,4299
0.272,6,10,1669,6,551,54,947,1346,4,159,90,159,323
366.36,6,25,1651,17,177,22897,177,1117,8,110,9171,110,534
1772.672,6,180,15480,120,69,14896,69,8940,60,69,30041,69,6540
5.531,17,4,240,2,32,5530,32,120,2,32,5529,32,120
300.536,6,17,1187,6,177,60072,177,509,11,110,30036,110,678
0.027,17,2,912,1,308,0,308,336,1,548,0,548,576
3.433,1,2,72,2,8,3433,8,72,0,0,0,0,0
0.177,6,32,15050,15,173,12,319,1480,17,1152,10,1438,13570
481.29,2,4,128,4,8,160430,8,128,0,0,0,0,0
32.751,6,25,6275,14,230,2519,517,1886,11,544,3273,1824,4389
1790.079,17,180,11520,180,36,10000,36,11520,0,0,0,0,0
174.134,6,50,11610,18,271,5524,469,3989,32,234,5616,1452,7621
0.388,6,14,1733,7,288,63,288,588,7,284,35,434,1145
293.539,6,8,475,6,31,58707,31,333,2,31,225145,31,142
1673.232,1,7,392,7,28,278872,28,392,0,0,0,0,0
34.908,17,4,240,2,32,34907,32,120,2,32,34907,32,120
11.465,6,36,13185,16,441,764,722,2849,20,680,547,2760,10336
1772.907,1,70,5880,70,56,25694,56,5880,0,0,0,0,0
74.965,17,4,352,2,60,74964,60,176,2,60,74964,60,176
1770.199,6,101,9410,66,66,27233,66,5610,35,60,52062,60,3800
639.192,17,48,3824,26,48,25567,48,1976,22,56,25530,56,1848
0.214,6,3,127,1,0,0,0,40,2,7,33,7,87
3.496,17,8,1656,4,30,1162,30,232,4,328,1160,484,1424
1796.474,17,448,39896,403,35,4468,288,25676,45,288,40023,288,14220
0.003,17,2,162,1,37,0,37,65,1,69,0,69,97
7.713,6,23,6496,9,154,964,267,832,14,566,571,1420,5664
300.408,6,31,11821,17,590,18775,1368,4446,14,829,18487,1368,7375
1.191,6,46,18136,26,882,47,1360,12560,20,476,54,2715,5576
300.367,6,60,41111,37,1220,8343,1408,34902,23,715,1400,1491,6209
0.457,6,72,95816,42,210,11,256,3244,30,3250,13,8448,92572
34.841,6,25,6284,16,117,2322,159,1441,9,727,4351,1418,4843
2.096,6,29,10365,17,367,131,833,1785,12,1012,182,1420,8580
1763.515,2,13,416,13,8,146959,8,416,0,0,0,0,0
1791.511,6,359,33620,168,300,10727,841,12991,191,60,9427,1550,20629
126.766,2,3,96,3,8,63383,8,96,0,0,0,0,0
1797.018,1,345,28980,345,56,5223,56,28980,0,0,0,0,0
309.711,1,4,539,4,106,103237,117,539,0,0,0,0,0
280.451,6,31,7472,13,158,23370,267,1317,18,543,16492,1380,6155
5.66,6,43,8329,21,227,283,314,4022,22,489,240,1179,4307
31.631,17,4,352,2,60,31630,60,176,2,60,31630,60,176
0.186,6,7,280,4,0,1,0,160,3,0,3,0,120
1.917,17,2,166,1,47,0,47,75,1,63,0,63,91
8.158,6,18,9535,9,275,1019,275,643,9,1704,932,2840,8892
885.366,6,213,20788,117,109,7273,1189,8863,96,192,9319,1460,11925
1798.776,17,87,3648,86,14,21162,14,3612,1,8,0,8,36
1799.988,6,356,22520,208,69,8695,69,12460,148,69,12242,69,10060
0.019,17,2,554,1,30,0,30,58,1,468,0,468,496
3.253,17,5,340,5,40,813,40,340,0,0,0,0,0
0.19,6,9,1339,5,145,47,145,349,4,826,33,826,990
33.827,6,34,5261,16,154,2241,721,1922,18,342,1977,1368,3339
1.014,17,2,677,1,300,0,300,328,1,321,0,321,349
0.297,6,25,6032,12,164,27,453,1442,13,558,23,1440,4590
4.623,6,139,100078,73,969,64,1460,14017,66,1413,69,3834,86061
111.6,6,24,7268,5,156,27900,267,678,19,447,6191,3417,6590
14.725,17,4,1344,4,308,4908,308,1344,0,0,0,0,0
1.384,6,43,14644,24,737,60,1360,9108,19,433,66,1360,5536
1775.233,17,138,11040,69,48,26106,48,5244,69,56,26106,56,5796
1773.312,6,183,15738,121,69,14777,69,8980,62,69,29070,69,6758
1.313,6,41,8431,21,321,65,1164,2810,20,400,60,1360,5621
104.477,17,4,1344,4,308,34825,308,1344,0,0,0,0,0
284.749,17,2,136,2,40,284749,47,136,0,0,0,0,0
504.255,2,3,96,3,8,252127,8,96,0,0,0,0,0
1795.795,1,57,4788,0,0,0,0,0,57,56,32067,56,4788
1791.773,17,29,9512,29,300,63991,300,9512,0,0,0,0,0
240.273,6,53,17646,29,743,8580,1418,14906,24,185,10444,580,2740
0.099,17,4,368,2,32,98,32,120,2,96,31,96,248
1786.438,1,67,5628,0,0,0,0,0,67,56,27067,56,5628
0.223,17,2,778,2,361,223,361,778,0,0,0,0,0
4.898,17,4,288,2,36,4897,36,128,2,52,4898,52,160
20.334,6,19,2432,11,189,2033,517,1350,8,323,2903,499,1082
2.317,6,115,87240,50,131,47,232,2529,65,1368,32,1430,84711
1779.03,1,342,28728,342,56,5217,56,28728,0,0,0,0,0
1797.552,1,345,28980,345,56,5225,56,28980,0,0,0,0,0
31.473,6,5,240,1,0,0,0,48,4,0,9430,0,192
11.891,6,16,4732,9,290,1486,517,1057,7,1101,1961,1448,3675
1786.151,6,111,8910,71,66,25516,66,5150,40,60,45796,60,3760
49.597,6,6587,6368157,4420,1364,11,1408,6250809,2167,776,22,1408,117348
0.82,6,23,6199,13,268,64,679,1865,10,982,88,1691,4334
0.008,17,4,300,2,39,6,39,134,2,55,6,55,166
231.336,17,6,528,3,60,115667,60,264,3,60,115667,60,264
289.268,6,58,10077,30,660,9974,1418,6254,28,117,10712,580,3823
300.653,6,36,8204,20,241,15823,619,1810,16,522,567,2720,6394
1780.122,6,354,22509,207,69,8641,69,12489,147,69,12191,69,10020
240.3,6,43,9108,21,524,12014,1418,5819,22,237,11442,618,3289
1796.577,17,142,11360,71,48,25665,48,5396,71,56,25665,56,5964
1791.982,17,87,3648,86,14,21082,14,3612,1,8,0,8,36
1.888,6,24,8748,14,289,145,599,1431,10,987,188,1452,7317
14.496,6,2431,2091114,1367,1432,10,1448,2019078,1064,931,13,2761,72036
360.966,2,3,96,3,8,180483,8,96,0,0,0,0,0
96.04,17,4,352,2,60,96039,60,176,2,60,96038,60,176
1773.212,6,183,15738,121,69,14776,69,8980,62,69,29064,69,6758
1.196,17,8,656,4,37,398,37,260,4,71,395,89,396
107.214,6,18,732,7,0,7328,0,284,11,0,10718,0,448
122.822,6,4194,3671154,2524,1366,48,1368,3568104,1670,899,73,1473,103050
1799.429,6,356,22520,208,69,8692,69,12460,148,69,12240,69,10060
1784.748,6,102,8364,68,66,26638,66,4964,34,60,54080,60,3400
0.6,17,2,780,2,362,600,362,780,0,0,0,0,0
45.937,6,50,13525,23,408,2088,1440,5455,27,409,1759,1440,8070
0.032,17,2,188,1,37,0,37,65,1,95,0,95,123
81.782,6,38,7839,11,150,1599,267,1200,27,396,3145,1460,6639
1.254,6,41,9968,21,440,62,1360,4392,20,433,57,1360,5576
0.014,17,4,825,2,37,1,37,130,2,319,3,331,695
11.016,6,1648,1521589,1076,1362,10,1420,1494358,572,475,19,1883,27231
7.837,6,65,20406,34,552,237,1152,15723,31,491,251,1179,4683
1787.852,17,89,3729,87,13,20786,14,3649,2,12,1787669,16,80
1785.696,6,356,22520,208,69,8626,69,12460,148,69,12147,69,10060
7.599,6,33,6145,17,206,474,314,2744,16,551,489,1179,3401
1770.418,6,99,9306,66,66,27237,66,5610,33,60,55322,60,3696
1793.419,6,219,19998,110,128,15919,208,14429,109,31,16604,31,5569
1796.425,1,98,5488,98,28,18519,28,5488,0,0,0,0,0
23.442,6,27,11812,7,154,3907,267,752,20,683,1230,1420,11060
378.09,2,3,96,3,8,189045,8,96,0,0,0,0,0
503.681,2,3,96,3,8,251840,8,96,0,0,0,0,0
1.325,17,4,716,2,30,966,30,116,2,272,0,272,600
0.93,6,28,8460,15,222,54,540,1964,13,994,63,1791,6496
1795.2,17,378,61220,378,133,4761,389,61220,0,0,0,0,0
1730.208,1,45,3780,0,0,0,0,0,45,56,39322,56,3780
1798.855,6,133,8561,75,50,24306,208,5311,58,31,31555,31,3250
1795.801,17,449,39928,404,35,4456,288,25708,45,288,40024,288,14220
0.996,17,2,925,1,548,0,548,576,1,321,0,321,349
5.606,6,41,7349,21,218,280,314,3463,20,513,275,1179,3886
4.998,17,4,558,2,36,4988,36,128,2,187,4989,187,430
23.126,1,4,224,4,28,7708,28,224,0,0,0,0,0
1795.177,6,130,10360,82,66,22162,66,5920,48,60,38189,60,4440
1680.228,1,8,448,8,28,240032,28,448,0,0,0,0,0
1783.805,6,375,26108,215,98,8335,469,15292,160,69,11218,69,10816
1799.684,6,220,20361,115,123,15780,208,15231,105,31,17302,31,5130
1789.328,17,488,72509,231,203,7779,1350,53456,257,46,6988,1350,19053
0.084,6,11,1686,6,131,16,131,451,5,967,20,967,1235
42.582,17,24,1824,24,48,1851,48,1824,0,0,0,0,0
1.938,17,2,672,2,308,1938,308,672,0,0,0,0,0
1799.815,17,450,39960,405,35,4454,288,25740,45,288,40021,288,14220
300.762,6,43,14375,24,869,13076,1460,8813,19,399,477,1460,5562
1.902,17,2,672,2,308,1902,308,672,0,0,0,0,0
1787.409,6,102,8296,68,65,26677,65,4930,34,59,54160,59,3366
3.639,17,5,290,5,30,909,30,290,0,0,0,0,0
1786.321,6,359,22709,209,69,8588,69,12569,150,69,11986,69,10140
1740.976,6,90,6521,59,31,30016,31,3998,31,31,58031,31,2523
936.235,6,52,4056,34,45,28370,205,2491,18,34,55061,98,1565
1.87,6,23,5171,12,137,170,267,1172,11,592,148,1467,3999
2.925,17,2,1430,2,687,2925,687,1430,0,0,0,0,0
1681.441,1,15,840,15,28,120102,28,840,0,0,0,0,0
26.826,6,25,6757,12,181,2438,267,1212,13,717,2230,2036,5545
1798.26,17,179,13962,179,50,10102,50,13962,0,0,0,0,0
1787.446,1,58,4872,58,56,31358,56,4872,0,0,0,0,0
60.246,6,7,526,4,214,20000,214,394,3,0,30053,0,132
1.023,17,3,404,2,64,998,64,184,1,192,0,192,220
1799.56,17,3537,169776,1759,20,1023,20,84432,1778,20,1012,20,85344
0.325,1,2,112,2,28,325,28,112,0,0,0,0,0
1772.886,6,180,15480,120,69,14898,69,8940,60,69,30048,69,6540
150.09,6,22,9783,12,410,56,922,1742,10,1271,16661,4416,8041
280.264,6,30,7432,14,158,21558,267,1357,16,603,18681,2800,6075
1777.496,17,138,11040,69,48,26139,48,5244,69,56,26139,56,5796
155.516,6,23,9823,12,410,57,922,1742,11,1089,15537,2720,8081
1787.224,17,142,11360,71,48,25531,48,5396,71,56,25531,56,5964
0.005,6,2,92,1,0,0,0,52,1,0,0,0,40
0.038,6,7,380,4,0,12,0,216,3,0,9,0,164
1764.676,17,164,13818,152,30,11686,37,8858,12,385,154990,463,4960
0.327,6,28,9171,13,262,27,690,1735,15,831,23,1408,7436
1656.233,1,8,848,8,78,236604,78,848,0,0,0,0,0
0.186,6,46,20504,26,1030,7,1420,15483,20,467,9,1883,5021
0.025,6,10,2047,6,740,4,1323,1724,4,159,7,159,323
7.422,6,5,284,1,0,0,0,60,4,0,2411,0,224
0.309,6,27,9098,13,262,25,690,1747,14,945,23,1408,7351
1732.313,17,287,47009,287,135,6057,363,47009,0,0,0,0,0
11.328,6,1419,1135428,759,1396,14,1448,1089712,660,776,16,1448,45716
30.6,6,5,224,3,0,15300,0,128,2,0,1026,0,96
0.568,6,52,23873,29,1092,20,1380,18699,23,421,23,1923,5174
240.254,6,56,18106,31,798,8008,1418,15186,25,201,10010,580,2920
1700.421,17,12,498,11,14,170042,14,462,1,8,0,8,36
40.142,17,24,1824,24,48,1745,48,1824,0,0,0,0,0
1146.495,1,6,636,6,78,229299,78,636,0,0,0,0,0
0.244,6,46,22173,27,1072,9,1420,17192,19,467,13,1883,4981
0.935,6,36,8311,18,351,55,1380,2482,18,464,51,1525,5829
320.299,6,24,7468,11,168,32029,267,1636,13,588,521,1917,5832
280.213,6,30,7432,14,158,21554,267,1357,16,603,18678,2600,6075
253.239,17,4,352,2,60,253238,60,176,2,60,253238,60,176
0.282,6,28,9123,13,247,23,624,1672,15,832,19,1438,7451
1751.348,17,12,498,11,14,175134,14,462,1,8,0,8,36
1.312,6,29,6120,14,150,100,267,1615,15,650,81,1452,4505
0.613,6,120,82773,69,1292,9,1432,76442,51,427,11,1432,6331
377.791,17,3,222,3,46,188895,46,222,0,0,0,0,0
5.337,6,38,7229,19,218,296,314,3383,19,513,282,1179,3846
4.833,6,40,7309,21,218,241,314,3463,19,440,254,1152,3846
1786.282,6,106,8456,68,65,26660,65,4930,38,59,48275,59,3526
9.989,6,15,2391,8,125,1427,245,700,7,703,1621,1152,1691
13.393,6,23,4768,10,296,1488,722,1429,13,295,1047,1408,3339
14.431,17,3,1167,3,361,7215,371,1167,0,0,0,0,0
0.052,17,8,2454,8,278,7,317,2454,0,0,0,0,0
7.83,6,43,19962,22,813,338,1152,18781,21,341,390,341,1181
170.653,17,12,4032,12,308,15513,308,4032,0,0,0,0,0
4.042,6,40,7309,21,218,202,314,3463,19,440,210,1152,3846
5.001,6,39,7269,21,218,250,314,3463,18,513,278,1179,3806
902.403,2,7,224,7,8,150400,8,224,0,0,0,0,0
365.684,6,18,1242,14,180,28129,180,916,4,110,20063,110,326
2.311,6,58,23691,29,1035,82,1440,17755,29,433,75,1440,5936
2.531,6,24,7482,13,335,210,668,2050,11,968,249,1475,5432
630.436,2,5,160,5,8,157609,8,160,0,0,0,0,0
0.269,6,11,615,8,0,35,0,440,3,31,61,31,175
61.375,6,11,452,6,0,12275,0,244,5,0,15333,0,208
1738.614,1,56,4704,0,0,0,0,0,56,56,31611,56,4704
1768.852,1,79,6636,79,56,22677,56,6636,0,0,0,0,0
1.473,17,2,776,2,360,1473,360,776,0,0,0,0,0
2.894,6,204,208842,73,282,40,877,5499,131,1572,21,4254,203343
300.779,2,4,128,4,8,100259,8,128,0,0,0,0,0
39.34,17,22,1936,11,48,3933,48,836,11,72,3932,72,1100
1744.212,6,95,7203,63,38,28132,205,4476,32,33,56253,98,2727
1769.673,6,102,9473,67,65,26813,65,5694,35,59,52045,59,3779
1796.064,17,448,39896,403,35,4467,288,25676,45,288,40016,288,14220
1.314,6,50,18530,27,837,50,1360,12834,23,433,51,1360,5696
756.002,2,5,160,5,8,189000,8,160,0,0,0,0,0
29.242,6,4180,3983193,2688,1402,10,1448,3900933,1492,776,19,1448,82260
0.073,1,2,112,2,28,73,28,112,0,0,0,0,0
1743.351,6,95,7203,63,38,28118,205,4476,32,33,56227,98,2727
270.044,2,5,160,5,8,67511,8,160,0,0,0,0,0
280.518,6,30,7432,13,158,23376,267,1317,17,603,17523,2076,6115
8.055,6,643,587711,415,1353,18,1368,571179,228,776,34,2736,16532
3.952,6,2,88,2,0,0,0,88,0,0,0,0,0
59.868,6,32,8952,14,158,4605,267,1357,18,624,3519,1400,7595
1798.621,17,449,39928,404,35,4463,288,25708,45,288,40019,288,14220
4.269,6,34,8671,18,150,250,374,1479,16,934,283,1420,7192
0.069,6,13,4362,7,127,11,127,499,6,1181,13,1930,3863
1795.405,17,447,39864,402,35,4477,288,25644,45,288,40019,288,14220
17.199,17,4,352,2,48,17186,48,152,2,72,17186,72,200
78.369,6,9670,9220823,6227,1400,12,1448,9036291,3443,776,22,1448,184532
404.665,17,56,4666,52,30,7934,37,3030,4,381,114320,463,1636
1.309,6,45,14808,26,740,52,1360,9227,19,437,62,2715,5581
1.902,17,2,672,2,308,1902,308,672,0,0,0,0,0
3.835,6,2,80,1,0,0,0,40,1,0,0,0,40
24.317,17,1455,1707042,221,82,110,1350,24519,1234,1335,19,1350,1682523
300.759,6,52,29825,27,190,11567,444,2197,25,1385,10031,2816,27628
171.768,6,22,9783,12,410,49,922,1742,10,1271,19072,4416,8041
54.912,6,31,7725,11,155,9,267,1226,20,355,2889,3417,6499
280.015,6,29,7392,14,158,21539,267,1357,15,678,20000,3436,6035
0.394,17,2,204,1,34,0,34,62,1,114,0,114,142
254.854,17,4,352,2,60,254852,60,176,2,60,254852,60,176
65.357,6,35,9107,15,327,179,1189,2575,20,477,3439,1997,6532
0.174,6,2,1274,1,1194,0,1194,1234,1,0,0,0,40
0.183,17,2,152,1,48,0,48,76,1,48,0,48,76
15.352,17,11,4242,5,414,3830,1350,2210,6,310,3064,1350,2032
1771.279,6,101,9415,67,65,26837,65,5641,34,59,53672,59,3774
101.944,6,36,8487,18,412,529,922,2014,18,478,5986,2128,6473
1790.816,1,341,28644,341,56,5267,56,28644,0,0,0,0,0
778.353,17,10,2594,5,31,194585,37,297,5,431,194585,463,2297
4.226,6,38,7245,20,218,222,314,3423,18,516,233,1179,3822
1798.504,6,367,25650,214,99,8443,469,15045,153,69,11829,69,10605
0.053,17,4,344,2,47,11,47,150,2,69,43,75,194
0.262,17,2,167,1,39,0,39,67,1,72,0,72,100
1786.652,6,102,8296,68,65,26666,65,4930,34,59,54138,59,3366
280.613,6,29,7392,13,158,23384,267,1317,16,603,18703,2036,6075
11.84,17,4,824,2,48,11816,48,152,2,308,11824,308,672
240.502,6,43,8853,22,567,11452,1418,5689,21,258,12024,588,3164
1780.619,6,181,15589,121,69,14838,69,9049,60,69,30173,69,6540
0.048,6,10,1514,5,503,12,503,771,5,475,11,475,743
242.075,6,40,6883,20,167,12740,517,2098,20,467,12740,1418,4785
324.373,17,6,528,3,48,162184,48,228,3,72,162184,72,300
1792.092,17,141,11276,71,48,25600,48,5396,70,56,25971,56,5880
504.712,2,5,160,5,8,126178,8,160,0,0,0,0,0
281.58,6,30,7432,14,158,21660,267,1357,16,678,18771,3436,6075
340.425,17,6,1992,6,304,68085,308,1992,0,0,0,0,0
38.205,17,4,240,2,32,38203,32,120,2,32,38204,32,120
5.015,17,4,558,2,36,5004,36,128,2,187,5003,187,430
188.468,6,41,9554,20,263,9919,1189,2913,21,445,3201,1917,6641
1790.997,1,79,4424,79,28,22961,28,4424,0,0,0,0,0
981.043,6,60,4722,34,64,27907,64,2448,26,49,39238,58,2274
1780.677,1,58,4872,0,0,0,0,0,58,56,31239,56,4872
0.382,6,21,7217,13,318,31,599,1957,8,967,52,1471,5260
3.027,6,2,88,2,0,0,0,88,0,0,0,0,0
1786.185,6,355,22480,207,69,8670,69,12420,148,69,12149,69,10060
1.383,6,48,19513,27,913,53,1360,13897,21,476,59,2715,5616
174.029,6,37,13345,19,562,9668,1360,4177,18,703,10223,2134,9168
17.438,6,1591,1382783,945,1380,18,1448,1344503,646,776,26,1448,38280
106.532,6,25,9908,12,549,68,1460,2709,13,952,8865,1460,7199
2.005,17,14,5083,14,335,154,361,5083,0,0,0,0,0
1729.363,6,60,4400,40,33,44342,33,2740,20,31,91009,31,1660
367.78,6,38,8890,17,143,16993,516,1830,21,345,18384,1452,7060
103.713,6,3179,3630119,1100,226,94,233,74498,2079,1660,49,13032,3555621
1773.501,6,210,24110,133,89,13435,981,11158,77,135,23329,1420,12952
1798.246,6,368,25221,214,93,8442,469,14645,154,69,11752,69,10576
0.041,6,3,182,2,31,41,31,111,1,31,0,31,71
1796.415,17,142,11360,71,48,25662,48,5396,71,56,25663,56,5964
0.026,6,14,4020,7,88,4,88,388,7,1113,4,1460,3632
0.044,17,2,184,1,32,0,32,60,1,96,0,96,124
15.694,6,24,4395,13,214,1307,383,1812,11,427,1390,1179,2583
0.507,17,3,451,2,39,249,39,134,1,289,0,289,317
1797.673,1,345,28980,345,56,5225,56,28980,0,0,0,0,0
0.086,6,11,3287,6,81,17,81,401,5,872,21,1448,2886
20.19,6,17,2871,7,517,3365,517,885,10,1418,2220,1418,1986
1795.434,6,368,25897,216,98,8350,469,15332,152,69,11887,69,10565
0.032,17,2,384,1,32,0,32,60,1,296,0,296,324
280.228,6,29,7392,13,158,23352,267,1317,16,603,18676,2036,6075
0.475,6,26,8945,15,334,33,663,2149,11,1034,40,1946,6796
37.741,6,38,8391,19,333,662,685,1816,19,446,2089,3488,6575
1.325,6,51,19730,27,920,50,1360,13994,24,433,48,1360,5736
679.485,6,58,9231,40,91,17422,504,3624,18,305,35053,1452,5607
6.993,6,157,143244,101,1043,69,1360,20869,56,2793,124,10880,122375
300.706,6,38,8566,20,315,15826,882,2093,18,441,497,1440,6473
1786.239,6,104,8564,68,66,26660,66,4964,36,60,51032,60,3600
0.162,6,33,8553,17,293,10,517,1873,16,602,10,1889,6680
1.802,6,13,2311,8,188,257,245,700,5,1407,363,1407,1611
5.671,6,29,8403,13,155,472,267,1306,16,537,377,2840,7097
1720.511,17,12,498,11,14,172051,14,462,1,8,0,8,36
0.073,17,2,235,1,36,0,36,64,1,143,0,143,171
0.031,17,2,200,1,40,0,40,68,1,104,0,104,132
89.421,6,24,9717,12,523,66,1460,2605,12,1103,8116,2374,7112
1787.704,17,83,3480,82,14,22070,14,3444,1,8,0,8,36
0.024,17,2,399,1,39,0,39,67,1,304,0,304,332
292.283,6,1419,689571,748,849,390,1152,657867,671,404,435,1179,31704
1750.675,17,13,534,11,14,175049,14,462,2,8,1750493,8,72
9.092,6,10,1687,6,100,1818,100,344,4,1179,2942,1179,1343
0.443,17,3,543,2,39,438,39,134,1,381,0,381,409
0.303,6,21,7290,12,335,27,668,1974,9,968,37,1906,5316
0.257,17,2,476,1,39,0,39,67,1,381,0,381,409
240.183,6,57,15755,28,691,8895,1402,12535,29,213,8577,580,3220
1796.708,17,448,39896,403,35,4469,288,25676,45,288,40015,288,14220
1.491,6,47,17216,25,877,62,1460,11560,22,433,61,1460,5656
1787.917,6,355,22480,207,69,8679,69,12420,148,69,12162,69,10060
19.089,17,33,16227,18,581,1121,1350,10964,15,322,1361,1350,5263
34.086,17,9,2088,9,204,4260,204,2088,0,0,0,0,0
169.83,6,44,7898,22,135,8085,517,2133,22,418,8085,1418,5765
240.204,6,53,17846,28,799,8896,1402,15058,25,185,10008,580,2788
25.155,6,22,5135,6,341,2929,722,1345,16,268,1664,1448,3790
1772.401,6,180,15480,120,69,14894,69,8940,60,69,30032,69,6540
31.089,6,10,432,3,0,15459,0,128,7,0,5153,0,304
1777.215,1,110,6160,110,28,16304,28,6160,0,0,0,0,0
301.135,6,17,1749,10,177,33440,177,1059,7,110,50160,110,690
10.747,6,1611,1477241,1044,1363,10,1420,1450234,567,475,18,1883,27007
1.679,6,52,21243,30,950,57,1360,15542,22,437,69,2715,5701
3.059,17,4,1556,4,361,1019,361,1556,0,0,0,0,0
1799.755,17,142,11360,71,48,25709,48,5396,71,56,25709,56,5964
280.684,6,28,7352,13,158,23390,267,1317,15,603,20043,1400,6035
69.039,17,4,530,2,36,69034,36,128,2,173,69034,187,402
1796.007,1,58,4872,58,56,31508,56,4872,0,0,0,0,0
0.011,17,2,379,1,29,0,29,57,1,294,0,294,322
0.255,6,3,182,2,31,255,31,111,1,31,0,31,71
0.293,17,2,167,1,39,0,39,67,1,72,0,72,100
45.566,6,5336,4979856,3250,1444,13,1448,4853952,2086,776,21,1448,125904
363.171,6,58,13863,34,432,11005,1360,7946,24,309,764,2667,5917
1772.399,6,393,66290,221,304,8056,304,47228,172,83,10364,83,19062
541.381,2,5,160,5,8,135345,8,160,0,0,0,0,0
0.12,17,2,399,1,39,0,39,67,1,304,0,304,332
1799.59,1,57,4788,57,56,32135,56,4788,0,0,0,0,0
0.065,17,2,904,2,424,65,548,904,0,0,0,0,0
0.053,17,2,241,1,36,0,36,64,1,149,0,149,177
306.149,17,33,35970,33,1062,9567,1450,35970,0,0,0,0,0
1797.378,1,238,13328,238,28,7583,28,13328,0,0,0,0,0
0.493,17,3,451,2,39,170,39,134,1,289,0,289,317
0.404,6,50,21916,28,976,14,1380,16794,22,421,17,1923,5122
3.172,6,523,510076,181,225,17,255,13034,342,1413,9,2880,497042
1134.286,1,10,560,10,28,126031,28,560,0,0,0,0,0
0.542,6,214,193531,137,183,3,230,7989,77,2420,5,12672,185542
1.365,6,12,1767,8,100,195,100,424,4,589,365,1152,1343
0.097,6,12,624,0,0,0,0,0,12,0,0,0,624
1786.942,17,87,3648,86,14,21022,14,3612,1,8,0,8,36
11.793,6,1907,1628494,1151,1363,10,1380,1590664,756,630,15,3303,37830
1779.342,17,139,11116,70,48,25787,48,5320,69,56,26166,56,5796
4.249,6,38,7229,19,218,236,314,3383,19,513,221,1179,3846
1.399,6,56,17954,28,707,51,1360,8925,28,438,51,1360,9029
34.278,17,40,5880,20,48,1803,48,1520,20,190,1803,308,4360
4.108,17,2,122,2,33,4108,33,122,0,0,0,0,0
12.286,6,40,9530,22,105,585,352,1874,18,769,714,4662,7656
1.498,6,39,9888,20,502,78,1460,4352,19,433,73,1460,5536
8.829,6,74,20798,37,514,245,1152,15891,37,427,238,1152,4907
20.157,17,47,18528,23,493,914,1350,12004,24,243,875,1350,6524
1785.863,6,382,26871,214,97,8384,469,15390,168,69,10693,69,11481
65.531,6,77,25720,42,1115,276,1360,18579,35,249,1922,2667,7141
0.208,6,10,1671,6,552,41,948,1348,4,159,68,159,323
4.105,17,16,18167,4,1036,1368,1350,4259,12,1131,320,1350,13908
0.657,17,2,683,1,306,0,306,334,1,321,0,321,349
101.781,17,4,240,2,32,101780,32,120,2,32,101780,32,120
1765.277,6,161,12801,86,93,20767,208,8747,75,31,23849,31,4054
1.332,6,51,20993,28,943,49,1360,15297,23,433,52,1360,5696
1790.745,6,355,22480,207,69,8692,69,12420,148,69,12181,69,10060
22.992,17,36,12613,16,164,1530,1350,3086,20,448,1208,1350,9527
83.943,6,46,13299,23,926,413,1360,7484,23,348,3807,2720,5815
1113.184,1,5,280,5,28,278296,28,280,0,0,0,0,0
1795.82,1,264,14784,264,28,6828,28,14784,0,0,0,0,0
0.149,6,45,21608,27,1037,5,1420,16667,18,526,8,3303,4941
0.017,17,4,865,2,47,0,47,150,2,329,4,341,715
7.973,17,5,3686,5,709,1993,1451,3686,0,0,0,0,0
1780.322,6,354,22440,207,69,8642,69,12420,147,69,12193,69,10020
30.168,6,16,952,9,46,3771,46,488,7,46,5006,46,464
0.208,6,4,4300,3,1368,0,1368,4260,1,0,0,0,40
92.706,6,17,2055,9,302,11588,302,1370,8,83,13241,83,685
0.992,17,2,677,1,300,0,300,328,1,321,0,321,349
1747.151,6,95,7203,63,38,28179,205,4476,32,33,56349,98,2727
62.094,17,3,228,3,48,31047,48,228,0,0,0,0,0
2.771,17,2,152,1,48,0,48,76,1,48,0,48,76
13.954,6,21,6825,12,275,1268,275,1038,9,1353,1115,1440,5787
15.92,6,5,260,1,0,0,0,52,4,0,4202,0,208
1722.135,17,12,498,11,14,172213,14,462,1,8,0,8,36
1795.723,17,140,11200,70,48,26024,48,5320,70,56,26024,56,5880
5.687,6,40,7309,20,218,299,314,3423,20,513,283,1179,3886
12.133,6,1825,1683783,1185,1368,10,1380,1652529,640,383,18,1380,31254
6.908,6,24,8191,14,315,531,1091,2303,10,1072,739,2519,5888
1177.801,17,8,336,8,14,168257,14,336,0,0,0,0,0
10.174,6,2047,1812802,1187,1436,8,1448,1756522,860,776,11,1448,56280
0.242,17,3,451,2,39,201,39,134,1,289,0,289,317
0.103,17,2,218,1,65,0,65,93,1,97,0,97,125
242.081,2,2,64,2,8,242081,8,64,0,0,0,0,0
1799.902,17,180,14040,180,50,10055,50,14040,0,0,0,0,0
1704.991,1,8,448,8,28,243570,28,448,0,0,0,0,0
0.227,17,2,198,1,39,0,39,67,1,103,0,103,131
262.678,17,4,352,2,60,262677,60,176,2,60,262677,60,176
10.869,6,18,5610,10,275,1207,275,958,8,1440,831,1440,4652
1.242,6,52,21806,29,932,44,1360,16110,23,433,49,1360,5696
0.144,17,4,588,2,48,136,48,152,2,190,133,308,436
0.134,17,2,148,1,38,0,38,66,1,54,0,54,82
179.43,17,20,1760,10,48,19935,48,760,10,72,19935,72,1000
1.946,6,17,3523,9,454,243,585,2283,8,396,269,580,1240
1746.464,17,221,48576,221,191,7938,422,48576,0,0,0,0,0
89.564,1,4,224,4,28,29854,28,224,0,0,0,0,0
240.417,6,43,8396,23,449,10926,1418,5700,20,206,12652,580,2696
184.33,17,10,880,5,48,46080,48,380,5,72,46079,72,500
1070.988,1,87,4872,87,28,12453,28,4872,0,0,0,0,0
15.381,17,23,11156,12,566,1394,1350,7132,11,337,1534,1350,4024
1772.397,6,180,15480,120,69,14894,69,8940,60,69,30036,69,6540
8.964,6,1587,1335831,874,1438,10,1448,1290915,713,776,12,1448,44916
2.912,17,4,1568,4,364,970,364,1568,0,0,0,0,0
0.088,17,4,352,2,37,48,37,130,2,83,41,89,222
1793.428,6,356,22520,208,69,8663,69,12460,148,69,12200,69,10060
8.329,1,9,756,9,56,1041,56,756,0,0,0,0,0
126.143,6,129,97633,83,1272,1538,1408,85732,46,730,2187,3847,11901
1788.492,6,354,22440,206,69,8724,69,12380,148,69,12166,69,10060
1798.843,1,342,28728,342,56,5275,56,28728,0,0,0,0,0
1794.089,17,80,3354,79,14,23001,14,3318,1,8,0,8,36
1796.432,17,449,39928,404,35,4457,288,25708,45,288,40020,288,14220
249.349,6,52,10291,25,293,10389,832,3373,27,499,9589,1418,6918
1744.255,6,114,10758,71,86,24917,205,7225,43,31,41523,33,3533
1.775,6,27,10171,16,283,118,583,1495,11,1029,160,1420,8676
0.693,6,12,1048,6,256,136,256,500,6,304,136,304,548
157.43,17,6,2016,6,308,31486,308,2016,0,0,0,0,0
1792.988,1,58,4872,58,56,31455,56,4872,0,0,0,0,0
18.69,6,21,5922,11,275,1869,275,998,10,902,1378,1440,4924
719.71,2,9,288,9,8,89963,8,288,0,0,0,0,0
0.106,6,20,17683,12,273,9,517,1453,8,3951,13,7202,16230
17.392,6,1877,1694523,1186,1374,14,1380,1657250,691,558,25,1923,37273
1.791,17,2,778,2,361,1791,361,778,0,0,0,0,0
280.364,6,27,7312,12,158,25487,267,1277,15,678,20016,2045,6035
6.67,6,25,3892,13,181,555,293,1797,12,537,582,1179,2095
45.877,6,23,11606,9,181,5734,181,685,14,1129,3499,1578,10921
1.315,6,10,1102,6,483,263,483,803,4,83,435,83,299
9.599,6,93,29647,46,595,213,1152,23285,47,447,203,1179,6362
0.025,17,2,158,1,34,0,34,62,1,68,0,68,96
9.451,6,1293,1056630,703,1408,13,1448,1016762,590,776,15,1448,39868
5.093,6,14,3157,5,92,1273,92,348,9,465,569,1408,2809
1777.114,17,79,3312,78,14,23079,14,3276,1,8,0,8,36
641.982,17,52,4160,26,48,25679,48,1976,26,56,25679,56,2184
71.107,6,15,620,7,0,4237,0,288,8,0,10154,0,332
5.115,17,3,208,2,36,5003,36,128,1,52,0,52,80
25.196,17,32,4704,16,48,1679,48,1216,16,190,1679,308,3488
3.097,6,17,3329,6,92,619,92,400,11,465,280,1408,2929
4.95,6,41,7349,22,218,235,314,3503,19,513,260,1179,3846
11.917,6,1186,1101284,729,1430,15,1448,1070736,457,776,25,1448,30548
0.165,17,8,2750,8,315,23,354,2750,0,0,0,0,0
0.107,17,2,157,1,31,0,31,59,1,70,0,70,98
0.153,6,9,1346,5,145,38,145,349,4,833,16,833,997
3.202,6,28,10894,16,670,213,1360,6032,12,1089,275,2103,4862
0.017,17,4,680,2,33,0,33,122,2,251,1,323,558
623.142,6,92,12941,53,93,11983,267,4552,39,213,16398,3417,8389
2.93,17,2,116,2,30,2930,30,116,0,0,0,0,0
280.426,6,29,7392,13,158,23368,267,1317,16,603,18689,2076,6075
0.479,6,6,324,4,0,159,0,216,2,0,216,0,108
1778.007,17,142,11360,71,48,25399,48,5396,71,56,25399,56,5964
1740.45,17,29,6815,29,207,62158,207,6815,0,0,0,0,0
1757.897,6,95,7203,63,38,28353,205,4476,32,33,56700,98,2727
0.025,17,2,501,1,34,0,34,62,1,411,0,411,439
1777.614,17,309,68947,309,195,5771,422,68947,0,0,0,0,0
1.08,6,3,144,2,0,1080,0,92,1,0,0,0,52
0.425,6,52,21666,29,957,15,1380,16504,23,468,17,3303,5162
31.738,6,7,308,1,0,0,0,44,6,0,6312,0,264
2.265,6,10,429,4,0,755,0,164,6,7,393,7,265
108.594,17,4,352,2,60,108593,60,176,2,60,108589,60,176
0.211,6,10,1102,6,483,42,483,803,4,83,67,83,299
288.982,6,81,30317,38,594,7810,1418,10903,43,746,6880,1418,19414
0.068,17,2,170,1,49,0,49,77,1,65,0,65,93
1.31,6,41,10025,22,502,62,1460,4444,19,400,62,1460,5581
1787.905,6,364,25737,207,99,8679,469,14765,157,69,11460,69,10972
1643.789,1,8,848,8,78,234827,78,848,0,0,0,0,0
297.521,6,39,9753,14,158,22886,267,1357,25,410,12318,1400,8396
0.011,17,2,245,1,32,0,32,60,1,157,0,157,185
1772.301,6,180,15480,120,69,14893,69,8940,60,69,30034,69,6540
3.988,17,3,180,3,32,1994,32,180,0,0,0,0,0
1739.451,1,15,840,15,28,124246,28,840,0,0,0,0,0
0.051,17,4,284,2,32,23,32,120,2,54,30,60,164
4.067,17,5,290,5,30,1016,30,290,0,0,0,0,0
1796.758,6,356,22520,208,69,8679,69,12460,148,69,12222,69,10060
3.696,6,18,3434,10,49,410,92,651,8,393,112,1408,2783
0.305,17,2,231,1,34,0,34,62,1,141,0,141,169
1621.44,1,14,784,14,28,124726,28,784,0,0,0,0,0
1797.987,6,373,26428,216,104,8362,469,15663,157,69,11524,69,10765
1707.413,6,290,51046,109,340,13897,1360,28797,181,109,9484,3289,22249
0.226,6,25,7216,13,155,18,267,1301,12,678,19,2045,5915
233.652,6,37,8570,13,189,10214,516,1474,24,382,10155,1452,7096
0.427,6,12,1653,6,288,79,288,548,6,426,48,434,1105
1794.278,1,252,26712,252,78,7148,78,26712,0,0,0,0,0
1772.811,6,180,15480,120,69,14897,69,8940,60,69,30041,69,6540
12.43,17,22,13344,9,683,1553,1350,6403,13,505,639,1350,6941
1.057,6,23,7952,13,164,75,267,1340,10,1216,99,3819,6612
429.325,17,19,1715,19,62,23851,355,1715,0,0,0,0,0
299.528,6,6,364,4,31,99842,31,222,2,31,299517,31,142
0.778,6,10,1687,7,100,129,100,384,3,1179,261,1179,1303
1784.489,17,142,11360,71,48,25491,48,5396,71,56,25491,56,5964
743.784,17,88,7964,80,30,9414,37,4668,8,384,97573,463,3296
1747.294,6,95,7203,63,38,28182,205,4476,32,33,56354,98,2727
1779.714,6,383,24566,219,69,8163,69,13314,164,69,10918,69,11252
0.833,6,11,1727,7,100,138,100,384,4,589,193,1152,1343
74.18,17,4,304,2,48,74136,48,152,2,48,74137,48,152
8.278,6,1688,1525611,1051,1372,7,1408,1487823,637,776,12,1408,37788
1792.042,6,244,35804,152,302,11867,302,26032,92,83,19692,83,9772
126.351,17,2,136,2,40,126351,47,136,0,0,0,0,0
1770.416,6,109,10044,70,64,25658,64,5904,39,58,46587,58,4140
0.298,17,2,178,1,29,0,29,57,1,93,0,93,121
560.428,17,6,453,3,30,280205,30,174,3,65,280204,71,279
0.109,17,3,431,2,41,1,41,138,1,265,0,265,293
1792.989,6,112,7296,67,50,27166,208,4535,45,31,40738,31,2761
1786.186,6,104,8444,68,66,26659,66,4964,36,60,51031,60,3480
1720.742,17,12,498,11,14,172074,14,462,1,8,0,8,36
1026.661,2,10,320,10,8,114073,8,320,0,0,0,0,0
1.519,6,46,18897,26,942,60,1460,13321,20,476,69,2615,5576
1759.643,6,100,7866,66,45,27071,205,4902,34,35,53311,98,2964
240.286,6,52,18244,28,813,8899,1418,15297,24,241,10446,580,2947
1777.051,17,140,11200,70,48,25754,48,5320,70,56,25754,56,5880
1.408,6,28,9254,14,226,108,647,1870,14,831,92,1438,7384
5.012,17,4,558,2,36,5006,36,128,2,187,5008,187,430
1756.823,6,89,6607,44,34,40855,37,2450,45,361,39926,446,4157
19.521,17,6,1236,3,48,9756,48,228,3,308,9755,308,1008
0.102,6,4,172,2,0,102,0,92,2,0,0,0,80
272.19,1,18,1008,18,28,16011,28,1008,0,0,0,0,0
6.404,6,51,14268,21,367,320,1390,3441,30,457,214,1440,10827
1741.135,6,92,6668,60,31,29510,31,4062,32,31,56164,31,2606
7.763,6,15,1362,8,275,1109,275,878,7,96,975,96,484
1764.57,2,10,320,10,8,196063,8,320,0,0,0,0,0
0.94,17,17,8355,8,532,128,1350,4481,9,402,107,1350,3874
22.953,17,8,1176,4,48,7578,48,304,4,190,7645,308,872
1786.387,6,358,22669,209,69,8588,69,12500,149,69,12069,69,10169
1783.752,17,48,16128,48,308,37952,308,16128,0,0,0,0,0
67.857,6,36,5627,17,213,4241,585,2814,19,181,3766,580,2813
3.293,17,26,7676,26,267,131,388,7676,0,0,0,0,0
1618.336,1,8,448,8,28,231190,28,448,0,0,0,0,0
85.146,6,73,50507,46,1210,1892,1408,42368,27,747,2369,1408,8139
241.282,6,53,11070,26,202,9651,834,3038,27,508,9279,2340,8032
21.385,6,1190,1048424,744,1331,28,1368,1017128,446,753,47,1368,31296
0.798,17,2,677,1,300,0,300,328,1,321,0,321,349
0.01,6,2,80,1,0,0,0,40,1,0,0,0,40
1799.319,6,361,24692,210,85,8609,1077,13617,151,79,11993,421,11075
4.532,6,40,7325,19,218,251,314,3383,21,442,213,1152,3942
136.06,6,30,7432,13,158,11338,267,1317,17,543,8501,1400,6115
1772.164,6,180,15480,120,69,14892,69,8940,60,69,30035,69,6540
1773.045,6,180,15480,120,69,14899,69,8940,60,69,30047,69,6540
65.172,6,30,7297,14,155,5013,267,1346,16,441,4344,1420,5951
6.223,6,16,3262,9,210,775,210,908,7,664,1027,904,2354
818.61,6,110,17287,59,81,14078,721,5306,51,382,16368,1414,11981
0.154,6,3,132,2,0,2,0,92,1,0,0,0,40
1784.072,6,102,8296,68,65,26627,65,4930,34,59,54060,59,3366
1744.692,2,14,448,14,8,134207,8,448,0,0,0,0,0
300.56,6,13,979,7,177,50064,177,561,6,110,60077,110,418
1.418,6,47,18309,26,893,56,1460,12693,21,433,61,1460,5616
170.246,6,42,6067,16,165,983,722,1998,26,159,6802,2026,4069
11.442,6,1822,1581576,1095,1390,10,1420,1548263,727,467,15,1883,33313
4.307,17,5,290,5,30,1076,30,290,0,0,0,0,0
1796.051,6,356,22520,208,69,8676,69,12460,148,69,12217,69,10060
6.987,6,1419,1286740,884,1377,7,1408,1254256,535,931,12,2801,32484
1792.281,17,83,3480,82,14,22126,14,3444,1,8,0,8,36
1799.876,6,356,22520,208,69,8695,69,12460,148,69,12244,69,10060
1773.149,6,181,15589,120,69,14900,69,8940,61,69,29545,69,6649
0.312,6,25,6116,12,181,28,537,1526,13,558,25,1402,4590
300.663,6,38,8566,20,315,15824,882,2093,18,441,501,1440,6473
240.269,6,54,17582,29,771,8580,1402,14639,25,204,10010,580,2943
1776.847,1,58,4872,58,56,31172,56,4872,0,0,0,0,0
13.43,6,24,6993,13,275,1119,275,1078,11,910,841,1440,5915
0.464,6,50,20532,28,1015,17,1380,15374,22,425,20,1923,5158
7.429,6,52,9930,26,233,297,314,4781,26,456,286,1179,5149
1785.39,17,87,3648,86,14,21004,14,3612,1,8,0,8,36
242.469,6,14,1212,5,302,60617,302,570,9,83,30224,83,642
221.219,17,4,240,2,32,221218,32,120,2,32,221217,32,120
18.119,6,24,9694,9,190,416,370,1124,15,796,1291,1460,8570
1788.362,17,87,3648,86,14,21039,14,3612,1,8,0,8,36
1501.844,6,91,7587,55,65,27098,65,4020,36,59,42907,90,3567
1700.318,17,12,498,11,14,170031,14,462,1,8,0,8,36
1798.622,1,83,6972,0,0,0,0,0,83,56,21934,56,6972
3.752,17,4,352,2,48,3744,48,152,2,72,3743,72,200
20.197,6,18,3376,7,49,3333,92,471,11,1164,2001,1448,2905
9.968,6,82,24469,43,532,237,1152,18768,39,459,255,1179,5701
0.068,6,14,4920,7,100,9,100,472,7,1019,6,1448,4448
62.151,6,519,239752,273,814,228,1152,224407,246,423,252,1179,15345
2.966,6,11,467,6,0,593,0,248,5,7,693,7,219
28.536,6,30,7432,13,158,2378,267,1317,17,543,1782,1400,6115
1.066,17,4,368,2,32,995,32,120,2,96,961,96,248
292.979,6,34,7050,15,168,12163,516,1615,19,291,16271,1452,5435
0.915,6,10,1687,7,100,152,100,384,3,1179,317,1179,1303
5.394,17,35,20611,20,860,283,1350,17767,15,161,242,1350,2844
8.312,6,1330,1401529,828,1120,10,1360,60820,502,2706,16,17680,1340709
1783.815,6,351,22320,205,69,8744,69,12340,146,69,12302,69,9980
1773.434,6,180,15480,120,69,14902,69,8940,60,69,30055,69,6540
1773.09,6,180,15480,120,69,14899,69,8940,60,69,30051,69,6540
1.148,6,23,7952,12,164,88,267,1288,11,1216,97,3819,6664
1763.928,2,14,448,14,8,135686,8,448,0,0,0,0,0
14.495,6,42,13802,21,374,724,721,3466,21,730,574,2840,10336
16.677,17,28,11304,14,580,1268,1350,8512,14,171,1279,1350,2792
842.271,2,9,288,9,8,105283,8,288,0,0,0,0,0
376.146,2,6,192,6,8,75229,8,192,0,0,0,0,0
182.015,6,46,8935,18,121,5335,267,1819,28,272,6740,1460,7116
1787.097,6,356,22520,208,69,8633,69,12460,148,69,12155,69,10060
240.186,6,54,17731,29,772,8577,1402,14643,25,222,10007,580,3088
1799.13,1,16,896,16,28,119942,28,896,0,0,0,0,0
0.141,17,2,780,2,362,141,362,780,0,0,0,0,0
1749.545,17,12,498,11,14,174954,14,462,1,8,0,8,36
4.377,6,12,2271,7,188,729,245,660,5,1407,1030,1407,1611
9.208,6,16,3272,8,49,1315,92,523,8,1164,1275,1448,2749
297.037,17,4,240,2,32,297036,32,120,2,32,297036,32,120
1782.449,17,142,11360,71,48,25463,48,5396,71,56,25463,56,5964
1790.703,17,29,9512,29,300,63953,300,9512,0,0,0,0,0
1781.215,6,131,12727,80,60,22547,722,6527,51,86,35619,1402,6200
1783.813,6,111,11712,72,131,25124,1271,7630,39,70,46940,241,4082
1786.725,6,359,22709,209,69,8590,69,12569,150,69,11991,69,10140
0.815,6,16,4471,9,327,97,634,1784,7,767,130,1328,2687
280.425,6,31,7472,13,158,23368,267,1317,18,603,16492,2600,6155
0.158,17,4,284,2,32,80,32,120,2,54,79,60,164
4.745,6,23,6481,10,268,522,517,1334,13,744,392,1408,5147
0.076,6,9,1339,5,145,19,145,349,4,826,19,826,990
0.484,17,2,144,1,36,0,36,64,1,52,0,52,80
0.219,17,8,2758,8,316,31,355,2758,0,0,0,0,0
1773.128,6,180,15480,120,69,14900,69,8940,60,69,30046,69,6540
3.877,17,4,352,2,48,3867,48,152,2,72,3866,72,200
0.214,17,2,166,1,47,0,47,75,1,63,0,63,91
0.912,6,24,8975,13,264,76,700,1623,11,1150,75,2570,7352
0.116,17,2,384,1,32,0,32,60,1,296,0,296,324
0.313,17,4,334,2,39,200,39,134,2,72,0,72,200
0.48,6,4,220,2,0,480,0,100,2,0,305,0,120
1752.02,6,95,7203,63,38,28258,205,4476,32,33,56504,98,2727
1680.49,1,14,784,14,28,129268,28,784,0,0,0,0,0
1783.303,6,102,8296,68,65,26616,65,4930,34,59,54036,59,3366
1.724,6,9,527,5,43,431,43,311,4,0,572,0,216
0.124,17,2,217,1,50,0,50,78,1,111,0,111,139
315.976,6,109,34779,57,507,5642,1360,23624,52,292,6192,2720,11155
9.25,6,1831,1678495,1147,1384,7,1408,1638263,684,931,13,2801,40232
1799.708,17,334,54190,334,134,5404,363,54190,0,0,0,0,0
7.641,6,30,8255,14,247,587,503,2243,16,572,497,1440,6012
1.754,17,20,5180,20,231,92,388,5180,0,0,0,0,0
1747.684,6,125,12336,77,62,22995,722,6338,48,87,37177,1408,5998
280.187,6,29,7392,14,158,21552,267,1357,15,678,20010,3536,6035
1682.681,17,14,1036,7,30,280442,30,406,7,62,280435,62,630
13.506,6,23,4584,11,201,1328,722,1588,12,394,1211,1408,2996
8.223,6,81,24525,40,552,210,1152,18744,41,459,199,1179,5781
236.011,17,4,352,2,60,236010,60,176,2,60,236010,60,176
1.236,6,46,18985,27,881,47,1360,13449,19,476,59,2715,5536
1.941,6,15,3632,8,150,277,174,624,7,681,306,1452,3008
87.76,6,20,8677,11,316,66,639,1420,9,1377,10955,3928,7257
128.723,17,4,240,2,32,128722,32,120,2,32,128722,32,120
126.773,6,23,8052,12,378,63,799,1682,11,845,12663,4080,6370
1789.985,1,16,896,16,28,119332,28,896,0,0,0,0,0
1.304,6,51,20424,28,904,48,1360,14728,23,433,51,1360,5696
1.018,17,2,176,2,60,1018,60,176,0,0,0,0,0
11.933,6,1846,1643620,1162,1364,10,1380,1610095,684,511,17,1923,33525
411.63,1,15,1568,15,76,29402,105,1568,0,0,0,0,0
176.505,6,44,16286,21,759,8825,1408,9440,23,509,8021,1408,6846
0.238,17,2,148,1,32,0,32,60,1,60,0,60,88
1786.985,6,104,8376,68,65,26671,65,4930,36,59,51051,59,3446
18.315,6,1206,1090706,794,1300,22,1368,1063510,412,776,44,2736,27196
0.105,6,10,1671,6,552,19,948,1348,4,159,34,159,323
194.708,17,28,2072,28,46,7211,46,2072,0,0,0,0,0
0.196,17,2,602,1,46,0,46,74,1,500,0,500,528
0.76,6,335,539076,151,201,5,230,8869,184,2860,3,8412,530207
8.176,6,18,6871,9,275,1022,275,643,9,1171,677,1440,6228
284.292,6,71,48216,45,1180,6461,1448,40136,26,746,2463,1448,8080
1.076,6,24,8442,14,203,82,467,1549,10,1060,114,2816,6893
0.896,6,10,1687,7,100,149,100,384,3,1179,322,1179,1303
1.346,17,6,1469,3,40,667,40,204,3,393,666,423,1265
280.44,6,30,7432,13,158,23370,267,1317,17,603,17523,2760,6115
102.515,17,4,240,2,32,102514,32,120,2,32,102514,32,120
2.139,17,2,370,1,33,0,33,61,1,281,0,281,309
0.393,6,26,9026,13,263,32,691,1736,13,943,31,1448,7290
280.612,6,27,7312,12,158,25510,267,1277,15,678,20035,2045,6035
395.15,6,21,1422,15,180,28225,180,992,6,110,12320,110,430
3.643,6,35,6209,18,206,214,314,2784,17,456,211,1152,3425
375.974,6,18,1242,14,180,28921,180,916,4,110,20066,110,326
0.049,17,5,696,3,60,16,60,264,2,188,25,188,432
127.871,17,4,240,2,32,127870,32,120,2,32,127870,32,120
20.134,6,1290,1152525,759,1434,26,1448,1118445,531,776,37,1448,34080
1798.664,17,141,11276,71,48,25695,48,5396,70,56,26067,56,5880
1786.783,6,104,8376,68,65,26668,65,4930,36,59,51048,59,3446
5.023,17,4,542,2,36,5006,36,128,2,179,5012,187,414
240.269,6,46,9126,24,519,10446,1402,5931,22,227,11441,618,3195
244.96,6,62,11701,28,235,9072,681,3862,34,356,7422,1512,7839
682.506,6,62,5698,36,116,19500,301,4224,26,31,27122,31,1474
0.313,6,27,8963,13,237,26,590,1635,14,941,22,1408,7328
1798.137,6,356,22520,208,69,8686,69,12460,148,69,12232,69,10060
52.55,17,16,18211,16,1110,3503,1451,18211,0,0,0,0,0
33.755,6,31,5093,15,154,2411,722,1858,16,342,2235,1408,3235
27.635,6,23,3754,11,195,2763,195,874,12,398,2492,419,2880
0.939,6,10,1687,7,100,156,100,384,3,1179,338,1179,1303
11.767,6,18,5839,10,784,1307,1360,3538,8,247,1640,272,2301
1799.611,17,448,39612,404,35,4465,288,25708,44,288,40951,288,13904
1.651,6,5,272,3,0,825,0,144,2,0,0,0,128
1780.01,17,140,11200,70,48,25797,48,5320,70,56,25797,56,5880
1778.862,17,374,77680,374,179,4769,422,77680,0,0,0,0,0
1778.259,17,73,3060,72,14,25045,14,3024,1,8,0,8,36
15.869,6,1436,1329784,874,1439,18,1448,1293858,562,899,27,1448,35926
0.458,17,12,5866,5,432,114,1350,2304,7,480,64,1350,3562
0.02,1,2,112,2,28,20,28,112,0,0,0,0,0
49.318,17,2,672,2,308,49318,308,672,0,0,0,0,0
16.623,17,26,18768,14,861,1273,1350,12452,12,498,1504,1350,6316
1683.422,1,7,392,7,28,280570,28,392,0,0,0,0,0
1794.449,17,87,3648,86,14,21111,14,3612,1,8,0,8,36
5.035,17,4,288,2,36,5003,36,128,2,52,5004,52,160
1747.623,6,95,7203,63,38,28187,205,4476,32,33,56362,98,2727
1742.17,6,95,7203,63,38,28099,205,4476,32,33,56193,98,2727
128.242,6,23,3336,12,180,11658,595,1712,11,261,12813,580,1624
0.515,17,3,451,2,39,131,39,134,1,289,0,289,317
1797.558,6,379,26406,219,97,8245,469,15521,160,69,11305,69,10885
0.072,6,2,80,1,0,0,0,40,1,0,0,0,40
0.185,17,2,347,1,29,0,29,57,1,262,0,262,290
43.497,6,36,8455,18,410,504,882,1982,18,478,2551,2720,6473
4.293,6,35,6209,18,206,252,314,2784,17,456,253,1152,3425
1781.774,6,355,22549,207,69,8649,69,12420,148,69,12120,69,10129
227.31,17,2,136,2,40,227310,47,136,0,0,0,0,0
1383.69,2,14,448,14,8,106437,8,448,0,0,0,0,0
0.022,6,13,3876,7,124,3,124,496,6,1530,4,1612,3380
0.964,6,26,9043,14,264,74,700,1651,12,985,69,1360,7392
0.39,6,26,8995,13,252,32,647,1692,13,945,30,1448,7303
1329.65,17,106,8480,53,48,25570,48,4028,53,56,25570,56,4452
0.008,6,20,9985,11,125,0,125,705,9,1760,0,2896,9280
1797.556,17,140,11200,70,48,26051,48,5320,70,56,26051,56,5880
1.443,6,24,9050,13,422,120,1205,2374,11,1219,123,2736,6676
240.222,6,53,17590,28,788,8896,1408,14870,25,176,10009,580,2720
1782.732,17,83,3480,82,14,22009,14,3444,1,8,0,8,36
15.66,6,6,340,1,0,0,0,60,5,0,3869,0,280
1.239,6,51,21408,29,910,44,1360,15752,22,476,51,2715,5656
51.902,6,29,7257,14,155,3992,267,1346,15,482,3706,2840,5911
169.809,6,21,8523,11,549,97,1308,2119,10,1198,18846,3151,6404
1744.697,2,23,736,23,8,79304,8,736,0,0,0,0,0
201.503,6,29,6376,14,189,9139,516,1512,15,355,14386,1452,4864
1773.019,6,181,15589,120,69,14899,69,8940,61,69,29549,69,6649
1794.35,6,365,23087,211,69,8544,69,12787,154,69,11727,69,10300
5.18,6,45,8425,22,227,246,314,4062,23,429,224,1152,4363
298.6,1,6,336,6,28,59720,28,336,0,0,0,0,0
1740.429,17,30,31620,30,1026,60014,1026,31620,0,0,0,0,0
1787.162,6,356,22520,208,69,8633,69,12460,148,69,12155,69,10060
5.937,6,15,2399,7,188,989,245,660,8,703,812,1152,1739
300.711,6,39,8396,20,262,15826,671,1882,19,441,474,1460,6514
0.469,6,4,208,2,0,469,0,112,2,0,300,0,96
503.308,17,24,4944,12,48,45754,48,912,12,308,45754,308,4032
2.814,6,56,14403,27,551,108,1429,4984,29,412,93,1460,9419
0.039,17,2,146,1,37,0,37,65,1,53,0,53,81
0.037,17,4,424,2,46,5,46,148,2,110,0,110,276
146.809,6,179,135297,109,1306,1359,1448,120666,70,609,2123,1448,14631
9.582,6,84,25130,43,550,228,1152,19349,41,413,233,1152,5781
1792.251,6,356,22520,208,69,8658,69,12460,148,69,12192,69,10060
0.231,6,22,4442,11,165,23,456,1394,11,493,22,888,3048
15.603,17,15,6729,8,539,2220,1350,4539,7,284,2588,1350,2190
6.955,6,65,20406,34,552,210,1152,15723,31,491,223,1179,4683
721.936,2,6,192,6,8,144387,8,192,0,0,0,0,0
1786.143,6,104,8376,68,65,26658,65,4930,36,59,51030,59,3446
2.949,1,3,318,3,78,1474,78,318,0,0,0,0,0
33.607,6,29,5188,15,180,2400,721,1858,14,433,2569,2026,3330
0.072,6,9,1340,5,145,18,145,349,4,827,22,827,991
1794.506,6,359,22709,209,69,8627,69,12569,150,69,12042,69,10140
22.301,6,36,12391,19,576,1238,998,3108,17,660,1382,1705,9283
1.339,6,46,19056,26,954,53,1460,13480,20,433,59,1460,5576
8.884,6,70,20606,36,531,253,1152,15803,34,429,261,1152,4803
281.29,6,29,7392,13,158,23440,267,1317,16,603,18745,2036,6075
11.05,6,20,4442,11,275,1105,275,998,9,768,773,1440,3444
1.447,6,46,18991,26,949,57,1460,13415,20,433,65,1460,5576
1774.083,6,180,15480,120,69,14908,69,8940,60,69,30060,69,6540
11.6,6,21,6825,12,275,1054,275,1038,9,1353,823,1420,5787
1772.299,6,180,15480,120,69,14893,69,8940,60,69,30032,69,6540
240.199,6,55,17887,29,787,8578,1402,14914,26,179,9607,580,2973
1.91,17,2,116,2,30,1910,30,116,0,0,0,0,0
37.664,17,11,836,11,48,3766,48,836,0,0,0,0,0
5.542,6,20,9330,10,275,615,275,679,10,1030,352,1440,8651
1335.158,17,247,18772,247,48,5427,48,18772,0,0,0,0,0
5.015,17,4,530,2,36,5006,36,128,2,173,5004,187,402
556.732,6,441,71755,249,304,2244,304,50696,192,83,2914,83,21059
1.381,6,38,8278,19,321,76,1164,2742,19,433,66,1360,5536
22.309,6,49,10491,25,706,431,1360,4622,24,376,962,4027,5869
0.284,17,2,384,1,39,0,39,67,1,289,0,289,317
63.743,17,4,352,2,60,63742,60,176,2,60,63742,60,176
1793.54,6,356,22520,208,69,8664,69,12460,148,69,12200,69,10060
1783.598,6,356,22520,208,69,8616,69,12460,148,69,12130,69,10060
3.647,6,32,8777,16,340,243,721,2684,16,605,231,2840,6093
1786.825,6,104,8444,68,66,26669,66,4964,36,60,51049,60,3480
280.42,6,31,7472,13,158,23368,267,1317,18,603,16492,2076,6155
0.031,17,2,519,1,40,0,40,68,1,423,0,423,451
0.051,17,2,198,1,39,0,39,67,1,103,0,103,131
20.604,6,23,6179,14,117,1584,159,1337,9,873,2574,1658,4842
0.088,17,2,390,1,46,0,46,74,1,288,0,288,316
2.0,17,6,360,3,32,999,32,180,3,32,999,32,180
0.46,6,10,968,5,256,112,256,460,5,304,112,304,508
14.01,6,6,328,4,0,4670,0,216,2,0,13675,0,112
1749.605,17,12,498,11,14,174960,14,462,1,8,0,8,36
62.119,6,77,53476,48,1186,1321,1368,45232,29,841,2209,2519,8244
0.089,6,9,1339,5,145,22,145,349,4,826,27,826,990
11.375,6,27,11373,13,275,947,275,1078,14,1080,765,1420,10295
1.085,6,26,8995,13,252,90,647,1692,13,945,76,1448,7303
0.014,17,2,443,1,40,0,40,68,1,347,0,347,375
0.02,6,10,1568,5,121,5,121,389,5,911,4,911,1179
5.339,6,569,513424,364,1349,14,1368,498100,205,776,25,2736,15324
280.212,17,4,1098,2,30,280199,30,116,2,463,280201,463,982
0.849,6,10,924,5,283,142,283,551,5,105,143,105,373
29.224,17,4,352,2,60,29223,60,176,2,60,29223,60,176
1681.722,17,14,1036,7,30,280284,30,406,7,62,280284,62,630
0.638,17,2,144,1,36,0,36,64,1,52,0,52,80
0.0,17,1,701,1,673,0,673,701,0,0,0,0,0
1786.032,6,104,8376,68,65,26657,65,4930,36,59,51025,59,3446
95.432,6,472,144654,249,220,384,795,42553,223,502,429,998,102101
12.387,1,4,224,4,28,4129,28,224,0,0,0,0,0
249.156,6,116,87861,75,1249,3366,1408,77607,41,811,3010,3847,10254
252.244,2,3,96,3,8,126122,8,96,0,0,0,0,0
1729.223,6,61,4464,41,33,43230,33,2804,20,31,91000,31,1660
0.218,6,47,20171,26,1001,8,1420,15110,21,420,10,1420,5061
1.456,6,20,10720,9,156,182,156,560,11,1213,113,1360,10160
641.373,17,95,7267,48,40,13642,41,3292,47,56,13942,57,3975
2.749,17,3,468,3,128,1374,128,468,0,0,0,0,0
1748.388,6,100,7897,65,45,27318,205,4850,35,35,51414,98,3047
1787.907,6,368,25828,211,99,8513,469,14925,157,69,11460,69,10903
1794.015,17,142,11352,72,48,25266,48,5472,70,56,25996,56,5880
102.034,17,13,2244,13,144,8502,392,2244,0,0,0,0,0
0.248,17,2,198,1,63,0,63,91,1,79,0,79,107
17.068,17,10,880,5,48,4264,48,380,5,72,4263,72,500
5.129,17,4,304,4,48,1709,48,304,0,0,0,0,0
0.019,17,2,366,1,36,0,36,64,1,274,0,274,302
343.851,1,34,5567,34,135,10419,351,5567,0,0,0,0,0
1.297,6,49,19390,29,897,46,1360,13769,20,437,59,2715,5621
1.071,6,24,8004,12,164,82,267,1288,12,1014,82,2411,6716
5.037,17,4,288,2,36,5006,36,128,2,52,5005,52,160
35.311,6,37,7704,18,144,2077,721,2124,19,508,1949,2026,5580
13.198,6,19,2529,12,211,1174,211,1078,7,545,2192,904,1451
1792.296,1,58,4872,58,56,31443,56,4872,0,0,0,0,0
1783.668,17,83,3480,82,14,22020,14,3444,1,8,0,8,36
1791.225,17,144,11520,72,48,25228,48,5472,72,56,25228,56,6048
1699.443,17,12,498,11,14,169944,14,462,1,8,0,8,36
1753.834,6,106,8573,68,48,26176,205,5198,38,36,47391,98,3375
1792.024,6,118,8710,65,26,27999,26,3832,53,110,34461,427,4878
2.268,6,50,19268,28,954,84,1460,13567,22,400,95,1460,5701
0.95,17,2,122,2,33,950,33,122,0,0,0,0,0
1797.329,17,449,39928,404,35,4459,288,25708,45,288,40017,288,14220
289.881,6,35,7074,21,140,14494,501,1970,14,412,22287,1420,5104
119.272,6,101,68345,59,1221,2056,1368,59280,42,747,1619,1368,9065
7.19,6,700,589918,422,1325,16,1368,570798,278,931,25,2736,19120
1.344,6,25,8056,12,164,104,267,1288,13,1014,95,2491,6768
0.173,6,2,206,1,126,0,126,166,1,0,0,0,40
183.928,6,42,3103,20,86,9671,86,1162,22,41,8758,63,1941
0.025,17,2,672,2,308,25,308,672,0,0,0,0,0
280.698,6,30,7773,14,158,21592,267,1357,16,641,18710,3456,6416
1793.723,6,244,35804,152,302,11878,302,26032,92,83,19711,83,9772
1.333,6,47,19146,27,889,51,1360,13570,20,476,60,2715,5576
378.503,6,22,2259,16,141,25233,141,813,6,398,4643,419,1446
1699.419,17,12,498,11,14,169941,14,462,1,8,0,8,36
1794.6,1,231,12936,231,28,7802,28,12936,0,0,0,0,0
7.058,6,1567,1464435,1000,1387,6,1408,1430287,567,931,12,2816,34148
548.827,6,9,546,6,31,109765,31,333,3,31,274403,31,213
1798.148,6,359,22709,209,69,8644,69,12569,150,69,12065,69,10140
0.029,6,4,477,3,140,1,250,437,1,0,0,0,40
1772.221,6,180,15480,120,69,14892,69,8940,60,69,30033,69,6540
3.309,17,8,704,4,37,1008,37,260,4,83,146,89,444
1799.568,17,142,11360,71,48,25707,48,5396,71,56,25707,56,5964
1786.254,17,87,3648,86,14,21014,14,3612,1,8,0,8,36
3.195,6,3,168,1,0,0,0,52,2,0,277,0,116
0.853,17,4,314,2,31,808,31,118,2,70,821,70,196
0.159,6,2,80,1,0,0,0,40,1,0,0,0,40
1.035,6,27,8463,14,270,67,561,1945,13,997,72,2720,6518
1.256,6,10,1687,7,100,209,100,384,3,1179,497,1179,1303
296.797,6,6,364,4,31,98932,31,222,2,31,296525,31,142
1780.783,6,353,22400,206,69,8686,69,12380,147,69,12197,69,10020
0.184,17,2,632,1,288,0,288,316,1,288,0,288,316
1681.628,17,14,1036,7,30,280269,30,406,7,62,280269,62,630
571.319,2,7,224,7,8,95219,8,224,0,0,0,0,0
1776.121,6,180,15480,120,69,14925,69,8940,60,69,30096,69,6540
0.393,17,2,154,1,33,0,33,61,1,65,0,65,93
423.477,17,17,5696,17,307,26467,308,5696,0,0,0,0,0
19.206,17,42,21129,19,316,1065,1350,6539,23,606,871,1350,14590
244.657,17,10,3421,10,314,27184,342,3421,0,0,0,0,0
1787.048,6,104,8444,68,66,26672,66,4964,36,60,51054,60,3480
1.413,6,23,5084,12,137,128,267,1172,11,692,140,1467,3912
1744.658,6,98,7421,64,38,27692,205,4528,34,33,52858,98,2893
300.718,6,40,29177,22,190,14319,444,1913,18,2024,14154,4206,27264
115.188,17,3,228,3,48,57594,48,228,0,0,0,0,0
1.623,6,30,10405,18,367,95,833,1825,12,1012,139,1420,8580
280.21,6,28,7352,13,158,23350,267,1317,15,678,20011,4200,6035
0.361,6,4,232,1,0,0,0,52,3,0,180,0,180
0.542,17,2,167,1,39,0,39,67,1,72,0,72,100
5.356,2,2,64,2,8,5356,8,64,0,0,0,0,0
6.808,6,16,3478,7,145,1134,145,574,9,634,755,634,2904
377.612,2,3,96,3,8,188806,8,96,0,0,0,0,0
1744.486,6,97,7307,63,38,28136,205,4476,34,33,52854,98,2831
1789.418,6,356,22520,208,69,8644,69,12460,148,69,12172,69,10060
2.958,6,12,507,7,0,493,0,288,5,7,690,7,219
0.142,6,9,1346,5,145,35,145,349,4,833,35,833,997
1.311,6,54,23919,30,997,45,1460,18183,24,476,49,2615,5736
1.125,17,7,492,4,32,363,32,240,3,56,537,60,252
362.614,6,46,10606,29,302,12950,1360,5124,17,435,539,2667,5482
1744.724,2,28,896,28,8,64619,8,896,0,0,0,0,0
166.631,6,21,9086,12,304,74,597,1425,9,1457,20807,3081,7661
13.389,17,3,228,3,48,6694,48,228,0,0,0,0,0
0.142,17,2,213,1,54,0,54,82,1,103,0,103,131
183.697,17,4,240,2,32,183695,32,120,2,32,183696,32,120
280.349,6,30,7432,13,158,23362,267,1317,17,543,17516,1400,6115
87.655,6,41,9644,17,290,2123,1189,2724,24,372,3810,1420,6920
1744.521,6,95,7203,63,38,28137,205,4476,32,33,56268,98,2727
0.26,17,2,218,1,65,0,65,93,1,97,0,97,125
1793.628,17,66,2766,65,14,28025,14,2730,1,8,0,8,36
2.072,17,3,3261,3,1059,1036,1427,3261,0,0,0,0,0
1795.183,17,142,11360,71,48,25645,48,5396,71,56,25645,56,5964
126.039,6,12,1767,6,100,25207,100,344,6,1179,25155,1179,1423
0.087,17,2,390,1,46,0,46,74,1,288,0,288,316
240.457,6,53,17624,28,777,8902,1418,14683,25,204,10016,580,2941
1772.436,6,180,15480,120,69,14894,69,8940,60,69,30036,69,6540
38.875,17,22,1936,11,48,3886,48,836,11,72,3886,72,1100
1224.945,6,84,11126,49,91,22554,515,4079,35,176,36024,1452,7047
626.244,2,6,192,6,8,125248,8,192,0,0,0,0,0
532.567,2,5,160,5,8,133141,8,160,0,0,0,0,0
280.04,6,28,7352,13,158,23336,267,1317,15,678,20000,2045,6035
1799.35,6,356,22520,208,69,8692,69,12460,148,69,12240,69,10060
368.314,6,14,1034,10,180,40923,180,708,4,110,20061,110,326
255.541,6,32,8952,14,158,19657,267,1357,18,624,15028,1400,7595
18.014,6,7,308,7,0,0,0,308,0,0,0,0,0
1793.79,1,58,4872,0,0,0,0,0,58,56,31470,56,4872
1.0,6,24,8893,14,203,76,458,1406,10,1179,90,2566,7487
1789.99,6,362,22967,210,69,8564,69,12609,152,69,11854,69,10358
530.218,6,51,8409,24,121,16477,516,2300,27,228,20389,1452,6109
1780.254,17,365,101502,365,250,4890,422,101502,0,0,0,0,0
0.161,17,2,904,2,424,161,548,904,0,0,0,0,0
845.717,17,234,36869,115,204,7418,1350,26708,119,57,7166,1350,10161
7.695,6,27,6922,12,146,699,267,1218,15,566,532,1420,5704
0.231,17,3,2906,3,940,115,1451,2906,0,0,0,0,0
2.192,6,13,2311,8,188,313,245,700,5,1407,486,1407,1611
3.38,6,2,88,2,0,0,0,88,0,0,0,0,0
238.62,6,48,9172,22,142,11352,722,2455,26,378,9535,2760,6717
15.89,6,7,392,2,0,15890,0,112,5,0,3814,0,280
10.013,6,14,10136,4,135,3337,135,351,10,1322,1112,1448,9785
6.17,6,2,149,0,0,0,0,0,2,69,6170,69,149
7.622,6,1686,1410186,918,1433,8,1448,1353490,768,776,9,1448,56696
34.371,17,122,73807,70,891,497,1350,64398,52,152,673,1350,9409
281.105,6,28,7352,14,158,21623,267,1357,14,775,21604,4836,5995
4.22,6,38,7229,19,218,234,314,3383,19,440,220,1152,3846
1416.144,6,302,78261,143,448,9972,1440,56441,159,188,8962,1698,21820
0.071,17,2,650,1,308,0,308,336,1,286,0,286,314
0.013,17,2,456,1,60,0,60,88,1,340,0,340,368
1790.425,1,58,4872,58,56,31410,56,4872,0,0,0,0,0
1745.532,6,97,7307,63,38,28153,205,4476,34,33,52883,98,2831
3.175,17,5,295,5,31,793,31,295,0,0,0,0,0
13.397,6,19,3457,11,211,1339,211,1050,8,665,1913,904,2407
1.83,6,4,172,2,0,1830,0,84,2,0,1022,0,88
18.01,6,20,9665,9,275,2251,275,918,11,1382,1719,1440,8747
372.207,6,21,1422,15,180,26586,180,992,6,110,12260,110,430
32.337,6,7,420,1,0,0,0,60,6,0,6465,0,360
0.244,6,12,4230,7,111,40,111,483,5,1739,60,3311,3747
78.97,6,76,57805,52,1207,1548,1368,49821,24,841,2700,2519,7984
0.255,17,2,152,1,48,0,48,76,1,48,0,48,76
134.06,6,126,93333,77,1289,1763,1448,82670,49,675,1850,1448,10663
0.655,17,6,660,3,78,327,84,320,3,85,219,104,340
300.783,6,39,9638,21,540,15039,1360,4116,18,399,505,1360,5522
32.042,6,9,396,2,0,3482,0,88,7,0,5325,0,308
13.497,6,1239,1113822,733,1437,18,1448,1080634,506,931,26,2896,33188
173.378,6,68,47401,44,1197,4032,1368,39419,24,840,2679,2519,7982
1710.704,17,13,534,11,14,171052,14,462,2,8,1710524,8,72
1781.876,6,356,22520,208,69,8608,69,12460,148,69,12121,69,10060
0.574,17,4,624,2,64,573,64,184,2,192,454,192,440
1.423,6,48,18313,26,1007,56,1380,13179,22,421,65,1923,5134
0.362,6,27,8963,13,237,30,590,1635,14,941,26,1402,7328
299.672,6,6,364,4,31,99890,31,222,2,31,299531,31,142
280.852,6,31,7541,13,158,23404,267,1317,18,500,16504,1400,6224
0.005,6,11,14640,1,0,0,0,40,10,1408,0,1408,14600
1785.855,6,352,22360,206,69,8711,69,12380,146,69,12316,69,9980
0.37,6,26,8995,13,252,30,647,1692,13,945,29,1438,7303
240.311,6,42,8912,21,519,12015,1402,5773,21,254,12015,617,3139
58.115,17,10,880,5,48,14527,48,380,5,72,14527,72,500
280.573,6,30,7432,13,158,23381,267,1317,17,603,17531,2760,6115
280.261,6,30,7432,13,158,23355,267,1317,17,543,17513,1400,6115
52.09,17,3,228,3,48,26045,48,228,0,0,0,0,0
764.331,6,80,10123,35,95,22478,517,2914,45,230,17370,1418,7209
1.348,6,51,21236,28,959,49,1460,15540,23,433,53,1460,5696
16.021,6,17,2425,10,211,1779,211,974,7,545,2618,904,1451
110.466,6,43,8924,21,401,646,889,2136,22,368,5254,3488,6788
5.018,17,4,306,2,36,5003,36,128,2,61,4997,70,178
66.067,6,30,7432,13,158,5505,267,1317,17,543,4124,1400,6115
40.656,17,4,240,2,32,40655,32,120,2,32,40655,32,120
92.482,6,14,2303,6,275,18496,275,519,8,1440,12783,1440,1784
10.011,17,2,130,2,37,10011,37,130,0,0,0,0,0
1772.339,6,180,15480,120,69,14893,69,8940,60,69,30038,69,6540
5.043,6,38,7245,19,218,280,314,3383,19,516,265,1179,3862
1745.594,6,94,7151,62,38,28616,205,4424,32,33,56295,98,2727
1741.498,17,30,31680,30,1028,60051,1028,31680,0,0,0,0,0
1.324,6,27,5927,13,156,110,267,1462,14,650,89,1452,4465
245.244,6,50,5667,26,161,9809,517,2549,24,154,10662,851,3118
1763.615,2,15,480,15,8,125972,8,480,0,0,0,0,0
96.474,6,15,1132,4,226,125,226,442,11,110,9629,110,690
8.381,6,1819,1683813,1150,1386,7,1408,1644361,669,931,12,2816,39452
0.426,6,10,1254,5,304,105,304,880,5,102,104,102,374
1.313,17,4,272,2,32,964,32,120,2,48,0,48,152
10.008,6,1494,1223534,810,1412,12,1448,1176122,684,776,14,1448,47412
12.164,17,20,1720,10,47,1350,47,750,10,69,1350,75,970
1799.276,1,57,4788,57,56,32129,56,4788,0,0,0,0,0
7.582,17,4,240,2,32,7581,32,120,2,32,7581,32,120
0.154,17,2,198,1,37,0,37,65,1,105,0,105,133
1787.495,6,105,8475,68,65,26679,65,4930,37,59,49650,59,3545
280.233,6,26,7142,12,181,25475,267,1212,14,670,21552,2036,5930
189.363,6,27,6213,9,220,8113,516,1246,18,352,11133,1452,4967
1799.699,6,355,22480,207,69,8736,69,12420,148,69,12242,69,10060
1720.444,17,12,498,11,14,172044,14,462,1,8,0,8,36
6.787,6,18,2786,9,152,848,267,822,9,533,815,1179,1964
0.018,6,2,116,1,0,0,0,64,1,0,0,0,52
1766.82,6,189,11598,94,47,18998,208,6806,95,31,18793,31,4792
12.383,6,7,292,4,0,4122,0,164,3,0,6183,0,128
7.381,6,45,13733,20,299,388,721,3200,25,635,299,1414,10533
0.047,17,2,912,1,308,0,308,336,1,548,0,548,576
280.267,6,31,7472,14,158,21559,267,1357,17,543,17515,1400,6115
1795.375,6,368,23276,212,69,8508,69,12896,156,69,11583,69,10380
0.318,6,3,327,2,103,3,138,287,1,0,0,0,40
138.791,6,32,8952,14,158,10676,267,1357,18,624,8160,1400,7595
163.636,6,24,10168,13,549,70,1360,2749,11,1161,16347,2720,7419
1747.394,6,99,7411,63,38,28183,205,4476,36,33,49918,98,2935
0.228,6,22,5040,11,137,22,267,1132,11,692,22,1467,3908
0.273,6,26,6084,12,164,24,453,1442,14,558,20,1408,4642
1755.202,1,126,13356,126,78,14041,78,13356,0,0,0,0,0
11.787,6,26,9960,12,275,1071,275,1038,14,927,891,1440,8922
2.899,6,36,17866,19,773,161,1460,6219,17,1095,172,1460,11647
11.676,6,1862,1613419,1125,1380,10,1420,1579718,737,467,15,1883,33701
0.115,6,5,248,3,0,4,0,156,2,0,115,0,92
0.383,6,27,7296,12,155,34,267,1261,15,678,26,2800,6035
1792.618,6,356,22520,208,69,8659,69,12460,148,69,12194,69,10060
1.725,6,14,2351,8,188,246,245,700,6,703,291,1152,1651
781.272,6,78,8942,41,89,19531,721,3939,37,122,19392,1448,5003
1682.443,1,15,840,15,28,120174,28,840,0,0,0,0,0
240.277,6,54,17894,29,788,8581,1402,14922,25,208,10011,580,2972
1.663,6,1187,1076668,649,209,2,230,36149,538,1889,3,5632,1040519
5.044,17,4,240,2,32,5043,32,120,2,32,5043,32,120
1775.37,17,120,9600,60,48,30090,48,4560,60,56,30090,56,5040
366.979,6,21,1419,15,177,26212,177,989,6,110,12227,110,430
0.917,6,24,6416,13,299,76,838,2019,11,988,90,1731,4397
1799.902,17,449,39928,404,35,4466,288,25708,45,288,40021,288,14220
0.512,6,12,1653,6,288,96,288,548,6,426,55,434,1105
1680.805,2,18,576,18,8,98870,8,576,0,0,0,0,0
203.8,17,3,228,3,48,101900,48,228,0,0,0,0,0
1787.302,6,104,8504,69,66,26283,66,5004,35,60,52564,60,3500
38.793,1,44,4576,0,0,0,0,0,44,76,902,76,4576
1791.238,1,59,4956,59,56,30883,56,4956,0,0,0,0,0
10.004,6,14,2351,8,188,1429,245,700,6,703,1948,1152,1651
1797.467,6,366,25610,213,99,8478,469,15005,153,69,11824,69,10605
1785.487,17,87,3648,86,14,21005,14,3612,1,8,0,8,36
11.378,6,1811,1572162,1100,1375,10,1420,1539501,711,420,16,1420,32661
0.024,17,4,927,2,33,0,33,122,2,374,4,404,805
3.806,17,3,228,3,48,1903,48,228,0,0,0,0,0
300.75,6,41,13615,23,892,13670,1360,8093,18,435,505,2720,5522
1751.286,17,13,534,11,14,175104,14,462,2,8,1751081,8,72
1797.667,17,449,39928,404,35,4460,288,25708,45,288,40014,288,14220
1.112,6,8,342,4,0,370,0,164,4,7,256,7,178
0.06,6,2,80,1,0,0,0,40,1,0,0,0,40
31.51,6,7,308,1,0,0,0,44,6,0,6283,0,264
1787.117,6,104,8308,68,64,26673,64,4896,36,58,51058,58,3412
3.78,17,5,295,5,31,945,31,295,0,0,0,0,0
0.017,6,5,260,2,0,8,0,104,3,0,8,0,156
317.099,6,78,17563,38,290,8570,1360,7707,40,317,8127,1360,9856
1.42,17,2,255,1,43,0,43,71,1,156,0,156,184
6.148,6,30,7297,14,155,472,267,1346,16,441,409,1420,5951
307.655,6,109,63983,54,518,5804,1354,6711,55,1157,1157,1582,57272
0.56,6,348,320549,167,184,3,275,9364,181,1695,2,5472,311185
0.789,6,2,1175,1,0,0,0,40,1,1095,0,1095,1135
102.324,6,90,59248,52,1223,2006,1368,50464,38,747,1718,1368,8784
1794.814,17,80,3354,79,14,23010,14,3318,1,8,0,8,36
280.23,17,4,1098,2,30,280217,30,116,2,463,280219,463,982
52.623,6,29,7257,13,155,4385,267,1306,16,441,3506,1460,5951
2.827,6,2,156,1,64,0,64,116,1,0,0,0,40
0.432,6,12,1653,6,288,79,288,548,6,426,50,434,1105
0.007,17,2,363,1,29,0,29,57,1,278,0,278,306
1797.964,1,244,13664,244,28,7399,28,13664,0,0,0,0,0
1.165,6,11,912,6,181,233,181,489,5,77,141,134,423
240.298,6,46,12668,23,508,10922,1402,5788,23,567,10922,2422,6880
2.094,17,3,174,3,30,1047,30,174,0,0,0,0,0
1796.98,17,448,39896,403,35,4470,288,25676,45,288,40017,288,14220
113.831,6,24,10136,13,541,55,1360,2717,11,1161,11369,2720,7419
129.684,17,4,352,2,60,129683,60,176,2,60,129680,60,176
1746.239,1,57,4788,57,56,31182,56,4788,0,0,0,0,0
1771.272,6,101,9344,66,65,27250,65,5577,35,59,52093,59,3767
38.038,2,4,160,4,16,12679,16,160,0,0,0,0,0
1523.807,1,20,1120,20,28,80200,28,1120,0,0,0,0,0
1789.079,1,58,4872,58,56,31387,56,4872,0,0,0,0,0
21.917,6,9,577,0,0,0,0,0,9,31,2739,31,577
1758.416,17,152,27089,152,150,11645,422,27089,0,0,0,0,0
285.168,6,53,6972,20,113,10847,722,2299,33,128,8906,1408,4673
98.162,6,21,10242,8,275,1551,275,878,13,1104,8138,1440,9364
6.065,6,585,528137,379,1332,16,1368,512761,206,931,28,2736,15376
1211.634,6,123,10711,77,70,15942,138,5840,46,68,26925,69,4871
0.738,17,25,16288,14,774,54,1350,11228,11,432,70,1350,5060
3.673,17,10,2515,5,40,910,40,340,5,407,917,451,2175
10.077,17,3,3019,3,978,5038,1360,3019,0,0,0,0,0
371.378,6,18,1239,14,177,28567,177,913,4,110,20059,110,326
1741.596,6,100,7494,64,38,27644,205,4559,36,33,49742,98,2935
282.028,6,30,7432,13,158,23502,267,1317,17,603,17623,2760,6115
8.803,6,17,1442,9,275,1100,275,918,8,96,1115,96,524
124.775,6,35,7906,13,155,10397,267,1306,22,336,5941,1997,6600
850.787,1,38,2128,38,28,22994,28,2128,0,0,0,0,0
0.388,6,21,7281,12,334,34,663,1969,9,967,47,1471,5312
1797.542,1,218,12208,218,28,8283,28,12208,0,0,0,0,0
1775.352,6,182,15629,121,69,14794,69,8980,61,69,29580,69,6649
1792.993,17,765,46134,765,32,2346,37,46134,0,0,0,0,0
4.062,6,9,527,5,43,1015,43,311,4,0,1332,0,216
293.213,1,10,1040,10,76,32579,91,1040,0,0,0,0,0
11.453,6,32,4070,22,211,545,211,1523,10,665,770,904,2547
0.881,17,2,572,1,39,0,39,67,1,477,0,477,505
168.244,17,4,240,2,32,168243,32,120,2,32,168243,32,120
0.006,17,2,366,1,63,0,63,91,1,247,0,247,275
0.167,17,2,152,1,48,0,48,76,1,48,0,48,76
42.374,17,24,2112,12,48,3846,48,912,12,72,3845,72,1200
0.104,17,4,368,2,32,103,32,120,2,96,48,96,248
300.309,6,47,29541,22,190,14300,444,1913,25,1316,10010,1769,27628
108.889,6,841,396913,449,819,243,1152,376085,392,428,277,1179,20828
12.137,17,20,3900,10,32,1346,32,600,10,302,1346,308,3300
0.292,17,2,262,1,39,0,39,67,1,167,0,167,195
23.186,17,37,20506,10,628,144,1350,6569,27,488,890,1350,13937
1.569,6,10,924,5,283,345,283,551,5,105,346,105,373
0.326,17,2,290,1,40,0,40,68,1,194,0,194,222
138.779,6,86,56982,52,1202,2721,1368,48426,34,753,1906,2519,8556
289.491,17,4,352,2,60,289490,60,176,2,60,289490,60,176
1.709,6,13,2311,8,188,244,245,700,5,1407,361,1407,1611
0.006,6,2,280,1,188,0,188,240,1,0,0,0,40
0.997,17,5,716,3,64,497,64,276,2,192,882,192,440
0.949,6,11,1727,7,100,158,100,384,4,589,230,1152,1343
1772.212,6,180,15480,120,69,14892,69,8940,60,69,30032,69,6540
0.303,6,10,1102,6,483,60,483,803,4,83,98,83,299
0.014,17,2,412,1,31,0,31,59,1,325,0,325,353
403.749,6,77,12606,39,131,8736,469,4064,38,226,10911,1460,8542
1.431,17,2,784,2,364,1431,364,784,0,0,0,0,0
177.88,6,25,10829,12,380,78,832,1665,13,959,14812,1440,9164
0.25,6,5,280,3,0,125,0,160,2,0,1,0,120
1797.971,6,374,26068,216,98,8362,469,15263,158,69,11450,69,10805
3.965,17,5,720,4,60,1317,60,352,1,340,0,340,368
61.299,6,37,15984,22,805,2919,1408,9206,15,665,4360,1408,6778
0.5,6,12,1653,6,288,99,288,548,6,426,57,434,1105
41.952,6,5482,5274567,3668,1361,11,1408,5175575,1814,776,23,1408,98992
1.506,6,50,19072,29,869,53,1360,13411,21,437,64,2715,5661
108.785,6,26,9849,6,341,17032,722,1345,20,438,5715,1408,8504
0.016,17,2,204,1,34,0,34,62,1,114,0,114,142
1796.357,1,58,4872,0,0,0,0,0,58,56,31515,56,4872
5.156,17,3,208,2,36,5007,36,128,1,52,0,52,80
2.646,6,115,86917,50,131,54,232,2529,65,1363,35,1430,84388
8.776,6,664,601604,434,1320,19,1368,584980,230,776,37,2736,16624
135.051,6,29,14025,15,519,58,884,2721,14,1073,10378,2568,11304
151.336,6,2,120,2,0,0,0,120,0,0,0,0,0
169.129,17,6,488,3,53,84563,64,244,3,53,84564,64,244
6.06,6,1656,1534085,1017,1428,5,1448,1496181,639,776,9,1448,37904
176.956,6,32,18701,15,708,46,1460,4174,17,1152,11051,1460,14527
68.125,1,2,120,2,32,68125,32,120,0,0,0,0,0
8.008,6,1863,1766540,1205,1393,6,1408,1727402,658,819,11,2801,39138
5.61,6,48,20848,25,525,233,1440,3754,23,897,229,1440,17094
1785.209,6,354,22440,207,69,8666,69,12420,147,69,12227,69,10020
0.451,17,4,588,2,48,238,48,152,2,190,241,308,436
1.64,6,13,2311,8,188,234,245,700,5,1407,348,1407,1611
1799.469,6,370,25839,215,99,8408,469,15154,155,69,11682,69,10685
0.019,17,2,235,1,36,0,36,64,1,143,0,143,171
19.688,6,37,8495,18,410,508,882,1982,19,441,1086,1460,6513
10.908,6,20,4442,11,275,1090,275,998,9,768,767,1440,3444
1.376,6,34,11652,18,401,80,1360,3576,16,1060,80,3942,8076
0.233,6,10,767,5,186,35,186,454,5,45,56,45,313
0.041,17,4,414,2,40,0,40,136,2,111,37,117,278
0.032,17,2,167,1,39,0,39,67,1,72,0,72,100
17.806,6,914,740355,551,1267,31,1368,716815,363,931,48,2841,23540
1744.651,2,30,960,30,8,60160,8,960,0,0,0,0,0
0.132,6,10,1514,5,503,33,503,771,5,475,33,475,743
301.011,6,45,13833,25,892,12542,1360,8186,20,402,464,2667,5647
0.415,6,26,9026,13,263,34,691,1736,13,943,32,1448,7290
281.013,6,30,7432,14,158,21616,267,1357,16,603,18732,2036,6075
1776.397,17,140,11200,70,48,25744,48,5320,70,56,25744,56,5880
1750.52,17,12,498,11,14,175052,14,462,1,8,0,8,36
1.191,6,38,9848,21,440,59,1360,4392,17,476,64,2715,5456
1789.4,17,144,11520,72,48,25202,48,5472,72,56,25202,56,6048
95.675,6,31,18612,18,702,51,1360,4967,13,1639,7961,4416,13645
0.049,6,9,1348,5,145,12,145,349,4,835,13,835,999
1740.808,6,87,6322,58,31,30540,31,3915,29,31,62171,31,2407
12.974,6,7,380,4,0,4324,0,216,3,0,6378,0,164
0.539,6,28,7480,17,306,33,1087,2826,11,701,52,1696,4654
2.171,6,13,2311,8,188,310,245,700,5,1407,481,1407,1611
0.165,17,2,904,2,424,165,548,904,0,0,0,0,0
0.004,6,2,80,1,0,0,0,40,1,0,0,0,40
1740.767,17,30,20190,30,645,60026,645,20190,0,0,0,0,0
87.419,6,46,8912,22,345,746,720,2043,24,346,3793,2128,6869
2.136,17,4,1344,4,308,712,308,1344,0,0,0,0,0
1772.909,6,180,15480,120,69,14898,69,8940,60,69,30041,69,6540
10.008,17,3,289,2,47,10001,47,150,1,111,0,111,139
377.218,6,18,1242,14,180,29016,180,916,4,110,20059,110,326
317.037,6,72,19235,36,339,9058,1360,9630,36,354,9054,1929,9605
1787.059,6,106,8456,68,65,26672,65,4930,38,59,48296,59,3526
0.027,17,2,389,1,34,0,34,62,1,299,0,299,327
1.108,6,11,1727,7,100,184,100,384,4,589,288,1152,1343
1740.448,17,30,20190,30,645,60015,645,20190,0,0,0,0,0
1795.302,17,448,39896,403,35,4465,288,25676,45,288,40019,288,14220
1797.057,1,342,28728,342,56,5269,56,28728,0,0,0,0,0
1775.738,6,181,15589,120,69,14922,69,8940,61,69,29590,69,6649
1.934,6,29,9362,14,164,135,267,1571,15,873,125,1440,7791
1798.448,1,345,28980,345,56,5228,56,28980,0,0,0,0,0
1798.164,17,449,39928,404,35,4461,288,25708,45,288,40015,288,14220
120.372,2,2,64,2,8,120372,8,64,0,0,0,0,0
0.205,6,9,1340,5,145,51,145,349,4,827,38,827,991
55.299,6,44,8813,21,334,704,688,1984,23,346,2507,2720,6829
0.088,17,2,152,1,48,0,48,76,1,48,0,48,76
421.147,2,5,160,5,8,105286,8,160,0,0,0,0,0
1797.186,6,370,23425,213,69,8477,69,13005,157,69,11520,69,10420
1.122,17,2,168,1,48,0,48,76,1,64,0,64,92
2.079,17,3,329,2,39,1578,39,134,1,167,0,167,195
115.494,6,51,22600,27,1030,4442,1360,11428,24,680,5014,1360,11172
0.046,17,4,284,2,32,26,32,120,2,54,26,60,164
1796.949,17,448,39896,403,35,4470,288,25676,45,288,40016,288,14220
7.716,6,42,7144,21,137,385,267,2361,21,787,364,1460,4783
1787.21,6,102,8364,68,66,26674,66,4964,34,60,54154,60,3400
1.418,6,50,19369,27,897,54,1440,13673,23,433,54,1440,5696
300.333,6,52,29913,20,190,15806,444,1809,32,1057,9687,1461,28104
846.517,17,9,650,5,30,211595,30,290,4,62,281745,62,360
68.305,6,32,7515,14,155,5254,267,1346,18,388,4016,1460,6169
10.415,6,16,3911,9,275,1301,275,643,7,992,916,1440,3268
1786.557,6,106,8456,68,65,26665,65,4930,38,59,48282,59,3526
106.04,6,18,2104,9,100,13255,100,472,9,252,13211,1152,1632
0.004,17,2,154,1,33,0,33,61,1,65,0,65,93
240.73,6,53,15034,28,663,8915,1402,12072,25,205,10030,580,2962
0.546,17,2,476,1,39,0,39,67,1,381,0,381,409
3.974,17,4,240,4,32,1324,32,240,0,0,0,0,0
1749.512,1,72,6048,0,0,0,0,0,72,56,24641,56,6048
1789.832,17,87,3648,86,14,21056,14,3612,1,8,0,8,36
1798.187,17,759,45786,759,32,2372,37,45786,0,0,0,0,0
0.28,17,2,184,1,32,0,32,60,1,96,0,96,124
1638.87,2,9,288,9,8,204858,8,288,0,0,0,0,0
0.146,17,12,4389,12,337,13,360,4389,0,0,0,0,0
8.156,6,18,6631,9,275,1019,275,643,9,1123,935,1380,5988
1786.241,6,109,8830,71,66,25517,66,5150,38,60,48274,60,3680
1793.161,1,274,15344,274,28,6568,28,15344,0,0,0,0,0
1681.452,1,15,870,15,30,120103,30,870,0,0,0,0,0
94.557,17,62,16058,62,231,1550,388,16058,0,0,0,0,0
311.254,6,101,17648,65,304,4863,304,13108,36,83,8890,83,4540
0.04,6,12,3462,6,75,7,75,395,6,1373,8,1448,3067
1676.09,1,7,392,7,28,279348,28,392,0,0,0,0,0
1796.786,17,768,46392,768,32,2342,37,46392,0,0,0,0,0
0.005,6,2,144,1,0,0,0,40,1,64,0,64,104
5.304,6,38,7229,20,218,279,314,3423,18,513,296,1179,3806
72.387,6,21,8279,11,525,94,1237,2048,10,1163,8021,3151,6231
6.201,6,34,6185,17,206,387,314,2744,17,551,361,1179,3441
188.066,6,33,3885,18,180,11062,595,2024,15,266,13432,580,1861
95.445,1,4,224,4,28,31815,28,224,0,0,0,0,0
0.023,6,10,1514,5,503,5,503,771,5,475,5,475,743
280.435,6,31,7813,14,158,21571,267,1357,17,577,17526,2036,6456
1788.237,6,363,22938,210,69,8556,69,12678,153,69,11764,69,10260
175.232,17,2,72,1,8,0,8,36,1,8,0,8,36
1791.579,17,180,14040,180,50,10008,50,14040,0,0,0,0,0
1783.814,6,357,22629,208,69,8617,69,12460,149,69,12052,69,10169
12.55,17,16,3460,8,47,1790,47,600,8,329,1791,341,2860
0.48,6,23,4506,11,165,48,456,1394,12,493,38,888,3112
1788.967,17,142,11360,71,48,25556,48,5396,71,56,25556,56,5964
1740.742,17,30,31680,30,1028,60025,1028,31680,0,0,0,0,0
5.845,6,519,449902,322,1330,17,1368,434626,197,776,28,1473,15276
1795.069,6,206,18199,104,120,17427,208,12972,102,31,17770,31,5227
0.957,6,10,1687,7,100,159,100,384,3,1179,354,1179,1303
33.315,6,27,4885,13,180,2776,722,1754,14,399,2548,1448,3131
827.371,1,7,969,7,110,137895,207,969,0,0,0,0,0
0.081,17,2,152,2,48,81,48,152,0,0,0,0,0
1738.854,1,56,4704,56,56,31615,56,4704,0,0,0,0,0
65.189,17,3,181,3,32,32594,33,181,0,0,0,0,0
839.509,6,116,14808,68,84,12529,267,5507,48,175,17861,1420,9301
0.034,6,10,1512,5,503,8,503,771,5,473,8,473,741
10.411,6,83,24893,43,561,247,1152,19136,40,461,260,1179,5757
0.194,1,2,112,2,28,194,28,112,0,0,0,0,0
255.328,6,30,7432,13,158,21277,267,1317,17,543,15955,1400,6115
2.578,6,4,298,0,0,0,0,0,4,69,859,69,298
1740.261,6,87,6322,58,31,30530,31,3915,29,31,62151,31,2407
2.543,6,116,87200,50,131,51,232,2529,66,1367,34,1430,84671
10.654,6,20,4390,11,275,1065,275,998,9,755,738,1414,3392
1745.661,6,96,7255,62,38,28617,205,4424,34,33,52891,98,2831
0.117,6,9,1339,5,145,29,145,349,4,826,35,826,990
191.165,6,70,46815,44,1175,4445,1408,38730,26,960,2461,3847,8085
367.306,6,18,1239,14,177,28254,177,913,4,110,20056,110,326
11.601,6,1852,1599017,1112,1382,10,1420,1564896,740,467,15,1883,34121
0.846,6,23,6426,13,313,69,906,2092,10,982,93,1731,4334
64.79,6,7,420,7,0,0,0,420,0,0,0,0,0
10.408,17,2,102,0,0,0,0,0,2,23,10408,26,102
1692.773,2,13,416,13,8,141064,8,416,0,0,0,0,0
37.923,6,42,8752,21,367,508,787,2034,21,419,1890,4848,6718
4.237,17,5,4754,5,922,1059,1451,4754,0,0,0,0,0
12.082,17,20,1440,10,33,1342,33,610,10,55,1341,61,830
0.422,6,12,1653,6,288,77,288,548,6,426,48,434,1105
44.131,17,5346,1979279,3664,475,12,1108,1844850,1682,51,26,598,134429
1792.765,1,58,4872,58,56,31452,56,4872,0,0,0,0,0
1740.434,17,29,19517,29,645,62158,645,19517,0,0,0,0,0
134.491,17,8,2688,8,308,19213,308,2688,0,0,0,0,0
60.347,6,4,168,3,0,30173,0,124,1,0,0,0,44
0.795,6,15,2224,7,288,103,288,620,8,424,88,434,1604
0.205,17,2,2380,2,1162,205,1162,2380,0,0,0,0,0
0.028,17,4,288,2,33,0,33,122,2,55,0,61,166
1785.887,6,104,8376,68,65,26655,65,4930,36,59,51022,59,3446
1770.27,6,103,9592,67,66,26822,66,5728,36,60,50576,60,3864
128.069,17,4,1344,4,308,42689,308,1344,0,0,0,0,0
5.017,17,4,288,2,36,5017,36,128,2,52,5016,52,160
4.713,6,40,7309,20,218,248,314,3423,20,440,234,1152,3886
34.016,6,31,5106,15,154,2429,722,1872,16,342,2254,1408,3234
34.413,6,15,2297,9,211,4301,211,898,6,545,6882,904,1399
0.448,17,4,1108,2,30,435,30,116,2,468,435,468,992
1.113,6,24,8004,12,164,86,267,1288,12,1014,86,2816,6716
280.309,6,30,7432,13,158,23359,267,1317,17,543,17513,1400,6115
0.066,6,6,300,4,0,2,0,208,2,0,66,0,92
1794.943,1,206,21836,206,78,8755,78,21836,0,0,0,0,0
5.859,6,42,7389,22,218,279,314,3503,20,440,295,1152,3886
1765.3,1,89,7476,0,0,0,0,0,89,56,20060,56,7476
0.011,17,2,251,1,36,0,36,64,1,159,0,159,187
1.475,6,5,262,4,31,281,31,222,1,0,0,0,40
99.121,6,47,10041,23,450,601,766,2813,24,347,4304,2720,7228
63.264,6,27,7177,12,155,5751,267,1266,15,482,4518,1420,5911
5.18,6,5,224,3,0,2590,0,128,2,0,1022,0,96
158.794,6,28,6515,11,216,5562,501,1310,17,322,9919,1420,5205
369.024,6,23,1535,16,177,24601,177,1053,7,110,10372,110,482
1795.054,1,58,4872,0,0,0,0,0,58,56,31492,56,4872
0.037,17,2,672,2,308,37,308,672,0,0,0,0,0
1776.75,17,142,11360,71,48,25381,48,5396,71,56,25381,56,5964
61.367,6,36,8455,18,410,513,882,1982,18,478,3601,2720,6473
1773.214,6,180,15480,120,69,14900,69,8940,60,69,30049,69,6540
0.278,6,21,7281,13,334,22,663,2021,8,1209,38,1906,5260
1796.184,17,447,39864,402,35,4479,288,25644,45,288,40018,288,14220
280.3,6,26,7272,12,158,25481,267,1277,14,775,21556,2800,5995
0.85,6,129,106346,57,338,15,338,3648,72,1434,10,1631,102698
7.06,6,1783,1645639,1127,1382,6,1408,1606863,656,931,10,2816,38776
4.216,17,5,295,5,31,1054,31,295,0,0,0,0,0
13.247,6,14,2185,8,324,1892,585,1073,6,396,2604,580,1112
1773.069,6,180,15480,120,69,14899,69,8940,60,69,30043,69,6540
0.45,17,8,2750,8,315,64,354,2750,0,0,0,0,0
0.126,17,2,602,1,46,0,46,74,1,500,0,500,528
3.888,17,4,1564,4,363,1296,363,1564,0,0,0,0,0
1795.129,1,212,11872,212,28,8507,28,11872,0,0,0,0,0
280.199,6,26,7272,12,158,25472,267,1277,14,775,21552,2800,5995
2.448,6,28,10093,12,265,222,764,1731,16,835,152,1418,8362
1680.58,1,15,870,15,30,120041,30,870,0,0,0,0,0
55.352,17,6,528,3,60,27675,60,264,3,60,27675,60,264
17.56,17,4,304,4,48,5853,48,304,0,0,0,0,0
37.887,17,22,1672,22,48,1804,48,1672,0,0,0,0,0
299.808,17,26,3999,13,40,24983,40,884,13,211,24982,249,3115
1782.781,6,354,22440,207,69,8654,69,12420,147,69,12210,69,10020
0.052,17,4,336,2,34,0,34,124,2,78,20,84,212
6.092,17,6,414,3,33,3042,33,183,3,49,3043,49,231
0.012,17,2,427,1,47,0,47,75,1,324,0,324,352
1744.418,6,95,7203,63,38,28135,205,4476,32,33,56261,98,2727
1764.178,2,12,384,12,8,160379,8,384,0,0,0,0,0
30.31,6,36,9426,17,315,1894,721,3209,19,681,1626,1414,6217
1194.194,6,90,12027,57,93,21324,498,4813,33,190,37315,1414,7214
1783.614,6,371,25341,214,93,8373,469,14714,157,69,11431,69,10627
1679.898,1,15,840,15,28,119992,28,840,0,0,0,0,0
170.885,6,20,8672,11,314,66,634,1415,9,1377,21346,3928,7257
1770.655,6,111,10230,70,66,25661,66,5974,41,60,44263,60,4256
0.012,17,2,364,1,62,0,62,90,1,246,0,246,274
1798.166,17,449,39928,404,35,4461,288,25708,45,288,40018,288,14220
280.05,1,2,120,2,32,280050,32,120,0,0,0,0,0
4.12,17,4,304,4,48,1373,48,304,0,0,0,0,0
0.011,6,3,120,2,0,11,0,80,1,0,0,0,40
4.786,6,39,7285,20,218,251,314,3423,19,516,251,1179,3862
151.834,6,206,172521,138,1300,1108,1408,158082,68,680,2207,3847,14439
0.416,6,51,17680,28,869,15,1380,12473,23,355,16,1380,5207
0.164,6,25,7216,13,155,13,267,1301,12,678,14,4200,5915
382.626,6,27,3258,18,141,22507,141,917,9,492,2943,775,2341
1744.739,2,28,896,28,8,64619,8,896,0,0,0,0,0
1750.307,1,75,6300,75,56,23652,56,6300,0,0,0,0,0
61.846,6,80,53083,47,1205,1344,1448,44637,33,746,1925,1448,8446
35.671,6,35,13591,19,480,1981,928,4155,16,798,2350,1696,9436
1786.656,1,59,4956,0,0,0,0,0,59,56,30804,56,4956
1770.512,6,102,9540,67,66,26825,66,5728,35,60,52071,60,3812
1771.933,6,180,15480,120,69,14890,69,8940,60,69,30031,69,6540
55.857,6,33,7805,12,155,5077,267,1266,21,334,2792,2840,6539
16.53,6,22,6637,8,154,2361,267,792,14,527,1257,2920,5845
0.335,17,8,2766,8,317,47,356,2766,0,0,0,0,0
0.445,17,2,152,1,48,0,48,76,1,48,0,48,76
280.029,6,31,7472,14,158,21540,267,1357,17,543,17499,1400,6115
1800.0,6,219,17314,83,75,21585,375,8497,136,49,13333,143,8817
0.084,17,2,279,1,36,0,36,64,1,187,0,187,215
0.006,6,3,168,2,24,0,24,128,1,0,0,0,40
0.059,17,2,241,1,36,0,36,64,1,149,0,149,177
0.189,6,27,7296,13,155,15,267,1301,14,603,13,1400,5995
1787.017,17,87,3648,86,14,21023,14,3612,1,8,0,8,36
6.78,6,28,12541,12,265,616,764,1743,16,995,451,2816,10798
1.637,6,25,8763,15,285,116,587,1459,10,985,163,1420,7304
280.352,6,31,7472,14,158,21565,267,1357,17,543,17518,1300,6115
0.851,17,16,12352,9,668,106,1350,6264,7,841,60,1350,6088
11.595,6,24,8413,13,275,966,275,1078,11,1147,850,2840,7335
1620.132,1,7,392,7,28,270022,28,392,0,0,0,0,0
1797.846,6,376,26286,217,98,8323,469,15372,159,69,11376,69,10914
2.835,17,2,784,2,364,2835,364,784,0,0,0,0,0
882.398,2,8,256,8,8,126056,8,256,0,0,0,0,0
1791.022,17,178,13884,178,50,10118,50,13884,0,0,0,0,0
116.341,6,25,6757,12,181,10576,267,1212,13,717,9690,2036,5545
0.779,17,4,624,2,64,421,64,184,2,192,452,192,440
1.655,17,6,432,3,36,812,36,192,3,52,808,52,240
0.027,17,3,1007,1,137,0,137,165,2,393,26,393,842
0.493,6,22,7255,13,318,41,600,1958,9,964,58,1471,5297
60.029,17,5,2599,5,491,15007,696,2599,0,0,0,0,0
67.029,6,33,9459,11,155,82,267,1226,22,408,3191,1420,8233
16.721,6,25,5293,8,256,2388,722,1437,17,247,1033,1408,3856
1.081,17,23,17285,10,740,120,1350,7684,13,710,85,1350,9601
1740.699,6,87,6322,58,31,30538,31,3915,29,31,62166,31,2407
1.313,6,48,19101,27,883,50,1360,13485,21,433,56,1360,5616
125.046,17,9,2984,9,303,15630,308,2984,0,0,0,0,0
1681.268,1,15,840,15,28,120090,28,840,0,0,0,0,0
1791.18,6,362,23836,212,81,8489,469,13558,150,69,12020,69,10278
15.574,17,24,7371,11,357,1549,1350,4242,13,212,1290,1350,3129
300.706,6,41,8657,21,283,15035,786,2041,20,414,466,2720,6616
318.061,6,76,18986,39,315,8370,1460,9787,37,335,8829,1629,9199
0.175,6,12,3705,6,171,33,171,491,6,964,29,1448,3214
9.011,17,4,240,2,32,9010,32,120,2,32,9010,32,120
1624.346,2,17,544,17,8,101521,8,544,0,0,0,0,0
1794.821,17,142,11360,71,48,25640,48,5396,71,56,25640,56,5964
690.282,1,11,1069,11,69,69028,88,1069,0,0,0,0,0
604.056,17,7,2520,7,332,100676,1316,2520,0,0,0,0,0
0.56,6,22,7342,13,335,46,668,2026,9,1210,64,1946,5316
601.597,2,6,192,6,8,120319,8,192,0,0,0,0,0
737.759,6,49,8425,27,115,18754,501,2470,22,253,35127,1420,5955
3.995,6,23,6480,10,268,439,517,1333,13,744,329,1418,5147
0.259,17,3,507,2,39,106,39,134,1,345,0,345,373
0.308,6,26,16741,16,144,20,255,1404,10,2115,33,7010,15337
1590.939,6,93,7440,56,65,26562,65,4060,37,52,44190,59,3380
31.721,6,7,308,1,0,0,0,44,6,0,6324,0,264
653.728,6,208,42118,95,331,6954,1440,23437,113,246,5834,1702,18681
1764.626,2,14,448,14,8,135740,8,448,0,0,0,0,0
302.741,6,23,1649,10,31,33617,31,675,13,31,25212,31,974
132.699,17,4,352,2,60,132698,60,176,2,60,132698,60,176
266.901,17,4,352,2,60,266900,60,176,2,60,266900,60,176
240.31,6,44,8498,22,449,11443,1402,5660,22,187,11443,580,2838
1798.916,1,16,896,16,28,119927,28,896,0,0,0,0,0
0.865,6,29,7398,17,423,54,1109,2416,12,561,61,2744,4982
301.234,6,45,14541,24,791,13097,1360,8899,21,399,449,1360,5642
1786.123,6,96,7872,64,66,28351,66,4672,32,60,57613,60,3200
2.005,17,3,1173,3,363,1002,363,1173,0,0,0,0,0
0.491,1,2,163,2,53,491,78,163,0,0,0,0,0
120.459,6,22,8775,11,467,88,1064,1875,11,1074,12028,1791,6900
33.455,6,33,5243,16,180,2230,722,1911,17,271,2078,1408,3332
1772.356,6,180,15480,120,69,14893,69,8940,60,69,30039,69,6540
0.21,6,9,1002,5,213,52,213,417,4,421,60,421,585
3.11,17,4,368,4,64,1036,64,368,0,0,0,0,0
1799.941,17,4432,212736,2217,20,812,20,106416,2215,20,812,20,106320
0.365,6,26,9012,13,252,30,646,1694,13,947,28,1402,7318
92.018,6,19,4267,7,316,15308,722,1321,12,1165,8350,1408,2946
0.217,6,11,1864,7,262,36,517,896,4,752,63,752,968
480.196,17,771,454212,435,848,1106,1350,381450,336,188,1433,1350,72762
182.384,6,77,47977,44,1201,4241,1448,39539,33,746,1926,1448,8438
1.325,6,41,11378,21,616,66,1460,5802,20,433,60,1460,5576
1763.786,6,4577,4261795,1656,148,1065,925,99804,2921,1408,604,2836,4161991
1740.909,6,87,6322,58,31,30542,31,3915,29,31,62174,31,2407
1772.912,6,181,15589,120,69,14898,69,8940,61,69,29545,69,6649
354.831,6,34,7049,20,142,18675,515,1944,14,454,20883,1452,5105
1795.341,1,58,4872,58,56,31497,56,4872,0,0,0,0,0
1790.051,6,320,82672,192,718,9371,723,55980,128,156,14094,269,26692
39.885,6,10,600,0,0,0,0,0,10,0,0,0,600
146.194,1,3,168,3,28,73097,28,168,0,0,0,0,0
5.007,17,4,288,2,36,5007,36,128,2,52,5006,52,160
0.036,17,2,154,1,33,0,33,61,1,65,0,65,93
1781.084,1,64,5376,0,0,0,0,0,64,56,28271,56,5376
238.835,6,29,7392,14,158,18371,267,1357,15,678,17056,3436,6035
240.362,6,46,9092,24,197,10449,751,2637,22,530,11444,2380,6455
6.57,6,57,10689,29,238,234,314,5460,28,456,234,1179,5229
0.049,17,4,284,2,32,31,32,120,2,54,34,60,164
76.047,6,33,7693,12,155,36,267,1266,21,348,3801,1420,6427
4.59,17,6,1350,6,197,918,206,1350,0,0,0,0,0
66.112,17,4,352,2,60,66110,60,176,2,60,66110,60,176
1.906,6,86,54144,49,1288,39,1432,48364,37,389,48,1432,5780
0.0,1,1,36,1,8,0,8,36,0,0,0,0,0
9.665,6,11,640,5,0,2416,0,280,6,0,1401,0,360
1797.747,1,162,9072,162,28,11166,28,9072,0,0,0,0,0
1742.958,6,94,7151,62,38,28573,205,4424,32,33,56209,98,2727
317.043,6,57,12633,29,141,11322,615,3620,28,414,11737,2720,9013
240.231,6,61,20901,31,806,8007,1418,17745,30,198,8283,580,3156
1794.321,17,66,2766,65,14,28036,14,2730,1,8,0,8,36
1760.657,6,175,14224,90,103,19782,208,9677,85,31,20955,31,4547
291.527,6,49,8124,24,116,12673,517,2215,25,417,12145,1418,5909
43.38,6,25,7097,12,155,3943,267,1266,13,589,3614,3426,5831
1741.085,1,55,4620,0,0,0,0,0,55,56,32242,56,4620
0.961,6,17,2349,8,324,137,585,1061,9,396,113,580,1288
1764.403,6,105,6240,60,26,29905,26,3510,45,26,40080,26,2730
9.85,6,1657,1508478,1040,1372,9,1408,1471730,617,931,15,2801,36748
1772.87,6,180,15480,120,69,14898,69,8940,60,69,30042,69,6540
5.165,17,45,19063,23,627,234,1350,15087,22,152,194,1350,3976
1799.104,17,449,39928,404,35,4464,288,25708,45,288,40023,288,14220
280.62,6,29,7733,13,158,23385,267,1317,16,577,18706,1400,6416
0.91,17,4,566,2,31,884,31,118,2,196,897,196,448
6.157,6,14,2147,9,100,769,100,764,5,1179,1463,1179,1383
242.768,17,11,836,11,48,24276,48,836,0,0,0,0,0
154.304,1,20,1680,20,56,8121,56,1680,0,0,0,0,0
228.087,6,113,84101,71,1273,3258,1448,73755,42,679,2358,1448,10346
0.004,6,2,80,2,0,0,0,80,0,0,0,0,0
1772.297,6,180,15480,120,69,14893,69,8940,60,69,30034,69,6540
1771.472,6,101,9410,66,66,27253,66,5610,35,60,52098,60,3800
0.816,17,8,2750,8,315,116,354,2750,0,0,0,0,0
5.039,17,4,288,2,36,5007,36,128,2,52,5007,52,160
1769.504,6,99,9240,66,65,27223,65,5577,33,59,55293,59,3663
280.238,6,30,7432,13,158,23353,267,1317,17,543,17514,1400,6115
11.567,6,25,8473,13,275,963,275,1078,12,986,750,1440,7395
81.987,6,11,1202,3,594,40990,594,758,8,0,11711,0,444
11.152,6,26,11958,13,275,929,275,1078,13,1293,892,1414,10880
0.148,17,2,411,1,33,0,33,61,1,322,0,322,350
135.854,6,24,7700,8,272,265,516,1140,16,455,9050,1452,6560
0.023,17,2,152,1,48,0,48,76,1,48,0,48,76
1794.999,1,250,14000,250,28,7208,28,14000,0,0,0,0,0
1773.037,6,180,15480,120,69,14899,69,8940,60,69,30050,69,6540
7.333,6,646,511017,350,1378,20,1448,490961,296,776,24,1448,20056
5.141,6,38,7229,20,218,270,314,3423,18,513,287,1179,3806
0.459,6,5,248,3,0,229,0,144,2,0,407,0,104
240.167,6,53,17900,28,797,8894,1408,15027,25,195,10006,580,2873
60.466,6,20,8931,11,757,6046,1448,3608,9,807,7546,1448,5323
8.302,6,1691,1551205,1068,1374,7,1408,1514145,623,931,13,2801,37060
1776.838,6,76,3952,38,0,48017,0,1976,38,0,48017,0,1976
0.077,6,12,3705,6,171,15,171,491,6,964,15,1448,3214
240.217,6,55,18759,30,791,8283,1418,15818,25,204,10008,580,2941
374.713,6,23,1538,16,180,24980,180,1056,7,110,10415,110,482
1791.786,6,202,26319,111,304,16288,304,18064,91,83,19908,83,8255
1205.534,17,23,7546,23,300,54797,308,7546,0,0,0,0,0
0.46,2,2,80,2,16,460,16,80,0,0,0,0,0
156.92,17,4,304,2,48,156907,48,152,2,48,156907,48,152
77.266,6,21,9340,11,596,67,1445,2261,10,1111,8570,2374,7079
1778.874,6,104,8435,69,65,26159,65,4970,35,59,52315,59,3465
301.038,6,49,14034,27,881,11578,1460,8214,22,328,427,2567,5820
152.36,6,24,5204,9,216,6865,501,1230,15,259,10876,1420,3974
67.618,17,5,1676,5,307,16904,308,1676,0,0,0,0,0
67.031,17,60,15540,60,231,1136,388,15540,0,0,0,0,0
2.871,17,4,624,4,128,957,128,624,0,0,0,0,0
1748.464,6,97,7338,64,38,27753,205,4528,33,33,54627,98,2810
368.376,6,23,1538,16,180,24558,180,1056,7,110,10402,110,482
6.031,6,1313,1206052,826,1383,7,1408,1176064,487,931,12,2801,29988
5.045,17,3,208,2,36,5001,36,128,1,52,0,52,80
269.044,17,4,352,2,60,269043,60,176,2,60,269043,60,176
1780.018,6,244,25128,98,67,18349,659,9278,146,133,12275,1938,15850
1795.751,17,446,39264,403,35,4467,288,25676,43,288,40973,288,13588
1797.59,1,78,4368,78,28,23345,28,4368,0,0,0,0,0
8.08,6,18,6767,9,275,1010,275,643,9,1150,714,1414,6124
1.705,6,48,19816,28,872,63,1360,14240,20,476,78,2715,5576
0.021,6,13,3980,7,88,3,88,388,6,1670,3,1880,3592
4.329,17,6,2328,6,360,865,360,2328,0,0,0,0,0
0.013,17,2,187,1,28,0,28,56,1,103,0,103,131
0.565,6,37,8026,19,353,31,1432,2530,18,477,29,1473,5496
0.686,6,10,1514,5,503,171,503,771,5,475,171,475,743
111.143,6,36,8455,18,410,515,882,1982,18,478,6528,2720,6473
0.188,6,9,1339,5,145,47,145,349,4,826,36,826,990
1741.951,17,30,31680,30,1028,60067,1028,31680,0,0,0,0,0
1783.698,6,240,24920,97,67,18578,659,9238,143,134,12560,1938,15682
352.39,6,32,9996,22,124,16780,808,2276,10,1044,64,2720,7720
1742.462,6,100,7700,66,41,26807,205,4757,34,34,52790,98,2943
1786.999,17,87,3648,86,14,21023,14,3612,1,8,0,8,36
10.237,6,68,20190,36,561,292,1152,15483,32,489,321,1179,4707
0.707,6,21,9743,12,410,64,922,1742,9,1271,70,4416,8001
34.778,1,40,4160,0,0,0,0,0,40,76,891,76,4160
1.144,6,25,8056,12,164,88,267,1288,13,869,81,1440,6768
0.002,17,2,554,2,249,2,249,554,0,0,0,0,0
30.795,6,6,360,0,0,0,0,0,6,0,0,0,360
3.075,17,3,228,2,48,3054,48,152,1,48,0,48,76
0.87,1,10,840,10,56,96,56,840,0,0,0,0,0
562.005,6,56,8807,27,127,13191,515,2354,29,203,20067,1452,6453
69.504,6,30,7366,14,155,5346,267,1346,16,447,4632,2840,6020
1680.524,1,15,840,15,28,120037,28,840,0,0,0,0,0
100.661,6,24,5153,10,241,11184,722,1480,14,364,7728,1408,3673
1.17,6,13,989,7,222,193,222,510,6,231,232,231,479
282.557,6,30,7432,13,158,23546,267,1317,17,543,17657,1400,6115
0.77,6,34,8112,19,241,42,619,1758,15,574,46,4848,6354
1788.381,17,83,3480,82,14,22078,14,3444,1,8,0,8,36
1786.429,6,112,8944,69,66,26271,66,5004,43,60,42531,60,3940
49.154,6,35,15455,19,566,2730,1408,3335,16,1253,3276,2816,12120
14.764,6,29,10789,15,458,1054,1067,2007,14,912,1125,1696,8782
1793.44,6,732,49501,365,31,4927,31,24715,367,31,4898,31,24786
374.736,6,18,1242,14,180,28825,180,916,4,110,20064,110,326
267.847,6,35,6477,18,286,15755,1314,2445,17,304,16739,1420,4032
240.122,6,38,8598,18,165,14124,517,1938,20,623,12637,1402,6660
240.846,17,4,240,2,32,240845,32,120,2,32,240845,32,120
1798.794,6,191,18610,126,99,14390,469,11525,65,69,28104,69,7085
300.763,6,47,10320,24,433,13076,910,3194,23,344,691,1360,7126
1785.881,6,362,23243,206,69,8711,69,12518,156,69,11521,69,10725
367.138,6,23,1535,16,177,24475,177,1053,7,110,10362,110,482
15.906,17,19,13250,11,970,1581,1350,10980,8,255,2259,1350,2270
1739.494,6,87,6322,58,31,30517,31,3915,29,31,62124,31,2407
1260.77,2,10,320,10,8,140085,8,320,0,0,0,0,0
1796.268,17,87,3648,86,14,21132,14,3612,1,8,0,8,36
1.408,6,39,8294,19,321,78,1164,2718,20,433,64,1460,5576
1.246,6,24,8016,12,164,96,267,1300,12,1014,96,2411,6716
0.101,6,10,582,5,42,25,42,310,5,0,21,0,272
1.858,6,13,2311,8,188,265,245,700,5,1407,402,1407,1611
4.758,6,15,1208,8,283,654,283,715,7,105,763,105,493
0.094,6,9,1002,5,213,23,213,417,4,421,23,421,585
351.979,17,26,2288,13,48,29330,48,988,13,72,29330,72,1300
0.109,17,2,602,1,46,0,46,74,1,500,0,500,528
618.399,6,67,7895,33,98,19324,722,3146,34,124,18733,2026,4749
108.866,17,6,348,6,30,21773,30,348,0,0,0,0,0
11.951,2,2,64,2,8,11951,8,64,0,0,0,0,0
1796.549,17,449,39928,404,35,4457,288,25708,45,288,40021,288,14220
1741.337,6,87,6322,58,31,30549,31,3915,29,31,62188,31,2407
18.145,6,1819,1666688,1136,1388,15,1448,1626508,683,776,26,1448,40180
1740.473,17,29,30566,29,1026,62159,1026,30566,0,0,0,0,0
0.011,17,3,416,2,30,5,30,116,1,272,0,272,300
1.061,6,28,8503,15,225,63,561,1985,13,997,72,1791,6518
1799.994,6,222,19066,83,75,21951,339,8527,139,70,13042,1062,10539
192.03,6,30,7434,7,156,32005,267,758,23,319,8727,2840,6676
0.498,6,27,9118,13,263,41,688,1748,14,947,35,1368,7370
46.872,6,30,7297,14,155,3605,267,1346,16,441,3124,1420,5951
1799.382,6,439,26474,228,69,7926,69,13398,211,38,8568,69,13076
1.398,6,47,19232,27,896,53,1360,13656,20,529,63,4075,5576
1794.175,1,192,20352,192,78,9393,78,20352,0,0,0,0,0
0.166,6,9,1338,5,145,41,145,349,4,825,45,825,989
104.537,6,25,10385,13,642,72,1460,3121,12,967,9486,1460,7264
240.19,6,54,17860,29,791,8578,1402,14976,25,197,10007,580,2884
0.002,17,2,178,1,47,0,47,75,1,75,0,75,103
0.07,6,13,4276,7,126,11,126,498,6,1152,12,1845,3778
1772.536,6,180,15480,120,69,14895,69,8940,60,69,30036,69,6540
14.204,17,8,608,4,37,4732,37,260,4,59,4732,65,348
74.809,6,37,16439,16,308,4986,1018,3939,21,815,3739,1491,12500
1796.0,17,449,39928,404,35,4456,288,25708,45,288,40016,288,14220
2.878,6,31,14543,18,773,169,1360,6164,13,1307,227,2574,8379
246.066,17,4,240,2,32,246065,32,120,2,32,246065,32,120
11.79,6,19,6745,10,275,1310,275,958,9,1353,1350,1440,5787
360.928,2,5,160,5,8,90232,8,160,0,0,0,0,0
1.632,6,25,8777,15,287,116,594,1466,10,986,162,1420,7311
1777.011,1,73,6132,73,56,24680,56,6132,0,0,0,0,0
8.397,17,3,208,2,36,6360,36,128,1,52,0,52,80
0.164,6,12,3462,6,75,32,75,395,6,1373,32,1448,3067
470.842,6,51,6692,25,103,19618,722,2652,26,157,16336,1448,4040
1797.969,17,449,39928,404,35,4461,288,25708,45,288,40021,288,14220
0.243,6,9,1339,5,145,60,145,349,4,826,40,826,990
1772.257,6,180,15480,120,69,14892,69,8940,60,69,30031,69,6540
1771.079,6,103,9448,66,65,27247,65,5577,37,59,49194,59,3871
0.158,17,2,180,1,30,0,30,58,1,94,0,94,122
0.145,17,4,336,2,34,15,34,124,2,78,140,84,212
17.809,6,32,9226,18,402,1047,722,3140,14,787,1185,1380,6086
1780.922,17,142,11360,71,48,25441,48,5396,71,56,25441,56,5964
65.603,6,17,4039,7,407,10933,722,1186,10,1164,7256,1408,2853
3.255,17,2,144,1,36,0,36,64,1,52,0,52,80
11.761,6,1857,1623418,1147,1362,10,1380,1588829,710,558,16,1923,34589
240.174,6,54,18071,29,811,8577,1402,15312,25,181,10007,580,2759
0.32,6,26,8862,13,231,26,563,1608,13,938,26,1408,7254
1767.312,6,192,34042,125,302,14252,302,25534,67,83,26777,83,8508
3.864,17,2,152,2,48,3864,48,152,0,0,0,0,0
1798.231,6,354,22440,207,69,8729,69,12420,147,69,12316,69,10020
0.592,6,28,7480,17,306,37,1087,2826,11,701,57,1696,4654
1796.96,17,449,39928,404,35,4458,288,25708,45,288,40020,288,14220
1787.906,6,358,22738,209,69,8595,69,12569,149,69,12080,69,10169
6.088,6,15,5935,4,101,2026,112,371,11,639,602,1420,5564
1795.136,1,57,4788,0,0,0,0,0,57,56,32056,56,4788
11.825,6,25,8473,13,275,985,275,1078,12,986,852,1440,7395
8.567,6,17,5391,9,275,1070,275,643,8,1104,974,1440,4748
1758.462,17,314,69511,314,193,5618,364,69511,0,0,0,0,0
1795.399,17,448,39896,403,35,4466,288,25676,45,288,40023,288,14220
1783.811,6,364,23047,211,69,8494,69,12787,153,69,11735,69,10260
1780.939,1,135,7560,135,28,13290,28,7560,0,0,0,0,0
1799.09,17,763,46067,763,32,2361,37,46067,0,0,0,0,0
17.782,1,4,224,4,28,5927,28,224,0,0,0,0,0
24.411,17,16,15879,16,964,1627,1450,15879,0,0,0,0,0
0.921,6,11,1727,7,100,153,100,384,4,589,217,1152,1343
90.873,6,788,386472,436,823,208,1152,367601,352,435,258,1179,18871
6.051,6,41,7349,21,201,302,314,3463,20,440,304,1152,3886
230.174,6,24,7337,8,184,32882,267,1065,16,468,15344,1420,6272
1.189,6,39,9900,21,440,59,1360,4404,18,433,60,1360,5496
316.978,6,107,34623,54,531,5980,1360,23520,53,320,6093,1360,11103
42.37,6,28,7217,13,155,3530,267,1306,15,482,3025,1997,5911
0.233,17,4,352,2,37,0,37,130,2,83,0,89,222
49.663,6,36,8360,18,378,508,786,1886,18,478,2913,2128,6474
16.059,6,16,2358,9,210,2007,210,908,7,545,2675,904,1450
0.017,17,4,284,2,32,1,32,120,2,54,0,60,164
1710.37,17,294,59983,294,176,5837,422,59983,0,0,0,0,0
300.594,6,37,8408,20,286,15820,797,1976,17,521,529,3488,6432
81.738,6,25,5280,8,256,482,256,1860,17,304,5107,304,3420
1020.265,17,200,15200,200,48,5126,48,15200,0,0,0,0,0
1783.222,17,83,3480,82,14,22015,14,3444,1,8,0,8,36
56.116,6,13,1079,12,43,5101,43,1019,1,0,0,0,60
1.702,6,48,18841,27,865,65,1360,13225,21,433,74,1360,5616
13.944,17,16,2352,8,48,1990,48,608,8,190,1990,308,1744
280.442,6,31,7472,13,158,23370,267,1317,18,603,16493,2760,6155
1741.55,17,28,6580,28,207,64501,207,6580,0,0,0,0,0
1790.472,17,87,3648,86,14,21064,14,3612,1,8,0,8,36
1773.706,6,182,15629,121,69,14780,69,9049,61,69,29559,69,6580
169.925,6,30,7432,13,158,14160,267,1317,17,543,10618,1400,6115
0.119,17,2,180,1,30,0,30,58,1,94,0,94,122
0.109,17,2,554,1,30,0,30,58,1,468,0,468,496
24.163,6,1349,1200846,788,1439,30,1448,1163898,561,776,42,1448,36948
0.439,6,49,20049,27,985,16,1380,14915,22,421,19,1923,5134
27.194,6,9,536,3,0,13595,0,172,6,0,5438,0,364
10.769,6,20,7050,11,275,1076,275,998,9,1420,749,1420,6052
9.137,6,69,21750,36,576,261,1152,17003,33,427,277,1152,4747
39.033,17,42,6056,21,48,1951,48,1596,21,184,1951,308,4460
1799.257,6,224,21334,111,82,16356,721,10298,113,158,16062,2007,11036
0.367,6,23,7802,13,318,29,600,1970,10,884,39,1471,5832
1726.478,17,12,498,11,14,172647,14,462,1,8,0,8,36
1770.922,6,100,9358,66,66,27244,66,5610,34,60,53661,60,3748
1743.387,6,111,8043,69,31,25638,31,4714,42,31,42521,31,3329
0.0,6,2,287,2,103,0,138,287,0,0,0,0,0
1255.542,6,116,15771,66,99,19316,877,6720,50,183,25622,1448,9051
4.872,6,45,8409,22,227,232,314,4062,23,489,210,1179,4347
1.305,6,10,1687,7,100,217,100,384,3,1179,525,1179,1303
1740.482,17,30,31680,30,1028,60016,1028,31680,0,0,0,0,0
304.174,1,3,327,3,81,152087,91,327,0,0,0,0,0
464.17,1,14,784,14,28,35705,28,784,0,0,0,0,0
0.019,17,2,144,1,36,0,36,64,1,52,0,52,80
1.445,6,50,18866,27,861,55,1360,13170,23,433,57,1360,5696
349.349,6,43,6288,27,91,13436,722,2880,16,321,17287,2330,3408
5.059,17,4,428,2,39,5058,39,134,2,119,5008,119,294
1.072,17,4,660,2,33,1010,33,122,2,241,0,249,538
1781.995,6,353,22400,206,69,8692,69,12380,147,69,12205,69,10020
0.002,17,2,246,1,67,0,67,95,1,123,0,123,151
1.368,6,31,6280,15,141,97,267,1735,16,650,86,1420,4545
35.908,17,4,352,2,60,35907,60,176,2,60,35907,60,176
700.974,1,28,1568,28,28,25962,28,1568,0,0,0,0,0
287.579,6,30,7432,13,158,23964,267,1317,17,603,17970,2760,6115
20.137,17,4,824,2,48,20130,48,152,2,308,20129,308,672
12.128,17,20,4325,10,47,1346,47,750,10,329,1346,341,3575
1786.182,17,87,3648,86,14,21013,14,3612,1,8,0,8,36
8.914,6,82,24565,41,552,222,1152,18784,41,459,216,1179,5781
11.855,6,25,8473,13,275,987,275,1078,12,986,867,1440,7395
1799.926,17,449,39928,404,35,4466,288,25708,45,288,40017,288,14220
55.663,6,81,25797,23,189,2530,267,2637,58,434,974,2036,23160
240.26,6,53,17932,28,800,8897,1418,15070,25,194,10010,580,2862
26.658,6,33,8223,16,199,1777,721,2039,17,687,1593,2840,6184
1785.777,6,359,22709,209,69,8585,69,12569,150,69,11985,69,10140
0.103,6,10,1669,6,551,20,947,1346,4,159,34,159,323
0.409,6,51,22018,29,980,14,1380,16896,22,421,17,1923,5122
1736.286,17,16,4127,16,229,115752,682,4127,0,0,0,0,0
0.013,6,2,80,1,0,0,0,40,1,0,0,0,40
1795.405,17,448,39896,403,35,4466,288,25676,45,288,40019,288,14220
0.561,6,23,7802,12,318,50,600,1918,11,757,55,1408,5884
0.448,6,26,8991,13,252,37,647,1692,13,945,35,1438,7299
0.191,6,3,120,2,0,191,0,80,1,0,0,0,40
0.057,17,4,398,2,46,0,46,148,2,97,6,103,250
796.101,6,81,9170,44,91,18510,722,4127,37,111,22109,2026,5043
282.378,6,34,7734,14,158,21721,267,1357,20,464,14839,1400,6377
0.085,17,8,2446,8,277,12,316,2446,0,0,0,0,0
19.82,17,4,352,2,48,19807,48,152,2,72,19807,72,200
378.011,2,3,96,3,8,189005,8,96,0,0,0,0,0
0.253,6,27,7296,13,155,21,267,1301,14,603,18,2036,5995
1771.32,6,105,9935,68,70,26437,234,5948,37,60,49200,83,3987
1763.298,2,13,416,13,8,146941,8,416,0,0,0,0,0
1783.28,6,105,8534,69,65,26224,65,4970,36,59,50948,59,3564
1786.271,6,110,8746,70,65,25887,65,5140,40,59,45797,59,3606
32.896,1,36,3744,0,0,0,0,0,36,76,939,76,3744
1799.151,1,342,28728,342,56,5276,56,28728,0,0,0,0,0
0.01,17,2,338,1,33,0,33,61,1,249,0,249,277
0.0,17,1,232,1,204,0,204,232,0,0,0,0,0
0.081,6,10,1669,6,551,16,947,1346,4,159,27,159,323
9.96,6,8,460,3,0,4980,0,160,5,0,2012,0,300
1796.711,6,390,25791,205,81,8807,469,13416,185,52,9764,69,12375
1.044,17,6,606,3,33,500,33,183,3,113,516,145,423
0.154,17,2,144,1,36,0,36,64,1,52,0,52,80
1771.606,17,15,2910,15,166,126543,166,2910,0,0,0,0,0
1771.225,1,58,4872,58,56,31074,56,4872,0,0,0,0,0
94.246,17,4,352,2,60,94245,60,176,2,60,94244,60,176
1798.823,6,309,22999,184,92,9829,469,13583,125,69,14502,69,9416
1788.474,6,356,22520,208,69,8639,69,12460,148,69,12166,69,10060
0.407,6,12,3462,6,75,81,75,395,6,1373,81,1448,3067
0.262,6,26,6084,12,164,23,453,1442,14,558,19,1402,4642
339.459,6,59,7465,30,121,11698,721,3149,29,148,12115,1448,4316
1786.401,6,104,8376,68,65,26662,65,4930,36,59,51037,59,3446
0.025,17,8,1670,8,180,3,219,1670,0,0,0,0,0
1772.588,6,180,15480,120,69,14895,69,8940,60,69,30041,69,6540
280.57,6,28,7352,13,158,23380,267,1317,15,678,20032,3456,6035
9.819,6,1521,1357765,942,1391,10,1420,1330372,579,467,16,1883,27393
4.893,17,4,432,2,45,3048,45,146,2,115,3720,115,286
0.973,1,4,2304,4,548,324,548,2304,0,0,0,0,0
4.383,6,37,7205,19,218,243,314,3383,18,516,242,1179,3822
312.791,6,29,7045,11,273,5642,501,1811,18,346,18394,1420,5234
11.916,6,1855,1637947,1158,1361,10,1380,1605825,697,421,17,1923,32122
36.012,17,10,760,10,48,4001,48,760,0,0,0,0,0
0.03,6,2,116,1,0,0,0,64,1,0,0,0,52
1740.987,6,87,6322,58,31,30543,31,3915,29,31,62176,31,2407
1.331,6,29,6149,14,154,102,267,1644,15,780,83,1460,4505
2.23,6,13,2311,8,188,318,245,700,5,1407,496,1407,1611
1741.957,17,150,25974,150,145,11690,389,25974,0,0,0,0,0
1.66,6,54,21542,30,967,57,1460,15761,24,400,62,1460,5781
16.053,6,6,328,4,0,5351,0,216,2,0,15830,0,112
13.9,6,30,7573,12,155,1263,267,1266,18,398,817,3417,6307
1769.808,6,99,9306,66,66,27227,66,5610,33,60,55303,60,3696
0.498,17,3,451,2,39,399,39,134,1,289,0,289,317
169.722,6,59,28113,31,565,125,1360,5891,28,1004,6281,1696,22222
12.226,17,6,528,3,48,6105,48,228,3,72,6102,72,300
8.261,6,1853,1701685,1163,1384,6,1408,1661141,690,931,11,2801,40544
1593.049,1,8,848,8,78,227578,78,848,0,0,0,0,0
317.389,17,10,3360,10,308,35265,308,3360,0,0,0,0,0
0.014,17,2,479,1,41,0,41,69,1,382,0,382,410
1800.0,6,214,14736,80,46,22405,46,6248,134,46,13533,46,8488
60.033,17,12,2000,6,48,12003,48,456,6,229,12004,308,1544
1.971,6,33,6607,18,153,115,267,2102,15,650,132,1452,4505
1743.146,6,95,7203,63,38,28115,205,4476,32,33,56220,98,2727
64.046,6,36,9147,15,327,143,1189,2575,21,440,3201,1420,6572
280.471,6,29,7392,13,158,23372,267,1317,16,678,18695,3456,6075
1775.136,1,58,4872,0,0,0,0,0,58,56,31142,56,4872
1745.71,6,95,7203,63,38,28156,205,4476,32,33,56300,98,2727
6.239,6,965,957630,638,1430,9,1448,935962,327,776,18,1448,21668
1773.747,6,280,35941,115,142,15557,1360,16883,165,149,10814,4662,19058
16.344,17,26,5731,12,219,1482,1350,2971,14,169,1254,1350,2760
1796.919,17,449,39928,404,35,4458,288,25708,45,288,40018,288,14220
1788.033,6,356,22520,208,69,8637,69,12460,148,69,12163,69,10060
1.255,6,10,1687,7,100,209,100,384,3,1179,495,1179,1303
1798.893,6,367,23443,210,69,8607,69,12609,157,69,11528,69,10834
1792.093,6,356,22520,208,69,8657,69,12460,148,69,12191,69,10060
107.872,6,860,411747,456,835,237,1152,390082,404,423,266,1179,21665
0.094,17,5,1572,5,286,23,317,1572,0,0,0,0,0
0.026,17,2,350,1,39,0,39,67,1,255,0,255,283
1739.324,6,87,6322,58,31,30514,31,3915,29,31,62118,31,2407
1122.21,17,10,740,5,30,280546,30,290,5,62,280534,62,450
1745.18,6,221,18606,82,72,21543,339,8114,139,69,12646,1062,10492
845.46,17,12,7025,12,557,76860,1437,7025,0,0,0,0,0
1789.759,17,87,3648,86,14,21055,14,3612,1,8,0,8,36
1771.98,6,101,9344,66,65,27261,65,5577,35,59,52114,59,3767
242.504,6,59,20879,30,846,8361,1418,17642,29,172,8660,580,3237
280.237,6,28,7352,12,158,25476,267,1277,16,603,18678,1400,6075
0.072,17,2,672,2,308,72,308,672,0,0,0,0,0
79.32,17,4,628,2,33,79309,33,122,2,225,79308,233,506
1787.404,6,185,17195,98,129,18426,208,12754,87,31,20780,31,4441
1076.899,17,210,15960,210,48,5152,48,15960,0,0,0,0,0
18.847,17,4,240,2,32,18846,32,120,2,32,18845,32,120
1799.351,17,448,39612,404,35,4464,288,25708,44,288,40948,288,13904
424.858,6,93,15235,54,304,8016,304,10744,39,83,11177,83,4491
1.359,6,48,20432,28,913,50,1360,14856,20,476,61,2715,5576
0.046,6,2,80,1,0,0,0,40,1,0,0,0,40
276.87,6,30,7432,13,158,23072,267,1317,17,543,17301,1400,6115
280.506,6,28,7352,12,158,25500,267,1277,16,678,18691,2085,6075
1770.342,17,254,49215,254,165,6997,358,49215,0,0,0,0,0
1795.442,1,339,28476,339,56,5311,56,28476,0,0,0,0,0
1796.541,17,449,39928,404,35,4457,288,25708,45,288,40023,288,14220
1775.652,1,196,10976,196,28,9105,28,10976,0,0,0,0,0
8.988,2,5,224,5,20,2247,32,224,0,0,0,0,0
590.203,6,61,13009,31,117,19670,517,2556,30,684,20349,2447,10453
4.023,6,11,467,6,0,804,0,248,5,7,748,7,219
1783.416,17,84,3516,82,14,22015,14,3444,2,8,1783222,8,72
17.541,17,29,20539,15,824,1250,1350,12793,14,525,1346,1350,7746
1.596,6,6,340,3,0,798,0,160,3,0,488,0,180
1740.068,6,87,6322,58,31,30527,31,3915,29,31,62144,31,2407
75.753,6,31,7613,12,155,28,267,1266,19,398,4208,3417,6347
0.962,6,14,2033,7,288,157,288,876,7,426,131,434,1157
1740.014,1,12,696,12,30,158183,30,696,0,0,0,0,0
299.535,6,6,364,4,31,99845,31,222,2,31,299520,31,142
20.171,6,23,6179,14,117,1551,159,1337,9,873,2519,1658,4842
0.693,6,12,1304,6,256,136,256,756,6,304,136,304,548
240.651,2,2,64,2,8,240651,8,64,0,0,0,0,0
0.407,17,2,152,1,48,0,48,76,1,48,0,48,76
1329.22,6,96,12215,64,82,21098,504,5352,32,199,40183,1452,6863
1680.719,17,13,534,11,14,168052,14,462,2,8,1680526,8,72
31.247,6,8,348,2,0,49,0,84,6,0,6240,0,264
6.641,6,16,1387,8,182,948,182,788,8,77,834,134,599
46.342,6,14,2195,8,329,6620,595,1083,6,396,9265,580,1112
0.061,1,2,112,2,28,61,28,112,0,0,0,0,0
0.077,17,2,2752,2,1348,77,1348,2752,0,0,0,0,0
3.774,6,2,88,2,0,0,0,88,0,0,0,0,0
1.306,6,49,21028,28,950,48,1360,15412,21,433,56,1360,5616
21.03,17,4,240,2,32,21029,32,120,2,32,21028,32,120
1.417,6,47,14920,26,743,56,1360,9259,21,437,61,2720,5661
1784.533,17,142,11360,71,48,25493,48,5396,71,56,25493,56,5964
1767.584,1,58,4872,58,56,31010,56,4872,0,0,0,0,0
1771.587,6,101,9278,66,64,27255,64,5544,35,58,52102,58,3734
1795.431,17,180,14040,180,50,10030,50,14040,0,0,0,0,0
1788.557,1,110,6160,110,28,16408,28,6160,0,0,0,0,0
0.216,17,4,304,2,48,109,48,152,2,48,108,48,152
1777.507,1,258,14448,258,28,6916,28,14448,0,0,0,0,0
0.535,17,3,451,2,39,248,39,134,1,289,0,289,317
1786.63,6,108,8666,70,65,25893,65,5140,38,59,48284,59,3526
193.164,6,40,11844,15,305,13796,1189,3049,25,409,8048,1420,8795
1146.24,6,89,11436,53,92,22043,502,4246,36,185,32747,1420,7190
1786.998,6,102,8296,68,65,26671,65,4930,34,59,54146,59,3366
0.088,17,2,167,1,39,0,39,67,1,72,0,72,100
0.545,6,22,7333,13,334,45,663,2021,9,1209,63,1946,5312
1782.391,17,140,11200,70,48,25831,48,5320,70,56,25831,56,5880
32.2,6,6,328,4,0,10733,0,216,2,0,32191,0,112
0.077,17,2,572,1,39,0,39,67,1,477,0,477,505
1742.802,6,96,7286,63,38,28109,205,4476,33,33,54449,98,2810
20.072,17,18,7755,8,480,2855,1350,4071,10,340,2221,1350,3684
240.703,2,2,64,2,8,240703,8,64,0,0,0,0,0
38.909,6,27,7177,13,155,3242,267,1306,14,530,2992,3417,5871
1786.738,6,104,8376,68,65,26667,65,4930,36,59,51047,59,3446
0.103,6,10,1378,5,145,25,145,349,5,825,17,825,1029
0.439,6,21,7302,12,335,39,668,1986,9,968,54,1475,5316
56.06,6,31,7725,11,155,9,267,1226,20,355,2950,3417,6499
373.401,6,18,1242,14,180,28723,180,916,4,110,20062,110,326
1795.553,17,448,39612,404,35,4455,288,25708,44,288,40945,288,13904
372.428,6,25,1651,17,177,23276,177,1117,8,110,9239,110,534
1797.883,17,29,10005,29,317,64210,317,10005,0,0,0,0,0
1787.634,6,102,8296,68,65,26681,65,4930,34,59,54166,59,3366
1770.407,6,103,9514,66,66,27237,66,5610,37,60,49175,60,3904
58.192,6,36,8455,17,410,536,882,1942,19,441,3225,1360,6513
0.089,6,10,582,5,42,22,42,310,5,0,21,0,272
33.128,6,11,640,5,41,8250,46,323,6,38,6600,46,317
1772.224,17,16,4153,8,30,253173,37,471,8,432,253173,463,3682
1.074,6,10,1687,7,100,179,100,384,3,1179,385,1179,1303
1797.372,1,272,15232,272,28,6632,28,15232,0,0,0,0,0
30.525,6,11,3508,4,106,10173,106,274,7,736,5086,1420,3234
0.29,6,22,5876,12,164,26,453,1442,10,558,30,1448,4434
1.329,6,51,21386,29,908,47,1360,15730,22,476,53,2715,5656
13.399,6,22,5782,12,275,1218,275,1042,10,1440,943,1440,4740
0.5,17,4,288,2,36,468,36,128,2,52,466,52,160
1771.612,1,58,4872,58,56,31080,56,4872,0,0,0,0,0
0.155,1,2,112,2,28,155,28,112,0,0,0,0,0
1.235,6,23,7952,12,164,95,267,1288,11,1216,105,3819,6664
0.524,6,23,4506,11,165,52,456,1394,12,493,43,888,3112
1739.599,6,129,7954,72,43,24501,208,4744,57,31,31060,31,3210
1797.296,1,345,28980,345,56,5224,56,28980,0,0,0,0,0
1782.446,17,83,3480,82,14,22005,14,3444,1,8,0,8,36
1771.541,6,131,8010,71,26,25307,26,4270,60,26,30025,26,3740
12.299,6,58,36872,38,1045,332,1408,30215,20,934,633,2816,6657
0.012,6,3,175,1,0,0,0,40,2,31,0,31,135
4.009,6,2,88,2,0,0,0,88,0,0,0,0,0
317.188,6,64,19156,32,469,10231,1360,9791,32,383,10226,1929,9365
1796.17,6,366,25610,213,99,8472,469,15005,153,69,11813,69,10605
280.569,6,29,7392,12,158,25506,267,1277,17,678,17531,2085,6115
91.337,6,19,9056,11,499,85,1193,1971,8,1688,13024,4999,7085
63.318,6,30,7297,14,155,4870,267,1346,16,441,4220,1420,5951
1799.355,17,1056,231913,1056,191,1705,389,231913,0,0,0,0,0
280.631,6,30,7432,13,158,23385,267,1317,17,603,17537,2076,6115
1.3,6,24,6636,13,350,107,1089,2276,11,783,129,1420,4360
1624.329,2,15,480,15,8,116023,8,480,0,0,0,0,0
280.242,6,30,7432,13,158,23353,267,1317,17,543,17514,1400,6115
1794.527,6,378,23952,216,69,8346,69,13332,162,69,11145,69,10620
0.614,6,10,924,5,283,106,283,551,5,105,99,105,373
23.019,6,23,7091,14,275,1770,275,863,9,1171,999,1440,6228
0.591,17,2,144,1,36,0,36,64,1,52,0,52,80
5.022,17,4,288,2,36,5005,36,128,2,52,5005,52,160
93.4,1,4,224,4,28,31133,28,224,0,0,0,0,0
1744.156,6,96,7255,62,38,28592,205,4424,34,33,52847,98,2831
0.006,6,4,172,2,0,6,0,80,2,0,4,0,92
6.554,6,21,3264,12,163,595,267,1300,9,400,781,1179,1964
1770.146,6,106,9876,68,65,26420,65,5811,38,59,47839,59,4065
3.678,6,24,6530,11,268,362,517,1385,13,744,302,1418,5145
1785.858,6,355,22480,207,69,8669,69,12420,148,69,12148,69,10060
1798.451,17,448,39896,403,35,4473,288,25676,45,288,40023,288,14220
0.012,17,4,284,2,32,3,32,120,2,54,2,60,164
16.148,17,13,6704,7,613,2686,1350,4488,6,341,3223,1350,2216
0.784,6,146,101306,81,1302,9,1432,94415,65,475,11,1871,6891
515.44,17,76,5776,76,48,6872,48,5776,0,0,0,0,0
1791.952,1,342,28728,342,56,5254,56,28728,0,0,0,0,0
9.976,17,2,120,2,32,9976,32,120,0,0,0,0,0
1773.064,6,182,15698,120,69,14899,69,8940,62,69,29059,69,6758
75.581,6,9,515,5,43,18895,43,299,4,0,25192,0,216
362.176,2,6,192,6,8,72435,8,192,0,0,0,0,0
1797.849,6,267,32544,110,134,16492,1360,15557,157,135,11523,2720,16987
1.605,6,68,50242,42,1274,39,1408,42985,26,1179,57,3819,7257
91.61,17,2,672,2,308,91610,308,672,0,0,0,0,0
1.411,6,49,19250,28,955,52,1460,13589,21,400,61,1460,5661
121.804,6,32,8952,14,158,9369,267,1357,18,624,7154,1400,7595
65.323,6,27,7177,13,155,5443,267,1306,14,530,5024,3417,5871
1741.834,6,179,11012,90,48,19571,208,6553,89,31,19790,31,4459
1.015,17,5,1272,3,40,507,41,206,2,505,0,505,1066
1782.333,6,242,18167,149,69,12042,69,10307,93,69,19373,69,7860
2.016,17,22,5709,22,231,96,389,5709,0,0,0,0,0
240.645,2,2,64,2,8,240645,8,64,0,0,0,0,0
1784.189,6,364,25392,212,100,8455,469,14896,152,69,11815,69,10496
1795.983,17,144,11520,72,48,25295,48,5472,72,56,25295,56,6048
224.455,6,54,12115,21,247,11222,469,4316,33,231,7013,1452,7799
3.925,17,28,10174,12,453,356,1350,5774,16,247,238,1350,4400
11.421,17,12,1764,6,48,2281,48,456,6,190,2281,308,1308
2.87,6,22,6417,10,268,314,517,1333,12,744,257,1418,5084
0.014,17,2,395,1,39,0,39,67,1,300,0,300,328
0.044,17,4,352,2,37,0,37,130,2,83,5,89,222
1740.502,17,29,30624,29,1028,62160,1028,30624,0,0,0,0,0
34.695,17,38,13614,16,473,2311,1350,8029,22,225,1650,1350,5585
1046.521,17,238,24916,107,132,9872,1350,17180,131,31,8047,60,7736
1680.464,1,14,812,14,30,129266,30,812,0,0,0,0,0
10.418,6,91,28335,47,577,226,1152,22093,44,407,236,1152,6242
0.253,6,4,1037,2,0,221,0,104,2,853,36,853,933
2.867,17,3,201,3,39,1433,39,201,0,0,0,0,0
387.72,6,28,2631,16,183,25848,183,867,12,424,2874,434,1764
307.827,6,77,52013,47,1213,6691,1408,43718,30,747,2124,1408,8295
12.11,6,22,5603,12,275,1100,275,767,10,1104,1221,1440,4836
1742.721,6,119,12039,75,63,23550,721,6267,44,96,40518,1448,5772
1681.597,17,14,1036,7,30,280258,30,406,7,62,280260,62,630
281.836,17,6,525,3,32,140755,37,181,3,86,140799,136,344
2.245,6,36,13181,19,446,124,1460,3497,17,749,121,1460,9684
13.511,6,1370,1276179,841,1437,15,1448,1242295,529,776,24,1448,33884
0.1,6,10,520,0,0,0,0,0,10,0,0,0,520
0.164,6,46,20265,26,1013,6,1420,15244,20,467,8,1883,5021
0.966,17,2,122,2,33,966,33,122,0,0,0,0,0
1797.276,17,448,39896,403,35,4470,288,25676,45,288,40013,288,14220
1740.218,6,370,26929,203,104,8614,469,15350,167,69,10482,69,11579
32.616,6,1297,1151227,759,1435,42,1448,1116395,538,776,60,1448,34832
1752.871,6,95,7203,63,38,28272,205,4476,32,33,56530,98,2727
0.499,6,22,5959,12,108,45,147,919,10,927,54,1608,5040
1739.419,1,16,896,16,28,115961,28,896,0,0,0,0,0
83.143,6,28,17481,16,708,45,1360,4214,12,1825,7545,4870,13267
280.233,6,29,7392,13,158,23352,267,1317,16,543,18680,1400,6075
160.619,17,3,1008,3,308,80309,308,1008,0,0,0,0,0
0.053,17,2,266,1,41,0,41,69,1,169,0,169,197
1789.835,6,356,22520,208,69,8646,69,12460,148,69,12175,69,10060
3.968,17,4,352,4,60,1322,60,352,0,0,0,0,0
1.534,6,50,19453,29,896,54,1360,13792,21,437,66,2715,5661
60.466,17,4,5500,4,1347,20155,1347,5500,0,0,0,0,0
0.018,17,2,212,1,46,0,46,74,1,110,0,110,138
69.242,6,26,10182,13,549,106,1308,2247,13,822,5753,1360,7935
29.829,17,2,152,2,48,29829,48,152,0,0,0,0,0
5.479,6,2,123,1,0,0,0,40,1,31,0,31,83
118.622,17,4,352,2,60,118621,60,176,2,60,118621,60,176
357.119,6,64,10244,36,96,10203,267,2985,28,255,13226,1460,7259
0.266,17,3,234,2,39,194,39,134,1,72,0,72,100
1.177,6,22,6420,13,323,97,954,2140,9,1305,146,3151,4280
301.23,6,44,13367,22,720,14336,1360,7394,22,338,14336,2667,5973
1752.657,6,194,12537,97,57,18256,208,7758,97,31,18254,31,4779
1783.813,6,358,22669,209,69,8576,69,12500,149,69,12052,69,10169
0.658,17,8,2750,8,315,94,354,2750,0,0,0,0,0
300.547,6,12,915,5,177,75094,177,445,7,110,50062,110,470
1111.249,17,220,16720,220,48,5074,48,16720,0,0,0,0,0
1680.491,17,12,498,11,14,168049,14,462,1,8,0,8,36
363.084,6,70,11036,36,100,10373,267,3261,34,246,11002,1926,7775
1786.481,17,87,3648,86,14,21017,14,3612,1,8,0,8,36
1752.207,6,131,12735,79,61,22464,721,6503,52,85,34348,1448,6232
1796.001,17,82,3443,80,14,22734,15,3361,2,13,627562,18,82
1601.277,17,16,1265,8,30,228749,37,471,8,71,228749,136,794
481.298,2,4,128,4,8,160432,8,128,0,0,0,0,0
2.059,6,2,80,1,0,0,0,40,1,0,0,0,40
393.92,6,18,1242,14,180,30301,180,916,4,110,20072,110,326
8.051,6,1540,1485686,995,1417,7,1448,1452682,545,776,14,1448,33004
139.59,1,10,560,10,28,15510,28,560,0,0,0,0,0
0.261,17,2,195,1,44,0,44,72,1,95,0,95,123
4.159,17,13,14033,4,1036,1386,1350,4259,9,1058,353,1350,9774
8.793,6,81,54392,33,173,274,211,1871,48,1149,183,1432,52521
141.029,1,2,112,2,28,141029,28,112,0,0,0,0,0
5.03,17,4,288,2,36,5008,36,128,2,52,5015,52,160
1739.834,6,126,16265,75,80,23511,876,7053,51,168,34796,1408,9212
67.158,1,4,224,4,28,22386,28,224,0,0,0,0,0
11.382,6,1808,1573241,1097,1379,10,1420,1540580,711,467,16,1883,32661
1764.771,2,14,448,14,8,135751,8,448,0,0,0,0,0
300.869,6,49,20363,28,1043,11143,1440,14721,21,399,435,1440,5642
0.073,17,2,198,1,63,0,63,91,1,79,0,79,107
1783.121,17,140,11200,70,48,25842,48,5320,70,56,25842,56,5880
825.502,6,165,49005,83,798,7932,1291,34467,82,225,10190,1420,14538
87.111,6,9,468,9,0,0,0,468,0,0,0,0,0
0.012,6,2,251,1,159,0,159,211,1,0,0,0,40
10.193,6,1625,1406305,983,1376,10,1420,1376404,642,467,15,1883,29901
5.004,17,8,1469,8,155,714,392,1469,0,0,0,0,0
0.027,17,4,420,2,33,6,33,122,2,121,6,145,298
1.33,6,39,9888,20,502,70,1460,4352,19,433,63,1460,5536
140.251,6,25,7693,8,267,252,502,1126,17,420,8760,1420,6567
1796.714,17,282,60793,282,187,6394,422,60793,0,0,0,0,0
1700.635,17,13,534,11,14,170045,14,462,2,8,1700458,8,72
280.259,6,27,7312,13,158,23354,267,1317,14,775,21552,4836,5995
1.864,6,32,10369,19,283,103,582,1614,13,1028,139,1420,8755
280.232,6,27,7312,13,158,23352,267,1317,14,775,21550,4836,5995
5.075,17,4,288,2,36,5021,36,128,2,52,5022,52,160
1.337,6,46,18121,26,882,53,1360,12545,20,476,61,2715,5576
118.79,6,30,8872,14,158,9137,267,1357,16,763,7915,2036,7515
2.161,6,11,1731,7,100,360,100,384,4,1179,634,1179,1347
0.441,6,4,1037,2,0,217,0,104,2,853,225,853,933
80.865,6,34,25261,18,130,4756,139,1391,16,1786,5385,4380,23870
1771.202,6,99,9306,66,66,27249,66,5610,33,60,55347,60,3696
34.855,6,30,5042,15,180,2489,722,1859,15,342,2452,1448,3183
145.119,6,25,10829,12,380,73,832,1665,13,959,12082,1440,9164
0.312,6,27,9081,14,257,24,669,1766,13,1103,25,2804,7315
265.588,1,4,224,4,28,88529,28,224,0,0,0,0,0
4.307,6,35,6209,18,206,253,314,2784,17,456,253,1152,3425
0.013,17,2,409,1,58,0,58,86,1,295,0,295,323
0.639,6,10,924,5,283,105,283,551,5,105,109,105,373
0.045,17,4,336,2,34,1,34,124,2,78,40,84,212
1250.161,6,257,17516,112,46,11257,46,7208,145,46,8681,46,10308
0.125,17,4,420,2,33,2,33,122,2,121,2,145,298
0.324,17,2,178,1,29,0,29,57,1,93,0,93,121
1789.952,6,356,22589,208,69,8647,69,12529,148,69,12176,69,10060
5.001,17,4,288,2,36,5001,36,128,2,52,4957,52,160
44.18,17,15,7808,8,655,6311,1350,5466,7,306,2520,1350,2342
1.504,6,10,924,5,283,248,283,551,5,105,256,105,373
1.674,6,47,18499,27,843,64,1360,12923,20,433,75,1360,5576
1772.558,6,180,15480,120,69,14895,69,8940,60,69,30038,69,6540
79.342,6,29,14054,15,519,72,884,2721,14,1076,6090,2720,11333
421.09,2,6,192,6,8,84218,8,192,0,0,0,0,0
3.599,17,10,2547,5,40,896,40,340,5,413,897,423,2207
0.128,17,2,198,1,39,0,39,67,1,103,0,103,131
0.008,17,4,791,2,32,0,32,120,2,307,0,319,671
134.886,6,21,9657,11,375,78,816,1599,10,1274,14970,2720,8058
0.003,17,6,411,6,40,0,41,411,0,0,0,0,0
0.506,6,22,7345,13,334,42,663,2021,9,1209,57,1946,5324
1652.859,1,8,448,8,28,236122,28,448,0,0,0,0,0
1772.847,6,181,15589,120,69,14897,69,8940,61,69,29541,69,6649
6.433,6,1478,1343852,915,1388,6,1408,1309912,563,931,11,2816,33940
0.026,6,16,6004,8,88,3,88,452,8,1305,3,1880,5552
1771.628,6,101,9410,66,66,27255,66,5610,35,60,52104,60,3800
106.885,6,12,5885,2,92,8776,92,204,10,1286,11856,1408,5681
1791.924,6,356,22520,208,69,8656,69,12460,148,69,12189,69,10060
0.677,6,10,767,5,186,168,186,454,5,45,167,45,313
1746.461,6,99,7504,64,38,27721,205,4528,35,33,51360,98,2976
765.272,17,57,19120,57,307,13665,308,19120,0,0,0,0,0
1236.947,1,41,2296,41,28,30923,28,2296,0,0,0,0,0
1041.279,6,200,13011,112,71,9380,138,6895,88,68,11968,69,6116
113.927,6,1077,523298,575,841,198,1152,497015,502,413,226,1179,26283
190.15,17,5,1680,5,308,47537,308,1680,0,0,0,0,0
240.314,6,43,9068,20,208,12646,517,2297,23,506,10922,1418,6771
1.322,6,40,11338,22,547,62,1360,5842,18,476,67,2715,5496
42.165,17,24,2112,12,48,3832,48,912,12,72,3832,72,1200
43.001,17,24,2112,12,48,3903,48,912,12,72,3903,72,1200
0.313,17,2,212,1,46,0,46,74,1,110,0,110,138
20.456,6,25,7309,14,107,1573,159,1202,11,789,2043,1418,6107
18.607,17,17,6732,9,482,2321,1350,4591,8,239,2653,1350,2141
1773.026,1,58,4872,0,0,0,0,0,58,56,31105,56,4872
0.24,6,22,5040,11,137,24,267,1132,11,577,23,1400,3908
4.546,17,2,144,1,36,0,36,64,1,52,0,52,80
1646.585,1,120,6720,120,28,13836,28,6720,0,0,0,0,0
1776.669,17,140,11200,70,48,25748,48,5320,70,56,25748,56,5880
24.99,17,4,1635,4,380,8330,392,1635,0,0,0,0,0
3.649,6,2,88,2,0,0,0,88,0,0,0,0,0
0.612,6,23,7367,14,261,47,602,2043,9,1209,70,1946,5324
3.92,17,8,1924,4,60,1302,60,352,4,365,1303,384,1572
0.069,6,9,1343,5,145,17,145,349,4,830,17,830,994
0.091,17,2,144,1,36,0,36,64,1,52,0,52,80
204.161,1,3,168,3,28,102080,28,168,0,0,0,0,0
0.649,6,10,924,5,283,112,283,551,5,105,110,105,373
1789.848,17,142,11360,71,48,25569,48,5396,71,56,25569,56,5964
0.484,1,10,840,10,56,53,56,840,0,0,0,0,0
1787.32,6,104,8376,68,65,26676,65,4930,36,59,51062,59,3446
1792.116,1,288,30528,288,78,6244,78,30528,0,0,0,0,0
0.185,6,26,7256,12,155,16,267,1261,14,603,12,1400,5995
1772.834,6,182,15560,120,69,14897,69,8940,62,69,29055,69,6620
1756.383,6,107,6382,61,26,29272,26,3588,46,26,39029,26,2794
0.06,17,4,588,2,48,55,48,152,2,190,53,308,436
1787.554,1,173,9688,173,28,10392,28,9688,0,0,0,0,0
1794.171,17,83,3480,82,14,22150,14,3444,1,8,0,8,36
136.713,6,41,21152,14,576,708,928,4641,27,700,5252,1578,16511
370.806,6,21,1422,15,180,26486,180,992,6,110,12262,110,430
782.112,2,9,288,9,8,97764,8,288,0,0,0,0,0
6.324,1,4,413,4,75,2108,119,413,0,0,0,0,0
1799.88,6,358,22738,210,69,8611,69,12678,148,69,12243,69,10060
1.773,6,30,8872,14,158,136,267,1357,16,763,113,2800,7515
1684.558,2,16,512,16,8,112303,8,512,0,0,0,0,0
1786.603,6,104,8444,68,66,26665,66,4964,36,60,51043,60,3480
1791.54,17,180,14040,180,50,10008,50,14040,0,0,0,0,0
0.433,6,53,23073,29,1040,15,1380,17871,24,421,16,1923,5202
2.217,6,20,3833,11,234,221,564,1504,9,463,254,1343,2329
0.174,6,27,7296,13,155,14,267,1301,14,543,12,1400,5995
6.247,6,42,7405,21,218,312,314,3463,21,442,299,1152,3942
1789.334,1,208,11648,208,28,8644,28,11648,0,0,0,0,0
5.028,17,3,257,2,37,5005,37,130,1,99,0,99,127
1772.419,6,180,15480,120,69,14894,69,8940,60,69,30034,69,6540
541.498,2,5,160,5,8,135374,8,160,0,0,0,0,0
3.836,6,13,3116,8,49,548,92,523,5,1164,910,1448,2593
1781.763,6,416,24920,208,69,8607,69,12460,208,34,8607,64,12460
2.289,17,3,1008,3,308,1144,308,1008,0,0,0,0,0
1.103,17,4,464,3,64,529,64,276,1,160,0,160,188
0.001,6,2,311,0,0,0,0,0,2,231,1,231,311
1795.153,17,80,3354,79,14,23014,14,3318,1,8,0,8,36
1.171,6,25,8056,12,164,90,267,1288,13,869,82,1402,6768
0.23,1,2,112,2,28,230,28,112,0,0,0,0,0
1.849,17,4,240,2,32,1847,32,120,2,32,1848,32,120
0.061,17,2,194,1,48,0,48,76,1,90,0,90,118
842.304,2,7,224,7,8,140384,8,224,0,0,0,0,0
1798.314,6,368,25690,215,99,8403,469,15085,153,69,11830,69,10605
275.446,17,4,352,2,60,275445,60,176,2,60,275445,60,176
1799.479,6,137,15328,84,79,21680,519,6718,53,150,34603,1420,8610
1799.408,17,450,39960,405,35,4453,288,25740,45,288,40025,288,14220
334.704,1,6,336,6,28,66940,28,336,0,0,0,0,0
1796.898,1,342,28728,342,56,5269,56,28728,0,0,0,0,0
1.402,6,46,18738,26,930,56,1460,13162,20,476,64,2615,5576
0.803,6,24,6208,13,264,66,662,1848,11,783,79,1420,4360
1783.327,17,83,3480,82,14,22016,14,3444,1,8,0,8,36
7.904,6,1783,1507663,981,1438,7,1448,1452555,802,776,9,1448,55108
240.227,6,54,18126,29,807,8578,1418,15239,25,197,10008,580,2887
1786.636,6,104,8376,68,65,26666,65,4930,36,59,51044,59,3446
0.007,17,3,634,2,32,0,32,120,1,486,0,486,514
0.094,17,2,2380,2,1162,94,1162,2380,0,0,0,0,0
1789.018,6,359,22778,209,69,8601,69,12638,150,69,12004,69,10140
1638.449,1,8,448,8,28,234064,28,448,0,0,0,0,0
1.13,6,11,1727,7,100,188,100,384,4,589,291,1152,1343
252.792,2,2,64,2,8,252792,8,64,0,0,0,0,0
182.953,6,29,6630,12,220,6974,516,1365,17,327,11429,1452,5265
7.334,17,6,456,6,48,1466,48,456,0,0,0,0,0
1743.007,6,98,7390,63,38,28113,205,4476,35,33,51257,98,2914
1773.21,6,181,15589,120,69,14900,69,8940,61,69,29550,69,6649
15.873,17,15,5210,7,360,2632,1350,2717,8,283,2257,1350,2493
1797.125,1,345,28980,345,56,5224,56,28980,0,0,0,0,0
1694.654,17,71,4544,71,36,24209,36,4544,0,0,0,0,0
1783.81,6,373,26428,214,104,8374,469,15583,159,69,11289,69,10845
0.057,17,4,352,2,37,1,37,130,2,83,9,89,222
1779.819,1,342,28728,342,56,5219,56,28728,0,0,0,0,0
0.497,6,20,7229,13,334,41,663,2021,7,1209,75,1946,5208
8.194,6,69,20598,35,554,241,1152,15811,34,427,240,1152,4787
2.131,6,13,2311,8,188,304,245,700,5,1407,468,1407,1611
1.433,6,25,11769,15,900,102,1372,5291,10,743,140,2688,6478
5.066,17,4,288,2,36,5004,36,128,2,52,5018,52,160
0.143,17,2,461,1,34,0,34,62,1,371,0,371,399
11.079,6,8,336,4,0,3691,0,164,4,0,3680,0,172
3.798,6,13,2311,8,188,542,245,700,5,1407,886,1407,1611
1771.498,6,99,9240,66,65,27253,65,5577,33,59,55356,59,3663
4.724,6,10,436,4,0,1574,0,164,6,7,910,7,272
0.098,17,2,152,1,48,0,48,76,1,48,0,48,76
70.68,6,11,3732,4,133,410,133,297,7,3151,11728,3151,3435
0.126,17,2,692,2,318,126,353,692,0,0,0,0,0
168.693,17,4,352,2,60,168692,60,176,2,60,168692,60,176
3.783,17,5,295,5,31,945,31,295,0,0,0,0,0
1797.129,17,180,14040,180,50,10039,50,14040,0,0,0,0,0
1794.074,1,250,14000,250,28,7205,28,14000,0,0,0,0,0
280.409,6,32,7853,14,158,21569,267,1357,18,524,16493,1400,6496
0.934,6,7,295,4,0,311,0,164,3,7,257,7,131
9.819,6,11,3018,5,92,2454,92,360,6,1165,1873,1408,2658
31.916,6,400,341035,176,108,182,320,9753,224,1459,143,2816,331282
113.307,6,961,455554,511,833,222,1152,432422,450,427,251,1179,23132
1749.093,6,136,9785,78,31,22715,31,5416,58,31,30505,31,4369
361.036,2,5,160,5,8,90259,8,160,0,0,0,0,0
0.085,17,2,2384,2,1164,85,1164,2384,0,0,0,0,0
1784.024,6,359,22709,209,69,8577,69,12569,150,69,11973,69,10140
1767.601,17,316,51884,316,136,5611,389,51884,0,0,0,0,0
2.948,6,14,2351,8,188,421,245,700,6,1407,517,1407,1651
0.5,6,20,7229,13,334,41,663,2021,7,1209,77,1946,5208
1744.645,2,30,960,30,8,60160,8,960,0,0,0,0,0
9.984,6,30,4327,15,256,712,256,3420,15,303,712,303,907
471.861,1,3,168,3,28,235930,28,168,0,0,0,0,0
1787.826,6,180,15480,120,69,15023,69,8940,60,69,30293,69,6540
9.916,6,14,1660,3,106,4952,106,234,11,160,990,512,1426
232.697,6,69,9943,33,102,5792,267,2672,36,322,6648,1460,7271
0.394,6,6,248,4,0,131,0,164,2,0,188,0,84
265.319,17,4,240,2,32,265317,32,120,2,32,265318,32,120
1504.031,2,10,320,10,8,167114,8,320,0,0,0,0,0
504.083,2,4,128,4,8,168027,8,128,0,0,0,0,0
323.839,1,5,573,5,86,80959,105,573,0,0,0,0,0
1684.051,6,341,23989,197,103,8592,469,14089,144,69,11775,69,9900
1740.58,1,16,896,16,28,116038,28,896,0,0,0,0,0
0.553,6,28,10116,14,253,42,653,1762,14,952,41,1438,8354
1729.214,6,60,4400,40,33,44338,33,2740,20,31,90998,31,1660
195.618,17,4,1081,4,242,65206,687,1081,0,0,0,0,0
764.558,1,14,784,14,28,58812,28,784,0,0,0,0,0
57.151,6,55,21856,29,1124,433,1360,15908,26,348,2276,1360,5948
7.995,6,19,8221,9,275,999,275,643,10,1194,850,1414,7578
0.002,6,3,132,1,0,0,0,40,2,0,1,0,92
1796.691,6,368,23276,212,69,8515,69,12896,156,69,11591,69,10380
0.031,17,4,350,2,34,23,34,124,2,85,10,91,226
1798.856,17,447,39296,404,35,4463,288,25708,43,288,40920,288,13588
23.135,6,33,8095,16,188,1542,721,1962,17,681,1433,2840,6133
1.045,6,28,8546,16,229,58,583,2047,12,1201,77,3151,6499
2.211,17,4,1552,4,360,737,360,1552,0,0,0,0,0
299.467,17,4,352,2,60,299466,60,176,2,60,299466,60,176
1789.392,1,240,25440,240,78,7486,78,25440,0,0,0,0,0
9.984,17,2,152,2,48,9984,48,152,0,0,0,0,0
0.145,6,2,170,1,0,0,0,40,1,90,0,90,130
348.943,6,81,12504,41,322,8723,1366,6355,40,213,8947,1372,6149
3.97,17,3,276,3,64,1985,64,276,0,0,0,0,0
1780.43,6,355,22549,207,69,8642,69,12420,148,69,12111,69,10129
240.222,6,53,17558,28,771,8896,1408,14574,25,209,10009,580,2984
0.498,6,58,27920,33,1060,15,1380,22562,25,421,18,1923,5358
114.728,6,34,8435,17,410,1178,882,2002,17,574,7160,4848,6433
0.073,17,2,241,1,36,0,36,64,1,149,0,149,177
2.328,17,2,776,2,360,2328,360,776,0,0,0,0,0
33.66,6,32,5146,15,154,2404,722,1858,17,300,2090,1288,3288
1721.139,17,12,498,11,14,172113,14,462,1,8,0,8,36
0.206,6,24,7176,12,155,18,267,1261,12,775,15,3445,5915
0.011,17,2,198,1,63,0,63,91,1,79,0,79,107
6.562,6,1036,964875,668,1371,9,1408,941075,368,931,17,2801,23800
1785.857,6,364,25392,212,100,8463,469,14896,152,69,11826,69,10496
0.017,17,4,336,2,34,0,34,124,2,78,3,84,212
1776.719,17,128,10240,64,48,28201,48,4864,64,56,28201,56,5376
0.143,17,2,586,1,46,0,46,74,1,484,0,484,512
1790.065,17,142,11360,71,48,25571,48,5396,71,56,25571,56,5964
0.023,17,2,572,1,39,0,39,67,1,477,0,477,505
240.499,6,48,9690,24,579,10456,1418,5958,24,225,10456,651,3732
0.076,17,2,347,1,29,0,29,57,1,262,0,262,290
105.371,17,4,1344,4,308,35123,308,1344,0,0,0,0,0
858.201,1,56,3136,56,28,15603,28,3136,0,0,0,0,0
3.235,6,26,9338,13,422,254,1205,2374,13,1046,253,2491,6964
12.471,6,1962,1724687,1197,1385,10,1420,1689842,765,467,16,1883,34845
4.851,6,40,7309,21,218,242,314,3463,19,440,255,1152,3846
6.083,17,6,414,3,33,3038,33,183,3,49,3038,49,231
11.794,6,21,6825,12,275,1072,275,1038,9,1353,847,1440,5787
0.007,17,2,459,1,40,0,40,68,1,363,0,363,391
1738.748,6,69,5014,46,31,38638,31,3105,23,31,79033,31,1909
506.182,17,5,691,5,110,126545,355,691,0,0,0,0,0
1776.238,17,73,3060,72,14,25017,14,3024,1,8,0,8,36
0.054,17,2,198,1,39,0,39,67,1,103,0,103,131
1.721,1,2,112,2,28,1721,28,112,0,0,0,0,0
0.324,6,20,4960,10,137,36,267,1092,10,692,33,1467,3868
109.711,6,27,9569,13,703,83,1360,3376,14,803,8426,4080,6193
35.275,17,147,122246,57,141,628,1350,9643,90,1223,395,1350,112603
0.146,6,10,1383,6,145,29,145,389,4,830,45,830,994
1375.092,1,7,392,7,28,229182,28,392,0,0,0,0,0
3.685,6,63,39538,38,973,99,1360,12271,25,1875,146,5599,27267
1.183,6,51,13829,24,551,51,1429,4840,27,464,44,1986,8989
1201.751,17,96,7680,48,48,25569,48,3648,48,56,25569,56,4032
0.29,6,27,9042,13,247,24,624,1672,14,947,21,1408,7370
1765.231,1,224,12544,224,28,7915,28,12544,0,0,0,0,0
0.257,17,3,451,2,39,57,39,134,1,289,0,289,317
1763.751,2,12,384,12,8,160341,8,384,0,0,0,0,0
1780.553,17,140,11200,70,48,25804,48,5320,70,56,25804,56,5880
755.59,2,7,224,7,8,125931,8,224,0,0,0,0,0
1766.484,6,159,16195,86,64,20779,721,6670,73,150,24531,2840,9525
0.169,6,26,7256,13,155,14,267,1301,13,603,13,2036,5955
0.013,17,2,251,1,36,0,36,64,1,159,0,159,187
1773.564,6,180,15480,120,69,14903,69,8940,60,69,30053,69,6540
140.87,17,4,352,2,60,140868,60,176,2,60,140869,60,176
3.454,17,5,456,4,60,1151,60,352,1,76,0,76,104
149.309,6,25,6271,9,267,130,501,1165,16,343,9947,1420,5106
0.013,6,12,977,7,182,2,182,554,5,77,2,134,423
0.16,6,25,7216,13,155,13,267,1301,12,678,13,2800,5915
1680.535,17,12,498,11,14,168053,14,462,1,8,0,8,36
0.291,6,27,9081,13,261,24,683,1740,14,943,21,1408,7341
1.978,6,1405,1555343,584,340,3,341,31738,821,1814,2,4104,1523605
0.515,17,2,925,1,548,0,548,576,1,321,0,321,349
0.033,17,3,392,2,60,0,60,176,1,188,0,188,216
1790.892,6,271,33401,112,138,16132,1360,16290,159,132,11333,1942,17111
0.096,17,4,368,2,32,96,32,120,2,96,33,96,248
1.054,6,31,12121,17,525,65,1360,3350,14,819,66,1379,8771
399.172,6,18,1242,14,180,30705,180,916,4,110,20088,110,326
8.095,6,12,945,6,222,1617,222,466,6,231,1617,231,479
0.423,6,28,10148,14,252,32,646,1758,14,956,31,1438,8390
1783.364,17,83,3480,82,14,22016,14,3444,1,8,0,8,36
0.944,6,10,1687,7,100,157,100,384,3,1179,335,1179,1303
1785.86,6,379,26737,217,103,8267,469,15841,162,69,11092,69,10896
280.35,6,28,7352,12,158,25486,267,1277,16,603,18681,1400,6075
46.113,1,8,848,8,78,6587,78,848,0,0,0,0,0
1700.429,17,12,498,11,14,170042,14,462,1,8,0,8,36
0.038,17,2,146,1,37,0,37,65,1,53,0,53,81
0.114,17,2,180,1,30,0,30,58,1,94,0,94,122
7.159,6,65,20102,34,541,216,1152,15435,31,489,229,1179,4667
1.726,6,13,1096,7,283,257,283,663,6,105,309,105,433
300.268,6,31,11826,18,593,17662,1408,4503,13,948,20018,1578,7323
1797.545,6,359,23178,210,75,8600,469,13009,149,69,12143,69,10169
0.429,6,2,80,1,0,0,0,40,1,0,0,0,40
11.369,6,1802,1570697,1090,1387,10,1420,1537996,712,420,15,1420,32701
0.137,17,2,154,1,33,0,33,61,1,65,0,65,93
193.1,6,34,12757,11,327,19309,1189,2415,23,523,8776,1420,10342
369.576,6,21,1422,15,180,26398,180,992,6,110,12277,110,430
1744.698,2,24,768,24,8,75856,8,768,0,0,0,0,0
5.731,6,42,7389,22,218,272,314,3503,20,440,288,1152,3886
1800.0,6,212,16750,79,74,23076,365,8156,133,48,13636,78,8594
240.269,6,42,8735,21,173,12013,517,2314,21,591,12013,1408,6421
735.592,17,19,1444,19,48,40866,48,1444,0,0,0,0,0
1.584,6,50,18694,27,848,60,1360,12998,23,433,63,1360,5696
502.582,17,23,5336,23,204,22844,204,5336,0,0,0,0,0
280.415,6,28,7352,14,158,21570,267,1357,14,678,21566,3456,5995
0.173,6,9,1002,5,213,43,213,417,4,421,46,421,585
1741.359,17,29,6699,29,203,62191,203,6699,0,0,0,0,0
1799.098,17,75,3144,74,14,24645,14,3108,1,8,0,8,36
1787.258,6,104,8444,68,66,26675,66,4964,36,60,51059,60,3480
118.235,6,29,6927,16,234,7882,663,2246,13,571,9850,1469,4681
51.978,6,29,7392,13,158,4331,267,1317,16,603,3461,1400,6075
38.263,17,44,6468,22,48,1821,48,1672,22,190,1821,308,4796
131.925,6,889,468813,516,850,256,1152,451215,373,380,353,1152,17598
0.008,6,4,160,2,0,8,0,80,2,0,2,0,80
1796.791,17,449,39928,404,35,4458,288,25708,45,288,40020,288,14220
1771.552,6,99,9174,66,64,27254,64,5544,33,58,55358,58,3630
240.2,6,57,18643,31,747,8006,1418,15814,26,183,9607,580,2829
31.514,6,7,336,1,0,0,0,48,6,0,6301,0,288
118.539,17,4,352,2,60,118538,60,176,2,60,118538,60,176
1772.267,6,180,15480,120,69,14893,69,8940,60,69,30037,69,6540
17.644,17,20,6530,9,429,2202,1350,4115,11,191,1761,1350,2415
1.536,6,41,9968,21,440,76,1360,4392,20,433,70,1360,5576
1796.139,17,449,39928,404,35,4456,288,25708,45,288,40016,288,14220
1.132,6,54,13954,25,549,47,1429,4876,29,416,38,1460,9078
1782.477,17,171,10944,171,36,10485,36,10944,0,0,0,0,0
25.152,17,4,352,2,60,25151,60,176,2,60,25151,60,176
1780.567,6,102,8280,68,64,26575,65,4922,34,58,53953,59,3358
0.96,17,4,308,2,33,958,33,122,2,65,959,65,186
0.215,17,4,284,2,32,105,32,120,2,54,112,60,164
280.573,6,31,7541,13,158,23381,267,1317,18,500,16501,1400,6224
2.335,17,15,5424,15,333,166,361,5424,0,0,0,0,0
31.33,6,31,7497,11,182,3133,267,1179,20,393,1647,1917,6318
78.168,6,11,1003,6,332,15633,332,652,5,83,19538,83,351
1.96,6,29,7520,16,306,130,1087,2786,13,601,162,1420,4734
325.677,6,8,475,6,31,65135,31,333,2,31,299514,31,142
0.943,6,2,120,2,0,0,0,120,0,0,0,0,0
1793.523,17,87,3648,86,14,21100,14,3612,1,8,0,8,36
0.014,17,2,154,1,33,0,33,61,1,65,0,65,93
1792.642,6,218,20011,110,128,16446,208,14668,108,31,16751,31,5343
1757.155,1,15,1780,15,90,125511,105,1780,0,0,0,0,0
696.533,6,151,16538,76,158,9287,208,13166,75,31,9407,31,3372
280.351,6,28,7352,12,158,25486,267,1277,16,603,18688,1400,6075
1782.576,6,354,22440,207,69,8653,69,12420,147,69,12208,69,10020
0.137,6,6,300,5,0,7,0,260,1,0,0,0,40
27.772,17,2,388,2,166,27772,166,388,0,0,0,0,0
80.881,6,757,351672,396,820,204,1152,332441,361,435,223,1179,19231
54.523,17,12,12975,12,1053,4956,1072,12975,0,0,0,0,0
69.285,6,31,4533,16,234,4608,564,1852,15,463,4937,1343,2681
5.407,6,40,7309,21,218,270,314,3463,19,513,285,1179,3846
0.058,17,13,10019,7,741,9,1350,5384,6,744,3,1350,4635
111.219,6,22,8752,7,106,18536,106,394,15,596,7943,3417,8358
1740.45,17,30,31650,30,1027,60015,1027,31650,0,0,0,0,0
225.136,17,4,352,2,60,225134,60,176,2,60,225134,60,176
45.146,6,42,12569,18,214,2655,721,2011,24,533,1368,2840,10558
0.106,17,2,158,1,34,0,34,62,1,68,0,68,96
0.16,6,6,300,4,0,0,0,208,2,0,160,0,92
240.3,6,38,8732,19,523,13349,1418,5711,19,225,13349,619,3021
1765.41,2,15,480,15,8,126100,8,480,0,0,0,0,0
1740.498,17,30,7050,30,207,60017,207,7050,0,0,0,0,0
1789.955,6,358,22669,209,69,8605,69,12500,149,69,12094,69,10169
56.314,6,2505,2308961,1736,1254,21,1408,2259895,769,907,73,1408,49066
0.882,17,2,134,2,39,882,39,134,0,0,0,0,0
280.259,6,28,7352,12,158,25478,267,1277,16,603,18679,1400,6075
22.966,6,14,2185,8,324,3280,585,1073,6,396,4505,580,1112
17.065,6,2787,2621483,1811,1370,9,1408,2566067,976,931,17,2816,55416
1786.596,6,104,8444,68,66,26665,66,4964,36,60,51042,60,3480
1790.801,1,56,4704,0,0,0,0,0,56,56,32560,56,4704
0.074,1,2,112,2,28,74,28,112,0,0,0,0,0
0.18,6,25,7216,13,155,15,267,1301,12,775,15,3445,5915
0.608,6,22,7284,13,319,50,602,1960,9,1209,67,1946,5324
1744.275,6,95,7203,63,38,28133,205,4476,32,33,56259,98,2727
1779.335,1,58,4872,58,56,31216,56,4872,0,0,0,0,0
0.44,6,18,3068,9,282,55,531,1606,9,493,40,828,1462
32.358,6,15,4216,8,351,4622,722,1467,7,793,5351,1448,2749
280.33,6,29,7392,13,158,23360,267,1317,16,603,18681,1400,6075
0.897,6,52,13893,25,551,37,1429,4904,27,464,33,1986,8989
1787.906,6,356,22589,208,69,8637,69,12460,148,69,12162,69,10129
1792.0,6,373,25959,215,98,8373,469,15223,158,69,11413,69,10736
0.911,6,18,5172,10,150,101,174,704,8,828,116,1420,4468
13.327,6,1767,1578332,1091,1366,12,1408,1538516,676,931,19,2801,39816
1629.079,1,7,392,7,28,271513,28,392,0,0,0,0,0
2.579,17,8,1600,4,30,856,30,232,4,314,856,468,1368
4.752,17,10,1858,5,36,1186,36,320,5,279,1186,318,1538
8.688,6,3,162,1,0,0,0,40,2,42,8593,42,122
11.037,6,20,5616,11,275,1103,275,998,9,1414,780,1414,4618
1772.368,6,180,15480,120,69,14893,69,8940,60,69,30034,69,6540
1.771,6,14,4954,8,125,228,125,549,6,1361,353,2472,4405
1792.578,17,180,11520,180,36,10014,36,11520,0,0,0,0,0
1772.114,6,180,15480,120,69,14891,69,8940,60,69,30033,69,6540
0.021,17,2,152,1,48,0,48,76,1,48,0,48,76
0.499,6,27,9176,13,225,41,733,1809,14,945,35,1368,7367
300.674,6,40,8665,21,308,15033,888,2151,19,441,474,1360,6514
2.321,6,16,1630,9,304,290,304,1084,7,83,383,83,546
0.005,17,2,333,1,32,0,32,60,1,245,0,245,273
1.111,2,2,64,2,8,1111,8,64,0,0,0,0,0
24.052,6,21,1973,10,275,2672,275,1233,11,96,1800,96,740
237.483,6,32,9674,12,189,12634,516,1432,20,530,12493,1452,8242
1677.097,1,7,742,7,78,279516,78,742,0,0,0,0,0
1739.438,6,87,6322,58,31,30516,31,3915,29,31,62122,31,2407
1.705,6,13,2311,8,188,243,245,700,5,1407,361,1407,1611
1787.242,6,102,8364,68,66,26675,66,4964,34,60,54156,60,3400
1718.459,1,8,448,8,28,245494,28,448,0,0,0,0,0
1792.604,1,342,28728,342,56,5256,56,28728,0,0,0,0,0
0.198,6,46,21766,27,1045,7,1420,16785,19,467,10,1883,4981
1790.103,17,296,62988,296,184,6068,422,62988,0,0,0,0,0
1798.43,6,356,22520,208,69,8688,69,12460,148,69,12233,69,10060
0.879,6,143,153185,66,268,13,517,4514,77,1981,10,6840,148671
285.407,17,4,240,2,32,285406,32,120,2,32,285406,32,120
1770.95,6,102,9396,66,65,27245,65,5577,36,59,50596,59,3819
300.538,6,11,912,6,226,60072,226,546,5,110,75090,110,366
0.065,17,4,352,2,37,57,37,130,2,83,56,89,222
17.193,6,16,2297,9,324,2149,585,1125,7,396,2723,580,1172
1.216,6,198,156542,120,1348,10,1432,149122,78,389,14,1432,7420
11.384,6,25,11918,12,275,1034,275,1038,13,1293,864,1414,10880
2.07,6,9,527,5,43,517,43,311,4,0,653,0,216
1740.237,17,30,1710,30,29,60008,29,1710,0,0,0,0,0
1797.458,6,362,22898,210,69,8600,69,12678,152,69,11903,69,10220
10.252,6,84,24549,43,549,244,1152,18768,41,413,249,1152,5781
64.612,6,33,8273,12,140,5770,267,1473,21,425,3229,1452,6800
51.637,6,48,13095,23,1026,523,1460,7169,25,307,2144,1460,5926
0.723,6,22,7354,13,335,60,668,2026,9,1210,86,1946,5328
1790.992,1,192,10752,192,28,9376,28,10752,0,0,0,0,0
1786.602,6,102,8364,68,66,26665,66,4964,34,60,54136,60,3400
6.831,6,40,7309,20,218,359,314,3423,20,513,345,1179,3886
0.001,6,2,165,1,85,0,85,125,1,0,0,0,40
1790.132,17,418,118589,418,255,4292,422,118589,0,0,0,0,0
0.023,17,2,537,1,32,0,32,60,1,449,0,449,477
1771.793,6,102,9396,66,65,27258,65,5577,36,59,50620,59,3819
123.409,17,4,1344,4,308,41136,308,1344,0,0,0,0,0
290.659,17,4,352,2,60,290658,60,176,2,60,290658,60,176
60.851,6,20,7273,10,267,6761,501,1205,10,809,6751,1420,6068
6.477,6,31,8888,13,155,539,267,1306,18,489,380,1997,7582
1769.805,6,101,9344,66,65,27227,65,5577,35,59,52050,59,3767
280.25,6,27,7312,13,158,23354,267,1317,14,775,21555,3445,5995
1797.779,17,449,39928,404,35,4460,288,25708,45,288,40022,288,14220
0.036,17,2,430,1,32,0,32,60,1,342,0,342,370
13.171,6,101,29935,52,548,258,1152,23477,49,449,268,1179,6458
98.397,6,43,8757,22,401,646,889,2164,21,521,4912,3488,6593
36.058,2,7,336,7,24,6009,32,336,0,0,0,0,0
1083.994,6,68,9195,34,294,32845,517,2953,34,893,32846,2449,6242
71.84,6,15,1928,9,483,8980,483,1442,6,83,14365,83,486
92.698,6,26,12852,15,836,57,1360,5661,11,1123,9252,3085,7191
10.993,6,20,4442,11,275,1099,275,998,9,768,777,1440,3444
380.815,6,43,3858,25,102,15867,208,2952,18,31,22389,31,906
25.188,6,23,5538,14,107,1937,159,1194,9,773,2518,1402,4344
63.57,6,13,5586,4,106,21190,106,274,9,822,7921,1420,5312
0.85,6,23,10776,13,478,70,1360,2465,10,1579,78,4432,8311
360.986,2,3,96,3,8,180493,8,96,0,0,0,0,0
0.832,6,3,127,1,0,0,0,40,2,7,0,7,87
122.732,6,101,15802,54,304,2315,304,11084,47,83,2633,83,4718
1690.846,17,16,1265,8,30,241541,37,471,8,71,241542,136,794
1154.071,17,188,14288,188,48,6171,48,14288,0,0,0,0,0
1786.363,6,102,8296,68,65,26662,65,4930,34,59,54129,59,3366
882.686,6,216,13608,116,69,7675,69,7607,100,69,8916,69,6001
1.223,6,24,8004,12,164,94,267,1288,12,1014,94,2331,6716
1729.187,6,62,4504,40,33,44338,33,2740,22,31,82333,31,1764
71.976,6,20,7758,8,210,10282,267,1593,12,567,6526,4260,6165
0.028,17,2,156,1,34,0,34,62,1,66,0,66,94
127.384,17,4,240,2,32,127383,32,120,2,32,127383,32,120
115.221,17,6,528,3,48,57606,48,228,3,72,57606,72,300
1744.629,2,30,960,30,8,60159,8,960,0,0,0,0,0
80.279,6,28,9454,14,531,83,1254,2245,14,737,6161,2720,7209
234.255,1,6,336,6,28,46851,28,336,0,0,0,0,0
0.545,17,3,451,2,39,254,39,134,1,289,0,289,317
0.029,17,2,180,1,30,0,30,58,1,94,0,94,122
1773.013,6,205,22508,130,75,13744,267,10057,75,133,23953,1997,12451
45.72,6,42,10016,20,541,539,910,3023,22,435,2169,2720,6993
18.488,17,24,12091,10,256,2050,1350,2848,14,632,1419,1350,9243
424.9,6,45,3870,30,69,14651,69,2235,15,69,30300,69,1635
41.141,17,44,6468,22,48,1955,48,1672,22,190,1955,308,4796
10.851,6,19,4362,11,275,1085,275,998,8,1010,856,2840,3364
15.71,6,15,1290,5,261,3927,261,465,10,421,1741,421,825
0.019,6,15,5679,9,134,2,134,514,6,2456,3,3453,5165
0.387,6,53,23653,30,1018,13,1380,16568,23,558,15,1923,7085
1.26,6,47,18161,26,882,50,1360,12545,21,476,54,2715,5616
0.967,17,2,925,1,548,0,548,576,1,321,0,321,349
0.291,17,4,502,2,31,280,31,118,2,164,277,164,384
1171.791,6,208,30391,119,304,9930,304,20936,89,83,13315,83,9455
1.414,6,11,1727,7,100,235,100,384,4,589,383,1152,1343
0.209,6,10,767,5,186,51,186,454,5,45,51,45,313
279.26,6,91,19913,42,270,6811,1189,6552,49,379,5817,1420,13361
1773.077,1,58,4872,58,56,31106,56,4872,0,0,0,0,0
1772.682,6,180,15480,120,69,14896,69,8940,60,69,30042,69,6540
2.071,6,19,3781,10,234,230,564,1452,9,463,236,1343,2329
842.617,17,8,592,4,30,280838,30,232,4,62,280864,62,360
11.092,6,1975,1709874,1125,1424,9,1448,1651446,850,776,12,1448,58428
32.594,6,7,400,6,0,6518,0,340,1,0,0,0,60
0.523,17,2,152,1,48,0,48,76,1,48,0,48,76
0.307,17,2,172,1,50,0,50,78,1,66,0,66,94
0.024,17,2,154,1,33,0,33,61,1,65,0,65,93
0.009,17,4,336,2,34,0,34,124,2,78,1,84,212
71.918,6,13,1450,7,302,11986,302,964,6,83,14380,83,486
1.89,6,50,20236,27,959,72,1460,14540,23,433,65,1460,5696
17.442,6,29,7688,11,133,1744,267,981,18,459,1011,1420,6707
11.857,6,1874,1638548,1138,1386,10,1420,1604863,736,467,16,1883,33685
0.435,17,4,624,2,64,434,64,184,2,192,290,192,440
1.341,6,48,18200,26,882,53,1460,12544,22,433,55,1460,5656
12.816,6,9,1647,6,100,2563,100,344,3,1179,6271,1179,1303
0.886,6,11,1727,7,100,147,100,384,4,589,212,1152,1343
1702.607,1,8,448,8,28,243229,28,448,0,0,0,0,0
0.015,6,3,1082,1,0,0,0,40,2,962,0,962,1042
1746.652,6,99,7411,63,38,28171,205,4476,36,33,49891,98,2935
50.482,6,18,6357,5,152,1977,267,662,13,574,4186,1179,5695
61.319,6,36,15828,22,795,2919,1448,9102,14,748,4697,2359,6726
1772.968,1,58,4872,0,0,0,0,0,58,56,31104,56,4872
280.559,6,30,7432,13,158,23379,267,1317,17,603,17530,2760,6115
30.35,17,4,352,2,60,30349,60,176,2,60,30348,60,176
1786.294,6,106,8644,70,66,25888,66,5044,36,60,51034,60,3600
8.523,6,2006,1857862,1272,1382,6,1408,1815030,734,931,11,2816,42832
300.72,6,38,8541,20,308,15827,888,2067,18,441,503,1440,6474
370.977,6,18,1242,14,180,28536,180,916,4,110,20068,110,326
1772.382,6,180,15480,120,69,14893,69,8940,60,69,30033,69,6540
5.057,6,39,7269,20,218,266,314,3423,19,513,267,1179,3846
1.075,6,1179,1062158,622,183,1,230,33753,557,1800,1,4224,1028405
9.114,2,2,64,2,8,9114,8,64,0,0,0,0,0
6.444,17,4,240,2,32,6443,32,120,2,32,6443,32,120
0.404,6,17,6337,9,141,50,275,646,8,894,27,1440,5691
1699.432,17,12,498,11,14,169943,14,462,1,8,0,8,36
51.361,17,4,352,2,60,51360,60,176,2,60,51360,60,176
50.059,17,4,352,2,60,50058,60,176,2,60,50057,60,176
1795.732,17,446,39832,401,35,4489,288,25612,45,288,40019,288,14220
1774.86,6,180,15480,120,69,14914,69,8940,60,69,30077,69,6540
277.169,17,4,272,2,40,277168,47,136,2,40,277168,47,136
1752.5,6,197,18561,99,68,17882,721,8251,98,163,18064,1414,10310
12.244,17,10,2105,5,47,3059,47,375,5,318,3059,318,1730
1.772,6,47,18799,27,865,68,1360,13223,20,476,81,2715,5576
1796.198,6,355,22480,207,69,8719,69,12420,148,69,12218,69,10060
0.001,6,2,171,2,91,1,91,171,0,0,0,0,0
280.199,6,28,7352,13,158,23349,267,1317,15,678,20011,3900,6035
0.332,6,3,144,2,0,6,0,92,1,0,0,0,52
299.566,6,6,364,4,31,99855,31,222,2,31,299556,31,142
228.346,6,122,89928,76,1257,3044,1408,79414,46,676,2516,1408,10514
1.193,6,24,8004,12,164,92,267,1288,12,1014,92,2804,6716
1796.453,17,448,39896,403,35,4468,288,25676,45,288,40020,288,14220
5.39,6,37,15772,20,887,283,1360,6181,17,889,327,3639,9591
16.461,6,6,557,3,189,8104,189,329,3,96,8159,96,228
6.037,17,4,240,2,32,6036,32,120,2,32,6035,32,120
8.029,6,27,7513,13,155,669,267,1306,14,563,616,3417,6207
51.366,6,10,648,10,31,5707,31,648,0,0,0,0,0
1680.511,17,12,498,11,14,168051,14,462,1,8,0,8,36
1772.473,6,180,15480,120,69,14894,69,8940,60,69,30036,69,6540
0.515,17,4,420,2,33,329,33,122,2,121,353,145,298
5.565,17,4,352,2,60,5564,60,176,2,60,5564,60,176
73.107,6,17,712,8,0,1946,0,332,9,0,9105,0,380
1.567,6,51,22850,30,939,54,1360,17234,21,476,68,2715,5616
1797.67,1,268,28408,268,78,6732,78,28408,0,0,0,0,0
0.172,6,2,149,1,33,0,33,85,1,0,0,0,64
60.623,6,9,774,5,180,15155,180,448,4,110,20075,110,326
9.183,17,16,1136,8,32,1311,32,480,8,54,1311,60,656
9.081,6,36,8230,18,334,534,688,1756,18,441,524,1360,6474
0.701,17,15,9128,8,822,99,1350,6803,7,304,111,1350,2325
4.985,6,37,7189,19,218,276,314,3383,18,513,275,1179,3806
0.018,17,2,185,1,45,0,45,73,1,84,0,84,112
11.87,6,1874,1639539,1140,1384,10,1420,1605958,734,467,16,1883,33581
1798.327,6,363,24414,212,88,8522,469,14027,151,69,11988,69,10387
5.989,17,3,228,3,48,2994,48,228,0,0,0,0,0
1772.021,6,180,15480,120,69,14890,69,8940,60,69,30032,69,6540
1795.974,17,448,39896,403,35,4467,288,25676,45,288,40021,288,14220
2.849,17,4,1568,4,364,949,364,1568,0,0,0,0,0
2.206,17,2,672,2,308,2206,308,672,0,0,0,0,0
1780.611,17,142,11360,71,48,25436,48,5396,71,56,25436,56,5964
240.531,6,69,25201,35,548,7074,1418,6768,34,793,7288,1418,18433
1741.739,1,58,4872,58,56,30556,56,4872,0,0,0,0,0
17.118,6,2979,2808677,1881,1413,9,1448,2746917,1098,776,15,1448,61760
216.411,17,4,352,2,60,216410,60,176,2,60,216409,60,176
0.329,6,26,8903,13,234,27,575,1620,13,942,26,1408,7283
1770.125,6,101,9344,66,65,27232,65,5577,35,59,52060,59,3767
70.102,6,29,8832,13,158,5841,267,1317,16,763,4671,2800,7515
129.407,6,50,9146,20,129,6798,267,2115,30,341,4451,1926,7031
0.011,17,2,157,1,31,0,31,59,1,70,0,70,98
299.654,1,26,1456,26,28,11986,28,1456,0,0,0,0,0
1798.728,1,345,28980,345,56,5228,56,28980,0,0,0,0,0
1.947,6,19,1895,10,222,213,222,1296,9,231,241,231,599
1798.951,6,356,22520,208,69,8690,69,12460,148,69,12237,69,10060
2.0,6,27,10201,16,288,133,598,1510,11,1030,180,1420,8691
1770.719,1,58,4872,58,56,31065,56,4872,0,0,0,0,0
79.076,6,38,5668,21,154,3953,722,2184,17,324,1063,1448,3484
1772.66,6,180,15480,120,69,14896,69,8940,60,69,30040,69,6540
35.819,6,14,1913,11,222,3581,222,1554,3,231,17853,231,359
10.555,6,20,4442,11,275,1055,275,998,9,768,743,1440,3444
5.251,6,13,2202,7,210,875,210,792,6,545,1049,904,1410
0.235,17,2,384,1,39,0,39,67,1,289,0,289,317
1799.609,1,15,840,15,28,128543,28,840,0,0,0,0,0
1795.175,6,120,14013,78,79,23313,499,6065,42,156,43782,2642,7948
1796.523,17,141,11276,71,48,25664,48,5396,70,56,26036,56,5880
72.574,17,4,352,2,60,72573,60,176,2,60,72572,60,176
1749.02,6,95,7203,63,38,28210,205,4476,32,33,56409,98,2727
0.939,2,3,96,3,8,469,8,96,0,0,0,0,0
5.07,6,8,320,2,0,5070,0,80,6,0,993,0,240
236.94,17,8,608,8,48,33848,48,608,0,0,0,0,0
0.605,6,7,295,4,0,201,0,164,3,7,153,7,131
401.4,17,13,3208,13,218,33450,370,3208,0,0,0,0,0
0.193,17,2,128,1,36,0,36,64,1,36,0,36,64
1.097,6,23,7952,12,164,84,267,1288,11,1216,93,2816,6664
31.105,17,9,684,9,48,3888,48,684,0,0,0,0,0
0.401,6,12,1653,6,288,74,288,548,6,426,44,434,1105
53.19,17,11,13017,11,1155,5319,1451,13017,0,0,0,0,0
136.494,17,4,352,2,60,136493,60,176,2,60,136493,60,176
1787.336,6,102,8296,68,65,26676,65,4930,34,59,54159,59,3366
68.138,6,24,11131,12,623,82,1360,3640,12,999,6182,1360,7491
0.39,6,10,968,5,256,95,256,460,5,304,95,304,508
584.891,17,45,3588,24,48,25430,48,1824,21,56,25434,56,1764
1.29,6,50,19233,27,887,49,1360,13537,23,433,50,1360,5696
4.291,1,8,832,0,0,0,0,0,8,76,613,76,832
0.118,6,10,1380,5,145,29,145,349,5,827,22,827,1031
4.185,6,21,3652,12,121,380,126,996,9,363,518,1140,2656
0.107,17,2,162,1,36,0,36,64,1,70,0,70,98
1758.113,6,4208,3656902,2057,147,855,907,119145,2151,1644,817,8448,3537757
0.012,17,2,515,1,40,0,40,68,1,419,0,419,447
1788.317,17,87,3648,86,14,21039,14,3612,1,8,0,8,36
68.479,6,65,36207,39,1128,1797,1408,28031,26,569,2732,1408,8176
143.215,6,70,33246,38,814,153,1460,12175,32,899,4608,2284,21071
300.845,2,3,96,3,8,150422,8,96,0,0,0,0,0
0.948,6,8,564,5,106,155,106,428,3,0,311,0,136
18.178,6,2,111,0,0,0,0,0,2,31,18178,31,111
0.406,6,12,1653,6,288,81,288,548,6,426,46,434,1105
4.003,17,4,244,4,33,1334,33,244,0,0,0,0,0
300.166,6,43,10181,22,590,14285,1440,4477,21,346,14999,1440,5704
0.25,6,9,1339,5,145,62,145,349,4,826,44,826,990
34.346,17,4,352,2,60,34345,60,176,2,60,34345,60,176
11.066,6,88,26845,45,570,251,1152,20643,43,407,257,1152,6202
1790.412,6,369,26006,212,99,8485,469,14965,157,69,11476,69,11041
9.172,6,17,6735,9,275,1146,275,643,8,1440,1187,1440,6092
0.004,6,5,279,1,0,0,0,40,4,31,1,31,239
2.576,6,40,14370,22,225,119,561,2337,18,1027,140,1631,12033
1746.283,6,96,7255,62,38,28627,205,4424,34,33,52909,98,2831
4.99,17,4,558,2,36,4979,36,128,2,187,4977,187,430
280.319,6,28,7352,12,158,25483,267,1277,16,603,18685,1400,6075
1799.328,17,449,39928,404,35,4464,288,25708,45,288,40024,288,14220
0.02,17,2,157,1,31,0,31,59,1,70,0,70,98
2.049,17,4,580,2,40,2026,40,136,2,194,2004,194,444
1799.121,17,180,14040,180,50,10050,50,14040,0,0,0,0,0
1.472,2,3,96,3,8,736,8,96,0,0,0,0,0
0.259,17,2,152,1,48,0,48,76,1,48,0,48,76
0.259,6,9,1148,5,145,64,145,349,4,635,58,635,799
0.408,6,26,9013,13,257,34,669,1714,13,945,32,1438,7299
1780.238,17,85,3564,84,14,21448,14,3528,1,8,0,8,36
70.577,6,31,8972,12,165,6416,267,1479,19,480,3920,1997,7493
1692.376,1,53,2968,53,28,32545,28,2968,0,0,0,0,0
1783.131,6,102,8296,68,65,26613,65,4930,34,59,54031,59,3366
15.122,2,3,96,3,8,7561,8,96,0,0,0,0,0
0.163,6,11,1703,6,314,32,500,948,5,487,40,487,755
644.709,17,16,5352,16,306,42980,308,5352,0,0,0,0,0
280.417,6,28,7352,12,158,25492,267,1277,16,678,18691,2085,6075
0.437,6,20,7196,12,325,39,626,1932,8,1210,61,1906,5264
302.727,6,43,7527,18,286,17807,1314,2445,25,214,12613,1420,5082
1740.152,6,87,6322,58,31,30528,31,3915,29,31,62147,31,2407
1.424,6,51,19309,28,889,52,1360,13613,23,433,55,1360,5696
1791.109,1,58,4872,0,0,0,0,0,58,56,31422,56,4872
1280.949,6,80,11187,51,97,20602,498,4384,29,208,45745,1420,6803
575.307,1,6,489,6,53,115061,78,489,0,0,0,0,0
11.906,6,1889,1645502,1152,1374,10,1420,1611801,737,420,16,1420,33701
1.097,6,117,88745,51,131,21,232,2569,66,1392,16,2860,86176
241.793,2,3,96,3,8,120896,8,96,0,0,0,0,0
37.928,17,44,6468,22,48,1805,48,1672,22,190,1805,308,4796
352.519,6,25,10685,4,106,400,106,274,21,503,17625,1420,10411
1738.97,1,57,4788,0,0,0,0,0,57,56,31053,56,4788
164.26,1,4,224,4,28,54753,28,224,0,0,0,0,0
1740.559,17,30,20190,30,645,60019,645,20190,0,0,0,0,0
290.071,6,28,7352,13,158,24172,267,1317,15,775,20717,4836,6035
1792.342,17,180,14040,180,50,10013,50,14040,0,0,0,0,0
1740.635,17,27,6345,27,207,66947,207,6345,0,0,0,0,0
1.52,6,51,21257,29,900,54,1360,15601,22,476,62,2715,5656
13.822,6,1244,1105326,780,1334,17,1368,1070854,464,776,29,2736,34472
8.21,6,16,6243,5,156,2052,267,678,11,731,801,3377,5565
1784.785,1,58,4872,58,56,31312,56,4872,0,0,0,0,0
0.072,17,2,154,1,33,0,33,61,1,65,0,65,93
1786.751,6,102,8228,68,64,26667,64,4896,34,58,54141,58,3332
0.706,6,14,3185,8,92,100,92,552,6,579,42,2026,2633
0.053,17,4,284,2,32,0,32,120,2,54,24,60,164
123.16,6,79,66446,28,527,4556,1448,3573,51,1433,2459,2896,62873
0.048,17,2,152,1,48,0,48,76,1,48,0,48,76
0.611,17,7,2390,7,313,101,354,2390,0,0,0,0,0
1385.635,2,9,288,9,8,173204,8,288,0,0,0,0,0
1.683,6,14,1640,7,256,278,256,1052,7,304,279,304,588
1772.237,6,180,15480,120,69,14892,69,8940,60,69,30033,69,6540
72.735,17,20,1760,10,48,8080,48,760,10,72,8080,72,1000
0.776,6,26,9012,13,252,64,646,1694,13,947,57,1438,7318
14.897,6,10,1102,6,483,2979,483,803,4,83,4963,83,299
1095.145,17,314,35520,147,137,7500,1350,24400,167,38,6595,1350,11120
1.161,6,24,8004,12,164,89,267,1288,12,1014,89,2411,6716
1799.879,17,449,39928,404,35,4466,288,25708,45,288,40019,288,14220
0.047,17,2,223,1,36,0,36,64,1,131,0,131,159
11.862,6,1873,1625084,1147,1363,10,1380,1591802,726,421,16,1923,33282
1707.72,1,100,10600,100,78,17249,78,10600,0,0,0,0,0
1782.839,6,105,8593,68,65,26609,65,4930,37,59,49520,59,3663
334.498,6,175,138068,113,1270,2986,1408,125332,62,731,2397,3847,12736
280.201,6,26,7272,12,158,25472,267,1277,14,775,21550,2800,5995
240.183,6,54,18269,29,807,8577,1408,15246,25,214,10007,580,3023
1785.892,6,108,8713,69,65,26263,65,4970,39,59,46994,59,3743
1770.88,6,101,9278,66,64,27244,64,5544,35,58,52082,58,3734
129.5,6,19,6426,7,154,21583,267,752,12,740,11738,4837,5674
1.199,6,51,21604,29,922,42,1360,15948,22,433,49,1360,5656
240.622,2,2,64,2,8,240622,8,64,0,0,0,0,0
402.835,17,8,2688,8,308,57547,308,2688,0,0,0,0,0
0.001,17,2,154,1,33,0,33,61,1,65,0,65,93
1772.574,6,180,15480,120,69,14895,69,8940,60,69,30039,69,6540
0.166,17,4,1116,2,32,161,32,120,2,470,18,470,996
1580.111,1,52,4368,52,56,30982,56,4368,0,0,0,0,0
1.287,6,50,19324,27,894,49,1360,13628,23,433,50,1360,5696
1.459,1,10,840,10,56,162,56,840,0,0,0,0,0
5.011,17,4,352,2,60,5009,60,176,2,60,5010,60,176
156.884,17,4,240,2,32,156883,32,120,2,32,156883,32,120
7.079,6,45,8409,23,227,321,314,4102,22,489,323,1179,4307
1771.65,17,170,27690,170,134,10483,363,27690,0,0,0,0,0
3.846,17,6,438,3,34,1922,34,186,3,56,1916,68,252
274.7,17,6,528,3,60,137349,60,264,3,60,137349,60,264
0.367,6,6,324,4,0,122,0,216,2,0,188,0,108
1.41,6,50,21138,28,955,52,1360,15482,22,433,57,1360,5656
1.439,17,2,1712,2,828,1439,1315,1712,0,0,0,0,0
0.022,17,2,912,1,308,0,308,336,1,548,0,548,576
1776.564,6,181,15589,120,69,14929,69,8940,61,69,29600,69,6649
1739.077,1,56,4704,56,56,31619,56,4704,0,0,0,0,0
280.247,6,28,7352,12,158,25477,267,1277,16,603,18679,1400,6075
27.621,17,6,456,6,48,5524,48,456,0,0,0,0,0
0.272,6,27,6202,13,181,22,537,1578,14,555,19,1542,4624
21.077,6,26,6348,15,117,1505,159,1389,11,873,2103,1709,4959
1799.799,6,368,25690,215,99,8410,469,15085,153,69,11840,69,10605
786.214,1,24,1344,24,28,34183,28,1344,0,0,0,0,0
1744.807,6,95,7203,63,38,28142,205,4476,32,33,56269,98,2727
280.474,6,30,7432,13,158,23372,267,1317,17,678,17526,3456,6115
1744.788,6,95,7203,63,38,28141,205,4476,32,33,56276,98,2727
0.085,6,10,767,5,186,20,186,454,5,45,18,45,313
1772.206,6,180,15480,120,69,14892,69,8940,60,69,30032,69,6540
5.009,17,3,343,2,36,5004,36,128,1,187,0,187,215
0.819,6,26,5700,13,125,68,267,1275,13,780,62,1460,4425
1740.176,17,30,1710,30,29,60006,29,1710,0,0,0,0,0
65.484,6,21,852,11,0,6547,0,444,10,0,7274,0,408
0.055,6,7,423,4,43,5,43,259,3,0,25,0,164
0.357,6,6,324,4,0,119,0,216,2,0,170,0,108
1786.487,6,105,8484,68,66,26663,66,4964,37,60,49622,60,3520
0.863,17,3,634,2,32,858,32,120,1,486,0,486,514
165.29,6,19,780,7,0,4047,0,284,12,0,15025,0,496
98.678,17,4,352,2,60,98677,60,176,2,60,98677,60,176
2.242,6,13,2311,8,188,320,245,700,5,1407,495,1407,1611
20.149,6,624,695181,143,205,141,443,6633,481,1400,27,1485,688548
275.712,1,17,952,17,28,17232,28,952,0,0,0,0,0
1787.062,6,356,22520,208,69,8633,69,12460,148,69,12154,69,10060
64.615,6,10,856,5,90,16153,270,563,5,31,15216,31,293
1504.044,2,11,352,11,8,150404,8,352,0,0,0,0,0
7.804,6,67,20486,35,552,229,1152,15763,32,491,243,1179,4723
4.074,17,5,295,5,31,1018,31,295,0,0,0,0,0
0.033,6,3,187,1,0,0,0,40,2,31,2,31,147
3.502,6,135,186904,83,977,42,1360,16058,52,4017,66,17680,170846
240.183,6,53,17436,29,735,8577,1402,14763,24,177,10442,580,2673
3.127,6,4,176,1,0,0,0,44,3,0,1510,0,132
280.43,6,26,7272,13,158,23369,267,1317,13,775,23365,3465,5955
75.341,17,17,18479,17,1059,4708,1061,18479,0,0,0,0,0
276.666,6,26,1795,10,332,30740,332,872,16,83,18444,83,923
1740.617,17,30,7050,30,207,60021,207,7050,0,0,0,0,0
0.021,17,4,352,2,60,20,60,176,2,60,20,60,176
15.052,17,5,3490,5,670,3763,1451,3490,0,0,0,0,0
0.073,17,7,532,7,48,12,48,532,0,0,0,0,0
9.423,6,260,224846,161,1336,58,1368,212952,99,838,93,1368,11894
1761.977,6,125,7584,68,26,26297,26,4078,57,26,31463,26,3506
1779.473,1,342,28728,342,56,5218,56,28728,0,0,0,0,0
1.38,6,47,19570,27,920,53,1360,13994,20,476,62,2715,5576
3.642,17,10,1986,5,30,908,30,290,5,311,907,468,1696
1700.588,17,12,498,11,14,170058,14,462,1,8,0,8,36
140.465,6,21,9532,11,545,87,1330,2108,10,1402,15587,3639,7424
1771.504,6,101,9344,66,65,27253,65,5577,35,59,52099,59,3767
30.063,6,9,520,3,0,15031,0,160,6,0,3247,0,360
1787.384,6,102,8364,68,66,26677,66,4964,34,60,54158,60,3400
0.148,17,2,172,1,50,0,50,78,1,66,0,66,94
1785.761,6,106,8524,68,66,26653,66,4964,38,60,48261,60,3560
47.546,1,4,224,4,28,15848,28,224,0,0,0,0,0
1776.531,6,102,8228,68,64,26515,64,4896,34,58,53831,58,3332
81.839,6,28,5081,13,170,6819,722,1697,15,325,5830,1408,3384
280.342,6,30,7432,13,158,23361,267,1317,17,543,17514,1400,6115
745.068,6,78,9007,43,89,17739,722,4043,35,125,21906,1408,4964
4.56,6,37,7189,19,218,253,314,3383,18,513,252,1179,3806
69.098,6,25,7097,12,155,6281,267,1266,13,589,5757,3426,5831
297.082,17,4,240,2,32,297081,32,120,2,32,297081,32,120
0.032,6,3,327,2,103,0,138,287,1,0,0,0,40
2.216,6,98,60451,57,1271,39,1432,50696,41,578,47,2218,9755
3.399,17,5,360,5,44,849,44,360,0,0,0,0,0
11.787,17,81,45049,46,775,261,1350,36965,35,202,340,1350,8084
2.248,17,4,236,4,31,749,31,236,0,0,0,0,0
0.042,6,3,120,2,0,42,0,80,1,0,0,0,40
86.396,6,807,387369,427,839,202,1152,366307,380,418,227,1179,21062
1.304,6,26,8726,15,195,93,389,1763,11,911,104,1448,6963
1797.635,1,345,28980,345,56,5225,56,28980,0,0,0,0,0
2.355,17,27,20432,12,779,214,1350,9690,15,688,122,1350,10742
0.062,17,2,160,1,48,0,48,76,1,56,0,56,84
6.29,6,14,1247,7,222,1044,222,728,7,231,1045,231,519
0.376,6,28,9001,13,227,31,547,1592,15,827,26,1408,7409
0.351,6,28,9001,13,227,29,547,1592,15,827,22,1408,7409
133.361,17,4,1344,4,308,44453,308,1344,0,0,0,0,0
0.397,17,2,186,1,41,0,41,69,1,89,0,89,117
163.006,17,23,3807,23,137,7409,247,3807,0,0,0,0,0
360.896,2,5,160,5,8,90224,8,160,0,0,0,0,0
0.004,17,3,1007,1,137,0,137,165,2,393,4,393,842
84.914,6,24,10995,13,596,138,1445,2365,11,1168,8454,3834,8630
1792.341,17,140,11200,70,48,25975,48,5320,70,56,25975,56,5880
316.985,6,142,53067,71,823,4528,1360,39951,71,285,4526,4649,13116
50.462,17,4,352,2,60,50461,60,176,2,60,50461,60,176
12.067,17,8,608,8,48,1723,48,608,0,0,0,0,0
340.709,17,6,2046,6,313,68141,329,2046,0,0,0,0,0
169.668,6,65,12897,25,262,7068,469,4951,40,243,4349,1917,7946
1.538,6,53,20958,30,931,53,1460,15217,23,437,61,2920,5741
0.004,6,2,104,1,0,0,0,64,1,0,0,0,40
0.365,6,9,539,5,43,65,43,311,4,0,121,0,228
0.611,6,41,24158,19,840,33,1360,5847,22,1088,20,1360,18311
293.134,17,4,240,2,32,293133,32,120,2,32,293132,32,120
237.747,17,4,352,2,60,237745,60,176,2,60,237746,60,176
1796.527,6,356,22520,208,69,8678,69,12460,148,69,12221,69,10060
140.882,6,48,13767,21,181,7044,267,2296,27,610,5406,1400,11471
105.078,6,15,1554,9,302,13134,302,1068,6,83,21013,83,486
1792.566,17,144,11520,72,48,25247,48,5472,72,56,25247,56,6048
1797.932,1,339,28476,339,56,5319,56,28476,0,0,0,0,0
25.61,6,12,904,3,106,12805,106,234,9,90,3175,90,670
1.052,6,26,9900,14,351,80,1045,1996,12,1482,78,3930,7904
35.005,6,35,5345,17,154,2187,722,1962,18,271,2046,1448,3383
1772.414,6,182,15698,120,69,14894,69,8940,62,69,29048,69,6758
25.011,6,2469,2146250,1448,1393,17,1448,2082658,1021,776,24,1448,63592
15.104,17,11,4786,5,509,3768,1350,2685,6,322,3014,1350,2101
171.146,17,4,352,2,60,171145,60,176,2,60,171144,60,176
5.339,6,16,3269,5,92,1334,92,348,11,463,507,1408,2921
295.395,17,4,240,2,32,295394,32,120,2,32,295394,32,120
1794.155,17,144,11520,72,48,25269,48,5472,72,56,25269,56,6048
1787.667,6,137,20021,84,251,21538,1302,13923,53,94,34376,268,6098
5.846,6,32,6295,17,338,365,1314,2374,15,331,417,1420,3921
0.02,17,2,200,1,40,0,40,68,1,104,0,104,132
1773.16,6,180,15480,120,69,14900,69,8940,60,69,30047,69,6540
0.302,17,2,198,1,63,0,63,91,1,79,0,79,107
6.968,6,1775,1651017,1097,1425,6,1448,1611097,678,776,10,1448,39920
7.01,6,13,5586,4,106,2336,106,274,9,822,811,1452,5312
88.498,6,23,10009,12,531,60,1360,2637,11,1384,8836,3934,7372
7.424,6,824,688706,480,1355,15,1408,666154,344,931,21,2801,22552
0.316,6,21,7220,9,265,38,764,1539,12,1009,28,2378,5681
1794.997,17,216,57424,216,237,8348,422,57424,0,0,0,0,0
1791.526,17,142,11360,71,48,25593,48,5396,71,56,25593,56,5964
0.082,6,11,1564,6,503,16,503,823,5,473,20,473,741
12.147,6,1804,1598866,1127,1365,10,1380,1566728,677,383,17,1380,32138
289.031,1,4,224,4,28,96343,28,224,0,0,0,0,0
11.345,17,6,528,3,48,5666,48,228,3,72,5666,72,300
0.927,6,245,234129,95,194,9,230,5727,150,1490,4,2896,228402
1743.0,6,104,7550,66,31,26815,31,4503,38,31,47107,31,3047
3.721,6,16,3249,9,49,465,92,563,7,463,34,1448,2686
11.608,6,1825,1589135,1109,1378,10,1420,1556274,716,467,16,1883,32861
0.052,17,2,212,1,46,0,46,74,1,110,0,110,138
1.369,6,48,18833,27,864,52,1360,13217,21,476,59,2720,5616
2.219,17,116,92761,45,77,50,1350,4750,71,1211,30,1350,88011
0.616,6,10,861,5,222,151,222,426,5,231,151,231,435
1793.04,1,162,17172,162,78,11136,78,17172,0,0,0,0,0
34.148,17,6,1236,3,48,17070,48,228,3,308,17070,308,1008
0.087,17,2,178,1,47,0,47,75,1,75,0,75,103
6.141,6,980,836735,586,1382,10,1420,816754,394,420,15,1420,19981
0.236,17,2,304,1,60,0,60,88,1,188,0,188,216
1794.193,17,80,3354,79,14,23002,14,3318,1,8,0,8,36
1786.271,6,104,8376,68,65,26660,65,4930,36,59,51033,59,3446
1.26,6,25,8080,12,164,97,267,1312,13,869,89,1408,6768
1788.974,17,142,11360,71,48,25556,48,5396,71,56,25556,56,5964
204.656,6,30,7432,14,158,15742,267,1357,16,603,13641,2800,6075
10.898,6,18,5610,10,275,1210,275,958,8,1440,838,1440,4652
3.992,17,4,296,4,46,1330,46,296,0,0,0,0,0
35.295,17,44,6468,22,48,1677,48,1672,22,190,1678,308,4796
1.584,17,2,154,1,33,0,33,61,1,65,0,65,93
1792.094,6,361,22858,210,69,8574,69,12609,151,69,11946,69,10249
1793.178,17,180,14040,180,50,10017,50,14040,0,0,0,0,0
280.468,6,28,7352,13,158,23372,267,1317,15,775,20026,3465,6035
0.014,17,3,451,2,39,0,39,134,1,289,0,289,317
4.193,17,5,290,5,30,1048,30,290,0,0,0,0,0
1617.683,1,14,784,14,28,124437,28,784,0,0,0,0,0
1770.717,6,99,9174,66,64,27241,64,5544,33,58,55332,58,3630
30.707,6,1369,1050391,738,1362,41,1380,1017061,631,383,48,1380,33330
17.134,6,6,1255,4,327,5711,413,814,2,180,16946,269,441
1.97,6,20,3833,11,234,197,564,1504,9,463,223,1343,2329
7.293,6,1567,1423773,973,1384,7,1408,1388221,594,931,11,2816,35552
1770.898,6,103,9382,66,64,27244,64,5544,37,58,49189,58,3838
106.35,17,4,352,2,60,106349,60,176,2,60,106349,60,176
0.076,17,2,549,1,30,0,30,58,1,463,0,463,491
0.556,6,21,7217,12,318,50,599,1905,9,967,68,1906,5312
116.614,17,14,1232,7,48,19434,48,532,7,72,19434,72,700
0.851,6,52,13853,24,549,37,1429,4824,28,438,30,1460,9029
79.47,17,6,456,6,48,15894,48,456,0,0,0,0,0
1755.899,17,50,16736,50,306,35834,308,16736,0,0,0,0,0
3.002,17,4,424,2,46,3000,46,148,2,110,2718,110,276
659.57,6,104,20716,50,635,13454,1418,14684,54,188,12442,899,6032
4.364,6,38,7229,19,218,242,314,3383,19,440,228,1152,3846
1771.525,1,112,6272,112,28,15959,28,6272,0,0,0,0,0
1740.126,17,30,1710,30,29,60004,29,1710,0,0,0,0,0
39.82,17,22,1936,11,48,3981,48,836,11,72,3981,72,1100
300.784,6,40,9758,20,647,15830,1460,4094,20,346,452,1460,5664
1686.533,17,12,498,11,14,168653,14,462,1,8,0,8,36
1.74,2,2,64,2,8,1740,8,64,0,0,0,0,0
0.119,6,10,1369,5,134,29,134,402,5,351,29,380,967
9.221,17,4,352,2,48,9202,48,152,2,72,9192,72,200
66.845,6,17,15583,3,183,23837,183,343,14,1628,5131,2720,15240
0.945,6,124,88802,54,131,17,232,2689,70,1412,12,2840,86113
791.246,6,69,8103,36,84,19463,721,3409,33,135,24720,1448,4694
1.521,6,53,20481,29,964,54,1460,14700,24,400,58,1460,5781
0.529,17,3,451,2,39,493,39,134,1,289,0,289,317
1799.588,17,449,39928,404,35,4465,288,25708,45,288,40018,288,14220
132.778,17,4,1344,4,308,44259,308,1344,0,0,0,0,0
11.026,6,18,4266,10,275,1225,275,958,8,992,892,1440,3308
300.144,6,40,10190,21,626,14998,1460,4628,19,399,16664,1460,5562
0.416,6,7,376,4,0,138,0,216,3,0,104,0,160
228.299,17,4,352,2,60,228298,60,176,2,60,228298,60,176
1772.918,6,180,15480,120,69,14898,69,8940,60,69,30044,69,6540
0.338,6,3,246,2,66,338,66,146,1,60,0,60,100
1787.906,6,356,22589,207,69,8679,69,12420,149,69,12080,69,10169
16.628,6,14,1025,7,222,2768,222,506,7,231,2769,231,519
3.054,17,8,1816,4,30,1014,30,232,4,368,1014,468,1584
68.136,2,4,128,4,8,22712,8,128,0,0,0,0,0
1784.161,17,83,3480,82,14,22026,14,3444,1,8,0,8,36
1.937,17,3,3668,3,1194,968,1431,3668,0,0,0,0,0
0.039,6,2,92,1,0,0,0,40,1,0,0,0,52
0.283,17,2,144,1,36,0,36,64,1,52,0,52,80
1220.897,6,115,18801,35,163,35908,1305,4888,80,164,15451,1629,13913
51.017,6,27,7177,13,155,4251,267,1306,14,530,3923,3417,5871
1739.763,1,15,840,15,28,124268,28,840,0,0,0,0,0
7.392,6,1672,1439982,943,1436,7,1448,1393262,729,776,9,1448,46720
7.442,6,1956,1814833,1207,1423,6,1448,1771221,749,776,9,1448,43612
0.599,6,132,87821,71,1326,8,1432,81148,61,467,9,1871,6673
218.48,17,32,6015,21,31,10819,37,1246,11,405,21847,463,4769
618.013,6,75,14590,33,208,19312,1305,4143,42,273,15070,1929,10447
1780.406,6,182,15560,121,69,14836,69,8911,61,69,29670,69,6649
283.5,6,31,7476,14,158,21807,267,1361,17,543,17537,1400,6115
1797.791,6,356,22520,208,69,8684,69,12460,148,69,12229,69,10060
124.442,6,35,7975,12,155,28,267,1266,23,321,5656,1997,6709
18.131,6,85,27968,44,583,421,1152,22187,41,459,445,1179,5781
90.127,17,4,356,2,29,90110,29,114,2,93,90108,93,242
3.832,6,2,1253,1,0,0,0,40,1,1173,0,1173,1213
21.779,6,16,2297,9,324,2722,585,1125,7,396,3626,580,1172
1.306,6,51,18669,29,840,46,1360,12968,22,400,54,1360,5701
1795.899,17,485,162952,485,307,3710,308,162952,0,0,0,0,0
33.704,6,32,5343,16,154,2246,722,1911,16,370,2234,2026,3432
112.177,6,178,134820,111,1287,1019,1408,120404,67,606,1672,1408,14416
1664.109,1,8,448,8,28,237729,28,448,0,0,0,0,0
1777.627,1,58,4872,58,56,31186,56,4872,0,0,0,0,0
1781.023,6,108,11247,53,119,34249,517,3742,55,458,32981,2412,7505
0.818,6,39,8524,21,271,40,739,2006,18,445,39,1928,6518
1790.154,6,356,22520,208,69,8647,69,12460,148,69,12176,69,10060
1798.139,17,448,39896,403,35,4472,288,25676,45,288,40023,288,14220
0.748,6,9,1002,5,213,187,213,417,4,421,245,421,585
1741.01,17,30,7050,30,207,60034,207,7050,0,0,0,0,0
1743.091,6,95,7203,63,38,28114,205,4476,32,33,56216,98,2727
82.545,1,8,672,0,0,0,0,0,8,56,11792,56,672
0.115,6,13,4525,8,290,16,517,993,5,1088,25,1418,3532
66.483,6,25,9968,12,549,64,1440,2709,13,961,5528,1440,7259
1.68,6,14,2351,8,188,240,245,700,6,703,284,1152,1651
0.108,17,2,180,1,30,0,30,58,1,94,0,94,122
20.15,6,2872,2651600,1836,1365,10,1408,2593052,1036,931,19,2801,58548
1792.29,6,492,30645,274,99,6565,469,17445,218,34,8258,64,13200
75.224,6,7,384,2,0,3259,0,112,5,0,18761,0,272
0.829,17,2,136,1,32,0,32,60,1,48,0,48,76
1.621,6,14,1640,7,256,268,256,1052,7,304,268,304,588
0.041,17,2,362,1,46,0,46,74,1,260,0,260,288
0.918,6,37,8255,19,247,51,643,1781,18,441,37,1460,6474
0.206,17,8,2750,8,315,29,354,2750,0,0,0,0,0
0.077,6,5,485,1,0,0,0,40,4,95,0,95,445
5.002,17,4,288,2,36,5000,36,128,2,52,5000,52,160
0.067,17,3,234,2,39,34,39,134,1,72,0,72,100
1799.991,6,250,30985,97,133,18749,1460,14158,153,137,11841,1460,16827
284.638,6,34,8615,14,158,21895,267,1357,20,496,14980,1400,7258
91.127,6,26,12015,12,452,117,1460,2321,14,1140,6999,1460,9694
93.307,6,13,1140,13,47,7775,62,1140,0,0,0,0,0
0.535,6,10,1669,6,551,106,947,1346,4,159,178,159,323
1799.21,17,449,39928,404,35,4464,288,25708,45,288,40023,288,14220
1789.473,6,366,25541,213,100,8440,469,14936,153,69,11769,69,10605
33.455,6,29,4989,14,180,2573,722,1806,15,342,2376,1408,3183
472.632,6,26,1898,13,31,39386,31,850,13,31,39370,31,1048
2.599,17,2,778,2,361,2599,361,778,0,0,0,0,0
0.136,6,3,175,2,31,0,31,135,1,0,0,0,40
85.427,17,4,1544,4,358,28475,548,1544,0,0,0,0,0
169.842,6,26,7272,13,158,14153,267,1317,13,905,14148,4845,5955
280.336,6,29,7392,13,158,23361,267,1317,16,603,18679,2800,6075
0.057,17,2,904,1,300,0,300,328,1,548,0,548,576
319.845,6,30,7476,6,154,63969,267,712,24,305,13905,1420,6764
1.557,6,25,8801,15,291,111,606,1478,10,988,153,1452,7323
0.379,6,24,5980,12,164,34,453,1442,12,651,32,1448,4538
1772.503,6,180,15480,120,69,14894,69,8940,60,69,30037,69,6540
1771.291,6,99,9240,66,65,27250,65,5577,33,59,55349,59,3663
1634.673,6,366,34873,198,110,8297,469,15522,168,161,9788,1452,19351
1638.221,2,11,352,11,8,163822,8,352,0,0,0,0,0
630.513,2,4,128,4,8,210171,8,128,0,0,0,0,0
30.124,6,12,1317,7,174,5020,174,546,5,251,7526,476,771
1.683,6,14,2351,8,188,240,245,700,6,703,284,1152,1651
280.719,6,31,7813,13,158,23393,267,1317,18,577,16510,2076,6496
1145.419,1,38,3192,0,0,0,0,0,38,56,30957,56,3192
0.404,6,82,52715,47,1253,8,1432,47024,35,427,11,1432,5691
1794.15,17,139,11116,70,48,26001,48,5320,69,56,26384,56,5796
601.235,6,24,1826,13,41,50102,73,1030,11,40,60108,40,796
29.511,17,4,240,2,32,29510,32,120,2,32,29510,32,120
64.916,6,12,927,4,177,121,177,393,8,110,9248,110,534
1779.712,6,248,25342,100,67,17975,681,9414,148,135,12106,2720,15928
2.649,6,27,10087,15,284,189,584,1456,12,905,224,1420,8631
1794.017,17,142,11360,71,48,25628,48,5396,71,56,25628,56,5964
289.411,17,4,352,2,60,289409,60,176,2,60,289410,60,176
0.348,17,2,167,1,39,0,39,67,1,72,0,72,100
576.014,6,8,692,8,46,82287,62,692,0,0,0,0,0
0.067,17,2,152,1,48,0,48,76,1,48,0,48,76
1789.09,17,86,3606,85,14,21298,14,3570,1,8,0,8,36
1773.158,1,58,4872,58,56,31108,56,4872,0,0,0,0,0
296.091,1,4,326,4,53,98697,78,326,0,0,0,0,0
1.295,6,9,382,4,0,431,0,164,5,7,256,7,218
0.178,6,10,1379,5,145,44,145,349,5,826,35,826,1030
1.059,17,3,660,2,46,1000,46,148,1,484,0,484,512
0.006,17,2,419,1,44,0,44,72,1,319,0,319,347
31.407,6,3,144,1,0,0,0,48,2,0,15947,0,96
1790.692,6,376,23803,215,69,8367,69,13223,161,69,11191,69,10580
0.079,6,9,1339,5,145,19,145,349,4,826,22,826,990
72.211,6,32,7584,13,155,6017,267,1306,19,393,4011,1997,6278
226.952,17,36,2736,36,48,6484,48,2736,0,0,0,0,0
10.885,6,845,780922,562,1324,19,1368,761542,283,776,37,1473,19380
1625.898,1,8,848,8,78,232271,78,848,0,0,0,0,0
1796.904,6,384,27144,220,102,8205,469,16099,164,69,11021,69,11045
92.568,6,11627,11216645,7811,1359,11,1408,11013525,3816,931,24,2801,203120
1.528,6,49,19349,27,898,58,1360,13693,22,433,62,1360,5656
12.082,6,87,26245,44,553,280,1152,20043,43,447,281,1179,6202
902.405,2,11,352,11,8,90240,8,352,0,0,0,0,0
664.354,17,50,3984,27,48,25552,48,2052,23,56,25514,56,1932
536.735,6,47,7985,24,124,16437,502,2205,23,242,24393,1420,5780
1.183,6,49,19695,29,919,42,1360,14074,20,437,53,2715,5621
1769.151,1,58,4872,0,0,0,0,0,58,56,31037,56,4872
1786.748,6,102,8296,68,65,26667,65,4930,34,59,54141,59,3366
280.344,6,30,7432,13,158,23362,267,1317,17,543,17513,1400,6115
0.274,17,2,384,1,39,0,39,67,1,289,0,289,317
4.169,6,38,7229,19,218,231,314,3383,19,513,218,1179,3846
0.411,6,6,324,4,0,137,0,216,2,0,223,0,108
1.325,6,38,23972,18,300,77,390,2747,20,1259,66,1408,21225
1796.172,17,142,11360,71,48,25659,48,5396,71,56,25659,56,5964
240.244,6,50,15284,26,693,9609,1418,12455,24,196,10444,580,2829
1.062,17,7,2375,7,311,177,355,2375,0,0,0,0,0
0.268,1,2,112,2,28,268,28,112,0,0,0,0,0
0.102,17,2,235,1,36,0,36,64,1,143,0,143,171
172.767,6,30,7432,13,158,14397,267,1317,17,543,10795,1400,6115
1782.538,17,83,3480,82,14,22006,14,3444,1,8,0,8,36
27.324,6,3777,3562268,2474,1362,10,1408,3489848,1303,931,20,2801,72420
1780.95,17,142,11360,71,48,25441,48,5396,71,56,25441,56,5964
20.73,6,28,7756,15,151,1480,318,1707,13,766,1726,1669,6049
0.132,17,4,284,2,32,72,32,120,2,54,61,60,164
1710.433,17,12,498,11,14,171043,14,462,1,8,0,8,36
0.166,6,28,7336,14,155,12,267,1341,14,603,11,2800,5995
3.768,6,34,6169,18,206,221,314,2784,16,548,233,1179,3385
1772.283,6,182,15629,121,69,14769,69,8980,61,69,29533,69,6649
1787.042,6,354,22440,207,69,8674,69,12420,147,69,12239,69,10020
1764.476,2,15,480,15,8,126034,8,480,0,0,0,0,0
2.791,1,2,813,2,378,2791,421,813,0,0,0,0,0
0.444,6,52,23234,29,1064,15,1380,16149,23,558,18,1923,7085
1771.395,6,101,9410,66,66,27252,66,5610,35,60,52096,60,3800
1786.604,6,104,8376,68,65,26665,65,4930,36,59,51043,59,3446
1751.911,6,182,11194,93,47,19042,208,6735,89,31,19905,31,4459
1763.997,2,14,448,14,8,135692,8,448,0,0,0,0,0
92.062,2,4,128,4,8,30687,8,128,0,0,0,0,0
1.168,6,10,1687,7,100,194,100,384,3,1179,453,1179,1303
1.782,6,2,80,1,0,0,0,40,1,0,0,0,40
11.824,6,1803,1624608,1148,1364,10,1380,1594154,655,421,18,1923,30454
0.308,6,27,8942,13,232,25,569,1614,14,941,23,1402,7328
1773.112,6,180,15480,120,69,14900,69,8940,60,69,30051,69,6540
6.946,6,1295,1148146,769,1412,8,1448,1116130,526,776,12,1448,32016
0.021,17,4,560,2,64,7,64,184,2,160,0,160,376
11.952,6,31,9111,14,402,919,721,2978,17,605,682,1414,6133
1.271,6,51,19749,29,916,45,1360,14048,22,437,52,2715,5701
1787.001,6,104,8444,68,66,26671,66,4964,36,60,51054,60,3480
0.303,6,28,9128,13,252,25,647,1692,15,831,21,1408,7436
0.045,17,2,152,1,48,0,48,76,1,48,0,48,76
8.875,6,26,7070,9,147,1109,267,1104,17,527,543,1452,5966
1.058,2,3,128,3,18,529,24,128,0,0,0,0,0
474.441,6,9,546,6,31,94888,31,333,3,31,237213,31,213
3.028,6,29,10986,15,683,216,1460,5414,14,833,221,1460,5572
298.192,1,4,224,4,28,99397,28,224,0,0,0,0,0
1793.937,17,66,2766,65,14,28030,14,2730,1,8,0,8,36
1.333,6,24,9521,14,351,102,1046,1997,10,1422,128,4380,7524
1782.86,6,360,22818,209,69,8571,69,12569,151,69,11885,69,10249
998.475,17,27,9006,27,305,38402,314,9006,0,0,0,0,0
1799.999,6,211,16256,78,68,23210,297,7662,133,48,13636,78,8594
1720.691,17,12,498,11,14,172069,14,462,1,8,0,8,36
240.232,6,53,17855,28,794,8897,1418,14966,25,197,10009,580,2889
101.119,6,25,9908,12,549,66,1460,2709,13,952,8416,1460,7199
1779.327,17,142,11360,71,48,25418,48,5396,71,56,25418,56,5964
0.041,6,12,886,7,88,6,88,460,5,79,8,149,426
283.661,17,4,294,2,34,283651,37,125,2,56,283653,60,169
227.222,17,4,240,2,32,227221,32,120,2,32,227221,32,120
1.311,6,47,18160,26,882,52,1440,12544,21,433,56,1440,5616
1758.412,6,3919,3157047,1830,145,961,900,105472,2089,1458,842,4224,3051575
300.16,6,40,10149,21,619,14999,1440,4587,19,399,16665,1440,5562
1681.185,17,16,4225,8,30,240167,37,471,8,441,240167,463,3754
1.271,6,38,8252,19,320,70,1162,2716,19,476,60,2715,5536
1740.231,1,15,870,15,30,124302,30,870,0,0,0,0,0
240.707,6,48,6528,21,214,12032,585,3032,27,188,9256,580,3496
252.254,2,3,96,3,8,126127,8,96,0,0,0,0,0
1740.443,17,30,31680,30,1028,60015,1028,31680,0,0,0,0,0
1.443,17,6,1242,3,32,719,32,180,3,326,516,486,1062
1.297,6,46,19056,27,886,49,1360,13520,19,476,62,2715,5536
1795.765,17,449,39928,404,35,4455,288,25708,45,288,40021,288,14220
0.019,17,4,1148,2,32,14,32,120,2,486,13,486,1028
15.88,17,12,5252,6,490,3161,1350,3112,6,328,3161,1350,2140
1.358,6,2,100,1,0,0,0,60,1,0,0,0,40
0.185,6,26,7256,13,155,15,267,1301,13,678,13,2800,5955
1.429,6,17,6337,9,141,178,275,646,8,894,58,1440,5691
1781.803,6,366,23196,212,69,8444,69,12827,154,69,11645,69,10369
1733.752,1,76,6384,0,0,0,0,0,76,56,23116,56,6384
1788.634,17,87,3648,86,14,21042,14,3612,1,8,0,8,36
280.394,6,27,7312,12,158,25490,267,1277,15,678,20025,2085,6035
280.213,6,29,7392,13,158,23351,267,1317,16,603,18679,2036,6075
1797.06,17,179,13962,179,50,10095,50,13962,0,0,0,0,0
4.916,6,40,7309,22,218,234,314,3503,18,513,274,1179,3806
212.418,1,2,120,2,32,212418,32,120,0,0,0,0,0
3.072,17,4,624,4,128,1024,128,624,0,0,0,0,0
1744.259,6,95,7203,63,38,28133,205,4476,32,33,56253,98,2727
1742.842,6,103,7486,65,31,27231,31,4439,38,31,47103,31,3047
41.104,17,5,4754,5,922,10276,1451,4754,0,0,0,0,0
1771.497,6,99,9240,66,65,27253,65,5577,33,59,55355,59,3663
0.944,17,2,780,2,362,944,362,780,0,0,0,0,0
0.012,6,3,327,2,103,1,138,287,1,0,0,0,40
5.027,17,3,343,2,36,5004,36,128,1,187,0,187,215
0.384,6,14,1733,7,288,61,288,588,7,284,35,434,1145
146.198,17,4,352,2,60,146197,60,176,2,60,146197,60,176
4.741,6,43,8329,21,227,237,314,4022,22,489,214,1179,4307
290.262,1,4,224,4,28,96754,28,224,0,0,0,0,0
1781.761,6,355,22480,207,69,8649,69,12420,148,69,12120,69,10060
1797.049,17,448,39896,403,35,4470,288,25676,45,288,40017,288,14220
20.136,17,5,610,5,94,5034,94,610,0,0,0,0,0
1771.342,6,99,9240,66,65,27251,65,5577,33,59,55351,59,3663
147.676,17,4,1344,4,308,49225,308,1344,0,0,0,0,0
0.57,6,6,248,4,0,190,0,164,2,0,270,0,84
0.516,17,2,384,1,39,0,39,67,1,289,0,289,317
18.679,17,41,13640,20,473,981,1350,10039,21,143,932,1350,3601
1797.416,17,448,39896,403,35,4471,288,25676,45,288,40020,288,14220
1.713,6,26,8747,16,275,114,559,1471,10,981,170,1420,7276
8.16,6,23,9928,6,154,1632,267,712,17,710,493,1460,9216
1.286,6,48,19598,27,919,49,1460,13982,21,433,55,1460,5616
0.26,6,28,7336,13,155,21,267,1301,15,543,16,1400,6035
0.881,6,10,1687,7,100,146,100,384,3,1179,313,1179,1303
229.283,17,19,6616,19,320,12737,548,6616,0,0,0,0,0
5.756,6,39,24041,21,840,287,1360,5915,18,1338,329,2720,18126
0.021,6,2,149,1,0,0,0,40,1,69,0,69,109
1786.091,6,365,23156,211,69,8505,69,12856,154,69,11673,69,10300
4.818,6,38,7245,19,218,267,314,3383,19,516,253,1179,3862
1.499,17,4,768,2,39,1019,39,134,2,289,1026,289,634
1776.052,17,140,11200,70,48,25739,48,5320,70,56,25739,56,5880
0.553,6,10,1671,6,552,110,948,1348,4,159,184,159,323
10.858,6,20,4322,11,275,1085,275,998,9,738,757,1380,3324
1122.7,6,98,10239,55,73,20790,722,4842,43,108,26726,1440,5397
1782.174,17,83,3480,82,14,22002,14,3444,1,8,0,8,36
0.537,6,26,6095,13,108,44,147,959,13,658,44,1414,5136
73.214,6,43,9901,21,635,598,1360,4095,22,327,3478,2667,5806
0.011,6,3,151,1,0,0,0,40,2,31,1,31,111
3.151,17,4,304,2,48,3143,48,152,2,48,3142,48,152
0.568,6,20,7151,12,318,51,600,1906,8,964,72,1471,5245
142.906,6,34,6778,20,337,7508,571,4419,14,233,10974,249,2359
2.064,17,4,1556,4,361,688,361,1556,0,0,0,0,0
176.531,6,8,480,2,112,176520,112,200,6,0,35304,0,280
0.205,6,9,527,5,43,51,43,311,4,0,33,0,216
8.887,6,17,5391,9,275,1110,275,643,8,1104,990,1440,4748
0.105,6,12,3462,6,75,20,75,395,6,1373,20,1448,3067
1761.758,6,98,7421,65,38,27527,205,4611,33,33,55049,98,2810
1.05,6,9,1340,5,145,262,145,349,4,827,230,827,991
245.35,6,50,7464,22,332,11682,1056,3524,28,206,9086,580,3940
3.953,6,22,6427,10,268,434,517,1333,12,744,355,1418,5094
94.998,6,36,5365,21,154,4749,721,2182,15,342,1106,2026,3183
2.659,17,3,1173,3,363,1329,363,1173,0,0,0,0,0
0.953,6,28,8160,15,222,56,540,1964,13,944,65,1591,6196
0.363,17,14,7052,7,613,60,1350,4493,7,337,55,1350,2559
0.008,17,2,480,1,64,0,64,92,1,360,0,360,388
0.201,6,2,80,1,0,0,0,40,1,0,0,0,40
1747.285,6,97,7307,63,38,28182,205,4476,34,33,52942,98,2831
367.144,6,19,1303,14,177,28241,177,925,5,110,15162,110,378
0.008,17,2,290,1,40,0,40,68,1,194,0,194,222
3.35,6,28,11108,10,185,372,275,961,18,724,184,1414,10147
1798.489,6,372,26126,214,99,8443,469,15114,158,69,11452,69,11012
652.51,2,8,256,8,8,93215,8,256,0,0,0,0,0
1.398,6,10,924,5,283,307,283,551,5,105,307,105,373
1758.309,17,150,33612,150,196,11800,358,33612,0,0,0,0,0
0.015,17,2,366,1,37,0,37,65,1,273,0,273,301
120.553,6,29,14054,15,519,69,884,2721,14,1195,9260,3928,11333
0.925,6,27,12527,15,529,66,1360,3290,12,1093,69,2561,9237
0.054,6,17,6005,8,186,7,267,701,9,822,6,1420,5304
1782.425,17,83,3480,82,14,22005,14,3444,1,8,0,8,36
1744.707,2,22,704,22,8,83081,8,704,0,0,0,0,0
0.183,6,10,1379,5,145,45,145,349,5,826,29,826,1030
1771.545,6,99,9306,66,66,27254,66,5610,33,60,55358,60,3696
205.649,6,36,8510,19,266,11422,517,2087,17,691,12850,1418,6423
6.234,6,1550,1449661,991,1386,6,1408,1415929,559,931,10,2816,33732
0.211,6,26,7256,13,155,17,267,1301,13,678,17,2800,5955
0.133,6,19,7233,11,359,13,765,2019,8,958,16,1440,5214
335.457,17,6,528,3,60,167728,60,264,3,60,167727,60,264
1793.892,17,66,2766,65,14,28029,14,2730,1,8,0,8,36
53.317,6,9,1249,9,127,6664,127,1249,0,0,0,0,0
55.702,17,4,240,2,32,55701,32,120,2,32,55701,32,120
407.149,6,430,69312,244,304,1675,304,48672,186,83,2199,83,20640
1799.615,6,373,26028,216,98,8370,469,15263,157,69,11535,69,10765
0.243,17,8,2758,8,316,34,355,2758,0,0,0,0,0
0.585,6,131,101298,65,131,9,232,3129,66,1619,8,2840,98169
300.821,6,38,8598,22,308,14324,888,2159,16,526,574,4848,6439
1789.192,6,358,22669,209,69,8601,69,12569,149,69,12087,69,10100
26.098,6,71,15770,35,340,322,889,2986,36,435,741,1360,12784
280.47,6,29,7392,13,158,23372,267,1317,16,603,18695,2760,6075
1798.095,17,447,39296,403,35,4472,288,25392,44,288,40950,288,13904
2.688,17,4,344,2,47,0,47,150,2,69,0,75,194
49.078,6,25,7097,12,155,4461,267,1266,13,589,4089,3426,5831
1772.994,6,183,15738,121,69,14774,69,8980,62,69,29063,69,6758
0.121,6,10,1569,5,627,30,627,895,5,406,30,406,674
7.189,6,1179,997149,694,1388,10,1420,973528,485,467,14,1883,23621
1.378,6,47,18160,26,882,55,1460,12544,21,433,59,1460,5616
1792.227,1,341,28644,341,56,5271,56,28644,0,0,0,0,0
4.589,17,28,6786,11,236,458,1350,2910,17,200,200,1350,3876
0.017,17,2,158,1,34,0,34,62,1,68,0,68,96
1.551,6,48,19342,27,901,59,1460,13726,21,433,67,1460,5616
37.757,6,31,5215,13,180,3146,722,1756,18,311,2204,2026,3459
0.246,6,25,4623,12,165,22,456,1446,13,415,19,888,3177
6.048,6,41,7349,21,218,302,314,3463,20,513,303,1179,3886
31.509,6,7,336,1,0,0,0,48,6,0,6299,0,288
1.142,6,25,8056,13,164,81,267,1340,12,1014,88,2816,6716
280.455,6,26,7272,12,158,25495,267,1277,14,775,21570,3465,5995
0.948,6,28,8263,14,270,60,561,1945,14,820,59,1440,6318
13.657,6,20,8512,7,106,2276,106,394,13,690,1137,2840,8118
0.006,6,2,214,1,134,0,134,174,1,0,0,0,40
1767.801,6,137,8386,72,26,24898,26,4376,65,26,27621,26,4010
115.637,6,38,8608,18,413,574,923,2003,20,413,6078,2128,6605
0.509,6,12,1653,6,288,95,288,548,6,426,59,434,1105
1770.58,6,99,9240,66,65,27239,65,5577,33,59,55327,59,3663
687.768,6,77,10401,42,100,16774,516,3490,35,211,17780,1452,6911
0.045,17,2,157,1,31,0,31,59,1,70,0,70,98
555.561,17,81,6156,81,48,6944,48,6156,0,0,0,0,0
1740.573,17,30,31620,30,1026,60019,1026,31620,0,0,0,0,0
1799.501,6,372,26319,215,104,8408,469,15623,157,69,11535,69,10696
245.705,17,15,4844,15,294,17550,329,4844,0,0,0,0,0
1748.401,6,98,7402,64,38,27752,205,4559,34,33,52973,98,2843
1782.292,17,83,3480,82,14,22003,14,3444,1,8,0,8,36
0.373,17,2,234,1,33,0,33,61,1,145,0,145,173
61.35,6,38,15948,22,796,2921,1368,9117,16,665,4071,1368,6831
1783.694,6,364,25392,212,100,8453,469,14896,152,69,11809,69,10496
1783.236,6,353,22400,206,69,8698,69,12380,147,69,12213,69,10020
68.164,17,4,240,2,32,68163,32,120,2,32,68163,32,120
1789.949,6,361,23727,210,81,8564,469,13478,151,69,11932,69,10249
31.553,6,7,336,1,0,0,0,48,6,0,6309,0,288
1.797,6,52,22491,28,975,66,1440,16755,24,433,69,1440,5736
316.908,6,95,34041,51,574,6338,1360,23344,44,357,7366,4649,10697
315.944,6,91,14898,43,111,7522,615,4625,48,252,6719,1929,10273
6.314,6,1066,944328,649,1377,9,1408,917980,417,931,14,2816,26348
1795.363,1,228,12768,228,28,7909,28,12768,0,0,0,0,0
651.911,2,6,192,6,8,130382,8,192,0,0,0,0,0
0.061,6,9,1340,5,145,15,145,349,4,827,16,827,991
1.053,6,26,6060,14,138,81,267,1675,12,650,88,1420,4385
237.938,1,8,448,8,28,33991,28,448,0,0,0,0,0
818.367,6,131,20240,68,118,12214,721,7805,63,367,13196,2391,12435
3.094,17,6,870,3,40,1531,40,204,3,194,1525,194,666
1771.966,6,180,15480,120,69,14890,69,8940,60,69,30032,69,6540
166.678,17,2,136,2,40,166678,47,136,0,0,0,0,0
75.513,6,31,15738,16,585,52,1360,3609,15,1279,5384,3485,12129
1.292,6,53,19867,29,920,46,1460,14086,24,400,48,1460,5781
0.719,6,17,5712,10,259,79,479,1183,7,849,107,1452,4529
133.751,6,27,5095,11,216,935,314,1956,16,498,8899,1179,3139
101.807,6,43,11382,18,403,2648,1189,3953,25,401,4241,1926,7429
1.662,6,13,2311,8,188,237,245,700,5,1407,352,1407,1611
6.684,6,34,6169,18,206,393,314,2784,16,548,414,1179,3385
1785.971,17,162,29988,162,157,11092,422,29988,0,0,0,0,0
0.48,17,3,543,2,39,240,39,134,1,381,0,381,409
1.048,17,4,502,3,32,513,32,180,1,294,0,294,322
0.012,6,3,120,1,0,0,0,40,2,0,11,0,80
20.207,17,6,1936,6,294,4041,300,1936,0,0,0,0,0
12.238,17,8,704,4,48,4076,48,304,4,72,4075,72,400
0.909,6,11,1727,7,100,151,100,384,4,589,216,1152,1343
1796.338,6,359,22709,209,69,8636,69,12569,150,69,12055,69,10140
252.394,6,20,4271,6,150,164,174,544,14,263,19405,1452,3727
278.691,17,12,912,12,48,25335,48,912,0,0,0,0,0
1783.463,17,83,3480,82,14,22018,14,3444,1,8,0,8,36
1782.368,17,83,3480,82,14,22004,14,3444,1,8,0,8,36
0.015,17,3,716,2,64,10,64,184,1,504,0,504,532
240.551,6,60,24566,30,539,8294,1402,6446,30,973,8294,2804,18120
1795.587,1,342,28728,342,56,5265,56,28728,0,0,0,0,0
0.152,6,11,1739,6,126,30,126,386,5,1149,34,1149,1353
241.017,6,42,5900,20,248,12683,582,2813,22,215,11475,580,3087
22.938,17,8,1176,4,48,7574,48,304,4,190,7635,308,872
280.433,6,30,7432,13,158,23369,267,1317,17,603,17524,2076,6115
1786.519,1,9,504,9,28,223314,28,504,0,0,0,0,0
0.355,6,10,968,5,256,87,256,460,5,304,87,304,508
0.057,6,10,1495,5,507,14,507,727,5,556,14,556,768
1.55,6,12,1304,6,256,307,256,756,6,304,307,304,548
0.056,17,2,152,1,48,0,48,76,1,48,0,48,76
21.229,6,25,11166,15,634,1516,1360,3806,10,1389,2338,3933,7360
0.007,17,2,463,1,41,0,41,69,1,366,0,366,394
1796.697,6,292,28264,122,67,14847,681,10534,170,113,10630,1360,17730
1741.414,17,30,6930,30,203,60048,203,6930,0,0,0,0,0
1796.319,1,274,15344,274,28,6579,28,15344,0,0,0,0,0
1788.06,6,359,22709,209,69,8596,69,12569,150,69,12000,69,10140
0.896,6,13,938,7,185,149,185,565,6,45,179,45,373
1798.188,1,341,28644,341,56,5288,56,28644,0,0,0,0,0
146.785,6,15,3111,7,500,148,1237,1801,8,489,20944,826,1310
280.297,6,28,7352,13,158,23358,267,1317,15,678,20018,2800,6035
1788.971,17,140,11200,70,48,25926,48,5320,70,56,25926,56,5880
1750.838,1,178,9968,178,28,9891,28,9968,0,0,0,0,0
2.025,6,21,4871,12,255,184,501,1641,9,550,241,1448,3230
8.032,6,80,24757,41,561,200,1152,19056,39,413,204,1152,5701
1789.952,6,352,22360,205,69,8774,69,12340,147,69,12259,69,10020
0.134,17,4,420,2,33,0,33,122,2,121,85,145,298
1.198,6,25,8056,12,164,93,267,1288,13,869,85,1448,6768
1744.233,6,97,7307,63,38,28132,205,4476,34,33,52842,98,2831
62.355,6,60,38968,38,1163,1685,1408,31083,22,841,2925,2439,7885
2.364,6,14,2351,8,188,337,245,700,6,703,421,1152,1651
0.233,6,43,18769,25,985,9,1420,13828,18,467,13,1883,4941
1702.828,17,14,1036,7,30,283802,30,406,7,62,283802,62,630
1.073,6,29,8200,15,222,64,540,1964,14,944,68,1591,6236
38.87,17,6,360,3,32,19434,32,180,3,32,19434,32,180
265.622,17,4,240,2,32,265621,32,120,2,32,265621,32,120
1799.173,1,57,4788,57,56,32128,56,4788,0,0,0,0,0
1.323,6,48,18559,26,910,52,1460,12903,22,433,54,1460,5656
0.226,17,2,2384,2,1164,226,1164,2384,0,0,0,0,0
60.201,2,2,64,2,8,60201,8,64,0,0,0,0,0
1639.163,1,7,392,7,28,273193,28,392,0,0,0,0,0
70.143,1,6,336,6,28,14028,28,336,0,0,0,0,0
0.609,6,24,5992,12,164,55,453,1442,12,781,51,2224,4550
0.047,6,11,913,7,182,7,182,542,4,77,14,134,371
405.353,6,49,9458,18,105,23843,267,1989,31,248,13511,1452,7469
108.004,17,4,352,2,60,108003,60,176,2,60,108002,60,176
240.567,6,52,20965,26,1023,9621,1418,17751,26,204,9622,580,3214
0.267,6,19,7177,12,334,23,663,1969,7,1612,43,3314,5208
0.011,17,4,284,2,32,1,32,120,2,54,3,60,164
27.562,6,11,1405,3,585,13781,585,737,8,212,3899,212,668
1782.741,6,491,101100,250,370,7159,1380,47380,241,220,7427,1380,53720
0.139,17,2,144,1,36,0,36,64,1,52,0,52,80
1.149,6,32,6084,16,111,76,267,1539,16,650,67,1452,4545
125.614,6,21,4630,7,266,585,500,1084,14,297,9656,1420,3546
1772.563,6,106,9904,69,66,26051,66,5964,37,60,49234,60,3940
201.956,17,10,3352,10,307,22439,308,3352,0,0,0,0,0
0.641,6,24,10710,13,754,53,1360,3570,11,1114,46,3068,7140
58.265,17,6,528,3,48,29128,48,228,3,72,29128,72,300
300.597,6,37,8345,19,269,16699,731,1870,18,441,498,1440,6475
11.782,6,1005,932206,662,1334,17,1368,907474,343,776,33,1473,24732
0.668,17,20,13705,11,986,65,1350,11163,9,254,78,1350,2542
0.051,6,3,160,2,0,51,0,100,1,0,0,0,60
0.985,6,2,120,2,0,0,0,120,0,0,0,0,0
1796.345,17,87,3648,86,14,21133,14,3612,1,8,0,8,36
123.332,17,7,532,7,48,20555,48,532,0,0,0,0,0
1777.005,17,140,11200,70,48,25753,48,5320,70,56,25753,56,5880
1798.418,6,371,26348,215,105,8403,469,15554,156,69,11600,69,10794
1645.588,1,7,392,7,28,274264,28,392,0,0,0,0,0
1746.704,6,96,7255,62,38,28634,205,4424,34,33,52920,98,2831
0.032,17,4,352,2,37,26,37,130,2,83,23,89,222
1764.514,1,88,4928,88,28,20281,28,4928,0,0,0,0,0
1785.48,6,102,8364,68,66,26648,66,4964,34,60,54102,60,3400
976.59,1,48,2688,48,28,20778,28,2688,0,0,0,0,0
0.073,1,2,112,2,28,73,28,112,0,0,0,0,0
0.058,17,2,428,1,40,0,40,68,1,332,0,332,360
15.02,6,8,642,8,46,2145,46,642,0,0,0,0,0
258.083,17,6,360,3,32,129041,32,180,3,32,129041,32,180
48.278,6,493,219969,256,796,189,1152,205325,237,396,203,1152,14644
0.266,6,25,6039,12,164,24,453,1442,13,652,21,1408,4597
31.323,6,39,10186,19,632,502,1360,3320,20,503,1637,2134,6866
20.24,6,16,2224,8,555,2890,888,1434,8,231,2890,231,790
0.042,17,2,150,1,33,0,33,61,1,61,0,61,89
261.152,6,29,8885,12,328,23741,705,2263,17,955,16215,1418,6622
1798.035,6,191,18610,126,99,14384,469,11525,65,69,28088,69,7085
1783.811,6,359,22709,209,69,8575,69,12569,150,69,11971,69,10140
51.598,17,4,240,2,32,51597,32,120,2,32,51597,32,120
39.948,17,6,528,3,48,19969,48,228,3,72,19969,72,300
30.002,6,38,9586,18,289,1764,721,3329,20,681,1525,1440,6257
0.236,6,10,1669,6,551,47,947,1346,4,159,78,159,323
0.035,17,4,284,2,32,0,32,120,2,54,9,60,164
2.928,6,7,388,4,0,976,0,216,3,0,1440,0,172
1.258,6,10,1687,7,100,209,100,384,3,1179,499,1179,1303
0.553,17,2,384,1,39,0,39,67,1,289,0,289,317
15.621,17,21,15235,13,973,1296,1350,13019,8,249,2221,1350,2216
0.418,6,51,22669,28,1090,15,1380,17507,23,421,17,1923,5162
1286.374,1,82,4592,82,28,15881,28,4592,0,0,0,0,0
1788.135,1,342,28728,342,56,5243,56,28728,0,0,0,0,0
14.396,6,31,5903,15,154,1012,722,1882,16,398,948,2026,4021
240.198,6,54,18456,29,786,8578,1418,15670,25,184,10007,580,2786
0.212,17,2,204,1,34,0,34,62,1,114,0,114,142
0.017,17,2,309,1,45,0,45,73,1,208,0,208,236
0.265,17,2,136,1,32,0,32,60,1,48,0,48,76
29.082,6,16,1105,8,222,4153,222,546,8,231,4153,231,559
0.347,6,27,9047,13,252,28,647,1692,14,945,25,1408,7355
1741.658,1,15,840,15,28,124404,28,840,0,0,0,0,0
0.63,6,124,82581,68,1286,9,1432,76050,56,427,11,1432,6531
40.01,17,6,2016,6,308,8002,308,2016,0,0,0,0,0
280.393,6,30,7432,13,158,23366,267,1317,17,678,17521,2760,6115
1611.317,1,88,9328,88,78,18520,78,9328,0,0,0,0,0
280.437,6,30,7432,13,158,23369,267,1317,17,543,17521,1400,6115
289.4,1,4,224,4,28,96466,28,224,0,0,0,0,0
37.034,6,29,8832,14,158,2848,267,1357,15,858,2643,3436,7475
240.2,6,51,18010,27,799,9238,1418,15006,24,249,10443,580,3004
1771.492,6,103,9514,66,66,27253,66,5610,37,60,49205,60,3904
3.615,6,16,3706,8,75,516,75,519,8,1373,516,1448,3187
263.995,6,32,8952,14,158,20307,267,1357,18,624,15528,1400,7595
16.056,17,21,8242,10,498,1779,1350,5267,11,242,1601,1350,2975
1680.484,1,15,840,15,28,120034,28,840,0,0,0,0,0
6.984,17,24,15961,11,443,698,1350,5185,13,800,510,1350,10776
63.063,2,4,128,4,8,21021,8,128,0,0,0,0,0
0.107,17,4,284,2,32,36,32,120,2,54,72,60,164
0.01,6,2,80,1,0,0,0,40,1,0,0,0,40
1794.934,6,356,22520,208,69,8671,69,12460,148,69,12210,69,10060
251.932,2,3,96,3,8,125966,8,96,0,0,0,0,0
0.144,6,11,1973,6,242,28,517,1059,5,323,15,499,914
347.737,1,8,448,8,28,49676,28,448,0,0,0,0,0
23.962,6,36,8248,16,188,1597,722,1964,20,548,1238,1380,6284
1771.278,6,99,9306,66,66,27250,66,5610,33,60,55349,60,3696
2.504,6,13,2311,8,188,357,245,700,5,1407,566,1407,1611
285.968,6,26,2853,14,324,21994,585,1385,12,282,25991,580,1468
5.014,17,4,558,2,36,5004,36,128,2,187,4980,187,430
0.479,6,11,1585,5,585,119,585,841,6,212,71,212,744
0.044,17,2,384,1,32,0,32,60,1,296,0,296,324
0.243,6,19,4311,11,165,24,456,1394,8,498,31,888,2917
1786.929,6,78,4108,39,26,47023,26,2054,39,26,47023,26,2054
1039.199,6,148,17380,86,82,12225,267,6702,62,157,17035,1452,10678
0.026,6,2,92,2,0,0,0,92,0,0,0,0,0
1773.01,6,180,15480,120,69,14899,69,8940,60,69,30048,69,6540
0.095,17,4,284,2,32,14,32,120,2,54,82,60,164
280.47,6,29,7392,13,158,23372,267,1317,16,775,18695,4836,6075
9.108,17,16,1400,8,34,1298,34,496,8,85,1299,91,904
2.839,17,2,672,2,308,2839,308,672,0,0,0,0,0
0.532,17,3,543,2,39,147,39,134,1,381,0,381,409
1740.127,6,91,6604,59,31,30002,31,3998,32,31,56132,31,2606
1.047,17,17,11965,8,638,149,1350,5334,9,708,118,1350,6631
369.613,6,23,1538,16,180,24640,180,1056,7,110,10609,110,482
146.073,6,174,132895,109,1269,1352,1368,119938,65,679,1632,2519,12957
377.474,6,19,1303,14,177,29036,177,925,5,110,15685,110,378
1.173,6,11,1008,6,256,234,256,500,5,304,291,304,508
240.294,6,44,9094,21,523,12014,1408,5822,23,206,10922,617,3272
1787.495,17,87,3648,86,14,21029,14,3612,1,8,0,8,36
1.337,6,63,18888,31,707,44,1360,9081,32,425,41,1360,9807
1795.898,17,448,39896,403,35,4467,288,25676,45,288,40018,288,14220
1775.583,17,140,11200,70,48,25732,48,5320,70,56,25732,56,5880
11.02,6,21,6825,12,275,1001,275,1038,9,1353,761,1440,5787
0.425,6,10,968,5,256,102,256,460,5,304,102,304,508
34.442,17,3,228,3,48,17221,48,228,0,0,0,0,0
1790.929,6,356,22520,208,69,8651,69,12460,148,69,12183,69,10060
3.627,17,5,290,5,30,906,30,290,0,0,0,0,0
1613.981,1,7,392,7,28,268996,28,392,0,0,0,0,0
0.131,17,4,284,2,32,0,32,120,2,54,123,60,164
0.947,6,29,9314,16,203,63,458,1498,13,910,64,2720,7816
0.055,17,2,198,1,63,0,63,91,1,79,0,79,107
541.403,2,4,128,4,8,180467,8,128,0,0,0,0,0
226.699,17,40,5880,20,48,11930,48,1520,20,190,11930,308,4360
0.043,17,2,144,1,36,0,36,64,1,52,0,52,80
1797.031,17,448,39896,403,35,4470,288,25676,45,288,40014,288,14220
24.572,6,57,19192,34,673,733,1152,15522,23,457,971,1179,3670
164.081,6,45,10454,16,327,1658,1189,2615,29,333,5859,2006,7839
1774.765,6,268,32579,111,132,16133,1360,15592,157,137,11375,4662,16987
9.77,6,45,8095,24,228,424,314,4169,21,513,476,1179,3926
30.688,17,22,11387,10,582,3406,1350,6103,12,412,2786,1350,5284
1.565,6,52,19375,29,884,55,1360,13622,23,437,61,2715,5753
17.694,6,38,7340,23,195,804,293,3287,15,574,952,1179,4053
0.409,6,419,409070,144,201,2,486,8301,275,1426,1,1438,400769
1793.743,6,386,34492,218,123,8266,1189,17282,168,139,10740,1452,17210
60.178,2,2,64,2,8,60178,8,64,0,0,0,0,0
0.22,17,2,290,1,40,0,40,68,1,194,0,194,222
4.76,6,5,280,2,0,4760,0,100,3,0,1516,0,180
280.035,1,4,224,4,28,93345,28,224,0,0,0,0,0
1795.407,17,80,3354,79,14,23018,14,3318,1,8,0,8,36
0.43,2,4,160,4,16,143,16,160,0,0,0,0,0
1796.865,6,117,9404,75,65,24281,65,5600,42,59,43822,59,3804
0.533,6,59,23792,31,1010,17,1380,16483,28,561,17,1923,7309
1.358,6,51,18719,27,847,52,1360,12983,24,433,51,1360,5736
300.572,6,18,1227,6,177,60079,177,497,12,110,27308,110,730
0.011,6,4,160,2,0,11,0,80,2,0,0,0,80
0.749,17,4,352,2,60,748,60,176,2,60,748,60,176
1.394,6,24,8004,12,164,107,267,1288,12,1014,107,2491,6716
0.411,6,56,23602,31,944,13,1380,16437,25,511,15,1923,7165
1783.812,6,365,23156,210,69,8534,69,12816,155,69,11583,69,10340
8.233,6,78,24677,39,561,216,1152,18976,39,413,210,1152,5701
87.443,6,22,8810,11,333,74,692,1473,11,983,8731,1360,7337
431.135,17,6,528,3,60,215567,60,264,3,60,215567,60,264
602.323,6,54,8712,27,116,18740,516,2485,27,214,23163,1452,6227
0.164,17,2,234,1,41,0,41,69,1,137,0,137,165
1798.337,6,367,25650,214,99,8442,469,15045,153,69,11830,69,10605
1773.644,6,180,15480,120,69,14904,69,8940,60,69,30054,69,6540
1793.033,1,58,4872,58,56,31456,56,4872,0,0,0,0,0
1.423,6,52,19602,29,901,50,1460,13861,23,437,56,2615,5741
0.03,6,3,120,2,0,30,0,80,1,0,0,0,40
15.312,6,17,6232,4,222,5058,222,402,13,756,1264,1440,5830
1799.274,17,3022,145056,1511,20,1191,20,72528,1511,20,1191,20,72528
1740.501,17,29,30566,29,1026,62160,1026,30566,0,0,0,0,0
135.964,6,143,150791,44,289,3161,872,6626,99,1634,1387,5608,144165
1.301,6,54,23344,30,963,44,1360,17608,24,476,49,2715,5736
27.136,6,3958,3828489,2651,1367,10,1408,3755861,1307,776,20,1408,72628
11.85,6,1847,1632668,1155,1363,10,1380,1598823,692,558,17,1923,33845
2.858,17,37,16552,19,563,157,1350,11234,18,267,166,1350,5318
280.246,6,29,7392,13,158,23353,267,1317,16,603,18677,2036,6075
11.846,6,24,8413,13,275,987,275,1078,11,1147,942,2840,7335
1795.572,17,179,13962,179,50,10087,50,13962,0,0,0,0,0
1786.178,6,357,22698,207,69,8670,69,12420,150,69,11987,69,10278
0.079,17,2,586,1,46,0,46,74,1,484,0,484,512
46.691,6,42,8853,20,401,545,889,2096,22,391,2216,3488,6757
1751.152,17,12,498,11,14,175115,14,462,1,8,0,8,36
280.423,6,28,7352,12,158,25493,267,1277,16,678,18692,2085,6075
1725.068,1,8,448,8,28,246438,28,448,0,0,0,0,0
5.947,6,19,7923,10,134,660,142,672,9,1147,689,1452,7251
1.946,6,22,6563,13,229,162,498,1672,9,646,232,1414,4891
63.871,6,2928,2620132,2049,1207,31,1440,2568919,879,1097,72,1440,51213
298.089,17,4,352,2,60,298088,60,176,2,60,298088,60,176
13.84,6,30,5069,14,154,1047,722,1819,16,301,910,1402,3250
1787.904,6,360,24763,209,94,8595,469,14376,151,69,11919,69,10387
0.712,6,23,7406,13,335,59,668,2026,10,1210,75,1946,5380
95.453,17,4,240,2,32,95452,32,120,2,32,95452,32,120
0.021,17,3,244,2,32,11,32,120,1,96,0,96,124
1772.116,6,180,15480,120,69,14891,69,8940,60,69,30034,69,6540
1681.561,17,14,1036,7,30,280256,30,406,7,62,280256,62,630
18.903,1,8,832,0,0,0,0,0,8,76,2700,76,832
1786.706,6,102,8296,68,65,26667,65,4930,34,59,54139,59,3366
1616.94,1,7,392,7,28,269490,28,392,0,0,0,0,0
487.662,6,105,31872,57,652,8708,1418,26581,48,145,10375,580,5291
618.011,6,112,22057,47,276,13435,1460,10496,65,198,9654,1460,11561
1796.812,17,142,11360,71,48,25668,48,5396,71,56,25667,56,5964
1799.457,17,450,39960,405,35,4454,288,25740,45,288,40021,288,14220
240.651,6,45,9046,21,521,12029,1418,5795,24,221,10460,619,3251
1798.665,17,449,39928,404,35,4463,288,25708,45,288,40016,288,14220
2.877,17,4,1370,2,308,1877,308,672,2,321,1880,321,698
1774.632,6,180,15480,120,69,14912,69,8940,60,69,30075,69,6540
382.331,6,80,16522,42,138,9298,721,5278,38,511,10328,1414,11244
1786.815,6,102,8364,68,66,26668,66,4964,34,60,54142,60,3400
1.554,6,53,23901,30,998,53,1460,18205,23,433,60,1460,5696
280.379,6,28,7352,12,158,25489,267,1277,16,603,18681,1400,6075
1794.462,6,397,30023,228,122,7905,469,18295,169,69,10681,69,11728
0.001,6,2,149,1,0,0,0,40,1,69,0,69,109
1729.18,6,62,4504,40,33,44337,33,2740,22,31,82331,31,1764
1200.81,2,8,256,8,8,171544,8,256,0,0,0,0,0
1733.145,6,177,10786,85,46,18772,208,6083,92,31,19043,31,4703
1681.843,17,14,1036,7,30,280302,30,406,7,62,280304,62,630
299.942,1,4,224,4,28,99980,28,224,0,0,0,0,0
1744.503,6,95,7203,63,38,28137,205,4476,32,33,56265,98,2727
4.036,17,5,290,5,30,1009,30,290,0,0,0,0,0
1771.304,6,100,9226,66,64,27250,64,5544,34,58,53673,58,3682
1784.397,6,104,8376,68,65,26632,65,4930,36,59,50980,59,3446
52.289,6,1166,1030248,715,1361,73,1368,999586,451,899,115,2736,30662
1786.827,6,104,8444,68,66,26669,66,4964,36,60,51049,60,3480
0.348,6,27,9047,13,252,29,647,1692,14,945,26,1438,7355
12.534,6,80,24725,41,560,313,1152,19008,39,461,297,1179,5717
38.832,17,44,6468,22,48,1848,48,1672,22,190,1848,308,4796
0.128,6,7,280,2,0,0,0,80,5,0,18,0,200
0.858,6,27,5927,13,156,71,267,1462,14,650,59,1452,4465
3.404,6,22,6422,11,268,336,517,1385,11,744,336,1418,5037
1799.999,6,188,14399,70,67,25652,295,6759,118,48,15384,78,7640
578.501,1,5,1820,5,336,144625,336,1820,0,0,0,0,0
1773.23,6,181,15589,120,69,14901,69,8940,61,69,29547,69,6649
8.242,6,24,6897,7,138,1373,267,843,17,447,513,1460,6054
1798.171,6,356,22520,208,69,8686,69,12460,148,69,12232,69,10060
1799.665,6,216,16981,81,72,22125,375,8201,135,49,13430,144,8780
0.762,6,122,78378,67,1280,11,1432,71878,55,389,13,1432,6500
0.067,6,9,1002,5,213,16,213,417,4,421,15,421,585
240.951,6,53,9372,27,145,9267,517,2867,26,395,9637,2816,6505
2.883,17,8,1912,4,40,957,40,272,4,382,956,423,1640
1792.322,17,88,3684,86,14,21084,14,3612,2,8,1792146,8,72
1773.518,6,198,16657,120,69,14903,69,8940,78,58,23032,69,7717
0.932,17,3,201,3,39,466,39,201,0,0,0,0,0
0.25,6,9,1339,5,145,62,145,349,4,826,74,826,990
9.194,6,84,24917,42,544,224,1152,19096,42,413,217,1152,5821
0.354,6,22,7342,12,335,31,668,1974,10,1210,38,1906,5368
1723.849,1,78,4368,78,28,22387,28,4368,0,0,0,0,0
368.436,6,18,1696,14,509,28341,509,1089,4,435,61909,435,607
0.106,6,15,3636,8,226,14,226,650,7,871,16,1408,2986
1.149,6,212,156803,118,1346,9,1432,148798,94,420,12,1432,8005
0.259,17,2,2380,2,1162,259,1162,2380,0,0,0,0,0
2.948,17,4,624,4,128,982,128,624,0,0,0,0,0
11.816,6,1911,1626957,1149,1363,10,1380,1592190,762,387,15,2760,34767
0.12,6,2,100,1,0,0,0,60,1,0,0,0,40
0.394,17,2,194,1,61,0,61,89,1,77,0,77,105
914.612,6,134,15362,69,91,13447,721,6699,65,263,14287,1440,8663
1.233,6,209,160513,122,1331,10,1432,152742,87,427,14,1432,7771
16.076,6,1913,1596036,1120,1367,14,1380,1555871,793,511,20,1923,40165
0.513,17,2,476,1,39,0,39,67,1,381,0,381,409
337.455,17,141,36621,69,397,4458,1350,29346,72,73,4752,1350,7275
0.209,6,25,7458,13,177,17,337,1394,12,905,18,1588,6064
11.628,6,22,6817,12,275,1057,275,1038,10,1073,735,1420,5779
0.863,6,10,1687,7,100,143,100,384,3,1179,307,1179,1303
12.399,6,55,30926,32,520,399,1360,7098,23,1635,510,5440,23828
20.901,6,2541,2405709,1680,1356,12,1408,2356273,861,776,24,1408,49436
1789.949,6,355,22480,207,69,8689,69,12420,148,69,12176,69,10060
0.903,17,9,3275,9,335,112,361,3275,0,0,0,0,0
1796.209,1,59,4956,59,56,30969,56,4956,0,0,0,0,0
0.004,1,2,168,2,56,4,56,168,0,0,0,0,0
0.437,17,2,144,1,36,0,36,64,1,52,0,52,80
201.108,17,5,1203,5,212,50277,687,1203,0,0,0,0,0
1794.11,17,73,3060,72,14,25269,14,3024,1,8,0,8,36
4.601,6,17,968,12,0,418,0,708,5,0,863,0,260
1745.314,6,95,7203,63,38,28150,205,4476,32,33,56286,98,2727
198.299,1,6,336,6,28,39659,28,336,0,0,0,0,0
0.199,1,2,112,2,28,199,28,112,0,0,0,0,0
1798.138,17,448,39612,404,35,4461,288,25708,44,288,40950,288,13904
1.673,6,24,8725,15,285,119,588,1460,9,1150,186,2840,7265
4.352,6,2,88,2,0,0,0,88,0,0,0,0,0
33.782,6,30,5207,13,204,2815,722,1719,17,288,2099,1408,3488
4.515,6,3,132,3,0,0,0,132,0,0,0,0,0
1695.326,6,88,8133,54,66,27160,66,4590,34,55,51370,60,3543
1798.187,1,345,28980,345,56,5227,56,28980,0,0,0,0,0
0.344,17,2,144,1,36,0,36,64,1,52,0,52,80
0.489,17,3,451,2,39,463,39,134,1,289,0,289,317
0.055,6,13,3514,7,75,9,75,447,6,1373,10,1448,3067
1783.279,17,83,3480,82,14,22015,14,3444,1,8,0,8,36
1784.549,17,142,11360,71,48,25493,48,5396,71,56,25492,56,5964
0.005,17,2,120,1,32,0,32,60,1,32,0,32,60
7.273,6,1172,925042,612,1417,11,1448,889322,560,776,12,1448,35720
22.105,6,177,66876,91,700,245,1152,58272,86,430,256,1179,8604
1799.999,6,212,16636,79,72,23076,346,8042,133,48,13636,78,8594
1783.594,17,84,3516,82,14,22017,14,3444,2,8,1783380,8,72
9.445,17,4,352,2,60,9444,60,176,2,60,9444,60,176
1787.867,17,87,3648,86,14,21033,14,3612,1,8,0,8,36
1.383,6,21,5000,11,137,138,267,1132,10,692,130,1467,3868
1744.718,2,25,800,25,8,72696,8,800,0,0,0,0,0
1796.766,1,345,28980,345,56,5223,56,28980,0,0,0,0,0
0.032,2,2,80,2,16,32,16,80,0,0,0,0,0
20.899,6,17,3326,9,210,2612,210,920,8,664,2981,904,2406
0.644,17,2,925,1,548,0,548,576,1,321,0,321,349
37.7,6,39,9924,19,706,492,1460,4322,20,399,1974,1460,5602
3.203,17,4,518,3,39,837,39,201,1,289,0,289,317
0.451,6,52,22520,29,1013,16,1380,15435,23,558,18,1923,7085
1773.455,6,180,15480,120,69,14902,69,8940,60,69,30053,69,6540
8.236,6,1792,1684974,1151,1387,6,1408,1646978,641,931,12,2801,37996
0.071,17,3,543,2,39,66,39,134,1,381,0,381,409
7.4,6,6,280,2,0,7400,0,88,4,0,2418,0,192
0.001,6,2,104,0,0,0,0,0,2,0,0,0,104
1773.074,6,180,15480,120,69,14899,69,8940,60,69,30048,69,6540
1750.95,17,352,56686,352,133,4988,392,56686,0,0,0,0,0
11.401,6,41,7710,19,218,633,314,3383,22,491,530,1179,4327
3.002,17,4,296,4,46,1000,46,296,0,0,0,0,0
0.035,17,4,420,2,33,17,33,122,2,121,19,145,298
0.062,17,4,420,2,33,1,33,122,2,121,0,145,298
1.223,6,1811,1767136,713,183,1,230,40997,1098,1524,1,5608,1726139
1781.762,6,483,30152,267,100,6698,469,17096,216,34,8287,64,13056
0.421,6,20,9025,10,121,46,121,649,10,1121,46,1448,8376
1799.044,17,449,39928,404,35,4464,288,25708,45,288,40016,288,14220
238.69,17,6,528,3,60,119344,60,264,3,60,119344,60,264
1783.811,6,354,22440,206,69,8701,69,12380,148,69,12134,69,10060
1778.803,1,342,28728,342,56,5216,56,28728,0,0,0,0,0
1588.711,1,8,448,8,28,226958,28,448,0,0,0,0,0
0.742,6,29,9279,15,191,53,633,1939,14,941,55,1368,7340
143.113,17,5,380,5,48,35778,48,380,0,0,0,0,0
1752.34,6,95,7203,63,38,28263,205,4476,32,33,56516,98,2727
295.291,2,6,192,6,8,59058,8,192,0,0,0,0,0
0.063,17,2,258,1,37,0,37,65,1,165,0,165,193
47.236,17,26,2288,13,48,3935,48,988,13,72,3935,72,1300
5.019,17,3,208,2,36,4981,36,128,1,52,0,52,80
280.53,6,31,7472,13,158,23377,267,1317,18,603,16494,2076,6155
4.676,6,39,7269,19,218,259,314,3383,20,513,231,1179,3886
1797.28,17,448,39896,403,35,4470,288,25676,45,288,40019,288,14220
0.907,17,4,288,2,36,875,36,128,2,52,874,52,160
118.118,17,2,672,2,308,118118,308,672,0,0,0,0,0
16.206,17,22,10628,11,470,1616,1350,5478,11,440,1616,1350,5150
21.988,6,9,527,5,43,5497,43,311,4,0,7294,0,216
1782.66,6,356,22520,208,69,8611,69,12460,148,69,12126,69,10060
21.022,17,2,84,2,14,21022,14,84,0,0,0,0,0
17.931,17,44,19964,22,587,853,1350,13534,22,264,852,1350,6430
377.986,2,3,96,3,8,188993,8,96,0,0,0,0,0
0.49,6,123,87468,56,131,8,232,2769,67,1322,7,1430,84699
478.988,1,28,1568,28,28,17740,28,1568,0,0,0,0,0
125.225,17,4,406,2,43,125213,43,142,2,104,125210,104,264
5.122,6,38,7229,19,218,284,314,3383,19,513,269,1179,3846
7.74,6,980,864750,580,1412,13,1448,839262,400,776,18,1448,25488
0.05,17,4,336,2,34,1,34,124,2,78,3,84,212
282.256,6,27,7312,12,158,25659,267,1277,15,678,20136,2800,6035
1778.108,1,116,6496,116,28,15461,28,6496,0,0,0,0,0
378.489,6,16,1138,12,180,34408,180,812,4,110,20061,110,326
316.555,1,10,560,10,28,35172,28,560,0,0,0,0,0
1680.537,17,12,498,11,14,168053,14,462,1,8,0,8,36
1749.705,6,170,10205,87,43,20345,208,5955,83,31,21334,31,4250
0.002,17,2,548,2,246,2,246,548,0,0,0,0,0
1.036,6,11,1102,6,146,206,146,390,5,508,257,508,712
97.086,6,39,12197,20,633,5109,1360,4647,19,564,5384,1360,7550
163.576,6,120,88716,74,1281,2240,1448,78207,46,675,1872,1448,10509
0.238,6,5,248,3,0,0,0,156,2,0,238,0,92
0.016,17,2,558,1,41,0,41,69,1,461,0,461,489
868.591,6,175,11071,101,69,8685,69,6110,74,69,11898,69,4961
0.05,6,9,1339,5,145,12,145,349,4,826,13,826,990
3.111,6,33,9233,20,250,163,591,1805,13,863,243,1380,7428
1772.505,6,180,15480,120,69,14895,69,8940,60,69,30034,69,6540
4.188,17,5,290,5,30,1047,30,290,0,0,0,0,0
1798.03,17,449,39928,404,35,4461,288,25708,45,288,40020,288,14220
0.512,6,22,7345,13,334,42,663,2021,9,1209,57,1946,5324
1772.662,6,181,15589,120,69,14896,69,8940,61,69,29541,69,6649
237.096,17,10,4520,10,424,26344,548,4520,0,0,0,0,0
1764.333,2,15,480,15,8,126023,8,480,0,0,0,0,0
0.249,17,3,451,2,39,58,39,134,1,289,0,289,317
0.07,17,2,251,1,36,0,36,64,1,159,0,159,187
118.543,6,25,9968,12,549,67,1440,2709,13,961,9867,1440,7259
8.094,17,4,240,2,32,8094,32,120,2,32,8093,32,120
9.991,17,4,808,2,40,9981,40,136,2,308,9980,316,672
64.286,6,21,5386,9,133,27,159,887,12,966,5839,1708,4499
1795.36,17,448,39896,403,35,4466,288,25676,45,288,40015,288,14220
1741.004,6,87,6322,58,31,30543,31,3915,29,31,62176,31,2407
173.184,17,4,352,2,60,173183,60,176,2,60,173183,60,176
111.676,6,21,10120,11,433,87,990,1771,10,1322,12392,2568,8349
8.262,6,1722,1614870,1085,1410,7,1440,1577082,637,776,12,1440,37788
0.299,6,2,149,1,0,0,0,40,1,69,0,69,109
47.513,17,60,15540,60,231,805,388,15540,0,0,0,0,0
0.034,6,10,2047,6,740,6,1323,1724,4,159,9,159,323
178.141,2,2,64,2,8,178141,8,64,0,0,0,0,0
1787.472,6,102,8364,68,66,26678,66,4964,34,60,54162,60,3400
1.437,6,51,21411,28,970,53,1460,15715,23,433,56,1460,5696
138.882,6,12,858,12,26,12625,26,858,0,0,0,0,0
171.603,6,20,10080,11,433,76,990,1771,9,1587,21434,3928,8309
36.977,17,4,240,2,32,36976,32,120,2,32,36976,32,120
146.025,17,4,240,2,32,146024,32,120,2,32,146024,32,120
0.904,6,11,1727,7,100,150,100,384,4,589,217,1152,1343
1798.286,17,449,39928,404,35,4462,288,25708,45,288,40021,288,14220
1745.237,6,95,7203,62,38,28610,205,4424,33,33,54531,98,2779
240.371,6,47,9305,24,197,10449,751,2673,23,493,10923,2382,6632
1763.859,17,296,48542,296,135,5979,366,48542,0,0,0,0,0
5.008,17,4,288,2,36,5007,36,128,2,52,5007,52,160
15.232,6,18,6529,5,189,3808,189,409,13,558,1207,2720,6120
1.477,6,37,9808,20,502,77,1460,4352,17,476,78,2615,5456
0.597,6,21,5000,11,137,59,267,1132,10,692,53,1467,3868
1770.299,17,418,113276,418,242,4245,422,113276,0,0,0,0,0
285.08,6,19,1405,10,330,31674,330,858,9,83,35633,83,547
191.68,6,9,416,2,0,191669,0,88,7,0,31944,0,328
4.0,17,6,462,3,33,1999,33,183,3,65,1999,65,279
7.885,17,6,456,6,48,1577,48,456,0,0,0,0,0
0.123,6,2,92,1,0,0,0,52,1,0,0,0,40
315.973,6,53,12584,23,222,14362,1049,3399,30,362,10890,1360,9185
59.594,17,4,240,2,32,59593,32,120,2,32,59593,32,120
1798.589,6,127,8051,72,47,25332,208,4890,55,31,33302,31,3161
0.031,6,10,1677,6,555,5,951,1354,4,159,9,159,323
317.03,6,77,19702,39,325,8342,1360,10063,38,337,8564,1360,9639
122.412,6,42,13764,21,633,6120,1360,4723,21,584,6109,1360,9041
1745.914,6,95,7203,63,38,28159,205,4476,32,33,56309,98,2727
26.258,6,17,1946,8,198,3751,722,1396,9,27,3254,45,550
36.029,1,40,4160,0,0,0,0,0,40,76,923,76,4160
840.641,17,8,2196,4,30,280212,30,232,4,463,280212,463,1964
1771.138,6,114,7438,67,50,26835,208,4535,47,31,38497,31,2903
9.549,6,2,123,1,0,0,0,40,1,31,0,31,83
1784.593,17,224,63814,224,256,8002,422,63814,0,0,0,0,0
0.185,17,2,158,1,34,0,34,62,1,68,0,68,96
10.848,6,1702,1496236,1060,1361,10,1380,1464391,642,511,16,1923,31845
0.081,6,9,1344,5,145,20,145,349,4,831,23,831,995
2.935,17,2,386,1,46,0,46,74,1,284,0,284,312
1783.814,6,366,23196,211,69,8494,69,12787,155,69,11583,69,10409
1.855,17,23,6074,10,293,202,1350,3217,13,191,151,1350,2857
876.021,17,125,9500,125,48,7064,48,9500,0,0,0,0,0
7.75,17,6,528,3,48,3863,48,228,3,72,3868,72,300
0.116,17,2,138,1,33,0,33,61,1,49,0,49,77
794.023,17,10,821,5,31,198498,37,297,5,76,198498,136,524
1772.099,6,181,15589,120,69,14891,69,8940,61,69,29533,69,6649
244.082,6,37,9399,14,245,31,771,1963,23,415,11094,1438,7436
214.691,6,72,13147,31,279,7156,1189,5154,41,288,5367,1420,7993
280.56,6,31,7813,14,158,21581,267,1357,17,577,17532,2036,6456
1.779,17,3,174,3,30,889,30,174,0,0,0,0,0
254.682,6,404,413830,102,401,2521,1418,10762,302,1368,846,1418,403068
0.733,6,149,95306,77,1288,9,1420,88123,72,475,10,1883,7183
894.988,1,12,672,12,28,81362,28,672,0,0,0,0,0
94.707,2,6,192,6,8,18941,8,192,0,0,0,0,0
1744.604,2,23,736,23,8,79300,8,736,0,0,0,0,0
1121.012,17,12,969,6,31,224195,37,355,6,74,224196,136,614
1794.001,1,253,14168,253,28,7119,28,14168,0,0,0,0,0
128.853,6,24,6896,6,154,25770,267,712,18,419,7565,1420,6184
299.314,1,4,326,4,53,99771,78,326,0,0,0,0,0
188.153,6,116,88071,74,1274,2577,1448,77773,42,675,2646,1448,10298
291.984,6,34,7026,16,262,19462,517,1628,18,744,17172,1418,5398
1797.188,17,448,39612,404,35,4459,288,25708,44,288,40941,288,13904
1757.125,6,105,6270,60,27,29779,27,3525,45,27,39932,27,2745
1.637,17,3,468,3,128,818,128,468,0,0,0,0,0
6.418,6,1260,1123086,770,1379,8,1408,1092942,490,931,12,2816,30144
0.054,17,2,288,1,59,0,59,87,1,173,0,173,201
0.286,17,2,572,1,39,0,39,67,1,477,0,477,505
25.813,6,44,13700,21,300,1290,722,3244,23,794,1163,2760,10456
1679.451,1,15,840,15,28,119960,28,840,0,0,0,0,0
2.844,6,27,8825,16,281,189,577,1489,11,984,265,1452,7336
205.177,6,26,7091,11,150,317,174,744,15,441,14649,1420,6347
1794.05,6,400,28312,204,98,8837,469,14852,196,54,9200,69,13460
0.094,6,11,1420,7,145,15,145,429,4,827,25,827,991
1.378,17,3,196,2,32,954,32,120,1,48,0,48,76
1792.764,1,342,28728,342,56,5257,56,28728,0,0,0,0,0
1791.522,1,290,30740,290,78,6199,78,30740,0,0,0,0,0
2.916,6,2,88,2,0,0,0,88,0,0,0,0,0
1.0,6,24,6208,13,264,82,662,1848,11,783,99,1420,4360
296.293,17,4,240,2,32,296291,32,120,2,32,296292,32,120
281.494,17,4,240,2,32,281493,32,120,2,32,281493,32,120
0.836,6,26,9103,13,282,69,769,1814,13,1100,60,2736,7289
16.711,6,2665,2581867,1777,1378,9,1408,2531003,888,931,18,2816,50864
28.807,6,20,4317,13,213,2400,597,1781,7,543,4719,1408,2536
94.704,6,53,13670,28,926,336,1360,7730,25,328,3938,2667,5940
70.201,6,39,8604,15,141,4848,267,1599,24,401,3051,1452,7005
1795.134,17,80,3354,79,14,23014,14,3318,1,8,0,8,36
0.461,6,13,1693,6,288,92,288,548,7,426,41,434,1145
350.355,6,50,6563,27,109,13465,721,2723,23,176,15916,1448,3840
0.69,17,2,136,1,32,0,32,60,1,48,0,48,76
22.648,6,28,7041,9,154,22,267,832,19,388,1257,1420,6209
0.235,17,4,284,2,32,229,32,120,2,54,228,60,164
0.249,6,26,8712,14,158,19,267,1357,12,981,19,4836,7355
1784.331,2,52,2592,52,25,34986,32,2592,0,0,0,0,0
1796.318,17,179,13962,179,50,10091,50,13962,0,0,0,0,0
240.209,6,42,9085,20,138,12642,345,1905,22,602,11438,2799,7180
4.961,6,40,7309,21,218,248,314,3463,19,440,262,1152,3846
227.436,17,4,240,2,32,227435,32,120,2,32,227435,32,120
192.26,1,8,448,8,28,27465,28,448,0,0,0,0,0
1.48,6,36,8172,19,320,82,1162,2716,17,529,80,4075,5456
136.445,6,22,9783,12,410,53,922,1742,10,1271,15146,4416,8041
0.136,17,2,227,1,44,0,44,72,1,127,0,127,155
125.003,17,4,352,2,60,125002,60,176,2,60,125002,60,176
1.46,6,31,13573,19,765,81,1360,6162,12,864,117,3921,7411
11.027,6,18,4266,10,275,1225,275,958,8,992,892,1440,3308
0.036,17,2,603,1,40,0,40,68,1,507,0,507,535
31.006,17,5,3575,5,687,7751,687,3575,0,0,0,0,0
3.983,17,8,1248,4,64,1325,64,368,4,192,1324,192,880
10.972,6,18,5610,10,275,1219,275,958,8,1440,849,1440,4652
0.345,17,12,4365,12,335,31,358,4365,0,0,0,0,0
280.28,6,29,7392,13,158,23356,267,1317,16,603,18682,2036,6075
1795.493,17,81,3390,79,14,23017,14,3318,2,8,1795331,8,72
376.091,1,20,2120,20,78,19794,78,2120,0,0,0,0,0
77.466,6,17,3305,6,92,15493,92,400,11,1164,7729,1408,2905
1787.907,6,388,27304,220,102,8163,469,16168,168,69,10706,69,11136
0.166,6,27,7296,14,155,12,267,1341,13,603,13,2800,5955
0.715,6,14,1745,7,288,82,288,600,7,426,83,434,1145
0.083,17,4,857,2,45,0,45,146,2,327,4,339,711
0.252,6,3,128,2,0,252,0,84,1,0,0,0,44
437.87,1,4,224,4,28,145956,28,224,0,0,0,0,0
0.403,6,10,968,5,256,95,256,460,5,304,96,304,508
25.383,17,4,240,2,32,25382,32,120,2,32,25382,32,120
180.456,2,2,64,2,8,180456,8,64,0,0,0,0,0
0.93,6,180,206996,87,226,10,255,6440,93,2199,9,8412,200556
1.25,6,48,19611,27,920,48,1360,13995,21,476,54,2720,5616
0.08,17,4,284,2,32,2,32,120,2,54,1,60,164
255.155,6,24,5644,13,234,21262,517,1394,11,730,25514,1550,4250
0.221,6,18,5835,10,134,24,134,590,8,1637,31,1993,5245
1787.486,6,104,8240,68,63,26678,63,4862,36,57,51068,57,3378
4.173,6,39,7269,19,218,231,314,3383,20,513,206,1179,3886
66.851,6,1810,1600022,1106,1363,60,1368,1554804,704,899,94,1473,45218
1798.472,17,138,11040,69,48,26447,48,5244,69,56,26448,56,5796
1781.639,6,354,22440,207,69,8648,69,12420,147,69,12202,69,10020
4.205,17,5,290,5,30,1051,30,290,0,0,0,0,0
25.4,6,7,304,2,0,25400,0,84,5,0,3860,0,220
601.549,2,6,192,6,8,120309,8,192,0,0,0,0,0
1772.46,6,180,15480,120,69,14894,69,8940,60,69,30033,69,6540
377.231,6,18,1242,14,180,29017,180,916,4,110,20066,110,326
1773.995,6,183,15738,121,69,14783,69,8980,62,69,29080,69,6758
1756.608,6,184,11305,92,47,19303,208,6695,92,31,19300,31,4610
189.84,17,316,121032,139,452,1375,1350,66730,177,278,1064,1350,54302
1.321,6,51,21935,29,941,47,1360,16279,22,433,54,1360,5656
2.81,6,52,13890,25,551,117,1429,4892,27,416,100,1460,8998
1.708,6,13,2311,8,188,244,245,700,5,1407,361,1407,1611
882.504,17,43,1806,43,14,21012,14,1806,0,0,0,0,0
66.738,6,47,13593,19,431,210,1189,6375,28,380,2470,3377,7218
2.204,6,20,3833,11,234,220,564,1504,9,463,252,1343,2329
1.517,6,26,8521,15,175,108,362,1666,11,896,110,1408,6855
0.191,6,27,7296,13,155,15,267,1301,14,543,14,1400,5995
7.785,6,47,16530,27,544,299,915,5481,20,682,382,2629,11049
1786.552,6,105,8484,68,66,26664,66,4964,37,60,49624,60,3520
609.335,17,22,8657,22,365,29015,373,8657,0,0,0,0,0
0.01,6,11,3287,6,81,1,81,401,5,872,2,1448,2886
0.017,17,2,481,1,48,0,48,76,1,377,0,377,405
2.546,17,2,196,1,46,0,46,74,1,94,0,94,122
94.76,6,33,5209,20,180,4987,722,2130,13,399,1267,1408,3079
0.014,17,2,435,1,44,0,44,72,1,335,0,335,363
721.95,2,6,192,6,8,144390,8,192,0,0,0,0,0
0.196,17,2,290,1,40,0,40,68,1,194,0,194,222
0.862,6,20,5984,11,282,86,548,1292,9,721,96,1452,4692
1710.279,1,79,4424,79,28,21926,28,4424,0,0,0,0,0
1.276,6,16,6056,9,70,157,133,504,7,1756,211,2828,5552
1796.553,6,398,26890,217,99,8317,469,15165,181,48,9980,69,11725
280.228,6,29,7392,13,158,23352,267,1317,16,603,18679,1400,6075
4.0,17,8,616,4,33,1332,33,244,4,65,1333,65,372
1.412,6,227,162542,121,1366,11,1432,153810,106,389,12,1432,8732
0.639,6,10,924,5,283,110,283,551,5,105,105,105,373
75.66,6,34,7733,13,155,27,267,1306,21,348,3782,1420,6427
0.133,17,3,1167,3,361,66,361,1167,0,0,0,0,0
5.001,17,4,288,2,36,5000,36,128,2,52,5000,52,160
1558.441,1,7,392,7,28,259740,28,392,0,0,0,0,0
9.315,6,4,367,0,0,0,0,0,4,69,3105,69,367
1785.86,6,363,22938,210,69,8544,69,12678,153,69,11749,69,10260
10.866,6,3,260,0,0,0,0,0,3,92,5433,92,260
0.956,6,10,1687,7,100,159,100,384,3,1179,357,1179,1303
1781.763,6,374,26275,214,99,8365,469,15114,160,69,11206,69,11161
1773.034,6,181,15589,120,69,14899,69,8940,61,69,29547,69,6649
316.89,6,84,19701,38,329,8564,1360,9788,46,260,6899,1929,9913
17.736,6,6,328,4,0,5912,0,216,2,0,17727,0,112
15.754,17,17,11331,10,901,1747,1350,9290,7,263,2620,1350,2041
91.464,6,15,2234,9,323,11433,582,1122,6,396,18280,580,1112
259.785,6,38,9507,18,290,15281,517,1553,20,982,13274,1418,7954
1773.392,6,180,15480,120,69,14902,69,8940,60,69,30051,69,6540
38.244,17,11,4028,11,338,3824,360,4028,0,0,0,0,0
1785.93,1,268,15008,268,28,6688,28,15008,0,0,0,0,0
1.95,17,6,1674,3,32,972,32,180,3,470,972,470,1494
1743.024,6,103,7755,66,38,26815,205,4663,37,33,48410,98,3092
31.352,6,8,348,2,0,27,0,84,6,0,6266,0,264
1771.486,6,104,9716,68,66,26440,66,5792,36,60,50611,60,3924
0.853,17,4,368,2,32,833,32,120,2,96,837,96,248
378.047,2,3,96,3,8,189023,8,96,0,0,0,0,0
240.288,6,43,8710,21,519,12014,1402,5775,22,198,11442,618,2935
10.22,17,49,21679,17,617,638,1350,10967,32,306,328,1350,10712
0.387,6,21,7203,13,318,32,600,1958,8,964,53,1471,5245
138.612,6,18,4731,6,272,1655,516,1060,12,353,12585,1452,3671
107.242,6,17,4145,8,307,15320,722,1345,9,1164,7805,1448,2800
0.378,6,14,1733,7,288,62,288,588,7,284,35,434,1145
0.065,17,6,552,3,32,5,32,180,3,96,5,96,372
379.723,6,24,1575,15,177,27123,177,989,9,110,10080,110,586
1788.498,6,380,35065,208,75,8640,267,13453,172,184,10457,1926,21612
141.536,6,25,10208,12,549,71,1360,2709,13,995,11781,1360,7499
0.762,6,23,7564,12,825,69,1360,6287,11,206,59,417,1277
211.459,17,4,240,2,32,211458,32,120,2,32,211458,32,120
1780.436,6,353,22400,206,69,8685,69,12380,147,69,12194,69,10020
1799.602,6,364,25130,211,94,8569,469,14456,153,69,11837,69,10674
1772.349,6,180,15480,120,69,14893,69,8940,60,69,30036,69,6540
0.009,17,2,232,1,35,0,35,63,1,141,0,141,169
0.048,17,2,180,1,30,0,30,58,1,94,0,94,122
3.382,17,5,290,5,30,845,30,290,0,0,0,0,0
15.935,17,18,12806,11,933,1577,1350,10573,7,291,2641,1350,2233
1.405,6,44,10157,23,440,63,1360,4496,21,400,60,1360,5661
366.272,6,27,1767,18,177,21545,177,1181,9,110,8644,110,586
240.219,6,52,17713,27,795,9238,1402,14934,25,183,10008,580,2779
232.402,6,57,10023,25,117,9683,267,2535,32,258,7495,1452,7488
184.413,17,3,228,3,48,92206,48,228,0,0,0,0,0
756.987,2,6,192,6,8,151397,8,192,0,0,0,0,0
1771.47,1,58,4872,58,56,31078,56,4872,0,0,0,0,0
1782.424,6,111,8957,69,65,26212,65,5035,42,59,43470,59,3922
330.003,6,46,3410,18,64,17649,330,1629,28,47,12222,78,1781
67.759,6,21,9222,11,514,93,1237,2015,10,1359,7508,3639,7207
2.664,6,20,7253,10,357,296,721,1475,10,895,273,2840,5778
0.279,17,2,167,1,39,0,39,67,1,72,0,72,100
44.918,6,6,240,0,0,0,0,0,6,0,0,0,240
0.461,6,197,168538,118,183,3,230,6897,79,2045,4,5632,161641
0.156,6,11,1711,6,98,31,98,358,5,1149,33,1149,1353
3.784,17,5,295,5,31,946,31,295,0,0,0,0,0
0.032,17,6,1476,3,64,14,64,276,3,372,12,372,1200
0.18,6,41,16516,23,966,8,1420,11575,18,420,10,1420,4941
1.469,6,47,17803,26,855,58,1460,12187,21,433,63,1460,5616
1786.125,6,102,8364,68,66,26658,66,4964,34,60,54121,60,3400
7.759,1,12,1248,0,0,0,0,0,12,76,705,76,1248
1.192,6,10,1687,7,100,198,100,384,3,1179,461,1179,1303
162.524,6,23,9653,12,386,61,844,1672,11,1254,16240,2720,7981
1745.569,1,61,5124,61,56,29092,56,5124,0,0,0,0,0
1781.761,6,365,24963,212,94,8444,469,14496,153,69,11722,69,10467
1797.282,17,447,39580,403,35,4470,288,25676,44,288,40947,288,13904
0.548,6,22,7333,13,334,45,663,2021,9,1209,62,1946,5312
3.588,6,26,8153,12,330,322,517,1966,14,778,272,1418,6187
2.147,6,13,2311,8,188,306,245,700,5,1407,472,1407,1611
1741.405,17,29,30624,29,1028,62193,1028,30624,0,0,0,0,0
1799.859,17,423,154570,423,337,4265,438,154570,0,0,0,0,0
1783.818,6,416,24920,208,69,8617,69,12460,208,34,8617,48,12460
0.112,6,9,468,0,0,0,0,0,9,0,0,0,468
21.887,6,14,2716,6,841,4373,1460,1926,8,231,3123,231,790
1.357,6,24,8004,12,164,104,267,1288,12,1014,106,2491,6716
1658.163,1,7,392,7,28,276360,28,392,0,0,0,0,0
6.615,6,41,7349,21,218,330,314,3463,20,513,332,1179,3886
35.331,6,45,9974,23,289,1605,721,3537,22,616,1633,1414,6437
0.308,6,26,9060,13,271,25,726,1771,13,1100,23,2816,7289
1776.096,1,58,4872,58,56,31159,56,4872,0,0,0,0,0
1786.501,6,104,8444,68,66,26664,66,4964,36,60,51040,60,3480
43.642,1,4,224,4,28,14547,28,224,0,0,0,0,0
280.029,6,27,7312,12,158,25457,267,1277,15,678,20000,2045,6035
0.307,6,21,5000,10,137,34,267,1092,11,692,27,1467,3908
0.509,6,10,968,5,256,113,256,460,5,304,115,304,508
82.994,6,31,7018,15,171,5924,517,1658,16,564,5529,1408,5360
1787.608,6,102,8296,68,65,26680,65,4930,34,59,54166,59,3366
1797.282,17,449,39928,404,35,4459,288,25708,45,288,40016,288,14220
1795.116,17,80,3354,79,14,23014,14,3318,1,8,0,8,36
0.01,17,2,394,1,37,0,37,65,1,301,0,301,329
10.188,6,87,26517,43,562,242,1152,20275,44,407,231,1152,6242
11.723,6,1868,1618848,1142,1363,10,1380,1585566,726,421,16,1923,33282
0.505,6,29,7638,15,164,36,453,1634,14,750,35,1542,6004
1.093,6,214,148350,114,1315,9,1420,140035,100,427,10,1420,8315
66.09,6,32,8952,14,158,5083,267,1357,18,624,3885,1400,7595
1777.02,1,255,14280,255,28,6996,28,14280,0,0,0,0,0
1751.125,17,168,34090,168,174,10485,422,34090,0,0,0,0,0
4.006,6,4,284,3,124,2003,124,244,1,0,0,0,40
5.034,17,4,288,2,36,5004,36,128,2,52,5003,52,160
5.046,17,4,288,2,36,5003,36,128,2,52,5015,52,160
1.2,6,20,1661,11,71,120,71,829,9,83,145,83,832
48.374,6,27,7177,13,155,4031,267,1306,14,530,3720,3417,5871
0.007,17,2,367,1,33,0,33,61,1,278,0,278,306
1770.793,6,102,9406,67,64,26830,64,5660,35,58,52079,58,3746
5.89,6,41,7349,20,218,310,314,3423,21,440,281,1152,3926
0.006,17,4,248,2,34,4,34,124,2,34,5,34,124
6.316,17,4,304,3,48,3049,48,228,1,48,0,48,76
16.197,17,4,824,2,48,16183,48,152,2,308,16183,308,672
1426.384,1,96,10176,96,78,15014,78,10176,0,0,0,0,0
0.726,6,24,7543,14,273,55,663,2116,10,979,76,1906,5427
5.754,6,2060,2107738,666,203,8,230,41554,1394,1433,4,2880,2066184
1774.156,17,134,10720,67,48,26881,48,5092,67,56,26881,56,5628
38.681,17,11,836,11,48,3868,48,836,0,0,0,0,0
1787.395,6,103,8268,68,64,26677,64,4896,35,58,52566,58,3372
0.049,17,2,154,1,33,0,33,61,1,65,0,65,93
16.616,6,2387,2162943,1496,1366,10,1408,2111935,891,931,18,2816,51008
11.387,6,1517,1263119,844,1405,13,1448,1217687,673,776,16,1448,45432
1761.314,6,126,7713,69,27,25901,27,4131,57,27,31451,27,3582
277.643,1,6,336,6,28,55528,28,336,0,0,0,0,0
1133.996,2,8,256,8,8,161999,8,256,0,0,0,0,0
1750.031,17,12,498,11,14,175003,14,462,1,8,0,8,36
0.132,17,2,214,1,39,0,39,67,1,119,0,119,147
20.352,6,24,5827,14,107,1565,159,1190,10,821,2255,1659,4637
71.277,17,4,352,2,60,71276,60,176,2,60,71276,60,176
2.354,6,8,1607,5,100,588,100,304,3,1179,1045,1179,1303
1.143,6,24,9218,14,349,87,1040,1991,10,1135,101,2370,7227
0.011,17,2,409,1,46,0,46,74,1,307,0,307,335
251.472,2,2,64,2,8,251472,8,64,0,0,0,0,0
4.952,17,4,352,2,60,4946,60,176,2,60,4951,60,176
0.506,17,3,451,2,39,154,39,134,1,289,0,289,317
1785.199,1,184,10304,184,28,9755,28,10304,0,0,0,0,0
1.497,6,21,8039,12,245,136,517,1602,9,1490,186,5632,6437
300.742,6,86,67723,55,1311,5569,1448,60570,31,790,1152,1448,7153
254.337,17,4,352,2,60,254336,60,176,2,60,254336,60,176
0.482,6,19,5832,11,275,47,517,1681,8,931,67,1906,4151
1.588,6,44,14809,24,749,69,1360,9233,20,433,72,1360,5576
240.185,6,53,17473,28,772,8895,1402,14603,25,195,10007,580,2870
1786.409,6,102,8364,68,66,26662,66,4964,34,60,54130,60,3400
862.96,6,11,657,8,31,123280,31,444,3,31,299773,31,213
113.452,6,51,15761,26,971,388,1360,9866,25,325,4719,1360,5895
21.284,17,4,352,2,60,21283,60,176,2,60,21282,60,176
61.171,6,46,10056,22,631,754,1360,4139,24,309,2652,2720,5917
0.0,17,1,76,0,0,0,0,0,1,48,0,48,76
15.884,6,1304,1184932,781,1435,19,1448,1151652,523,776,29,1448,33280
0.072,17,2,168,1,48,0,48,76,1,64,0,64,92
1785.717,6,358,52621,139,149,12939,1440,20546,219,186,8190,1440,32075
280.309,6,29,7392,13,158,23359,267,1317,16,603,18682,1400,6075
1.353,6,10,1687,7,100,225,100,384,3,1179,543,1179,1303
1770.224,6,114,10596,72,66,24932,66,6156,42,60,43173,60,4440
1744.759,2,27,864,27,8,67106,8,864,0,0,0,0,0
29.051,17,9,684,9,48,3631,48,684,0,0,0,0,0
36.62,17,3,228,3,48,18310,48,228,0,0,0,0,0
1679.897,1,15,840,15,28,119992,28,840,0,0,0,0,0
6.759,17,35,8662,10,291,750,1350,3199,25,190,280,1350,5463
0.057,17,2,1358,2,651,57,651,1358,0,0,0,0,0
0.916,17,4,918,2,40,905,40,136,2,363,896,363,782
3.96,17,2,176,2,60,3960,60,176,0,0,0,0,0
280.464,6,28,7352,13,158,23372,267,1317,15,678,20029,2085,6035
242.645,17,4,352,2,60,242644,60,176,2,60,242644,60,176
240.161,6,54,19550,29,848,8577,1408,16782,25,182,10006,580,2768
154.411,6,22,9885,11,380,61,832,1613,11,1117,15428,2568,8272
0.21,6,27,7296,13,155,17,267,1301,14,603,13,2036,5995
14.58,6,898,822609,598,1307,24,1368,802345,300,776,48,1473,20264
2.966,17,3,468,3,128,1483,128,468,0,0,0,0,0
18.825,6,24,4103,13,211,1568,211,1353,11,545,1882,904,2750
221.615,6,27,5435,9,201,7140,516,1371,18,238,13031,1452,4064
1790.193,1,79,6636,0,0,0,0,0,79,56,22951,56,6636
1.559,17,29,7109,12,254,139,1350,3386,17,191,95,1350,3723
1.629,6,13,2311,8,188,232,245,700,5,1407,346,1407,1611
1740.475,17,30,31620,30,1026,60016,1026,31620,0,0,0,0,0
64.089,6,26,7143,12,156,5826,267,1272,14,530,4929,2006,5871
15.976,17,22,12382,12,821,1448,1350,10199,10,190,1770,1350,2183
45.109,6,55,13762,27,782,616,1360,7456,28,287,1664,2667,6306
159.439,6,213,174571,138,1304,1163,1408,159773,75,680,2151,3847,14798
0.551,6,50,21664,28,961,20,1380,16542,22,421,23,1923,5122
573.608,17,114,8664,114,48,5076,48,8664,0,0,0,0,0
1.521,6,42,11418,22,547,72,1360,5842,20,433,69,1360,5576
0.03,6,2,92,1,0,0,0,52,1,0,0,0,40
104.771,6,23,10829,12,380,77,832,1665,11,1244,10464,2720,9164
240.414,6,42,8825,21,521,12019,1418,5792,21,214,12019,618,3033
1.659,6,12,1163,6,222,328,222,688,6,231,327,231,475
0.089,17,2,130,1,29,0,29,57,1,45,0,45,73
420.011,17,4,1344,4,308,140003,308,1344,0,0,0,0,0
1638.658,2,10,320,10,8,182073,8,320,0,0,0,0,0
1672.438,1,7,392,7,28,278739,28,392,0,0,0,0,0
64.195,17,6,4495,6,721,12839,1238,4495,0,0,0,0,0
10.757,6,18,4226,10,275,1195,275,958,8,978,862,1420,3268
1787.554,17,87,3648,86,14,21030,14,3612,1,8,0,8,36
680.657,17,11,3688,11,307,68065,308,3688,0,0,0,0,0
85.582,6,25,10113,12,531,56,1360,2661,13,988,7121,1360,7452
1772.496,6,180,15480,120,69,14894,69,8940,60,69,30036,69,6540
428.945,6,70,35811,28,595,15880,1024,8915,42,788,10457,1460,26896
358.086,6,22,1756,14,226,27545,226,994,8,110,8787,110,762
1787.912,6,359,25054,209,100,8595,469,14707,150,69,11999,69,10347
16.76,6,20,6866,8,154,2394,267,792,12,698,1500,1942,6074
0.625,6,10,924,5,283,104,283,551,5,105,107,105,373
18.081,1,12,1248,0,0,0,0,0,12,76,1643,76,1248
0.292,17,8,2758,8,316,41,355,2758,0,0,0,0,0
5.684,6,40,7325,21,218,284,314,3463,19,516,301,1179,3862
240.169,6,53,17252,28,756,8895,1408,14325,25,202,10006,580,2927
1799.98,1,50,6125,50,94,36734,351,6125,0,0,0,0,0
1791.265,17,114,9120,57,48,31986,48,4332,57,56,31986,56,4788
240.205,6,44,8279,22,456,11438,1408,4818,22,230,11438,646,3461
1763.92,6,137,13425,82,67,21776,722,6900,55,83,32656,1448,6525
1773.574,6,182,15629,121,69,14779,69,8980,61,69,29551,69,6649
1783.437,6,153,14202,89,58,20266,722,7087,64,78,28305,1448,7115
1790.063,17,409,56003,187,198,9621,1350,42297,222,33,8099,61,13706
0.89,6,29,8610,15,229,54,583,2031,14,858,55,1360,6579
0.346,6,3,156,2,0,345,0,104,1,0,0,0,52
660.977,6,107,22154,52,276,12960,1360,11007,55,255,12237,1360,11147
1785.646,17,756,45584,756,32,2365,37,45584,0,0,0,0,0
0.64,17,2,703,2,323,640,354,703,0,0,0,0,0
4.175,6,10,1102,6,483,835,483,803,4,83,1373,83,299
0.898,6,32,14567,18,600,52,1360,3153,14,1084,56,1696,11414
280.865,17,4,352,2,60,280864,60,176,2,60,280864,60,176
60.532,17,4,240,2,32,60531,32,120,2,32,60531,32,120
1789.096,6,356,22520,208,69,8642,69,12460,148,69,12168,69,10060
3.883,17,5,290,5,30,970,30,290,0,0,0,0,0
1799.915,17,283,62949,283,194,6382,422,62949,0,0,0,0,0
280.2,6,30,7432,14,158,21553,267,1357,16,603,18679,2800,6075
6.595,6,23,4490,12,213,599,597,1689,11,552,639,1767,2801
0.009,6,2,80,2,0,0,0,80,0,0,0,0,0
70.942,1,6,336,6,28,14188,28,336,0,0,0,0,0
166.536,6,21,8544,11,556,99,1329,2140,10,998,18481,2720,6404
0.24,17,3,234,2,39,218,39,134,1,72,0,72,100
12.384,6,1967,1710646,1189,1384,10,1420,1675305,778,467,15,1883,35341
9.977,6,87,26745,44,552,232,1152,20543,43,407,231,1152,6202
0.891,17,2,134,2,39,891,39,134,0,0,0,0,0
2.709,6,9,2799,6,100,541,100,344,3,1165,637,1179,2455
2.375,6,111,87197,48,131,50,232,2449,63,1417,33,2790,84748
1.711,6,53,20088,30,873,59,1360,14347,23,400,67,1360,5741
300.269,6,49,29737,29,190,10723,444,2369,20,1754,12641,6557,27368
1011.735,6,75,7065,45,93,22990,205,4681,30,31,34881,33,2384
1.029,2,2,64,2,8,1029,8,64,0,0,0,0,0
0.015,17,5,696,3,60,5,60,264,2,188,1,188,432
8.196,6,18,6767,9,275,1024,275,643,9,1150,716,1414,6124
1783.812,6,361,22858,210,69,8534,69,12678,151,69,11892,69,10180
1799.261,1,174,9744,174,28,10400,28,9744,0,0,0,0,0
18.407,17,4,352,2,48,18395,48,152,2,72,18395,72,200
1785.36,17,140,11200,70,48,25874,48,5320,70,56,25874,56,5880
300.567,6,19,1315,8,177,42913,177,637,11,110,30039,110,678
70.989,6,47,10083,23,230,3226,721,3462,24,564,3076,1420,6621
18.193,17,31,6598,13,206,1513,1350,3042,18,169,1068,1350,3556
12.469,6,1934,1714949,1212,1364,10,1380,1681782,722,387,17,1923,33167
5.527,17,4,288,2,36,5485,36,128,2,52,5479,52,160
1785.86,6,364,23047,211,69,8504,69,12718,153,69,11749,69,10329
358.07,6,70,10671,39,304,9422,304,7568,31,83,11929,83,3103
41.421,17,44,6468,22,48,1972,48,1672,22,190,1971,308,4796
21.579,6,114,34569,69,169,317,318,9890,45,544,489,1709,24679
0.703,6,29,7376,14,155,54,267,1341,15,543,49,1400,6035
1795.098,17,142,11360,71,48,25644,48,5396,71,56,25644,56,5964
142.678,1,20,1680,20,56,7509,56,1680,0,0,0,0,0
1740.798,17,30,7050,30,207,60027,207,7050,0,0,0,0,0
15.894,17,27,19585,15,852,1130,1350,13214,12,502,1436,1350,6371
0.179,17,2,204,1,34,0,34,62,1,114,0,114,142
1793.254,17,180,11520,180,36,10018,36,11520,0,0,0,0,0
0.018,17,4,352,2,37,14,37,130,2,83,13,89,222
8.336,6,27,10301,10,124,926,126,692,17,809,503,1360,9609
1074.749,17,211,16036,211,48,5117,48,16036,0,0,0,0,0
0.61,17,4,560,2,64,609,64,184,2,160,483,160,376
0.018,6,10,1239,5,346,4,346,614,5,357,4,357,625
1772.308,6,180,15480,120,69,14893,69,8940,60,69,30031,69,6540
0.524,6,20,7229,12,334,42,663,1969,8,1209,70,1946,5260
31.859,6,6,360,0,0,0,0,0,6,0,0,0,360
93.482,6,42,9823,18,271,5498,1189,2902,24,425,4058,2006,6921
300.187,6,93,15346,48,317,6386,1408,7919,45,211,6822,1408,7427
0.891,6,16,5834,10,290,99,517,1097,6,1469,177,2421,4737
5.352,6,43,8329,21,227,267,314,4022,22,427,242,1152,4307
11.238,6,753,675314,492,1304,22,1368,657078,261,931,42,2736,18236
1786.576,6,102,8364,68,66,26665,66,4964,34,60,54136,60,3400
1773.323,6,180,15480,120,69,14901,69,8940,60,69,30047,69,6540
35.024,17,10,490,9,17,4378,58,406,1,56,0,56,84
0.04,17,2,180,1,30,0,30,58,1,94,0,94,122
0.021,17,3,434,2,60,1,60,176,1,230,0,230,258
300.087,6,50,13208,25,884,12496,1460,7282,25,307,12496,1460,5926
1797.398,6,368,25828,213,99,8478,469,15005,155,69,11668,69,10823
0.859,17,2,152,1,48,0,48,76,1,48,0,48,76
1785.722,17,86,3606,85,14,21258,14,3570,1,8,0,8,36
0.801,6,158,106583,85,1296,9,1420,99360,73,427,10,1420,7223
0.528,6,27,6213,14,181,40,537,1654,13,643,41,1542,4559
0.522,17,3,507,2,39,60,39,134,1,345,0,345,373
1795.962,17,447,39864,402,35,4478,288,25644,45,288,40020,288,14220
0.178,6,44,18339,24,1026,7,1420,13318,20,420,8,1420,5021
0.087,17,2,396,1,39,0,39,67,1,301,0,301,329
694.547,6,163,23170,85,304,8268,304,15796,78,83,9007,83,7374
20.123,6,20,3130,11,183,2012,517,1509,9,381,2514,499,1621
0.12,17,2,170,1,37,0,37,65,1,77,0,77,105
6.281,17,30,18412,17,747,392,1350,13177,13,374,520,1350,5235
1743.566,6,97,7338,64,38,27675,205,4528,33,33,54478,98,2810
0.56,17,15,8459,8,705,80,1350,5871,7,341,84,1350,2588
1.328,6,25,8056,12,164,105,267,1288,13,869,96,1408,6768
133.786,6,25,9968,12,549,71,1440,2709,13,961,11137,1440,7259
0.048,1,2,112,2,28,48,28,112,0,0,0,0,0
12.264,6,1952,1694732,1196,1364,10,1380,1660250,756,468,16,3303,34482
35.742,6,23,7592,13,257,2978,454,1444,10,802,3951,1440,6148
0.128,17,2,1920,2,932,128,932,1920,0,0,0,0,0
61.423,6,13,9156,4,174,20474,174,338,9,1408,5869,1452,8818
0.381,6,12,1653,6,288,72,288,548,6,426,44,434,1105
0.001,17,4,320,4,52,0,52,320,0,0,0,0,0
1781.467,1,67,5628,67,56,26991,56,5628,0,0,0,0,0
6.957,6,524,450380,327,1311,20,1368,435472,197,776,34,2736,14908
3.073,17,4,518,3,39,774,39,201,1,289,0,289,317
10.446,6,30,5669,15,197,746,314,2185,15,480,725,1179,3484
0.123,17,2,517,1,34,0,34,62,1,427,0,427,455
240.973,6,47,5684,24,235,10476,752,2943,23,153,10953,566,2741
1787.914,6,373,24097,208,69,8637,69,12805,165,69,10901,69,11292
4.915,17,2,656,2,300,4915,300,656,0,0,0,0,0
1788.206,6,379,23828,213,69,8434,69,12798,166,58,10837,69,11030
1763.853,2,12,384,12,8,160350,8,384,0,0,0,0,0
1786.152,6,104,8376,68,65,26658,65,4930,36,59,51030,59,3446
0.091,17,2,362,1,46,0,46,74,1,260,0,260,288
23.11,6,22,6956,6,154,4622,267,712,16,466,1524,2840,6244
280.412,6,30,7432,13,158,23367,267,1317,17,543,17518,1400,6115
251.521,17,4,352,2,60,251520,60,176,2,60,251520,60,176
1785.386,17,87,3648,86,14,21004,14,3612,1,8,0,8,36
17.389,17,8,704,4,48,5792,48,304,4,72,5791,72,400
0.196,6,46,21044,26,1068,7,1420,16023,20,467,9,1883,5021
2.379,17,32,18129,15,744,169,1350,11587,17,356,108,1350,6542
4.995,17,4,288,2,36,4994,36,128,2,52,4994,52,160
0.17,17,2,180,1,30,0,30,58,1,94,0,94,122
79.312,17,4,352,2,60,79311,60,176,2,60,79311,60,176
1740.48,17,30,31680,30,1028,60016,1028,31680,0,0,0,0,0
0.003,6,2,535,1,455,0,455,495,1,0,0,0,40
118.686,6,920,466494,524,834,226,1152,444840,396,415,299,1179,21654
1795.876,6,355,22480,207,69,8717,69,12420,148,69,12216,69,10060
1782.617,17,132,10560,66,48,27424,48,5016,66,56,27424,56,5544
9.49,6,50,10218,25,235,395,314,4768,25,444,384,1179,5450
0.657,6,14,1745,7,288,74,288,600,7,426,78,434,1145
127.803,6,8,349,3,0,63901,0,124,5,7,31802,7,225
165.088,6,23,940,9,0,5284,0,364,14,0,12698,0,576
1.344,6,41,10554,21,513,67,1360,4978,20,433,61,1360,5576
1788.488,1,266,14896,266,28,6749,28,14896,0,0,0,0,0
198.091,17,4,288,2,36,198090,36,128,2,52,198090,52,160
0.199,6,19,4920,10,137,22,267,1092,9,866,24,2867,3828
295.339,17,4,240,2,32,295337,32,120,2,32,295338,32,120
8.13,6,2118,1721998,1116,1439,6,1448,1654990,1002,776,7,1448,67008
161.947,6,33,14770,16,488,327,1360,3127,17,995,10112,1360,11643
242.38,6,67,17907,29,725,8656,1418,13848,38,148,6550,580,4059
2.813,6,18,6394,9,150,351,174,664,9,894,321,1452,5730
30.782,17,4,352,2,60,30780,60,176,2,60,30781,60,176
243.742,17,4,352,2,60,243741,60,176,2,60,243741,60,176
1.476,6,25,8245,13,584,123,1012,2438,12,646,117,1303,5807
3.144,6,16,3676,8,150,449,174,624,8,681,388,1452,3052
0.033,17,2,398,1,43,0,43,71,1,299,0,299,327
280.288,6,28,7352,12,158,25480,267,1277,16,603,18684,1400,6075
1741.781,6,87,6322,58,31,30557,31,3915,29,31,62205,31,2407
21.006,6,14,3177,6,92,4201,92,400,8,1164,2962,1448,2777
1742.928,6,97,7307,63,38,28111,205,4476,34,33,52804,98,2831
1789.245,6,361,22858,210,69,8560,69,12678,151,69,11928,69,10180
21.566,6,24,6997,14,275,1658,275,1126,10,910,1176,1440,5871
0.188,6,9,1339,5,145,47,145,349,4,826,47,826,990
7.678,6,25,3169,13,70,639,267,1085,12,400,631,1179,2084
64.999,6,9,372,4,0,4181,0,164,5,0,16245,0,208
129.416,2,3,96,3,8,64708,8,96,0,0,0,0,0
0.245,17,14,7139,6,615,49,1350,3860,8,381,30,1350,3279
1768.955,6,99,9240,66,65,27214,65,5577,33,59,55275,59,3663
240.35,6,45,9303,23,523,10924,1408,5917,22,248,11445,617,3386
3.761,6,8,428,2,0,3658,0,116,6,0,752,0,312
589.003,17,54,13482,54,221,11113,462,13482,0,0,0,0,0
1777.871,6,142,8722,78,42,23089,208,5139,64,31,28215,31,3583
7.866,6,13,3772,5,171,1966,171,439,8,964,1122,1448,3333
1772.504,6,203,22359,130,75,13740,267,10057,73,135,24611,3417,12302
1787.875,17,87,3648,86,14,21033,14,3612,1,8,0,8,36
0.182,17,2,1918,2,931,182,931,1918,0,0,0,0,0
1794.532,17,142,11360,71,48,25636,48,5396,71,56,25636,56,5964
0.392,6,10,967,5,256,96,256,460,5,303,96,303,507
4.035,17,8,736,4,32,1330,32,240,4,96,0,96,496
0.001,6,2,499,1,0,0,0,40,1,419,0,419,459
1.654,6,28,10159,17,275,103,557,1509,11,1025,148,1420,8650
1788.788,6,179,21598,105,125,17199,722,13515,74,67,24499,2026,8083
1770.135,6,210,16274,78,70,22987,315,7766,132,48,13512,78,8508
1799.068,2,27,864,27,8,69194,8,864,0,0,0,0,0
163.53,6,25,9794,12,532,55,1460,2642,13,945,13616,1460,7152
3.968,17,4,352,2,48,3962,48,152,2,72,3959,72,200
1719.542,17,12,498,11,14,171954,14,462,1,8,0,8,36
1495.862,2,13,416,13,8,124655,8,416,0,0,0,0,0
1796.404,1,58,4872,58,56,31515,56,4872,0,0,0,0,0
92.799,6,11,719,11,31,9279,31,719,0,0,0,0,0
0.051,17,2,389,1,34,0,34,62,1,299,0,299,327
372.115,6,18,1242,14,180,28624,180,916,4,110,20061,110,326
0.883,6,11,1727,7,100,147,100,384,4,589,206,1152,1343
1.353,6,11,3287,6,81,270,81,401,5,872,338,1448,2886
1772.192,6,180,15480,120,69,14892,69,8940,60,69,30036,69,6540
1700.68,17,12,498,11,14,170068,14,462,1,8,0,8,36
56.197,6,27,7177,13,155,4683,267,1306,14,530,4322,3417,5871
0.219,17,4,314,2,31,187,31,118,2,70,174,70,196
0.029,6,9,1339,5,145,7,145,349,4,826,7,826,990
294.164,17,4,558,2,36,294156,36,128,2,187,294159,187,430
1.1,6,23,7952,12,164,85,267,1288,11,1216,93,3819,6664
1.234,17,2,136,1,32,0,32,60,1,48,0,48,76
11.406,6,1708,1623526,1069,1440,10,1448,1585610,639,776,17,1448,37916
1767.46,6,147,29736,74,68,24210,517,5026,73,549,24546,2451,24710
1786.59,6,99,8118,66,66,27486,66,4818,33,60,55828,60,3300
537.788,17,44,3520,22,48,25608,48,1672,22,56,25608,56,1848
0.783,6,2,1175,1,0,0,0,40,1,1095,0,1095,1135
1799.735,1,57,4788,0,0,0,0,0,57,56,32138,56,4788
0.013,17,2,205,1,50,0,50,78,1,99,0,99,127
1751.219,17,275,54481,275,170,6391,373,54481,0,0,0,0,0
1682.482,1,15,870,15,30,120177,30,870,0,0,0,0,0
1795.003,17,446,39548,402,35,4476,288,25644,44,288,40952,288,13904
1776.738,6,181,15589,120,69,14930,69,8940,61,69,29606,69,6649
0.529,6,161,140650,95,183,5,230,5677,66,2055,7,5632,134973
1786.607,6,102,8296,68,65,26665,65,4930,34,59,54136,59,3366
1783.915,6,103,8326,68,64,26625,64,4896,35,58,52465,58,3430
1681.51,17,12,498,11,14,168151,14,462,1,8,0,8,36
1791.126,17,144,11520,72,48,25226,48,5472,72,56,25222,56,6048
26.316,6,35,8982,17,303,1644,721,2805,18,681,1536,2840,6177
96.272,6,6,552,4,124,32090,124,448,2,0,1002,0,104
281.103,6,29,7392,13,158,23425,267,1317,16,603,18730,2036,6075
0.204,6,14,5792,7,135,33,135,507,7,1228,33,1448,5285
1.532,6,39,9888,21,440,76,1360,4392,18,433,77,1360,5496
15.025,6,10,2131,7,275,2504,275,563,3,1440,6104,1440,1568
1770.718,6,121,11242,75,66,23928,66,6402,46,60,39347,60,4840
24.04,17,21,13230,10,537,2667,1350,5655,11,660,2400,1350,7575
0.091,6,2,421,1,0,0,0,40,1,341,0,341,381
1700.474,17,12,498,11,14,170047,14,462,1,8,0,8,36
0.475,6,13,1693,7,288,78,288,588,6,426,60,434,1105
0.933,17,4,886,2,40,921,40,136,2,347,922,347,750
10.282,6,84,24917,41,544,257,1152,19056,43,413,238,1152,5861
0.482,17,4,360,2,30,437,30,116,2,94,450,94,244
0.355,6,23,7272,12,257,32,748,1663,11,838,33,1418,5609
143.709,2,3,96,3,8,71854,8,96,0,0,0,0,0
96.553,6,33,8039,10,141,10726,267,1399,23,317,4388,1460,6640
1786.282,6,99,8052,66,65,27481,65,4785,33,59,55818,59,3267
1792.346,1,341,28644,341,56,5271,56,28644,0,0,0,0,0
1.309,6,47,18160,26,882,52,1360,12544,21,476,56,2715,5616
0.088,17,2,193,1,46,0,46,74,1,91,0,91,119
318.48,6,10,562,3,106,159235,106,234,7,0,53077,0,328
1682.656,17,14,1036,7,30,280437,30,406,7,62,280436,62,630
3.142,17,5,556,4,64,1042,64,368,1,160,0,160,188
1.536,6,38,8252,19,320,85,1162,2716,19,433,75,1460,5536
2.688,17,4,1568,4,364,896,364,1568,0,0,0,0,0
280.303,6,28,7352,13,158,23358,267,1317,15,678,20017,2045,6035
1451.027,1,46,2576,46,28,32245,28,2576,0,0,0,0,0
1782.317,17,83,3480,82,14,22003,14,3444,1,8,0,8,36
1780.72,6,268,33346,109,148,16486,1440,16599,159,128,11269,1440,16747
1639.867,1,7,392,7,28,273311,28,392,0,0,0,0,0
280.208,6,28,7352,12,158,25473,267,1277,16,603,18677,1400,6075
1751.47,1,194,20564,194,78,9074,78,20564,0,0,0,0,0
1774.992,6,182,15698,120,69,14915,69,8940,62,69,29091,69,6758
254.357,6,13,5591,4,112,84783,112,280,9,823,31793,1997,5311
0.367,6,12,1653,6,288,73,288,548,6,426,40,434,1105
1785.24,6,356,22520,208,69,8624,69,12460,148,69,12144,69,10060
1.021,17,17,6483,8,480,145,1350,4065,9,240,119,1350,2418
1764.31,2,15,480,15,8,126022,8,480,0,0,0,0,0
0.657,6,14,1745,7,288,76,288,600,7,426,78,434,1145
237.47,17,4,240,2,32,237468,32,120,2,32,237468,32,120
13.878,6,26,5147,17,211,866,211,1597,9,617,1734,904,3550
473.611,2,4,128,4,8,157870,8,128,0,0,0,0,0
110.414,6,22,8564,11,549,82,1309,2120,11,998,11024,1791,6444
72.108,6,30,7504,12,155,6555,267,1266,18,423,4241,2006,6238
0.207,17,4,284,2,32,200,32,120,2,54,200,60,164
1741.573,6,87,6322,58,31,30553,31,3915,29,31,62198,31,2407
133.324,17,3,514,3,143,66662,336,514,0,0,0,0,0
1772.463,17,79,3312,78,14,23019,14,3276,1,8,0,8,36
0.275,17,2,362,1,46,0,46,74,1,260,0,260,288
1793.84,6,205,17566,103,114,17586,208,12370,102,31,17757,31,5196
1773.626,6,180,15480,120,69,14904,69,8940,60,69,30052,69,6540
5.122,6,10,1323,4,222,1707,222,386,6,231,1004,231,937
1693.25,1,8,848,8,78,241892,78,848,0,0,0,0,0
1772.472,6,180,15480,120,69,14894,69,8940,60,69,30038,69,6540
13.734,17,3,1002,3,306,6867,306,1002,0,0,0,0,0
299.525,6,6,364,4,31,99841,31,222,2,31,299512,31,142
1785.146,6,358,22669,209,69,8582,69,12569,149,69,12059,69,10100
0.684,17,6,660,3,78,342,84,320,3,85,225,104,340
0.131,17,2,677,1,300,0,300,328,1,321,0,321,349
1740.421,17,30,6930,30,203,60014,203,6930,0,0,0,0,0
2.634,17,3,1167,3,361,1317,361,1167,0,0,0,0,0
960.846,17,269,51982,125,262,7265,1350,36302,144,80,6718,1350,15680
0.176,6,47,21026,26,1064,7,1420,15965,21,420,8,1420,5061
4.468,17,8,1536,4,39,1315,39,268,4,289,1323,289,1268
1.201,6,28,5811,14,111,92,267,1346,14,780,82,1460,4465
224.622,6,159,51662,81,581,2807,1360,37607,78,321,2915,1360,14055
1786.471,6,102,8364,68,66,26663,66,4964,34,60,54132,60,3400
141.906,6,56,31639,33,1099,4434,1448,23718,23,746,2791,1448,7921
1799.96,6,98,7421,65,38,28124,205,4611,33,33,56240,98,2810
1744.738,2,25,800,25,8,72697,8,800,0,0,0,0,0
0.112,6,9,1346,5,145,28,145,349,4,833,31,833,997
28.59,6,46,13953,22,289,1361,721,3491,24,730,1198,1414,10462
17.941,17,28,8447,14,384,1376,1350,5777,14,162,1376,1350,2670
20.391,6,16,1327,8,222,2911,222,768,8,231,2910,231,559
3.159,17,4,428,2,47,3108,47,150,2,111,3112,111,278
29.12,17,4,352,2,60,29119,60,176,2,60,29119,60,176
111.316,6,27,6494,11,220,5511,516,1326,16,348,7414,1452,5168
0.182,6,9,1339,5,145,45,145,349,4,826,41,826,990
1.305,6,48,20006,28,885,48,1360,14430,20,476,59,2715,5576
10.801,6,16,6159,4,189,3556,189,369,12,756,969,1360,5790
1797.138,6,354,22509,206,69,8766,69,12380,148,69,12225,69,10129
9.301,17,23,10243,11,590,929,1350,6805,12,258,842,1350,3438
1793.739,17,66,2766,65,14,28027,14,2730,1,8,0,8,36
1786.131,6,104,8444,68,66,26658,66,4964,36,60,51029,60,3480
12.084,6,1900,1661805,1151,1388,10,1420,1627624,749,467,16,1883,34181
1682.592,17,18,1413,9,30,210322,37,529,9,70,210322,136,884
85.616,6,44,9871,20,279,1671,1189,3041,24,418,3721,1917,6830
390.093,6,18,1242,14,180,30007,180,916,4,110,20072,110,326
1774.653,6,180,15480,120,69,14913,69,8940,60,69,30077,69,6540
262.96,17,4,240,2,32,262959,32,120,2,32,262959,32,120
1720.634,17,12,498,11,14,172063,14,462,1,8,0,8,36
11.015,6,19,7010,11,275,1101,275,998,8,1893,894,2840,6012
1758.3,6,3891,3641342,1383,148,1272,898,82355,2508,1408,701,2836,3558987
369.528,6,18,1242,14,180,28425,180,916,4,110,20058,110,326
10.445,6,1779,1638162,1095,1416,9,1448,1597918,684,776,15,1448,40244
1759.102,6,155,11542,81,67,21988,208,6222,74,51,24091,224,5320
42.918,17,6,1236,3,48,21454,48,228,3,308,21454,308,1008
1709.049,1,8,848,8,78,244149,78,848,0,0,0,0,0
32.979,17,21,8823,10,529,3663,1350,5576,11,267,3294,1350,3247
1787.458,6,105,8348,68,64,26678,64,4896,37,58,49648,58,3452
0.294,17,2,588,1,39,0,39,67,1,493,0,493,521
53.029,6,76,49704,46,1182,1178,1408,41410,30,960,1428,3847,8294
1785.085,6,375,23901,217,69,8264,69,13372,158,69,11369,69,10529
0.894,6,11,1727,7,100,149,100,384,4,589,211,1152,1343
1793.661,17,144,11520,72,48,25262,48,5472,72,56,25262,56,6048
0.695,17,4,314,2,31,573,31,118,2,70,0,70,196
1748.238,6,95,7203,63,38,28197,205,4476,32,33,56381,98,2727
842.203,2,6,192,6,8,168440,8,192,0,0,0,0,0
0.358,17,2,170,1,37,0,37,65,1,77,0,77,105
152.98,6,24,9834,12,438,80,1360,2266,12,1179,13890,2279,7568
1786.755,6,102,8296,68,65,26667,65,4930,34,59,54141,59,3366
756.477,2,5,160,5,8,189119,8,160,0,0,0,0,0
251.362,6,34,5178,17,135,1663,174,1362,17,261,15704,1452,3816
368.306,6,18,1242,14,180,28331,180,916,4,110,20067,110,326
1794.348,1,174,9744,174,28,10371,28,9744,0,0,0,0,0
3.976,17,4,248,4,34,1325,34,248,0,0,0,0,0
3.037,17,4,624,4,128,1012,128,624,0,0,0,0,0
1771.34,6,99,9240,66,65,27251,65,5577,33,59,55351,59,3663
5.328,17,29,12508,13,624,444,1350,8477,16,223,267,1350,4031
0.027,17,2,467,1,39,0,39,67,1,372,0,372,400
30.915,6,2991,2812062,1842,1441,16,1448,2741494,1149,776,26,1448,70568
0.055,17,4,588,2,48,49,48,152,2,190,48,308,436
1749.994,6,95,7203,63,38,28225,205,4476,32,33,56439,98,2727
0.115,17,2,602,1,46,0,46,74,1,500,0,500,528
1786.64,6,359,22709,209,69,8589,69,12569,150,69,11990,69,10140
75.344,6,48,8980,23,345,709,720,2071,25,346,3133,2720,6909
7.511,6,9,588,3,106,3741,106,234,6,90,1499,90,354
301.331,6,8,475,5,31,75332,31,293,3,31,149671,31,182
0.078,6,10,1752,6,592,15,1028,1429,4,159,25,159,323
0.919,17,2,237,1,72,0,72,100,1,109,0,109,137
0.91,6,15,2658,7,288,117,288,620,8,568,99,853,2038
0.08,17,2,157,1,31,0,31,59,1,70,0,70,98
164.869,6,56,15626,23,602,621,1440,4648,33,418,5146,1440,10978
6.047,17,3,228,3,48,3023,48,228,0,0,0,0,0
280.005,6,27,7312,13,158,23333,267,1317,14,775,21538,2800,5995
20.07,17,5,1680,5,308,5017,308,1680,0,0,0,0,0
42.706,17,52,25684,22,402,2032,1350,9465,30,512,1471,1350,16219
409.073,6,80,15860,35,243,12031,1189,7017,45,226,6927,1997,8843
276.818,17,4,352,2,60,276817,60,176,2,60,276817,60,176
0.025,17,3,244,2,32,11,32,120,1,96,0,96,124
300.652,6,37,8408,20,286,15823,797,1976,17,478,526,2720,6432
0.336,6,26,8785,13,210,28,482,1527,13,939,27,1408,7258
1750.774,6,97,7307,63,38,28238,205,4476,34,33,53044,98,2831
3.737,6,27,8839,16,283,249,583,1495,11,985,353,1420,7344
285.969,1,20,560,20,0,0,0,560,0,0,0,0,0
209.861,17,4,352,2,60,209860,60,176,2,60,209860,60,176
3.569,17,2,144,1,36,0,36,64,1,52,0,52,80
0.486,17,3,451,2,39,32,39,134,1,289,0,289,317
0.021,6,13,3980,7,88,3,88,388,6,1670,4,2920,3592
1798.049,1,345,28980,345,56,5226,56,28980,0,0,0,0,0
0.043,6,7,423,4,43,2,43,259,3,0,20,0,164
1770.64,6,104,9577,67,65,26827,65,5694,37,59,49181,59,3883
79.986,6,19,5968,11,186,7998,502,1378,8,711,270,1420,4590
318.167,17,17,1309,17,49,19885,49,1309,0,0,0,0,0
1785.188,6,96,7808,64,65,28336,65,4640,32,59,57583,59,3168
300.8,6,38,8725,21,315,15040,882,2225,17,446,537,2720,6500
53.678,17,4,824,2,48,53670,48,152,2,308,53671,308,672
0.154,6,10,1380,6,145,30,145,389,4,827,46,827,991
19.028,17,18,9667,9,733,2374,1350,6854,9,284,2374,1350,2813
1.762,17,3,1176,3,364,881,364,1176,0,0,0,0,0
5.693,6,41,7349,21,218,284,314,3463,20,513,284,1179,3886
161.761,6,32,12778,18,501,9515,1448,4468,14,1082,12419,2363,8310
756.616,2,5,160,5,8,189154,8,160,0,0,0,0,0
1783.461,17,83,3480,82,14,22018,14,3444,1,8,0,8,36
0.018,6,3,182,2,31,18,31,111,1,31,0,31,71
18.752,17,4,824,2,48,18739,48,152,2,308,18738,308,672
194.138,6,26,6643,12,274,17644,517,1454,14,744,14930,1408,5189
0.252,17,2,152,1,48,0,48,76,1,48,0,48,76
189.644,6,42,9956,19,117,6740,267,1822,23,400,8619,3417,8134
0.899,6,27,8506,15,229,53,583,2007,12,1201,66,3151,6499
95.863,6,35,8415,17,410,554,882,1942,18,478,5629,2128,6473
1793.418,1,204,11424,204,28,8834,28,11424,0,0,0,0,0
46.296,6,30,7432,13,158,3858,267,1317,17,543,2891,1400,6115
0.117,17,8,2750,8,315,16,354,2750,0,0,0,0,0
228.686,6,30,7432,13,158,19057,267,1317,17,603,14290,2076,6115
62.436,6,86,64407,55,1233,1156,1368,55900,31,840,2073,2519,8507
13.981,6,1974,1806775,1264,1373,11,1380,1769421,710,421,19,1923,37354
12.169,17,10,690,5,33,3040,33,305,5,49,3040,49,385
1676.35,1,8,448,8,28,239478,28,448,0,0,0,0,0
0.138,17,2,198,1,63,0,63,91,1,79,0,79,107
252.745,6,40,13145,25,541,10531,1396,3473,15,1269,8708,1396,9672
240.222,6,55,17904,28,748,8896,1402,14935,27,194,9239,580,2969
0.148,17,2,201,1,50,0,50,78,1,95,0,95,123
371.106,6,18,1239,14,177,28546,177,913,4,110,20059,110,326
131.443,17,4,1329,4,304,43814,308,1329,0,0,0,0,0
11.44,17,4,304,4,48,3813,48,304,0,0,0,0,0
204.461,17,4,352,2,60,204459,60,176,2,60,204460,60,176
1773.17,6,180,15480,120,69,14900,69,8940,60,69,30048,69,6540
2.827,17,3,451,2,39,984,39,134,1,289,0,289,317
2.523,6,14,2351,8,188,360,245,700,6,703,451,1152,1651
71.618,6,32,7653,13,155,5968,267,1306,19,398,3978,3417,6347
0.649,6,10,924,5,283,112,283,551,5,105,115,105,373
0.201,6,43,19963,25,1077,8,1420,15022,18,467,11,1883,4941
1.37,6,46,18934,27,877,52,1360,13398,19,529,66,4075,5536
0.036,17,2,167,1,31,0,31,59,1,80,0,80,108
3.221,17,27,10201,12,267,288,1350,3549,15,415,227,1350,6652
1.495,6,49,19524,27,911,57,1360,13868,22,433,61,1360,5656
49.156,6,3,237,1,69,0,69,109,2,48,49156,48,128
0.06,6,2,3617,1,0,0,0,40,1,3537,0,3537,3577
1779.316,1,191,10696,191,28,9364,28,10696,0,0,0,0,0
4.401,6,38,7229,19,218,244,314,3383,19,513,229,1179,3846
0.31,6,25,8851,13,234,25,575,1620,12,1099,27,2816,7231
0.221,17,2,176,1,48,0,48,76,1,72,0,72,100
0.566,6,20,7238,12,335,50,668,1974,8,1210,79,1906,5264
0.563,6,26,6121,13,108,46,147,959,13,773,43,1608,5162
108.285,6,20,8678,11,316,68,640,1421,9,1377,13519,3928,7257
5.529,6,12,507,6,0,1105,0,248,6,7,513,7,259
0.039,17,2,348,1,43,0,43,71,1,249,0,249,277
3.882,17,4,352,4,60,1294,60,352,0,0,0,0,0
108.276,6,35,23905,19,840,38,1360,5835,16,1935,7209,8160,18070
1.71,6,58,41003,36,1233,48,1408,33954,22,1179,72,3819,7049
1784.935,6,173,10626,91,45,19832,208,6447,82,31,22032,31,4179
1720.602,17,12,498,11,14,172060,14,462,1,8,0,8,36
0.087,6,10,1512,5,503,21,503,771,5,473,21,473,741
1794.963,17,1033,337516,510,570,3522,1350,305456,523,33,3436,361,32060
1785.862,6,469,30006,255,99,7030,469,16685,214,38,8384,69,13321
2.871,6,42,35214,22,283,136,884,2854,20,1957,150,6193,32360
40.841,6,867,717182,498,1358,82,1368,690132,369,838,110,1368,27050
0.005,6,5,5122,1,0,0,0,40,4,1218,0,1408,5082
135.495,6,23,9830,12,410,51,922,1778,11,1085,13537,2720,8052
280.192,6,28,7352,13,158,23349,267,1317,15,678,20011,3436,6035
1741.027,17,30,31680,30,1028,60035,1028,31680,0,0,0,0,0
374.721,6,24,2351,17,141,23420,141,865,7,398,3932,419,1486
566.881,6,8,475,6,31,113376,31,333,2,31,299508,31,142
3.931,17,5,290,5,30,982,30,290,0,0,0,0,0
23.88,6,32,8130,15,199,1705,721,1997,17,681,1481,1440,6133
1761.655,17,118,23451,118,170,15056,422,23451,0,0,0,0,0
0.021,17,4,352,2,37,1,37,130,2,83,4,89,222
1792.288,6,356,22520,208,69,8658,69,12460,148,69,12192,69,10060
1561.638,17,16,1265,8,30,223086,37,471,8,71,223086,136,794
0.023,17,2,144,1,36,0,36,64,1,52,0,52,80
0.01,17,4,420,2,33,8,33,122,2,121,8,145,298
1789.683,6,413,25226,220,69,8172,69,13009,193,43,9321,69,12217
381.037,6,17,1190,13,180,31753,180,864,4,110,20060,110,326
99.633,6,22,8962,11,514,86,1237,2015,11,927,9944,1460,6947
13.728,6,22,2985,13,137,1144,267,1077,9,384,1683,1152,1908
1786.864,6,102,8364,68,66,26669,66,4964,34,60,54144,60,3400
0.01,17,4,284,2,32,2,32,120,2,54,2,60,164
17.078,6,15,2233,8,322,2439,581,1069,7,396,2844,580,1164
0.056,17,3,1057,3,324,28,355,1057,0,0,0,0,0
2.383,17,2,685,1,308,0,308,336,1,321,0,321,349
0.101,6,10,1514,5,503,25,503,771,5,475,25,475,743
187.251,17,28,4588,14,48,14403,48,1064,14,223,14403,308,3524
1787.464,6,102,8296,68,65,26678,65,4930,34,59,54161,59,3366
0.006,17,2,189,1,37,0,37,65,1,96,0,96,124
34.584,17,11,836,11,48,3458,48,836,0,0,0,0,0
0.015,17,4,764,3,60,0,60,264,1,472,0,472,500
949.642,17,27,9512,27,324,36524,548,9512,0,0,0,0,0
1680.72,17,13,534,11,14,168054,14,462,2,8,1680541,8,72
141.588,6,20,4345,9,538,113,1351,2007,11,377,14141,1631,2338
1746.325,1,98,5488,98,28,18003,28,5488,0,0,0,0,0
43.179,17,24,1824,24,48,1877,48,1824,0,0,0,0,0
4.032,6,34,6169,17,206,252,314,2744,17,456,236,1152,3425
75.579,6,14,3164,5,92,18894,92,348,9,772,9357,2026,2816
0.013,6,10,1544,5,505,3,505,773,5,503,3,503,771
0.071,17,4,284,2,32,5,32,120,2,54,6,60,164
1772.763,6,180,15480,120,69,14897,69,8940,60,69,30046,69,6540
0.195,17,2,2382,2,1163,195,1163,2382,0,0,0,0,0
2.486,6,5,288,2,0,2301,0,112,3,0,1149,0,176
240.341,6,45,9118,21,523,12016,1408,5809,24,228,10449,617,3309
240.253,6,53,16224,27,701,9239,1418,13341,26,190,9609,580,2883
27.891,6,40,10390,16,383,52,836,1823,24,399,1206,1798,8567
0.303,17,4,588,2,48,286,48,152,2,190,279,308,436
38.828,17,4,352,2,60,38827,60,176,2,60,38826,60,176
0.526,6,28,8039,18,337,30,1420,3425,10,701,57,1728,4614
1761.564,6,3687,3451130,1302,149,1354,932,75469,2385,1407,738,2836,3375661
371.03,6,25,1651,17,177,23189,177,1117,8,110,9222,110,534
1787.568,6,102,8296,68,65,26680,65,4930,34,59,54165,59,3366
0.005,6,4,3071,0,0,0,0,0,4,970,1,1414,3071
0.523,6,27,9145,13,273,43,733,1778,14,945,37,1368,7367
0.999,2,2,80,2,16,999,16,80,0,0,0,0,0
1741.211,6,126,7803,72,43,24524,208,4744,54,31,32847,31,3059
361.044,2,4,128,4,8,120348,8,128,0,0,0,0,0
10.933,6,20,4442,11,275,1093,275,998,9,768,771,1440,3444
6.76,17,26,13166,14,740,517,1350,10764,12,172,611,1350,2402
1791.953,17,144,11520,72,48,25236,48,5472,72,56,25235,56,6048
1798.559,17,448,39896,403,35,4474,288,25676,45,288,40017,288,14220
11.477,6,1816,1584131,1102,1384,10,1420,1551350,714,467,16,1883,32781
16.829,6,2504,2340067,1554,1425,10,1448,2284763,950,776,17,1448,55304
375.231,17,76,5776,76,48,5003,48,5776,0,0,0,0,0
840.87,17,8,592,4,30,280282,30,232,4,62,280284,62,360
0.276,6,11,1170,6,135,53,135,379,5,587,67,587,791
175.208,17,2,72,1,8,0,8,36,1,8,0,8,36
5.31,6,44,8369,22,227,252,314,4062,22,489,240,1179,4307
12.374,6,16,2358,9,210,1546,210,908,7,545,2023,904,1450
0.069,17,2,166,1,47,0,47,75,1,63,0,63,91
243.421,6,100,38419,49,891,5071,1418,30196,51,370,4868,1418,8223
240.21,6,65,20562,36,806,6863,1402,17232,29,164,8578,580,3330
721.935,2,8,256,8,8,103133,8,256,0,0,0,0,0
373.389,6,18,1242,14,180,28722,180,916,4,110,20059,110,326
23.348,17,5,400,5,52,5837,52,400,0,0,0,0,0
3.631,6,14,3144,8,49,518,92,511,6,579,42,1408,2633
1788.403,6,168,14674,92,116,19652,208,10673,76,31,23840,31,4001
1795.177,17,448,39896,403,35,4465,288,25676,45,288,40022,288,14220
1796.742,1,286,30316,286,78,6304,78,30316,0,0,0,0,0
0.035,17,2,180,1,30,0,30,58,1,94,0,94,122
2.981,17,3,228,2,48,2903,48,152,1,48,0,48,76
1772.355,6,181,15589,121,69,14769,69,9049,60,69,30035,69,6540
1643.576,6,24,3624,16,241,109571,241,2568,8,92,234767,92,1056
0.375,6,52,19303,29,909,13,1380,12173,23,515,15,1923,7130
3.523,17,17,8569,9,588,440,1350,5549,8,349,497,1350,3020
297.252,17,4,240,2,32,297251,32,120,2,32,297251,32,120
112.224,6,25,11812,13,493,138,832,2525,12,1099,10190,1440,9287
285.495,6,33,8234,15,158,20392,267,1397,18,509,16792,1400,6837
1780.484,1,216,12096,216,28,8281,28,12096,0,0,0,0,0
0.876,6,10,1687,7,100,146,100,384,3,1179,316,1179,1303
1777.742,17,73,3060,72,14,25038,14,3024,1,8,0,8,36
13.932,17,12,1008,6,45,2785,45,438,6,67,2785,73,570
3.088,17,26,18814,13,827,230,1350,11118,13,564,232,1350,7696
245.046,6,324,401724,131,736,1884,1402,25236,193,2248,1276,7010,376488
527.873,17,6,528,3,60,263936,60,264,3,60,263936,60,264
0.456,6,4,1037,2,0,216,0,104,2,853,241,853,933
0.072,6,13,3514,7,75,11,75,447,6,1373,13,1448,3067
1.329,6,51,21141,28,952,49,1460,15445,23,433,52,1460,5696
7.989,6,678,564019,405,1320,19,1368,545159,273,776,28,1473,18860
17.54,17,13,6718,7,613,2916,1350,4488,6,343,3494,1350,2230
69.262,6,23,7953,8,154,9894,267,792,15,726,4932,1420,7161
0.016,17,2,558,1,32,0,32,60,1,470,0,470,498
13.774,17,6,5144,6,829,2754,1451,5144,0,0,0,0,0
1772.386,6,180,15480,120,69,14894,69,8940,60,69,30038,69,6540
0.009,17,2,441,1,36,0,36,64,1,349,0,349,377
0.963,6,10,1687,7,100,160,100,384,3,1179,354,1179,1303
300.18,6,34,9232,20,404,15798,1243,2726,14,524,5081,2896,6506
40.396,2,4,128,4,8,13465,8,128,0,0,0,0,0
368.384,6,11,774,9,106,46046,106,686,2,0,368375,0,88
4.362,6,39,7269,19,218,242,314,3383,20,440,216,1152,3886
640.291,1,16,896,16,28,42686,28,896,0,0,0,0,0
1796.624,17,179,13962,179,50,10093,50,13962,0,0,0,0,0
1751.706,17,12,498,11,14,175170,14,462,1,8,0,8,36
1771.537,6,103,9448,66,65,27254,65,5577,37,59,49206,59,3871
0.122,17,4,284,2,32,81,32,120,2,54,42,60,164
280.025,6,30,7432,14,158,21540,267,1357,16,603,18665,2036,6075
1794.746,6,128,12529,78,60,23308,722,6422,50,87,36622,2026,6107
125.111,2,2,64,2,8,125111,8,64,0,0,0,0,0
1786.628,6,104,8444,68,66,26666,66,4964,36,60,51043,60,3480
0.015,17,2,243,1,53,0,53,81,1,134,0,134,162
246.99,1,2,112,2,28,246990,28,112,0,0,0,0,0
749.541,1,38,2128,38,28,20257,28,2128,0,0,0,0,0
1785.863,6,367,23236,212,69,8463,69,12896,155,69,11596,69,10340
1795.615,17,448,39896,403,35,4466,288,25676,45,288,40014,288,14220
1795.233,17,449,39928,404,35,4454,288,25708,45,288,40021,288,14220
0.005,17,2,230,1,41,0,41,69,1,133,0,133,161
0.125,17,2,362,1,46,0,46,74,1,260,0,260,288
1798.566,17,449,39928,404,35,4462,288,25708,45,288,40021,288,14220
10.725,6,25,7097,12,155,975,267,1266,13,589,893,3426,5831
1787.528,6,353,34640,203,114,8849,597,16579,150,146,11996,1420,18061
252.765,2,3,96,3,8,126382,8,96,0,0,0,0,0
1797.806,17,448,39896,403,35,4472,288,25676,45,288,40014,288,14220
1782.39,6,126,16832,79,218,22851,1289,11687,47,81,38745,240,5145
280.205,6,28,7352,12,158,25473,267,1277,16,543,18679,1400,6075
1764.134,2,15,480,15,8,126009,8,480,0,0,0,0,0
0.174,6,23,7313,12,176,15,331,1336,11,1079,16,1588,5977
0.11,6,23,17255,14,180,8,250,1278,9,2214,12,9427,15977
39.295,6,4839,4545891,3072,1399,12,1448,4449331,1767,776,22,1448,96560
0.019,6,2,92,1,0,0,0,40,1,0,0,0,52
367.291,6,23,1499,14,177,28253,177,913,9,110,8551,110,586
1730.229,6,66,4800,42,33,42200,33,2889,24,31,75157,31,1911
0.005,17,2,475,1,40,0,40,68,1,379,0,379,407
4.763,6,39,10550,14,520,366,1440,4262,25,328,190,1440,6288
1797.556,1,345,28980,345,56,5225,56,28980,0,0,0,0,0
3.284,17,4,1556,4,361,1094,361,1556,0,0,0,0,0
300.9,6,50,20403,28,1043,11144,1360,14721,22,399,413,1360,5682
12.232,6,20,11614,5,153,3015,180,526,15,1164,861,1360,11088
6.894,6,654,607728,433,1338,15,1368,591252,221,776,30,1473,16476
65.792,6,27,7177,13,155,5482,267,1306,14,530,5060,2840,5871
1.138,6,24,8004,11,164,96,267,1236,13,869,80,1440,6768
1786.635,6,105,8481,69,65,26274,65,5035,36,59,51042,59,3446
0.071,6,2,92,1,0,0,0,40,1,0,0,0,52
280.241,6,29,7392,13,158,23353,267,1317,16,603,18679,2800,6075
12.905,6,2183,2016689,1388,1374,9,1408,1970685,795,931,16,2816,46004
1774.233,1,58,4872,0,0,0,0,0,58,56,31126,56,4872
1.132,6,24,8004,12,164,87,267,1288,12,1014,87,2411,6716
6.891,6,492,412903,301,1305,22,1368,398307,191,776,35,1473,14596
1786.93,6,101,8132,66,65,27491,65,4785,35,59,52554,59,3347
0.515,6,124,87941,56,131,9,232,2769,68,1329,7,1430,85172
0.022,17,4,344,2,47,12,47,150,2,69,13,75,194
698.616,17,12,4032,12,308,63510,308,4032,0,0,0,0,0
0.907,6,2,80,1,0,0,0,40,1,0,0,0,40
2.394,17,25,10893,12,556,217,1350,7015,13,270,189,1350,3878
1792.003,6,367,25650,214,99,8413,469,15045,153,69,11789,69,10605
0.052,17,2,554,1,30,0,30,58,1,468,0,468,496
69.088,6,27,7177,13,155,5757,267,1306,14,530,5313,3417,5871
0.524,6,14,4812,9,290,65,517,1045,5,1749,100,2919,3767
1744.295,6,96,7255,62,38,28595,205,4424,34,33,52846,98,2831
1787.139,6,104,8376,68,65,26673,65,4930,36,59,51057,59,3446
1.057,6,5,200,3,0,528,0,120,2,0,0,0,80
300.813,6,45,10240,23,433,13673,910,3154,22,364,740,2720,7086
75.639,6,32,7653,13,155,6303,267,1306,19,398,4201,2840,6347
650.381,17,102,18180,51,48,13006,48,3876,51,252,13007,308,14304
1786.938,17,87,3648,86,14,21022,14,3612,1,8,0,8,36
136.51,1,2,112,2,28,136510,28,112,0,0,0,0,0
191.14,17,8,480,4,32,63713,32,240,4,32,63712,32,240
0.131,17,4,284,2,32,69,32,120,2,54,66,60,164
93.445,6,41,8583,15,168,136,267,1956,26,348,3726,1460,6627
1777.336,17,140,11200,70,48,25758,48,5320,70,56,25758,56,5880
3.366,17,29,9967,15,299,238,1350,4909,14,333,256,1350,5058
14.735,1,4,224,4,28,4911,28,224,0,0,0,0,0
1791.496,17,180,14040,180,50,10008,50,14040,0,0,0,0,0
1741.479,6,87,6322,58,31,30552,31,3915,29,31,62194,31,2407
0.03,17,2,586,1,41,0,41,69,1,489,0,489,517
118.657,6,31,10872,18,619,6979,1171,3242,13,887,9876,3209,7630
2.288,6,16,4459,10,327,252,634,1836,6,767,454,1328,2623
0.555,17,4,716,2,30,540,30,116,2,272,541,272,600
0.514,6,16,6297,9,141,64,275,646,7,1073,32,2840,5651
0.252,6,9,527,5,43,63,43,311,4,0,46,0,216
1314.579,17,98,7840,49,48,27386,48,3724,49,56,27386,56,4116
1798.846,6,508,64876,248,187,7274,1360,42176,260,113,6944,6018,22700
85.272,6,72,50764,47,1184,1853,1448,42735,25,746,2566,1448,8029
0.092,17,4,284,2,32,42,32,120,2,54,51,60,164
441.544,6,30,2207,18,64,25973,64,1232,12,55,40115,58,975
21.042,6,10,572,4,0,7014,0,212,6,0,3252,0,360
140.288,6,31,8912,14,158,10791,267,1357,17,687,8762,1400,7555
0.43,6,54,23500,31,942,14,1380,16415,23,558,17,1923,7085
0.195,17,2,152,1,48,0,48,76,1,48,0,48,76
11.33,17,3,984,3,300,5665,300,984,0,0,0,0,0
1.521,17,2,136,1,32,0,32,60,1,48,0,48,76
1769.064,1,58,4872,58,56,31036,56,4872,0,0,0,0,0
280.25,6,27,7312,11,158,28025,267,1237,16,603,18682,1400,6075
18.112,6,2064,1895600,1327,1373,13,1380,1859030,737,421,24,1923,36570
377.633,2,4,128,4,8,125877,8,128,0,0,0,0,0
3.999,17,8,616,4,33,1332,33,244,4,65,1332,65,372
62.066,6,90,60131,52,1217,1216,1368,51419,38,841,1670,2736,8712
1789.965,6,356,22520,208,69,8647,69,12460,148,69,12176,69,10060
1689.129,6,224,16830,89,67,19193,293,8171,135,48,12604,78,8659
280.417,6,28,7352,12,158,25492,267,1277,16,678,18692,2085,6075
0.422,6,10,1992,5,288,97,288,508,5,424,59,434,1484
390.301,6,529,397199,246,752,1593,1408,21998,283,1349,1384,1629,375201
1790.612,1,58,4872,0,0,0,0,0,58,56,31414,56,4872
1772.577,6,180,15480,120,69,14895,69,8940,60,69,30042,69,6540
16.801,2,2,64,2,8,16801,8,64,0,0,0,0,0
589.398,6,98,6722,40,46,14986,46,2746,58,46,10340,46,3976
1138.302,2,14,448,14,8,87561,8,448,0,0,0,0,0
1778.221,6,114,8908,72,43,25045,205,5238,42,39,43365,108,3670
0.444,6,13,1693,6,288,87,288,548,7,426,42,434,1145
1.117,6,28,10120,17,349,69,779,1731,11,993,103,1452,8389
0.503,17,2,476,1,39,0,39,67,1,381,0,381,409
1747.31,6,171,10422,87,46,20317,208,6163,84,31,21047,31,4259
16.596,6,16,2373,10,211,1841,211,974,6,545,3314,904,1399
0.532,17,2,476,1,39,0,39,67,1,381,0,381,409
978.686,1,5,280,5,28,244671,28,280,0,0,0,0,0
1785.131,17,82,3438,81,14,22314,14,3402,1,8,0,8,36
1797.474,1,58,4872,58,56,31534,56,4872,0,0,0,0,0
0.903,6,22,5961,12,108,82,147,919,10,927,61,1608,5042
67.725,17,4,1344,4,308,22575,308,1344,0,0,0,0,0
1787.61,6,104,8376,68,65,26680,65,4930,36,59,51071,59,3446
1798.403,1,345,28980,345,56,5227,56,28980,0,0,0,0,0
1744.698,6,95,7203,63,38,28140,205,4476,32,33,56272,98,2727
268.665,6,320,258889,203,1306,1330,1408,239129,117,621,1758,3847,19760
1722.899,1,8,448,8,28,246128,28,448,0,0,0,0,0
0.239,17,2,185,1,45,0,45,73,1,84,0,84,112
34.829,6,36,8328,18,367,531,787,1854,18,478,2039,2128,6474
1772.529,6,180,15480,120,69,14895,69,8940,60,69,30041,69,6540
280.184,6,29,7392,13,158,23348,267,1317,16,603,18676,1400,6075
0.782,6,27,5927,13,156,65,267,1462,14,650,53,1414,4465
1.768,17,3,468,3,128,884,128,468,0,0,0,0,0
1799.875,6,366,25610,213,99,8489,469,15005,153,69,11841,69,10605
1741.234,6,87,6322,58,31,30547,31,3915,29,31,62184,31,2407
5.052,17,4,288,2,36,5004,36,128,2,52,5002,52,160
0.525,6,10,1514,5,503,131,503,771,5,475,131,475,743
5.377,6,40,7309,21,218,268,314,3463,19,513,283,1179,3846
1797.278,1,345,28980,345,56,5224,56,28980,0,0,0,0,0
1794.862,6,162,11933,87,67,20870,208,6878,75,45,24251,124,5055
280.238,6,31,7472,14,158,21556,267,1357,17,543,17513,1400,6115
1799.309,6,356,22520,208,69,8692,69,12460,148,69,12240,69,10060
1789.575,17,83,3480,82,14,22093,14,3444,1,8,0,8,36
315.827,6,146,36479,77,414,4155,1360,24782,69,255,4559,3289,11697
18.332,17,39,16564,21,498,915,1350,11054,18,278,1076,1350,5510
66.068,6,38,10488,19,826,505,1360,4926,19,399,3657,1360,5562
0.401,6,22,8747,12,334,35,663,1981,10,1039,43,1912,6766
2.191,17,4,610,3,39,839,39,201,1,381,0,381,409
1789.396,6,225,19615,83,79,21820,375,8853,142,70,12689,1062,10762
136.306,6,25,9968,12,549,61,1440,2709,13,961,11348,1440,7259
5.63,6,39,7285,20,218,296,314,3423,19,516,298,1179,3862
1787.848,17,83,3480,82,14,22072,14,3444,1,8,0,8,36
1798.379,17,448,39896,403,35,4473,288,25676,45,288,40017,288,14220
1.369,6,47,20192,27,964,52,1460,14616,20,433,61,1460,5576
110.792,17,14,1064,14,48,8522,48,1064,0,0,0,0,0
1786.872,6,102,8296,68,65,26669,65,4930,34,59,54144,59,3366
0.012,6,10,1514,5,503,2,503,771,5,475,3,475,743
1790.728,1,94,5264,94,28,19255,28,5264,0,0,0,0,0
481.269,2,5,160,5,8,120317,8,160,0,0,0,0,0
1793.459,6,356,22520,208,69,8664,69,12460,148,69,12200,69,10060
0.161,6,43,17516,24,962,7,1420,12535,19,467,8,1883,4981
1797.71,17,450,39960,405,35,4449,288,25740,45,288,40013,288,14220
0.412,17,3,451,2,39,406,39,134,1,289,0,289,317
1783.815,6,376,28631,219,126,8182,469,17590,157,69,11434,69,11041
1771.791,6,99,9240,66,65,27258,65,5577,33,59,55365,59,3663
240.177,6,55,18637,30,783,8281,1402,15675,25,206,10007,580,2962
17.56,17,34,9365,17,328,1095,1350,6060,17,166,1095,1350,3305
5.672,6,40,7325,20,218,298,314,3423,20,516,284,1179,3902
1798.821,17,140,11200,70,48,26069,48,5320,70,56,26069,56,5880
315.976,6,80,13889,43,123,7523,615,4424,37,346,8773,4649,9465
90.833,17,4,240,2,32,90832,32,120,2,32,90831,32,120
462.072,1,3,168,3,28,231036,28,168,0,0,0,0,0
323.587,17,7,2296,7,300,53931,300,2296,0,0,0,0,0
1.002,17,2,120,2,32,1002,32,120,0,0,0,0,0
0.036,17,2,157,1,31,0,31,59,1,70,0,70,98
19.278,17,4,240,2,32,19277,32,120,2,32,19277,32,120
61.839,6,73,50037,45,1196,1405,1408,41848,28,960,2281,3847,8189
66.172,6,11,1346,6,302,13234,302,912,5,83,16539,83,434
280.566,6,29,7733,13,158,23380,267,1317,16,641,18702,2045,6416
1.392,6,49,19650,27,920,53,1360,13994,22,476,57,2720,5656
505.174,17,37,5254,37,114,14032,300,5254,0,0,0,0,0
38.682,17,11,836,11,48,3868,48,836,0,0,0,0,0
0.122,6,11,1739,6,126,24,126,386,5,1149,27,1149,1353
295.408,6,42,7659,20,147,15545,517,1943,22,456,14064,1418,5716
1778.448,1,54,3024,54,28,33555,28,3024,0,0,0,0,0
1785.759,6,104,8504,69,66,26261,66,5004,35,60,52519,60,3500
1771.151,6,99,9306,66,66,27248,66,5610,33,60,55345,60,3696
1779.085,1,342,28728,342,56,5217,56,28728,0,0,0,0,0
165.164,6,253,210877,161,1343,1032,1440,195107,92,609,1623,1440,15770
0.546,17,4,952,2,39,532,39,134,2,381,19,381,818
1786.761,6,104,8510,69,66,26275,66,5070,35,60,52548,60,3440
4.22,6,38,7229,19,218,234,314,3383,19,513,220,1179,3846
240.257,6,63,28359,35,977,7066,1402,25293,28,200,8898,580,3066
0.523,6,10,924,5,283,88,283,551,5,105,88,105,373
83.261,6,23,6145,13,220,6938,516,1405,10,619,9237,1452,4740
1772.463,6,180,15480,120,69,14894,69,8940,60,69,30033,69,6540
1.564,17,3,1167,3,361,782,361,1167,0,0,0,0,0
14.024,6,21,6825,12,275,1274,275,1038,9,1353,1127,1440,5787
1772.33,6,180,15480,120,69,14893,69,8940,60,69,30032,69,6540
1791.416,1,59,4956,59,56,30886,56,4956,0,0,0,0,0
0.007,17,3,399,2,33,0,33,122,1,249,0,249,277
1799.638,6,377,26726,217,104,8331,469,15772,160,69,11317,69,10954
55.952,6,7270,6990152,4853,1363,11,1408,6859804,2417,931,23,2816,130348
4.073,17,5,340,5,40,1018,40,340,0,0,0,0,0
1798.343,6,151,10976,80,77,22763,208,7051,71,31,25684,31,3925
84.469,6,31,8030,16,345,45,720,1707,15,571,6023,3488,6323
0.026,6,4,160,2,0,26,0,80,2,0,1,0,80
1798.574,6,355,22480,207,69,8730,69,12420,148,69,12235,69,10060
1796.93,17,448,39896,403,35,4469,288,25676,45,288,40024,288,14220
0.046,17,2,912,1,308,0,308,336,1,548,0,548,576
0.295,6,22,5040,11,137,29,267,1132,11,577,28,1400,3908
1719.45,17,12,498,11,14,171945,14,462,1,8,0,8,36
0.182,17,2,180,1,30,0,30,58,1,94,0,94,122
0.786,6,10,1687,7,100,131,100,384,3,1179,263,1179,1303
3.359,6,38,13491,20,457,176,1360,4495,18,750,164,1380,8996
188.476,6,9,528,2,112,188460,112,200,7,0,31410,0,328
39.591,17,4,240,2,32,39591,32,120,2,32,39590,32,120
7.405,6,1131,982594,677,1371,10,1408,954322,454,931,15,2816,28272
1.452,6,49,19372,27,900,55,1460,13716,22,476,60,2615,5656
269.386,17,4,352,2,60,269385,60,176,2,60,269385,60,176
3.878,17,4,580,2,40,3865,40,136,2,194,3861,194,444
0.341,17,8,2742,8,314,48,353,2742,0,0,0,0,0
0.35,6,27,9047,13,252,29,647,1692,14,945,24,1408,7355
205.456,17,4,352,2,60,205455,60,176,2,60,205454,60,176
1762.682,1,62,5208,0,0,0,0,0,62,56,28896,56,5208
31.441,6,7,336,1,0,0,0,48,6,0,6286,0,288
1682.716,17,14,1036,7,30,280426,30,406,7,62,280445,62,630
1.438,6,225,185776,142,1336,10,1432,178156,83,428,17,1871,7620
22.968,6,10,436,4,0,7656,0,172,6,0,1707,0,264
0.148,6,12,1945,7,329,24,500,1030,5,647,37,647,915
147.762,6,41,11513,21,559,7388,1360,4262,20,584,7731,1360,7251
70.761,6,17,700,8,0,5424,0,328,9,0,8803,0,372
16.98,17,3,228,3,48,8490,48,228,0,0,0,0,0
0.001,6,2,80,2,0,0,0,80,0,0,0,0,0
127.853,17,20,20631,20,1003,6729,1451,20631,0,0,0,0,0
1791.364,6,205,39136,119,357,15181,1285,25489,86,170,21074,1420,13647
1774.003,6,202,22250,129,75,13859,267,10017,73,134,24636,1460,12233
0.298,17,2,170,1,37,0,37,65,1,77,0,77,105
1.684,6,50,19294,27,891,64,1360,13598,23,433,67,1360,5696
204.192,17,4,352,2,60,204190,60,176,2,60,204191,60,176
6.03,6,33,8512,17,164,366,267,1564,16,869,390,1448,6948
1.092,6,31,12124,17,525,68,1360,3350,14,820,70,1380,8774
265.343,6,21,9748,6,142,6197,174,670,15,706,18945,1452,9078
1755.349,6,95,7203,63,38,28312,205,4476,32,33,56610,98,2727
13.638,6,6,260,2,0,13638,0,84,4,0,2428,0,176
1792.459,17,179,13962,179,50,10069,50,13962,0,0,0,0,0
111.345,6,26,10689,13,525,121,1237,2151,13,889,9253,1460,8538
171.202,6,20716,20064202,13978,1358,12,1408,19709162,6738,931,25,2816,355040
1745.411,6,95,7203,63,38,28151,205,4476,32,33,56291,98,2727
0.031,17,2,588,1,39,0,39,67,1,493,0,493,521
0.272,6,9,1343,5,145,68,145,349,4,830,23,830,994
1672.794,6,141,9213,79,51,21446,208,6020,62,31,24390,31,3193
1680.739,1,15,840,15,28,120052,28,840,0,0,0,0,0
0.264,6,16,4552,8,88,37,88,460,8,1253,37,1880,4092
64.074,6,35,9038,15,327,138,1189,2575,20,471,3371,1420,6463
1775.514,6,126,12421,78,62,23058,722,6422,48,87,37771,1408,5999
0.102,6,9,1346,5,145,25,145,349,4,833,28,833,997
24.773,6,10,2516,9,256,3096,365,2412,1,64,0,64,104
0.2,17,2,144,1,36,0,36,64,1,52,0,52,80
0.035,6,2,99,1,0,0,0,40,1,7,0,7,59
15.52,6,10,636,4,106,5173,106,274,6,90,3064,90,362
240.456,6,53,19302,29,841,8587,1418,16659,24,173,10454,580,2643
4.575,17,17,7010,8,554,652,1350,4661,9,233,567,1350,2349
240.239,6,65,18927,33,772,7507,1408,15644,32,179,7749,580,3283
127.814,6,146,109387,92,1264,1404,1408,97098,54,631,2014,1408,12289
0.894,6,27,8420,15,222,54,540,1964,12,1192,66,3151,6456
0.084,17,2,152,1,48,0,48,76,1,48,0,48,76
2.55,6,53,23366,28,1027,94,1440,17590,25,433,93,1440,5776
3.191,6,13,547,7,0,531,0,288,6,7,592,7,259
36.556,17,22,1936,11,48,3648,48,836,11,72,3653,72,1100
0.011,17,2,283,1,31,0,31,59,1,196,0,196,224
1786.414,6,113,8978,72,65,25160,65,5155,41,59,44657,59,3823
280.198,6,29,7392,13,158,23349,267,1317,16,603,18676,1400,6075
0.04,2,2,64,2,8,40,8,64,0,0,0,0,0
0.084,17,2,702,2,323,84,329,702,0,0,0,0,0
280.878,6,30,7432,13,158,23406,267,1317,17,543,17549,1400,6115
357.131,2,5,160,5,8,89282,8,160,0,0,0,0,0
230.957,6,38,5791,20,139,12146,722,2300,18,317,13575,1448,3491
1768.143,1,180,10080,180,28,9877,28,10080,0,0,0,0,0
1796.301,17,449,39928,404,35,4457,288,25708,45,288,40020,288,14220
1777.198,17,138,11040,69,48,26135,48,5244,69,56,26135,56,5796
1786.267,6,102,8228,68,64,26660,64,4896,34,58,54126,58,3332
0.024,6,13,3769,7,171,3,171,555,6,964,4,1448,3214
1799.998,6,351,77071,145,479,12188,1440,55766,206,128,8780,1440,21305
0.875,17,6,864,3,36,434,36,192,3,196,434,292,672
180.67,6,26,5066,12,189,9948,516,1432,14,279,13883,1452,3634
1786.185,6,113,9050,72,66,25157,66,5190,41,60,44652,60,3860
4.121,17,4,232,4,30,1373,30,232,0,0,0,0,0
117.335,6,72,47806,45,1166,2666,1408,39670,27,960,2370,3847,8136
5.743,6,19,2410,10,304,638,304,1744,9,83,697,83,666
0.377,17,2,152,1,48,0,48,76,1,48,0,48,76
1789.339,6,121,14499,79,85,22940,516,6404,42,160,43640,1420,8095
1794.491,17,83,3480,82,14,22154,14,3444,1,8,0,8,36
1788.984,17,83,3480,82,14,22086,14,3444,1,8,0,8,36
358.757,6,47,10175,29,266,12812,1360,4653,18,399,510,1360,5522
0.174,17,2,572,1,39,0,39,67,1,477,0,477,505
1789.135,17,142,11360,71,48,25558,48,5396,71,56,25558,56,5964
0.458,6,23,6001,12,108,41,147,919,11,927,43,1608,5082
6.237,6,1578,1534314,1054,1382,5,1408,1502402,524,776,11,1408,31912
1785.668,6,127,13275,78,81,23190,502,6236,49,120,37199,1420,7039
1696.171,6,24,3624,16,241,113078,241,2568,8,92,242284,92,1056
1.468,2,2,64,2,8,1468,8,64,0,0,0,0,0
1797.377,1,207,11592,207,28,8725,28,11592,0,0,0,0,0
1779.967,17,86,3606,85,14,21190,14,3570,1,8,0,8,36
1.182,6,28,8631,15,236,69,625,2049,13,1008,81,1791,6582
0.328,17,7,2397,7,314,54,355,2397,0,0,0,0,0
6.03,17,4,406,2,46,6019,46,148,2,101,6019,101,258
86.498,6,23,10128,12,549,66,1360,2709,11,1393,8636,3934,7419
0.799,17,4,368,2,32,767,32,120,2,96,767,96,248
1439.82,6,109,10541,64,64,22854,205,5317,45,64,32719,170,5224
0.775,17,25,16295,14,771,57,1350,11198,11,435,74,1350,5097
0.044,17,2,157,1,31,0,31,59,1,70,0,70,98
1.3,6,12,1304,6,256,257,256,756,6,304,257,304,548
95.901,6,24,3326,10,183,10655,517,1457,14,381,7376,499,1869
340.537,17,6,1984,6,302,68107,308,1984,0,0,0,0,0
585.204,1,6,336,6,28,117040,28,336,0,0,0,0,0
1798.481,6,367,24643,214,87,8443,469,14176,153,69,11829,69,10467
0.081,6,9,1340,5,145,20,145,349,4,827,21,827,991
3.987,17,4,368,4,64,1329,64,368,0,0,0,0,0
1748.809,1,64,5376,64,56,27758,56,5376,0,0,0,0,0
0.078,6,10,766,5,185,16,185,453,5,45,15,45,313
0.405,6,10,967,5,256,97,256,460,5,303,97,303,507
1778.122,17,138,11040,69,48,26148,48,5244,69,56,26148,56,5796
106.302,17,2,672,2,308,106302,308,672,0,0,0,0,0
0.02,17,4,284,2,32,12,32,120,2,54,12,60,164
1798.746,17,446,39264,403,35,4474,288,25676,43,288,41922,288,13588
1.189,6,50,20644,28,922,44,1360,14988,22,433,49,1360,5656
1.267,6,23,7952,12,164,97,267,1288,11,1216,107,3819,6664
1.57,6,7,2530,2,1059,375,1368,2222,5,0,392,0,308
1.094,6,28,8263,15,225,65,561,1985,13,957,76,1631,6278
1798.867,1,101,5656,101,28,17988,28,5656,0,0,0,0,0
16.41,17,26,12954,12,409,1489,1350,5249,14,522,1260,1350,7705
292.14,1,6,336,6,28,58428,28,336,0,0,0,0,0
33.682,6,30,5043,15,154,2405,722,1859,15,400,2392,1402,3184
203.852,17,4,352,2,60,203851,60,176,2,60,203851,60,176
0.201,17,6,912,3,60,93,60,264,3,188,94,188,648
240.172,6,54,18148,29,806,8577,1402,15218,25,202,10006,580,2930
2.74,6,9,527,5,43,685,43,311,4,0,910,0,216
14.13,17,4,352,2,48,14096,48,152,2,72,14090,72,200
1745.55,2,15,480,15,8,124682,8,480,0,0,0,0,0
1793.437,6,356,22520,208,69,8663,69,12460,148,69,12200,69,10060
1785.114,1,266,14896,266,28,6736,28,14896,0,0,0,0,0
62.175,6,45,9930,23,631,457,1360,4155,22,348,2952,2667,5775
122.974,1,4,224,4,28,40991,28,224,0,0,0,0,0
1.364,17,2,780,2,362,1364,362,780,0,0,0,0,0
0.162,17,2,158,1,34,0,34,62,1,68,0,68,96
4.32,6,2,88,2,0,0,0,88,0,0,0,0,0
6.862,6,43,8329,22,227,326,314,4062,21,489,330,1179,4267
2.113,17,2,677,1,300,0,300,328,1,321,0,321,349
80.927,17,4,240,4,32,26975,32,240,0,0,0,0,0
2.188,6,20,3833,11,234,218,564,1504,9,463,250,1343,2329
240.654,2,2,64,2,8,240654,8,64,0,0,0,0,0
5.678,6,13,5758,3,106,2839,106,234,10,639,622,1452,5524
227.893,6,72,17847,32,370,7351,1148,8748,40,405,5759,1498,9099
37.587,6,4782,4626891,3215,1363,11,1408,4540719,1567,931,23,2801,86172
1796.502,1,215,12040,215,28,8394,28,12040,0,0,0,0,0
1765.459,17,168,14034,156,30,11390,37,9090,12,384,155064,463,4944
0.004,17,3,1007,1,137,0,137,165,2,393,1,393,842
0.016,17,2,362,1,53,0,53,81,1,253,0,253,281
1772.888,6,183,15738,121,69,14774,69,8980,62,69,29063,69,6758
3.002,17,5,434,4,46,1000,46,296,1,110,0,110,138
2.821,6,2,80,1,0,0,0,40,1,0,0,0,40
1262.423,2,11,352,11,8,126242,8,352,0,0,0,0,0
64.29,6,35,8262,10,162,157,267,1383,25,293,2678,1420,6879
1.292,6,13,1344,7,256,214,256,796,6,304,256,304,548
1786.791,6,113,9050,72,66,25166,66,5190,41,60,44667,60,3860
16.296,6,17,3857,6,170,3223,210,832,11,345,1611,1448,3025
1786.553,6,103,8326,68,64,26664,64,4896,35,58,52543,58,3430
48.214,17,42,7986,31,40,1607,41,2123,11,505,4720,505,5863
124.529,6,35,7906,12,155,189,267,1266,23,317,5659,1420,6640
1786.723,6,363,23214,209,69,8590,69,12569,154,69,11677,69,10645
0.233,6,47,21164,26,1074,9,1432,16103,21,420,11,1432,5061
0.311,17,2,279,1,36,0,36,64,1,187,0,187,215
300.67,6,38,8360,20,254,15824,671,1886,18,478,501,1928,6474
5.31,6,10,2030,7,241,885,241,1726,3,92,89,92,304
3.178,17,70,89423,69,1267,46,1472,89383,1,12,0,12,40
1779.011,17,142,11360,71,48,25414,48,5396,71,56,25414,56,5964
3.009,6,14,3459,8,81,429,81,513,6,872,601,1448,2946
0.761,6,11,1727,7,100,126,100,384,4,589,173,1152,1343
16.13,17,21,8589,10,529,1788,1350,5572,11,246,1609,1350,3017
280.16,6,27,7312,13,158,23346,267,1317,14,775,21550,4836,5995
2.838,6,14,2351,8,188,405,245,700,6,703,516,1152,1651
1682.683,17,15,1094,8,30,240378,30,464,7,62,280441,62,630
1720.488,17,12,498,11,14,172048,14,462,1,8,0,8,36
1.403,6,17,6714,9,275,175,275,639,8,958,164,2840,6075
118.146,6,22,8570,11,333,74,692,1473,11,949,11800,1440,7097
11.007,6,18,5610,10,275,1223,275,958,8,1440,852,1440,4652
0.239,6,9,1339,5,145,59,145,349,4,826,58,826,990
8.86,6,40,8141,18,218,521,314,3343,22,489,410,1179,4798
1267.275,6,147,19757,79,79,16247,721,6823,68,275,18708,2840,12934
1746.99,1,58,4872,0,0,0,0,0,58,56,30648,56,4872
0.474,6,125,88185,57,131,8,232,2809,68,1333,7,2720,85376
240.16,6,41,5390,22,205,11436,517,2589,19,224,13341,880,2801
1.226,6,46,18120,26,882,49,1360,12544,20,476,55,2720,5576
0.032,17,2,904,1,300,0,300,328,1,548,0,548,576
58.175,6,37,8981,20,152,3061,454,1748,17,594,3404,1642,7233
43.525,1,12,1248,0,0,0,0,0,12,76,3956,76,1248
1760.734,1,68,5712,0,0,0,0,0,68,56,26279,56,5712
0.206,6,4,160,2,0,206,0,80,2,0,1,0,80
1.263,6,47,19180,27,892,48,1360,13604,20,433,57,1360,5576
316.96,6,38,10152,15,132,22640,267,1929,23,405,1478,1460,8223
0.914,17,4,502,2,31,904,31,118,2,164,904,164,384
5.562,17,4,288,2,36,5006,36,128,2,52,0,52,160
1799.765,17,772,46617,772,32,2334,37,46617,0,0,0,0,0
15.261,17,18,5190,8,317,2176,1350,2766,10,214,1692,1350,2424
1682.673,17,16,4348,8,30,240380,30,464,8,457,240380,463,3884
12.637,6,15,4683,9,290,1579,517,1057,6,1653,2492,1858,3626
1774.566,6,180,15480,120,69,14912,69,8940,60,69,30076,69,6540
1740.519,17,28,29568,28,1028,64463,1028,29568,0,0,0,0,0
0.007,6,14,21236,1,0,0,0,40,13,1578,0,2736,21196
291.804,6,46,7894,23,129,13261,517,2125,23,507,13261,2398,5769
44.243,17,19,10692,10,662,4915,1350,6908,9,392,1898,1350,3784
8.284,6,20,5335,10,275,920,275,683,10,1059,563,1380,4652
0.071,6,11,15040,1,0,0,0,40,10,1448,3,1448,15000
4.314,1,5,420,5,56,1078,56,420,0,0,0,0,0
0.056,6,2,116,1,0,0,0,64,1,0,0,0,52
1776.75,6,220,19830,113,123,15863,208,14434,107,31,16759,31,5396
3.418,17,4,1568,4,364,1139,364,1568,0,0,0,0,0
0.052,17,4,420,2,33,0,33,122,2,121,34,145,298
1785.858,6,366,23196,211,69,8504,69,12787,155,69,11596,69,10409
4.901,6,22,6404,10,262,539,517,1316,12,744,441,1418,5088
0.342,6,22,7333,12,334,30,663,1969,10,1209,37,2816,5364
1773.395,6,182,15629,121,69,14778,69,8980,61,69,29555,69,6649
281.627,6,22,1504,12,31,25579,31,779,10,31,31264,31,725
351.973,6,9,1257,9,99,43996,138,1257,0,0,0,0,0
1793.48,1,292,30952,292,78,6163,78,30952,0,0,0,0,0
388.563,1,6,336,6,28,77712,28,336,0,0,0,0,0
301.707,6,52,17105,25,631,12571,1402,8905,27,339,2891,2694,8200
0.464,6,3,120,1,0,0,0,40,2,0,464,0,80
20.162,6,20,5366,12,107,1832,159,1074,8,967,2877,1659,4292
10.026,6,14,1247,7,222,1669,222,728,7,231,1669,231,519
8.257,17,5,2065,5,385,2064,394,2065,0,0,0,0,0
1787.905,6,379,26406,218,97,8239,469,15481,161,69,11174,69,10925
1784.343,6,365,25501,212,100,8456,469,14896,153,69,11736,69,10605
0.011,17,2,455,1,36,0,36,64,1,363,0,363,391
1785.253,17,136,10880,68,48,26645,48,5168,68,56,26645,56,5712
1.527,6,38,8254,19,321,84,1164,2718,19,433,74,1460,5536
10.781,6,20,4442,11,275,1078,275,998,9,768,738,1440,3444
264.49,17,16,17910,16,1091,17632,1450,17910,0,0,0,0,0
1.923,6,4,208,2,0,1126,0,104,2,0,1923,0,104
75.829,6,26,7344,8,155,286,267,1106,18,393,4459,1420,6238
93.92,6,44,8637,17,218,295,314,3303,27,607,3602,1179,5334
1787.141,6,102,8364,68,66,26673,66,4964,34,60,54151,60,3400
0.167,6,29,7376,14,155,12,267,1341,15,543,11,1400,6035
172.648,17,4,240,2,32,172647,32,120,2,32,172646,32,120
0.153,17,2,2128,2,1036,153,1036,2128,0,0,0,0,0
63.155,6,27,7177,13,155,5262,267,1306,14,530,4857,3417,5871
10.799,6,18,5610,10,275,1199,275,958,8,1440,822,1440,4652
363.151,6,18,1242,14,180,27934,180,916,4,110,20055,110,326
1.341,6,50,19332,27,894,51,1360,13636,23,433,52,1360,5696
104.178,6,54,12833,26,342,2440,1189,5498,28,344,3857,3377,7335
1.062,6,30,8443,16,270,58,629,2293,14,697,67,1360,6150
1783.734,6,380,24101,216,69,8296,69,13401,164,69,10942,69,10700
12.141,17,10,830,5,47,3033,47,375,5,63,3033,63,455
0.909,6,19,3126,9,324,113,585,1762,10,396,80,580,1364
77.686,6,17,2034,4,304,25895,304,520,13,83,6473,83,1514
0.321,6,14,3952,8,124,45,124,572,6,1530,64,1612,3380
1741.387,17,28,6580,28,207,64495,207,6580,0,0,0,0,0
1779.574,17,140,11200,70,48,25790,48,5320,70,56,25790,56,5880
1744.552,6,95,7203,63,38,28137,205,4476,32,33,56262,98,2727
0.045,17,2,339,1,33,0,33,61,1,250,0,250,278
34.693,6,29,5572,18,174,2040,517,2350,11,440,3468,499,3222
1791.307,1,58,4872,58,56,31426,56,4872,0,0,0,0,0
7.696,6,1086,931737,647,1360,11,1408,904245,439,931,17,2816,27492
280.26,6,29,7392,13,158,23355,267,1317,16,603,18683,2036,6075
1791.012,6,362,22898,210,69,8569,69,12678,152,69,11860,69,10220
166.291,17,4,317,2,33,166284,34,122,2,69,166284,79,195
0.506,6,2,1460,1,0,0,0,40,1,1380,0,1380,1420
99.629,6,169,137830,111,1285,905,1408,125302,58,731,1744,3847,12528
1789.182,17,83,3480,82,14,22088,14,3444,1,8,0,8,36
1794.636,6,368,23276,212,69,8505,69,12896,156,69,11578,69,10380
1779.351,17,79,3312,78,14,23108,14,3276,1,8,0,8,36
7.146,6,1510,1366886,936,1381,7,1408,1332374,574,931,12,2816,34512
0.535,6,20,7229,13,334,44,663,2021,7,1209,76,1946,5208
4.128,17,5,340,5,40,1032,40,340,0,0,0,0,0
1798.178,1,58,4872,0,0,0,0,0,58,56,31546,56,4872
364.645,6,34778,36526167,11592,802,31,1448,686387,23186,1496,15,5792,35839780
0.16,6,24,7176,12,155,14,267,1261,12,775,13,2800,5915
0.083,17,2,414,1,32,0,32,60,1,326,0,326,354
1744.681,6,99,7442,64,38,27693,205,4528,35,33,51307,98,2914
1.165,6,3,637,2,246,1124,462,597,1,0,0,0,40
0.501,17,2,384,1,39,0,39,67,1,289,0,289,317
0.059,17,4,284,2,32,1,32,120,2,54,12,60,164
1786.562,6,105,8348,68,64,26665,64,4896,37,58,49624,58,3452
0.844,17,3,451,2,39,727,39,134,1,289,0,289,317
1782.946,17,73,3060,72,14,25111,14,3024,1,8,0,8,36
0.442,6,12,1653,6,288,84,288,548,6,426,44,434,1105
6.008,6,40,7325,21,218,300,314,3463,19,516,319,1179,3862
12.376,6,14,601,6,0,2475,0,248,8,7,1735,7,353
1771.426,6,101,9344,66,65,27252,65,5577,35,59,52098,59,3767
1787.535,6,107,8561,69,65,26287,65,5035,38,59,48308,59,3526
0.018,17,2,633,2,288,18,293,633,0,0,0,0,0
0.137,17,2,168,1,32,0,32,60,1,80,0,80,108
0.155,17,2,136,1,32,0,32,60,1,48,0,48,76
0.819,6,28,7336,13,155,68,267,1301,15,543,51,1400,6035
11.521,6,93,27605,47,569,250,1152,21256,46,409,250,1179,6349
154.183,17,4,288,2,36,154183,36,128,2,52,154182,52,160
1781.873,6,353,22400,205,69,8693,69,12340,148,69,12121,69,10060
1795.544,17,449,39928,404,35,4455,288,25708,45,288,40017,288,14220
0.014,6,10,1138,4,595,4,595,811,6,7,2,7,327
0.069,6,10,1495,5,507,17,507,727,5,556,17,556,768
1.42,6,50,19694,27,920,54,1460,13998,23,433,54,1460,5696
155.127,17,4,352,2,60,155126,60,176,2,60,155121,60,176
194.185,17,4,352,2,60,194184,60,176,2,60,194184,60,176
2.907,6,2001,1888144,1118,214,2,230,62301,883,2020,3,11264,1825843
0.688,6,23,7385,13,334,57,663,2021,10,967,72,1471,5364
326.732,6,37,8053,16,158,21782,267,1437,21,524,16335,1400,6616
196.723,17,12,4032,12,308,17883,308,4032,0,0,0,0,0
1.391,6,41,10554,21,513,69,1460,4978,20,433,63,1460,5576
0.748,17,4,688,2,36,743,36,128,2,252,743,274,560
151.637,6,25,9756,12,665,77,1460,3174,13,864,12621,1460,6582
1749.541,17,12,498,11,14,174954,14,462,1,8,0,8,36
0.0,17,1,1021,1,993,0,993,1021,0,0,0,0,0
1799.464,17,448,39896,403,35,4476,288,25676,45,288,40022,288,14220
95.584,6,45,9056,22,414,688,928,2228,23,368,4339,3488,6828
5.189,6,17,10895,7,275,864,275,834,10,1379,441,1414,10061
1793.795,1,176,18656,176,78,10250,78,18656,0,0,0,0,0
630.647,2,4,128,4,8,210215,8,128,0,0,0,0,0
280.47,6,29,7392,13,158,23372,267,1317,16,678,18694,2760,6075
104.113,6,24,8707,13,641,76,1460,3117,11,856,10392,1547,5590
1788.004,17,140,11200,70,48,25912,48,5320,70,56,25912,56,5880
175.401,17,2,72,1,8,0,8,36,1,8,0,8,36
281.005,6,60,8723,28,158,10407,267,1917,32,552,9062,2076,6806
1.368,6,50,21271,28,964,50,1440,15615,22,433,56,1440,5656
1.05,6,29,8544,15,222,64,540,2008,14,852,67,1360,6536
0.234,17,2,154,1,41,0,41,69,1,57,0,57,85
1729.234,6,64,4684,41,33,43230,33,2825,23,31,78591,31,1859
1791.086,6,189,18451,124,89,14561,965,10534,65,81,27980,485,7917
16.399,6,12,5553,4,106,5464,106,274,8,1235,2341,3417,5279
300.952,6,38,9578,21,537,15047,1360,4096,17,435,544,2667,5482
77.383,6,65,42124,41,1142,1934,1368,34141,24,840,2691,2519,7983
1791.314,1,214,22684,214,78,8409,78,22684,0,0,0,0,0
1.017,17,4,566,2,31,1007,31,118,2,196,1005,196,448
1.277,6,16,2544,8,288,179,288,928,8,424,157,434,1616
1.535,17,4,240,2,32,1534,32,120,2,32,1534,32,120
1386.477,2,10,320,10,8,154053,8,320,0,0,0,0,0
554.716,6,44,7545,21,262,27733,517,1888,23,744,25212,1418,5657
0.187,6,9,1340,5,145,46,145,349,4,827,58,827,991
1.386,6,24,6042,13,108,115,147,959,11,773,113,1608,5083
240.264,6,54,18204,29,811,8580,1418,15316,25,197,10010,580,2888
4.986,6,18,3420,8,92,712,92,596,10,568,531,1408,2824
280.422,6,28,7352,13,158,23368,267,1317,15,775,20025,4836,6035
280.22,6,30,7432,14,158,21555,267,1357,16,603,18677,2800,6075
0.129,17,4,420,2,33,0,33,122,2,121,126,145,298
3.13,17,5,373,3,31,1538,31,177,2,70,1757,70,196
0.497,17,3,451,2,39,224,39,134,1,289,0,289,317
1701.703,17,12,498,11,14,170170,14,462,1,8,0,8,36
1782.732,6,356,22520,208,69,8612,69,12460,148,69,12127,69,10060
0.252,6,26,6168,12,181,22,537,1526,14,558,18,1408,4642
280.28,6,29,7392,13,158,23356,267,1317,16,603,18681,1400,6075
9.218,6,16,2370,10,210,1023,210,972,6,545,1808,904,1398
845.453,6,57,8231,29,262,30191,517,2304,28,893,31310,2450,5927
16.857,17,27,17546,11,600,1682,1350,6915,16,636,1121,1350,10631
1.339,6,39,8292,19,320,74,1162,2716,20,433,60,1460,5576
0.787,6,5,248,3,0,393,0,144,2,0,440,0,104
369.632,6,23,1535,16,177,24642,177,1053,7,110,10381,110,482
3.96,1,5,420,5,56,990,56,420,0,0,0,0,0
1744.107,6,95,7203,63,38,28130,205,4476,32,33,56247,98,2727
3.276,17,5,340,5,40,819,40,340,0,0,0,0,0
280.44,6,28,7352,13,158,23370,267,1317,15,775,20028,3465,6035
1.865,17,15,5409,7,355,310,1350,2684,8,312,168,1350,2725
5.384,6,16,6249,3,189,2690,267,507,13,578,448,1420,5742
1783.186,17,83,3480,82,14,22014,14,3444,1,8,0,8,36
31.471,6,7,336,1,0,0,0,48,6,0,6292,0,288
1771.925,6,180,15480,120,69,14890,69,8940,60,69,30032,69,6540
77.238,6,18,748,9,0,9654,0,368,9,0,9438,0,380
1779.249,6,110,8970,68,65,26555,65,4930,42,59,43394,59,4040
0.04,17,4,398,2,46,36,46,148,2,97,36,103,250
0.06,1,2,112,2,28,60,28,112,0,0,0,0,0
1795.724,17,447,39580,403,35,4466,288,25676,44,288,40946,288,13904
42.844,17,8,704,4,48,14278,48,304,4,72,14278,72,400
61.387,6,37,15935,22,800,2923,1440,9157,15,665,4366,1440,6778
1.314,6,50,20313,27,964,50,1460,14617,23,433,52,1460,5696
0.464,6,27,9064,13,252,38,646,1694,14,947,32,1438,7370
0.148,17,2,190,1,59,0,59,87,1,75,0,75,103
1.84,6,5,272,2,0,1840,0,104,3,0,896,0,168
0.04,17,2,136,1,32,0,32,60,1,48,0,48,76
17.554,6,15,4052,6,92,3510,92,400,9,454,191,1408,3652
1777.984,17,140,11200,70,48,25767,48,5320,70,56,25767,56,5880
1.283,6,24,8004,12,164,99,267,1288,12,1014,99,2411,6716
3.847,6,24,6045,12,108,349,147,919,12,927,349,1608,5126
0.42,6,6,324,4,0,140,0,216,2,0,191,0,108
280.549,6,32,7853,14,158,21580,267,1357,18,524,16501,1400,6496
0.172,17,2,144,1,36,0,36,64,1,52,0,52,80
125.329,6,13,3117,7,92,20888,92,476,6,581,25033,2026,2641
1795.35,6,356,22520,208,69,8673,69,12460,148,69,12212,69,10060
1747.685,6,95,7203,63,38,28188,205,4476,32,33,56370,98,2727
1781.781,1,342,28728,342,56,5225,56,28728,0,0,0,0,0
1792.005,6,359,22709,209,69,8615,69,12569,150,69,12026,69,10140
0.377,6,7,376,4,0,125,0,216,3,0,99,0,160
1.533,6,48,18143,26,878,61,1360,12487,22,433,63,1360,5656
304.568,6,288,228711,177,1286,1730,1368,216317,111,501,595,1571,12394
1794.277,17,365,58978,365,133,4929,381,58978,0,0,0,0,0
1745.325,6,95,7203,63,38,28150,205,4476,32,33,56293,98,2727
21.362,6,6,312,3,0,10681,0,156,3,0,10571,0,156
1792.892,17,180,11520,180,36,10016,36,11520,0,0,0,0,0
1796.719,17,448,39896,403,35,4469,288,25676,45,288,40024,288,14220
1781.5,6,104,8424,68,64,26589,64,4896,36,58,50897,58,3528
1752.585,6,99,7411,63,38,28267,205,4476,36,33,50063,98,2935
277.37,17,4,340,2,37,277359,37,130,2,77,277326,77,210
1777.505,6,204,22330,130,75,13779,267,10057,74,132,24344,1460,12273
280.958,6,30,7432,13,158,23413,267,1317,17,543,17554,1400,6115
0.009,6,2,104,1,0,0,0,64,1,0,0,0,40
17.713,17,5,1716,5,315,4428,376,1716,0,0,0,0,0
0.066,1,2,112,2,28,66,28,112,0,0,0,0,0
1770.603,6,118,10728,72,64,24938,64,6096,46,58,39343,58,4632
303.307,6,183,57582,72,565,4271,1440,30648,111,367,2752,1440,26934
1789.769,17,466,96431,466,178,3848,336,96431,0,0,0,0,0
19.784,17,53,37229,22,401,940,1350,9441,31,868,658,1350,27788
1774.029,1,58,4872,58,56,31123,56,4872,0,0,0,0,0
630.384,2,5,160,5,8,157596,8,160,0,0,0,0,0
1.373,6,50,19323,27,893,52,1360,13627,23,433,53,1360,5696
28.768,17,4,240,2,32,28767,32,120,2,32,28767,32,120
33.391,17,4,1374,4,315,11130,329,1374,0,0,0,0,0
1.176,6,230,170865,127,1368,9,1432,162500,103,467,11,1871,8365
1740.542,17,30,31680,30,1028,60018,1028,31680,0,0,0,0,0
295.576,1,4,224,4,28,98525,28,224,0,0,0,0,0
5.244,6,11,1971,6,451,1048,500,1222,5,481,1311,481,749
299.998,6,25,6822,12,158,27271,267,1277,13,717,24999,2036,5545
0.542,6,3,160,2,0,542,0,100,1,0,0,0,60
11.009,6,20,4442,11,275,1100,275,998,9,768,780,1440,3444
1786.54,6,102,8364,68,66,26664,66,4964,34,60,54134,60,3400
1789.108,17,142,11360,71,48,25558,48,5396,71,56,25558,56,5964
2.822,17,2,290,1,47,0,47,75,1,187,0,187,215
1773.825,6,180,15480,120,69,14906,69,8940,60,69,30060,69,6540
2.91,17,3,1021,2,308,1916,308,672,1,321,0,321,349
1794.171,6,356,22520,208,69,8667,69,12460,148,69,12204,69,10060
2.031,1,3,252,3,56,1015,56,252,0,0,0,0,0
563.622,6,54,9701,23,110,25618,267,2258,31,247,18787,1460,7443
18.155,17,4,304,2,48,18141,48,152,2,48,18140,48,152
240.231,6,54,17642,27,839,9239,1418,14838,27,174,9239,580,2804
1784.444,17,140,11200,70,48,25861,48,5320,70,56,25861,56,5880
1772.106,6,180,15480,120,69,14891,69,8940,60,69,30031,69,6540
371.072,6,208,162219,108,117,3467,517,7284,100,1576,2428,4314,154935
10.218,6,1896,1720324,1180,1378,8,1408,1678428,716,931,14,2816,41896
6.933,6,610,559649,402,1328,16,1368,544169,208,776,32,2736,15480
1791.452,17,345,58309,345,141,5207,366,58309,0,0,0,0,0
194.16,17,4,352,2,60,194159,60,176,2,60,194159,60,176
97.655,6,60,16065,29,474,3487,1440,5557,31,462,3224,1440,10508
0.101,17,2,347,1,29,0,29,57,1,262,0,262,290
0.014,17,2,466,1,33,0,33,61,1,377,0,377,405
0.444,17,8,2758,8,316,63,355,2758,0,0,0,0,0
2.169,6,14,2351,8,188,309,245,700,6,703,381,1152,1651
8.525,6,77,24365,39,552,224,1152,18704,38,459,223,1179,5661
240.936,6,30,10541,15,449,67,1368,2599,15,715,17206,1368,7942
1790.687,17,288,60328,288,181,6239,422,60328,0,0,0,0,0
375.973,6,18,1242,14,180,28921,180,916,4,110,20065,110,326
1788.947,17,83,3480,82,14,22085,14,3444,1,8,0,8,36
280.208,6,28,7352,13,158,23350,267,1317,15,678,20012,3436,6035
16.036,6,7,400,2,0,16036,0,100,5,0,3878,0,300
240.199,6,54,17605,30,734,8282,1402,14787,24,195,10443,580,2818
1779.031,17,140,11200,70,48,25782,48,5320,70,56,25782,56,5880
713.39,17,32,1344,32,14,23012,14,1344,0,0,0,0,0
1.022,17,4,324,2,31,1011,31,118,2,75,1009,80,206
0.622,6,6,328,4,0,207,0,216,2,0,611,0,112
2.223,17,2,1430,2,687,2223,687,1430,0,0,0,0,0
0.294,17,2,152,1,48,0,48,76,1,48,0,48,76
127.981,6,22,8258,11,511,81,1194,2029,11,825,12781,1360,6229
1789.734,1,58,4872,58,56,31398,56,4872,0,0,0,0,0
154.328,6,14,580,5,0,314,0,208,9,0,19289,0,372
1748.534,6,96,7286,63,38,28202,205,4476,33,33,54633,98,2810
0.014,17,2,156,1,42,0,42,70,1,58,0,58,86
0.821,6,11,1727,7,100,136,100,384,4,589,188,1152,1343
18.601,6,23,8238,13,248,1550,619,1679,10,861,2043,1440,6559
1795.804,6,368,25759,214,99,8431,469,15045,154,69,11737,69,10714
380.871,6,90,6642,44,86,8857,86,2542,46,39,8463,63,4100
1740.504,1,15,840,15,28,124321,28,840,0,0,0,0,0
1765.476,17,168,14066,156,30,11390,37,9090,12,386,155070,463,4976
1796.972,17,447,39580,403,35,4470,288,25676,44,288,40945,288,13904
241.225,6,47,5726,24,235,10487,752,2943,23,157,10964,575,2783
0.212,17,2,152,1,48,0,48,76,1,48,0,48,76
15.859,17,18,12471,11,922,1579,1350,10460,7,259,2631,1350,2011
102.343,6,98,71055,62,1256,1677,1448,61020,36,679,2740,1448,10035
1323.525,2,13,416,13,8,110293,8,416,0,0,0,0,0
0.067,17,2,268,1,33,0,33,61,1,179,0,179,207
1776.126,17,73,3060,72,14,25015,14,3024,1,8,0,8,36
1750.43,6,140,13692,85,66,20838,722,7087,55,82,32393,1408,6605
377.447,6,21,1419,15,177,26960,177,989,6,110,12262,110,430
10.411,17,9,1480,6,102,2082,288,780,3,205,205,288,700
853.455,6,75,8498,41,79,21331,722,3733,34,130,25856,1408,4765
197.695,1,16,896,16,28,13179,28,896,0,0,0,0,0
0.122,17,4,284,2,32,67,32,120,2,54,59,60,164
1684.53,2,27,864,27,8,64789,8,864,0,0,0,0,0
1220.683,17,59,2478,59,14,21046,14,2478,0,0,0,0,0
280.658,6,29,7733,13,158,23388,267,1317,16,641,18708,2045,6416
0.807,17,2,178,1,29,0,29,57,1,93,0,93,121
0.799,6,10,1687,7,100,133,100,384,3,1179,268,1179,1303
0.055,17,2,169,1,34,0,34,62,1,79,0,79,107
114.894,6,1000,524795,584,834,197,1152,503348,416,400,276,1152,21447
1792.026,6,373,26359,215,104,8373,469,15623,158,69,11414,69,10736
18.484,6,960,841638,587,1357,31,1368,816518,373,931,49,2736,25120
1762.468,6,122,12447,66,64,27113,517,4662,56,231,32043,1368,7785
1.367,6,20,3833,11,234,136,564,1504,9,463,149,1343,2329
1771.397,6,99,9240,66,65,27252,65,5577,33,59,55353,59,3663
0.342,6,10,968,5,256,84,256,460,5,304,83,304,508
63.59,6,9,514,3,106,31790,106,234,6,0,12716,0,280
1779.194,17,140,11200,70,48,25785,48,5320,70,56,25785,56,5880
22.442,6,16,3265,9,211,2804,211,910,7,665,3740,904,2355
1795.613,17,142,11360,71,48,25651,48,5396,71,56,25651,56,5964
280.22,6,29,7392,13,158,23351,267,1317,16,603,18677,2036,6075
21.481,17,19,10545,9,685,2680,1350,6418,10,384,2382,1350,4127
2.36,6,116,86820,50,131,48,232,2529,66,1360,32,1430,84291
1.781,6,9,527,5,43,445,43,311,4,0,592,0,216
0.454,6,24,7324,13,257,37,748,1715,11,838,44,1418,5609
8.39,6,17,3329,9,211,1048,211,922,8,665,1198,904,2407
1769.144,1,58,4872,0,0,0,0,0,58,56,31037,56,4872
0.956,17,11,4535,5,431,239,1350,2299,6,344,169,1350,2236
0.128,6,7,759,3,69,41,69,189,4,205,17,341,570
0.016,6,4,222,2,31,16,31,111,2,31,1,31,111
0.032,17,2,378,1,50,0,50,78,1,272,0,272,300
1786.536,6,102,8296,68,65,26664,65,4930,34,59,54134,59,3366
1686.402,1,8,448,8,28,240914,28,448,0,0,0,0,0
370.863,6,18,1242,14,180,28527,180,916,4,110,20062,110,326
1786.417,6,104,8504,69,66,26270,66,5004,35,60,52538,60,3500
300.556,6,11,866,6,180,60076,180,500,5,110,75095,110,366
1797.669,6,356,22520,208,69,8684,69,12460,148,69,12228,69,10060
0.124,6,12,3462,6,75,24,75,395,6,1373,24,1448,3067
1799.267,1,280,15680,280,28,6448,28,15680,0,0,0,0,0
224.006,17,6,1452,3,32,112001,37,181,3,395,112000,463,1271
1797.399,17,448,39612,404,35,4460,288,25708,44,288,40952,288,13904
1797.5,6,173,18526,92,92,19752,721,8681,81,150,22466,2840,9845
1.446,6,38,8252,19,320,80,1162,2716,19,433,68,1360,5536
1786.111,6,117,13597,77,81,23501,501,6030,40,156,45795,1420,7567
1443.894,2,16,512,16,8,96259,8,512,0,0,0,0,0
70.18,6,143,132542,99,430,716,647,6518,44,3093,1572,9856,126024
3.143,6,20,2616,11,304,314,304,1796,9,83,391,83,820
1771.494,6,101,9410,66,66,27253,66,5610,35,60,52100,60,3800
1798.813,17,142,11360,71,48,25697,48,5396,71,56,25697,56,5964
157.219,6,23,10096,13,541,52,1360,2717,10,1393,17454,3934,7379
1568.009,17,13,2522,13,166,130667,166,2522,0,0,0,0,0
10.67,6,16,3911,9,275,1333,275,643,7,992,957,1440,3268
1126.176,17,10,2745,5,30,281524,30,290,5,463,281541,463,2455
1795.219,17,87,3648,86,14,21120,14,3612,1,8,0,8,36
2.13,6,30,10405,18,367,125,833,1825,12,1012,185,1420,8580
0.009,17,2,588,1,39,0,39,67,1,493,0,493,521
1.953,17,2,1709,2,826,1953,1068,1709,0,0,0,0,0
1745.275,6,95,7203,63,38,28149,205,4476,32,33,56287,98,2727
5.437,6,19,9443,9,275,679,275,639,10,1050,554,2840,8804
0.008,17,2,358,1,30,0,30,58,1,272,0,272,300
99.568,1,3,479,3,131,49784,173,479,0,0,0,0,0
83.589,6,125,95479,79,1263,1071,1368,84961,46,738,1852,2736,10518
0.013,17,2,586,1,46,0,46,74,1,484,0,484,512
0.154,6,39,14349,21,854,7,1420,9408,18,420,8,1420,4941
8.81,6,41,8031,20,218,463,314,3423,21,470,426,1179,4608
1.704,6,13,2311,8,188,243,245,700,5,1407,360,1407,1611
1783.821,6,365,23711,211,78,8494,693,13411,154,69,11658,69,10300
140.512,17,4,352,2,60,140511,60,176,2,60,140511,60,176
0.042,17,2,136,1,32,0,32,60,1,48,0,48,76
222.782,6,36,11598,20,516,11725,1360,4458,16,648,14839,2720,7140
0.75,6,27,5927,13,156,62,267,1462,14,650,52,1420,4465
97.042,6,32,11566,14,774,111,1368,4609,18,400,5696,1368,6957
0.01,17,3,612,2,30,0,30,116,1,468,0,468,496
1.441,6,43,10728,23,517,65,1460,5107,20,400,65,1460,5621
0.272,17,2,172,1,50,0,50,78,1,66,0,66,94
1775.758,17,140,11200,70,48,25735,48,5320,70,56,25735,56,5880
1.65,6,13,2311,8,188,235,245,700,5,1407,348,1407,1611
1739.887,6,132,16470,78,78,22595,877,7154,54,154,32827,1408,9316
0.147,17,2,672,2,308,147,308,672,0,0,0,0,0
2.007,17,6,552,3,32,999,32,180,3,96,997,96,372
0.454,6,50,20846,27,1040,17,1380,15684,23,421,19,1923,5162
3.016,6,8,527,5,69,754,69,338,3,69,1397,69,189
1771.849,6,99,9240,66,65,27259,65,5577,33,59,55367,59,3663
1.329,6,48,19022,27,878,51,1440,13406,21,433,57,1440,5616
1797.115,1,58,4872,58,56,31528,56,4872,0,0,0,0,0
1795.641,17,449,39928,404,35,4455,288,25708,45,288,40014,288,14220
378.232,2,4,128,4,8,126077,8,128,0,0,0,0,0
366.024,6,19,1303,14,177,28155,177,925,5,110,15154,110,378
1594.44,1,8,848,8,78,227777,78,848,0,0,0,0,0
69.191,6,11,851,11,31,6919,31,851,0,0,0,0,0
13.909,6,90,27751,44,566,323,1152,21040,46,442,303,1179,6711
0.041,17,3,234,2,39,26,39,134,1,72,0,72,100
0.088,17,2,180,1,30,0,30,58,1,94,0,94,122
1744.628,6,346,21913,201,69,8723,69,12111,145,69,12115,69,9802
0.057,17,4,284,2,32,17,32,120,2,54,41,60,164
1783.33,17,83,3480,82,14,22016,14,3444,1,8,0,8,36
240.314,6,48,9207,22,197,11442,751,2533,26,483,9610,1368,6674
9.878,6,2567,4048810,392,693,25,1396,28728,2175,1802,4,9772,4020082
0.55,17,17,6216,8,397,72,1350,3405,9,284,60,1350,2811
0.164,6,26,7256,13,155,13,267,1301,13,678,13,2045,5955
0.346,6,3,120,1,0,0,0,40,2,0,346,0,80
5.998,6,37,7189,18,218,352,314,3343,19,513,319,1179,3846
1777.385,17,79,3312,78,14,23082,14,3276,1,8,0,8,36
0.007,17,2,186,1,29,0,29,57,1,101,0,101,129
41.091,6,28,7217,13,155,3424,267,1306,15,482,2934,1997,5911
0.056,17,4,284,2,32,39,32,120,2,54,43,60,164
0.0,17,2,2384,2,1164,0,1164,2384,0,0,0,0,0
2.157,6,58,23252,29,1007,77,1440,17316,29,433,70,1440,5936
1771.075,6,99,9306,66,66,27247,66,5610,33,60,55343,60,3696
1792.549,6,357,22698,208,69,8659,69,12598,149,69,12111,69,10100
0.58,6,15,1785,8,288,62,288,640,7,426,67,434,1145
1772.201,6,239,17840,120,69,14892,69,8940,119,34,15018,69,8900
1744.049,6,94,7151,62,38,28590,205,4424,32,33,56250,98,2727
99.99,17,4,352,2,60,99989,60,176,2,60,99989,60,176
1796.821,17,448,39612,404,35,4458,288,25708,44,288,40950,288,13904
0.675,6,16,1209,8,181,96,181,601,8,58,41,134,608
0.115,17,2,193,1,43,0,43,71,1,94,0,94,122
1796.033,6,378,26297,218,98,8276,469,15412,160,69,11295,69,10885
214.826,17,4,352,2,60,214825,60,176,2,60,214825,60,176
2.901,17,4,240,4,32,967,32,240,0,0,0,0,0
1787.658,6,102,8296,68,65,26681,65,4930,34,59,54167,59,3366
1.677,6,51,23323,28,1029,62,1440,17627,23,433,66,1440,5696
7.286,6,1865,1828663,1252,1387,5,1408,1792123,613,776,11,1408,36540
1776.999,17,140,11200,70,48,25753,48,5320,70,56,25753,56,5880
0.076,17,2,376,1,39,0,39,67,1,281,0,281,309
1682.794,17,14,1036,7,30,280456,30,406,7,62,280449,62,630
1785.428,6,102,8160,68,63,26648,63,4862,34,57,54101,57,3298
1.305,6,10,1687,7,100,217,100,384,3,1179,523,1179,1303
4.719,17,4,288,2,36,4688,36,128,2,52,4687,52,160
1798.349,17,449,39928,404,35,4462,288,25708,45,288,40015,288,14220
33.459,6,32,5157,15,180,2389,722,1860,17,267,2080,1408,3297
0.068,6,11,3287,6,81,13,81,401,5,872,16,1448,2886
1.653,6,27,10120,16,275,110,557,1469,11,1025,148,1420,8651
33.36,17,3,228,3,48,16680,48,228,0,0,0,0,0
1776.734,6,213,14700,105,68,17083,208,9388,108,31,16602,31,5312
300.275,6,30,11768,17,592,18767,1408,4445,13,1106,20019,2816,7323
0.361,6,21,5000,10,137,40,267,1092,11,692,35,1467,3908
1.778,6,27,12434,14,752,136,1360,3613,13,1036,114,1737,8821
1772.134,6,180,15480,120,69,14891,69,8940,60,69,30031,69,6540
1.496,6,57,21547,32,898,48,1360,13937,25,471,55,2715,7610
0.944,6,11,1727,7,100,157,100,384,4,589,226,1152,1343
20.005,17,4,304,4,48,6668,48,304,0,0,0,0,0
1700.322,1,8,448,8,28,242903,28,448,0,0,0,0,0
3.425,6,60,25314,33,996,107,1360,19353,27,400,123,1360,5961
2.282,6,13,2311,8,188,326,245,700,5,1407,506,1407,1611
3.034,6,19,5314,8,150,433,174,624,11,606,293,1420,4690
1700.628,17,13,534,11,14,170045,14,462,2,8,1700458,8,72
0.116,17,2,180,1,30,0,30,58,1,94,0,94,122
1788.655,17,87,3648,86,14,21043,14,3612,1,8,0,8,36
1.72,17,2,784,2,364,1720,364,784,0,0,0,0,0
1796.991,1,345,28980,345,56,5223,56,28980,0,0,0,0,0
39.555,6,28,7217,13,155,3296,267,1306,15,482,2824,1997,5911
1796.105,1,152,8512,152,28,11894,28,8512,0,0,0,0,0
4.942,6,12,1938,7,209,823,209,581,5,544,1230,891,1357
0.442,6,21,7203,12,318,38,600,1906,9,964,52,1471,5297
1740.551,17,30,20190,30,645,60019,645,20190,0,0,0,0,0
5.04,17,4,288,2,36,5007,36,128,2,52,5008,52,160
288.259,6,20,1369,12,31,26189,31,779,8,31,41155,31,590
9.496,6,1849,1723064,1184,1378,7,1408,1683820,665,931,14,2801,39244
0.681,17,4,768,2,39,667,39,134,2,289,658,289,634
240.644,2,3,96,3,8,120322,8,96,0,0,0,0,0
1771.547,1,58,4872,58,56,31079,56,4872,0,0,0,0,0
240.16,6,53,17722,28,781,8894,1408,14756,25,207,10006,580,2966
13.048,6,2240,2079407,1400,1405,9,1448,2031063,840,776,15,1448,48344
0.371,6,27,8942,13,232,30,569,1614,14,941,27,1438,7328
317.053,6,67,18951,37,335,8807,1360,9908,30,460,10927,1360,9043
240.206,6,56,16021,29,667,8578,1402,12878,27,192,9238,580,3143
0.508,6,22,7333,13,334,42,663,2021,9,967,56,1471,5312
1787.262,1,250,14000,250,28,7177,28,14000,0,0,0,0,0
2.723,6,38,8360,19,338,151,1270,2824,19,433,133,1440,5536
1775.355,17,140,11200,70,48,25729,48,5320,70,56,25729,56,5880
6.399,6,700,597938,416,1361,15,1408,578506,284,776,22,1408,19432
34.114,6,35,7531,17,154,2132,722,2011,18,508,1995,2026,5520
1798.25,17,445,39232,402,35,4484,288,25644,43,288,41929,288,13588
125.381,6,14,3144,7,92,20896,92,452,7,464,20867,2026,2692
13.017,6,1969,1820779,1261,1366,10,1408,1779299,708,931,18,2816,41480
1791.422,17,144,11520,72,48,25231,48,5472,72,56,25231,56,6048
87.66,6,39,8668,20,410,463,882,2110,19,445,4861,2128,6558
1774.247,6,180,15480,120,69,14909,69,8940,60,69,30064,69,6540
1799.977,1,16,896,16,28,119998,28,896,0,0,0,0,0
235.475,6,287,227837,174,1361,1361,1448,207880,113,599,1987,2359,19957
5.517,17,63,55025,27,529,212,1350,15057,36,1082,139,1350,39968
1.96,17,2,312,2,128,1960,128,312,0,0,0,0,0
240.146,6,96,83264,35,175,7062,517,2893,61,1543,4002,2804,80371
280.337,6,29,7392,13,158,23361,267,1317,16,603,18687,1400,6075
1772.149,6,180,15480,120,69,14892,69,8940,60,69,30034,69,6540
1772.548,6,180,15480,120,69,14895,69,8940,60,69,30036,69,6540
1780.082,17,142,11360,71,48,25429,48,5396,71,56,25429,56,5964
1.031,17,4,296,2,30,1000,30,116,2,62,1008,62,180
18.423,17,34,12499,18,518,1081,1350,9836,16,138,1225,1350,2663
1786.293,6,131,15710,83,92,21784,501,6835,48,165,38004,1420,8875
0.539,6,24,7503,14,275,41,674,2115,10,1212,54,1946,5388
26.551,17,42,10899,42,231,647,389,10899,0,0,0,0,0
1.723,6,19,3781,10,234,191,564,1452,9,463,193,1343,2329
1770.373,6,99,9240,66,65,27236,65,5577,33,59,55319,59,3663
1729.174,6,60,4400,40,33,44337,33,2740,20,31,91000,31,1660
1776.659,17,73,3060,72,14,25023,14,3024,1,8,0,8,36
75.228,6,33,14338,17,872,4701,1360,5944,16,967,5000,1360,8394
1744.641,2,25,800,25,8,72693,8,800,0,0,0,0,0
0.439,6,3,189,1,0,0,0,40,2,69,266,69,149
12.523,6,96,30833,48,608,266,1152,24431,48,447,261,1179,6402
300.753,6,41,8877,17,308,18788,889,1947,24,331,13070,3488,6930
0.0,17,1,67,1,39,0,39,67,0,0,0,0,0
8.319,6,70,20606,35,552,244,1152,15763,35,491,236,1179,4843
1795.215,17,448,39896,403,35,4465,288,25676,45,288,40021,288,14220
1.387,6,48,18238,26,885,55,1460,12582,22,433,57,1460,5656
1786.201,17,87,3648,86,14,21014,14,3612,1,8,0,8,36
12.721,6,24,3356,13,266,1060,517,1766,11,493,1130,828,1590
1793.285,6,356,22520,208,69,8663,69,12460,148,69,12199,69,10060
383.795,6,24,2351,17,141,23987,141,865,7,398,3912,419,1486
301.943,6,33,6397,17,286,18871,1314,2405,16,334,20129,1420,3992
4.238,17,2,166,1,47,0,47,75,1,63,0,63,91
1755.513,6,2397,2189100,970,147,1811,863,63784,1427,1515,1231,7090,2125316
1599.062,1,8,848,8,78,228437,78,848,0,0,0,0,0
0.006,17,2,355,1,35,0,35,63,1,264,0,264,292
1795.995,6,359,23178,210,75,8593,469,13009,149,69,12132,69,10169
4.274,6,32,6105,17,206,267,314,2744,15,551,286,1179,3361
1796.901,17,444,39200,400,35,4503,288,25296,44,288,40957,288,13904
1795.822,6,356,22520,208,69,8675,69,12460,148,69,12216,69,10060
280.456,6,28,7352,13,158,23371,267,1317,15,678,20029,2760,6035
1.207,6,23,7952,12,164,93,267,1288,11,1216,103,3819,6664
0.101,6,10,1671,6,552,20,948,1348,4,159,33,159,323
1082.875,2,9,288,9,8,135359,8,288,0,0,0,0,0
1748.533,6,96,7286,63,38,28202,205,4476,33,33,54628,98,2810
1.252,6,29,8832,14,158,96,267,1357,15,763,86,2076,7475
42.297,17,48,7056,24,48,1838,48,1824,24,190,1838,308,5232
1620.651,1,7,392,7,28,270108,28,392,0,0,0,0,0
13.251,6,17,1261,13,43,1104,43,1021,4,0,2336,0,240
0.493,6,3,127,1,0,0,0,40,2,7,0,7,87
0.057,6,2,80,1,0,0,0,40,1,0,0,0,40
2.778,6,6,328,4,0,926,0,216,2,0,2723,0,112
1798.523,17,450,39960,405,35,4451,288,25740,45,288,40018,288,14220
0.044,17,2,154,1,33,0,33,61,1,65,0,65,93
29.076,17,9,684,9,48,3634,48,684,0,0,0,0,0
1787.63,6,104,8376,68,65,26681,65,4930,36,59,51071,59,3446
1798.89,6,436,28410,218,99,8289,469,15205,218,34,8289,64,13205
1797.106,17,449,39928,404,35,4459,288,25708,45,288,40023,288,14220
283.637,1,4,224,4,28,94545,28,224,0,0,0,0,0
38.749,17,11,836,11,48,3874,48,836,0,0,0,0,0
39.284,6,44,7469,19,218,243,314,3383,25,513,1627,1179,4086
240.433,6,43,5641,21,225,12019,751,2916,22,195,11448,650,2725
0.355,17,2,348,1,39,0,39,67,1,253,0,253,281
7.017,6,157,198238,81,133,87,201,3807,76,2658,91,19796,194431
4.789,6,4,208,4,0,0,0,208,0,0,0,0,0
1796.231,6,385,26784,220,97,8201,469,15699,165,69,10951,69,11085
1797.878,17,447,39580,403,35,4472,288,25676,44,288,40948,288,13904
10.986,6,18,4266,10,275,1220,275,958,8,992,839,1440,3308
4.764,2,3,96,3,8,2382,8,96,0,0,0,0,0
32.948,17,36,5292,18,48,1937,48,1368,18,190,1937,308,3924
1.625,6,27,10191,16,287,108,593,1505,11,1030,146,1420,8686
195.76,17,4,352,2,60,195759,60,176,2,60,195759,60,176
51.443,17,18,1368,18,48,3026,48,1368,0,0,0,0,0
1744.657,2,27,864,27,8,67102,8,864,0,0,0,0,0
0.374,17,2,164,1,46,0,46,74,1,62,0,62,90
280.4,6,28,7352,13,158,23366,267,1317,15,775,20025,4836,6035
1765.001,2,13,416,13,8,147083,8,416,0,0,0,0,0
1766.997,6,128,7856,70,27,25608,27,4225,58,27,30999,27,3631
1787.52,1,67,5628,0,0,0,0,0,67,56,27083,56,5628
330.01,17,6,528,3,60,165004,60,264,3,60,165004,60,264
1787.051,6,102,8364,68,66,26672,66,4964,34,60,54150,60,3400
62.174,6,37,17017,23,826,2826,1368,10290,14,748,4764,2736,6727
77.118,6,23,9877,11,295,73,579,1359,12,1146,6998,1460,8518
240.412,6,46,9162,23,517,10926,1418,5873,23,208,10927,639,3289
0.877,6,3,127,1,0,0,0,40,2,7,1,7,87
1680.636,1,15,840,15,28,120045,28,840,0,0,0,0,0
301.423,6,38,15843,20,765,15855,1360,6212,18,809,17720,2720,9631
301.006,6,38,9602,19,531,16712,1360,3978,19,373,16712,2667,5624
15.689,17,20,6667,9,281,1957,1350,2788,11,324,1565,1350,3879
300.627,6,38,8403,20,271,15822,738,1929,18,441,496,1360,6474
0.031,1,2,112,2,28,31,28,112,0,0,0,0,0
117.046,17,4,1344,4,308,39015,308,1344,0,0,0,0,0
757.064,6,206,19206,105,88,7278,267,7854,101,178,7568,1460,11352
0.16,17,2,195,1,44,0,44,72,1,95,0,95,123
17.175,17,21,13216,11,954,1713,1350,10807,10,212,1903,1350,2409
0.489,6,50,21526,28,1016,18,1380,16404,22,421,21,1923,5122
240.204,6,54,18031,29,796,8578,1402,15055,25,208,10008,580,2976
0.524,6,9,2902,5,92,131,92,360,4,1165,76,1408,2542
8.052,6,14,5885,5,186,2010,267,581,9,822,1005,1452,5304
0.317,17,2,212,1,46,0,46,74,1,110,0,110,138
2.237,6,6,340,3,0,1118,0,160,3,0,690,0,180
271.381,17,4,352,2,60,271380,60,176,2,60,271379,60,176
0.372,17,8,2750,8,315,53,354,2750,0,0,0,0,0
35.359,6,33,9930,19,190,1964,517,2175,14,779,2718,1640,7755
0.028,6,12,3705,6,171,3,171,491,6,964,5,1448,3214
65.277,6,32,8918,13,327,201,1189,2495,19,514,3626,1420,6423
0.032,17,2,157,1,31,0,31,59,1,70,0,70,98
31.606,6,2,96,1,0,0,0,48,1,0,0,0,48
1784.934,6,164,17188,92,77,19614,519,7493,72,141,25138,1420,9695
16.906,17,23,5502,11,243,1687,1350,2991,12,181,1534,1350,2511
155.32,17,2,136,2,40,155320,47,136,0,0,0,0,0
0.134,17,2,389,1,34,0,34,62,1,299,0,299,327
1742.418,6,101,7515,63,38,28103,205,4476,38,33,47084,98,3039
37.05,6,27,6388,16,117,2470,159,1441,11,873,3700,1709,4947
1.212,6,20,3157,10,324,134,585,1201,10,285,133,580,1956
1798.444,6,849,58091,424,31,4251,31,28434,425,31,4241,31,29657
0.258,6,4,226,3,0,129,0,168,1,6,0,6,58
1786.445,6,102,8296,68,65,26663,65,4930,34,59,54131,59,3366
1.438,6,37,8214,19,321,79,1164,2718,18,476,73,2715,5496
4.789,17,11,5245,5,510,1197,1350,2690,6,397,830,1350,2555
6.6,6,65,20086,33,540,206,1152,15379,32,489,204,1179,4707
5.893,6,16,5237,5,288,1428,288,520,11,710,571,853,4717
280.276,17,4,296,2,30,280262,30,116,2,62,280264,62,180
1788.0,17,142,11360,71,48,25542,48,5396,71,56,25542,56,5964
7.723,6,22,4426,12,213,702,597,1689,10,441,839,1408,2737
1796.885,1,345,28980,345,56,5223,56,28980,0,0,0,0,0
17.247,17,4,240,2,32,17246,32,120,2,32,17246,32,120
0.583,6,14,1745,7,288,66,288,600,7,426,69,434,1145
0.084,6,10,766,5,185,18,185,453,5,45,20,45,313
3.541,17,19,7688,8,494,505,1350,4176,11,291,287,1350,3512
1797.948,6,326,32797,191,125,9462,469,17463,135,127,13413,1917,15334
0.098,1,2,163,2,53,98,78,163,0,0,0,0,0
300.856,6,38,8566,20,315,15834,882,2093,18,441,500,1360,6473
8.962,6,76,25553,36,802,256,1440,14392,40,475,224,1440,11161
253.522,17,4,352,2,60,253521,60,176,2,60,253521,60,176
1799.534,6,178,15331,118,69,14899,69,8791,60,69,30500,69,6540
0.008,17,4,398,2,46,5,46,148,2,97,4,103,250
1782.411,17,277,56489,277,175,6458,358,56489,0,0,0,0,0
1733.656,1,47,6713,47,114,37688,351,6713,0,0,0,0,0
1.913,6,25,8763,15,285,136,587,1459,10,985,191,1420,7304
0.035,17,2,317,1,43,0,43,71,1,218,0,218,246
1761.937,6,96,7255,62,38,28884,205,4424,34,33,53385,98,2831
9.824,6,17,6631,9,275,1228,275,643,8,1414,1240,1414,5988
469.081,6,4418,4405549,1531,385,306,420,89650,2887,1446,162,7190,4315899
1763.625,2,15,480,15,8,125973,8,480,0,0,0,0,0
0.054,6,7,423,4,43,5,43,259,3,0,21,0,164
1769.421,1,58,4872,58,56,31042,56,4872,0,0,0,0,0
1744.792,6,95,7203,63,38,28141,205,4476,32,33,56271,98,2727
1724.471,17,12,498,11,14,172447,14,462,1,8,0,8,36
270.69,6,16,1144,9,34,33821,38,638,7,35,45094,40,506
27.297,6,5,310,3,31,13569,31,187,2,31,27297,31,123
1.775,6,53,21408,29,901,63,1360,15627,24,400,69,1360,5781
0.57,6,20,7165,12,318,51,599,1905,8,1209,80,1906,5260
61.825,6,70,46577,43,1167,1472,1408,38437,27,747,2368,1408,8140
1777.832,17,140,11200,70,48,25765,48,5320,70,56,25765,56,5880
2.102,6,321,291635,210,260,10,517,13841,111,2666,18,9856,277794
1.836,6,31,6879,16,588,122,1360,4814,15,290,116,383,2065
0.065,17,2,363,1,29,0,29,57,1,278,0,278,306
0.446,6,12,1653,6,288,85,288,548,6,426,50,434,1105
1786.592,6,105,8610,70,66,25892,66,5110,35,60,52534,60,3500
0.913,6,26,14731,14,534,70,1288,2194,12,1505,62,3136,12537
0.007,17,2,128,1,36,0,36,64,1,36,0,36,64
1707.677,1,8,448,8,28,243953,28,448,0,0,0,0,0
0.178,17,2,2754,2,1349,178,1349,2754,0,0,0,0,0
3.086,17,3,1167,3,361,1543,361,1167,0,0,0,0,0
1.139,6,32,26475,20,679,59,1360,4227,12,2719,82,6800,22248
26.019,6,35,9209,16,321,1723,721,2894,19,555,1436,1440,6315
20.758,1,4,224,4,28,6919,28,224,0,0,0,0,0
1745.366,6,104,8203,68,45,26050,205,5044,36,35,49855,98,3159
103.745,6,20,9181,11,514,87,1236,2014,9,1359,12944,3639,7167
1792.635,1,250,14000,250,28,7199,28,14000,0,0,0,0,0
369.469,6,18,1239,14,177,28420,177,913,4,110,33471,110,326
0.504,17,3,451,2,39,267,39,134,1,289,0,289,317
25.437,6,2104,1977815,1301,1438,19,1448,1929043,803,776,31,1448,48772
1787.897,6,356,22520,208,69,8637,69,12460,148,69,12162,69,10060
252.846,6,68,48397,45,1190,5746,1408,40467,23,840,2801,2439,7930
0.52,6,27,6154,14,164,40,453,1570,13,648,40,2176,4584
0.819,6,20,5991,11,285,81,555,1299,9,721,92,1452,4692
0.01,17,2,394,1,30,0,30,58,1,308,0,308,336
236.938,17,4,1312,4,300,78979,308,1312,0,0,0,0,0
962.588,2,7,224,7,8,160431,8,224,0,0,0,0,0
2.21,6,12,1402,7,304,368,304,968,5,83,484,83,434
0.487,6,2,80,1,0,0,0,40,1,0,0,0,40
37.096,17,5,380,5,48,9274,48,380,0,0,0,0,0
366.887,6,27,1767,18,177,21581,177,1181,9,110,8550,110,586
0.013,6,9,1930,5,666,3,666,934,4,780,4,780,996
0.09,17,2,334,1,39,0,39,67,1,239,0,239,267
240.779,6,56,18727,30,795,8302,1418,15891,26,183,9630,580,2836
1795.742,6,356,22520,208,69,8675,69,12460,148,69,12215,69,10060
12.189,17,10,2105,5,47,3043,47,375,5,318,3043,318,1730
1771.895,6,180,15480,120,69,14889,69,8940,60,69,30030,69,6540
0.247,17,3,451,2,39,186,39,134,1,289,0,289,317
193.005,6,95,68824,61,1238,3216,1408,58920,34,677,2360,1408,9904
1773.976,17,140,11200,70,48,25709,48,5320,70,56,25709,56,5880
1.801,6,9,527,5,43,450,43,311,4,0,564,0,216
0.05,17,4,284,2,32,0,32,120,2,54,2,60,164
1791.485,1,342,28728,342,56,5253,56,28728,0,0,0,0,0
9.235,2,2,64,2,8,9235,8,64,0,0,0,0,0
7.471,17,6,528,3,48,3706,48,228,3,72,3664,72,300
4.187,1,3,168,3,28,2093,28,168,0,0,0,0,0
1750.74,1,56,4704,56,56,31831,56,4704,0,0,0,0,0
1744.301,6,95,7203,63,38,28133,205,4476,32,33,56257,98,2727
2.224,6,14,2351,8,188,317,245,700,6,703,392,1152,1651
51.154,17,8,2688,8,308,7307,308,2688,0,0,0,0,0
6.072,17,6,1219,3,47,3029,47,225,3,303,3031,318,994
1112.346,17,219,16644,219,48,5102,48,16644,0,0,0,0,0
1781.94,6,357,22698,208,69,8608,69,12460,149,69,12040,69,10238
0.39,17,2,152,1,48,0,48,76,1,48,0,48,76
1787.244,17,87,3648,86,14,21026,14,3612,1,8,0,8,36
1632.264,1,10,1080,10,80,181362,88,1080,0,0,0,0,0
0.029,17,2,152,1,48,0,48,76,1,48,0,48,76
1798.837,17,448,39896,403,35,4474,288,25676,45,288,40020,288,14220
1799.999,6,222,19206,82,77,21851,339,8581,140,69,12949,1062,10625
1786.629,6,106,8456,68,65,26666,65,4930,38,59,48284,59,3526
1.067,6,23,7952,11,164,90,267,1236,12,1014,82,2411,6716
1783.842,6,412,24829,204,69,8787,69,12300,208,34,8617,69,12529
0.224,6,41,16541,23,969,10,1420,11600,18,420,12,1420,4941
1.238,17,4,368,2,32,903,32,120,2,96,1024,96,248
2.65,6,13,2311,8,188,378,245,700,5,1407,599,1407,1611
280.136,6,28,7352,13,158,23344,267,1317,15,678,20005,4200,6035
5.527,6,41,7349,21,218,276,314,3463,20,513,276,1179,3886
618.597,6,66,8091,36,100,15071,722,3587,30,133,21324,1408,4504
1799.987,6,161,16797,86,77,21176,721,7221,75,146,23493,1440,9576
10.949,6,364,390730,113,687,97,1402,14847,251,1524,43,4206,375883
1789.174,17,142,11360,71,48,25559,48,5396,71,56,25559,56,5964
15.502,17,19,14390,12,985,1406,1350,12157,7,291,2577,1350,2233
64.011,6,38,9296,16,327,162,1189,2615,22,413,3047,1460,6681
219.881,17,4,352,2,60,219880,60,176,2,60,219880,60,176
701.616,6,42,3416,28,65,25985,65,2030,14,59,53963,59,1386
0.048,6,10,1514,5,503,11,503,771,5,475,12,475,743
1791.582,17,180,14040,180,50,10008,50,14040,0,0,0,0,0
1670.33,1,8,448,8,28,238618,28,448,0,0,0,0,0
4.747,17,23,14874,10,510,527,1350,5388,13,701,373,1350,9486
0.404,6,24,8922,13,263,33,691,1736,11,1321,38,4314,7186
0.782,17,2,925,1,548,0,548,576,1,321,0,321,349
1792.337,6,356,22520,208,69,8658,69,12460,148,69,12192,69,10060
1487.416,1,194,10864,194,28,7706,28,10864,0,0,0,0,0
8.576,6,80,24725,40,560,219,1152,18968,40,461,213,1179,5757
196.423,6,20,5402,10,404,21824,722,2550,10,1164,7700,1448,2852
599.205,6,9,546,6,31,119841,31,333,3,31,299575,31,213
40.233,6,2156,1713438,1198,1363,33,1380,1663256,958,421,41,1923,50182
240.203,6,56,18184,31,758,8006,1408,15272,25,200,10008,580,2912
0.01,17,2,322,1,36,0,36,64,1,230,0,230,258
299.902,6,8,475,5,31,74975,31,262,3,31,149880,31,213
5.101,17,4,288,2,36,5058,36,128,2,52,5070,52,160
280.611,6,32,7853,14,158,21585,267,1357,18,524,16505,1400,6496
125.369,6,14,3144,7,92,20894,92,452,7,464,20866,1408,2692
3.716,17,4,352,2,48,3707,48,152,2,72,3707,72,200
0.161,6,12,4475,7,290,26,517,941,5,1633,38,2686,3534
304.977,17,8,2688,8,308,43568,308,2688,0,0,0,0,0
1781.763,6,358,22669,209,69,8566,69,12500,149,69,12038,69,10169
11.82,6,93,27109,49,555,246,1152,20867,44,407,268,1152,6242
661.729,2,11,352,11,8,66172,8,352,0,0,0,0,0
0.04,6,2,123,1,0,0,0,40,1,31,0,31,83
242.612,6,64,25374,32,171,7826,517,3286,32,850,7826,3821,22088
882.093,2,6,192,6,8,176418,8,192,0,0,0,0,0
190.68,6,70,15159,27,224,7333,1189,3331,43,348,4536,1917,11828
0.052,1,6,624,0,0,0,0,0,6,76,10,76,624
4.844,6,22,5040,11,137,484,267,1132,11,577,456,1400,3908
1.663,6,27,10183,16,285,110,589,1501,11,1029,149,1420,8682
1745.236,17,13,2522,13,166,145436,166,2522,0,0,0,0,0
1748.328,6,95,7203,63,38,28198,205,4476,32,33,56384,98,2727
471.436,6,21,1615,10,65,24037,65,725,11,45,47135,59,890
2.383,6,13,2311,8,188,340,245,700,5,1407,533,1407,1611
0.527,17,8,2758,8,316,75,355,2758,0,0,0,0,0
23.843,6,23,6180,14,117,1834,159,1337,9,873,2977,1675,4843
485.169,17,4,910,4,199,161723,361,910,0,0,0,0,0
4.974,1,10,280,10,0,0,0,280,0,0,0,0,0
1793.86,1,251,14056,251,28,7175,28,14056,0,0,0,0,0
0.818,17,4,580,2,40,786,40,136,2,194,782,194,444
178.535,17,14,1120,7,48,29754,48,532,7,56,29754,56,588
352.559,6,19,6393,2,106,550,106,194,17,367,22034,1460,6199
1783.814,6,355,22480,207,69,8659,69,12420,148,69,12134,69,10060
15.315,17,14,5096,6,364,3048,1350,2353,8,314,2175,1350,2743
1786.734,6,106,8524,68,66,26667,66,4964,38,60,48287,60,3560
41.154,6,17,3903,3,92,107,92,256,14,242,3151,1408,3647
1.254,17,6,552,3,32,499,32,180,3,96,479,96,372
3.418,6,14,1758,7,503,569,503,895,7,475,569,475,863
14.228,6,14,2245,8,211,2030,211,846,6,545,2845,904,1399
18.754,6,31,13630,17,928,1172,1360,6320,14,962,1428,2720,7310
300.778,6,43,8926,18,308,17684,889,1987,25,311,12526,1360,6939
1779.844,17,140,11200,70,48,25794,48,5320,70,56,25794,56,5880
1773.021,6,181,15589,120,69,14899,69,8940,61,69,29545,69,6649
4.918,6,39,7269,20,218,258,314,3423,19,513,259,1179,3846
0.327,6,28,9036,13,234,27,575,1620,15,828,22,1408,7416
7.318,6,520,452307,221,924,33,1460,19043,299,1462,24,5840,433264
1785.927,6,102,8296,68,65,26655,65,4930,34,59,54115,59,3366
1.309,6,48,17473,27,886,50,1460,11812,21,480,56,4075,5661
0.205,6,46,21327,26,1089,8,1414,16306,20,467,10,1889,5021
12.626,6,14,1025,7,222,2101,222,506,7,231,2101,231,519
962.512,2,9,288,9,8,120314,8,288,0,0,0,0,0
11.457,6,7,466,0,0,0,0,0,7,31,1909,31,466
1770.975,6,27,4077,18,241,104175,241,2889,9,92,221349,92,1188
0.783,6,26,5649,12,140,71,267,1184,14,650,55,1420,4465
52.484,6,7,280,7,0,0,0,280,0,0,0,0,0
1.448,6,18,3257,10,99,141,182,924,8,477,181,1343,2333
66.582,6,27,7177,13,155,5548,267,1306,14,530,5120,3417,5871
0.376,6,29,10195,14,261,28,683,1792,15,951,25,1438,8403
1795.183,17,80,3354,79,14,23015,14,3318,1,8,0,8,36
541.417,2,6,192,6,8,108283,8,192,0,0,0,0,0
1772.078,6,180,15480,120,69,14891,69,8940,60,69,30034,69,6540
2.832,6,69,26290,38,968,76,1440,17139,31,463,88,1440,9151
33.177,6,2,104,2,0,0,0,104,0,0,0,0,0
1538.717,6,115,8009,68,59,22963,208,5292,47,31,33446,31,2717
0.016,17,2,221,1,35,0,35,63,1,130,0,130,158
3.768,6,13,3086,7,92,628,92,452,6,579,46,1448,2634
1082.926,2,9,288,9,8,135365,8,288,0,0,0,0,0
0.42,6,27,7296,12,155,38,267,1261,15,775,26,2760,6035
240.139,6,40,5197,19,181,13340,517,2099,21,222,12006,912,3098
300.758,6,39,8579,20,308,15829,888,2067,19,441,477,1460,6512
156.233,17,4,1344,4,308,52077,308,1344,0,0,0,0,0
14.898,6,66,20468,32,540,480,1152,15324,34,472,442,1179,5144
897.305,6,12,728,8,31,128186,31,444,4,31,298989,31,284
0.526,6,104,76948,57,339,9,339,3443,47,1578,10,2736,73505
6.659,6,38,7336,19,218,369,314,3383,19,455,355,1179,3953
2.766,17,22,10527,10,475,307,1350,5035,12,429,168,1350,5492
1.176,6,24,8004,12,164,91,267,1288,12,1014,90,2816,6716
1798.997,17,142,11360,71,48,25699,48,5396,71,56,25699,56,5964
11.882,6,1870,1640197,1138,1387,10,1420,1606696,732,467,16,1883,33501
1682.183,17,16,1265,8,30,240309,37,471,8,71,240305,136,794
0.613,6,6,248,4,0,204,0,164,2,0,333,0,84
0.351,6,24,7320,12,257,31,748,1663,12,837,31,1418,5657
12.407,6,14,2242,8,210,1772,210,844,6,545,2474,904,1398
49.772,6,42,8810,21,401,458,889,2124,21,416,2482,3488,6686
4.019,6,42,7405,22,218,191,314,3503,20,442,198,1152,3902
0.272,6,24,4571,12,165,24,456,1446,12,415,23,888,3125
0.8,17,2,154,1,33,0,33,61,1,65,0,65,93
1780.731,17,73,3060,72,14,25080,14,3024,1,8,0,8,36
1746.833,6,97,7307,63,38,28174,205,4476,34,33,52928,98,2831
1797.729,1,345,28980,345,56,5225,56,28980,0,0,0,0,0
31.48,6,20,3130,12,183,2861,517,1561,8,381,4495,499,1569
0.531,17,2,384,1,39,0,39,67,1,289,0,289,317
1797.314,17,448,39896,403,35,4470,288,25676,45,288,40022,288,14220
1741.498,1,56,4704,56,56,31663,56,4704,0,0,0,0,0
0.169,6,18,3068,9,282,21,531,1606,9,493,20,828,1462
1797.703,1,345,28980,345,56,5225,56,28980,0,0,0,0,0
241.668,6,47,8662,24,412,10506,1418,5791,23,205,10984,580,2871
22.987,17,4,352,2,48,22840,48,152,2,72,22970,72,200
0.852,6,20,5984,11,282,85,548,1292,9,721,95,1452,4692
630.131,2,4,128,4,8,210043,8,128,0,0,0,0,0
2.917,6,1314,1680815,541,214,5,230,30429,773,2088,3,13609,1650386
1789.544,6,365,23087,211,69,8521,69,12787,154,69,11696,69,10300
1782.562,6,354,22440,207,69,8653,69,12420,147,69,12208,69,10020
0.531,6,24,6076,12,181,48,537,1526,12,781,42,2224,4550
240.222,6,51,10275,26,220,9608,517,2901,25,433,10008,1501,7374
1.311,6,49,19163,27,884,50,1360,13507,22,433,54,1360,5656
9.24,17,4,824,2,48,9222,48,152,2,308,9218,308,672
78.596,1,6,336,6,28,15719,28,336,0,0,0,0,0
280.552,6,29,7392,13,158,23379,267,1317,16,678,18693,3456,6075
0.03,6,13,3980,7,88,4,88,388,6,1670,6,1880,3592
1.135,6,25,9512,13,164,81,267,1388,12,1248,88,4224,8124
0.955,6,29,8524,15,222,58,540,1988,14,852,59,1360,6536
280.285,6,27,7312,12,158,25480,267,1277,15,678,20018,2045,6035
1794.369,17,144,11520,72,48,25272,48,5472,72,56,25272,56,6048
22.173,6,9,527,5,43,5543,43,311,4,0,7355,0,216
1758.448,6,100,7866,66,45,27053,205,4902,34,35,53276,98,2964
1795.373,17,140,11200,70,48,26019,48,5320,70,56,26019,56,5880
240.217,6,53,18182,28,813,8896,1408,15287,25,198,10008,580,2895
0.334,17,8,2750,8,315,47,354,2750,0,0,0,0,0
0.139,17,4,350,2,34,1,34,124,2,85,120,91,226
0.256,6,7,423,4,43,70,43,259,3,0,27,0,164
1787.894,6,366,25072,212,93,8473,469,14565,154,69,11685,69,10507
0.064,6,2,92,1,0,0,0,52,1,0,0,0,40
4.745,6,41,7365,21,201,237,314,3463,20,516,236,1179,3902
3.695,17,2,656,2,300,3695,300,656,0,0,0,0,0
2.076,17,4,314,2,31,2064,31,118,2,70,2061,70,196
0.296,17,2,157,1,31,0,31,59,1,70,0,70,98
0.061,6,9,1339,5,145,15,145,349,4,826,17,826,990
457.11,6,63,4246,25,46,19046,46,1852,38,46,12350,46,2394
225.19,17,4,352,2,60,225189,60,176,2,60,225189,60,176
17.521,6,2615,2512147,1741,1367,9,1408,2462035,874,776,19,1408,50112
503.828,2,5,160,5,8,125957,8,160,0,0,0,0,0
7.79,6,12,871,7,275,1298,275,563,5,96,1440,96,308
0.079,17,4,352,2,37,39,37,130,2,83,42,89,222
1786.404,6,106,8524,68,66,26662,66,4964,38,60,48278,60,3560
0.172,6,44,21271,26,1090,6,1420,16330,18,467,9,1883,4941
64.114,17,18,1584,9,48,8013,48,684,9,72,8012,72,900
0.109,17,2,904,2,424,109,548,904,0,0,0,0,0
200.729,6,19,4208,9,296,25091,722,1353,10,388,22283,1408,2855
755.514,2,6,192,6,8,151102,8,192,0,0,0,0,0
1796.662,17,445,38948,403,35,4469,288,25676,42,288,40994,288,13272
0.979,6,28,8160,15,222,58,540,1964,13,944,66,1591,6196
0.09,6,12,1395,7,199,15,517,971,5,156,19,156,424
360.946,2,3,96,3,8,180473,8,96,0,0,0,0,0
1203.219,2,10,320,10,8,133691,8,320,0,0,0,0,0
2.885,17,2,312,2,128,2885,128,312,0,0,0,0,0
0.188,6,43,19410,25,1034,7,1420,14469,18,467,10,2840,4941
0.893,6,11,1727,7,100,148,100,384,4,589,211,1152,1343
1791.566,17,144,11520,72,48,25233,48,5472,72,56,25233,56,6048
1.229,6,23,7952,12,164,95,267,1288,11,1216,104,3819,6664
8.053,17,31,7811,15,296,572,1350,4866,16,156,533,1350,2945
300.803,6,23,7648,14,204,23138,467,1552,9,936,8227,2694,6096
4.098,17,2,668,2,306,4098,306,668,0,0,0,0,0
11.666,6,1857,1594034,1125,1362,10,1380,1560512,732,421,15,1923,33522
6.075,6,1594,1469619,1003,1387,5,1408,1434223,591,931,10,2801,35396
1787.719,6,104,8376,68,65,26682,65,4930,36,59,51073,59,3446
10.646,6,18,4266,10,275,1182,275,958,8,992,832,1440,3308
79.969,6,21,7438,10,216,8885,501,1270,11,715,7987,1420,6168
255.547,6,401,350884,269,1323,953,1368,328941,132,558,1813,1368,21943
5.664,6,40,7309,21,218,283,314,3463,19,513,300,1179,3846
10.3,6,9,527,5,43,2575,43,311,4,0,3431,0,216
1680.473,1,15,840,15,28,120033,28,840,0,0,0,0,0
3.5,17,5,290,5,30,875,30,290,0,0,0,0,0
1740.469,17,30,7050,30,207,60016,207,7050,0,0,0,0,0
3.248,6,26,7272,12,158,295,267,1277,14,678,248,2045,5995
1.301,6,45,18084,26,882,52,1360,12548,19,476,62,2715,5536
0.0,6,1,40,0,0,0,0,0,1,0,0,0,40
0.824,17,38,8329,38,191,22,220,8329,0,0,0,0,0
383.993,6,6,519,6,46,76798,62,519,0,0,0,0,0
233.105,6,27,1770,10,46,22581,46,722,17,46,14568,46,1048
16.1,6,24,7956,9,154,2012,267,832,15,651,1145,1420,7124
1133.043,2,9,288,9,8,141630,8,288,0,0,0,0,0
755.786,2,5,160,5,8,188946,8,160,0,0,0,0,0
1782.203,17,83,3480,82,14,22002,14,3444,1,8,0,8,36
61.32,6,35,15834,22,800,2920,1408,9159,13,855,5089,3847,6675
1749.844,17,13,534,11,14,174964,14,462,2,8,1749650,8,72
183.891,1,3,337,3,84,91945,89,337,0,0,0,0,0
7.006,6,4,240,4,0,0,0,240,0,0,0,0,0
0.638,6,23,5972,12,108,58,147,919,11,1152,61,2599,5053
3.249,17,3,1167,3,361,1624,361,1167,0,0,0,0,0
280.549,6,30,7432,13,158,23379,267,1317,17,603,17525,2076,6115
1793.191,17,83,3480,82,14,22138,14,3444,1,8,0,8,36
1.05,6,9,1186,4,302,347,302,812,5,102,261,102,374
1797.768,6,356,22520,208,69,8684,69,12460,148,69,12229,69,10060
61.289,6,11,674,6,43,12257,43,394,5,0,15312,0,280
34.848,6,31,5960,15,180,2489,721,1870,16,406,2308,2026,4090
1745.918,6,94,7151,62,38,28621,205,4424,32,33,56312,98,2727
0.027,17,4,420,2,33,19,33,122,2,121,19,145,298
11.331,17,3,984,3,300,5665,300,984,0,0,0,0,0
15.526,17,13,6699,7,613,2582,1350,4489,6,340,3098,1350,2210
1.153,6,14,3592,7,150,192,174,584,7,681,175,1452,3008
0.135,6,2,206,1,126,0,126,166,1,0,0,0,40
32.042,6,9,396,2,0,3484,0,88,7,0,5324,0,308
2.38,6,14,2351,8,188,340,245,700,6,703,423,1152,1651
1679.727,1,8,448,8,28,239961,28,448,0,0,0,0,0
1774.579,6,205,36974,121,256,14788,805,21665,84,182,21379,1402,15309
0.288,17,2,172,1,50,0,50,78,1,66,0,66,94
0.87,6,24,6420,13,299,72,842,2023,11,988,86,1731,4397
0.386,6,13,1693,7,288,63,288,588,6,426,42,434,1105
1786.569,6,356,22520,208,69,8630,69,12460,148,69,12153,69,10060
62.05,6,29,7257,13,155,5170,267,1306,16,441,4134,1420,5951
0.08,17,2,650,1,308,0,308,336,1,286,0,286,314
7.058,6,20,10480,6,275,1411,275,519,14,783,459,2007,9961
1741.258,17,29,6815,29,207,62187,207,6815,0,0,0,0,0
16.072,17,30,16904,16,632,1069,1350,10560,14,425,1233,1350,6344
280.483,6,29,7392,13,158,23373,267,1317,16,603,18696,2760,6075
378.516,6,17,1190,13,180,31543,180,864,4,110,20063,110,326
1.03,17,4,306,2,40,1006,41,137,2,56,1004,57,169
7.418,6,1373,1099180,717,1428,10,1448,1051760,656,776,11,1448,47420
1775.406,1,81,4536,81,28,22192,28,4536,0,0,0,0,0
1773.808,6,180,15480,120,69,14905,69,8940,60,69,30056,69,6540
1776.474,17,370,62596,370,141,4814,357,62596,0,0,0,0,0
2.698,17,2,136,1,32,0,32,60,1,48,0,48,76
99.48,6,22,8457,11,316,72,639,1420,11,940,9935,1460,7037
379.171,1,14,1176,14,56,29167,56,1176,0,0,0,0,0
0.963,17,4,1108,2,30,812,30,116,2,468,900,468,992
1771.547,6,99,9240,66,65,27254,65,5577,33,59,55357,59,3663
3.0,1,3,168,3,28,1500,28,168,0,0,0,0,0
295.318,6,43,6195,20,128,10543,722,2331,23,222,13414,1408,3864
1788.395,6,355,22480,207,69,8681,69,12420,148,69,12165,69,10060
3.033,6,5,346,1,0,0,0,52,4,31,1011,31,294
1772.44,6,180,15480,120,69,14894,69,8940,60,69,30040,69,6540
1652.509,1,7,392,7,28,275418,28,392,0,0,0,0,0
1790.152,17,22,1790,11,31,179014,37,652,11,75,179013,136,1138
22.675,6,232,101128,122,773,187,1152,92262,110,446,205,1179,8866
1682.886,17,14,1036,7,30,280473,30,406,7,62,280470,62,630
16.111,6,16,1327,8,222,2299,222,768,8,231,2299,231,559
1788.712,17,87,3648,86,14,21043,14,3612,1,8,0,8,36
233.687,17,4,352,2,60,233686,60,176,2,60,233686,60,176
0.83,6,26,5887,13,156,69,267,1462,13,650,61,1452,4425
1791.335,6,372,26526,213,104,8449,469,15543,159,69,11337,69,10983
0.011,17,2,435,1,37,0,37,65,1,342,0,342,370
266.363,17,4,352,2,60,266362,60,176,2,60,266362,60,176
50.091,6,28,7352,12,158,4553,267,1277,16,603,3336,1400,6075
1.156,6,29,9182,14,200,88,611,1739,15,830,79,1368,7443
1797.653,6,368,25759,214,99,8439,469,15045,154,69,11747,69,10714
541.469,2,5,160,5,8,135367,8,160,0,0,0,0,0
1763.801,6,105,8231,68,45,26325,205,5068,37,35,48985,98,3163
0.064,17,2,162,1,34,0,34,62,1,72,0,72,100
7.144,6,570,501563,364,1312,19,1368,486187,206,776,33,2736,15376
61.849,6,74,51196,46,1194,1374,1448,43012,28,746,2282,1448,8184
62.099,6,76,53121,47,1212,1349,1368,44881,29,747,2208,1368,8240
1786.79,17,87,3648,86,14,21021,14,3612,1,8,0,8,36
6.096,17,6,519,5,31,943,31,295,1,196,0,196,224
94.185,6,36,8153,12,141,2784,267,1335,24,292,4094,1460,6818
1.504,6,41,14907,24,706,65,1408,12567,17,206,93,580,2340
1756.349,17,339,78224,339,202,5196,422,78224,0,0,0,0,0
295.583,6,6,364,4,31,98527,31,222,2,31,295513,31,142
1794.846,17,87,3648,86,14,21115,14,3612,1,8,0,8,36
1774.206,6,180,15480,120,69,14909,69,8940,60,69,30067,69,6540
1740.645,17,29,6699,29,203,62165,203,6699,0,0,0,0,0
1.275,6,54,14512,25,549,53,1429,4908,29,421,44,1460,9604
1798.672,17,142,11360,71,48,25695,48,5396,71,56,25695,56,5964
1.133,6,10,968,5,256,281,256,460,5,304,281,304,508
280.215,6,28,7352,13,158,23351,267,1317,15,678,20012,3436,6035
280.224,6,30,7432,13,158,23352,267,1317,17,543,17511,1400,6115
13.893,6,2229,2031004,1365,1407,10,1448,1981142,864,702,15,1448,49862
0.056,17,2,186,1,41,0,41,69,1,89,0,89,117
1787.487,6,102,8364,68,66,26678,66,4964,34,60,54162,60,3400
161.505,6,164,131205,107,1285,1523,1408,118733,57,730,1605,3847,12472
33.601,6,25,4638,14,213,2584,597,1841,11,441,2951,1408,2797
1798.427,1,154,16324,154,78,11754,78,16324,0,0,0,0,0
1783.684,17,342,114912,342,308,5230,308,114912,0,0,0,0,0
280.308,6,31,7472,14,158,21562,267,1357,17,543,17515,1400,6115
300.692,6,37,8526,19,315,16705,882,2053,18,441,497,1440,6473
1681.951,1,7,392,7,28,280325,28,392,0,0,0,0,0
0.065,6,12,3702,6,170,12,170,490,6,964,11,1448,3212
1772.66,6,240,17880,120,69,14896,69,8940,120,34,14896,48,8940
260.283,17,4,352,2,60,260282,60,176,2,60,260282,60,176
1795.243,17,80,3354,79,14,23015,14,3318,1,8,0,8,36
7.292,6,5,220,1,0,0,0,44,4,0,2400,0,176
1775.017,6,153,16241,83,79,21646,722,6801,70,141,25718,1380,9440
1783.494,17,83,3480,82,14,22018,14,3444,1,8,0,8,36
1.574,6,50,19893,27,934,60,1460,14197,23,433,61,1460,5696
6.194,6,1007,851407,590,1362,10,1408,825059,417,776,14,1408,26348
1793.425,1,58,4872,0,0,0,0,0,58,56,31463,56,4872
1798.063,1,268,15008,268,28,6734,28,15008,0,0,0,0,0
215.853,17,4,240,2,32,215852,32,120,2,32,215852,32,120
1.672,6,29,10386,17,372,104,850,1802,12,1012,144,1420,8584
5.219,17,5,320,5,36,1304,36,320,0,0,0,0,0
1120.854,17,10,2745,5,30,280212,30,290,5,463,280212,463,2455
1765.274,6,78,3588,39,0,46454,0,2028,39,0,46454,0,1560
0.079,6,2,92,1,0,0,0,40,1,0,0,0,52
68.245,6,27,12938,15,519,56,884,2721,12,1215,6192,3928,10217
368.268,6,18,1242,14,180,28328,180,916,4,110,20064,110,326
1774.897,6,169,10342,87,46,20638,208,6163,82,31,21908,31,4179
1772.12,6,101,9410,66,66,27263,66,5610,35,60,52118,60,3800
1770.871,6,99,9240,66,65,27244,65,5577,33,59,55337,59,3663
377.309,6,21,1419,15,177,26950,177,989,6,110,12265,110,430
271.071,1,4,224,4,28,90357,28,224,0,0,0,0,0
0.217,17,4,580,2,40,0,40,136,2,194,0,194,444
49.59,6,35,9621,11,133,612,267,981,24,426,2155,1997,8640
526.11,17,31,10416,31,308,17537,308,10416,0,0,0,0,0
0.007,17,2,391,1,44,0,44,72,1,291,0,291,319
10.954,6,18,4266,10,275,1217,275,958,8,992,883,1440,3308
515.903,6,48,8216,25,122,16511,516,2348,23,247,23445,1452,5868
1.2,6,25,8068,12,164,92,267,1300,13,869,84,1408,6768
10.716,6,7,514,4,222,3571,222,386,3,0,5354,0,128
0.015,17,2,397,1,46,0,46,74,1,295,0,295,323
1795.28,17,215,49812,215,203,8389,422,49812,0,0,0,0,0
0.036,17,4,624,2,36,0,36,128,2,220,2,292,496
1741.306,17,30,20190,30,645,60045,645,20190,0,0,0,0,0
11.63,6,1866,1600536,1113,1382,10,1420,1566159,753,467,15,1883,34377
4.794,6,39,7269,20,218,252,314,3423,19,513,253,1179,3846
0.954,6,10,1687,7,100,159,100,384,3,1179,344,1179,1303
0.011,1,2,112,2,28,11,28,112,0,0,0,0,0
306.089,17,4,296,4,46,102029,46,296,0,0,0,0,0
178.33,17,4,352,2,60,178329,60,176,2,60,178329,60,176
1682.641,17,14,1036,7,30,280431,30,406,7,62,280432,62,630
0.062,17,8,1670,8,180,8,219,1670,0,0,0,0,0
0.179,6,23,7325,12,177,16,337,1342,11,1080,16,1588,5983
0.049,17,2,290,1,40,0,40,68,1,194,0,194,222
1786.509,17,83,3480,82,14,22055,14,3444,1,8,0,8,36
1.131,2,3,120,3,16,565,16,120,0,0,0,0,0
5.014,17,4,514,2,36,5005,36,128,2,165,5003,187,386
0.038,6,3,120,2,0,38,0,80,1,0,0,0,40
1780.854,6,349,31952,149,67,12031,659,11906,200,94,8948,1638,20046
4.257,6,38,7229,19,218,236,314,3383,19,513,222,1179,3846
1.632,6,15,3877,8,171,233,171,603,7,964,255,1448,3274
71.087,1,3,180,3,32,35543,32,180,0,0,0,0,0
140.598,6,17085,16427436,11057,1405,12,1448,16107692,6028,776,23,1448,319744
1799.988,17,448,39896,403,35,4477,288,25676,45,288,40019,288,14220
8.763,6,1362,1203237,853,1359,10,1420,1178502,509,427,17,1420,24735
0.935,6,10,1687,7,100,155,100,384,3,1179,344,1179,1303
141.33,6,59,29981,32,775,100,1360,11411,27,873,5430,1548,18570
65.137,6,9,484,4,0,21712,0,216,5,0,16155,0,268
97.093,6,34,9153,15,140,6935,267,1593,19,485,5391,1420,7560
3.15,17,23,7458,11,289,311,1350,3496,12,302,283,1350,3962
3.15,6,25,8068,12,164,267,267,1300,13,869,245,1368,6768
0.061,6,10,690,6,71,12,71,391,4,83,16,83,299
1.047,17,4,580,2,40,1016,40,136,2,194,1012,194,444
1.806,6,13,2311,8,188,258,245,700,5,1407,380,1407,1611
5.067,6,40,7309,21,218,253,314,3463,19,513,266,1179,3846
240.83,6,30,7432,13,158,20069,267,1317,17,543,15045,1400,6115
178.678,6,6,333,4,31,59559,31,222,2,31,0,31,111
1790.293,1,267,14952,267,28,6730,28,14952,0,0,0,0,0
216.224,17,4,352,2,60,216222,60,176,2,60,216223,60,176
29.499,6,31,10635,13,693,2458,1460,3325,18,469,1722,1460,7310
0.014,6,2,336,1,0,0,0,40,1,256,0,256,296
1504.043,2,16,512,16,8,100269,8,512,0,0,0,0,0
0.117,17,2,157,1,31,0,31,59,1,70,0,70,98
1795.38,6,357,22629,208,69,8673,69,12460,149,69,12130,69,10169
161.252,6,129,97663,81,1274,2015,1368,87042,48,811,2298,2736,10621
1.381,6,47,18707,26,924,55,1460,13091,21,433,58,1460,5616
1776.545,17,73,3060,72,14,25021,14,3024,1,8,0,8,36
0.844,6,20,5942,11,281,84,544,1288,9,715,94,1414,4654
1770.371,6,104,9648,68,65,26423,65,5758,36,59,50579,59,3890
1797.477,6,356,22520,208,69,8683,69,12460,148,69,12225,69,10060
317.054,6,62,13286,25,228,13210,1305,3545,37,294,8803,4649,9741
163.153,6,25,10208,12,549,69,1360,2709,13,995,13584,1360,7499
7.006,17,4,288,2,36,6957,36,128,2,52,6946,52,160
25.84,1,4,224,4,28,8613,28,224,0,0,0,0,0
13.069,6,18,9986,5,154,1163,182,540,13,891,1078,1360,9446
41.025,2,4,128,4,8,13675,8,128,0,0,0,0,0
1773.792,1,58,4872,58,56,31119,56,4872,0,0,0,0,0
1787.488,6,102,8296,68,65,26678,65,4930,34,59,54162,59,3366
0.007,17,2,515,1,137,0,137,165,1,322,0,322,350
275.792,6,77,53181,48,1212,5867,1368,44936,29,841,2208,2736,8245
19.99,17,3,192,3,36,9995,36,192,0,0,0,0,0
360.876,2,5,160,5,8,90219,8,160,0,0,0,0,0
8.607,6,35,8452,18,410,506,917,2020,17,478,527,2720,6432
1770.496,6,99,9108,66,63,27238,63,5511,33,57,55325,57,3597
37.422,6,27,7183,13,156,3118,267,1312,14,530,2877,3417,5871
11.017,6,18,5610,10,275,1224,275,958,8,1440,851,1440,4652
3.524,17,2,778,2,361,3524,361,778,0,0,0,0,0
0.315,6,27,9091,13,266,26,705,1750,14,943,23,1402,7341
4.052,17,31,16494,12,431,368,1350,5517,19,549,185,1350,10977
1791.117,6,441,26607,217,69,8292,69,13027,224,35,8031,48,13580
33.845,6,31,5093,15,154,2417,722,1858,16,342,2238,1448,3235
1.905,17,4,316,2,34,1001,34,124,2,68,1,68,192
0.17,17,2,167,1,39,0,39,67,1,72,0,72,100
0.959,1,2,112,2,28,959,28,112,0,0,0,0,0
9.728,6,2,260,0,0,0,0,0,2,90,9728,90,260
0.023,17,8,2454,8,278,3,317,2454,0,0,0,0,0
4.871,6,39,7269,21,218,243,314,3463,18,513,270,1179,3806
57.242,6,7652,7350833,4951,1405,11,1448,7205717,2701,931,21,2761,145116
1786.645,6,355,22342,206,69,8715,69,12311,149,69,12071,69,10031
0.074,17,4,284,2,32,35,32,120,2,54,40,60,164
0.053,6,2,88,1,0,0,0,40,1,0,0,0,48
1794.278,17,265,76636,265,261,6796,422,76636,0,0,0,0,0
0.434,6,56,23207,32,976,14,1380,16037,24,515,17,1923,7170
1740.53,17,29,30624,29,1028,62161,1028,30624,0,0,0,0,0
0.408,6,10,1992,5,288,96,288,508,5,424,55,434,1484
34.187,6,37,7619,18,154,2011,722,2051,19,457,1888,1408,5568
1.806,17,4,314,2,31,1788,31,118,2,70,1785,70,196
57.874,17,3,228,3,48,28937,48,228,0,0,0,0,0
1772.594,6,79,4160,40,26,45449,26,2106,39,26,46645,26,2054
1786.169,6,120,9516,75,66,24137,66,5376,45,60,40592,60,4140
1772.487,6,180,15480,120,69,14894,69,8940,60,69,30037,69,6540
1787.173,6,362,25519,210,99,8551,469,14885,152,69,11833,69,10634
0.567,6,23,4506,11,165,56,456,1394,12,493,44,888,3112
1789.207,17,83,3480,82,14,22088,14,3444,1,8,0,8,36
7.046,6,30,8848,13,155,587,267,1306,17,527,438,3417,7542
0.001,17,2,912,1,308,0,308,336,1,548,0,548,576
5.038,17,4,558,2,36,5034,36,128,2,187,5033,187,430
1.644,6,25,8056,12,164,131,267,1288,13,869,110,1448,6768
2.238,17,4,624,2,64,1887,64,184,2,192,2008,192,440
0.447,6,4,1037,2,0,220,0,104,2,853,230,853,933
1760.577,17,166,13918,154,30,11507,37,8974,12,384,154627,463,4944
8.208,17,4,1344,4,308,2736,308,1344,0,0,0,0,0
1740.164,6,87,6322,58,31,30529,31,3915,29,31,62147,31,2407
0.058,17,2,198,1,39,0,39,67,1,103,0,103,131
390.23,6,18,1242,14,180,30017,180,916,4,110,20068,110,326
280.325,6,29,7392,13,158,23360,267,1317,16,603,18687,2036,6075
25.15,17,16,1408,8,48,3591,48,608,8,72,3591,72,800
9.951,17,2,144,2,44,9951,44,144,0,0,0,0,0
0.471,6,23,5080,10,137,52,267,1092,13,692,35,1487,3988
70.31,17,4,240,2,32,70309,32,120,2,32,70309,32,120
1426.566,6,53,2756,26,0,54286,0,1352,27,0,54861,0,1404
264.204,17,4,288,2,36,264203,36,128,2,52,264204,52,160
3.026,17,8,1714,4,45,1001,45,292,4,327,1003,339,1422
0.08,17,5,380,5,48,20,48,380,0,0,0,0,0
1770.196,6,99,9306,66,66,27233,66,5610,33,60,55315,60,3696
35.263,6,2028,1623041,1133,1371,31,1380,1581127,895,421,39,1923,41914
0.008,17,4,352,2,37,2,37,130,2,83,1,89,222
0.368,6,27,8920,13,227,30,547,1592,14,941,26,1438,7328
1.761,6,202,147262,111,1371,16,1432,138914,91,389,17,1432,8348
23.445,6,3526,3190192,2188,1377,10,1408,3115892,1338,776,17,1408,74300
99.551,6,23,10757,9,514,264,1237,1967,14,911,7643,1360,8790
1.369,6,46,18886,26,875,54,1360,13319,20,528,62,2715,5567
0.87,6,20,5952,11,282,87,548,1292,9,716,97,1420,4660
4.055,1,5,420,5,56,1013,56,420,0,0,0,0,0
0.132,17,2,192,1,60,0,60,88,1,76,0,76,104
0.15,17,3,1008,3,308,75,308,1008,0,0,0,0,0
247.464,17,4,352,2,60,247463,60,176,2,60,247463,60,176
1.495,6,19,3781,10,234,166,564,1452,9,463,163,1343,2329
240.961,6,45,9157,22,524,11473,1418,5870,23,230,10952,618,3287
1.462,6,47,19574,27,920,56,1460,13998,20,529,65,4075,5576
1681.62,17,14,1036,7,30,280263,30,406,7,62,280264,62,630
83.171,17,4,352,2,60,83170,60,176,2,60,83170,60,176
1780.376,6,354,22440,207,69,8642,69,12420,147,69,12193,69,10020
1.371,6,45,15742,25,761,57,1360,10166,20,476,62,2715,5576
1.385,6,37,8315,19,337,76,1265,2819,18,476,71,2715,5496
1785.61,6,102,8296,68,65,26650,65,4930,34,59,54106,59,3366
22.321,6,25,4706,15,176,1594,517,2035,10,428,2479,499,2671
60.515,6,13,778,3,112,30245,112,240,10,90,6721,90,538
0.174,17,2,152,1,48,0,48,76,1,48,0,48,76
0.006,6,3,144,2,0,0,0,104,1,0,0,0,40
43.915,6,24,10230,8,402,6273,722,1530,16,671,2736,1380,8700
89.187,6,29,8832,13,158,7432,267,1317,16,763,5942,1781,7515
16.02,17,20,5579,10,303,1776,1350,3314,10,198,1776,1350,2265
240.519,6,42,8652,20,520,12655,1418,5736,22,252,11451,618,2916
1.5,17,2,178,1,29,0,29,57,1,93,0,93,121
6.827,6,16,3264,6,92,1365,92,400,10,579,662,1448,2864
0.243,17,2,384,1,39,0,39,67,1,289,0,289,317
0.673,6,10,924,5,283,125,283,551,5,105,125,105,373
317.052,6,41,11601,24,245,13784,1305,3442,17,829,19806,4649,8159
287.785,17,4,352,2,60,287784,60,176,2,60,287784,60,176
1700.494,17,12,498,11,14,170049,14,462,1,8,0,8,36
1756.786,6,184,11305,92,47,19305,208,6695,92,31,19302,31,4610
661.702,2,8,256,8,8,94528,8,256,0,0,0,0,0
1799.418,17,179,13962,179,50,10109,50,13962,0,0,0,0,0
6.237,6,40,7325,21,218,311,314,3463,19,516,331,1179,3862
14.922,6,2405,2029554,1334,1425,11,1448,1961218,1071,776,13,1448,68336
11.342,6,2342,2219392,1479,1421,7,1448,2169840,863,776,12,1448,49552
0.012,17,2,167,1,39,0,39,67,1,72,0,72,100
1.608,6,50,20117,28,887,59,1360,14461,22,476,66,2715,5656
1680.724,17,13,534,11,14,168053,14,462,2,8,1680524,8,72
300.229,6,32,11868,18,582,17660,1408,4463,14,952,18498,2816,7405
0.208,17,2,144,1,36,0,36,64,1,52,0,52,80
68.437,17,4,352,2,48,68426,48,152,2,72,68426,72,200
0.385,1,2,112,2,28,385,28,112,0,0,0,0,0
4.244,6,39,7269,19,218,235,314,3383,20,513,210,1179,3886
20.11,6,18,2368,10,189,2234,517,1298,8,323,2872,499,1070
10.911,17,1494,752894,1048,656,10,1108,717184,446,52,24,431,35710
0.454,6,15,1773,7,288,71,288,588,8,284,36,434,1185
23.902,17,2,152,2,48,23902,48,152,0,0,0,0,0
0.012,17,2,394,1,37,0,37,65,1,301,0,301,329
1779.739,17,142,11360,71,48,25424,48,5396,71,56,25424,56,5964
1.994,17,25,18969,12,668,181,1350,8357,13,788,98,1350,10612
0.022,17,2,162,1,36,0,36,64,1,70,0,70,98
0.832,6,27,5740,13,125,69,267,1275,14,650,58,1414,4465
1.403,6,53,20896,30,927,48,1360,15155,23,400,55,1360,5741
1740.494,17,30,20190,30,645,60017,645,20190,0,0,0,0,0
300.318,6,80,15978,40,260,7700,1109,6003,40,374,7700,2346,9975
19.66,6,2750,2534262,1707,1403,11,1448,2475362,1043,776,18,1448,58900
0.012,17,2,389,1,35,0,35,63,1,298,0,298,326
1797.175,17,1052,347117,498,600,3616,1350,312837,554,33,3249,1350,34280
1795.94,6,728,49188,364,31,4947,31,24613,364,31,4947,31,24575
61.845,6,71,47946,44,1172,1438,1448,39811,27,747,2369,1448,8135
0.03,17,2,263,1,36,0,36,64,1,171,0,171,199
288.94,6,30,7432,13,158,24078,267,1317,17,543,18056,1400,6115
1739.83,6,131,8211,73,47,24164,208,4992,58,31,30518,31,3219
0.368,6,26,8903,13,234,30,575,1620,13,942,29,1448,7283
280.465,6,28,7352,13,158,23372,267,1317,15,905,20030,4845,6035
240.25,6,55,17790,30,740,8284,1408,14893,25,198,10010,580,2897
535.635,6,79,11929,35,287,15752,1056,6724,44,160,12455,580,5205
163.484,6,70,48815,45,1201,3715,1408,40780,25,961,2569,3847,8035
0.553,6,28,7481,17,306,34,1088,2827,11,701,53,1696,4654
300.775,6,38,10300,21,657,15038,1360,4818,17,435,538,2720,5482
0.328,17,8,2750,8,315,46,354,2750,0,0,0,0,0
19.799,17,12,1056,6,48,3957,48,456,6,72,3957,72,600
35.723,6,32,8952,14,158,2747,267,1357,18,624,2099,1400,7595
13.778,6,25,4654,14,275,1059,275,1122,11,768,899,1440,3532
1744.66,2,26,832,26,8,69786,8,832,0,0,0,0,0
42.915,6,35,5437,15,154,3065,721,1870,20,252,2249,1408,3567
0.802,6,23,5529,12,140,72,267,1184,11,650,73,1414,4345
1738.297,1,59,4956,59,56,29970,56,4956,0,0,0,0,0
17.252,6,28,7352,13,158,1437,267,1317,15,678,1229,3436,6035
1785.859,6,374,23654,214,69,8384,69,13114,160,69,11231,69,10540
61.087,17,50,3830,25,40,2542,41,1715,25,56,2537,57,2115
0.343,6,27,8973,13,227,28,547,1616,14,827,24,1408,7357
1794.597,17,144,11520,72,48,25275,48,5472,72,56,25275,56,6048
0.01,17,2,322,1,46,0,46,74,1,220,0,220,248
1.559,6,49,19218,28,953,57,1460,13557,21,437,68,2615,5661
37.125,6,25,14816,8,192,4457,192,1200,17,1408,2319,1408,13616
1799.457,17,449,39928,404,35,4465,288,25708,45,288,40015,288,14220
1.953,17,22,5698,22,231,93,388,5698,0,0,0,0,0
1681.661,17,14,1036,7,30,280268,30,406,7,62,280269,62,630
1774.928,6,180,15480,120,69,14915,69,8940,60,69,30078,69,6540
5.16,6,7,400,3,0,2580,0,160,4,0,1020,0,240
1762.995,6,184,11274,92,48,19373,208,6664,92,31,19357,31,4610
1791.139,6,356,22520,208,69,8652,69,12460,148,69,12184,69,10060
1785.448,6,104,8444,68,66,26648,66,4964,36,60,51010,60,3480
1792.438,6,358,23021,209,69,8617,69,12500,149,74,12111,421,10521
0.064,2,3,96,3,8,32,8,96,0,0,0,0,0
1679.955,1,15,840,15,28,119996,28,840,0,0,0,0,0
0.013,17,2,167,1,39,0,39,67,1,72,0,72,100
1740.445,17,30,31620,30,1026,60015,1026,31620,0,0,0,0,0
1773.049,6,182,15698,120,69,14899,69,8940,62,69,29060,69,6758
2.419,6,731,1150729,360,215,6,230,21019,371,3009,6,25344,1129710
0.005,6,2,104,0,0,0,0,0,2,0,0,0,104
280.497,6,28,7352,13,158,23374,267,1317,15,678,20027,2760,6035
65.282,6,24,8056,12,378,51,799,1646,12,739,5923,2720,6410
1798.251,17,448,39896,403,35,4473,288,25676,45,288,40020,288,14220
564.104,17,8,616,8,49,80586,49,616,0,0,0,0,0
17.77,17,34,15390,16,418,1182,1350,7143,18,430,1043,1350,8247
31.571,6,6,360,0,0,0,0,0,6,0,0,0,360
10.64,6,2229,1945104,1272,1435,8,1448,1882152,957,776,10,1448,62952
1743.095,6,95,7203,63,38,28114,205,4476,32,33,56221,98,2727
283.074,6,31,7739,14,176,21774,267,1624,17,603,17690,1400,6115
1783.936,17,258,68851,258,238,6941,422,68851,0,0,0,0,0
52.554,2,2,64,2,8,52554,8,64,0,0,0,0,0
75.638,6,42,11269,21,374,3781,841,2668,21,416,3781,1548,8601
49.841,17,4,240,2,32,49839,32,120,2,32,49840,32,120
1718.377,1,120,6720,120,28,14440,28,6720,0,0,0,0,0
751.314,6,77,5475,42,66,18324,208,3672,35,31,22091,31,1803
4.427,6,39,7285,19,218,245,314,3383,20,442,219,1152,3902
0.681,2,4,160,4,16,227,16,160,0,0,0,0,0
0.019,6,2,133,1,0,0,0,40,1,53,0,53,93
0.105,17,2,181,1,32,0,32,60,1,93,0,93,121
1774.431,6,180,15480,120,69,14911,69,8940,60,69,30072,69,6540
1784.717,6,276,34095,113,140,15933,1360,16643,163,133,11015,2720,17452
3.859,17,4,240,4,32,1286,32,240,0,0,0,0,0
1730.229,6,64,4698,42,33,42200,33,2910,22,31,82382,31,1788
5.824,6,41,7349,21,218,291,314,3463,20,513,291,1179,3886
1788.764,17,142,11360,71,48,25553,48,5396,71,56,25553,56,5964
1.995,17,2,134,2,39,1995,39,134,0,0,0,0,0
227.632,6,29,7392,13,158,18969,267,1317,16,603,15172,2800,6075
6.176,6,1386,1280085,877,1383,6,1408,1248953,509,931,11,2816,31132
38.17,17,4,352,2,60,38169,60,176,2,60,38169,60,176
432.766,6,44,8164,22,127,18481,516,2162,22,255,20603,1452,6002
11.577,6,24,8413,13,275,964,275,1078,11,1147,830,2840,7335
676.95,17,22,7392,22,308,32235,308,7392,0,0,0,0,0
1797.866,1,248,13888,248,28,7278,28,13888,0,0,0,0,0
10.326,17,4,824,2,48,10300,48,152,2,308,10301,308,672
5.2,6,4,176,3,0,2600,0,128,1,0,0,0,48
1773.24,6,180,15480,120,69,14901,69,8940,60,69,30046,69,6540
202.427,6,5687,5025469,3457,1366,58,1368,4892735,2230,1124,90,2841,132734
297.519,17,4,352,2,60,297518,60,176,2,60,297518,60,176
1738.698,6,90,6521,59,31,29977,31,3998,31,31,57956,31,2523
1535.082,6,109,12722,64,85,23359,501,5120,45,148,34886,1420,7602
0.016,17,4,777,2,33,0,33,122,2,299,6,311,655
0.44,6,15,2451,8,325,62,587,1075,7,334,71,580,1376
550.905,1,25,1400,25,28,22954,28,1400,0,0,0,0,0
1771.609,6,99,9240,66,65,27255,65,5577,33,59,55359,59,3663
1723.849,1,8,448,8,28,246264,28,448,0,0,0,0,0
4.934,6,38,7245,19,218,274,314,3383,19,516,259,1179,3862
280.347,6,28,7352,12,158,25486,267,1277,16,603,18687,1400,6075
1770.524,6,99,9306,66,66,27238,66,5610,33,60,55326,60,3696
1740.447,17,30,6930,30,203,60015,203,6930,0,0,0,0,0
372.114,6,18,1242,14,180,28624,180,916,4,110,20064,110,326
1682.802,17,14,1036,7,30,280458,30,406,7,62,280459,62,630
2.038,17,2,144,1,36,0,36,64,1,52,0,52,80
169.384,17,4,352,2,60,169383,60,176,2,60,169383,60,176
27.01,6,75,20030,34,569,818,1163,8896,41,425,605,1440,11134
3.009,17,8,704,4,37,1001,37,260,4,83,998,89,444
8.136,6,1875,1752887,1171,1418,6,1440,1711615,704,776,11,1440,41272
1775.306,6,180,15480,120,69,14918,69,8940,60,69,30085,69,6540
72.715,17,20,1760,10,48,8078,48,760,10,72,8078,72,1000
27.667,6,48,13306,23,188,1257,721,2810,25,730,1145,1420,10496
0.354,17,2,290,1,40,0,40,68,1,194,0,194,222
19.492,6,305,223253,149,220,131,256,10802,156,1353,125,1657,212451
0.946,6,11,1727,7,100,157,100,384,4,589,226,1152,1343
1786.635,6,125,17201,79,145,22905,1287,8682,46,166,39700,1420,8519
1787.906,6,364,23047,210,69,8554,69,12747,154,69,11685,69,10300
15.107,17,11,4606,5,473,3769,1350,2508,6,321,3015,1350,2098
10.026,17,2,122,2,33,10026,33,122,0,0,0,0,0
37.038,17,4,240,2,32,37037,32,120,2,32,37037,32,120
4.529,6,39,7285,19,218,251,314,3383,20,516,224,1179,3902
1792.461,6,356,22520,208,69,8659,69,12460,148,69,12193,69,10060
1.39,6,11,1890,6,899,278,899,1219,5,403,347,403,671
0.097,17,4,364,2,52,1,52,160,2,74,51,80,204
5.065,17,4,288,2,36,5011,36,128,2,52,5031,52,160
0.061,6,12,3462,6,75,12,75,395,6,1373,12,1448,3067
1772.552,6,181,15589,120,69,14895,69,8940,61,69,29538,69,6649
8.764,6,80,25338,41,561,219,1152,19621,39,461,223,1179,5717
1787.102,6,102,8228,68,64,26673,64,4896,34,58,54151,58,3332
2.003,17,4,300,3,39,997,39,201,1,71,0,71,99
108.572,6,25,12764,15,830,58,1360,5613,10,1347,12044,4445,7151
1794.803,17,178,13884,178,50,10140,50,13884,0,0,0,0,0
0.974,6,10,1687,7,100,162,100,384,3,1179,361,1179,1303
1.362,6,131,103863,83,1347,16,1432,97643,48,428,22,1871,6220
0.424,6,25,8961,13,257,35,669,1714,12,1102,37,2804,7247
1.028,17,4,912,2,30,1014,30,116,2,370,1014,468,796
184.503,6,29,8832,13,158,15375,267,1317,16,763,12295,1781,7515
3.9,17,3,183,3,33,1950,33,183,0,0,0,0,0
1772.378,6,180,15480,120,69,14893,69,8940,60,69,30036,69,6540
16.004,6,91,28537,46,551,355,1152,22255,45,447,357,1179,6282
0.045,1,2,673,2,308,45,311,673,0,0,0,0,0
0.313,17,2,246,1,67,0,67,95,1,123,0,123,151
240.086,6,84,81366,32,175,7744,517,2725,52,1851,4707,4206,78641
240.338,6,43,8818,21,519,12016,1402,5776,22,210,11444,618,3042
35.208,6,32,8622,19,152,1956,318,2074,13,733,2933,1669,6548
508.229,6,92,14423,46,142,11293,1189,4988,46,189,11292,1420,9435
1.407,6,39,8294,19,321,78,1164,2718,20,433,64,1460,5576
1679.419,1,14,784,14,28,129186,28,784,0,0,0,0,0
1.373,6,24,8004,12,164,107,267,1288,12,1014,107,2491,6716
33.469,6,29,4989,14,180,2574,722,1806,15,342,2376,1408,3183
7.343,17,6,528,3,48,3667,48,228,3,72,3666,72,300
0.007,6,15,21040,1,0,0,0,40,14,1448,0,1448,21000
52.26,6,19,1319,13,43,4355,43,959,6,0,6201,0,360
368.705,6,25,1651,17,177,23044,177,1117,8,110,9190,110,534
8.08,6,41,8842,21,179,404,517,2401,20,597,351,2816,6441
15.384,6,27,4903,12,179,1398,722,1696,15,342,1065,1448,3207
0.303,6,26,6084,12,164,27,453,1442,14,558,22,1448,4642
11.205,6,20,4442,11,275,1120,275,998,9,768,780,1440,3444
859.999,6,74,9977,44,96,19999,501,3605,30,206,29650,1420,6372
0.391,6,79,53155,48,1234,8,1432,47624,31,427,12,1432,5531
248.973,6,28,7352,13,158,20747,267,1317,15,678,17781,3436,6035
1800.0,6,213,16806,78,73,22987,375,8029,135,49,13432,143,8777
183.278,6,55,9405,24,306,7968,1056,5230,31,195,6108,580,4175
1.429,6,249,195499,147,1342,9,1420,187128,102,475,14,1883,8371
1797.1,17,439,37620,401,35,4492,288,25612,38,288,47594,288,12008
1772.304,6,180,15480,120,69,14893,69,8940,60,69,30036,69,6540
3.182,17,6,1362,6,199,636,208,1362,0,0,0,0,0
1.611,6,9,527,5,43,402,43,311,4,0,536,0,216
0.048,17,4,608,2,60,9,60,176,2,188,15,188,432
0.071,17,2,152,1,48,0,48,76,1,48,0,48,76
39.864,17,22,1672,22,48,1898,48,1672,0,0,0,0,0
1681.724,17,14,1036,7,30,280282,30,406,7,62,280282,62,630
280.365,6,30,7432,13,158,23363,267,1317,17,543,17521,1400,6115
27.59,6,29,7257,13,155,2299,267,1306,16,441,1838,1420,5951
2.341,17,2,214,1,39,0,39,67,1,119,0,119,147
28.226,6,38,8341,19,345,1568,720,1827,19,441,481,1360,6514
128.677,6,41,11912,15,155,4668,267,1386,26,430,5145,2760,10526
1.94,6,50,19274,28,954,71,1460,13573,22,400,83,1460,5701
306.742,6,42,5790,21,302,15337,302,3516,21,83,15336,83,2274
1797.346,17,453,40168,406,35,4437,288,25812,47,277,38288,288,14356
31.883,6,63,43272,30,412,1099,517,2696,33,1253,907,1408,40576
1777.199,6,104,8477,68,52,26525,205,5276,36,36,50771,98,3201
252.265,17,104,4250,52,12,4903,58,2126,52,12,4946,56,2124
0.008,6,4,4017,1,0,0,0,40,3,1285,0,1414,3977
114.681,17,4,272,2,40,114680,47,136,2,40,114680,47,136
1787.105,6,111,8774,70,65,25900,65,5010,41,59,44674,59,3764
289.304,1,4,326,4,53,96434,78,326,0,0,0,0,0
0.4,6,17,2308,8,127,57,267,958,9,330,39,905,1350
1785.197,6,359,22709,209,69,8582,69,12569,150,69,11978,69,10140
11.266,6,1787,1556158,1081,1386,10,1420,1523697,706,420,15,1420,32461
0.028,17,2,2752,2,1348,28,1348,2752,0,0,0,0,0
1143.019,2,7,224,7,8,190503,8,224,0,0,0,0,0
4.034,17,7,7079,2,723,4034,1350,1503,5,1087,854,1350,5576
150.202,17,4,1344,4,308,50067,308,1344,0,0,0,0,0
0.348,17,2,152,1,48,0,48,76,1,48,0,48,76
1.394,17,20,6279,9,360,170,1350,3496,11,225,136,1350,2783
5.031,17,3,208,2,36,5006,36,128,1,52,0,52,80
50.683,6,60,27669,34,1191,329,1360,21733,26,348,2019,1360,5936
240.817,6,54,17877,28,802,8918,1418,15114,26,174,9632,580,2763
3.652,6,22,6411,11,262,358,517,1368,11,744,357,1368,5043
0.018,17,2,136,1,32,0,32,60,1,48,0,48,76
3.065,17,4,386,2,46,3058,46,148,2,91,2985,91,238
1774.022,6,181,15589,121,69,14783,69,9049,60,69,30066,69,6540
4.952,6,37,7189,19,218,275,314,3383,18,513,275,1179,3806
1681.85,17,14,1036,7,30,280301,30,406,7,62,280298,62,630
1771.799,6,182,15698,120,69,14889,69,8940,62,69,29045,69,6758
364.721,6,24,1868,17,180,22795,180,1276,7,110,10262,110,592
15.782,17,21,14386,12,978,1427,1350,12076,9,228,1963,1350,2310
1.319,6,51,21724,28,991,48,1440,16028,23,433,52,1440,5696
13.031,6,20,3497,12,211,1181,211,1082,8,665,1292,904,2415
1786.692,6,102,8296,68,65,26667,65,4930,34,59,54139,59,3366
130.331,6,17,1187,5,177,32582,177,445,12,110,11799,110,742
2.89,6,12,1671,6,279,578,279,587,6,191,472,272,1084
0.484,6,22,7342,13,335,40,668,2026,9,1210,55,1946,5316
1637.537,2,11,352,11,8,163753,8,352,0,0,0,0,0
280.254,6,29,7392,14,158,21558,267,1357,15,678,20013,3436,6035
0.527,17,14,5585,6,470,89,1350,2990,8,296,66,1350,2595
160.024,6,28,6752,13,274,13331,517,1508,15,744,11427,1418,5244
1776.871,6,185,15887,122,69,14684,69,9020,63,69,28656,69,6867
6.02,17,12,852,6,32,1201,32,360,6,54,1202,60,492
6.567,6,9,1562,6,597,911,1034,1438,3,0,3268,0,124
291.127,1,4,224,4,28,97042,28,224,0,0,0,0,0
1.335,6,47,18546,26,912,53,1460,12930,21,433,57,1460,5616
1790.227,6,357,22629,209,69,8606,69,12569,148,69,12176,69,10060
1773.569,1,58,4872,58,56,31115,56,4872,0,0,0,0,0
1797.042,6,367,25650,214,99,8436,469,15045,153,69,11822,69,10605
1770.997,6,101,9410,66,66,27246,66,5610,35,60,52084,60,3800
123.366,2,4,128,4,8,41122,8,128,0,0,0,0,0
11.244,17,6,8230,6,1343,2248,1347,8230,0,0,0,0,0
0.074,6,10,1495,5,507,18,507,727,5,556,18,556,768
0.053,17,4,398,2,46,0,46,148,2,97,0,103,250
300.627,6,45,8987,23,315,13664,882,2261,22,364,424,1460,6726
505.816,6,55,3577,31,47,16593,208,2338,24,34,21983,62,1239
0.505,17,4,768,2,39,499,39,134,2,289,14,289,634
1.399,6,47,19332,27,903,53,1360,13756,20,476,63,2715,5576
2.156,6,4,184,2,0,2156,0,88,2,0,0,0,96
4.739,6,39,7269,21,218,236,314,3463,18,513,263,1179,3806
10.987,6,20,4442,11,275,1098,275,998,9,768,751,1440,3444
1.056,17,4,624,2,64,900,64,184,2,192,923,192,440
126.02,2,2,64,2,8,126020,8,64,0,0,0,0,0
1786.869,6,102,8364,68,66,26669,66,4964,34,60,54143,60,3400
1799.378,6,367,25650,214,99,8447,469,15045,153,69,11837,69,10605
240.115,6,39,4764,20,181,12637,517,2151,19,202,13339,880,2613
241.385,6,153,125644,76,563,3218,1402,8476,77,1768,3176,4206,117168
574.922,6,89,12831,45,91,13066,267,4104,44,193,13369,1452,8727
1134.507,2,6,192,6,8,226901,8,192,0,0,0,0,0
0.011,1,2,220,2,82,11,88,220,0,0,0,0,0
300.809,6,47,11666,26,685,12032,1360,5917,21,349,429,2667,5749
280.181,6,28,7352,13,158,23348,267,1317,15,678,20010,2600,6035
1776.65,17,73,3060,72,14,25023,14,3024,1,8,0,8,36
1729.205,6,60,4400,40,33,44338,33,2740,20,31,91002,31,1660
0.121,17,2,198,1,39,0,39,67,1,103,0,103,131
1680.168,1,15,840,15,28,120012,28,840,0,0,0,0,0
280.17,6,28,7352,13,158,23347,267,1317,15,678,20010,2045,6035
1770.818,6,104,9815,68,69,26430,233,5914,36,59,50591,82,3901
280.264,6,28,7352,12,158,25478,267,1277,16,603,18681,1400,6075
189.547,6,75,49090,45,1201,4307,1368,40793,30,747,2129,1368,8297
157.474,17,6,2044,6,312,31494,376,2044,0,0,0,0,0
13.201,6,1757,1608924,1137,1366,11,1380,1577923,620,561,21,1923,31001
1.549,6,13,3939,7,171,252,171,714,6,1446,270,2675,3225
215.014,6,75,12018,39,160,5657,1189,4294,36,330,6141,3457,7724
0.23,6,88,97804,42,203,5,274,2803,46,2104,4,8448,95001
4.377,6,6,436,0,0,0,0,0,6,31,875,31,436
95.823,17,4,240,2,32,95822,32,120,2,32,95822,32,120
0.061,17,2,245,1,32,0,32,60,1,157,0,157,185
0.161,6,27,7296,13,155,13,267,1301,14,603,11,2800,5995
1795.396,17,447,39864,402,35,4477,288,25644,45,288,40018,288,14220
0.961,6,5,200,3,0,480,0,120,2,0,820,0,80
0.037,17,2,241,1,52,0,52,80,1,133,0,133,161
115.139,17,4,240,2,32,115138,32,120,2,32,115138,32,120
93.519,1,4,224,4,28,31173,28,224,0,0,0,0,0
1775.423,17,73,3060,72,14,25005,14,3024,1,8,0,8,36
486.207,6,32,2540,20,66,25589,66,1460,12,60,44181,60,1080
142.855,17,34,2825,34,55,4328,355,2825,0,0,0,0,0
0.864,6,26,5649,12,140,78,267,1184,14,650,61,1420,4465
1780.746,6,291,38515,120,159,14962,1360,19036,171,148,10474,4662,19479
240.268,6,53,14387,28,666,8898,1418,11468,25,201,10010,580,2919
2.041,17,4,580,2,40,2010,40,136,2,194,1997,194,444
0.523,6,20,7238,12,335,47,668,1974,8,1210,73,1906,5264
0.29,17,2,178,1,29,0,29,57,1,93,0,93,121
48.903,6,6185,5958982,4209,1340,11,1368,5851506,1976,776,24,1473,107476
1776.263,17,73,3060,72,14,25017,14,3024,1,8,0,8,36
37.118,17,4,524,2,39,37086,39,134,2,167,37086,167,390
10.347,6,122,86835,54,613,195,804,5887,68,1203,142,2864,80948
70.048,17,4,240,2,32,70047,32,120,2,32,70047,32,120
1680.23,1,14,812,14,30,129248,30,812,0,0,0,0,0
124.666,6,34,7935,12,155,27,267,1266,22,340,5936,3417,6669
7.596,6,9,602,3,112,3798,112,240,6,90,1481,90,362
1.992,17,3,468,3,128,996,128,468,0,0,0,0,0
7.108,6,7,300,3,0,3554,0,124,4,0,2366,0,176
0.301,6,27,9071,13,252,25,647,1716,14,945,22,1408,7355
833.743,1,11,1069,11,69,83374,88,1069,0,0,0,0,0
107.523,17,4,240,2,32,107521,32,120,2,32,107522,32,120
1769.976,1,188,10528,188,28,9465,28,10528,0,0,0,0,0
1793.709,1,70,7420,70,78,25995,78,7420,0,0,0,0,0
1798.459,6,356,22520,208,69,8688,69,12460,148,69,12234,69,10060
1786.631,17,87,3648,86,14,21019,14,3612,1,8,0,8,36
0.046,17,2,167,1,39,0,39,67,1,72,0,72,100
1788.085,6,356,22520,208,69,8638,69,12460,148,69,12163,69,10060
1784.513,6,102,8296,68,65,26634,65,4930,34,59,54073,59,3366
0.286,17,2,304,1,60,0,60,88,1,188,0,188,216
34.699,17,20,1760,10,48,3854,48,760,10,72,3854,72,1000
1754.781,1,102,5712,102,28,17374,28,5712,0,0,0,0,0
167.009,17,4,352,2,60,167008,60,176,2,60,167008,60,176
189.952,17,4,240,2,32,189951,32,120,2,32,189951,32,120
0.929,6,10,1687,7,100,154,100,384,3,1179,330,1179,1303
1788.958,6,255,46355,126,866,14311,1402,33476,129,61,13976,580,12879
275.521,6,28,7352,13,158,22960,267,1317,15,678,19657,2045,6035
1799.809,17,449,39928,404,35,4466,288,25708,45,288,40018,288,14220
1771.966,6,99,9306,66,66,27261,66,5610,33,60,55370,60,3696
187.306,6,43,6327,14,169,12363,722,1948,29,136,6682,2026,4379
3.759,17,5,295,5,31,939,31,295,0,0,0,0,0
1.339,6,49,20249,26,962,53,1440,14553,23,433,51,1440,5696
0.444,6,26,7256,13,155,37,267,1301,13,678,34,3436,5955
0.047,17,2,198,1,37,0,37,65,1,105,0,105,133
0.398,6,7,371,4,0,132,0,204,3,7,102,7,167
280.41,6,29,7392,13,158,23367,267,1317,16,775,18690,4836,6075
1.292,6,11,913,6,182,258,182,490,5,77,241,134,423
0.148,6,2,80,1,0,0,0,40,1,0,0,0,40
240.71,2,2,64,2,8,240710,8,64,0,0,0,0,0
0.121,17,2,152,1,48,0,48,76,1,48,0,48,76
38.11,17,22,1936,11,48,3810,48,836,11,72,3810,72,1100
0.034,17,2,389,1,128,0,128,156,1,205,0,205,233
841.367,17,8,592,4,30,280441,30,232,4,62,280437,62,360
0.313,6,28,9013,13,227,26,547,1604,15,827,21,1408,7409
1236.233,1,21,1176,21,28,61811,28,1176,0,0,0,0,0
1.143,6,25,6700,14,355,87,1113,2340,11,783,113,1420,4360
1725.502,17,12,498,11,14,172550,14,462,1,8,0,8,36
1740.919,1,15,840,15,28,124351,28,840,0,0,0,0,0
375.913,17,15,5550,15,342,26850,342,5550,0,0,0,0,0
1798.659,17,442,39136,398,35,4530,288,25232,44,288,40948,288,13904
843.236,17,10,2594,5,31,210806,37,297,5,431,210806,463,2297
4.07,17,5,290,5,30,1017,30,290,0,0,0,0,0
1681.517,17,14,1036,7,30,280250,30,406,7,62,280250,62,630
10.781,6,18,5610,10,275,1197,275,958,8,1440,785,1440,4652
1777.676,17,142,11360,71,48,25394,48,5396,71,56,25394,56,5964
0.46,6,19,7177,13,334,38,663,2021,6,1612,81,3314,5156
567.815,1,90,5040,90,28,6379,28,5040,0,0,0,0,0
20.015,6,27,7177,13,155,1667,267,1306,14,530,1538,3417,5871
0.033,17,2,128,1,28,0,28,56,1,44,0,44,72
374.04,6,25,1651,17,177,23377,177,1117,8,110,9223,110,534
0.524,17,18,13017,9,733,65,1350,6849,9,657,48,1350,6168
68.622,17,4,240,2,32,68621,32,120,2,32,68621,32,120
1794.301,17,265,58957,265,194,6796,356,58957,0,0,0,0,0
1627.189,1,8,448,8,28,232455,28,448,0,0,0,0,0
57.643,17,4,1344,4,308,19214,308,1344,0,0,0,0,0
336.397,1,4,464,4,88,112132,88,464,0,0,0,0,0
1.288,6,25,8080,12,164,99,267,1312,13,869,91,1408,6768
0.947,6,28,5893,14,123,72,267,1428,14,650,68,1420,4465
373.878,6,25,1651,17,177,23367,177,1117,8,110,9233,110,534
3.72,6,15,3195,9,49,465,92,563,6,579,44,2026,2632
6.782,6,476,416723,305,1304,21,1368,403167,171,931,38,2736,13556
2.048,6,52,22163,29,951,73,1360,16419,23,529,84,4075,5744
350.594,6,22,9648,7,154,42629,267,752,15,690,25041,1420,8896
11.339,6,2328,2265876,1559,1378,7,1408,2221224,769,931,14,2801,44652
1786.973,6,356,22520,208,69,8632,69,12460,148,69,12156,69,10060
0.34,6,23,5928,12,164,30,453,1442,11,781,31,2224,4486
0.191,6,10,1138,5,309,47,309,513,5,421,35,421,625
240.345,6,53,17575,28,778,8901,1402,14691,25,197,10014,580,2884
0.511,17,6,2069,6,316,102,354,2069,0,0,0,0,0
0.651,6,25,6081,13,108,54,147,959,12,773,58,1608,5122
208.601,17,4,352,2,60,208600,60,176,2,60,208599,60,176
38.499,6,27,7223,7,156,1356,267,758,20,402,2025,1452,6465
0.074,17,4,284,2,32,14,32,120,2,54,62,60,164
1796.156,6,397,25111,203,69,8891,69,12398,194,48,9306,69,12713
1.908,17,30,16534,17,639,116,1350,11355,13,370,156,1350,5179
0.446,6,12,2078,7,329,74,594,1018,5,396,108,580,1060
280.199,6,28,7352,13,158,23349,267,1317,15,678,20010,3536,6035
314.927,17,22,7376,22,307,14996,308,7376,0,0,0,0,0
1770.548,6,99,9306,66,66,27239,66,5610,33,60,55327,60,3696
0.562,6,34,7767,16,177,37,517,2623,18,465,30,1550,5144
0.228,17,6,460,3,40,0,41,206,3,56,56,57,254
13.29,6,24,6993,13,275,1107,275,1078,11,910,826,1420,5915
421.929,17,12,4032,12,308,38357,308,4032,0,0,0,0,0
1788.655,17,142,11360,71,48,25551,48,5396,71,56,25551,56,5964
10.02,17,2,142,2,43,10020,43,142,0,0,0,0,0
2.268,17,3,216,2,31,2240,31,118,1,70,0,70,98
0.021,17,2,224,1,52,0,52,80,1,116,0,116,144
1793.411,1,56,4704,0,0,0,0,0,56,56,32607,56,4704
0.011,6,2,746,1,666,0,666,706,1,0,0,0,40
1796.087,6,416,24920,208,69,8676,69,12460,208,34,8676,48,12460
1786.161,6,104,8444,68,66,26659,66,4964,36,60,51030,60,3480
240.481,6,56,24187,26,547,9619,1408,6284,30,960,8292,2810,17903
1681.542,17,14,1036,7,30,280255,30,406,7,62,280254,62,630
1631.709,1,7,392,7,28,271951,28,392,0,0,0,0,0
180.031,6,96,68013,58,1243,3158,1368,59004,38,841,1712,2736,9009
1.005,6,28,5893,14,123,77,267,1428,14,650,71,1414,4465
240.374,6,130,100427,78,214,3121,518,5592,52,1960,4713,7040,94835
0.881,6,21,5982,12,281,80,544,1328,9,715,98,1414,4654
158.043,6,29,9229,15,546,56,1331,2308,14,705,12146,1603,6921
1.5,6,47,18848,26,935,60,1460,13232,21,433,64,1460,5616
33.586,17,3,228,3,48,16793,48,228,0,0,0,0,0
27.448,6,1792,1680799,1176,1352,23,1368,1642129,616,950,44,2736,38670
0.272,6,10,1379,6,145,54,145,389,4,826,79,826,990
81.62,6,25,8431,9,153,10201,230,1113,16,499,5440,1408,7318
1782.694,6,353,22400,206,69,8696,69,12380,147,69,12210,69,10020
1799.299,1,56,4704,56,56,32714,56,4704,0,0,0,0,0
1682.779,17,14,1036,7,30,280457,30,406,7,62,280456,62,630
5.372,6,41,7349,21,218,268,314,3463,20,513,268,1179,3886
2.991,17,4,624,4,128,997,128,624,0,0,0,0,0
0.013,6,2,855,1,0,0,0,40,1,775,0,775,815
0.101,6,10,2115,6,597,19,1034,1438,4,513,33,513,677
0.524,17,2,154,1,33,0,33,61,1,65,0,65,93
1789.956,6,370,23425,213,69,8443,69,13005,157,69,11474,69,10420
1792.744,6,356,22520,208,69,8660,69,12460,148,69,12193,69,10060
14.975,6,21,5962,11,259,1496,326,1115,10,1435,1662,1448,4847
38.889,17,22,1936,11,48,3888,48,836,11,72,3887,72,1100
3.14,17,4,1560,4,362,1046,362,1560,0,0,0,0,0
64.566,6,12,927,4,177,113,177,393,8,110,9200,110,534
240.213,6,54,18004,29,789,8578,1402,14944,25,219,10008,580,3060
1787.093,6,102,8228,68,64,26673,64,4896,34,58,54147,58,3332
0.26,17,5,1810,5,334,65,355,1810,0,0,0,0,0
192.833,6,21,6347,9,154,24104,267,832,12,628,17498,1460,5515
0.119,6,12,2048,7,329,19,500,1030,5,750,29,750,1018
220.147,17,4,558,2,36,220142,36,128,2,187,220142,187,430
0.199,17,2,204,1,34,0,34,62,1,114,0,114,142
1796.921,17,449,39928,404,35,4458,288,25708,45,288,40020,288,14220
60.621,6,31,7809,14,135,4656,174,1242,17,534,3783,1452,6567
0.031,17,2,136,1,40,0,40,68,1,40,0,40,68
1796.705,6,395,24755,215,69,8395,69,12947,180,52,10037,69,11808
1786.315,6,113,9028,70,64,25888,64,5104,43,58,42529,58,3924
5.179,17,3,208,2,36,5003,36,128,1,52,0,52,80
1788.706,6,364,25392,212,100,8477,469,14896,152,69,11842,69,10496
1.95,17,2,672,2,308,1950,308,672,0,0,0,0,0
43.135,6,34,9073,14,328,76,1189,2541,20,440,2269,1420,6532
1.67,6,25,8709,15,276,119,560,1432,10,981,166,1420,7277
1616.521,1,7,392,7,28,269420,28,392,0,0,0,0,0
11.343,6,27,7177,13,155,945,267,1306,14,530,872,3417,5871
1.166,17,19,13289,11,989,113,1350,11196,8,233,161,1350,2093
1782.222,17,136,10880,68,48,26600,48,5168,68,56,26600,56,5712
141.731,6,51,35947,31,1241,31,1360,28586,20,935,7451,2720,7361
300.774,2,4,128,4,8,100258,8,128,0,0,0,0,0
0.055,6,10,2046,6,739,10,1322,1723,4,159,17,159,323
2.913,17,2,784,2,364,2913,364,784,0,0,0,0,0
1681.273,17,14,1036,7,30,280209,30,406,7,62,280209,62,630
1.866,17,6,540,3,30,916,30,174,3,94,916,94,366
4.346,6,39,7269,20,218,228,314,3423,19,440,226,1152,3846
0.078,17,4,368,2,35,0,35,126,2,93,35,99,242
3.648,6,2,88,2,0,0,0,88,0,0,0,0,0
5.342,6,595,509672,363,1339,14,1368,492932,232,776,22,2736,16740
280.233,6,29,7392,13,158,23352,267,1317,16,603,18680,2036,6075
1.702,6,9,1635,5,1104,425,1104,1308,4,159,566,159,327
0.428,17,2,154,1,33,0,33,61,1,65,0,65,93
1383.665,2,12,384,12,8,125787,8,384,0,0,0,0,0
35.172,17,40,5880,20,48,1850,48,1520,20,190,1850,308,4360
275.951,6,97,13637,40,205,7074,876,7021,57,128,4926,580,6616
0.319,17,5,1808,5,333,79,361,1808,0,0,0,0,0
1.347,6,48,19123,27,885,51,1360,13507,21,433,57,1360,5616
1.618,6,29,8722,14,283,109,625,2009,15,762,101,1360,6713
1785.731,1,207,21942,207,78,8668,78,21942,0,0,0,0,0
28.496,6,33,8267,20,129,1499,159,1979,13,622,2357,1418,6288
280.054,6,30,7432,14,158,21542,267,1357,16,603,18667,2036,6075
720.034,1,13,1571,13,92,60002,117,1571,0,0,0,0,0
1773.594,6,180,15480,120,69,14904,69,8940,60,69,30053,69,6540
130.637,17,6,1512,3,32,65314,37,181,3,415,65313,463,1331
0.811,6,2,1520,1,0,0,0,40,1,1440,0,1440,1480
267.857,6,55,3511,32,69,8640,69,1970,23,69,12175,69,1541
240.287,6,43,9011,21,519,12014,1402,5774,22,231,11441,617,3237
266.124,17,18,3720,18,178,15654,346,3720,0,0,0,0,0
1757.059,6,151,9321,80,44,22241,208,5489,71,31,25097,31,3832
0.353,1,10,280,10,0,0,0,280,0,0,0,0,0
1789.058,17,140,11200,70,48,25928,48,5320,70,56,25928,56,5880
0.166,6,46,21595,27,1034,6,1420,16614,19,467,8,1883,4981
42.328,1,48,4992,0,0,0,0,0,48,76,900,76,4992
1.527,6,49,18970,26,938,61,1460,13274,23,433,60,1460,5696
6.062,6,1786,1649850,1125,1388,5,1408,1610814,661,931,8,2801,39036
373.548,6,25,1651,17,177,23346,177,1117,8,110,9213,110,534
0.513,17,3,543,2,39,246,39,134,1,381,0,381,409
1.255,6,42,10602,21,514,62,1360,4986,21,433,53,1360,5616
100.339,6,22,900,10,0,11148,0,404,12,0,9121,0,496
1779.605,6,354,22440,207,69,8638,69,12420,147,69,12188,69,10020
0.024,6,2,421,1,0,0,0,40,1,341,0,341,381
176.467,6,19,8443,11,549,82,1308,2119,8,1498,25184,4511,6324
1744.732,2,26,832,26,8,69789,8,832,0,0,0,0,0
1749.02,6,99,7411,63,38,28210,205,4476,36,33,49963,98,2935
504.428,17,164,12389,93,40,5482,41,6380,71,56,7205,57,6009
60.36,6,10,648,10,31,6706,31,648,0,0,0,0,0
1.677,6,21,5402,12,125,151,212,986,9,675,208,1420,4416
1741.485,17,30,7050,30,207,60051,207,7050,0,0,0,0,0
165.514,6,19,780,7,0,4165,0,284,12,0,15045,0,496
2.016,17,3,2906,3,940,1008,1451,2906,0,0,0,0,0
1787.383,6,445,27193,225,69,7979,69,13485,220,39,8161,69,13708
1.121,6,24,8004,12,164,86,267,1288,12,1014,86,2804,6716
13.7,6,28,4956,14,154,1038,721,1855,14,394,1041,2026,3101
0.171,6,65,56957,25,273,7,517,2129,40,1465,3,4206,54828
0.006,6,2,170,1,0,0,0,40,1,90,0,90,130
685.005,6,106,14431,57,145,12232,1189,5773,49,257,7017,1917,8658
75.256,6,19,780,9,0,6173,0,364,10,0,8360,0,416
5.855,6,680,616488,437,1343,12,1368,599188,243,776,23,1473,17300
0.095,17,2,180,1,30,0,30,58,1,94,0,94,122
540.109,2,6,192,6,8,108021,8,192,0,0,0,0,0
1777.296,17,140,11200,70,48,25757,48,5320,70,56,25757,56,5880
20.334,6,21,5418,13,107,1694,159,1126,8,967,2898,1709,4292
78.404,6,16,16410,3,142,73,142,266,13,1420,6526,1420,16144
1682.332,1,15,840,15,28,120166,28,840,0,0,0,0,0
47.923,6,4,270,4,31,15974,31,270,0,0,0,0,0
11.164,6,6,328,4,0,3721,0,216,2,0,10931,0,112
1741.22,6,227,25202,113,77,15546,721,10327,114,251,15403,2007,14875
10.02,6,18,7388,7,154,1670,267,752,11,773,970,2840,6636
0.067,17,2,214,1,39,0,39,67,1,119,0,119,147
1679.615,1,7,742,7,78,279935,78,742,0,0,0,0,0
0.993,6,32,12964,17,525,62,1440,3350,15,818,58,1440,9614
367.266,6,23,1535,16,177,24484,177,1053,7,110,10372,110,482
0.965,17,4,624,2,64,964,64,184,2,192,866,192,440
1785.38,6,356,22520,208,69,8625,69,12460,148,69,12145,69,10060
1.686,17,19,7145,9,468,210,1350,4467,10,239,183,1350,2678
240.407,6,44,8448,22,449,11447,1418,5648,22,206,11447,580,2800
0.876,6,10,1687,7,100,146,100,384,3,1179,311,1179,1303
38.978,6,3,3831,3,1237,19489,1237,3831,0,0,0,0,0
36.859,6,40,8800,20,173,1939,721,2539,20,908,1886,1440,6261
1729.225,6,60,4400,40,33,44339,33,2740,20,31,91002,31,1660
0.016,17,4,344,2,47,0,47,150,2,69,5,75,194
0.063,17,2,235,1,36,0,36,64,1,143,0,143,171
95.278,6,29,12524,14,832,79,1360,4767,15,793,6793,1360,7757
0.639,6,17,1897,9,288,57,288,700,8,426,65,434,1197
1681.479,1,7,392,7,28,280246,28,392,0,0,0,0,0
1796.9,17,448,39896,403,35,4469,288,25676,45,288,40019,288,14220
0.882,6,11,1727,7,100,147,100,384,4,589,210,1152,1343
5.814,6,61,20651,30,878,200,1460,14435,31,381,182,1460,6216
1771.186,6,104,9644,67,66,26836,66,5728,37,60,49196,60,3916
1787.829,6,356,22520,208,69,8636,69,12460,148,69,12162,69,10060
677.351,6,45,7908,24,125,16439,501,2220,21,254,33863,1420,5688
401.004,6,82,12749,40,366,10282,1112,7244,42,173,9780,1186,5505
0.347,6,12,1653,6,288,65,288,548,6,426,38,434,1105
1781.371,17,142,11360,71,48,25447,48,5396,71,56,25447,56,5964
0.447,6,7,295,4,0,149,0,164,3,7,110,7,131
6.107,6,12,508,7,0,987,0,292,5,0,1468,0,216
0.439,6,7,371,4,0,146,0,204,3,7,106,7,167
315.961,6,99,15383,47,98,6868,615,4996,52,237,6192,4649,10387
0.31,17,2,225,1,37,0,37,65,1,132,0,132,160
1784.622,6,102,8228,68,64,26636,64,4896,34,58,54076,58,3332
1787.926,6,356,22520,208,69,8637,69,12460,148,69,12162,69,10060
10.964,6,20,4402,11,275,1096,275,998,9,758,776,1420,3404
1783.809,6,355,22480,207,69,8659,69,12420,148,69,12134,69,10060
75.433,6,13,540,6,0,2473,0,244,7,0,12570,0,296
1776.77,17,142,11360,71,48,25381,48,5396,71,56,25381,56,5964
13.638,6,101,32078,53,588,262,1152,25660,48,449,284,1179,6418
123.322,6,35,17648,19,583,344,1360,5486,16,1046,8211,3928,12162
94.072,6,25,8242,12,418,56,953,1792,13,657,7828,1360,6450
1720.509,17,12,498,11,14,172050,14,462,1,8,0,8,36
438.919,6,62,7591,26,109,17549,722,2673,36,117,12535,1408,4918
0.307,6,27,9047,13,252,25,647,1692,14,945,22,1408,7355
0.02,6,2,128,1,0,0,0,40,1,48,0,48,88
30.47,6,42,20202,19,160,1692,229,1822,23,1089,940,1440,18380
16.523,17,12,5217,6,490,3292,1350,3113,6,322,3289,1350,2104
1772.976,1,194,10864,194,28,9186,28,10864,0,0,0,0,0
0.175,6,2,1316,1,1236,0,1236,1276,1,0,0,0,40
12.519,6,15,2245,9,324,1564,585,1125,6,396,2387,580,1120
8.175,6,32,8010,12,169,743,267,1671,20,395,427,1460,6339
1796.352,6,356,22520,208,69,8678,69,12460,148,69,12219,69,10060
1740.461,17,27,6345,27,207,66940,207,6345,0,0,0,0,0
0.353,6,5,200,2,0,21,0,80,3,0,176,0,120
0.827,6,9,492,4,0,275,0,216,5,0,184,0,276
664.097,6,94,13298,53,94,12770,267,4691,41,198,16602,1460,8607
240.215,6,53,17837,28,793,8896,1408,14945,25,198,10008,580,2892
238.33,17,4,352,2,60,238329,60,176,2,60,238329,60,176
0.111,6,9,1340,5,145,27,145,349,4,827,27,827,991
1263.389,2,11,352,11,8,126338,8,352,0,0,0,0,0
2.054,17,4,314,2,31,2022,31,118,2,70,2008,70,196
1158.69,6,157,20204,80,79,14666,267,6470,77,149,15244,2006,13734
5.76,6,13,3121,6,92,1152,92,400,7,1164,861,1448,2721
1798.766,17,772,46624,772,32,2333,37,46624,0,0,0,0,0
4.61,17,4,240,4,32,1536,32,240,0,0,0,0,0
0.997,6,27,8456,15,222,60,540,2000,12,1192,73,4080,6456
1789.866,17,87,3648,86,14,21057,14,3612,1,8,0,8,36
1797.318,17,448,39896,403,35,4470,288,25676,45,288,40018,288,14220
1.433,6,37,8214,19,321,79,1164,2718,18,476,71,2615,5496
1783.555,6,102,6918,64,57,28310,208,4499,38,31,48188,31,2419
1.186,6,27,8591,15,236,72,625,2049,12,1210,89,2720,6542
1786.722,6,102,8296,68,65,26667,65,4930,34,59,54138,59,3366
945.46,6,115,7960,57,70,16880,208,5113,58,31,16584,31,2847
245.741,6,70,12968,30,198,8473,1189,3595,40,337,6300,1420,9373
12.341,6,6,328,4,0,4113,0,216,2,0,12323,0,112
1.657,17,3,1176,3,364,828,364,1176,0,0,0,0,0
1.378,6,46,18781,27,866,53,1360,13245,19,433,66,1360,5536
110.818,6,761,345739,379,832,293,1152,323148,382,384,290,1179,22591
29.495,6,34,9101,15,158,2106,267,1397,19,578,1635,1400,7704
1.241,6,26,8108,13,164,87,267,1340,13,869,87,1448,6768
1797.32,17,442,39704,397,36,4538,288,25484,45,288,40021,288,14220
1751.745,17,12,498,11,14,175174,14,462,1,8,0,8,36
2.265,17,4,1564,4,363,755,363,1564,0,0,0,0,0
79.864,6,27,10778,15,741,5704,1360,3598,12,1114,7246,2720,7180
1764.087,2,16,512,16,8,117605,8,512,0,0,0,0,0
3.204,17,5,290,5,30,801,30,290,0,0,0,0,0
1.463,6,50,20731,28,928,54,1440,15075,22,433,60,1440,5656
1.931,17,4,288,2,36,1905,36,128,2,52,1881,52,160
2.796,17,2,266,1,41,0,41,69,1,169,0,169,197
280.077,6,30,7432,14,158,21544,267,1357,16,603,18666,2036,6075
11.832,6,25,8473,13,275,986,275,1078,12,986,846,1440,7395
0.898,6,21,9222,11,514,89,1237,2015,10,970,72,1360,7207
1740.837,6,87,6322,58,31,30541,31,3915,29,31,62172,31,2407
41.68,17,6,528,3,48,20831,48,228,3,72,20832,72,300
0.059,6,11,913,6,182,11,182,490,5,77,4,134,423
0.118,6,10,1495,5,507,29,507,727,5,556,29,556,768
1.057,6,13,1182,7,146,175,146,430,6,254,209,506,752
14.93,6,27,4865,13,154,1206,722,1766,14,394,1126,1448,3099
1773.629,6,180,15480,120,69,14904,69,8940,60,69,30060,69,6540
217.922,6,71,15101,36,160,6226,267,3215,35,436,6406,2036,11886
1772.886,1,58,4872,58,56,31103,56,4872,0,0,0,0,0
48.947,6,24,1352,15,0,3496,0,820,9,0,4842,0,532
0.002,6,2,149,1,0,0,0,40,1,69,0,69,109
237.749,6,28,7352,13,158,19812,267,1317,15,678,16979,2045,6035
113.387,6,21,8712,11,314,80,634,1415,10,1147,12581,2720,7297
0.217,17,3,1008,3,308,108,308,1008,0,0,0,0,0
12.139,17,10,2240,5,46,3031,46,370,5,346,3031,346,1870
0.169,6,39,14432,22,863,8,1420,9531,17,467,10,1883,4901
1798.277,6,376,54181,178,268,10158,1360,34310,198,111,9127,2720,19871
1796.924,1,342,28728,342,56,5269,56,28728,0,0,0,0,0
0.506,17,17,10560,9,881,62,1350,8181,8,269,67,1350,2379
1794.362,17,179,13962,179,50,10080,50,13962,0,0,0,0,0
760.778,6,104,14182,53,92,14630,267,4622,51,166,15212,1460,9560
1789.443,6,366,23196,212,69,8480,69,12896,154,69,11695,69,10300
755.134,6,197,27645,84,222,9096,778,16080,113,123,6741,1062,11565
1.51,6,25,6084,13,108,125,147,959,12,772,110,1430,5125
1796.457,6,417,24965,208,69,8678,69,12460,209,34,8636,64,12505
1.918,17,2,312,2,128,1918,128,312,0,0,0,0,0
11.883,6,1882,1642073,1140,1386,10,1420,1608160,742,467,16,1883,33913
0.271,17,2,440,1,39,0,39,67,1,345,0,345,373
1.179,6,51,13829,24,551,51,1429,4840,27,464,44,1986,8989
0.037,17,4,352,2,37,0,37,130,2,83,0,89,222
31.64,6,6,280,2,0,31640,0,88,4,0,9450,0,192
4.183,6,18,4193,11,213,418,597,1649,7,724,665,1767,2544
1680.719,17,13,534,11,14,168053,14,462,2,8,1680527,8,72
280.431,6,27,7312,12,158,25493,267,1277,15,678,20028,2085,6035
369.646,6,18,1242,14,180,28434,180,916,4,110,20069,110,326
2.067,17,2,120,2,32,2067,32,120,0,0,0,0,0
17.38,6,21,7890,7,154,2896,267,752,14,657,1323,1452,7138
99.164,6,938,450940,502,830,197,1152,428709,436,398,227,1152,22231
1.012,6,24,8765,14,290,77,802,1753,10,1100,91,2920,7012
14.49,6,8,416,8,0,0,0,416,0,0,0,0,0
0.158,6,39,14963,22,916,7,1420,10062,17,526,9,3303,4901
1.147,17,23,13080,12,791,104,1350,9833,11,267,81,1350,3247
1503.966,2,18,576,18,8,88468,8,576,0,0,0,0,0
1799.499,1,57,4788,0,0,0,0,0,57,56,32133,56,4788
1.345,6,40,9928,21,440,67,1360,4392,19,476,63,2715,5536
280.227,6,29,7392,13,158,23352,267,1317,16,603,18678,2800,6075
167.384,6,58,37736,38,1118,4523,1408,29953,20,841,3233,2439,7783
0.307,17,4,352,2,60,306,60,176,2,60,306,60,176
240.217,6,52,17822,28,788,8896,1408,14867,24,242,10444,580,2955
404.064,6,68,4424,29,69,10777,69,1988,39,36,10632,69,2436
1775.819,1,76,6384,76,56,23677,56,6384,0,0,0,0,0
18.337,6,2994,2824955,1895,1411,9,1448,2763119,1099,776,16,1448,61836
153.612,17,4,352,2,60,153611,60,176,2,60,153611,60,176
18.923,6,16,3265,9,211,2365,211,910,7,665,3153,904,2355
1776.128,17,73,3060,72,14,25015,14,3024,1,8,0,8,36
1787.213,6,357,22629,208,69,8633,69,12460,149,69,12075,69,10169
1788.724,17,106,8480,53,48,34398,48,4028,53,56,34398,56,4452
43.383,6,6293,5937560,4116,1364,10,1408,5819558,2177,950,19,2801,118002
9.574,6,1145,1022563,694,1394,13,1448,994447,451,776,20,1448,28116
0.233,17,2,152,1,48,0,48,76,1,48,0,48,76
300.767,6,37,8431,20,291,15829,786,1997,17,478,534,2128,6434
230.346,17,8,1176,4,48,76778,48,304,4,190,76778,308,872
1786.191,17,140,11200,70,48,25886,48,5320,70,56,25885,56,5880
20.924,6,2177,1975128,1346,1387,15,1448,1927252,831,776,24,1448,47876
300.624,6,38,8595,21,308,15031,889,2131,17,481,529,3488,6464
1788.644,17,87,3648,86,14,21042,14,3612,1,8,0,8,36
33.996,17,20,1760,10,48,3776,48,760,10,72,3776,72,1000
1789.985,6,368,23345,212,69,8483,69,12965,156,69,11548,69,10380
1747.135,6,95,7203,63,38,28179,205,4476,32,33,56351,98,2727
1.311,6,47,18531,27,845,50,1360,12955,20,476,60,2715,5576
13.603,6,7,400,3,0,6801,0,176,4,0,3983,0,224
6.195,1,4,424,4,78,2065,78,424,0,0,0,0,0
1745.759,6,95,7203,63,38,28157,205,4476,32,33,56302,98,2727
0.332,6,22,7333,12,334,29,663,1969,10,806,36,1402,5364
0.285,6,20,7229,12,334,25,663,1969,8,1209,39,1906,5260
3.095,17,4,624,4,128,1031,128,624,0,0,0,0,0
300.296,6,31,12007,17,623,18768,1438,4633,14,829,18479,1438,7374
52.064,6,8,520,3,92,25447,92,256,5,0,12972,0,264
1797.94,17,448,39896,403,35,4472,288,25676,45,288,40017,288,14220
59.249,6,13,1807,6,100,124,100,344,7,1179,9834,1179,1463
1.231,6,7,288,4,0,410,0,164,3,0,396,0,124
111.756,6,14,1933,5,304,27939,304,876,9,83,13868,83,1057
1787.978,6,417,24960,209,69,8596,69,12500,208,34,8637,64,12460
0.191,6,46,21646,26,1036,7,1420,16625,20,420,9,1420,5021
3.196,17,4,518,3,39,836,39,201,1,289,0,289,317
1323.542,2,16,512,16,8,88236,8,512,0,0,0,0,0
1789.633,6,356,22520,208,69,8645,69,12460,148,69,12174,69,10060
224.069,17,4,240,2,32,224068,32,120,2,32,224068,32,120
1795.105,1,226,23956,226,78,7978,78,23956,0,0,0,0,0
1.351,6,32,12175,17,525,84,1360,3362,15,820,80,1380,8813
1744.695,2,29,928,29,8,62310,8,928,0,0,0,0,0
2.718,6,26,8521,16,175,181,362,1718,10,1045,235,2736,6803
280.475,6,28,7352,12,158,25497,267,1277,16,603,18692,1400,6075
0.06,17,4,284,2,32,0,32,120,2,54,6,60,164
1788.71,17,498,53065,241,131,7452,1350,38434,257,28,6987,60,14631
0.256,6,22,6633,10,181,23,267,1128,12,717,22,2036,5505
0.257,6,10,766,5,185,59,185,453,5,45,57,45,313
46.769,6,30,7432,13,158,3897,267,1317,17,543,2920,1400,6115
23.465,6,1394,1236096,904,1293,25,1368,1205952,490,776,47,1473,30144
1798.3,6,384,26744,220,97,8211,469,15699,164,69,11030,69,11045
296.31,6,51,9200,24,116,12879,517,2215,27,504,11393,1418,6985
1740.364,1,36,2016,36,28,49724,28,2016,0,0,0,0,0
0.119,17,4,284,2,32,0,32,120,2,54,0,60,164
0.204,17,2,572,1,39,0,39,67,1,477,0,477,505
1785.487,6,106,8524,68,66,26649,66,4964,38,60,48253,60,3560
9.298,17,2,778,2,361,9298,361,778,0,0,0,0,0
1787.906,6,357,22629,208,69,8637,69,12460,149,69,12080,69,10169
1771.982,6,180,15480,120,69,14890,69,8940,60,69,30032,69,6540
0.048,17,4,284,2,32,0,32,120,2,54,2,60,164
3.302,6,14,2351,8,188,471,245,700,6,703,609,1152,1651
12.113,6,6,328,4,0,4037,0,216,2,0,11801,0,112
1744.618,2,27,864,27,8,67100,8,864,0,0,0,0,0
1795.675,17,449,39928,404,35,4455,288,25708,45,288,40019,288,14220
234.451,17,6,360,3,32,117224,32,180,3,32,117225,32,180
280.267,6,29,7392,13,158,23355,267,1317,16,543,18683,1400,6075
0.92,17,2,136,2,40,920,40,136,0,0,0,0,0
374.834,6,103,13909,43,160,7277,1189,4454,60,163,6352,1420,9455
327.912,17,5,380,5,48,81978,48,380,0,0,0,0,0
0.224,6,3,120,2,0,224,0,80,1,0,0,0,40
43.416,17,439,461376,99,232,443,1350,25825,340,1253,127,1350,435551
1796.112,6,366,24603,213,87,8472,469,14136,153,69,11816,69,10467
0.584,17,2,167,1,39,0,39,67,1,72,0,72,100
29.979,17,4,256,4,36,9993,36,256,0,0,0,0,0
1680.005,1,14,812,14,30,129231,30,812,0,0,0,0,0
1791.419,6,748,50658,374,31,4802,31,25462,374,31,4802,31,25196
2.049,6,14,2351,8,188,292,245,700,6,703,356,1152,1651
8.403,6,22,9422,11,275,840,275,723,11,1178,604,1440,8699
1796.779,17,758,45714,758,32,2373,37,45714,0,0,0,0,0
1798.551,17,450,39960,405,35,4451,288,25740,45,288,40019,288,14220
0.005,17,2,499,1,33,0,33,61,1,410,0,410,438
244.964,6,68,28405,34,579,7418,1360,10130,34,889,7418,1595,18275
0.588,17,2,182,1,34,0,34,62,1,92,0,92,120
5.212,17,7,784,5,40,970,40,340,2,194,5159,194,444
0.509,6,23,7428,14,273,39,663,2104,9,1209,58,1946,5324
1.921,6,3,144,2,0,1921,0,92,1,0,0,0,52
0.427,6,26,9026,13,263,35,691,1736,13,943,34,1438,7290
1788.879,17,142,11360,71,48,25555,48,5396,71,56,25555,56,5964
12.124,6,8,440,5,0,3031,0,268,3,0,5775,0,172
1631.099,6,122,12106,70,66,23636,722,5850,52,84,31978,1408,6256
0.236,17,2,2746,2,1345,236,1345,2746,0,0,0,0,0
1.658,6,14,2351,8,188,236,245,700,6,703,281,1152,1651
0.0,17,3,1015,3,310,0,354,1015,0,0,0,0,0
0.759,6,23,5715,13,158,62,370,1315,10,999,83,1737,4400
0.287,6,2,1520,1,0,0,0,40,1,1440,0,1440,1480
1741.452,6,87,6322,58,31,30551,31,3915,29,31,62194,31,2407
1.71,6,14,2351,8,188,244,245,700,6,703,289,1152,1651
1.363,6,47,18165,26,882,54,1360,12549,21,476,58,2715,5616
2.488,17,2,136,1,32,0,32,60,1,48,0,48,76
23.604,17,21,8965,9,512,2946,1350,4860,12,314,2142,1350,4105
1791.213,1,200,11200,200,28,9001,28,11200,0,0,0,0,0
58.549,6,459,334682,224,161,262,517,13267,235,1338,250,4140,321415
1787.609,17,87,3648,86,14,21030,14,3612,1,8,0,8,36
1.13,6,23,7952,12,164,88,267,1288,11,1216,96,3819,6664
0.145,17,2,591,1,41,0,41,69,1,494,0,494,522
0.114,6,6,328,4,0,38,0,216,2,0,105,0,112
18.532,6,15,1065,8,222,2646,222,546,7,231,3087,231,519
1385.691,6,140,12017,92,69,15227,69,6923,48,69,29482,69,5094
0.363,6,7,1256,4,509,121,509,689,3,435,93,435,567
1780.488,6,124,7546,66,27,27392,27,3954,58,27,31217,27,3592
6.926,6,68,20286,33,565,216,1152,15459,35,427,196,1152,4827
1762.217,6,124,12253,76,62,23496,721,6286,48,91,37487,1368,5967
316.981,6,104,35906,55,553,5870,1360,24917,49,322,6601,3289,10989
10.396,6,86,24661,45,550,236,1152,18880,41,459,253,1179,5781
4.011,17,8,1288,4,33,1333,33,244,4,233,1333,233,1044
0.054,6,7,423,4,43,6,43,259,3,0,23,0,164
1277.266,17,1372,104138,752,40,1700,41,51629,620,56,2063,57,52509
1766.032,1,8,448,8,28,252290,28,448,0,0,0,0,0
62.619,6,82,52811,48,1159,1332,1368,44245,34,753,1889,2736,8566
267.479,1,16,1696,16,78,17831,78,1696,0,0,0,0,0
247.721,2,2,64,2,8,247721,8,64,0,0,0,0,0
2.123,6,41,17674,21,511,106,1460,3487,20,891,101,1460,14187
522.751,6,54,8747,27,110,14435,516,2626,27,264,20092,1452,6121
0.223,6,44,18356,24,1029,9,1432,13335,20,420,11,1432,5021
0.052,1,2,112,2,28,52,28,112,0,0,0,0,0
5.037,6,38,7229,20,218,265,314,3423,18,513,280,1179,3806
11.322,6,1798,1564204,1094,1376,10,1420,1531823,704,467,16,1883,32381
7.903,6,592,541877,386,1339,20,1368,526489,206,776,37,1473,15388
0.446,6,23,5975,12,108,40,147,919,11,922,43,2602,5056
90.499,17,4,240,2,32,90498,32,120,2,32,90498,32,120
1740.436,17,29,19517,29,645,62158,645,19517,0,0,0,0,0
53.733,17,4,1344,4,308,17911,308,1344,0,0,0,0,0
80.235,6,33,12006,16,281,755,632,1848,17,858,5006,1440,10158
1740.491,17,29,19517,29,645,62160,645,19517,0,0,0,0,0
68.14,6,22,4435,11,529,62,1322,2083,11,380,6802,1645,2352
1797.967,17,449,39928,404,35,4461,288,25708,45,288,40019,288,14220
0.069,17,2,146,1,37,0,37,65,1,53,0,53,81
1686.858,17,12,498,11,14,168685,14,462,1,8,0,8,36
59.344,17,6,456,6,48,11868,48,456,0,0,0,0,0
0.054,6,14,5792,7,135,8,135,507,7,1228,9,1448,5285
57.772,6,17,2349,9,324,7221,585,1125,8,396,8239,580,1224
277.971,17,4,244,2,33,277969,33,122,2,33,277970,33,122
1618.21,6,198,14886,76,65,21574,292,7055,122,48,13373,78,7831
1706.022,1,8,848,8,78,243717,78,848,0,0,0,0,0
1799.442,17,142,11360,71,48,25706,48,5396,71,56,25706,56,5964
6.227,6,1560,1445854,989,1384,6,1408,1411498,571,776,10,1408,34356
1680.379,1,15,870,15,30,120027,30,870,0,0,0,0,0
1740.542,17,28,6580,28,207,64464,207,6580,0,0,0,0,0
1766.887,17,102,8152,52,48,34644,48,3952,50,56,34512,56,4200
0.36,6,13,1693,7,288,58,288,588,6,426,39,434,1105
1780.461,6,362,22967,210,69,8518,69,12747,152,69,11790,69,10220
1799.638,6,368,25359,213,93,8488,469,14605,155,69,11684,69,10754
60.122,2,2,64,2,8,60122,8,64,0,0,0,0,0
1787.405,6,102,8364,68,66,26677,66,4964,34,60,54159,60,3400
0.328,6,9,1148,5,145,82,145,349,4,635,85,635,799
0.03,17,2,664,1,308,0,308,336,1,300,0,300,328
53.083,17,4,240,2,32,53082,32,120,2,32,53082,32,120
1.053,6,31,10074,16,229,60,583,2095,15,920,61,1360,7979
1680.719,17,28,29604,28,1029,62248,1064,29604,0,0,0,0,0
281.369,1,4,326,4,53,93789,78,326,0,0,0,0,0
0.189,17,2,152,1,48,0,48,76,1,48,0,48,76
280.306,6,28,7352,12,158,25482,267,1277,16,603,18684,1400,6075
0.499,6,25,6128,12,181,45,537,1526,13,651,38,1368,4602
1740.513,6,87,6322,58,31,30535,31,3915,29,31,62159,31,2407
57.264,17,8,2688,8,308,8180,308,2688,0,0,0,0,0
0.372,6,9,1340,5,145,93,145,349,4,827,93,827,991
240.246,6,53,17996,28,810,8897,1402,15240,25,181,10010,580,2756
0.811,6,10,1687,7,100,135,100,384,3,1179,273,1179,1303
1798.285,1,126,7056,126,28,14386,28,7056,0,0,0,0,0
70.23,17,4,240,2,32,70229,32,120,2,32,70229,32,120
10.262,17,4,5480,4,1342,3420,1347,5480,0,0,0,0,0
1.172,6,25,8056,12,164,90,267,1288,13,869,82,1448,6768
105.956,6,25,14564,14,534,72,1288,2194,11,1986,10576,4429,12370
10.772,6,20,4402,11,275,1077,275,998,9,758,758,1420,3404
188.104,6,45,8794,20,117,9900,267,1862,25,282,7830,1452,6932
1787.546,6,106,8388,68,64,26679,64,4896,38,58,48308,58,3492
1782.183,17,83,3480,82,14,22002,14,3444,1,8,0,8,36
0.055,17,2,144,1,36,0,36,64,1,52,0,52,80
9.127,6,884,815872,585,1326,15,1368,795660,299,776,29,1473,20212
0.836,17,2,152,1,48,0,48,76,1,48,0,48,76
0.078,17,2,362,1,32,0,32,60,1,274,0,274,302
11.577,6,24,9520,13,275,964,275,1078,11,1331,832,1420,8442
1770.043,6,106,9681,67,65,26818,65,5694,39,59,46577,59,3987
33.803,6,17,1231,9,53,4225,84,733,8,41,3327,51,498
0.034,1,4,416,0,0,0,0,0,4,76,11,76,416
1058.096,17,12,969,6,31,211611,37,355,6,74,211608,136,614
1681.277,17,14,3843,7,30,280212,30,406,7,463,280212,463,3437
0.073,17,2,672,2,308,73,308,672,0,0,0,0,0
20.33,17,61,40894,35,1012,597,1350,36428,26,143,811,1350,4466
1782.681,6,104,8376,68,65,26607,65,4930,36,59,50931,59,3446
1798.919,17,449,39928,404,35,4463,288,25708,45,288,40018,288,14220
1783.812,6,363,25352,211,100,8494,469,14856,152,69,11813,69,10496
1764.258,2,12,384,12,8,160387,8,384,0,0,0,0,0
42.43,6,30,7432,13,158,3535,267,1317,17,543,2649,1400,6115
1746.992,6,95,7234,62,38,28639,205,4424,33,33,54581,98,2810
4.879,6,38,7245,19,218,271,314,3383,19,516,257,1179,3862
0.178,6,46,22042,27,1064,6,1420,17061,19,467,9,1883,4981
0.023,17,2,672,2,308,23,308,672,0,0,0,0,0
20.145,6,22,5470,13,107,1678,159,1126,9,967,2517,1669,4344
0.046,17,2,152,1,48,0,48,76,1,48,0,48,76
280.378,6,30,7432,13,158,23364,267,1317,17,543,17514,1400,6115
4.354,6,16,1331,8,222,614,222,768,8,231,615,231,563
6.153,1,2,130,2,37,6153,37,130,0,0,0,0,0
0.185,6,22,6633,10,181,15,267,1128,12,717,16,2800,5505
0.452,6,12,1653,6,288,87,288,548,6,426,51,434,1105
0.262,17,2,440,1,39,0,39,67,1,345,0,345,373
1741.089,6,87,6322,58,31,30545,31,3915,29,31,62180,31,2407
8.066,6,68,20286,35,543,237,1152,15539,33,489,244,1179,4747
0.249,6,46,21042,26,1068,9,1420,16021,20,467,12,1883,5021
15.935,17,4,3100,4,747,5311,1451,3100,0,0,0,0,0
166.539,17,6,2046,6,313,33307,329,2046,0,0,0,0,0
1786.546,6,107,8428,68,64,26664,64,4896,39,58,47011,58,3532
1786.934,6,103,8401,69,65,26278,65,5035,34,59,54144,59,3366
716.81,6,294,175471,180,1208,4003,1448,155625,114,217,6342,1559,19846
280.204,6,28,7352,13,158,23350,267,1317,15,678,20010,4200,6035
24.948,6,14,1164,3,106,12474,106,234,11,90,2475,90,930
1785.3,1,212,11872,212,28,8461,28,11872,0,0,0,0,0
1790.822,17,316,24016,316,48,5685,48,24016,0,0,0,0,0
0.2,6,27,7296,13,155,16,267,1301,14,603,14,2800,5995
1790.073,6,451,36991,243,102,7396,1189,18868,208,136,8647,1460,18123
177.333,17,4,352,2,60,177332,60,176,2,60,177332,60,176
300.134,6,41,9953,22,579,14283,1440,4391,19,399,16664,1440,5562
0.169,6,23,7136,12,155,15,267,1261,11,905,16,4845,5875
0.353,6,9,1340,5,145,88,145,349,4,827,79,827,991
25.15,6,28,7833,11,245,2515,383,2408,17,592,1553,1152,5425
11.582,6,25,8453,13,275,965,275,1078,12,983,758,1420,7375
1680.623,17,12,498,11,14,168062,14,462,1,8,0,8,36
0.014,17,4,857,2,34,0,34,124,2,338,3,350,733
0.75,6,24,5569,12,140,68,267,1184,12,650,61,1452,4385
0.905,6,10,1687,7,100,150,100,384,3,1179,327,1179,1303
9.108,17,8,676,4,34,3034,34,248,4,79,3033,79,428
4.033,6,2,88,2,0,0,0,88,0,0,0,0,0
4.781,6,40,7309,20,218,251,314,3423,20,513,236,1179,3886
0.029,17,5,1032,3,60,9,60,264,2,356,18,356,768
280.081,6,29,7392,14,158,21544,267,1357,15,678,20002,3436,6035
829.289,1,102,10812,102,78,8210,78,10812,0,0,0,0,0
50.129,6,53,10639,25,533,804,910,3251,28,312,1851,1360,7388
1687.261,1,7,392,7,28,281210,28,392,0,0,0,0,0
180.433,2,3,96,3,8,90216,8,96,0,0,0,0,0
1795.371,17,80,3354,79,14,23017,14,3318,1,8,0,8,36
7.797,6,29,7126,16,282,519,613,2815,13,604,634,1408,4311
69.676,6,37,9325,15,155,4976,267,1386,22,391,3307,1420,7939
239.09,2,3,96,3,8,119545,8,96,0,0,0,0,0
1.819,17,29,15614,14,521,137,1350,7699,15,499,127,1350,7915
481.301,2,5,160,5,8,120325,8,160,0,0,0,0,0
0.018,17,2,510,1,37,0,37,65,1,417,0,417,445
1148.238,1,22,1848,0,0,0,0,0,22,56,54678,56,1848
64.777,6,12,927,4,177,118,177,393,8,110,9229,110,534
212.527,6,54,18335,30,768,7328,1418,15414,24,207,9239,580,2921
126.231,2,2,64,2,8,126231,8,64,0,0,0,0,0
145.472,17,4,1017,2,40,145446,47,136,2,412,145462,507,881
35.752,17,20,1760,10,48,3971,48,760,10,72,3970,72,1000
229.269,6,38,7523,18,248,13483,517,1959,20,642,12064,1418,5564
0.037,17,4,284,2,32,24,32,120,2,54,26,60,164
1006.985,17,61,4876,31,48,33565,48,2356,30,56,34723,56,2520
1744.689,2,19,608,19,8,96927,8,608,0,0,0,0,0
0.015,17,2,154,1,33,0,33,61,1,65,0,65,93
240.201,6,54,17930,29,789,8578,1408,14931,25,211,10008,580,2999
1743.089,6,99,7211,64,33,27668,96,4354,35,31,51260,33,2857
1799.821,6,221,38640,106,933,17141,1402,27907,115,52,15787,66,10733
1795.146,6,120,8702,72,31,25283,31,4944,48,31,38194,31,3758
0.115,17,2,184,1,32,0,32,60,1,96,0,96,124
14.007,17,16,3204,8,33,1998,33,488,8,311,1993,327,2716
1749.165,6,96,7286,63,38,28212,205,4476,33,33,54651,98,2810
1786.717,6,100,8027,65,65,27917,65,4680,35,59,52547,59,3347
1745.264,6,95,7203,63,38,28149,205,4476,32,33,56289,98,2727
1750.883,17,12,498,11,14,175088,14,462,1,8,0,8,36
0.116,17,2,2748,2,1346,116,1346,2748,0,0,0,0,0
1764.995,6,219,20835,108,79,16495,721,10034,111,171,16043,1440,10801
3.596,17,5,1160,5,204,899,204,1160,0,0,0,0,0
240.28,6,54,12942,27,568,9241,1418,9957,27,173,9241,580,2985
1747.051,6,95,7203,63,38,28178,205,4476,32,33,56345,98,2727
1.369,6,46,18579,26,917,54,1460,13003,20,433,61,1460,5576
3.741,17,2,656,2,300,3741,300,656,0,0,0,0,0
16.246,6,28,7352,13,158,1353,267,1317,15,678,1157,3436,6035
93.986,1,3,180,3,32,46993,32,180,0,0,0,0,0
352.659,6,20,6503,3,112,324,112,352,17,420,22040,1460,6151
1445.159,6,170,11676,63,46,23309,46,4958,107,46,13632,46,6718
1789.049,17,142,11360,71,48,25557,48,5396,71,56,25557,56,5964
0.113,6,10,1327,5,299,24,299,567,5,246,23,459,760
1744.662,2,16,512,16,8,116310,8,512,0,0,0,0,0
1744.41,6,94,7151,62,38,28596,205,4424,32,33,56258,98,2727
1796.6,6,374,26068,217,98,8317,469,15303,157,69,11515,69,10765
9.263,6,523,400478,288,1316,31,1368,383594,235,776,38,1473,16884
33.258,17,18,1584,9,48,4155,48,684,9,72,4155,72,900
240.309,6,42,8343,22,449,11443,1408,5648,20,205,12647,580,2695
0.541,6,25,7216,12,155,49,267,1261,13,678,39,2045,5955
70.449,6,29,7395,13,155,5870,267,1306,16,453,4695,3417,6089
1765.281,1,58,4872,58,56,30969,56,4872,0,0,0,0,0
66.469,17,4,352,2,60,66468,60,176,2,60,66468,60,176
1.063,6,28,8503,14,270,69,561,1945,14,997,68,2720,6558
138.948,6,24,8964,11,295,97,578,1359,13,1010,11568,1440,7605
1799.284,17,180,14040,180,50,10051,50,14040,0,0,0,0,0
1737.611,1,56,4704,0,0,0,0,0,56,56,31592,56,4704
1773.668,6,180,15480,120,69,14904,69,8940,60,69,30060,69,6540
0.831,17,4,368,2,64,830,64,184,2,64,829,64,184
1797.264,17,447,39296,404,35,4458,288,25708,43,288,41933,288,13588
116.791,17,4,1344,4,308,38930,308,1344,0,0,0,0,0
17.902,6,16,1327,8,222,2556,222,768,8,231,2556,231,559
12.644,6,2004,1743786,1210,1385,10,1420,1707805,794,467,15,1883,35981
1.09,6,28,8503,15,225,65,561,1985,13,997,75,2720,6518
300.54,6,19,1279,6,177,60074,177,497,13,110,25031,110,782
1.345,6,38,8254,19,321,74,1164,2718,19,433,64,1440,5536
300.031,6,52,15376,29,928,10709,1360,9609,23,439,13630,4027,5767
1699.442,17,12,498,11,14,169944,14,462,1,8,0,8,36
0.351,6,10,1671,6,552,70,948,1348,4,159,116,159,323
1741.053,6,88,6417,58,31,30544,31,3927,30,31,60034,31,2490
1734.316,17,316,54846,316,145,5505,405,54846,0,0,0,0,0
2.86,6,5,280,2,0,2860,0,100,3,0,1171,0,180
376.114,6,25,1651,17,177,23507,177,1117,8,110,9251,110,534
1786.276,6,447,26544,233,69,7699,69,13460,214,35,8386,64,13084
0.342,17,2,144,1,36,0,36,64,1,52,0,52,80
7.363,6,1950,1883729,1290,1385,5,1408,1844745,660,931,10,2801,38984
1.522,6,27,8108,14,222,101,540,1912,13,944,107,1591,6196
1764.127,2,10,320,10,8,196014,8,320,0,0,0,0,0
216.39,17,6,1496,3,32,108192,37,181,3,410,108192,463,1315
1772.038,6,180,15480,120,69,14891,69,8940,60,69,30031,69,6540
1799.907,1,76,6384,76,56,23998,56,6384,0,0,0,0,0
361.625,6,47,10492,29,290,12915,1360,4970,18,399,510,1360,5522
158.687,6,22,9126,12,304,70,597,1425,10,1214,17613,3081,7701
1532.302,6,201,17000,77,73,20159,332,7482,124,72,12457,1062,9518
2.386,17,22,10395,10,438,265,1350,4665,12,449,138,1350,5730
0.435,6,25,7711,16,339,29,949,3017,9,721,52,1460,4694
7.287,6,194,199718,97,133,75,201,4447,97,2035,73,10024,195271
1741.625,6,153,9724,82,51,21501,208,5985,71,31,24877,31,3739
1782.274,6,358,22669,209,69,8568,69,12569,149,69,12042,69,10100
138.945,17,4,352,2,60,138943,60,176,2,60,138944,60,176
4.29,1,8,832,0,0,0,0,0,8,76,612,76,832
240.176,6,53,18166,28,804,8895,1408,15147,25,213,10007,580,3019
1772.878,6,180,15480,120,69,14898,69,8940,60,69,30042,69,6540
0.992,17,2,663,1,286,0,286,314,1,321,0,321,349
0.486,17,4,288,2,36,438,36,128,2,52,439,52,160
1776.482,17,72,3018,71,14,25378,14,2982,1,8,0,8,36
103.401,6,38,7432,18,207,6079,517,1819,20,456,5439,1418,5613
0.349,6,20,7151,12,318,31,600,1906,8,1205,48,1891,5245
1775.007,6,209,24070,133,89,13447,981,11158,76,137,23662,2077,12912
1760.002,6,102,8032,67,45,26666,205,4985,35,35,51751,98,3047
1787.097,17,87,3648,86,14,21024,14,3612,1,8,0,8,36
1795.062,17,80,3354,79,14,23013,14,3318,1,8,0,8,36
709.911,1,4,224,4,28,236637,28,224,0,0,0,0,0
0.087,17,4,284,2,32,1,32,120,2,54,0,60,164
58.306,6,44,8916,21,410,474,882,2150,23,364,2644,1360,6766
193.26,6,23,6496,8,154,27608,267,792,15,637,13784,1997,5704
2.265,6,61,26696,34,1014,68,1360,20707,27,437,78,2715,5989
1753.132,6,29,3886,17,241,109570,241,2608,12,79,159313,92,1278
1797.894,6,381,27093,217,103,8323,469,15910,164,69,11028,69,11183
1.275,6,48,20266,28,902,47,1360,14690,20,476,57,2715,5576
0.037,6,11,912,6,181,7,181,489,5,77,6,134,423
1.199,6,24,5569,12,140,109,267,1184,12,650,102,1452,4385
0.064,6,10,767,5,186,11,186,454,5,45,14,45,313
82.138,6,19,772,8,0,7648,0,324,11,0,8212,0,448
3.727,17,4,1568,4,364,1242,364,1568,0,0,0,0,0
1793.96,17,144,11520,72,48,25266,48,5472,72,56,25266,56,6048
2.428,6,27,8205,12,330,214,517,1966,15,778,168,1418,6239
3.778,6,2,88,2,0,0,0,88,0,0,0,0,0
353.732,1,5,442,5,60,88433,88,442,0,0,0,0,0
15.156,6,5,752,3,46,7578,46,166,2,506,14922,506,586
0.082,17,4,284,2,32,0,32,120,2,54,5,60,164
1.339,17,6,1226,3,32,667,32,180,3,320,667,470,1046
6.998,6,663,607956,430,1347,15,1368,591164,233,776,29,1473,16792
3.156,6,5,280,2,0,3156,0,100,3,0,1178,0,180
4.227,6,39,7285,20,218,222,314,3423,19,516,221,1179,3862
0.01,6,2,190,1,110,0,110,150,1,0,0,0,40
35.345,6,43,8801,21,412,817,889,2168,22,521,1676,3488,6633
1795.199,6,355,22480,207,69,8714,69,12420,148,69,12212,69,10060
0.165,6,42,18453,24,1044,7,1420,13512,18,467,9,1883,4941
140.545,6,21,8544,11,556,102,1329,2140,10,998,15592,2720,6404
17.07,6,27,7232,8,153,2438,267,1095,19,447,941,1420,6137
29.555,6,16,1105,8,222,4220,222,546,8,231,4220,231,559
0.191,6,47,21570,26,1100,7,1420,16497,21,420,9,1420,5073
1785.731,1,342,28728,342,56,5236,56,28728,0,0,0,0,0
20.002,17,4,352,2,60,20001,60,176,2,60,20001,60,176
240.286,6,43,8864,21,519,12014,1402,5774,22,215,11441,618,3090
0.019,6,2,99,1,0,0,0,40,1,7,0,7,59
0.517,17,2,304,1,60,0,60,88,1,188,0,188,216
0.078,17,2,180,1,30,0,30,58,1,94,0,94,122
1.412,6,24,8004,12,164,108,267,1288,12,1014,110,2491,6716
1789.958,6,373,23614,214,69,8403,69,13114,159,69,11328,69,10500
331.887,6,18,1813,12,177,30171,177,1163,6,110,15243,110,650
20.167,6,22,5494,12,107,1833,159,1098,10,773,2240,1408,4396
0.612,6,38,11756,22,597,29,1188,7709,16,356,35,1048,4047
166.115,17,4,352,2,60,166114,60,176,2,60,166114,60,176
13.819,6,27,5064,13,154,1132,722,1767,14,427,1048,1440,3297
0.01,6,4,212,2,0,5,0,112,2,0,8,0,100
102.31,17,4,352,2,60,102308,60,176,2,60,102309,60,176
0.005,17,2,452,1,59,0,59,87,1,337,0,337,365
1772.413,6,180,15480,120,69,14894,69,8940,60,69,30036,69,6540
81.948,6,49,13793,18,238,4819,708,3114,31,449,2731,1452,10679
232.282,17,4,240,2,32,232281,32,120,2,32,232281,32,120
1746.303,17,167,37181,167,194,10519,342,37181,0,0,0,0,0
1796.762,17,448,39896,403,35,4469,288,25676,45,288,40018,288,14220
1751.484,6,137,13799,84,72,21102,722,7274,53,85,33678,1408,6525
5.65,1,6,504,6,56,1130,56,504,0,0,0,0,0
0.593,6,30,6412,16,178,39,365,1384,14,445,35,2348,5028
102.812,17,4,240,2,32,102811,32,120,2,32,102810,32,120
1743.547,6,91,6623,61,31,29059,31,4164,30,31,60119,31,2459
1789.733,6,281,34671,116,141,15561,1360,17009,165,134,10912,2720,17662
1.565,6,47,19163,27,891,60,1360,13587,20,433,72,1360,5576
1745.745,6,90,6540,60,31,29588,31,4050,30,31,60186,31,2490
1740.47,17,28,6580,28,207,64461,207,6580,0,0,0,0,0
1.081,17,3,404,2,64,1001,64,184,1,192,0,192,220
1772.207,6,180,15480,120,69,14892,69,8940,60,69,30033,69,6540
240.612,6,55,18217,30,815,8296,1418,15440,25,163,10024,580,2777
5.599,6,14,1029,7,222,931,222,506,7,231,931,231,523
365.784,6,18,1242,14,180,28137,180,916,4,110,20064,110,326
0.531,6,143,167773,65,183,8,230,3949,78,2102,5,5632,163824
5.06,17,4,288,2,36,5005,36,128,2,52,5027,52,160
189.507,17,4,240,2,32,189506,32,120,2,32,189505,32,120
240.179,6,56,20127,30,833,8281,1408,17396,26,171,9607,580,2731
0.047,6,17,6068,10,88,5,88,556,7,1740,7,1880,5512
204.218,17,4,1344,4,308,68072,308,1344,0,0,0,0,0
1720.868,17,12,498,11,14,172086,14,462,1,8,0,8,36
28.353,6,4130,3900477,2636,1400,10,1448,3818125,1494,776,18,1448,82352
64.986,6,22,6636,6,154,12997,267,712,16,479,4319,1420,5924
2.779,17,4,1568,4,364,926,364,1568,0,0,0,0,0
20.129,6,21,5418,12,107,1829,159,1074,9,773,2515,1402,4344
1779.76,1,124,6944,124,28,14469,28,6944,0,0,0,0,0
1764.329,17,29,6815,29,207,63011,207,6815,0,0,0,0,0
0.988,6,32,12966,17,525,61,1440,3350,15,818,57,1440,9616
1681.341,17,16,4241,8,30,240190,37,471,8,443,240191,463,3770
1796.142,17,448,39896,403,35,4468,288,25676,45,288,40017,288,14220
92.39,6,25,6601,8,247,539,516,1314,17,383,5769,1452,5287
547.131,17,162,39414,74,269,6750,1350,22042,88,169,6288,1350,17372
0.029,17,4,284,2,32,15,32,120,2,54,17,60,164
64.707,6,12,1222,6,226,12941,226,772,6,110,12632,110,450
135.692,17,4,352,2,60,135691,60,176,2,60,135691,60,176
0.436,6,13,1693,7,288,68,288,588,6,426,48,434,1105
1744.655,2,17,544,17,8,109040,8,544,0,0,0,0,0
7.241,6,12,5538,4,106,2409,106,274,8,987,1032,1452,5264
0.028,17,2,170,1,37,0,37,65,1,77,0,77,105
105.885,6,31,7613,11,155,475,267,1226,20,371,5572,1420,6387
83.685,6,25,9968,12,549,63,1440,2709,13,961,6962,1440,7259
0.025,6,12,3462,6,75,4,75,395,6,1373,5,1448,3067
1783.441,17,138,11040,69,48,26226,48,5244,69,56,26226,56,5796
1787.161,6,102,8228,68,64,26674,64,4896,34,58,54153,58,3332
4.174,17,10,1450,5,40,1041,40,340,5,194,1041,194,1110
10.351,6,4,174,1,0,0,0,40,3,7,5115,7,134
201.596,17,25,4664,25,158,8399,371,4664,0,0,0,0,0
0.017,17,2,170,1,49,0,49,77,1,65,0,65,93
180.523,2,2,64,2,8,180523,8,64,0,0,0,0,0
6.019,6,11,467,5,0,1504,0,208,6,7,637,7,259
1790.998,1,342,28728,342,56,5252,56,28728,0,0,0,0,0
1799.167,17,142,11360,71,48,25701,48,5396,71,56,25701,56,5964
6.083,17,22,7235,9,336,760,1350,3284,13,275,285,1350,3951
0.262,6,24,6064,12,181,23,537,1526,12,651,22,1402,4538
0.162,6,20,9985,10,125,17,125,653,10,1257,17,1448,9332
1755.976,1,79,4424,79,28,22512,28,4424,0,0,0,0,0
3.967,17,8,1176,4,48,1318,48,304,4,190,1318,308,872
42.895,6,47,21545,25,592,1787,1402,4863,22,1194,2041,2804,16682
1787.908,6,417,27773,216,100,8315,469,15056,201,41,8939,69,12717
0.113,17,4,588,2,48,101,48,152,2,190,101,308,436
18.887,6,968,877952,613,1355,30,1368,852092,355,776,52,1473,25860
8.91,6,16,3265,9,211,1113,211,910,7,665,1484,904,2355
0.482,17,2,144,1,36,0,36,64,1,52,0,52,80
17.38,6,21,6527,7,154,2896,267,752,14,520,1333,1420,5775
3.0,17,3,222,3,46,1500,46,222,0,0,0,0,0
0.636,17,14,7750,7,747,106,1350,5425,7,304,67,1350,2325
5.359,6,40,7309,22,218,255,314,3503,18,513,300,1179,3806
29.372,17,16,9183,9,733,3671,1350,6849,7,305,45,1350,2334
59.677,1,5,140,5,0,0,0,140,0,0,0,0,0
1.312,6,46,19136,27,892,50,1360,13600,19,529,62,4075,5536
5.377,6,38,7245,20,218,283,314,3423,18,516,300,1179,3822
4.676,6,38,7229,19,218,259,314,3383,19,513,245,1179,3846
1797.557,17,489,30070,489,33,3683,37,30070,0,0,0,0,0
661.453,17,22,2071,11,33,66143,37,673,11,99,66143,155,1398
0.254,6,24,6064,12,181,23,537,1526,12,651,22,2194,4538
356.955,6,25,2115,15,177,25496,177,1343,10,110,7360,110,772
284.221,17,4,352,2,60,284220,60,176,2,60,284220,60,176
0.148,17,2,180,1,30,0,30,58,1,94,0,94,122
1740.856,6,87,6322,58,31,30541,31,3915,29,31,62173,31,2407
300.309,6,50,27500,28,435,11122,1130,3288,22,1356,2284,6864,24212
1781.763,6,360,24156,210,88,8525,469,13878,150,69,11958,69,10278
40.637,17,6,528,3,48,20314,48,228,3,72,20314,72,300
289.309,6,38,16036,23,805,13150,1408,9258,15,665,4361,1408,6778
7.121,6,1524,1274446,836,1431,8,1448,1229858,688,776,10,1448,44588
223.661,6,34,11323,19,516,12425,1360,4406,15,700,15962,2137,6917
366.434,6,21,1419,15,177,26173,177,989,6,110,12227,110,430
0.244,17,3,451,2,39,13,39,134,1,289,0,289,317
1799.767,1,59,4956,59,56,31030,56,4956,0,0,0,0,0
59.696,6,55,7864,49,174,1243,174,2138,6,1370,1985,1420,5726
4.207,17,4,352,2,60,4205,60,176,2,60,4206,60,176
193.15,6,552,261237,286,834,255,1152,243387,266,400,727,1179,17850
5.856,6,40,7309,20,218,308,314,3423,20,513,292,1179,3886
67.424,17,4,352,2,60,67423,60,176,2,60,67423,60,176
1770.1,6,99,9306,66,66,27232,66,5610,33,60,55312,60,3696
1789.006,17,142,11360,71,48,25557,48,5396,71,56,25557,56,5964
0.175,6,2,80,1,0,0,0,40,1,0,0,0,40
62.087,17,28,2339,26,30,2480,37,1515,2,384,433,463,824
372.948,6,37,7606,27,118,14344,267,2181,10,1004,19,3445,5425
1.09,6,24,6431,13,309,90,885,2071,11,783,108,1420,4360
294.358,17,6,360,3,32,147177,32,180,3,32,147178,32,180
0.245,17,8,2758,8,316,35,355,2758,0,0,0,0,0
0.024,6,3,132,1,0,0,0,40,2,0,12,0,92
3.937,6,16,2435,9,125,492,245,740,7,1407,613,1407,1695
155.943,17,4,240,2,32,155942,32,120,2,32,155942,32,120
28.705,6,20,3623,9,529,3586,1452,2482,11,231,2868,231,1141
221.52,6,28,7352,13,158,18460,267,1317,15,678,15818,2800,6035
3.922,6,25,8469,14,175,301,362,1614,11,1045,366,2491,6855
0.042,6,2,149,1,0,0,0,40,1,69,0,69,109
240.215,6,56,21320,30,888,8282,1418,18442,26,189,9608,580,2878
98.448,6,893,440257,489,838,201,1152,418624,404,420,243,1179,21633
60.101,6,18,5941,9,290,7512,517,1057,9,1469,7485,2410,4884
1744.704,2,28,896,28,8,64618,8,896,0,0,0,0,0
1.2,6,23,5370,13,113,86,162,976,10,798,126,1771,4394
280.458,6,29,7392,13,158,23371,267,1317,16,678,18695,2085,6075
1743.132,1,141,7896,141,28,12450,28,7896,0,0,0,0,0
0.033,1,2,450,2,197,33,197,450,0,0,0,0,0
15.407,6,6,288,1,0,0,0,48,5,0,3849,0,240
1786.789,17,87,3648,86,14,21021,14,3612,1,8,0,8,36
1761.415,17,168,14050,156,30,11363,37,9090,12,385,154700,463,4960
454.31,6,9,546,6,31,90862,31,333,3,31,227149,31,213
280.433,6,27,7312,12,158,25493,267,1277,15,775,20027,3465,6035
1784.159,17,142,11360,71,48,25487,48,5396,71,56,25487,56,5964
230.712,17,14,4696,14,307,17747,308,4696,0,0,0,0,0
1786.798,6,102,8364,68,66,26668,66,4964,34,60,54142,60,3400
0.918,6,11,1727,7,100,153,100,384,4,589,218,1152,1343
1626.309,1,8,448,8,28,232329,28,448,0,0,0,0,0
0.53,6,19,6417,11,141,53,275,726,8,894,30,1440,5691
10.994,6,18,4266,10,275,1221,275,958,8,992,869,1440,3308
1.28,6,11,1727,7,100,213,100,384,4,589,337,1152,1343
1773.304,6,182,15629,121,69,14777,69,8980,61,69,29548,69,6649
1784.025,6,109,8635,68,65,26627,65,4930,41,59,44598,59,3705
0.087,17,2,586,1,46,0,46,74,1,484,0,484,512
0.01,6,2,104,1,0,0,0,52,1,0,0,0,52
13.004,6,29,8526,16,482,866,721,2576,13,903,914,1440,5950
1.334,6,50,18797,29,852,47,1360,13136,21,480,58,4075,5661
1781.118,6,218,16790,82,71,21987,329,8045,136,48,13193,78,8745
4.952,17,3,208,2,36,4893,36,128,1,52,0,52,80
280.439,6,25,7232,12,158,25494,267,1277,13,775,23366,3465,5955
1793.523,17,120,9600,60,48,30398,48,4560,60,56,30398,56,5040
1770.202,6,106,9684,68,64,26420,64,5724,38,58,47840,58,3960
7.643,17,3,228,3,48,3821,48,228,0,0,0,0,0
0.25,17,2,158,1,34,0,34,62,1,68,0,68,96
1780.244,17,142,11360,71,48,25431,48,5396,71,56,25431,56,5964
13.001,6,24,6993,13,275,1083,275,1078,11,910,790,1440,5915
12.742,6,666,592533,392,1433,32,1448,572199,274,899,45,1448,20334
868.82,6,100,16944,64,302,13790,302,12408,36,83,24818,83,4536
5.032,17,4,288,2,36,5001,36,128,2,52,5001,52,160
0.02,17,2,330,1,30,0,30,58,1,244,0,244,272
1794.791,6,371,23465,213,69,8465,69,13005,158,69,11431,69,10460
0.051,17,4,352,2,37,1,37,130,2,83,9,89,222
1790.359,6,356,22520,208,69,8649,69,12460,148,69,12179,69,10060
18.336,17,43,19556,20,605,963,1350,12663,23,271,832,1350,6893
1783.152,1,58,4872,58,56,31283,56,4872,0,0,0,0,0
47.618,6,50,10507,24,533,663,910,3199,26,329,1899,2720,7308
1795.856,17,80,3354,79,14,23023,14,3318,1,8,0,8,36
1794.935,1,134,7504,134,28,13495,28,7504,0,0,0,0,0
0.592,6,126,83109,69,1294,8,1420,76538,57,427,10,1420,6571
1763.828,2,15,480,15,8,125987,8,480,0,0,0,0,0
1799.055,6,128,8060,72,47,25335,208,4921,56,31,32706,31,3139
1794.728,17,87,3648,86,14,21114,14,3612,1,8,0,8,36
1794.59,17,86,3606,85,14,21364,14,3570,1,8,0,8,36
100.958,6,29,7464,9,155,1565,267,1146,20,367,5313,1420,6318
1774.758,1,161,10164,161,56,11092,56,10164,0,0,0,0,0
1.623,17,4,580,2,40,1592,40,136,2,194,1589,194,444
1791.179,6,455,86096,199,534,8882,1460,66391,256,59,7024,754,19705
1787.79,6,103,8395,68,65,26683,65,4930,35,59,52579,59,3465
1788.306,17,140,11200,70,48,25916,48,5320,70,56,25916,56,5880
0.017,17,2,438,1,72,0,72,100,1,310,0,310,338
3.113,17,4,400,2,48,3102,48,152,2,96,3081,96,248
374.548,6,25,1651,17,177,23409,177,1117,8,110,9170,110,534
7.216,6,35,6518,18,213,424,314,3077,17,551,434,1179,3441
23.515,6,23,6946,6,154,4703,267,712,17,462,1467,3377,6234
0.159,17,2,304,1,60,0,60,88,1,188,0,188,216
160.663,6,24,10090,13,532,54,1360,2718,11,1153,16052,2720,7372
4.043,17,5,295,5,31,1010,31,295,0,0,0,0,0
1.451,6,40,8389,21,320,72,1162,2808,19,437,70,2715,5581
12.601,6,21,6825,12,275,1145,275,1038,9,1353,948,1440,5787
0.664,6,10,766,5,185,129,185,453,5,45,153,45,313
1786.581,6,106,8620,68,64,26665,64,4896,38,58,48283,58,3724
54.203,17,42,10878,42,231,1322,388,10878,0,0,0,0,0
9.169,6,41,12895,22,453,364,1360,5908,19,776,498,2720,6987
3.365,17,4,524,2,39,3334,39,134,2,167,3304,167,390
273.69,6,34,20674,23,996,12440,1343,15153,11,705,3072,1491,5521
841.322,17,58,19534,58,308,14760,548,19534,0,0,0,0,0
1769.723,6,102,9462,66,66,27226,66,5610,36,60,50560,60,3852
0.27,6,16,3386,9,337,33,752,1827,7,593,36,1035,1559
1787.907,6,361,22858,210,69,8554,69,12678,151,69,11919,69,10180
162.526,17,4,240,2,32,162525,32,120,2,32,162525,32,120
35.959,17,22,1936,11,48,3592,48,836,11,72,3594,72,1100
1786.482,6,106,8456,68,65,26663,65,4930,38,59,48280,59,3526
0.533,17,2,144,1,36,0,36,64,1,52,0,52,80
1786.964,6,152,25379,91,483,19854,483,19705,61,83,29782,83,5674
1776.097,17,140,11200,70,48,25740,48,5320,70,56,25740,56,5880
126.785,17,4,240,2,32,126784,32,120,2,32,126784,32,120
652.97,6,78,20360,33,463,154,1360,10650,45,300,14837,1929,9710
1680.532,17,12,498,11,14,168053,14,462,1,8,0,8,36
0.324,6,27,8967,14,234,24,575,1672,13,1099,26,2816,7295
3.386,6,2,88,2,0,0,0,88,0,0,0,0,0
373.784,6,25,1651,17,177,23361,177,1117,8,110,9262,110,534
2.7,17,24,15249,10,434,299,1350,4628,14,730,205,1350,10621
188.687,6,48,10588,19,249,10482,1189,3011,29,291,6738,1420,7577
1772.355,6,182,15629,121,69,14769,69,8980,61,69,29531,69,6649
0.156,6,10,767,5,186,37,186,454,5,45,38,45,313
148.624,6,34,19183,16,708,49,1460,4226,18,1094,8734,1460,14957
1796.146,6,359,22778,210,69,8594,69,12678,149,69,12135,69,10100
0.067,6,2,92,1,0,0,0,52,1,0,0,0,40
10.573,17,7,6006,7,830,1762,1451,6006,0,0,0,0,0
0.267,6,9,1346,5,145,66,145,349,4,833,51,833,997
27.204,17,8,608,8,48,3886,48,608,0,0,0,0,0
16.167,17,18,7783,9,429,2012,1350,4117,9,379,2011,1350,3666
14.17,6,754,617363,433,1345,32,1368,594263,321,776,43,1473,23100
10.391,6,1439,1289900,873,1397,11,1448,1255804,566,776,18,1448,34096
0.467,6,51,22200,28,1058,17,1380,17026,23,421,19,1923,5174
1772.877,6,203,22221,130,75,13743,267,10057,73,133,24620,1420,12164
1737.702,6,204,13393,105,57,16707,208,8441,99,31,17729,31,4952
5.526,6,34,6260,16,206,368,314,2704,18,472,309,1179,3556
1705.098,1,8,448,8,28,243585,28,448,0,0,0,0,0
1.129,6,24,8004,11,164,95,267,1236,13,869,79,1440,6768
11.658,6,33,8870,16,482,777,721,2576,17,560,664,1420,6294
1.519,6,46,19050,27,885,58,1360,13514,19,529,73,4075,5536
31.56,6,7,336,1,0,0,0,48,6,0,6309,0,288
15.648,6,13,3380,4,92,5216,92,296,9,434,1918,1408,3084
3.147,6,52,13874,25,549,131,1429,4876,27,439,109,1986,8998
48.887,6,15,6082,2,106,500,106,194,13,487,4073,1460,5888
1680.608,17,12,498,11,14,168060,14,462,1,8,0,8,36
1751.598,17,178,40355,178,198,9896,358,40355,0,0,0,0,0
0.211,6,94,82127,58,211,3,258,4280,36,2234,5,7040,77847
0.0,17,2,1045,2,494,0,513,1045,0,0,0,0,0
0.441,6,27,9069,13,257,36,669,1714,14,945,32,1438,7355
366.063,6,23,1535,16,177,24404,177,1053,7,110,10363,110,482
1.03,6,25,6535,14,322,78,949,2175,11,979,102,1731,4360
1782.164,6,356,22520,208,69,8609,69,12460,148,69,12122,69,10060
170.943,6,37,7309,18,171,10053,517,1801,19,564,9494,1418,5508
1791.999,6,364,24454,211,88,8533,469,13987,153,69,11789,69,10467
113.811,17,8,2688,8,308,16258,308,2688,0,0,0,0,0
10.364,6,25,6847,8,138,1480,267,883,17,479,647,1420,5964
1792.24,1,57,4788,57,56,32004,56,4788,0,0,0,0,0
13.626,6,27,4866,13,154,1117,722,1766,14,394,1035,2026,3100
1795.752,6,361,76940,156,369,11584,1460,50283,205,188,8802,1642,26657
774.422,1,73,16697,73,200,10755,222,16697,0,0,0,0,0
0.289,6,24,4571,12,165,26,456,1446,12,415,25,888,3125
1763.752,6,27,4077,18,241,103750,241,2889,9,92,220446,92,1188
0.162,17,2,214,1,39,0,39,67,1,119,0,119,147
0.959,6,31,9195,18,384,56,1460,3441,13,746,63,1547,5754
31.214,6,8,348,2,0,18,0,84,6,0,6241,0,264
1740.911,6,163,9894,85,43,20725,208,5875,78,31,22593,31,4019
560.422,17,6,1631,3,30,280205,30,174,3,457,280203,463,1457
280.385,6,30,7432,13,158,23365,267,1317,17,603,17521,2076,6115
1049.672,17,11,836,11,48,104967,48,836,0,0,0,0,0
246.635,6,56,10479,28,168,9134,346,2716,28,419,9134,1408,7763
1779.961,17,142,11360,71,48,25427,48,5396,71,56,25427,56,5964
0.085,17,2,586,1,46,0,46,74,1,484,0,484,512
0.385,6,3,182,2,31,385,31,111,1,31,0,31,71
371.703,17,6,360,3,32,185851,32,180,3,32,185851,32,180
29.535,17,19,12022,10,663,3281,1350,6913,9,539,50,1350,5109
0.13,6,5,373,3,36,65,38,229,2,40,1,40,144
286.881,17,4,352,2,60,286880,60,176,2,60,286879,60,176
0.369,6,11,1170,6,135,66,135,379,5,587,79,587,791
0.171,17,2,198,1,37,0,37,65,1,105,0,105,133
71.098,6,31,7475,13,155,5924,267,1306,18,418,4181,1997,6169
0.862,6,34,8124,18,241,50,619,1730,16,522,47,3488,6394
1699.919,17,13,534,11,14,169974,14,462,2,8,1693472,8,72
1771.117,6,101,9410,66,66,27247,66,5610,35,60,52089,60,3800
15.143,17,3,228,3,48,7571,48,228,0,0,0,0,0
0.247,6,9,1345,5,145,61,145,349,4,832,32,832,996
1633.754,1,53,2968,53,28,31418,28,2968,0,0,0,0,0
1772.893,6,180,15480,120,69,14898,69,8940,60,69,30048,69,6540
0.573,6,108,71472,60,1282,9,1432,65261,48,475,11,1871,6211
1777.462,6,138,8854,78,49,23083,208,5524,60,31,30121,31,3330
4.298,6,2,88,2,0,0,0,88,0,0,0,0,0
1796.258,6,356,22520,208,69,8677,69,12460,148,69,12219,69,10060
136.67,6,24,6217,9,272,108,516,1180,15,403,9755,1452,5037
0.054,17,4,368,2,35,0,35,126,2,93,1,99,242
29.807,6,36,8393,16,175,1987,721,2047,20,554,1539,2840,6346
26.511,6,39,8735,16,401,70,889,1876,23,329,1196,1928,6859
1.101,6,23,7952,12,164,85,267,1288,11,1216,93,3819,6664
1681.304,17,14,1036,7,30,280214,30,406,7,62,280214,62,630
281.784,17,4,240,2,32,281783,32,120,2,32,281783,32,120
54.1,6,44,8549,21,318,640,639,1874,23,441,2453,1360,6675
51.623,6,502,449821,201,724,258,1408,23306,301,1416,172,4224,426515
360.485,2,3,96,3,8,180242,8,96,0,0,0,0,0
673.782,6,89,28283,50,526,13750,1360,14756,39,519,11748,3494,13527
64.068,6,18,6650,5,154,16017,267,672,13,495,3479,1420,5978
7.352,17,16,3268,8,37,1048,37,520,8,315,1048,331,2748
20.121,6,20,5365,12,107,1829,159,1074,8,966,2873,1674,4291
9.217,6,14,816,6,0,1843,0,344,8,0,1315,0,472
1796.809,17,448,39896,403,35,4469,288,25676,45,288,40020,288,14220
1681.193,17,14,3843,7,30,280198,30,406,7,463,280198,463,3437
20.363,6,23,5534,13,107,1696,159,1126,10,967,2254,1709,4408
0.092,17,2,572,1,39,0,39,67,1,477,0,477,505
377.722,2,3,96,3,8,188861,8,96,0,0,0,0,0
1.307,6,11,1727,7,100,217,100,384,4,589,348,1152,1343
0.691,6,14,1733,7,288,111,288,588,7,284,53,434,1145
300.664,6,39,8511,20,291,15824,786,1997,19,441,468,1360,6514
2.337,6,14,2351,8,188,333,245,700,6,703,413,1152,1651
2.528,17,29,13548,14,674,194,1350,9833,15,219,115,1350,3715
0.332,6,27,9043,13,252,27,647,1692,14,945,24,1408,7351
1780.977,17,142,11360,71,48,25442,48,5396,71,56,25442,56,5964
158.456,17,4,352,2,60,158455,60,176,2,60,158454,60,176
1791.03,6,356,22520,208,69,8652,69,12460,148,69,12183,69,10060
1.251,6,39,9888,21,440,62,1360,4392,18,529,63,4075,5496
1787.905,6,356,22520,208,69,8637,69,12460,148,69,12162,69,10060
1744.863,6,95,7203,63,38,28142,205,4476,32,33,56274,98,2727
1007.292,2,9,288,9,8,125911,8,288,0,0,0,0,0
360.84,2,5,160,5,8,90210,8,160,0,0,0,0,0
6.729,6,34,9403,18,641,395,1360,3961,16,435,437,2667,5442
19.66,6,14,2245,8,211,2808,211,846,6,545,3931,904,1399
62.385,6,32,8952,14,158,4798,267,1357,18,624,3666,1400,7595
0.043,17,4,304,2,37,0,37,130,2,59,35,65,174
1.651,6,5,375,1,91,0,91,143,4,0,550,0,232
275.675,6,9,558,6,43,55135,43,394,3,0,137833,0,164
0.253,17,2,572,1,39,0,39,67,1,477,0,477,505
0.305,6,21,5000,10,137,33,267,1092,11,692,28,1467,3908
15.107,17,17,5901,7,371,2513,1350,2797,10,282,1675,1350,3104
280.647,6,28,7352,12,158,25513,267,1277,16,603,18707,1400,6075
2.478,17,4,240,2,32,2477,32,120,2,32,2476,32,120
0.173,6,10,767,5,186,41,186,454,5,45,40,45,313
3.89,17,6,462,3,33,1944,33,183,3,65,1944,65,279
1700.434,17,12,498,11,14,170043,14,462,1,8,0,8,36
1796.915,17,311,65525,311,182,5796,422,65525,0,0,0,0,0
1798.342,17,448,39612,404,35,4462,288,25708,44,288,40017,288,13904
6.163,6,1452,1334123,914,1382,6,1408,1301483,538,931,11,2816,32640
1786.515,6,105,8416,68,65,26664,65,4930,37,59,49621,59,3486
1792.205,17,140,11200,70,48,25973,48,5320,70,56,25973,56,5880
37.793,6,37,8495,17,410,538,882,1942,20,441,1982,1360,6553
0.484,6,15,5386,8,965,69,1360,3217,7,269,43,272,2169
121.957,6,22,6168,7,272,206,516,1100,15,372,8704,1452,5068
1.111,6,24,8004,12,164,85,267,1288,12,1014,85,2423,6716
0.496,6,111,87189,48,131,10,232,2449,63,1442,7,2860,84740
0.258,17,2,212,1,46,0,46,74,1,110,0,110,138
5.0,6,39,12589,16,319,212,1189,2882,23,487,226,1420,9707
1.307,6,10,924,5,283,279,283,551,5,105,281,105,373
1757.677,6,263,38884,158,302,9564,302,27902,105,83,16900,83,10982
1793.655,6,356,22520,208,69,8664,69,12460,148,69,12200,69,10060
8.783,6,17,4130,9,275,1097,275,918,8,1440,1114,1440,3212
1798.491,6,361,24334,211,88,8564,469,13987,150,69,12068,69,10347
0.245,17,4,1574,4,365,81,373,1574,0,0,0,0,0
240.181,6,53,18911,28,811,8895,1402,16065,25,192,10007,580,2846
0.0,6,1,40,1,0,0,0,40,0,0,0,0,0
8.081,6,892,730959,511,1345,15,1368,703391,381,776,20,1473,27568
0.014,6,2,133,1,0,0,0,40,1,53,0,53,93
1770.8,6,101,9410,66,66,27243,66,5610,35,60,52080,60,3800
0.956,6,30,12642,17,529,59,1360,3370,13,1092,65,3921,9272
1786.134,17,87,3648,86,14,21013,14,3612,1,8,0,8,36
58.868,6,46,10261,22,533,463,910,3095,24,364,2553,2128,7166
0.044,6,9,1339,5,145,11,145,349,4,826,10,826,990
1770.143,6,213,16868,79,74,22692,375,8177,134,49,13309,143,8691
0.353,6,45,17803,25,977,14,1380,12761,20,421,16,1923,5042
0.897,17,2,148,2,46,897,46,148,0,0,0,0,0
1.409,6,50,19102,27,878,54,1360,13406,23,433,55,1360,5696
280.231,6,27,7312,13,158,23352,267,1317,14,775,21553,4836,5995
3.535,6,15,3201,5,92,883,92,348,10,387,345,1408,2853
76.689,6,15,1598,6,226,2514,226,784,9,110,9566,110,814
0.092,17,4,368,2,32,70,32,120,2,96,43,96,248
184.223,2,4,128,4,8,61407,8,128,0,0,0,0,0
1796.429,6,354,22440,207,69,8720,69,12420,147,69,12304,69,10020
542.753,6,9,546,6,31,108550,31,333,3,31,271371,31,213
46.499,6,27,7177,13,155,3874,267,1306,14,530,3576,3417,5871
0.501,6,7,400,5,0,125,0,296,2,0,107,0,104
1.627,6,13,2311,8,188,232,245,700,5,1407,344,1407,1611
0.464,6,50,21463,28,1012,17,1380,16341,22,421,20,1923,5122
1786.079,6,106,8584,69,66,26265,66,5004,37,60,49610,60,3580
1798.731,6,431,26063,211,69,8565,69,12718,220,35,8213,69,13345
0.058,17,4,284,2,32,44,32,120,2,54,41,60,164
1786.41,6,104,8444,68,66,26662,66,4964,36,60,51037,60,3480
1.194,6,176,144124,78,278,15,852,5746,98,1433,11,4254,138378
39.311,17,22,1936,11,48,3919,48,836,11,72,3929,72,1100
1706.616,1,30,1680,30,28,58848,28,1680,0,0,0,0,0
1.318,6,47,19121,27,888,50,1360,13545,20,433,60,1360,5576
83.074,6,22,900,10,0,6077,0,408,12,0,7550,0,492
379.806,6,18,1242,14,180,29215,180,916,4,110,20076,110,326
0.512,17,3,451,2,39,225,39,134,1,289,0,289,317
0.485,17,4,288,2,36,454,36,128,2,52,52,52,160
0.201,17,2,144,1,36,0,36,64,1,52,0,52,80
1797.404,1,67,5628,67,56,27233,56,5628,0,0,0,0,0
1.133,6,10,1687,7,100,188,100,384,3,1179,423,1179,1303
1787.23,1,337,28308,337,56,5319,56,28308,0,0,0,0,0
1740.5,17,29,30624,29,1028,62160,1028,30624,0,0,0,0,0
1771.569,6,82,4316,41,26,44288,26,2158,41,26,44288,26,2158
1729.183,6,63,4601,41,33,43229,33,2825,22,31,82333,31,1776
97.846,6,102,54597,53,789,226,1460,16497,49,926,2032,1779,38100
1.66,17,24,9222,12,305,147,1350,3998,12,407,147,1350,5224
3.832,6,36,6265,19,206,212,314,2824,17,551,223,1179,3441
5.017,17,3,208,2,36,5003,36,128,1,52,0,52,80
1799.888,17,4407,211536,2205,20,816,20,105840,2202,20,817,20,105696
276.932,17,4,352,2,60,276930,60,176,2,60,276930,60,176
1786.497,6,102,8364,68,66,26664,66,4964,34,60,54133,60,3400
286.56,1,4,224,4,28,95520,28,224,0,0,0,0,0
1794.085,6,145,10705,81,77,22426,208,7060,64,31,28471,31,3645
280.333,6,29,7392,13,158,23361,267,1317,16,603,18682,2036,6075
1740.513,6,87,6322,58,31,30535,31,3915,29,31,62160,31,2407
1772.644,6,180,15480,120,69,14896,69,8940,60,69,30039,69,6540
112.877,1,20,1680,20,56,5940,56,1680,0,0,0,0,0
0.754,6,10,1687,7,100,125,100,384,3,1179,254,1179,1303
1798.826,1,345,28980,345,56,5229,56,28980,0,0,0,0,0
65.742,17,8,608,8,48,9391,48,608,0,0,0,0,0
4.043,17,4,244,4,33,1347,33,244,0,0,0,0,0
61.826,6,77,48547,44,1181,1437,1448,40100,33,747,1924,1448,8447
0.359,6,6,324,4,0,119,0,216,2,0,181,0,108
1.106,6,25,8080,12,164,85,267,1312,13,869,78,1408,6768
0.911,6,24,4825,13,207,75,519,1710,11,507,83,1408,3115
804.654,1,84,4704,84,28,9694,28,4704,0,0,0,0,0
1796.553,17,448,39896,403,35,4469,288,25676,45,288,40018,288,14220
0.376,6,14,1733,7,288,57,288,588,7,284,35,434,1145
11.976,6,16,1402,8,275,1710,275,878,8,96,1145,96,524
271.367,1,4,224,4,28,90455,28,224,0,0,0,0,0
1789.533,1,157,8792,157,28,11471,28,8792,0,0,0,0,0
1744.654,6,95,7203,63,38,28139,205,4476,32,33,56267,98,2727
1795.418,17,140,11200,70,48,26020,48,5320,70,56,26020,56,5880
0.221,17,8,2758,8,316,31,355,2758,0,0,0,0,0
1786.163,17,87,3648,86,14,21013,14,3612,1,8,0,8,36
7.154,6,66,20110,33,561,223,1152,15363,33,489,215,1179,4747
1788.37,17,83,3480,82,14,22078,14,3444,1,8,0,8,36
2.05,17,4,580,2,40,2019,40,136,2,194,2016,194,444
0.269,6,9,1339,5,145,67,145,349,4,826,47,826,990
0.0,17,6,2117,6,324,0,354,2117,0,0,0,0,0
1773.826,6,180,15480,120,69,14906,69,8940,60,69,30058,69,6540
7.437,6,1168,1032964,733,1359,10,1420,1011213,435,427,17,1420,21751
1791.041,1,339,28476,339,56,5298,56,28476,0,0,0,0,0
1787.287,6,102,8228,68,64,26675,64,4896,34,58,54152,58,3332
38.472,17,44,6468,22,48,1830,48,1672,22,190,1829,308,4796
2.29,6,14,2191,8,329,327,595,1071,6,396,391,580,1120
1781.409,17,136,10880,68,48,26588,48,5168,68,56,26588,56,5712
10.879,6,20,4442,11,275,1087,275,998,9,768,763,1440,3444
1.015,6,19,5880,11,285,101,556,1300,8,709,124,1380,4580
1792.291,1,272,15232,272,28,6613,28,15232,0,0,0,0,0
10.754,6,22,6058,11,275,1075,275,998,11,768,821,1440,5060
1793.863,1,81,4536,81,28,22423,28,4536,0,0,0,0,0
227.091,17,4,1344,4,308,75697,308,1344,0,0,0,0,0
6.12,6,2,111,2,31,6120,31,111,0,0,0,0,0
10.82,6,2124,1997577,1377,1375,7,1408,1954069,747,931,14,2801,43508
13.347,6,24,6993,13,275,1112,275,1078,11,910,833,1420,5915
0.087,17,2,442,1,46,0,46,74,1,340,0,340,368
1772.27,6,180,15480,120,69,14893,69,8940,60,69,30034,69,6540
1775.205,17,73,3060,72,14,25002,14,3024,1,8,0,8,36
3.159,17,4,272,2,32,3155,32,120,2,48,3155,48,152
280.208,6,30,7432,13,158,23350,267,1317,17,543,17509,1400,6115
1738.66,6,87,6322,58,31,30502,31,3915,29,31,62094,31,2407
2.001,6,15,3632,8,150,285,174,624,7,681,265,1452,3008
1785.707,6,102,8364,68,66,26652,66,4964,34,60,54109,60,3400
0.157,6,26,7256,13,155,13,267,1301,13,603,12,2036,5955
1790.373,17,83,3480,82,14,22103,14,3444,1,8,0,8,36
7.995,2,2,64,2,8,7995,8,64,0,0,0,0,0
1764.499,2,12,384,12,8,160409,8,384,0,0,0,0,0
17.347,6,2609,2439707,1692,1363,10,1408,2387359,917,776,18,1408,52348
302.117,6,53,21903,31,981,10070,1360,15992,22,386,473,2667,5911
1770.2,6,102,9600,68,66,26420,66,5792,34,60,53638,60,3808
1786.765,6,102,8296,68,65,26668,65,4930,34,59,54141,59,3366
5.022,17,4,288,2,36,5005,36,128,2,52,5001,52,160
448.647,17,60,15540,60,231,7604,388,15540,0,0,0,0,0
1683.427,1,7,742,7,78,280571,78,742,0,0,0,0,0
3.271,6,2,88,2,0,0,0,88,0,0,0,0,0
14.194,6,31,7613,12,155,1290,267,1266,19,371,788,1997,6347
0.839,6,123,89086,55,131,15,232,2729,68,1348,12,1420,86357
372.086,6,18,1242,14,180,28622,180,916,4,110,20061,110,326
10.151,6,30,7432,13,158,845,267,1317,17,543,632,1400,6115
22.327,6,23,3944,14,179,1717,517,1824,9,411,2788,499,2120
0.146,17,2,154,1,33,0,33,61,1,65,0,65,93
0.488,17,3,451,2,39,248,39,134,1,289,0,289,317
1.321,6,40,10522,21,514,66,1360,4986,19,529,63,4075,5536
333.499,17,10,1490,10,121,37055,121,1490,0,0,0,0,0
15.604,6,6,264,1,0,0,0,44,5,0,3839,0,220
1.339,6,30,6160,15,150,95,267,1655,15,650,85,1452,4505
16.735,17,8,1176,4,48,5575,48,304,4,190,5575,308,872
0.057,17,2,144,1,36,0,36,64,1,52,0,52,80
0.656,6,10,924,5,283,113,283,551,5,105,112,105,373
0.061,6,10,1495,5,507,15,507,727,5,556,15,556,768
2.812,17,2,279,1,36,0,36,64,1,187,0,187,215
0.002,17,2,2752,2,1348,2,1348,2752,0,0,0,0,0
1792.376,1,286,16016,286,28,6289,28,16016,0,0,0,0,0
376.183,6,23,1535,16,177,25078,177,1053,7,110,10414,110,482
1.192,6,10,968,5,256,292,256,460,5,304,294,304,508
1793.967,17,144,11520,72,48,25267,48,5472,72,56,25267,56,6048
1796.03,17,448,39896,403,35,4467,288,25676,45,288,40020,288,14220
208.209,6,24,4911,10,220,6289,516,1286,14,278,15996,1452,3625
1796.159,6,743,50300,371,31,4854,31,25194,372,31,4840,31,25106
1771.11,1,156,16536,156,78,11426,78,16536,0,0,0,0,0
3.758,17,22,15642,13,988,312,1350,13211,9,242,465,1350,2431
175.11,17,4,558,2,36,175100,36,128,2,187,175101,187,430
1772.067,1,58,4872,58,56,31088,56,4872,0,0,0,0,0
21.892,17,4,352,2,60,21891,60,176,2,60,21891,60,176
3.066,17,4,304,2,48,3048,48,152,2,48,3048,48,152
1774.241,6,180,15480,120,69,14909,69,8940,60,69,30069,69,6540
15.233,6,14,1025,7,222,2537,222,506,7,231,2537,231,519
240.167,6,53,18054,28,803,8894,1408,15116,25,203,10006,580,2938
202.75,17,4,240,2,32,202749,32,120,2,32,202749,32,120
0.029,6,10,520,0,0,0,0,0,10,0,0,0,520
57.588,6,50,13622,24,937,669,1460,7625,26,290,2296,1460,5997
169.531,17,28,2128,28,48,6278,48,2128,0,0,0,0,0
9.914,17,2,672,2,308,9914,308,672,0,0,0,0,0
0.018,6,11,1864,6,262,3,517,844,5,752,4,752,1020
1.865,6,44,15022,23,199,76,561,2422,21,903,84,1440,12600
240.213,6,54,18385,29,822,8578,1402,15505,25,196,10008,580,2880
1772.505,6,206,22479,131,75,13634,267,10097,75,132,23949,1460,12382
1795.936,17,448,39896,403,35,4467,288,25676,45,288,40014,288,14220
1689.227,17,21,6186,21,266,84461,1059,6186,0,0,0,0,0
162.556,17,4,352,2,60,162555,60,176,2,60,162555,60,176
0.122,17,2,672,2,308,122,308,672,0,0,0,0,0
1.464,6,50,19344,27,895,56,1460,13648,23,433,57,1460,5696
1785.857,6,373,23683,213,69,8423,69,13143,160,69,11231,69,10540
12.783,6,2496,2345735,1615,1375,7,1408,2295259,881,931,14,2816,50476
33.793,6,20,6488,6,154,6758,267,712,14,520,2595,1460,5776
322.252,6,6,2395,6,431,64450,431,2395,0,0,0,0,0
1786.236,6,354,22440,207,69,8671,69,12420,147,69,12234,69,10020
5.158,6,37,7189,19,218,286,314,3383,18,513,287,1179,3806
294.528,17,4,352,2,60,294527,60,176,2,60,294527,60,176
136.693,17,4,240,2,32,136692,32,120,2,32,136692,32,120
53.819,17,16,18199,16,1109,3587,1451,18199,0,0,0,0,0
1082.865,2,12,384,12,8,98442,8,384,0,0,0,0,0
123.131,17,12,16480,12,1345,11193,1347,16480,0,0,0,0,0
1799.316,1,58,4872,58,56,31566,56,4872,0,0,0,0,0
1772.422,6,180,15480,120,69,14894,69,8940,60,69,30039,69,6540
366.223,6,25,1651,17,177,22888,177,1117,8,110,9170,110,534
1770.303,6,101,9344,66,65,27235,65,5577,35,59,52062,59,3767
1773.531,6,181,15589,120,69,14903,69,8940,61,69,29554,69,6649
1787.824,6,355,22480,207,69,8678,69,12420,148,69,12161,69,10060
164.748,6,25,1020,10,0,6011,0,404,15,0,11766,0,616
0.039,6,9,1339,5,145,9,145,349,4,826,9,826,990
9.645,6,1521,1336762,947,1359,10,1420,1309403,574,427,16,1420,27359
300.778,6,33,8390,17,204,18798,467,1744,16,446,5073,1402,6646
1.431,6,29,10024,16,606,76,1460,3715,13,722,100,1934,6309
0.439,17,4,566,2,31,429,31,118,2,196,427,196,448
0.087,17,2,180,1,30,0,30,58,1,94,0,94,122
396.537,6,18,1242,14,180,30502,180,916,4,110,20087,110,326
6.81,6,615,500506,362,1314,18,1368,482686,253,665,26,1368,17820
0.217,17,2,180,1,30,0,30,58,1,94,0,94,122
0.805,6,81,69313,49,337,16,392,6074,32,2052,25,7040,63239
185.866,6,80,52711,48,1194,3954,1448,44322,32,746,2008,1448,8389
0.457,6,53,22318,29,995,16,1380,15193,24,558,17,1923,7125
4.817,6,38,7229,19,218,267,314,3383,19,513,253,1179,3846
10.76,6,20,4442,11,275,1076,275,998,9,768,747,1440,3444
6.51,6,65,20102,34,541,197,1152,15435,31,489,208,1179,4667
0.436,6,7,295,4,0,145,0,164,3,7,105,7,131
1676.522,1,7,392,7,28,279420,28,392,0,0,0,0,0
1.284,6,49,18782,27,858,49,1360,13126,22,433,52,1360,5656
3.375,17,4,1556,4,361,1125,361,1556,0,0,0,0,0
1773.988,6,294,26275,171,76,10435,267,11973,123,132,14540,1460,14302
9.855,6,28,8792,13,158,821,267,1317,15,858,697,3445,7475
1784.373,17,142,11360,71,48,25490,48,5396,71,56,25490,56,5964
3.523,17,5,364,4,32,1166,32,240,1,96,0,96,124
1799.848,1,58,4872,58,56,31576,56,4872,0,0,0,0,0
0.256,17,2,152,1,48,0,48,76,1,48,0,48,76
1.939,6,49,20663,26,952,77,1460,13507,23,518,76,1460,7156
10.319,6,50,10125,24,454,448,774,2833,26,328,405,1360,7292
1745.5,6,95,7203,63,38,28153,205,4476,32,33,56293,98,2727
1275.606,1,100,5600,100,28,12884,28,5600,0,0,0,0,0
1792.812,6,355,22549,207,69,8702,69,12420,148,69,12195,69,10129
280.259,6,29,7392,13,158,23354,267,1317,16,543,18682,1400,6075
299.875,2,6,192,6,8,59975,8,192,0,0,0,0,0
0.046,17,2,398,1,43,0,43,71,1,299,0,299,327
2.974,6,2,88,2,0,0,0,88,0,0,0,0,0
38.896,17,11,836,11,48,3889,48,836,0,0,0,0,0
44.159,17,14,7760,8,655,6308,1350,5466,6,354,3021,1350,2294
5.085,17,3,401,2,37,4978,37,130,1,243,0,243,271
0.225,17,2,212,1,46,0,46,74,1,110,0,110,138
280.256,6,28,7352,13,158,23354,267,1317,15,678,20017,2045,6035
200.51,6,69,10425,30,122,6914,267,2795,39,275,5266,1917,7630
485.576,17,224,58016,224,231,2177,388,58016,0,0,0,0,0
137.606,6,4063,3595986,2475,1365,55,1368,3498308,1588,899,86,1473,97678
0.106,17,4,368,2,32,105,32,120,2,96,51,96,248
293.975,1,5,1081,5,188,73493,320,1081,0,0,0,0,0
229.326,17,4,288,2,36,229324,36,128,2,52,229324,52,160
249.279,6,31,7472,13,158,20773,267,1317,18,543,14660,1380,6155
19.661,6,2578,2276622,1529,1404,12,1448,2216414,1049,776,18,1448,60208
2.344,6,25,10097,13,687,195,1352,2745,12,840,203,1827,7352
1772.668,6,285,36784,116,145,15413,1360,17476,169,149,10550,4662,19308
1.534,17,22,9152,11,349,150,1350,4152,11,426,150,1350,5000
240.225,6,53,17936,28,799,8896,1418,15055,25,196,10008,580,2881
1742.14,1,63,5292,63,56,28099,56,5292,0,0,0,0,0
41.348,17,3,228,3,48,20674,48,228,0,0,0,0,0
1788.304,1,58,4872,58,56,31373,56,4872,0,0,0,0,0
11.817,6,1841,1637336,1156,1364,10,1380,1602755,685,558,17,1923,34581
0.025,17,2,366,1,36,0,36,64,1,274,0,274,302
0.363,17,2,152,1,48,0,48,76,1,48,0,48,76
1744.891,6,95,7203,63,38,28143,205,4476,32,33,56275,98,2727
0.274,17,2,558,1,32,0,32,60,1,470,0,470,498
1776.985,17,44,14784,44,308,41325,308,14784,0,0,0,0,0
1797.054,17,448,39896,403,35,4470,288,25676,45,288,40019,288,14220
0.002,17,2,128,1,36,0,36,64,1,36,0,36,64
191.793,1,3,168,3,28,95896,28,168,0,0,0,0,0
184.162,17,10,585,10,30,20462,31,585,0,0,0,0,0
160.132,6,29,13854,16,558,47,1360,2905,13,1302,13330,2720,10949
602.877,6,36,6579,19,250,33493,1314,2516,17,307,37678,1420,4063
1799.77,17,142,11360,71,48,25710,48,5396,71,56,25710,56,5964
240.298,6,42,8856,21,524,12014,1418,5818,21,242,12014,684,3038
280.18,6,31,7472,14,158,21552,267,1357,17,543,17508,1400,6115
1744.731,2,25,800,25,8,72697,8,800,0,0,0,0,0
0.24,6,23,4519,11,165,24,456,1394,12,498,21,888,3125
2.083,17,6,1030,3,32,779,32,180,3,255,0,274,850
240.238,6,56,19040,24,622,10445,1418,8731,32,616,7749,1418,10309
368.784,6,23,1535,16,177,24585,177,1053,7,110,10371,110,482
170.739,6,6,1255,4,327,56913,413,814,2,180,170547,269,441
300.818,6,44,11868,22,641,14324,1448,4417,22,370,704,1448,7451
301.019,6,40,12184,22,675,14334,1448,5206,18,502,519,1258,6978
1799.657,6,290,33672,117,128,15255,1460,16109,173,121,10462,1460,17563
1793.652,1,160,8960,160,28,11280,28,8960,0,0,0,0,0
364.597,6,25,1651,17,177,22787,177,1117,8,110,9158,110,534
320.844,17,77,3104,67,12,4855,16,2692,10,13,22993,16,412
4.363,6,2,88,2,0,0,0,88,0,0,0,0,0
92.571,6,24,8962,12,467,88,1064,1927,12,817,8400,1455,7035
65.615,6,25,10030,12,579,59,1460,2831,13,952,5457,1460,7199
8.287,6,1990,1871887,1250,1418,6,1448,1828743,740,776,10,1448,43144
0.012,17,2,520,1,69,0,69,97,1,395,0,395,423
1786.493,6,104,8376,68,65,26664,65,4930,36,59,51039,59,3446
1787.203,6,103,8268,68,64,26674,64,4896,35,58,52562,58,3372
0.187,17,2,157,1,31,0,31,59,1,70,0,70,98
141.765,6,31,8912,15,158,10126,267,1397,16,763,9450,2036,7515
54.985,17,4,240,2,32,54983,32,120,2,32,54984,32,120
1798.122,1,58,4872,0,0,0,0,0,58,56,31546,56,4872
4.776,17,2,128,2,36,4776,36,128,0,0,0,0,0
1.263,6,46,19194,27,896,48,1360,13658,19,476,59,2715,5536
1797.149,17,762,45974,762,32,2361,37,45974,0,0,0,0,0
1797.616,17,448,39896,403,35,4471,288,25676,45,288,40015,288,14220
0.073,17,2,650,1,308,0,308,336,1,286,0,286,314
1789.319,17,142,11360,71,48,25561,48,5396,71,56,25561,56,5964
972.411,1,36,2016,36,28,27783,28,2016,0,0,0,0,0
1.873,17,3,183,3,33,936,33,183,0,0,0,0,0
0.632,6,10,1992,5,288,150,288,508,5,424,85,434,1484
300.154,6,47,17279,27,959,11537,1360,11677,20,435,15788,2667,5602
6.783,6,1573,1344646,880,1437,7,1448,1301114,693,776,9,1448,43532
1795.754,17,446,38980,404,35,4455,288,25708,42,288,42946,288,13272
8.1,6,16,2440,8,130,1157,130,684,8,1296,1007,1296,1756
63.626,6,11,682,4,112,21205,112,280,7,90,10602,90,402
0.024,6,26,35908,11,269,2,269,849,15,2636,0,7040,35059
256.593,6,28,8792,13,158,21382,267,1317,15,858,18318,2045,7475
1.925,6,40,10092,21,440,96,1360,4460,19,405,94,1360,5632
1760.672,6,5563,5487448,1984,135,887,911,113092,3579,1483,492,5672,5374356
0.583,6,27,9020,13,253,48,653,1698,14,939,41,1368,7322
1.254,6,23,6514,13,334,103,1008,2194,10,979,138,1731,4320
1798.976,17,448,39896,403,35,4475,288,25676,45,288,40017,288,14220
33.782,6,33,5197,16,154,2252,722,1911,17,299,2098,1440,3286
0.228,17,2,2380,2,1162,228,1162,2380,0,0,0,0,0
0.104,17,4,284,2,32,57,32,120,2,54,92,60,164
1173.789,6,69,5519,45,65,26677,65,3230,24,57,51030,59,2289
5.25,6,26,10088,14,660,403,1360,3246,12,907,462,1360,6842
1791.717,6,356,22520,208,69,8655,69,12460,148,69,12188,69,10060
1791.765,1,342,28728,342,56,5254,56,28728,0,0,0,0,0
42.641,6,32,8249,19,129,2368,159,1927,13,626,3550,1402,6322
7.918,17,2,672,2,308,7918,308,672,0,0,0,0,0
1799.708,1,58,4872,58,56,31573,56,4872,0,0,0,0,0
333.585,6,34,6997,15,165,11785,502,1598,19,289,18528,1420,5399
0.079,17,2,154,1,33,0,33,61,1,65,0,65,93
1.681,6,14,2351,8,188,240,245,700,6,703,284,1152,1651
1789.373,6,356,22520,208,69,8644,69,12460,148,69,12172,69,10060
0.354,17,4,1305,4,298,118,332,1305,0,0,0,0,0
1749.519,17,12,498,11,14,174951,14,462,1,8,0,8,36
1786.767,6,185,11376,92,47,19634,208,6695,93,31,19418,31,4681
462.39,6,81,12466,35,93,13599,267,3083,46,179,10269,1420,9383
4.028,6,11,467,6,0,805,0,248,5,7,749,7,219
0.002,6,2,123,1,0,0,0,40,1,31,0,31,83
82.418,17,4,1344,4,308,27472,308,1344,0,0,0,0,0
260.422,6,18,9754,3,106,225,106,234,15,685,18600,1917,9520
6.308,1,3,168,3,28,3154,28,168,0,0,0,0,0
0.403,6,12,1653,6,288,75,288,548,6,426,44,434,1105
50.586,6,30,8872,13,158,4215,267,1317,17,687,3159,1400,7555
0.299,17,2,152,1,48,0,48,76,1,48,0,48,76
4.953,17,3,208,2,36,4921,36,128,1,52,0,52,80
1080.451,6,152,28862,94,483,11617,483,22767,58,83,18954,83,6095
1.533,6,19,3781,10,234,170,564,1452,9,463,167,1343,2329
280.501,6,30,7432,13,158,23375,267,1317,17,678,17528,2760,6115
0.458,6,23,4531,12,165,41,456,1446,11,415,40,888,3085
113.115,6,77,52442,48,1176,2406,1408,41384,29,867,2202,1408,11058
0.507,6,50,20237,27,930,19,1380,15075,23,421,20,1923,5162
1.651,6,16,1575,8,181,235,181,810,8,82,224,154,765
299.527,6,6,364,4,31,99842,31,222,2,31,299515,31,142
10.941,6,18,5610,10,275,1215,275,958,8,1440,846,1440,4652
282.238,6,32,7521,14,158,21710,267,1357,18,544,16598,1380,6164
1.677,6,12,2271,7,188,279,245,660,5,1407,355,1407,1611
1770.471,6,106,9823,69,65,26036,65,5822,37,59,49177,59,4001
1749.677,17,12,498,11,14,174967,14,462,1,8,0,8,36
8.316,6,66,20206,34,565,252,1152,15499,32,489,259,1179,4707
1787.152,17,144,11520,72,48,25170,48,5472,72,56,25165,56,6048
1744.929,6,95,7203,63,38,28144,205,4476,32,33,56273,98,2727
1775.941,6,181,15589,120,69,14923,69,8940,61,69,29593,69,6649
1783.814,17,44,14784,44,308,41484,308,14784,0,0,0,0,0
0.86,6,10,1687,7,100,143,100,384,3,1179,307,1179,1303
212.255,6,45,8794,21,112,10612,267,1971,24,292,9226,1452,6823
1778.11,1,60,5040,60,56,30137,56,5040,0,0,0,0,0
1794.134,1,59,4956,59,56,30933,56,4956,0,0,0,0,0
1792.215,6,372,26319,215,104,8374,469,15623,157,69,11487,69,10696
2.959,17,3,1021,2,308,1960,308,672,1,321,0,321,349
154.077,6,24,10727,13,726,97,1329,3457,11,974,15386,2720,7270
240.215,6,53,15615,28,663,8896,1402,12745,25,195,10008,580,2870
1.303,6,51,19262,27,886,50,1360,13526,24,433,48,1360,5736
0.215,6,10,1514,5,503,53,503,771,5,475,53,475,743
3.714,17,31,12364,13,516,309,1350,7083,18,265,209,1350,5281
1.701,17,2,152,1,48,0,48,76,1,48,0,48,76
18.367,6,2808,2704783,1874,1368,9,1408,2651551,934,776,19,1408,53232
101.862,6,29,13893,16,850,59,1360,6622,13,1123,8474,2720,7271
9.636,6,79,24365,40,550,247,1152,18664,39,459,245,1179,5701
1.324,6,47,18698,26,923,52,1440,13082,21,433,57,1440,5616
4.96,6,24,8349,13,522,413,1018,2252,11,788,494,1491,6097
1681.925,6,24,3624,16,241,112128,241,2568,8,92,240248,92,1056
0.093,6,9,1340,5,145,23,145,349,4,827,26,827,991
0.02,17,4,317,2,39,19,39,134,2,63,9,72,183
159.089,6,19040,18356636,12799,1357,12,1408,18027440,6241,776,25,1408,329196
155.395,6,31,14640,16,488,325,1360,3125,15,1211,11090,3928,11515
288.703,17,4,352,2,60,288702,60,176,2,60,288701,60,176
101.136,6,18,4149,9,296,12642,722,1353,9,581,12620,2026,2796
1794.098,17,80,3354,79,14,23001,14,3318,1,8,0,8,36
22.36,17,4,1344,4,308,7453,308,1344,0,0,0,0,0
76.079,17,3,1026,1,300,0,300,328,2,321,75084,321,698
0.052,6,10,583,5,43,13,43,311,5,0,10,0,272
12.391,6,17,1538,8,275,1770,275,878,9,96,1505,96,660
1758.089,1,67,5628,67,56,26637,56,5628,0,0,0,0,0
0.489,6,50,19698,28,1028,18,1380,14531,22,387,20,1923,5167
33.736,6,29,4988,15,154,2409,721,1857,14,479,2580,2026,3131
2.064,6,29,10365,17,367,129,833,1785,12,1012,179,1420,8580
7.624,6,7,533,4,245,2541,245,409,3,0,2794,0,124
0.909,6,11,1727,7,100,151,100,384,4,589,219,1152,1343
1793.618,17,144,11520,72,48,25262,48,5472,72,56,25262,56,6048
80.398,6,41,8316,16,155,99,267,1442,25,325,3349,2006,6874
1.995,6,9,527,5,43,498,43,311,4,0,663,0,216
60.97,6,67,47102,43,801,1451,1408,7538,24,1824,2648,10419,39564
1681.644,1,15,840,15,28,120117,28,840,0,0,0,0,0
1785.271,6,102,8364,68,66,26645,66,4964,34,60,54096,60,3400
48.145,6,27,7183,13,156,4012,267,1312,14,530,3702,3417,5871
0.118,6,40,33810,14,215,9,517,1586,26,1402,4,2876,32224
1776.867,17,142,11360,71,48,25383,48,5396,71,56,25383,56,5964
158.203,6,33,16642,15,634,81,1360,3181,18,1060,9297,1360,13461
1799.996,6,195,13596,69,46,26039,46,5658,126,46,14398,46,7938
721.967,2,8,256,8,8,103138,8,256,0,0,0,0,0
0.716,6,27,5927,13,156,59,267,1462,14,650,50,1420,4465
1.248,6,38,9848,21,440,62,1360,4392,17,529,67,4075,5456
225.741,17,6,528,3,60,112870,60,264,3,60,112870,60,264
0.079,17,2,196,1,46,0,46,74,1,94,0,94,122
1790.705,1,80,6720,0,0,0,0,0,80,56,22667,56,6720
1789.177,17,142,11360,71,48,25559,48,5396,71,56,25559,56,5964
1679.531,17,12,498,11,14,167953,14,462,1,8,0,8,36
280.488,6,28,7352,13,158,23374,267,1317,15,603,20029,2076,6035
1737.829,1,56,4704,0,0,0,0,0,56,56,31596,56,4704
10.664,6,97,30713,48,588,226,1152,24271,49,447,210,1179,6442
65.813,6,15,1868,8,302,9401,302,1318,7,83,10947,83,550
1796.494,17,448,39612,404,35,4457,288,25708,44,288,40949,288,13904
16.829,17,39,18182,20,636,884,1350,13293,19,229,933,1350,4889
2.396,17,19,6924,9,471,299,1350,4497,10,214,262,1350,2427
1.426,6,52,21641,29,922,50,1360,15945,23,433,56,1360,5696
4.876,17,6,1362,6,199,975,208,1362,0,0,0,0,0
0.044,17,2,206,1,44,0,44,72,1,106,0,106,134
11.86,6,1938,1639616,1156,1364,10,1380,1603962,782,383,15,1380,35654
1739.459,6,112,8732,70,44,25209,150,5191,42,38,42425,163,3541
0.007,17,2,144,1,36,0,36,64,1,52,0,52,80
22.031,17,30,14045,13,319,1833,1350,4518,17,532,1375,1350,9527
1799.642,17,303,70316,303,204,5959,356,70316,0,0,0,0,0
0.1,6,9,2074,6,596,19,1033,1437,3,513,48,513,637
72.011,1,12,1248,0,0,0,0,0,12,76,6546,76,1248
1794.791,1,206,11536,206,28,8755,28,11536,0,0,0,0,0
0.006,6,2,149,1,0,0,0,40,1,69,0,69,109
1.909,6,2,100,1,0,0,0,60,1,0,0,0,40
1.105,6,24,8004,12,164,85,267,1288,12,1014,85,2804,6716
0.067,6,9,1002,5,213,16,213,417,4,421,18,421,585
280.272,6,29,7392,13,158,23356,267,1317,16,603,18680,2036,6075
60.362,6,27,7177,13,155,5030,267,1306,14,530,4642,3417,5871
0.025,6,12,3462,6,75,4,75,395,6,1373,4,1448,3067
1.346,6,51,19821,29,920,48,1360,14120,22,400,55,1360,5701
1795.944,17,447,39864,402,35,4478,288,25644,45,288,40022,288,14220
0.004,6,3,4011,1,0,0,0,40,2,1945,0,2760,3971
74.231,6,11,1691,11,139,7423,139,1691,0,0,0,0,0
0.007,17,2,399,1,39,0,39,67,1,304,0,304,332
1680.478,1,15,870,15,30,120034,30,870,0,0,0,0,0
68.947,6,25,7097,12,155,6267,267,1266,13,589,5744,3426,5831
1785.357,6,356,22520,208,69,8624,69,12460,148,69,12145,69,10060
1787.358,6,102,8228,68,64,26676,64,4896,34,58,54160,58,3332
1788.529,17,141,11276,71,48,25549,48,5396,70,56,25920,56,5880
10.886,6,18,4266,10,275,1209,275,958,8,992,867,1440,3308
1745.643,6,98,7359,63,38,28155,205,4476,35,33,51333,98,2883
694.318,17,10,821,5,31,173571,37,297,5,76,173569,136,524
0.136,17,2,445,1,34,0,34,62,1,355,0,355,383
312.32,6,75,49154,45,1203,7098,1408,40861,30,960,2123,3847,8293
1796.9,6,430,25810,215,69,8396,69,12809,215,35,8396,69,13001
1680.421,1,15,840,15,28,120030,28,840,0,0,0,0,0
0.126,17,2,389,1,34,0,34,62,1,299,0,299,327
1.323,17,4,360,2,30,1310,30,116,2,94,1311,94,244
73.342,6,23,6458,10,262,8144,517,1314,13,744,6107,1408,5144
1717.834,17,17,5622,17,302,107364,1451,5622,0,0,0,0,0
0.065,17,11,6679,7,513,10,1350,3792,4,693,8,1350,2887
1263.331,2,15,480,15,8,90237,8,480,0,0,0,0,0
20.312,6,49,22981,26,248,812,682,2378,23,1212,920,1569,20603
206.682,17,4,352,2,48,206670,48,152,2,72,206671,72,200
1799.998,6,215,16893,80,71,22784,338,8162,135,49,13431,143,8731
300.682,6,39,8545,21,299,15034,852,2071,18,441,496,1360,6474
1796.295,6,367,23236,212,69,8513,69,12896,155,69,11663,69,10340
280.242,6,28,7352,12,158,25476,267,1277,16,603,18679,1400,6075
182.218,6,28,7352,13,158,15184,267,1317,15,678,13013,3436,6035
293.258,6,85,30892,42,594,7152,1418,11107,43,762,6982,1418,19785
0.841,6,2,111,1,0,0,0,40,1,31,0,31,71
10.772,6,20,4442,11,275,1077,275,998,9,768,783,1440,3444
610.396,1,8,448,8,28,87199,28,448,0,0,0,0,0
1788.497,1,58,4872,58,56,31377,56,4872,0,0,0,0,0
0.419,6,12,3704,6,171,82,171,491,6,964,81,1448,3213
1.17,6,25,8056,12,164,90,267,1288,13,869,82,1448,6768
1.439,6,16,2024,8,256,204,256,1092,8,304,204,304,932
137.766,6,20,4572,8,271,136,515,1139,12,327,12515,1452,3433
382.37,6,17,1266,11,106,38237,106,978,6,0,6295,0,288
1770.532,6,103,9514,66,66,27238,66,5610,37,60,49178,60,3904
1772.354,6,180,15480,120,69,14893,69,8940,60,69,30038,69,6540
1.252,6,41,10455,21,499,62,1360,4879,20,433,57,1360,5576
29.209,1,4,224,4,28,9736,28,224,0,0,0,0,0
1230.067,6,73,5803,48,65,26171,65,3415,25,57,51249,59,2388
1.717,6,13,2311,8,188,245,245,700,5,1407,363,1407,1611
0.021,17,2,251,1,31,0,31,59,1,164,0,164,192
1743.546,6,95,7203,63,38,28121,205,4476,32,33,56231,98,2727
432.204,6,87,13186,41,146,10800,721,5605,46,337,9600,1440,7581
58.607,6,6,336,4,0,19535,0,216,2,0,2204,0,120
292.438,6,44,7828,20,121,15389,517,2019,24,504,12712,1418,5809
158.799,6,22,9200,11,499,86,1193,1995,11,964,15861,1360,7205
1680.574,17,12,498,11,14,168057,14,462,1,8,0,8,36
479.13,17,40,3200,20,48,25216,48,1520,20,56,25216,56,1680
1782.629,6,180,15480,120,69,14980,69,8940,60,69,30209,69,6540
93.198,17,22,3352,11,48,9319,48,836,11,200,9318,308,2516
1785.041,17,219,56102,219,228,8188,422,56102,0,0,0,0,0
1794.647,17,1942,147523,1058,40,1697,41,72648,884,56,2032,57,74875
1.054,17,4,368,2,32,865,32,120,2,96,911,96,248
121.425,17,5830,5148316,2127,38,57,1350,140658,3703,1324,32,1350,5007658
0.155,6,10,767,5,186,38,186,454,5,45,38,45,313
5.447,6,40,7309,21,218,272,314,3463,19,440,287,1152,3846
2.509,17,3,1176,3,364,1254,364,1176,0,0,0,0,0
12.76,6,17,2349,9,324,1595,585,1125,8,396,1678,580,1224
0.244,1,2,112,2,28,244,28,112,0,0,0,0,0
1.16,6,24,8004,12,164,89,267,1288,12,1014,89,2804,6716
0.036,17,2,152,1,48,0,48,76,1,48,0,48,76
7.262,17,35,24605,17,616,453,1350,10959,18,730,306,1350,13646
0.066,17,2,616,1,60,0,60,88,1,500,0,500,528
5.006,17,4,558,2,36,5002,36,128,2,187,5000,187,430
274.954,17,4,352,2,60,274953,60,176,2,60,274952,60,176
1785.885,6,377,23843,215,69,8345,69,13223,162,69,11092,69,10620
0.277,6,9,1340,5,145,69,145,349,4,827,63,827,991
1.347,6,48,18204,26,882,53,1360,12548,22,476,55,2720,5656
13.51,6,35,9889,17,338,844,1314,2374,18,485,793,1460,7515
1.28,6,30,6220,16,138,85,267,1755,14,780,86,1460,4465
1798.381,17,449,39928,404,35,4462,288,25708,45,288,40021,288,14220
15.748,17,19,12168,11,869,1568,1350,9867,8,259,2237,1350,2301
1783.668,17,87,3658,84,14,21489,15,3530,3,14,246352,18,128
13.635,6,25,7103,12,156,1239,267,1272,13,589,1135,3426,5831
299.257,17,15,5072,15,310,21375,326,5072,0,0,0,0,0
0.353,17,2,152,1,48,0,48,76,1,48,0,48,76
287.291,6,31,3769,15,237,20520,585,1501,16,357,19152,580,2268
14.522,17,4,3100,4,747,4840,1451,3100,0,0,0,0,0
15.647,6,7,380,2,0,15647,0,100,5,0,3870,0,280
125.816,2,2,64,2,8,125816,8,64,0,0,0,0,0
1.02,17,5,728,3,32,507,32,180,2,246,5,246,548
3.712,17,4,1556,4,361,1237,361,1556,0,0,0,0,0
20.868,17,4,352,2,60,20867,60,176,2,60,20867,60,176
104.373,6,24,9832,12,465,80,1360,2373,12,995,9473,1360,7459
2.089,17,4,706,3,39,1001,39,201,1,477,0,477,505
9.069,6,87,26853,44,555,210,1152,20651,43,407,209,1152,6202
0.688,17,4,288,2,36,655,36,128,2,52,655,52,160
224.852,17,4,352,2,60,224851,60,176,2,60,224851,60,176
0.562,6,21,7281,13,334,46,663,2021,8,967,75,1471,5260
15.108,6,3,440,1,0,0,0,40,2,160,15104,160,400
1786.42,6,102,8296,68,65,26662,65,4930,34,59,54131,59,3366
120.236,17,4846,4360236,1723,38,69,1350,113972,3123,1331,38,1350,4246264
0.172,6,26,7256,12,155,15,267,1261,14,603,12,1400,5995
2.014,17,2,204,1,34,0,34,62,1,114,0,114,142
9.205,6,17,5391,9,275,1150,275,643,8,1104,1251,1440,4748
9.897,6,82,24501,41,550,247,1152,18720,41,459,241,1179,5781
807.793,17,6,2073,1,300,0,300,328,5,321,201699,321,1745
0.958,17,2,312,2,128,958,128,312,0,0,0,0,0
290.694,6,28,7352,13,158,24224,267,1317,15,775,20761,4836,6035
1.939,17,2,463,1,29,0,29,57,1,378,0,378,406
1747.351,6,95,7203,63,38,28183,205,4476,32,33,56357,98,2727
1789.953,6,386,31957,223,140,8062,1189,18774,163,88,11049,453,13183
1295.033,6,131,11243,87,69,15058,69,6516,44,69,30116,69,4727
19.41,6,18,2474,10,210,2153,210,956,8,545,2771,904,1518
1780.923,1,166,17596,166,78,10793,78,17596,0,0,0,0,0
0.889,6,29,8610,15,229,54,583,2031,14,858,55,1360,6579
483.323,6,73,11018,42,91,11788,267,3432,31,234,16104,1420,7586
74.537,6,40,11003,12,177,231,267,1738,28,406,2759,1460,9265
138.434,6,30,7432,13,158,11536,267,1317,17,543,8651,1400,6115
1.293,2,3,96,3,8,646,8,96,0,0,0,0,0
136.143,6,35,15272,17,894,84,1360,6089,18,768,7997,1360,9183
1741.04,6,87,6322,58,31,30544,31,3915,29,31,62179,31,2407
2.343,6,36,11532,19,199,127,561,2214,17,1078,135,1631,9318
1794.023,1,58,4872,0,0,0,0,0,58,56,31474,56,4872
61.386,6,13,1040,7,226,10231,226,594,6,110,12238,110,446
1790.156,6,361,22858,210,69,8565,69,12678,151,69,11934,69,10180
120.303,2,2,64,2,8,120303,8,64,0,0,0,0,0
240.304,6,39,7355,19,460,13349,1418,4678,20,232,12646,580,2677
55.949,17,4,240,2,32,55948,32,120,2,32,55948,32,120
0.136,6,3,120,1,0,0,0,40,2,0,135,0,80
1779.264,17,73,3060,72,14,25060,14,3024,1,8,0,8,36
375.413,6,1028,986969,349,233,1078,950,20729,679,1397,553,2836,966240
1796.327,17,447,39580,403,35,4468,288,25676,44,288,40950,288,13904
1770.286,6,103,9448,66,65,27235,65,5577,37,59,49171,59,3871
0.418,6,48,20740,27,1039,16,1380,15658,21,421,19,1923,5082
0.011,17,2,586,1,46,0,46,74,1,484,0,484,512
1.916,17,3,174,3,30,958,30,174,0,0,0,0,0
7.271,6,32,8952,14,158,559,267,1357,18,624,424,1400,7595
215.297,6,31,6806,13,189,9056,516,1470,18,307,12659,1452,5336
39.033,17,44,6468,22,48,1858,48,1672,22,190,1858,308,4796
1746.114,6,101,7912,65,45,27283,205,4844,36,35,49878,98,3068
1786.732,6,359,22709,209,69,8590,69,12569,150,69,11988,69,10140
299.904,6,6,364,4,31,99968,31,222,2,31,299890,31,142
1786.893,6,104,8424,68,64,26670,64,4896,36,58,51051,58,3528
8.001,6,38,7320,18,218,470,314,3343,20,453,407,1179,3977
0.254,17,3,451,2,39,101,39,134,1,289,0,289,317
372.224,6,18,1242,14,180,28632,180,916,4,110,20062,110,326
1.38,6,36,8174,19,321,76,1164,2718,17,476,75,2720,5456
1737.832,1,64,5376,64,56,27584,56,5376,0,0,0,0,0
33.418,6,29,4992,14,180,2570,722,1808,15,342,2374,1408,3184
61.309,6,35,15899,22,807,2919,1408,9225,13,855,5088,3847,6674
1799.136,6,363,22938,211,69,8567,69,12649,152,69,11718,69,10289
1420.957,17,140,11651,130,30,11015,37,7575,10,379,151250,463,4076
0.381,6,10,1992,5,288,93,288,508,5,424,51,434,1484
1778.331,17,142,11360,71,48,25404,48,5396,71,56,25404,56,5964
15.461,17,21,6197,9,251,1928,1350,2511,12,279,1402,1350,3686
1.067,6,32,12924,16,529,71,1460,3330,16,812,57,1460,9594
1768.774,17,46,15440,46,307,39306,308,15440,0,0,0,0,0
8.575,6,20,10969,6,275,1715,275,519,14,823,568,1440,10450
31.957,6,26,10432,8,154,4565,267,792,18,636,1878,1460,9640
0.25,6,23,6019,12,181,22,537,1526,11,782,24,2231,4493
15.133,17,6,528,3,48,7561,48,228,3,72,7561,72,300
248.848,6,2056,1054934,1142,856,218,1152,1008809,914,382,272,1179,46125
70.39,6,26,7158,10,155,7821,267,1186,16,443,4679,1420,5972
0.063,17,4,284,2,32,0,32,120,2,54,0,60,164
1386.353,2,8,256,8,8,198050,8,256,0,0,0,0,0
1744.605,2,19,608,19,8,96922,8,608,0,0,0,0,0
160.708,6,21,8750,11,327,73,640,1453,10,1147,17842,2568,7297
12.087,6,94,28482,50,546,246,1152,22224,44,449,274,1179,6258
280.395,6,28,7352,12,158,25490,267,1277,16,603,18689,1400,6075
0.723,17,4,624,2,64,444,64,184,2,192,445,192,440
477.747,17,15,5044,15,308,34124,312,5044,0,0,0,0,0
0.051,6,10,1512,5,503,12,503,771,5,473,12,473,741
1784.847,6,117,13795,75,81,24119,501,5950,42,162,43530,1420,7845
280.202,6,28,7352,13,158,23350,267,1317,15,678,20011,2045,6035
1796.809,17,180,14040,180,50,10038,50,14040,0,0,0,0,0
0.075,6,10,767,5,186,17,186,454,5,45,14,45,313
7.05,6,1428,1337172,919,1379,7,1408,1305942,509,792,13,1408,31230
1773.05,6,180,15480,120,69,14899,69,8940,60,69,30048,69,6540
0.667,6,3,144,2,0,667,0,92,1,0,0,0,52
285.346,1,4,326,4,53,95115,78,326,0,0,0,0,0
1793.457,1,128,7168,128,28,14121,28,7168,0,0,0,0,0
0.193,6,21,5000,10,137,21,267,1092,11,692,18,1467,3908
1789.506,17,142,11360,71,48,25564,48,5396,71,56,25564,56,5964
1156.486,17,199,15124,199,48,5840,48,15124,0,0,0,0,0
280.295,6,29,7392,13,158,23357,267,1317,16,603,18682,1400,6075
0.024,17,2,410,1,36,0,36,64,1,318,0,318,346
1.661,6,52,20938,30,930,57,1360,15237,22,400,71,1360,5701
1796.091,6,387,27402,222,102,8127,469,16248,165,69,10950,69,11154
0.049,17,4,284,2,32,34,32,120,2,54,34,60,164
8.209,6,33,6440,19,120,456,267,1971,14,780,607,1491,4469
1740.725,17,30,6930,30,203,60025,203,6930,0,0,0,0,0
1682.045,17,14,1036,7,30,280335,30,406,7,62,280335,62,630
14.767,17,9,2348,5,40,3691,41,344,4,473,4579,505,2004
1793.294,17,140,11200,70,48,25989,48,5320,70,56,25989,56,5880
0.085,17,2,245,1,32,0,32,60,1,157,0,157,185
12.042,17,3,222,3,46,6021,46,222,0,0,0,0,0
1783.811,6,365,24963,213,94,8414,469,14467,152,69,11813,69,10496
1742.365,1,15,870,15,30,124454,30,870,0,0,0,0,0
56.88,6,11,3542,11,330,5688,330,3542,0,0,0,0,0
840.886,17,8,592,4,30,280285,30,232,4,62,280290,62,360
280.386,6,30,7432,13,158,23365,267,1317,17,543,17519,1400,6115
1774.526,6,267,19642,135,69,13242,69,9609,132,36,13545,69,10033
5.6,6,709,656018,462,1348,11,1368,636270,247,931,21,2736,19748
240.194,6,55,19321,30,815,8282,1408,16248,25,220,10007,580,3073
1771.118,6,105,6270,60,27,30018,27,3525,45,27,40251,27,2745
8.411,6,16,4519,9,147,1051,202,771,7,844,21,1647,3748
467.27,6,124,15041,61,145,7787,1173,5365,63,216,7534,1460,9676
0.341,6,27,9076,13,252,28,647,1692,14,831,25,1408,7384
5.499,6,42,7389,22,218,261,314,3503,20,440,275,1152,3886
0.212,17,2,348,1,39,0,39,67,1,253,0,253,281
0.176,17,2,396,1,39,0,39,67,1,301,0,301,329
5.189,17,4,352,2,48,5043,48,152,2,72,5058,72,200
0.762,17,4,580,2,40,741,40,136,2,194,742,194,444
1789.768,17,44,14784,44,308,41622,308,14784,0,0,0,0,0
1783.939,6,367,25581,213,99,8414,469,15005,154,69,11659,69,10576
1.484,6,41,9968,21,440,74,1360,4392,20,433,68,1360,5576
0.839,6,23,6426,13,313,69,906,2092,10,982,92,1731,4334
5.019,17,3,208,2,36,5002,36,128,1,52,0,52,80
8.347,6,54,20435,28,893,309,1440,14555,26,433,326,1440,5880
104.513,17,4,1344,4,308,34837,308,1344,0,0,0,0,0
0.965,6,25,8805,14,290,74,802,1753,11,942,77,1460,7052
0.497,17,2,476,1,39,0,39,67,1,381,0,381,409
1790.697,6,356,22520,208,69,8650,69,12460,148,69,12181,69,10060
1740.86,1,86,7224,86,56,20480,56,7224,0,0,0,0,0
240.485,6,52,17648,27,793,9249,1402,14893,25,206,10019,580,2755
0.007,17,3,401,2,39,0,39,134,1,239,0,239,267
1.038,17,3,215,2,33,934,33,122,1,65,0,65,93
317.029,6,104,34456,56,519,5764,1360,23553,48,358,6742,4649,10903
31.608,6,7,336,1,0,0,0,48,6,0,6319,0,288
2.746,2,2,64,2,8,2746,8,64,0,0,0,0,0
1782.331,6,238,23759,144,75,12463,267,10686,94,132,19164,1420,13073
1760.817,6,79,4198,40,26,45148,26,2132,39,26,46336,26,2066
256.12,1,14,784,14,28,19701,28,784,0,0,0,0,0
1784.054,6,117,13432,74,162,24439,1272,8983,43,73,42475,241,4449
795.091,17,13,4368,13,308,66257,308,4368,0,0,0,0,0
307.989,6,44,3158,17,65,17375,292,1463,27,47,11845,78,1695
0.008,6,10,1371,5,126,1,126,394,5,356,1,380,977
240.203,6,56,20941,30,863,8282,1418,17965,26,202,9607,580,2976
1.992,6,10,1691,6,100,398,100,344,4,1179,581,1179,1347
25.286,6,48,13179,24,175,1099,721,2723,24,791,1089,2840,10456
0.013,6,4,222,2,31,13,31,111,2,31,0,31,111
1751.044,1,61,5124,61,56,29184,56,5124,0,0,0,0,0
0.047,17,4,368,2,32,26,32,120,2,96,28,96,248
221.252,6,134,36079,68,445,3302,1360,24226,66,224,3390,2720,11853
12.477,6,9,376,5,0,3117,0,204,4,0,4155,0,172
1792.869,17,142,11360,71,48,25612,48,5396,71,56,25612,56,5964
11.167,6,27,11355,13,275,930,275,1078,14,1078,821,1414,10277
1783.284,17,83,3480,82,14,22015,14,3444,1,8,0,8,36
1700.479,1,8,448,8,28,242925,28,448,0,0,0,0,0
5.003,17,4,288,2,36,5002,36,128,2,52,5001,52,160
960.542,6,215913,213970291,75396,335,12,338,4087315,140517,1441,6,4314,209882976
1776.125,6,207,23921,133,89,13455,981,11158,74,139,24325,3457,12763
0.254,17,2,184,1,32,0,32,60,1,96,0,96,124
0.912,6,32,12164,17,525,57,1360,3350,15,820,53,1380,8814
1786.16,6,102,8364,68,66,26659,66,4964,34,60,54114,60,3400
1772.757,6,181,15589,120,69,14897,69,8940,61,69,29540,69,6649
0.01,17,2,304,1,37,0,37,65,1,211,0,211,239
1680.506,1,15,870,15,30,120036,30,870,0,0,0,0,0
1769.768,6,101,9344,66,65,27227,65,5577,35,59,52048,59,3767
300.662,6,38,8566,20,315,15824,882,2093,18,441,497,1440,6473
4.103,17,10,1450,5,40,1022,40,340,5,194,1022,194,1110
191.293,17,4,352,2,60,191292,60,176,2,60,191292,60,176
27.424,6,3840,3557541,2359,1424,11,1448,3472013,1481,776,18,1448,85528
51.796,6,63,13219,28,543,588,800,3975,35,290,1518,2128,9244
0.308,6,22,7342,13,335,25,668,2026,9,1210,37,1906,5316
1.66,6,51,29752,25,243,69,444,2058,26,1315,61,1551,27694
19.308,6,20,6487,6,154,3861,267,712,14,520,1473,1452,5775
7.144,6,65,21019,35,575,210,1152,16376,30,491,237,1179,4643
10.441,6,10,579,5,43,2610,43,311,5,0,2590,0,268
0.006,17,2,237,1,34,0,34,62,1,147,0,147,175
10.762,6,18,5550,10,275,1195,275,958,8,1420,856,1420,4592
22.85,6,48,18666,20,375,1202,994,2432,28,686,840,1440,16234
1763.343,2,15,480,15,8,125953,8,480,0,0,0,0,0
1784.452,6,415,24949,207,69,8662,69,12420,208,34,8620,48,12529
1798.613,1,254,14224,254,28,7109,28,14224,0,0,0,0,0
25.13,6,53,14863,26,517,1005,1152,10878,27,414,956,1179,3985
240.203,6,53,17996,28,807,8896,1408,15199,25,186,10008,580,2797
0.052,17,2,418,1,37,0,37,65,1,325,0,325,353
45.044,17,11,11720,11,1037,4504,1044,11720,0,0,0,0,0
240.209,6,54,17296,29,764,8578,1402,14519,25,183,10008,580,2777
259.178,17,4,352,2,60,259177,60,176,2,60,259177,60,176
176.645,6,21,8279,11,525,98,1237,2048,10,1163,19606,3151,6231
1780.615,1,256,14336,256,28,6982,28,14336,0,0,0,0,0
0.353,17,8,2750,8,315,50,354,2750,0,0,0,0,0
1.668,6,26,8813,16,286,111,592,1504,10,986,166,1420,7309
8.085,17,4,352,2,48,8077,48,152,2,72,8076,72,200
3.177,17,5,295,5,31,794,31,295,0,0,0,0,0
219.031,17,4,352,2,60,219030,60,176,2,60,219030,60,176
1775.279,17,73,3060,72,14,25003,14,3024,1,8,0,8,36
0.98,6,25,9015,13,264,81,700,1623,12,985,73,1360,7392
175.86,6,267,218762,169,1345,1046,1448,199871,98,599,1810,2359,18891
30.954,6,35,9021,18,262,1820,721,2826,17,612,1887,1440,6195
0.536,6,2,1540,2,1460,536,1460,1540,0,0,0,0,0
0.004,17,2,356,1,32,0,32,60,1,268,0,268,296
1772.108,6,180,15480,120,69,14891,69,8940,60,69,30034,69,6540
1774.26,17,140,11200,70,48,25713,48,5320,70,56,25713,56,5880
0.626,6,24,7446,12,335,56,668,1974,12,806,56,1408,5472
1.566,17,4,896,2,64,1560,64,184,2,328,1560,344,712
0.024,17,2,482,1,37,0,37,65,1,389,0,389,417
125.129,6,23,10665,13,720,3005,1308,3435,10,1136,13883,3151,7230
0.279,17,2,198,1,63,0,63,91,1,79,0,79,107
0.424,6,2,80,1,0,0,0,40,1,0,0,0,40
1.089,6,23,7952,12,164,84,267,1288,11,1216,93,3819,6664
1716.918,2,13,416,13,8,143076,8,416,0,0,0,0,0
1.693,6,48,4977,24,131,73,1357,3068,24,135,64,460,1909
226.383,17,4,352,2,60,226382,60,176,2,60,226382,60,176
240.423,6,56,23885,26,539,9616,1402,6211,30,947,8290,2404,17674
258.677,6,107,21779,51,439,5173,1360,11033,56,229,4692,1360,10746
1787.315,6,102,8228,68,64,26676,64,4896,34,58,54157,58,3332
0.104,17,2,245,1,32,0,32,60,1,157,0,157,185
0.01,17,2,494,1,64,0,64,92,1,374,0,374,402
88.196,17,11,836,11,48,8819,48,836,0,0,0,0,0
84.276,6,25,6318,9,272,93,516,1180,16,345,5612,1452,5138
1770.498,6,101,9344,66,65,27238,65,5577,35,59,52070,59,3767
5.006,17,4,288,2,36,5004,36,128,2,52,5004,52,160
22.652,6,28,10555,15,695,1618,1360,3427,13,942,1872,3601,7128
0.03,17,2,487,1,40,0,40,68,1,391,0,391,419
166.485,1,4,224,4,28,55495,28,224,0,0,0,0,0
280.449,6,29,7392,13,158,23370,267,1317,16,678,18693,2760,6075
1.417,6,47,19463,27,912,54,1360,13887,20,476,64,2715,5576
15.212,17,23,16437,13,853,1264,1350,11453,10,470,1686,1350,4984
1763.708,2,14,448,14,8,135669,8,448,0,0,0,0,0
51.999,6,34,8180,19,164,2888,517,2145,15,583,3709,1388,6035
246.567,17,2,368,2,156,246567,156,368,0,0,0,0,0
0.659,6,20,7168,12,319,59,602,1908,8,1209,93,1906,5260
149.626,6,30,8872,14,158,11509,267,1357,16,763,9971,2076,7515
2.96,1,30,840,30,0,0,0,840,0,0,0,0,0
286.5,6,32,3312,16,324,19099,584,1524,16,192,19099,580,1788
233.368,17,4,352,2,60,233366,60,176,2,60,233367,60,176
1.535,6,74,51858,42,1275,37,1408,44289,32,1179,44,3819,7569
120.311,2,3,96,3,8,60155,8,96,0,0,0,0,0
1796.445,1,58,4872,0,0,0,0,0,58,56,31516,56,4872
1796.939,1,345,28980,345,56,5223,56,28980,0,0,0,0,0
1745.245,6,105,8207,67,42,26443,205,4845,38,38,47163,149,3362
48.716,17,4,1344,4,308,16238,308,1344,0,0,0,0,0
1788.094,6,356,22520,208,69,8638,69,12460,148,69,12163,69,10060
1788.658,6,375,26246,217,98,8280,469,15303,158,69,11392,69,10943
1121.879,17,12,3294,6,30,224373,30,348,6,463,224373,463,2946
1787.5,6,102,8296,68,65,26679,65,4930,34,59,54162,59,3366
1740.754,17,30,20190,30,645,60026,645,20190,0,0,0,0,0
217.198,1,4,224,4,28,72399,28,224,0,0,0,0,0
514.048,6,98,6197,55,69,8584,69,3304,43,69,12239,69,2893
1781.293,17,136,10880,68,48,26586,48,5168,68,56,26586,56,5712
541.436,2,4,128,4,8,180478,8,128,0,0,0,0,0
0.45,17,2,178,1,29,0,29,57,1,93,0,93,121
4.945,17,4,558,2,36,4940,36,128,2,187,4940,187,430
0.455,6,98,70045,62,1262,7,1420,64384,36,467,12,1883,5661
1.305,6,48,19804,28,871,48,1360,14228,20,476,59,2715,5576
240.193,6,53,18073,28,808,8895,1418,15215,25,193,10007,580,2858
1681.613,17,14,1036,7,30,280265,30,406,7,62,280266,62,630
1792.74,1,140,7840,140,28,12897,28,7840,0,0,0,0,0
1788.43,6,356,22520,208,69,8639,69,12460,148,69,12166,69,10060
54.081,6,14,1847,5,100,163,100,304,9,1179,6728,1179,1543
5.155,17,126,172852,124,1365,20,1472,172772,2,12,5007,12,80
0.707,6,144,105040,85,1319,8,1420,98459,59,467,12,1883,6581
1720.481,17,12,498,11,14,172048,14,462,1,8,0,8,36
0.025,17,2,180,1,30,0,30,58,1,94,0,94,122
1797.341,17,448,39896,403,35,4470,288,25676,45,288,40019,288,14220
1787.206,6,356,22520,208,69,8633,69,12460,148,69,12157,69,10060
240.369,6,44,8468,23,449,10925,1418,5700,21,208,12017,580,2768
316.959,6,100,34103,55,518,5869,1360,23504,45,399,7200,3289,10599
0.473,17,2,384,1,39,0,39,67,1,289,0,289,317
12.876,6,823,736519,537,1300,23,1368,716983,286,776,44,1473,19536
163.279,6,32,13049,10,211,8288,516,1460,22,629,7770,1452,11589
43.521,6,42,8836,21,410,443,882,2150,21,416,2169,3488,6686
1111.138,17,220,16720,220,48,5073,48,16720,0,0,0,0,0
280.544,6,27,7312,12,158,25504,267,1277,15,775,20033,3465,6035
1785.859,6,363,24814,212,94,8463,469,14427,151,69,11905,69,10387
3.3,17,2,204,1,34,0,34,62,1,114,0,114,142
280.543,17,4,296,2,30,280499,30,116,2,62,280490,62,180
1.614,17,2,136,1,32,0,32,60,1,48,0,48,76
94.52,6,11,719,11,31,9452,31,719,0,0,0,0,0
0.764,6,11,1727,7,100,127,100,384,4,589,171,1152,1343
1734.82,17,144,23130,144,132,12131,373,23130,0,0,0,0,0
0.014,17,3,716,2,64,0,64,184,1,504,0,504,532
176.68,17,4,352,2,60,176679,60,176,2,60,176678,60,176
176.946,6,33,18128,17,636,47,1360,3943,16,1230,11786,4854,14185
1681.656,17,14,1036,7,30,280270,30,406,7,62,280270,62,630
280.446,6,30,7432,13,158,23370,267,1317,17,603,17525,2600,6115
0.037,17,2,904,1,300,0,300,328,1,548,0,548,576
1786.619,17,87,3648,86,14,21019,14,3612,1,8,0,8,36
1701.416,17,12,498,11,14,170141,14,462,1,8,0,8,36
19.155,17,4,352,2,60,19154,60,176,2,60,19154,60,176
1788.974,17,87,3648,86,14,21046,14,3612,1,8,0,8,36
0.431,6,12,1653,6,288,83,288,548,6,426,46,434,1105
1794.652,6,277,34497,113,143,16022,1360,17049,164,134,11009,2720,17448
60.828,17,4,304,4,48,20276,48,304,0,0,0,0,0
130.932,6,22,8319,11,525,88,1237,2048,11,831,13075,1360,6271
0.01,17,2,435,1,41,0,41,69,1,338,0,338,366
38.26,17,22,1672,22,48,1821,48,1672,0,0,0,0,0
240.18,6,54,17746,29,744,8577,1408,14925,25,189,10007,580,2821
33.585,6,32,5157,16,154,2227,722,1923,16,399,2227,1440,3234
5.009,17,3,343,2,36,5002,36,128,1,187,0,187,215
288.415,17,2,1269,2,606,288415,687,1269,0,0,0,0,0
27.057,6,50,13221,23,186,1229,722,2605,27,680,1032,1380,10616
1771.917,1,58,4872,58,56,31086,56,4872,0,0,0,0,0
1784.386,6,356,22520,208,69,8620,69,12460,148,69,12138,69,10060
65.428,6,46,10143,20,256,3443,1189,3120,26,398,2616,1420,7023
0.465,6,20,7229,13,334,38,663,2021,7,1209,72,1946,5208
1.376,6,49,20349,28,905,50,1360,14733,21,476,59,2715,5616
605.242,6,39,6699,21,250,30262,1314,2596,18,281,35598,1460,4103
1788.295,17,58,19488,58,308,31373,308,19488,0,0,0,0,0
4.551,6,15,4273,6,129,243,133,503,9,486,568,1731,3770
1744.667,2,15,480,15,8,124619,8,480,0,0,0,0,0
241.675,17,6,528,3,60,120837,60,264,3,60,120836,60,264
5.73,6,525,432133,309,1325,18,1368,416237,216,776,25,1473,15896
1694.084,6,24,3624,16,241,112938,241,2568,8,92,241985,92,1056
297.785,6,54,8231,40,155,7635,267,2642,14,717,22904,2036,5589
1783.805,6,371,25810,214,99,8374,469,15114,157,69,11434,69,10696
0.202,6,46,20791,26,1050,8,1420,15770,20,467,10,1883,5021
1.884,6,113,87222,48,131,40,232,2449,65,1392,28,2755,84773
3.011,1,3,318,3,78,1505,78,318,0,0,0,0,0
1.744,6,23,7952,12,164,133,267,1288,11,1216,149,3779,6664
0.008,6,7,280,4,0,1,0,160,3,0,0,0,120
1680.396,1,15,840,15,28,120028,28,840,0,0,0,0,0
0.291,17,2,384,1,36,0,36,64,1,292,0,292,320
2.334,17,2,178,1,29,0,29,57,1,93,0,93,121
147.723,6,69,43698,41,1186,3693,1448,35368,28,843,2352,2359,8330
0.047,17,2,290,1,40,0,40,68,1,194,0,194,222
1.762,6,29,9061,17,374,110,856,1808,12,846,150,1380,7253
1781.108,6,181,15589,120,69,14967,69,8940,61,69,29684,69,6649
301.297,6,36,8210,20,245,15857,635,1814,16,522,608,2720,6396
1770.673,6,106,9752,68,65,26427,65,5758,38,59,47853,59,3994
1.893,17,4,296,3,30,945,30,174,1,94,0,94,122
1797.655,6,379,26475,218,97,8284,469,15481,161,69,11232,69,10994
8.541,6,2217,2068190,1412,1386,5,1408,2021666,805,931,10,2801,46524
366.844,6,23,1499,14,177,28218,177,913,9,110,8694,110,586
0.185,17,15,9470,8,832,20,1350,6882,7,341,24,1350,2588
120.567,17,4,352,2,60,120566,60,176,2,60,120566,60,176
25.498,6,36,8403,16,184,1699,721,2119,20,548,1319,1440,6284
1.759,17,19,5088,19,239,97,389,5088,0,0,0,0,0
240.474,6,42,6147,19,331,13359,1056,3330,23,179,10930,580,2817
1771.447,6,99,9306,66,66,27253,66,5610,33,60,55355,60,3696
2.264,17,4,1564,4,363,754,363,1564,0,0,0,0,0
1794.324,17,80,3354,79,14,23004,14,3318,1,8,0,8,36
1783.248,17,83,3480,82,14,22015,14,3444,1,8,0,8,36
185.563,6,32,11871,17,501,11493,1440,4410,15,951,13241,1440,7461
0.498,17,22,14985,12,999,42,1350,12335,10,237,46,1350,2650
543.073,17,61,5983,55,36,10056,49,3566,6,374,108610,463,2417
20.059,17,28,2050,20,40,1055,41,1373,8,56,2,57,677
370.882,6,46,5024,18,180,21816,595,2024,28,119,13736,580,3000
0.086,17,2,146,2,45,86,45,146,0,0,0,0,0
1797.727,6,373,26028,216,98,8361,469,15263,157,69,11521,69,10765
2.003,17,19,13637,11,974,199,1350,11027,8,298,281,1350,2610
0.187,6,32,8360,17,277,11,517,1811,15,659,12,3303,6549
0.04,6,2,92,1,0,0,0,52,1,0,0,0,40
17.639,6,6,328,4,0,5879,0,216,2,0,17221,0,112
0.033,17,2,152,1,48,0,48,76,1,48,0,48,76
1792.055,2,27,864,27,8,68925,8,864,0,0,0,0,0
0.331,17,2,198,1,63,0,63,91,1,79,0,79,107
130.301,6,24,6202,14,186,10023,500,1494,10,614,14470,1420,4708
56.242,6,37,8435,17,389,541,854,1881,20,441,2952,1460,6554
0.497,6,25,6081,13,108,41,147,959,12,773,41,1608,5122
1798.186,17,448,39896,403,35,4473,288,25676,45,288,40017,288,14220
0.016,17,2,572,1,39,0,39,67,1,477,0,477,505
1794.788,17,83,3480,82,14,22157,14,3444,1,8,0,8,36
221.046,17,4,352,2,60,221045,60,176,2,60,221045,60,176
1.582,6,24,6041,13,108,131,147,959,11,773,134,1608,5082
27.157,17,16,1408,8,48,3878,48,608,8,72,3878,72,800
3.134,17,3,174,3,30,1567,30,174,0,0,0,0,0
240.649,2,3,96,3,8,120324,8,96,0,0,0,0,0
1749.49,17,12,498,11,14,174949,14,462,1,8,0,8,36
0.106,6,9,902,5,201,26,201,405,4,333,33,333,497
1772.748,6,180,15480,120,69,14897,69,8940,60,69,30038,69,6540
1786.479,6,102,8296,68,65,26663,65,4930,34,59,54133,59,3366
240.182,6,53,18127,28,804,8895,1402,15148,25,208,10007,580,2979
1748.888,17,350,56610,350,133,5011,366,56610,0,0,0,0,0
280.368,6,27,7312,11,158,28036,267,1237,16,603,18690,2036,6075
0.782,6,23,7394,13,335,65,668,2026,10,968,82,1475,5368
1.346,6,44,15769,25,766,56,1360,10233,19,476,63,2715,5536
40.021,17,522,557814,119,84,338,1350,13440,403,1322,99,1350,544374
1742.941,1,54,4536,54,56,32885,56,4536,0,0,0,0,0
1772.471,6,180,15480,120,69,14894,69,8940,60,69,30033,69,6540
0.275,17,2,179,1,43,0,43,71,1,80,0,80,108
1795.086,17,448,39896,403,35,4465,288,25676,45,288,40022,288,14220
1782.904,17,134,10720,67,48,27013,48,5092,67,56,27013,56,5628
0.442,17,18,8847,9,399,54,1350,3844,9,527,51,1350,5003
400.459,6,18,1242,14,180,30804,180,916,4,110,20079,110,326
243.615,6,42,6375,19,332,13533,1056,3320,23,230,11073,580,3055
1795.482,17,449,39928,404,35,4455,288,25708,45,288,40018,288,14220
235.882,6,36,8752,18,326,13869,517,2261,18,792,13870,1368,6491
1.644,6,3,327,2,103,22,138,287,1,0,0,0,40
1779.647,6,353,22400,206,69,8681,69,12380,147,69,12188,69,10020
1.09,6,25,5096,13,163,90,201,879,12,413,66,1432,4217
1415.422,6,188,22671,91,84,15724,721,8566,97,276,14742,1440,14105
1770.553,6,108,9998,70,65,25660,65,5886,38,59,47850,59,4112
0.45,17,15,7877,7,657,74,1350,4796,8,357,59,1350,3081
1795.933,6,356,22520,208,69,8676,69,12460,148,69,12217,69,10060
0.326,17,2,154,1,33,0,33,61,1,65,0,65,93
376.025,6,18,1242,14,180,28925,180,916,4,110,20059,110,326
1.899,6,26,8159,13,141,142,267,1391,13,869,142,1368,6768
3.278,6,12,2133,6,503,655,503,1326,6,475,655,475,807
0.005,17,2,532,1,29,0,29,57,1,447,0,447,475
1800.0,6,212,16313,79,68,23076,293,7719,133,48,13636,78,8594
11.199,6,4,168,3,0,5599,0,124,1,0,0,0,44
37.935,17,22,1936,11,48,3792,48,836,11,72,3792,72,1100
0.02,17,2,198,1,39,0,39,67,1,103,0,103,131
600.523,6,53,8396,32,111,19371,504,2728,21,301,30021,1420,5668
0.272,17,8,2758,8,316,38,355,2758,0,0,0,0,0
13.765,6,31,7613,12,155,1251,267,1266,19,371,764,1997,6347
1772.115,6,180,15480,120,69,14891,69,8940,60,69,30032,69,6540
1786.576,6,102,8296,68,65,26665,65,4930,34,59,54136,59,3366
1672.614,1,8,448,8,28,238944,28,448,0,0,0,0,0
100.122,6,23,10009,12,531,61,1360,2637,11,1384,9997,3934,7372
3.04,17,2,778,2,361,3040,361,778,0,0,0,0,0
1.552,6,67,47679,41,1234,38,1408,40422,26,1179,55,3819,7257
1793.29,6,261,38105,160,302,11278,302,27414,101,83,17932,83,10691
15.42,17,13,6591,7,613,2560,1350,4487,6,322,3067,1350,2104
285.581,1,4,224,4,28,95193,28,224,0,0,0,0,0
11.211,6,91,28252,46,544,249,1152,22002,45,444,248,1179,6250
1786.407,6,362,22967,210,69,8547,69,12609,152,69,11830,69,10358
17.346,6,7,382,3,0,8673,0,120,4,51,5392,51,262
5.975,6,588,546902,392,1332,14,1368,532046,196,776,29,1473,14856
3.064,6,43,11890,23,352,139,1432,2684,20,646,148,1820,9206
5.121,6,16,3532,9,179,640,194,846,7,578,846,905,2686
1744.678,6,97,7307,63,38,28139,205,4476,34,33,52859,98,2831
16.012,17,4,304,4,48,5337,48,304,0,0,0,0,0
280.317,6,30,7432,13,158,23359,267,1317,17,543,17514,1300,6115
0.055,6,7,759,3,69,23,69,189,4,205,6,341,570
298.33,17,9,3138,9,320,37291,548,3138,0,0,0,0,0
12.706,17,4,824,2,48,12687,48,152,2,308,12686,308,672
59.396,17,4,240,2,32,59395,32,120,2,32,59395,32,120
369.563,6,18,1242,14,180,28427,180,916,4,110,20066,110,326
9.027,6,80,24954,40,568,231,1152,19213,40,459,224,1179,5741
1793.477,17,87,3648,86,14,21099,14,3612,1,8,0,8,36
0.011,17,4,970,2,52,0,52,160,2,377,1,425,810
60.447,6,9,774,5,180,15111,180,448,4,110,20076,110,326
0.045,17,2,147,1,32,0,32,60,1,59,0,59,87
5.016,17,4,288,2,36,5003,36,128,2,52,5002,52,160
1.113,17,2,178,1,29,0,29,57,1,93,0,93,121
74.051,6,26,11467,15,698,5289,1408,4280,11,1321,7400,2816,7187
1779.858,6,354,22440,207,69,8640,69,12420,147,69,12190,69,10020
601.643,2,9,288,9,8,75205,8,288,0,0,0,0,0
203.359,6,19,4495,7,268,354,505,1089,12,364,18479,1420,3406
280.62,6,37,11242,17,158,17538,267,1477,20,689,14767,1400,9765
1789.951,17,87,3648,86,14,21058,14,3612,1,8,0,8,36
1796.577,6,316,23434,156,178,11566,515,9162,160,38,11299,62,14272
0.094,6,7,423,4,43,4,43,259,3,0,46,0,164
0.282,17,2,152,1,48,0,48,76,1,48,0,48,76
1072.354,17,53,2220,52,14,21026,14,2184,1,8,0,8,36
11.821,6,1860,1631894,1134,1385,10,1420,1598633,726,467,16,1883,33261
0.186,6,46,21508,26,1101,7,1420,16487,20,467,9,1883,5021
0.186,1,2,112,2,28,186,28,112,0,0,0,0,0
1781.177,1,274,15344,274,28,6524,28,15344,0,0,0,0,0
4.793,6,24,7502,11,286,479,721,1590,13,673,360,2840,5912
1795.319,17,447,39864,402,35,4477,288,25644,45,288,40019,288,14220
0.101,6,9,1343,5,145,25,145,349,4,830,29,830,994
1796.106,17,449,39928,404,35,4456,288,25708,45,288,40019,288,14220
0.319,17,2,214,1,39,0,39,67,1,119,0,119,147
140.332,6,37,22094,22,1061,6680,1360,14716,15,845,10009,2720,7378
280.188,6,27,7312,13,158,23349,267,1317,14,775,21549,3445,5995
61.548,6,37,15936,22,800,2930,1448,9158,15,665,4378,1448,6778
119.905,17,4,240,2,32,119904,32,120,2,32,119904,32,120
3.272,6,2,88,2,0,0,0,88,0,0,0,0,0
5.152,6,858,715126,505,1372,10,1420,696773,353,467,14,1883,18353
1674.993,1,8,448,8,28,239284,28,448,0,0,0,0,0
1640.063,1,22,1232,22,28,78098,28,1232,0,0,0,0,0
1797.13,17,142,11360,71,48,25673,48,5396,71,56,25672,56,5964
3.682,17,42,24663,22,893,175,1350,20269,20,191,172,1350,4394
1679.712,17,13,534,11,14,167952,14,462,2,8,1679518,8,72
37.709,2,2,64,2,8,37709,8,64,0,0,0,0,0
1796.809,17,142,11360,71,48,25575,48,5396,71,56,25668,56,5964
75.6,6,18,748,9,0,3103,0,368,9,0,9448,0,380
1785.857,6,354,22440,207,69,8669,69,12420,147,69,12231,69,10020
4.047,17,7,612,4,32,1297,32,240,3,96,1522,96,372
1791.168,6,414,35582,234,115,7687,1189,18234,180,133,10006,2077,17348
0.01,17,3,426,2,32,0,32,120,1,278,0,278,306
1781.762,6,370,25770,214,99,8365,469,15114,156,69,11495,69,10656
1799.47,17,87,3648,86,14,21170,14,3612,1,8,0,8,36
1.77,6,11,1727,7,100,295,100,384,4,1179,503,1179,1343
480.456,17,11,3688,11,307,48045,308,3688,0,0,0,0,0
4.432,6,38,7245,19,218,246,314,3383,19,516,232,1179,3862
11.829,6,99,31896,50,586,241,1152,25454,49,447,241,1179,6442
1795.901,17,448,39896,403,35,4467,288,25676,45,288,40021,288,14220
170.943,6,7,364,7,0,0,0,364,0,0,0,0,0
140.055,6,6,1225,4,319,46685,398,799,2,173,139865,254,426
240.28,6,53,17921,28,798,8898,1418,15034,25,197,10010,580,2887
280.202,1,3,180,3,32,140101,32,180,0,0,0,0,0
198.762,17,4,240,2,32,198760,32,120,2,32,198761,32,120
1.84,17,19,13443,11,966,183,1350,10938,8,285,257,1350,2505
0.812,6,11,1008,6,256,160,256,500,5,304,198,304,508
1740.482,17,29,30624,29,1028,62160,1028,30624,0,0,0,0,0
5.053,17,4,288,2,36,5006,36,128,2,52,4989,52,160
38.422,6,50,10140,25,378,371,786,2238,25,362,1595,1440,7902
0.915,17,11,4581,5,432,228,1350,2300,6,352,82,1350,2281
1490.718,6,91,7331,60,66,25266,66,4380,31,59,49687,60,2951
15.412,6,2573,2360689,1626,1372,9,1408,2306781,947,931,16,2816,53908
10.927,17,4,824,2,48,10913,48,152,2,308,10893,308,672
1798.063,17,142,11360,71,48,25686,48,5396,71,56,25686,56,5964
280.604,6,27,7312,12,158,25509,267,1277,15,775,20039,3465,6035
203.924,17,3,222,3,46,101962,46,222,0,0,0,0,0
1679.329,1,15,840,15,28,119952,28,840,0,0,0,0,0
30.31,6,33,8673,18,152,1782,318,2022,15,651,2164,1418,6651
10.783,6,20,4442,11,275,1078,275,998,9,768,750,1440,3444
1.362,6,50,20953,28,943,50,1360,15297,22,433,56,1360,5656
1798.205,6,382,26995,219,103,8248,469,15990,163,69,11099,69,11005
299.915,1,4,326,4,53,99971,78,326,0,0,0,0,0
1771.514,6,101,9344,66,65,27254,65,5577,35,59,52099,59,3767
22.622,17,25,13160,14,747,1737,1350,10853,11,181,2259,1350,2307
0.98,6,11,1727,7,100,163,100,384,4,589,239,1152,1343
0.952,17,4,624,2,64,951,64,184,2,192,832,192,440
0.037,17,2,154,1,33,0,33,61,1,65,0,65,93
1.616,6,27,10177,16,284,107,586,1498,11,1029,145,1420,8679
1.245,6,40,10514,21,513,62,1360,4978,19,476,59,2715,5536
1757.111,17,275,56211,275,176,6412,422,56211,0,0,0,0,0
120.374,2,2,64,2,8,120374,8,64,0,0,0,0,0
0.263,17,8,2750,8,315,37,354,2750,0,0,0,0,0
1770.79,6,101,9410,66,66,27242,66,5610,35,60,52079,60,3800
3.045,17,8,1560,4,32,1010,32,240,4,302,1010,308,1320
0.067,17,2,219,1,50,0,50,78,1,113,0,113,141
0.087,17,2,572,1,39,0,39,67,1,477,0,477,505
1744.245,6,96,7286,63,38,28132,205,4476,33,33,54500,98,2810
2.934,17,2,176,2,60,2934,60,176,0,0,0,0,0
1775.675,17,138,11040,69,48,26112,48,5244,69,56,26112,56,5796
1762.93,1,8,448,8,28,251847,28,448,0,0,0,0,0
0.418,6,5,248,3,0,209,0,144,2,0,415,0,104
62.389,6,71,53158,48,1186,1327,1368,45228,23,840,2824,2736,7930
1749.531,17,12,498,11,14,174953,14,462,1,8,0,8,36
1.552,6,29,10365,17,367,97,833,1785,12,1012,133,1420,8580
1747.445,6,95,7203,63,38,28184,205,4476,32,33,56358,98,2727
42.116,17,24,2112,12,48,3827,48,912,12,72,3827,72,1200
1792.73,17,179,13962,179,50,10071,50,13962,0,0,0,0,0
8.148,6,24,7956,10,154,905,267,872,14,724,613,1997,7084
116.449,1,3,360,3,92,58224,112,360,0,0,0,0,0
1.295,17,19,7451,9,495,161,1350,4715,10,245,137,1350,2736
1.969,6,7,295,4,0,656,0,164,3,7,469,7,131
322.613,6,62,40684,39,1180,8489,1448,32735,23,749,2791,1448,7949
35.229,6,5126,4892843,3445,1344,10,1368,4800645,1681,792,20,2736,92198
207.485,6,49,10645,19,117,11526,267,1822,30,292,7153,1420,8823
240.201,6,57,21689,31,852,8006,1418,18669,26,207,9607,580,3020
364.01,17,12,1056,6,48,72800,48,456,6,72,72799,72,600
0.705,6,24,5755,13,158,58,370,1315,11,799,69,1420,4440
0.431,6,13,1693,7,288,66,288,588,6,426,50,434,1105
1787.966,6,138,15980,84,88,21541,510,7080,54,156,33732,1380,8900
1787.907,6,371,25879,214,99,8393,469,15114,157,69,11460,69,10765
0.017,17,4,368,2,32,15,32,120,2,96,5,96,248
282.758,6,29,8792,12,158,25705,267,1277,17,683,17670,1400,7515
1789.715,17,29,9512,29,300,63918,300,9512,0,0,0,0,0
241.57,6,44,9212,21,476,12077,1368,6336,23,207,10979,580,2876
469.382,1,17,1802,17,78,29336,78,1802,0,0,0,0,0
21.084,6,6,324,4,0,7028,0,216,2,0,20865,0,108
282.435,1,4,224,4,28,94145,28,224,0,0,0,0,0
0.809,6,10,1687,7,100,134,100,384,3,1179,272,1179,1303
60.118,6,14,3888,8,127,8588,127,467,6,1056,12015,1704,3421
580.944,6,1439,306399,856,362,679,1368,149635,583,223,998,1328,156764
251.075,6,31,10212,14,158,19313,267,1357,17,742,15690,1781,8855
0.509,17,3,451,2,39,387,39,134,1,289,0,289,317
22.848,6,34,8136,16,188,1523,721,1963,18,605,1333,1440,6173
638.963,17,68,6464,36,72,18256,136,3616,32,61,17717,72,2848
1786.8,6,102,8296,68,65,26668,65,4930,34,59,54143,59,3366
1655.434,1,8,448,8,28,236490,28,448,0,0,0,0,0
1.679,6,19,3781,10,234,186,564,1452,9,463,184,1343,2329
0.037,6,14,4334,7,111,6,111,483,7,869,6,1448,3851
1797.463,6,356,22520,208,69,8683,69,12460,148,69,12227,69,10060
280.309,6,28,7352,12,158,25482,267,1277,16,603,18685,1400,6075
281.962,6,31,7813,13,158,23496,267,1317,18,524,16584,1400,6496
60.57,6,11,5498,5,106,15142,106,314,6,1234,12075,2006,5184
1.245,6,41,10554,21,513,62,1460,4978,20,433,56,1460,5576
1.045,17,4,644,2,33,990,33,122,2,233,1,233,522
24.348,6,2,172,2,46,24348,46,172,0,0,0,0,0
1795.088,6,419,25040,211,69,8548,69,12580,208,34,8671,64,12460
237.608,1,4,224,4,28,79202,28,224,0,0,0,0,0
1.427,6,46,19351,27,907,54,1360,13815,19,476,68,2715,5536
684.585,6,11,1680,7,241,114069,241,1244,4,92,228136,92,436
19.851,17,44,8313,19,170,1101,1350,3766,25,153,825,1350,4547
10.875,6,18,5610,10,275,1208,275,958,8,1440,835,1440,4652
5.527,6,23,3636,12,167,502,293,1490,11,425,526,1179,2146
1787.749,6,102,8364,68,66,26682,66,4964,34,60,54169,60,3400
1684.77,1,7,392,7,28,280795,28,392,0,0,0,0,0
368.681,6,19,1303,14,177,28360,177,925,5,110,15164,110,378
0.166,6,46,21252,26,1083,6,1420,16231,20,467,8,1883,5021
31.815,17,6,528,3,48,15903,48,228,3,72,15903,72,300
35.183,2,2,64,2,8,35183,8,64,0,0,0,0,0
292.539,6,50,9136,24,153,12717,517,2211,26,464,11699,1418,6925
1797.872,17,497,60428,229,160,7885,1350,43099,268,36,6733,1350,17329
0.486,6,39,8421,20,352,25,1420,2568,19,462,26,1485,5853
0.294,17,12,4365,12,335,26,358,4365,0,0,0,0,0
0.048,17,4,344,2,47,1,47,150,2,69,11,75,194
1798.347,17,88,3684,86,14,21154,14,3612,2,8,1798162,8,72
1795.521,17,142,11360,71,48,25650,48,5396,71,56,25650,56,5964
74.36,6,35,11414,11,174,7436,267,1493,24,471,3225,2760,9921
1770.459,6,99,9240,66,65,27237,65,5577,33,59,55323,59,3663
10.065,17,4,720,2,40,10061,40,136,2,264,10060,264,584
4.876,6,37,7189,19,218,270,314,3383,18,513,267,1179,3806
369.678,6,18,1242,14,180,28436,180,916,4,110,20071,110,326
16.597,6,27,7177,13,155,1383,267,1306,14,530,1275,3417,5871
2.453,17,3,1164,3,360,1226,360,1164,0,0,0,0,0
1773.221,6,180,15480,120,69,14901,69,8940,60,69,30045,69,6540
267.738,17,11,3771,11,314,26773,342,3771,0,0,0,0,0
0.336,17,2,167,1,39,0,39,67,1,72,0,72,100
1789.622,6,356,22520,208,69,8645,69,12460,148,69,12174,69,10060
1787.609,6,102,8296,68,65,26680,65,4930,34,59,54165,59,3366
36.741,17,22,1936,11,48,3670,48,836,11,72,3670,72,1100
1629.841,1,8,848,8,78,232834,78,848,0,0,0,0,0
1786.966,6,102,8296,68,65,26671,65,4930,34,59,54146,59,3366
1.679,6,51,19388,29,889,59,1360,13687,22,437,69,2715,5701
1679.637,17,12,498,11,14,167963,14,462,1,8,0,8,36
372.065,6,18,1242,14,180,28620,180,916,4,110,20059,110,326
1788.775,6,275,34777,112,149,16113,1360,17291,163,133,11040,2720,17486
3.455,6,2,88,2,0,0,0,88,0,0,0,0,0
261.197,6,27,11414,11,181,26119,267,1168,16,872,17370,2036,10246
1.301,17,14,8039,8,671,185,1350,5597,6,379,205,1350,2442
1.182,6,25,8056,12,164,91,267,1288,13,869,83,1448,6768
1408.623,6,143,12275,94,69,15146,69,7072,49,69,29346,69,5203
0.014,17,3,993,3,303,7,332,993,0,0,0,0,0
1.252,17,22,16450,11,762,124,1350,8697,11,676,122,1350,7753
241.053,6,321,336412,107,273,2274,499,6417,214,1532,1130,4314,329995
235.48,6,61,37767,40,625,6037,1167,10236,21,1762,11773,7040,27531
102.933,6,15,1657,9,177,12866,177,1007,6,110,20519,110,650
1203.375,17,9,372,8,14,171910,14,336,1,8,0,8,36
59.527,17,28,2339,26,30,2380,37,1515,2,384,346,463,824
1771.926,6,180,15480,120,69,14890,69,8940,60,69,30030,69,6540
255.164,6,10,628,4,106,85051,106,274,6,90,51030,90,354
1786.825,6,105,8484,68,66,26669,66,4964,37,60,49631,60,3520
0.061,6,2,80,1,0,0,0,40,1,0,0,0,40
130.487,17,4,352,2,60,130486,60,176,2,60,130486,60,176
5.048,17,4,558,2,36,5043,36,128,2,187,5043,187,430
1778.359,17,44,14784,44,308,41357,308,14784,0,0,0,0,0
1796.141,17,144,11520,72,48,25297,48,5472,72,56,25297,56,6048
0.169,17,2,304,1,60,0,60,88,1,188,0,188,216
5.22,17,12,1056,6,37,1042,37,390,6,83,1042,89,666
1339.032,6,137,11759,90,69,15045,69,6774,47,69,29109,69,4985
15.315,6,23,5271,12,351,1392,1382,2242,11,430,1528,1460,3029
386.325,6,18,1242,14,180,29717,180,916,4,110,20073,110,326
1747.774,6,130,8171,73,47,24274,208,4992,57,31,31206,31,3179
10.073,6,15,2306,9,210,1257,210,908,6,545,2014,904,1398
1.079,17,4,360,2,30,1014,30,116,2,94,1030,94,244
115.149,6,32,12282,17,523,7196,1440,4571,15,983,8200,1440,7711
1681.335,17,14,3799,7,30,280220,30,406,7,456,280220,463,3393
2.694,17,4,1568,4,364,898,364,1568,0,0,0,0,0
999.309,17,194,14744,194,48,5177,48,14744,0,0,0,0,0
1682.836,17,14,1036,7,30,280466,30,406,7,62,280468,62,630
0.012,6,9,1878,5,666,3,666,934,4,728,3,728,944
216.582,1,8,448,8,28,30940,28,448,0,0,0,0,0
1744.335,6,95,7203,63,38,28134,205,4476,32,33,56258,98,2727
0.02,17,2,279,1,36,0,36,64,1,187,0,187,215
0.022,6,3,120,1,0,0,0,40,2,0,21,0,80
295.302,1,4,224,4,28,98434,28,224,0,0,0,0,0
1790.235,1,64,5376,0,0,0,0,0,64,56,28416,56,5376
281.759,17,6,528,3,60,140879,60,264,3,60,140879,60,264
0.911,17,4,680,2,33,904,33,122,2,251,901,323,558
0.342,6,11,911,6,181,68,181,489,5,77,82,133,422
1680.525,17,12,498,11,14,168052,14,462,1,8,0,8,36
1734.23,6,67,4941,45,33,39414,33,3165,22,31,82572,31,1776
14.798,6,25,4955,11,308,1479,722,1800,14,299,1121,1408,3155
5.638,6,560,506866,364,1328,14,1368,492010,196,776,27,2736,14856
0.358,17,2,152,1,48,0,48,76,1,48,0,48,76
1791.699,1,121,6776,121,28,14930,28,6776,0,0,0,0,0
2.978,17,2,144,1,36,0,36,64,1,52,0,52,80
131.261,17,6,528,3,48,65626,48,228,3,72,65625,72,300
300.833,6,49,20407,28,1045,11141,1360,14765,21,399,432,1360,5642
1797.911,6,365,25032,213,94,8480,469,14536,152,69,11903,69,10496
1745.26,6,100,7866,66,45,26850,205,4902,34,35,52876,98,2964
2.558,17,2,178,1,29,0,29,57,1,93,0,93,121
280.505,6,28,7352,13,158,23375,267,1317,15,905,20026,4845,6035
1783.812,6,402,27422,224,97,7999,469,15790,178,57,10078,69,11632
0.167,6,3,132,2,0,3,0,92,1,0,0,0,40
64.312,6,7998,7688043,5353,1359,12,1408,7545827,2645,931,24,2801,142216
1798.035,17,142,11360,71,48,25686,48,5396,71,56,25686,56,5964
0.694,17,4,560,2,64,485,64,184,2,160,592,160,376
395.333,6,24,1845,15,64,28238,64,1048,9,54,49400,58,797
300.338,6,27,7927,14,364,23102,890,2217,13,628,3224,2804,5710
0.455,6,2,111,1,0,0,0,40,1,31,0,31,71
1.344,6,53,21683,31,918,44,1360,15982,22,437,55,2715,5701
95.139,6,42,9578,20,269,4991,1173,2966,22,440,4527,1460,6612
299.543,6,6,364,4,31,99847,31,222,2,31,299529,31,142
1786.611,6,104,8444,68,66,26665,66,4964,36,60,51043,60,3480
4.177,17,2,144,1,36,0,36,64,1,52,0,52,80
10.033,6,38,7245,19,218,557,314,3383,19,516,542,1179,3862
15.508,17,19,9580,10,437,1719,1350,4655,9,519,1934,1350,4925
41.061,17,4,240,2,32,41059,32,120,2,32,41060,32,120
8.892,6,21,4179,10,188,988,245,1164,11,853,851,1152,3015
1.394,6,51,21414,31,906,46,1360,15793,20,480,63,4075,5621
0.018,17,2,158,1,34,0,34,62,1,68,0,68,96
16.724,17,32,17911,15,750,1192,1350,11675,17,338,1043,1350,6236
11.605,6,98,30881,51,576,232,1152,24519,47,407,246,1152,6362
1772.334,6,180,15480,120,69,14893,69,8940,60,69,30032,69,6540
60.676,1,17,1768,0,0,0,0,0,17,76,3792,76,1768
1786.75,6,104,8297,69,63,26275,63,4902,35,57,52549,57,3395
1771.276,6,102,9711,68,69,26436,233,5914,34,59,53671,82,3797
1785.86,6,358,22738,208,69,8627,69,12460,150,69,11985,69,10278
0.121,6,9,1342,5,145,30,145,349,4,829,31,829,993
1776.232,17,73,3060,72,14,25017,14,3024,1,8,0,8,36
300.645,6,37,8431,20,291,15823,786,1997,17,478,531,1968,6434
0.046,6,3,120,2,0,46,0,80,1,0,0,0,40
242.271,6,54,12319,28,594,8973,1418,9236,26,156,9690,580,3083
197.264,17,4,352,2,60,197263,60,176,2,60,197263,60,176
18.47,17,17,11127,10,878,2048,1350,9069,7,266,3073,1350,2058
1798.969,6,174,18296,95,87,19137,721,8684,79,161,23058,2840,9612
1763.021,17,29,19517,29,645,62965,645,19517,0,0,0,0,0
240.222,6,59,18521,28,825,8896,1418,15500,31,175,8007,580,3021
732.17,6,73,8256,38,83,19783,721,3482,35,118,21528,1448,4774
160.431,6,10,1687,6,100,32086,100,344,4,1179,53382,1179,1343
26.471,6,27,9967,13,533,2205,1050,2309,14,692,2032,1448,7658
1796.65,17,142,11360,71,48,25666,48,5396,71,56,25666,56,5964
1786.149,17,142,11360,71,48,25515,48,5396,71,56,25515,56,5964
1794.567,17,356,56925,356,131,5055,363,56925,0,0,0,0,0
27.517,6,47,13036,23,186,1250,721,2600,24,728,1187,1440,10436
785.059,6,180,12692,94,94,8440,469,6975,86,69,9234,69,5717
299.614,6,6,364,4,31,99871,31,222,2,31,299602,31,142
1741.077,6,101,7308,64,31,27636,31,4356,37,31,48362,31,2952
0.012,17,2,672,2,308,12,308,672,0,0,0,0,0
1796.395,1,92,5152,92,28,19740,28,5152,0,0,0,0,0
1745.0,6,97,7369,63,38,28145,205,4476,34,33,52867,98,2893
1798.834,17,348,26448,348,48,5183,48,26448,0,0,0,0,0
0.16,6,9,1002,5,213,40,213,417,4,421,48,421,585
1795.437,6,391,27562,222,101,8124,469,16317,169,69,10686,69,11245
0.002,17,2,834,2,389,2,389,834,0,0,0,0,0
300.693,6,37,8424,20,280,15825,775,1990,17,522,534,2720,6434
175.414,17,4,352,2,60,175413,60,176,2,60,175412,60,176
1796.363,6,358,22669,209,69,8636,69,12569,149,69,12134,69,10100
4.963,1,10,280,10,0,0,0,280,0,0,0,0,0
300.483,6,25,8439,13,364,25040,858,2141,12,708,5587,1448,6298
0.449,6,22,7342,12,335,40,668,1974,10,1210,49,1906,5368
240.235,6,54,17747,29,788,8579,1408,14919,25,190,10009,580,2828
1.325,6,48,20195,28,897,49,1360,14619,20,476,60,2715,5576
267.495,17,3,1008,3,308,133747,308,1008,0,0,0,0,0
0.006,17,2,235,1,36,0,36,64,1,143,0,143,171
249.684,17,4,240,2,32,249683,32,120,2,32,249683,32,120
7.282,6,1226,1097774,741,1402,9,1448,1067890,485,776,14,1448,29884
1771.138,6,101,9278,66,64,27248,64,5544,35,58,52081,58,3734
1787.496,17,142,11360,71,48,25535,48,5396,71,56,25535,56,5964
1796.481,2,25,800,25,8,74853,8,800,0,0,0,0,0
46.72,6,31,8981,14,158,3593,267,1357,17,694,2915,3436,7624
31.346,17,4,240,2,32,31345,32,120,2,32,31345,32,120
6.766,6,65,20166,32,565,218,1152,15419,33,489,203,1179,4747
778.028,6,39,3039,19,63,25041,63,1390,20,44,40944,57,1649
0.947,6,25,9560,14,351,72,1045,1996,11,1016,76,1460,7564
1786.697,6,102,8364,68,66,26667,66,4964,34,60,54137,60,3400
3.277,6,7,400,3,0,1638,0,160,4,0,1032,0,240
1.282,6,11,1420,5,145,320,145,349,6,827,150,827,1071
1.314,6,47,19575,27,920,50,1360,13999,20,476,60,2715,5576
182.945,6,11,676,4,92,60981,92,308,7,0,12664,0,368
1.4,6,47,16753,25,838,58,1440,11097,22,433,57,1440,5656
76.232,6,32,7718,12,163,90,267,1469,20,388,4011,1460,6249
1786.336,17,142,11360,71,48,25518,48,5396,71,56,25518,56,5964
1797.672,17,449,39928,404,35,4460,288,25708,45,288,40025,288,14220
72.93,6,11,1346,6,302,14586,302,912,5,83,18228,83,434
1778.79,17,243,54605,243,196,7350,422,54605,0,0,0,0,0
1780.528,6,185,15887,122,69,14715,69,9020,63,69,28711,69,6867
61.322,6,39,18477,23,883,2787,1448,10918,16,746,4071,1448,7559
2.19,6,29,10373,17,368,136,837,1789,12,1012,191,1420,8584
4.642,6,38,7245,20,218,244,314,3423,18,516,257,1179,3822
114.025,6,26,11935,14,591,1287,1360,3562,12,1125,10348,2279,8373
287.414,6,33,3965,16,237,19157,585,1589,17,296,17960,580,2376
0.294,6,27,9102,13,262,24,690,1747,14,945,22,1408,7355
0.675,6,36,11917,21,686,33,1188,7951,15,353,41,1048,3966
1787.245,17,87,3648,86,14,21026,14,3612,1,8,0,8,36
0.079,6,8,432,4,0,26,0,216,4,0,3,0,216
1034.692,6,277,25291,141,102,6975,1189,11497,136,173,7661,3386,13794
1788.293,6,102,6595,65,47,27942,208,4154,37,31,49665,31,2441
14.586,6,10,436,4,0,4862,0,172,6,0,1733,0,264
8.578,6,37,8507,19,410,476,882,2034,18,441,495,1360,6473
1787.011,6,380,26846,218,103,8235,469,15881,162,69,11096,69,10965
1797.71,17,180,14040,180,50,10043,50,14040,0,0,0,0,0
2.94,6,29,13419,14,564,226,1360,3472,15,933,194,1360,9947
1785.858,6,443,26660,220,69,8154,69,13147,223,35,8044,48,13513
0.852,6,20,5966,11,287,85,562,1306,9,716,95,1420,4660
1772.599,1,58,4872,58,56,31098,56,4872,0,0,0,0,0
1792.172,1,342,28728,342,56,5255,56,28728,0,0,0,0,0
0.02,17,2,118,1,31,0,31,59,1,31,0,31,59
0.141,17,4,420,2,33,50,33,122,2,121,93,145,298
36.618,1,4,224,4,28,12206,28,224,0,0,0,0,0
32.171,6,21,6506,6,154,6434,267,712,15,518,2285,1420,5794
0.419,6,50,21709,28,1029,15,1380,16587,22,421,18,1923,5122
1795.973,17,144,11520,72,48,25295,48,5472,72,56,25295,56,6048
1789.693,1,262,14672,262,28,6857,28,14672,0,0,0,0,0
1.956,17,22,5709,22,231,93,389,5709,0,0,0,0,0
195.889,17,4,352,2,60,195887,60,176,2,60,195888,60,176
0.005,17,2,383,1,39,0,39,67,1,288,0,288,316
0.114,17,3,1063,3,326,57,354,1063,0,0,0,0,0
1.901,17,6,432,3,36,917,36,192,3,52,928,52,240
1.505,6,4,284,0,0,0,0,0,4,31,501,31,284
101.442,6,45,8773,23,194,219,721,2307,22,464,4822,2840,6466
10.819,17,15,17706,15,1152,772,1449,17706,0,0,0,0,0
115.752,6,21,10356,11,444,64,1023,1804,10,1356,12847,2720,8552
8.836,6,33,12650,16,481,589,721,2570,17,783,479,2391,10080
84.2,6,34,7802,12,155,54,267,1266,22,332,4009,1460,6536
1.37,6,53,20195,29,943,48,1460,14414,24,400,51,1460,5781
8.12,6,77,24605,40,560,208,1152,18968,37,461,218,1179,5637
1.501,6,50,19064,27,875,57,1360,13368,23,433,59,1360,5696
80.143,6,29,9333,15,563,86,1351,2334,14,714,6151,1631,6999
1780.293,6,104,8444,68,66,26571,66,4964,36,60,50862,60,3480
0.185,6,43,17421,24,955,8,1420,12440,19,467,9,1883,4981
1788.873,17,142,11360,71,48,25555,48,5396,71,56,25555,56,5964
1.305,6,47,19463,27,912,50,1360,13887,20,476,59,2715,5576
1795.065,17,449,39928,404,35,4454,288,25708,45,288,40018,288,14220
207.563,17,4,240,2,32,207562,32,120,2,32,207562,32,120
6.71,6,458,430073,313,1316,20,1368,417869,145,776,45,2736,12204
1797.324,6,367,25650,214,99,8438,469,15045,153,69,11823,69,10605
0.0,17,1,361,1,333,0,333,361,0,0,0,0,0
1793.53,17,87,3648,86,14,21100,14,3612,1,8,0,8,36
20.27,17,27,7176,13,307,1689,1350,4358,14,173,1554,1350,2818
1740.71,6,135,8225,74,42,23845,208,4886,61,31,29006,31,3339
0.025,17,2,332,1,43,0,43,71,1,233,0,233,261
1774.927,6,180,15480,120,69,14915,69,8940,60,69,30079,69,6540
1786.43,6,106,8524,68,66,26663,66,4964,38,60,48279,60,3560
0.243,6,26,7256,13,155,20,267,1301,13,603,18,1400,5955
1772.559,6,180,15480,120,69,14895,69,8940,60,69,30037,69,6540
0.106,6,10,582,5,42,26,42,310,5,0,20,0,272
39.196,17,11,836,11,48,3919,48,836,0,0,0,0,0
1783.725,17,83,3480,82,14,22021,14,3444,1,8,0,8,36
1783.855,17,85,3561,83,13,21752,14,3481,2,12,1783669,16,80
1.324,6,10,924,5,283,286,283,551,5,105,287,105,373
300.68,6,37,8526,20,315,15825,882,2093,17,478,529,2128,6433
29.962,17,18,1584,9,48,3744,48,684,9,72,3744,72,900
1713.409,17,427,38088,384,35,4473,288,24500,43,288,40121,288,13588
1795.295,6,356,22520,208,69,8672,69,12460,148,69,12212,69,10060
0.399,17,8,2750,8,315,57,354,2750,0,0,0,0,0
0.325,17,8,2750,8,315,46,354,2750,0,0,0,0,0
25.132,17,25,7805,11,422,2510,1350,4955,14,175,1930,1350,2850
1.253,6,23,7952,12,164,96,267,1288,11,1216,106,3819,6664
1749.512,17,12,498,11,14,174951,14,462,1,8,0,8,36
0.448,6,52,22643,29,1017,16,1380,17469,23,421,18,1923,5174
1772.379,6,219,17380,82,75,21879,337,8491,137,50,13031,143,8889
0.412,6,8,840,5,256,103,256,716,3,0,85,0,124
117.246,17,4,352,2,60,117245,60,176,2,60,117245,60,176
1761.33,6,79,4160,40,26,45160,26,2106,39,26,46349,26,2054
1.213,6,25,8056,12,164,94,267,1288,13,869,86,1448,6768
1791.84,6,375,26246,216,98,8334,469,15332,159,69,11337,69,10914
7.685,6,31,8912,14,158,591,267,1357,17,687,477,1781,7555
0.455,1,5,420,5,56,113,56,420,0,0,0,0,0
0.549,17,2,116,2,30,549,30,116,0,0,0,0,0
1.311,6,47,19574,27,920,50,1360,13998,20,476,59,2715,5576
1790.429,17,87,3648,86,14,21063,14,3612,1,8,0,8,36
20.403,6,2650,2470267,1668,1401,12,1448,2414539,982,776,20,1448,55728
1.266,6,10,1687,7,100,211,100,384,3,1179,504,1179,1303
300.208,6,33,11979,18,592,17659,1402,4521,15,833,17192,2804,7458
1787.295,1,242,13552,242,28,7416,28,13552,0,0,0,0,0
0.776,17,4,240,2,32,774,32,120,2,32,774,32,120
39.927,6,28,7217,13,155,3327,267,1306,15,482,2851,1997,5911
1.398,6,19,7844,10,141,155,275,686,9,970,148,2840,7158
1790.959,1,58,4872,58,56,31420,56,4872,0,0,0,0,0
1.567,6,2,87,1,0,0,0,40,1,7,0,7,47
1777.911,17,142,11360,71,48,25397,48,5396,71,56,25398,56,5964
245.244,6,84,21912,42,520,5980,1418,13646,42,357,5981,1418,8266
266.759,17,924,509009,867,556,306,1252,506685,57,12,4762,56,2324
1789.196,17,134,10720,67,48,27108,48,5092,67,56,27108,56,5628
1749.956,1,68,5712,68,56,26118,56,5712,0,0,0,0,0
0.019,6,12,975,7,181,3,181,553,5,77,3,133,422
1.103,17,2,384,1,36,0,36,64,1,292,0,292,320
0.201,6,10,1840,5,901,50,901,1169,5,403,50,403,671
1682.768,17,14,1036,7,30,280452,30,406,7,62,280453,62,630
0.066,17,8,608,8,48,9,48,608,0,0,0,0,0
4.42,6,38,7245,19,218,245,314,3383,19,516,226,1179,3862
6.796,6,1442,1151145,748,1433,8,1448,1101485,694,776,9,1448,49660
1.021,6,10,861,5,222,250,222,426,5,231,248,231,435
28.198,17,4,240,2,32,28197,32,120,2,32,28197,32,120
1777.862,17,73,3060,72,14,25040,14,3024,1,8,0,8,36
1798.941,1,16,896,16,28,119929,28,896,0,0,0,0,0
4.884,6,37,7189,19,218,271,314,3383,18,513,272,1179,3806
372.167,6,21,1422,15,180,26583,180,992,6,110,12250,110,430
130.178,17,14,896,14,36,10013,36,896,0,0,0,0,0
0.454,6,12,1653,6,288,89,288,548,6,426,52,434,1105
280.22,6,29,7392,13,158,23351,267,1317,16,603,18679,2800,6075
65.792,6,30,8872,13,158,5482,267,1317,17,763,4106,1781,7555
565.23,17,16,5376,16,308,37682,308,5376,0,0,0,0,0
49.296,6,43,8756,21,345,671,720,1967,22,368,2341,3488,6789
2.466,6,14,2351,8,188,352,245,700,6,703,415,1152,1651
1789.254,1,268,15008,268,28,6701,28,15008,0,0,0,0,0
0.052,17,8,2446,8,277,7,316,2446,0,0,0,0,0
104.561,6,67,47185,44,1191,2431,1408,39254,23,747,2801,1408,7931
0.149,6,12,3488,6,101,29,101,421,6,1373,29,1448,3067
1.337,6,23,6595,13,350,110,1088,2275,10,979,147,1731,4320
7.056,17,24,15359,13,917,588,1350,12293,11,250,653,1350,3066
68.088,1,3,180,3,32,34044,32,180,0,0,0,0,0
0.019,6,14,4044,8,88,2,88,452,6,1670,3,1880,3592
1744.718,2,17,544,17,8,109044,8,544,0,0,0,0,0
0.538,6,21,7203,13,318,44,600,1958,8,964,69,1471,5245
1787.911,6,364,23116,210,69,8554,69,12678,154,69,11685,69,10438
318.973,6,23,2157,10,80,35441,138,883,13,68,26580,69,1274
1795.742,17,448,39612,404,35,4455,288,25708,44,288,40952,288,13904
1.865,17,2,154,1,41,0,41,69,1,57,0,57,85
1740.997,6,87,6322,58,31,30543,31,3915,29,31,62178,31,2407
1745.412,6,95,7203,63,38,28151,205,4476,32,33,56296,98,2727
519.96,1,8,448,8,28,74280,28,448,0,0,0,0,0
20.315,6,20,2484,10,189,2257,517,1298,10,323,2250,499,1186
1745.711,6,94,7151,62,38,28618,205,4424,32,33,56299,98,2727
10.723,6,20,4442,11,275,1072,275,998,9,768,738,1440,3444
1.004,6,21,5960,12,285,91,556,1340,9,709,110,1380,4620
4.488,6,21,6369,10,268,493,517,1333,11,744,444,1418,5036
0.121,6,9,1002,5,213,30,213,417,4,421,33,421,585
285.891,6,27,2917,14,324,21989,585,1397,13,282,23821,580,1520
214.044,6,51,9439,25,121,8917,267,2467,26,311,8561,3417,6972
3.353,6,8,343,3,0,1585,0,124,5,7,792,7,219
192.002,6,4,574,4,103,64000,138,574,0,0,0,0,0
1786.395,6,106,8388,68,64,26662,64,4896,38,58,48278,58,3492
0.162,6,24,7176,12,155,14,267,1261,12,678,14,2800,5915
280.191,6,27,7312,13,158,23349,267,1317,14,775,21549,4836,5995
284.302,17,4,240,2,32,284301,32,120,2,32,284301,32,120
1.225,6,49,18827,29,855,43,1360,13206,20,400,55,1360,5621
218.353,1,3,168,3,28,109176,28,168,0,0,0,0,0
3.209,6,9,520,4,0,1069,0,220,5,0,778,0,300
280.437,6,30,7432,13,158,23369,267,1317,17,603,17525,2236,6115
226.673,17,26,2288,13,48,18888,48,988,13,72,18888,72,1300
1786.581,6,104,8376,68,65,26665,65,4930,36,59,51042,59,3446
0.219,17,3,234,2,39,205,39,134,1,72,0,72,100
15.972,6,5,232,3,0,7986,0,136,2,0,7275,0,96
66.77,6,143,128352,92,430,733,647,6166,51,2490,1321,12672,122186
1789.498,1,234,13104,234,28,7680,28,13104,0,0,0,0,0
1087.549,17,118,10550,107,30,10259,37,6255,11,362,102579,463,4295
4.011,17,4,244,4,33,1337,33,244,0,0,0,0,0
0.997,6,28,8484,15,222,61,540,1988,13,994,68,1791,6496
1795.94,17,87,3648,86,14,21128,14,3612,1,8,0,8,36
298.939,2,2,64,2,8,298939,8,64,0,0,0,0,0
1794.809,1,264,14784,264,28,6824,28,14784,0,0,0,0,0
0.004,6,2,92,1,0,0,0,40,1,0,0,0,52
0.046,17,4,1375,4,315,15,354,1375,0,0,0,0,0
1744.726,2,29,928,29,8,62311,8,928,0,0,0,0,0
1783.127,17,83,3480,82,14,22013,14,3444,1,8,0,8,36
300.734,2,4,128,4,8,100244,8,128,0,0,0,0,0
1794.951,17,193,53502,193,249,9348,357,53502,0,0,0,0,0
0.011,17,2,339,1,35,0,35,63,1,248,0,248,276
0.277,6,23,5928,12,164,25,453,1442,11,781,26,2224,4486
39.696,17,11,836,11,48,3969,48,836,0,0,0,0,0
25.983,6,36,8477,17,191,1623,721,2213,19,611,1386,1440,6264
1771.025,6,101,9344,66,65,27246,65,5577,35,59,52085,59,3767
0.131,17,2,455,2,199,131,354,455,0,0,0,0,0
6.801,6,4,232,1,0,0,0,52,3,0,3400,0,180
184.333,17,5,380,5,48,46083,48,380,0,0,0,0,0
11.291,6,1806,1566821,1088,1386,10,1414,1533820,718,467,15,1889,33001
0.035,17,4,1232,2,60,20,60,176,2,500,21,500,1056
1783.029,17,293,95449,293,297,6106,422,95449,0,0,0,0,0
1795.819,6,722,48747,361,31,4988,31,24383,361,31,4988,31,24364
1778.033,1,252,14112,252,28,7083,28,14112,0,0,0,0,0
1788.627,1,77,6468,0,0,0,0,0,77,56,23534,56,6468
1787.457,1,58,4872,58,56,31358,56,4872,0,0,0,0,0
1741.897,17,16,1265,8,30,248819,37,471,8,71,248836,136,794
31.866,6,6,360,0,0,0,0,0,6,0,0,0,360
0.309,6,25,8810,13,231,25,563,1608,12,1095,26,2816,7202
0.359,6,23,6673,10,181,33,267,1128,13,627,28,1400,5545
0.378,6,27,9120,13,266,31,705,1750,14,829,28,1402,7370
1.195,6,31,12124,17,525,74,1360,3350,14,820,76,1380,8774
280.475,6,29,7392,13,158,23372,267,1317,16,603,18694,2076,6075
1751.693,6,97,7307,63,38,28253,205,4476,34,33,53071,98,2831
74.97,1,2,284,2,114,74970,123,284,0,0,0,0,0
1.87,6,5,338,1,0,0,0,40,4,69,599,69,298
381.46,6,23,1499,14,177,29343,177,913,9,110,10712,110,586
251.635,17,4,352,2,60,251634,60,176,2,60,251633,60,176
0.189,17,4,588,2,48,172,48,152,2,190,164,308,436
1795.935,17,448,39896,403,35,4467,288,25676,45,288,40021,288,14220
13.894,6,20,1495,10,222,1543,222,848,10,231,1542,231,647
1.404,6,23,5084,12,137,127,267,1172,11,692,139,1467,3912
1795.162,17,80,3354,79,14,23014,14,3318,1,8,0,8,36
23.166,17,68,22869,33,473,722,1350,16557,35,152,680,1350,6312
59.443,6,29,8832,14,158,4572,267,1357,15,858,4244,3436,7475
1790.16,6,4156,3954298,1483,128,1207,341,87963,2673,1433,669,2804,3866335
1.999,6,8,430,3,0,999,0,152,5,7,451,7,278
52.247,6,27,7177,13,155,4353,267,1306,14,530,4018,3417,5871
12.594,6,16,1327,8,222,1796,222,768,8,231,1796,231,559
0.028,17,2,251,1,36,0,36,64,1,159,0,159,187
3.44,6,4,176,2,0,3440,0,88,2,0,1022,0,88
1772.119,6,180,15480,120,69,14891,69,8940,60,69,30033,69,6540
1206.094,6,244,15487,142,69,8553,69,8578,102,69,11938,69,6909
1784.853,6,356,22520,208,69,8622,69,12460,148,69,12141,69,10060
12.525,6,890,758751,539,1328,22,1368,733343,351,776,35,2736,25408
1671.761,1,8,448,8,28,238823,28,448,0,0,0,0,0
1798.905,6,401,26414,194,46,9320,46,11694,207,46,8731,46,14720
11.862,6,95,29183,48,564,252,1152,22821,47,447,251,1179,6362
2.423,6,5,288,2,0,2245,0,112,3,0,1123,0,176
3.175,6,11,467,6,0,635,0,248,5,7,748,7,219
0.149,17,2,672,2,308,149,308,672,0,0,0,0,0
9.159,6,18,1415,9,222,1143,222,808,9,231,1143,231,607
0.943,6,13,1904,7,279,157,279,918,6,218,138,272,986
1799.264,17,449,39928,404,35,4464,288,25708,45,288,40020,288,14220
280.076,6,28,7352,13,158,23339,267,1317,15,678,19999,2800,6035
3.617,17,5,900,4,64,1196,64,368,1,504,0,504,532
11.68,6,982,1465012,621,1153,18,1360,52552,361,4087,31,35360,1412460
1794.676,6,367,25581,214,99,8425,469,15045,153,69,11804,69,10536
3.863,17,4,1568,4,364,1287,364,1568,0,0,0,0,0
61.826,6,22,10179,12,397,55,884,1717,10,1341,6854,3928,8462
73.253,6,29,8832,14,158,5634,267,1357,15,858,5228,2800,7475
372.816,17,12,4496,12,346,33892,548,4496,0,0,0,0,0
0.209,17,2,168,1,32,0,32,60,1,80,0,80,108
1.251,6,16,2256,8,288,153,288,652,8,424,153,434,1604
15.561,6,2954,2836026,1909,1407,8,1440,2777022,1045,776,14,1440,59004
17.516,6,21,4573,11,214,1751,383,1732,10,487,592,1179,2841
0.006,17,2,387,1,65,0,65,93,1,266,0,266,294
0.904,6,10,1687,7,100,150,100,384,3,1179,318,1179,1303
1791.901,17,180,14040,180,50,10010,50,14040,0,0,0,0,0
1760.185,1,32,2688,32,56,56780,56,2688,0,0,0,0,0
1681.174,17,14,3843,7,30,280195,30,406,7,463,280194,463,3437
1763.985,2,14,448,14,8,135691,8,448,0,0,0,0,0
0.578,6,15,4865,9,290,72,517,1045,6,1166,81,1502,3820
1783.813,6,361,22858,210,69,8534,69,12678,151,69,11892,69,10180
18.801,6,438,364336,257,1348,73,1368,349218,181,1124,103,2736,15118
2.331,17,2,677,1,300,0,300,328,1,321,0,321,349
1787.384,17,142,11360,71,48,25533,48,5396,71,56,25533,56,5964
3.567,6,6,264,2,0,3482,0,88,4,0,1160,0,176
11.867,6,1908,1640834,1150,1372,10,1420,1606281,758,467,15,1883,34553
4.057,17,2,656,2,300,4057,300,656,0,0,0,0,0
169.046,17,4,352,2,60,169045,60,176,2,60,169045,60,176
1770.837,1,58,4872,58,56,31067,56,4872,0,0,0,0,0
1.342,6,10,767,5,186,335,186,454,5,45,335,45,313
1771.534,6,184,11274,92,47,19465,208,6695,92,31,19465,31,4579
25.496,17,4,240,2,32,25495,32,120,2,32,25495,32,120
0.155,17,2,180,1,30,0,30,58,1,94,0,94,122
1795.386,1,342,28728,342,56,5265,56,28728,0,0,0,0,0
1.963,17,2,120,2,32,1963,32,120,0,0,0,0,0
635.612,1,50,2800,50,28,12971,28,2800,0,0,0,0,0
0.32,6,20,7229,12,334,28,663,1969,8,1209,44,1906,5260
1783.329,17,83,3480,82,14,22016,14,3444,1,8,0,8,36
15.315,6,2578,2457271,1646,1414,9,1448,2404131,932,776,16,1448,53140
1790.644,6,356,22520,208,69,8650,69,12460,148,69,12181,69,10060
10.671,6,93,29407,46,588,237,1152,23029,47,449,226,1179,6378
57.859,17,6,528,3,48,28925,48,228,3,72,28925,72,300
1.229,6,58,18054,28,706,45,1360,8945,30,438,41,1360,9109
37.764,17,44,6468,22,48,1797,48,1672,22,190,1797,308,4796
1739.441,1,15,840,15,28,124245,28,840,0,0,0,0,0
368.651,6,23,1535,16,177,24576,177,1053,7,110,10376,110,482
0.009,17,2,382,1,37,0,37,65,1,289,0,289,317
1787.342,17,73,3060,72,14,25173,14,3024,1,8,0,8,36
1799.987,6,131,8242,75,47,24324,208,5072,56,31,32723,31,3170
1784.711,6,356,22520,208,69,8621,69,12460,148,69,12139,69,10060
0.018,17,2,152,2,48,18,48,152,0,0,0,0,0
655.93,6,142,16927,64,126,9632,1189,5984,78,181,8518,1420,10943
427.019,6,72,14287,37,105,11861,267,3499,35,312,12559,3417,10788
139.386,6,25,7770,8,272,252,516,1140,17,424,8706,1452,6630
270.172,6,66,46671,44,1177,6283,1368,38793,22,840,2955,2519,7878
252.861,6,512,392661,225,505,1128,1418,18847,287,1329,884,1418,373814
11.325,6,24,10575,12,275,1029,275,1038,12,1292,928,1440,9537
0.056,6,7,423,4,43,4,43,259,3,0,27,0,164
0.092,6,9,1002,5,213,23,213,417,4,421,27,421,585
1781.774,6,109,8759,71,65,25453,65,5115,38,59,48153,59,3644
1789.459,6,358,22669,208,69,8644,69,12529,150,69,12009,69,10140
5.439,6,39,7269,20,218,286,314,3423,19,440,288,1152,3846
7.131,17,2,672,2,308,7131,308,672,0,0,0,0,0
0.012,17,2,378,1,30,0,30,58,1,292,0,292,320
1781.986,6,104,8376,68,65,26596,65,4930,36,59,50911,59,3446
144.36,6,17,6188,4,106,48120,106,274,13,489,12013,1420,5914
31.987,17,6,1236,3,48,15990,48,228,3,308,15990,308,1008
5.498,6,21,6358,10,262,601,517,1316,11,744,542,1368,5042
1.536,6,20,3833,11,234,153,564,1504,9,463,166,1343,2329
63.572,6,38,6709,19,156,3531,189,1441,19,345,3515,2720,5268
17.485,17,29,6504,12,192,1587,1350,2640,17,199,1090,1350,3864
0.015,17,4,352,2,60,14,60,176,2,60,13,60,176
1779.685,17,142,11360,71,48,25423,48,5396,71,56,25423,56,5964
1757.207,6,107,6344,60,26,29781,26,3510,47,26,38198,26,2834
59.301,6,27,7177,13,155,4941,267,1306,14,530,4561,3417,5871
8.919,6,26,8740,13,122,743,267,1192,13,857,662,1448,7548
0.019,17,2,366,1,37,0,37,65,1,273,0,273,301
376.651,6,8,475,6,31,75330,31,333,2,31,299925,31,142
247.274,6,39,15845,20,1350,13014,1408,14556,19,293,13737,293,1289
0.047,17,2,279,1,36,0,36,64,1,187,0,187,215
0.04,17,2,347,1,29,0,29,57,1,262,0,262,290
12.796,6,2309,2197611,1480,1407,8,1440,2149839,829,776,15,1440,47772
2.659,17,4,1556,4,361,886,361,1556,0,0,0,0,0
1799.358,17,763,46046,763,32,2361,37,46046,0,0,0,0,0
1774.649,1,58,4872,58,56,31134,56,4872,0,0,0,0,0
1772.405,6,180,15480,120,69,14894,69,8940,60,69,30038,69,6540
0.837,6,36,8333,19,277,46,761,1900,17,478,43,2880,6433
0.371,6,27,8920,13,227,30,547,1592,14,941,28,1408,7328
1781.777,6,365,23087,211,69,8484,69,12787,154,69,11645,69,10300
0.932,17,2,144,1,36,0,36,64,1,52,0,52,80
1795.175,6,415,49298,207,154,8713,721,34555,208,168,8671,2007,14743
175.738,1,2,232,2,88,175738,100,232,0,0,0,0,0
1.364,6,41,9968,21,440,68,1360,4392,20,476,61,2715,5576
1786.037,6,359,22709,209,69,8586,69,12569,150,69,11986,69,10140
38.802,17,22,1936,11,48,3873,48,836,11,72,3874,72,1100
1740.561,17,28,18844,28,645,64465,645,18844,0,0,0,0,0
16.197,6,707,576242,383,1423,42,1448,553777,324,688,48,1448,22465
14.09,17,4,352,2,48,14081,48,152,2,72,14078,72,200
0.363,17,8,2766,8,317,51,356,2766,0,0,0,0,0
0.848,6,5,774,3,241,285,241,602,2,92,312,92,172
3.563,17,55,37778,23,384,160,1350,9493,32,855,113,1350,28285
4.015,17,4,232,4,30,1338,30,232,0,0,0,0,0
12.154,6,92,26930,47,551,264,1152,20648,45,447,270,1179,6282
156.578,1,6,336,6,28,31315,28,336,0,0,0,0,0
13.802,6,29,4970,14,154,1044,722,1818,15,338,973,1408,3152
1782.152,17,83,3480,82,14,22001,14,3444,1,8,0,8,36
0.216,17,2,152,1,48,0,48,76,1,48,0,48,76
0.273,6,10,1042,5,213,68,213,417,5,421,52,421,625
1.907,17,2,672,2,308,1907,308,672,0,0,0,0,0
1772.464,6,180,15480,120,69,14894,69,8940,60,69,30033,69,6540
0.284,6,24,5987,12,164,25,453,1442,12,652,24,1402,4545
12.327,6,23,9480,13,275,1027,275,1078,10,1598,1270,2840,8402
22.176,6,16,1858,6,283,4399,283,898,10,105,2444,105,960
0.072,6,10,1495,5,507,17,507,727,5,556,18,556,768
1786.401,6,116,13763,72,83,25160,516,5812,44,166,41541,1452,7951
0.008,17,2,485,1,45,0,45,73,1,384,0,384,412
255.973,6,6,861,6,103,51194,138,861,0,0,0,0,0
246.414,17,4,240,2,32,246413,32,120,2,32,246413,32,120
2.527,6,20,3833,11,234,252,564,1504,9,463,293,1343,2329
1741.459,6,87,6322,58,31,30551,31,3915,29,31,62194,31,2407
6.16,17,3,228,3,48,3080,48,228,0,0,0,0,0
64.65,6,17,692,8,0,7857,0,324,9,0,8079,0,368
1781.685,6,267,32619,107,133,16807,1360,15512,160,137,11204,4662,17107
241.077,6,44,6570,19,262,13392,582,3355,25,235,10044,580,3215
1.26,6,28,6347,14,164,96,267,1882,14,780,86,1460,4465
0.032,1,2,112,2,28,32,28,112,0,0,0,0,0
1798.961,17,449,39928,404,35,4463,288,25708,45,288,40021,288,14220
1750.916,6,159,9818,83,47,21352,208,5848,76,31,23341,31,3970
1773.064,6,181,15589,120,69,14899,69,8940,61,69,29549,69,6649
73.119,6,64,19823,30,181,2521,267,3388,34,836,2215,2800,16435
1794.921,1,57,4788,57,56,32052,56,4788,0,0,0,0,0
1552.331,1,20,1120,20,28,81701,28,1120,0,0,0,0,0
47.194,17,60,15570,60,231,799,389,15570,0,0,0,0,0
5.054,17,4,288,2,36,5011,36,128,2,52,5008,52,160
321.686,6,1125,1002875,763,1336,422,1360,979377,362,183,81,2667,23498
0.282,17,2,586,1,46,0,46,74,1,484,0,484,512
5.989,2,2,64,2,8,5989,8,64,0,0,0,0,0
0.29,17,2,167,1,39,0,39,67,1,72,0,72,100
61.676,6,16,15612,3,133,75,133,257,13,1483,5137,1691,15355
62.462,6,8143,7665751,5093,1420,12,1448,7489283,3050,776,20,1448,176468
777.546,6,78,9225,44,80,18082,721,3836,34,150,21520,1448,5389
31.449,17,7,604,4,48,10478,48,304,3,72,15715,72,300
25.843,6,3,134,0,0,0,0,0,3,7,12921,7,134
1795.85,17,447,39864,402,35,4478,288,25644,45,288,40022,288,14220
70.654,6,77,49609,47,1149,1535,1448,40395,30,763,2135,1448,9214
0.041,17,2,378,1,30,0,30,58,1,292,0,292,320
15.384,17,16,5096,7,360,2553,1350,2718,9,236,1914,1350,2378
15.367,6,18,2481,10,211,1707,211,970,8,545,2041,904,1511
30.685,17,16,1408,8,48,4381,48,608,8,72,4382,72,800
134.989,6,29,7392,13,158,11249,267,1317,16,603,8998,2036,6075
11.814,6,1903,1628054,1148,1363,10,1380,1593612,755,421,15,1923,34442
0.012,17,2,350,1,37,0,37,65,1,257,0,257,285
256.13,6,23,6592,7,156,42688,267,758,16,518,17064,1460,5834
0.947,17,4,560,2,64,946,64,184,2,160,826,160,376
265.394,1,41,4264,0,0,0,0,0,41,76,6634,76,4264
0.784,17,2,136,1,32,0,32,60,1,48,0,48,76
2.974,17,6,1674,3,32,983,32,180,3,470,0,470,1494
1.007,6,29,8524,15,222,60,540,1988,14,852,63,1360,6536
405.0,6,214,59226,97,560,4218,1460,38252,117,232,3490,2920,20974
0.974,6,28,8496,15,222,58,540,2000,13,994,65,2720,6496
96.273,6,57,37562,37,1159,2674,1448,29769,20,963,3238,4344,7793
0.685,6,4,172,2,0,497,0,92,2,0,507,0,80
33.874,6,31,5094,15,154,2419,722,1859,16,342,2245,1448,3235
5.537,6,39,7285,20,218,291,314,3423,19,516,293,1179,3862
1690.662,1,96,5376,96,28,17796,28,5376,0,0,0,0,0
1789.203,6,381,26555,220,97,8169,469,15630,161,69,11179,69,10925
1786.161,6,353,32398,175,355,10265,842,12760,178,61,10089,1539,19638
0.382,17,8,2758,8,316,54,355,2758,0,0,0,0,0
1702.193,1,14,784,14,28,130937,28,784,0,0,0,0,0
33.491,6,40,9471,19,321,1860,721,3014,21,467,1654,1420,6457
240.318,6,55,20106,30,861,8286,1418,17068,25,216,10012,580,3038
29.684,6,16,660,9,0,3710,0,364,7,0,3979,0,296
1745.096,6,95,7203,63,38,28146,205,4476,32,33,56286,98,2727
83.204,6,30,7432,13,158,6933,267,1317,17,543,5197,1400,6115
1682.762,17,14,1036,7,30,280453,30,406,7,62,280454,62,630
52.566,17,6,456,6,48,10513,48,456,0,0,0,0,0
1772.135,6,180,15480,120,69,14891,69,8940,60,69,30035,69,6540
1655.917,1,9,975,9,80,206989,99,975,0,0,0,0,0
871.499,17,20,7060,20,325,45868,382,7060,0,0,0,0,0
1782.65,6,354,22440,207,69,8653,69,12420,147,69,12209,69,10020
0.03,6,2,123,1,0,0,0,40,1,31,0,31,83
305.394,6,414,343367,255,1379,1202,1460,330361,159,236,83,1460,13006
7.851,6,79,24914,40,568,201,1152,19213,39,413,200,1152,5701
1772.439,6,99,9240,66,65,27268,65,5577,33,59,55385,59,3663
300.599,6,43,8907,22,315,14314,882,2221,21,388,442,2720,6686
11.467,6,21,6825,12,275,1042,275,1038,9,1353,807,1440,5787
1770.27,6,99,9306,66,66,27234,66,5610,33,60,55318,60,3696
0.309,6,6,328,4,0,103,0,216,2,0,300,0,112
55.505,6,31,7725,11,155,8,267,1226,20,355,2921,3417,6499
1798.557,17,87,3648,86,14,21159,14,3612,1,8,0,8,36
1786.684,6,110,8616,68,65,26666,65,4930,42,59,43575,59,3686
0.802,17,3,1170,3,362,401,362,1170,0,0,0,0,0
1777.91,17,142,11360,71,48,25398,48,5396,71,56,25398,56,5964
3.164,17,4,272,2,32,3160,32,120,2,48,3159,48,152
1793.199,17,140,11200,70,48,25988,48,5320,70,56,25988,56,5880
2.37,17,4,610,3,39,923,39,201,1,381,0,381,409
54.707,6,16,1166,9,39,6838,39,507,7,49,9117,63,659
1747.074,6,95,7203,63,38,28178,205,4476,32,33,56347,98,2727
1799.958,17,449,39928,404,35,4466,288,25708,45,288,40021,288,14220
0.199,1,2,112,2,28,199,28,112,0,0,0,0,0
3.299,17,3,228,2,48,3049,48,152,1,48,0,48,76
6.166,6,44,8385,23,227,280,314,4102,21,491,295,1179,4283
121.654,6,81,55203,50,1195,2482,1368,46854,31,841,2070,2519,8349
0.571,6,110,76973,64,1287,9,1432,70842,46,475,12,1871,6131
55.498,17,4,240,2,32,55497,32,120,2,32,55497,32,120
2.08,1,2,112,2,28,2080,28,112,0,0,0,0,0
1740.508,6,87,6322,58,31,30535,31,3915,29,31,62160,31,2407
240.204,6,53,18270,28,812,8896,1402,15272,25,211,10008,580,2998
1797.899,6,356,22520,208,69,8685,69,12460,148,69,12230,69,10060
104.826,6,22,8355,11,525,79,1237,2084,11,969,10466,2720,6271
1.101,6,32,6300,16,138,73,267,1755,16,650,65,1420,4545
0.313,17,5,1696,5,311,78,354,1696,0,0,0,0,0
0.103,17,2,389,1,34,0,34,62,1,299,0,299,327
1785.557,6,418,25048,209,69,8584,69,12500,209,34,8584,48,12548
122.887,17,10,13724,10,1344,13654,1347,13724,0,0,0,0,0
0.172,6,10,1677,6,555,30,951,1354,4,159,51,159,323
1665.638,1,8,848,8,78,237948,78,848,0,0,0,0,0
23.533,6,28,6128,15,120,1680,159,1532,13,1289,1868,3077,4596
1799.255,17,66,2766,65,14,28113,14,2730,1,8,0,8,36
1745.885,6,100,7463,63,38,28159,205,4476,37,33,48490,98,2987
1746.605,6,95,7203,63,38,28171,205,4476,32,33,56333,98,2727
1741.443,17,30,31680,30,1028,60049,1028,31680,0,0,0,0,0
0.374,6,13,1693,7,288,62,288,588,6,426,41,434,1105
38.469,17,22,1936,11,48,3845,48,836,11,72,3845,72,1100
1781.246,1,58,4872,58,56,31249,56,4872,0,0,0,0,0
1788.917,6,365,24963,212,94,8478,469,14496,153,69,11768,69,10467
0.509,17,3,451,2,39,138,39,134,1,289,0,289,317
16.646,6,17,1153,8,222,2376,222,546,9,231,2079,231,607
0.435,6,12,1653,6,288,87,288,548,6,426,47,434,1105
1615.991,1,7,392,7,28,269331,28,392,0,0,0,0,0
1.361,6,50,19854,27,931,52,1460,14158,23,433,53,1460,5696
0.011,6,3,151,1,0,0,0,40,2,31,2,31,111
877.808,6,125,14808,64,91,13933,721,6392,61,248,14465,1440,8416
61.307,6,37,15985,22,805,2919,1408,9206,15,665,4361,1408,6779
7.644,6,538,499922,263,249,29,255,25231,275,1711,27,5608,474691
2.59,17,38,30263,22,984,121,1350,22271,16,471,170,1350,7992
1798.653,17,449,39928,404,35,4463,288,25708,45,288,40019,288,14220
1777.596,17,140,11200,70,48,25762,48,5320,70,56,25762,56,5880
1.642,6,41,9968,21,440,82,1360,4392,20,476,74,2720,5576
13.953,6,22,4526,12,275,1268,275,1038,10,768,1019,1440,3488
37.724,17,4,1344,4,308,12574,308,1344,0,0,0,0,0
0.302,6,27,8971,13,232,25,569,1614,14,827,22,1402,7357
11.737,6,98,30129,50,587,239,1152,23727,48,447,244,1179,6402
0.619,17,2,144,1,36,0,36,64,1,52,0,52,80
246.765,6,23,8846,5,112,33,112,320,18,487,14515,1420,8526
0.018,17,4,668,2,32,13,32,120,2,246,2,246,548
0.593,6,14,1745,7,288,73,288,600,7,426,69,434,1145
5.012,6,38,7229,19,218,278,314,3383,19,440,264,1152,3846
2.234,6,13,2311,8,188,319,245,700,5,1407,494,1407,1611
18.941,17,36,12893,20,489,995,1350,10342,16,131,1260,1350,2551
0.022,17,2,180,1,30,0,30,58,1,94,0,94,122
777.654,1,12,672,12,28,70695,28,672,0,0,0,0,0
240.185,6,57,17325,29,714,8577,1402,14371,28,186,8895,580,2954
12.915,6,2046,1783601,1239,1384,10,1420,1747076,807,467,16,1883,36525
15.086,6,24,6993,13,275,1257,275,1078,11,910,1006,1420,5915
104.872,2,2,64,2,8,104872,8,64,0,0,0,0,0
1782.379,17,81,3410,72,13,25103,14,3014,9,16,30071,16,396
0.829,6,13,1096,7,283,109,283,663,6,105,131,105,433
1660.121,17,81,3396,80,14,21014,14,3360,1,8,0,8,36
92.805,6,43,27170,19,741,143,1460,3778,24,1318,4020,2920,23392
1789.258,17,142,11360,71,48,25560,48,5396,71,56,25560,56,5964
1792.006,6,362,24774,211,94,8533,469,14387,151,69,11946,69,10387
11.478,6,27,11433,13,275,956,275,1078,14,1087,847,1440,10355
3.692,2,3,96,3,8,1846,8,96,0,0,0,0,0
0.006,17,4,304,2,37,0,37,130,2,59,0,65,174
0.667,17,15,7227,7,604,110,1350,4430,8,321,90,1350,2797
4.95,6,37,7189,19,218,275,314,3383,18,513,274,1179,3806
0.061,1,2,112,2,28,61,28,112,0,0,0,0,0
0.014,17,2,355,1,33,0,33,61,1,266,0,266,294
0.03,17,2,241,1,36,0,36,64,1,149,0,149,177
1756.161,6,184,11305,92,47,19298,208,6695,92,31,19295,31,4610
1799.46,1,56,4704,56,56,32717,56,4704,0,0,0,0,0
1783.986,17,256,24156,128,33,14046,37,7872,128,99,14046,155,16284
280.203,6,29,7392,13,158,23350,267,1317,16,603,18677,2036,6075
11.23,6,101,31406,51,602,224,1152,24924,50,407,223,1152,6482
74.774,6,23,9794,12,410,57,922,1742,11,1085,7463,2720,8052
0.064,17,2,195,1,44,0,44,72,1,95,0,95,123
31.886,6,255,249082,83,104,388,306,4735,172,1409,186,1418,244347
16.489,6,25,5001,11,308,1648,722,1800,14,305,1245,1408,3201
0.602,6,125,87849,59,131,10,232,2889,66,1349,9,2199,84960
0.01,17,2,410,1,37,0,37,65,1,317,0,317,345
0.308,1,2,112,2,28,308,28,112,0,0,0,0,0
1798.17,6,380,26584,219,97,8248,469,15590,161,69,11236,69,10994
80.141,6,22,8810,11,333,70,692,1473,11,983,8001,1360,7337
1795.814,17,448,39896,403,35,4467,288,25676,45,288,40016,288,14220
1072.637,17,54,2265,53,13,20627,14,2221,1,16,0,16,44
9.022,17,3,290,2,37,9003,37,130,1,132,0,132,160
0.165,6,9,1144,5,145,41,145,349,4,631,40,631,795
151.725,6,173,131307,108,1267,1417,1408,118418,65,730,1279,3847,12889
29.754,6,13,1100,5,283,7417,283,563,8,105,4226,105,537
87.942,6,22,2564,8,189,12562,517,1194,14,323,6764,499,1370
0.01,17,2,443,1,40,0,40,68,1,347,0,347,375
1773.249,1,58,4872,0,0,0,0,0,58,56,31109,56,4872
1786.379,6,114,9156,73,66,24810,66,5296,41,60,44657,60,3860
1681.791,1,15,840,15,28,120127,28,840,0,0,0,0,0
17.035,6,22,6552,8,156,2433,267,798,14,648,1305,3457,5754
0.016,17,2,212,1,53,0,53,81,1,103,0,103,131
8.652,6,70,20286,35,520,254,1152,15459,35,489,245,1179,4827
66.781,6,25,1799,18,43,3927,43,1399,7,0,10628,0,400
44.841,6,30,7297,14,155,3449,267,1346,16,441,2988,1420,5951
250.004,17,4,352,2,48,249993,48,152,2,72,249992,72,200
1739.027,1,57,4788,57,56,31054,56,4788,0,0,0,0,0
140.409,6,24,10085,13,531,58,1360,2713,11,1153,14025,2720,7372
8.75,6,41,8681,20,367,460,787,1994,21,364,428,1360,6687
1797.993,17,450,39960,405,35,4450,288,25740,45,288,40021,288,14220
292.943,6,46,7904,21,116,14644,517,2035,25,504,12203,1418,5869
1786.515,6,102,8364,68,66,26664,66,4964,34,60,54133,60,3400
1791.083,6,82,5683,40,36,45924,36,2164,42,445,43683,445,3519
1792.158,17,87,3648,86,14,21084,14,3612,1,8,0,8,36
31.333,17,18,1368,18,48,1843,48,1368,0,0,0,0,0
6.24,6,1471,1368707,937,1384,6,1408,1336275,534,931,11,2816,32432
0.72,6,146,99978,80,1301,9,1420,93047,66,475,10,1883,6931
1794.264,1,58,4872,58,56,31478,56,4872,0,0,0,0,0
1762.702,1,75,6300,0,0,0,0,0,75,56,23820,56,6300
32.145,6,182,195521,64,114,510,343,3784,118,1628,274,4206,191737
4.946,6,39,7269,19,218,274,314,3383,20,440,247,1152,3886
18.114,6,8,440,5,0,4528,0,268,3,0,9050,0,172
2.684,6,2,88,2,0,0,0,88,0,0,0,0,0
1.53,17,4,396,2,39,1000,39,134,2,103,0,103,262
1740.09,6,99,7161,63,31,28065,31,4273,36,31,49716,31,2888
1787.901,6,371,25810,214,99,8393,469,15114,157,69,11460,69,10696
1798.051,6,359,22778,210,69,8603,69,12609,149,69,12148,69,10169
1782.333,6,102,8296,68,65,26601,65,4930,34,59,54006,59,3366
1793.278,6,356,22520,208,69,8663,69,12460,148,69,12199,69,10060
1784.556,1,162,17172,162,78,11084,78,17172,0,0,0,0,0
217.223,6,27,5127,11,186,11665,502,1378,16,258,14475,1420,3749
292.756,17,4,240,2,32,292755,32,120,2,32,292755,32,120
7.34,6,6,280,2,0,7340,0,88,4,0,2387,0,192
0.56,6,23,7428,14,273,43,663,2104,9,1209,66,1946,5324
1755.91,6,2599,2806079,1047,122,1678,333,68461,1552,1795,1132,11344,2737618
141.322,17,4,352,2,60,141321,60,176,2,60,141321,60,176
145.234,17,2,740,2,342,145234,342,740,0,0,0,0,0
1775.527,17,140,11200,70,48,25732,48,5320,70,56,25732,56,5880
1792.863,1,168,9408,168,28,10735,28,9408,0,0,0,0,0
65.597,1,6,336,6,28,13119,28,336,0,0,0,0,0
4.171,6,33,6129,18,206,245,314,2784,15,548,279,1179,3345
1465.249,1,7,392,7,28,244208,28,392,0,0,0,0,0
281.981,6,30,7432,13,158,23498,267,1317,17,543,17604,1400,6115
240.59,6,54,18077,28,799,8906,1418,15061,26,207,9620,580,3016
1791.994,6,429,72036,199,231,9049,1360,44822,230,180,7824,1942,27214
1741.858,6,87,6322,58,31,30558,31,3915,29,31,62208,31,2407
240.235,6,56,19598,29,845,8579,1408,16743,27,180,9239,580,2855
2.079,17,16,11693,10,896,231,1350,9240,6,380,382,1350,2453
1790.768,6,364,57755,220,316,8177,316,42124,144,83,12522,83,15631
1786.706,6,356,22520,208,69,8631,69,12460,148,69,12154,69,10060
43.672,6,5,228,0,0,0,0,0,5,7,10918,7,228
19.32,17,35,21591,19,745,1071,1350,14703,16,402,1285,1350,6888
316.989,6,107,35904,58,511,5561,1360,24869,49,312,6600,2720,11035
1.585,2,3,96,3,8,792,8,96,0,0,0,0,0
0.326,17,3,1170,3,362,163,362,1170,0,0,0,0,0
358.102,6,2984,1542370,1698,838,211,1152,1473053,1286,364,278,1179,69317
0.259,6,26,9034,13,257,21,667,1715,13,947,21,1408,7319
1564.208,2,12,384,12,8,142200,8,384,0,0,0,0,0
298.614,6,59,3740,34,69,9048,69,2050,25,69,12441,69,1690
661.748,2,8,256,8,8,94535,8,256,0,0,0,0,0
38.97,6,6,340,2,0,38970,0,100,4,0,7400,0,240
1763.571,17,150,25727,150,143,11836,376,25727,0,0,0,0,0
4.301,6,2,104,2,0,0,0,104,0,0,0,0,0
0.409,6,25,7711,16,339,27,949,3017,9,721,49,1420,4694
1774.26,17,139,11124,69,48,25724,48,5244,70,56,25713,56,5880
50.925,17,35,13655,18,544,2991,1350,10311,17,168,3177,1350,3344
64.436,6,12,927,4,177,121,177,393,8,110,9181,110,534
0.133,17,2,170,1,37,0,37,65,1,77,0,77,105
541.154,6,53,18109,23,371,23888,1024,5777,30,556,18653,1360,12332
1729.191,6,63,4601,41,33,43229,33,2825,22,31,82333,31,1776
1.7,6,13,2311,8,188,242,245,700,5,1407,359,1407,1611
20.207,6,17,2316,10,189,2245,517,1298,7,323,3366,499,1018
5.343,6,40,7325,21,218,267,314,3463,19,516,282,1179,3862
1.432,6,58,17922,29,767,51,1440,8853,29,438,50,1440,9069
2.496,17,4,518,3,39,977,39,201,1,289,0,289,317
6.964,6,11,1424,6,145,1392,145,389,5,827,876,827,1035
39.43,17,22,1936,11,48,3941,48,836,11,72,3941,72,1100
1773.221,6,181,15589,120,69,14901,69,8940,61,69,29547,69,6649
1.725,6,14,2351,8,188,246,245,700,6,703,292,1152,1651
3.177,6,61,22788,33,939,99,1460,13643,28,471,101,1460,9145
3.172,6,2,1520,1,0,0,0,40,1,1440,0,1440,1480
1366.017,6,160,19452,100,128,13798,485,10293,60,114,23152,453,9159
1.499,17,2,290,1,47,0,47,75,1,187,0,187,215
1679.532,1,15,840,15,28,119966,28,840,0,0,0,0,0
146.808,6,21,8279,11,525,94,1237,2048,10,969,16291,1791,6231
40.287,6,40,9257,24,541,1751,1244,5572,16,203,2683,1282,3685
1795.611,17,446,38980,404,35,4455,288,25708,42,288,42948,288,13272
1799.794,17,142,11360,71,48,25711,48,5396,71,56,25711,56,5964
1740.941,17,30,31680,30,1028,60032,1028,31680,0,0,0,0,0
1781.8,6,366,25003,213,94,8404,469,14536,153,69,11722,69,10467
0.319,17,2,198,1,39,0,39,67,1,103,0,103,131
1305.983,6,73,19058,46,311,29021,721,12423,27,504,5225,1440,6635
715.154,2,4,128,4,8,238384,8,128,0,0,0,0,0
10.855,6,20,4402,11,275,1085,275,998,9,758,757,1420,3404
125.455,6,5,267,3,0,62727,0,152,2,7,125250,7,115
720.711,17,56,4480,28,48,26692,48,2128,28,56,26692,56,2352
0.063,6,9,1002,5,213,15,213,417,4,421,18,421,585
1.792,17,23,8067,11,453,178,1350,5292,12,203,160,1350,2775
295.394,17,4,352,2,60,295393,60,176,2,60,295392,60,176
6.287,6,1042,923791,638,1370,9,1408,898119,404,931,15,2816,25672
45.567,17,8,704,4,48,15186,48,304,4,72,15185,72,400
1.395,17,2,152,1,48,0,48,76,1,48,0,48,76
1.104,6,24,8004,12,164,86,267,1288,12,1014,85,2804,6716
1.384,6,46,17865,26,862,55,1460,12289,20,433,63,1460,5576
1788.57,6,356,22520,208,69,8640,69,12460,148,69,12167,69,10060
209.367,17,36,3816,18,92,12315,136,2160,18,64,12315,72,1656
1.353,6,41,8443,21,321,67,1164,2822,20,437,62,2715,5621
3.026,17,7,612,4,32,1001,32,240,3,96,1503,96,372
0.27,17,2,476,1,39,0,39,67,1,381,0,381,409
661.023,17,51,4068,27,48,25423,48,2052,24,56,25420,56,2016
6.194,6,40,7309,21,218,309,314,3463,19,513,329,1179,3846
4.058,17,5,290,5,30,1014,30,290,0,0,0,0,0
0.424,6,10,968,5,256,102,256,460,5,304,101,304,508
681.906,17,8,2672,8,306,97415,308,2672,0,0,0,0,0
300.918,6,38,9629,19,648,16717,1440,4036,19,370,485,1440,5593
5.733,6,33,8929,16,303,382,721,2765,17,608,346,1440,6164
0.412,6,26,9039,13,266,34,705,1750,13,943,32,1438,7289
158.686,17,4,352,2,60,158685,60,176,2,60,158685,60,176
16.546,17,26,5514,12,219,1501,1350,2974,14,153,1270,1350,2540
280.233,6,27,7312,13,158,23352,267,1317,14,775,21553,3445,5995
1764.719,2,13,416,13,8,147059,8,416,0,0,0,0,0
315.936,6,81,14050,38,125,8538,658,4207,43,270,7519,1360,9843
0.29,17,2,184,1,32,0,32,60,1,96,0,96,124
1775.253,17,73,3060,72,14,25003,14,3024,1,8,0,8,36
1739.978,6,87,6322,58,31,30525,31,3915,29,31,62141,31,2407
0.371,6,6,324,4,0,123,0,216,2,0,180,0,108
1796.864,17,449,39928,404,35,4458,288,25708,45,288,40012,288,14220
1786.937,6,360,22818,210,69,8549,69,12678,150,69,11989,69,10140
1788.804,6,366,25541,213,100,8437,469,14936,153,69,11768,69,10605
2.554,6,30,5973,14,123,196,267,1428,16,650,161,1420,4545
1796.659,1,58,4872,0,0,0,0,0,58,56,31520,56,4872
13.681,6,27,4866,13,154,1122,722,1767,14,394,1039,1408,3099
240.486,6,37,6644,19,158,13359,517,2107,18,598,14145,1418,4537
1795.665,6,356,22520,208,69,8674,69,12460,148,69,12215,69,10060
1769.969,6,109,10056,70,65,25651,65,5939,39,59,46575,59,4117
1772.326,6,180,15480,120,69,14893,69,8940,60,69,30034,69,6540
1787.28,17,87,3648,86,14,21026,14,3612,1,8,0,8,36
0.607,6,24,6435,13,310,49,889,2075,11,783,59,1420,4360
2.862,6,60,16891,31,241,95,619,2381,29,555,96,1360,14510
1.257,6,37,8214,19,321,69,1164,2718,18,476,63,2715,5496
1564.197,2,16,512,16,8,104279,8,512,0,0,0,0,0
294.172,6,36,8086,13,158,24514,267,1317,23,365,13370,1400,6769
1793.038,6,368,25759,214,99,8418,469,15045,154,69,11719,69,10714
460.632,6,7421,6088866,3423,485,134,522,206290,3998,1421,115,7040,5882576
1.133,6,25,8056,12,164,87,267,1288,13,869,80,1408,6768
1741.861,6,87,6322,58,31,30558,31,3915,29,31,62207,31,2407
285.633,6,30,8077,12,158,25966,267,1277,18,552,16800,1400,6800
215.951,17,4,352,2,60,215950,60,176,2,60,215950,60,176
1785.816,6,105,8481,69,65,26262,65,5035,36,59,51020,59,3446
1794.921,17,409,68603,198,220,9111,1350,49285,211,63,8543,1350,19318
1680.83,17,13,534,11,14,168064,14,462,2,8,1680644,8,72
0.061,6,9,1339,5,145,15,145,349,4,826,15,826,990
283.785,6,32,7853,14,158,21829,267,1357,18,524,16692,1400,6496
1786.431,6,104,8308,68,64,26663,64,4896,36,58,51038,58,3412
19.795,17,2,152,2,48,19795,48,152,0,0,0,0,0
0.408,17,2,144,1,36,0,36,64,1,52,0,52,80
0.545,17,3,451,2,39,468,39,134,1,289,0,289,317
1620.655,1,7,392,7,28,270109,28,392,0,0,0,0,0
7.833,17,12,1764,6,48,1564,48,456,6,190,1564,308,1308
15.507,6,22,1662,11,275,1550,275,1006,11,96,1454,96,656
220.02,17,4,300,2,47,220019,47,150,2,47,220019,47,150
0.035,17,2,283,1,31,0,31,59,1,196,0,196,224
1770.268,6,99,9240,66,65,27234,65,5577,33,59,55318,59,3663
1.275,6,213,163638,125,1322,10,1432,155827,88,427,14,1432,7811
204.428,6,30,7432,13,158,17035,267,1317,17,603,12774,2076,6115
5.796,6,41,7349,21,218,289,314,3463,20,513,290,1179,3886
265.978,1,5,280,5,28,66494,28,280,0,0,0,0,0
1793.962,17,142,11360,71,48,25627,48,5396,71,56,25627,56,5964
1772.814,6,270,33083,111,137,16115,1360,16016,159,133,11219,2720,17067
6.138,6,1305,1167939,801,1379,7,1408,1137067,504,931,11,2816,30872
1.678,6,19,3781,10,234,186,564,1452,9,463,186,1343,2329
153.713,17,604,115450,601,163,256,172,115286,3,26,9963,56,164
1772.071,6,180,15480,120,69,14891,69,8940,60,69,30034,69,6540
55.274,6,25,6757,12,181,5024,267,1212,13,717,4598,2036,5545
29.294,17,15,7785,8,655,4184,1350,5471,7,302,43,1350,2314
10.969,6,18,5610,10,275,1218,275,958,8,1440,843,1440,4652
1.428,6,10,1687,7,100,238,100,384,3,1179,589,1179,1303
38.38,17,22,1936,11,48,3837,48,836,11,72,3836,72,1100
1795.222,17,80,3354,79,14,23015,14,3318,1,8,0,8,36
1638.749,1,7,392,7,28,273124,28,392,0,0,0,0,0
88.043,17,20,1520,20,48,4633,48,1520,0,0,0,0,0
240.207,6,54,18212,28,803,8896,1418,15124,26,216,9607,580,3088
1.378,6,47,18804,27,865,53,1360,13228,20,476,61,2715,5576
300.766,6,42,8829,21,308,15038,889,2143,21,364,430,1360,6686
753.257,1,40,4240,40,78,19314,78,4240,0,0,0,0,0
280.482,6,30,7432,13,158,23373,267,1317,17,603,17525,2760,6115
1789.95,6,376,23803,215,69,8364,69,13223,161,69,11187,69,10580
13.126,17,4,824,2,48,13110,48,152,2,308,13111,308,672
27.032,6,35,9238,17,291,1689,721,3014,18,687,1530,2840,6224
10.232,6,9,913,6,147,2032,147,761,3,0,5085,0,152
1.18,17,5,373,3,31,574,31,177,2,70,873,70,196
1.313,6,53,22814,29,992,46,1440,17078,24,433,49,1440,5736
0.011,17,2,452,1,59,0,59,87,1,337,0,337,365
1679.487,1,11,638,11,30,167948,30,638,0,0,0,0,0
737.562,6,155,10797,78,69,9578,69,4845,77,66,9704,69,5952
34.833,17,20,1520,20,48,1833,48,1520,0,0,0,0,0
65.006,6,12,927,4,177,126,177,393,8,110,9260,110,534
1.267,6,50,18638,27,845,48,1360,12942,23,433,49,1360,5696
0.213,6,27,7296,13,155,17,267,1301,14,543,15,1400,5995
19.772,17,22,12612,13,767,1645,1350,10345,9,223,2467,1350,2267
61.34,6,35,15827,22,800,2920,1408,9153,13,855,5089,3847,6674
2.955,6,2,88,2,0,0,0,88,0,0,0,0,0
0.232,17,2,152,1,48,0,48,76,1,48,0,48,76
1.565,6,51,18879,29,855,55,1360,13178,22,437,64,2715,5701
11.237,6,26,11958,13,275,936,275,1078,13,1293,895,1414,10880
291.547,6,1173,173674,589,258,495,1440,125944,584,124,490,1440,47730
1743.823,6,95,7203,63,38,28126,205,4476,32,33,56242,98,2727
1800.0,6,215,16891,79,72,22692,337,8074,136,49,13333,143,8817
32.014,6,9,396,2,0,3444,0,88,7,0,5320,0,308
0.42,6,13,1693,7,288,66,288,588,6,426,49,434,1105
58.46,1,2,768,2,356,58460,359,768,0,0,0,0,0
5.873,6,10,767,5,186,1460,186,454,5,45,1442,45,313
1786.644,6,108,8536,68,65,26666,65,4930,40,59,45808,59,3606
286.275,6,142,103903,86,1261,3367,1368,92816,56,742,1850,2736,11087
1748.235,6,95,7203,63,38,28197,205,4476,32,33,56382,98,2727
1798.714,6,426,38214,232,129,7786,1189,19754,194,125,9319,1460,18460
10.721,6,18,5610,10,275,1191,275,958,8,1440,815,1440,4652
1739.096,1,56,4704,0,0,0,0,0,56,56,31619,56,4704
0.151,17,2,136,1,32,0,32,60,1,48,0,48,76
1780.793,17,142,11360,71,48,25439,48,5396,71,56,25439,56,5964
1682.774,17,14,1036,7,30,280455,30,406,7,62,280456,62,630
0.56,6,27,7296,13,155,46,267,1301,14,543,36,1400,5995
154.55,6,23,10229,11,433,77,990,1771,12,995,14037,1360,8458
1682.502,1,8,448,8,28,240357,28,448,0,0,0,0,0
18.016,6,1111,965229,691,1323,26,1368,938441,420,931,42,2736,26788
0.491,6,12,1653,6,288,94,288,548,6,426,53,434,1105
0.103,17,2,212,1,46,0,46,74,1,110,0,110,138
0.91,6,52,13853,24,549,39,1429,4824,28,438,32,1460,9029
4.218,17,8,648,4,34,1333,34,248,4,72,1345,84,400
1795.671,17,448,39896,403,35,4466,288,25676,45,288,40017,288,14220
1784.712,17,142,11360,71,48,25495,48,5396,71,56,25495,56,5964
1788.863,1,232,12992,232,28,7743,28,12992,0,0,0,0,0
1798.031,17,449,39928,404,35,4461,288,25708,45,288,40020,288,14220
1141.045,6,140,24978,93,302,12402,302,18716,47,83,24805,83,6262
272.23,17,4,352,2,60,272229,60,176,2,60,272229,60,176
1796.072,1,58,4872,58,56,31510,56,4872,0,0,0,0,0
1775.637,6,312,78018,152,823,11759,1402,46628,160,192,11167,2804,31390
157.115,6,10,545,3,0,78557,0,152,7,7,26156,7,393
2.284,17,4,734,3,46,1001,46,222,1,484,0,484,512
276.214,17,2142,417130,1901,167,145,172,372246,241,158,410,172,44884
617.151,1,7,420,7,32,102858,32,420,0,0,0,0,0
1.418,6,51,20136,29,945,50,1460,14435,22,437,58,2615,5701
1795.097,17,449,39928,404,35,4454,288,25708,45,288,40017,288,14220
1773.776,1,342,28728,342,56,5201,56,28728,0,0,0,0,0
0.139,6,2,100,1,0,0,0,60,1,0,0,0,40
24.21,17,12,1056,6,48,4808,48,456,6,72,4820,72,600
3.604,17,6,731,5,40,897,40,340,1,363,0,363,391
0.226,17,2,2344,2,1144,226,1258,2344,0,0,0,0,0
1792.455,17,180,14040,180,50,10013,50,14040,0,0,0,0,0
397.563,17,105,25370,105,213,3822,422,25370,0,0,0,0,0
0.003,6,3,120,1,0,0,0,40,2,0,0,0,80
46.52,6,29,7257,13,155,3876,267,1306,16,441,3100,1420,5951
1791.957,1,236,13216,236,28,7625,28,13216,0,0,0,0,0
1796.074,17,449,39928,404,35,4456,288,25708,45,288,40021,288,14220
0.037,6,7,380,4,0,12,0,216,3,0,10,0,164
4.472,6,25,4645,13,561,372,1460,3393,12,152,355,152,1252
1.125,6,24,5755,13,158,93,370,1315,11,799,111,1420,4440
1772.41,6,180,15480,120,69,14894,69,8940,60,69,30032,69,6540
0.459,6,11,1008,6,256,88,256,500,5,304,110,304,508
0.136,17,4,420,2,33,0,33,122,2,121,2,145,298
1782.484,17,73,3060,72,14,25105,14,3024,1,8,0,8,36
150.042,6,12,732,7,27,25007,27,418,5,27,37497,27,314
3.186,17,5,290,5,30,796,30,290,0,0,0,0,0
33.82,6,30,5042,15,154,2415,722,1859,15,399,2395,1448,3183
1777.816,1,63,5292,63,56,28674,56,5292,0,0,0,0,0
64.845,6,21,2739,11,302,6484,302,1776,10,83,7147,83,963
1742.052,1,15,840,15,28,124432,28,840,0,0,0,0,0
1.553,6,29,10365,17,367,97,833,1785,12,1012,133,1420,8580
8.721,6,39,12234,19,957,484,1360,6539,20,348,449,2667,5695
15.159,17,21,15238,11,918,1512,1350,10416,10,454,1680,1350,4822
1.207,17,26,6602,11,269,117,1350,3276,15,193,83,1350,3326
51.684,6,6321,6045409,3965,1440,12,1448,5908433,2356,776,21,1448,136976
1800.0,6,2968,544119,1546,216,1165,1460,368411,1422,525,1266,1460,175708
379.523,6,40,7069,16,406,3202,813,4082,24,108,16497,240,2987
60.273,6,12,664,7,0,10045,0,380,5,0,15064,0,284
3.843,17,29,16886,12,364,346,1350,4710,17,688,238,1350,12176
300.442,6,49,33592,31,1240,10014,1440,27680,18,828,1464,1440,5912
1787.415,6,104,8376,68,65,26677,65,4930,36,59,51066,59,3446
2.198,17,4,314,2,31,2166,31,118,2,70,2152,70,196
28.865,6,280,121786,146,786,199,1152,111262,134,430,214,1179,10524
1787.373,6,102,8296,68,65,26677,65,4930,34,59,54158,59,3366
0.177,6,9,1002,5,213,44,213,417,4,421,49,421,585
960.993,17,684,48157,609,40,1580,41,41813,75,56,534,57,6344
39.765,17,11,836,11,48,3976,48,836,0,0,0,0,0
80.991,6,20,820,9,0,6101,0,364,11,0,8097,0,456
1775.397,6,180,15480,120,69,14919,69,8940,60,69,30083,69,6540
5.058,17,4,288,2,36,5004,36,128,2,52,5023,52,160
1617.175,1,7,392,7,28,269529,28,392,0,0,0,0,0
1770.574,6,101,9410,66,66,27239,66,5610,35,60,52073,60,3800
1797.892,17,142,11360,71,48,25684,48,5396,71,56,25684,56,5964
0.069,6,2,100,1,0,0,0,60,1,0,0,0,40
0.096,6,9,1346,5,145,24,145,349,4,833,25,833,997
0.382,17,4,624,2,64,381,64,184,2,192,266,192,440
0.302,6,27,6118,13,164,25,453,1494,14,486,22,1402,4624
0.059,17,4,288,2,33,4,33,122,2,55,0,61,166
11.19,6,26,11213,13,275,932,275,1078,13,1200,910,2760,10135
280.192,17,4,1082,2,30,280188,30,116,2,455,280187,463,966
1799.551,17,142,11360,71,48,25707,48,5396,71,56,25707,56,5964
1.321,6,11,1727,7,100,220,100,384,4,589,360,1152,1343
381.27,17,10,880,5,48,95314,48,380,5,72,95315,72,500
34.244,17,40,5880,20,48,1801,48,1520,20,190,1801,308,4360
2.862,6,15,4344,5,288,669,288,520,10,682,297,853,3824
0.047,6,4,208,2,0,9,0,104,2,0,10,0,104
1778.009,1,56,3136,56,28,32327,28,3136,0,0,0,0,0
1203.268,2,12,384,12,8,109388,8,384,0,0,0,0,0
0.018,6,14,4020,7,88,2,88,388,7,1113,3,1460,3632
1.303,6,37,8214,19,321,72,1164,2718,18,476,66,2715,5496
0.547,6,24,7489,14,274,42,668,2109,10,1210,56,1946,5380
0.334,6,24,4571,12,165,30,456,1446,12,415,29,888,3125
0.129,17,2,237,1,72,0,72,100,1,109,0,109,137
13.53,6,3,156,3,0,0,0,156,0,0,0,0,0
1684.505,2,14,448,14,8,129577,8,448,0,0,0,0,0
148.4,6,27,8011,11,261,90,467,1365,16,446,9882,1408,6646
0.412,6,13,1693,7,288,67,288,588,6,426,43,434,1105
0.011,17,4,632,3,60,1,60,264,1,340,0,340,368
1.567,6,25,8775,15,287,111,593,1465,10,986,154,1420,7310
6.636,6,568,508328,366,1322,17,1368,492488,202,776,31,1473,15840
1786.147,6,106,8524,68,66,26658,66,4964,38,60,48271,60,3560
1719.445,17,12,498,11,14,171944,14,462,1,8,0,8,36
114.17,17,4,240,2,32,114169,32,120,2,32,114169,32,120
5.712,6,128,100504,57,961,102,1460,13121,71,1408,79,1607,87383
1786.835,6,106,8644,70,66,25896,66,5044,36,60,51049,60,3600
50.186,17,4,240,2,32,50185,32,120,2,32,50185,32,120
3.045,17,6,510,3,47,1519,47,225,3,67,1518,75,285
250.154,17,4,514,2,36,250144,36,128,2,165,250145,187,386
0.006,17,2,167,1,39,0,39,67,1,72,0,72,100
139.731,6,77,51699,47,1204,3037,1448,43408,30,747,2123,1448,8291
0.111,17,2,217,1,50,0,50,78,1,111,0,111,139
280.569,6,30,7432,13,158,23380,267,1317,17,603,17527,2076,6115
1744.887,6,95,7203,63,38,28143,205,4476,32,33,56278,98,2727
1793.257,6,371,23465,213,69,8458,69,13005,158,69,11421,69,10460
0.053,6,6,328,4,0,17,0,216,2,0,37,0,112
1799.934,17,450,39960,405,35,4455,288,25740,45,288,40024,288,14220
0.767,17,2,136,1,32,0,32,60,1,48,0,48,76
12.535,6,23,3689,15,211,891,211,1282,8,665,1790,904,2407
0.009,17,2,318,1,39,0,39,67,1,223,0,223,251
1799.512,17,449,39928,404,35,4465,288,25708,45,288,40020,288,14220
1797.821,6,271,32718,112,131,16195,1360,15651,159,135,11377,4080,17067
4.585,6,38,7245,19,218,254,314,3383,19,516,239,1179,3862
0.381,1,2,112,2,28,381,28,112,0,0,0,0,0
0.759,17,17,5697,7,316,126,1350,2413,10,300,63,1350,3284
1.753,6,72,49733,42,1252,42,1402,42268,30,842,54,1402,7465
5.588,6,39,7269,20,218,294,314,3423,19,513,296,1179,3846
1783.809,6,364,24385,212,88,8454,469,14027,152,69,11813,69,10358
10.02,17,4,304,2,40,10009,40,136,2,56,10008,56,168
1.001,17,4,240,2,32,1000,32,120,2,32,1000,32,120
0.035,17,2,157,1,31,0,31,59,1,70,0,70,98
1.339,6,8,820,4,302,445,302,510,4,102,445,102,310
101.931,6,11,719,11,31,10193,31,719,0,0,0,0,0
1.355,17,29,10499,12,363,120,1350,4703,17,312,82,1350,5796
122.638,6,22,9032,11,376,105,827,1602,11,996,12250,2521,7430
48.712,6,62,33308,33,671,1522,1368,6409,29,1153,1738,2736,26899
0.845,6,19,5908,10,281,93,544,1248,9,716,94,1420,4660
37.598,17,22,1672,22,48,1790,48,1672,0,0,0,0,0
2.242,6,14,1435,7,283,343,283,938,7,105,343,105,497
93.739,6,37,7392,17,207,5856,517,1771,20,416,4931,1418,5621
1.338,6,37,15420,19,511,74,1460,3383,18,869,68,1460,12037
4.684,6,36,6249,19,206,260,314,2824,17,456,277,1152,3425
1.412,6,27,6120,15,141,100,267,1735,12,650,121,1420,4385
368.403,6,18,1242,14,180,28338,180,916,4,110,20064,110,326
373.827,6,25,1651,17,177,23364,177,1117,8,110,9260,110,534
1796.291,17,87,3648,86,14,21132,14,3612,1,8,0,8,36
1.258,17,21,6172,9,330,156,1350,3228,12,217,111,1350,2944
4.825,6,38,7229,19,218,268,314,3383,19,513,254,1179,3846
1088.665,17,12,969,6,31,217730,37,355,6,74,217730,136,614
3.058,6,2,88,2,0,0,0,88,0,0,0,0,0
1772.901,6,180,15480,120,69,14898,69,8940,60,69,30045,69,6540
0.105,17,4,284,2,32,0,32,120,2,54,0,60,164
1763.565,2,15,480,15,8,125968,8,480,0,0,0,0,0
1.308,6,49,20562,27,985,50,1460,14906,22,433,53,1460,5656
0.518,6,9,1346,5,145,129,145,349,4,833,146,833,997
1795.848,17,448,39384,403,35,4467,288,25412,45,282,40018,288,13972
47.571,6,5399,5172981,3607,1357,13,1408,5075121,1792,776,26,1408,97860
1203.199,2,14,448,14,8,92553,8,448,0,0,0,0,0
21.665,6,39,8554,16,340,52,707,1694,23,348,977,3488,6860
32.864,17,20,1760,10,48,3649,48,760,10,72,3643,72,1000
972.988,17,190,14440,190,48,5148,48,14440,0,0,0,0,0
1795.944,17,118,9440,59,48,30964,48,4484,59,56,30964,56,4956
1742.197,1,56,4704,0,0,0,0,0,56,56,31676,56,4704
280.761,6,30,7432,13,158,23396,267,1317,17,543,17529,1400,6115
0.394,6,6,324,4,0,131,0,216,2,0,206,0,108
1786.821,6,179,37476,104,477,17347,1258,29014,75,105,24144,192,8462
0.202,6,3,144,2,0,31,0,104,1,0,0,0,40
0.373,6,12,1653,6,288,69,288,548,6,426,39,434,1105
116.662,6,32,24714,19,884,29,1360,6097,13,2260,9712,9520,18617
3.995,17,8,616,4,33,1331,33,244,4,65,1331,65,372
15.159,17,22,15058,11,893,1512,1350,10132,11,419,1512,1350,4926
132.617,17,4,240,2,32,132616,32,120,2,32,132615,32,120
1103.478,6,121,21318,79,304,14147,304,15972,42,83,26910,83,5346
38.159,17,42,10878,42,231,930,388,10878,0,0,0,0,0
822.603,1,10,560,10,28,91400,28,560,0,0,0,0,0
300.694,6,38,8439,20,283,15826,786,1965,18,441,502,1360,6474
1770.602,17,313,52590,313,140,5675,376,52590,0,0,0,0,0
1780.989,17,128,10240,64,48,28269,48,4864,64,56,28269,56,5376
1748.923,6,94,7151,62,38,28670,205,4424,32,33,56407,98,2727
1741.767,1,83,6972,0,0,0,0,0,83,56,21241,56,6972
98.408,6,33,16884,15,447,59,1020,1987,18,1011,5780,1360,14897
0.586,6,26,6121,13,108,48,147,959,13,773,46,1608,5162
45.717,6,464,214315,243,821,188,1152,200311,221,430,206,1179,14004
0.074,6,9,1339,5,145,18,145,349,4,826,21,826,990
0.359,17,2,198,1,39,0,39,67,1,103,0,103,131
147.686,1,2,112,2,28,147686,28,112,0,0,0,0,0
1790.517,6,356,22520,208,69,8649,69,12460,148,69,12177,69,10060
122.968,6,24,8675,13,633,76,1460,3085,11,856,12278,1547,5590
1787.603,6,102,8228,68,64,26680,64,4896,34,58,54167,58,3332
1786.3,6,122,9698,76,65,23817,65,5380,46,59,39691,59,4318
5.053,17,4,288,2,36,5005,36,128,2,52,4995,52,160
0.445,6,9,1346,4,145,148,145,309,5,833,107,833,1037
240.178,6,54,17866,29,791,8577,1402,14968,25,198,10007,580,2898
1.385,6,34,11170,18,559,81,1360,4122,16,639,80,1360,7048
4.509,17,2,668,2,306,4509,306,668,0,0,0,0,0
81.371,6,749,351939,396,821,206,1152,333028,353,398,230,1152,18911
1783.813,6,356,22520,208,69,8617,69,12460,148,69,12134,69,10060
12.469,6,31398,28050628,14658,149,0,279,777830,16740,1577,0,16896,27272798
7.009,17,14,1198,7,47,1167,47,525,7,68,1167,75,673
0.195,6,9,1146,5,357,48,357,561,4,421,46,421,585
31.38,6,5,216,4,0,10460,0,168,1,0,0,0,48
62.87,2,4,128,4,8,20956,8,128,0,0,0,0,0
1783.418,17,83,3480,82,14,22017,14,3444,1,8,0,8,36
131.889,6,25,9002,12,467,93,1064,1927,13,817,10976,1455,7075
10.7,6,35,15422,18,282,629,721,2417,17,1232,560,1440,13005
73.256,17,5,380,5,48,18314,48,380,0,0,0,0,0
1145.102,6,101,6338,53,46,22017,208,3736,48,31,24360,31,2602
24.063,6,1262,1125878,740,1440,32,1448,1092590,522,776,45,1448,33288
1785.542,6,120,9576,76,66,23807,66,5416,44,60,41522,60,4160
121.713,6,33,23804,19,840,37,1360,5835,14,1933,9351,6771,17969
1797.568,1,150,8400,150,28,12064,28,8400,0,0,0,0,0
458.326,6,122,15391,53,150,8813,1189,5136,69,174,6739,1420,10255
1750.644,17,12,498,11,14,175064,14,462,1,8,0,8,36
280.067,6,27,7312,13,158,23338,267,1317,14,775,21538,2800,5995
2.168,17,2,677,1,300,0,300,328,1,321,0,321,349
0.917,6,10,1687,7,100,152,100,384,3,1179,325,1179,1303
1.2,6,25,8056,12,164,93,267,1288,13,869,85,1448,6768
15.797,6,29,5003,15,154,1128,722,1871,14,400,1200,1440,3132
1789.886,6,363,24345,211,88,8523,469,13987,152,69,11852,69,10358
380.552,17,25,8400,25,308,15856,308,8400,0,0,0,0,0
8.089,6,1705,1536499,1053,1379,7,1408,1497931,652,931,12,2816,38568
1077.603,2,11,352,11,8,107760,8,352,0,0,0,0,0
5.122,17,4,288,2,36,5008,36,128,2,52,4991,52,160
0.378,17,2,178,1,29,0,29,57,1,93,0,93,121
1684.502,2,20,640,20,8,88658,8,640,0,0,0,0,0
47.12,6,57,16431,26,585,1884,1440,8121,31,370,1554,1440,8310
829.019,6,233,22236,117,108,7146,1189,9772,116,181,7208,1460,12464
1113.48,2,11,352,11,8,111348,8,352,0,0,0,0,0
3.816,17,4,352,2,48,3803,48,152,2,72,3804,72,200
6.806,17,347,69080,342,172,19,172,68400,5,108,1295,172,680
1796.836,17,83,3480,82,14,22183,14,3444,1,8,0,8,36
280.241,6,28,7352,13,158,23353,267,1317,15,678,20012,3436,6035
374.683,6,18,1242,14,180,28821,180,916,4,110,20065,110,326
1786.497,6,104,8308,68,64,26664,64,4896,36,58,51040,58,3412
1787.238,6,104,8376,68,65,26675,65,4930,36,59,51059,59,3446
1741.268,6,87,6322,58,31,30548,31,3915,29,31,62187,31,2407
10.933,6,22,3863,10,194,1214,293,1378,12,285,965,1179,2485
0.385,6,24,6071,12,181,35,537,1526,12,782,33,2231,4545
4.967,17,28,13189,12,557,451,1350,7027,16,357,222,1350,6162
1.525,6,10,1687,7,100,254,100,384,3,1179,638,1179,1303
9.005,6,16,1402,8,275,1286,275,878,8,96,1117,96,524
240.225,6,54,17530,29,739,8579,1418,14818,25,175,10008,580,2712
321.001,6,288,80867,134,661,777,1460,57912,154,210,2097,1460,22955
5.806,6,29,8403,13,155,483,267,1306,16,537,386,3417,7097
1743.77,6,102,7970,66,45,26827,205,4902,36,35,49813,98,3068
12.372,17,2,768,2,356,12372,356,768,0,0,0,0,0
28.595,6,46,13108,22,188,1361,721,2768,24,781,1197,1440,10340
1771.567,1,58,4872,58,56,31080,56,4872,0,0,0,0,0
268.218,6,49,4058,21,97,13410,457,2295,28,53,9928,145,1763
1791.356,17,87,3648,86,14,21074,14,3612,1,8,0,8,36
0.029,17,2,148,1,30,0,30,58,1,62,0,62,90
281.785,6,29,7392,13,158,23482,267,1317,16,603,18759,2036,6075
480.746,6,1617,1575006,948,339,507,420,55474,669,2239,629,12672,1519532
4.211,17,5,290,5,30,1052,30,290,0,0,0,0,0
5.189,6,38,7229,19,218,288,314,3383,19,513,273,1179,3846
0.677,6,48,20986,27,1054,26,1380,15880,21,425,31,1923,5106
21.359,6,22,5478,13,107,1779,159,1134,9,773,2543,1418,4344
1.228,6,26,8108,12,164,95,267,1288,14,869,80,1440,6820
1740.481,17,29,6699,29,203,62160,203,6699,0,0,0,0,0
9.985,6,85,26869,44,557,232,1152,20731,41,449,242,1179,6138
283.97,17,4,352,2,60,283969,60,176,2,60,283969,60,176
2.742,17,4,624,4,128,914,128,624,0,0,0,0,0
280.226,6,30,7432,14,158,21555,267,1357,16,603,18679,2800,6075
300.551,6,41,23479,24,991,13067,1440,16143,17,804,3211,1440,7336
15.508,6,8,452,3,0,7754,0,152,5,0,3686,0,300
9.276,6,1648,1494423,1024,1380,8,1408,1457311,624,931,14,2801,37112
1.466,6,50,19129,27,880,56,1360,13433,23,433,55,1360,5696
0.369,6,22,7330,13,318,30,600,1970,9,976,45,1891,5360
669.008,6,44,3377,27,64,25731,64,1912,17,56,41805,58,1465
300.78,2,3,96,3,8,150390,8,96,0,0,0,0,0
560.723,17,6,444,3,30,280341,30,174,3,62,280345,62,270
1793.304,6,355,22480,207,69,8705,69,12420,148,69,12198,69,10060
0.15,17,2,2754,2,1349,150,1349,2754,0,0,0,0,0
1.547,6,50,18933,28,928,57,1460,13232,22,400,64,1460,5701
31.445,6,3,144,1,0,0,0,48,2,0,16128,0,96
1.227,6,25,8056,12,164,95,267,1288,13,869,87,1402,6768
1740.554,6,87,6322,58,31,30536,31,3915,29,31,62160,31,2407
0.088,1,2,112,2,28,88,28,112,0,0,0,0,0
1.556,6,9,527,5,43,389,43,311,4,0,517,0,216
1771.66,6,99,9240,66,65,27256,65,5577,33,59,55361,59,3663
3.991,17,8,1248,4,64,1325,64,368,4,192,1208,192,880
0.022,6,14,4044,8,88,3,88,452,6,1670,4,1880,3592
1730.019,1,128,13568,128,78,13622,78,13568,0,0,0,0,0
280.259,6,30,7432,13,158,23354,267,1317,17,543,17513,1400,6115
1798.532,6,381,28969,222,126,8138,469,17710,159,69,11379,69,11259
234.438,6,22,1545,16,43,15629,43,1185,6,0,46224,0,360
240.482,6,35,6441,18,168,14145,517,1956,17,598,15029,1418,4485
1796.742,17,449,39928,404,35,4458,288,25708,45,288,40021,288,14220
3.591,6,12,3032,5,92,897,92,348,7,579,487,1448,2684
1786.678,6,102,8296,68,65,26666,65,4930,34,59,54139,59,3366
14.708,17,6,528,3,48,7349,48,228,3,72,7349,72,300
1745.971,6,95,7203,63,38,28160,205,4476,32,33,56310,98,2727
9.368,6,16,5255,9,275,1171,275,643,7,1440,726,1440,4612
125.081,6,34,7935,12,155,29,267,1266,22,340,5955,3417,6669
1557.443,2,13,416,13,8,129786,8,416,0,0,0,0,0
88.351,17,2,768,2,356,88351,356,768,0,0,0,0,0
12.397,6,1976,1713735,1194,1380,10,1420,1678234,782,467,15,1883,35501
1773.606,6,180,15480,120,69,14904,69,8940,60,69,30056,69,6540
0.252,6,16,6734,8,120,36,120,544,8,1153,36,1448,6190
2.398,6,13,2311,8,188,342,245,700,5,1407,536,1407,1611
1676.162,1,8,448,8,28,239451,28,448,0,0,0,0,0
88.222,6,37,8401,18,371,517,797,1889,19,478,4892,2128,6512
1768.906,1,59,4956,59,56,30498,56,4956,0,0,0,0,0
15.46,17,27,12558,14,661,1186,1350,9649,13,195,1285,1350,2909
1763.318,2,14,448,14,8,135639,8,448,0,0,0,0,0
39.079,17,21,1836,11,48,3905,48,836,10,72,4338,72,1000
0.029,6,11,1566,6,503,5,503,823,5,475,7,475,743
1614.931,1,7,392,7,28,269155,28,392,0,0,0,0,0
1755.207,6,3842,4474831,1409,149,1246,893,88652,2433,1804,721,8412,4386179
0.51,17,3,451,2,39,33,39,134,1,289,0,289,317
8.028,6,27,5559,13,213,669,293,2020,14,425,598,1179,3539
1761.135,1,122,12932,122,78,14554,78,12932,0,0,0,0,0
1799.919,17,140,11200,70,48,26085,48,5320,70,56,26085,56,5880
373.448,6,18,1242,14,180,28726,180,916,4,110,20073,110,326
1786.863,17,140,11200,70,48,25896,48,5320,70,56,25896,56,5880
0.206,17,2,2730,2,1337,206,1337,2730,0,0,0,0,0
12.174,6,9,376,5,0,3042,0,204,4,0,4052,0,172
319.621,6,10,660,5,106,79905,106,420,5,0,3845,0,240
1797.806,1,154,16324,154,78,11750,78,16324,0,0,0,0,0
0.91,6,10,1687,7,100,151,100,384,3,1179,330,1179,1303
1782.096,6,354,22440,207,69,8650,69,12420,147,69,12206,69,10020
1778.6,17,58,19408,58,306,31203,308,19408,0,0,0,0,0
516.411,17,76,5776,76,48,6885,48,5776,0,0,0,0,0
0.066,17,2,245,1,32,0,32,60,1,157,0,157,185
1701.546,1,60,6360,60,78,28839,78,6360,0,0,0,0,0
1771.769,6,99,9240,66,65,27257,65,5577,33,59,55364,59,3663
1681.456,17,14,3771,7,30,280241,30,406,7,452,280240,463,3365
60.081,2,2,64,2,8,60081,8,64,0,0,0,0,0
1751.944,1,47,3948,0,0,0,0,0,47,56,38085,56,3948
1796.097,17,449,39928,404,35,4456,288,25708,45,288,40022,288,14220
8.084,6,1701,1568703,1073,1384,7,1408,1531383,628,931,12,2816,37320
280.209,6,30,7432,13,158,23350,267,1317,17,543,17511,1400,6115
1786.736,6,104,8444,68,66,26667,66,4964,36,60,51046,60,3480
0.007,17,2,180,1,30,0,30,58,1,94,0,94,122
52.797,6,38,8563,16,367,37,787,1774,22,368,2507,3488,6789
0.648,6,132,95788,79,1306,8,1420,89447,53,467,12,1883,6341
189.528,6,26,4999,11,220,6307,516,1325,15,255,13531,1452,3674
226.705,17,46,7116,23,48,10304,48,1748,23,205,10304,308,5368
0.71,6,20,7229,13,334,59,663,2021,7,1209,113,1946,5208
280.534,6,28,7352,12,158,25503,267,1277,16,678,18696,2085,6075
1775.194,1,8,448,8,28,253599,28,448,0,0,0,0,0
1794.093,17,180,11520,180,36,10022,36,11520,0,0,0,0,0
0.002,6,2,100,1,0,0,0,60,1,0,0,0,40
1787.462,6,102,8364,68,66,26678,66,4964,34,60,54161,60,3400
1789.617,17,142,11360,71,48,25565,48,5396,71,56,25565,56,5964
215.584,6,76,12016,29,224,6334,1189,3411,47,216,4686,512,8605
1793.541,17,169,10816,169,36,10675,36,10816,0,0,0,0,0
0.03,17,4,368,2,32,0,32,120,2,96,1,96,248
1799.908,17,448,39896,403,35,4477,288,25676,45,288,40019,288,14220
0.037,17,2,166,1,39,0,39,67,1,71,0,71,99
1798.568,17,448,39896,403,35,4474,288,25676,45,288,40020,288,14220
1.208,6,24,6636,13,350,100,1089,2276,11,783,120,1420,4360
0.616,17,8,2758,8,316,88,355,2758,0,0,0,0,0
1772.397,6,180,15480,120,69,14894,69,8940,60,69,30033,69,6540
1799.347,17,449,39644,405,35,4453,288,25740,44,288,40948,288,13904
0.88,17,2,685,1,308,0,308,336,1,321,0,321,349
0.516,6,18,4942,11,193,50,358,1218,7,860,84,1420,3724
0.51,17,3,451,2,39,239,39,134,1,289,0,289,317
773.337,1,30,1680,30,28,26666,28,1680,0,0,0,0,0
1383.635,2,11,352,11,8,138363,8,352,0,0,0,0,0
1785.607,6,363,23076,210,69,8543,69,12609,153,69,11747,69,10467
14.307,6,1358,1193419,814,1385,17,1448,1160467,544,776,26,1448,32952
300.482,6,361,528819,215,162,1404,230,12142,146,3610,2072,12618,516677
1.884,17,21,12690,12,818,168,1350,10157,9,253,231,1350,2533
90.199,6,23,10009,12,531,51,1360,2637,11,1384,9007,3934,7372
1082.931,2,11,352,11,8,108293,8,352,0,0,0,0,0
0.979,17,2,312,2,128,979,128,312,0,0,0,0,0
0.402,6,26,8863,13,231,33,563,1608,13,938,30,1438,7255
4.763,17,4,352,2,60,4762,60,176,2,60,4762,60,176
1770.424,6,99,9306,66,66,27237,66,5610,33,60,55322,60,3696
108.513,6,99,66973,58,1221,1903,1368,58009,41,841,1609,2736,8964
0.003,17,2,237,1,72,0,72,100,1,109,0,109,137
0.491,6,21,7304,13,337,40,674,2032,8,1212,62,2736,5272
0.865,6,10,1687,7,100,144,100,384,3,1179,295,1179,1303
0.0,17,1,1072,1,1044,0,1044,1072,0,0,0,0,0
0.048,17,4,352,2,37,39,37,130,2,83,41,89,222
0.081,6,59,48201,22,187,3,273,1737,37,1349,1,1408,46464
1799.941,1,16,896,16,28,119996,28,896,0,0,0,0,0
2.645,17,4,1568,4,364,881,364,1568,0,0,0,0,0
77.233,6,35,8439,17,410,557,882,1966,18,478,4534,2128,6473
8.761,6,68,21139,35,575,257,1152,16376,33,429,265,1152,4763
1789.689,17,87,3648,86,14,21055,14,3612,1,8,0,8,36
1795.058,1,168,9408,168,28,10748,28,9408,0,0,0,0,0
1799.596,17,449,39928,404,35,4465,288,25708,45,288,40018,288,14220
1783.392,17,79,3312,78,14,23160,14,3276,1,8,0,8,36
15.122,17,11,4249,5,411,3773,1350,2196,6,314,3018,1350,2053
90.909,6,44,7485,18,218,313,314,3343,26,516,3625,1179,4142
1792.622,1,262,27772,262,78,6868,78,27772,0,0,0,0,0
372.09,6,18,1242,14,180,28622,180,916,4,110,20063,110,326
1790.053,17,1059,320940,488,560,3675,1350,286963,571,31,3140,340,33977
300.576,6,36,8369,20,286,15819,797,1976,16,521,561,2720,6393
1.012,17,5,824,3,32,503,32,180,2,294,5,294,644
6.638,6,20,9285,9,275,829,275,639,11,911,561,1414,8646
13.404,17,3,1152,3,356,6702,356,1152,0,0,0,0,0
0.049,17,4,368,2,32,10,32,120,2,96,0,96,248
0.287,17,2,214,1,39,0,39,67,1,119,0,119,147
60.136,6,14,852,6,41,11991,46,363,8,42,8590,46,489
3.632,17,5,295,5,31,908,31,295,0,0,0,0,0
0.016,17,2,451,1,41,0,41,69,1,354,0,354,382
1781.943,1,66,5544,66,56,27414,56,5544,0,0,0,0,0
0.31,6,22,7333,13,334,25,663,2021,9,967,37,1912,5312
1781.734,17,139,11116,70,48,25822,48,5320,69,56,26201,56,5796
0.009,17,2,356,1,32,0,32,60,1,268,0,268,296
300.803,6,39,9935,21,590,15040,1360,4413,18,399,503,1360,5522
1.206,6,40,9928,21,440,60,1360,4392,19,476,57,2715,5536
7.183,6,1373,1235901,847,1380,8,1408,1203885,526,931,13,2801,32016
2.103,17,2,784,2,364,2103,364,784,0,0,0,0,0
66.92,6,10,648,10,31,7435,31,648,0,0,0,0,0
0.153,17,2,166,1,39,0,39,67,1,71,0,71,99
1.071,17,20,6947,8,304,153,1350,2660,12,329,70,1350,4287
1742.756,6,95,7203,63,38,28108,205,4476,32,33,56205,98,2727
58.265,17,10,880,5,48,14564,48,380,5,72,14564,72,500
2.792,17,4,288,2,36,2504,36,128,2,52,2544,52,160
1772.649,6,180,15480,120,69,14896,69,8940,60,69,30040,69,6540
280.479,6,28,7352,13,158,23373,267,1317,15,775,20027,3465,6035
1771.443,6,99,9306,66,66,27252,66,5610,33,60,55354,60,3696
1771.67,6,279,34132,113,138,15817,1360,16604,166,131,10736,1360,17528
4.348,6,40,7309,19,218,241,314,3383,21,440,204,1152,3926
1114.199,1,46,2576,46,28,24759,28,2576,0,0,0,0,0
5.055,6,40,7325,22,218,240,314,3503,18,516,282,1179,3822
18.263,6,15,2245,9,324,2282,585,1125,6,396,3650,580,1120
1782.211,17,83,3480,82,14,22002,14,3444,1,8,0,8,36
1774.439,1,67,5628,67,56,26885,56,5628,0,0,0,0,0
1797.317,17,324,41308,159,170,11375,1350,31486,165,31,10958,61,9822
0.155,6,10,582,5,42,38,42,310,5,0,36,0,272
632.468,17,16,1408,8,48,90351,48,608,8,72,90351,72,800
1786.41,6,104,8444,68,66,26662,66,4964,36,60,51029,60,3480
53.331,6,7,832,4,245,17777,245,409,3,299,26513,299,423
1783.262,6,356,22520,208,69,8614,69,12460,148,69,12130,69,10060
1740.403,17,27,18171,27,645,66938,645,18171,0,0,0,0,0
0.22,17,2,334,1,32,0,32,60,1,246,0,246,274
122.48,6,32,7545,11,474,12248,841,2002,21,246,6121,1418,5543
1787.651,6,102,8296,68,65,26681,65,4930,34,59,54167,59,3366
6.067,6,1674,1529464,1043,1387,5,1408,1491988,631,931,9,2801,37476
0.055,17,4,398,2,46,1,46,148,2,97,1,103,250
0.01,6,3,168,1,0,0,0,52,2,0,7,0,116
280.267,6,30,7432,13,158,23355,267,1317,17,543,17510,1400,6115
1796.573,6,359,22709,209,69,8637,69,12569,150,69,12057,69,10140
50.642,6,11,628,4,0,16880,0,216,7,0,8438,0,412
0.174,17,2,152,1,48,0,48,76,1,48,0,48,76
280.2,6,28,7352,13,158,23350,267,1317,15,678,20011,2045,6035
1.359,6,37,8214,19,321,75,1164,2718,18,476,69,2615,5496
372.149,6,18,1242,14,180,28626,180,916,4,110,20071,110,326
53.69,6,9,468,9,0,0,0,468,0,0,0,0,0
0.671,17,4,288,2,36,642,36,128,2,52,641,52,160
280.29,6,28,7352,13,158,23357,267,1317,15,678,20015,2600,6035
0.659,6,108,80499,54,273,12,517,4185,54,1413,12,2896,76314
1.997,17,2,672,2,308,1997,308,672,0,0,0,0,0
5.578,6,55,19940,26,912,223,1440,13848,29,405,190,1440,6092
1750.561,17,12,498,11,14,175056,14,462,1,8,0,8,36
280.414,6,30,7501,13,158,23367,267,1317,17,550,17524,1400,6184
1773.286,6,189,16116,124,69,14416,69,9169,65,69,27700,69,6947
0.469,6,12,1653,6,288,92,288,548,6,426,55,434,1105
0.337,6,24,4571,12,165,30,456,1446,12,415,28,888,3125
1594.389,1,8,448,8,28,227769,28,448,0,0,0,0,0
4.654,6,39,7269,19,218,258,314,3383,20,513,230,1179,3886
0.188,17,2,198,1,63,0,63,91,1,79,0,79,107
33.601,6,20,4273,11,291,3360,722,1453,9,469,1959,1408,2820
48.12,17,4,406,2,43,48107,43,142,2,104,48106,104,264
19.591,17,39,17939,18,359,1150,1350,6973,21,494,977,1350,10966
1.412,6,41,11378,21,616,70,1460,5802,20,476,63,2615,5576
7.655,6,47,8505,24,227,332,314,4142,23,429,335,1152,4363
698.085,1,18,1008,18,28,41063,28,1008,0,0,0,0,0
1772.835,6,180,15480,120,69,14897,69,8940,60,69,30040,69,6540
372.543,6,23,1535,16,177,24836,177,1053,7,110,10392,110,482
15.702,17,13,6542,7,612,2607,1350,4485,6,314,3127,1350,2057
1799.997,6,2831,547136,1438,200,1231,1460,312276,1393,593,1293,1552,234860
21.979,17,45,10732,21,268,1096,1350,6224,24,159,953,1350,4508
6.071,6,30,6215,16,338,404,1314,2334,14,368,465,1420,3881
584.749,17,28,4303,14,40,44980,43,958,14,210,44979,249,3345
300.864,6,30,8833,16,348,20057,970,2605,14,782,2846,2939,6228
783.478,6,109,20906,65,483,12241,483,15962,44,83,18220,83,4944
27.875,17,8,608,8,48,3982,48,608,0,0,0,0,0
1744.283,6,94,7151,62,38,28594,205,4424,32,33,56256,98,2727
0.007,17,2,415,1,34,0,34,62,1,325,0,325,353
242.808,6,47,9250,21,191,12138,751,2635,26,476,9711,1368,6615
1793.099,17,66,2766,65,14,28017,14,2730,1,8,0,8,36
1776.569,17,138,11040,69,48,26125,48,5244,69,56,26125,56,5796
0.046,17,2,169,1,34,0,34,62,1,79,0,79,107
0.1,6,10,2115,6,597,19,1034,1438,4,513,32,513,677
176.254,17,4,240,2,32,176252,32,120,2,32,176253,32,120
240.672,2,3,96,3,8,120336,8,96,0,0,0,0,0
0.496,17,2,152,1,48,0,48,76,1,48,0,48,76
0.38,6,10,968,5,256,93,256,460,5,304,93,304,508
1.337,6,23,7952,11,164,113,267,1236,12,1216,103,3859,6716
1.115,6,24,8765,14,290,85,802,1753,10,1100,102,2920,7012
0.026,17,3,422,2,32,0,32,120,1,274,0,274,302
165.049,6,19,780,7,0,4037,0,284,12,0,15003,0,496
0.23,6,49,23637,28,1089,8,1420,18576,21,467,11,1883,5061
882.003,2,5,160,5,8,220500,8,160,0,0,0,0,0
1789.791,6,418,25048,209,69,8604,69,12500,209,34,8604,48,12548
11.277,6,21,6947,13,106,939,267,1205,8,2653,1581,5255,5742
0.74,6,24,7849,11,108,74,147,879,13,805,57,1608,6970
59.367,17,10,10842,10,1056,6596,1451,10842,0,0,0,0,0
0.456,6,180,180002,128,183,3,230,7621,52,3393,6,15488,172381
1792.211,6,377,26326,217,98,8297,469,15372,160,69,11271,69,10954
1742.658,6,145,9134,79,48,22341,208,5595,66,31,26806,31,3539
0.496,17,3,451,2,39,479,39,134,1,289,0,289,317
269.135,6,23,2177,13,105,22427,205,1403,10,31,29882,33,774
0.117,17,2,212,1,46,0,46,74,1,110,0,110,138
0.305,17,2,152,1,48,0,48,76,1,48,0,48,76
103.57,6,36,25541,20,884,41,1360,6149,16,2082,6895,8160,19392
0.224,17,2,2730,2,1337,224,1337,2730,0,0,0,0,0
57.116,17,4,352,2,60,57115,60,176,2,60,57114,60,176
89.855,6,18,4079,7,407,14975,722,1174,11,1164,8966,1408,2905
638.166,6,104,16362,45,161,14503,469,6173,59,144,11002,2840,10189
1.582,6,40,8439,21,321,79,1164,2858,19,480,76,4075,5581
280.327,6,29,7392,13,158,23360,267,1317,16,603,18683,1400,6075
1797.473,17,448,39896,403,35,4471,288,25676,45,288,40015,288,14220
1772.313,6,180,15480,120,69,14893,69,8940,60,69,30035,69,6540
1795.166,17,18,1413,9,30,224386,37,529,9,70,224386,136,884
2.248,6,14,3203,7,145,374,145,429,7,830,340,830,2774
1773.514,6,206,22479,131,75,13642,267,10097,75,132,23965,1452,12382
1798.391,1,259,14504,259,28,6970,28,14504,0,0,0,0,0
0.296,6,9,1002,5,213,74,213,417,4,421,95,421,585
11.075,6,26,9953,13,275,922,275,1078,13,1042,705,1440,8875
3.012,17,4,768,2,36,3004,36,128,2,292,3004,292,640
1787.623,6,365,23087,211,69,8512,69,12787,154,69,11683,69,10300
5.225,17,4,352,2,60,5224,60,176,2,60,5224,60,176
1777.909,17,225,52016,225,203,7937,422,52016,0,0,0,0,0
98.098,6,46,12828,21,180,4904,722,2291,25,595,4054,1380,10537
1795.604,17,449,39928,404,35,4455,288,25708,45,288,40020,288,14220
36.723,6,24,8388,13,231,3060,391,1245,11,955,3652,1460,7143
6.848,6,17,2425,9,211,855,211,922,8,545,974,904,1503
113.539,6,44,8718,22,371,813,766,2085,22,521,5399,3488,6633
14.694,17,6,456,6,48,2938,48,456,0,0,0,0,0
0.275,6,9,1340,5,145,68,145,349,4,827,38,827,991
1795.036,1,224,23744,224,78,8049,78,23744,0,0,0,0,0
1795.718,6,363,23007,211,69,8551,69,12649,152,69,11892,69,10358
1299.351,6,90,11506,56,88,23624,501,4540,34,193,39371,1420,6966
0.835,6,8,521,4,31,278,31,270,4,31,190,31,251
1.335,6,50,19734,27,923,51,1440,14038,23,433,52,1440,5696
0.025,6,13,3514,7,75,4,75,447,6,1373,4,1448,3067
1785.876,6,127,14300,80,81,22606,503,6217,47,147,38821,1420,8083
1772.446,6,180,15480,120,69,14894,69,8940,60,69,30033,69,6540
0.832,6,59,28702,34,1052,25,1380,21457,25,558,33,1923,7245
18.958,17,4,824,2,48,18907,48,152,2,308,18920,308,672
124.994,6,34,7935,12,155,28,267,1266,22,340,5951,3417,6669
263.178,1,4,224,4,28,87726,28,224,0,0,0,0,0
44.156,6,28,12112,15,664,3153,1448,4784,13,832,3678,1448,7328
300.285,6,41,29258,22,190,14299,444,1913,19,1882,13344,7010,27345
1.115,17,4,288,2,36,1084,36,128,2,52,1073,52,160
194.474,6,117,89456,74,1293,2664,1448,78885,43,741,2818,2359,10571
9.332,6,18,1415,9,222,1165,222,808,9,231,1165,231,607
67.58,6,21,9270,11,304,104,610,1384,10,1494,7488,3931,7886
352.27,6,22,6646,3,98,160120,106,325,19,370,19569,1460,6321
1681.274,17,14,3827,7,30,280211,30,406,7,460,280211,463,3421
300.627,6,44,8985,24,336,13070,999,2386,20,482,527,2720,6599
1786.625,6,102,8228,68,64,26666,64,4896,34,58,54137,58,3332
240.2,6,55,18775,30,797,8282,1418,15919,25,193,10007,580,2856
5.017,17,4,558,2,36,5007,36,128,2,187,5008,187,430
0.01,17,4,350,2,34,6,34,124,2,85,5,91,226
3.535,17,5,340,5,40,883,40,340,0,0,0,0,0
1172.087,6,90,9611,51,68,23441,721,4438,39,120,28707,2329,5173
1773.553,6,180,15480,120,69,14903,69,8940,60,69,30052,69,6540
0.398,6,14,1733,7,288,66,288,588,7,284,34,434,1145
1681.51,17,14,1036,7,30,280249,30,406,7,62,280249,62,630
24.267,1,22,2296,1,84,0,84,112,21,76,786,76,2184
0.044,1,2,112,2,28,44,28,112,0,0,0,0,0
1788.165,6,398,24344,209,69,8596,69,12500,189,42,9511,69,11844
37.331,6,40,9967,19,541,520,910,2983,21,438,1860,2720,6984
44.961,2,7,320,7,21,7493,32,320,0,0,0,0,0
11.503,6,90,28146,47,556,250,1152,21928,43,449,267,1179,6218
415.424,17,56,20538,56,338,7553,361,20538,0,0,0,0,0
1.725,17,6,552,3,32,855,32,180,3,96,853,96,372
1788.44,17,87,3648,86,14,21040,14,3612,1,8,0,8,36
0.383,6,25,6054,13,108,31,147,959,12,768,34,1581,5095
120.368,17,4,352,2,60,120367,60,176,2,60,120367,60,176
240.174,6,54,18334,29,783,8577,1402,15610,25,177,10007,580,2724
1799.536,6,256,22564,156,98,11609,1093,12714,100,88,18176,533,9850
699.72,6,82,15677,44,159,16269,381,3069,38,734,18907,1642,12608
2.875,6,9,527,5,43,718,43,311,4,0,956,0,216
124.355,2,2,64,2,8,124355,8,64,0,0,0,0,0
30.693,6,18,6500,5,154,7673,267,672,13,588,2541,1926,5828
56.225,6,11,993,4,302,18741,302,506,7,83,9369,83,487
245.757,6,46,2944,24,69,8518,69,1443,22,69,11702,69,1501
227.3,17,4,352,2,60,227298,60,176,2,60,227299,60,176
1792.375,17,180,11520,180,36,10013,36,11520,0,0,0,0,0
0.147,6,9,1340,5,145,36,145,349,4,827,36,827,991
0.157,6,46,21557,27,1031,6,1420,16576,19,467,8,1883,4981
1663.052,1,8,448,8,28,237578,28,448,0,0,0,0,0
1772.45,6,180,15480,120,69,14894,69,8940,60,69,30039,69,6540
23.504,6,45,10252,21,533,540,910,3055,24,345,1016,2720,7197
1764.522,2,17,544,17,8,110282,8,544,0,0,0,0,0
11.223,6,27,11433,13,275,935,275,1078,14,1087,833,1440,10355
82.75,6,38,9138,13,141,6895,267,1375,25,321,3437,1440,7763
5.848,6,39,7269,19,218,324,314,3383,20,513,292,1179,3886
1744.622,2,29,928,29,8,62307,8,928,0,0,0,0,0
45.437,6,15,3205,6,92,9087,92,400,9,577,5629,1408,2805
234.655,6,277,244271,192,1302,1228,1368,227553,85,614,2599,2519,16718
240.823,6,25,7248,6,154,38302,267,712,19,412,13378,1460,6536
1386.253,2,12,384,12,8,126023,8,384,0,0,0,0,0
1771.095,6,104,9648,68,65,26434,65,5758,36,59,50600,59,3890
219.571,6,35,7449,12,189,10160,516,1430,23,254,9976,1452,6019
1798.875,6,303,54578,127,319,14276,1460,36765,176,125,10278,1460,17813
4.029,6,14,6071,3,189,2010,267,507,11,639,401,1460,5564
271.581,17,4,352,2,60,271580,60,176,2,60,271580,60,176
1171.62,17,118,24308,59,48,20200,48,4484,59,308,20200,308,19824
462.007,6,60,10084,30,102,15931,267,2745,30,255,15930,1460,7339
1772.389,6,180,15480,120,69,14894,69,8940,60,69,30035,69,6540
50.169,6,50,14346,24,1040,670,1460,8349,26,290,1999,1460,5997
0.36,6,26,8990,13,247,30,624,1672,13,947,26,1448,7318
0.775,6,29,6007,14,156,59,267,1502,15,650,50,1420,4505
1782.772,6,357,22629,208,69,8612,69,12460,149,69,12045,69,10169
0.354,17,2,144,1,36,0,36,64,1,52,0,52,80
5.789,17,27,8724,11,332,578,1350,3960,16,269,346,1350,4764
1786.014,6,102,8296,68,65,26656,65,4930,34,59,54119,59,3366
1.29,6,47,19289,27,900,49,1360,13713,20,476,59,2715,5576
13.134,17,4,824,2,48,13112,48,152,2,308,13112,308,672
1798.656,17,449,39928,404,35,4463,288,25708,45,288,40021,288,14220
0.01,17,2,307,1,33,0,33,61,1,218,0,218,246
0.104,17,2,213,1,44,0,44,72,1,113,0,113,141
1799.344,6,135,8433,76,46,23991,208,5143,59,31,31017,31,3290
1795.468,17,448,39896,403,35,4466,288,25676,45,288,40023,288,14220
0.567,6,14,1745,7,288,64,288,600,7,426,65,434,1145
9.926,6,27,7578,14,138,763,267,1552,13,1326,810,2736,6026
5.855,6,40,7309,20,218,308,314,3423,20,513,292,1179,3886
1753.184,6,97,7307,63,38,28277,205,4476,34,33,53117,98,2831
0.092,17,2,192,1,37,0,37,65,1,99,0,99,127
9.713,6,85,27365,44,572,225,1152,21243,41,447,236,1179,6122
257.537,6,28,6961,13,229,163,498,1672,15,390,18389,1420,5289
0.268,17,2,158,1,34,0,34,62,1,68,0,68,96
1769.983,1,106,5936,106,28,16856,28,5936,0,0,0,0,0
1786.461,6,102,8296,68,65,26663,65,4930,34,59,54132,59,3366
280.52,6,30,7432,13,158,23376,267,1317,17,603,17526,2760,6115
7.084,6,14,1247,7,222,1179,222,728,7,231,1179,231,519
1.841,6,3,189,0,0,0,0,0,3,69,920,69,189
0.548,6,28,9121,14,257,42,669,1766,14,945,38,1438,7355
280.641,6,30,7432,13,158,23386,267,1317,17,543,17537,1300,6115
121.128,6,69,47520,44,1199,2816,1408,39485,25,961,2565,3847,8035
0.02,6,17,6068,10,88,2,88,556,7,1740,3,1880,5512
0.017,17,2,209,1,30,0,30,58,1,123,0,123,151
129.49,17,4,1344,4,308,43163,308,1344,0,0,0,0,0
157.405,6,39,10025,13,227,859,721,1886,26,417,6289,1420,8139
0.02,6,4,212,2,0,12,0,112,2,0,17,0,100
240.221,6,59,20420,29,826,8578,1418,17214,30,204,8283,580,3206
0.068,17,2,235,1,36,0,36,64,1,143,0,143,171
0.178,17,2,162,1,36,0,36,64,1,70,0,70,98
280.641,6,31,7813,14,158,21587,267,1357,17,524,17539,1400,6456
0.014,17,2,344,1,41,0,41,69,1,247,0,247,275
297.663,6,59,10151,25,160,6468,721,2926,34,279,9015,2840,7225
1795.879,17,142,11360,71,48,25655,48,5396,71,56,25655,56,5964
1750.596,17,12,498,11,14,175059,14,462,1,8,0,8,36
1118.985,1,54,3024,54,28,21112,28,3024,0,0,0,0,0
0.054,6,3,120,2,0,54,0,80,1,0,0,0,40
278.901,1,4,224,4,28,92967,28,224,0,0,0,0,0
0.104,6,3,128,2,0,104,0,84,1,0,0,0,44
1681.636,17,14,1036,7,30,280264,30,406,7,62,280265,62,630
1796.567,17,448,39896,403,35,4469,288,25676,45,288,40023,288,14220
1.87,6,9,3066,4,183,530,267,531,5,777,408,1152,2535
1356.222,1,188,10528,188,28,7252,28,10528,0,0,0,0,0
280.047,6,29,7392,13,158,23337,267,1317,16,603,18666,2036,6075
293.079,1,4,224,4,28,97693,28,224,0,0,0,0,0
64.081,6,37,9187,16,327,135,1189,2615,21,440,3203,1420,6572
368.621,6,23,1535,16,177,24574,177,1053,7,110,11489,110,482
3.921,17,5,290,5,30,980,30,290,0,0,0,0,0
1.649,6,22,5961,12,108,149,147,919,10,927,153,1608,5042
0.016,17,2,144,1,36,0,36,64,1,52,0,52,80
100.789,6,29,7392,13,158,8399,267,1317,16,678,6712,3456,6075
0.032,17,2,244,1,43,0,43,71,1,145,0,145,173
1787.164,6,102,8228,68,64,26674,64,4896,34,58,54154,58,3332
6.849,6,44,12938,22,186,326,721,2562,22,791,317,2840,10376
21.561,6,13,1498,5,226,2132,226,720,8,110,3055,110,778
1787.002,6,110,8616,68,65,26671,65,4930,42,59,43582,59,3686
4.084,17,2,1430,2,687,4084,687,1430,0,0,0,0,0
0.943,6,22,7900,12,164,85,267,1288,10,1216,85,3819,6612
0.009,6,3,1560,1,0,0,0,40,2,1440,8,1440,1520
5.595,6,16,10658,6,275,1119,275,519,10,1390,602,1440,10139
0.107,17,4,2876,2,689,107,1350,1434,2,693,48,1350,1442
280.332,6,28,7352,12,158,25484,267,1277,16,603,18686,1400,6075
1684.418,17,14,3815,7,30,280733,30,406,7,459,280734,463,3409
1741.098,6,87,6322,58,31,30545,31,3915,29,31,62181,31,2407
1798.724,17,448,39612,404,35,4463,288,25708,44,288,40948,288,13904
1.325,6,10,1687,7,100,220,100,384,3,1179,535,1179,1303
1772.321,6,180,15480,120,69,14893,69,8940,60,69,30035,69,6540
1789.863,6,354,28537,204,75,8817,267,13224,150,136,12012,2828,15313
0.44,17,8,2750,8,315,62,354,2750,0,0,0,0,0
1744.644,2,25,800,25,8,72693,8,800,0,0,0,0,0
63.926,6,45,8949,21,410,584,882,2174,24,386,2773,1360,6775
305.889,6,40,6149,20,507,16098,1418,4592,20,86,16098,283,1557
1797.016,17,448,39896,403,35,4470,288,25676,45,288,40017,288,14220
1477.444,1,7,392,7,28,246240,28,392,0,0,0,0,0
0.402,17,17,12144,10,960,35,1350,9883,7,295,53,1350,2261
300.597,6,37,8526,19,315,16699,882,2053,18,441,497,1440,6473
1789.133,1,58,4872,0,0,0,0,0,58,56,31388,56,4872
126.062,17,6,360,3,32,63030,32,180,3,32,63030,32,180
1773.132,6,180,15480,120,69,14900,69,8940,60,69,30049,69,6540
538.731,2,3,96,3,8,269365,8,96,0,0,0,0,0
2.462,6,77,50832,45,1161,55,1408,17545,32,1436,75,4307,33287
1785.865,6,369,26130,214,105,8384,469,15514,155,69,11596,69,10616
0.978,6,9,1647,6,100,195,100,344,3,1179,353,1179,1303
5.029,17,4,288,2,36,5006,36,128,2,52,5013,52,160
2.636,6,29,6175,15,338,188,1314,2294,14,368,201,1460,3881
1744.754,2,21,672,21,8,87237,8,672,0,0,0,0,0
26.348,6,47,13172,22,194,1254,722,2636,25,794,1088,1380,10536
125.46,6,16,3248,8,92,17922,92,504,8,387,17888,1408,2744
1772.176,6,180,15480,120,69,14892,69,8940,60,69,30033,69,6540
1797.167,17,448,39896,403,35,4470,288,25676,45,288,40019,288,14220
0.114,17,4,352,2,37,0,37,130,2,83,1,89,222
0.066,17,2,672,2,308,66,308,672,0,0,0,0,0
0.653,17,12,6670,6,711,124,1350,4439,6,343,124,1350,2231
2.253,6,27,6197,13,181,187,537,1590,14,643,172,1542,4607
1.27,6,4,172,2,0,1177,0,84,2,0,1021,0,88
1.729,6,38,13358,21,584,86,1360,4414,17,687,97,1360,8944
3.906,17,3,180,3,32,1953,32,180,0,0,0,0,0
280.189,6,31,7472,14,158,21553,267,1357,17,543,17509,1400,6115
1772.412,6,180,15480,120,69,14894,69,8940,60,69,30035,69,6540
74.663,17,4,352,2,60,74662,60,176,2,60,74661,60,176
240.281,6,43,9156,21,524,12013,1418,5817,22,243,11441,618,3339
1787.079,17,87,3648,86,14,21024,14,3612,1,8,0,8,36
119.09,6,99,16306,56,304,2165,304,11808,43,83,2807,83,4498
0.156,6,25,7216,13,155,13,267,1301,12,678,13,4200,5915
60.745,6,13,3832,7,407,10124,722,1186,6,1165,12084,1448,2646
0.017,6,4,222,2,31,17,31,111,2,31,3,31,111
1782.19,17,83,3480,82,14,22002,14,3444,1,8,0,8,36
1783.467,17,83,3480,82,14,22018,14,3444,1,8,0,8,36
281.457,1,4,224,4,28,93819,28,224,0,0,0,0,0
38.494,6,36,11025,14,463,2961,1024,3386,22,449,1424,1360,7639
12.157,6,89,26261,44,551,282,1152,19979,45,447,269,1179,6282
0.003,6,5,5880,1,0,0,0,40,4,1408,0,1408,5840
280.544,6,30,7432,13,158,23378,267,1317,17,603,17524,2076,6115
162.791,17,4,352,2,60,162790,60,176,2,60,162790,60,176
392.626,17,13,4652,13,329,32718,548,4652,0,0,0,0,0
1784.827,6,361,22858,210,69,8539,69,12678,151,69,11898,69,10180
33.647,6,29,4989,14,180,2588,722,1806,15,342,2383,1402,3183
1741.47,17,29,30624,29,1028,62195,1028,30624,0,0,0,0,0
1772.554,6,182,15629,121,69,14771,69,9049,61,69,29534,69,6580
1794.585,1,298,16688,298,28,6042,28,16688,0,0,0,0,0
19.979,6,16,1327,8,222,2852,222,768,8,231,2852,231,559
1.536,6,5,200,2,0,0,0,80,3,0,768,0,120
82.231,6,29,8832,14,158,6325,267,1357,15,858,5871,3436,7475
1788.559,17,83,3480,82,14,22080,14,3444,1,8,0,8,36
1.29,6,39,9889,20,503,67,1460,4353,19,433,62,1460,5536
1799.975,17,70774,2830896,35379,16,50,16,1556676,35395,8,50,8,1274220
372.327,6,25,1651,17,177,23270,177,1117,8,110,9233,110,534
281.711,6,31,7476,13,158,23475,267,1317,18,543,16564,1400,6159
0.534,6,21,5000,10,137,59,267,1092,11,692,51,1467,3908
0.164,1,2,112,2,28,164,28,112,0,0,0,0,0
126.093,2,2,64,2,8,126093,8,64,0,0,0,0,0
1770.281,6,102,9462,66,66,27235,66,5610,36,60,50576,60,3852
0.496,6,3,120,2,0,496,0,80,1,0,0,0,40
0.158,17,2,192,1,60,0,60,88,1,76,0,76,104
0.042,6,2,92,1,0,0,0,52,1,0,0,0,40
1799.275,17,449,39928,404,35,4464,288,25708,45,288,40021,288,14220
1794.695,17,87,3648,86,14,21114,14,3612,1,8,0,8,36
1738.275,1,13,754,13,30,144856,30,754,0,0,0,0,0
0.273,17,2,586,1,46,0,46,74,1,484,0,484,512
10.759,6,18,4226,10,275,1195,275,958,8,978,856,1420,3268
301.047,6,46,17836,26,1014,12041,1460,12234,20,399,467,1460,5602
99.319,6,117,89486,75,1254,1342,1408,79177,42,811,2415,3847,10309
11.679,6,1793,1610859,1093,1419,10,1432,1578306,700,420,16,1432,32553
409.576,6,28,2355,18,57,24092,205,1454,10,38,45484,98,901
2.153,17,3,1008,3,308,1076,308,1008,0,0,0,0,0
63.759,6,13,1079,12,43,5796,43,1019,1,0,0,0,60
1786.541,6,106,8524,68,66,26664,66,4964,38,60,48282,60,3560
7.176,6,18,1820,9,181,897,181,1019,9,96,894,134,801
7.006,6,617,565511,405,1331,16,1368,549823,212,776,32,1473,15688
6.367,2,2,64,2,8,6367,8,64,0,0,0,0,0
785.774,1,16,896,16,28,52384,28,896,0,0,0,0,0
50.5,2,2,64,2,8,50500,8,64,0,0,0,0,0
4.126,17,4,296,4,46,1375,46,296,0,0,0,0,0
281.353,6,31,7610,13,158,23446,267,1317,18,506,16526,2036,6293
0.483,17,24,16075,13,1009,39,1350,13489,11,207,45,1350,2586
300.826,6,45,10240,23,433,13673,910,3154,22,364,716,2128,7086
52.537,17,4,240,2,32,52536,32,120,2,32,52536,32,120
0.453,6,25,7887,16,364,30,1125,3193,9,721,54,1420,4694
1777.747,17,140,11200,70,48,25764,48,5320,70,56,25764,56,5880
1786.74,6,106,8515,69,65,26275,65,4970,37,59,49628,59,3545
130.249,17,4,352,2,60,130248,60,176,2,60,130248,60,176
5.433,6,2,92,1,0,0,0,40,1,0,0,0,52
10.598,1,9,756,9,56,1324,56,756,0,0,0,0,0
0.352,6,27,9112,13,271,29,726,1771,14,943,26,1408,7341
0.069,6,2,100,1,0,0,0,40,1,0,0,0,60
296.834,17,10,585,10,30,32981,31,585,0,0,0,0,0
268.819,6,64,10294,27,347,10338,1056,6298,37,135,7466,580,3996
1770.174,6,215,16827,80,72,22405,336,8096,135,49,13210,143,8731
124.524,6,32,7855,11,155,31,267,1226,21,361,6225,3426,6629
0.586,6,20,7049,12,164,53,267,1124,8,1833,72,3819,5925
6.601,6,43,8329,21,227,330,314,4022,22,489,301,1179,4307
280.583,6,30,7432,13,158,23381,267,1317,17,543,17530,1400,6115
79.44,6,45,13042,23,890,502,1360,7236,22,327,3774,2667,5806
171.45,6,1541,763791,834,849,205,1152,727928,707,398,242,1179,35863
301.037,6,83,54267,49,1242,6271,1368,47338,34,468,1374,1571,6929
17.925,6,18,1407,9,222,2239,222,808,9,231,2239,231,599
869.461,1,8,448,8,28,124208,28,448,0,0,0,0,0
240.325,6,43,9032,21,524,12015,1418,5818,22,229,11443,618,3214
0.006,6,4,196,3,0,0,0,156,1,0,0,0,40
1756.971,6,187,11456,94,47,18892,208,6806,93,31,19094,31,4650
83.495,6,36,23924,19,840,37,1360,5835,17,1739,5209,4080,18089
1782.243,17,83,3480,82,14,22003,14,3444,1,8,0,8,36
0.151,17,2,784,2,364,151,364,784,0,0,0,0,0
0.088,17,2,136,1,32,0,32,60,1,48,0,48,76
76.707,6,14,580,7,0,12784,0,284,7,0,12527,0,296
275.352,17,6,424,3,42,137675,64,212,3,42,137675,64,212
12.286,6,2,1175,1,0,0,0,40,1,1095,0,1095,1135
0.038,17,4,284,2,32,25,32,120,2,54,26,60,164
1776.609,1,61,5124,0,0,0,0,0,61,56,29610,56,5124
1793.135,17,144,11520,72,48,25255,48,5472,72,56,25255,56,6048
7.544,6,29,12266,8,138,1077,267,883,21,702,376,1420,11383
1799.512,1,345,28980,345,56,5231,56,28980,0,0,0,0,0
0.099,17,2,157,1,31,0,31,59,1,70,0,70,98
0.902,6,10,1687,7,100,150,100,384,3,1179,323,1179,1303
0.021,17,2,152,1,48,0,48,76,1,48,0,48,76
0.317,6,21,4390,11,165,31,456,1394,10,493,33,888,2996
1759.209,6,158,9986,83,51,21453,208,6025,75,31,23767,31,3961
98.206,6,23,9313,11,514,84,1236,2026,12,970,8911,1360,7287
1765.561,6,102,7970,66,45,27162,205,4902,36,35,50434,98,3068
1.258,6,38,8252,19,320,69,1162,2716,19,433,60,1360,5536
106.807,6,1005,507474,557,843,192,1152,484763,448,398,238,1152,22711
1770.945,6,105,9618,66,66,27245,66,5610,39,60,46601,60,4008
1786.774,6,102,8296,68,65,26668,65,4930,34,59,54142,59,3366
1593.45,1,84,8904,84,78,19198,78,8904,0,0,0,0,0
282.206,1,4,224,4,28,94068,28,224,0,0,0,0,0
149.834,6,12,680,5,0,37455,0,260,7,56,24969,56,420
0.19,6,9,1050,5,261,47,261,465,4,421,40,421,585
0.09,17,2,146,1,37,0,37,65,1,53,0,53,81
1205.518,17,236,17936,236,48,5129,48,17936,0,0,0,0,0
1610.206,6,24,3624,16,241,107347,241,2568,8,92,229999,92,1056
1745.94,6,96,7255,62,38,28621,205,4424,34,33,52899,98,2831
740.001,6,141,114861,58,241,12355,241,2633,83,1312,9024,1460,112228
7.204,6,38,10164,18,283,422,469,3846,20,423,377,3377,6318
0.006,17,3,524,2,64,3,64,184,1,312,0,312,340
372.141,6,25,1654,17,180,23258,180,1120,8,110,9285,110,534
1408.886,1,7,392,7,28,234814,28,392,0,0,0,0,0
1772.356,6,180,15480,120,69,14893,69,8940,60,69,30031,69,6540
0.018,1,4,416,0,0,0,0,0,4,76,6,76,416
5.036,17,4,288,2,36,5006,36,128,2,52,4997,52,160
1782.135,17,83,3480,82,14,22001,14,3444,1,8,0,8,36
240.205,6,53,17568,28,774,8896,1402,14633,25,203,10008,580,2935
15.32,17,17,9187,7,560,2548,1350,4116,10,479,1698,1350,5071
1774.11,17,142,11360,71,48,25344,48,5396,71,56,25344,56,5964
0.049,6,14,4308,7,85,8,85,457,7,869,8,1448,3851
1737.885,1,56,4704,0,0,0,0,0,56,56,31597,56,4704
0.36,6,10,968,5,256,88,256,460,5,304,88,304,508
0.044,17,4,320,2,41,0,41,138,2,63,5,69,182
240.651,6,48,6592,22,209,11459,585,3062,26,180,9625,580,3530
15.499,17,27,17649,15,805,1104,1350,12501,12,401,1405,1350,5148
0.05,17,2,198,1,37,0,37,65,1,105,0,105,133
0.16,1,2,112,2,28,160,28,112,0,0,0,0,0
599.669,6,9,546,6,31,119933,31,333,3,31,299817,31,213
0.021,17,2,904,1,300,0,300,328,1,548,0,548,576
11.067,17,4,1344,4,308,3689,308,1344,0,0,0,0,0
1787.379,1,278,29468,278,78,6452,78,29468,0,0,0,0,0
1.158,6,25,6081,13,108,96,147,959,12,773,102,1608,5122
1738.308,1,56,4704,56,56,31605,56,4704,0,0,0,0,0
1703.759,1,8,448,8,28,243394,28,448,0,0,0,0,0
0.312,6,25,9008,13,271,26,726,1771,12,1100,27,2816,7237
1711.01,1,8,848,8,78,244430,78,848,0,0,0,0,0
65.491,6,27,7177,13,155,5457,267,1306,14,530,5037,3417,5871
10.473,6,18,7870,9,275,1309,275,643,9,1371,1253,1440,7227
4.792,17,16,9698,8,705,684,1350,5871,8,450,676,1350,3827
911.606,1,28,1568,28,28,33763,28,1568,0,0,0,0,0
0.27,6,3,3020,1,0,0,0,40,2,1438,1,1438,2980
10.229,6,87,26469,43,560,243,1152,20227,44,407,232,1152,6242
104.528,6,24,8919,12,314,124,634,1491,12,867,9491,1360,7428
8.729,6,34,8248,18,367,513,787,1854,16,522,566,3488,6394
13.657,17,3,2906,3,940,6828,1451,2906,0,0,0,0,0
0.292,6,22,7333,13,334,23,663,2021,9,967,35,1912,5312
1745.392,1,73,6132,73,56,24241,56,6132,0,0,0,0,0
1.413,6,44,8549,22,320,67,1162,2848,22,400,58,1360,5701
548.023,1,6,336,6,28,109604,28,336,0,0,0,0,0
1795.423,17,448,39896,403,35,4466,288,25676,45,288,40015,288,14220
1786.458,6,102,8364,68,66,26663,66,4964,34,60,54131,60,3400
0.176,17,2,2752,2,1348,176,1348,2752,0,0,0,0,0
1743.459,6,96,7286,63,38,28120,205,4476,33,33,54472,98,2810
1680.477,1,15,840,15,28,120034,28,840,0,0,0,0,0
299.547,6,6,364,4,31,99849,31,222,2,31,299534,31,142
1.509,6,10,1185,6,279,301,279,587,4,191,192,272,598
1787.233,6,105,8481,69,65,26282,65,5035,36,59,51060,59,3446
271.571,6,59,10054,30,277,9364,1206,4355,29,297,9698,1408,5699
1353.693,1,38,2128,38,28,36586,28,2128,0,0,0,0,0
1769.155,6,99,9174,66,64,27217,64,5544,33,58,55281,58,3630
13.637,6,1009,881406,633,1318,21,1368,857190,376,776,35,2736,24216
0.947,6,10,1687,7,100,157,100,384,3,1179,323,1179,1303
705.083,1,4,224,4,28,235027,28,224,0,0,0,0,0
0.134,6,10,1671,6,552,26,948,1348,4,159,44,159,323
1796.946,17,449,39928,404,35,4458,288,25708,45,288,40021,288,14220
1.339,6,50,19365,29,892,47,1360,13704,21,437,58,2715,5661
6.092,17,3,228,3,48,3046,48,228,0,0,0,0,0
97.359,17,6,2016,6,308,19471,308,2016,0,0,0,0,0
107.812,1,2,320,2,132,107812,173,320,0,0,0,0,0
782.068,2,8,256,8,8,111724,8,256,0,0,0,0,0
28.171,6,1680,1493056,1081,1303,25,1368,1455384,599,776,46,2736,37672
0.042,6,12,3705,6,171,5,171,491,6,964,8,1448,3214
1786.339,6,363,40933,180,169,9979,208,32559,183,31,9813,31,8374
62.143,6,47,10085,23,635,505,1360,4199,24,327,2694,2667,5886
281.525,6,29,7392,13,158,23460,267,1317,16,603,18750,2036,6075
1794.583,6,182,15560,120,69,15080,69,8940,62,69,29411,69,6620
3.003,6,108,96497,50,333,61,333,4927,58,1735,52,2736,91570
5.329,6,12,6134,4,275,1776,275,439,8,1073,409,2007,5695
1774.984,1,58,4872,58,56,31140,56,4872,0,0,0,0,0
179.438,6,22,8553,11,545,82,1330,2109,11,856,17927,1360,6444
1786.111,6,356,22520,208,69,8628,69,12460,148,69,12150,69,10060
62.104,6,27,7177,13,155,5175,267,1306,14,530,4776,2840,5871
73.138,6,32,7653,12,155,32,267,1266,20,371,3848,1997,6387
62.854,6,24,6509,11,262,6281,517,1368,13,744,5234,1418,5141
7.45,6,653,541534,388,1321,18,1368,522434,265,776,27,1473,19100
2.682,6,12,1402,7,304,447,304,968,5,83,523,83,434
4.599,17,2,166,1,47,0,47,75,1,63,0,63,91
1740.965,6,132,17216,81,87,21762,877,7906,51,166,34818,4023,9310
372.092,6,18,1242,14,180,28622,180,916,4,110,20066,110,326
1.742,6,9,468,5,0,435,0,260,4,0,516,0,208
240.208,6,54,18368,29,826,8578,1418,15558,25,187,10008,580,2810
9.112,6,37,8360,18,365,536,780,1847,19,441,492,1460,6513
1798.044,1,345,28980,345,56,5226,56,28980,0,0,0,0,0
0.017,17,2,206,1,44,0,44,72,1,106,0,106,134
299.586,6,6,364,4,31,99862,31,222,2,31,299525,31,142
0.031,17,4,288,2,33,1,33,122,2,55,0,61,166
0.442,17,8,2750,8,315,63,354,2750,0,0,0,0,0
1.74,6,19,3781,10,234,193,564,1452,9,463,194,1343,2329
1.328,6,38,9848,21,440,66,1360,4392,17,476,68,2715,5456
0.633,17,7,2390,7,313,105,354,2390,0,0,0,0,0
199.434,6,33,19147,18,486,11731,938,2427,15,1448,4388,8448,16720
0.052,17,4,284,2,32,46,32,120,2,54,41,60,164
196.561,17,4,300,2,47,196560,47,150,2,47,196559,47,150
13.569,6,30,7573,12,155,1233,267,1266,18,398,797,3417,6307
0.384,17,3,2906,3,940,192,1451,2906,0,0,0,0,0
46.782,17,4,240,2,32,46781,32,120,2,32,46781,32,120
280.51,6,28,7352,12,158,25500,267,1277,16,603,18690,2036,6075
372.06,6,19,1294,14,180,28620,180,916,5,110,15045,110,378
92.159,6,32,7515,15,141,6582,267,1455,17,413,5758,1460,6060
111.126,6,36,7942,14,163,8548,267,1549,22,367,5287,1452,6393
3.654,17,5,295,5,31,913,31,295,0,0,0,0,0
20.58,6,34,5647,25,211,857,211,2097,9,617,2572,904,3550
148.168,17,7,845,7,92,24694,355,845,0,0,0,0,0
0.037,17,4,284,2,32,25,32,120,2,54,27,60,164
0.006,17,2,114,1,29,0,29,57,1,29,0,29,57
2.344,17,4,1556,4,361,781,361,1556,0,0,0,0,0
33.087,6,16,7573,8,999,4726,1241,2414,8,790,4725,1408,5159
1764.346,2,14,448,14,8,135718,8,448,0,0,0,0,0
61.889,6,75,49658,45,1182,1406,1408,41364,30,960,2126,3847,8294
1710.939,1,8,448,8,28,244419,28,448,0,0,0,0,0
15.162,17,10,880,5,48,3788,48,380,5,72,3786,72,500
0.061,17,2,136,1,32,0,32,60,1,48,0,48,76
1772.833,6,180,15480,120,69,14897,69,8940,60,69,30040,69,6540
3.837,17,2,152,2,48,3837,48,152,0,0,0,0,0
1685.978,17,14,3815,7,30,280992,30,406,7,459,280994,463,3409
1760.564,6,5250,4352986,2483,148,709,900,140098,2767,1510,636,5632,4212888
1787.911,6,367,29378,211,125,8513,981,16206,156,101,11534,453,13172
60.072,6,6717,6284153,4362,1357,13,1368,6137133,2355,776,25,2736,147020
12.145,17,10,1965,5,33,3032,33,305,5,304,3032,304,1660
1654.579,17,27,1128,26,14,66183,14,1092,1,8,0,8,36
2.727,6,2,88,2,0,0,0,88,0,0,0,0,0
1740.658,17,30,7050,30,207,60022,207,7050,0,0,0,0,0
0.387,6,13,1693,7,288,60,288,588,6,426,41,434,1105
0.315,6,4,160,2,0,153,0,80,2,0,163,0,80
0.072,6,10,767,5,186,17,186,454,5,45,13,45,313
11.921,17,8,704,4,48,3969,48,304,4,72,3969,72,400
360.027,6,28,7935,10,216,7123,501,1270,18,396,21172,1420,6665
0.614,6,11,976,5,283,104,283,551,6,105,81,105,425
52.984,6,545,451773,354,1322,46,1360,437559,191,211,277,1360,14214
1797.857,17,448,39896,403,35,4472,288,25676,45,288,40016,288,14220
288.881,6,32,3201,16,324,19258,585,1509,16,282,19258,580,1692
1681.814,17,16,1265,8,30,240256,37,471,8,71,240256,136,794
3.222,6,69,51938,43,985,76,1360,12600,26,2552,123,8160,39338
1769.692,6,101,9410,66,66,27226,66,5610,35,60,52045,60,3800
1778.789,1,63,5292,63,56,28690,56,5292,0,0,0,0,0
2.369,6,14,2351,8,188,338,245,700,6,703,421,1152,1651
0.004,17,2,350,1,33,0,33,61,1,261,0,261,289
0.006,17,2,222,1,37,0,37,65,1,129,0,129,157
0.161,17,2,348,1,39,0,39,67,1,253,0,253,281
4.634,6,59,23309,33,959,144,1460,15838,26,400,163,1460,7471
1.171,6,24,8016,12,164,90,267,1300,12,1014,90,2411,6716
39.572,17,22,1936,11,48,3956,48,836,11,72,3956,72,1100
1741.125,6,89,6469,59,31,30019,31,3979,30,31,60036,31,2490
127.735,6,39,5733,23,180,5806,722,2299,16,288,1026,2026,3434
373.634,6,24,1587,16,177,24908,177,1053,8,110,9229,110,534
10.871,6,1631,1491064,1055,1362,10,1420,1463673,576,475,18,1883,27391
1798.201,17,260,54150,260,180,6942,422,54150,0,0,0,0,0
138.853,17,4,352,2,60,138852,60,176,2,60,138852,60,176
10.962,6,27,11355,13,275,913,275,1078,14,1078,810,1414,10277
1741.498,6,87,6322,58,31,30552,31,3915,29,31,62196,31,2407
10.14,6,17,3502,9,210,1265,210,896,8,545,1434,905,2606
74.495,6,104,81464,70,1257,1079,1408,71571,34,811,2145,3847,9893
168.494,6,25,9541,12,457,59,1460,2342,13,952,14030,1460,7199
879.195,6,113,14550,67,82,13321,267,5329,46,179,19489,2920,9221
842.956,17,8,592,4,30,280886,30,232,4,62,280980,62,360
32.811,6,9,396,2,0,2310,0,88,7,0,5453,0,308
1746.571,17,214,50218,214,206,8199,422,50218,0,0,0,0,0
1.699,6,26,8781,16,281,113,576,1488,10,984,168,1452,7293
1786.721,6,104,8444,68,66,26667,66,4964,36,60,51046,60,3480
5.348,6,29,11876,14,336,411,722,1911,15,1040,367,4140,9965
105.34,6,169,69363,82,777,1300,1152,60053,87,416,1221,1179,9310
0.589,6,22,7312,13,325,49,626,1984,9,1210,68,1946,5328
1783.507,6,364,25392,212,100,8452,469,14896,152,69,11809,69,10496
1777.391,17,140,11200,70,48,25759,48,5320,70,56,25759,56,5880
155.003,6,24,10054,12,532,59,1360,2642,12,1153,14079,2720,7412
1773.144,6,180,15480,120,69,14900,69,8940,60,69,30050,69,6540
18.544,6,45,8290,25,200,772,314,4606,20,480,949,1179,3684
55.237,6,355,154807,178,796,312,1152,141780,177,494,312,1179,13027
196.321,6,15,4429,4,341,65440,722,1239,11,325,1421,2026,3190
1771.23,6,101,9344,66,65,27249,65,5577,35,59,52092,59,3767
0.04,6,11,1564,6,503,8,503,823,5,473,10,473,741
1.465,17,25,18019,14,998,95,1350,14373,11,303,138,1350,3646
0.0,17,1,1393,1,1365,0,1365,1393,0,0,0,0,0
3.999,17,4,352,2,48,3984,48,152,2,72,3986,72,200
0.366,17,2,304,1,60,0,60,88,1,188,0,188,216
0.97,6,4,253,2,31,970,31,111,2,31,840,31,142
0.035,6,5,310,3,31,17,31,175,2,31,0,31,135
0.98,17,2,493,1,48,0,48,76,1,389,0,389,417
1.137,6,10,1687,6,100,227,100,344,4,589,289,1152,1343
445.503,17,28,4242,14,40,34268,43,961,14,206,34268,249,3281
117.414,6,24,10002,12,397,70,884,1717,12,974,10661,1503,8285
0.324,17,2,152,1,48,0,48,76,1,48,0,48,76
1780.779,6,101,10771,50,226,36341,517,3551,51,570,35614,3815,7220
4.232,6,40,7309,19,218,235,314,3383,21,440,198,1152,3926
23.784,6,3536,3239401,2231,1371,10,1408,3166877,1305,776,18,1408,72524
5.536,17,27,16164,11,727,553,1350,8315,16,462,356,1350,7849
0.035,17,2,152,1,48,0,48,76,1,48,0,48,76
0.001,6,2,92,2,0,0,0,92,0,0,0,0,0
169.998,6,459,393602,183,707,934,1418,18719,276,1381,618,1418,374883
410.538,17,8,512,4,36,136845,47,256,4,36,136845,47,256
1385.417,6,171,13040,65,69,21645,294,6217,106,48,13193,78,6823
0.303,6,24,6559,11,263,29,517,1634,13,530,24,1408,4925
1790.66,1,251,14056,251,28,7162,28,14056,0,0,0,0,0
177.754,6,55,14526,24,168,7728,267,2485,31,568,5923,1400,12041
1008.841,2,7,224,7,8,168140,8,224,0,0,0,0,0
1771.946,6,99,9306,66,66,27260,66,5610,33,60,55370,60,3696
1.312,6,50,19022,27,872,50,1360,13326,23,476,51,2715,5696
10.837,6,91,27930,45,565,246,1152,21608,46,447,235,1179,6322
26.376,17,33,15524,12,419,2394,1350,5366,21,455,1316,1350,10158
3.574,17,4,1556,4,361,1191,361,1556,0,0,0,0,0
0.764,6,22,5489,11,140,76,267,1144,11,780,69,1460,4345
0.19,17,11,4474,5,432,47,1350,2301,6,334,25,1350,2173
1690.396,1,8,848,8,78,241485,78,848,0,0,0,0,0
1796.31,17,1026,70448,1026,40,1752,41,70448,0,0,0,0,0
0.012,17,2,197,1,41,0,41,69,1,100,0,100,128
15.054,6,83,25543,42,564,367,1152,19762,41,413,369,1152,5781
1.11,6,19,7275,10,262,123,517,1328,9,911,60,2411,5947
1773.005,6,205,22439,131,75,13638,267,10097,74,133,24286,1917,12342
168.693,6,30,7432,13,158,14057,267,1317,17,543,10538,1400,6115
61.329,6,35,15923,22,809,2920,1408,9249,13,855,5088,3847,6674
0.625,17,15,8502,8,705,89,1350,5871,7,347,95,1350,2631
0.62,6,25,8033,12,186,56,367,1378,13,995,49,1408,6655
1773.024,6,180,15480,120,69,14899,69,8940,60,69,30047,69,6540
12.671,6,17,5761,6,106,2518,106,362,11,823,1265,1460,5399
300.605,6,46,8984,23,286,13663,766,2156,23,327,583,1460,6828
1772.907,6,180,15480,120,69,14898,69,8940,60,69,30048,69,6540
628.362,17,12,1056,6,48,125670,48,456,6,72,125670,72,600
0.021,17,4,859,2,37,0,37,130,2,336,0,348,729
258.946,17,4,240,2,32,258945,32,120,2,32,258945,32,120
1782.969,6,105,8475,68,65,26611,65,4930,37,59,49524,59,3545
42.496,6,26,12524,8,275,6070,275,874,18,728,2464,1440,11650
20.569,6,26,6348,15,117,1469,159,1389,11,873,2043,1709,4959
560.551,17,6,1647,3,30,280236,30,174,3,463,280273,463,1473
132.357,6,23,8359,11,525,88,1237,2048,12,831,12017,1360,6311
1764.407,17,168,13918,156,30,11383,37,9090,12,374,154791,463,4828
7.401,6,12,5529,4,106,2463,106,274,8,985,1055,1420,5255
846.059,6,92,9153,57,111,15108,469,5412,35,68,24883,69,3741
1764.31,2,14,448,14,8,135716,8,448,0,0,0,0,0
4.243,17,10,785,5,31,1052,31,295,5,70,1044,70,490
754.135,6,77,11508,39,119,19845,517,3653,38,364,20369,3816,7855
523.807,6,56,8663,26,121,20952,517,2344,30,279,18060,1418,6319
70.023,6,25,9849,12,531,86,1440,2637,13,954,5823,1440,7212
60.911,6,111,79094,70,1291,136,1360,72607,41,402,1518,2667,6487
14.251,6,24,3984,12,199,1295,293,1681,12,363,1269,1179,2303
1746.754,6,97,7307,63,38,28173,205,4476,34,33,52922,98,2831
1782.498,17,142,11360,71,48,25464,48,5396,71,56,25464,56,5964
1786.209,6,415,24949,210,69,8546,69,12540,205,35,8755,69,12409
1.696,6,13,2311,8,188,242,245,700,5,1407,359,1407,1611
1.922,17,2,672,2,308,1922,308,672,0,0,0,0,0
1.879,6,20,3833,11,234,187,564,1504,9,463,212,1343,2329
3.675,6,2,88,2,0,0,0,88,0,0,0,0,0
2.92,6,28,9115,14,200,224,611,1775,14,941,219,1368,7340
1799.982,6,201,13974,73,46,24999,46,5910,128,46,14171,46,8064
0.172,17,2,1924,2,934,172,934,1924,0,0,0,0,0
1.002,17,2,677,1,300,0,300,328,1,321,0,321,349
1789.955,1,58,4872,0,0,0,0,0,58,56,31402,56,4872
0.224,17,2,152,1,48,0,48,76,1,48,0,48,76
304.237,17,10,585,10,30,33804,31,585,0,0,0,0,0
2.368,17,2,144,1,36,0,36,64,1,52,0,52,80
25.92,6,26,3220,14,196,1993,632,1596,12,226,2339,338,1624
4.884,17,4,288,2,36,4883,36,128,2,52,4884,52,160
0.958,6,10,1687,7,100,159,100,384,3,1179,354,1179,1303
1696.695,6,98,9413,45,36,38559,36,2664,53,445,32627,445,6749
0.007,6,2,80,1,0,0,0,40,1,0,0,0,40
1.133,17,2,178,1,29,0,29,57,1,93,0,93,121
0.937,6,153,111399,89,1311,10,1432,104548,64,475,14,1871,6851
10.182,6,9,529,5,45,2545,45,313,4,0,3392,0,216
1.398,6,41,8429,21,320,69,1162,2808,20,400,64,1460,5621
0.727,6,21,5000,11,137,72,267,1132,10,692,79,1467,3868
1.681,6,37,8214,19,321,93,1164,2718,18,476,86,2720,5496
160.244,17,8,568,4,32,53412,32,240,4,54,53412,60,328
10.133,6,1550,1396219,989,1362,10,1380,1365790,561,683,18,3303,30429
1772.79,6,180,15480,120,69,14897,69,8940,60,69,30046,69,6540
1682.846,17,14,1036,7,30,280463,30,406,7,62,280461,62,630
240.264,6,55,20243,30,788,8284,1418,17334,25,200,10010,580,2909
20.201,6,27,7299,15,149,1442,318,1560,12,638,1835,1418,5739
1789.915,17,143,11436,72,48,25209,48,5472,71,56,25569,56,5964
302.422,6,44,19885,23,321,13746,1034,3457,21,1176,3160,2939,16428
671.762,6,40,3169,21,64,24548,64,1608,19,44,37315,58,1561
178.714,6,48,7204,28,304,6619,304,5136,20,83,9405,83,2068
280.654,6,32,7853,14,158,21588,267,1357,18,524,16508,1300,6496
0.96,17,2,256,1,49,0,49,77,1,151,0,151,179
1.15,6,24,8004,12,164,88,267,1288,12,1014,88,2816,6716
1779.776,6,353,22400,206,69,8681,69,12380,147,69,12190,69,10020
1619.357,1,8,848,8,78,231336,78,848,0,0,0,0,0
1765.28,2,15,480,15,8,126091,8,480,0,0,0,0,0
125.463,2,2,64,2,8,125463,8,64,0,0,0,0,0
1.262,6,53,18812,29,841,45,1360,13031,24,400,47,1360,5781
2.024,17,23,16229,11,727,202,1350,8307,12,632,170,1350,7922
0.032,17,4,859,2,37,0,37,130,2,336,1,348,729
760.152,6,116,18394,59,106,13103,721,6204,57,381,13571,1414,12190
240.08,6,32,9516,17,157,15005,517,1837,15,689,17148,1408,7679
0.009,17,2,236,1,40,0,40,68,1,140,0,140,168
0.024,17,2,327,1,35,0,35,63,1,236,0,236,264
253.398,17,8,2672,8,306,36199,306,2672,0,0,0,0,0
739.974,6,136,19478,73,304,10277,304,13288,63,83,11926,83,6190
244.061,17,4,352,2,60,244060,60,176,2,60,244059,60,176
1775.628,17,142,11360,71,48,25365,48,5396,71,56,25365,56,5964
1791.162,1,288,30528,288,78,6240,78,30528,0,0,0,0,0
169.978,17,4,352,2,60,169977,60,176,2,60,169977,60,176
562.801,17,7684,5812800,7574,738,74,1252,5808356,110,12,4912,56,4444
271.482,6,53,20285,29,935,9689,1360,14294,24,386,11795,2667,5991
0.865,6,10,1687,7,100,144,100,384,3,1179,306,1179,1303
280.231,6,28,7352,13,158,23352,267,1317,15,678,20013,3436,6035
1.003,6,7,5207,1,0,0,0,40,6,985,0,1420,5167
1787.819,1,341,28644,341,56,5258,56,28644,0,0,0,0,0
280.036,6,29,7392,14,158,21541,267,1357,15,678,19999,3436,6035
55.218,17,2,72,1,8,0,8,36,1,8,0,8,36
0.93,6,28,6109,14,154,71,267,1644,14,650,65,1420,4465
443.045,1,62,3472,0,0,0,0,0,62,28,7263,28,3472
1.012,6,10,1687,7,100,168,100,384,3,1179,381,1179,1303
0.101,6,10,1495,5,507,25,507,727,5,556,25,556,768
0.009,17,2,307,1,33,0,33,61,1,218,0,218,246
1787.423,6,102,8296,68,65,26677,65,4930,34,59,54160,59,3366
7.715,17,6,528,3,48,3852,48,228,3,72,3852,72,300
1793.32,6,80,4264,41,26,44832,26,2184,39,26,47191,26,2080
0.048,17,2,167,1,39,0,39,67,1,72,0,72,100
3.795,17,5,340,5,40,948,40,340,0,0,0,0,0
126.896,17,4,240,2,32,126895,32,120,2,32,126895,32,120
38.972,6,37,8528,15,263,2783,596,2092,22,377,1855,1440,6436
1778.884,17,140,11200,70,48,25780,48,5320,70,56,25780,56,5880
0.525,17,3,543,2,39,515,39,134,1,381,0,381,409
0.038,17,4,284,2,32,32,32,120,2,54,30,60,164
1787.268,6,106,8524,68,66,26675,66,4964,38,60,48301,60,3560
1755.532,6,4180,4317440,1583,149,1109,936,97943,2597,1618,676,9814,4219497
1772.195,6,180,15480,120,69,14892,69,8940,60,69,30034,69,6540
1.249,17,6,552,3,64,624,64,276,3,64,623,64,276
280.509,6,29,7392,13,158,23375,267,1317,16,678,18691,3456,6075
3.312,6,18,6816,6,106,662,106,460,12,733,296,1460,6356
252.687,17,4,352,2,60,252685,60,176,2,60,252686,60,176
1798.985,1,345,28980,345,56,5229,56,28980,0,0,0,0,0
216.326,6,119,93474,79,1253,2773,1408,81863,40,865,2225,4224,11611
1.41,6,50,19505,27,906,54,1460,13809,23,433,55,1460,5696
300.565,6,19,1279,6,177,60077,177,497,13,110,25032,110,782
0.002,6,4,227,1,0,0,0,40,3,31,0,31,187
0.045,17,4,284,2,32,22,32,120,2,54,25,60,164
300.202,6,6,364,4,31,100067,31,222,2,31,299900,31,142
0.267,17,4,624,2,64,196,64,184,2,192,204,192,440
3.838,6,14,3143,8,49,548,92,511,6,579,42,1408,2632
1777.724,17,79,3312,78,14,23087,14,3276,1,8,0,8,36
9.237,17,4,824,2,48,9220,48,152,2,308,9218,308,672
136.821,17,4,352,2,60,136820,60,176,2,60,136820,60,176
300.687,6,44,8809,23,280,13667,775,2122,21,416,429,2720,6687
1779.406,17,142,11360,71,48,25419,48,5396,71,56,25419,56,5964
0.056,6,2,1540,1,0,0,0,40,1,1460,0,1460,1500
2.838,6,55,14111,27,549,109,1429,5004,28,419,94,1986,9107
1795.38,17,449,39928,404,35,4455,288,25708,45,288,40016,288,14220
2.036,6,19,3781,10,234,226,564,1452,9,463,231,1343,2329
0.029,17,2,904,1,548,0,548,576,1,300,0,300,328
1793.305,6,370,25839,214,99,8419,469,15114,156,69,11567,69,10725
60.045,6,8,432,5,0,15011,0,268,3,0,30014,0,164
0.498,17,15,9129,8,822,67,1350,6803,7,304,74,1350,2326
18.964,17,35,20394,18,733,1113,1350,13699,17,365,1183,1350,6695
1771.938,6,180,15480,120,69,14890,69,8940,60,69,30031,69,6540
1.072,6,28,8160,15,222,64,540,1964,13,944,72,1591,6196
1744.24,6,95,7203,63,38,28132,205,4476,32,33,56252,98,2727
1772.281,6,181,15589,120,69,14893,69,8940,61,69,29530,69,6649
4.168,2,2,64,2,8,4168,8,64,0,0,0,0,0
2.364,17,2,144,1,36,0,36,64,1,52,0,52,80
7.972,1,11,1547,11,112,797,122,1547,0,0,0,0,0
15.086,17,5,380,5,48,3771,48,380,0,0,0,0,0
1751.803,17,244,48126,244,169,7209,342,48126,0,0,0,0,0
0.444,17,2,158,1,34,0,34,62,1,68,0,68,96
1776.109,1,240,25440,240,78,7431,78,25440,0,0,0,0,0
25.682,6,3465,3321330,2309,1362,11,1408,3256554,1156,776,22,1408,64776
1781.501,17,142,11360,71,48,25449,48,5396,71,56,25449,56,5964
0.105,17,4,284,2,32,85,32,120,2,54,22,60,164
1.678,6,53,22551,28,976,62,1440,16775,25,433,61,1440,5776
7.299,6,896,694377,464,1399,15,1448,663921,432,776,16,1448,30456
124.128,6,33,7895,11,155,31,267,1226,22,340,5910,2006,6669
1771.344,6,99,9240,66,65,27251,65,5577,33,59,55351,59,3663
280.002,6,31,7472,14,158,21538,267,1357,17,543,17499,1400,6115
1.901,17,2,116,2,30,1901,30,116,0,0,0,0,0
208.515,17,7,2320,7,303,34752,308,2320,0,0,0,0,0
0.219,6,9,527,5,43,54,43,311,4,0,52,0,216
1.638,6,52,18901,29,854,58,1360,13160,23,400,64,1360,5741
0.442,6,9,1348,5,145,110,145,349,4,835,145,835,999
1793.736,6,278,34395,114,142,15872,1360,16947,164,134,11003,3302,17448
1798.848,17,459,59621,209,178,8648,1350,43187,250,37,7224,1350,16434
41.542,6,5653,5384655,3624,1405,11,1448,5273227,2029,776,20,1448,111428
1.27,6,50,19980,28,878,47,1360,14324,22,433,52,1360,5656
61.232,6,13,1079,12,43,5566,43,1019,1,0,0,0,60
240.353,6,43,8395,22,449,11444,1418,5648,21,205,12017,580,2747
243.756,6,52,8462,24,265,10597,592,3188,28,293,9027,709,5274
1790.561,17,87,3648,86,14,21065,14,3612,1,8,0,8,36
0.657,17,19,12026,10,664,73,1350,6924,9,538,57,1350,5102
1789.213,6,397,24160,208,69,8643,69,12460,189,40,9517,69,11700
1788.028,6,355,22480,207,69,8679,69,12420,148,69,12163,69,10060
280.503,6,30,7432,13,158,23375,267,1317,17,603,17526,2076,6115
1786.617,6,102,8364,68,66,26665,66,4964,34,60,54137,60,3400
0.423,6,12,1653,6,288,78,288,548,6,426,49,434,1105
0.085,1,2,163,2,53,85,78,163,0,0,0,0,0
1.114,17,30,10901,12,365,98,1350,4723,18,315,63,1350,6178
1.669,17,3,1170,3,362,834,362,1170,0,0,0,0,0
1701.394,17,12,498,11,14,170139,14,462,1,8,0,8,36
868.862,1,8,448,8,28,124123,28,448,0,0,0,0,0
0.031,6,15,4478,8,127,3,127,563,7,885,5,1448,3915
1786.842,1,37,4733,37,99,49634,351,4733,0,0,0,0,0
35.872,6,23,1615,12,222,3259,222,932,11,231,3585,231,683
1782.415,17,83,3480,82,14,22005,14,3444,1,8,0,8,36
252.42,2,2,64,2,8,252420,8,64,0,0,0,0,0
0.144,1,2,112,2,28,144,28,112,0,0,0,0,0
8.665,17,4,352,2,60,8664,60,176,2,60,8664,60,176
0.202,17,3,688,2,64,16,64,184,1,476,0,476,504
280.257,6,30,7432,13,158,23354,267,1317,17,543,17513,1400,6115
1797.095,1,58,4872,0,0,0,0,0,58,56,31527,56,4872
0.124,6,14,5718,7,290,20,517,941,7,1468,17,2407,4777
175.645,17,4,240,2,32,175644,32,120,2,32,175644,32,120
320.46,6,17,6456,4,154,106820,267,632,13,529,2716,1460,5824
5.023,17,4,558,2,36,5012,36,128,2,187,5012,187,430
1741.757,6,87,6322,58,31,30557,31,3915,29,31,62205,31,2407
0.516,1,10,840,10,56,57,56,840,0,0,0,0,0
471.531,6,52,6807,29,98,16840,722,2881,23,209,21425,2329,3926
3.924,17,5,295,5,31,981,31,295,0,0,0,0,0
300.653,6,39,8618,20,315,15823,882,2105,19,441,491,1440,6513
280.221,6,24,7054,11,181,28022,267,1168,13,670,23347,2036,5886
8.767,17,4,1344,4,308,2922,308,1344,0,0,0,0,0
15.022,6,7,603,5,105,3754,105,519,2,0,15015,0,84
1.239,6,48,20940,28,947,45,1360,15364,20,433,56,1360,5576
12.438,6,2462,2242440,1475,1432,8,1448,2180276,987,776,12,1448,62164
270.325,1,6,336,6,28,54065,28,336,0,0,0,0,0
1780.511,1,162,9072,162,28,11059,28,9072,0,0,0,0,0
76.285,17,10,880,5,48,19069,48,380,5,72,19069,72,500
1749.171,6,96,7286,63,38,28212,205,4476,33,33,54651,98,2810
0.087,17,2,217,1,50,0,50,78,1,111,0,111,139
300.887,6,22,9387,13,389,25060,1221,2110,9,1381,37590,3639,7277
377.209,6,49,8838,23,114,17144,267,2189,26,400,15086,3457,6649
1746.462,6,91,6623,60,31,29601,31,4050,31,31,58202,31,2573
189.138,17,4,768,2,32,189133,32,120,2,296,189133,296,648
0.529,6,13,3922,8,273,75,517,971,5,1341,120,1418,2951
1788.543,17,256,51340,256,172,7013,356,51340,0,0,0,0,0
1791.701,17,144,11520,72,48,25234,48,5472,72,56,25234,56,6048
1798.756,6,365,24563,213,88,8484,469,14067,152,69,11910,69,10496
300.74,6,25,8124,13,441,25061,1178,2450,12,630,5606,1571,5674
303.401,6,30,10412,15,504,21671,1002,3308,15,631,2615,1440,7104
0.081,6,8,458,5,106,11,106,322,3,0,22,0,136
280.06,6,30,7432,13,158,23338,267,1317,17,543,17500,1400,6115
1.266,6,24,8004,12,164,97,267,1288,12,1014,97,2804,6716
1799.988,17,450,39960,405,35,4455,288,25740,45,288,40020,288,14220
0.043,17,2,136,1,32,0,32,60,1,48,0,48,76
1700.599,17,13,534,11,14,170042,14,462,2,8,1700420,8,72
137.416,17,4,377,2,33,137269,37,123,2,99,137400,136,254
75.829,6,33,7693,12,155,29,267,1266,21,348,3791,1420,6427
0.166,6,39,15424,22,962,7,1420,10523,17,467,9,1883,4901
504.687,2,5,160,5,8,126171,8,160,0,0,0,0,0
165.19,6,21,2557,12,324,15017,585,1281,9,396,20625,580,1276
14.438,17,3,838,3,251,7219,362,838,0,0,0,0,0
0.006,17,2,393,1,33,0,33,61,1,304,0,304,332
4.831,6,35,6209,18,206,284,314,2784,17,456,285,1152,3425
1774.127,6,184,15916,120,69,14908,69,8940,64,69,28152,69,6976
1.186,6,31,6044,16,111,79,267,1539,15,780,75,1460,4505
1772.359,1,56,4704,56,56,32224,56,4704,0,0,0,0,0
257.666,6,52,8081,23,289,11710,1056,4385,29,167,9200,580,3696
1770.639,6,104,9648,68,65,26427,65,5758,36,59,50587,59,3890
0.91,6,11,1727,7,100,151,100,384,4,589,221,1152,1343
20.143,6,20,3130,11,183,2014,517,1509,9,381,2516,499,1621
1779.236,6,141,14408,87,77,20688,722,7699,54,84,33565,1408,6709
3.753,6,53,15327,28,731,139,1460,9231,25,361,141,1460,6096
0.01,17,2,201,1,40,0,40,68,1,105,0,105,133
1776.458,17,142,11360,71,48,25377,48,5396,71,56,25377,56,5964
2.835,6,14,1845,7,229,360,597,1039,7,147,404,346,806
1786.57,6,102,8364,68,66,26665,66,4964,34,60,54135,60,3400
0.312,6,22,4442,11,165,31,456,1394,11,493,29,888,3048
1789.337,6,130,15384,81,90,22366,502,6763,49,162,37275,1420,8621
280.483,6,31,7813,14,158,21575,267,1357,17,577,17528,2036,6456
300.719,6,41,8772,21,315,15035,882,2157,20,386,447,1460,6615
280.321,6,30,7432,13,158,23360,267,1317,17,543,17519,1300,6115
331.98,6,8,475,6,31,66396,31,333,2,31,299590,31,142
1792.493,1,230,12880,230,28,7827,28,12880,0,0,0,0,0
408.66,1,12,672,12,28,37150,28,672,0,0,0,0,0
241.783,6,108,76333,42,563,5889,1418,6699,66,1248,3715,1418,69634
319.168,6,9,522,2,106,319157,106,194,7,0,53192,0,328
0.78,6,11,1727,7,100,130,100,384,4,589,174,1152,1343
1791.724,1,58,4872,0,0,0,0,0,58,56,31433,56,4872
1745.195,6,96,7286,63,38,28148,205,4476,33,33,54531,98,2810
1773.806,6,180,15480,120,69,14905,69,8940,60,69,30057,69,6540
33.811,17,4,244,2,33,33809,33,122,2,33,33810,33,122
0.071,17,2,214,1,39,0,39,67,1,119,0,119,147
0.446,6,23,6001,12,108,40,147,919,11,927,41,1608,5082
235.161,6,30,8872,14,158,18089,267,1357,16,763,15675,2045,7515
17.365,6,11,2033,7,326,2894,589,1025,4,396,24,580,1008
1795.078,17,80,3354,79,14,23013,14,3318,1,8,0,8,36
290.22,6,35,4113,16,237,19347,585,1577,19,256,16122,580,2536
6.271,6,45,8409,23,227,285,314,4102,22,489,287,1179,4307
95.735,6,12,1055,6,332,19146,332,652,6,83,19146,83,403
0.023,17,2,198,1,39,0,39,67,1,103,0,103,131
1681.367,17,14,3799,7,30,280226,30,406,7,456,280226,463,3393
1700.594,17,13,534,11,14,170041,14,462,2,8,1700418,8,72
113.317,6,149,145538,108,877,25,1360,14006,41,3935,2829,31280,131532
1744.424,6,95,7203,63,38,28135,205,4476,32,33,56263,98,2727
251.904,2,3,96,3,8,125952,8,96,0,0,0,0,0
54.488,6,28,7217,13,155,4540,267,1306,15,482,3891,1420,5911
1798.069,17,450,39960,405,35,4450,288,25740,45,288,40019,288,14220
1.196,17,3,1170,3,362,598,362,1170,0,0,0,0,0
2.186,17,2,685,1,308,0,308,336,1,321,0,321,349
384.307,17,6,360,3,32,192153,32,180,3,32,192153,32,180
58.197,6,21,8664,5,106,13,106,314,16,550,3879,1420,8350
0.987,17,3,286,2,46,980,46,148,1,110,0,110,138
1779.703,17,140,11200,70,48,25792,48,5320,70,56,25792,56,5880
1779.61,6,354,22440,207,69,8638,69,12420,147,69,12188,69,10020
0.01,17,2,444,1,39,0,39,67,1,349,0,349,377
4.111,17,5,4317,2,720,4111,1350,1497,3,912,709,1350,2820
0.005,17,4,809,2,33,0,33,122,2,315,0,327,687
560.525,17,6,444,3,30,280256,30,174,3,62,280257,62,270
280.239,6,28,7352,12,158,25476,267,1277,16,543,18680,1400,6075
1784.769,1,242,13552,242,28,7405,28,13552,0,0,0,0,0
1773.395,6,181,15589,120,69,14902,69,8940,61,69,29549,69,6649
2.061,17,3,215,2,33,2000,33,122,1,65,0,65,93
1751.945,6,96,7286,63,38,28257,205,4476,33,33,54734,98,2810
1795.792,17,518,163265,518,287,3473,422,163265,0,0,0,0,0
1.185,6,23,7952,12,164,91,267,1288,11,1216,100,3825,6664
0.303,6,22,4442,11,165,30,456,1394,11,493,28,888,3048
0.044,6,11,912,6,181,8,181,489,5,77,6,134,423
1792.329,1,210,11760,210,28,8575,28,11760,0,0,0,0,0
1765.606,17,168,14022,156,30,11390,37,9090,12,383,154995,463,4932
1797.078,6,400,50210,198,172,9121,721,35562,202,163,8939,1420,14648
0.146,6,44,21070,26,1076,5,1420,16129,18,467,7,1883,4941
1767.888,1,201,11256,201,28,8839,28,11256,0,0,0,0,0
1778.709,6,106,8456,68,65,26547,65,4930,38,59,48070,59,3526
31.581,6,8,348,2,0,16,0,84,6,0,6314,0,264
389.966,6,18,1242,14,180,29997,180,916,4,110,20062,110,326
8.663,2,2,64,2,8,8663,8,64,0,0,0,0,0
126.042,6,81,24707,36,971,1326,1360,14209,45,287,2860,1360,10498
1799.954,6,221,25442,85,180,21088,1360,16924,136,47,13331,142,8518
0.381,6,12,1653,6,288,75,288,548,6,426,40,434,1105
5.722,6,16,3262,9,210,715,210,908,7,664,953,904,2354
0.372,6,21,7203,12,318,33,600,1906,9,964,45,1891,5297
0.299,17,4,588,2,48,289,48,152,2,190,287,308,436
0.292,6,2,100,1,0,0,0,60,1,0,0,0,40
150.413,6,163,25248,86,304,1769,304,17404,77,83,1965,83,7844
862.693,17,162,12312,162,48,5358,48,12312,0,0,0,0,0
192.854,6,19,8104,4,202,9145,241,766,15,612,13775,958,7338
2.508,6,13,2311,8,188,358,245,700,5,1407,562,1407,1611
0.052,6,9,1002,5,213,13,213,417,4,421,14,421,585
10.408,6,10,436,4,0,3469,0,172,6,0,2038,0,264
1789.713,17,144,11520,72,48,25207,48,5472,72,56,25206,56,6048
860.651,6,216,23599,119,167,7293,1189,11619,97,179,8964,1926,11980
62.606,6,19,772,10,0,6955,0,404,9,0,7824,0,368
16.92,6,13,5668,4,106,5640,106,274,9,718,2111,1460,5394
4.494,6,13,5941,3,189,2240,267,507,10,718,498,1460,5434
322.296,6,29,6448,11,139,32229,159,1150,18,873,18958,1668,5298
293.193,17,6,528,3,60,146596,60,264,3,60,146596,60,264
1778.94,17,73,3060,72,14,25055,14,3024,1,8,0,8,36
62.974,6,47,11611,21,350,3148,1189,4349,26,414,2518,1420,7262
1776.788,6,106,8388,68,64,26519,64,4896,38,58,48019,58,3492
0.105,17,3,634,2,32,98,32,120,1,486,0,486,514
0.013,17,2,425,1,46,0,46,74,1,323,0,323,351
1796.807,17,449,39928,404,35,4458,288,25708,45,288,40018,288,14220
0.822,6,51,13829,24,551,35,1429,4840,27,464,30,1986,8989
1.359,17,20,12786,10,571,151,1350,5997,10,650,127,1350,6789
244.077,17,2,672,2,308,244077,308,672,0,0,0,0,0
1784.485,6,102,8296,68,65,26634,65,4930,34,59,54072,59,3366
273.467,1,4,326,4,53,91155,78,326,0,0,0,0,0
0.0,6,1,450,1,398,0,398,450,0,0,0,0,0
1740.412,17,30,31680,30,1028,60014,1028,31680,0,0,0,0,0
1773.29,6,180,15480,120,69,14901,69,8940,60,69,30050,69,6540
1747.127,6,97,7338,64,38,27732,205,4528,33,33,54585,98,2810
8.58,6,18,1851,9,222,1068,222,1252,9,231,1068,231,599
9.137,17,3,942,3,286,4568,286,942,0,0,0,0,0
280.022,6,26,7272,12,158,25456,267,1277,14,775,21537,2800,5995
560.413,17,6,1647,3,30,280203,30,174,3,463,280204,463,1473
164.015,17,7,532,7,48,27335,48,532,0,0,0,0,0
1744.689,2,18,576,18,8,102628,8,576,0,0,0,0,0
86.516,6,23,10581,11,367,65,783,1574,12,1064,7852,1460,9007
118.481,6,21,8279,11,525,89,1237,2048,10,969,13145,1791,6231
1740.558,17,27,6345,27,207,66944,207,6345,0,0,0,0,0
0.095,6,12,1941,7,210,15,210,582,5,545,22,905,1359
90.704,6,28,8792,13,158,7558,267,1317,15,858,6476,2800,7475
1795.262,1,50,2800,50,28,36638,28,2800,0,0,0,0,0
0.06,6,10,1495,5,507,15,507,727,5,556,15,556,768
1787.118,6,106,8456,68,65,26673,65,4930,38,59,48296,59,3526
59.165,17,3,1008,3,308,29582,308,1008,0,0,0,0,0
121.199,17,4,352,2,60,121198,60,176,2,60,121198,60,176
11.971,6,16,1402,8,275,1710,275,878,8,96,1145,96,524
33.757,6,31,5094,15,154,2411,722,1860,16,342,2236,1448,3234
1779.97,17,142,11360,71,48,25427,48,5396,71,56,25427,56,5964
1769.861,1,158,8848,158,28,11273,28,8848,0,0,0,0,0
1793.643,1,345,28980,345,56,5214,56,28980,0,0,0,0,0
23.21,6,33,8095,17,188,1450,721,2002,16,681,1534,2840,6093
1791.623,17,323,51714,323,132,5564,357,51714,0,0,0,0,0
295.052,1,4,224,4,28,98350,28,224,0,0,0,0,0
2.992,17,3,174,3,30,1496,30,174,0,0,0,0,0
15.412,6,48,14829,21,375,770,1360,3916,27,612,556,1360,10913
1773.618,17,140,11200,70,48,25704,48,5320,70,56,25704,56,5880
377.569,6,17,2617,16,275,25171,275,2573,1,0,0,0,44
68.512,17,4,352,2,60,68511,60,176,2,60,68511,60,176
1792.065,1,256,14336,256,28,7027,28,14336,0,0,0,0,0
300.996,6,19,1279,6,177,60164,177,497,13,110,25068,110,782
1741.095,1,61,5124,61,56,29018,56,5124,0,0,0,0,0
15.12,6,27,7177,12,155,1374,267,1266,15,482,1079,1420,5911
4.889,17,2,690,2,317,4889,317,690,0,0,0,0,0
1789.235,17,87,3648,86,14,21049,14,3612,1,8,0,8,36
34.475,6,90,27405,42,554,840,1152,20535,48,411,728,1179,6870
1.127,6,22,5040,11,137,112,267,1132,11,692,102,1467,3908
0.064,6,36,61545,20,280,3,517,1890,16,4901,3,16896,59655
72.44,6,7,280,7,0,0,0,280,0,0,0,0,0
372.41,6,27,1767,18,177,21906,177,1181,9,110,8849,110,586
222.586,6,25,6339,9,272,238,516,1180,16,347,14832,1452,5159
10.689,6,1683,1476600,1034,1376,10,1420,1446419,649,467,16,1883,30181
0.783,17,3,1170,3,362,391,362,1170,0,0,0,0,0
20.755,6,15,6261,5,275,5188,275,479,10,895,1971,1440,5782
5.376,6,40,7309,22,218,256,314,3503,18,513,299,1179,3806
1791.997,6,380,24101,217,69,8296,69,13441,163,69,11061,69,10660
88.816,6,23,10009,12,531,67,1360,2637,11,1384,8866,3934,7372
0.37,6,23,7271,11,257,36,748,1611,12,838,32,1418,5660
0.118,6,10,1669,6,551,23,947,1346,4,159,39,159,323
4.015,17,4,352,2,48,4006,48,152,2,72,4006,72,200
1787.2,6,103,8395,68,65,26674,65,4930,35,59,52561,59,3465
0.042,17,2,180,1,30,0,30,58,1,94,0,94,122
16.771,17,19,10968,11,778,1673,1350,8874,8,233,2391,1350,2094
1787.908,6,364,23047,211,69,8513,69,12787,153,69,11762,69,10260
1.209,17,3,2906,3,940,604,1451,2906,0,0,0,0,0
5.706,6,40,7309,20,218,300,314,3423,20,513,285,1179,3886
1659.768,1,7,392,7,28,276628,28,392,0,0,0,0,0
288.301,6,30,8914,11,181,28830,267,1168,19,498,16013,1400,7746
250.699,6,31,8912,14,158,19284,267,1357,17,687,15666,1400,7555
30.854,17,18,1368,18,48,1814,48,1368,0,0,0,0,0
1788.461,6,108,7251,67,56,27097,208,4650,41,31,44699,31,2601
10.757,6,11,3009,4,92,3585,92,296,7,2329,1670,2329,2713
1.364,6,48,18925,26,938,54,1460,13269,22,433,55,1460,5656
1795.535,6,367,25650,214,99,8429,469,15045,153,69,11810,69,10605
34.814,6,31,7911,18,129,2047,159,1863,13,670,2900,1418,6048
81.315,6,25,1028,12,0,5081,0,488,13,0,6774,0,540
8.443,6,1603,1477678,1018,1374,8,1408,1442594,585,931,14,2801,35084
0.118,17,2,279,1,36,0,36,64,1,187,0,187,215
36.603,1,31,3224,0,0,0,0,0,31,76,1220,76,3224
0.252,1,2,112,2,28,252,28,112,0,0,0,0,0
0.124,17,2,410,1,46,0,46,74,1,308,0,308,336
0.005,17,2,383,1,43,0,43,71,1,284,0,284,312
0.036,6,10,1514,5,503,9,503,771,5,475,9,475,743
0.971,6,34,6823,18,182,57,537,2036,16,491,61,1542,4787
113.907,6,957,497150,555,839,205,1152,476279,402,398,283,1152,20871
0.076,17,2,650,1,308,0,308,336,1,286,0,286,314
5.016,17,4,542,2,36,5002,36,128,2,179,5000,187,414
1785.863,6,363,25352,211,100,8504,469,14856,152,69,11826,69,10496
280.084,6,28,7352,13,158,23340,267,1317,15,678,20000,2800,6035
72.977,1,3,168,3,28,36488,28,168,0,0,0,0,0
1660.115,6,126,12762,77,70,21843,722,6598,49,95,34581,1448,6164
1771.06,6,104,9716,68,66,26433,66,5792,36,60,50599,60,3924
0.867,6,53,23782,30,1019,29,1380,18584,23,421,37,1923,5198
3.776,17,34,25727,11,385,377,1350,4548,23,892,163,1350,21179
1771.001,6,100,9292,66,65,27246,65,5577,34,59,53663,59,3715
51.417,17,33,9807,16,317,3425,1350,5531,17,223,3211,1350,4276
89.928,6,849,418466,465,836,193,1152,396919,384,412,234,1179,21547
1771.393,6,99,9240,66,65,27252,65,5577,33,59,55353,59,3663
0.178,17,4,284,2,32,0,32,120,2,54,1,60,164
1776.294,17,142,11360,71,48,25375,48,5396,71,56,25375,56,5964
57.103,6,26,7137,13,155,4758,267,1306,13,589,4758,4837,5831
13.808,17,5,4754,5,922,3452,1451,4754,0,0,0,0,0
173.641,6,57,51351,28,747,39,1360,4143,29,2001,6197,5440,47208
1.733,6,25,8753,15,283,123,582,1454,10,985,172,1420,7299
1782.837,6,419,25109,209,69,8571,69,12500,210,34,8530,64,12609
0.294,17,2,144,1,36,0,36,64,1,52,0,52,80
1756.382,6,95,7203,63,38,28328,205,4476,32,33,56647,98,2727
8.173,6,77,24850,39,568,215,1152,19189,38,459,213,1179,5661
1775.73,17,142,11360,71,48,25366,48,5396,71,56,25366,56,5964
1744.47,6,100,7729,66,42,26838,205,4786,34,34,52854,98,2943
92.051,6,38,11237,18,343,5414,1283,3016,20,512,4835,1593,8221
99.195,6,43,13687,23,891,4501,1460,8085,20,399,5212,1460,5602
1791.513,6,183,15738,122,69,14805,69,9089,61,69,29849,69,6649
1.273,6,46,14764,24,737,55,1360,9108,22,433,52,1360,5656
34.56,6,45,8817,22,345,552,720,2019,23,391,1563,2720,6798
1789.308,17,144,11520,72,48,25201,48,5472,72,56,25201,56,6048
1796.875,1,58,4872,58,56,31524,56,4872,0,0,0,0,0
0.052,17,4,240,2,32,0,32,120,2,32,30,32,120
1784.319,17,138,11040,69,48,26239,48,5244,69,56,26239,56,5796
8.292,6,17,6591,9,275,1036,275,643,8,1404,1148,2760,5948
1.355,6,49,19309,27,895,52,1440,13653,22,433,55,1440,5656
1797.443,1,58,4872,58,56,31534,56,4872,0,0,0,0,0
1786.334,6,389,34375,218,119,8231,1189,17180,171,134,10507,3466,17195
0.322,17,2,152,1,48,0,48,76,1,48,0,48,76
1796.729,17,449,39928,404,35,4458,288,25708,45,288,40020,288,14220
1720.552,17,12,498,11,14,172055,14,462,1,8,0,8,36
0.496,6,50,20475,28,945,18,1380,15353,22,421,21,1923,5122
1.225,6,8,342,4,0,408,0,164,4,7,266,7,178
15.697,17,16,5188,7,354,2602,1350,2680,9,250,1956,1350,2508
1.182,6,24,8004,12,164,91,267,1288,12,1014,91,2411,6716
1798.142,1,29,3074,29,78,64219,78,3074,0,0,0,0,0
149.594,6,4107,4324431,1084,327,138,327,56823,3023,1479,49,4188,4267608
1794.283,6,365,25570,213,99,8463,469,15005,152,69,11880,69,10565
0.179,6,43,17338,24,948,7,1420,12357,19,467,9,1883,4981
1798.394,17,450,39960,405,35,4451,288,25740,45,288,40022,288,14220
66.362,6,24,10043,12,653,74,1360,3126,12,1070,6016,2720,6917
1799.36,6,344,31814,189,102,9571,469,15038,155,120,11682,1452,16776
23.244,6,33,8097,16,188,1549,721,1964,17,681,1440,2840,6133
0.121,17,2,196,1,62,0,62,90,1,78,0,78,106
1772.772,6,180,15480,120,69,14897,69,8940,60,69,30044,69,6540
1791.702,6,246,25206,99,67,18281,681,9362,147,136,12271,2720,15844
145.66,17,3,1000,3,305,72830,308,1000,0,0,0,0,0
269.981,6,28,7352,13,158,22498,267,1317,15,603,19283,2036,6035
109.206,17,4,352,2,60,109204,60,176,2,60,109205,60,176
0.35,17,4,724,2,32,346,32,120,2,274,44,274,604
1751.562,6,95,7203,63,38,28251,205,4476,32,33,56491,98,2727
1787.766,6,102,8296,68,65,26683,65,4930,34,59,54167,59,3366
6.57,6,41,7365,21,218,328,314,3463,20,516,331,1179,3902
191.387,6,173,136975,111,1287,1739,1408,124236,62,731,1870,3847,12739
1746.302,6,98,7390,63,38,28166,205,4476,35,33,51351,98,2914
1764.429,17,168,14126,156,30,11383,37,9090,12,391,154793,463,5036
251.612,6,23,5831,7,150,102,174,584,16,328,16768,1420,5247
159.674,17,4,352,2,60,159673,60,176,2,60,159673,60,176
322.92,6,32475,30488472,12798,159,25,283,781636,19677,1458,13,5752,29706836
0.006,17,2,399,1,34,0,34,62,1,309,0,309,337
0.023,17,3,1007,1,137,0,137,165,2,393,22,393,842
7.108,6,5,240,1,0,0,0,48,4,0,2365,0,192
0.016,6,4,224,2,0,2,0,112,2,0,15,0,112
0.088,17,2,2384,2,1164,88,1164,2384,0,0,0,0,0
1798.596,6,379,26475,218,98,8288,469,15412,161,69,11239,69,11063
78.016,17,4,352,2,60,78015,60,176,2,60,78015,60,176
0.427,6,22,7255,13,318,35,600,1958,9,964,50,1471,5297
1769.689,6,99,9240,66,65,27225,65,5577,33,59,55298,59,3663
20.466,6,20,3130,12,183,1860,517,1561,8,381,2921,499,1569
0.039,17,6,912,3,60,13,60,264,3,188,15,188,648
537.038,1,28,1568,28,28,19890,28,1568,0,0,0,0,0
0.008,17,2,487,1,40,0,40,68,1,391,0,391,419
65.584,6,39,11055,20,526,3442,1360,4004,19,570,3633,1360,7051
0.086,17,4,365,3,32,2,32,180,1,157,0,157,185
1.758,6,13,2311,8,188,251,245,700,5,1407,369,1407,1611
886.275,1,8,448,8,28,126610,28,448,0,0,0,0,0
1790.436,6,356,22520,208,69,8649,69,12460,148,69,12179,69,10060
280.232,6,28,7352,13,158,23352,267,1317,15,678,20015,3436,6035
49.502,2,4,128,4,8,16500,8,128,0,0,0,0,0
0.166,6,43,19443,25,1037,6,1414,14502,18,467,9,1889,4941
5.007,17,4,558,2,36,5002,36,128,2,187,4996,187,430
0.451,6,9,1340,5,145,112,145,349,4,827,147,827,991
0.013,17,2,180,1,30,0,30,58,1,94,0,94,122
1.101,17,8,672,4,34,365,34,248,4,78,365,84,424
2.83,6,33,12741,16,766,188,1360,6039,17,1001,168,1569,6702
0.247,6,9,1339,5,145,61,145,349,4,826,53,826,990
0.618,17,2,180,1,30,0,30,58,1,94,0,94,122
1699.485,17,12,498,11,14,169948,14,462,1,8,0,8,36
3.532,6,6,1276,4,241,1177,722,1172,2,0,165,0,104
154.226,6,15,612,5,0,6077,0,204,10,0,17135,0,408
49.358,6,21,4560,12,161,4487,722,1759,9,579,1786,1448,2801
7.174,6,1295,1146045,790,1371,8,1408,1115121,505,931,13,2801,30924
240.208,6,65,21069,31,806,8006,1418,17746,34,193,7278,580,3323
241.376,6,33,6335,15,167,17240,517,1790,18,598,14198,1418,4545
130.183,6,26,13387,13,541,58,1360,2728,13,1446,10838,3934,10659
1786.395,6,102,8364,68,66,26662,66,4964,34,60,54130,60,3400
61.691,6,71,43182,40,1168,1581,1448,34817,31,749,2048,1448,8365
280.278,6,30,7432,13,158,23356,267,1317,17,543,17511,1400,6115
0.073,17,2,362,1,32,0,32,60,1,274,0,274,302
5.57,6,37,7205,19,218,309,314,3383,18,516,312,1179,3822
100.121,17,4,558,2,36,100108,36,128,2,187,100108,187,430
1798.595,17,448,39896,403,35,4474,288,25676,45,288,40020,288,14220
10.791,17,15,17706,15,1152,770,1449,17706,0,0,0,0,0
0.083,6,9,1348,5,145,20,145,349,4,835,25,835,999
0.037,6,10,1514,5,503,9,503,771,5,475,9,475,743
29.432,6,26,6777,12,133,2675,159,1059,14,707,2223,1418,5718
1720.505,17,12,498,11,14,172050,14,462,1,8,0,8,36
1169.884,17,26,2167,13,31,97487,37,775,13,79,97487,136,1392
1.407,6,38,9848,21,440,70,1360,4392,17,476,75,2715,5456
10.858,17,15,17678,15,1150,775,1451,17678,0,0,0,0,0
8.02,6,26,6813,9,138,1002,267,931,17,518,499,1420,5882
0.104,17,2,776,2,360,104,360,776,0,0,0,0,0
4.412,6,36,6249,19,206,245,314,2824,17,548,256,1179,3425
0.345,17,8,2766,8,317,49,356,2766,0,0,0,0,0
1793.356,17,518,61379,234,156,7696,1350,43275,284,35,6336,1350,18104
1788.077,6,365,23087,211,69,8514,69,12787,154,69,11686,69,10300
3.553,6,35,6209,17,206,222,314,2744,18,456,194,1152,3465
1787.35,6,104,8376,68,65,26676,65,4930,36,59,51063,59,3446
0.026,6,4,208,2,0,3,0,104,2,0,0,0,104
2.65,6,5775,6796555,1756,151,1,285,103540,4019,1614,0,12942,6693015
0.029,17,2,237,1,72,0,72,100,1,109,0,109,137
4.423,6,38,7229,19,218,245,314,3383,19,513,231,1179,3846
0.922,6,11,1727,7,100,153,100,384,4,589,219,1152,1343
0.322,17,2,154,1,33,0,33,61,1,65,0,65,93
4.011,17,8,848,4,46,1333,46,296,4,110,1333,110,552
202.457,17,10,3328,10,304,22495,308,3328,0,0,0,0,0
374.093,6,18,1239,14,177,28776,177,913,4,110,20060,110,326
1.171,17,3,238,2,30,1167,30,116,1,94,0,94,122
14.428,6,9,874,4,304,4806,304,512,5,102,3604,102,362
1.404,6,47,19254,28,897,52,1360,13718,19,476,67,2715,5536
1784.802,6,359,22778,208,69,8622,69,12529,151,69,11898,69,10249
10.802,6,20,4442,11,275,1080,275,998,9,768,753,1440,3444
1797.711,1,345,28980,345,56,5225,56,28980,0,0,0,0,0
72.288,6,29,8740,13,258,72,486,1327,16,676,4809,4421,7413
1787.094,6,690,121665,440,304,4070,304,89376,250,83,7176,83,32289
1783.703,6,146,8851,79,41,22867,208,5210,67,31,27019,31,3641
1.253,6,705,758012,208,346,6,356,12197,497,1454,2,2896,745815
280.471,6,27,7312,12,158,25497,267,1277,15,678,20028,2760,6035
1741.325,6,90,6521,59,31,30022,31,3998,31,31,58043,31,2523
0.052,17,2,198,1,37,0,37,65,1,105,0,105,133
2.0,17,3,180,3,32,1000,32,180,0,0,0,0,0
3.95,17,2,116,2,30,3950,30,116,0,0,0,0,0
1744.629,2,27,864,27,8,67101,8,864,0,0,0,0,0
0.043,1,2,112,2,28,43,28,112,0,0,0,0,0
34.941,6,35,6129,17,154,2183,722,1975,18,357,2044,2026,4154
289.681,1,4,224,4,28,96560,28,224,0,0,0,0,0
19.895,6,9,520,3,0,9947,0,160,6,0,3156,0,360
240.151,6,30,7432,13,158,20012,267,1317,17,543,15003,1400,6115
8.537,17,16,7383,8,585,1214,1350,4907,8,281,1214,1350,2476
0.002,6,2,632,1,0,0,0,40,1,552,0,552,592
1720.659,17,13,534,11,14,172048,14,462,2,8,1720482,8,72
1790.733,6,358,23021,209,69,8609,69,12500,149,74,12099,421,10521
1779.803,17,136,10880,68,48,26564,48,5168,68,56,26564,56,5712
1785.785,17,140,11200,70,48,25880,48,5320,70,56,25880,56,5880
1763.62,2,15,480,15,8,125972,8,480,0,0,0,0,0
1.428,6,7,295,4,0,476,0,164,3,7,204,7,131
4.656,17,5,320,5,36,1164,36,320,0,0,0,0,0
16.585,17,23,6864,11,358,1657,1350,4248,12,190,1504,1350,2616
0.242,17,2,384,1,39,0,39,67,1,289,0,289,317
1791.797,17,29,9512,29,300,63992,300,9512,0,0,0,0,0
1797.413,1,345,28980,345,56,5225,56,28980,0,0,0,0,0
1741.387,6,87,6322,58,31,30550,31,3915,29,31,62192,31,2407
405.2,17,12,4032,12,308,36836,308,4032,0,0,0,0,0
1.636,17,2,178,1,29,0,29,57,1,93,0,93,121
27.253,6,3640,3402423,2298,1400,11,1448,3327963,1342,776,20,1448,74460
0.126,17,2,588,1,39,0,39,67,1,493,0,493,521
1797.282,1,276,15456,276,28,6535,28,15456,0,0,0,0,0
1771.983,6,180,15480,120,69,14890,69,8940,60,69,30031,69,6540
147.222,6,20,2592,11,304,14722,304,1784,9,83,18401,83,808
1680.715,1,12,696,12,30,152792,30,696,0,0,0,0,0
364.684,6,25,1651,17,177,22792,177,1117,8,110,9158,110,534
62.83,2,2,64,2,8,62830,8,64,0,0,0,0,0
68.067,6,45,10813,17,257,4254,1189,3275,28,426,2519,1460,7538
1739.279,6,96,6262,60,47,29479,208,3923,36,31,49683,31,2339
0.208,17,2,152,1,48,0,48,76,1,48,0,48,76
7.658,17,457,504617,92,107,84,1350,12456,365,1320,20,1350,492161
1771.464,6,99,9306,66,66,27253,66,5610,33,60,55355,60,3696
1.148,6,23,6542,13,339,95,1035,2222,10,979,126,1731,4320
240.353,6,46,9154,23,521,10924,1418,5908,23,204,10924,618,3246
8.402,6,23,10824,11,275,840,275,723,12,1201,743,1414,10101
0.132,17,2,372,1,34,0,34,62,1,282,0,282,310
1.519,6,50,20041,30,876,52,1360,14420,20,437,69,2715,5621
1.826,6,345,449877,116,162,15,230,6850,229,1907,7,8208,443027
2.502,17,3,543,2,39,984,39,134,1,381,0,381,409
0.018,17,2,279,1,36,0,36,64,1,187,0,187,215
285.189,6,44,3236,18,66,16766,328,1581,26,47,11407,78,1655
0.064,17,2,304,1,60,0,60,88,1,188,0,188,216
0.28,6,20,7238,12,335,24,668,1974,8,1210,39,1906,5264
1.066,17,15,8513,8,706,152,1350,5872,7,349,168,1350,2641
1787.364,1,73,6132,73,56,24824,56,6132,0,0,0,0,0
106.244,6,25,3721,13,302,8853,302,2484,12,83,9631,83,1237
11.015,6,18,5610,10,275,1223,275,958,8,1440,802,1440,4652
298.955,6,29,7392,13,158,24912,267,1317,16,603,19899,2036,6075
1780.153,1,342,28728,342,56,5220,56,28728,0,0,0,0,0
24.253,6,6,328,4,0,8084,0,216,2,0,24230,0,112
0.357,1,2,112,2,28,357,28,112,0,0,0,0,0
15.456,17,14,5632,7,451,2570,1350,3353,7,297,2570,1350,2279
89.51,6,24,10252,12,433,61,990,1823,12,992,8124,1360,8429
1.617,6,50,19364,29,892,57,1360,13703,21,400,70,1360,5661
0.521,6,22,5961,12,108,47,147,919,10,927,51,1608,5042
295.595,1,4,224,4,28,98531,28,224,0,0,0,0,0
1789.937,1,264,14784,264,28,6805,28,14784,0,0,0,0,0
3.345,17,5,290,5,30,836,30,290,0,0,0,0,0
808.004,6,108,8524,41,78,19449,337,4234,67,50,12242,143,4290
61.669,6,51,29729,31,1069,2055,1408,21942,20,962,3233,3847,7787
11.845,6,1734,1615154,1140,1365,10,1432,1587103,594,475,19,1871,28051
6.574,17,4,352,2,60,6573,60,176,2,60,6572,60,176
1796.783,6,356,22520,208,69,8680,69,12460,148,69,12222,69,10060
1728.598,17,118,23605,118,172,14774,422,23605,0,0,0,0,0
0.139,6,46,21977,27,1059,5,1420,16996,19,467,7,1883,4981
195.999,6,21,6506,6,154,39199,267,712,15,518,13998,1420,5794
840.795,17,8,592,4,30,280261,30,232,4,62,280260,62,360
721.894,2,9,288,9,8,90236,8,288,0,0,0,0,0
506.945,6,131,18638,56,211,7766,1189,7526,75,155,6850,2006,11112
170.312,6,6,1255,4,327,56770,413,814,2,180,170125,269,441
3.054,17,3,1173,3,363,1527,363,1173,0,0,0,0,0
1686.758,1,7,392,7,28,281126,28,392,0,0,0,0,0
615.724,17,9,972,9,80,76965,352,972,0,0,0,0,0
1333.455,6,75,5822,45,41,27266,205,3261,30,33,45975,98,2561
0.566,17,2,672,2,308,566,308,672,0,0,0,0,0
0.014,6,12,3462,6,75,2,75,395,6,1373,2,1448,3067
1789.988,6,364,23047,210,69,8564,69,12747,154,69,11696,69,10300
8.212,17,6,528,3,48,4099,48,228,3,72,4099,72,300
10.735,17,74,89213,71,1226,79,1472,89093,3,12,5221,12,120
1789.958,6,364,25392,212,100,8483,469,14896,152,69,11853,69,10496
0.12,17,2,396,1,39,0,39,67,1,301,0,301,329
270.229,1,7,392,7,28,45038,28,392,0,0,0,0,0
0.195,6,46,20804,26,1051,7,1420,15783,20,467,9,1883,5021
1770.105,6,101,9344,66,65,27232,65,5577,35,59,52058,59,3767
300.37,6,110,181304,75,162,4059,230,4706,35,5637,8834,18613,176598
0.005,6,3,120,2,0,5,0,80,1,0,0,0,40
240.212,6,50,15607,26,714,9608,1402,12784,24,195,10443,580,2823
0.057,17,2,904,1,300,0,300,328,1,548,0,548,576
1744.497,6,95,7203,63,38,28137,205,4476,32,33,56260,98,2727
0.966,17,5,1176,3,32,480,32,180,2,470,960,470,996
1768.766,6,125,12567,78,62,22970,721,6422,47,94,38443,2026,6145
432.186,17,8,2688,8,308,61740,308,2688,0,0,0,0,0
198.867,17,4,352,2,60,198866,60,176,2,60,198866,60,176
1.461,6,54,19515,29,892,52,1460,13694,25,400,53,1460,5821
1747.637,6,152,9476,81,48,21845,208,5737,71,31,24962,31,3739
12.153,17,10,2240,5,46,3035,46,370,5,346,3034,346,1870
0.18,6,33,17745,19,171,10,313,1742,14,1908,13,5632,16003
1789.267,17,142,11360,71,48,25560,48,5396,71,56,25560,56,5964
1796.936,17,449,39928,404,35,4458,288,25708,45,288,40017,288,14220
94.362,6,22,10186,11,304,79,597,1385,11,1192,9418,1460,8801
1719.633,17,12,498,11,14,171963,14,462,1,8,0,8,36
89.915,17,47,16456,19,445,4995,1350,8993,28,238,3328,1350,7463
1772.167,6,27,4077,18,241,104245,241,2889,9,92,221496,92,1188
1562.159,6,210,17748,81,74,19525,301,7840,129,70,12204,1062,9908
1763.827,17,276,43236,276,128,6413,357,43236,0,0,0,0,0
0.031,17,2,588,1,39,0,39,67,1,493,0,493,521
240.341,6,48,8698,25,449,10013,1418,5816,23,186,10924,580,2882
71.766,6,24,10054,13,532,69,1360,2682,11,1153,7158,2574,7372
757.101,1,26,2184,0,0,0,0,0,26,56,30284,56,2184
0.179,6,12,3462,6,75,35,75,395,6,1373,35,1448,3067
0.276,6,26,9019,13,252,23,647,1716,13,1103,22,2816,7303
61.359,6,39,17444,23,795,2789,1408,9206,16,739,4074,1408,8238
3.259,6,27,8969,16,372,217,850,1762,11,966,312,1452,7207
1785.556,17,87,3648,86,14,21006,14,3612,1,8,0,8,36
1790.654,17,142,11360,71,48,25580,48,5396,71,56,25580,56,5964
1.403,6,44,11555,23,616,63,1460,5894,21,400,61,1460,5661
1799.668,17,447,39580,403,35,4476,288,25676,44,288,40940,288,13904
1786.651,6,104,8444,68,66,26666,66,4964,36,60,51044,60,3480
1.669,6,14,2351,8,188,238,245,700,6,703,284,1152,1651
12.152,6,13,572,5,0,1446,0,220,8,0,1698,0,352
0.058,17,4,420,2,33,12,33,122,2,121,47,145,298
1787.904,6,362,22898,210,69,8554,69,12678,152,69,11839,69,10220
3.655,6,14,3179,9,49,456,92,599,5,772,59,2026,2580
60.993,17,4,304,4,48,20331,48,304,0,0,0,0,0
0.219,17,2,162,1,36,0,36,64,1,70,0,70,98
4.183,6,38,7229,19,218,232,314,3383,19,513,218,1179,3846
1.527,6,66,48144,41,1251,38,1408,40939,25,1179,56,3819,7205
381.057,6,18,1242,14,180,29312,180,916,4,110,20073,110,326
1342.166,6,49,13130,28,414,49709,1460,5722,21,437,67094,1460,7408
22.528,17,25,12813,14,712,1730,1350,10373,11,193,2249,1350,2440
60.251,6,19,10844,10,174,6694,174,578,9,1414,5258,1452,10266
0.502,6,20,7252,13,337,41,674,2032,7,1212,76,1946,5220
1786.219,17,87,3648,86,14,21014,14,3612,1,8,0,8,36
5.029,1,2,192,0,0,0,0,0,2,68,5029,68,192
1788.756,17,87,3648,86,14,21044,14,3612,1,8,0,8,36
1740.6,17,30,7050,30,207,60020,207,7050,0,0,0,0,0
24.251,6,27,7177,13,155,2020,267,1306,14,530,1864,3417,5871
1770.403,6,105,9486,66,64,27236,64,5544,39,58,46587,58,3942
1793.784,17,180,11520,180,36,10021,36,11520,0,0,0,0,0
0.013,17,2,469,1,45,0,45,73,1,368,0,368,396
1746.278,6,95,7203,63,38,28165,205,4476,32,33,56325,98,2727
3.902,17,5,295,5,31,975,31,295,0,0,0,0,0
0.106,17,2,2728,2,1336,106,1336,2728,0,0,0,0,0
0.4,6,10,968,5,256,95,256,460,5,304,96,304,508
7.5,6,1285,1172025,805,1379,9,1408,1142401,480,931,15,2801,29624
962.573,2,10,320,10,8,106952,8,320,0,0,0,0,0
1792.365,6,355,22549,206,69,8743,69,12380,149,69,12110,69,10169
0.025,17,2,656,1,300,0,300,328,1,300,0,300,328
1.364,6,38,8087,19,293,75,998,2551,19,433,65,1460,5536
821.095,2,7,224,7,8,136849,8,224,0,0,0,0,0
4.608,6,36,6249,19,206,256,314,2824,17,548,272,1179,3425
1.075,6,28,8160,15,222,64,540,1964,13,944,73,1591,6196
1781.428,1,58,4872,58,56,31253,56,4872,0,0,0,0,0
6.377,6,3,553,1,302,0,302,354,2,83,6377,83,199
103.615,6,21,8194,11,511,87,1194,2005,10,962,11493,1791,6189
23.13,6,3211,2839920,1965,1362,11,1408,2770452,1246,776,18,1408,69468
1384.005,6,274,17377,160,69,8704,69,9643,114,69,12247,69,7734
1799.921,17,449,39928,404,35,4466,288,25708,45,288,40017,288,14220
1.021,17,2,279,1,36,0,36,64,1,187,0,187,215
1773.129,6,180,15480,120,69,14900,69,8940,60,69,30050,69,6540
300.632,6,48,9053,24,280,13070,774,2184,24,327,677,1460,6869
1741.634,6,91,6604,59,31,30028,31,3998,32,31,56181,31,2606
24.6,6,11,5498,4,106,8200,106,274,7,987,4070,1452,5224
1125.135,6,146,11429,55,74,20833,336,5549,91,49,12501,143,5880
9.267,6,70,21790,35,576,272,1152,16963,35,427,264,1152,4827
242.737,6,46,5794,22,235,11558,752,2851,24,153,10553,631,2943
271.072,6,32,8263,13,158,22589,267,1317,19,515,15047,2036,6946
1.387,6,50,19375,27,897,53,1360,13679,23,433,54,1360,5696
98.387,6,24,10043,12,653,70,1360,3126,12,1070,8929,2235,6917
14.506,17,4,352,2,60,14505,60,176,2,60,14504,60,176
49.905,6,31,6895,11,205,993,293,2089,20,363,2613,1152,4806
1769.518,6,102,9461,67,65,26810,65,5694,35,59,52040,59,3767
8.228,6,1945,1799121,1232,1382,6,1408,1757381,713,931,11,2801,41740
1797.091,6,367,25650,214,99,8437,469,15045,153,69,11822,69,10605
1741.423,6,87,6322,58,31,30551,31,3915,29,31,62192,31,2407
253.943,6,2252,1133697,1237,847,205,1152,1081795,1015,376,250,1179,51902
277.412,1,10,280,10,0,0,0,280,0,0,0,0,0
18.754,17,4,824,2,48,18740,48,152,2,308,18740,308,672
247.459,6,14,1425,5,187,128,187,455,9,247,30905,462,970
0.124,17,2,586,1,46,0,46,74,1,484,0,484,512
193.898,17,8,568,4,32,64626,32,240,4,54,64626,60,328
882.314,2,8,256,8,8,126044,8,256,0,0,0,0,0
509.479,1,10,560,10,28,56608,28,560,0,0,0,0,0
1773.824,6,181,15589,120,69,14906,69,8940,61,69,29560,69,6649
240.188,6,53,17358,28,762,8895,1402,14434,25,202,10007,580,2924
0.068,17,2,283,1,31,0,31,59,1,196,0,196,224
3.709,6,27,8199,12,330,333,517,1966,15,777,261,1418,6233
1789.967,6,356,22520,208,69,8647,69,12460,148,69,12176,69,10060
0.384,6,10,968,5,256,92,256,460,5,304,92,304,508
0.428,6,10,1992,5,288,102,288,508,5,424,61,434,1484
5.775,6,45,8409,23,227,262,314,4102,22,427,263,1152,4307
1.666,6,2,142,1,0,0,0,40,1,62,0,62,102
5.656,6,40,7309,21,218,282,314,3463,19,513,299,1179,3846
262.159,6,14,728,14,0,0,0,728,0,0,0,0,0
1782.626,6,355,22549,206,69,8695,69,12380,149,69,12044,69,10169
0.263,6,2,100,1,0,0,0,60,1,0,0,0,40
1786.257,17,87,3648,86,14,21014,14,3612,1,8,0,8,36
1767.978,6,398,50700,199,152,8926,721,32332,199,241,8928,2391,18368
1776.894,6,429,70096,240,304,7434,304,49596,189,83,9451,83,20500
0.051,17,4,284,2,32,0,32,120,2,54,1,60,164
0.144,17,2,2384,2,1164,144,1164,2384,0,0,0,0,0
129.688,6,30,7432,13,158,10807,267,1317,17,543,8100,1400,6115
1774.455,6,180,15480,120,69,14911,69,8940,60,69,30070,69,6540
6.126,6,2040,1966665,1147,219,5,230,64691,893,2082,6,7040,1901974
0.072,17,2,182,1,37,0,37,65,1,89,0,89,117
1799.695,6,356,22520,208,69,8694,69,12460,148,69,12240,69,10060
0.43,6,20,7238,12,335,38,668,1974,8,1210,60,1906,5264
838.696,17,236,28992,108,155,7838,1350,19858,128,43,6598,1350,9134
1787.702,6,102,8296,68,65,26682,65,4930,34,59,54170,59,3366
3.851,17,2,690,2,317,3851,317,690,0,0,0,0,0
1787.904,6,355,22687,204,69,8807,69,12300,151,69,11919,69,10387
1633.032,1,7,392,7,28,272172,28,392,0,0,0,0,0
0.018,17,2,128,1,36,0,36,64,1,36,0,36,64
0.219,6,3,187,2,31,20,31,147,1,0,0,0,40
0.027,17,2,548,2,246,27,246,548,0,0,0,0,0
11.793,6,1865,1623805,1147,1363,10,1380,1590843,718,383,16,1380,32962
2.995,17,2,148,1,32,0,32,60,1,60,0,60,88
381.078,6,18,1242,14,180,29313,180,916,4,110,20064,110,326
272.932,1,10,560,10,28,30325,28,560,0,0,0,0,0
0.268,17,4,1327,4,303,89,354,1327,0,0,0,0,0
436.679,6,21,1813,8,66,23749,66,680,13,41,36381,60,1133
1799.205,17,759,45807,759,32,2373,37,45807,0,0,0,0,0
0.079,17,4,284,2,32,0,32,120,2,54,75,60,164
0.815,6,10,924,5,283,151,283,551,5,105,154,105,373
56.946,6,49,10455,23,533,705,910,3147,26,312,2272,1460,7308
0.924,2,2,80,2,16,924,16,80,0,0,0,0,0
37.735,17,22,1936,11,48,3772,48,836,11,72,3772,72,1100
1703.458,1,8,448,8,28,243351,28,448,0,0,0,0,0
425.872,2,4,128,4,8,141957,8,128,0,0,0,0,0
1786.507,6,102,8364,68,66,26664,66,4964,34,60,54133,60,3400
1082.891,6,239,17963,133,121,8203,469,10894,106,69,10313,69,7069
18.631,6,13,1209,4,283,6151,283,507,9,105,2306,105,702
0.468,6,20,7151,12,318,42,600,1906,8,1205,66,1891,5245
127.751,6,35,5314,21,180,6387,721,2182,14,342,1179,2026,3132
1791.271,17,496,61167,234,161,7687,1350,44348,262,36,6861,1350,16819
1798.987,1,58,4872,58,56,31561,56,4872,0,0,0,0,0
1799.123,17,449,39928,404,35,4464,288,25708,45,288,40018,288,14220
25.281,6,20,9701,7,211,4213,722,1416,13,1086,2084,1448,8285
3.586,17,5,290,5,30,896,30,290,0,0,0,0,0
1.409,6,47,19000,26,947,56,1460,13384,21,433,61,1460,5616
0.035,17,2,227,1,44,0,44,72,1,127,0,127,155
1787.463,6,104,8376,68,65,26678,65,4930,36,59,51066,59,3446
152.889,6,22,8450,11,313,67,632,1413,11,940,15276,1460,7037
63.301,6,20,8652,11,296,59,577,1360,9,1384,7896,3932,7292
1.369,6,49,20305,27,966,52,1460,14649,22,433,56,1460,5656
0.604,6,10,924,5,283,103,283,551,5,105,106,105,373
0.199,17,2,152,1,48,0,48,76,1,48,0,48,76
10.989,6,20,4442,11,275,1098,275,998,9,768,785,1440,3444
0.365,6,23,7394,13,335,29,668,2026,10,1210,39,1906,5368
29.408,17,6,1236,3,48,14667,48,228,3,308,14668,308,1008
1756.786,1,164,9184,164,28,10777,28,9184,0,0,0,0,0
1739.158,6,95,6910,62,31,28510,31,4209,33,31,54347,31,2701
0.135,17,4,284,2,32,0,32,120,2,54,116,60,164
35.56,6,51,17036,28,260,1311,723,3596,23,833,1610,1440,13440
265.937,1,3,168,3,28,132968,28,168,0,0,0,0,0
3.261,6,12,511,6,0,652,0,248,6,7,612,7,263
17.901,6,46,5883,21,222,894,222,4174,25,231,745,231,1709
1703.894,1,19,1064,19,28,94660,28,1064,0,0,0,0,0
28.982,6,2159,1832601,1276,1374,22,1380,1786907,883,421,32,1923,45694
174.46,6,22,8450,11,313,69,632,1413,11,940,17432,1460,7037
12.024,17,8,1714,4,45,4004,45,292,4,327,3996,339,1422
1792.149,6,381,47209,186,171,9685,722,32773,195,141,9236,1380,14436
1782.379,6,388,23896,203,69,8823,69,12260,185,43,9686,69,11636
0.089,17,2,201,1,50,0,50,78,1,95,0,95,123
40.071,17,4,240,2,32,40070,32,120,2,32,40069,32,120
1786.001,1,144,8064,144,28,12489,28,8064,0,0,0,0,0
5.922,17,3,1008,3,308,2961,308,1008,0,0,0,0,0
0.026,17,4,284,2,32,19,32,120,2,54,9,60,164
300.781,6,48,18343,27,965,11568,1360,12701,21,399,431,1360,5642
178.449,17,4,352,2,60,178448,60,176,2,60,178448,60,176
299.528,6,6,364,4,31,99842,31,222,2,31,299513,31,142
1779.957,17,142,11360,71,48,25427,48,5396,71,56,25427,56,5964
0.028,17,2,330,1,30,0,30,58,1,244,0,244,272
2.689,6,2,88,2,0,0,0,88,0,0,0,0,0
0.379,6,19,7099,12,318,34,600,1906,7,1205,59,1851,5193
3.161,17,2,178,1,29,0,29,57,1,93,0,93,121
1773.102,6,182,15629,121,69,14775,69,8980,61,69,29544,69,6649
1.436,6,38,8252,19,320,79,1162,2716,19,476,68,2715,5536
17.784,6,16,2297,9,324,2223,585,1125,7,396,2943,580,1172
1778.54,1,58,4872,58,56,31202,56,4872,0,0,0,0,0
1785.942,17,355,95857,355,242,5045,422,95857,0,0,0,0,0
1700.653,17,13,534,11,14,170047,14,462,2,8,1700475,8,72
0.95,6,21,9086,12,304,86,597,1425,9,1214,86,3081,7661
280.233,6,27,7312,12,158,25475,267,1277,15,678,20014,2045,6035
0.003,17,2,198,1,37,0,37,65,1,105,0,105,133
218.47,6,71,47868,45,1169,4965,1448,39785,26,747,2467,1448,8083
374.766,6,25,1651,17,177,23422,177,1117,8,110,9259,110,534
1.661,6,14,2351,8,188,237,245,700,6,703,282,1152,1651
2.71,17,2,685,1,308,0,308,336,1,321,0,321,349
1782.113,6,354,22440,207,69,8651,69,12420,147,69,12206,69,10020
3.941,6,2,88,2,0,0,0,88,0,0,0,0,0
0.053,6,7,423,4,43,5,43,259,3,0,25,0,164
45.491,6,5802,5558220,3871,1359,11,1408,5453144,1931,776,23,1408,105076
1797.802,17,449,39416,404,34,4461,288,25444,45,282,40021,288,13972
0.232,17,8,2750,8,315,33,354,2750,0,0,0,0,0
1.406,6,46,18856,27,872,54,1360,13320,19,476,67,2715,5536
1786.533,6,102,8228,68,64,26664,64,4896,34,58,54134,58,3332
5.236,6,18,2181,9,120,654,197,970,9,421,654,752,1211
37.08,17,44,6468,22,48,1763,48,1672,22,190,1764,308,4796
378.77,6,18,1239,14,177,29136,177,913,4,110,20065,110,326
6.514,6,1446,1297187,866,1417,7,1448,1262363,580,776,10,1448,34824
882.239,2,6,192,6,8,176447,8,192,0,0,0,0,0
1.786,6,8,440,4,0,595,0,216,4,0,248,0,224
408.778,6,70,11519,28,99,10507,267,2527,42,197,9969,1460,8992
121.014,17,5,380,5,48,30253,48,380,0,0,0,0,0
0.275,6,27,9114,13,257,22,667,1715,14,951,20,2816,7399
47.504,6,25,7097,12,155,4318,267,1266,13,589,3957,3426,5831
0.284,17,2,225,1,37,0,37,65,1,132,0,132,160
33.727,6,30,5042,15,154,2409,721,1859,15,399,2394,2026,3183
372.051,6,17,1190,13,180,31004,180,864,4,110,20057,110,326
0.082,17,2,347,1,29,0,29,57,1,262,0,262,290
0.563,1,2,112,2,28,563,28,112,0,0,0,0,0
0.209,1,2,112,2,28,209,28,112,0,0,0,0,0
200.006,6,76,51999,47,1214,4347,1408,43750,29,841,2200,2439,8249
240.204,6,52,17811,27,797,9238,1418,14966,25,192,10008,580,2845
1789.953,6,432,25986,215,69,8364,69,12878,217,35,8286,48,13108
1743.997,6,95,7203,63,38,28128,205,4476,32,33,56251,98,2727
187.364,1,12,672,12,28,17033,28,672,0,0,0,0,0
414.001,6,88,14320,42,105,10093,659,4772,46,320,9196,2720,9548
0.453,6,55,22484,31,931,15,1380,15314,24,515,17,1923,7170
0.012,17,2,428,1,34,0,34,62,1,338,0,338,366
6.62,6,671,594750,427,1321,15,1368,577398,244,776,26,1473,17352
1789.958,6,371,23534,214,69,8403,69,13114,157,69,11474,69,10420
0.009,17,2,570,1,30,0,30,58,1,484,0,484,512
43.781,17,4,304,4,48,14593,48,304,0,0,0,0,0
1780.614,17,142,11360,71,48,25437,48,5396,71,56,25437,56,5964
1798.05,6,371,25948,215,98,8402,469,15223,156,69,11599,69,10725
5.171,17,3,3161,3,1025,2585,1061,3161,0,0,0,0,0
1191.704,6,325,57544,206,304,5813,304,42336,119,83,10097,83,15208
2.287,17,12,6564,5,616,571,1350,3224,7,449,375,1350,3340
1.127,6,24,8004,11,164,95,267,1236,13,869,79,1448,6768
16.414,6,683,579317,405,1353,40,1368,558441,278,931,58,2841,20876
86.255,17,4,352,2,60,86254,60,176,2,60,86251,60,176
2.603,17,2,144,1,36,0,36,64,1,52,0,52,80
45.359,17,23,9691,11,569,4532,1350,6568,12,232,4120,1350,3123
1772.32,6,180,15480,120,69,14893,69,8940,60,69,30036,69,6540
1774.815,6,257,27232,127,73,14063,722,11562,130,232,13756,1380,15670
1770.907,6,101,9344,66,65,27244,65,5577,35,59,52083,59,3767
280.349,6,30,7432,13,158,23362,267,1317,17,543,17511,1400,6115
1777.91,6,183,15738,121,69,14815,69,8980,62,69,29138,69,6758
369.727,6,25,1651,17,177,23107,177,1117,8,110,9199,110,534
5.68,17,31,16493,12,341,516,1350,4437,19,606,184,1350,12056
4.949,6,40,7325,20,218,260,314,3423,20,516,247,1179,3902
0.202,17,2,170,1,37,0,37,65,1,77,0,77,105
3.155,6,25,7199,13,297,262,830,2011,12,940,285,1731,5188
280.515,6,30,7432,13,158,23376,267,1317,17,543,17531,1400,6115
0.286,17,2,157,1,31,0,31,59,1,70,0,70,98
1795.106,17,447,39864,402,35,4476,288,25644,45,288,40022,288,14220
2.398,17,8,1698,4,47,794,47,300,4,321,788,341,1398
1787.903,6,356,22520,208,69,8637,69,12460,148,69,12162,69,10060
300.789,6,42,13652,23,892,13672,1460,8090,19,399,480,1460,5562
0.141,17,2,672,2,308,141,308,672,0,0,0,0,0
292.767,6,40,2220,20,31,15400,31,1172,20,31,15400,31,1048
5.219,6,41,8265,20,227,274,314,3982,21,491,245,1179,4283
1782.101,17,83,3480,82,14,22001,14,3444,1,8,0,8,36
149.028,17,4,352,2,60,149027,60,176,2,60,149027,60,176
3.039,17,2,204,1,34,0,34,62,1,114,0,114,142
4.654,6,33,6129,18,206,273,314,2784,15,548,314,1179,3345
1799.202,1,59,4956,0,0,0,0,0,59,56,31020,56,4956
1.506,6,12,1304,6,256,298,256,756,6,304,298,304,548
0.599,6,28,9080,15,273,42,663,2180,13,886,46,1368,6900
0.256,6,3,175,2,31,10,31,135,1,0,0,0,40
0.026,17,2,554,1,30,0,30,58,1,468,0,468,496
1798.741,1,16,928,16,30,119916,30,928,0,0,0,0,0
1.991,17,2,178,1,29,0,29,57,1,93,0,93,121
1.734,6,20,3833,11,234,173,564,1504,9,463,192,1343,2329
376.422,6,21,1419,15,177,26887,177,989,6,110,12258,110,430
26.429,17,16,1216,16,48,1761,48,1216,0,0,0,0,0
300.76,6,49,10486,24,433,13076,910,3218,25,312,524,1360,7268
0.375,6,10,968,5,256,90,256,460,5,304,89,304,508
1746.142,6,102,7970,66,45,26863,205,4902,36,35,49879,98,3068
169.8,6,7101,6419138,2750,340,61,342,148819,4351,1393,38,4224,6270319
8.813,6,73,20902,37,559,244,1152,16035,36,427,244,1152,4867
1798.431,17,449,39928,404,35,4462,288,25708,45,288,40092,288,14220
1771.768,6,99,9240,66,65,27257,65,5577,33,59,55365,59,3663
15.117,17,15,4833,7,354,2513,1350,2679,8,241,2154,1350,2154
108.122,17,4,240,2,32,108121,32,120,2,32,108121,32,120
0.008,17,2,293,1,30,0,30,58,1,207,0,207,235
12.161,17,4,352,2,48,12147,48,152,2,72,12140,72,200
57.895,17,4,352,2,60,57893,60,176,2,60,57894,60,176
280.691,6,30,7432,13,158,23390,267,1317,17,543,17536,1400,6115
1787.272,6,102,8296,68,65,26675,65,4930,34,59,54153,59,3366
9.809,6,756,657642,474,1316,20,1368,638314,282,776,34,1473,19328
1107.437,17,46,7116,23,48,50337,48,1748,23,205,50337,308,5368
1.035,17,4,884,2,30,1021,30,116,2,356,1023,468,768
1795.355,17,148,12048,74,50,24593,136,5800,74,56,24593,72,6248
10.707,6,81,24461,41,550,267,1152,18720,40,459,266,1179,5741
0.25,17,2,142,1,35,0,35,63,1,51,0,51,79
0.262,6,26,7256,13,155,21,267,1301,13,603,21,1400,5955
1773.222,6,191,16265,125,69,14300,69,9278,66,69,27273,69,6987
1782.398,17,189,43435,189,201,9480,422,43435,0,0,0,0,0
4.248,17,10,644,5,30,1053,30,290,5,42,1058,94,354
6.645,6,584,539428,386,1334,16,1368,524468,198,776,32,1473,14960
0.467,6,22,7281,13,318,38,599,1969,9,967,57,1912,5312
36.861,1,6,636,6,78,7372,78,636,0,0,0,0,0
1786.214,17,87,3648,86,14,21014,14,3612,1,8,0,8,36
1781.761,6,358,22669,209,69,8566,69,12569,149,69,12038,69,10100
280.558,6,29,7392,12,158,25505,267,1277,17,603,17530,1400,6115
0.003,17,2,152,1,48,0,48,76,1,48,0,48,76
1.358,6,38,9127,20,399,71,1440,3631,18,433,69,1440,5496
11.527,6,90,27597,46,573,256,1152,21355,44,447,261,1179,6242
0.377,6,26,9013,13,252,31,646,1694,13,947,30,1402,7319
1740.836,6,87,6322,58,31,30540,31,3915,29,31,62171,31,2407
11.716,6,1869,1619910,1129,1380,10,1420,1586089,740,420,15,1420,33821
0.306,6,21,7281,12,334,27,663,1969,9,967,37,1471,5312
0.023,17,4,724,2,32,18,32,120,2,274,11,274,604
0.937,6,10,1687,7,100,156,100,384,3,1179,335,1179,1303
0.009,17,3,618,2,32,1,32,120,1,470,0,470,498
1797.162,17,448,39896,403,35,4470,288,25676,45,288,40017,288,14220
0.431,6,12,1653,6,288,83,288,548,6,426,47,434,1105
280.228,6,29,7392,13,158,23352,267,1317,16,543,18680,1400,6075
1748.666,1,55,4620,55,56,32382,56,4620,0,0,0,0,0
1791.128,17,445,55869,210,164,8569,1350,40525,235,37,7654,1350,15344
43.777,17,4,304,4,48,14592,48,304,0,0,0,0,0
0.034,17,8,1670,8,180,4,219,1670,0,0,0,0,0
1783.682,6,270,33418,110,142,16362,1360,16267,160,135,11217,4662,17151
18.827,17,29,7938,12,258,1708,1350,3438,17,236,1174,1350,4500
0.027,17,2,234,1,33,0,33,61,1,145,0,145,173
1.446,6,25,8056,12,164,112,267,1288,13,1014,103,2491,6768
0.031,6,32,19072,16,126,1,126,966,16,1328,2,1448,18106
0.045,17,4,352,2,37,0,37,130,2,83,9,89,222
170.112,6,29,7392,13,158,14176,267,1317,16,603,11338,2036,6075
0.115,6,9,1346,5,145,28,145,349,4,833,32,833,997
5.376,6,39,7285,21,218,268,314,3463,18,516,300,1179,3822
210.029,6,100,17447,46,293,4667,1189,8589,54,247,3960,1460,8858
80.828,6,22,900,10,0,5960,0,404,12,0,7347,0,496
1706.296,17,249,66985,249,241,6880,422,66985,0,0,0,0,0
6.534,6,32,7512,15,158,466,267,1397,17,543,401,1400,6115
2.659,6,27,6095,14,338,204,1314,2254,13,414,220,1420,3841
19.388,6,1510,1396620,920,1438,20,1448,1359712,590,776,32,1448,36908
1779.226,17,141,11276,71,48,25417,48,5396,70,56,25785,56,5880
1786.788,6,115,13290,74,162,24476,1286,8958,41,72,44667,240,4332
7.31,6,6,280,2,0,7310,0,88,4,0,2383,0,192
11.192,1,9,1197,9,105,1399,105,1197,0,0,0,0,0
0.557,6,23,7437,14,274,42,668,2109,9,1210,65,1946,5328
14.753,6,23,6002,11,275,1475,275,998,12,902,1205,1440,5004
52.95,6,26,8131,11,232,5290,517,1522,15,648,3779,1408,6609
184.351,17,82,16208,57,40,3291,41,3907,25,464,6723,505,12301
0.926,6,24,9000,14,259,71,680,1631,10,1159,83,2720,7369
0.467,6,12,1653,6,288,86,288,548,6,426,50,434,1105
1799.59,6,425,28176,205,46,8676,46,12292,220,46,8217,46,15884
239.687,17,12,1056,6,48,47935,48,456,6,72,47935,72,600
0.036,17,2,158,1,34,0,34,62,1,68,0,68,96
1792.146,6,356,22520,208,69,8657,69,12460,148,69,12191,69,10060
0.254,17,3,234,2,39,185,39,134,1,72,0,72,100
2.152,17,3,1176,3,364,1076,364,1176,0,0,0,0,0
19.24,6,3182,2988798,2057,1374,9,1408,2925622,1125,931,16,2816,63176
0.225,6,3,453,2,241,225,241,321,1,92,0,92,132
0.123,6,10,1569,5,627,30,627,895,5,406,30,406,674
1786.482,6,102,8364,68,66,26663,66,4964,34,60,54133,60,3400
2.53,17,22,13722,10,604,278,1350,6320,12,588,227,1350,7402
0.62,17,24,15706,13,978,51,1350,13087,11,210,58,1350,2619
1781.76,6,360,22818,209,69,8566,69,12569,151,69,11878,69,10249
3.681,6,12,1771,7,100,613,100,384,5,589,856,1152,1387
1771.434,6,124,12524,75,66,23938,722,6298,49,87,36899,1448,6226
352.187,6,11,1613,11,106,35218,138,1613,0,0,0,0,0
11.172,6,91,27594,46,572,248,1152,21312,45,447,247,1179,6282
0.003,17,3,1561,3,492,1,520,1561,0,0,0,0,0
0.044,17,4,368,2,32,9,32,120,2,96,0,96,248
89.975,17,4,304,2,48,89959,48,152,2,48,89958,48,152
0.994,6,27,8120,14,222,64,540,1924,13,944,68,1591,6196
1796.814,1,344,28896,341,56,5284,56,28644,3,56,998,56,252
1.393,6,47,17592,26,838,55,1360,11976,21,433,59,1360,5616
1794.845,17,73,3060,72,14,25279,14,3024,1,8,0,8,36
4.001,17,5,340,5,40,1000,40,340,0,0,0,0,0
0.098,17,2,410,1,46,0,46,74,1,308,0,308,336
1772.563,6,180,15480,120,69,14895,69,8940,60,69,30039,69,6540
1783.81,6,354,22440,207,69,8659,69,12420,147,69,12217,69,10020
120.305,2,2,64,2,8,120305,8,64,0,0,0,0,0
297.059,17,4,240,2,32,297058,32,120,2,32,297058,32,120
2.79,6,6,340,3,0,1395,0,160,3,0,515,0,180
4.048,6,35,6209,19,206,224,314,2824,16,456,252,1152,3385
3.218,6,36,19415,18,786,189,1460,6248,18,1130,176,1607,13167
1785.859,6,358,23021,209,69,8585,69,12500,149,74,12066,421,10521
13.745,6,2488,2362854,1624,1378,8,1408,2313262,864,931,15,2801,49592
30.887,6,36,8343,18,372,905,802,1869,18,478,1807,2720,6474
1793.392,6,367,23236,212,69,8499,69,12896,155,69,11645,69,10340
192.152,1,8,3143,8,364,27450,470,3143,0,0,0,0,0
5.973,6,107,87180,44,164,138,232,2258,63,1420,96,2840,84922
164.872,17,4,352,2,60,164871,60,176,2,60,164871,60,176
0.429,17,2,152,1,48,0,48,76,1,48,0,48,76
538.752,6,10,586,6,31,107750,31,333,4,31,179580,31,253
1772.348,6,180,15480,120,69,14893,69,8940,60,69,30034,69,6540
179.488,17,3,1232,3,382,89744,548,1232,0,0,0,0,0
1745.587,6,101,7918,65,45,27274,205,4850,36,35,49862,98,3068
8.336,17,4,352,2,48,8318,48,152,2,72,8313,72,200
0.775,6,148,99991,80,1300,9,1420,92968,68,427,11,1420,7023
1787.771,17,87,3648,86,14,21032,14,3612,1,8,0,8,36
40.849,17,11,836,11,48,4084,48,836,0,0,0,0,0
212.724,1,16,1344,16,56,14181,56,1344,0,0,0,0,0
125.413,6,20,4338,10,243,13934,722,1490,10,464,13912,1408,2848
0.013,17,2,152,2,48,13,48,152,0,0,0,0,0
119.027,17,4,352,2,60,119026,60,176,2,60,119026,60,176
1761.302,6,129,7908,70,27,25525,27,4210,59,27,30366,27,3698
1758.919,1,57,4788,57,56,31409,56,4788,0,0,0,0,0
1789.95,6,383,31630,222,141,8099,1189,18665,161,89,11187,453,12965
1729.383,6,65,4748,42,33,42180,33,2889,23,31,78591,31,1859
41.527,6,136,31723,65,447,648,1440,17019,71,303,541,1702,14704
0.994,6,23,9472,14,350,76,1041,1992,9,1421,101,3830,7480
0.274,17,2,776,2,360,274,360,776,0,0,0,0,0
16.363,17,6,528,3,48,8177,48,228,3,72,8177,72,300
138.257,6,22,10607,12,307,183,605,1446,10,1458,15342,3953,9161
1750.606,17,12,498,11,14,175060,14,462,1,8,0,8,36
12.17,17,4,352,2,48,12150,48,152,2,72,12150,72,200
12.76,6,2152,2039122,1407,1374,8,1408,1995718,745,931,16,2801,43404
1787.257,6,102,8228,68,64,26675,64,4896,34,58,54146,58,3332
1.247,6,49,20196,27,959,47,1460,14540,22,433,51,1460,5656
1783.191,17,83,3480,82,14,22014,14,3444,1,8,0,8,36
1116.531,17,220,16720,220,48,5098,48,16720,0,0,0,0,0
0.596,6,133,89277,72,1305,8,1420,82546,61,427,9,1420,6731
1761.863,1,191,10696,191,28,9272,28,10696,0,0,0,0,0
1.426,6,48,19369,27,902,54,1360,13753,21,433,61,1360,5616
0.214,6,3,144,2,0,3,0,92,1,0,0,0,52
17.57,17,25,5643,11,234,1753,1350,2887,14,168,1348,1350,2756
1785.277,17,87,3648,86,14,21003,14,3612,1,8,0,8,36
1797.179,1,61,5124,0,0,0,0,0,61,56,29952,56,5124
0.061,17,4,420,2,33,0,33,122,2,121,50,145,298
0.459,6,10,887,5,248,96,248,452,5,231,96,231,435
1784.347,17,44,14784,44,308,41496,308,14784,0,0,0,0,0
0.024,17,2,510,1,37,0,37,65,1,417,0,417,445
76.022,6,70,43463,41,1180,1900,1448,35202,29,843,2195,2359,8261
0.003,6,2,80,1,0,0,0,40,1,0,0,0,40
1777.96,17,141,11276,71,48,25399,48,5396,70,56,25767,56,5880
1.654,6,33,6124,17,111,103,267,1579,16,650,99,1420,4545
1763.153,17,150,25202,150,140,11833,373,25202,0,0,0,0,0
300.823,6,36,11352,20,571,15832,1408,4478,16,548,571,2126,6874
20.166,6,21,5417,12,107,1833,159,1074,9,773,2519,1418,4343
1758.383,6,100,7866,66,45,27052,205,4902,34,35,53275,98,2964
0.303,6,19,7186,12,335,26,668,1974,7,1613,49,3314,5212
10.768,6,20,4442,11,275,1076,275,998,9,768,745,1440,3444
171.448,6,29,13407,17,488,305,1360,3155,12,1394,15574,3928,10252
1797.521,6,363,24414,212,88,8519,469,14027,151,69,11981,69,10387
1798.745,17,449,39928,404,35,4463,288,25708,45,288,40020,288,14220
70.413,6,29,7395,13,155,5867,267,1306,16,453,4693,3417,6089
63.021,6,42,8772,21,363,790,775,2023,21,393,3144,4848,6749
0.864,6,2,92,1,0,0,0,40,1,0,0,0,52
1793.855,17,66,2766,65,14,28028,14,2730,1,8,0,8,36
37.533,17,42,11592,20,357,1973,1350,7717,22,148,1785,1350,3875
13.287,6,23,6953,13,275,1107,275,1078,10,1092,934,2391,5875
973.038,17,190,14440,190,48,5148,48,14440,0,0,0,0,0
1798.87,17,449,39928,404,35,4463,288,25708,45,288,40020,288,14220
1747.957,6,95,7203,63,38,28192,205,4476,32,33,56373,98,2727
0.375,6,28,7037,17,242,23,645,2383,11,701,36,1728,4654
1750.595,17,12,498,11,14,175059,14,462,1,8,0,8,36
77.062,17,8,608,8,48,11008,48,608,0,0,0,0,0
1386.062,2,12,384,12,8,126005,8,384,0,0,0,0,0
2.659,17,19,7118,9,471,331,1350,4494,10,234,291,1350,2624
1682.8,17,16,1184,8,30,240397,30,464,8,62,240397,62,720
1797.685,1,170,9520,170,28,10637,28,9520,0,0,0,0,0
112.546,6,25,10769,12,380,70,832,1665,13,952,9367,1460,9104
1069.059,6,242,31611,123,165,8762,925,20646,119,213,9058,1414,10965
0.006,17,3,634,2,32,2,32,120,1,486,0,486,514
0.163,17,4,624,2,64,161,64,184,2,192,37,192,440
69.536,6,137,86660,80,1232,140,1360,78433,57,282,1238,2667,8227
1781.891,17,140,11200,70,48,25824,48,5320,70,56,25824,56,5880
17.315,6,2451,2270421,1527,1406,11,1448,2217709,924,776,18,1448,52712
0.421,6,47,19221,26,1003,16,1380,14139,21,421,18,1923,5082
1749.643,6,112,8944,71,65,24994,65,5180,41,59,43738,59,3764
4.385,6,37,7189,19,218,243,314,3383,18,513,242,1179,3806
0.428,6,26,8995,13,252,35,647,1692,13,945,31,1448,7303
0.386,17,8,2766,8,317,55,356,2766,0,0,0,0,0
1787.454,6,104,8308,68,64,26678,64,4896,36,58,51067,58,3412
1776.632,17,73,3060,72,14,25022,14,3024,1,8,0,8,36
1788.554,6,393,24762,216,76,8318,501,13281,177,49,10162,69,11481
9.882,6,1413,1345380,953,1366,10,1432,1322680,460,428,21,1871,22700
39.923,17,3,228,3,48,19961,48,228,0,0,0,0,0
282.833,6,30,7432,14,158,21756,267,1357,16,678,18852,3456,6075
76.283,6,7,322,0,0,0,0,0,7,7,12713,7,322
240.307,6,43,9067,21,524,12014,1418,5816,22,233,11442,638,3251
230.342,17,4,304,4,48,76780,48,304,0,0,0,0,0
80.667,6,33,8992,15,158,5761,267,1397,18,624,4741,1400,7595
1770.968,6,105,9552,66,65,27245,65,5577,39,59,46600,59,3975
5.69,6,38,7229,20,218,299,314,3423,18,513,316,1179,3806
0.715,6,27,9047,13,252,59,647,1692,14,945,46,1408,7355
87.866,6,65,39900,39,1140,2312,1448,31700,26,843,2532,2359,8200
38.164,17,22,1672,22,48,1817,48,1672,0,0,0,0,0
460.439,6,42,7709,20,248,24231,517,2055,22,643,21923,1418,5654
72.037,6,15,3212,5,92,157,92,360,10,1164,7984,1448,2852
1737.03,17,278,62185,278,195,6270,422,62185,0,0,0,0,0
0.005,17,2,150,1,39,0,39,67,1,55,0,55,83
0.015,17,2,431,1,34,0,34,62,1,341,0,341,369
136.03,6,35,8703,15,269,9713,517,2160,20,610,7157,1418,6543
64.135,6,335,147533,173,791,372,1152,135921,162,427,396,1179,11612
1740.021,17,28,1596,28,29,64445,29,1596,0,0,0,0,0
293.172,6,47,4698,16,132,11914,722,2287,31,36,9765,98,2411
0.746,17,2,685,1,308,0,308,336,1,321,0,321,349
1681.414,1,11,638,11,30,168141,30,638,0,0,0,0,0
371.552,6,18,1239,14,177,28580,177,913,4,110,20060,110,326
738.844,6,51,8884,31,122,16283,498,2954,20,284,38882,1420,5930
4.049,6,38,7229,20,218,213,314,3423,18,513,223,1179,3806
40.613,17,6,528,3,48,20285,48,228,3,72,20296,72,300
1731.381,6,329,22716,139,46,12546,46,9228,190,46,9160,46,13488
10.11,6,6,328,4,0,3370,0,216,2,0,10085,0,112
83.05,6,73,51674,47,1209,1805,1368,43588,26,1121,2486,5255,8086
300.125,6,39,9638,20,648,15786,1440,4076,19,399,16664,1440,5562
280.25,6,28,7352,12,158,25477,267,1277,16,603,18680,1400,6075
5.504,6,39,7285,21,218,275,314,3463,18,516,308,1179,3822
1739.185,1,58,4872,58,56,30512,56,4872,0,0,0,0,0
175.85,17,2,672,2,308,175850,308,672,0,0,0,0,0
0.142,6,9,1339,5,145,35,145,349,4,826,34,826,990
0.288,17,2,152,1,48,0,48,76,1,48,0,48,76
1732.69,1,43,3612,43,56,41254,56,3612,0,0,0,0,0
9.791,6,79,24278,39,559,257,1152,18910,40,470,244,1179,5368
8.674,6,2,1520,1,0,0,0,40,1,1440,0,1440,1480
5.001,17,4,558,2,36,4997,36,128,2,187,4997,187,430
1786.217,6,104,8444,68,66,26659,66,4964,36,60,51032,60,3480
0.051,6,11,1805,6,126,10,126,446,5,545,11,990,1359
11.01,6,20,4442,11,275,1101,275,998,9,768,774,1440,3444
371.063,6,23,1535,16,177,24737,177,1053,7,110,10389,110,482
0.285,6,25,6098,12,181,25,537,1526,13,555,22,1402,4572
541.479,2,6,192,6,8,108295,8,192,0,0,0,0,0
69.793,17,16,1216,16,48,4652,48,1216,0,0,0,0,0
1720.72,17,12,498,11,14,172072,14,462,1,8,0,8,36
1.206,6,19,8152,9,75,150,75,670,10,1388,133,1448,7482
4.214,17,25,11307,11,348,421,1350,4143,14,483,240,1350,7164
1.184,1,2,112,2,28,1184,28,112,0,0,0,0,0
106.764,6,65,45870,43,1191,2542,1408,37991,22,961,2931,3847,7879
61.836,6,68,48827,44,1204,1438,1408,40846,24,960,2678,3847,7981
5.029,17,4,288,2,36,4997,36,128,2,52,4997,52,160
0.846,6,26,5887,13,156,70,267,1462,13,780,63,1460,4425
0.198,17,4,624,2,64,197,64,184,2,192,77,192,440
1766.155,1,56,4704,0,0,0,0,0,56,56,32111,56,4704
503.812,2,3,96,3,8,251906,8,96,0,0,0,0,0
1668.228,1,7,742,7,78,278038,78,742,0,0,0,0,0
33.608,6,11,612,7,0,5601,0,380,4,0,11194,0,232
0.425,6,13,1693,7,288,69,288,588,6,426,46,434,1105
196.603,17,4,352,2,60,196602,60,176,2,60,196602,60,176
1784.537,6,831,149109,545,304,3280,304,111660,286,83,6261,83,37449
1772.614,6,180,15480,120,69,14895,69,8940,60,69,30035,69,6540
0.013,6,2,381,2,150,13,270,381,0,0,0,0,0
1227.314,17,238,18088,238,48,5178,48,18088,0,0,0,0,0
0.204,17,2,136,1,32,0,32,60,1,48,0,48,76
139.303,17,4,352,2,60,139302,60,176,2,60,139301,60,176
1797.38,6,361,22858,210,69,8599,69,12678,151,69,11982,69,10180
155.168,17,4,352,2,60,155167,60,176,2,60,155167,60,176
365.964,17,7,2348,7,307,60994,308,2348,0,0,0,0,0
1759.723,6,114,9392,74,55,24105,205,5780,40,38,45115,98,3612
3.783,6,131,96606,60,915,64,1440,12506,71,1377,51,2880,84100
1795.289,6,145,17885,87,92,20875,500,7284,58,168,31494,1420,10601
862.694,17,162,12312,162,48,5358,48,12312,0,0,0,0,0
1.555,17,18,5665,7,309,259,1350,2360,11,272,77,1350,3305
1275.191,6,91,11893,62,82,20904,504,5208,29,204,42554,1452,6685
280.475,6,28,7352,13,158,23372,267,1317,15,678,20030,3456,6035
0.052,17,4,364,2,52,0,52,160,2,74,6,80,204
0.021,17,2,904,1,548,0,548,576,1,300,0,300,328
255.491,6,1151,558698,607,851,218,1152,529355,544,398,470,1179,29343
39.832,6,43,10063,20,667,813,1360,4217,23,307,1801,1360,5846
1797.666,2,23,736,23,8,81712,8,736,0,0,0,0,0
108.904,6,35,11779,16,316,7257,517,2456,19,831,6047,1408,9323
1785.277,6,158,16509,81,83,22315,517,6446,77,247,23489,2409,10063
25.632,6,37,9090,19,269,1424,721,2917,18,681,1496,1420,6173
27.308,1,4,224,4,28,9102,28,224,0,0,0,0,0
289.406,6,309,49393,172,304,1692,304,34764,137,83,2127,83,14629
1783.16,17,86,3606,85,14,21228,14,3570,1,8,0,8,36
1778.262,1,8,448,8,28,254037,28,448,0,0,0,0,0
12.411,6,7,380,4,0,4137,0,216,3,0,6196,0,164
0.024,1,2,112,2,28,24,28,112,0,0,0,0,0
128.628,17,4,352,2,60,128627,60,176,2,60,128627,60,176
5.526,6,13,1980,6,210,1105,210,518,7,545,909,904,1462
1798.115,17,142,11360,71,48,25687,48,5396,71,56,25687,56,5964
1340.595,6,1418,1279217,504,160,2665,844,32027,914,1398,1468,2836,1247190
1796.113,1,56,4704,56,56,32656,56,4704,0,0,0,0,0
0.405,6,24,6721,12,284,36,517,1780,12,718,36,1408,4941
1795.389,17,448,39896,403,35,4466,288,25676,45,288,40021,288,14220
6.852,17,39,6859,18,173,401,1350,3624,21,126,341,1350,3235
384.14,6,23,6861,6,94,76828,106,627,17,396,16006,1420,6234
11.778,6,1856,1626578,1126,1390,10,1420,1593157,730,467,16,1883,33421
1772.465,6,180,15480,120,69,14894,69,8940,60,69,30037,69,6540
37.561,17,6,528,3,48,18775,48,228,3,72,18774,72,300
1.795,6,34,6380,16,138,119,267,1755,18,650,97,1380,4625
624.98,1,12,1284,12,79,56816,100,1284,0,0,0,0,0
8.266,6,79,24685,41,560,206,1152,19008,38,461,216,1179,5677
20.145,6,21,5418,12,107,1831,159,1074,9,967,2517,1669,4344
368.282,6,18,1242,14,180,28329,180,916,4,110,20063,110,326
1790.062,1,240,13440,240,28,7489,28,13440,0,0,0,0,0
1120.084,17,112,7168,112,36,10090,36,7168,0,0,0,0,0
4.212,17,21,22432,6,703,842,1350,4387,15,1175,190,1350,18045
4.596,6,3,132,1,0,0,0,52,2,0,4407,0,80
1769.215,1,58,4872,58,56,31038,56,4872,0,0,0,0,0
6.025,17,4,802,2,44,6010,44,144,2,301,6010,317,658
95.489,6,40,8799,17,401,1395,889,1940,23,348,4334,3488,6859
9.432,6,34,7113,18,214,554,314,2864,16,515,610,1179,4249
0.045,6,5,658,0,0,0,0,0,5,229,11,389,658
1796.537,17,449,39928,404,35,4457,288,25708,45,288,40022,288,14220
0.584,6,27,10311,12,557,53,1365,2305,15,656,37,1440,8006
3.546,17,2,136,1,32,0,32,60,1,48,0,48,76
0.56,17,2,167,1,39,0,39,67,1,72,0,72,100
1799.563,17,210,63344,210,273,8610,422,63344,0,0,0,0,0
299.539,6,7,404,5,31,74884,31,262,2,31,299516,31,142
0.157,6,9,1348,5,145,39,145,349,4,835,47,835,999
1744.651,2,27,864,27,8,67101,8,864,0,0,0,0,0
3.146,6,5,415,5,31,786,31,415,0,0,0,0,0
1143.048,2,12,384,12,8,103913,8,384,0,0,0,0,0
16.16,17,20,6268,8,306,2304,1350,2674,12,271,1466,1350,3594
1.86,6,2,1253,1,0,0,0,40,1,1173,0,1173,1213
0.933,6,10,1687,7,100,155,100,384,3,1179,337,1179,1303
51.657,6,18,2511,7,188,238,245,660,11,1407,5141,1407,1851
1769.989,6,99,9306,66,66,27230,66,5610,33,60,55309,60,3696
1792.604,6,355,22549,206,69,8744,69,12380,149,69,12112,69,10169
76.989,17,4,304,2,48,76972,48,152,2,48,76972,48,152
1786.952,6,104,8308,68,64,26670,64,4896,36,58,51053,58,3412
0.345,6,29,7522,17,306,21,1089,2828,12,601,30,1360,4694
3.012,6,17,4500,9,85,376,85,581,8,1159,430,2896,3919
1786.567,6,102,8228,68,64,26665,64,4896,34,58,54135,58,3332
33.654,6,31,5093,15,154,2403,722,1858,16,342,2232,1408,3235
10.268,6,53,21933,28,1146,380,1440,16069,25,346,409,1440,5864
1794.28,6,368,25897,216,98,8345,469,15332,152,69,11880,69,10565
1781.766,6,355,22549,206,69,8691,69,12380,149,69,12038,69,10169
8.604,17,3,228,3,48,4302,48,228,0,0,0,0,0
0.052,6,13,3514,7,75,8,75,447,6,1373,10,1448,3067
0.099,17,5,884,3,36,47,36,192,2,318,93,318,692
76.237,17,4,352,2,60,76235,60,176,2,60,76236,60,176
1798.386,1,345,28980,345,56,5227,56,28980,0,0,0,0,0
1.055,6,56,14151,27,549,40,1429,5004,29,419,36,1986,9147
558.45,6,91,13183,49,109,11630,721,5585,42,328,13616,1414,7598
19.846,17,5,5353,5,1042,4961,1060,5353,0,0,0,0,0
0.308,1,6,624,0,0,0,0,0,6,76,61,76,624
377.342,6,18,1242,14,180,29026,180,916,4,110,20076,110,326
0.311,17,2,172,1,50,0,50,78,1,66,0,66,94
125.23,6,38,6029,13,204,1872,722,1708,25,212,5210,1408,4321
663.536,1,6,886,6,119,132707,320,886,0,0,0,0,0
1797.348,17,444,39200,400,35,4504,288,25296,44,288,40951,288,13904
73.485,6,140,50719,78,665,954,1360,37130,62,392,1200,1360,13589
8.139,6,566,526181,373,1348,21,1368,511457,193,776,41,1473,14724
370.35,17,8,2688,8,308,52907,308,2688,0,0,0,0,0
1.345,17,6,1310,3,30,661,30,174,3,350,661,468,1136
1797.745,17,77,3228,76,14,23969,14,3192,1,8,0,8,36
1794.462,1,88,4928,88,28,20626,28,4928,0,0,0,0,0
0.057,17,3,208,2,36,24,36,128,1,52,0,52,80
6.125,6,986,848175,593,1384,10,1420,828234,393,467,15,1883,19941
1780.321,6,359,22778,209,69,8559,69,12569,150,69,11948,69,10209
5.024,17,4,288,2,36,5003,36,128,2,52,5006,52,160
6.66,6,6,1760,4,0,1964,0,208,2,1448,1,1448,1552
1755.798,6,4414,4236435,2361,147,743,951,138389,2053,2019,855,11264,4098046
1782.447,6,367,23305,212,69,8447,69,12965,155,69,11573,69,10340
1772.087,6,180,15480,120,69,14891,69,8940,60,69,30034,69,6540
1756.911,1,65,5460,65,56,27451,56,5460,0,0,0,0,0
1780.43,6,352,22360,205,69,8689,69,12340,147,69,12194,69,10020
28.816,6,14,2626,8,152,4116,267,782,6,400,5667,1179,1844
23.905,17,3,1008,3,308,11952,308,1008,0,0,0,0,0
1794.345,1,286,16016,286,28,6295,28,16016,0,0,0,0,0
0.017,17,2,578,1,45,0,45,73,1,477,0,477,505
3.393,17,79,99895,78,1252,44,1472,99855,1,12,0,12,40
18.585,6,32,5256,16,146,1239,722,2009,16,399,1227,1402,3247
75.365,6,29,7392,13,158,6280,267,1317,16,603,5022,2036,6075
145.662,1,6,336,6,28,29132,28,336,0,0,0,0,0
8.138,6,21,4374,12,213,739,597,1689,9,552,992,1767,2685
368.705,6,18,1239,14,177,28361,177,913,4,110,20060,110,326
5.032,6,41,7349,21,218,251,314,3463,20,440,250,1152,3886
396.508,6,18,1340,6,65,21676,65,435,12,38,36038,59,905
240.189,6,54,17118,29,760,8578,1408,14439,25,171,10007,580,2679
589.598,1,6,336,6,28,117919,28,336,0,0,0,0,0
0.021,1,2,450,2,197,21,197,450,0,0,0,0,0
280.307,6,30,7432,13,158,23358,267,1317,17,543,17518,1400,6115
1743.897,6,100,7568,64,38,27680,205,4559,36,33,49818,98,3009
1746.286,1,58,3248,58,28,30636,28,3248,0,0,0,0,0
41.532,17,16,1216,16,48,2768,48,1216,0,0,0,0,0
39.94,6,27,7312,13,158,3328,267,1317,14,775,3070,3445,5995
280.255,6,29,7392,13,158,23354,267,1317,16,603,18681,1400,6075
14.413,6,2351,2189981,1516,1367,9,1408,2141897,835,931,17,2816,48084
1795.078,17,140,11200,70,48,26015,48,5320,70,56,26015,56,5880
300.294,6,33,11958,18,588,17664,1438,4500,15,833,17181,1488,7458
1.582,6,26,6000,14,150,121,267,1615,12,780,127,1460,4385
2.083,6,36,11423,18,297,122,646,2750,18,856,121,1438,8673
0.225,17,5,1945,5,361,56,361,1945,0,0,0,0,0
1740.807,17,30,7050,30,207,60027,207,7050,0,0,0,0,0
15.6,6,7,328,2,0,15600,0,88,5,0,3858,0,240
0.617,6,8,440,5,0,154,0,268,3,0,196,0,172
2.401,17,2,152,1,48,0,48,76,1,48,0,48,76
1772.802,6,180,15480,120,69,14897,69,8940,60,69,30040,69,6540
0.045,17,2,148,1,38,0,38,66,1,54,0,54,82
58.27,17,6,528,3,48,29129,48,228,3,72,29130,72,300
53.196,6,31,7472,13,158,4433,267,1317,18,603,3128,1400,6155
368.62,6,21,1419,15,177,26330,177,989,6,110,12235,110,430
0.485,17,3,451,2,39,185,39,134,1,289,0,289,317
4.01,17,4,240,4,32,1336,32,240,0,0,0,0,0
1785.953,6,394,26592,214,100,8384,469,14976,180,48,9977,69,11616
17.228,6,1818,1662468,1147,1395,15,1432,1630329,671,475,25,1871,32139
159.271,17,4,352,2,60,159270,60,176,2,60,159269,60,176
2.473,17,32,15567,15,743,176,1350,11571,17,207,102,1350,3996
0.075,17,3,618,2,32,48,32,120,1,470,0,470,498
1.282,6,50,20333,28,901,47,1360,14677,22,433,53,1360,5656
323.502,6,29,7394,4,154,107830,267,632,25,287,13478,1460,6762
264.621,17,4,352,2,60,264620,60,176,2,60,264620,60,176
0.013,17,2,387,1,65,0,65,93,1,266,0,266,294
3.492,6,2,88,2,0,0,0,88,0,0,0,0,0
0.539,6,25,8987,13,266,44,705,1750,12,1100,48,2804,7237
495.888,2,6,192,6,8,99177,8,192,0,0,0,0,0
381.145,6,18,1242,14,180,29318,180,916,4,110,20068,110,326
9.678,6,10,1829,5,241,2419,456,731,5,419,1172,811,1098
1789.069,17,81,27332,81,309,22363,320,27332,0,0,0,0,0
1771.621,6,101,9410,66,66,27255,66,5610,35,60,52103,60,3800
1773.306,17,285,61836,285,188,6244,422,61836,0,0,0,0,0
300.805,6,45,17891,26,1023,12032,1360,12329,19,435,479,2667,5562
56.419,6,30,12717,15,727,4029,1134,3687,15,915,4026,1368,9030
725.347,6,75,8944,47,78,15768,722,4407,28,153,21135,2026,4537
1787.815,6,372,25919,215,99,8354,469,15154,157,69,11457,69,10765
4.9,6,35,6209,18,206,288,314,2784,17,548,290,1179,3425
1.258,6,41,11378,22,547,59,1360,5842,19,476,60,2715,5536
111.836,6,23,7981,12,376,55,793,1640,11,841,11171,2720,6341
247.731,17,4,240,2,32,247730,32,120,2,32,247730,32,120
0.31,6,27,9120,14,266,23,705,1802,13,947,25,2804,7318
0.056,17,4,284,2,32,1,32,120,2,54,0,60,164
1.413,6,48,20546,27,987,54,1460,14930,21,433,61,1460,5616
0.05,17,2,190,1,59,0,59,87,1,75,0,75,103
1791.801,17,142,11360,71,48,25597,48,5396,71,56,25597,56,5964
1785.406,17,136,10880,68,48,26647,48,5168,68,56,26647,56,5712
249.207,17,9,684,9,48,31150,48,684,0,0,0,0,0
1.291,6,49,19879,28,874,47,1360,14263,21,433,55,1360,5616
0.017,17,4,344,2,47,9,47,150,2,69,10,75,194
1773.061,6,180,15480,120,69,14899,69,8940,60,69,30044,69,6540
127.64,6,31,8912,14,158,9818,267,1357,17,687,7974,1781,7555
1773.512,6,180,15480,120,69,14903,69,8940,60,69,30056,69,6540
0.465,6,13,1693,7,288,75,288,588,6,426,51,434,1105
1.542,6,33,11148,18,559,90,1360,4134,15,640,97,1360,7014
0.009,17,4,276,3,33,0,33,183,1,65,0,65,93
7.841,6,36,10004,16,619,55,1360,3150,20,402,402,1360,6854
0.445,17,13,7014,7,613,74,1350,4490,6,392,69,1350,2524
283.102,6,32,7516,14,158,21777,267,1361,18,603,16494,2076,6155
16.922,17,30,6971,14,224,1299,1350,3528,16,187,1126,1350,3443
0.095,1,2,163,2,53,95,78,163,0,0,0,0,0
0.463,17,11,4027,11,338,46,358,4027,0,0,0,0,0
167.927,6,24,10126,12,421,112,956,1789,12,980,15251,1529,8337
7.548,6,38,10564,21,701,377,1360,5082,17,435,460,2667,5482
1699.992,6,161,14030,103,70,16666,138,7777,58,69,27219,69,6253
0.526,17,3,451,2,39,478,39,134,1,289,0,289,317
1786.479,6,104,8444,68,66,26663,66,4964,36,60,51039,60,3480
0.491,6,20,7196,12,325,44,626,1932,8,1210,69,1906,5264
82.21,6,29,7392,13,158,6850,267,1317,16,603,5479,2800,6075
272.218,17,4,352,2,60,272217,60,176,2,60,272217,60,176
0.003,6,3,132,1,0,0,0,40,2,0,0,0,92
1739.461,6,171,18032,88,91,19993,722,8005,83,139,21208,1380,10027
703.122,6,103,9555,39,78,18500,301,3920,64,93,11160,1062,5635
64.361,17,4,352,2,60,64360,60,176,2,60,64360,60,176
39.436,6,5062,4787686,3320,1364,11,1408,4692438,1742,931,22,2816,95248
1748.945,6,100,7866,66,45,26906,205,4902,34,35,52987,98,2964
0.009,17,2,352,1,36,0,36,64,1,260,0,260,288
875.392,6,57,9003,40,101,22445,267,3014,17,442,457,2036,5989
10.701,6,15,2356,8,194,1497,194,590,7,368,1746,1360,1766
1787.116,6,102,8364,68,66,26673,66,4964,34,60,54148,60,3400
0.185,6,2,1273,1,1193,0,1193,1233,1,0,0,0,40
1740.464,17,30,31680,30,1028,60016,1028,31680,0,0,0,0,0
45.56,2,3,96,3,8,22780,8,96,0,0,0,0,0
0.407,6,10,968,5,256,100,256,460,5,304,100,304,508
0.259,6,26,8991,13,247,21,624,1672,13,1105,21,2816,7319
1775.739,6,274,32068,111,128,16141,1460,15241,163,128,10960,1642,16827
1785.857,6,447,27012,223,69,8044,69,13336,224,36,8008,69,13676
0.124,6,19,8973,10,121,13,121,649,9,1308,15,1802,8324
854.841,17,124,9424,124,48,6949,48,9424,0,0,0,0,0
1263.319,2,14,448,14,8,97178,8,448,0,0,0,0,0
16.22,17,10,880,5,48,4052,48,380,5,72,4052,72,500
1798.126,1,150,8400,150,28,12067,28,8400,0,0,0,0,0
229.809,17,4,1576,4,366,76603,548,1576,0,0,0,0,0
11.622,6,239,169627,122,1165,96,1460,37562,117,1384,97,1591,132065
11.798,6,1912,1623181,1145,1363,10,1380,1588259,767,421,15,1923,34922
122.996,17,4,352,2,60,122995,60,176,2,60,122995,60,176
1018.066,6,44,6132,28,216,37706,1408,4916,16,31,67843,31,1216
132.255,6,68,48981,46,1172,2939,1408,41102,22,961,2933,3847,7879
293.542,1,6,336,6,28,58708,28,336,0,0,0,0,0
1739.302,1,15,840,15,28,124235,28,840,0,0,0,0,0
11.847,6,1886,1619975,1143,1363,10,1380,1586013,743,421,15,1923,33962
300.237,6,25,8558,15,403,21445,1240,2415,10,935,7365,2896,6143
1773.924,1,58,4872,58,56,31121,56,4872,0,0,0,0,0
12.183,6,7,296,3,0,6002,0,124,4,0,4052,0,172
0.045,6,2,417,1,325,0,325,377,1,0,0,0,40
58.039,6,10,648,10,31,6448,31,648,0,0,0,0,0
602.817,6,117,23095,51,281,12052,1360,11140,66,221,9271,4649,11955
1.536,6,64,44816,38,1270,41,1448,37559,26,842,54,1448,7257
300.785,6,33,15621,17,195,18799,431,1696,16,1006,4599,3345,13925
1.621,6,49,19751,27,927,62,1360,14095,22,433,67,1360,5656
1772.243,6,180,15480,120,69,14892,69,8940,60,69,30031,69,6540
280.266,6,30,7432,13,158,23355,267,1317,17,543,17513,1400,6115
0.086,6,7,423,4,43,8,43,259,3,0,35,0,164
0.369,6,12,1653,6,288,71,288,548,6,426,41,434,1105
172.656,6,23,11156,11,380,102,832,1633,12,1128,15684,1460,9523
11.683,6,1815,1594320,1129,1362,10,1380,1562581,686,387,16,2760,31739
3.928,17,5,290,5,30,982,30,290,0,0,0,0,0
1.303,6,37,8212,19,320,72,1162,2716,18,476,67,2715,5496
1.305,6,52,19154,29,872,46,1360,13413,23,437,51,2715,5741
0.042,17,2,339,1,33,0,33,61,1,250,0,250,278
1764.586,2,15,480,15,8,126041,8,480,0,0,0,0,0
1720.638,17,13,534,11,14,172044,14,462,2,8,1720461,8,72
48.196,6,30,7297,14,155,3707,267,1346,16,441,3212,1420,5951
0.467,6,12,1653,6,288,89,288,548,6,426,50,434,1105
1744.631,2,26,832,26,8,69785,8,832,0,0,0,0,0
1409.925,17,321,38738,158,156,8980,1350,29095,163,31,8430,60,9643
0.201,17,2,152,1,48,0,48,76,1,48,0,48,76
9.633,6,36,7731,17,206,602,314,2744,19,603,520,1179,4987
421.157,2,3,96,3,8,210578,8,96,0,0,0,0,0
41.58,17,3,228,3,48,20790,48,228,0,0,0,0,0
353.44,6,24,6691,4,106,117813,106,274,20,350,18593,1460,6417
1798.747,17,142,11360,71,48,25696,48,5396,71,56,25696,56,5964
1777.831,17,213,51491,213,213,8385,422,51491,0,0,0,0,0
1.347,6,43,10117,23,440,61,1360,4496,20,437,61,2720,5621
154.839,17,4,240,2,32,154838,32,120,2,32,154838,32,120
6.725,17,32,7660,10,230,747,1350,2581,22,202,317,1350,5079
12.87,6,1289,1144075,751,1438,16,1448,1109643,538,776,23,1448,34432
280.262,6,27,7312,12,158,25478,267,1277,15,678,20016,2045,6035
0.464,6,13,1693,7,288,77,288,588,6,426,53,434,1105
1797.038,17,241,61255,241,226,7487,422,61255,0,0,0,0,0
1755.893,6,103,6154,59,26,30273,27,3467,44,26,40833,27,2687
1798.539,17,140,11200,70,48,26065,48,5320,70,56,26065,56,5880
1785.211,17,87,3648,86,14,21002,14,3612,1,8,0,8,36
2.083,6,26,6125,14,108,160,147,999,12,773,160,1608,5126
0.179,6,9,1339,5,145,44,145,349,4,826,54,826,990
1743.708,1,15,840,15,28,124550,28,840,0,0,0,0,0
1798.719,6,368,23414,213,69,8484,69,12729,155,69,11679,69,10685
721.953,2,8,256,8,8,103136,8,256,0,0,0,0,0
1772.507,6,203,22290,130,75,13740,267,10057,73,134,24612,2840,12233
1786.107,17,86,3606,85,14,21263,14,3570,1,8,0,8,36
19.922,6,32,8952,14,158,1532,267,1357,18,624,1160,1400,7595
1104.116,6,139,10556,53,69,21230,293,5025,86,48,12989,78,5531
0.213,17,2,181,1,32,0,32,60,1,93,0,93,121
117.633,6,23,9218,11,406,260,908,1691,12,1005,10682,1360,7527
2.569,6,28,9003,17,371,160,847,1799,11,965,246,1452,7204
0.311,6,20,4960,10,137,34,267,1092,10,692,33,1467,3868
230.748,17,5,679,5,107,57687,355,679,0,0,0,0,0
3.667,6,14,3144,8,49,523,92,511,6,579,43,1408,2633
25.193,6,36,8323,18,178,1481,721,2150,18,605,1469,1440,6173
1787.898,6,357,22629,208,69,8637,69,12460,149,69,12080,69,10169
1760.484,1,200,21200,200,78,8846,78,21200,0,0,0,0,0
110.979,1,4,224,4,28,36993,28,224,0,0,0,0,0
1.062,17,4,314,2,31,1016,31,118,2,70,1030,70,196
1769.477,1,154,8624,154,28,11565,28,8624,0,0,0,0,0
8.461,6,23,10824,11,275,846,275,723,12,1201,721,1414,10101
280.268,6,29,7392,13,158,23355,267,1317,16,603,18681,1400,6075
0.162,1,6,624,0,0,0,0,0,6,76,32,76,624
1793.67,6,288,35998,116,139,15596,1460,16957,172,141,10488,1642,19041
1792.02,1,58,4872,0,0,0,0,0,58,56,31438,56,4872
0.064,17,2,152,1,48,0,48,76,1,48,0,48,76
64.292,6,47,13022,23,876,635,1360,7136,24,307,2787,1360,5886
267.165,17,4,352,2,60,267164,60,176,2,60,267164,60,176
1793.928,1,59,4956,59,56,30929,56,4956,0,0,0,0,0
300.623,6,38,8566,20,315,15822,882,2093,18,441,498,1440,6473
60.579,6,7,320,2,0,60570,0,88,5,0,15142,0,232
0.97,6,29,8543,15,225,57,561,1985,14,855,60,1360,6558
88.35,6,34,8288,14,169,6796,267,1756,20,440,4640,1420,6532
240.131,6,48,9424,25,209,10005,834,2784,23,494,10914,2816,6640
1773.089,6,180,15480,120,69,14899,69,8940,60,69,30047,69,6540
0.569,6,13,3041,7,695,94,860,1763,6,479,112,939,1278
398.431,6,27,3987,20,342,20970,342,2530,7,233,39551,233,1457
0.07,17,2,334,1,39,0,39,67,1,239,0,239,267
848.991,17,68,5440,34,48,25726,48,2584,34,56,25726,56,2856
0.797,17,4,624,2,64,795,64,184,2,192,681,192,440
1.442,6,19,3781,10,234,160,564,1452,9,463,157,1343,2329
0.393,6,10,968,5,256,94,256,460,5,304,94,304,508
0.097,6,6,328,4,0,32,0,216,2,0,78,0,112
10.132,6,88,27522,45,574,230,1152,21320,43,447,234,1179,6202
40.245,6,28,8684,14,355,3095,734,2535,14,902,3095,1408,6149
5.88,2,3,96,3,8,2940,8,96,0,0,0,0,0
7.723,17,6,528,3,48,3855,48,228,3,72,3855,72,300
5.142,6,38,7229,19,218,285,314,3383,19,513,270,1179,3846
1.312,6,428,374972,214,263,6,517,12896,214,1671,5,8448,362076
16.931,17,6,255,2,11,16931,14,79,4,16,4997,16,176
0.754,17,4,352,2,60,753,60,176,2,60,753,60,176
1.618,6,27,10181,16,285,107,588,1500,11,1029,146,1420,8681
0.318,6,20,7229,12,334,28,663,1969,8,1209,44,1906,5260
88.209,6,156,120705,96,1320,928,1448,108014,60,683,1486,2359,12691
1619.961,1,14,1141,14,53,124612,78,1141,0,0,0,0,0
120.543,6,9,1647,6,100,24108,100,344,3,1179,60127,1179,1303
1782.632,6,104,8564,68,66,26606,66,4964,36,60,50929,60,3600
37.719,6,1053,932804,648,1360,58,1368,904438,405,899,92,1473,28366
1786.899,6,104,8444,68,66,26670,66,4964,36,60,51051,60,3480
3.041,17,4,624,4,128,1013,128,624,0,0,0,0,0
0.997,6,26,9706,15,574,60,1360,3502,11,1150,81,2720,6204
1787.402,6,359,22709,209,69,8593,69,12569,150,69,11995,69,10140
1797.7,6,356,22520,208,69,8684,69,12460,148,69,12229,69,10060
1.182,6,58,18034,28,707,43,1360,8925,30,438,40,1360,9109
11.823,6,1878,1634920,1137,1383,10,1420,1601047,741,467,15,1883,33873
447.889,1,3,168,3,28,223944,28,168,0,0,0,0,0
22.745,6,34,15211,18,894,1337,1360,6131,16,936,1503,2720,9080
9.499,6,6,312,6,0,0,0,312,0,0,0,0,0
0.721,2,2,64,2,8,721,8,64,0,0,0,0,0
6.007,6,3,180,3,0,0,0,180,0,0,0,0,0
306.577,1,4,1313,4,300,102192,327,1313,0,0,0,0,0
0.983,17,4,624,2,64,981,64,184,2,192,860,192,440
0.043,17,4,608,2,60,0,60,176,2,188,17,188,432
1797.232,17,448,39896,403,35,4470,288,25676,45,288,40017,288,14220
96.228,6,32,11981,17,608,107,1360,3754,15,761,6859,2720,8227
1170.414,6,145,16142,69,93,17209,721,6958,76,204,15603,1440,9184
0.524,6,14,1745,7,288,59,288,600,7,426,60,434,1145
1792.835,6,356,22520,208,69,8661,69,12460,148,69,12195,69,10060
9.565,1,20,560,20,0,0,0,560,0,0,0,0,0
1750.644,6,94,7151,62,38,28699,205,4424,32,33,56465,98,2727
196.728,6,82,56846,51,1206,3934,1368,48497,31,961,2066,3887,8349
0.004,6,2,170,1,0,0,0,40,1,90,0,90,130
1.214,6,29,13131,17,529,75,1360,3370,12,1158,92,3921,9761
1778.24,6,122,14249,76,82,23709,519,6008,46,152,39514,1420,8241
1787.565,6,102,8228,68,64,26680,64,4896,34,58,54165,58,3332
240.156,6,45,9477,22,192,11435,752,2688,23,557,10915,2348,6789
1793.594,6,356,22589,207,69,8706,69,12489,149,69,12117,69,10100
1.264,6,25,8056,12,164,97,267,1288,13,869,89,1402,6768
61.728,6,70,46099,42,1190,1505,1448,37913,28,746,2277,1448,8186
1772.191,6,180,15480,120,69,14892,69,8940,60,69,30031,69,6540
1786.245,1,342,28728,342,56,5238,56,28728,0,0,0,0,0
1799.644,17,450,39960,405,35,4454,288,25740,45,288,40020,288,14220
840.571,17,8,2152,4,30,280188,30,232,4,452,280189,463,1920
0.616,6,10,1116,6,180,123,180,680,4,110,139,110,436
0.018,17,2,672,2,308,18,308,672,0,0,0,0,0
968.597,17,140,10640,140,48,6968,48,10640,0,0,0,0,0
1747.43,6,94,7151,62,38,28646,205,4424,32,33,56360,98,2727
0.28,6,2,116,1,0,0,0,64,1,0,0,0,52
12.254,6,20,4442,10,275,1361,275,958,10,768,1239,1440,3484
1772.095,6,180,15480,120,69,14891,69,8940,60,69,30032,69,6540
0.218,6,14,2247,7,503,36,503,1390,7,473,36,473,857
0.585,17,21,6113,9,332,72,1350,3247,12,210,50,1350,2866
15.87,17,15,5053,7,360,2632,1350,2716,8,264,2255,1350,2337
240.623,2,5,160,5,8,60155,8,160,0,0,0,0,0
56.605,6,31,7725,11,155,9,267,1226,20,355,2978,3417,6499
1761.721,6,124,12524,68,66,26293,517,4740,56,255,32029,3819,7784
7.223,6,1713,1581352,1081,1385,6,1408,1543824,632,776,11,1408,37528
1770.471,6,101,9278,66,64,27238,64,5544,35,58,52068,58,3734
762.373,6,12,728,8,31,108910,31,444,4,31,254119,31,284
0.148,6,7,364,0,0,0,0,0,7,0,0,0,364
959.857,1,5,280,5,28,239964,28,280,0,0,0,0,0
1796.837,6,363,24966,156,46,11575,46,10200,207,46,8722,46,14766
244.3,6,30,8218,11,189,11829,516,1390,19,379,13567,1452,6828
0.954,17,5,1176,3,32,475,32,180,2,470,4,470,996
369.366,6,25,1651,17,177,23085,177,1117,8,110,9236,110,534
0.013,6,9,1557,5,515,3,515,783,4,558,4,558,774
111.676,6,36,10097,14,183,8590,314,2214,22,583,5306,1179,7883
1774.645,6,188,11527,94,47,19082,208,6775,94,31,19079,31,4752
1799.305,1,16,896,16,28,119953,28,896,0,0,0,0,0
230.297,17,4,240,2,32,230296,32,120,2,32,230296,32,120
1798.347,17,142,11360,71,48,25690,48,5396,71,56,25690,56,5964
0.606,6,13,1096,7,283,71,283,663,6,105,86,105,433
1687.011,17,31,24123,31,750,56233,1451,24123,0,0,0,0,0
0.013,17,4,764,2,32,8,32,120,2,294,8,294,644
1740.563,17,30,6930,30,203,60019,203,6930,0,0,0,0,0
0.966,6,54,13954,25,549,40,1429,4876,29,416,33,1460,9078
1776.498,17,73,3060,72,14,25021,14,3024,1,8,0,8,36
1786.838,6,103,8404,68,66,26669,66,4964,35,60,52551,60,3440
1799.616,17,142,11360,71,48,25708,48,5396,71,56,25708,56,5964
9.062,6,14,2242,8,210,1284,210,844,6,545,1749,904,1398
0.252,17,3,451,2,39,126,39,134,1,289,0,289,317
566.784,6,45,6539,22,134,13350,519,2093,23,195,25759,1420,4446
0.003,17,2,134,1,31,0,31,59,1,47,0,47,75
1794.096,17,144,11520,72,48,25268,48,5472,72,56,25268,56,6048
1.485,6,38,8254,19,321,82,1164,2718,19,433,67,1460,5536
280.472,6,29,7392,13,158,23372,267,1317,16,603,18694,2076,6075
881.274,2,5,160,5,8,220318,8,160,0,0,0,0,0
370.659,6,213,23344,105,87,3564,1448,9517,108,131,3464,1983,13827
210.96,17,4,352,2,60,210959,60,176,2,60,210959,60,176
31.55,6,7,336,1,0,0,0,48,6,0,6308,0,288
0.156,6,10,1383,6,145,31,145,389,4,830,48,830,994
0.449,6,57,24416,33,988,14,1380,17246,24,515,17,1923,7170
314.935,6,23,2585,7,242,52488,517,1111,16,323,20995,499,1474
1798.704,6,368,25759,214,99,8444,469,15045,154,69,11753,69,10714
10.96,6,20,4390,11,275,1096,275,998,9,755,773,1414,3392
39.393,17,44,6468,22,48,1870,48,1672,22,190,1874,308,4796
25.5,6,41,8569,20,171,1342,721,2174,21,504,1264,2840,6395
24.446,6,11,5489,5,106,6110,106,314,6,1642,4888,3417,5175
0.965,6,30,9453,17,448,60,1360,3401,13,788,62,1747,6052
1785.178,1,339,28476,339,56,5281,56,28476,0,0,0,0,0
1799.069,2,10,320,10,8,199896,8,320,0,0,0,0,0
0.423,6,10,968,5,256,103,256,460,5,304,102,304,508
53.709,1,12,1248,0,0,0,0,0,12,76,4882,76,1248
1789.214,1,260,14560,260,28,6908,28,14560,0,0,0,0,0
1781.144,6,104,8376,68,65,26584,65,4930,36,59,50887,59,3446
260.676,6,21,6646,3,106,7,106,234,18,355,15333,1420,6412
1790.841,1,189,10584,189,28,9525,28,10584,0,0,0,0,0
190.692,6,328,265011,204,1313,939,1368,245754,124,614,1357,2519,19257
1.394,6,49,18302,28,882,51,1360,12641,21,437,60,2720,5661
280.207,6,29,7392,14,158,21554,267,1357,15,678,20010,3436,6035
0.012,17,2,337,1,48,0,48,76,1,233,0,233,261
8.807,6,17,5313,9,275,1100,275,643,8,1084,1013,1414,4670
1796.488,17,768,46308,768,32,2342,37,46308,0,0,0,0,0
3.119,6,30,14045,17,772,194,1360,6120,13,1232,245,2574,7925
378.526,2,4,128,4,8,126175,8,128,0,0,0,0,0
372.43,6,25,1651,17,177,23276,177,1117,8,110,9252,110,534
58.059,17,4,352,2,60,58057,60,176,2,60,58058,60,176
280.499,6,23,7014,12,181,25499,267,1208,11,893,28041,4836,5806
45.421,6,38,9429,21,152,2271,452,1798,17,630,1591,2720,7631
0.52,6,6,324,4,0,173,0,216,2,0,212,0,108
0.302,17,2,144,1,36,0,36,64,1,52,0,52,80
508.537,6,29,4304,15,265,36323,517,2404,14,294,39117,338,1900
3.246,6,81,68477,54,748,61,1360,8180,27,3700,116,16320,60297
897.99,6,49,10591,23,370,40815,531,2352,26,859,35917,1408,8239
0.807,6,20,5952,11,282,80,548,1292,9,716,90,1420,4660
0.324,6,27,8955,13,234,27,575,1620,14,942,24,1408,7335
328.455,6,36,4289,19,304,18247,304,2808,17,83,20470,83,1481
1269.304,6,266,19664,154,119,8296,469,11872,112,69,11372,69,7792
14.121,17,4,240,2,32,14120,32,120,2,32,14120,32,120
958.57,1,24,1344,24,28,41676,28,1344,0,0,0,0,0
2.021,6,14,2351,8,188,288,245,700,6,703,354,1152,1651
0.051,6,9,1002,5,213,12,213,417,4,421,14,421,585
240.205,6,53,18214,28,814,8896,1418,15313,25,199,10008,580,2901
1780.491,17,128,10240,64,48,28261,48,4864,64,56,28261,56,5376
61.429,6,37,15936,22,800,2925,1448,9158,15,665,4369,1448,6778
0.02,17,2,192,1,37,0,37,65,1,99,0,99,127
3.03,6,7,400,3,0,1515,0,160,4,0,990,0,240
0.905,6,34,13173,19,872,50,1460,6911,15,627,51,1460,6262
1688.515,1,8,448,8,28,241216,28,448,0,0,0,0,0
240.17,6,53,17713,28,795,8895,1408,14980,25,178,10006,580,2733
40.145,17,3,228,3,48,20072,48,228,0,0,0,0,0
1779.16,17,142,11360,71,48,25416,48,5396,71,56,25416,56,5964
145.113,6,25,6318,9,272,93,516,1180,16,345,9668,1452,5138
158.306,17,208,199461,194,997,817,1252,198901,14,12,3345,12,560
0.074,17,2,279,1,36,0,36,64,1,187,0,187,215
755.582,2,7,224,7,8,125930,8,224,0,0,0,0,0
0.095,6,11,3653,6,171,18,171,491,5,1447,22,2676,3162
0.057,17,2,152,1,48,0,48,76,1,48,0,48,76
3.138,6,76,43865,38,974,84,1460,12278,38,1155,80,1607,31587
1776.189,17,73,3060,72,14,25016,14,3024,1,8,0,8,36
152.342,6,20,8154,11,511,86,1194,2005,9,1155,19021,3151,6149
0.028,6,10,861,6,182,5,182,490,4,77,7,134,371
280.256,6,31,7472,14,158,21558,267,1357,17,543,17513,1400,6115
1740.122,6,87,6322,58,31,30528,31,3915,29,31,62146,31,2407
105.087,17,4,558,2,36,105079,36,128,2,187,105083,187,430
0.124,6,10,1569,5,627,30,627,895,5,406,31,406,674
139.856,17,4,352,2,60,139855,60,176,2,60,139855,60,176
175.071,6,1635,808296,890,841,196,1152,770945,745,397,234,1179,37351
242.514,6,53,21571,34,606,7348,1360,14150,19,738,108,3494,7421
1.005,17,2,116,2,30,1005,30,116,0,0,0,0,0
6.691,6,13,2315,7,188,1115,245,660,6,1407,1282,1407,1655
924.724,1,34,1904,34,28,28021,28,1904,0,0,0,0,0
4.322,17,4,824,2,48,4304,48,152,2,308,4298,308,672
0.321,17,8,2758,8,316,45,355,2758,0,0,0,0,0
65.432,6,28,7217,13,155,5452,267,1306,15,482,4673,1997,5911
1799.996,6,211,16359,78,70,22986,315,7765,133,48,13636,78,8594
1772.367,6,180,15480,120,69,14893,69,8940,60,69,30039,69,6540
300.796,2,3,96,3,8,150398,8,96,0,0,0,0,0
285.464,6,76,54601,49,1219,5947,1368,46460,27,841,2388,2519,8141
301.793,6,57,23575,31,1081,10059,1440,17492,26,358,384,1440,6083
1.188,6,49,20278,27,900,45,1360,14622,22,476,48,2715,5656
5.995,6,964,831201,583,1383,10,1420,811740,381,467,15,1883,19461
0.524,6,10,968,5,256,114,256,460,5,304,121,304,508
1263.362,2,13,416,13,8,105280,8,416,0,0,0,0,0
0.122,1,2,112,2,28,122,28,112,0,0,0,0,0
1786.762,6,102,8296,68,65,26668,65,4930,34,59,54141,59,3366
1772.584,6,180,15480,120,69,14895,69,8940,60,69,30039,69,6540
0.137,17,2,268,1,33,0,33,61,1,179,0,179,207
0.998,17,2,685,1,308,0,308,336,1,321,0,321,349
1.01,6,14,5975,5,186,250,267,581,9,837,124,1420,5394
1793.755,17,66,2766,65,14,28027,14,2730,1,8,0,8,36
1148.997,6,12,1308,12,69,104454,69,1308,0,0,0,0,0
60.374,6,9,820,5,226,15093,226,494,4,110,20054,110,326
4.009,17,8,1272,4,33,1332,33,244,4,229,1332,233,1028
0.06,17,2,212,1,46,0,46,74,1,110,0,110,138
0.301,6,26,8911,13,237,25,590,1635,13,1098,24,2816,7276
1739.263,6,87,6322,58,31,30513,31,3915,29,31,62115,31,2407
9.161,17,12,918,6,40,1787,41,411,6,56,1829,57,507
1173.437,1,6,336,6,28,234687,28,336,0,0,0,0,0
1.271,6,47,18160,26,882,50,1360,12544,21,476,54,2715,5616
161.029,17,4,352,2,60,161027,60,176,2,60,161028,60,176
125.161,17,21,1854,21,60,6258,346,1854,0,0,0,0,0
66.467,17,4,352,2,48,66455,48,152,2,72,66455,72,200
125.892,2,2,64,2,8,125892,8,64,0,0,0,0,0
0.165,6,3,152,2,0,165,0,100,1,0,0,0,52
4.905,6,39,7269,19,218,272,314,3383,20,513,244,1179,3886
280.229,6,29,7392,13,158,23352,267,1317,16,603,18679,2800,6075
1796.223,6,392,27671,222,101,8127,469,16386,170,69,10626,69,11285
141.885,17,24,1824,24,48,6168,48,1824,0,0,0,0,0
0.992,17,4,396,2,39,990,39,134,2,103,980,103,262
12.342,6,112,73114,60,956,209,1360,14095,52,1388,238,2720,59019
67.606,17,4,352,2,48,67597,48,152,2,72,67597,72,200
1796.418,17,433,145382,433,307,4158,323,145382,0,0,0,0,0
6.772,6,41,7349,22,218,322,314,3503,19,513,361,1179,3846
0.123,17,2,672,2,308,123,308,672,0,0,0,0,0
1612.202,1,68,3808,68,28,24062,28,3808,0,0,0,0,0
24.857,6,37,8495,18,410,505,882,1982,19,441,1373,1460,6513
4.784,6,40,7309,20,218,251,314,3423,20,440,238,1152,3886
3.945,17,34,9421,16,292,260,1350,5131,18,210,230,1350,4290
1.346,17,4,240,2,32,1345,32,120,2,32,1344,32,120
310.924,6,31,7199,15,201,4008,498,1814,16,364,20722,1420,5385
1638.585,2,12,384,12,8,148962,8,384,0,0,0,0,0
1786.516,6,104,8444,68,66,26664,66,4964,36,60,51040,60,3480
237.42,17,4,352,2,60,237418,60,176,2,60,237419,60,176
0.241,6,10,766,5,185,58,185,453,5,45,60,45,313
129.609,1,4,224,4,28,43203,28,224,0,0,0,0,0
0.93,6,10,1687,7,100,155,100,384,3,1179,329,1179,1303
0.109,6,9,1340,5,145,27,145,349,4,827,29,827,991
5.023,17,4,558,2,36,5008,36,128,2,187,5013,187,430
1.087,17,3,1176,3,364,543,364,1176,0,0,0,0,0
2.978,17,29,6123,13,231,245,1350,3369,16,144,196,1350,2754
0.109,17,2,152,1,48,0,48,76,1,48,0,48,76
7.156,6,1702,1666657,1143,1385,6,1408,1632925,559,776,12,1408,33732
320.523,6,75,12204,30,198,6745,1189,3589,45,234,7284,1420,8615
1774.668,6,188,16352,120,69,14913,69,8940,68,69,26482,69,7412
1761.107,1,58,4872,58,56,30896,56,4872,0,0,0,0,0
5.135,17,3,208,2,36,5002,36,128,1,52,0,52,80
224.018,17,4,240,2,32,224017,32,120,2,32,224017,32,120
18.155,6,31,8912,14,158,1396,267,1357,17,687,1128,1781,7555
120.547,17,4,352,2,60,120546,60,176,2,60,120546,60,176
75.43,6,22,908,11,0,4809,0,448,11,0,7542,0,460
1740.516,17,30,20190,30,645,60017,645,20190,0,0,0,0,0
458.402,17,68,5168,68,48,6841,48,5168,0,0,0,0,0
1.373,6,41,10563,21,514,68,1440,4987,20,433,62,1440,5576
66.731,6,37,12164,20,710,3512,1440,5818,17,706,4159,1587,6346
0.361,6,26,9013,13,257,30,669,1714,13,1102,29,2804,7299
346.897,6,13,1464,1,106,0,106,146,12,76,31535,90,1318
300.666,6,45,8792,25,263,12527,707,2145,20,416,487,2720,6647
1773.262,6,182,15629,121,69,14777,69,8980,61,69,29550,69,6649
1798.417,1,278,29468,278,78,6492,78,29468,0,0,0,0,0
4.851,6,39,7269,19,218,269,314,3383,20,513,240,1179,3886
12.287,17,4,352,2,60,12286,60,176,2,60,12285,60,176
412.865,6,39,7297,19,262,22933,517,1784,20,744,21726,1418,5513
0.279,17,2,362,1,41,0,41,69,1,265,0,265,293
214.533,6,38,16036,23,805,9751,1408,9258,15,665,4364,1408,6778
15.879,17,6,2016,6,308,3175,308,2016,0,0,0,0,0
0.007,6,14,5639,8,134,1,134,474,6,2456,1,3453,5165
4.207,6,38,7229,20,218,221,314,3423,18,513,232,1179,3806
1775.997,6,180,15480,120,69,14924,69,8940,60,69,30098,69,6540
2.261,6,13,2311,8,188,323,245,700,5,1407,500,1407,1611
145.597,6,22,8224,11,511,95,1194,2017,11,822,14541,1360,6207
281.616,6,30,7432,13,158,23468,267,1317,17,543,17579,1400,6115
0.06,6,2,116,1,0,0,0,52,1,0,0,0,64
1739.591,1,8,448,8,28,248513,28,448,0,0,0,0,0
0.007,17,2,527,1,33,0,33,61,1,438,0,438,466
0.226,17,7,2368,7,310,37,354,2368,0,0,0,0,0
1789.957,6,370,23425,213,69,8443,69,13005,157,69,11474,69,10420
5.568,6,40,7309,21,218,278,314,3463,19,513,295,1179,3846
300.655,6,35,8385,20,299,15823,852,2031,15,574,605,4848,6354
1772.329,6,180,15480,120,69,14893,69,8940,60,69,30037,69,6540
1796.806,6,388,27373,220,102,8204,469,16168,168,69,10758,69,11205
27.049,17,9,2097,9,205,3381,205,2097,0,0,0,0,0
3.389,6,572,476086,341,1372,9,1420,462592,231,468,14,3303,13494
1797.346,6,360,23025,206,69,8767,69,12518,154,69,11747,69,10507
0.455,6,7,376,4,0,151,0,216,3,0,120,0,160
0.05,6,12,3513,6,126,10,126,446,6,1373,8,1448,3067
0.179,6,10,1669,6,551,35,947,1346,4,159,59,159,323
1798.326,17,763,46032,763,32,2360,37,46032,0,0,0,0,0
2.575,17,28,6811,12,249,231,1350,3326,16,189,169,1350,3485
1755.58,17,12,498,11,14,175558,14,462,1,8,0,8,36
222.815,6,38,22320,23,950,10127,1178,15456,15,607,2823,1448,6864
220.523,17,22,1408,22,36,10501,36,1408,0,0,0,0,0
397.846,6,59,7592,28,121,14728,722,3048,31,140,13255,2026,4544
299.097,1,4,224,4,28,99699,28,224,0,0,0,0,0
93.093,6,21,6034,13,220,7757,516,1405,8,717,8976,1452,4629
6.357,6,43,7770,22,218,302,314,3503,21,427,305,1152,4267
1786.208,17,87,3648,86,14,21014,14,3612,1,8,0,8,36
28.43,6,20,4452,10,296,3158,722,1405,10,420,3137,1408,3047
1772.688,6,180,15480,120,69,14896,69,8940,60,69,30039,69,6540
0.948,6,27,9390,14,450,72,1402,2988,13,635,66,3047,6402
0.634,17,2,219,1,50,0,50,78,1,113,0,113,141
882.487,2,6,192,6,8,176497,8,192,0,0,0,0,0
1788.404,1,132,7392,132,28,13651,28,7392,0,0,0,0,0
19.392,6,36,8280,18,351,525,739,1807,18,521,1131,2720,6473
1.549,6,12,1044,6,283,273,283,611,6,105,273,105,433
1790.278,1,216,12096,216,28,8326,28,12096,0,0,0,0,0
31.177,6,7,420,1,0,0,0,60,6,0,6234,0,360
10.717,6,6,328,4,0,3572,0,216,2,0,10704,0,112
1.069,6,32,8952,14,158,82,267,1357,18,687,58,1781,7595
1.422,6,48,14732,26,484,56,1432,3552,22,571,51,1432,11180
1793.416,6,410,26198,229,69,7865,69,14473,181,69,9961,69,11725
0.175,1,10,840,10,56,19,56,840,0,0,0,0,0
209.643,17,4,240,2,32,209642,32,120,2,32,209642,32,120
0.578,6,37,19233,21,170,28,265,1950,16,1644,36,4206,17283
6.979,6,24,3976,10,256,774,256,2196,14,304,536,304,1780
280.038,6,29,7392,14,158,21541,267,1357,15,678,20002,3436,6035
300.841,6,37,10154,22,683,14325,1420,5698,15,427,617,3020,4456
0.135,17,2,144,1,36,0,36,64,1,52,0,52,80
288.636,6,316,50555,177,304,1639,304,35340,139,83,2091,83,15215
541.43,2,7,224,7,8,90238,8,224,0,0,0,0,0
293.092,6,147,114253,93,1275,3185,1368,103094,54,737,2032,2736,11159
1781.72,17,142,11360,71,48,25453,48,5396,71,56,25453,56,5964
0.037,17,2,154,1,33,0,33,61,1,65,0,65,93
1684.53,2,25,800,25,8,70188,8,800,0,0,0,0,0
0.276,6,21,5000,11,137,27,267,1132,10,692,28,1467,3868
59.492,17,4,352,2,60,59491,60,176,2,60,59491,60,176
0.12,17,2,180,1,30,0,30,58,1,94,0,94,122
316.853,6,56,11663,30,141,10925,615,3636,26,387,12184,1629,8027
0.02,17,2,144,1,36,0,36,64,1,52,0,52,80
52.305,6,46,10006,22,450,560,766,2809,24,345,2268,2720,7197
280.316,6,29,7392,13,158,23359,267,1317,16,603,18682,2036,6075
1780.419,6,107,8564,68,66,26573,66,4964,39,60,46850,60,3600
0.704,17,14,8028,8,670,100,1350,5586,6,379,125,1350,2442
2.609,6,58,24495,34,999,79,1460,18463,24,421,100,4075,6032
0.304,6,21,6055,11,284,29,517,1716,10,952,33,1906,4339
240.261,6,55,19006,30,774,8284,1408,16283,25,176,10010,580,2723
38.05,17,4,352,2,60,38049,60,176,2,60,38049,60,176
2.911,17,4,854,2,39,2906,39,134,2,332,2904,332,720
142.473,6,14,3145,7,92,23745,92,452,7,465,23704,1408,2693
16.81,17,15,8018,7,614,2796,1350,4494,8,412,2396,1350,3524
1790.149,6,356,22520,208,69,8648,69,12460,148,69,12177,69,10060
2.912,6,16,5004,9,290,364,517,1057,7,1191,475,1396,3947
2.149,17,4,314,2,31,2087,31,118,2,70,2014,70,196
0.398,6,24,7437,13,334,33,663,2021,11,967,38,1912,5416
1781.762,6,361,22858,210,69,8525,69,12678,151,69,11878,69,10180
0.01,17,2,393,1,32,0,32,60,1,305,0,305,333
1796.671,17,448,39612,404,35,4458,288,25708,44,288,40951,288,13904
315.97,6,90,20332,42,287,7706,1360,10063,48,268,6719,1929,10269
1797.842,1,345,28980,345,56,5226,56,28980,0,0,0,0,0
0.007,17,2,366,1,33,0,33,61,1,277,0,277,305
164.087,6,32,8952,14,158,12622,267,1357,18,624,9640,1400,7595
186.119,17,4,352,2,60,186117,60,176,2,60,186118,60,176
2.438,17,4,352,2,60,2437,60,176,2,60,2437,60,176
309.482,6,6,240,6,0,0,0,240,0,0,0,0,0
240.196,6,54,17652,29,786,8578,1418,14893,25,181,10007,580,2759
127.789,6,21,9148,11,499,81,1193,1983,10,1125,14178,2279,7165
1.671,6,9,527,5,43,417,43,311,4,0,552,0,216
0.326,17,2,214,1,39,0,39,67,1,119,0,119,147
1789.296,17,83,3480,82,14,22090,14,3444,1,8,0,8,36
1738.702,6,87,6322,58,31,30503,31,3915,29,31,62096,31,2407
107.061,6,21,860,9,0,6308,0,368,12,0,9731,0,492
1443.877,2,16,512,16,8,96258,8,512,0,0,0,0,0
1785.21,17,87,3648,86,14,21002,14,3612,1,8,0,8,36
5.062,17,3,343,2,36,5007,36,128,1,187,0,187,215
83.26,6,46,21505,25,598,3469,1402,4896,21,1292,4161,4206,16609
0.423,6,12,1653,6,288,84,288,548,6,426,49,434,1105
349.887,6,46,6370,25,112,14578,722,2641,21,239,17485,1408,3729
782.053,2,6,192,6,8,156410,8,192,0,0,0,0,0
0.555,6,49,20178,27,996,21,1380,15056,22,468,24,3303,5122
1751.224,6,95,7203,63,38,28245,205,4476,32,33,56481,98,2727
1771.434,6,106,9684,68,64,26439,64,5724,38,58,47874,58,3960
0.106,1,2,112,2,28,106,28,112,0,0,0,0,0
0.289,6,41,29196,18,243,17,444,1674,23,1385,10,1798,27522
2.732,17,8,1586,4,33,906,33,244,4,307,894,327,1342
1770.863,6,101,9344,66,65,27244,65,5577,35,59,52080,59,3767
300.965,6,46,15497,27,875,11575,1360,9890,19,402,489,2667,5607
39.462,17,4,352,2,60,39460,60,176,2,60,39461,60,176
0.016,17,2,184,1,32,0,32,60,1,96,0,96,124
1795.377,17,447,39864,402,35,4477,288,25644,45,288,40017,288,14220
1.372,6,41,9316,22,399,65,1360,3735,19,400,65,1360,5581
240.218,6,54,17712,29,742,8579,1408,14884,25,190,10008,580,2828
42.262,6,14,580,8,0,6037,0,324,6,0,4874,0,256
0.052,6,2,133,1,0,0,0,40,1,53,0,53,93
361.039,2,4,128,4,8,120346,8,128,0,0,0,0,0
280.448,6,31,7472,13,158,23370,267,1317,18,603,16493,2076,6155
0.936,6,10,1687,7,100,156,100,384,3,1179,337,1179,1303
7.361,6,7,300,3,0,3680,0,124,4,0,2420,0,176
45.201,6,18,6865,5,352,7130,722,1325,13,607,3751,1448,5540
81.205,6,3333,2975612,2050,1365,39,1368,2895274,1283,899,63,2736,80338
121.899,1,6,336,6,28,24379,28,336,0,0,0,0,0
31.374,6,61,23716,32,1144,389,1440,17401,29,285,1114,1440,6315
1782.244,17,86,3606,85,14,21217,14,3570,1,8,0,8,36
9.449,6,1284,1156509,774,1414,11,1448,1125325,510,776,18,1448,31184
3.999,17,4,244,4,33,1333,33,244,0,0,0,0,0
1785.539,6,102,8364,68,66,26649,66,4964,34,60,54104,60,3400
0.819,6,18,6377,11,141,81,275,726,7,1073,35,2840,5651
1739.943,17,60,20160,60,308,29490,308,20160,0,0,0,0,0
1787.599,6,4317,4841037,1620,131,1104,350,98733,2697,1755,663,8412,4742304
12.65,6,2293,2152581,1486,1371,8,1408,2105953,807,931,15,2816,46628
1.468,6,192,158392,81,239,18,255,7567,111,1330,13,1674,150825
257.283,6,27,6921,13,229,162,498,1672,14,425,19784,2642,5249
1.268,6,52,19278,29,879,45,1360,13537,23,437,49,2720,5741
1795.033,6,244,35804,152,302,11887,302,26032,92,83,19725,83,9772
133.78,6,25,10094,12,532,59,1360,2642,13,988,11138,1360,7452
7.703,6,14,1247,7,222,1282,222,728,7,231,1282,231,519
280.414,6,30,7432,13,158,23367,267,1317,17,543,17525,1400,6115
93.005,6,5,293,4,31,31001,31,222,1,31,0,31,71
1783.918,1,67,5628,67,56,27029,56,5628,0,0,0,0,0
0.271,17,2,148,1,32,0,32,60,1,60,0,60,88
1773.134,6,181,15589,120,69,14900,69,8940,61,69,29544,69,6649
5.314,17,3,208,2,36,5008,36,128,1,52,0,52,80
0.143,17,2,172,1,50,0,50,78,1,66,0,66,94
899.177,6,12,728,8,31,128453,31,444,4,31,299622,31,284
1.016,6,25,8806,14,290,78,803,1754,11,942,83,1460,7052
1775.727,1,67,5628,67,56,26904,56,5628,0,0,0,0,0
1786.631,6,104,8376,68,65,26666,65,4930,36,59,51044,59,3446
3.915,6,13,3116,8,49,559,92,523,5,1164,929,1448,2593
1.728,17,2,172,1,50,0,50,78,1,66,0,66,94
280.484,6,30,7432,13,158,23373,267,1317,17,543,17524,1400,6115
1741.958,6,155,9804,82,51,21505,208,5985,73,31,24190,31,3819
209.131,1,2,232,2,88,209131,88,232,0,0,0,0,0
281.044,6,31,7481,13,158,23420,267,1317,18,544,16527,1380,6164
1757.955,1,82,6888,0,0,0,0,0,82,56,21703,56,6888
0.258,6,3,160,2,0,258,0,100,1,0,0,0,60
542.88,6,5563,5011720,2872,486,189,528,168978,2691,1751,179,18304,4842742
12.98,6,41,9669,20,218,683,314,3423,21,675,621,1179,6246
1659.003,6,151,18209,93,82,18032,267,7749,58,156,20797,1917,10460
1786.568,6,102,8228,68,64,26665,64,4896,34,58,54135,58,3332
0.146,6,10,1379,5,145,36,145,349,5,826,25,826,1030
1797.375,17,317,74885,317,208,5687,422,74885,0,0,0,0,0
61.339,6,37,16032,22,810,2920,1448,9254,15,665,4363,1448,6778
1069.06,17,767,53999,683,40,1567,41,46893,84,56,530,57,7106
0.151,17,2,214,1,39,0,39,67,1,119,0,119,147
1786.227,6,102,8296,68,65,26660,65,4930,34,59,54125,59,3366
50.356,6,38,8744,20,347,2650,728,1887,18,471,511,1360,6857
1.217,6,32,8620,17,222,73,540,2044,15,852,73,1360,6576
352.034,6,21,6605,3,106,10,106,234,18,352,20707,1460,6371
1773.513,6,180,15480,120,69,14903,69,8940,60,69,30056,69,6540
1.013,17,8,568,4,32,333,32,240,4,54,333,60,328
725.782,6,101,13656,55,87,13440,267,4573,46,180,16128,1452,9083
56.728,6,31,7725,11,155,9,267,1226,20,355,2985,3417,6499
1681.539,17,14,1036,7,30,280250,30,406,7,62,280251,62,630
1792.076,1,108,6048,108,28,16748,28,6048,0,0,0,0,0
1786.211,17,87,3648,86,14,21014,14,3612,1,8,0,8,36
281.254,6,31,7813,14,158,21634,267,1357,17,577,17576,1400,6456
1754.064,17,140,11200,70,48,25421,48,5320,70,56,25421,56,5880
0.5,17,3,451,2,39,70,39,134,1,289,0,289,317
21.211,17,4,352,2,48,21203,48,152,2,72,21203,72,200
1700.694,17,12,498,11,14,170069,14,462,1,8,0,8,36
1.988,6,15,3479,6,288,358,288,548,9,639,226,853,2931
31.711,17,4,272,2,40,31710,47,136,2,40,31710,47,136
93.791,6,35,9681,12,159,8525,267,1602,23,397,4262,1460,8079
31.804,6,209,161275,96,70,334,133,5311,113,1376,283,1408,155964
4.751,17,24,7353,9,295,593,1350,2915,15,267,227,1350,4438
1715.738,17,210,51914,210,219,8209,422,51914,0,0,0,0,0
1082.819,2,12,384,12,8,98438,8,384,0,0,0,0,0
5.55,6,11,2239,5,188,1387,245,580,6,703,1055,1152,1659
12.317,6,1944,1705000,1179,1390,10,1420,1670179,765,420,16,1420,34821
516.279,6,1186,962177,552,127,936,318,38197,634,1453,815,2804,923980
1.711,6,14,2351,8,188,244,245,700,6,703,290,1152,1651
536.775,17,8,2045,4,31,178923,37,239,4,423,178923,463,1806
60.393,6,11,2994,6,92,12078,92,400,5,1165,15049,1408,2594
518.62,6,33,2560,16,65,25227,65,1160,17,45,32408,59,1400
1784.849,6,80,4250,40,26,45764,26,2132,40,26,45764,26,2118
1625.46,6,35,5409,22,241,77402,241,4013,13,92,135426,92,1396
1.149,6,26,9564,13,164,81,267,1388,13,1070,81,2816,8176
2.867,6,2,88,2,0,0,0,88,0,0,0,0,0
262.471,17,4,352,2,60,262469,60,176,2,60,262470,60,176
12.258,6,1944,1694200,1180,1381,10,1420,1659419,764,420,16,1420,34781
0.002,6,3,189,1,0,0,0,40,2,69,0,69,149
1681.278,17,14,3843,7,30,280212,30,406,7,463,280212,463,3437
1799.468,17,777,46830,777,32,2318,37,46830,0,0,0,0,0
0.051,17,8,2454,8,278,7,317,2454,0,0,0,0,0
5.208,6,9,520,4,0,1736,0,220,5,0,754,0,300
0.5,17,12,7220,6,768,98,1350,4778,6,379,92,1350,2442
0.088,17,4,360,2,30,0,30,116,2,94,46,94,244
5.636,6,46,8449,22,227,268,314,4062,24,427,234,1152,4387
299.565,6,6,364,4,31,99855,31,222,2,31,299539,31,142
301.117,6,40,9884,22,571,14338,1360,4362,18,399,511,1360,5522
0.304,6,28,9193,13,271,25,726,1771,15,829,21,1408,7422
0.33,6,26,6066,13,164,27,453,1494,13,555,25,1542,4572
0.437,6,28,9023,13,232,36,569,1614,15,827,29,1438,7409
0.404,6,14,1733,7,288,62,288,588,7,284,37,434,1145
4.838,6,39,7269,21,218,241,314,3463,18,513,269,1179,3806
0.648,6,10,924,5,283,111,283,551,5,105,109,105,373
9.117,6,87,28015,44,589,212,1152,21813,43,407,211,1152,6202
293.441,17,4,352,2,60,293440,60,176,2,60,293439,60,176
1799.488,17,751,45322,751,32,2399,37,45322,0,0,0,0,0
0.62,6,109,87396,51,131,12,232,2569,58,1556,10,2760,84827
16.983,6,47,16387,21,314,840,776,3144,26,869,671,1360,13243
1.28,17,2,572,1,39,0,39,67,1,477,0,477,505
1764.747,6,114,6855,63,27,28459,27,3732,51,27,35291,27,3123
0.562,6,2,111,1,0,0,0,40,1,31,0,31,71
1.355,6,10,1687,7,100,225,100,384,3,1179,542,1179,1303
374.932,6,25,1651,17,177,23433,177,1117,8,110,9257,110,534
60.649,6,45,20723,25,131,2527,134,1832,20,991,3189,1448,18891
1.491,6,19,3781,10,234,165,564,1452,9,463,162,1343,2329
367.355,6,21,1419,15,177,26239,177,989,6,110,12231,110,430
1768.721,6,80,5616,39,36,46543,36,2136,41,449,44216,458,3480
300.852,6,27,11146,15,315,21479,922,1941,12,1089,27337,3056,9205
1772.595,6,187,15967,123,69,14529,69,9129,64,69,28135,69,6838
128.628,6,40,8807,17,412,3726,889,1948,23,348,5840,3488,6859
1207.809,6,226,24761,107,118,10904,469,10102,119,116,10235,1460,14659
832.437,17,68,5440,34,48,25219,48,2584,34,56,25223,56,2856
17.073,6,2,1175,1,0,0,0,40,1,1095,0,1095,1135
1794.148,6,247,47315,153,483,11803,483,37427,94,83,19291,83,9888
240.43,6,58,24700,26,548,9616,1418,6299,32,880,7755,1418,18401
1769.556,1,58,4872,58,56,31044,56,4872,0,0,0,0,0
241.021,6,44,7066,22,332,11474,1056,3524,22,264,11474,611,3542
1772.259,6,180,15480,120,69,14892,69,8940,60,69,30033,69,6540
1.572,6,43,10141,23,440,71,1360,4520,20,437,71,2715,5621
0.496,6,25,7455,16,302,33,693,2761,9,721,60,1420,4694
0.01,17,2,459,1,40,0,40,68,1,363,0,363,391
1.345,6,39,8294,19,321,74,1164,2718,20,433,61,1360,5576
5.048,17,4,288,2,36,5016,36,128,2,52,5017,52,160
0.195,6,10,1669,6,551,39,947,1346,4,159,64,159,323
0.094,6,20,6200,11,88,9,88,608,9,1305,11,1880,5592
0.225,6,3,144,2,0,225,0,104,1,0,0,0,40
0.041,17,2,382,1,32,0,32,60,1,294,0,294,322
258.419,6,30,8872,14,158,19878,267,1357,16,763,17224,2036,7515
300.989,6,45,25832,26,804,12039,1408,8633,19,1350,1592,5450,17199
0.439,6,15,1773,7,288,69,288,588,8,284,34,434,1185
0.003,6,3,2880,1,0,0,0,40,2,1368,1,1368,2840
1774.561,6,207,23990,132,89,13546,981,11118,75,138,23973,1926,12872
157.351,6,134,20793,72,304,2216,304,14512,62,83,2579,83,6281
0.166,1,2,112,2,28,166,28,112,0,0,0,0,0
1786.524,6,106,8388,68,64,26664,64,4896,38,58,48282,58,3492
1772.433,6,180,15480,120,69,14894,69,8940,60,69,30034,69,6540
756.802,2,5,160,5,8,189200,8,160,0,0,0,0,0
300.302,6,32,11884,17,592,18768,1402,4457,15,829,17165,1402,7427
1787.947,6,359,22778,208,69,8637,69,12529,151,69,11919,69,10249
368.371,6,226,38122,137,304,2708,304,27888,89,83,4184,83,10234
0.918,6,32,13122,19,695,51,1360,5671,13,768,63,2561,7451
1680.115,1,15,840,15,28,120008,28,840,0,0,0,0,0
1794.11,6,360,24135,210,83,8584,981,13521,150,74,12039,405,10614
1094.603,17,216,16416,216,48,5091,48,16416,0,0,0,0,0
61.628,6,48,27884,30,1034,2125,1408,20201,18,748,3612,1408,7683
372.199,6,25,1651,17,177,23262,177,1117,8,110,9232,110,534
1770.819,6,99,9240,66,65,27243,65,5577,33,59,55334,59,3663
332.566,1,8,448,8,28,47509,28,448,0,0,0,0,0
316.057,6,63,18705,39,324,8317,1360,10040,24,699,13734,4649,8665
0.013,6,2,549,1,469,0,469,509,1,0,0,0,40
21.486,17,43,7138,20,140,1129,1350,3369,23,135,975,1350,3769
612.71,6,47,9104,24,131,14093,501,2149,23,301,27846,1420,6955
156.581,6,41,8646,14,150,2447,267,1618,27,282,6021,1460,7028
280.269,6,28,7352,12,158,25479,267,1277,16,603,18682,1400,6075
0.71,17,3,1167,3,361,355,361,1167,0,0,0,0,0
1788.68,17,87,3648,86,14,21043,14,3612,1,8,0,8,36
1.285,6,8,342,4,0,428,0,164,4,7,351,7,178
0.065,6,6,272,3,0,23,0,136,3,0,24,0,136
1779.849,1,63,5292,63,56,28707,56,5292,0,0,0,0,0
2.864,17,3,1173,3,363,1432,363,1173,0,0,0,0,0
5.813,6,537,464234,334,1324,16,1368,449014,203,776,27,2736,15220
1741.161,6,87,6322,58,31,30546,31,3915,29,31,62182,31,2407
1.73,2,5,200,5,16,432,16,200,0,0,0,0,0
1323.53,2,11,352,11,8,132353,8,352,0,0,0,0,0
1788.637,17,87,3648,86,14,21042,14,3612,1,8,0,8,36
1681.392,17,14,3815,7,30,280228,30,406,7,459,280230,463,3409
2.353,6,24,8004,12,164,176,267,1288,12,1014,181,2331,6716
2.769,17,8,672,4,45,920,45,292,4,67,920,73,380
1691.694,1,7,392,7,28,281949,28,392,0,0,0,0,0
0.114,6,12,2048,7,329,18,500,1030,5,750,28,750,1018
11.638,6,1863,1608810,1124,1377,10,1420,1575029,739,467,15,1883,33781
6.289,6,38,7229,20,218,331,314,3423,18,513,353,1179,3806
1747.528,6,119,12038,75,63,23615,722,6267,44,96,40631,1408,5771
8.303,6,18,6767,9,275,1037,275,643,9,1150,948,1414,6124
828.764,1,12,1641,12,108,75342,351,1641,0,0,0,0,0
0.052,17,2,136,1,32,0,32,60,1,48,0,48,76
11.715,17,4,352,2,48,11696,48,152,2,72,11696,72,200
5.142,6,38,7245,20,218,270,314,3423,18,516,286,1179,3822
1743.69,1,74,6216,0,0,0,0,0,74,56,23886,56,6216
1765.223,17,294,60722,294,178,6024,422,60722,0,0,0,0,0
19.701,6,17,2425,9,211,2462,211,922,8,545,2767,904,1503
1772.266,6,180,15480,120,69,14892,69,8940,60,69,30031,69,6540
0.273,6,46,21802,27,1048,10,1420,16821,19,467,14,1883,4981
17.034,17,27,14030,12,550,1545,1350,6943,15,444,1214,1350,7087
1772.401,6,180,15480,120,69,14894,69,8940,60,69,30036,69,6540
1.46,6,19,3781,10,234,162,564,1452,9,463,159,1343,2329
1796.781,17,447,39864,402,35,4480,288,25644,45,288,40020,288,14220
1741.482,6,92,6668,60,31,29516,31,4062,32,31,56176,31,2606
0.491,6,10,968,5,256,118,256,460,5,304,119,304,508
4.605,6,10,1714,5,100,1151,100,304,5,603,1081,1179,1410
0.941,6,10,1687,7,100,156,100,384,3,1179,341,1179,1303
1.604,6,24,9457,14,372,123,808,1708,10,1222,161,4416,7749
1742.924,6,95,7203,63,38,28111,205,4476,32,33,56214,98,2727
1.671,6,48,18852,26,932,66,1460,13196,22,476,68,2615,5656
7.06,6,6,280,2,0,7060,0,88,4,0,2350,0,192
233.238,6,18,5839,10,784,25915,1360,3538,8,247,33286,272,2301
0.416,6,54,23516,29,1065,14,1380,18262,25,421,16,1923,5254
1781.217,1,246,13776,246,28,7270,28,13776,0,0,0,0,0
1783.814,6,353,22400,205,69,8744,69,12340,148,69,12134,69,10060
1780.819,1,248,26288,248,78,7209,78,26288,0,0,0,0,0
1781.764,6,371,25741,214,99,8365,469,15114,157,69,11421,69,10627
1131.785,6,338,88602,155,573,7349,1440,61405,183,206,6217,1440,27197
1796.441,17,449,39928,404,35,4457,288,25708,45,288,40019,288,14220
2.773,6,2,88,2,0,0,0,88,0,0,0,0,0
277.926,17,4,352,2,60,277924,60,176,2,60,277925,60,176
1798.785,17,144,11520,72,48,25334,48,5472,72,56,25334,56,6048
12.338,6,86,24661,42,533,300,1152,18760,44,413,279,1152,5901
5.791,17,6,610,5,36,1193,36,320,1,262,0,262,290
15.87,6,31,5107,15,154,1133,722,1871,16,342,1045,1408,3236
280.047,6,31,7472,15,158,20003,267,1397,16,603,18666,2036,6075
235.914,17,4,352,2,60,235912,60,176,2,60,235913,60,176
0.007,6,2,519,1,427,0,427,479,1,0,0,0,40
48.894,17,4,352,2,60,48893,60,176,2,60,48893,60,176
325.957,6,72,48016,45,1172,7408,1408,39877,27,961,2370,3847,8139
2.568,6,12,1414,6,304,513,304,916,6,83,478,83,498
0.016,17,2,231,1,34,0,34,62,1,141,0,141,169
119.538,17,4,1344,4,308,39846,308,1344,0,0,0,0,0
3.663,6,2,88,2,0,0,0,88,0,0,0,0,0
0.183,17,2,2382,2,1163,183,1163,2382,0,0,0,0,0
1784.314,6,365,23087,211,69,8496,69,12787,154,69,11659,69,10300
1789.528,6,184,15778,122,69,14789,69,9020,62,69,29323,69,6758
12.972,6,15,3511,4,92,4324,92,296,11,293,948,1408,3215
0.128,1,2,112,2,28,128,28,112,0,0,0,0,0
0.322,6,23,4494,11,165,32,456,1394,12,493,27,888,3100
1790.492,6,356,22589,207,69,8691,69,12420,149,69,12097,69,10169
10.816,6,927,778877,513,1430,20,1448,750681,414,931,25,2761,28196
0.0,17,2,172,1,50,0,50,78,1,66,0,66,94
1786.626,6,102,8296,68,65,26666,65,4930,34,59,54137,59,3366
1768.538,6,101,9410,66,66,27208,66,5610,35,60,52010,60,3800
1681.553,1,15,840,15,28,120110,28,840,0,0,0,0,0
1760.949,6,78,4056,39,0,46339,0,2028,39,0,46339,0,2028
1.69,6,13,2311,8,188,241,245,700,5,1407,356,1407,1611
0.212,17,2,2380,2,1162,212,1162,2380,0,0,0,0,0
5.407,6,42,8289,21,227,270,314,4022,21,489,256,1179,4267
18.791,6,17,4400,8,271,2684,515,1139,9,413,2296,1452,3261
2.148,6,20,3833,11,234,214,564,1504,9,463,246,1343,2329
1745.843,6,99,7411,63,38,28158,205,4476,36,33,49872,98,2935
300.836,6,50,10558,25,439,12534,910,3290,25,312,537,1460,7268
0.545,17,3,543,2,39,327,39,134,1,381,0,381,409
227.916,6,4506,5676810,1257,774,181,1368,92514,3249,1680,70,5472,5584296
1794.812,17,179,13962,179,50,10083,50,13962,0,0,0,0,0
260.426,17,4,240,2,32,260425,32,120,2,32,260425,32,120
21.064,17,4,288,2,36,21031,36,128,2,52,21033,52,160
1763.675,1,246,26076,246,78,7198,78,26076,0,0,0,0,0
1791.848,17,179,13962,179,50,10066,50,13962,0,0,0,0,0
45.609,17,4,352,2,60,45608,60,176,2,60,45608,60,176
12.087,6,22,5603,12,275,1098,275,767,10,1104,1098,1440,4836
235.683,2,2,64,2,8,235683,8,64,0,0,0,0,0
0.492,6,27,9141,13,268,41,710,1758,14,947,35,1368,7383
1773.721,6,106,8742,69,45,26084,205,5096,37,46,49263,435,3646
1684.537,17,14,3843,7,30,280754,30,406,7,463,280754,463,3437
154.285,6,42,8329,19,123,8570,267,1753,23,332,7012,1420,6576
0.298,17,2,180,1,30,0,30,58,1,94,0,94,122
1.413,6,15,1793,8,288,201,288,648,7,284,34,434,1145
84.13,1,5,280,5,28,21032,28,280,0,0,0,0,0
1260.147,2,10,320,10,8,140016,8,320,0,0,0,0,0
102.495,6,35,9256,12,155,147,267,1266,23,371,4658,1420,7990
335.842,6,184,56649,92,467,3690,1440,27141,92,452,3688,1440,29508
1745.443,6,95,7203,63,38,28152,205,4476,32,33,56297,98,2727
102.7,17,4,240,2,32,102699,32,120,2,32,102699,32,120
184.487,6,39,11106,21,394,9217,1275,3875,18,524,10844,3929,7231
299.511,6,6,364,4,31,99837,31,222,2,31,299504,31,142
16.59,6,2,111,2,31,16590,31,111,0,0,0,0,0
1789.096,1,58,4872,58,56,31387,56,4872,0,0,0,0,0
831.037,6,67,8031,43,71,19786,722,3961,24,176,32222,2328,4070
0.513,17,3,451,2,39,230,39,134,1,289,0,289,317
1.617,17,6,471,3,31,792,31,177,3,70,789,70,294
2.973,17,4,272,2,32,2964,32,120,2,48,2965,48,152
12.139,6,86,26317,43,557,289,1152,20115,43,447,281,1179,6202
300.278,6,46,29556,27,190,11549,444,2209,19,2027,13358,5149,27347
1783.617,17,140,11200,70,48,25849,48,5320,70,56,25849,56,5880
1785.793,6,102,8364,68,66,26653,66,4964,34,60,54111,60,3400
61.319,6,37,15935,22,800,2919,1402,9157,15,665,4361,1402,6778
0.436,6,51,21967,29,976,15,1380,16845,22,421,18,1923,5122
0.057,17,2,184,1,32,0,32,60,1,96,0,96,124
0.194,6,3,175,2,31,23,31,135,1,0,0,0,40
286.326,6,33,3741,17,237,17895,585,1629,16,254,19088,580,2112
1795.254,6,128,12573,80,62,22724,722,6574,48,87,38188,2026,5999
0.102,17,2,290,1,40,0,40,68,1,194,0,194,222
594.108,6,83,7985,31,78,19798,339,3124,52,103,11646,1062,4861
10.432,6,9,527,5,43,2608,43,311,4,0,3475,0,216
11.847,6,541,459732,323,1351,36,1368,442586,218,899,53,1473,17146
1.08,6,208,143294,111,1319,9,1420,135099,97,475,11,1883,8195
280.271,6,28,7352,12,158,25479,267,1277,16,603,18682,1400,6075
18.814,17,24,3528,12,48,1709,48,912,12,190,1702,308,2616
0.057,6,2,80,1,0,0,0,40,1,0,0,0,40
10.57,6,8,1599,4,1104,3523,1104,1268,4,159,3517,159,331
53.22,17,4,352,2,60,53218,60,176,2,60,53219,60,176
1739.574,1,56,4704,56,56,31628,56,4704,0,0,0,0,0
0.366,17,8,2758,8,316,52,355,2758,0,0,0,0,0
17.574,6,12,700,5,0,4393,0,280,7,0,1953,0,420
1782.225,17,142,11360,71,48,25460,48,5396,71,56,25460,56,5964
1684.511,2,29,928,29,8,60161,8,928,0,0,0,0,0
0.353,6,6,312,4,0,117,0,208,2,0,0,0,104
286.838,17,4,352,2,60,286836,60,176,2,60,286837,60,176
280.43,6,30,7432,13,158,23369,267,1317,17,543,17521,1400,6115
0.185,6,2,92,1,0,0,0,52,1,0,0,0,40
176.364,6,11,682,4,112,58785,112,280,7,90,29392,90,402
280.504,6,29,7392,13,158,23375,267,1317,16,603,18695,2760,6075
0.179,17,2,348,1,39,0,39,67,1,253,0,253,281
0.18,6,4,908,2,717,180,717,797,2,31,1,31,111
0.911,6,11,1727,7,100,151,100,384,4,589,216,1152,1343
1021.636,1,12,672,12,28,92876,28,672,0,0,0,0,0
1755.157,6,95,7203,63,38,28308,205,4476,32,33,56602,98,2727
3.298,6,50,27583,25,843,137,1440,10324,25,1083,131,1440,17259
280.635,6,30,7432,13,158,23386,267,1317,17,543,17533,1400,6115
300.398,6,74,54782,46,1276,6675,1408,48338,28,828,2273,1491,6444
1740.883,6,87,6322,58,31,30541,31,3915,29,31,62173,31,2407
161.432,6,52,13340,19,312,181,469,3891,33,290,5044,1460,9449
118.746,6,26,8214,13,379,75,802,1713,13,663,9882,2720,6501
1.051,6,9,492,5,0,262,0,268,4,0,295,0,224
0.174,17,2,166,1,47,0,47,75,1,63,0,63,91
1082.998,1,295,24780,295,56,3683,56,24780,0,0,0,0,0
1.762,17,32,20380,15,717,125,1350,11180,17,513,81,1350,9200
88.254,6,22,8324,11,549,99,1309,2120,11,958,8807,1631,6204
240.242,6,53,17537,28,782,8897,1418,14761,25,183,10009,580,2776
33.29,6,4316,4145102,2884,1361,11,1408,4065974,1432,776,23,1408,79128
1738.551,6,87,6322,58,31,30500,31,3915,29,31,62090,31,2407
0.461,17,2,152,1,48,0,48,76,1,48,0,48,76
600.025,1,6,336,6,28,120005,28,336,0,0,0,0,0
0.027,6,10,1671,6,552,5,948,1348,4,159,8,159,323
240.203,6,53,18089,28,813,8896,1402,15289,25,186,10008,580,2800
1741.556,17,27,28512,27,1028,66982,1028,28512,0,0,0,0,0
0.008,6,6,7490,1,0,0,0,40,5,1438,1,1438,7450
1771.39,6,102,9779,68,70,26438,234,5948,34,60,53675,83,3831
3.753,2,2,64,2,8,3753,8,64,0,0,0,0,0
1771.26,6,118,14374,74,148,24263,827,9334,44,74,41189,193,5040
4.987,17,4,288,2,36,4986,36,128,2,52,4985,52,160
1.473,6,44,14578,24,728,64,1360,9002,20,476,67,2715,5576
0.006,17,2,194,1,42,0,42,70,1,96,0,96,124
1787.271,6,414,24936,205,69,8761,69,12340,209,35,8592,69,12596
6.149,17,24,14355,10,382,683,1350,4106,14,704,441,1350,10249
75.888,6,23,948,11,0,5564,0,448,12,0,6898,0,500
1771.967,6,180,15480,120,69,14890,69,8940,60,69,30032,69,6540
0.068,6,2,80,0,0,0,0,0,2,0,0,0,80
0.169,17,2,214,1,39,0,39,67,1,119,0,119,147
240.171,6,53,17720,28,785,8894,1402,14817,25,199,10006,580,2903
1797.515,1,168,17808,168,78,10763,78,17808,0,0,0,0,0
2.782,17,8,1768,4,30,922,30,232,4,356,923,468,1536
1634.938,1,8,448,8,28,233562,28,448,0,0,0,0,0
2.321,17,2,178,1,29,0,29,57,1,93,0,93,121
1.344,17,2,192,1,60,0,60,88,1,76,0,76,104
5.01,17,4,288,2,36,5009,36,128,2,52,5009,52,160
1564.21,2,19,608,19,8,86900,8,608,0,0,0,0,0
1792.219,1,196,10976,196,28,9190,28,10976,0,0,0,0,0
0.06,17,2,140,1,34,0,34,62,1,50,0,50,78
6.773,6,1541,1345107,877,1438,7,1448,1298321,664,792,9,1448,46786
976.634,6,74,10424,41,99,20331,477,3529,33,185,30517,1452,6895
0.562,6,51,20959,28,974,20,1380,13874,23,511,23,1923,7085
3.518,17,10,2194,5,30,871,30,290,5,352,876,468,1904
1772.294,6,180,15480,120,69,14893,69,8940,60,69,30035,69,6540
240.385,6,55,18637,29,829,8584,1418,15629,26,206,9615,580,3008
280.586,6,27,7312,12,158,25507,267,1277,15,775,20028,3465,6035
0.012,6,2,80,1,0,0,0,40,1,0,0,0,40
93.177,6,9,504,4,0,31059,0,216,5,0,11300,0,288
1777.056,17,73,3060,72,14,25028,14,3024,1,8,0,8,36
1790.61,1,224,23744,224,78,8029,78,23744,0,0,0,0,0
1747.219,1,83,6972,0,0,0,0,0,83,56,21307,56,6972
240.199,6,55,19281,30,822,8282,1418,16364,25,201,10007,580,2917
1796.831,17,142,11360,71,48,25668,48,5396,71,56,25668,56,5964
0.005,17,2,912,1,308,0,308,336,1,548,0,548,576
0.048,17,4,368,2,32,9,32,120,2,96,1,96,248
2.508,17,26,16908,12,481,228,1350,6118,14,742,175,1350,10790
3.977,17,4,368,4,64,1325,64,368,0,0,0,0,0
0.5,6,22,7356,13,337,41,674,2032,9,1212,57,1946,5324
185.969,17,42,6292,21,48,9297,48,1596,21,195,9297,308,4696
8.38,17,2,672,2,308,8380,308,672,0,0,0,0,0
0.022,17,2,231,1,34,0,34,62,1,141,0,141,169
0.347,17,2,154,1,33,0,33,61,1,65,0,65,93
1770.877,6,99,9306,66,66,27244,66,5610,33,60,55337,60,3696
7.729,17,6,528,3,48,3858,48,228,3,72,3858,72,300
4.959,17,6,494,4,47,1001,47,300,2,69,0,75,194
1786.558,6,103,8404,68,66,26665,66,4964,35,60,52543,60,3440
5.014,17,4,558,2,36,5004,36,128,2,187,5004,187,430
11.828,6,25,8473,13,275,985,275,1078,12,986,855,1440,7395
1672.926,1,8,448,8,28,238989,28,448,0,0,0,0,0
0.806,17,12,5942,6,585,161,1350,3679,6,349,135,1350,2263
21.173,6,24,6231,14,117,1628,159,1337,10,727,2351,1418,4894
1680.722,17,13,534,11,14,168053,14,462,2,8,1680537,8,72
241.306,6,48,8602,20,436,12700,1056,5013,28,175,8937,580,3589
0.677,6,125,87780,59,131,11,232,2889,66,1348,10,2860,84891
0.258,6,19,5832,11,275,25,517,1681,8,931,35,1912,4151
2.282,6,13,2311,8,188,326,245,700,5,1407,509,1407,1611
0.549,6,10,924,5,283,91,283,551,5,105,92,105,373
31.739,6,7,308,1,0,0,0,44,6,0,6329,0,264
0.01,17,2,574,1,32,0,32,60,1,486,0,486,514
369.872,6,27,1767,18,177,21757,177,1181,9,110,9253,110,586
120.338,2,2,64,2,8,120338,8,64,0,0,0,0,0
1710.63,1,8,448,8,28,244375,28,448,0,0,0,0,0
0.453,6,20,5891,11,280,44,517,1703,9,742,55,1408,4188
1772.491,6,180,15480,120,69,14894,69,8940,60,69,30036,69,6540
0.421,6,3,120,3,0,0,0,120,0,0,0,0,0
280.42,6,29,7392,14,158,21570,267,1357,15,678,20025,3456,6035
160.544,6,69,46260,44,1158,3733,1408,38227,25,747,2570,1408,8033
1.198,6,25,8056,12,164,92,267,1288,13,869,85,1440,6768
3.2,17,2,1430,2,687,3200,687,1430,0,0,0,0,0
1799.531,6,376,26217,217,98,8331,469,15372,159,69,11386,69,10845
29.422,6,2,104,2,0,0,0,104,0,0,0,0,0
275.665,17,4,240,2,32,275664,32,120,2,32,275664,32,120
0.564,6,25,7887,16,364,37,1125,3193,9,721,68,1420,4694
31.407,6,10,918,4,179,10469,267,518,6,53,6272,85,400
1382.456,6,276,17526,159,69,8749,69,9603,117,69,11917,69,7923
0.498,6,124,87848,59,131,8,232,2889,65,1372,7,2860,84959
1795.597,17,446,39548,402,35,4477,288,25644,44,288,40949,288,13904
373.754,6,23,1535,16,177,24916,177,1053,7,110,10400,110,482
39.545,17,26,1994,13,40,3295,41,893,13,56,3294,57,1101
10.924,6,80,24405,40,533,280,1152,18664,40,459,272,1179,5741
24.025,6,20,8481,12,148,2184,149,1236,8,853,230,1483,7245
4.866,6,42,7389,22,218,231,314,3503,20,440,242,1152,3886
3.857,17,4,352,4,60,1285,60,352,0,0,0,0,0
0.308,6,25,8965,13,257,25,669,1714,12,1103,27,2804,7251
12.037,17,4,768,2,32,12033,32,120,2,296,12033,296,648
21.014,17,4,558,2,36,21009,36,128,2,187,21009,187,430
560.464,17,6,1647,3,30,280196,30,174,3,463,280229,463,1473
315.458,6,17,1540,2,112,30490,112,200,15,77,22532,90,1340
1772.439,6,180,15480,120,69,14894,69,8940,60,69,30040,69,6540
1794.903,6,245,35856,152,302,11886,302,26032,93,83,19509,83,9824
1774.0,6,180,15480,120,69,14907,69,8940,60,69,30060,69,6540
12.7,17,7,7134,6,1140,799,1350,7009,1,97,0,97,125
1787.595,6,363,24952,211,94,8512,469,14456,152,69,11838,69,10496
1798.608,17,449,39928,404,35,4463,288,25708,45,288,40017,288,14220
0.136,1,2,112,2,28,136,28,112,0,0,0,0,0
1772.804,6,180,15480,120,69,14897,69,8940,60,69,30044,69,6540
1797.698,17,142,11360,71,48,25681,48,5396,71,56,25681,56,5964
0.588,6,20,6457,11,141,58,275,726,9,766,23,1420,5731
1.406,6,51,21289,28,962,52,1440,15593,23,433,55,1440,5696
0.04,17,4,284,2,32,26,32,120,2,54,16,60,164
1679.929,1,15,840,15,28,119994,28,840,0,0,0,0,0
2.039,6,74,42880,38,711,55,1438,6251,36,1287,57,1765,36629
1.397,6,39,9900,21,440,69,1360,4404,18,529,70,4075,5496
0.173,6,46,22309,27,1081,6,1420,17328,19,467,9,1883,4981
1.587,6,19,3781,10,234,176,564,1452,9,463,172,1343,2329
1771.258,6,105,9552,66,65,27250,65,5577,39,59,46609,59,3975
0.898,6,10,1687,7,100,149,100,384,3,1179,323,1179,1303
221.51,6,40,8727,17,119,13844,267,1880,23,328,5542,4837,6847
0.067,17,2,182,1,39,0,39,67,1,87,0,87,115
62.284,6,49,10455,22,533,723,910,3107,27,312,2390,1460,7348
255.344,6,45,8332,20,156,7142,517,2145,25,325,10638,1498,6187
0.165,17,2,152,1,48,0,48,76,1,48,0,48,76
40.516,17,44,6468,22,48,1928,48,1672,22,190,1928,308,4796
26.826,6,36,9251,17,321,1676,721,2936,19,555,1433,1440,6315
10.347,6,4,196,4,0,0,0,196,0,0,0,0,0
1772.518,6,180,15480,120,69,14895,69,8940,60,69,30038,69,6540
230.923,17,6,528,3,60,115461,60,264,3,60,115461,60,264
1783.876,6,102,8296,68,65,26625,65,4930,34,59,54053,59,3366
300.718,6,70,48676,42,1258,7334,1368,46238,28,324,8913,800,2438
0.783,6,25,10730,14,749,60,1360,3590,11,955,62,2720,7140
26.223,6,3578,3377594,2280,1402,11,1448,3305434,1298,776,20,1448,72160
1744.023,6,127,11786,73,94,24222,205,7677,54,31,32898,33,4109
52.269,6,32,8952,14,158,4020,267,1357,18,624,3070,1400,7595
2.79,17,4,240,2,32,2789,32,120,2,32,2789,32,120
1713.064,17,357,78309,357,191,4811,462,78309,0,0,0,0,0
4.359,6,39,7269,20,218,229,314,3423,19,440,228,1152,3846
1792.99,6,365,23087,211,69,8537,69,12787,154,69,11716,69,10300
31.512,6,7,420,1,0,0,0,60,6,0,6300,0,360
12.18,6,1873,1623802,1147,1362,10,1380,1590508,726,421,16,1923,33294
300.612,6,36,8458,20,308,15821,885,2064,16,522,565,4080,6394
1786.836,6,102,8296,68,65,26669,65,4930,34,59,54143,59,3366
2.303,17,2,136,1,32,0,32,60,1,48,0,48,76
1.328,6,39,8292,19,320,73,1162,2716,20,433,60,1460,5576
1787.905,6,355,22480,207,69,8679,69,12420,148,69,12162,69,10060
1.12,17,4,288,2,36,1087,36,128,2,52,1089,52,160
292.982,1,4,224,4,28,97660,28,224,0,0,0,0,0
240.126,6,44,5483,23,247,10914,835,2950,21,159,12006,553,2533
1786.915,6,175,25925,102,243,17692,1294,16503,73,127,24816,362,9422
1748.405,6,95,7203,63,38,28200,205,4476,32,33,56389,98,2727
10.242,17,8,704,4,60,3413,60,352,4,60,3413,60,352
0.013,17,2,572,1,39,0,39,67,1,477,0,477,505
1770.646,1,58,4872,58,56,31063,56,4872,0,0,0,0,0
121.675,17,96,6974,72,40,1713,41,4943,24,56,717,57,2031
1799.546,17,450,39960,405,35,4454,288,25740,45,288,40021,288,14220
0.29,6,535,538931,355,201,0,486,20493,180,2892,1,16896,518438
0.455,6,22,7342,12,335,40,668,1974,10,1210,50,1906,5368
194.188,6,250,198283,156,1301,1252,1368,182488,94,605,1355,1368,15795
101.411,6,104,74498,54,768,17,1460,5267,50,1493,2066,2920,69231
1176.55,17,652,46089,569,40,2071,41,39067,83,56,430,57,7022
19.998,17,3,447,3,121,9999,121,447,0,0,0,0,0
0.0,6,1,40,0,0,0,0,0,1,0,0,0,40
1772.768,6,180,15480,120,69,14897,69,8940,60,69,30043,69,6540
36.194,17,3,228,3,48,18097,48,228,0,0,0,0,0
1.517,6,258,203320,152,1338,10,1420,194789,106,534,14,3303,8531
285.941,6,31,7815,11,140,28593,267,1433,20,371,15048,1460,6382
9.186,17,8,1684,4,47,3057,47,300,4,318,3057,318,1384
1782.31,17,83,3480,82,14,22003,14,3444,1,8,0,8,36
1.418,6,48,19578,27,917,54,1460,13962,21,476,61,2615,5616
0.5,17,3,451,2,39,442,39,134,1,289,0,289,317
0.469,17,4,377,2,33,456,37,123,2,99,443,136,254
1.615,6,42,10688,23,517,73,1360,5107,19,400,78,1360,5581
11.002,6,20,4442,11,275,1100,275,998,9,768,779,1440,3444
1793.345,17,180,14040,180,50,10018,50,14040,0,0,0,0,0
280.446,6,29,7392,13,158,23370,267,1317,16,678,18694,2085,6075
0.243,17,2,2730,2,1337,243,1337,2730,0,0,0,0,0
0.797,17,2,144,1,36,0,36,64,1,52,0,52,80
0.139,6,9,1343,5,145,34,145,349,4,830,36,830,994
300.065,6,42,12681,23,770,13631,1360,7119,19,435,16660,2667,5562
540.978,6,46,7855,22,132,15525,501,2075,24,253,23516,1420,5780
1793.137,1,58,7521,58,101,31458,320,7521,0,0,0,0,0
1739.668,1,15,840,15,28,124262,28,840,0,0,0,0,0
8.198,6,54,9669,27,233,315,314,4821,27,418,303,1152,4848
1783.84,6,368,25690,213,99,8414,469,15005,155,69,11583,69,10685
1780.435,1,58,4872,0,0,0,0,0,58,56,31235,56,4872
0.374,17,2,144,1,36,0,36,64,1,52,0,52,80
291.23,1,4,224,4,28,97076,28,224,0,0,0,0,0
12.13,17,20,1440,10,33,1347,33,610,10,55,1347,61,830
147.194,17,4,304,2,48,147181,48,152,2,48,147180,48,152
44.905,6,30,7432,13,158,3742,267,1317,17,543,2801,1400,6115
12.465,17,2,672,2,308,12465,308,672,0,0,0,0,0
329.655,17,6,528,3,60,164827,60,264,3,60,164827,60,264
89.856,6,43,25893,22,884,33,1360,6297,21,1338,4486,3379,19596
125.448,6,14,3144,7,92,20908,92,452,7,464,20874,1448,2692
1780.975,6,334,22468,195,69,9180,69,12492,139,69,12905,69,9976
1790.373,6,405,36535,229,137,7852,1189,19347,176,133,10230,1460,17188
1745.326,6,95,7203,63,38,28150,205,4476,32,33,56292,98,2727
0.096,6,3,156,0,0,0,0,0,3,0,0,0,156
610.458,1,58,3248,58,28,10709,28,3248,0,0,0,0,0
1.487,6,29,5964,16,111,99,267,1539,13,780,110,1460,4425
0.0,6,1,307,1,267,0,267,307,0,0,0,0,0
6.774,6,15,2391,8,125,967,245,700,7,1407,1085,1407,1691
1734.491,17,177,46993,177,237,9855,422,46993,0,0,0,0,0
0.04,17,4,859,2,37,0,37,130,2,336,0,348,729
1705.152,1,8,448,8,28,243593,28,448,0,0,0,0,0
1787.658,17,87,3648,86,14,21031,14,3612,1,8,0,8,36
68.067,6,20,9096,11,499,83,1193,1971,9,1350,8487,4080,7125
1758.782,6,105,6240,60,26,29808,26,3510,45,26,39970,26,2730
1.014,6,23,6380,13,299,84,842,2023,10,988,111,1699,4357
1402.35,17,14,1117,7,31,233718,37,413,7,72,233715,136,704
1786.544,6,362,22967,210,69,8548,69,12678,152,69,11831,69,10289
1.245,6,24,8004,12,164,96,267,1288,12,1014,96,2804,6716
1.18,6,4,184,2,0,1180,0,88,2,0,1024,0,96
3.141,17,2,303,1,45,0,45,73,1,202,0,202,230
1.235,17,2,178,1,29,0,29,57,1,93,0,93,121
7.023,6,65,20454,34,554,212,1152,15771,31,491,225,1179,4683
881.96,6,144,24467,82,304,10888,304,18340,62,83,12366,83,6127
30.431,17,8,704,4,48,10140,48,304,4,72,10140,72,400
1785.511,17,87,3648,86,14,21006,14,3612,1,8,0,8,36
1.676,6,14,2351,8,188,239,245,700,6,703,284,1152,1651
322.071,17,6,528,3,60,161035,60,264,3,60,161034,60,264
8.05,6,18,6791,9,275,1006,275,643,9,1155,687,1420,6148
140.0,6,30,7432,14,158,10769,267,1357,16,603,9326,2800,6075
668.988,1,14,784,14,28,51460,28,784,0,0,0,0,0
1790.628,17,142,11360,71,48,25579,48,5396,71,56,25579,56,5964
0.27,6,24,6064,12,181,24,537,1526,12,651,23,1448,4538
131.425,17,8,2688,8,308,18775,308,2688,0,0,0,0,0
0.027,17,2,356,1,32,0,32,60,1,268,0,268,296
1796.433,6,366,25541,213,100,8473,469,14936,153,69,11818,69,10605
0.027,17,2,327,1,35,0,35,63,1,236,0,236,264
1785.331,6,107,8624,69,66,26254,66,5004,38,60,48249,60,3620
280.516,6,30,7432,13,158,23376,267,1317,17,603,17529,2076,6115
1799.882,17,142,11360,71,48,25711,48,5396,71,56,25711,56,5964
194.489,17,8,1176,4,48,64826,48,304,4,190,64825,308,872
1.176,17,355,386680,73,105,16,1350,9728,282,1308,4,1350,376952
508.028,17,17,1292,17,48,31751,48,1292,0,0,0,0,0
280.416,6,31,7813,13,158,23368,267,1317,18,524,16494,1400,6496
1754.166,6,113,8442,70,38,25422,205,4902,43,32,41759,98,3540
240.169,6,53,17401,28,769,8895,1408,14552,25,192,10006,580,2849
10.857,6,20,4442,11,275,1085,275,998,9,768,725,1440,3444
295.167,1,2,120,2,32,295167,32,120,0,0,0,0,0
0.44,6,5,272,2,0,440,0,104,3,0,108,0,168
280.463,6,29,7392,13,158,23371,267,1317,16,603,18694,2760,6075
0.314,6,26,8946,13,244,26,618,1663,13,942,25,1402,7283
22.651,17,2,152,2,48,22651,48,152,0,0,0,0,0
0.007,17,2,672,2,308,7,308,672,0,0,0,0,0
0.05,6,13,4282,7,111,8,111,483,6,1159,10,2896,3799
1780.024,1,342,28728,342,56,5220,56,28728,0,0,0,0,0
1780.82,17,140,11192,71,48,25440,48,5396,69,56,26188,56,5796
383.133,6,10,628,8,106,54732,106,540,2,0,383121,0,88
5.684,6,39,7269,21,218,284,314,3463,18,513,319,1179,3806
1744.265,6,95,7203,63,38,28133,205,4476,32,33,56258,98,2727
1684.568,17,16,4178,16,233,112304,1210,4178,0,0,0,0,0
1789.96,6,376,23803,215,69,8364,69,13223,161,69,11187,69,10580
11.715,6,1852,1618182,1125,1384,10,1420,1584881,727,467,16,1883,33301
280.63,6,27,7312,13,158,23385,267,1317,14,775,21577,3465,5995
300.649,6,39,8511,20,291,15823,786,1997,19,441,471,1440,6514
1738.889,1,16,896,16,28,115925,28,896,0,0,0,0,0
1781.676,17,82,3432,80,14,22550,14,3360,2,8,1781488,8,72
1524.009,6,183,20662,111,78,13854,267,8745,72,136,21464,1420,11917
1.564,6,48,19276,27,896,60,1440,13660,21,433,67,1440,5616
5.307,6,34,6185,18,206,312,314,2784,16,551,336,1179,3401
0.615,6,3,156,1,0,0,0,52,2,0,615,0,104
317.032,6,72,19179,38,325,8568,1360,9700,34,386,9602,3289,9479
0.384,6,13,1693,7,288,64,288,588,6,284,39,434,1105
1783.808,6,472,27293,261,69,6839,69,14649,211,34,8494,64,12644
191.75,1,3,377,3,97,95875,117,377,0,0,0,0,0
0.021,17,2,433,1,34,0,34,62,1,343,0,343,371
1685.641,17,14,3783,7,30,280937,30,406,7,454,280937,463,3377
1785.515,6,103,8395,68,65,26649,65,4930,35,59,52512,59,3465
825.52,17,120,9120,120,48,6937,48,9120,0,0,0,0,0
316.932,6,100,35402,56,547,5762,1360,24705,44,371,7367,4649,10697
1790.168,6,365,24563,213,87,8444,469,14136,152,69,11854,69,10427
7.368,17,4,240,2,32,7367,32,120,2,32,7366,32,120
1583.81,17,126,10080,63,48,25545,48,4788,63,56,25545,56,5292
106.042,6,6,1255,4,327,35347,413,814,2,180,105837,269,441
5.279,6,39,7269,20,218,277,314,3423,19,513,279,1179,3846
0.225,6,24,7176,13,155,18,267,1301,11,775,21,2800,5875
0.005,17,2,440,1,40,0,40,68,1,344,0,344,372
1798.321,17,449,39928,404,35,4462,288,25708,45,288,40020,288,14220
1.406,6,38,9848,21,440,70,1360,4392,17,476,76,2715,5456
1.221,6,57,17914,29,700,43,1360,8885,28,464,44,2186,9029
281.347,6,31,7882,13,158,23445,267,1317,18,531,16527,2036,6565
1.214,6,25,8056,12,164,93,267,1288,13,869,86,1448,6768
11.595,6,24,8413,13,275,966,275,1078,11,1147,837,2840,7335
1134.067,2,7,224,7,8,189011,8,224,0,0,0,0,0
1771.59,6,101,9344,66,65,27255,65,5577,35,59,52103,59,3767
0.379,17,8,2758,8,316,54,355,2758,0,0,0,0,0
70.438,6,28,7355,12,155,6403,267,1266,16,453,4695,2006,6089
4.992,17,4,558,2,36,4988,36,128,2,187,4987,187,430
1794.665,1,124,6944,124,28,14590,28,6944,0,0,0,0,0
1786.555,6,102,8364,68,66,26665,66,4964,34,60,54135,60,3400
924.278,6,77,9691,37,99,21314,516,3275,40,130,23697,1452,6416
0.929,17,2,144,1,36,0,36,64,1,52,0,52,80
1784.329,6,355,22480,207,69,8661,69,12420,148,69,12138,69,10060
1221.723,6,239,15287,135,69,8586,69,8091,104,69,11861,69,7196
73.703,6,22,9920,11,433,71,990,1771,11,1099,7356,1440,8149
1786.62,6,104,8444,68,66,26665,66,4964,36,60,51043,60,3480
123.044,6,35,10126,14,258,7134,486,1391,21,563,6145,1460,8735
1799.951,17,448,39896,403,35,4477,288,25676,45,288,40023,288,14220
4.728,6,37,7189,19,218,262,314,3383,18,513,262,1179,3806
6.352,6,1698,1577444,1078,1386,5,1408,1540540,620,931,9,2816,36904
5.009,17,4,558,2,36,5000,36,128,2,187,5000,187,430
3.172,17,2,166,1,47,0,47,75,1,63,0,63,91
2.487,6,32,9208,19,252,138,598,1772,13,864,190,1380,7436
0.08,6,3,182,2,31,80,31,111,1,31,0,31,71
152.565,6,24,10168,12,549,69,1360,2709,12,1161,13855,2720,7459
1.56,2,3,136,3,21,780,24,136,0,0,0,0,0
2.942,6,498,412338,296,1371,9,1420,400037,202,526,14,3303,12301
7.384,6,10,5234,4,95,2381,100,355,6,1158,1429,1179,4879
8.989,17,8,1604,4,37,2993,37,260,4,308,2992,308,1344
0.721,6,4,1861,2,0,526,0,104,2,826,705,1448,1757
1744.67,2,26,832,26,8,69786,8,832,0,0,0,0,0
175.404,6,253,199240,154,1317,1146,1408,183233,99,602,1786,1408,16007
1787.069,6,102,8296,68,65,26672,65,4930,34,59,54149,59,3366
1787.906,6,357,22629,208,69,8637,69,12460,149,69,12080,69,10169
1786.775,6,102,8296,68,65,26668,65,4930,34,59,54141,59,3366
22.791,6,9,577,0,0,0,0,0,9,31,2848,31,577
1789.25,17,87,3648,86,14,21050,14,3612,1,8,0,8,36
0.168,6,46,21618,27,1035,6,1420,16637,19,467,8,1883,4981
3.894,17,5,340,5,40,973,40,340,0,0,0,0,0
1642.453,1,8,448,8,28,234636,28,448,0,0,0,0,0
0.0,17,1,521,1,493,0,493,521,0,0,0,0,0
0.282,6,26,9039,13,266,23,705,1750,13,943,22,1402,7289
899.658,6,12,728,8,31,128522,31,444,4,31,299793,31,284
1625.889,1,7,392,7,28,270981,28,392,0,0,0,0,0
0.013,17,4,284,2,32,2,32,120,2,54,1,60,164
273.101,17,4,240,2,32,273100,32,120,2,32,273100,32,120
0.854,6,28,8484,14,266,56,540,1948,14,852,53,1360,6536
280.196,6,28,7352,13,158,23349,267,1317,15,678,20011,2045,6035
4.788,6,40,7309,20,218,252,314,3423,20,513,239,1179,3886
0.021,1,2,112,2,28,21,28,112,0,0,0,0,0
10.0,6,1379,1283603,862,1411,11,1448,1252055,517,776,19,1448,31548
1.161,6,211,160033,123,1326,9,1432,152222,88,427,13,1432,7811
1799.967,1,16,896,16,28,119997,28,896,0,0,0,0,0
3.119,6,5980,9710118,942,147,3,269,50900,5038,1866,0,9856,9659218
1755.808,6,184,11128,92,45,19294,208,6487,92,31,19291,31,4641
88.555,6,72,46815,44,1171,2059,1408,38627,28,960,2279,3847,8188
10.767,6,20,4442,11,275,1076,275,998,9,768,804,1440,3444
655.192,6,94,7485,38,80,17704,336,3865,56,51,11910,143,3620
67.227,6,27,7405,12,150,6110,267,1542,15,583,4801,2006,5863
11.842,6,21,6825,12,275,1076,275,1038,9,1353,854,1440,5787
3.53,6,61,22950,33,951,110,1460,13796,28,471,114,2615,9154
0.017,6,13,3514,7,75,2,75,447,6,1373,3,1448,3067
1776.713,17,73,3060,72,14,25024,14,3024,1,8,0,8,36
1217.621,17,343,38749,154,151,7958,1350,27589,189,31,6476,60,11160
178.464,2,2,64,2,8,178464,8,64,0,0,0,0,0
10.153,6,84,24917,44,561,236,1152,19176,40,413,253,1152,5741
0.686,6,109,86715,57,131,12,232,2809,52,1740,13,2828,83906
0.514,17,2,152,1,48,0,48,76,1,48,0,48,76
782.056,2,6,192,6,8,156411,8,192,0,0,0,0,0
1361.485,6,109,11834,60,83,23074,517,4495,49,265,28362,1368,7339
1771.429,6,104,9648,68,65,26439,65,5758,36,59,50609,59,3890
0.053,17,2,144,1,36,0,36,64,1,52,0,52,80
33.879,6,28,4939,14,154,2606,722,1807,14,480,2590,1408,3132
367.166,6,23,1535,16,177,24477,177,1053,7,110,10364,110,482
1790.543,6,362,22898,210,69,8567,69,12678,152,69,11857,69,10220
280.3,6,29,7392,13,158,23358,267,1317,16,603,18679,2800,6075
1633.412,1,20,1120,20,28,85969,28,1120,0,0,0,0,0
35.897,6,44,8976,21,401,744,889,2148,23,346,1626,2128,6828
1798.446,1,16,896,16,28,119896,28,896,0,0,0,0,0
0.032,1,2,212,2,78,32,78,212,0,0,0,0,0
305.955,6,20,2588,7,221,50991,517,1270,13,323,25495,499,1318
57.064,17,20,1760,10,48,6339,48,760,10,72,6339,72,1000
0.183,17,2,304,1,60,0,60,88,1,188,0,188,216
6.1,6,648,587174,418,1338,14,1368,570550,230,776,25,1473,16624
22.766,6,4,3040,2,0,22766,0,80,2,1440,18944,1440,2960
1260.111,2,9,288,9,8,157513,8,288,0,0,0,0,0
7.718,17,3,228,3,48,3859,48,228,0,0,0,0,0
146.992,6,25,11178,12,397,70,884,1717,13,992,12238,1460,9461
1104.589,1,10,560,10,28,122732,28,560,0,0,0,0,0
137.287,6,26,10576,13,385,241,844,1743,13,1037,11429,3961,8833
0.025,6,2,80,1,0,0,0,40,1,0,0,0,40
1.673,6,52,20577,27,977,64,1440,14801,25,433,62,1440,5776
5.041,17,4,288,2,36,5009,36,128,2,52,5008,52,160
59.866,17,4,352,2,60,59865,60,176,2,60,59864,60,176
1.274,17,2,778,2,361,1274,361,778,0,0,0,0,0
62.501,6,28,7286,13,141,5208,267,1375,15,482,4453,1460,5911
0.084,17,2,154,1,33,0,33,61,1,65,0,65,93
0.014,17,2,547,1,40,0,40,68,1,451,0,451,479
4.474,6,37,7205,19,218,248,314,3383,18,516,248,1179,3822
1795.901,6,148,10179,81,64,22448,208,6290,67,31,27204,31,3889
240.804,6,44,8972,21,519,12039,1402,5778,23,220,10945,617,3194
0.623,17,4,420,2,33,616,33,122,2,121,616,145,298
1786.5,6,226,24893,142,93,12670,469,12013,84,133,21521,3417,12880
12.382,6,14,1847,7,100,2063,100,384,7,1179,2021,1179,1463
1766.015,17,282,55633,282,169,6284,422,55633,0,0,0,0,0
1775.606,1,59,4956,59,56,30613,56,4956,0,0,0,0,0
341.329,17,8,6592,8,796,48761,1447,6592,0,0,0,0,0
31.911,6,9,396,2,0,3490,0,88,7,0,5303,0,308
1.027,17,3,372,2,64,993,64,184,1,160,0,160,188
0.253,17,16,8516,8,705,35,1350,5868,8,303,31,1350,2648
280.709,6,29,7392,13,158,23392,267,1317,16,603,18708,2036,6075
215.684,17,4,352,2,60,215683,60,176,2,60,215683,60,176
280.279,6,25,7094,11,181,28027,267,1168,14,595,21559,1400,5926
1740.573,1,54,4536,0,0,0,0,0,54,56,32841,56,4536
280.777,6,30,7432,13,158,23398,267,1317,17,543,17542,1400,6115
4.38,6,2,88,2,0,0,0,88,0,0,0,0,0
0.295,17,6,471,3,31,0,31,177,3,70,0,70,294
546.821,1,12,672,12,28,49711,28,672,0,0,0,0,0
1.3,6,50,18687,27,848,50,1360,12991,23,433,51,1360,5696
199.337,6,30,7432,13,158,16611,267,1317,17,543,12457,1400,6115
0.923,17,4,820,2,36,913,36,128,2,318,911,318,692
3.855,6,2,88,2,0,0,0,88,0,0,0,0,0
0.401,1,2,112,2,28,401,28,112,0,0,0,0,0
0.679,6,15,1785,8,288,86,288,640,7,426,83,434,1145
43.764,17,4,1328,4,304,14588,308,1328,0,0,0,0,0
0.054,17,4,352,2,37,0,37,130,2,83,10,89,222
1786.61,6,102,8296,68,65,26665,65,4930,34,59,54137,59,3366
3.509,6,11,467,6,0,701,0,248,5,7,618,7,219
11.741,6,101,32275,52,593,230,1152,25833,49,447,239,1179,6442
0.072,17,10,760,10,48,8,48,760,0,0,0,0,0
53.259,6,10,648,10,31,5917,31,648,0,0,0,0,0
171.495,17,4,240,2,32,171494,32,120,2,32,171494,32,120
1745.184,1,8,848,8,78,249312,78,848,0,0,0,0,0
0.875,6,28,8530,17,565,54,1360,3588,11,561,68,2720,4942
240.297,6,55,18137,29,805,8581,1402,15212,26,195,9611,580,2925
7.451,6,7,300,3,0,3725,0,124,4,0,2397,0,176
3.559,6,22,5675,12,197,323,501,1275,10,999,394,1731,4400
120.395,2,3,96,3,8,60197,8,96,0,0,0,0,0
247.567,6,46,9261,20,165,13029,517,2086,26,484,9902,1402,7175
361.005,2,5,160,5,8,90251,8,160,0,0,0,0,0
241.074,6,435,387791,156,460,1555,1418,11825,279,1358,867,1418,375966
375.926,6,23,1538,16,180,25061,180,1056,7,110,10397,110,482
1739.449,6,87,6322,58,31,30516,31,3915,29,31,62122,31,2407
101.37,17,4,352,2,60,101369,60,176,2,60,101369,60,176
1.208,6,30,7559,17,305,75,1086,2825,13,601,99,1420,4734
434.362,17,16,5608,16,322,28957,548,5608,0,0,0,0,0
1796.48,1,214,11984,214,28,8434,28,11984,0,0,0,0,0
1.379,6,48,19191,27,890,53,1360,13575,21,476,59,2715,5616
0.51,17,2,476,1,39,0,39,67,1,381,0,381,409
1788.986,6,362,22898,210,69,8559,69,12678,152,69,11846,69,10220
280.183,6,29,7392,13,158,23348,267,1317,16,603,18676,2800,6075
13.069,6,15,1877,7,177,2178,177,891,8,110,1569,110,986
36.893,17,22,1936,11,48,3686,48,836,11,72,3686,72,1100
1795.967,6,356,22520,208,69,8676,69,12460,148,69,12217,69,10060
1796.581,1,250,14000,250,28,7215,28,14000,0,0,0,0,0
0.217,17,2,572,1,39,0,39,67,1,477,0,477,505
42.301,17,44,6468,22,48,2013,48,1672,22,190,2013,308,4796
31.692,6,108,81229,64,226,503,258,6973,44,2180,736,15681,74256
38.96,17,22,1672,22,48,1855,48,1672,0,0,0,0,0
244.962,17,4,352,2,60,244961,60,176,2,60,244961,60,176
30.162,17,4,352,2,60,30161,60,176,2,60,30161,60,176
1783.265,6,367,25112,213,93,8411,469,14605,154,69,11654,69,10507
1799.616,6,108,11075,49,37,37491,37,3053,59,446,31027,446,8022
661.831,2,5,160,5,8,165457,8,160,0,0,0,0,0
240.34,6,43,8962,21,523,12016,1418,5814,22,221,11444,617,3148
8.298,6,19,6835,10,275,922,275,683,9,1444,908,2840,6152
369.643,6,18,1242,14,180,28434,180,916,4,110,20068,110,326
108.532,6,78,52955,48,1204,2309,1448,44665,30,746,2126,1448,8290
1799.846,17,9402,451296,4701,20,382,20,225648,4701,20,382,20,225648
1742.761,1,60,5040,60,56,29538,56,5040,0,0,0,0,0
240.547,6,45,9225,21,520,12026,1418,5788,24,242,10456,618,3437
1121.845,17,10,740,5,30,280449,30,290,5,62,280450,62,450
1785.858,6,368,23276,212,69,8463,69,12896,156,69,11521,69,10380
97.549,6,16,6170,2,106,490,106,194,14,450,7502,1420,5976
1792.236,17,180,14040,180,50,10012,50,14040,0,0,0,0,0
1.301,6,51,19513,27,904,50,1440,13777,24,433,49,1440,5736
1745.378,6,95,7203,63,38,28151,205,4476,32,33,56295,98,2727
4.611,6,25,8092,12,164,380,267,1324,13,869,367,1368,6768
7.033,6,12,524,6,0,1406,0,260,6,0,1127,0,264
68.893,6,26,6797,12,181,6263,267,1212,14,627,5297,1400,5585
1751.294,6,112,9144,72,54,24666,205,5606,40,38,44897,98,3538
1742.137,6,141,8558,77,42,22922,208,5099,64,31,27647,31,3459
1.891,17,4,396,2,39,1890,39,134,2,103,1889,103,262
4.657,6,38,7245,19,218,258,314,3383,19,516,244,1179,3862
291.203,1,10,280,10,0,0,0,280,0,0,0,0,0
1700.54,17,12,498,11,14,170054,14,462,1,8,0,8,36
4.616,6,37,7189,19,218,256,314,3383,18,513,256,1179,3806
15.526,6,7,380,2,0,15526,0,100,5,0,3833,0,280
1786.537,17,87,3648,86,14,21018,14,3612,1,8,0,8,36
3.497,6,2,88,2,0,0,0,88,0,0,0,0,0
0.095,6,10,1677,6,555,18,951,1354,4,159,31,159,323
1.303,6,41,11378,22,547,62,1360,5842,19,433,62,1360,5536
1744.7,2,24,768,24,8,75856,8,768,0,0,0,0,0
1787.213,17,87,3648,86,14,21026,14,3612,1,8,0,8,36
1.323,6,50,20605,28,919,49,1440,14949,22,433,54,1440,5656
1796.991,17,29,9512,29,300,64178,300,9512,0,0,0,0,0
3.075,17,6,471,3,31,1521,31,177,3,70,1521,70,294
13.955,6,27,4865,13,154,1145,722,1766,14,394,1060,1408,3099
1786.605,6,106,8584,69,66,26273,66,5004,37,60,49625,60,3580
0.051,17,4,284,2,32,37,32,120,2,54,15,60,164
4.71,6,37,7189,19,218,261,314,3383,18,513,262,1179,3806
54.12,17,4,352,2,60,54119,60,176,2,60,54119,60,176
0.247,17,3,451,2,39,7,39,134,1,289,0,289,317
1.225,6,23,7952,12,164,94,267,1288,11,1216,104,3819,6664
1795.027,17,144,11520,72,48,25281,48,5472,72,56,25281,56,6048
1786.562,6,102,8364,68,66,26665,66,4964,34,60,54135,60,3400
10.426,6,16,3911,9,275,1303,275,643,7,992,915,1440,3268
377.56,6,25,1651,17,177,23597,177,1117,8,110,9500,110,534
264.076,17,4,352,2,60,264074,60,176,2,60,264075,60,176
1788.668,17,122,9760,61,48,29810,48,4636,61,56,29810,56,5124
0.011,17,2,172,1,50,0,50,78,1,66,0,66,94
3.605,17,5,295,5,31,901,31,295,0,0,0,0,0
7.22,6,1762,1633241,1117,1384,6,1408,1595037,645,931,10,2816,38204
1756.318,6,95,7203,63,38,28327,205,4476,32,33,56648,98,2727
1791.251,17,140,11200,70,48,25960,48,5320,70,56,25960,56,5880
112.037,17,4,1344,4,308,37345,308,1344,0,0,0,0,0
1772.503,6,181,15589,120,69,14894,69,8940,61,69,29540,69,6649
1.019,6,29,7520,17,306,63,1087,2826,12,701,91,1728,4694
0.261,17,2,166,1,47,0,47,75,1,63,0,63,91
1786.798,6,106,8524,68,66,26668,66,4964,38,60,48289,60,3560
1764.415,2,14,448,14,8,135724,8,448,0,0,0,0,0
4.234,17,16,15542,6,703,846,1350,4387,10,1087,347,1350,11155
0.079,6,12,3462,6,75,15,75,395,6,1373,15,1448,3067
48.391,6,11,676,4,106,16128,106,274,7,90,8064,90,402
433.734,1,30,840,30,0,0,0,840,0,0,0,0,0
0.09,17,2,348,1,39,0,39,67,1,253,0,253,281
0.047,6,29,7835,17,131,2,131,1023,12,618,4,1000,6812
47.913,17,40,10360,40,231,1228,388,10360,0,0,0,0,0
0.01,17,2,376,1,39,0,39,67,1,281,0,281,309
1772.266,6,180,15480,120,69,14892,69,8940,60,69,30032,69,6540
1777.636,6,250,46012,124,867,14452,1402,33382,126,61,14221,580,12630
10.95,6,79,24689,40,560,280,1152,18968,39,461,281,1179,5721
205.225,17,3,1000,3,305,102612,308,1000,0,0,0,0,0
142.189,17,4,352,2,60,142188,60,176,2,60,142188,60,176
1783.033,6,361,22858,210,69,8531,69,12678,151,69,11886,69,10180
0.372,17,4,680,2,33,331,33,122,2,251,327,323,558
13.767,6,23,5822,13,275,1147,275,1082,10,1440,972,1440,4740
0.236,6,23,4519,11,165,23,456,1394,12,498,19,888,3125
11.928,6,1752,1619772,1142,1366,10,1432,1590937,610,427,19,1432,28835
0.221,6,4,222,2,31,221,31,111,2,31,0,31,111
1.447,6,25,8056,12,164,113,267,1288,13,1014,103,2736,6768
0.016,17,2,366,1,37,0,37,65,1,273,0,273,301
280.239,6,30,7432,13,158,23353,267,1317,17,543,17511,1400,6115
650.622,6,74,6678,37,122,18068,208,4795,37,31,18066,31,1883
1791.016,6,358,22738,208,69,8652,69,12460,150,69,12019,69,10278
1745.622,6,97,7307,63,38,28155,205,4476,34,33,52890,98,2831
1794.103,17,270,54002,270,172,6669,358,54002,0,0,0,0,0
1.349,6,50,19464,27,904,51,1360,13768,23,433,52,1360,5696
5.993,6,41,7365,21,218,299,314,3463,20,516,302,1179,3902
24.497,2,2,64,2,8,24497,8,64,0,0,0,0,0
204.876,17,18,1440,9,48,25607,48,684,9,56,25607,56,756
0.473,6,10,968,5,256,116,256,460,5,304,115,304,508
1.389,6,41,11964,22,612,66,1360,6428,19,433,66,1360,5536
17.709,6,23,9503,8,187,2529,187,587,15,1181,1241,1440,8916
1669.411,1,7,392,7,28,278235,28,392,0,0,0,0,0
167.629,6,22,8524,11,310,64,619,1402,11,952,16749,1460,7122
1773.528,6,180,15480,120,69,14903,69,8940,60,69,30054,69,6540
158.248,6,35,7954,12,141,14385,267,1335,23,316,7192,1420,6619
1762.453,1,54,4536,54,56,33253,56,4536,0,0,0,0,0
0.242,6,27,7296,14,155,18,267,1341,13,603,19,2036,5955
50.597,6,26,8647,12,458,4599,731,1994,14,537,3871,1520,6653
1.646,6,13,2311,8,188,235,245,700,5,1407,349,1407,1611
2.435,17,2,685,1,308,0,308,336,1,321,0,321,349
280.534,6,29,7392,13,158,23377,267,1317,16,603,18695,1400,6075
0.677,6,118,87577,54,131,12,232,2689,64,1419,10,2760,84888
0.028,17,2,201,1,36,0,36,64,1,109,0,109,137
1796.525,17,449,39928,404,35,4457,288,25708,45,288,40020,288,14220
0.513,17,4,288,2,36,480,36,128,2,52,482,52,160
18.145,6,1292,1182835,820,1361,21,1368,1148327,472,776,38,1473,34508
6.998,6,476,404950,296,1303,22,1368,390926,180,776,37,1473,14024
260.098,6,30,7432,14,158,20007,267,1357,16,603,17337,2800,6075
0.201,17,4,344,2,47,39,47,150,2,69,163,75,194
0.402,17,15,8442,8,706,57,1350,5872,7,339,57,1350,2570
1.781,6,24,8004,12,164,134,267,1288,12,1014,139,2331,6716
1.62,6,46,18766,26,932,64,1460,13190,20,476,74,2615,5576
0.964,6,10,1687,7,100,160,100,384,3,1179,355,1179,1303
0.879,17,20,7017,8,303,125,1350,2650,12,335,73,1350,4367
1788.701,6,126,15198,81,90,22358,510,6772,45,161,40649,1380,8426
448.303,17,18,1584,9,48,56036,48,684,9,72,56036,72,900
1770.258,6,101,9410,66,66,27234,66,5610,35,60,52063,60,3800
0.017,17,2,196,1,62,0,62,90,1,78,0,78,106
240.295,6,43,8807,21,519,12014,1402,5775,22,208,11442,618,3032
524.9,1,28,2968,28,78,19440,78,2968,0,0,0,0,0
94.741,6,26,7916,12,261,8612,467,1405,14,481,7267,1368,6511
0.205,17,4,334,2,39,157,39,134,2,72,150,72,200
1.165,6,25,8056,13,164,82,267,1340,12,869,90,1448,6716
300.838,6,48,13126,25,884,12534,1460,7280,23,307,497,1460,5846
0.099,6,9,1339,5,145,24,145,349,4,826,23,826,990
10.217,6,82,24565,40,552,261,1152,18744,42,413,243,1152,5821
6.612,6,3,1560,1,0,0,0,40,2,1440,3490,1440,1520
11.837,6,25,8473,13,275,986,275,1078,12,986,862,1440,7395
72.109,6,33,7624,14,155,5546,267,1346,19,393,4005,1997,6278
280.392,6,31,7472,13,158,23366,267,1317,18,603,16491,2076,6155
227.977,6,29,7392,13,158,18998,267,1317,16,603,15193,1400,6075
217.599,6,67,14280,25,110,9066,267,2338,42,301,5307,1460,11942
280.248,6,29,7392,13,158,23354,267,1317,16,603,18679,1400,6075
241.018,6,45,8637,22,461,11475,1368,5774,23,207,10953,580,2863
1798.803,6,365,25570,213,99,8484,469,15005,152,69,11911,69,10565
240.635,6,43,8852,21,578,12031,1418,5728,22,246,11458,620,3124
1679.507,17,12,498,11,14,167950,14,462,1,8,0,8,36
1330.485,17,106,8480,53,48,25586,48,4028,53,56,25586,56,4452
1773.324,6,180,15480,120,69,14901,69,8940,60,69,30051,69,6540
0.054,1,2,112,2,28,54,28,112,0,0,0,0,0
0.057,17,2,214,1,39,0,39,67,1,119,0,119,147
11.258,6,27,11373,13,275,938,275,1078,14,1080,835,1420,10295
7.196,6,955,1003109,326,647,22,647,22136,629,1512,10,7240,980973
300.872,6,46,18217,27,961,11572,1360,12655,19,435,481,2667,5562
0.306,6,26,9034,13,262,25,690,1735,13,945,25,1408,7299
1.337,6,50,18884,27,862,51,1360,13188,23,433,53,1360,5696
2.039,6,27,6164,13,108,169,147,959,14,772,152,1608,5205
2.231,17,34,9662,15,347,157,1350,5629,19,184,122,1350,4033
0.017,17,2,439,2,191,17,336,439,0,0,0,0,0
95.056,17,4,240,2,32,95055,32,120,2,32,95055,32,120
1773.161,6,180,15480,120,69,14900,69,8940,60,69,30045,69,6540
1.345,6,50,19416,27,900,51,1460,13720,23,476,52,2615,5696
0.732,17,5,561,3,31,360,31,177,2,164,718,164,384
1749.606,17,12,498,11,14,174960,14,462,1,8,0,8,36
0.114,17,2,396,1,39,0,39,67,1,301,0,301,329
1796.477,6,123,12308,77,62,23637,721,6401,46,97,39913,2330,5907
1792.547,17,87,3648,86,14,21088,14,3612,1,8,0,8,36
688.303,17,6,246,5,14,172075,14,210,1,8,0,8,36
1740.802,6,138,8646,75,46,23524,208,5134,63,31,28072,31,3512
595.574,6,13,768,9,31,74446,31,484,4,31,116014,31,284
1798.029,17,448,39328,405,35,4450,288,25740,43,288,41931,288,13588
0.018,17,4,398,2,46,11,46,148,2,97,9,103,250
1370.857,6,185,19833,91,100,15230,721,9881,94,220,14738,1420,9952
0.3,6,26,9013,13,257,24,669,1714,13,1102,24,2804,7299
251.495,6,66,44953,43,1159,5987,1408,37024,23,960,2799,3847,7929
1.67,6,13,2311,8,188,238,245,700,5,1407,353,1407,1611
60.35,6,9,759,5,177,15087,177,433,4,110,20059,110,326
70.244,6,26,7055,11,532,29,1420,2588,15,427,5016,1715,4467
1789.419,1,58,4872,58,56,31393,56,4872,0,0,0,0,0
1.788,6,25,6032,13,164,149,453,1494,12,651,141,1448,4538
5.022,17,4,288,2,36,5007,36,128,2,52,5009,52,160
0.248,6,26,7256,13,155,20,267,1301,13,678,18,2800,5955
1795.768,17,448,39896,403,35,4467,288,25676,45,288,40020,288,14220
51.332,6,10,648,10,31,5703,31,648,0,0,0,0,0
0.784,6,23,6168,13,264,65,662,1848,10,979,86,1731,4320
11.014,6,18,5610,10,275,1223,275,958,8,1440,819,1440,4652
887.752,6,57,5498,32,98,25259,205,3440,25,31,36968,33,2058
1.365,6,50,19505,27,906,52,1460,13809,23,433,52,1460,5696
18.389,6,2469,2252529,1565,1360,11,1408,2200845,904,931,20,2816,51684
1624.153,6,95,7582,62,64,26625,64,4464,33,58,50752,58,3118
1746.865,6,97,7307,63,38,28175,205,4476,34,33,52927,98,2831
0.007,17,2,122,1,33,0,33,61,1,33,0,33,61
251.871,2,3,96,3,8,125935,8,96,0,0,0,0,0
1792.298,17,87,3648,86,14,21085,14,3612,1,8,0,8,36
69.18,6,59,36887,37,1127,1921,1448,28990,22,749,2926,1448,7897
166.773,6,30,14600,16,488,324,1360,3125,14,1362,12819,3928,11475
33.652,6,30,5064,15,154,2403,722,1882,15,399,2391,2026,3182
61.889,6,75,52096,46,1219,1375,1448,43858,29,746,2202,1448,8238
3.594,6,14,2351,8,188,513,245,700,6,1407,664,1407,1651
1069.398,1,16,896,16,28,71293,28,896,0,0,0,0,0
1791.181,6,356,22520,208,69,8653,69,12460,148,69,12184,69,10060
1783.101,17,83,3480,82,14,22013,14,3444,1,8,0,8,36
1795.687,6,374,23432,212,69,8510,69,12620,162,58,11153,69,10812
39.792,17,44,6468,22,48,1894,48,1672,22,190,1894,308,4796
0.116,6,11,1703,6,314,23,500,948,5,487,28,487,755
1785.569,17,87,3648,86,14,21006,14,3612,1,8,0,8,36
1787.343,6,117,13597,77,81,23517,501,6030,40,156,45827,1420,7567
1784.469,6,359,22709,209,69,8579,69,12569,150,69,11976,69,10140
0.053,6,9,1343,5,145,13,145,349,4,830,11,830,994
152.619,6,305,252772,196,1312,782,1368,234688,109,620,1400,2519,18084
113.685,6,122,92347,78,1255,1476,1408,81933,44,811,1915,3847,10414
1786.837,6,104,8376,68,65,26669,65,4930,36,59,51048,59,3446
6.075,6,1400,1293030,887,1381,6,1408,1261690,513,931,11,2816,31340
0.283,6,21,5000,10,137,31,267,1092,11,692,27,1467,3908
1797.966,1,58,4872,58,56,31543,56,4872,0,0,0,0,0
240.348,6,48,12216,24,442,10449,1402,5696,24,526,10449,1402,6520
0.2,6,10,1378,6,145,40,145,389,4,825,60,825,989
1.937,6,10,2102,10,255,215,316,2102,0,0,0,0,0
2.671,6,2,104,2,0,0,0,104,0,0,0,0,0
139.911,6,35,8161,10,141,5709,267,1255,25,294,5829,1452,6906
0.137,6,37,13847,21,902,6,1420,8986,16,420,8,1420,4861
1758.401,17,267,56631,267,184,6610,422,56631,0,0,0,0,0
1776.461,17,65,2724,64,14,28197,14,2688,1,8,0,8,36
1.231,17,2,322,1,33,0,33,61,1,233,0,233,261
280.469,6,29,7392,13,158,23372,267,1317,16,603,18690,2076,6075
4.369,6,35,6209,19,206,242,314,2824,16,548,275,1179,3385
1.715,6,12,3462,6,75,343,75,395,6,1373,342,1448,3067
85.358,17,3,228,3,48,42679,48,228,0,0,0,0,0
1786.659,6,102,8364,68,66,26666,66,4964,34,60,54138,60,3400
0.012,6,20,9985,10,125,1,125,653,10,1257,1,1448,9332
1741.088,6,89,6426,58,31,30545,31,3915,31,31,58035,31,2511
18.365,6,16,1327,8,222,2622,222,768,8,231,2622,231,559
41.81,1,4,224,4,28,13936,28,224,0,0,0,0,0
1744.124,6,95,7203,63,38,28131,205,4476,32,33,56249,98,2727
1789.495,17,83,3480,82,14,22092,14,3444,1,8,0,8,36
0.279,6,20,4960,10,137,31,267,1092,10,692,30,1467,3868
1.387,17,21,15035,12,1016,125,1350,12534,9,249,168,1350,2501
18.131,17,2,152,2,48,18131,48,152,0,0,0,0,0
86.297,2,2,64,2,8,86297,8,64,0,0,0,0,0
7.235,6,1215,1055639,727,1371,9,1408,1025599,488,931,14,2816,30040
1740.98,6,87,6322,58,31,30543,31,3915,29,31,62176,31,2407
1740.2,6,87,6322,58,31,30529,31,3915,29,31,62149,31,2407
2.187,17,4,314,2,31,2145,31,118,2,70,2155,70,196
0.292,17,7,2368,7,310,48,354,2368,0,0,0,0,0
199.731,17,4,352,2,60,199729,60,176,2,60,199730,60,176
60.13,2,2,64,2,8,60130,8,64,0,0,0,0,0
0.018,17,2,402,2,173,18,300,402,0,0,0,0,0
0.734,6,26,9017,13,261,61,683,1728,13,943,54,1438,7289
2.532,6,38,13182,21,222,105,540,2264,17,1136,128,4511,10918
1796.687,17,448,39896,403,35,4469,288,25676,45,288,40021,288,14220
1741.126,6,90,6521,59,31,30019,31,3998,31,31,58037,31,2523
1.629,6,47,17209,28,801,60,1360,11628,19,480,79,4075,5581
1.766,17,20,5180,20,231,92,388,5180,0,0,0,0,0
34.83,1,39,4056,0,0,0,0,0,39,76,916,76,4056
1793.821,17,84,3516,82,14,22143,14,3444,2,8,1793631,8,72
280.439,6,29,7392,13,158,23369,267,1317,16,678,18691,2085,6075
240.287,6,43,9001,21,516,12014,1402,5746,22,233,11441,618,3255
3.132,6,28,4741,14,197,240,314,2145,14,508,220,1179,2596
3.807,17,4,296,4,46,1269,46,296,0,0,0,0,0
1.034,6,30,12064,16,525,68,1360,3310,14,909,65,1380,8754
1.447,17,2,146,1,37,0,37,65,1,53,0,53,81
9.691,6,28,8529,14,482,745,721,2492,14,683,661,2840,6037
12.226,6,6,328,4,0,4075,0,216,2,0,12215,0,112
1744.706,2,28,896,28,8,64618,8,896,0,0,0,0,0
0.135,17,2,206,1,44,0,44,72,1,106,0,106,134
0.437,6,11,913,6,182,87,182,490,5,77,45,134,423
283.227,6,30,7432,13,158,23602,267,1317,17,603,17699,2076,6115
0.844,6,21,5988,12,281,76,544,1328,9,716,94,1420,4660
3.095,6,43,13560,23,225,134,561,2389,20,863,153,1631,11171
150.054,6,64,43432,41,1190,3751,1448,35484,23,843,2815,2359,7948
42.578,17,24,1824,24,48,1851,48,1824,0,0,0,0,0
0.004,6,2,1500,1,0,0,0,40,1,1420,0,1420,1460
3.578,6,44,19668,24,511,155,1460,3619,20,952,166,1460,16049
1786.872,6,104,8376,68,65,26669,65,4930,36,59,51048,59,3446
29.209,6,4168,4014307,2708,1404,10,1448,3933723,1460,776,19,1448,80584
47.342,17,52,7644,26,48,1893,48,1976,26,190,1893,308,5668
1784.98,6,357,22629,208,69,8623,69,12529,149,69,12060,69,10100
0.045,6,7,423,4,43,2,43,259,3,0,21,0,164
0.283,17,5,1757,5,323,70,354,1757,0,0,0,0,0
1786.59,6,447,26160,239,69,7506,69,13700,208,34,8630,64,12460
38.621,17,22,1936,11,48,3861,48,836,11,72,3861,72,1100
240.216,6,55,18119,28,810,8896,1418,15235,27,184,9238,580,2884
4.305,6,38,7229,19,218,239,314,3383,19,513,225,1179,3846
1785.856,6,382,28531,219,120,8191,1189,17041,163,74,11023,256,11490
1798.323,6,866,59407,429,31,4201,31,29229,437,31,4124,31,30178
1786.772,6,106,8574,70,65,25895,65,5010,36,59,51047,59,3564
17.742,1,4,224,4,28,5914,28,224,0,0,0,0,0
1791.461,17,140,11184,72,48,25231,48,5472,68,56,26737,56,5712
1786.374,6,105,8550,69,66,26270,66,5070,36,60,51036,60,3480
296.21,1,4,326,4,53,98736,78,326,0,0,0,0,0
1744.632,2,16,512,16,8,116308,8,512,0,0,0,0,0
1794.341,17,180,11520,180,36,10024,36,11520,0,0,0,0,0
1744.864,1,60,5040,60,56,29573,56,5040,0,0,0,0,0
369.846,1,11,924,11,56,36984,56,924,0,0,0,0,0
1772.077,6,181,15589,120,69,14891,69,8940,61,69,29533,69,6649
0.68,2,3,96,3,8,340,8,96,0,0,0,0,0
9.658,6,1505,1334871,909,1414,10,1432,1306810,596,420,16,1432,28061
126.665,6,39,15806,21,666,197,1460,3628,18,952,7440,1547,12178
1.332,6,49,19808,27,931,51,1440,14152,22,433,54,1440,5656
2.474,17,58,47172,23,383,112,1350,9457,35,1049,70,1350,37715
1740.44,17,29,30624,29,1028,62158,1028,30624,0,0,0,0,0
1739.009,1,73,6132,0,0,0,0,0,73,56,24152,56,6132
1793.82,6,294,36484,121,141,14947,1460,17325,173,140,10428,1642,19159
0.035,17,2,176,1,48,0,48,76,1,72,0,72,100
63.157,17,4,288,2,36,63125,36,128,2,52,63114,52,160
1789.897,6,447,35721,242,88,7426,1189,17649,205,137,8773,1917,18072
240.185,6,58,18215,30,754,8281,1402,15153,28,199,8895,580,3062
1.279,2,2,64,2,8,1279,8,64,0,0,0,0,0
10.1,6,745,633363,459,1308,21,1368,613827,286,776,34,1473,19536
1799.947,17,772,46624,772,32,2334,37,46624,0,0,0,0,0
369.843,6,27,1767,18,177,21755,177,1181,9,110,8929,110,586
0.201,6,46,21105,26,1073,8,1420,16084,20,467,10,1883,5021
0.39,6,12,1653,6,288,71,288,548,6,426,43,434,1105
1787.922,6,356,22520,208,69,8637,69,12460,148,69,12162,69,10060
8.167,6,9,2091,4,275,2722,275,439,5,1440,1542,1440,1652
0.085,17,2,162,1,34,0,34,62,1,72,0,72,100
280.376,6,29,7392,13,158,23364,267,1317,16,603,18684,1400,6075
2.465,6,22,6476,12,334,222,1010,2156,10,979,269,1691,4320
315.032,6,23,2585,7,242,52504,517,1111,16,323,21001,499,1474
448.174,6,92,30916,43,586,10670,1402,11044,49,666,9336,1402,19872
1772.717,6,180,15480,120,69,14896,69,8940,60,69,30037,69,6540
1794.557,6,126,16864,78,220,23305,1290,11704,48,83,38182,240,5160
1800.0,6,212,16315,79,68,23076,294,7721,133,48,13635,78,8594
0.201,17,2,152,1,48,0,48,76,1,48,0,48,76
0.077,6,11,819,6,186,15,186,506,5,45,17,45,313
35.601,17,6,362,3,32,17800,33,181,3,32,17800,33,181
125.957,6,75,51045,47,1187,2738,1408,42854,28,747,2280,1408,8191
1745.552,6,90,6540,60,31,29585,31,4050,30,31,60183,31,2490
91.643,6,35,7911,19,449,5091,1402,5480,16,227,6025,580,2431
1799.872,1,218,23108,218,78,8294,78,23108,0,0,0,0,0
1720.661,17,13,534,11,14,172045,14,462,2,8,1720484,8,72
218.78,6,30,7432,13,158,18231,267,1317,17,543,13671,1400,6115
1741.415,17,28,6580,28,207,64496,207,6580,0,0,0,0,0
1797.848,6,372,25988,216,98,8362,469,15263,156,69,11595,69,10725
1772.78,6,180,15480,120,69,14897,69,8940,60,69,30038,69,6540
1784.805,6,117,13853,76,81,23797,500,5989,41,159,44617,1420,7864
97.344,6,79,57923,51,1238,1946,1448,49713,28,843,2283,2359,8210
131.798,6,18,1375,9,332,16474,332,808,9,83,16359,83,567
0.176,17,2,348,1,39,0,39,67,1,253,0,253,281
240.284,6,43,9088,21,523,12013,1418,5814,22,235,11441,618,3274
1738.079,17,196,31576,196,133,8913,404,31576,0,0,0,0,0
1786.338,17,87,3648,86,14,21015,14,3612,1,8,0,8,36
11.312,6,853,695108,499,1313,22,1368,670768,354,776,31,1473,24340
1788.915,1,228,24168,228,78,7880,78,24168,0,0,0,0,0
0.002,6,2,128,1,0,0,0,40,1,48,0,48,88
1787.573,6,106,8456,68,65,26680,65,4930,38,59,48309,59,3526
300.905,6,41,10058,22,590,14328,1360,4465,19,370,481,1360,5593
1786.722,6,102,8228,68,64,26667,64,4896,34,58,54140,58,3332
1786.769,6,105,8416,68,65,26668,65,4930,37,59,49629,59,3486
0.035,17,2,158,1,34,0,34,62,1,68,0,68,96
0.437,6,13,1693,7,288,69,288,588,6,426,48,434,1105
0.661,17,3,1164,3,360,330,360,1164,0,0,0,0,0
1796.41,17,449,39928,404,35,4457,288,25708,45,288,40016,288,14220
1768.29,1,73,6132,73,56,24559,56,6132,0,0,0,0,0
1787.901,6,368,25759,213,100,8433,469,14936,155,69,11609,69,10823
2.316,6,13,2311,8,188,330,245,700,5,1407,516,1407,1611
7.728,17,36,8672,11,280,772,1350,3395,25,183,320,1350,5277
4.452,6,39,7285,19,218,247,314,3383,20,442,220,1152,3902
1795.116,1,268,15008,268,28,6723,28,15008,0,0,0,0,0
5.17,6,5,232,2,0,5170,0,88,3,0,1512,0,144
12.249,6,1874,1674932,1178,1368,10,1380,1641446,696,421,17,1923,33486
1788.726,17,83,3480,82,14,22083,14,3444,1,8,0,8,36
1.118,17,2,204,1,34,0,34,62,1,114,0,114,142
2.143,6,30,10405,18,367,126,833,1825,12,1012,186,1420,8580
1789.865,6,357,22629,208,69,8646,69,12460,149,69,12093,69,10169
2.911,6,1653,1726603,529,217,5,230,29905,1124,1460,2,4344,1696698
2.076,6,28,9585,17,323,129,702,1654,11,935,189,1336,7931
1787.612,6,102,8228,68,64,26680,64,4896,34,58,54167,58,3332
1.378,6,50,20017,27,943,53,1440,14321,23,433,54,1440,5696
1794.779,1,170,9520,170,28,10619,28,9520,0,0,0,0,0
0.049,17,4,420,2,33,0,33,122,2,121,16,145,298
0.355,17,2,152,1,48,0,48,76,1,48,0,48,76
1798.515,6,380,23720,213,69,8483,69,12660,167,55,10834,69,11060
0.012,17,2,191,1,30,0,30,58,1,105,0,105,133
66.786,6,25,10829,12,380,73,832,1665,13,959,5554,1440,9164
300.852,6,50,10526,25,433,12535,910,3258,25,312,542,1460,7268
1771.737,6,101,9278,66,64,27257,64,5544,35,58,52107,58,3734
1770.494,6,101,9410,66,66,27238,66,5610,35,60,52070,60,3800
0.128,6,2,116,1,0,0,0,52,1,0,0,0,64
0.519,6,23,7428,14,273,39,663,2104,9,1209,58,1946,5324
1791.529,17,180,14040,180,50,10008,50,14040,0,0,0,0,0
0.073,6,2,1251,1,1159,0,1159,1211,1,0,0,0,40
291.148,6,45,7918,22,116,13861,517,2111,23,417,13231,1418,5807
1795.895,17,488,58247,224,156,8053,1350,41338,264,36,6828,1350,16909
1796.866,1,342,28728,342,56,5269,56,28728,0,0,0,0,0
60.164,2,2,64,2,8,60164,8,64,0,0,0,0,0
1782.815,6,359,22709,209,69,8571,69,12569,150,69,11965,69,10140
124.01,17,4,240,2,32,124009,32,120,2,32,124009,32,120
0.459,6,26,6096,14,108,35,147,999,12,768,41,1581,5097
239.215,6,24491,24550689,8787,807,27,1448,534290,15704,1480,15,8688,24016399
1786.213,17,87,3648,86,14,21014,14,3612,1,8,0,8,36
31.976,6,278,255508,111,128,290,308,6230,167,1476,192,2816,249278
0.009,17,2,350,1,39,0,39,67,1,255,0,255,283
1682.291,17,16,1265,8,30,240322,37,471,8,71,240322,136,794
41.571,6,30,7297,14,155,3197,267,1346,16,441,2770,1420,5951
1.333,6,50,21051,28,949,49,1460,15395,22,433,54,1460,5656
240.225,6,53,18506,28,824,8896,1418,15482,25,214,10008,580,3024
3.524,17,4,1560,4,362,1174,362,1560,0,0,0,0,0
123.08,6,31,7840,12,317,253,975,2705,19,397,6823,1179,5135
561.952,17,8,480,4,32,187317,32,240,4,32,187317,32,240
10.489,17,3,984,3,300,5244,300,984,0,0,0,0,0
192.639,6,28,7258,5,154,48157,267,672,23,314,8755,1460,6586
1.101,6,26,9593,14,350,84,1042,1993,12,1015,76,1460,7600
1.996,17,2,672,2,308,1996,308,672,0,0,0,0,0
146.381,6,22,9261,11,514,87,1236,2014,11,1132,14621,2279,7247
1680.774,17,13,534,11,14,168054,14,462,2,8,1680591,8,72
0.393,6,24,5980,12,164,35,453,1442,12,651,33,1448,4538
366.219,6,25,1651,17,177,22888,177,1117,8,110,9170,110,534
6.041,17,4,1370,2,308,5049,308,672,2,321,5040,321,698
1773.317,6,181,15589,120,69,14901,69,8940,61,69,29552,69,6649
1.989,17,4,644,2,33,1000,33,122,2,233,9,233,522
0.282,17,2,180,1,30,0,30,58,1,94,0,94,122
0.083,17,2,396,1,39,0,39,67,1,301,0,301,329
1780.415,17,142,11360,71,48,25434,48,5396,71,56,25434,56,5964
1775.615,17,140,11200,70,48,25733,48,5320,70,56,25733,56,5880
1548.567,1,138,7728,138,28,11303,28,7728,0,0,0,0,0
0.511,6,10,968,5,256,123,256,460,5,304,123,304,508
5.552,6,40,7325,20,218,292,314,3423,20,516,278,1179,3902
1.652,6,27,10179,16,285,110,587,1499,11,1029,148,1420,8680
272.767,1,4,224,4,28,90922,28,224,0,0,0,0,0
240.199,6,54,17826,29,795,8578,1418,15046,25,184,10007,580,2780
240.362,6,44,8480,23,449,10925,1418,5712,21,208,12017,580,2768
0.058,17,4,284,2,32,0,32,120,2,54,15,60,164
0.522,6,27,9167,13,282,43,769,1814,14,943,37,1368,7353
1797.785,17,373,77807,373,180,4832,361,77807,0,0,0,0,0
34.179,17,20,1760,10,48,3796,48,760,10,72,3796,72,1000
3.334,17,5,295,5,31,833,31,295,0,0,0,0,0
1.994,17,4,518,3,39,982,39,201,1,289,0,289,317
189.346,17,4,514,2,36,189341,36,128,2,165,189341,187,386
0.009,17,2,463,1,44,0,44,72,1,363,0,363,391
303.572,6,135,15617,51,94,6071,267,4404,84,135,3657,3417,11213
0.134,17,2,198,1,37,0,37,65,1,105,0,105,133
0.4,6,12,1653,6,288,75,288,548,6,426,43,434,1105
0.885,6,16,2678,8,288,96,288,640,8,426,81,853,2038
1.095,17,4,368,2,32,871,32,120,2,96,816,96,248
0.415,6,47,17796,25,970,17,1380,12674,22,421,18,1923,5122
39.306,17,22,1672,22,48,1871,48,1672,0,0,0,0,0
15.623,17,21,13174,11,963,1559,1350,10904,10,199,1732,1350,2270
91.163,6,28,9486,15,542,74,1287,2294,13,832,7582,3151,7192
66.872,17,24,2112,12,48,6078,48,912,12,72,6078,72,1200
4.569,17,2,178,1,29,0,29,57,1,93,0,93,121
1790.907,6,311,19478,181,69,9949,69,10759,130,69,13882,69,8719
0.521,17,2,476,1,39,0,39,67,1,381,0,381,409
134.38,6,28,8906,16,403,8958,1408,2869,12,772,3329,1491,6037
0.997,17,5,1176,3,32,496,32,180,2,470,5,470,996
1772.457,6,180,15480,120,69,14894,69,8940,60,69,30036,69,6540
0.523,6,22,7342,12,335,47,668,1974,10,806,57,1408,5368
12.113,6,25,8473,13,275,1009,275,1078,12,986,957,1440,7395
1785.213,17,87,3648,86,14,21002,14,3612,1,8,0,8,36
3.851,6,4,617,1,302,0,302,354,3,83,1925,83,263
1742.395,6,94,7151,62,38,28563,205,4424,32,33,56198,98,2727
0.112,17,2,182,1,39,0,39,67,1,87,0,87,115
1775.845,17,142,11360,71,48,25368,48,5396,71,56,25368,56,5964
8.641,6,80,25098,40,561,221,1152,19016,40,407,214,1152,6082
300.127,6,54,18214,26,900,11998,1360,11877,28,273,11109,2667,6337
1786.644,6,108,8724,70,66,25893,66,5044,38,60,48284,60,3680
1740.675,17,30,6930,30,203,60023,203,6930,0,0,0,0,0
4.249,6,10,1102,6,483,849,483,803,4,83,1412,83,299
1774.259,6,180,15480,120,69,14909,69,8940,60,69,30069,69,6540
13.521,6,1407,1275920,841,1434,15,1448,1240196,566,776,23,1448,35724
5.013,17,4,288,2,36,4994,36,128,2,52,4999,52,160
5.837,6,37,7461,19,231,324,314,3314,18,489,301,1179,4147
42.29,17,48,7056,24,48,1838,48,1824,24,190,1838,308,5232
1776.215,1,61,5124,0,0,0,0,0,61,56,29603,56,5124
1782.578,17,83,3480,82,14,22007,14,3444,1,8,0,8,36
13.749,6,25,4786,13,154,1127,721,1790,12,592,1233,2118,2996
624.001,6,551,184600,290,259,2055,1360,66466,261,912,2400,9520,118134
3.285,17,3,228,2,48,3100,48,152,1,48,0,48,76
120.051,6,34,8693,20,189,6318,517,2738,14,579,9233,3473,5955
0.156,17,2,152,1,48,0,48,76,1,48,0,48,76
0.381,17,2,304,1,60,0,60,88,1,188,0,188,216
3.234,17,5,295,5,31,808,31,295,0,0,0,0,0
2.053,17,2,312,2,128,2053,128,312,0,0,0,0,0
0.098,17,2,158,1,34,0,34,62,1,68,0,68,96
280.25,6,28,7352,13,158,23354,267,1317,15,678,20016,2045,6035
0.564,6,7,423,4,43,174,43,259,3,0,23,0,164
1788.331,17,83,3480,82,14,22078,14,3444,1,8,0,8,36
168.92,17,2,908,2,426,168920,687,908,0,0,0,0,0
1772.933,6,180,15480,120,69,14898,69,8940,60,69,30045,69,6540
1043.0,17,205,15580,205,48,5112,48,15580,0,0,0,0,0
13.256,6,106,34805,56,592,241,1152,28307,50,449,265,1179,6498
21.499,17,46,7380,21,136,1073,1350,3444,25,129,894,1350,3936
1.291,6,25,8056,12,164,97,267,1288,13,869,91,1448,6768
225.406,6,21,1620,11,177,22526,177,994,10,110,25026,110,626
377.826,2,4,128,4,8,125942,8,128,0,0,0,0,0
0.898,17,2,144,1,36,0,36,64,1,52,0,52,80
60.284,6,41,20515,21,131,3014,134,1624,20,991,3170,1448,18891
3.245,6,13,1466,8,304,463,304,1032,5,83,795,83,434
82.947,17,4,240,2,32,82946,32,120,2,32,82946,32,120
37.382,17,44,6468,22,48,1777,48,1672,22,190,1777,308,4796
0.522,17,3,451,2,39,192,39,134,1,289,0,289,317
0.059,17,2,216,1,45,0,45,73,1,115,0,115,143
0.093,17,2,154,1,33,0,33,61,1,65,0,65,93
1.249,6,25,8056,12,164,95,267,1288,13,869,88,1448,6768
0.154,6,10,767,5,186,35,186,454,5,45,38,45,313
10.825,6,19,7365,7,272,1804,516,1100,12,642,976,1452,6265
0.017,6,3,120,1,0,0,0,40,2,0,14,0,80
1.38,17,6,432,3,36,663,36,192,3,52,673,52,240
1796.941,1,341,28644,341,56,5285,56,28644,0,0,0,0,0
1772.675,6,180,15480,120,69,14896,69,8940,60,69,30037,69,6540
224.624,17,28,32527,28,1133,8319,1450,32527,0,0,0,0,0
1798.134,17,448,39384,403,35,4472,288,25412,45,282,40015,288,13972
560.76,17,8,2045,4,31,186916,37,239,4,423,186916,463,1806
26.93,17,24,7487,10,406,2992,1350,4341,14,196,2069,1350,3146
2.042,6,20,3833,11,234,204,564,1504,9,463,230,1343,2329
0.41,6,27,9124,13,271,34,726,1783,14,943,30,1408,7341
1783.812,6,362,22898,210,69,8534,69,12609,152,69,11813,69,10289
380.474,6,69,10962,34,304,11529,304,7248,35,83,11145,83,3714
1749.497,6,97,7307,63,38,28217,205,4476,34,33,53003,98,2831
2.526,6,21,6366,10,268,275,517,1333,11,744,248,1418,5033
33.719,6,30,5042,15,154,2408,722,1859,15,399,2395,1440,3183
0.006,17,2,415,1,39,0,39,67,1,320,0,320,348
0.016,17,2,235,1,36,0,36,64,1,143,0,143,171
1796.355,6,356,22520,208,69,8678,69,12460,148,69,12220,69,10060
0.392,6,12,1653,6,288,72,288,548,6,426,42,434,1105
52.347,6,38,8503,18,399,509,882,1950,20,441,2748,1460,6553
0.015,6,10,1810,5,655,3,655,923,5,619,3,619,887
0.002,6,4,4510,1,0,0,0,40,3,1438,1,1438,4470
2.068,6,26,8277,14,150,157,374,1315,12,1079,186,1691,6962
1787.481,6,105,8550,69,66,26286,66,5070,36,60,51067,60,3480
86.959,6,25,12703,13,519,95,884,2629,12,1197,7891,2720,10074
0.05,17,4,352,2,37,0,37,130,2,83,10,89,222
5.833,6,40,7309,20,218,307,314,3423,20,513,292,1179,3886
0.001,17,4,352,2,37,0,37,130,2,83,1,89,222
38.525,17,11,836,11,48,3852,48,836,0,0,0,0,0
265.484,6,44,7900,22,134,12642,516,2090,22,289,12637,1452,5810
3.242,6,26,7196,14,657,249,1418,5339,12,245,293,580,1857
1681.402,1,15,840,15,28,120100,28,840,0,0,0,0,0
5.32,6,18,8909,8,162,760,267,912,10,1244,578,2301,7997
351.1,6,49,9415,26,134,14044,889,2556,23,329,895,2720,6859
1080.142,17,58,19488,58,308,18949,308,19488,0,0,0,0,0
1.306,6,22,7900,12,164,100,267,1288,10,1521,123,5227,6612
1798.227,1,59,4956,0,0,0,0,0,59,56,31003,56,4956
44.224,6,708,704496,456,141,97,213,25399,252,2707,176,14080,679097
20.827,6,3123,2786292,1851,1416,11,1448,2707960,1272,776,16,1448,78332
16.255,17,22,12395,11,520,1621,1350,6038,11,549,1621,1350,6357
1780.34,1,132,7392,132,28,13590,28,7392,0,0,0,0,0
4.976,17,4,558,2,36,4971,36,128,2,187,4971,187,430
1787.533,17,87,3648,86,14,21029,14,3612,1,8,0,8,36
81.211,6,22,10814,11,410,78,922,1702,11,1237,8107,1460,9112
1.351,6,50,20147,28,889,50,1360,14491,22,476,55,2715,5656
30.47,17,40,10360,40,231,781,388,10360,0,0,0,0,0
1743.745,6,95,7203,63,38,28124,205,4476,32,33,56243,98,2727
1794.139,17,80,3354,79,14,23001,14,3318,1,8,0,8,36
15.214,6,5,752,3,46,7607,46,166,2,506,14953,506,586
315.904,6,59,12805,28,141,11700,615,3580,31,398,10525,2720,9225
1742.884,6,97,7307,63,38,28111,205,4476,34,33,52805,98,2831
0.05,6,5,248,4,0,2,0,208,1,0,0,0,40
1.26,6,49,19640,27,919,48,1360,13984,22,476,52,2715,5656
2.435,17,18,6893,9,472,300,1350,4501,9,237,300,1350,2392
185.378,17,6,586,3,37,92686,47,197,3,101,92686,145,389
0.046,17,2,180,1,30,0,30,58,1,94,0,94,122
1.52,6,52,13906,25,553,63,1429,4908,27,439,44,1986,8998
88.819,6,123,89232,75,1245,1200,1408,78612,48,811,1885,3847,10620
288.828,6,265,42925,152,304,1912,304,30612,113,83,2578,83,12313
0.059,6,2,133,1,0,0,0,40,1,53,0,53,93
254.471,6,20,1230,8,106,36353,106,654,12,0,2857,0,576
5.01,17,4,530,2,36,5002,36,128,2,173,5006,187,402
0.58,6,21,5000,11,137,58,267,1132,10,692,58,1467,3868
1750.665,17,12,498,11,14,175066,14,462,1,8,0,8,36
10.944,17,4,352,2,60,10943,60,176,2,60,10943,60,176
1.23,6,46,19084,27,888,47,1360,13548,19,476,59,2715,5536
1798.074,17,448,39896,403,35,4472,288,25676,45,288,40017,288,14220
1797.666,17,180,14040,180,50,10042,50,14040,0,0,0,0,0
1772.543,1,58,4872,0,0,0,0,0,58,56,31097,56,4872
274.536,1,2,112,2,28,274536,28,112,0,0,0,0,0
432.338,6,173,41221,83,548,3332,1288,24158,90,253,4856,1420,17063
1770.658,6,103,9519,67,65,26828,65,5641,36,59,50587,59,3878
32.603,6,9,372,7,0,5433,0,284,2,0,1310,0,88
30.026,6,121,49389,64,774,476,1360,36701,57,471,533,1360,12688
137.848,6,22,6083,13,185,11487,500,1450,9,711,14755,1420,4633
0.395,6,22,7333,13,334,32,663,2021,9,967,48,1471,5312
122.95,6,184,137799,110,1288,1127,1408,123027,74,727,1681,2816,14772
0.122,17,2,182,1,39,0,39,67,1,87,0,87,115
1746.143,6,99,7814,65,45,27283,205,4850,34,35,52902,98,2964
0.731,6,2,1175,1,0,0,0,40,1,1095,0,1095,1135
3.35,17,2,374,1,47,0,47,75,1,271,0,271,299
3.423,17,5,340,5,40,855,40,340,0,0,0,0,0
1786.658,6,102,8364,68,66,26666,66,4964,34,60,54137,60,3400
6.01,6,40,7309,20,218,316,314,3423,20,513,301,1179,3886
1785.743,6,107,8750,69,66,26260,66,5070,38,60,48260,60,3680
1787.782,1,163,9128,163,28,11035,28,9128,0,0,0,0,0
1797.601,1,342,28728,342,56,5271,56,28728,0,0,0,0,0
0.008,17,4,344,2,47,5,47,150,2,69,4,75,194
1778.803,17,140,11200,70,48,25779,48,5320,70,56,25779,56,5880
0.112,6,2,111,1,0,0,0,40,1,31,0,31,71
0.95,17,2,778,2,361,950,361,778,0,0,0,0,0
3.327,6,98,68058,55,1257,61,1368,59473,43,842,74,1368,8585
1777.953,17,140,11200,70,48,25767,48,5320,70,56,25767,56,5880
12.832,6,22,3634,15,210,916,210,1280,7,664,2138,904,2354
280.471,6,29,7392,13,158,23372,267,1317,16,775,18694,4836,6075
1786.921,6,102,8364,68,66,26670,66,4964,34,60,54145,60,3400
7.028,6,1065,967862,688,1362,10,1420,948467,377,475,18,1883,19395
504.249,2,5,160,5,8,126062,8,160,0,0,0,0,0
1.247,6,49,19457,27,906,47,1360,13801,22,476,51,2720,5656
0.064,6,9,1339,5,145,16,145,349,4,826,10,826,990
0.004,17,2,359,1,29,0,29,57,1,274,0,274,302
0.008,17,2,368,1,32,0,32,60,1,280,0,280,308
11.912,6,46,8881,22,227,567,314,4062,24,428,506,1179,4819
0.533,17,3,234,2,39,496,39,134,1,72,0,72,100
1.721,6,13,2311,8,188,245,245,700,5,1407,365,1407,1611
1799.918,17,354,77264,354,190,5098,422,77264,0,0,0,0,0
1.408,6,48,20959,28,948,52,1360,15383,20,476,64,2715,5576
0.01,17,2,263,1,36,0,36,64,1,171,0,171,199
1.019,6,26,5700,13,125,84,267,1275,13,780,77,1460,4425
1790.966,1,156,16536,156,78,11554,78,16536,0,0,0,0,0
28.29,6,46,8982,22,401,448,888,2175,24,364,1223,1360,6807
1786.656,6,102,8296,68,65,26666,65,4930,34,59,54137,59,3366
1.258,6,128,90383,60,131,21,232,2929,68,1344,18,1420,87454
11.067,6,18,4266,10,275,1229,275,958,8,992,882,1440,3308
20.432,6,19,2432,10,189,2270,517,1298,9,323,2534,499,1134
1.06,17,4,360,2,30,1014,30,116,2,94,1015,94,244
0.601,6,10,924,5,283,101,283,551,5,105,104,105,373
1788.768,6,271,35575,109,171,16561,1460,18788,162,128,11109,1642,16787
0.152,17,4,420,2,33,106,33,122,2,121,121,145,298
26.753,6,44,7863,27,168,1028,267,1752,17,387,1357,768,6111
1787.456,6,103,8336,68,65,26678,65,4930,35,59,52568,59,3406
300.869,2,4,128,4,8,100289,8,128,0,0,0,0,0
60.23,2,2,64,2,8,60230,8,64,0,0,0,0,0
0.008,6,6,374,2,31,5,31,135,4,31,1,31,239
1.344,6,10,1687,7,100,224,100,384,3,1179,542,1179,1303
1796.609,17,377,126640,377,307,4778,308,126640,0,0,0,0,0
8.276,6,20,8169,10,275,919,275,683,10,1414,844,1414,7486
66.022,6,20,9185,11,515,80,1240,2018,9,1359,8230,3639,7167
0.072,6,2,364,1,0,0,0,40,1,272,0,272,324
0.021,17,2,136,1,32,0,32,60,1,48,0,48,76
1771.443,1,190,10640,190,28,9372,28,10640,0,0,0,0,0
18.019,6,8,1607,5,100,4504,100,304,3,1179,8885,1179,1303
42.947,6,25,7097,12,155,3904,267,1266,13,589,3578,3426,5831
8.988,17,4,1824,2,308,8988,308,672,2,548,11,548,1152
1797.446,1,58,4872,58,56,31534,56,4872,0,0,0,0,0
0.045,17,4,352,2,37,6,37,130,2,83,41,89,222
1798.916,6,376,26617,217,104,8328,469,15772,159,69,11384,69,10845
1743.444,6,95,7203,63,38,28120,205,4476,32,33,56225,98,2727
0.147,6,2,133,1,0,0,0,40,1,53,0,53,93
15.817,6,11,2033,7,326,2636,589,1025,4,396,271,580,1008
1494.994,6,157,19346,106,84,14238,267,9511,51,165,21629,2009,9835
125.604,6,13,3383,5,92,31401,92,348,8,435,17910,2026,3035
280.423,6,29,7392,13,158,23368,267,1317,16,678,18691,2600,6075
12.22,17,20,1760,10,37,1357,37,650,10,83,1357,89,1110
1685.388,6,24,3973,16,262,112359,413,2740,8,114,240739,269,1233
733.228,17,333,25379,174,40,4238,41,11930,159,56,4640,57,13449
17.412,6,80,24744,41,547,435,1152,19171,39,400,447,1152,5573
597.992,2,5,160,5,8,149498,8,160,0,0,0,0,0
2.064,6,24,5755,13,158,170,370,1315,11,999,204,1691,4440
10.995,6,639,541234,379,1353,28,1368,521806,260,776,41,1473,19428
240.363,6,47,9094,24,524,10450,1418,5974,23,212,10925,617,3120
1771.09,6,101,9344,66,65,27247,65,5577,35,59,52087,59,3767
1680.697,17,13,534,11,14,168051,14,462,2,8,1680511,8,72
0.022,17,2,664,1,308,0,308,336,1,300,0,300,328
67.537,6,29,7257,13,155,5628,267,1306,16,441,4501,1420,5951
0.048,17,2,212,1,46,0,46,74,1,110,0,110,138
8.305,6,19,6360,5,96,2073,106,496,14,529,638,1420,5864
1764.1,2,12,384,12,8,160372,8,384,0,0,0,0,0
1743.062,6,95,7203,63,38,28113,205,4476,32,33,56218,98,2727
1792.136,17,180,14040,180,50,10011,50,14040,0,0,0,0,0
148.885,17,3,228,3,48,74442,48,228,0,0,0,0,0
691.143,6,29,1937,20,330,36375,330,1378,9,83,30008,83,559
1.382,6,50,18896,29,858,49,1360,13235,21,437,60,2715,5661
1.381,6,24,8004,11,164,118,267,1236,13,869,98,1368,6768
1800.0,6,233,16124,89,46,20225,46,6684,144,46,12587,46,9440
1740.65,17,30,31620,30,1026,60022,1026,31620,0,0,0,0,0
164.556,6,22,8319,11,525,114,1237,2048,11,969,16433,1791,6271
33.79,6,31,5094,15,154,2413,722,1859,16,342,2239,1408,3235
1772.364,6,180,15480,120,69,14893,69,8940,60,69,30032,69,6540
240.176,6,55,18344,30,759,8281,1408,15245,25,223,10007,580,3099
1797.172,17,144,11520,72,48,25312,48,5472,72,56,25312,56,6048
13.007,17,2,152,2,48,13007,48,152,0,0,0,0,0
1799.571,1,56,4704,56,56,32719,56,4704,0,0,0,0,0
5.038,17,4,288,2,36,5006,36,128,2,52,5006,52,160
1620.039,1,7,392,7,28,270006,28,392,0,0,0,0,0
0.008,17,2,346,1,61,0,61,89,1,229,0,229,257
8.165,6,21,2206,10,222,905,222,1296,11,231,814,231,910
0.173,17,2,2756,2,1350,173,1350,2756,0,0,0,0,0
2.278,6,14,2351,8,188,325,245,700,6,703,408,1152,1651
1.168,6,203,155297,119,1322,9,1432,147646,84,475,13,1871,7651
0.216,17,2,1918,2,931,216,931,1918,0,0,0,0,0
1773.758,6,180,15480,120,69,14905,69,8940,60,69,30059,69,6540
1795.872,6,367,25650,214,99,8431,469,15045,153,69,11811,69,10605
1785.814,6,379,24268,217,69,8267,69,13303,162,69,11091,69,10965
0.208,6,10,1184,5,145,52,145,349,5,631,38,631,835
280.239,6,29,7392,13,158,23353,267,1317,16,603,18677,2236,6075
13.509,17,34,9807,15,345,962,1350,5598,19,193,748,1350,4209
0.119,17,2,386,1,41,0,41,69,1,289,0,289,317
1780.758,6,117,13649,75,162,24064,1270,9003,42,78,43430,240,4646
0.091,6,9,1147,5,145,22,145,349,4,634,15,634,798
54.14,6,12,640,5,0,13535,0,268,7,0,8871,0,372
0.18,6,3,2615,2,1247,0,1360,2575,1,0,0,0,40
1792.373,6,427,25616,215,69,8375,69,12740,212,35,8494,64,12876
0.977,6,179,138028,107,1318,9,1432,130857,72,427,13,1432,7171
0.258,17,3,1170,3,362,129,362,1170,0,0,0,0,0
300.805,6,50,10526,25,433,12533,910,3258,25,312,524,1460,7268
0.421,6,25,8974,13,263,35,691,1736,12,1101,33,2896,7238
1.155,6,117,87685,50,131,23,232,2529,67,1352,15,1430,85156
471.432,6,21,1595,10,63,24045,63,715,11,44,47134,57,880
134.164,6,24,10054,12,532,54,1360,2642,12,1153,12185,2574,7412
1773.503,6,180,15480,120,69,14903,69,8940,60,69,30052,69,6540
1779.4,6,102,8296,68,65,26558,65,4930,34,59,53918,59,3366
0.031,6,12,3462,6,75,6,75,395,6,1373,6,1448,3067
0.024,6,10,1327,5,299,4,299,567,5,246,4,459,760
0.044,17,2,144,1,36,0,36,64,1,52,0,52,80
0.662,1,2,112,2,28,662,28,112,0,0,0,0,0
27.802,6,8,1411,6,304,5560,304,1212,2,83,424,83,199
280.53,6,30,7432,13,158,23377,267,1317,17,603,17526,2076,6115
368.44,6,23,1535,16,177,24562,177,1053,7,110,10374,110,482
1.407,6,51,21469,28,974,52,1460,15773,23,433,55,1460,5696
80.826,17,4,240,2,32,80825,32,120,2,32,80825,32,120
13.008,6,40,13578,20,402,684,722,3222,20,734,439,1380,10356
0.052,17,2,180,1,30,0,30,58,1,94,0,94,122
125.461,6,17,4021,9,407,15682,722,1278,8,387,17888,1408,2743
5.881,6,37,9311,19,259,326,464,1594,18,537,335,2128,7717
81.357,6,3631,3188148,2250,1331,36,1368,3103108,1381,776,58,1473,85040
415.056,17,14,4704,14,308,31927,308,4704,0,0,0,0,0
61.968,6,70,46987,43,1180,1475,1448,38854,27,746,2374,1448,8133
300.813,2,3,96,3,8,150406,8,96,0,0,0,0,0
155.513,17,4,352,2,60,155512,60,176,2,60,155512,60,176
0.035,6,2,80,2,0,0,0,80,0,0,0,0,0
1.309,6,50,21317,28,967,48,1460,15661,22,433,53,1460,5656
1787.67,17,87,3648,86,14,21031,14,3612,1,8,0,8,36
1.5,6,38,9848,20,502,78,1460,4352,18,433,74,1460,5496
1.943,6,32,8952,16,158,129,267,1437,16,763,128,2800,7515
5.02,17,4,288,2,36,4988,36,128,2,52,4988,52,160
0.451,17,2,558,1,32,0,32,60,1,470,0,470,498
0.128,17,2,184,1,32,0,32,60,1,96,0,96,124
53.525,6,27,7177,13,155,4460,267,1306,14,530,4116,3417,5871
1.178,6,24,8004,12,164,91,267,1288,12,1014,91,2816,6716
1785.129,6,102,8296,68,65,26643,65,4930,34,59,54092,59,3366
1771.698,6,99,9240,66,65,27256,65,5577,33,59,55362,59,3663
1.356,6,51,18983,29,861,48,1360,13282,22,437,56,2715,5701
0.005,17,2,350,1,37,0,37,65,1,257,0,257,285
0.013,17,2,550,2,247,13,247,550,0,0,0,0,0
0.253,17,2,198,1,39,0,39,67,1,103,0,103,131
1246.243,6,317,87464,148,500,8477,1360,65048,169,198,7417,1360,22416
0.593,6,28,9167,13,262,49,690,1735,15,830,39,1408,7432
11.043,6,18,4266,10,275,1227,275,958,8,992,892,1440,3308
0.55,6,23,7406,14,335,42,668,2090,9,806,63,1368,5316
0.078,6,10,1378,5,145,19,145,349,5,825,15,825,1029
1774.31,17,140,11200,70,48,25714,48,5320,70,56,25714,56,5880
1777.281,17,79,3312,78,14,23081,14,3276,1,8,0,8,36
1.149,6,22,7900,12,164,88,267,1288,10,1521,108,5227,6612
1786.369,6,104,8444,68,66,26662,66,4964,36,60,51036,60,3480
29.327,17,15,7805,8,655,4189,1350,5471,7,305,44,1350,2334
368.56,6,8,352,5,0,92140,0,208,3,0,1516,0,144
1770.518,6,99,9240,66,65,27238,65,5577,33,59,55326,59,3663
1.295,6,47,16834,27,840,49,1360,11213,20,437,59,2715,5621
38.846,17,7,532,7,48,6474,48,532,0,0,0,0,0
1749.349,6,111,8043,69,31,25725,31,4714,42,31,42663,31,3329
0.282,6,20,7238,12,335,25,668,1974,8,1210,39,1906,5264
1.534,6,47,19293,27,898,59,1360,13717,20,476,70,2715,5576
1649.112,1,48,2688,48,28,35087,28,2688,0,0,0,0,0
7.244,6,1588,1453361,995,1382,7,1408,1417861,593,931,11,2816,35500
182.27,6,16,1249,9,330,22783,330,794,7,83,30087,83,455
5.074,17,4,304,4,48,1691,48,304,0,0,0,0,0
240.216,6,55,19373,30,833,8283,1408,16572,25,186,10008,580,2801
1781.079,6,102,8296,68,65,26583,65,4930,34,59,53969,59,3366
0.338,6,21,5000,10,137,37,267,1092,11,692,29,1467,3908
1795.943,17,447,39864,402,35,4478,288,25644,45,288,40022,288,14220
281.381,6,30,7773,13,158,23448,267,1317,17,577,17575,1400,6456
1705.71,1,84,8904,84,78,20550,78,8904,0,0,0,0,0
1788.938,17,142,11360,71,48,25556,48,5396,71,56,25556,56,5964
1777.561,1,208,11648,208,28,8587,28,11648,0,0,0,0,0
54.076,6,29,7257,14,155,4159,267,1346,15,482,3861,2840,5911
62.57,6,42,10921,18,350,3680,1189,4229,24,440,2719,1420,6692
2.017,17,4,950,2,40,2004,40,136,2,379,2006,379,814
1.762,17,20,5190,20,231,92,389,5190,0,0,0,0,0
3.817,6,32,6105,17,206,238,314,2744,15,551,254,1179,3361
0.588,6,23,6398,13,310,48,892,2078,10,979,64,1731,4320
170.097,6,23,9178,12,304,77,597,1437,11,1041,16991,1721,7741
0.336,6,14,4329,7,127,53,127,499,7,864,37,1448,3830
1787.473,17,87,3648,86,14,21029,14,3612,1,8,0,8,36
280.248,6,27,7312,12,158,25477,267,1277,15,678,20011,2045,6035
66.038,17,4,558,2,36,66034,36,128,2,187,66034,187,430
1786.723,6,356,22520,208,69,8631,69,12460,148,69,12154,69,10060
5.986,6,45,8425,23,227,272,314,4102,22,429,272,1152,4323
261.395,17,4,352,2,60,261394,60,176,2,60,261393,60,176
0.193,17,3,234,2,39,166,39,134,1,72,0,72,100
20.021,17,3,192,3,36,10010,36,192,0,0,0,0,0
0.007,17,4,420,2,33,0,33,122,2,121,1,145,298
128.98,6,21,6771,6,138,25796,267,803,15,487,9184,1420,5968
5.797,17,32,9401,13,307,483,1350,4362,19,237,187,1350,5039
165.789,6,23,940,9,0,5601,0,364,14,0,12752,0,576
0.163,17,2,152,1,48,0,48,76,1,48,0,48,76
1762.308,2,12,384,12,8,160209,8,384,0,0,0,0,0
0.254,17,2,384,1,39,0,39,67,1,289,0,289,317
65.008,6,21,6434,6,154,12998,267,712,15,464,4642,1452,5722
172.884,6,22,8212,11,511,95,1194,2005,11,1151,17270,3151,6207
1.488,17,2,628,2,286,1488,286,628,0,0,0,0,0
0.061,17,2,251,1,36,0,36,64,1,159,0,159,187
1.388,6,31,12883,16,529,92,1460,3330,15,812,86,1460,9553
1784.714,1,168,9408,168,28,10686,28,9408,0,0,0,0,0
2.002,17,4,314,2,31,1956,31,118,2,70,1969,70,196
10.411,17,26,7296,12,341,943,1350,4435,14,176,798,1350,2861
295.258,17,4,352,2,60,295257,60,176,2,60,295257,60,176
70.89,6,31,6660,17,186,4430,501,1615,14,448,5446,1420,5045
1786.659,6,359,22709,209,69,8589,69,12569,150,69,11990,69,10140
185.989,6,38,10958,21,397,9291,1133,3883,17,563,11614,2816,7075
16.038,17,21,14513,12,999,1454,1350,12325,9,215,2000,1350,2188
1798.01,17,142,11360,71,48,25685,48,5396,71,56,25685,56,5964
0.454,6,10,968,5,256,111,256,460,5,304,111,304,508
240.159,6,47,10177,23,209,10916,835,2693,24,566,10441,2816,7484
0.005,17,2,408,1,39,0,39,67,1,313,0,313,341
0.071,17,4,350,2,34,0,34,124,2,85,12,91,226
150.609,6,24,6217,10,272,89,516,1220,14,403,11578,1452,4997
0.022,17,2,384,1,32,0,32,60,1,296,0,296,324
8.046,6,1530,1403811,937,1418,8,1448,1368299,593,776,13,1448,35512
84.187,6,31,14502,15,894,83,1360,5997,16,872,5600,2720,8505
1786.442,17,87,3648,86,14,21016,14,3612,1,8,0,8,36
3.998,17,4,352,2,48,3987,48,152,2,72,3985,72,200
176.173,6,225,170446,137,1284,1295,1408,154835,88,680,1555,3847,15611
16.114,6,19,6522,6,140,3222,267,809,13,576,1340,1420,5713
2.006,17,43,35833,18,407,118,1350,7838,25,1091,79,1350,27995
1772.476,6,180,15480,120,69,14894,69,8940,60,69,30036,69,6540
1789.201,17,142,11360,71,48,25559,48,5396,71,56,25559,56,5964
39.827,6,6,1255,4,327,13275,413,814,2,180,39634,269,441
0.055,17,4,288,2,36,32,36,128,2,52,35,52,160
16.861,17,2,672,2,308,16861,308,672,0,0,0,0,0
0.024,17,2,588,1,45,0,45,73,1,487,0,487,515
230.02,17,4,352,2,48,230010,48,152,2,72,230010,72,200
4.426,6,37,7189,19,218,245,314,3383,18,513,244,1179,3806
0.772,6,17,5132,9,150,96,174,664,8,828,96,1420,4468
0.001,6,2,100,1,0,0,0,60,1,0,0,0,40
1.908,17,3,1176,3,364,954,364,1176,0,0,0,0,0
0.118,17,2,158,1,34,0,34,62,1,68,0,68,96
0.424,17,3,1164,3,360,212,360,1164,0,0,0,0,0
0.067,17,2,2384,2,1164,67,1164,2384,0,0,0,0,0
1798.074,17,142,11360,71,48,25686,48,5396,71,56,25686,56,5964
2.418,17,3,208,2,36,2328,36,128,1,52,0,52,80
743.006,6,154,9748,88,69,8540,69,5383,66,69,11430,69,4365
9.063,6,42,8289,21,227,453,314,4022,21,489,431,1179,4267
168.162,17,4,352,2,60,168161,60,176,2,60,168160,60,176
1.179,6,25,8056,12,164,90,267,1288,13,869,83,1448,6768
10.013,17,4,390,2,44,9981,44,144,2,95,9975,95,246
13.707,6,28,4917,13,154,1124,722,1767,15,338,966,1448,3150
746.272,1,30,1680,30,28,25733,28,1680,0,0,0,0,0
211.023,1,6,636,6,78,42204,78,636,0,0,0,0,0
140.346,6,26,6454,10,220,6243,516,1286,16,348,9349,1452,5168
1776.593,17,227,54285,227,211,7861,356,54285,0,0,0,0,0
366.969,6,18,1242,14,180,28228,180,916,4,110,20057,110,326
1772.294,6,180,15480,120,69,14893,69,8940,60,69,30037,69,6540
1798.711,17,142,11360,71,48,25695,48,5396,71,56,25695,56,5964
0.869,6,23,6168,13,264,70,662,1848,10,979,94,1691,4320
1751.758,17,155,15566,155,72,11375,346,15566,0,0,0,0,0
117.246,6,22,900,9,0,6119,0,364,13,0,9769,0,536
0.099,6,9,1147,5,145,24,145,349,4,634,25,634,798
1.496,2,3,128,3,18,748,24,128,0,0,0,0,0
0.082,17,4,284,2,32,0,32,120,2,54,0,60,164
1794.415,17,144,11520,72,48,25273,48,5472,72,56,25273,56,6048
0.034,17,3,993,3,303,17,332,993,0,0,0,0,0
1753.565,6,97,7338,64,38,27834,205,4528,33,33,54788,98,2810
4.092,6,22,6449,10,275,445,517,1353,12,744,363,1368,5096
240.613,6,48,7749,21,355,12028,1056,4671,27,181,9252,580,3078
1769.503,6,99,9240,66,65,27223,65,5577,33,59,55294,59,3663
1669.338,1,118,6608,118,28,14267,28,6608,0,0,0,0,0
846.939,2,8,256,8,8,120991,8,256,0,0,0,0,0
1788.655,1,207,21942,207,78,8682,78,21942,0,0,0,0,0
0.084,6,2,88,1,0,0,0,44,1,0,0,0,44
220.696,17,4,240,2,32,220695,32,120,2,32,220695,32,120
1.114,6,30,12757,16,524,74,1460,3306,14,807,71,1460,9451
0.922,6,11,1727,7,100,153,100,384,4,589,220,1152,1343
551.709,1,8,1062,8,104,78815,173,1062,0,0,0,0,0
1790.793,6,479,27519,269,69,6682,69,14969,210,34,8568,64,12550
0.386,6,29,7088,17,244,24,656,2394,12,601,34,1420,4694
240.205,6,54,18354,29,814,8578,1408,15355,25,211,10008,580,2999
11.886,6,1873,1641983,1137,1390,10,1420,1608322,736,467,16,1883,33661
3.096,6,4,160,3,0,1463,0,120,1,0,0,0,40
1415.7,17,12,3294,6,30,283137,30,348,6,463,283138,463,2946
1740.443,17,29,19517,29,645,62158,645,19517,0,0,0,0,0
0.683,6,18,4942,11,193,67,358,1218,7,860,112,1420,3724
289.07,1,4,224,4,28,96356,28,224,0,0,0,0,0
0.101,17,4,284,2,32,89,32,120,2,54,14,60,164
30.817,6,59,20901,27,962,1185,1440,14605,32,381,981,1440,6296
0.365,17,8,2766,8,317,52,356,2766,0,0,0,0,0
1700.623,17,12,498,11,14,170062,14,462,1,8,0,8,36
335.024,6,86,18059,41,779,8375,1418,12380,45,110,7613,580,5679
0.065,6,2,80,1,0,0,0,40,1,0,0,0,40
1798.986,17,448,39896,403,35,4475,288,25676,45,288,40017,288,14220
0.015,17,2,306,1,33,0,33,61,1,217,0,217,245
251.779,17,4,240,2,32,251778,32,120,2,32,251778,32,120
144.713,17,4,240,2,32,144712,32,120,2,32,144712,32,120
1790.986,6,324,21447,191,69,9426,69,11849,133,69,13567,69,9598
53.421,6,14,580,8,0,7631,0,324,6,0,4840,0,256
47.544,6,27,7177,13,155,3962,267,1306,14,530,3656,3417,5871
1260.5,2,13,416,13,8,105041,8,416,0,0,0,0,0
1.289,6,31,6467,14,164,99,267,1882,17,650,70,1452,4585
1787.313,17,89,3737,87,14,20782,15,3655,2,13,601042,18,82
0.413,6,12,1653,6,288,78,288,548,6,426,49,434,1105
26.624,6,46,13747,22,299,1267,721,3280,24,678,1137,1440,10467
1770.791,6,139,18185,84,166,21334,817,11522,55,92,32790,350,6663
2.534,6,14,2351,8,188,362,245,700,6,703,453,1152,1651
10.767,6,18,5610,10,275,1196,275,958,8,1440,779,1440,4652
1786.239,17,87,3648,86,14,21014,14,3612,1,8,0,8,36
0.022,6,4,208,2,0,22,0,104,2,0,0,0,104
0.021,17,2,150,1,47,0,47,75,1,47,0,47,75
1790.271,1,335,28140,335,56,5360,56,28140,0,0,0,0,0
0.255,6,9,1002,5,213,63,213,417,4,421,70,421,585
0.111,17,2,390,1,46,0,46,74,1,288,0,288,316
109.436,6,25,10240,14,549,125,1360,2809,11,1393,10929,3934,7431
0.011,6,2,149,1,69,0,69,109,1,0,0,0,40
1772.271,6,180,15480,120,69,14893,69,8940,60,69,30034,69,6540
363.225,6,19,1306,14,180,27940,180,928,5,110,15173,110,378
0.499,17,3,451,2,39,323,39,134,1,289,0,289,317
0.068,17,2,440,1,45,0,45,73,1,339,0,339,367
1681.402,17,14,3843,7,30,280231,30,406,7,463,280231,463,3437
1795.096,17,449,39928,404,35,4454,288,25708,45,288,40016,288,14220
280.495,6,31,7472,13,158,23374,267,1317,18,603,16495,2076,6155
1785.169,6,102,8296,68,65,26644,65,4930,34,59,54092,59,3366
20.603,6,21,3561,11,211,2057,211,1050,10,665,2288,904,2511
1.739,17,2,144,1,36,0,36,64,1,52,0,52,80
1772.313,6,180,15480,120,69,14893,69,8940,60,69,30030,69,6540
1792.0,6,366,23403,209,69,8615,69,12638,157,69,11487,69,10765
1791.398,17,44,14784,44,308,41660,308,14784,0,0,0,0,0
0.819,17,2,178,1,29,0,29,57,1,93,0,93,121
25.034,6,24,4536,11,517,2502,517,1121,13,1341,2085,1418,3415
32.32,6,4412,4146219,2876,1363,11,1408,4061683,1536,776,20,1408,84536
751.616,6,151,9559,88,69,8639,69,5245,63,69,12121,69,4314
15.357,17,28,14040,14,763,1178,1350,11081,14,183,1177,1350,2959
0.54,6,10,924,5,283,90,283,551,5,105,92,105,373
6.918,6,747,673064,473,1353,14,1368,653776,274,776,24,2736,19288
0.223,6,9,1002,5,213,55,213,417,4,421,63,421,585
4.973,6,38,7245,20,218,261,314,3423,18,516,276,1179,3822
1794.176,17,144,11520,72,48,25270,48,5472,72,56,25270,56,6048
1769.829,6,99,9240,66,65,27228,65,5577,33,59,55304,59,3663
0.082,6,3,246,2,63,5,63,206,1,0,0,0,40
1794.279,17,281,57460,281,176,6408,422,57460,0,0,0,0,0
172.613,6,31,5450,11,189,10994,516,1392,20,232,9079,1452,4058
1792.343,17,180,14040,180,50,10013,50,14040,0,0,0,0,0
1770.844,6,101,9410,66,66,27243,66,5610,35,60,52080,60,3800
240.217,6,54,18333,29,769,8578,1402,15361,25,208,10008,580,2972
77.355,6,11,735,5,275,706,275,483,6,0,15392,0,252
1738.932,6,87,6322,58,31,30507,31,3915,29,31,62104,31,2407
12.13,6,1748,1639433,1158,1366,10,1432,1611437,590,389,20,1432,27996
0.733,17,4,820,2,36,723,36,128,2,318,714,318,692
1787.472,6,102,8296,68,65,26678,65,4930,34,59,54161,59,3366
1783.225,6,369,25799,213,99,8411,469,15005,156,69,11504,69,10794
1.338,6,39,8294,19,321,74,1164,2718,20,433,59,1460,5576
1.057,6,5,315,1,31,0,31,83,4,0,352,0,232
1740.615,17,30,7050,30,207,60021,207,7050,0,0,0,0,0
1751.475,6,95,7203,63,38,28249,205,4476,32,33,56490,98,2727
1.311,6,45,19193,26,898,52,1360,13657,19,433,63,1360,5536
4.981,17,4,288,2,36,4963,36,128,2,52,4962,52,160
1679.036,1,8,448,8,28,239862,28,448,0,0,0,0,0
18.46,6,10,808,3,106,9230,106,234,7,90,3061,90,574
1681.376,1,15,840,15,28,120098,28,840,0,0,0,0,0
21.839,17,4,240,2,32,21838,32,120,2,32,21838,32,120
56.339,6,2891,2681003,1866,1354,30,1368,2613475,1025,776,54,2736,67528
12.938,6,1052,904110,650,1315,19,1368,878542,402,776,31,1473,25568
1797.946,1,345,28980,345,56,5226,56,28980,0,0,0,0,0
1797.972,17,88,29568,88,308,20666,308,29568,0,0,0,0,0
35.645,1,41,4264,0,0,0,0,0,41,76,891,76,4264
69.523,6,26,7206,12,155,6320,267,1266,14,537,5347,3426,5940
1793.21,17,179,11456,179,36,10074,36,11456,0,0,0,0,0
4.264,17,5,295,5,31,1066,31,295,0,0,0,0,0
10.773,6,20,4402,11,275,1077,275,998,9,758,763,1420,3404
1771.563,6,101,9410,66,66,27254,66,5610,35,60,52102,60,3800
1.293,6,212,166382,128,1324,10,1420,158731,84,475,15,1883,7651
50.418,1,7,2669,7,353,8403,369,2669,0,0,0,0,0
7.916,17,6,528,3,48,3951,48,228,3,72,3950,72,300
11.685,6,1879,1616431,1123,1384,10,1420,1581958,756,467,15,1883,34473
82.685,6,35,7842,13,155,6890,267,1306,22,332,3936,1420,6536
1782.16,6,103,8464,68,66,26599,66,4964,35,60,52413,60,3500
5.571,6,39,7269,21,218,278,314,3463,18,513,311,1179,3806
0.09,1,2,112,2,28,90,28,112,0,0,0,0,0
1196.359,6,17,1052,10,31,132928,31,555,7,31,199390,31,497
375.226,17,76,5776,76,48,5003,48,5776,0,0,0,0,0
240.253,6,56,19445,28,724,8898,1418,13794,28,463,8897,1501,5651
1736.644,17,112,21157,112,160,15645,422,21157,0,0,0,0,0
1744.96,6,99,7411,63,38,28144,205,4476,36,33,49848,98,2935
1.41,6,50,21298,28,966,52,1460,15642,22,433,58,1460,5656
1.934,6,24,6045,13,108,161,147,959,11,927,154,1608,5086
1773.07,6,181,15589,120,69,14899,69,8940,61,69,29543,69,6649
1.262,6,30,6303,17,138,78,267,1795,13,569,98,1414,4508
1793.806,17,66,2766,65,14,28028,14,2730,1,8,0,8,36
1774.581,6,180,15480,120,69,14912,69,8940,60,69,30076,69,6540
1786.152,17,142,11360,71,48,25516,48,5396,71,56,25516,56,5964
1770.907,6,106,9685,69,63,26042,63,5754,37,57,49189,57,3931
1787.943,6,3772,3695008,1235,129,1448,354,71619,2537,1417,705,2836,3623389
1799.751,6,356,22520,208,69,8694,69,12460,148,69,12242,69,10060
31.538,6,7,308,1,0,0,0,44,6,0,6289,0,264
87.588,6,45,8887,22,305,542,780,2169,23,413,3975,1360,6718
1.55,6,10,1687,7,100,258,100,384,3,1179,546,1179,1303
1.226,6,45,19085,26,891,49,1360,13549,19,476,58,2720,5536
635.801,1,8,721,8,62,90828,88,721,0,0,0,0,0
34.286,17,9,684,9,48,4285,48,684,0,0,0,0,0
0.119,6,12,3704,6,171,23,171,491,6,964,20,1448,3213
0.471,6,9,527,5,43,117,43,311,4,0,149,0,216
35.88,6,2,868,2,382,35880,382,868,0,0,0,0,0
240.333,6,45,8981,24,524,10448,1418,5973,21,212,12015,618,3008
0.501,17,2,476,1,39,0,39,67,1,381,0,381,409
0.0,6,2,92,1,0,0,0,52,1,0,0,0,40
172.157,6,30,8872,13,158,14346,267,1317,17,687,10753,1400,7555
1787.094,6,102,8296,68,65,26673,65,4930,34,59,54150,59,3366
70.139,6,12,1170,4,92,23374,138,436,8,69,10016,69,734
13.816,6,30,5070,14,154,1045,722,1820,16,301,908,1402,3250
1741.232,6,87,6322,58,31,30547,31,3915,29,31,62186,31,2407
317.011,6,74,18901,38,325,8567,1460,9696,36,323,9052,1460,9205
1.471,6,31,6467,15,164,105,267,1922,16,650,90,1380,4545
0.067,17,2,142,1,35,0,35,63,1,51,0,51,79
8.027,6,26,6723,10,138,891,267,971,16,566,533,1420,5752
1785.066,6,102,8296,68,65,26642,65,4930,34,59,54090,59,3366
0.186,17,2,180,1,30,0,30,58,1,94,0,94,122
280.299,6,28,7352,13,158,23358,267,1317,15,678,20011,2800,6035
0.374,6,27,8920,13,227,31,547,1592,14,941,28,1408,7328
5.906,6,12,2271,7,188,984,245,660,5,703,1412,1152,1611
74.017,6,51,35390,30,1287,33,1460,28289,21,694,3692,1460,7101
8.457,6,79,25282,41,579,211,1152,19621,38,459,221,1179,5661
80.945,17,4,352,2,60,80944,60,176,2,60,80944,60,176
0.773,6,21,7958,14,402,59,668,2746,7,1210,123,1946,5212
53.969,6,40,8775,17,401,2122,889,1916,23,348,2446,3488,6859
17.606,17,51,37230,20,507,925,1350,10705,31,827,585,1350,26525
1.253,6,3,1574,2,0,36,0,104,1,1418,0,1418,1470
240.288,6,43,8925,22,519,11442,1402,5827,21,249,12014,619,3098
0.053,17,2,464,1,43,0,43,71,1,365,0,365,393
7.93,6,10,808,3,106,3965,106,234,7,90,1283,90,574
1785.535,1,209,11704,209,28,8584,28,11704,0,0,0,0,0
1782.503,1,100,5600,100,28,18005,28,5600,0,0,0,0,0
133.827,6,24,11649,13,712,97,1307,3402,11,1113,13363,2279,8247
1.375,17,22,12827,10,566,149,1350,5942,12,545,122,1350,6885
1776.751,6,102,8364,68,66,26518,66,4964,34,60,53837,60,3400
0.035,6,2,421,1,0,0,0,40,1,341,0,341,381
1770.945,6,102,9462,66,66,27245,66,5610,36,60,50595,60,3852
52.07,6,37,8495,18,410,518,882,1982,19,478,2882,2720,6513
357.657,6,46,10841,29,320,12773,1360,5359,17,435,538,2667,5482
1773.072,6,181,15589,120,69,14899,69,8940,61,69,29546,69,6649
8.237,17,6,528,3,48,4112,48,228,3,72,4112,72,300
0.133,6,10,690,6,71,26,71,391,4,83,31,83,299
0.306,17,2,157,1,31,0,31,59,1,70,0,70,98
0.208,17,4,825,2,37,204,37,130,2,319,203,331,695
4.965,17,3,2037,3,651,2482,651,2037,0,0,0,0,0
204.298,17,4,240,2,32,204297,32,120,2,32,204297,32,120
1770.168,6,449,60697,197,206,9030,1460,42502,252,90,7052,1062,18195
4.829,6,39,7269,19,218,268,314,3383,20,513,237,1179,3886
0.34,17,8,2758,8,316,48,355,2758,0,0,0,0,0
1775.759,6,180,15480,120,69,14922,69,8940,60,69,30094,69,6540
211.214,6,238,185014,145,1291,1466,1368,170220,93,679,1402,2519,14794
0.114,6,36,21312,18,132,6,132,1076,18,1286,6,1448,20236
11.741,6,1879,1617251,1141,1363,10,1380,1583501,738,421,15,1923,33750
11.32,6,1804,1564504,1087,1385,10,1420,1531603,717,467,15,1883,32901
0.412,6,10,887,5,248,100,248,452,5,231,100,231,435
0.007,17,2,122,1,33,0,33,61,1,33,0,33,61
20.203,6,17,2316,10,189,2244,517,1298,7,323,3364,499,1018
0.611,17,4,314,2,31,581,31,118,2,70,585,70,196
564.836,2,7,224,7,8,94139,8,224,0,0,0,0,0
1785.97,6,356,22520,208,69,8627,69,12460,148,69,12148,69,10060
1796.178,17,449,39928,404,35,4457,288,25708,45,288,40015,288,14220
3.316,17,5,340,5,40,829,40,340,0,0,0,0,0
0.395,17,2,266,1,41,0,41,69,1,169,0,169,197
253.242,6,41,10531,16,374,636,846,2710,25,383,10551,1438,7821
0.864,6,12,1767,8,100,123,100,424,4,589,205,1152,1343
1.999,17,8,1360,4,33,661,33,244,4,251,663,323,1116
9.899,6,1787,1653627,1101,1423,8,1448,1613009,686,702,14,1448,40618
657.482,2,8,256,8,8,93926,8,256,0,0,0,0,0
2.921,17,23,7493,10,389,324,1350,4179,13,226,231,1350,3314
16.919,17,24,8754,24,336,735,359,8754,0,0,0,0,0
267.408,17,4,352,2,60,267407,60,176,2,60,267407,60,176
0.667,6,88,77157,56,266,12,517,4334,32,2635,21,8448,72823
307.137,6,161,133423,109,1281,2843,1408,119804,52,779,2500,4224,13619
0.04,6,2,499,1,0,0,0,40,1,419,0,419,459
1756.241,6,105,6240,60,26,29765,26,3510,45,26,39913,26,2730
12.794,6,31,8415,15,225,906,561,2005,16,820,841,1440,6410
0.0,17,1,68,1,40,0,40,68,0,0,0,0,0
64.671,6,17,692,8,0,7841,0,324,9,0,8082,0,368
0.043,17,4,352,2,37,34,37,130,2,83,34,89,222
4.173,6,34,6169,19,206,231,314,2824,15,548,278,1179,3345
61.336,6,42,22259,26,951,2453,1408,14683,16,842,4072,2439,7576
0.511,17,3,451,2,39,487,39,134,1,289,0,289,317
0.098,17,2,152,1,48,0,48,76,1,48,0,48,76
1.825,6,9,1346,5,145,456,145,349,4,833,379,833,997
1778.849,6,427,36780,206,73,8676,1305,14573,221,89,8085,1360,22207
1784.432,6,370,23080,208,69,8620,69,12460,162,55,11083,69,10620
2.029,17,4,678,3,32,507,32,180,1,470,0,470,498
0.007,17,2,348,1,62,0,62,90,1,230,0,230,258
10.597,6,1814,1680985,1184,1346,8,1368,1643561,630,931,16,2736,37424
0.014,17,2,466,1,34,0,34,62,1,376,0,376,404
240.343,1,2,112,2,28,240343,28,112,0,0,0,0,0
0.52,17,6,1392,3,64,257,64,276,3,344,257,344,1116
1792.738,6,356,22520,208,69,8660,69,12460,148,69,12195,69,10060
1690.218,6,149,89542,49,241,27289,241,2634,100,846,17072,1621,86908
15.633,6,6,340,1,0,0,0,60,5,0,3865,0,280
1797.117,17,144,11520,72,48,25311,48,5472,72,56,25311,56,6048
0.899,17,2,776,2,360,899,360,776,0,0,0,0,0
0.702,6,27,7296,13,155,58,267,1301,14,603,47,2036,5995
0.337,17,2,204,1,34,0,34,62,1,114,0,114,142
1623.992,1,8,448,8,28,231998,28,448,0,0,0,0,0
1.736,6,50,19406,27,899,66,1460,13710,23,433,67,1460,5696
4.638,6,38,7229,20,218,244,314,3423,18,513,256,1179,3806
125.772,2,2,64,2,8,125772,8,64,0,0,0,0,0
1680.125,17,12,498,11,14,168012,14,462,1,8,0,8,36
11.265,6,1762,1567986,1102,1368,10,1380,1534516,660,421,17,1923,33470
0.191,6,2,142,1,62,0,62,102,1,0,0,0,40
13.945,6,44,10310,21,619,697,1460,3398,23,460,581,1460,6912
488.732,6,25,1889,19,31,27151,31,1391,6,31,60504,31,498
0.044,17,4,368,2,32,14,32,120,2,96,1,96,248
0.688,6,22,5040,12,137,62,267,1172,10,692,65,1467,3868
0.186,6,24,7176,12,155,16,267,1261,12,775,14,3445,5915
1.578,6,50,19373,27,897,60,1360,13677,23,433,62,1360,5696
0.368,6,6,324,4,0,122,0,216,2,0,190,0,108
5.593,6,44,8369,21,227,279,314,4022,23,489,241,1179,4347
0.032,6,10,1512,5,503,8,503,771,5,473,8,473,741
300.678,6,34,8288,19,286,16704,797,1936,15,574,605,4848,6352
1740.982,6,90,6521,59,31,30016,31,3998,31,31,58031,31,2523
541.431,2,7,224,7,8,90238,8,224,0,0,0,0,0
20.022,17,29,24017,14,844,1537,1350,12211,15,759,1427,1350,11806
108.228,6,23,1403,12,69,9837,69,756,11,69,10822,69,647
1796.706,6,356,22520,208,69,8679,69,12460,148,69,12222,69,10060
63.483,6,43,8833,20,371,795,766,2005,23,368,2879,2720,6828
280.466,6,30,7432,14,158,21574,267,1357,16,678,18694,3456,6075
0.076,6,6,718,3,304,29,304,460,3,102,24,102,258
269.818,17,4,240,2,32,269817,32,120,2,32,269817,32,120
233.713,17,4,352,2,60,233712,60,176,2,60,233712,60,176
1.517,6,52,17994,26,830,60,1380,12685,26,467,59,1923,5309
1785.189,17,87,3648,86,14,21002,14,3612,1,8,0,8,36
0.416,6,10,968,5,256,101,256,460,5,304,101,304,508
1784.851,6,360,22818,209,69,8581,69,12569,151,69,11898,69,10249
1781.762,6,331,21106,193,69,9280,69,11653,138,69,13005,69,9453
0.107,6,10,1495,5,507,26,507,727,5,556,26,556,768
0.571,6,27,9145,13,273,47,733,1778,14,945,40,1368,7367
0.529,17,2,384,1,39,0,39,67,1,289,0,289,317
48.506,6,15,5673,4,106,16164,106,274,11,706,4849,1452,5399
2.463,17,31,15631,15,764,175,1350,11888,16,205,114,1350,3743
0.991,17,2,685,1,308,0,308,336,1,321,0,321,349
86.728,17,22,1672,22,48,4129,48,1672,0,0,0,0,0
1778.467,17,140,11200,70,48,25774,48,5320,70,56,25774,56,5880
379.797,6,18,1242,14,180,29215,180,916,4,110,20061,110,326
1786.408,6,363,24814,212,94,8466,469,14427,151,69,11906,69,10387
280.287,6,29,7392,13,158,23357,267,1317,16,603,18683,1400,6075
1744.647,2,15,480,15,8,124617,8,480,0,0,0,0,0
2.445,17,4,1564,4,363,815,363,1564,0,0,0,0,0
75.626,6,30,7573,12,155,6875,267,1266,18,429,4448,3426,6307
1769.999,6,99,9240,66,65,27230,65,5577,33,59,55309,59,3663
1.302,6,49,19597,27,914,50,1360,13941,22,433,53,1360,5656
38.861,17,22,1936,11,48,3885,48,836,11,72,3885,72,1100
38.391,17,22,1936,11,48,3831,48,836,11,72,3835,72,1100
0.014,17,2,393,1,33,0,33,61,1,304,0,304,332
159.323,17,4,240,2,32,159322,32,120,2,32,159321,32,120
294.777,1,4,326,4,53,98259,78,326,0,0,0,0,0
1799.997,6,175,17773,91,79,19999,721,7684,84,137,21681,1420,10089
1.082,17,4,1220,2,64,990,64,184,2,490,0,504,1036
2.083,1,2,56,2,0,0,0,56,0,0,0,0,0
0.012,17,2,348,1,39,0,39,67,1,253,0,253,281
238.124,6,31,8238,12,169,12338,516,1498,19,426,13223,1452,6740
1794.94,6,365,23087,211,69,8547,69,12787,154,69,11731,69,10300
0.171,17,2,2380,2,1162,171,1162,2380,0,0,0,0,0
1749.596,6,97,7307,63,38,28219,205,4476,34,33,53012,98,2831
1792.003,6,381,24210,215,69,8373,69,13361,166,69,10860,69,10849
1681.536,17,16,1265,8,30,240217,37,471,8,71,240217,136,794
3.04,17,2,116,2,30,3040,30,116,0,0,0,0,0
1.772,6,11,1727,7,100,295,100,384,4,1179,500,1179,1343
1782.92,6,356,22520,208,69,8613,69,12460,148,69,12128,69,10060
1.038,17,4,482,3,32,512,32,180,1,274,0,274,302
54.4,6,36,8360,18,378,510,786,1886,18,478,3191,2720,6474
290.32,6,241,37658,132,304,2216,304,26276,109,83,2682,83,11382
1786.38,6,150,19350,90,302,20071,302,13740,60,83,30277,83,5610
194.558,6,28,9560,11,154,19455,267,920,17,793,12094,1420,8640
5.044,17,4,288,2,36,5042,36,128,2,52,5029,52,160
8.625,6,79,24717,40,561,221,1152,19016,39,413,219,1152,5701
1.35,6,37,9808,20,502,71,1460,4352,17,476,73,2615,5456
1.211,6,24,6040,13,108,100,147,959,11,772,104,1608,5081
72.302,6,30,7432,13,158,6025,267,1317,17,543,4516,1400,6115
0.106,17,2,157,1,31,0,31,59,1,70,0,70,98
0.032,6,11,911,6,181,6,181,489,5,77,4,133,422
0.619,6,20,7238,13,335,51,668,2026,7,1210,96,1946,5212
1.911,17,2,672,2,308,1911,308,672,0,0,0,0,0
1.425,6,11,1727,7,100,237,100,384,4,589,392,1152,1343
1799.457,6,304,34884,148,145,12239,721,21638,156,142,11608,2840,13246
257.524,6,20,6866,8,154,36789,267,792,12,698,23403,1942,6074
1795.212,1,99,10494,99,78,18318,78,10494,0,0,0,0,0
100.47,6,947,462644,509,840,197,1152,439992,438,427,229,1179,22652
0.118,17,2,198,1,37,0,37,65,1,105,0,105,133
0.111,17,2,136,1,32,0,32,60,1,48,0,48,76
10.599,6,23,5272,12,351,963,1382,2242,11,431,1054,1460,3030
1795.271,17,448,39896,403,35,4465,288,25676,45,288,40018,288,14220
1795.491,17,448,39896,403,35,4466,288,25676,45,288,40020,288,14220
0.334,6,28,7482,17,306,20,1089,2828,11,701,32,1788,4654
1720.338,17,12,498,11,14,172033,14,462,1,8,0,8,36
3.35,17,8,736,4,64,1116,64,368,4,64,1116,64,368
33.744,6,31,5094,15,154,2410,721,1858,16,342,2236,1368,3236
0.869,6,11,1727,7,100,144,100,384,4,589,206,1152,1343
1773.774,6,180,15480,120,69,14905,69,8940,60,69,30053,69,6540
0.147,17,2,602,1,46,0,46,74,1,500,0,500,528
1.392,6,45,18700,26,930,55,1460,13164,19,476,66,2615,5536
0.015,17,2,362,1,32,0,32,60,1,274,0,274,302
1787.106,17,86,3612,86,14,21024,14,3612,0,0,0,0,0
10.91,6,18,4226,10,275,1212,275,958,8,978,878,1420,3268
0.002,6,2,103,1,0,0,0,40,1,23,0,23,63
1742.842,6,136,8535,75,46,23551,208,5134,61,31,29042,31,3401
0.007,17,2,304,1,36,0,36,64,1,212,0,212,240
1.725,6,25,8786,15,288,123,598,1470,10,987,172,1452,7316
162.182,17,4,304,2,48,162171,48,152,2,48,162170,48,152
1557.794,6,309,19743,182,69,8606,69,11144,127,69,12363,69,8599
1744.102,6,97,7307,63,38,28130,205,4476,34,33,52844,98,2831
0.462,6,20,7165,12,318,41,599,1905,8,1209,64,1906,5260
8.54,6,30,9649,16,422,555,1205,2530,14,911,640,2491,7119
1.102,6,14,2033,7,288,182,288,876,7,426,155,434,1157
1781.104,6,353,22400,206,69,8688,69,12380,147,69,12199,69,10020
7.655,6,65,20102,33,562,239,1152,15395,32,489,238,1179,4707
5.062,2,2,64,2,8,5062,8,64,0,0,0,0,0
1789.741,6,364,23185,209,69,8604,69,12638,155,69,11620,69,10547
1679.503,17,12,498,11,14,167950,14,462,1,8,0,8,36
0.187,6,9,1346,5,145,46,145,349,4,833,43,833,997
4.994,17,2,908,2,426,4994,687,908,0,0,0,0,0
1799.684,17,309,64573,309,180,5843,364,64573,0,0,0,0,0
1684.487,2,19,608,19,8,93582,8,608,0,0,0,0,0
34.356,17,31,8267,12,286,3120,1350,3769,19,208,1906,1350,4498
1004.955,6,77,10557,43,96,21905,516,3645,34,178,30450,1452,6912
1787.74,6,116,13691,74,81,24489,504,5880,42,161,43601,1420,7811
1740.463,17,22,23188,22,1026,82879,1026,23188,0,0,0,0,0
1783.103,17,73,3060,72,14,25114,14,3024,1,8,0,8,36
541.451,2,5,160,5,8,135362,8,160,0,0,0,0,0
1772.093,6,180,15480,120,69,14891,69,8940,60,69,30033,69,6540
118.735,6,25,11178,12,397,77,884,1717,13,992,9882,1460,9461
1787.793,17,87,3648,86,14,21032,14,3612,1,8,0,8,36
79.982,17,4,824,2,48,79974,48,152,2,308,79974,308,672
1773.124,6,180,15480,120,69,14900,69,8940,60,69,30048,69,6540
1644.198,1,8,848,8,78,234885,78,848,0,0,0,0,0
1798.206,17,448,39896,403,35,4473,288,25676,45,288,40020,288,14220
1786.55,6,154,19574,92,302,19632,302,13852,62,83,29287,83,5722
327.681,6,64,4009,35,69,8058,69,2159,29,69,11702,69,1850
661.749,2,6,192,6,8,132349,8,192,0,0,0,0,0
1741.362,6,87,6322,58,31,30550,31,3915,29,31,62190,31,2407
3.025,17,4,724,2,41,2990,41,138,2,265,3002,265,586
301.1,6,37,8404,20,284,15847,792,1971,17,521,560,2720,6433
1.369,6,41,10037,23,440,62,1360,4496,18,437,69,2715,5541
60.138,2,2,64,2,8,60138,8,64,0,0,0,0,0
1796.633,17,87,3648,86,14,21136,14,3612,1,8,0,8,36
1741.869,1,57,4788,57,56,31104,56,4788,0,0,0,0,0
66.458,6,18,1813,8,177,287,177,955,10,110,7362,110,858
280.239,6,29,7392,13,158,23353,267,1317,16,603,18677,2800,6075
20.162,17,25,18903,10,535,2237,1350,5632,15,856,1438,1350,13271
605.061,2,6,192,6,8,121012,8,192,0,0,0,0,0
1784.196,6,356,22520,208,69,8619,69,12460,148,69,12137,69,10060
1.022,6,22,7912,11,164,102,267,1248,11,1014,81,2411,6664
0.502,17,3,451,2,39,13,39,134,1,289,0,289,317
0.684,6,9,1346,5,145,171,145,349,4,833,208,833,997
421.065,2,4,128,4,8,140355,8,128,0,0,0,0,0
3.219,17,3,1167,3,361,1609,361,1167,0,0,0,0,0
1791.52,17,180,14040,180,50,10008,50,14040,0,0,0,0,0
1740.72,17,29,30624,29,1028,62168,1028,30624,0,0,0,0,0
65.006,6,76,44578,42,1164,1585,1448,35964,34,843,1944,2896,8614
134.603,6,75,51252,47,1194,2926,1448,43066,28,746,2282,1448,8186
281.444,6,32,7516,14,158,21649,267,1357,18,543,16550,1400,6159
1797.77,1,342,28728,342,56,5272,56,28728,0,0,0,0,0
1800.0,6,232,17673,87,66,20581,457,8477,145,48,12500,142,9196
0.605,6,14,2598,7,288,94,288,600,7,568,72,853,1998
0.009,17,2,366,1,33,0,33,61,1,277,0,277,305
1789.803,6,416,24920,208,69,8646,69,12460,208,34,8646,48,12460
11.191,6,1637,1521000,1075,1365,10,1432,1494196,562,389,19,1432,26804
0.015,6,2,182,1,102,0,102,142,1,0,0,0,40
0.125,17,2,182,1,39,0,39,67,1,87,0,87,115
1785.229,17,87,3648,86,14,21002,14,3612,1,8,0,8,36
1679.539,1,7,392,7,28,279923,28,392,0,0,0,0,0
0.024,17,2,438,1,33,0,33,61,1,349,0,349,377
61.888,6,68,47611,44,1166,1439,1408,39630,24,960,2680,3847,7981
1.448,6,24,8004,12,164,112,267,1288,12,1014,112,2491,6716
6.372,6,32,8952,14,158,490,267,1357,18,624,373,1400,7595
1.789,6,7,2719,4,100,596,100,264,3,1165,584,1179,2455
9.174,6,2,80,1,0,0,0,40,1,0,0,0,40
714.332,1,14,1484,14,78,54948,78,1484,0,0,0,0,0
0.378,17,8,2742,8,314,54,353,2742,0,0,0,0,0
0.276,17,12,4413,12,339,25,362,4413,0,0,0,0,0
3.583,17,10,2295,5,40,893,40,340,5,363,891,379,1955
20.181,6,21,5418,12,107,1834,159,1074,9,967,2517,1669,4344
14.016,6,25,4654,14,275,1078,275,1122,11,768,920,1440,3532
73.402,6,25,9789,12,531,64,1460,2637,13,945,6105,1460,7152
870.447,17,172,13072,172,48,5090,48,13072,0,0,0,0,0
1536.391,1,294,24696,294,56,5243,56,24696,0,0,0,0,0
5.604,6,14,3152,5,92,1401,92,348,9,579,611,1448,2804
5.028,1,10,840,10,56,558,56,840,0,0,0,0,0
0.92,6,11,1727,7,100,153,100,384,4,589,217,1152,1343
1786.817,6,106,8456,68,65,26668,65,4930,38,59,48289,59,3526
0.604,6,13,1693,6,288,84,288,548,7,426,71,434,1145
317.77,1,28,1568,28,28,11769,28,1568,0,0,0,0,0
0.906,6,10,1687,7,100,151,100,384,3,1179,327,1179,1303
151.406,6,21,5007,7,187,25234,293,1035,14,340,11625,1179,3972
317.039,6,66,18446,35,354,9324,1460,9579,31,400,10558,3089,8867
29.932,6,3854,3653907,2464,1403,12,1448,3576939,1390,776,21,1448,76968
1786.279,17,87,3648,86,14,21015,14,3612,1,8,0,8,36
0.698,6,53,24901,30,1088,24,1380,19739,23,421,30,1923,5162
85.539,6,25,7299,6,155,1390,267,1026,19,367,4751,1420,6273
0.571,17,2,384,1,39,0,39,67,1,289,0,289,317
4.094,6,32,9183,19,173,227,362,2216,13,896,238,1408,6967
1793.122,17,142,11360,71,48,25614,48,5396,71,56,25615,56,5964
1774.18,6,182,15698,120,69,14909,69,8940,62,69,29081,69,6758
125.429,6,14,3145,7,92,20904,92,452,7,465,20868,1408,2693
1594.874,6,319,20350,181,69,8556,69,10897,138,69,11641,69,9453
3.084,6,2,120,2,0,0,0,120,0,0,0,0,0
176.57,6,6,384,3,112,88285,112,240,3,0,1522,0,144
1775.564,17,73,3060,72,14,25007,14,3024,1,8,0,8,36
1769.882,6,101,9344,66,65,27228,65,5577,35,59,52051,59,3767
15.135,17,15,4906,7,355,2516,1350,2683,8,249,2157,1350,2223
7.267,6,1852,1710884,1167,1387,6,1408,1670600,685,776,10,1408,40284
371.316,6,25,1651,17,177,23207,177,1117,8,110,9214,110,534
997.403,6,100,11204,51,71,19947,517,3839,49,265,20778,1418,7365
1785.815,6,125,14469,79,81,22895,501,6110,46,148,39682,1420,8359
902.356,2,7,224,7,8,150392,8,224,0,0,0,0,0
5.006,17,4,558,2,36,5000,36,128,2,187,5000,187,430
1772.908,6,180,15480,120,69,14898,69,8940,60,69,30043,69,6540
1795.861,1,281,15736,281,28,6413,28,15736,0,0,0,0,0
1.719,6,10,924,5,283,316,283,551,5,105,300,105,373
0.526,17,2,672,2,308,526,308,672,0,0,0,0,0
196.983,6,71,50214,46,1205,4377,1408,42180,25,960,2566,3847,8034
0.789,6,10,1687,7,100,131,100,384,3,1179,266,1179,1303
3.481,17,2,656,2,300,3481,300,656,0,0,0,0,0
310.285,1,14,1484,14,78,23868,78,1484,0,0,0,0,0
296.014,6,6,364,4,31,98671,31,222,2,31,296000,31,142
651.633,6,75,11126,41,88,16286,721,3854,34,328,19740,2840,7272
10.759,6,20,4390,11,275,1075,275,998,9,755,745,1414,3392
2.075,17,6,994,3,36,1030,36,192,3,239,1035,318,802
179.874,6,26,11792,13,433,131,990,1875,13,1173,14979,3928,9917
6.662,6,10,2961,5,49,1665,92,367,5,1165,1619,1408,2594
21.991,6,2653,2526771,1687,1419,12,1448,2470387,966,872,22,1448,56384
0.93,6,29,12011,16,525,62,1360,3298,13,909,63,1379,8713
4.603,6,37,7205,19,218,255,314,3383,18,516,255,1179,3822
1744.67,2,29,928,29,8,62309,8,928,0,0,0,0,0
43.803,6,32,8952,14,158,3369,267,1357,18,624,2575,1400,7595
1786.615,6,105,8484,68,66,26665,66,4964,37,60,49625,60,3520
61.315,6,37,16080,22,815,2919,1408,9302,15,665,4362,1408,6778
300.938,6,49,20383,28,1045,11145,1360,14741,21,399,432,1360,5642
189.591,6,28,7352,12,158,17235,267,1277,16,603,12624,1400,6075
683.549,17,12,4032,12,308,62140,308,4032,0,0,0,0,0
1786.982,6,356,22520,208,69,8632,69,12460,148,69,12156,69,10060
1720.859,17,12,498,11,14,172085,14,462,1,8,0,8,36
1794.665,6,356,22520,208,69,8669,69,12460,148,69,12208,69,10060
6.798,6,507,428657,307,1329,21,1368,413581,200,776,33,1473,15076
1777.005,6,201,22210,129,75,13882,267,10017,72,136,25020,1926,12193
70.41,6,32,7515,14,155,5416,267,1346,18,388,4141,1420,6169
240.293,6,43,9251,21,519,12014,1402,5774,22,258,11442,618,3477
1746.447,6,91,6623,60,31,29600,31,4050,31,31,58200,31,2573
32.83,6,17,6256,6,154,6566,267,712,11,728,3252,3417,5544
0.504,6,60,25070,31,1025,16,1380,17733,29,558,16,1923,7337
1799.744,1,252,14112,252,28,7170,28,14112,0,0,0,0,0
15.073,6,2643,2560964,1704,1424,8,1448,2507350,939,792,15,1448,53614
8.888,17,2,1824,2,884,8888,1427,1824,0,0,0,0,0
36.036,6,27,7183,13,156,3003,267,1312,14,530,2771,3417,5871
0.013,6,2,92,1,0,0,0,40,1,0,0,0,52
0.272,6,20,7238,12,335,24,668,1974,8,1210,37,1906,5264
4.775,6,40,7309,20,218,251,314,3423,20,513,236,1179,3886
7.207,6,1689,1593030,1091,1384,6,1408,1557270,598,931,11,2816,35760
1783.437,17,83,3480,82,14,22017,14,3444,1,8,0,8,36
1799.99,17,465,156240,465,308,3879,308,156240,0,0,0,0,0
281.27,6,30,7432,13,158,23439,267,1317,17,543,17578,1400,6115
37.826,17,20,1760,10,48,4202,48,760,10,72,4201,72,1000
0.39,17,2,154,1,33,0,33,61,1,65,0,65,93
1.003,6,11,1572,5,503,250,503,771,6,473,200,473,801
1745.473,6,95,7203,63,38,28152,205,4476,32,33,56296,98,2727
0.336,6,26,8869,13,232,28,567,1612,13,1095,25,2816,7257
223.051,17,4,352,2,60,223050,60,176,2,60,223050,60,176
1772.966,6,180,15480,120,69,14898,69,8940,60,69,30049,69,6540
0.85,6,10,1687,7,100,141,100,384,3,1179,303,1179,1303
1792.549,17,142,11360,71,48,25607,48,5396,71,56,25607,56,5964
882.205,2,7,224,7,8,147034,8,224,0,0,0,0,0
1791.396,17,87,3648,86,14,21075,14,3612,1,8,0,8,36
1745.472,6,95,7203,63,38,28152,205,4476,32,33,56296,98,2727
1779.081,1,76,4256,76,28,23721,28,4256,0,0,0,0,0
0.24,6,9,1339,5,145,60,145,349,4,826,67,826,990
0.262,17,2,672,2,308,262,308,672,0,0,0,0,0
0.02,17,2,198,1,39,0,39,67,1,103,0,103,131
0.047,17,2,178,1,47,0,47,75,1,75,0,75,103
1785.853,6,360,24156,210,88,8544,469,13878,150,69,11985,69,10278
35.448,6,31,5095,15,154,2532,722,1860,16,342,2327,1448,3235
340.746,17,7,2358,7,308,56791,322,2358,0,0,0,0,0
1.007,6,27,8506,15,229,60,583,2007,12,1201,74,3151,6499
4.637,17,24,7740,10,389,515,1350,4175,14,226,287,1350,3565
3.996,17,2,656,2,300,3996,300,656,0,0,0,0,0
0.087,17,2,904,1,300,0,300,328,1,548,0,548,576
159.652,6,23,9823,12,410,61,922,1742,11,1089,15950,2720,8081
1.216,17,20,13092,8,447,173,1350,3805,12,745,104,1350,9287
445.515,1,5,549,5,81,111378,105,549,0,0,0,0,0
0.18,6,2,1273,1,1193,0,1193,1233,1,0,0,0,40
0.103,17,4,336,2,34,0,34,124,2,78,53,84,212
307.287,6,35,8573,20,142,16173,516,1945,15,502,21942,1452,6628
1.069,6,23,7952,12,164,97,267,1288,11,869,85,1448,6664
0.023,17,2,904,1,300,0,300,328,1,548,0,548,576
506.612,6,8,475,6,31,101322,31,333,2,31,299519,31,142
0.953,17,5,1176,3,32,473,32,180,2,470,6,470,996
146.073,17,4,352,2,60,146072,60,176,2,60,146072,60,176
2.93,17,3,468,3,128,1465,128,468,0,0,0,0,0
1.217,6,10,1687,7,100,202,100,384,3,1179,473,1179,1303
20.148,6,20,5366,12,107,1831,159,1074,8,967,2874,1675,4292
0.014,17,3,1007,1,137,0,137,165,2,393,13,393,842
8.205,6,18,6871,9,275,1025,275,643,9,1171,632,1440,6228
9.69,1,8,4185,8,495,1384,548,4185,0,0,0,0,0
58.204,6,40,9704,21,642,444,1360,4097,19,402,3223,2667,5607
0.357,6,28,9184,14,266,27,705,1802,14,947,26,2804,7382
58.679,6,645,515252,372,1430,60,1460,494263,273,173,215,1460,20989
1792.718,6,102,8172,62,65,26604,65,4495,40,53,45964,59,3677
1244.97,6,118,13910,66,82,19153,722,5533,52,179,24404,1440,8377
36.657,17,16,2352,8,48,5235,48,608,8,190,5235,308,1744
0.202,17,4,368,2,32,35,32,120,2,96,0,96,248
0.281,17,2,656,2,300,281,300,656,0,0,0,0,0
1798.359,17,180,14040,180,50,10046,50,14040,0,0,0,0,0
5.827,6,23,7048,13,185,485,275,1085,10,694,247,1440,5963
1770.575,6,104,10579,68,88,26426,822,6536,36,63,50585,191,4043
4.372,6,37,7205,19,218,242,314,3383,18,516,241,1179,3822
1787.665,17,87,3648,86,14,21031,14,3612,1,8,0,8,36
162.07,6,25,6397,15,167,11576,517,1610,10,547,17998,1420,4787
1783.238,6,352,28664,203,75,8827,267,13115,149,133,12048,3417,15549
11.755,6,2,80,1,0,0,0,40,1,0,0,0,40
1786.207,17,87,3648,86,14,21014,14,3612,1,8,0,8,36
125.844,2,2,64,2,8,125844,8,64,0,0,0,0,0
0.014,17,2,635,2,289,14,294,635,0,0,0,0,0
240.219,6,57,19969,31,775,8007,1408,17134,26,184,9608,580,2835
7.325,6,5,220,1,0,0,0,44,4,0,2413,0,176
1799.355,17,4220,202560,2110,20,853,20,101280,2110,20,853,20,101280
4.945,17,4,1366,2,306,3939,306,668,2,321,3951,321,698
0.089,17,2,154,1,33,0,33,61,1,65,0,65,93
0.337,6,27,9043,13,252,28,647,1692,14,945,24,1408,7351
46.637,6,43,8781,21,378,473,786,2054,22,389,2214,2720,6727
1744.717,2,14,448,14,8,134209,8,448,0,0,0,0,0
1630.16,1,8,448,8,28,232880,28,448,0,0,0,0,0
240.513,6,41,8723,20,583,12658,1402,5713,21,238,12025,580,3010
15.818,17,21,12922,11,944,1578,1350,10698,10,194,1753,1350,2224
1795.712,1,246,13776,246,28,7329,28,13776,0,0,0,0,0
240.342,6,44,8447,22,449,11444,1402,5648,22,205,11444,580,2799
1791.547,6,363,23007,211,69,8530,69,12787,152,69,11861,69,10220
1745.487,6,90,6540,60,31,29584,31,4050,30,31,60182,31,2490
0.014,17,4,480,3,60,5,60,264,1,188,0,188,216
0.059,17,2,251,1,36,0,36,64,1,159,0,159,187
0.753,6,553,515918,319,183,2,230,17673,234,2095,2,5632,498245
0.145,6,7,423,4,43,36,43,259,3,0,22,0,164
382.378,6,15,1178,9,106,47796,106,898,6,0,76473,0,280
1795.956,6,358,22738,208,69,8676,69,12460,150,69,12052,69,10278
1.26,17,3,1230,3,382,630,392,1230,0,0,0,0,0
85.791,6,744,355640,399,837,215,1152,335994,345,389,248,1152,19646
1682.765,17,14,1036,7,30,280449,30,406,7,62,280452,62,630
9.11,6,38,8509,19,401,506,889,1996,19,441,473,1460,6513
0.025,17,2,570,1,30,0,30,58,1,484,0,484,512
0.254,17,2,152,1,48,0,48,76,1,48,0,48,76
32.006,6,212,230516,53,122,615,289,3123,159,1404,202,1418,227393
90.337,6,97,89711,43,290,2150,924,3976,54,1692,1702,5608,85735
1798.42,1,16,896,16,28,119894,28,896,0,0,0,0,0
1797.279,17,448,39896,403,35,4470,288,25676,45,288,40014,288,14220
3.033,17,4,340,2,37,3027,37,130,2,77,3027,77,210
2.173,6,13,1553,8,177,310,177,955,5,110,488,110,598
1741.832,17,30,31680,30,1028,60063,1028,31680,0,0,0,0,0
1746.392,6,97,7307,63,38,28167,205,4476,34,33,52908,98,2831
42.138,6,18,5789,11,271,4213,515,1259,7,849,115,1452,4530
9.18,6,796,688306,490,1332,18,1368,667730,306,776,29,1473,20576
1740.619,17,30,31680,30,1028,60021,1028,31680,0,0,0,0,0
59.063,2,2,64,2,8,59063,8,64,0,0,0,0,0
1785.857,6,366,25541,213,100,8423,469,14936,153,69,11749,69,10605
1.222,6,49,18909,27,865,47,1360,13253,22,433,50,1360,5656
0.511,6,10,1671,6,552,102,948,1348,4,159,166,159,323
1143.024,2,8,256,8,8,163289,8,256,0,0,0,0,0
1764.525,6,126,7674,68,27,26335,27,4097,58,27,30955,27,3577
14.383,17,4,352,2,60,14382,60,176,2,60,14382,60,176
290.978,1,4,224,4,28,96992,28,224,0,0,0,0,0
97.987,17,4,352,2,60,97986,60,176,2,60,97986,60,176
9.523,6,92,29174,47,543,207,1152,22551,45,438,210,1179,6623
1660.92,1,8,448,8,28,237274,28,448,0,0,0,0,0
0.3,17,2,198,1,39,0,39,67,1,103,0,103,131
368.614,6,25,1651,17,177,23038,177,1117,8,110,9224,110,534
0.159,17,2,586,1,46,0,46,74,1,484,0,484,512
280.228,6,27,7312,13,158,23352,267,1317,14,775,21551,4836,5995
1790.458,17,110,7040,110,36,16426,36,7040,0,0,0,0,0
29.85,17,4,824,2,48,29840,48,152,2,308,29837,308,672
1.594,6,57,22659,30,946,54,1380,17325,27,383,58,1380,5334
8.746,6,38,7845,20,155,460,267,1589,18,612,510,2045,6256
0.79,17,4,368,2,64,789,64,184,2,64,789,64,184
1740.614,17,30,7050,30,207,60021,207,7050,0,0,0,0,0
1786.677,1,66,3696,66,28,27487,28,3696,0,0,0,0,0
0.247,17,3,507,2,39,0,39,134,1,345,0,345,373
235.485,6,70,17735,31,309,4440,1040,6508,39,483,6192,1440,11227
1.87,6,2,87,1,0,0,0,40,1,7,0,7,47
1793.325,1,62,5208,62,56,29398,56,5208,0,0,0,0,0
13.42,6,6,328,4,0,4473,0,216,2,0,13239,0,112
1796.532,6,97,7648,64,46,28516,205,4767,33,35,56066,98,2881
0.084,1,2,112,2,28,84,28,112,0,0,0,0,0
1744.226,6,97,7307,63,38,28132,205,4476,34,33,52842,98,2831
1795.084,1,67,5628,67,56,27198,56,5628,0,0,0,0,0
1.154,6,24,8004,12,164,90,267,1288,12,1014,89,2411,6716
0.156,6,40,14973,22,913,7,1420,10032,18,467,8,1883,4941
18.241,17,37,13280,20,493,958,1350,10435,17,139,1138,1350,2845
1775.491,6,120,7286,67,26,26900,26,4000,53,26,34143,26,3286
245.983,6,30,7432,13,158,20498,267,1317,17,543,15370,1400,6115
0.383,6,10,968,5,256,93,256,460,5,304,92,304,508
312.423,6,1508,1468479,1032,1410,303,1440,1438683,476,167,42,1440,29796
1793.842,6,360,22749,209,69,8624,69,12569,151,69,11958,69,10180
574.587,17,4,304,4,48,191529,48,304,0,0,0,0,0
0.059,17,2,214,1,47,0,47,75,1,111,0,111,139
80.352,17,4,352,2,60,80351,60,176,2,60,80350,60,176
252.743,17,4,300,2,47,252741,47,150,2,47,252741,47,150
0.503,17,3,451,2,39,194,39,134,1,289,0,289,317
1782.652,17,73,3060,72,14,25107,14,3024,1,8,0,8,36
8.782,6,17,1442,9,275,1097,275,918,8,96,1116,96,524
300.15,6,24,8495,14,404,23088,1241,2352,10,802,7265,1448,6143
387.564,6,18,1242,14,180,29812,180,916,4,110,20061,110,326
0.082,6,9,1343,5,145,20,145,349,4,830,22,830,994
54.61,6,23,8360,13,515,4550,950,2219,10,801,6065,1488,6141
1529.26,17,22,1952,11,32,152922,37,666,11,88,152922,136,1286
59.225,17,4,352,2,60,59224,60,176,2,60,59223,60,176
1.372,6,38,8254,19,321,76,1164,2718,19,433,65,1360,5536
1791.033,1,202,11312,202,28,8910,28,11312,0,0,0,0,0
1771.885,6,180,15480,120,69,14889,69,8940,60,69,30030,69,6540
0.348,6,20,7229,12,334,31,663,1969,8,1209,48,1906,5260
3.991,17,2,128,2,36,3991,36,128,0,0,0,0,0
7.739,6,1509,1280665,840,1434,9,1448,1238809,669,776,11,1448,41856
1798.529,17,142,11360,71,48,25693,48,5396,71,56,25693,56,5964
1797.887,17,450,39960,405,35,4450,288,25740,45,288,40024,288,14220
1772.545,6,180,15480,120,69,14895,69,8940,60,69,30042,69,6540
1.32,6,38,8252,19,320,73,1162,2716,19,476,64,2715,5536
1.01,17,5,1176,3,32,502,32,180,2,470,17,470,996
8.058,17,4,240,2,32,8057,32,120,2,32,8056,32,120
1745.241,6,94,7151,62,38,28610,205,4424,32,33,56284,98,2727
1763.793,1,36,4075,36,85,50394,105,4075,0,0,0,0,0
2.972,17,8,480,4,32,990,32,240,4,32,990,32,240
1799.007,1,298,31588,298,78,6057,78,31588,0,0,0,0,0
5.963,6,524,453990,326,1327,17,1368,439030,198,776,29,1473,14960
1795.274,17,448,39612,404,35,4454,288,25708,44,288,40020,288,13904
30.315,6,39,9332,20,321,1595,721,3060,19,687,1622,1414,6272
24.229,6,1601,1509947,1049,1360,23,1368,1472619,552,931,43,2736,37328
0.64,6,31,17665,18,708,37,1360,4358,13,1419,41,4416,13307
1788.002,1,342,28728,342,56,5243,56,28728,0,0,0,0,0
2.035,17,3,174,3,30,1017,30,174,0,0,0,0,0
1764.753,6,195,18619,99,68,18007,721,8149,96,157,18574,1414,10470
1679.942,1,15,840,15,28,119995,28,840,0,0,0,0,0
63.159,6,43,8924,21,401,1121,889,2136,22,368,3001,2720,6788
14.447,17,2,780,2,362,14447,362,780,0,0,0,0,0
0.992,6,27,12479,16,522,66,1360,3286,11,1248,80,3921,9193
15.887,17,14,7585,8,665,2256,1350,5549,6,311,3160,1350,2036
1.709,6,9,527,5,43,427,43,311,4,0,565,0,216
0.011,6,10,1544,5,505,2,505,773,5,503,2,503,771
1771.172,6,99,9306,66,66,27248,66,5610,33,60,55346,60,3696
101.192,6,1458,1354027,942,1423,61,1460,1322836,516,169,196,1460,31191
1745.465,6,95,7203,63,38,28152,205,4476,32,33,56291,98,2727
9.152,6,25,7663,12,301,832,721,1690,13,681,676,2840,5973
163.423,17,4,240,2,32,163422,32,120,2,32,163422,32,120
0.023,6,2,92,1,0,0,0,52,1,0,0,0,40
17.353,17,4,352,2,48,17343,48,152,2,72,17341,72,200
32.89,17,9,684,9,48,4111,48,684,0,0,0,0,0
1799.386,1,16,896,16,28,119959,28,896,0,0,0,0,0
0.339,6,27,9043,13,252,27,647,1692,14,945,25,1408,7351
19.961,17,5,1680,5,308,4990,308,1680,0,0,0,0,0
1777.937,1,60,5040,60,56,30134,56,5040,0,0,0,0,0
300.224,6,34,17569,21,1005,15011,1408,12173,13,785,3017,1491,5396
33.482,6,29,5025,15,180,2391,721,1894,14,399,2561,2026,3131
22.515,6,15,3550,9,290,2814,517,961,6,1168,4501,1809,2589
1.564,6,50,21029,28,948,57,1460,15373,22,433,66,1460,5656
280.024,6,30,7432,13,158,23335,267,1317,17,543,17500,1400,6115
0.045,17,2,904,1,300,0,300,328,1,548,0,548,576
0.914,6,24,5755,13,158,75,370,1315,11,799,90,1420,4440
0.297,6,21,5000,10,137,33,267,1092,11,692,27,1467,3908
2.003,17,3,1173,3,363,1001,363,1173,0,0,0,0,0
230.193,17,4,352,2,48,230183,48,152,2,72,230183,72,200
0.364,6,10,968,5,256,87,256,460,5,304,87,304,508
1719.288,1,8,448,8,28,245612,28,448,0,0,0,0,0
1793.266,6,356,22520,208,69,8663,69,12460,148,69,12197,69,10060
0.245,6,21,5920,11,181,24,537,1486,10,558,24,1440,4434
820.195,17,10,821,5,31,205037,37,297,5,76,205034,136,524
280.267,6,26,7272,13,158,23355,267,1317,13,775,23353,3445,5955
280.253,6,29,7392,13,158,23354,267,1317,16,603,18680,2036,6075
0.089,6,12,2069,7,324,14,585,1009,5,396,20,580,1060
0.051,17,4,284,2,32,37,32,120,2,54,30,60,164
0.154,6,10,1800,6,616,30,1076,1477,4,159,49,159,323
0.268,6,26,8995,13,252,22,647,1692,13,1103,21,2816,7303
1793.798,17,144,11520,72,48,25264,48,5472,72,56,25264,56,6048
1797.012,1,282,15792,282,28,6395,28,15792,0,0,0,0,0
1795.746,17,448,39896,403,35,4467,288,25676,45,288,40021,288,14220
430.315,6,102,15036,47,224,9354,1189,5931,55,237,7968,1997,9105
1773.674,6,180,15480,120,69,14904,69,8940,60,69,30054,69,6540
252.747,2,2,64,2,8,252747,8,64,0,0,0,0,0
0.413,6,26,8890,13,232,34,569,1614,13,941,32,1438,7276
1740.451,1,56,4704,56,56,31644,56,4704,0,0,0,0,0
24.004,6,12,1355,7,284,4000,517,940,5,147,5999,147,415
1.49,6,50,21214,29,900,53,1360,15598,21,476,64,2715,5616
1755.678,6,106,6292,60,26,29757,26,3510,46,26,39006,26,2782
1752.307,1,48,5088,48,78,37283,78,5088,0,0,0,0,0
38.504,17,4,352,2,60,38503,60,176,2,60,38503,60,176
1684.527,2,25,800,25,8,70188,8,800,0,0,0,0,0
0.264,6,3,802,2,413,264,413,493,1,269,0,269,309
1796.717,17,85,3561,83,13,21911,14,3481,2,12,22411,16,80
1784.82,6,117,13912,75,81,24119,500,5949,42,156,43530,1420,7963
147.676,1,8,448,8,28,21096,28,448,0,0,0,0,0
9.218,6,81,25362,41,579,230,1152,19621,40,459,229,1179,5741
1776.973,17,73,3060,72,14,25027,14,3024,1,8,0,8,36
1791.881,1,149,8344,149,28,12107,28,8344,0,0,0,0,0
61.969,6,81,56092,49,1219,1291,1368,47690,32,841,1990,2736,8402
1796.29,6,384,23640,208,69,8677,69,12460,176,47,10264,69,11180
0.024,17,2,338,1,33,0,33,61,1,249,0,249,277
1.034,6,13,2040,7,130,172,130,450,6,1326,206,1326,1590
1796.031,1,42,3528,42,56,43805,56,3528,0,0,0,0,0
25.138,17,16,1408,8,48,3590,48,608,8,72,3589,72,800
0.542,6,22,7345,13,334,45,663,2021,9,1209,61,1946,5324
0.794,17,4,644,2,36,789,36,128,2,230,770,230,516
1772.209,6,240,17880,120,69,14892,69,8940,120,34,14892,48,8940
98.877,6,48,14094,18,312,1037,469,3851,30,361,3409,1452,10243
1075.465,2,12,384,12,8,97769,8,384,0,0,0,0,0
153.636,6,27,7856,11,181,15363,267,1168,16,549,10230,1400,6688
1.586,6,32,8952,14,158,122,267,1357,18,624,92,1400,7595
1783.223,17,83,3480,82,14,22015,14,3444,1,8,0,8,36
0.571,17,8,2750,8,315,81,354,2750,0,0,0,0,0
1799.829,1,67,5628,0,0,0,0,0,67,56,27270,56,5628
7.706,17,3,228,3,48,3853,48,228,0,0,0,0,0
11.839,6,25,8473,13,275,986,275,1078,12,986,861,1440,7395
1742.601,6,95,7203,63,38,28106,205,4476,32,33,56203,98,2727
21.023,17,28,8653,13,409,1749,1350,5687,15,169,1499,1350,2966
1798.813,6,123,7829,71,48,25697,208,4819,52,31,35262,31,3010
0.503,6,20,7252,13,337,41,674,2032,7,1212,74,1946,5220
1787.155,17,87,3648,86,14,21025,14,3612,1,8,0,8,36
1742.934,1,15,840,15,28,124495,28,840,0,0,0,0,0
4.612,6,29,11862,12,423,419,721,1755,17,785,224,1414,10107
1629.667,1,8,448,8,28,232809,28,448,0,0,0,0,0
1682.728,17,16,1265,8,30,240373,37,471,8,71,240384,136,794
1797.402,17,448,39896,403,35,4471,288,25676,45,288,40019,288,14220
14.272,6,77,24733,40,596,365,1152,19485,37,470,389,1179,5248
0.05,6,6,328,4,0,16,0,216,2,0,16,0,112
1791.998,6,369,25730,214,99,8413,469,15114,155,69,11636,69,10616
0.069,17,2,554,1,30,0,30,58,1,468,0,468,496
0.727,1,10,840,10,56,80,56,840,0,0,0,0,0
1782.362,17,83,3480,82,14,22004,14,3444,1,8,0,8,36
1756.292,6,252,48260,155,483,11404,483,38038,97,83,18294,83,10222
2.112,6,13,2311,8,188,301,245,700,5,1407,462,1407,1611
1.192,6,22,7900,11,164,100,267,1236,11,1216,101,3819,6664
0.676,6,11,976,5,283,114,283,551,6,105,90,105,425
839.958,6,109,13899,58,104,14733,721,5765,51,243,16795,1414,8134
0.4,6,48,20664,27,1033,15,1380,15582,21,421,17,1923,5082
1.829,6,28,8984,17,366,114,832,1784,11,965,174,1420,7200
124.221,6,33,7757,13,155,10351,267,1306,20,376,6537,3417,6451
1.095,17,4,420,2,33,1087,33,122,2,121,1085,145,298
3.077,17,4,368,4,64,1025,64,368,0,0,0,0,0
46.678,6,32,8952,14,158,3590,267,1357,18,624,2741,1400,7595
12.114,6,1966,1663008,1172,1363,10,1380,1627006,794,383,15,1380,36002
1795.737,6,104,8570,69,66,26407,66,5070,35,60,52812,60,3500
369.633,6,23,1535,16,177,24642,177,1053,7,110,10384,110,482
189.071,6,31,7472,14,158,14543,267,1357,17,543,11814,1400,6115
0.469,17,16,9180,8,469,67,1350,3981,8,621,51,1350,5199
2.476,17,3,451,2,39,962,39,134,1,289,0,289,317
1738.779,1,59,4956,59,56,29978,56,4956,0,0,0,0,0
8.139,17,12,1764,6,48,1625,48,456,6,190,1625,308,1308
175.188,6,27,17412,16,708,46,1360,4214,11,2124,17505,5223,13198
1798.719,17,449,39928,404,35,4463,288,25708,45,288,40015,288,14220
0.044,17,4,352,2,37,3,37,130,2,83,0,89,222
300.562,6,36,20690,21,360,15028,1091,2577,15,1732,17181,4206,18113
12.504,6,1936,1836039,1261,1380,9,1408,1796251,675,931,18,2801,39788
0.079,6,3,136,2,0,79,0,88,1,0,0,0,48
151.248,6,1386,713550,786,844,192,1152,682340,600,400,252,1179,31210
260.975,17,7,2264,3,308,130487,308,1008,4,286,83502,286,1256
275.462,6,24,4892,9,220,7000,516,1245,15,276,19669,1452,3647
1774.858,17,44,14784,44,308,41275,308,14784,0,0,0,0,0
374.839,6,23,1499,14,177,28833,177,913,9,110,9472,110,586
280.573,6,30,7432,13,158,23381,267,1317,17,543,17533,1400,6115
11.652,6,89,26501,46,558,258,1152,20283,43,449,270,1179,6218
1757.793,6,94,7151,62,38,28816,205,4424,32,33,56691,98,2727
56.342,6,11,1003,6,332,11268,332,652,5,83,14051,83,351
1789.948,6,237,24653,96,67,18839,616,9097,141,139,12784,4658,15556
8.869,6,1450,1230187,854,1387,10,1420,1202090,596,467,14,1883,28097
0.258,6,24,5120,12,137,23,267,1172,12,577,22,1400,3948
1.768,6,18,3257,10,99,176,182,924,8,477,227,1343,2333
280.476,6,30,7432,13,158,23373,267,1317,17,603,17523,2076,6115
1116.633,17,220,16720,220,48,5098,48,16720,0,0,0,0,0
3.996,17,8,1248,4,64,1328,64,368,4,192,1328,192,880
6.109,17,8,676,4,47,2033,47,300,4,66,2033,75,376
165.76,6,21,11264,21,565,8288,1402,11264,0,0,0,0,0
1782.434,17,140,11200,70,48,25832,48,5320,70,56,25832,56,5880
68.576,6,27,7177,13,155,5714,267,1306,14,530,5274,3417,5871
1.742,6,51,19717,29,889,62,1360,13678,22,428,74,2715,6039
441.509,6,376,59790,210,304,2112,304,42016,166,83,2675,83,17774
1782.527,6,354,22440,207,69,8653,69,12420,147,69,12208,69,10020
133.729,6,22,8961,11,514,124,1236,2014,11,927,13354,1460,6947
1121.058,17,10,740,5,30,280261,30,290,5,62,280261,62,450
1680.541,1,8,848,8,78,240077,78,848,0,0,0,0,0
126.557,6,7,296,2,0,3269,0,84,5,0,31579,0,212
5.086,17,4,428,2,39,5085,39,134,2,119,5074,119,294
93.066,17,12,1056,6,48,18611,48,456,6,72,18611,72,600
1772.429,6,180,15480,120,69,14894,69,8940,60,69,30033,69,6540
1796.958,17,449,39928,404,35,4458,288,25708,45,288,40014,288,14220
1798.083,1,345,28980,345,56,5226,56,28980,0,0,0,0,0
258.765,6,32,8952,14,158,19905,267,1357,18,624,15210,1400,7595
3.38,6,10,2929,4,92,1126,92,296,6,579,571,1408,2633
0.122,17,2,166,1,39,0,39,67,1,71,0,71,99
140.925,6,26,6409,9,272,227,516,1180,17,324,8802,1452,5229
1603.347,1,14,1141,14,53,123334,78,1141,0,0,0,0,0
1783.266,17,83,3480,82,14,22015,14,3444,1,8,0,8,36
10.803,17,15,17718,15,1153,771,1452,17718,0,0,0,0,0
0.001,17,2,211,1,59,0,59,87,1,96,0,96,124
4.012,17,8,1288,4,33,1333,33,244,4,233,1333,233,1044
0.553,17,2,218,1,65,0,65,93,1,97,0,97,125
1682.888,17,14,1036,7,30,280471,30,406,7,62,280473,62,630
0.007,17,2,572,1,39,0,39,67,1,477,0,477,505
36.652,17,22,1936,11,48,3658,48,836,11,72,3658,72,1100
504.493,2,3,96,3,8,252246,8,96,0,0,0,0,0
28.964,17,4,352,2,60,28963,60,176,2,60,28963,60,176
0.64,6,16,6284,7,106,106,106,394,9,788,61,1420,5890
126.556,2,2,64,2,8,126556,8,64,0,0,0,0,0
280.219,6,29,7392,13,158,23351,267,1317,16,603,18680,2036,6075
52.756,6,13,571,3,0,26378,0,124,10,7,5833,7,447
54.611,6,44,8873,21,371,694,797,2045,23,368,2476,2720,6828
1788.749,17,142,11360,71,48,25553,48,5396,71,56,25553,56,5964
126.274,6,6,326,3,0,63137,0,152,3,7,63025,7,174
1377.912,6,140,12017,92,69,15141,69,6923,48,69,29317,69,5094
1797.326,17,236,68367,236,261,7648,422,68367,0,0,0,0,0
378.215,2,3,96,3,8,189107,8,96,0,0,0,0,0
22.789,6,37,8403,18,365,516,780,1859,19,444,1257,2128,6544
110.748,6,25,11118,12,433,72,990,1823,13,973,9217,1440,9295
0.032,6,9,1880,5,910,7,910,1178,4,486,10,486,702
65.11,6,15,10330,4,174,21703,174,338,11,1363,6112,1420,9992
5.855,6,32,8952,14,158,450,267,1357,18,624,339,1400,7595
126.275,2,2,64,2,8,126275,8,64,0,0,0,0,0
121.404,17,8,2688,8,308,17343,308,2688,0,0,0,0,0
1771.222,6,99,9306,66,66,27249,66,5610,33,60,55347,60,3696
11.578,6,26,7703,11,301,1157,721,1650,15,544,791,1420,6053
0.013,17,2,350,1,33,0,33,61,1,261,0,261,289
31.559,6,7,336,1,0,0,0,48,6,0,6309,0,288
0.157,6,2,1274,1,1194,0,1194,1234,1,0,0,0,40
240.202,6,54,17319,29,774,8578,1408,14675,25,167,10008,580,2644
0.047,6,4,208,2,0,11,0,104,2,0,21,0,104
0.098,6,9,1340,5,145,24,145,349,4,827,25,827,991
31.041,6,552,589213,238,322,130,517,18561,314,1847,99,13680,570652
4.189,6,39,7269,19,218,232,314,3383,20,440,206,1152,3886
0.009,17,2,427,1,39,0,39,67,1,332,0,332,360
1799.44,6,356,22520,208,69,8692,69,12460,148,69,12240,69,10060
0.048,17,2,158,1,34,0,34,62,1,68,0,68,96
1740.267,6,87,6322,58,31,30531,31,3915,29,31,62147,31,2407
0.908,17,2,148,2,46,908,46,148,0,0,0,0,0
0.271,17,4,334,2,39,265,39,134,2,72,0,72,200
1553.95,6,322,22815,185,102,8445,469,13471,137,69,11425,69,9344
12.459,6,1905,1745642,1230,1368,10,1380,1709124,675,515,18,1923,36518
0.048,6,5,260,3,0,4,0,156,2,0,0,0,104
0.028,17,2,157,1,31,0,31,59,1,70,0,70,98
0.763,17,3,684,2,64,736,64,184,1,472,0,472,500
0.32,6,22,4442,11,165,32,456,1394,11,493,30,888,3048
1.673,6,12,3359,4,288,536,288,468,8,639,214,853,2891
129.992,17,2,150,2,47,129992,47,150,0,0,0,0,0
1776.433,17,140,11200,70,48,25745,48,5320,70,56,25745,56,5880
1798.273,17,1230,411671,1230,306,1463,376,411671,0,0,0,0,0
62.286,6,4,904,4,248,20762,248,904,0,0,0,0,0
0.114,6,16,6653,8,138,16,138,562,8,1134,16,1448,6091
2.998,6,12,1938,7,209,499,209,581,5,544,746,891,1357
1770.937,6,104,9776,69,66,26043,66,5856,35,60,52078,60,3920
0.303,6,26,9039,13,266,25,705,1750,13,943,24,1402,7289
0.893,6,10,1687,7,100,148,100,384,3,1179,321,1179,1303
1738.656,6,87,6322,58,31,30502,31,3915,29,31,62094,31,2407
1.631,6,37,8212,19,320,90,1162,2716,18,476,83,2715,5496
0.58,6,12,1163,6,222,113,222,688,6,231,113,231,475
1772.366,6,180,15480,120,69,14893,69,8940,60,69,30036,69,6540
0.012,17,2,557,1,66,0,66,94,1,435,0,435,463
0.857,6,23,9988,12,665,77,1360,3186,11,1058,62,2720,6802
163.176,6,133,105027,88,1283,1875,1408,93154,45,635,2551,1408,11873
122.38,2,3,96,3,8,61190,8,96,0,0,0,0,0
1.957,17,2,672,2,308,1957,308,672,0,0,0,0,0
3.484,17,4,1560,4,362,1161,362,1560,0,0,0,0,0
1796.78,1,345,28980,345,56,5223,56,28980,0,0,0,0,0
280.412,6,29,7392,13,158,23367,267,1317,16,603,18690,2076,6075
0.142,17,2,154,1,33,0,33,61,1,65,0,65,93
16.569,17,22,5814,9,242,2067,1350,2431,13,232,1378,1350,3383
0.51,6,23,7782,14,325,39,626,2048,9,876,62,1475,5734
1786.314,6,104,8424,68,64,26661,64,4896,36,58,51034,58,3528
280.197,6,27,7312,13,158,23349,267,1317,14,775,21550,3445,5995
0.733,6,125,83229,68,1296,10,1432,76658,57,427,12,1432,6571
481.257,2,7,224,7,8,80209,8,224,0,0,0,0,0
133.693,17,4,352,2,60,133692,60,176,2,60,133692,60,176
105.042,17,3,528,3,148,52521,348,528,0,0,0,0,0
1794.024,17,142,11360,71,48,25628,48,5396,71,56,25628,56,5964
1786.819,17,87,3648,86,14,21021,14,3612,1,8,0,8,36
1749.513,17,12,498,11,14,174951,14,462,1,8,0,8,36
0.51,17,2,384,1,39,0,39,67,1,289,0,289,317
1794.315,17,80,3354,79,14,23004,14,3318,1,8,0,8,36
341.53,17,14,4704,14,308,26271,308,4704,0,0,0,0,0
1.812,6,25,8759,15,284,129,585,1457,10,985,177,1452,7302
123.654,17,85,6483,44,40,2875,41,3016,41,56,3090,57,3467
64.081,6,27,7183,13,156,5340,267,1312,14,530,4928,3417,5871
0.636,6,15,1785,8,288,65,288,640,7,426,76,434,1145
158.11,17,6,528,3,60,79054,60,264,3,60,79054,60,264
120.361,2,3,96,3,8,60180,8,96,0,0,0,0,0
1.687,6,26,8827,16,289,112,599,1511,10,987,167,1452,7316
0.017,17,2,412,1,33,0,33,61,1,323,0,323,351
1798.011,17,450,39960,405,35,4450,288,25740,45,288,40019,288,14220
1.471,6,38,8254,19,321,81,1164,2718,19,476,69,2920,5536
1789.825,6,356,22520,208,69,8646,69,12460,148,69,12175,69,10060
0.099,17,2,213,1,44,0,44,72,1,113,0,113,141
298.985,1,4,224,4,28,99661,28,224,0,0,0,0,0
1787.339,6,102,8296,68,65,26676,65,4930,34,59,54158,59,3366
18.642,17,12,1056,6,48,3726,48,456,6,72,3726,72,600
0.273,6,72,68600,42,183,6,230,2881,30,2291,6,7040,65719
4.33,6,4,1600,2,0,3050,0,80,2,1440,1665,1440,1520
0.011,17,2,526,1,32,0,32,60,1,438,0,438,466
79.388,17,4,304,4,48,26462,48,304,0,0,0,0,0
300.283,6,79,14402,38,412,8115,1320,8232,41,200,7506,1402,6170
112.641,6,6,1255,4,327,37547,413,814,2,180,112451,269,441
2.805,17,542,609467,102,82,27,1350,11307,440,1331,6,1350,598160
1.276,6,25,8056,12,164,96,267,1288,13,869,90,1448,6768
4.684,6,39,7269,19,218,260,314,3383,20,513,231,1179,3886
1776.421,6,184,15847,121,69,14803,69,8980,63,69,28647,69,6867
0.445,6,22,7342,12,335,40,668,1974,10,1210,48,1906,5368
242.516,6,58,18411,31,804,8083,1418,15296,27,212,9327,580,3115
1785.742,6,356,22520,208,69,8626,69,12460,148,69,12147,69,10060
240.657,2,2,64,2,8,240657,8,64,0,0,0,0,0
0.906,6,10,861,5,222,221,222,426,5,231,221,231,435
3.652,17,2,178,1,29,0,29,57,1,93,0,93,121
982.365,17,15,3903,15,232,70168,460,3903,0,0,0,0,0
0.93,17,2,677,1,300,0,300,328,1,321,0,321,349
8.647,17,4,352,2,60,8646,60,176,2,60,8646,60,176
0.156,17,4,668,2,32,146,32,120,2,246,142,246,548
146.318,17,4,352,2,60,146317,60,176,2,60,146317,60,176
1774.525,6,180,15480,120,69,14911,69,8940,60,69,30072,69,6540
5.026,17,3,208,2,36,5004,36,128,1,52,0,52,80
2.037,6,20,2389,9,222,252,222,1252,11,231,202,231,1137
285.152,6,21,1946,11,330,28514,330,1252,10,83,31682,83,694
1797.407,17,142,11360,71,48,25677,48,5396,71,56,25677,56,5964
0.059,17,2,164,1,46,0,46,74,1,62,0,62,90
300.237,6,39,18090,21,254,15011,672,2118,18,1156,14130,1448,15972
1776.247,6,189,18664,124,92,14441,469,10811,65,80,27751,453,7853
7.636,17,12,1764,6,48,1524,48,456,6,190,1524,308,1308
217.708,17,4,1388,4,319,72569,336,1388,0,0,0,0,0
0.0,6,1,40,0,0,0,0,0,1,0,0,0,40
55.273,17,2,72,1,8,0,8,36,1,8,0,8,36
60.285,6,20,9184,12,651,5480,1408,3891,8,973,8603,2521,5293
15.527,17,10,880,5,48,3879,48,380,5,72,3879,72,500
0.062,6,2,92,1,0,0,0,52,1,0,0,0,40
7.914,6,79,24914,40,568,202,1152,19213,39,413,201,1152,5701
280.206,17,4,296,2,30,280187,30,116,2,62,280182,62,180
87.826,17,4,352,2,60,87825,60,176,2,60,87824,60,176
1745.836,1,8,848,8,78,249405,78,848,0,0,0,0,0
79.196,6,739,352317,398,819,199,1152,333886,341,435,232,1179,18431
0.175,1,2,112,2,28,175,28,112,0,0,0,0,0
9.214,6,86,26493,42,562,224,1152,20251,44,447,208,1179,6242
1783.812,6,360,22887,208,69,8617,69,12529,152,69,11813,69,10358
240.168,6,57,17866,31,779,8005,1408,14865,26,205,9606,580,3001
1770.024,6,99,9240,66,65,27231,65,5577,33,59,55310,59,3663
881.306,2,6,192,6,8,176261,8,192,0,0,0,0,0
8.91,6,21,6596,6,154,1782,267,712,15,527,607,1917,5884
1760.513,6,128,7817,69,27,25889,27,4161,59,27,30352,27,3656
0.004,17,2,378,1,33,0,33,61,1,289,0,289,317
38.05,17,22,1936,11,48,3804,48,836,11,72,3804,72,1100
0.156,17,2,2754,2,1349,156,1349,2754,0,0,0,0,0
1795.883,17,449,39928,404,35,4456,288,25708,45,288,40018,288,14220
1.5,1,9,756,9,56,187,56,756,0,0,0,0,0
615.928,6,143,18994,59,103,10619,615,5579,84,152,7419,4649,13415
0.059,17,2,154,1,41,0,41,69,1,57,0,57,85
11.836,6,25,8473,13,275,986,275,1078,12,986,847,1440,7395
1744.65,2,27,864,27,8,67101,8,864,0,0,0,0,0
1777.394,17,142,11360,71,48,25390,48,5396,71,56,25390,56,5964
1799.153,1,57,4788,0,0,0,0,0,57,56,32127,56,4788
1799.577,17,448,39612,404,35,4465,288,25708,44,288,40951,288,13904
1792.552,17,180,14040,180,50,10014,50,14040,0,0,0,0,0
3.134,6,3,541,2,0,3134,0,80,1,421,0,421,461
1740.402,17,28,29568,28,1028,64459,1028,29568,0,0,0,0,0
72.821,6,31,7742,12,169,6620,267,1671,19,441,4037,1420,6071
1738.536,1,56,4704,56,56,31609,56,4704,0,0,0,0,0
153.1,6,22,8752,11,314,71,634,1415,11,983,15295,1360,7337
3.636,17,5,290,5,30,909,30,290,0,0,0,0,0
1.069,6,24,6551,13,333,87,1005,2191,11,783,104,1460,4360
0.027,1,2,748,2,346,27,346,748,0,0,0,0,0
49.248,6,458,205657,233,816,212,1152,191493,225,396,218,1152,14164
1740.461,17,29,6815,29,207,62159,207,6815,0,0,0,0,0
283.551,6,35,7977,13,143,23629,267,1386,22,407,13496,1400,6591
0.546,6,3,151,1,31,0,31,71,2,0,546,0,80
603.216,1,18,1008,18,28,35483,28,1008,0,0,0,0,0
1794.047,6,364,23323,208,69,8666,69,12529,156,69,11574,69,10794
3.816,1,9,936,0,0,0,0,0,9,76,477,76,936
37.884,1,43,4472,0,0,0,0,0,43,76,902,76,4472
0.228,17,2,588,1,39,0,39,67,1,493,0,493,521
0.165,6,10,1669,6,551,33,947,1346,4,159,55,159,323
5.253,6,39,7269,21,218,262,314,3463,18,513,292,1179,3806
1772.432,6,180,15480,120,69,14894,69,8940,60,69,30034,69,6540
1794.26,17,144,11520,72,48,25271,48,5472,72,56,25271,56,6048
1118.689,17,220,16720,220,48,5108,48,16720,0,0,0,0,0
125.38,6,20,4390,8,296,17911,722,1301,12,307,11381,1440,3089
1708.636,6,440,70792,240,304,7149,304,49340,200,83,8585,83,21452
1794.355,17,87,3648,86,14,21110,14,3612,1,8,0,8,36
28.312,6,16,2373,10,211,3142,211,974,6,545,5654,904,1399
1.468,6,30,10318,17,356,91,801,1753,13,1005,105,1420,8565
189.104,6,177,141430,114,1318,1673,1408,127221,63,606,2685,1408,14209
280.568,6,27,7312,12,158,25506,267,1277,15,775,20035,3465,6035
240.175,6,52,17074,27,760,9237,1402,14344,25,177,10007,580,2730
1777.286,1,73,4088,73,28,24684,28,4088,0,0,0,0,0
378.508,2,4,128,4,8,126169,8,128,0,0,0,0,0
0.211,6,4,493,2,241,211,241,321,2,92,4,92,172
1772.985,6,180,15480,120,69,14899,69,8940,60,69,30044,69,6540
0.586,6,23,7406,13,335,48,668,2026,10,1210,60,2736,5380
66.322,6,27,7177,13,155,5526,267,1306,14,530,5100,3417,5871
32.162,6,49,10052,24,450,674,766,2877,25,410,1335,3488,7175
0.005,17,2,251,1,36,0,36,64,1,159,0,159,187
7.072,6,40,7309,20,218,372,314,3423,20,513,356,1179,3886
6.749,6,604,528212,379,1326,17,1368,511848,225,776,29,1473,16364
280.056,6,28,7352,13,158,23338,267,1317,15,678,19999,2800,6035
20.196,6,23,5522,13,107,1683,159,1126,10,773,2239,1418,4396
0.023,17,2,466,1,33,0,33,61,1,377,0,377,405
1.48,17,18,10632,9,881,183,1350,8181,9,244,180,1350,2451
147.988,17,3,528,3,148,73994,352,528,0,0,0,0,0
1796.185,17,449,39928,404,35,4457,288,25708,45,288,40020,288,14220
1734.377,17,144,24426,144,141,12128,389,24426,0,0,0,0,0
70.903,6,38,10376,17,296,4431,469,3949,21,348,3518,1460,6427
1.455,17,4,252,3,31,726,31,177,1,47,0,47,75
1788.124,6,362,22898,210,69,8555,69,12678,152,69,11841,69,10220
1772.62,6,180,15480,120,69,14895,69,8940,60,69,30040,69,6540
1776.214,17,75,3141,73,13,24667,14,3061,2,12,1776034,16,80
300.248,6,91,14765,45,275,6823,1408,7603,46,215,6672,1408,7162
280.249,6,29,7392,13,158,23354,267,1317,16,603,18680,2036,6075
6.364,6,1012,930979,400,953,15,1460,28181,612,1458,10,4380,902798
0.11,6,13,2100,7,329,18,500,1030,6,375,22,500,1070
1739.283,6,87,6322,58,31,30513,31,3915,29,31,62116,31,2407
1791.025,1,58,4872,58,56,31421,56,4872,0,0,0,0,0
0.08,17,4,588,2,48,66,48,152,2,190,66,308,436
240.219,6,58,15384,28,672,8896,1418,12228,30,198,8282,580,3156
0.056,17,3,244,2,32,14,32,120,1,96,0,96,124
541.806,17,16,5376,16,308,36120,308,5376,0,0,0,0,0
300.247,6,31,11831,17,592,18765,1402,4456,14,948,18482,2804,7375
274.573,6,2455,1281532,1429,830,192,1152,1229563,1026,376,267,1179,51969
0.365,6,25,8816,13,227,30,547,1592,12,1098,31,2816,7224
34.235,17,10,760,10,48,3803,48,760,0,0,0,0,0
0.184,6,9,1339,5,145,46,145,349,4,826,46,826,990
1707.796,6,104,13193,61,73,28463,722,5515,43,248,14861,1440,7678
300.702,6,39,8606,20,315,15826,882,2093,19,441,473,1460,6513
1.255,6,23,6511,13,333,103,1005,2191,10,979,137,1691,4320
85.133,6,31,13216,15,488,342,1460,3075,16,948,5666,1460,10141
280.207,6,29,7392,13,158,23350,267,1317,16,603,18679,1400,6075
0.078,17,2,152,1,48,0,48,76,1,48,0,48,76
13.775,6,82,24837,42,561,335,1152,19080,40,461,346,1179,5757
1742.656,6,111,8062,68,31,26009,31,4669,43,31,41491,31,3393
9.981,6,81,24461,42,550,243,1152,18760,39,459,255,1179,5701
253.507,6,60,10109,27,343,9749,1056,6229,33,151,7921,580,3880
0.54,6,14,1745,7,288,62,288,600,7,426,61,434,1145
1784.198,6,281,51672,183,316,9803,316,38904,98,83,18393,83,12768
1796.922,1,340,28560,340,56,5300,56,28560,0,0,0,0,0
87.132,6,38,11580,9,155,1306,267,1146,29,385,3111,1460,10434
0.275,6,21,5000,10,137,30,267,1092,11,692,25,1467,3908
1641.935,1,20,1120,20,28,86417,28,1120,0,0,0,0,0
1745.82,6,95,7203,63,38,28158,205,4476,32,33,56303,98,2727
1792.001,6,367,23236,212,69,8492,69,12896,155,69,11636,69,10340
2.696,17,27,18594,12,505,244,1350,6404,15,784,190,1350,12190
301.341,6,37,15843,20,770,15850,1360,6252,17,889,18822,3639,9591
17.757,17,14,6792,7,613,2954,1350,4490,7,300,2954,1350,2302
3.946,17,5,295,5,31,986,31,295,0,0,0,0,0
358.376,2,6,192,6,8,71675,8,192,0,0,0,0,0
0.325,17,4,368,2,32,322,32,120,2,96,309,96,248
300.96,6,43,13799,22,795,14323,1360,8095,21,346,15039,1360,5704
1728.247,1,8,848,8,78,246892,78,848,0,0,0,0,0
1772.563,17,182,43122,182,208,9793,422,43122,0,0,0,0,0
3.01,17,4,842,2,47,3000,47,150,2,318,3000,318,692
1785.86,6,352,22360,204,69,8797,69,12300,148,69,12148,69,10060
1792.141,17,83,3480,82,14,22125,14,3444,1,8,0,8,36
1795.368,17,89,3737,87,14,20876,15,3655,2,13,257044,18,82
0.39,6,21,7203,13,318,32,600,1958,8,964,53,1471,5245
332.734,6,70,12289,24,105,10554,267,2229,46,200,7393,1420,10060
2.007,17,3,468,3,128,1003,128,468,0,0,0,0,0
5.732,17,5,364,4,32,1226,32,240,1,96,0,96,124
1787.543,6,357,22629,208,69,8635,69,12460,149,69,12077,69,10169
1783.129,17,83,3480,82,14,22013,14,3444,1,8,0,8,36
4.989,6,39,7269,19,218,277,314,3383,20,513,247,1179,3886
292.969,1,4,326,4,53,97656,78,326,0,0,0,0,0
1795.329,17,448,39896,403,35,4465,288,25676,45,288,40014,288,14220
2.73,17,3,1164,3,360,1365,360,1164,0,0,0,0,0
1.385,6,19,3781,10,234,153,564,1452,9,463,150,1343,2329
0.062,17,2,544,1,128,0,128,156,1,360,0,360,388
1799.569,17,454,152544,454,308,3972,308,152544,0,0,0,0,0
254.488,6,47,8619,24,518,11064,1418,5946,23,160,11566,580,2673
1796.722,17,449,39928,404,35,4458,288,25708,45,288,40020,288,14220
0.506,6,4,220,2,0,506,0,100,2,0,302,0,120
1798.629,6,363,24414,212,88,8524,469,14027,151,69,11987,69,10387
1796.814,6,356,22520,208,69,8680,69,12460,148,69,12222,69,10060
19.834,6,66,21922,34,714,601,1360,15699,32,409,632,1360,6223
1748.306,6,95,7203,63,38,28198,205,4476,32,33,56384,98,2727
261.343,6,6,364,4,31,87114,31,222,2,31,261324,31,142
0.165,6,2,142,1,62,0,62,102,1,0,0,0,40
460.342,17,12,4032,12,308,41849,308,4032,0,0,0,0,0
0.03,17,2,399,1,39,0,39,67,1,304,0,304,332
0.117,6,15,5908,8,103,16,103,527,7,1252,19,1472,5381
3.949,17,5,290,5,30,987,30,290,0,0,0,0,0
1799.923,1,336,28224,336,56,5372,56,28224,0,0,0,0,0
89.624,6,25,9762,12,524,63,1460,2610,13,945,7457,1460,7152
7.446,6,7,300,2,0,7274,0,84,5,0,1818,0,216
316.984,6,69,19615,35,324,9323,1360,9234,34,429,9601,2720,10381
300.838,6,46,10345,23,433,13674,910,3166,23,347,588,2128,7179
6.642,6,41,7642,20,224,349,314,3716,21,440,319,1152,3926
481.29,2,4,128,4,8,160430,8,128,0,0,0,0,0
15.888,17,12,5225,6,490,3165,1350,3109,6,324,3162,1350,2116
0.095,6,9,1148,5,145,23,145,349,4,635,19,635,799
0.758,6,27,5927,13,156,63,267,1462,14,650,53,1420,4465
1719.722,17,12,498,11,14,171972,14,462,1,8,0,8,36
301.075,6,50,10204,26,366,12043,766,2976,24,347,673,3488,7228
0.124,6,9,1002,5,213,31,213,417,4,421,39,421,585
16.547,6,869,760390,530,1358,30,1368,736550,339,665,48,1368,23840
182.612,6,429,431988,156,169,1177,520,8465,273,1586,671,8760,423523
149.044,17,8,1856,8,204,21292,204,1856,0,0,0,0,0
6.19,6,34,8108,18,317,364,636,1715,16,521,399,2720,6393
0.041,17,2,166,1,39,0,39,67,1,71,0,71,99
0.766,6,13,1981,7,288,125,288,876,6,426,112,434,1105
0.523,6,23,7428,14,273,40,663,2104,9,1209,58,1946,5324
1788.947,6,356,22520,208,69,8642,69,12460,148,69,12166,69,10060
1770.647,6,101,9410,66,66,27240,66,5610,35,60,52075,60,3800
1185.455,6,261,46377,166,304,7184,304,34168,95,83,12598,83,12209
17.298,17,25,14301,13,840,1439,1350,11286,12,223,1569,1350,3015
379.777,6,18,1242,14,180,29213,180,916,4,110,20062,110,326
1734.78,1,40,4240,40,78,44481,78,4240,0,0,0,0,0
7.138,2,2,64,2,8,7138,8,64,0,0,0,0,0
53.053,6,38,9884,18,706,532,1460,4282,20,399,2783,1460,5602
0.51,6,23,7428,14,273,39,663,2104,9,1209,58,1946,5324
1.245,6,50,19253,27,888,47,1360,13557,23,433,48,1360,5696
170.119,6,25,9968,12,549,65,1440,2709,13,961,14164,1440,7259
188.822,17,4,240,2,32,188821,32,120,2,32,188821,32,120
1737.267,1,56,4704,56,56,31586,56,4704,0,0,0,0,0
265.551,6,3396,3595862,1074,778,247,1448,80045,2322,1476,114,4344,3515817
1771.432,6,101,9410,66,66,27252,66,5610,35,60,52098,60,3800
1.654,6,78,52023,43,1274,39,1448,44298,35,842,43,1448,7725
0.161,6,44,21188,26,1084,6,1420,16247,18,467,9,1883,4941
374.125,6,27,1767,18,177,22007,177,1181,9,110,8903,110,586
1633.383,6,126,8064,69,52,24020,208,4916,57,31,29163,31,3148
16.84,6,22,6456,8,154,2405,267,792,14,637,1269,1420,5664
2.574,17,4,1564,4,363,858,363,1564,0,0,0,0,0
4.377,6,34,15692,18,894,257,1360,6141,16,889,280,3639,9551
41.408,6,26,6797,12,181,3764,267,1212,14,627,3184,1400,5585
5.032,6,41,7349,21,218,251,314,3463,20,440,251,1152,3886
13.277,6,49,13964,23,522,591,1152,8757,26,462,520,1152,5207
2.297,6,12,2271,7,188,382,245,660,5,1407,511,1407,1611
1740.495,17,30,7050,30,207,60017,207,7050,0,0,0,0,0
75.396,6,40,8669,20,226,3968,585,2907,20,427,3934,960,5762
300.33,6,41,19914,21,419,15016,1130,2814,20,1003,3224,1546,17100
11.811,6,1872,1630112,1128,1391,10,1420,1596131,744,467,15,1883,33981
0.986,6,24,9127,13,312,82,889,1800,11,982,81,1440,7327
0.478,6,52,20956,29,969,17,1380,15749,23,387,19,1923,5207
0.372,6,49,20914,27,1048,14,1380,15792,22,421,16,1923,5122
117.13,6,33,7847,11,155,11713,267,1226,22,337,5576,1452,6621
1797.594,17,142,11360,71,48,25679,48,5396,71,56,25679,56,5964
1258.969,17,14,1117,7,31,209825,37,413,7,72,209825,136,704
6.195,6,2014,1913941,1304,1391,4,1408,1872357,710,931,8,2816,41584
280.512,6,31,7472,13,158,23376,267,1317,18,603,16497,2760,6155
32.957,17,4,240,2,32,32956,32,120,2,32,32955,32,120
4.26,6,38,7229,19,218,236,314,3383,19,513,221,1179,3846
0.749,6,35,8271,19,271,41,738,1877,16,574,40,4848,6394
300.873,6,36,8525,18,309,17689,891,1989,18,446,17689,2720,6536
368.344,6,18,1242,14,180,28334,180,916,4,110,20059,110,326
1720.915,17,12,498,11,14,172091,14,462,1,8,0,8,36
4.968,6,42,7389,22,218,236,314,3503,20,513,248,1179,3886
126.867,6,46,10430,21,220,6343,721,3704,25,476,5278,2840,6726
4.6,6,39,7269,20,218,242,314,3423,19,440,241,1152,3846
1.3,6,47,18591,27,850,50,1360,13015,20,476,59,2715,5576
1740.089,6,87,6322,58,31,30527,31,3915,29,31,62145,31,2407
0.187,17,2,2380,2,1162,187,1162,2380,0,0,0,0,0
1772.06,6,180,15480,120,69,14891,69,8940,60,69,30031,69,6540
1793.583,17,87,3648,86,14,21100,14,3612,1,8,0,8,36
1770.246,6,99,9240,66,65,27234,65,5577,33,59,55315,59,3663
1719.493,1,25,2919,25,88,71645,173,2919,0,0,0,0,0
3.535,17,33,12205,15,384,250,1350,6181,18,306,206,1350,6024
0.064,17,2,341,1,64,0,64,92,1,221,0,221,249
68.463,6,23,10009,12,531,62,1360,2637,11,1384,6832,3934,7372
42.228,17,12,912,12,48,3838,48,912,0,0,0,0,0
5.386,17,4,4283,4,1042,1795,1234,4283,0,0,0,0,0
11.701,6,2158,2010980,1378,1381,8,1408,1965756,780,931,14,2816,45224
1799.816,17,449,39928,404,35,4466,288,25708,45,288,40018,288,14220
1.357,6,52,22491,29,975,48,1440,16795,23,433,53,1440,5696
99.815,6,10,768,2,31,1,31,135,8,31,2879,31,633
1.014,6,10,1687,7,100,169,100,384,3,1179,374,1179,1303
252.11,2,3,96,3,8,126055,8,96,0,0,0,0,0
300.237,6,30,11783,17,592,18764,1408,4461,13,1106,20020,2816,7322
101.161,6,34,25465,20,884,40,1360,6149,14,2082,7770,10179,19316
1624.313,2,17,544,17,8,101519,8,544,0,0,0,0,0
47.133,6,52,11186,27,812,342,1360,5246,25,352,1956,4027,5940
69.026,6,30,7297,14,155,5309,267,1346,16,441,4601,1420,5951
312.421,6,23,5479,9,133,39052,159,887,14,967,24031,1669,4592
51.05,6,6576,6388027,4282,1413,11,1448,6264063,2294,776,22,1448,123964
1.456,17,20,6208,8,282,208,1350,2480,12,282,71,1350,3728
56.454,17,19,6566,9,432,7050,1350,4147,10,213,6265,1350,2419
1008.39,2,8,256,8,8,144055,8,256,0,0,0,0,0
1784.033,17,142,11360,71,48,25485,48,5396,71,56,25485,56,5964
0.261,6,25,6116,12,181,23,537,1526,13,651,20,1408,4590
1799.691,17,142,11360,71,48,25709,48,5396,71,56,25709,56,5964
300.515,6,36,8391,20,291,15816,786,1997,16,522,560,3488,6394
1790.656,17,142,11360,71,48,25580,48,5396,71,56,25580,56,5964
1796.349,1,284,30104,284,78,6347,78,30104,0,0,0,0,0
1740.401,17,29,6815,29,207,62157,207,6815,0,0,0,0,0
3.356,6,16,3676,8,150,479,174,624,8,681,465,1420,3052
86.95,1,4,424,4,78,28983,78,424,0,0,0,0,0
0.185,17,4,284,2,32,62,32,120,2,54,124,60,164
3.232,17,5,356,4,40,1049,40,272,1,56,0,56,84
1758.593,1,216,22896,216,78,8179,78,22896,0,0,0,0,0
99.262,6,862,406069,446,836,223,1152,383567,416,418,238,1179,22502
0.05,17,2,198,1,39,0,39,67,1,103,0,103,131
9.509,6,6,1197,6,177,1901,177,1197,0,0,0,0,0
11.506,6,86,24645,43,533,273,1152,18784,43,459,267,1179,5861
6.385,6,45,8409,24,227,277,314,4142,21,489,305,1179,4267
0.621,6,130,79867,66,1302,9,1420,73014,64,420,9,1420,6853
13.662,6,119,44698,63,675,220,1152,38349,56,456,243,1179,6349
1793.845,17,140,11200,70,48,25997,48,5320,70,56,25997,56,5880
2.964,17,3,1021,2,308,1970,308,672,1,321,0,321,349
1798.084,17,142,11360,71,48,25686,48,5396,71,56,25686,56,5964
71.621,17,8,608,8,48,10231,48,608,0,0,0,0,0
6.372,6,904,756994,521,1369,11,1408,732414,383,931,16,2816,24580
0.007,17,2,363,1,39,0,39,67,1,268,0,268,296
2.895,17,4,292,2,37,2888,37,130,2,53,2887,53,162
1.286,6,47,19837,27,939,49,1460,14261,20,433,58,1460,5576
0.282,17,2,384,1,39,0,39,67,1,289,0,289,317
0.467,6,20,4960,10,137,51,267,1092,10,692,47,1467,3868
1681.797,17,18,1413,9,30,210223,37,529,9,70,210222,136,884
1720.445,17,12,498,11,14,172044,14,462,1,8,0,8,36
1.267,6,46,19158,27,893,48,1360,13622,19,476,61,2715,5536
61.683,6,57,36757,36,1126,1762,1448,28911,21,843,3072,2359,7846
8.027,17,6,528,3,48,4006,48,228,3,72,4006,72,300
1.436,6,39,8294,19,321,79,1164,2718,20,433,66,1440,5576
58.678,6,1129,1353111,554,619,106,1368,41915,575,2300,102,10944,1311196
1795.555,17,447,39864,402,35,4477,288,25644,45,288,40016,288,14220
1794.136,17,80,3354,79,14,23001,14,3318,1,8,0,8,36
1782.487,6,372,23574,213,69,8407,69,13074,159,69,11281,69,10500
1752.568,17,248,55407,248,195,7095,422,55407,0,0,0,0,0
1749.681,17,12,498,11,14,174968,14,462,1,8,0,8,36
1784.139,17,142,11360,71,48,25487,48,5396,71,56,25487,56,5964
424.504,6,28,2127,18,64,24970,64,1232,10,55,47158,58,895
0.114,17,2,192,1,37,0,37,65,1,99,0,99,127
1786.845,6,403,24847,213,69,8428,69,12798,190,45,9453,69,12049
1798.076,6,356,22520,208,69,8686,69,12460,148,69,12230,69,10060
0.127,17,2,152,1,48,0,48,76,1,48,0,48,76
27.681,6,30,7432,13,158,2306,267,1317,17,603,1725,2076,6115
88.263,17,4,352,2,60,88262,60,176,2,60,88262,60,176
1740.142,6,87,6322,58,31,30528,31,3915,29,31,62147,31,2407
1763.707,6,122,12417,66,66,27132,517,4636,56,242,32065,2448,7781
504.358,2,3,96,3,8,252179,8,96,0,0,0,0,0
139.498,6,22,4556,14,483,10730,483,3634,8,83,19926,83,922
1783.831,6,365,23087,211,69,8494,69,12787,154,69,11658,69,10300
1794.317,17,144,11520,72,48,25271,48,5472,72,56,25272,56,6048
1794.431,6,356,22520,208,69,8668,69,12460,148,69,12206,69,10060
1745.339,6,99,7442,64,38,27703,205,4528,35,33,51326,98,2914
1795.98,6,367,25650,214,99,8431,469,15045,153,69,11814,69,10605
18.207,6,25,4470,14,275,1400,275,1126,11,1440,1490,1440,3344
20.446,17,8,1412,4,48,6811,48,304,4,249,6812,308,1108
130.163,1,6,336,6,28,26032,28,336,0,0,0,0,0
281.251,1,2,112,2,28,281251,28,112,0,0,0,0,0
1770.156,6,208,15860,76,64,23600,293,7274,132,49,13512,78,8586
305.679,6,558,482447,351,1396,873,1460,466617,207,209,65,1460,15830
1772.533,6,180,15480,120,69,14895,69,8940,60,69,30040,69,6540
1674.121,1,10,1090,10,81,186013,88,1090,0,0,0,0,0
1788.339,1,20,1120,20,28,94123,28,1120,0,0,0,0,0
1740.716,6,87,6322,58,31,30538,31,3915,29,31,62167,31,2407
125.384,6,14,3144,7,92,20897,92,452,7,464,20866,1408,2692
0.953,6,29,9423,16,196,63,517,2213,13,652,65,1408,7210
854.429,17,209,20528,101,114,8488,1350,14355,108,29,7985,60,6173
280.449,6,28,7352,12,158,25495,267,1277,16,678,18693,2085,6075
280.198,6,28,7352,13,158,23349,267,1317,15,678,20010,2800,6035
1.071,6,58,38610,36,351,30,351,2231,22,1854,50,4224,36379
1800.0,6,228,18369,86,79,20823,364,9234,142,50,12765,143,9135
29.223,17,33,9714,13,321,2433,1350,4543,20,230,1536,1350,5171
161.205,6,119,89631,75,1276,2178,1448,79228,44,675,1958,1448,10403
1786.536,6,106,8524,68,66,26664,66,4964,38,60,48282,60,3560
1.394,6,40,11338,22,547,66,1360,5842,18,476,71,2720,5496
0.039,17,3,1063,3,326,19,354,1063,0,0,0,0,0
1772.866,1,236,13216,236,28,7544,28,13216,0,0,0,0,0
1797.103,17,144,11520,72,48,25311,48,5472,72,56,25311,56,6048
29.119,6,30,7297,14,155,2239,267,1346,16,441,1940,1420,5951
8.373,17,2,121,2,32,8373,33,121,0,0,0,0,0
4.251,6,49,43427,36,251,121,251,2382,13,4484,353,11216,41045
1092.084,1,16,896,16,28,72805,28,896,0,0,0,0,0
19.759,17,32,13562,15,388,1409,1350,6250,17,402,1232,1350,7312
254.128,6,156,63306,77,787,3343,1152,55877,79,387,3254,1179,7429
1768.614,1,58,4872,58,56,31028,56,4872,0,0,0,0,0
1791.268,6,359,22709,209,69,8611,69,12569,150,69,12019,69,10140
1788.293,1,134,7504,134,28,13445,28,7504,0,0,0,0,0
23.632,6,89,27082,45,549,537,1152,20499,44,438,542,1179,6583
24.542,6,60,19615,30,610,846,1152,15244,30,452,837,1179,4371
1784.017,6,354,22440,207,69,8660,69,12420,147,69,12218,69,10020
81.982,17,4,352,2,60,81981,60,176,2,60,81981,60,176
1.098,17,22,9447,10,531,122,1350,5593,12,293,83,1350,3854
0.047,17,2,214,1,39,0,39,67,1,119,0,119,147
1799.043,1,345,28980,345,56,5229,56,28980,0,0,0,0,0
29.11,17,18,1584,9,48,3631,48,684,9,72,3630,72,900
0.505,6,12,1653,6,288,96,288,548,6,426,56,434,1105
177.263,2,3,96,3,8,88631,8,96,0,0,0,0,0
10.764,6,19,7010,11,275,1076,275,998,8,1893,856,2840,6012
1680.687,17,12,498,11,14,168068,14,462,1,8,0,8,36
55.841,6,27,7177,13,155,4653,267,1306,14,530,4294,3417,5871
192.06,6,14,5708,5,106,48015,106,314,9,718,23983,1420,5394
1745.087,6,95,7203,63,38,28146,205,4476,32,33,56279,98,2727
1785.118,17,128,10240,64,48,28335,48,4864,64,56,28335,56,5376
3.151,6,10,427,5,0,744,0,208,5,7,745,7,219
1776.154,17,73,3060,72,14,25016,14,3024,1,8,0,8,36
1681.22,1,15,840,15,28,120087,28,840,0,0,0,0,0
1743.094,6,94,7151,62,38,28575,205,4424,32,33,56218,98,2727
1795.117,1,73,6132,0,0,0,0,0,73,56,24932,56,6132
11.556,6,39,8010,18,218,679,314,3343,21,477,565,1152,4667
255.29,6,6,362,5,106,63822,106,314,1,0,0,0,48
31.52,6,7,308,1,0,0,0,44,6,0,6285,0,264
96.97,6,31,8074,10,155,10774,267,1186,21,355,4833,1460,6888
61.838,17,6,456,6,48,12367,48,456,0,0,0,0,0
1784.983,17,83,3480,82,14,22036,14,3444,1,8,0,8,36
0.082,17,2,154,1,33,0,33,61,1,65,0,65,93
0.345,17,2,144,1,36,0,36,64,1,52,0,52,80
1795.681,17,446,39832,401,35,4489,288,25612,45,288,40019,288,14220
902.42,2,8,256,8,8,128917,8,256,0,0,0,0,0
300.273,6,33,15523,20,974,15803,1402,9834,13,715,5107,2804,5689
280.247,6,30,7432,13,158,23353,267,1317,17,543,17510,1400,6115
38.687,17,11,836,11,48,3868,48,836,0,0,0,0,0
4.009,6,40,7309,20,218,211,314,3423,20,440,198,1152,3886
3.873,17,10,900,5,30,953,30,290,5,94,955,94,610
1.006,6,3,160,2,0,965,0,120,1,0,0,0,40
1787.343,6,102,8296,68,65,26676,65,4930,34,59,54158,59,3366
70.402,17,2,368,2,156,70402,156,368,0,0,0,0,0
1795.646,17,142,11360,71,48,25651,48,5396,71,56,25651,56,5964
121.222,6,23,10009,12,531,65,1360,2637,11,1384,12108,3934,7372
1394.006,6,97,10554,65,65,21781,722,5685,32,123,37947,2330,4869
1769.439,6,107,9999,71,65,25277,65,6003,36,59,50552,59,3996
22.053,6,46,15050,23,905,413,1460,9099,23,358,994,1460,5951
1785.45,17,142,11360,71,48,25506,48,5396,71,56,25506,56,5964
0.499,6,6,359,4,43,166,43,259,2,0,15,0,100
280.648,6,30,7501,13,158,23387,267,1317,17,550,17527,2036,6184
1771.105,6,120,11054,75,65,23933,65,6365,45,59,40249,59,4689
0.223,17,2,152,1,48,0,48,76,1,48,0,48,76
2.45,6,10,1102,6,483,490,483,803,4,83,814,83,299
185.455,6,4217,3704059,2550,1366,72,1368,3605273,1667,899,111,1473,98786
1785.89,17,312,23712,312,48,5742,48,23712,0,0,0,0,0
0.969,6,2,104,1,0,0,0,52,1,0,0,0,52
1729.163,6,62,4504,40,33,44337,33,2740,22,31,82333,31,1764
1789.242,6,359,22709,209,69,8602,69,12569,150,69,12005,69,10140
1796.88,17,448,39896,403,35,4469,288,25676,45,288,40019,288,14220
11.268,6,27,11373,13,275,939,275,1078,14,1080,836,1420,10295
186.021,17,6,528,3,60,93010,60,264,3,60,93010,60,264
1770.457,6,99,9240,66,65,27237,65,5577,33,59,55324,59,3663
5.238,6,38,7229,20,218,275,314,3423,18,513,291,1179,3806
1785.682,17,140,11200,70,48,25879,48,5320,70,56,25879,56,5880
16.289,6,19,4190,10,275,1809,275,958,9,952,1420,1380,3232
221.081,6,29,7392,13,158,18423,267,1317,16,678,14734,3456,6075
1787.109,17,87,3648,86,14,21024,14,3612,1,8,0,8,36
4.144,17,2,152,2,48,4144,48,152,0,0,0,0,0
1784.415,6,104,8308,68,64,26633,64,4896,36,58,50980,58,3412
0.071,17,2,181,1,34,0,34,62,1,91,0,91,119
1798.366,17,448,39896,403,35,4473,288,25676,45,288,40021,288,14220
15.46,17,15,7520,7,505,2569,1350,3737,8,444,2202,1350,3783
3.876,17,4,240,4,32,1292,32,240,0,0,0,0,0
1.28,6,50,18896,27,863,49,1360,13200,23,433,50,1360,5696
0.271,6,10,1060,5,517,45,517,785,5,7,45,7,275
11.593,6,23,4280,14,210,836,210,1822,9,664,1448,904,2458
2.884,17,8,720,4,30,961,30,232,4,94,960,94,488
15.917,6,25,7026,6,154,3183,267,712,19,396,880,1460,6314
1794.89,6,215,18891,107,119,16932,208,13362,108,31,16772,31,5529
1.99,17,22,5698,22,231,94,388,5698,0,0,0,0,0
136.709,17,6,525,3,32,68323,37,181,3,86,68330,136,344
1.112,6,24,8004,12,164,86,267,1288,12,1014,85,2804,6716
148.601,6,23,10009,12,531,67,1360,2637,11,1384,14846,2720,7372
4.93,17,5,4754,5,922,1232,1451,4754,0,0,0,0,0
280.573,6,26,7272,12,158,25506,267,1277,14,775,21572,3465,5995
1777.595,17,73,3060,72,14,25036,14,3024,1,8,0,8,36
0.064,6,12,2903,6,126,12,126,446,6,713,12,1448,2457
280.657,6,29,7733,13,158,23388,267,1317,16,641,18709,2045,6416
20.107,6,21,5418,12,107,1827,159,1074,9,967,2512,2816,4344
10.154,6,14,4929,8,429,78,517,1283,6,834,2005,1400,3646
1771.267,6,99,9306,66,66,27250,66,5610,33,60,55348,60,3696
0.52,17,3,451,2,39,117,39,134,1,289,0,289,317
1794.231,17,144,11520,72,48,25270,48,5472,72,56,25270,56,6048
0.39,17,8,2750,8,315,55,354,2750,0,0,0,0,0
179.66,17,16,1280,8,48,25664,48,608,8,56,25664,56,672
1789.964,6,357,22629,208,69,8647,69,12460,149,69,12094,69,10169
1773.452,6,180,15480,120,69,14902,69,8940,60,69,30051,69,6540
124.612,6,7,292,3,0,62306,0,124,4,0,41448,0,168
128.771,6,37,16739,19,488,300,1460,3283,18,1060,7554,2368,13456
1.002,17,2,116,2,30,1002,30,116,0,0,0,0,0
85.412,6,40,9781,16,287,2249,1189,2951,24,418,3712,1917,6830
28.586,6,37,8495,18,410,512,882,1982,19,441,1580,1440,6513
4.585,17,28,10144,12,450,416,1350,5744,16,247,254,1350,4400
137.98,6,15,4385,8,674,128,1360,3038,7,527,22968,903,1347
0.389,6,26,9017,13,261,32,683,1728,13,943,30,1438,7289
0.036,17,4,284,2,32,21,32,120,2,54,16,60,164
0.954,6,25,8044,13,164,79,267,1328,12,869,70,1408,6716
285.046,6,27,7312,11,158,28504,267,1237,16,603,18999,2036,6075
1788.91,17,87,3648,86,14,21046,14,3612,1,8,0,8,36
1.077,6,25,8056,12,164,83,267,1288,13,869,76,1402,6768
243.918,6,15,1481,5,191,12,191,459,10,247,27100,462,1022
1771.395,6,101,9344,66,65,27252,65,5577,35,59,52097,59,3767
165.235,17,4,352,2,60,165234,60,176,2,60,165233,60,176
1797.363,1,174,9744,174,28,10389,28,9744,0,0,0,0,0
204.842,6,73,49423,46,1169,4552,1408,39878,27,813,2369,1408,9545
110.015,6,20,9425,11,537,84,1306,2084,9,1393,13729,3639,7341
298.841,17,6,528,3,60,149420,60,264,3,60,149420,60,264
0.06,17,2,235,1,36,0,36,64,1,143,0,143,171
0.232,6,10,1671,6,552,46,948,1348,4,159,77,159,323
1.363,17,4,314,2,31,1332,31,118,2,70,1317,70,196
1.232,6,46,18125,26,882,49,1360,12549,20,476,56,2715,5576
121.824,6,23,10128,13,549,55,1360,2749,10,1393,13520,3934,7379
33.971,17,10,880,5,48,8490,48,380,5,72,8490,72,500
1773.256,6,181,15589,120,69,14901,69,8940,61,69,29549,69,6649
0.572,1,10,280,10,0,0,0,280,0,0,0,0,0
59.944,17,7,448,7,36,9990,36,448,0,0,0,0,0
1794.373,17,144,11520,72,48,25272,48,5472,72,56,25272,56,6048
1795.225,17,80,3354,79,14,23015,14,3318,1,8,0,8,36
45.122,6,37,8495,18,410,508,882,1982,19,478,2499,2720,6513
1772.304,6,180,15480,120,69,14893,69,8940,60,69,30034,69,6540
1789.953,6,371,23465,213,69,8443,69,13005,158,69,11400,69,10460
1.388,6,47,18672,26,921,55,1460,13056,21,433,59,1460,5616
1740.444,17,28,29568,28,1028,64460,1028,29568,0,0,0,0,0
1790.557,6,359,22778,209,69,8608,69,12500,150,69,12017,69,10278
0.468,6,50,21512,28,1014,17,1380,16390,22,421,19,1923,5122
1776.058,1,58,4872,58,56,31158,56,4872,0,0,0,0,0
300.86,6,43,13670,24,889,13080,1360,8108,19,399,478,1360,5562
65.599,17,4,352,2,60,65598,60,176,2,60,65598,60,176
1793.165,1,272,15232,272,28,6616,28,15232,0,0,0,0,0
0.334,6,25,8832,13,236,27,585,1630,12,1095,29,2804,7202
0.82,6,34,8235,19,272,45,743,1881,15,574,48,4848,6354
1056.974,6,63,4857,37,44,26728,205,2721,26,34,42271,98,2136
367.018,6,17,1190,13,180,30584,180,864,4,110,20058,110,326
178.215,17,8,2688,8,308,25459,308,2688,0,0,0,0,0
0.46,6,22,7345,13,334,38,663,2021,9,1209,52,1946,5324
0.05,1,2,163,2,53,50,78,163,0,0,0,0,0
1768.816,6,101,9344,66,65,27212,65,5577,35,59,52020,59,3767
78.104,17,4,240,2,32,78103,32,120,2,32,78103,32,120
1.98,17,3,201,3,39,990,39,201,0,0,0,0,0
1790.022,17,87,3648,86,14,21059,14,3612,1,8,0,8,36
0.023,17,2,212,1,46,0,46,74,1,110,0,110,138
0.204,17,4,1440,4,332,68,355,1440,0,0,0,0,0
125.11,6,32,7717,12,155,28,267,1266,20,376,6584,3417,6451
0.395,6,85,59288,51,1289,7,1432,53637,34,427,11,1432,5651
1749.464,6,106,7806,63,38,28217,205,4476,43,33,41647,98,3330
136.422,17,4,352,2,60,136421,60,176,2,60,136421,60,176
1756.143,6,105,6240,60,26,29764,26,3510,45,26,39911,26,2730
1.939,6,13,3522,6,75,387,75,395,7,1373,323,1448,3127
0.846,6,2,1134,1,0,0,0,40,1,1054,0,1054,1094
4.979,17,4,558,2,36,4969,36,128,2,187,4969,187,430
1797.203,17,32,10772,32,308,57974,382,10772,0,0,0,0,0
4.382,6,39,7269,20,218,230,314,3423,19,513,228,1179,3846
14.906,6,6,328,4,0,4968,0,216,2,0,14899,0,112
1401.123,17,12,3278,6,30,280209,30,348,6,460,280223,463,2930
0.015,17,2,456,2,200,15,353,456,0,0,0,0,0
15.591,17,12,5244,6,490,3103,1350,3109,6,327,3101,1350,2135
1740.615,17,30,31680,30,1028,60021,1028,31680,0,0,0,0,0
38.905,17,21,1596,21,48,1945,48,1596,0,0,0,0,0
0.484,6,23,7397,13,334,40,663,2021,10,1209,48,1946,5376
1.318,6,8,342,4,0,439,0,164,4,7,273,7,178
0.072,1,2,112,2,28,72,28,112,0,0,0,0,0
240.187,6,52,15802,28,684,8895,1402,13100,24,180,10442,580,2702
0.001,17,8,2446,8,277,0,316,2446,0,0,0,0,0
37.555,17,44,6468,22,48,1787,48,1672,22,190,1787,308,4796
125.987,2,2,64,2,8,125987,8,64,0,0,0,0,0
1775.353,1,58,4872,58,56,31146,56,4872,0,0,0,0,0
5.314,2,2,64,2,8,5314,8,64,0,0,0,0,0
0.421,6,36,8283,19,355,23,1432,2540,17,505,24,1473,5743
1742.029,1,124,13144,124,78,14162,78,13144,0,0,0,0,0
362.373,6,64,10787,35,107,10658,267,3557,29,288,12940,3417,7230
799.563,1,80,8480,80,78,10121,78,8480,0,0,0,0,0
11.511,6,1827,1589750,1123,1363,10,1380,1555425,704,558,16,1923,34325
0.032,17,4,336,2,34,0,34,124,2,78,18,84,212
0.017,17,2,167,1,39,0,39,67,1,72,0,72,100
3.836,17,5,290,5,30,959,30,290,0,0,0,0,0
3.167,6,14,2351,8,188,452,245,700,6,703,580,1152,1651
0.65,6,24,7981,12,186,59,367,1378,12,995,57,1438,6603
0.621,17,15,5599,7,441,91,1350,3285,8,261,79,1350,2314
2.554,6,8,349,3,0,106,0,124,5,7,588,7,225
2.658,17,8,720,4,30,871,30,232,4,94,875,94,488
280.045,6,30,7432,14,158,21541,267,1357,16,603,18667,2800,6075
210.923,1,2,120,2,32,210923,32,120,0,0,0,0,0
280.287,6,27,7312,12,158,25480,267,1277,15,678,20017,2045,6035
74.478,17,6,525,3,32,37222,37,181,3,86,37222,136,344
421.711,6,86,5510,47,69,9167,69,2915,39,69,11097,69,2595
1651.136,1,8,448,8,28,235876,28,448,0,0,0,0,0
15.646,6,19,4723,7,211,2607,211,1005,12,771,1414,1091,3718
3.923,17,10,1287,5,31,978,31,295,5,170,978,196,992
601.638,2,5,160,5,8,150409,8,160,0,0,0,0,0
0.891,6,10,1687,7,100,148,100,384,3,1179,323,1179,1303
0.09,17,2,279,1,36,0,36,64,1,187,0,187,215
1779.619,17,142,11360,71,48,25423,48,5396,71,56,25423,56,5964
4.235,17,5,290,5,30,1058,30,290,0,0,0,0,0
1797.814,6,359,22709,209,69,8643,69,12569,150,69,12065,69,10140
911.478,17,18,5968,18,303,53616,308,5968,0,0,0,0,0
102.276,6,18,2392,10,324,11364,584,1176,8,396,14574,580,1216
1757.258,6,169,22397,95,304,18694,304,15588,74,83,24068,83,6809
1.421,6,2,214,2,134,1421,134,214,0,0,0,0,0
0.816,6,10,1687,7,100,136,100,384,3,1179,279,1179,1303
2.03,17,6,474,3,34,1000,34,186,3,68,0,68,288
1744.628,2,16,512,16,8,116308,8,512,0,0,0,0,0
1744.214,6,102,7964,66,45,26834,205,4896,36,35,49824,98,3068
0.01,17,2,554,1,30,0,30,58,1,468,0,468,496
293.355,1,4,224,4,28,97785,28,224,0,0,0,0,0
5.951,6,498,453848,323,1343,17,1368,440084,175,776,32,1473,13764
1203.176,2,16,512,16,8,80211,8,512,0,0,0,0,0
0.309,17,8,2742,8,314,44,353,2742,0,0,0,0,0
1763.444,1,264,14784,264,28,6705,28,14784,0,0,0,0,0
105.86,1,4,224,4,28,35286,28,224,0,0,0,0,0
1771.424,1,110,6160,110,28,16251,28,6160,0,0,0,0,0
10.407,6,23,5096,10,199,1156,293,1601,13,495,845,1179,3495
280.225,6,30,7432,13,158,23352,267,1317,17,543,17512,1400,6115
0.16,6,12,3462,6,75,31,75,395,6,1373,32,1448,3067
1682.81,1,7,392,7,28,280468,28,392,0,0,0,0,0
240.186,6,56,20224,30,820,8282,1408,17153,26,213,9607,580,3071
1799.075,1,342,28728,342,56,5275,56,28728,0,0,0,0,0
270.201,6,24,7054,11,181,27020,267,1168,13,670,22514,2036,5886
1741.183,17,29,30566,29,1026,62185,1026,30566,0,0,0,0,0
0.212,6,34,7989,17,278,13,517,1815,17,498,12,1432,6174
0.645,1,10,840,10,56,71,56,840,0,0,0,0,0
378.714,6,114,18214,51,107,7571,721,5902,63,391,6105,1440,12312
6.281,6,1277,1160853,777,1415,7,1448,1130189,500,776,12,1448,30664
220.117,17,4,530,2,36,220112,36,128,2,173,220112,187,402
169.155,6,63,40223,39,1161,4451,1408,32232,24,841,2670,2816,7991
424.39,17,131,18389,59,178,6330,1350,12154,72,58,5976,1350,6235
15.393,6,2653,2508958,1725,1377,8,1408,2456038,928,931,16,2816,52920
125.363,6,14,3145,7,92,20893,92,452,7,465,20863,1448,2693
0.847,17,2,144,1,36,0,36,64,1,52,0,52,80
8.511,6,14,1322,8,275,1215,275,878,6,96,1242,96,444
1764.061,2,14,448,14,8,135697,8,448,0,0,0,0,0
66.336,6,106,73634,61,1246,1105,1368,64251,45,840,1501,2519,9383
1777.094,17,73,3060,72,14,25029,14,3024,1,8,0,8,36
291.218,6,11,1125,2,103,1,138,287,9,68,36402,69,838
3.481,17,10,2327,5,40,867,40,340,5,369,866,379,1987
264.797,17,4,352,2,60,264796,60,176,2,60,264795,60,176
26.316,6,39,9371,18,321,1548,722,2976,21,504,1305,1380,6395
299.351,1,4,326,4,53,99783,78,326,0,0,0,0,0
127.092,17,4,352,2,60,127091,60,176,2,60,127091,60,176
0.363,17,8,2750,8,315,51,354,2750,0,0,0,0,0
1786.709,17,87,3648,86,14,21020,14,3612,1,8,0,8,36
1745.718,6,95,7203,63,38,28156,205,4476,32,33,56300,98,2727
1738.716,6,87,6322,58,31,30503,31,3915,29,31,62096,31,2407
5.28,6,23,4478,12,213,480,597,1689,11,441,511,1448,2789
1772.717,6,180,15480,120,69,14896,69,8940,60,69,30040,69,6540
7.684,6,8,602,0,0,0,0,0,8,31,1097,31,602
38.701,17,44,6468,22,48,1842,48,1672,22,190,1842,308,4796
1778.72,1,58,4872,58,56,31205,56,4872,0,0,0,0,0
0.028,6,10,1512,5,503,7,503,771,5,473,6,473,741
0.094,6,9,1343,5,145,23,145,349,4,830,20,830,994
240.165,6,55,19338,30,828,8281,1408,16487,25,192,10006,580,2851
395.509,6,69,19567,26,561,15820,1360,9513,43,297,9305,1360,10054
9.996,17,3,1008,3,308,4998,308,1008,0,0,0,0,0
1595.397,6,85,6082,53,31,30680,31,3550,32,31,51458,31,2532
1783.401,17,83,3480,82,14,22017,14,3444,1,8,0,8,36
12.124,6,1906,1666033,1155,1387,10,1420,1631772,751,467,16,2840,34261
1744.699,2,18,576,18,8,102629,8,576,0,0,0,0,0
12.123,6,1907,1669158,1162,1381,10,1420,1635137,745,467,16,1883,34021
22.012,6,30,4910,16,213,1467,597,1941,14,441,1627,1440,2969
15.203,6,9,527,5,43,3800,43,311,4,0,5064,0,216
5.504,6,590,540163,386,1335,13,1368,524891,204,776,26,2736,15272
560.431,17,6,453,3,30,280203,30,174,3,65,280207,71,279
1733.022,6,196,13498,71,46,24330,46,5646,125,46,13975,46,7852
16.988,17,48,22071,23,619,770,1350,14882,25,259,706,1350,7189
0.044,6,3,187,1,0,0,0,52,2,31,0,31,135
0.637,6,10,924,5,283,107,283,551,5,105,104,105,373
0.079,17,2,558,1,32,0,32,60,1,470,0,470,498
0.673,17,22,14737,13,916,53,1350,12275,9,245,79,1350,2462
1792.296,6,233,20068,88,78,20599,338,9094,145,69,12445,1062,10974
1640.528,1,7,392,7,28,273421,28,392,0,0,0,0,0
1788.046,17,142,11360,71,48,25543,48,5396,71,56,25543,56,5964
0.407,6,27,8920,14,227,31,547,1644,13,941,32,1448,7276
0.303,6,3,168,2,0,303,0,112,1,0,0,0,56
272.772,6,20,1374,11,31,27277,31,696,9,31,34072,31,678
1781.412,6,354,22440,207,69,8647,69,12420,147,69,12201,69,10020
5.708,6,40,7309,20,218,300,314,3423,20,513,285,1179,3886
62.873,17,4,5504,4,1348,20957,1348,5504,0,0,0,0,0
0.821,6,10,1687,7,100,136,100,384,3,1179,280,1179,1303
0.192,6,2,149,1,0,0,0,40,1,69,0,69,109
0.074,17,2,348,1,39,0,39,67,1,253,0,253,281
0.029,17,2,144,1,36,0,36,64,1,52,0,52,80
0.157,6,10,1327,5,299,28,299,567,5,246,29,459,760
48.405,1,4,224,4,28,16135,28,224,0,0,0,0,0
1796.008,6,130,8171,74,47,24602,208,5001,56,31,32648,31,3170
1.806,17,35,21753,16,622,118,1350,10415,19,568,98,1350,11338
0.227,6,25,4623,12,165,20,456,1446,13,415,18,888,3177
13.046,6,14,2185,8,324,1863,585,1073,6,396,2555,580,1112
290.016,1,4,224,4,28,96672,28,224,0,0,0,0,0
0.046,17,2,164,1,46,0,46,74,1,62,0,62,90
371.495,6,27,1767,18,177,21852,177,1181,9,110,9145,110,586
1772.465,6,180,15480,120,69,14894,69,8940,60,69,30033,69,6540
0.048,6,10,1512,5,503,12,503,771,5,473,12,473,741
1770.213,1,8,448,8,28,252887,28,448,0,0,0,0,0
1779.875,17,138,11040,69,48,26174,48,5244,69,56,26174,56,5796
46.284,1,3,730,3,215,23142,351,730,0,0,0,0,0
1741.48,17,30,31680,30,1028,60051,1028,31680,0,0,0,0,0
0.173,6,9,1340,5,145,43,145,349,4,827,27,827,991
1781.561,17,142,11360,71,48,25450,48,5396,71,56,25450,56,5964
1776.589,1,100,5600,100,28,17945,28,5600,0,0,0,0,0
1.412,6,47,19264,27,898,54,1360,13688,20,476,64,2715,5576
20.31,6,26,7074,7,154,3385,267,752,19,396,1118,1452,6322
1.033,6,10,1687,7,100,172,100,384,3,1179,395,1179,1303
1798.786,6,367,25650,214,99,8445,469,15045,153,69,11833,69,10605
0.05,17,4,284,2,32,39,32,120,2,54,39,60,164
1111.657,17,220,16720,220,48,5076,48,16720,0,0,0,0,0
2.375,6,10,1135,5,259,593,259,495,5,110,471,110,640
0.21,1,6,432,0,0,0,0,0,6,44,42,44,432
0.059,17,2,912,1,308,0,308,336,1,548,0,548,576
1739.778,2,25,800,25,8,72490,8,800,0,0,0,0,0
316.794,17,5,1680,5,308,79198,308,1680,0,0,0,0,0
1.208,6,24,8028,12,164,93,267,1312,12,1014,93,2411,6716
367.152,6,25,1639,16,177,24476,177,1053,9,110,8913,110,586
280.445,6,30,7432,13,158,23370,267,1317,17,678,17524,3456,6115
0.246,17,2,162,1,34,0,34,62,1,72,0,72,100
0.15,17,2,1920,2,932,150,932,1920,0,0,0,0,0
11.465,6,1930,1781748,1197,1409,9,1448,1738968,733,776,15,1448,42780
17.398,6,14,2181,8,322,2485,581,1069,6,396,3477,580,1112
1796.471,6,412,36510,184,67,9816,659,13702,228,87,7913,1360,22808
17.821,17,39,18190,18,611,1046,1350,11510,21,290,889,1350,6680
297.113,1,4,224,4,28,99037,28,224,0,0,0,0,0
31.921,6,2,88,1,0,0,0,44,1,0,0,0,44
1789.951,6,367,25581,213,99,8443,469,15005,154,69,11699,69,10576
0.306,6,21,5000,10,137,34,267,1092,11,692,29,1467,3908
26.471,6,1086,951063,661,1359,39,1368,921951,425,776,61,1473,29112
1776.999,6,108,8536,68,65,26522,65,4930,40,59,45559,59,3606
10.029,17,3,433,2,37,10016,37,130,1,275,0,275,303
1796.017,17,447,39864,402,35,4478,288,25644,45,288,40017,288,14220
300.581,6,18,1227,5,177,75102,177,445,13,110,25033,110,782
1799.816,17,753,45417,753,32,2393,37,45417,0,0,0,0,0
1770.019,1,58,4872,58,56,31052,56,4872,0,0,0,0,0
368.555,6,25,1651,17,177,23034,177,1117,8,110,9202,110,534
247.119,6,30,6842,18,142,14536,518,1862,12,449,15231,1420,4980
0.158,6,10,1514,5,503,39,503,771,5,475,39,475,743
31.985,6,421,357326,188,122,171,288,10346,233,1462,137,2816,346980
1789.533,1,248,26288,248,78,7245,78,26288,0,0,0,0,0
300.549,6,11,863,6,177,60075,177,497,5,110,75093,110,366
22.902,6,27,7675,16,151,1526,318,1759,11,762,2285,1418,5916
1714.738,1,24,1344,24,28,74553,28,1344,0,0,0,0,0
0.16,6,14,4044,8,88,22,88,452,6,1670,31,1880,3592
0.279,6,9,1340,5,145,69,145,349,4,827,29,827,991
300.145,6,10,596,6,46,60002,46,390,4,46,100003,46,206
1796.429,6,356,22520,208,69,8678,69,12460,148,69,12220,69,10060
61.792,6,40,20468,19,132,3432,135,1524,21,991,3083,1448,18944
1777.172,17,140,11200,70,48,25756,48,5320,70,56,25756,56,5880
0.308,6,11,1170,6,135,55,135,379,5,587,73,587,791
387.565,6,18,1242,14,180,29812,180,916,4,110,20065,110,326
6.056,6,23,7328,12,146,550,175,1068,11,944,589,1448,6260
248.161,1,3,168,3,28,124080,28,168,0,0,0,0,0
1786.344,6,102,8296,68,65,26661,65,4930,34,59,54128,59,3366
7.588,6,1218,1045116,726,1389,10,1420,1021215,492,420,15,1420,23901
1790.603,6,371,26748,215,111,8367,469,15954,156,69,11551,69,10794
1.306,6,38,8266,19,321,72,1164,2730,19,433,63,1360,5536
4.31,6,38,7229,19,218,239,314,3383,19,513,225,1179,3846
1789.716,17,20,5822,20,263,94195,1316,5822,0,0,0,0,0
0.041,17,8,1670,8,180,5,219,1670,0,0,0,0,0
1795.407,17,87,3648,86,14,21122,14,3612,1,8,0,8,36
46.875,6,47,13937,24,1014,641,1360,8153,23,373,2123,2667,5784
1797.343,17,448,39896,403,35,4471,288,25676,45,288,40019,288,14220
5.609,6,572,461147,328,1333,16,1368,443795,244,776,22,1473,17352
1143.898,17,224,17024,224,48,5129,48,17024,0,0,0,0,0
0.017,17,4,791,2,32,0,32,120,2,307,7,319,671
37.95,17,22,1672,22,48,1807,48,1672,0,0,0,0,0
280.383,6,31,7472,13,158,23365,267,1317,18,603,16491,2076,6155
0.312,17,4,314,2,31,297,31,118,2,70,296,70,196
11.011,6,21,4442,12,275,1001,275,1038,9,758,779,1420,3404
0.362,17,2,154,1,33,0,33,61,1,65,0,65,93
2.046,17,6,462,3,33,999,33,183,3,65,999,65,279
104.892,6,347,324207,212,373,497,392,27141,135,2197,782,7749,297066
0.635,17,2,144,1,36,0,36,64,1,52,0,52,80
1740.656,17,30,7050,30,207,60022,207,7050,0,0,0,0,0
0.148,17,4,284,2,32,12,32,120,2,54,137,60,164
1.698,6,20,3833,11,234,169,564,1504,9,463,192,1343,2329
63.237,2,2,64,2,8,63237,8,64,0,0,0,0,0
0.62,6,30,15554,16,664,41,1360,3365,14,1290,36,4416,12189
174.817,6,24,10282,12,433,64,990,1823,12,995,15881,2720,8459
280.528,6,30,7432,13,158,23377,267,1317,17,603,17526,2076,6115
291.602,1,4,224,4,28,97200,28,224,0,0,0,0,0
281.531,6,32,7512,14,158,21656,267,1357,18,603,16557,2760,6155
1678.629,1,8,848,8,78,239804,78,848,0,0,0,0,0
1798.623,6,365,24563,212,87,8524,469,14096,153,69,11830,69,10467
12.993,6,41,9041,21,393,649,866,2145,20,434,613,2920,6896
1772.019,6,99,9306,66,66,27261,66,5610,33,60,55372,60,3696
1786.595,6,102,8228,68,64,26665,64,4896,34,58,54136,58,3332
5.016,17,3,335,2,41,5006,41,138,1,169,0,169,197
0.05,17,2,167,1,39,0,39,67,1,72,0,72,100
0.035,17,3,286,2,46,0,46,148,1,110,0,110,138
0.021,1,5,140,5,0,0,0,140,0,0,0,0,0
1679.404,2,25,800,25,8,69975,8,800,0,0,0,0,0
9.09,6,1529,1403505,924,1437,9,1448,1365977,605,776,14,1448,37528
1785.452,17,142,11360,71,48,25506,48,5396,71,56,25506,56,5964
12.275,6,1944,1689218,1194,1363,10,1380,1652816,750,515,16,1923,36402
31.53,6,7,308,1,0,0,0,44,6,0,6285,0,264
0.603,6,125,88498,57,131,10,232,2809,68,1338,8,1420,85689
6.228,6,41,7349,21,218,311,314,3463,20,440,313,1152,3886
0.294,17,4,304,2,48,1,48,152,2,48,0,48,152
0.544,6,24,6015,12,108,49,147,919,12,922,49,1581,5096
0.767,17,2,144,1,36,0,36,64,1,52,0,52,80
1786.402,6,104,8444,68,66,26662,66,4964,36,60,51037,60,3480
1.022,17,2,116,2,30,1022,30,116,0,0,0,0,0
0.011,17,2,415,1,65,0,65,93,1,294,0,294,322
0.484,6,26,9017,13,261,40,683,1728,13,943,35,1448,7289
161.101,17,3,228,3,48,80550,48,228,0,0,0,0,0
0.017,17,2,156,1,42,0,42,70,1,58,0,58,86
149.483,17,4,352,2,60,149481,60,176,2,60,149482,60,176
301.401,6,41,11409,21,544,15070,1098,3892,20,462,2800,2804,7517
1.097,17,4,820,2,36,1093,36,128,2,318,1092,318,692
1787.902,6,354,22440,206,69,8721,69,12380,148,69,12162,69,10060
15.32,6,18,2971,10,221,1702,517,1402,8,381,2187,499,1569
1140.062,17,20,1140,20,29,60003,29,1140,0,0,0,0,0
0.021,17,2,262,1,62,0,62,90,1,144,0,144,172
2.898,6,45,25827,22,796,138,1460,6498,23,1226,123,1689,19329
0.234,17,4,350,2,34,223,34,124,2,85,221,91,226
300.08,2,4,128,4,8,100026,8,128,0,0,0,0,0
11.089,6,12,700,5,0,2772,0,280,7,0,1206,0,420
0.506,6,27,9018,13,248,42,633,1678,14,941,36,1368,7340
1785.171,1,178,9968,178,28,10085,28,9968,0,0,0,0,0
0.012,17,2,154,1,33,0,33,61,1,65,0,65,93
125.896,6,15,3203,7,92,20982,92,452,8,388,17962,1408,2751
0.96,6,10,1687,7,100,160,100,384,3,1179,351,1179,1303
65.843,6,25,8894,14,296,5064,582,1481,11,994,6552,1778,7413
0.47,17,4,352,2,60,469,60,176,2,60,469,60,176
0.261,6,25,6032,12,164,23,453,1442,13,558,20,1448,4590
32.053,6,9,396,2,0,3518,0,88,7,0,5327,0,308
1798.516,17,87,3648,86,14,21159,14,3612,1,8,0,8,36
1757.164,6,115,6946,64,27,27890,27,3811,51,27,35142,27,3135
1787.908,6,382,24388,219,69,8201,69,13314,163,69,11036,69,11074
0.171,6,46,20624,26,1038,6,1420,15603,20,467,8,1883,5021
240.493,6,41,8900,20,577,12657,1402,5665,21,266,12024,620,3235
6.257,6,6,240,4,0,2085,0,160,2,0,1538,0,80
1792.497,17,142,11360,71,48,25606,48,5396,71,56,25606,56,5964
1783.358,6,102,8296,68,65,26617,65,4930,34,59,54038,59,3366
31.012,17,6,670,6,83,6202,84,670,0,0,0,0,0
0.21,6,21,5000,10,137,23,267,1092,11,692,20,1467,3908
296.547,1,4,224,4,28,98849,28,224,0,0,0,0,0
62.855,6,39,12701,20,892,43,1360,7077,19,373,3481,2667,5624
1.125,17,4,884,2,30,1065,30,116,2,356,1073,468,768
7.986,1,2,112,2,28,7986,28,112,0,0,0,0,0
1797.199,6,355,22480,207,69,8624,69,12420,148,69,12225,69,10060
0.092,17,4,352,2,37,56,37,130,2,83,40,89,222
7.162,17,4,1344,4,308,2387,308,1344,0,0,0,0,0
1753.955,6,97,7307,63,38,28289,205,4476,34,33,53137,98,2831
0.054,6,2,1997,1,0,0,0,40,1,1917,0,1917,1957
0.028,17,2,186,1,41,0,41,69,1,89,0,89,117
0.147,17,4,588,2,48,135,48,152,2,190,134,308,436
0.659,17,4,352,2,37,0,37,130,2,83,1,89,222
135.173,6,34,14428,18,489,277,1460,3213,16,960,9002,1460,11215
0.596,6,63,28737,34,1043,18,1380,23323,29,421,19,1923,5414
370.828,6,23,1538,16,180,24721,180,1056,7,110,10417,110,482
9.279,6,40,7309,22,218,441,314,3503,18,513,512,1179,3806
1742.184,6,138,8792,77,49,22923,208,5422,61,31,29030,31,3370
0.581,6,21,5000,10,137,64,267,1092,11,692,49,1467,3908
33.549,6,30,5041,15,154,2396,722,1859,15,399,2382,1448,3182
10.445,6,81,24477,42,550,254,1152,18760,39,461,267,1179,5717
187.478,17,4,240,2,32,187477,32,120,2,32,187476,32,120
1756.211,6,105,6258,60,26,29765,27,3519,45,26,39913,27,2739
61.308,6,35,15977,22,815,2919,1408,9303,13,855,5088,3847,6674
57.434,17,4,352,2,60,57433,60,176,2,60,57433,60,176
3.899,17,8,1216,4,60,1299,60,352,4,188,1295,188,864
11.851,6,21,6777,12,275,1077,275,1038,9,1341,854,1440,5739
1797.47,1,204,21624,204,78,8854,78,21624,0,0,0,0,0
186.817,6,30,7432,13,158,15568,267,1317,17,543,11670,1400,6115
201.215,17,5,338,5,39,50303,40,338,0,0,0,0,0
1.353,6,44,18810,26,941,54,1460,13314,18,529,68,4075,5496
5.342,6,22,4426,12,213,485,597,1689,10,552,573,1767,2737
0.321,17,2,212,1,46,0,46,74,1,110,0,110,138
0.557,6,110,87015,60,131,9,232,2929,50,1824,11,4260,84086
8.258,6,21,8305,10,275,917,275,683,11,1194,766,1414,7622
0.046,17,4,724,2,32,36,32,120,2,274,35,274,604
1.995,17,3,215,2,33,1990,33,122,1,65,0,65,93
2.437,6,27,8963,16,371,162,847,1759,11,965,235,1420,7204
1070.186,1,98,5488,98,28,11032,28,5488,0,0,0,0,0
299.202,17,2,136,2,40,299202,47,136,0,0,0,0,0
0.002,6,4,229,1,0,0,0,40,3,34,0,64,189
0.133,17,2,152,1,48,0,48,76,1,48,0,48,76
1776.861,17,138,11040,69,48,26129,48,5244,69,56,26130,56,5796
0.232,6,8,530,5,43,57,43,354,3,0,114,0,176
0.512,17,3,451,2,39,60,39,134,1,289,0,289,317
504.116,2,3,96,3,8,252058,8,96,0,0,0,0,0
27.47,6,9,484,4,0,9156,0,216,5,0,6823,0,268
1740.431,17,30,31620,30,1026,60014,1026,31620,0,0,0,0,0
0.248,6,11,1864,7,262,41,517,896,4,752,63,752,968
1.239,17,6,552,3,64,619,64,276,3,64,619,64,276
1.441,6,47,19052,26,951,57,1460,13436,21,433,61,1460,5616
3.459,6,2,88,2,0,0,0,88,0,0,0,0,0
1796.781,17,449,39928,404,35,4458,288,25708,45,288,40019,288,14220
300.296,6,48,29734,25,190,12512,444,2117,23,1553,10994,4206,27617
1748.379,6,96,7286,63,38,28199,205,4476,33,33,54629,98,2810
256.741,6,29,7001,13,229,165,498,1672,16,390,17110,1420,5329
0.083,17,4,352,2,37,44,37,130,2,83,40,89,222
1772.755,1,14,784,14,28,136365,28,784,0,0,0,0,0
0.533,17,15,8078,7,606,88,1350,4444,8,426,67,1350,3634
1770.141,6,99,9240,66,65,27232,65,5577,33,59,55314,59,3663
1770.485,6,99,9174,66,64,27238,64,5544,33,58,55325,58,3630
1793.016,6,123,12286,77,62,23592,722,6393,46,92,39835,2026,5893
24.194,17,22,3588,11,48,2418,48,836,11,222,2418,308,2752
1773.317,6,181,15589,120,69,14901,69,8940,61,69,29549,69,6649
1797.633,6,367,25650,214,99,8439,469,15045,153,69,11823,69,10605
1799.118,17,758,45742,758,32,2376,37,45742,0,0,0,0,0
14.755,6,29,5052,15,154,1038,722,1908,14,402,1120,2026,3144
364.56,6,18,1242,14,180,28043,180,916,4,110,20056,110,326
59.558,6,106,78737,70,1266,860,1360,72495,36,435,1696,2667,6242
318.057,6,70,18280,35,355,9354,1460,9253,35,346,9345,1629,9027
1795.142,17,80,3354,79,14,23014,14,3318,1,8,0,8,36
2.549,6,2,87,0,0,0,0,0,2,7,2549,7,87
0.365,6,19,4286,11,165,36,456,1394,8,493,43,888,2892
0.353,17,8,2774,8,318,50,357,2774,0,0,0,0,0
1795.753,6,229,17993,87,73,20879,336,8812,142,50,12734,143,9181
36.076,6,18,5791,11,272,3607,516,1260,7,849,117,1452,4531
300.07,6,16,1529,6,187,60014,187,507,10,247,27073,462,1022
11.064,6,20,4390,11,275,1106,275,998,9,755,781,1414,3392
0.362,6,22,7342,12,335,32,668,1974,10,1210,39,1906,5368
1794.851,17,303,58129,303,163,5943,422,58129,0,0,0,0,0
2.212,2,2,64,2,8,2212,8,64,0,0,0,0,0
1796.921,17,449,39928,404,35,4458,288,25708,45,288,40018,288,14220
1783.81,6,358,22669,209,69,8576,69,12500,149,69,12052,69,10169
2.597,17,33,7218,14,221,197,1350,3487,19,168,142,1350,3731
273.153,6,297,78901,177,444,1552,1440,36318,120,327,2295,1328,42583
1.412,6,45,16863,25,854,58,1440,11287,20,433,64,1440,5576
292.536,6,28,9724,14,346,22502,1004,2122,14,859,22502,1438,7602
20.095,6,21,5418,12,107,1826,159,1074,9,967,2511,1669,4344
122.403,17,8,2688,8,308,17486,308,2688,0,0,0,0,0
1776.978,17,73,3060,72,14,25027,14,3024,1,8,0,8,36
0.299,6,10,1671,6,552,59,948,1348,4,159,99,159,323
1772.912,6,180,15480,120,69,14898,69,8940,60,69,30041,69,6540
0.336,17,2,136,1,32,0,32,60,1,48,0,48,76
175.147,6,24,9113,12,356,84,765,1592,12,878,15909,2521,7521
1740.913,17,30,7050,30,207,60031,207,7050,0,0,0,0,0
0.124,17,2,245,1,32,0,32,60,1,157,0,157,185
175.659,6,34,17182,17,972,56,1460,8505,17,887,10968,1460,8677
280.278,6,27,7312,12,158,25479,267,1277,15,678,20017,2045,6035
1774.849,6,186,15996,121,69,14790,69,9049,65,69,27729,69,6947
42.008,17,48,7056,24,48,1826,48,1824,24,190,1826,308,5232
28.073,6,19,4363,10,272,3119,516,1220,9,555,2285,1452,3143
252.44,2,3,96,3,8,126220,8,96,0,0,0,0,0
1778.561,17,142,11360,71,48,25407,48,5396,71,56,25407,56,5964
1.03,6,10,861,5,222,253,222,426,5,231,253,231,435
300.814,6,51,13321,26,888,12032,1460,7364,25,290,645,1460,5957
1798.097,17,449,39644,405,35,4450,288,25740,44,288,40951,288,13904
4.763,17,2,656,2,300,4763,300,656,0,0,0,0,0
300.33,6,54,27061,32,1132,9688,1408,21003,22,446,2948,1408,6058
0.012,17,2,336,1,37,0,37,65,1,243,0,243,271
13.533,6,83,24792,41,541,338,1152,18971,42,459,322,1179,5821
190.27,17,4,240,2,32,190268,32,120,2,32,190269,32,120
269.994,6,34,7081,19,142,14999,516,1905,15,415,19279,1452,5176
579.24,17,140,21328,63,170,9342,1350,12496,77,86,7620,1350,8832
5.957,6,5,220,5,0,0,0,220,0,0,0,0,0
1754.905,6,117,8670,65,26,27419,26,3804,52,102,34408,427,4866
0.476,6,24,6040,13,108,39,147,959,11,772,45,1608,5081
3.805,17,4,3964,4,963,1268,1451,3964,0,0,0,0,0
1698.951,1,8,848,8,78,242707,78,848,0,0,0,0,0
153.598,17,4,240,2,32,153597,32,120,2,32,153597,32,120
1789.537,6,103,8404,68,66,26709,66,4964,35,60,52630,60,3440
1799.614,6,356,22520,208,69,8693,69,12460,148,69,12242,69,10060
0.409,6,10,967,5,256,97,256,460,5,303,98,303,507
3.526,6,56,20603,29,951,125,1440,14535,27,381,115,1440,6068
267.763,17,4,240,2,32,267762,32,120,2,32,267762,32,120
1740.771,6,87,6322,58,31,30539,31,3915,29,31,62170,31,2407
266.362,6,29,7392,13,158,22196,267,1317,16,603,17754,2036,6075
2.233,17,29,10045,14,316,169,1350,4816,15,320,157,1350,5229
4.365,6,36,7165,18,218,256,314,3343,18,516,241,1179,3822
120.832,6,2,2460,0,0,0,0,0,2,1190,120832,1190,2460
1789.662,17,140,11200,70,48,25936,48,5320,70,56,25937,56,5880
0.362,6,14,1733,7,288,60,288,588,7,284,32,434,1145
132.227,6,26,7918,8,216,9810,501,1190,18,428,7772,1420,6728
0.009,17,2,330,1,30,0,30,58,1,244,0,244,272
0.261,17,2,1918,2,931,261,931,1918,0,0,0,0,0
75.031,6,41,8649,20,365,805,780,1963,21,388,3743,2128,6686
166.652,17,5,5854,5,1142,41663,1444,5854,0,0,0,0,0
1787.826,1,130,7280,130,28,13859,28,7280,0,0,0,0,0
1141.475,6,117,10062,78,69,14824,69,5811,39,69,30032,69,4251
1793.407,17,87,3648,86,14,21098,14,3612,1,8,0,8,36
191.263,6,41,11216,22,361,9098,1275,4041,19,561,10617,2736,7175
13.193,6,7,380,4,0,4397,0,216,3,0,6592,0,164
0.04,6,10,859,6,181,8,181,489,4,77,11,133,370
3.375,17,19,4773,19,223,187,389,4773,0,0,0,0,0
1.049,17,4,580,2,40,1017,40,136,2,194,1016,194,444
0.005,17,2,410,1,37,0,37,65,1,317,0,317,345
1681.551,17,16,1265,8,30,240219,37,471,8,71,240219,136,794
1778.418,6,105,8484,68,66,26543,66,4964,37,60,49398,60,3520
21.867,17,4,824,2,48,21857,48,152,2,308,21855,308,672
0.068,17,2,180,1,30,0,30,58,1,94,0,94,122
0.016,6,9,1612,5,636,3,636,904,4,492,5,492,708
6.415,6,28,10363,15,458,458,1368,2644,13,879,531,1368,7719
252.006,17,2,150,2,47,252006,47,150,0,0,0,0,0
1769.052,6,105,8747,69,42,26015,205,4984,36,52,50537,553,3763
360.877,2,4,128,4,8,120292,8,128,0,0,0,0,0
9.207,6,19,2538,10,210,1022,210,984,9,545,1150,904,1554
0.013,17,2,198,1,39,0,39,67,1,103,0,103,131
0.939,6,10,1687,7,100,156,100,384,3,1179,332,1179,1303
1.635,6,48,18665,27,852,62,1360,13049,21,476,70,2720,5616
0.18,17,2,2752,2,1348,180,1348,2752,0,0,0,0,0
9.436,6,16,5255,9,275,1179,275,643,7,1440,736,1440,4612
0.092,6,10,1495,5,507,23,507,727,5,556,22,556,768
34.998,17,40,5880,20,48,1841,48,1520,20,190,1841,308,4360
39.723,17,44,6468,22,48,1891,48,1672,22,190,1891,308,4796
2.068,6,14,2351,8,188,295,245,700,6,703,359,1152,1651
1796.938,1,244,13664,244,28,7394,28,13664,0,0,0,0,0
1779.924,6,696,127889,374,339,4771,1380,64234,322,216,5544,837,63655
2.324,6,13,2425,6,213,464,213,457,7,421,368,421,1968
1792.495,1,342,28728,342,56,5256,56,28728,0,0,0,0,0
0.689,6,28,7336,13,155,57,267,1301,15,543,48,1400,6035
317.828,6,28,6562,11,220,5613,516,1325,17,325,19858,1452,5237
5.569,17,2,146,1,37,0,37,65,1,53,0,53,81
1753.293,6,96,7255,63,38,28278,205,4476,33,33,54775,98,2779
33.569,6,32,5158,16,154,2226,722,1923,16,342,2226,1440,3235
571.143,17,12,4722,12,365,51922,373,4722,0,0,0,0,0
1.521,6,38,8252,19,320,84,1162,2716,19,433,73,1440,5536
280.491,6,31,7472,13,158,23374,267,1317,18,603,16492,2076,6155
0.03,6,12,3462,6,75,6,75,395,6,1373,6,1448,3067
2.13,6,29,10386,17,367,133,833,1785,12,1014,185,1414,8601
40.292,6,46,9083,21,410,801,916,2175,25,327,1672,1360,6908
51.622,6,45,8916,21,401,699,889,2172,24,444,2237,2720,6744
2.19,17,2,925,1,548,0,548,576,1,321,0,321,349
1797.562,6,356,22520,208,69,8683,69,12460,148,69,12228,69,10060
0.124,17,4,300,2,39,123,39,134,2,55,122,55,166
10.989,6,18,1398,11,275,1098,275,1002,7,96,1457,96,396
170.175,17,2,1084,2,514,170175,514,1084,0,0,0,0,0
0.694,17,19,12654,11,901,69,1350,10224,8,275,94,1350,2430
4.69,6,37,7189,19,218,260,314,3383,18,513,259,1179,3806
1680.065,17,14,587,12,14,152733,15,505,2,13,476592,18,82
0.012,17,2,419,1,44,0,44,72,1,319,0,319,347
1791.121,17,178,13884,178,50,10119,50,13884,0,0,0,0,0
90.966,17,19,1444,19,48,5053,48,1444,0,0,0,0,0
287.542,6,31,3137,16,324,19169,585,1497,15,282,20538,580,1640
1770.26,6,27,4077,18,241,104132,241,2889,9,92,221259,92,1188
36.161,17,40,5880,20,48,1902,48,1520,20,190,1902,308,4360
342.009,1,10,560,10,28,38001,28,560,0,0,0,0,0
365.668,6,18,1242,14,180,28128,180,916,4,110,20055,110,326
2.291,6,13,2311,8,188,327,245,700,5,1407,510,1407,1611
11.024,6,91,27253,47,562,239,1152,21011,44,447,250,1179,6242
126.083,2,2,64,2,8,126083,8,64,0,0,0,0,0
5.851,6,41,7349,22,218,278,314,3503,19,440,310,1152,3846
39.08,17,22,1672,22,48,1860,48,1672,0,0,0,0,0
1756.291,6,95,7203,63,38,28327,205,4476,32,33,56648,98,2727
0.036,17,4,344,2,47,0,47,150,2,69,1,75,194
1771.257,6,99,9240,66,65,27250,65,5577,33,59,55348,59,3663
2.968,17,3,222,3,46,1484,46,222,0,0,0,0,0
9.342,6,41,7690,21,218,467,314,3463,20,489,477,1179,4227
300.162,6,47,15119,26,834,11999,1360,9428,21,403,14999,2667,5691
4.155,6,39,7269,19,218,230,314,3383,20,440,205,1152,3886
0.091,17,4,368,2,32,90,32,120,2,96,38,96,248
2.164,6,15,1073,8,222,301,222,550,7,231,353,231,523
890.084,1,14,784,14,28,68468,28,784,0,0,0,0,0
5.006,17,4,288,2,36,5005,36,128,2,52,5004,52,160
280.211,6,28,7352,13,158,23350,267,1317,15,678,20010,3436,6035
7.577,6,67,20198,34,541,229,1152,15435,33,491,228,1179,4763
1784.473,6,191,18872,126,94,14275,485,11019,65,80,27878,453,7853
13.458,6,2214,2034221,1363,1411,9,1448,1985293,851,776,15,1448,48928
33.344,6,95,60416,58,1288,174,1360,53944,37,355,919,2667,6472
0.429,6,13,1693,7,288,67,288,588,6,426,44,434,1105
0.296,6,27,9085,13,257,24,667,1715,14,947,22,1408,7370
34.328,17,40,5880,20,48,1806,48,1520,20,190,1806,308,4360
363.834,17,137,35640,137,232,2675,388,35640,0,0,0,0,0
3.136,6,12,887,6,186,627,186,514,6,45,626,45,373
4.965,6,39,7269,19,218,275,314,3383,20,513,248,1179,3886
282.565,17,3,1026,1,300,0,300,328,2,321,281572,321,698
1797.711,6,750,50805,375,31,4806,31,25545,375,31,4804,31,25260
300.567,6,16,1135,6,177,60077,177,509,10,110,33376,110,626
379.818,6,18,1242,14,180,29216,180,916,4,110,20064,110,326
0.347,17,2,304,1,60,0,60,88,1,188,0,188,216
0.001,6,2,150,1,0,0,0,40,1,58,0,58,110
733.251,17,16,5298,16,303,48883,308,5298,0,0,0,0,0
10.701,6,1944,1822806,1223,1412,8,1448,1780650,721,776,14,1448,42156
0.134,17,4,308,2,38,0,38,132,2,60,42,66,176
15.617,17,30,16298,16,797,1027,1350,13214,14,192,1195,1350,3084
1793.7,17,140,11200,70,48,25995,48,5320,70,56,25995,56,5880
69.833,6,41,8590,20,345,820,720,1903,21,389,3484,2128,6687
61.339,6,35,15834,22,800,2920,1408,9159,13,855,5090,3847,6675
0.401,6,29,10173,14,252,30,647,1756,15,953,27,1438,8417
143.068,17,6,528,3,48,71528,48,228,3,72,71528,72,300
1.0,17,2,124,2,34,1000,34,124,0,0,0,0,0
1798.492,6,369,24792,214,87,8443,469,14245,155,69,11675,69,10547
0.452,6,10,968,5,256,111,256,460,5,304,110,304,508
1.066,6,15,3685,8,126,152,126,558,7,1373,177,1448,3127
1750.6,6,124,12316,75,61,23656,722,6235,49,88,36464,1448,6081
24.575,6,33,8849,15,340,1755,722,2645,18,608,1420,1380,6204
167.418,1,8,448,8,28,23916,28,448,0,0,0,0,0
240.191,6,53,18561,29,784,8578,1402,15629,24,239,10442,580,2932
1773.638,17,140,11200,70,48,25704,48,5320,70,56,25704,56,5880
3.366,17,10,2546,5,30,838,30,290,5,423,823,468,2256
8.234,6,19,8221,9,275,1029,275,643,10,1194,888,1414,7578
1790.383,1,342,28728,342,56,5250,56,28728,0,0,0,0,0
280.24,6,21,6362,9,87,35030,105,538,12,667,25472,1400,5824
1788.478,6,362,22898,210,69,8557,69,12678,152,69,11841,69,10220
102.384,17,3,1008,3,308,51192,308,1008,0,0,0,0,0
0.519,17,3,451,2,39,510,39,134,1,289,0,289,317
1749.6,17,12,498,11,14,174960,14,462,1,8,0,8,36
0.153,6,19,8976,10,124,16,124,652,9,1308,19,1802,8324
3.941,17,4,244,4,33,1313,33,244,0,0,0,0,0
7.016,6,29,7464,12,155,637,267,1266,17,423,437,3417,6198
9.847,6,37,10512,19,303,547,721,2890,18,766,520,1414,7622
1793.257,1,256,27136,256,78,7032,78,27136,0,0,0,0,0
113.95,17,6,750,6,97,22790,352,750,0,0,0,0,0
0.286,17,4,368,2,32,272,32,120,2,96,274,96,248
0.863,6,11,1727,7,100,143,100,384,4,589,205,1152,1343
48.403,17,40,10360,40,231,1241,388,10360,0,0,0,0,0
1798.096,17,450,39960,405,35,4450,288,25740,45,288,40016,288,14220
240.146,6,43,5687,22,235,11435,833,3038,21,192,12007,539,2649
1785.735,6,274,32899,111,129,16232,1360,15672,163,132,11022,1360,17227
4.701,6,41,7349,20,218,247,314,3423,21,440,222,1152,3926
1787.522,6,102,8296,68,65,26679,65,4930,34,59,54163,59,3366
280.08,6,28,7352,13,158,23340,267,1317,15,678,19999,3436,6035
41.861,17,4,352,2,60,41860,60,176,2,60,41859,60,176
0.23,17,4,304,2,48,116,48,152,2,48,116,48,152
4.368,17,2,656,2,300,4368,300,656,0,0,0,0,0
37.368,6,4683,4464779,3022,1398,12,1448,4373731,1661,776,22,1448,91048
0.144,17,2,672,2,308,144,308,672,0,0,0,0,0
315.945,6,77,13757,40,127,8101,615,4246,37,334,8772,4649,9511
1.694,17,16,9381,9,741,211,1350,6927,7,322,259,1350,2454
7.007,6,1611,1515854,1039,1383,6,1408,1481446,572,931,11,2801,34408
1.242,6,25,8056,13,164,88,267,1340,12,1014,94,2331,6716
7.121,6,1567,1452802,1000,1377,6,1408,1418654,567,1164,12,4209,34148
152.581,17,8,2688,8,308,21797,308,2688,0,0,0,0,0
280.257,6,30,7432,13,158,23354,267,1317,17,543,17510,1400,6115
1.391,17,4,334,2,39,765,39,134,2,72,0,72,200
3.407,6,2,88,2,0,0,0,88,0,0,0,0,0
0.877,6,10,1386,5,145,219,145,349,5,833,93,833,1037
1.285,6,44,14943,24,761,55,1360,9367,20,476,58,2720,5576
280.227,6,29,7392,13,158,23352,267,1317,16,543,18680,1400,6075
0.412,17,4,1336,4,306,137,354,1336,0,0,0,0,0
5.022,17,4,288,2,36,5002,36,128,2,52,5002,52,160
1.003,17,2,685,1,308,0,308,336,1,321,0,321,349
0.134,17,4,284,2,32,130,32,120,2,54,130,60,164
1795.298,17,81,3390,79,14,23014,14,3318,2,8,1795123,8,72
377.961,2,3,96,3,8,188980,8,96,0,0,0,0,0
32.457,6,33,19735,18,544,1909,1114,2589,15,1487,2263,4042,17146
10.995,6,20,5694,11,275,1099,275,998,9,1440,746,1440,4696
240.743,6,39,8340,18,182,14160,517,2221,21,501,12036,1418,6119
280.446,6,30,7432,13,158,23370,267,1317,17,543,17526,1400,6115
0.014,17,2,423,1,33,0,33,61,1,334,0,334,362
1794.975,1,182,10192,182,28,9916,28,10192,0,0,0,0,0
0.057,6,3,144,2,0,50,0,104,1,0,0,0,40
1.206,6,25,8044,13,164,100,267,1328,12,869,92,1408,6716
8.831,17,4,352,2,60,8830,60,176,2,60,8830,60,176
101.918,17,4,352,2,60,101917,60,176,2,60,101917,60,176
282.971,17,4,240,2,32,282970,32,120,2,32,282970,32,120
782.052,2,9,288,9,8,97756,8,288,0,0,0,0,0
6.075,6,724,634435,448,1341,13,1368,613495,276,776,21,1473,20940
34.701,17,20,1520,20,48,1826,48,1520,0,0,0,0,0
38.87,17,22,1936,11,48,3885,48,836,11,72,3885,72,1100
20.792,6,27,7299,15,149,1485,318,1560,12,638,1889,1418,5739
1791.022,1,280,15680,280,28,6419,28,15680,0,0,0,0,0
1727.004,17,12,498,11,14,172700,14,462,1,8,0,8,36
240.154,6,39,5288,19,235,13341,752,2647,20,199,12639,565,2641
0.628,6,15,1785,8,288,62,288,640,7,426,70,434,1145
1.671,6,13,2311,8,188,238,245,700,5,1407,355,1407,1611
0.422,6,10,968,5,256,101,256,460,5,304,100,304,508
1684.519,2,14,448,14,8,129578,8,448,0,0,0,0,0
1.865,17,2,124,2,34,1865,34,124,0,0,0,0,0
0.007,17,2,528,1,128,0,128,156,1,344,0,344,372
5.98,17,5,542,4,32,1332,32,240,1,274,0,274,302
120.381,2,2,64,2,8,120381,8,64,0,0,0,0,0
4.142,17,10,2419,5,40,1031,40,340,5,387,1032,423,2079
0.495,17,3,451,2,39,184,39,134,1,289,0,289,317
30.13,6,36,8455,17,410,540,882,1942,19,441,1666,1460,6513
1.287,6,38,8252,19,320,71,1162,2716,19,433,61,1360,5536
0.251,17,3,451,2,39,7,39,134,1,289,0,289,317
0.627,17,4,560,2,64,525,64,184,2,160,394,160,376
0.157,6,43,17186,24,935,6,1420,12205,19,467,8,1883,4981
1.334,6,49,18240,26,882,53,1460,12544,23,433,52,1460,5696
1.418,6,46,18090,26,880,56,1460,12514,20,433,64,1460,5576
1789.387,6,357,22629,208,69,8644,69,12460,149,69,12090,69,10169
3.886,17,4,244,4,33,1295,33,244,0,0,0,0,0
2.809,6,2,88,2,0,0,0,88,0,0,0,0,0
48.635,1,20,1120,20,28,2559,28,1120,0,0,0,0,0
7.104,6,1577,1460710,1003,1379,6,1408,1426198,574,931,12,2816,34512
365.722,6,18,1696,14,509,28132,509,1089,4,435,72193,435,607
2.384,17,33,18349,15,763,170,1350,11870,18,331,96,1350,6479
0.008,17,2,550,2,247,8,247,550,0,0,0,0,0
21.448,6,11,784,3,92,10616,92,256,8,92,3039,92,528
0.123,6,12,3462,6,75,24,75,395,6,1373,24,1448,3067
21.547,17,25,12004,13,698,1795,1350,9447,12,185,1956,1350,2557
0.2,17,2,1920,2,932,200,932,1920,0,0,0,0,0
1.19,6,26,7927,16,364,79,1125,3193,10,721,130,1420,4734
6.698,6,1015,893958,612,1382,10,1408,868338,403,931,16,2816,25620
1797.684,6,416,24920,208,69,8684,69,12460,208,34,8684,64,12460
1.508,6,50,21248,29,902,53,1360,15632,21,476,64,2715,5616
1785.637,17,29,9512,29,300,63772,300,9512,0,0,0,0,0
0.004,17,2,394,1,33,0,33,61,1,305,0,305,333
1777.934,17,118,9440,59,48,30653,48,4484,59,56,30653,56,4956
1789.333,17,381,50156,182,180,9884,1350,37899,199,33,9036,61,12257
1740.222,6,91,6604,59,31,30003,31,3998,32,31,56135,31,2606
0.416,6,13,1693,7,288,64,288,588,6,426,48,434,1105
1777.931,17,140,11200,70,48,25767,48,5320,70,56,25767,56,5880
0.048,17,4,588,2,48,42,48,152,2,190,40,308,436
0.32,17,8,2758,8,316,45,355,2758,0,0,0,0,0
137.041,6,31,8912,14,158,10541,267,1357,17,687,8562,1781,7555
0.422,17,4,288,2,36,391,36,128,2,52,390,52,160
3.148,17,4,624,4,128,1049,128,624,0,0,0,0,0
42.42,17,4,240,2,32,42419,32,120,2,32,42419,32,120
1.852,6,14,1792,8,121,264,121,553,6,911,370,911,1239
125.327,2,2,64,2,8,125327,8,64,0,0,0,0,0
1710.461,1,8,448,8,28,244351,28,448,0,0,0,0,0
1.238,6,43,10105,23,440,56,1360,4484,20,437,56,2715,5621
59.584,6,24,6946,6,154,2836,267,712,18,423,3504,1420,6234
1796.217,17,448,39612,404,35,4457,288,25708,44,288,40952,288,13904
0.123,6,9,1002,5,213,30,213,417,4,421,37,421,585
1729.395,6,63,4601,41,33,43234,33,2825,22,31,82334,31,1776
43.046,1,8,448,8,28,6149,28,448,0,0,0,0,0
1787.425,6,102,8228,68,64,26677,64,4896,34,58,54161,58,3332
0.031,6,15,5964,8,88,4,88,452,7,1740,5,1880,5512
26.067,17,47,14750,22,318,1239,1350,7623,25,257,1084,1350,7127
1.699,6,14,2351,8,188,242,245,700,6,703,287,1152,1651
0.311,6,22,7342,12,335,27,668,1974,10,1210,34,1906,5368
126.483,6,69,46904,44,1179,2941,1408,38869,25,840,2568,2439,8035
0.006,6,6,5167,2,0,1,0,80,4,1231,0,1917,5087
1785.79,6,128,12052,78,93,23192,292,6752,50,82,36442,247,5300
8.762,6,73,20758,38,554,236,1152,15931,35,427,249,1152,4827
31.838,6,72,71108,29,124,1137,296,1882,43,1717,757,2804,69226
1700.443,17,12,498,11,14,170044,14,462,1,8,0,8,36
123.92,17,6,2016,6,308,24784,308,2016,0,0,0,0,0
287.529,17,4,240,2,32,287528,32,120,2,32,287527,32,120
280.261,6,22,6974,10,181,31140,267,1128,12,766,25475,2045,5846
1775.531,17,142,11360,71,48,25364,48,5396,71,56,25364,56,5964
1.015,17,3,183,2,33,991,33,122,1,33,0,33,61
0.054,6,10,766,5,185,13,185,453,5,45,11,45,313
1714.846,1,122,6832,122,28,14172,28,6832,0,0,0,0,0
3.331,17,5,290,5,30,832,30,290,0,0,0,0,0
42.171,17,4,240,2,32,42170,32,120,2,32,42170,32,120
1.385,6,23,7952,11,164,117,267,1236,12,1014,108,2491,6716
0.529,6,54,21494,27,1074,20,1380,16172,27,421,18,1923,5322
1771.114,6,99,9174,66,64,27247,64,5544,33,58,55344,58,3630
303.386,6,44,15212,20,592,15964,1368,6987,24,577,13188,2736,8225
0.002,6,2,92,1,0,0,0,52,1,0,0,0,40
72.285,6,21,860,11,0,7228,0,444,10,0,8029,0,416
280.462,6,30,7432,13,158,23371,267,1317,17,678,17522,2760,6115
1.274,6,45,18084,26,882,50,1360,12548,19,433,61,1360,5536
1797.263,17,448,39896,403,35,4470,288,25676,45,288,40020,288,14220
18.747,17,12,1056,6,48,3745,48,456,6,72,3730,72,600
0.052,17,2,396,1,39,0,39,67,1,301,0,301,329
1.382,6,49,18297,28,882,51,1440,12636,21,400,60,1440,5661
1741.841,6,131,8866,72,59,24532,208,5452,59,31,30023,31,3414
1779.029,17,140,11200,70,48,25782,48,5320,70,56,25782,56,5880
61.331,6,40,21243,25,956,2555,1402,13742,15,839,4362,2804,7501
1785.449,6,122,9551,75,65,24127,65,5665,47,59,38811,59,3886
1624.377,2,13,416,13,8,135364,8,416,0,0,0,0,0
1658.718,1,8,448,8,28,236959,28,448,0,0,0,0,0
148.04,6,150,116523,93,1321,1609,1448,103986,57,797,2638,5255,12537
1744.22,6,95,7203,63,38,28132,205,4476,32,33,56251,98,2727
591.171,6,67,8070,38,100,15977,722,3679,29,143,21106,1440,4391
1783.316,17,83,3480,82,14,22016,14,3444,1,8,0,8,36
1784.949,6,102,8364,68,66,26641,66,4964,34,60,54086,60,3400
15.539,17,6,528,3,48,7765,48,228,3,72,7765,72,300
917.05,6,82,9462,44,86,19228,721,4189,38,109,24779,1448,5273
78.298,17,4,352,2,60,78296,60,176,2,60,78297,60,176
5.023,6,2,176,1,0,0,0,40,1,96,0,96,136
16.28,17,21,7229,10,317,1808,1350,3454,11,315,1625,1350,3775
575.564,1,4,1541,4,357,191854,421,1541,0,0,0,0,0
0.174,1,2,112,2,28,174,28,112,0,0,0,0,0
0.94,6,10,1687,7,100,156,100,384,3,1179,338,1179,1303
29.781,6,38,9586,18,289,1751,721,3329,20,681,1513,1420,6257
7.655,17,64,46392,25,304,318,1350,8301,39,948,121,1350,38091
1788.717,17,83,3480,82,14,22082,14,3444,1,8,0,8,36
252.312,17,4,558,2,36,252305,36,128,2,187,252307,187,430
0.217,1,2,163,2,53,217,78,163,0,0,0,0,0
38.94,6,27,7177,13,155,3245,267,1306,14,530,2994,3417,5871
0.052,17,2,304,1,60,0,60,88,1,188,0,188,216
15.028,17,4,304,2,48,15017,48,152,2,48,14886,48,152
1781.764,6,362,22898,210,69,8525,69,12678,152,69,11799,69,10220
1786.5,6,106,8524,68,66,26664,66,4964,38,60,48281,60,3560
1786.082,6,104,8376,68,65,26657,65,4930,36,59,51028,59,3446
1789.366,17,142,11360,71,48,25562,48,5396,71,56,25562,56,5964
7.974,6,14,2243,8,210,1138,210,844,6,545,1594,905,1399
1.956,6,14,2351,8,188,279,245,700,6,703,339,1152,1651
0.058,6,11,913,6,182,11,182,490,5,77,6,134,423
1744.118,6,94,7151,62,38,28592,205,4424,32,33,56250,98,2727
0.857,6,27,5740,13,125,71,267,1275,14,650,59,1420,4465
312.319,6,11,700,6,106,62463,106,460,5,0,3863,0,240
0.151,17,4,284,2,32,76,32,120,2,54,77,60,164
1781.185,17,79,3312,78,14,23132,14,3276,1,8,0,8,36
168.929,6,217,171415,135,1308,1260,1408,156255,82,640,2082,2439,15160
1.18,6,376,322367,147,236,8,256,10257,229,1358,5,1804,312110
3.647,17,8,2020,4,30,1212,30,232,4,419,1212,468,1788
123.936,6,32,7717,12,155,28,267,1266,20,376,6522,3417,6451
0.696,6,10,968,5,256,170,256,460,5,304,170,304,508
52.128,17,4,352,2,60,52126,60,176,2,60,52127,60,176
1773.002,6,209,24070,132,89,13534,981,11118,77,135,23324,1420,12952
5.03,17,4,288,2,36,4998,36,128,2,52,4999,52,160
268.461,17,4,352,2,60,268460,60,176,2,60,268459,60,176
10.53,1,6,336,6,28,2106,28,336,0,0,0,0,0
1785.21,17,163,14204,81,59,22315,136,7124,82,58,22039,72,7080
186.744,6,35,11193,12,305,16972,517,1548,23,563,8486,1408,9645
196.493,17,4,240,2,32,196492,32,120,2,32,196492,32,120
11.24,6,27,11355,13,275,936,275,1078,14,1078,815,1414,10277
0.083,6,9,1345,5,145,20,145,349,4,832,22,832,996
0.684,17,24,12261,12,557,61,1350,7020,12,408,59,1350,5241
288.881,17,4,352,2,60,288880,60,176,2,60,288880,60,176
0.044,17,4,680,2,33,0,33,122,2,251,34,323,558
432.131,17,8,892,8,83,61733,346,892,0,0,0,0,0
1164.885,6,127,7803,63,48,18785,208,4499,64,31,18487,31,3304
0.445,17,14,7087,7,605,74,1350,4434,7,351,65,1350,2653
280.46,6,30,7432,14,158,21573,267,1357,16,678,18691,3456,6075
240.327,6,93,80671,30,186,8286,585,2701,63,1409,3875,2836,77970
1796.886,1,345,28980,345,56,5223,56,28980,0,0,0,0,0
1782.245,17,79,3312,78,14,23146,14,3276,1,8,0,8,36
2.327,6,29,10374,17,368,145,837,1789,12,1012,203,1420,8585
1786.008,1,214,11984,214,28,8385,28,11984,0,0,0,0,0
0.467,17,2,144,1,36,0,36,64,1,52,0,52,80
240.19,6,55,19697,30,842,8282,1418,16733,25,207,10007,580,2964
0.021,6,15,3980,8,124,3,124,548,7,1020,3,1448,3432
10.258,17,4,5492,4,1345,3419,1350,5492,0,0,0,0,0
0.421,6,10,968,5,256,101,256,460,5,304,101,304,508
1791.129,6,357,22629,208,69,8652,69,12460,149,69,12101,69,10169
352.36,6,22,6555,4,106,117453,106,274,18,370,20719,1420,6281
280.424,6,29,7392,13,158,23368,267,1317,16,678,18692,2085,6075
0.66,6,15,2638,8,288,78,288,640,7,568,80,853,1998
0.021,17,2,203,1,35,0,35,63,1,112,0,112,140
2.532,17,35,10584,15,295,178,1350,4854,20,258,131,1350,5730
52.165,6,327,188852,210,845,249,1135,183490,117,341,449,341,5362
23.863,6,35,8288,16,175,1590,721,2044,19,608,1300,1440,6244
1793.241,6,370,25508,213,93,8458,469,14605,157,69,11492,69,10903
7.103,6,1932,1811300,1238,1385,5,1408,1770548,694,931,9,2801,40752
0.189,17,2,572,1,39,0,39,67,1,477,0,477,505
839.117,17,14,4856,14,318,64547,548,4856,0,0,0,0,0
1795.702,17,447,39864,402,35,4478,288,25644,45,288,40018,288,14220
20.253,17,6,6388,6,1036,4050,1043,6388,0,0,0,0,0
1786.639,6,106,8388,68,64,26666,64,4896,38,58,48285,58,3492
1.206,6,24,8004,12,164,93,267,1288,12,1014,93,2411,6716
251.783,2,3,96,3,8,125891,8,96,0,0,0,0,0
52.87,17,14,793,6,26,10571,29,324,8,30,7510,41,469
1786.988,6,102,8228,68,64,26671,64,4896,34,58,54148,58,3332
1798.647,6,385,27253,221,102,8175,469,16208,164,69,11033,69,11045
1740.489,17,29,30566,29,1026,62160,1026,30566,0,0,0,0,0
1794.438,17,293,63963,293,190,6145,422,63963,0,0,0,0,0
1792.187,6,366,23265,210,69,8575,69,12747,156,69,11562,69,10518
1787.627,6,205,14146,75,46,24157,46,5956,130,46,13856,46,8190
0.223,6,3,168,1,0,0,0,52,2,0,44,0,116
0.127,6,61,48392,24,152,5,255,1864,37,1351,3,2804,46528
0.031,17,2,329,1,45,0,45,73,1,228,0,228,256
1799.734,17,449,39928,404,35,4465,288,25708,45,288,40020,288,14220
42.91,6,26,7186,7,133,2021,267,821,19,430,2383,2840,6365
1782.804,6,356,22520,208,69,8612,69,12460,148,69,12127,69,10060
1772.198,6,180,15480,120,69,14892,69,8940,60,69,30032,69,6540
372.004,6,19,1303,14,177,28615,177,925,5,110,17678,110,378
103.985,6,134,114467,86,854,57,1360,12864,48,2491,2209,8160,101603
0.007,17,2,554,1,30,0,30,58,1,468,0,468,496
300.72,6,53,30057,27,190,11566,444,2265,26,1391,12028,5149,27792
1789.772,17,140,11200,70,48,25938,48,5320,70,56,25938,56,5880
73.736,6,20,816,9,0,6885,0,364,11,0,7372,0,452
1786.322,6,104,8444,68,66,26661,66,4964,36,60,51035,60,3480
40.69,6,19,3602,13,304,3390,304,3104,6,83,8117,83,498
9.119,2,2,64,2,8,9119,8,64,0,0,0,0,0
2.756,17,27,9748,11,333,275,1350,3977,16,332,116,1350,5771
1743.811,6,110,8964,71,46,24911,205,5214,39,44,45879,170,3750
601.555,2,5,160,5,8,150388,8,160,0,0,0,0,0
58.474,1,4,578,4,116,19491,197,578,0,0,0,0,0
8.111,1,9,756,0,0,0,0,0,9,56,1013,56,756
1786.808,6,103,8401,69,65,26276,65,5035,34,59,54109,59,3366
5.525,6,39,7269,20,218,290,314,3423,19,513,292,1179,3846
1772.972,6,180,15480,120,69,14898,69,8940,60,69,30049,69,6540
1792.848,1,239,13384,239,28,7532,28,13384,0,0,0,0,0
10.746,6,18,5610,10,275,1194,275,958,8,1440,815,1440,4652
1792.315,17,145,9280,145,36,12446,36,9280,0,0,0,0,0
98.553,6,926,461738,512,838,192,1152,440387,414,398,238,1152,21351
60.066,17,231,45672,0,0,0,0,0,231,169,261,308,45672
0.633,6,22,7284,13,319,52,602,1960,9,1209,71,2736,5324
0.003,17,4,352,2,60,0,60,176,2,60,1,60,176
6.324,6,116,93602,60,333,107,333,5936,56,1764,114,2736,87666
0.014,17,2,295,1,35,0,35,63,1,204,0,204,232
0.108,2,3,96,3,8,54,8,96,0,0,0,0,0
34.426,17,48,22441,24,694,1495,1350,17330,24,184,1495,1350,5111
300.205,6,48,29689,28,190,11118,444,2321,20,1754,12641,6557,27368
1153.509,6,15,910,10,31,128167,31,555,5,31,288368,31,355
195.52,6,25,6846,7,154,32586,267,752,18,447,11499,1460,6094
0.748,6,2,87,1,0,0,0,40,1,7,0,7,47
0.365,17,3,543,2,39,103,39,134,1,381,0,381,409
595.271,1,7,2408,7,316,99211,371,2408,0,0,0,0,0
360.995,2,3,96,3,8,180497,8,96,0,0,0,0,0
174.56,6,29,7392,13,158,14546,267,1317,16,603,11635,1400,6075
7.752,17,12,1764,6,48,1547,48,456,6,190,1547,308,1308
189.911,17,4,352,2,60,189910,60,176,2,60,189910,60,176
1783.495,6,102,10706,50,168,36396,517,3460,52,644,34969,2409,7246
1759.754,1,20,1120,20,28,92618,28,1120,0,0,0,0,0
377.212,6,23,1535,16,177,25147,177,1053,7,110,10417,110,482
0.513,6,27,9018,13,248,42,633,1678,14,941,36,1368,7340
1744.831,1,56,4704,0,0,0,0,0,56,56,31724,56,4704
96.012,6,35,18772,18,702,49,1360,4967,17,1092,5992,2150,13805
1799.313,17,430,34208,403,35,4475,288,25676,27,288,67720,288,8532
2.313,6,16,3248,9,49,289,92,563,7,463,37,1408,2685
1799.365,17,450,39960,405,35,4453,288,25740,45,288,40020,288,14220
1.752,17,15,8457,8,705,250,1350,5868,7,341,283,1350,2589
343.956,6,72,15879,39,530,9051,1402,12121,33,169,10746,580,3758
3.335,17,16,8555,8,657,476,1350,5481,8,356,416,1350,3074
0.32,17,8,2774,8,318,45,357,2774,0,0,0,0,0
1795.692,1,58,4872,0,0,0,0,0,58,56,31503,56,4872
1785.785,6,106,8388,68,64,26653,64,4896,38,58,48262,58,3492
0.151,17,2,290,1,40,0,40,68,1,194,0,194,222
36.973,17,18,1368,18,48,2174,48,1368,0,0,0,0,0
378.46,2,3,96,3,8,189230,8,96,0,0,0,0,0
1789.326,17,140,11200,70,48,25932,48,5320,70,56,25932,56,5880
1.939,6,29,9078,14,232,149,569,1666,15,941,133,1438,7412
1799.394,17,449,39416,404,34,4464,288,25444,45,282,40018,288,13972
34.831,6,27,3766,14,304,2679,304,2560,13,83,2871,83,1206
1787.916,17,124,9920,62,48,29309,48,4712,62,56,29309,56,5208
1794.424,17,304,68119,304,196,5922,356,68119,0,0,0,0,0
1744.668,2,16,512,16,8,116311,8,512,0,0,0,0,0
5.366,6,39,7285,20,218,282,314,3423,19,516,283,1179,3862
1740.287,6,87,6322,58,31,30531,31,3915,29,31,62149,31,2407
2.699,6,12,1636,6,503,539,503,835,6,473,539,473,801
484.595,6,58,7408,27,103,14468,721,2755,31,138,16147,1448,4653
0.692,17,19,13195,11,937,68,1350,10625,8,293,94,1350,2570
0.266,6,27,6202,13,181,22,537,1578,14,486,19,1448,4624
293.13,2,3,96,3,8,146565,8,96,0,0,0,0,0
4.136,6,39,7269,19,218,229,314,3383,20,440,204,1152,3886
0.947,6,21,5988,12,281,86,544,1328,9,716,105,1420,4660
252.066,6,31,8912,14,158,19389,267,1357,17,687,15746,1781,7555
1787.878,6,365,23156,211,69,8513,69,12787,154,69,11685,69,10369
20.001,17,3,192,3,36,10000,36,192,0,0,0,0,0
1.214,17,2,122,2,33,1214,33,122,0,0,0,0,0
1.692,6,13,2311,8,188,241,245,700,5,1407,360,1407,1611
60.373,6,9,515,5,43,15093,43,299,4,0,20120,0,216
280.531,6,30,7432,14,158,21579,267,1357,16,678,18698,3456,6075
1781.836,6,105,8416,68,65,26594,65,4930,37,59,49492,59,3486
0.301,6,26,8988,13,246,25,622,1670,13,947,24,1448,7318
1789.353,17,142,11360,71,48,25561,48,5396,71,56,25561,56,5964
0.028,17,4,352,2,60,25,60,176,2,60,27,60,176
1787.006,6,104,8308,68,64,26671,64,4896,36,58,51054,58,3412
38.558,6,39,8586,15,333,51,685,1656,24,331,1668,2720,6930
1.346,6,45,19458,27,917,51,1360,13962,18,476,68,2720,5496
1785.599,6,182,15629,121,69,14879,69,9049,61,69,29758,69,6580
245.592,17,19,7088,19,345,13644,548,7088,0,0,0,0,0
503.734,6,54,8362,28,116,18655,517,2411,26,417,20147,1418,5951
1797.591,6,356,22520,208,69,8684,69,12460,148,69,12228,69,10060
1785.858,6,366,22920,208,69,8627,69,12460,158,59,11374,69,10460
0.105,17,3,618,2,32,9,32,120,1,470,0,470,498
0.024,17,2,171,1,39,0,39,67,1,76,0,76,104
16.746,6,11,856,3,106,8373,106,234,8,90,2365,90,622
80.299,6,16,1032,7,46,13383,46,442,9,46,10019,46,590
0.535,17,3,451,2,39,55,39,134,1,289,0,289,317
3.813,17,4,296,4,46,1271,46,296,0,0,0,0,0
0.022,17,2,180,1,30,0,30,58,1,94,0,94,122
11.726,17,14,16232,14,1131,902,1450,16232,0,0,0,0,0
120.362,2,3,96,3,8,60181,8,96,0,0,0,0,0
175.736,6,36,8354,17,345,3774,720,1747,19,416,9755,2720,6607
94.134,6,50,13196,25,876,998,1360,7239,25,290,3915,1360,5957
1780.808,17,140,11200,70,48,25808,48,5320,70,56,25808,56,5880
1624.372,2,15,480,15,8,116026,8,480,0,0,0,0,0
1.757,17,25,15372,12,592,157,1350,7440,13,582,143,1350,7932
40.771,6,16,940,6,0,8154,0,340,10,0,4364,0,600
1787.342,6,358,22669,209,69,8592,69,12569,149,69,12076,69,10100
52.686,6,44,13842,22,1015,425,1360,8067,22,325,2500,1360,5775
1775.99,1,59,4956,0,0,0,0,0,59,56,30620,56,4956
0.062,17,2,144,1,36,0,36,64,1,52,0,52,80
286.275,6,22,1172,12,0,26023,0,640,10,0,31807,0,532
1770.257,6,103,9448,66,65,27234,65,5577,37,59,49170,59,3871
0.947,6,10,1687,7,100,157,100,384,3,1179,346,1179,1303
1798.308,1,56,4704,56,56,32696,56,4704,0,0,0,0,0
32.152,17,4,304,2,48,32151,64,152,2,48,32151,64,152
1783.814,6,361,22858,210,69,8534,69,12678,151,69,11892,69,10180
65.585,6,27,8937,9,155,297,267,1146,18,504,3857,4846,7791
1780.607,17,399,133028,399,305,4473,422,133028,0,0,0,0,0
264.54,6,31,8912,14,158,20349,267,1357,17,763,16528,2076,7555
0.123,6,11,912,6,181,24,181,489,5,77,18,134,423
71.416,6,25,8870,12,654,78,1440,3129,13,744,5936,1440,5741
1788.597,1,178,9968,178,28,10105,28,9968,0,0,0,0,0
1723.425,17,12,498,11,14,172342,14,462,1,8,0,8,36
199.272,17,4,272,2,40,199271,47,136,2,40,199270,47,136
1564.23,2,14,448,14,8,120325,8,448,0,0,0,0,0
1744.617,2,24,768,24,8,75852,8,768,0,0,0,0,0
57.148,6,31,7725,11,155,9,267,1226,20,355,3007,3417,6499
0.808,17,2,116,2,30,808,30,116,0,0,0,0,0
354.468,17,7,2344,7,306,59078,308,2344,0,0,0,0,0
390.43,17,3,228,3,48,195215,48,228,0,0,0,0,0
1699.459,17,12,498,11,14,169945,14,462,1,8,0,8,36
24.174,17,12,5892,6,584,4834,1350,3673,6,341,4828,1350,2219
336.293,6,1016,881845,642,1430,524,1460,857088,374,167,117,1460,24757
10.604,6,16,3911,9,275,1325,275,643,7,992,962,1440,3268
1776.402,17,86,3606,85,14,21147,14,3570,1,8,0,8,36
1777.081,17,138,11040,69,48,26132,48,5244,69,56,26132,56,5796
1.748,6,13,2311,8,188,249,245,700,5,1407,370,1407,1611
44.083,6,27,7177,13,155,3673,267,1306,14,530,3390,3417,5871
25.477,6,15,2245,9,324,3184,585,1125,6,396,5058,580,1120
0.269,6,20,4960,10,137,29,267,1092,10,692,28,1467,3868
1772.293,6,180,15480,120,69,14893,69,8940,60,69,30033,69,6540
121.779,17,4,352,2,60,121777,60,176,2,60,121777,60,176
1.582,6,41,9968,21,440,79,1360,4392,20,476,71,2720,5576
1.565,6,52,19128,28,937,57,1460,13347,24,400,57,1460,5781
1664.352,1,8,448,8,28,237764,28,448,0,0,0,0,0
1.096,17,3,1167,3,361,548,361,1167,0,0,0,0,0
220.725,6,25,6338,9,272,241,516,1180,16,347,14709,1452,5158
120.72,6,29,8832,14,158,9286,267,1357,15,981,8613,3465,7475
3.76,17,3,1167,3,361,1880,361,1167,0,0,0,0,0
1.326,6,38,8252,19,320,73,1162,2716,19,476,63,2715,5536
58.965,17,4,240,2,32,58964,32,120,2,32,58964,32,120
1791.908,6,387,61093,245,302,7343,302,44796,142,83,12708,83,16297
1793.866,17,144,11520,72,48,25265,48,5472,72,56,25265,56,6048
33.697,17,442,451803,108,196,314,1350,24285,334,1251,96,1350,427518
1785.856,6,365,25501,212,100,8463,469,14896,153,69,11749,69,10605
305.668,6,95,15860,45,259,6947,1189,6741,50,253,6233,1420,9119
47.332,6,28,7352,13,158,3944,267,1317,15,678,3377,3456,6035
0.914,6,10,1687,7,100,152,100,384,3,1179,330,1179,1303
282.924,6,27,7573,13,175,23577,267,1578,14,678,21748,2045,5995
7.686,6,23,7364,13,325,640,626,1984,10,1210,850,2736,5380
4.158,17,5,1716,5,315,1039,376,1716,0,0,0,0,0
191.392,6,6,394,3,122,91,122,262,3,0,95624,0,132
70.66,6,23,8166,12,201,52,290,1115,11,942,7053,2720,7051
1793.473,6,369,25730,214,99,8420,469,15114,155,69,11642,69,10616
40.187,17,22,1936,11,48,4017,48,836,11,72,4017,72,1100
1772.703,6,180,15480,120,69,14896,69,8940,60,69,30041,69,6540
49.7,17,4,352,2,60,49699,60,176,2,60,49698,60,176
6.035,6,1532,1405294,960,1386,6,1408,1370886,572,931,10,2801,34408
225.27,17,10,880,5,48,56314,48,380,5,72,56314,72,500
44.198,17,15,7808,8,655,6314,1350,5466,7,306,2519,1350,2342
0.496,6,26,8868,13,227,41,547,1592,13,941,38,1448,7276
1794.253,17,66,2766,65,14,28035,14,2730,1,8,0,8,36
0.039,17,4,368,2,32,29,32,120,2,96,0,96,248
0.248,1,2,112,2,28,248,28,112,0,0,0,0,0
12.262,6,20,1495,10,222,1357,222,848,10,231,1357,231,647
0.041,17,4,284,2,32,1,32,120,2,54,4,60,164
34.337,17,6,1236,3,48,17164,48,228,3,308,17163,308,1008
1797.382,17,352,26752,352,48,5120,48,26752,0,0,0,0,0
520.957,6,34,2469,17,31,32549,31,1132,17,31,32549,31,1337
1.279,6,39,9888,20,502,67,1460,4352,19,433,61,1460,5536
31.682,6,7,396,1,0,0,0,60,6,0,6302,0,336
1788.133,17,87,3648,86,14,21036,14,3612,1,8,0,8,36
1790.029,17,179,13962,179,50,10056,50,13962,0,0,0,0,0
0.132,6,9,1338,5,145,33,145,349,4,825,27,825,989
68.309,6,30,7432,13,158,5692,267,1317,17,543,4266,1400,6115
105.795,17,4,240,2,32,105794,32,120,2,32,105794,32,120
5.185,6,38,7229,20,218,272,314,3423,18,513,290,1179,3806
1740.673,17,30,31680,30,1028,60023,1028,31680,0,0,0,0,0
1797.382,6,366,25610,213,99,8478,469,15005,153,69,11823,69,10605
21.411,6,24,5869,13,229,1784,517,1649,11,606,2140,998,4220
1789.507,6,130,12799,80,64,22651,722,6664,50,84,36513,1408,6135
0.84,17,11,7418,7,756,140,1350,5491,4,453,247,1350,1927
1.098,17,6,936,3,64,538,64,276,3,192,539,192,660
62.879,6,19,1543,8,275,8982,275,603,11,96,6126,96,940
1773.327,6,204,22330,130,75,13746,267,10057,74,132,24288,1460,12273
47.646,6,2,104,2,0,0,0,104,0,0,0,0,0
1798.625,6,356,22520,208,69,8689,69,12460,148,69,12235,69,10060
32.251,17,4,240,2,32,32249,32,120,2,32,32250,32,120
0.427,6,52,21011,29,973,15,1380,15804,23,387,17,1923,5207
1798.854,1,15,840,15,28,128489,28,840,0,0,0,0,0
4.784,6,59,41294,34,880,144,1360,13720,25,1475,194,6303,27574
2.181,17,4,360,2,30,1917,30,116,2,94,1944,94,244
82.891,2,5,160,5,8,20722,8,160,0,0,0,0,0
1779.0,6,223,25458,133,89,13477,981,11227,90,126,19984,1420,14231
1773.195,6,180,15480,120,69,14900,69,8940,60,69,30052,69,6540
5.413,6,3,511,2,0,5413,0,80,1,391,0,391,431
12.105,6,1911,1663326,1159,1379,10,1420,1629025,752,467,16,1883,34301
317.965,6,439,380588,286,1365,1115,1448,354825,153,539,2034,1448,25763
0.271,17,6,2117,6,324,54,354,2117,0,0,0,0,0
1.342,6,41,10061,22,502,63,1460,4480,19,437,64,2615,5581
8.151,6,12,3341,7,170,1358,170,554,5,1259,1988,1368,2787
0.368,17,4,624,2,64,366,64,184,2,192,246,192,440
1794.768,6,358,22669,209,69,8628,69,12569,149,69,12126,69,10100
234.358,6,28,12374,10,220,6239,516,1285,18,647,13780,1452,11089
2.464,17,14,5083,14,335,189,361,5083,0,0,0,0,0
1787.243,6,174,32757,101,405,17872,1258,24338,73,107,24821,312,8419
10.683,2,3,144,3,24,5341,32,144,0,0,0,0,0
1797.636,17,448,39896,403,35,4471,288,25676,45,288,40017,288,14220
0.564,17,2,180,1,30,0,30,58,1,94,0,94,122
1.121,6,24,9027,14,280,86,764,1715,10,1150,101,2720,7312
280.265,6,30,7432,13,158,23355,267,1317,17,543,17512,1400,6115
15.165,6,2680,2529525,1740,1376,8,1408,2475969,940,931,15,2801,53556
1.233,6,25,8056,12,164,96,267,1288,13,869,87,1448,6768
280.438,6,29,7392,13,158,23369,267,1317,16,603,18690,2800,6075
0.727,17,11,4635,5,432,181,1350,2300,6,361,64,1350,2335
2.459,6,25,6058,12,108,223,147,919,13,768,203,1581,5139
1746.3,6,94,7151,62,38,28627,205,4424,32,33,56317,98,2727
284.244,1,4,326,4,53,94748,78,326,0,0,0,0,0
2.563,6,3,120,2,0,2563,0,80,1,0,0,0,40
10.569,6,1713,1458017,1013,1383,10,1420,1425772,700,467,15,1883,32245
61.908,6,69,49604,45,1190,1407,1408,41623,24,960,2681,3847,7981
1692.191,17,16,1265,8,30,241734,37,471,8,71,241737,136,794
3.015,17,3,264,3,60,1507,60,264,0,0,0,0,0
0.012,17,2,340,1,32,0,32,60,1,252,0,252,280
0.061,17,2,118,1,31,0,31,59,1,31,0,31,59
1.99,17,2,122,2,33,1990,33,122,0,0,0,0,0
1208.136,6,111,15783,70,89,17509,876,7303,41,211,27975,4029,8480
2.312,6,54,19377,27,886,88,1440,13521,27,433,81,1440,5856
1772.194,6,180,15480,120,69,14892,69,8940,60,69,30033,69,6540
1.02,17,2,116,2,30,1020,30,116,0,0,0,0,0
31.464,6,4,192,1,0,0,0,48,3,0,12072,0,144
0.014,17,4,865,2,47,1,47,150,2,329,1,341,715
100.457,17,4,240,2,32,100456,32,120,2,32,100456,32,120
55.0,17,4,240,2,32,54999,32,120,2,32,54999,32,120
296.518,17,4,352,2,60,296517,60,176,2,60,296517,60,176
1741.985,6,118,11986,75,63,23540,722,6267,43,99,41467,2329,5719
2.098,17,4,236,2,31,2051,31,118,2,31,2072,31,118
4.276,6,33,6129,17,206,267,314,2744,16,548,267,1179,3385
1437.439,6,87,7284,61,66,23957,66,4684,26,60,54164,60,2600
1795.14,1,58,4872,0,0,0,0,0,58,56,31493,56,4872
1.319,6,50,18807,29,852,47,1360,13146,21,437,57,2715,5661
3.007,6,2,88,2,0,0,0,88,0,0,0,0,0
3.815,17,5,340,5,40,953,40,340,0,0,0,0,0
4.346,6,40,7309,19,218,241,314,3383,21,440,203,1152,3926
1768.961,1,58,4872,58,56,31034,56,4872,0,0,0,0,0
108.501,17,4,352,2,60,108500,60,176,2,60,108499,60,176
4.246,6,39,7269,19,218,235,314,3383,20,513,210,1179,3886
68.342,6,7,373,3,31,34171,31,151,4,31,22208,31,222
1699.46,17,12,498,11,14,169946,14,462,1,8,0,8,36
15.29,6,9,492,5,0,3822,0,268,4,0,5076,0,224
242.318,17,6,528,3,60,121158,60,264,3,60,121158,60,264
0.193,6,12,3462,6,75,38,75,395,6,1373,38,1448,3067
66.304,6,13,1847,8,302,9472,302,1330,5,83,16559,83,517
1791.965,1,256,14336,256,28,7027,28,14336,0,0,0,0,0
1777.9,17,142,11360,71,48,25398,48,5396,71,56,25397,56,5964
1741.069,6,130,7963,72,43,24522,208,4744,58,31,30539,31,3219
249.203,17,4,352,2,60,249201,60,176,2,60,249197,60,176
11.598,6,24,8413,13,275,966,275,1078,11,1147,838,2840,7335
10.989,6,22,4526,12,275,999,275,1038,10,768,705,1440,3488
0.041,17,4,420,2,33,37,33,122,2,121,37,145,298
0.01,17,2,235,1,39,0,39,67,1,140,0,140,168
193.191,17,4,352,2,60,193189,60,176,2,60,193190,60,176
0.016,17,2,351,1,49,0,49,77,1,246,0,246,274
1662.125,1,7,392,7,28,277020,28,392,0,0,0,0,0
7.809,6,11,774,4,106,2603,106,282,7,90,1268,90,492
240.228,6,49,29614,23,243,10919,444,1934,26,1253,9608,1551,27680
1739.54,1,59,4956,59,56,29992,56,4956,0,0,0,0,0
0.084,6,9,1346,5,145,21,145,349,4,833,22,833,997
1773.145,6,180,15480,120,69,14900,69,8940,60,69,30049,69,6540
1.451,6,47,18708,26,924,58,1460,13092,21,476,62,2615,5616
0.988,6,30,12083,16,525,65,1360,3310,14,820,61,1380,8773
125.841,2,2,64,2,8,125841,8,64,0,0,0,0,0
121.181,2,2,64,2,8,121181,8,64,0,0,0,0,0
1785.978,6,150,24780,90,483,20067,483,19170,60,83,30270,83,5610
95.117,6,22,8764,11,314,116,634,1427,11,983,9496,1360,7337
1680.432,1,15,840,15,28,120030,28,840,0,0,0,0,0
1745.286,6,95,7203,63,38,28149,205,4476,32,33,56289,98,2727
0.057,17,4,284,2,32,1,32,120,2,54,0,60,164
1753.567,1,82,6888,0,0,0,0,0,82,56,21648,56,6888
5.146,6,38,7245,19,218,285,314,3383,19,516,270,1179,3862
1778.936,17,82,3438,81,14,22236,14,3402,1,8,0,8,36
2.955,17,6,1453,3,40,1471,40,204,3,388,1468,407,1249
1799.057,17,450,39960,405,35,4453,288,25740,45,288,40020,288,14220
0.147,17,2,290,1,40,0,40,68,1,194,0,194,222
936.591,6,89,5672,46,48,20813,208,3301,43,31,22282,31,2371
117.588,6,74,18216,29,424,4199,1189,6264,45,289,2668,1420,11952
1792.011,1,190,20140,190,78,9481,78,20140,0,0,0,0,0
1746.585,6,95,7203,63,38,28170,205,4476,32,33,56333,98,2727
1798.178,17,449,39928,404,35,4461,288,25708,45,288,40023,288,14220
14.13,6,684,568165,377,1424,37,1448,546839,307,899,43,1448,21326
34.699,6,4915,4659520,3220,1369,10,1408,4566716,1695,931,20,2816,92804
109.768,6,13378,12846492,8745,1389,12,1440,12600864,4633,776,23,1440,245628
0.31,17,4,668,2,32,305,32,120,2,246,301,246,548
1780.967,6,180,15480,120,69,14966,69,8940,60,69,30172,69,6540
2.833,6,2,88,2,0,0,0,88,0,0,0,0,0
5.052,17,4,824,2,48,5045,48,152,2,308,5044,308,672
5.423,6,39,7285,20,218,285,314,3423,19,516,286,1179,3862
1769.193,1,59,4956,0,0,0,0,0,59,56,30503,56,4956
116.693,6,21,8712,11,314,89,634,1415,10,1147,12948,2720,7297
0.865,6,2,1194,1,0,0,0,40,1,1114,0,1114,1154
0.177,17,2,204,1,34,0,34,62,1,114,0,114,142
447.328,17,8,2688,8,308,63904,308,2688,0,0,0,0,0
3.978,17,4,296,4,46,1326,46,296,0,0,0,0,0
24.234,6,3786,3654254,2558,1353,9,1368,3585722,1228,776,19,1473,68532
1744.643,2,24,768,24,8,75854,8,768,0,0,0,0,0
1.129,6,14,1745,7,288,171,288,600,7,426,158,434,1145
0.255,17,3,487,2,39,62,39,134,1,325,0,325,353
0.209,6,3,156,2,0,209,0,104,1,0,0,0,52
23.148,6,35,8259,17,175,1446,722,2086,18,681,1349,2760,6173
9.797,6,44,8809,22,191,466,721,2417,22,611,457,1440,6392
85.295,6,91,65863,57,1232,1523,1368,57203,34,841,1891,2519,8660
38.816,17,22,1936,11,48,3880,48,836,11,72,3880,72,1100
1786.774,17,142,11360,71,48,25524,48,5396,71,56,25524,56,5964
5.054,17,4,288,2,36,5006,36,128,2,52,5003,52,160
180.371,17,4,352,2,60,180370,60,176,2,60,180370,60,176
1680.362,1,15,840,15,28,120025,28,840,0,0,0,0,0
4.986,6,40,7309,20,218,262,314,3423,20,513,246,1179,3886
2.322,6,34,13616,18,525,136,1360,3402,16,869,100,1380,10214
0.147,6,10,1383,6,145,29,145,389,4,830,45,830,994
1786.596,6,102,8228,68,64,26665,64,4896,34,58,54136,58,3332
16.801,17,37,15245,17,483,1050,1350,8694,20,299,874,1350,6551
64.616,17,4,240,2,32,64615,32,120,2,32,64614,32,120
0.141,17,4,284,2,32,0,32,120,2,54,115,60,164
5.997,17,4,586,2,37,5993,37,130,2,200,5993,200,456
0.13,1,2,112,2,28,130,28,112,0,0,0,0,0
0.423,6,5,248,3,0,211,0,144,2,0,420,0,104
103.809,6,23,9823,12,410,50,922,1742,11,1089,10368,3056,8081
18.809,17,40,10380,40,231,482,389,10380,0,0,0,0,0
369.408,6,21,1419,15,177,26386,177,989,6,110,12243,110,430
74.358,1,6,336,6,28,14871,28,336,0,0,0,0,0
0.086,17,4,288,2,33,0,33,122,2,55,1,61,166
5.774,6,575,526400,377,1332,14,1368,511440,198,776,28,2736,14960
1776.257,17,73,3060,72,14,25017,14,3024,1,8,0,8,36
270.079,17,4,786,2,34,270069,39,124,2,303,270073,316,662
1795.276,6,387,26498,219,99,8234,469,15245,168,56,10750,69,11253
0.807,6,26,5887,13,156,67,267,1462,13,650,60,1420,4425
1740.872,6,87,6322,58,31,30541,31,3915,29,31,62173,31,2407
0.108,17,4,2876,2,689,108,1350,1434,2,693,72,1350,1442
372.169,6,18,1239,14,177,28628,177,913,4,110,20062,110,326
1799.144,17,449,39928,404,35,4464,288,25708,45,288,40019,288,14220
15.457,17,16,5432,8,373,2204,1350,3213,8,249,2203,1350,2219
50.404,6,63,17350,34,303,29,1360,8669,29,441,1795,4649,8681
0.044,17,2,144,1,36,0,36,64,1,52,0,52,80
280.179,6,28,7352,13,158,23348,267,1317,15,678,20010,2800,6035
1.161,6,10,1687,7,100,193,100,384,3,1179,449,1179,1303
0.319,6,26,9012,13,252,26,646,1694,13,1105,26,2804,7318
125.901,2,2,64,2,8,125901,8,64,0,0,0,0,0
11.406,6,14,2245,8,211,1629,211,846,6,545,2270,904,1399
27.399,6,45,9694,27,168,1053,517,3613,18,467,1610,499,6081
0.19,6,26,7256,13,155,15,267,1301,13,603,14,2036,5955
1672.616,1,7,392,7,28,278769,28,392,0,0,0,0,0
0.448,6,24,6015,13,108,37,147,959,11,768,43,1581,5056
1798.8,17,449,39928,404,35,4463,288,25708,45,288,40016,288,14220
0.422,6,12,1653,6,288,82,288,548,6,426,50,434,1105
1772.688,6,180,15480,120,69,14896,69,8940,60,69,30037,69,6540
300.698,6,49,9051,25,266,12529,720,2182,24,346,666,2720,6869
3.322,17,5,295,5,31,830,31,295,0,0,0,0,0
378.889,6,21,1419,15,177,27063,177,989,6,110,12266,110,430
1.475,6,12,1304,6,256,293,256,756,6,304,293,304,548
0.436,6,24,6042,13,108,36,147,959,11,773,41,1608,5083
67.777,17,4,352,2,60,67776,60,176,2,60,67776,60,176
141.976,6,25,5613,10,107,15774,159,970,15,966,10140,1668,4643
2.246,6,431,319438,230,1369,9,1420,306313,201,526,11,3303,13125
0.008,6,12,3947,8,114,1,114,454,4,3321,2,3321,3493
0.056,17,2,245,1,32,0,32,60,1,157,0,157,185
25.424,6,37,8409,18,171,1495,721,2094,19,616,1402,2840,6315
511.782,1,3,168,3,28,255891,28,168,0,0,0,0,0
1783.372,17,337,25612,337,48,5307,48,25612,0,0,0,0,0
0.35,6,4,160,2,0,178,0,80,2,0,178,0,80
38.09,17,11,836,11,48,3809,48,836,0,0,0,0,0
3.163,6,12,3061,5,92,790,92,348,7,1164,457,1408,2713
10.975,17,4,304,4,48,3658,48,304,0,0,0,0,0
1682.011,17,14,1036,7,30,280330,30,406,7,62,280330,62,630
0.175,17,2,193,1,34,0,34,62,1,103,0,103,131
240.464,6,62,25116,32,548,7756,1418,6610,30,941,8291,1418,18506
254.422,1,10,840,10,56,28269,56,840,0,0,0,0,0
419.772,2,4,128,4,8,139924,8,128,0,0,0,0,0
1719.549,17,12,498,11,14,171954,14,462,1,8,0,8,36
1793.198,17,431,57996,202,178,8921,1350,41638,229,43,7864,1350,16358
11.844,6,2301,1998593,1317,1426,8,1448,1937137,984,776,11,1448,61456
238.979,6,32,5374,16,152,15931,722,2060,16,413,7631,1448,3314
1776.025,6,138,8490,72,26,25013,26,4362,66,26,27322,26,4128
87.855,6,873,424585,472,836,186,1152,403754,401,435,219,1179,20831
1.563,6,8,448,5,0,390,0,276,3,0,737,0,172
1143.061,2,9,288,9,8,142882,8,288,0,0,0,0,0
63.199,17,4,1344,4,308,21066,308,1344,0,0,0,0,0
842.318,2,10,320,10,8,93590,8,320,0,0,0,0,0
1504.034,2,14,448,14,8,115694,8,448,0,0,0,0,0
1786.474,6,102,8364,68,66,26663,66,4964,34,60,54132,60,3400
15.481,17,20,2940,10,48,1718,48,760,10,190,1716,308,2180
1754.233,6,90,7600,44,34,40792,36,2518,46,384,38973,445,5082
5.922,6,38,7229,20,218,311,314,3423,18,513,331,1179,3806
6.127,17,5,352,3,36,2914,36,192,2,52,3770,52,160
22.941,6,35,8177,17,188,1433,721,2004,18,605,1337,1420,6173
0.153,17,2,439,1,33,0,33,61,1,350,0,350,378
0.518,17,2,144,1,36,0,36,64,1,52,0,52,80
21.425,17,4,824,2,48,21403,48,152,2,308,21412,308,672
827.048,1,8,448,8,28,118149,28,448,0,0,0,0,0
2.792,6,13,1211,6,177,558,177,493,7,110,412,110,718
0.028,17,2,152,1,48,0,48,76,1,48,0,48,76
21.128,6,18,4915,10,215,2347,517,1173,8,1102,3002,1368,3742
7.234,6,46,23893,24,585,314,753,5755,22,958,334,1360,18138
222.635,17,4,352,2,60,222634,60,176,2,60,222633,60,176
166.023,6,13,923,7,65,27670,65,475,6,52,33188,59,448
1715.414,1,102,10812,102,78,16984,78,10812,0,0,0,0,0
0.53,17,3,451,2,39,17,39,134,1,289,0,289,317
10.988,6,18,4266,10,275,1220,275,958,8,992,887,1440,3308
0.075,6,9,1340,5,145,18,145,349,4,827,20,827,991
300.774,6,21,8792,13,156,25053,285,1311,8,1413,42949,2170,7481
218.786,17,4,240,2,32,218785,32,120,2,32,218785,32,120
1782.252,17,83,3480,82,14,22003,14,3444,1,8,0,8,36
4.032,17,2,134,2,39,4032,39,134,0,0,0,0,0
1781.803,6,80,4250,40,26,45686,26,2132,40,26,45686,26,2118
1750.671,17,12,498,11,14,175067,14,462,1,8,0,8,36
1786.394,6,104,8444,68,66,26662,66,4964,36,60,51036,60,3480
1.105,6,25,8056,12,164,85,267,1288,13,869,78,1448,6768
0.728,17,4,368,2,64,727,64,184,2,64,726,64,184
1788.518,6,125,14634,79,84,22929,497,6385,46,160,39741,1420,8249
0.524,17,3,451,2,39,401,39,134,1,289,0,289,317
7.355,6,5,284,1,0,0,0,60,4,0,2387,0,224
0.007,17,2,682,1,32,0,32,60,1,594,0,594,622
280.404,6,31,7472,13,158,23367,267,1317,18,603,16492,2076,6155
6.735,6,501,402687,293,1305,22,1368,387207,208,776,31,1473,15480
1791.369,6,365,24963,212,94,8489,469,14496,153,69,11783,69,10467
0.095,6,11,911,6,181,19,181,489,5,77,18,133,422
0.018,17,4,380,2,34,11,34,124,2,100,9,112,256
4.188,17,2,656,2,300,4188,300,656,0,0,0,0,0
1739.062,6,87,6322,58,31,30509,31,3915,29,31,62108,31,2407
1218.739,6,45,3440,34,33,36931,33,2527,11,31,91000,31,913
284.365,1,4,224,4,28,94788,28,224,0,0,0,0,0
0.184,17,2,2384,2,1164,184,1164,2384,0,0,0,0,0
113.584,6,165,130681,105,1309,1092,1448,118060,60,632,1910,1448,12621
1790.929,1,342,28728,342,56,5251,56,28728,0,0,0,0,0
0.104,17,2,152,1,48,0,48,76,1,48,0,48,76
1789.47,17,84,3522,83,14,21822,14,3486,1,8,0,8,36
1.246,6,46,19121,27,890,47,1360,13585,19,476,60,2715,5536
5.0,17,4,558,2,36,4995,36,128,2,187,4995,187,430
0.17,6,25,7216,13,155,14,267,1301,12,678,14,2045,5915
27.838,6,3457,3196264,2221,1360,12,1408,3127328,1236,931,22,2816,68936
282.239,6,30,7432,13,158,23519,267,1317,17,603,17637,2076,6115
1.42,6,19,3781,10,234,157,564,1452,9,463,155,1343,2329
2.03,17,3,310,2,31,1016,31,118,1,164,0,164,192
0.255,17,3,451,2,39,75,39,134,1,289,0,289,317
0.756,17,3,1170,3,362,378,362,1170,0,0,0,0,0
1750.584,6,95,7203,63,38,28235,205,4476,32,33,56459,98,2727
31.987,17,33,11977,15,520,2284,1350,8224,18,180,1879,1350,3753
0.938,6,24,8028,12,164,85,267,1312,12,869,70,1408,6716
1782.13,6,356,22520,208,69,8609,69,12460,148,69,12121,69,10060
1773.048,6,180,15480,120,69,14899,69,8940,60,69,30050,69,6540
0.027,17,4,352,2,37,23,37,130,2,83,22,89,222
1.42,6,50,19716,29,917,50,1360,14055,21,437,60,2715,5661
1791.437,17,364,66251,364,154,4935,357,66251,0,0,0,0,0
1781.339,1,65,5460,65,56,27833,56,5460,0,0,0,0,0
0.065,17,2,378,1,50,0,50,78,1,272,0,272,300
80.975,6,30,8872,14,158,6228,267,1357,16,763,5394,1781,7515
8.866,17,4,606,2,45,8837,45,146,2,202,8838,202,460
1798.595,17,87,3648,86,14,21159,14,3612,1,8,0,8,36
27.651,17,4,240,2,32,27649,32,120,2,32,27650,32,120
1.215,6,10,1687,7,100,202,100,384,3,1179,482,1179,1303
119.384,6,81,50246,46,1190,2652,1448,41701,35,839,1815,2359,8545
1779.432,17,140,11200,70,48,25788,48,5320,70,56,25788,56,5880
63.151,17,4,240,2,32,63150,32,120,2,32,63150,32,120
22.764,6,29,4838,15,275,1626,275,1174,14,768,1384,1440,3664
1771.481,6,99,9306,66,66,27253,66,5610,33,60,55355,60,3696
1797.288,1,196,20776,196,78,9216,78,20776,0,0,0,0,0
232.314,6,73,12152,34,198,7039,1189,3749,39,284,6109,1420,8403
13.23,6,21,8265,10,275,1470,275,958,11,1371,1177,1440,7307
0.129,17,2,336,1,37,0,37,65,1,243,0,243,271
280.191,6,30,7432,14,158,21553,267,1357,16,603,18676,1400,6075
0.082,17,2,245,1,32,0,32,60,1,157,0,157,185
1.394,6,41,11378,22,547,66,1360,5842,19,476,66,2720,5536
1783.529,6,103,8470,69,66,26228,66,5070,34,60,54032,60,3400
1773.344,6,181,15589,120,69,14902,69,8940,61,69,29553,69,6649
300.423,6,58,44325,36,1296,8583,1448,38168,22,715,2132,1448,6157
1786.468,6,108,8724,70,66,25890,66,5044,38,60,48279,60,3680
1786.578,6,104,8376,68,65,26665,65,4930,36,59,51042,59,3446
5.184,6,39,7269,20,218,272,314,3423,19,513,271,1179,3846
207.696,17,4,240,2,32,207695,32,120,2,32,207695,32,120
280.262,6,28,7352,12,158,25478,267,1277,16,603,18681,1400,6075
0.213,6,17,6127,9,103,26,103,682,8,1252,30,1472,5445
0.019,17,4,843,2,34,0,34,124,2,331,2,343,719
1796.17,1,278,15568,278,28,6484,28,15568,0,0,0,0,0
60.549,6,27,7177,13,155,5045,267,1306,14,530,4656,3417,5871
28.779,6,40,9368,20,321,1514,721,3056,20,687,1469,1440,6312
1.775,17,2,778,2,361,1775,361,778,0,0,0,0,0
3.172,6,533,432047,310,1363,10,1420,418714,223,526,14,3303,13333
1797.905,17,768,46392,768,32,2344,37,46392,0,0,0,0,0
240.307,6,43,9054,21,523,12015,1408,5810,22,232,11443,639,3244
8.555,6,18,1415,9,222,1068,222,808,9,231,1068,231,607
3.125,17,3,186,3,34,1562,34,186,0,0,0,0,0
1797.791,17,448,39896,403,35,4472,288,25676,45,288,40018,288,14220
162.688,17,8,704,4,48,54226,48,304,4,72,54226,72,400
283.155,6,31,7577,14,149,21781,267,1462,17,603,17689,2076,6115
0.295,6,25,8965,13,261,24,683,1728,12,1100,26,2816,7237
59.201,6,10,768,10,31,6577,31,768,0,0,0,0,0
241.043,6,55,7817,24,251,10478,585,3794,31,199,8033,580,4023
240.308,6,33,9115,15,144,17163,341,1520,18,666,14134,1438,7595
1424.148,17,400,55990,192,172,7456,1350,38472,208,56,6872,1350,17518
0.548,17,2,167,1,39,0,39,67,1,72,0,72,100
1762.844,6,99,9617,45,37,40063,37,2759,54,446,33260,446,6858
5.002,6,42,7389,21,201,250,314,3463,21,440,236,1152,3926
1740.914,6,88,6374,58,31,30542,31,3915,30,31,60031,31,2459
0.1,17,2,122,1,33,0,33,61,1,33,0,33,61
19.51,6,24,6772,7,133,3251,267,821,17,477,1207,1460,5951
1637.404,6,332,22134,176,69,9356,69,10973,156,67,10563,69,11161
10.78,6,18,4266,10,275,1197,275,958,8,992,858,1440,3308
0.015,6,11,3653,6,171,2,171,491,5,1447,3,2676,3162
1762.399,1,62,5208,62,56,28891,56,5208,0,0,0,0,0
1795.795,6,186,11478,93,47,19519,208,6735,93,31,19516,31,4743
0.039,17,2,212,1,46,0,46,74,1,110,0,110,138
1793.884,17,140,11200,70,48,25998,48,5320,70,56,25998,56,5880
0.419,6,54,23686,31,954,13,1380,16601,23,558,17,1923,7085
1792.583,6,164,20976,96,304,18869,304,14752,68,83,26079,83,6224
1786.624,6,356,22520,208,69,8631,69,12460,148,69,12153,69,10060
4.961,17,4,558,2,36,4950,36,128,2,187,4952,187,430
1676.1,6,24,3973,16,262,111740,413,2740,8,114,239418,269,1233
5.489,6,40,7325,21,218,274,314,3463,19,442,289,1152,3862
0.009,17,2,316,1,31,0,31,59,1,229,0,229,257
5.205,17,4,288,2,36,5007,36,128,2,52,1,52,160
1.109,6,25,8056,12,164,85,267,1288,13,869,78,1402,6768
11.115,6,6,352,2,0,11115,0,112,4,0,2388,0,240
11.672,6,1858,1613563,1127,1376,10,1420,1580090,731,467,15,1883,33473
41.023,17,12,1764,6,48,8203,48,456,6,190,8202,308,1308
423.655,6,130,98792,84,1280,5104,1448,87629,46,584,3526,1448,11163
0.318,6,21,7290,12,335,28,668,1974,9,968,38,1912,5316
55.089,6,50,11854,20,615,51,921,3934,30,268,1895,1360,7920
3.83,6,32,6089,17,206,239,314,2744,15,548,255,1179,3345
1787.259,6,102,8364,68,66,26675,66,4964,34,60,54155,60,3400
0.154,6,7,423,4,43,38,43,259,3,0,25,0,164
1763.503,17,168,14050,156,30,11377,37,9090,12,385,154712,463,4960
1737.519,6,123,12203,75,62,23479,722,6235,48,88,36959,1448,5968
0.079,6,10,1495,5,507,19,507,727,5,556,19,556,768
222.995,6,36,11598,20,516,11736,1360,4458,16,648,14854,2720,7140
0.889,6,11,1727,7,100,148,100,384,4,589,212,1152,1343
1799.306,6,415,24880,208,69,8692,69,12460,207,34,8734,64,12420
0.815,6,19,5908,11,281,81,544,1288,8,859,105,2642,4620
300.768,6,50,13251,25,884,12532,1460,7294,25,290,632,1460,5957
18.143,17,4,824,2,48,18132,48,152,2,308,18131,308,672
1769.87,6,108,10016,70,65,25650,65,6045,38,59,47831,59,3971
7.961,2,2,64,2,8,7961,8,64,0,0,0,0,0
1739.31,6,105,7602,66,31,26758,31,4503,39,31,45770,31,3099
8.984,1,3,168,3,28,4492,28,168,0,0,0,0,0
0.501,17,3,451,2,39,421,39,134,1,289,0,289,317
121.018,6,24,9000,12,704,74,1440,3331,12,862,10985,1593,5669
1780.723,17,142,11360,71,48,25438,48,5396,71,56,25438,56,5964
218.729,17,4,352,2,60,218728,60,176,2,60,218728,60,176
7.309,6,1278,1181274,812,1379,8,1408,1152378,466,931,15,2816,28896
1773.152,6,180,15480,120,69,14900,69,8940,60,69,30049,69,6540
1787.209,6,104,8308,68,64,26674,64,4896,36,58,51060,58,3412
887.973,1,8,1106,8,110,126853,207,1106,0,0,0,0,0
0.453,6,13,1693,7,288,73,288,588,6,426,52,434,1105
3.444,6,2,88,2,0,0,0,88,0,0,0,0,0
45.141,17,4,240,2,32,45140,32,120,2,32,45139,32,120
1740.087,17,30,1710,30,29,60003,29,1710,0,0,0,0,0
6.975,1,3,653,3,189,3487,409,653,0,0,0,0,0
6.193,2,2,64,2,8,6193,8,64,0,0,0,0,0
13.724,6,22,6817,12,275,1247,275,1038,10,1073,968,1420,5779
39.941,6,47,13507,23,944,572,1360,7621,24,327,1729,2667,5886
1772.745,6,120,7323,67,27,26859,27,4003,53,27,34090,27,3320
545.731,1,6,336,6,28,109146,28,336,0,0,0,0,0
1.161,6,24,8028,12,164,89,267,1312,12,1014,89,2411,6716
103.55,17,8,640,4,48,34512,48,304,4,56,34511,56,336
1772.917,6,180,15480,120,69,14898,69,8940,60,69,30048,69,6540
1773.238,1,58,4872,58,56,31109,56,4872,0,0,0,0,0
299.55,6,6,364,4,31,99850,31,222,2,31,299525,31,142
1723.475,1,78,8268,78,78,22382,78,8268,0,0,0,0,0
126.52,2,2,64,2,8,126520,8,64,0,0,0,0,0
367.884,6,56,14527,34,490,11148,1360,8769,22,347,416,1360,5758
19.343,6,11,660,4,0,2335,0,240,7,0,3050,0,420
4.359,1,2,112,2,28,4359,28,112,0,0,0,0,0
15.712,17,12,5629,6,578,3135,1350,3640,6,303,3135,1350,1989
0.651,6,122,88065,59,131,11,232,2889,63,1425,10,2860,85176
0.028,17,2,152,1,48,0,48,76,1,48,0,48,76
1780.088,1,333,27972,333,56,5361,56,27972,0,0,0,0,0
0.004,17,3,394,2,32,0,32,120,1,246,0,246,274
1.342,6,47,19097,27,886,51,1360,13521,20,476,59,2715,5576
8.379,17,4,762,2,48,8357,48,152,2,277,8357,277,610
244.056,1,6,336,6,28,48811,28,336,0,0,0,0,0
5.359,6,38,7245,19,218,297,314,3383,19,516,283,1179,3862
1.278,6,50,19786,27,927,49,1360,14090,23,433,49,1360,5696
1772.781,6,180,15480,120,69,14897,69,8940,60,69,30046,69,6540
322.396,6,33,7418,20,118,16968,267,1873,13,627,21,1400,5545
280.43,6,30,7432,13,158,23369,267,1317,17,603,17522,1380,6115
1786.687,6,104,8376,68,65,26666,65,4930,36,59,51045,59,3446
1785.263,6,115,13307,74,162,24455,1286,8975,41,72,44629,240,4332
1788.534,6,356,22520,208,69,8640,69,12460,148,69,12166,69,10060
1789.188,17,142,11360,71,48,25559,48,5396,71,56,25559,56,5964
1784.32,17,199,50886,199,227,9011,422,50886,0,0,0,0,0
1744.85,6,96,7255,62,38,28604,205,4424,34,33,52863,98,2831
1767.099,17,46,15432,46,307,39268,308,15432,0,0,0,0,0
1783.632,6,355,22480,206,69,8700,69,12380,149,69,12051,69,10100
50.761,17,4,352,2,60,50760,60,176,2,60,50760,60,176
4.082,6,38,7229,19,218,226,314,3383,19,440,213,1152,3846
1791.14,1,342,28728,342,56,5252,56,28728,0,0,0,0,0
840.281,17,11,1068,11,69,84028,300,1068,0,0,0,0,0
1630.724,17,24,2019,12,31,148219,37,717,12,80,148242,136,1302
1663.072,1,7,392,7,28,277178,28,392,0,0,0,0,0
1.815,6,27,10201,16,288,121,598,1510,11,1030,163,1420,8691
8.003,6,72,20846,37,559,222,1152,16019,35,427,227,1152,4827
1772.072,6,180,15480,120,69,14891,69,8940,60,69,30033,69,6540
1788.668,17,87,3648,86,14,21043,14,3612,1,8,0,8,36
1788.218,6,361,22858,210,69,8556,69,12678,151,69,11921,69,10180
0.076,1,2,112,2,28,76,28,112,0,0,0,0,0
17.362,17,28,19524,16,706,1155,1350,11746,12,620,1575,1350,7778
1.408,6,41,11378,21,616,70,1440,5802,20,433,63,1440,5576
1.429,6,50,19269,27,890,54,1460,13573,23,433,56,1460,5696
0.287,6,6,328,4,0,95,0,216,2,0,279,0,112
0.28,17,2,152,1,48,0,48,76,1,48,0,48,76
0.306,6,27,9040,13,246,25,622,1670,14,947,22,1448,7370
1742.882,6,94,7151,62,38,28571,205,4424,32,33,56208,98,2727
240.261,6,42,7853,21,156,12012,517,2197,21,455,12011,1418,5656
9.785,6,1455,1340451,948,1363,10,1432,1315868,507,475,19,1871,24583
195.456,17,6,528,3,60,97727,60,264,3,60,97727,60,264
222.999,17,6,528,3,48,111492,48,228,3,72,111493,72,300
0.037,17,2,398,1,43,0,43,71,1,299,0,299,327
161.754,6,24,9206,12,304,72,597,1425,12,911,14689,1360,7781
809.845,1,4,424,4,78,269948,78,424,0,0,0,0,0
0.536,17,2,384,1,39,0,39,67,1,289,0,289,317
1772.884,6,180,15480,120,69,14898,69,8940,60,69,30040,69,6540
6.313,6,38,8810,24,225,274,590,2090,14,769,468,1380,6720
1.49,6,13,2311,8,188,212,245,700,5,1407,311,1407,1611
1785.977,6,103,8404,68,66,26656,66,4964,35,60,52526,60,3440
2.124,6,13,2311,8,188,303,245,700,5,1407,465,1407,1611
148.909,17,6,1236,3,48,74450,48,228,3,308,74450,308,1008
31.418,6,7,336,1,0,0,0,48,6,0,6281,0,288
300.645,6,11,912,6,226,60090,226,546,5,110,75112,110,366
99.389,6,29,7392,13,158,8282,267,1317,16,603,6625,2036,6075
1794.401,17,144,11520,72,48,25273,48,5472,72,56,25273,56,6048
0.508,6,2,100,1,0,0,0,40,1,0,0,0,60
0.599,6,10,924,5,283,102,283,551,5,105,97,105,373
664.365,6,296,88505,135,809,4957,1418,75050,161,76,4152,580,13455
0.927,6,10,1687,7,100,154,100,384,3,1179,335,1179,1303
5.16,6,39,7269,19,218,286,314,3383,20,513,258,1179,3886
0.093,17,4,284,2,32,78,32,120,2,54,77,60,164
219.514,17,2,386,2,165,219514,165,386,0,0,0,0,0
946.646,6,211,20356,116,112,7853,1189,8685,95,178,10070,1420,11671
1758.617,6,96,6262,61,47,29310,208,3963,35,31,51706,31,2299
14.342,6,120,39747,60,634,243,1152,32865,60,447,237,1179,6882
1769.464,6,91,32139,50,495,36111,1460,12990,41,648,44232,1460,19149
101.382,6,47,9128,22,412,753,889,2220,25,327,4218,1360,6908
1.057,6,37,11655,22,592,50,1188,7660,15,356,68,758,3995
61.86,6,75,53394,47,1221,1344,1448,45208,28,746,2282,1448,8186
1771.532,6,101,9410,66,66,27254,66,5610,35,60,52101,60,3800
0.315,6,3,327,2,103,0,138,287,1,0,0,0,40
292.006,17,4,352,2,60,292005,60,176,2,60,292005,60,176
36.724,17,44,6468,22,48,1745,48,1672,22,190,1745,308,4796
31.982,6,27,7045,16,124,2132,159,1600,11,810,3197,1668,5445
18.7,6,15,3304,3,92,1528,92,256,12,345,1683,1448,3048
1770.265,6,108,9788,68,64,26421,64,5724,40,58,45389,58,4064
1783.972,1,58,4872,58,56,31297,56,4872,0,0,0,0,0
4.902,6,41,7349,21,218,245,314,3463,20,440,244,1152,3886
173.981,17,218,35085,109,38,1610,44,7274,109,227,1610,345,27811
682.521,17,8,2672,8,306,97503,308,2672,0,0,0,0,0
0.258,6,9,1002,5,213,64,213,417,4,421,74,421,585
228.422,17,4,352,2,60,228421,60,176,2,60,228420,60,176
246.705,6,84,37957,31,221,8223,639,4557,53,928,4744,2919,33400
71.678,6,11,1583,11,127,7167,127,1583,0,0,0,0,0
1789.214,6,5126,5577114,2595,127,689,339,163920,2531,2150,707,8448,5413194
1.301,6,39,8294,19,321,72,1164,2718,20,433,59,1460,5576
1797.503,1,238,13328,238,28,7584,28,13328,0,0,0,0,0
0.084,17,4,352,2,37,45,37,130,2,83,41,89,222
2.973,17,2,1430,2,687,2973,687,1430,0,0,0,0,0
1788.351,6,361,22858,210,69,8556,69,12678,151,69,11922,69,10180
61.399,6,8,432,5,0,15349,0,268,3,0,30570,0,164
1783.814,6,362,24774,211,94,8494,469,14387,151,69,11892,69,10387
4.187,6,34,6169,17,206,261,314,2744,17,456,246,1152,3425
0.118,1,2,112,2,28,118,28,112,0,0,0,0,0
4.808,6,41,7349,20,218,253,314,3423,21,440,227,1152,3926
252.452,2,3,96,3,8,126226,8,96,0,0,0,0,0
0.469,6,20,7229,12,334,42,663,1969,8,1209,66,1906,5260
182.84,17,5,1644,5,300,45710,304,1644,0,0,0,0,0
1690.958,2,26,832,26,8,67638,8,832,0,0,0,0,0
0.428,6,25,7711,16,339,28,949,3017,9,721,51,1420,4694
0.124,6,11,1369,7,284,20,517,928,4,112,35,156,441
0.074,17,2,1920,2,932,74,932,1920,0,0,0,0,0
1682.682,17,14,1036,7,30,280437,30,406,7,62,280440,62,630
4.765,6,39,7285,19,218,264,314,3383,20,516,237,1179,3902
1741.459,6,90,6521,59,31,30025,31,3998,31,31,58043,31,2523
1786.636,6,104,8435,69,65,26274,65,4970,35,59,52545,59,3465
1.464,6,46,19012,26,951,58,1460,13436,20,476,66,2615,5576
1.402,6,25,8056,12,164,109,267,1288,13,1014,100,2491,6768
1650.586,6,324,20550,186,69,8613,69,11235,138,69,12047,69,9315
1770.43,17,349,58665,349,140,5087,386,58665,0,0,0,0,0
0.105,6,9,1339,5,145,26,145,349,4,826,23,826,990
61.844,1,24,2496,0,0,0,0,0,24,76,2688,76,2496
0.306,17,2,198,1,39,0,39,67,1,103,0,103,131
71.03,1,3,180,3,32,35515,32,180,0,0,0,0,0
1.624,6,48,19070,27,881,62,1360,13454,21,433,71,1360,5616
33.261,6,27,7177,13,155,2771,267,1306,14,530,2558,3417,5871
1023.67,6,92,14422,55,483,18956,483,11079,37,83,28434,83,3343
1771.447,6,104,9815,68,69,26439,233,5914,36,59,50610,82,3901
0.048,17,4,304,2,37,0,37,130,2,59,10,65,174
14.799,6,14,2185,8,324,2114,585,1073,6,396,2930,580,1112
1799.08,17,184,14529,173,30,10459,37,10076,11,376,142523,463,4453
115.205,1,12,1248,0,0,0,0,0,12,76,10473,76,1248
2.845,6,50,19356,30,889,98,1360,13723,20,480,139,4075,5633
3.415,17,2,632,1,288,0,288,316,1,288,0,288,316
1794.11,17,80,3354,79,14,23001,14,3318,1,8,0,8,36
540.861,2,4,128,4,8,180287,8,128,0,0,0,0,0
0.184,6,25,7216,13,155,15,267,1301,12,775,16,3445,5915
280.432,6,28,7352,13,158,23369,267,1317,15,775,20028,3465,6035
1681.692,17,14,1036,7,30,280274,30,406,7,62,280274,62,630
1795.089,17,80,3354,79,14,23013,14,3318,1,8,0,8,36
0.051,17,4,284,2,32,35,32,120,2,54,21,60,164
369.587,6,26,1706,18,180,21740,180,1172,8,110,9299,110,534
1782.891,17,85,3569,83,14,21742,15,3487,2,13,382662,18,82
1.652,6,14,2351,8,188,236,245,700,6,703,280,1152,1651
0.55,6,10,968,5,256,107,256,460,5,304,131,304,508
720.322,6,169,20487,73,124,10004,1189,6530,96,163,7582,1420,13957
297.307,1,4,224,4,28,99102,28,224,0,0,0,0,0
10.078,17,2,124,2,34,10078,34,124,0,0,0,0,0
0.959,6,27,8420,15,222,58,540,1964,12,1192,72,3151,6456
0.125,17,2,672,2,308,125,308,672,0,0,0,0,0
2.234,6,14,2351,8,188,319,245,700,6,703,397,1152,1651
1441.047,17,25,26350,25,1026,60043,1026,26350,0,0,0,0,0
1786.451,6,106,8524,68,66,26663,66,4964,38,60,48280,60,3560
6.276,6,17,2632,10,210,697,210,1170,7,545,1045,904,1462
3.525,6,14,3144,8,49,503,92,511,6,579,37,1408,2633
1800.0,6,219,17419,81,75,22125,337,8444,138,50,13138,143,8975
1787.905,6,363,25352,211,100,8513,469,14856,152,69,11840,69,10496
0.441,6,12,1653,6,288,87,288,548,6,426,52,434,1105
172.43,17,4,304,2,48,172417,48,152,2,48,172417,48,152
1752.792,1,8,848,8,78,250398,78,848,0,0,0,0,0
18.707,6,22,4549,11,211,1851,722,1636,11,779,1852,1448,2913
19.582,6,10,560,6,0,3916,0,328,4,0,6075,0,232
19.436,17,2,778,2,361,19436,361,778,0,0,0,0,0
4.844,6,32,6089,17,206,302,314,2744,15,548,326,1179,3345
745.518,6,61,9246,33,106,20264,516,2920,28,208,27608,1452,6326
1789.42,6,415,35819,231,116,7780,1189,18242,184,132,9778,1917,17577
333.903,17,10,760,10,48,37100,48,760,0,0,0,0,0
315.909,6,92,20746,48,259,6721,1360,10775,44,303,7343,3289,9971
0.522,17,6,1048,4,64,172,64,368,2,312,515,312,680
169.401,6,24,10487,13,704,624,1240,3368,11,952,16923,1791,7119
11.407,6,12,700,5,0,2851,0,280,7,0,1842,0,420
0.335,17,2,152,1,48,0,48,76,1,48,0,48,76
367.007,6,18,1242,14,180,28231,180,916,4,110,20063,110,326
1783.424,6,360,24156,210,88,8533,469,13878,150,69,11966,69,10278
0.194,17,8,2758,8,316,27,355,2758,0,0,0,0,0
1781.834,6,359,22778,209,69,8566,69,12569,150,69,11958,69,10209
0.355,6,27,9047,13,252,29,647,1692,14,945,26,1438,7355
1794.706,6,356,22520,208,69,8670,69,12460,148,69,12208,69,10060
129.197,6,35,15692,18,887,80,1360,6101,17,889,8064,3639,9591
178.975,1,20,1680,20,56,9419,56,1680,0,0,0,0,0
1799.099,1,58,4872,0,0,0,0,0,58,56,31563,56,4872
3.858,6,13,3293,6,49,771,92,407,7,503,143,1448,2886
294.339,6,50,8224,24,106,12795,517,2241,26,417,11771,1418,5983
14.112,17,4,352,2,48,14102,48,152,2,72,14101,72,200
1782.106,17,83,3480,82,14,22001,14,3444,1,8,0,8,36
0.888,6,11,1727,7,100,148,100,384,4,589,210,1152,1343
3.838,6,2,1175,1,0,0,0,40,1,1095,0,1095,1135
280.24,6,31,7472,14,158,21556,267,1357,17,543,17512,1400,6115
3.992,17,3,180,3,32,1996,32,180,0,0,0,0,0
0.36,17,2,152,1,48,0,48,76,1,48,0,48,76
86.029,6,119,90989,76,1256,1147,1408,80629,43,811,2043,3847,10360
0.551,17,3,451,2,39,445,39,134,1,289,0,289,317
240.301,6,61,17554,30,760,8285,1418,14494,31,180,8009,580,3060
6.031,17,5,562,4,32,1332,32,240,1,294,0,294,322
0.05,17,2,136,1,32,0,32,60,1,48,0,48,76
376.943,17,2003,379640,1934,166,195,172,375600,69,30,3894,172,4040
1785.857,6,420,25208,210,69,8544,69,12540,210,34,8544,64,12668
1.142,6,25,8068,12,164,88,267,1300,13,869,80,1408,6768
0.125,17,2,152,1,48,0,48,76,1,48,0,48,76
1.018,17,2,116,2,30,1018,30,116,0,0,0,0,0
66.992,2,2,64,2,8,66992,8,64,0,0,0,0,0
1770.879,6,152,25074,91,277,19676,820,17498,61,95,29513,192,7576
16.874,6,18,1407,9,222,2107,222,808,9,231,2107,231,599
169.999,1,6,336,6,28,33999,28,336,0,0,0,0,0
133.548,17,2,672,2,308,133548,308,672,0,0,0,0,0
34.618,17,4,240,2,32,34616,32,120,2,32,34616,32,120
1796.438,17,142,11360,71,48,25663,48,5396,71,56,25663,56,5964
252.51,17,4,288,2,36,252476,36,128,2,52,252478,52,160
632.001,6,73,10027,34,108,15142,501,2880,39,174,16629,1420,7147
317.844,6,88,20276,35,363,9348,1460,9793,53,208,6108,3089,10483
123.579,6,23,10465,11,444,81,1023,1804,12,1021,11219,1360,8661
1797.801,6,367,25650,214,99,8440,469,15045,153,69,11824,69,10605
33.728,6,32,5159,16,154,2237,722,1924,16,342,2237,1440,3235
18.715,6,2880,2727134,1829,1412,10,1448,2667794,1051,776,17,1448,59340
1789.514,1,8,448,8,28,255644,28,448,0,0,0,0,0
340.372,17,5,1688,5,309,85093,316,1688,0,0,0,0,0
187.461,6,34,11190,21,398,9372,1448,5491,13,716,15620,1448,5699
0.086,6,4,160,2,0,12,0,80,2,0,86,0,80
0.013,17,2,586,1,46,0,46,74,1,484,0,484,512
1.245,6,47,18164,26,882,49,1360,12548,21,433,53,1360,5616
10.426,17,4,352,2,48,10418,48,152,2,72,10417,72,200
0.253,6,178,168191,63,264,4,517,4868,115,1417,1,1448,163323
0.089,17,2,586,1,46,0,46,74,1,484,0,484,512
0.4,6,18,6377,10,141,44,275,686,8,894,27,2840,5691
216.485,17,4,240,2,32,216484,32,120,2,32,216484,32,120
2.526,6,18,3257,10,99,261,182,924,8,477,335,1343,2333
64.53,6,9,372,4,0,3965,0,164,5,0,16129,0,208
1789.876,6,356,22520,208,69,8646,69,12460,148,69,12175,69,10060
1741.439,6,89,6469,59,31,30024,31,3979,30,31,60048,31,2490
280.351,6,30,7432,13,158,23362,267,1317,17,543,17513,1400,6115
152.092,17,4,352,2,60,152091,60,176,2,60,152091,60,176
6.008,6,41,7349,21,218,300,314,3463,20,513,301,1179,3886
5.195,6,3,1560,1,0,0,0,40,2,1440,2586,1440,1520
311.498,6,534,423420,242,145,1292,230,15496,292,1368,1070,2736,407924
0.333,6,27,9066,13,247,27,624,1696,14,947,25,1408,7370
169.164,6,232,36345,123,304,1386,304,25176,109,83,1553,83,11169
59.821,6,3020,3642865,1485,615,40,1368,86658,1535,2276,38,19152,3556207
0.032,17,4,360,2,30,8,30,116,2,94,14,94,244
0.021,6,10,1903,5,657,5,657,925,5,710,5,710,978
656.727,1,40,2240,40,28,16839,28,2240,0,0,0,0,0
0.009,17,2,223,1,36,0,36,64,1,131,0,131,159
2.381,6,16,2297,9,322,297,581,1117,7,396,395,580,1180
1145.757,1,30,1680,30,28,39508,28,1680,0,0,0,0,0
300.35,6,26,9562,14,441,23103,1178,2514,12,802,3941,1448,7048
92.625,17,4,1344,4,308,30875,308,1344,0,0,0,0,0
1790.676,6,366,25610,213,99,8446,469,15005,153,69,11780,69,10605
4.878,6,35,6209,19,206,271,314,2824,16,548,308,1179,3385
290.525,6,282,45642,159,304,1838,304,32204,123,83,2381,83,13438
0.059,6,2,170,1,0,0,0,40,1,90,0,90,130
1.138,6,25,8056,12,164,87,267,1288,13,869,80,1448,6768
1.363,6,41,9968,21,440,68,1360,4392,20,433,62,1360,5576
1787.579,6,103,8395,68,65,26680,65,4930,35,59,52572,59,3465
1781.89,6,102,8296,68,65,26595,65,4930,34,59,53993,59,3366
1.517,6,19,3781,10,234,168,564,1452,9,463,166,1343,2329
78.144,6,25,10094,12,532,72,1360,2642,13,988,6497,1360,7452
232.022,17,5,1724,1,300,0,300,328,4,321,77010,321,1396
378.518,6,18,1242,14,180,29116,180,916,4,110,20060,110,326
1740.46,17,29,6815,29,207,62159,207,6815,0,0,0,0,0
8.69,6,24,11564,7,154,1448,267,752,17,778,536,1420,10812
20.435,6,21,5418,13,107,1702,159,1126,8,967,2910,1709,4292
1796.314,17,447,39580,403,35,4468,288,25676,44,288,40947,288,13904
1798.963,6,128,8445,73,55,24985,208,5315,55,31,32170,31,3130
1799.981,6,366,25610,213,99,8490,469,15005,153,69,11841,69,10605
1787.134,6,104,8308,68,64,26673,64,4896,36,58,51058,58,3412
145.958,6,34,17777,18,708,39,1360,4350,16,1161,9721,3510,13427
1779.089,17,86,3606,85,14,21179,14,3570,1,8,0,8,36
10.866,6,89,27066,45,559,246,1152,20824,44,447,246,1179,6242
1.662,6,47,18379,27,835,63,1360,12803,20,433,77,1360,5576
1773.039,1,58,4872,0,0,0,0,0,58,56,31105,56,4872
0.037,6,10,2047,6,740,7,1323,1724,4,159,11,159,323
1783.297,17,83,3480,82,14,22016,14,3444,1,8,0,8,36
0.071,17,2,582,1,30,0,30,58,1,496,0,496,524
1.496,17,4,314,2,31,581,31,118,2,70,0,70,196
0.099,1,2,112,2,28,99,28,112,0,0,0,0,0
421.113,2,4,128,4,8,140371,8,128,0,0,0,0,0
20.513,17,20,6751,9,429,2560,1350,4120,11,211,2048,1350,2631
240.319,6,45,8982,23,524,10923,1418,5920,22,212,11443,618,3062
370.304,6,40,10139,17,140,23144,267,2379,23,488,516,1460,7760
291.098,6,34,7070,16,262,19403,517,1640,18,642,17120,1418,5430
0.018,6,13,3514,7,75,3,75,447,6,1373,3,1448,3067
149.236,17,4,304,2,48,149223,48,152,2,48,149223,48,152
17.983,17,35,18439,19,635,997,1350,12611,16,336,1196,1350,5828
18.862,6,14,2242,8,210,2693,210,844,6,545,3772,904,1398
6.014,17,12,852,6,32,1201,32,360,6,54,1201,60,492
1796.344,1,58,4872,58,56,31514,56,4872,0,0,0,0,0
0.028,17,2,283,1,31,0,31,59,1,196,0,196,224
1783.45,17,83,3480,82,14,22017,14,3444,1,8,0,8,36
280.568,6,30,7432,14,158,21582,267,1357,16,678,18702,3456,6075
31.748,6,7,308,1,0,0,0,44,6,0,6299,0,264
3.242,17,4,1560,4,362,1080,362,1560,0,0,0,0,0
293.478,6,48,8044,22,116,13973,517,2099,26,456,11737,1418,5945
630.113,2,4,128,4,8,210037,8,128,0,0,0,0,0
1.274,17,6,462,3,37,635,37,195,3,61,634,65,267
1800.0,6,221,19678,83,104,21585,1360,10557,138,52,13138,224,9121
2.408,6,2,80,1,0,0,0,40,1,0,0,0,40
34.094,6,5,280,4,0,11364,0,220,1,0,0,0,60
367.062,6,21,1422,15,180,26218,180,992,6,110,12234,110,430
300.777,6,43,15308,25,875,12532,1360,9786,18,435,506,2667,5522
33.277,6,15,11978,5,275,8319,275,479,10,1585,3673,2840,11499
1799.778,6,370,25908,214,99,8449,469,15114,156,69,11611,69,10794
116.238,6,28,8792,14,158,8941,267,1357,14,981,8940,3445,7435
1789.322,17,87,3648,86,14,21050,14,3612,1,8,0,8,36
91.112,6,820,400249,446,831,204,1152,380498,374,435,243,1179,19751
5.379,6,717,647550,454,1354,11,1368,626474,263,776,19,1473,21076
0.283,17,4,588,2,48,274,48,152,2,190,272,308,436
4.52,6,5,260,5,0,0,0,260,0,0,0,0,0
0.047,17,8,1670,8,180,6,219,1670,0,0,0,0,0
0.282,17,2,167,1,39,0,39,67,1,72,0,72,100
2.242,6,34,6618,17,149,140,267,2033,17,780,125,1531,4585
5.985,17,3,1008,3,308,2992,308,1008,0,0,0,0,0
1783.809,6,381,23844,217,69,8258,69,12958,164,60,10943,69,10886
368.836,6,27,1767,18,177,21696,177,1181,9,110,8589,110,586
9.917,6,1551,1362369,965,1358,10,1420,1334518,586,427,16,1420,27851
2.359,6,16,3672,9,150,294,174,664,7,681,217,1452,3008
2.071,17,4,240,2,32,2070,32,120,2,32,2070,32,120
0.103,6,9,1343,5,145,25,145,349,4,830,29,830,994
1.297,17,3,451,2,39,759,39,134,1,289,0,289,317
161.288,17,8,2688,8,308,23041,308,2688,0,0,0,0,0
1.008,6,3,160,2,0,992,0,120,1,0,0,0,40
254.349,6,10,5375,4,106,84778,106,274,6,1213,50867,1452,5101
42.617,17,46,6644,23,48,1935,48,1748,23,184,1933,308,4896
4.709,6,43,8329,21,227,235,314,4022,22,427,212,1152,4307
1794.24,17,144,11520,72,48,25270,48,5472,72,56,25270,56,6048
4.701,6,39,7269,20,218,247,314,3423,19,513,247,1179,3846
1772.605,6,180,15480,120,69,14895,69,8940,60,69,30036,69,6540
40.064,17,11,530,10,16,4451,58,446,1,56,0,56,84
0.156,6,14,3578,7,75,26,75,459,7,1373,25,1448,3119
140.807,17,36,1440,30,12,4855,12,1200,6,12,2579,12,240
1660.498,1,7,392,7,28,276749,28,392,0,0,0,0,0
1259.869,2,7,224,7,8,209978,8,224,0,0,0,0,0
1793.036,17,281,66471,281,208,6403,422,66471,0,0,0,0,0
249.659,17,6,528,3,60,124829,60,264,3,60,124829,60,264
10.287,6,84,26141,44,554,239,1152,20059,40,447,256,1179,6082
0.369,6,24,4571,12,165,33,456,1446,12,415,31,888,3125
0.037,1,10,840,10,56,4,56,840,0,0,0,0,0
1788.495,6,3934,3741798,1482,132,1207,354,88275,2452,1482,729,4224,3653523
1770.462,6,117,10836,74,66,24252,66,6284,43,60,42151,60,4552
240.229,6,55,19667,30,840,8283,1408,16701,25,207,10009,580,2966
280.264,6,30,7432,13,158,23355,267,1317,17,543,17515,1300,6115
2.382,6,21,3433,12,162,216,293,1458,9,537,264,1179,1975
280.397,6,30,7432,13,158,23366,267,1317,17,543,17522,1400,6115
3.981,17,27,10342,12,330,361,1350,4299,15,374,194,1350,6043
1788.513,6,345,22287,202,69,8898,69,12289,143,69,12595,69,9998
1.339,17,4,560,2,64,980,64,184,2,160,1056,160,376
1780.092,17,140,11200,70,48,25798,48,5320,70,56,25798,56,5880
153.652,6,68,11949,29,210,5486,1189,3480,39,287,4043,1460,8469
3.732,17,33,15371,15,715,266,1350,11148,18,206,189,1350,4223
37.319,6,1046,909616,439,205,85,221,27758,607,1417,61,2876,881858
19.142,6,40,9454,22,101,911,317,1827,18,626,324,1360,7627
5.332,17,3,208,2,36,5005,36,128,1,52,0,52,80
1781.303,17,140,11200,70,48,25815,48,5320,70,56,25815,56,5880
118.239,6,25,1000,0,0,0,0,0,25,0,0,0,1000
4.108,6,34,6185,17,206,256,314,2744,17,551,240,1179,3441
41.367,17,24,2112,12,48,3753,48,912,12,72,3754,72,1200
20.486,6,22,5469,13,107,1707,159,1126,9,773,2554,1418,4343
281.831,6,30,7432,13,158,23485,267,1317,17,543,17596,1400,6115
240.179,6,54,17591,29,773,8577,1402,14667,25,202,10007,580,2924
237.699,17,2,908,2,426,237699,687,908,0,0,0,0,0
1683.503,1,7,392,7,28,280583,28,392,0,0,0,0,0
0.52,6,27,9130,13,263,43,688,1748,14,947,37,1368,7382
0.042,17,4,284,2,32,35,32,120,2,54,34,60,164
1774.905,1,58,4872,0,0,0,0,0,58,56,31138,56,4872
180.482,2,4,128,4,8,60160,8,128,0,0,0,0,0
0.827,6,20,5995,11,286,82,559,1303,9,721,92,1452,4692
1777.065,17,73,3060,72,14,25029,14,3024,1,8,0,8,36
4.974,6,42,7389,22,218,236,314,3503,20,440,248,1152,3886
319.489,17,6,2316,6,358,63897,548,2316,0,0,0,0,0
0.283,17,2,180,1,30,0,30,58,1,94,0,94,122
1368.874,1,36,2016,36,28,39110,28,2016,0,0,0,0,0
53.578,6,23,1699,17,43,3348,43,1339,6,0,6199,0,360
317.033,6,64,18367,33,388,9907,1460,9500,31,380,10562,3089,8867
1786.33,6,103,8404,68,66,26661,66,4964,35,60,52536,60,3440
1798.869,6,244,46664,152,483,11913,483,36892,92,83,19767,83,9772
0.019,6,20,9985,11,125,1,125,705,9,1760,2,2896,9280
44.64,17,6,2016,6,308,8928,308,2016,0,0,0,0,0
110.188,6,30,13159,16,489,320,1460,3121,14,1051,8465,1460,10038
178.96,2,3,96,3,8,89480,8,96,0,0,0,0,0
23.949,6,25,3414,12,183,2176,517,1573,13,381,1994,499,1841
1788.095,6,356,22520,208,69,8638,69,12460,148,69,12163,69,10060
42.38,17,24,2112,12,48,3845,48,912,12,72,3850,72,1200
11.953,6,5,310,3,31,5900,31,187,2,31,11953,31,123
1794.785,1,228,12768,228,28,7906,28,12768,0,0,0,0,0
15.492,17,10,880,5,48,3870,48,380,5,72,3869,72,500
1791.248,6,356,22520,208,69,8653,69,12460,148,69,12185,69,10060
0.044,17,4,352,2,60,31,60,176,2,60,28,60,176
300.823,6,87,55364,46,1232,6684,1368,46782,41,805,6022,1368,8582
27.705,17,4,352,2,60,27703,60,176,2,60,27704,60,176
0.073,17,2,279,1,36,0,36,64,1,187,0,187,215
1785.767,6,102,8296,68,65,26653,65,4930,34,59,54111,59,3366
0.515,6,28,9262,14,232,39,769,1909,14,943,37,1368,7353
192.595,6,30,7432,13,158,16049,267,1317,17,543,12035,1400,6115
0.026,17,4,865,2,47,16,47,150,2,329,16,341,715
0.009,17,2,220,1,33,0,33,61,1,131,0,131,159
5.697,6,40,7325,21,218,284,314,3463,19,516,302,1179,3862
1.654,6,14,2351,8,188,236,245,700,6,703,280,1152,1651
50.699,6,27,7177,13,155,4224,267,1306,14,530,3899,3417,5871
280.724,6,30,7432,13,158,23393,267,1317,17,603,17541,2760,6115
8.045,6,66,20622,35,559,236,1152,15955,31,489,258,1179,4667
1170.852,17,772,78112,711,40,1649,41,48818,61,452,632,505,29294
127.447,6,7,288,2,0,255,0,84,5,0,31799,0,204
1.397,6,10,1687,7,100,232,100,384,3,1179,565,1179,1303
141.182,6,25,9936,12,541,64,1440,2677,13,961,11753,1440,7259
16.321,6,76,21000,38,501,441,1152,16053,38,489,432,1179,4947
1793.013,6,356,22520,208,69,8661,69,12460,148,69,12197,69,10060
1743.154,6,95,7203,63,38,28115,205,4476,32,33,56225,98,2727
902.422,2,11,352,11,8,90242,8,352,0,0,0,0,0
0.015,17,2,357,1,34,0,34,62,1,267,0,267,295
0.075,17,2,306,1,33,0,33,61,1,217,0,217,245
1775.647,6,284,36633,115,142,15574,1360,17312,169,147,10568,2720,19321
125.386,6,16,3248,8,92,17912,92,504,8,387,17885,1440,2744
1714.505,1,10,1080,10,80,190500,88,1080,0,0,0,0,0
1786.476,17,87,3648,86,14,21017,14,3612,1,8,0,8,36
1790.678,6,452,26360,244,69,7369,69,13900,208,34,8650,64,12460
126.049,6,45,9985,16,327,1577,1189,2615,29,310,4501,1420,7370
732.239,17,9,693,9,49,91529,49,693,0,0,0,0,0
4.328,17,29,10824,12,447,393,1350,5705,17,273,211,1350,5119
1734.294,17,17,5622,17,302,108393,1451,5622,0,0,0,0,0
1.992,17,4,420,2,33,0,33,122,2,121,0,145,298
0.166,6,10,1379,5,145,41,145,349,5,826,29,826,1030
0.722,17,19,8917,9,422,86,1350,4050,10,458,76,1350,4867
1799.591,17,449,39928,404,35,4465,288,25708,45,288,40018,288,14220
1740.984,17,30,31680,30,1028,60033,1028,31680,0,0,0,0,0
1791.98,1,342,28728,342,56,5255,56,28728,0,0,0,0,0
281.91,6,29,7392,13,158,23492,267,1317,16,603,18772,2036,6075
67.917,6,28,7352,12,158,6174,267,1277,16,603,4525,1400,6075
62.749,6,29,7392,13,158,5229,267,1317,16,603,4180,2036,6075
1771.013,6,115,11387,71,59,25300,722,5790,44,91,41177,1408,5597
290.522,1,6,1039,6,145,58104,320,1039,0,0,0,0,0
0.056,17,2,280,1,64,0,64,92,1,160,0,160,188
156.559,6,25,4837,9,272,3046,516,1180,16,300,10420,1452,3657
5.647,6,262,205160,121,190,47,253,7753,141,1377,40,2816,197407
35.467,17,20,1520,20,48,1866,48,1520,0,0,0,0,0
1788.932,17,83,3480,82,14,22085,14,3444,1,8,0,8,36
1.641,17,21,8968,10,529,182,1350,5570,11,280,125,1350,3398
1799.88,17,446,39264,403,35,4477,288,25676,43,288,40934,288,13588
1769.383,1,58,4872,58,56,31041,56,4872,0,0,0,0,0
470.988,6,277,30489,107,111,4443,327,16071,170,110,2786,110,14418
12.79,6,9,602,3,112,6395,112,240,6,90,2521,90,362
1025.584,17,44,1845,43,13,24418,14,1801,1,16,0,16,44
1595.503,1,8,448,8,28,227929,28,448,0,0,0,0,0
0.406,6,24,4571,12,165,36,456,1446,12,415,35,888,3125
11.007,6,20,4442,11,275,1100,275,998,9,768,775,1440,3444
166.831,6,21,4631,8,267,158,502,1126,13,298,13895,1420,3505
295.792,6,52,8324,26,117,11829,517,2332,26,384,11829,1418,5992
0.087,17,2,172,1,50,0,50,78,1,66,0,66,94
1768.784,6,230,18876,117,99,15246,208,13426,113,31,15791,31,5450
240.225,6,53,17680,28,781,8896,1418,14754,25,202,10008,580,2926
2.656,6,10,1102,6,483,531,483,803,4,83,882,83,299
1787.515,6,102,8296,68,65,26679,65,4930,34,59,54162,59,3366
0.015,17,2,564,1,64,0,64,92,1,444,0,444,472
1680.678,17,13,534,11,14,168049,14,462,2,8,1680500,8,72
117.61,6,42,8867,19,410,656,882,2070,23,345,5339,1360,6797
3.975,17,2,176,2,60,3975,60,176,0,0,0,0,0
0.629,6,130,94450,78,1288,8,1420,88149,52,526,12,3303,6301
1.041,6,24,9512,14,350,80,1041,1992,10,1184,94,2370,7520
300.577,6,18,1227,5,177,75100,177,445,13,110,25033,110,782
15.13,17,15,7960,8,706,2155,1350,5876,7,269,2515,1350,2084
300.866,6,47,10320,24,433,13081,910,3194,23,344,707,1360,7126
7.842,6,270,196663,137,194,57,230,8091,133,1386,54,1452,188572
0.534,6,10,861,5,222,131,222,426,5,231,130,231,435
16.685,17,16,9030,9,745,2078,1350,6961,7,267,2768,1350,2069
0.041,17,6,1307,6,189,8,219,1307,0,0,0,0,0
0.342,1,2,163,2,53,342,78,163,0,0,0,0,0
915.88,6,166,27264,72,245,12899,1360,12901,94,158,9846,3289,14363
6.722,6,1097,933199,652,1385,10,1420,911154,445,420,15,1420,22045
12.193,6,93,27621,46,554,270,1152,21243,47,449,259,1179,6378
1786.582,6,104,8444,68,66,26665,66,4964,36,60,51042,60,3480
1764.072,1,14,784,14,28,135697,28,784,0,0,0,0,0
1788.724,17,87,3648,86,14,21043,14,3612,1,8,0,8,36
0.478,6,10,968,5,256,117,256,460,5,304,117,304,508
0.403,6,20,5884,12,275,36,517,1733,8,745,55,1440,4151
0.418,6,21,7217,13,318,34,599,1957,8,967,58,1471,5260
72.602,6,22,7483,12,818,75,1360,6243,10,207,8046,418,1240
2.414,6,13,2311,8,188,344,245,700,5,1407,539,1407,1611
57.215,6,35,9760,17,157,3575,517,2136,18,742,3362,2342,7624
0.401,6,12,1653,6,288,77,288,548,6,426,44,434,1105
1745.38,6,101,7918,65,45,27271,205,4850,36,35,49858,98,3068
207.978,6,45,13310,21,181,10398,267,2300,24,772,9042,3436,11010
1785.359,17,87,3648,86,14,21004,14,3612,1,8,0,8,36
5.029,17,4,288,2,36,5012,36,128,2,52,4999,52,160
711.704,6,139,9148,76,69,8842,69,4765,63,69,11478,69,4383
368.368,6,15,1048,12,106,33487,106,912,3,0,184179,0,136
1770.145,6,221,20923,84,122,21325,1360,11950,137,50,13015,144,8973
0.046,17,6,1658,6,248,9,373,1658,0,0,0,0,0
1776.113,6,27,4077,18,241,104477,241,2889,9,92,221992,92,1188
0.007,17,2,558,1,32,0,32,60,1,470,0,470,498
0.03,17,2,317,1,43,0,43,71,1,218,0,218,246
1.117,6,24,6554,13,334,92,1008,2194,11,783,110,1420,4360
5.436,6,41,8249,20,227,286,314,3982,21,489,258,1179,4267
252.02,2,2,64,2,8,252020,8,64,0,0,0,0,0
1.202,6,25,8068,12,164,94,267,1300,13,869,86,1408,6768
15.963,17,32,15575,17,664,995,1350,11777,15,225,1138,1350,3798
0.551,6,49,19998,27,983,21,1380,14876,22,421,23,1923,5122
6.463,6,48,23406,25,1042,269,1460,11480,23,785,280,2079,11926
5.033,17,4,288,2,36,5002,36,128,2,52,4976,52,160
301.477,1,4,224,4,28,100492,28,224,0,0,0,0,0
1.628,6,14,2351,8,188,232,245,700,6,703,276,1152,1651
3.755,2,2,64,2,8,3755,8,64,0,0,0,0,0
367.967,6,56,7036,27,109,14145,722,2761,29,146,13135,1402,4275
1794.42,17,769,46366,769,32,2336,37,46366,0,0,0,0,0
1775.303,6,180,15480,120,69,14918,69,8940,60,69,30080,69,6540
1770.23,17,279,63842,279,200,6367,364,63842,0,0,0,0,0
88.668,17,6,528,3,48,44330,48,228,3,72,44329,72,300
1.279,6,10,1671,6,552,255,948,1348,4,159,426,159,323
180.837,6,23,7596,12,321,16439,517,1275,11,717,18057,1448,6321
38.472,1,44,4576,0,0,0,0,0,44,76,894,76,4576
157.162,17,4,240,2,32,157160,32,120,2,32,157161,32,120
1774.186,1,55,4620,0,0,0,0,0,55,56,32855,56,4620
62.43,6,12,896,4,106,20810,106,274,8,90,8891,90,622
0.255,6,20,9025,10,121,28,121,649,10,1121,28,1448,8376
15.371,6,24,6993,13,275,1280,275,1078,11,910,1042,1440,5915
1.117,6,26,9564,13,164,79,267,1388,13,1070,79,2411,8176
1786.392,6,102,8296,68,65,26662,65,4930,34,59,54130,59,3366
0.01,17,2,607,1,45,0,45,73,1,506,0,506,534
1756.065,6,95,7203,63,38,28323,205,4476,32,33,56635,98,2727
81.474,6,22,900,10,0,6269,0,404,12,0,7405,0,496
7.751,17,12,1764,6,48,1547,48,456,6,190,1547,308,1308
0.866,6,21,9254,11,525,86,1237,2047,10,970,70,1360,7207
0.01,17,2,182,1,39,0,39,67,1,87,0,87,115
1797.474,1,345,28980,345,56,5225,56,28980,0,0,0,0,0
1.284,17,4,284,2,32,583,32,120,2,54,703,60,164
438.95,17,12,4032,12,308,39904,308,4032,0,0,0,0,0
1707.115,17,40,3446,20,32,89846,37,1202,20,84,89846,136,2244
0.515,17,3,451,2,39,37,39,134,1,289,0,289,317
1654.729,1,7,392,7,28,275788,28,392,0,0,0,0,0
481.28,2,6,192,6,8,96256,8,192,0,0,0,0,0
2.886,17,3,1176,3,364,1443,364,1176,0,0,0,0,0
70.552,6,21,860,10,0,6064,0,408,11,0,7050,0,452
0.16,17,2,166,1,47,0,47,75,1,63,0,63,91
1796.647,17,448,39896,403,35,4469,288,25676,45,288,40018,288,14220
0.032,17,2,574,1,32,0,32,60,1,486,0,486,514
370.922,6,18,1242,14,180,28532,180,916,4,110,20065,110,326
236.631,2,3,96,3,8,118315,8,96,0,0,0,0,0
64.458,6,31,16406,14,249,77,431,1485,17,935,4015,2736,14921
20.168,6,36,8262,20,345,1061,722,1869,16,521,570,3488,6393
2.0,1,3,252,3,56,1000,56,252,0,0,0,0,0
1781.916,6,355,22480,207,69,8650,69,12420,148,69,12121,69,10060
11.838,6,25,8473,13,275,986,275,1078,12,986,850,1440,7395
0.03,17,2,283,1,31,0,31,59,1,196,0,196,224
374.895,6,26,3218,18,141,22052,141,917,8,492,3343,775,2301
4.05,17,5,295,5,31,1012,31,295,0,0,0,0,0
0.247,17,2,2384,2,1164,247,1164,2384,0,0,0,0,0
0.466,6,26,8891,13,237,38,589,1634,13,939,36,1438,7257
1199.412,17,224,17024,224,48,5378,48,17024,0,0,0,0,0
1795.201,17,80,3354,79,14,23015,14,3318,1,8,0,8,36
0.674,6,30,7117,18,242,39,645,2423,12,701,56,1728,4694
33.833,6,31,5140,15,180,2416,721,1859,16,305,2240,1368,3281
0.042,17,2,198,1,39,0,39,67,1,103,0,103,131
11.608,6,1843,1598794,1114,1380,10,1420,1565413,729,467,15,1883,33381
3.018,17,3,180,3,32,1509,32,180,0,0,0,0,0
77.319,6,4580,3527175,2145,341,36,343,151205,2435,1348,31,2736,3375970
30.95,17,6,638,6,78,6190,84,638,0,0,0,0,0
1774.162,17,190,45316,190,210,9387,422,45316,0,0,0,0,0
48.457,17,4,240,2,32,48456,32,120,2,32,48456,32,120
0.046,6,10,1514,5,503,11,503,771,5,475,11,475,743
1.332,6,50,18870,27,861,51,1360,13174,23,433,51,1360,5696
1.459,17,6,817,3,31,725,31,177,3,185,723,196,640
1799.952,17,448,39896,403,35,4477,288,25676,45,288,40023,288,14220
7.177,6,16,3262,9,210,896,210,908,7,664,1196,904,2354
921.628,1,5,530,5,78,230407,78,530,0,0,0,0,0
6.592,17,15,6238,7,476,1092,1350,3533,8,310,936,1350,2705
143.743,6,24,3386,14,181,11057,595,1814,10,261,15037,580,1572
0.172,6,10,767,5,186,42,186,454,5,45,41,45,313
1773.32,6,203,22290,130,75,13746,267,10057,73,134,24626,1917,12233
1764.088,2,13,416,13,8,147007,8,416,0,0,0,0,0
280.945,6,32,7650,13,158,23412,267,1317,19,464,15605,1400,6333
1741.513,6,87,6322,58,31,30552,31,3915,29,31,62196,31,2407
37.089,6,2904,2692874,1761,1443,20,1448,2623206,1143,776,32,1448,69668
0.26,17,3,451,2,39,181,39,134,1,289,0,289,317
62.6,1,4,424,4,78,20866,78,424,0,0,0,0,0
1111.541,17,219,16644,219,48,5098,48,16644,0,0,0,0,0
300.176,6,42,13233,23,839,13636,1360,7671,19,479,16666,4027,5562
72.014,17,4,304,4,48,24004,48,304,0,0,0,0,0
7.403,6,6,324,2,0,7403,0,100,4,0,2409,0,224
0.058,17,3,216,2,31,0,31,118,1,70,0,70,98
1386.618,2,15,480,15,8,99044,8,480,0,0,0,0,0
3.5,17,10,900,5,30,871,30,290,5,94,872,94,610
0.032,17,4,368,2,32,9,32,120,2,96,14,96,248
0.001,17,2,158,1,34,0,34,62,1,68,0,68,96
316.958,6,59,12781,28,141,11739,615,3556,31,419,10560,3289,9225
1740.533,17,30,7050,30,207,60018,207,7050,0,0,0,0,0
12.107,6,1921,1665603,1160,1380,10,1420,1630942,761,467,15,1883,34661
0.057,6,9,1339,5,145,14,145,349,4,826,12,826,990
0.478,6,12,1653,6,288,95,288,548,6,426,53,434,1105
1779.621,17,140,11200,70,48,25791,48,5320,70,56,25791,56,5880
24.846,6,31,4298,16,304,1656,304,2968,15,83,1714,83,1330
300.74,6,27,12170,14,315,23124,922,1865,13,1085,25051,1460,10305
1.573,6,76,52531,44,1251,36,1402,44860,32,857,45,1402,7671
25.405,6,43,12813,21,199,1270,721,2437,22,791,1201,2840,10376
99.731,17,3,195,3,37,49865,47,195,0,0,0,0,0
3.392,17,5,364,4,32,1124,32,240,1,96,0,96,124
0.365,17,8,2774,8,318,52,357,2774,0,0,0,0,0
1776.723,17,140,11200,70,48,25749,48,5320,70,56,25749,56,5880
10.656,6,20,4442,11,275,1065,275,998,9,768,736,1440,3444
1750.409,6,149,9148,80,44,22157,208,5489,69,31,25737,31,3659
0.767,6,25,5640,14,121,59,267,1295,11,780,69,1460,4345
14.905,6,1765,1552220,1041,1405,14,1448,1507616,724,776,20,1448,44604
1790.724,17,128,10240,64,48,28424,48,4864,64,56,28424,56,5376
5.614,6,39,7285,20,218,295,314,3423,19,516,297,1179,3862
1786.222,6,105,8475,68,65,26660,65,4930,37,59,49614,59,3545
31.251,17,4,352,2,48,31241,48,152,2,72,31242,72,200
1745.415,6,94,7151,62,38,28613,205,4424,32,33,56292,98,2727
196.665,17,518,291346,497,556,396,1252,290498,21,12,3941,16,848
1.226,6,8,342,4,0,408,0,164,4,7,275,7,178
0.016,17,2,399,1,39,0,39,67,1,304,0,304,332
10.932,6,1629,1500977,1060,1364,10,1420,1473902,569,475,19,1883,27075
1790.723,1,342,28728,342,56,5251,56,28728,0,0,0,0,0
280.348,6,29,7392,13,158,23362,267,1317,16,603,18686,1400,6075
0.838,6,20,5952,11,282,83,548,1292,9,716,93,1420,4660
144.574,6,137,104281,86,1271,1700,1368,93502,51,676,1651,1368,10779
1772.375,6,180,15480,120,69,14893,69,8940,60,69,30031,69,6540
0.002,1,2,112,2,28,2,28,112,0,0,0,0,0
1745.161,6,100,7866,66,45,26848,205,4902,34,35,52877,98,2964
0.006,17,2,463,1,41,0,41,69,1,366,0,366,394
0.367,6,10,968,5,256,89,256,460,5,304,88,304,508
468.109,6,132,15897,56,150,7333,1189,5112,76,157,6241,1420,10785
1787.054,6,102,8296,68,65,26672,65,4930,34,59,54150,59,3366
0.625,6,10,861,5,222,152,222,426,5,231,152,231,435
1.19,6,24,8004,12,164,91,267,1288,12,1014,91,2331,6716
347.472,1,5,280,5,28,86868,28,280,0,0,0,0,0
0.027,6,3,182,2,31,27,31,111,1,31,0,31,71
1751.945,6,95,7203,63,38,28257,205,4476,32,33,56500,98,2727
0.482,17,15,9135,8,822,68,1350,6803,7,305,66,1350,2332
9.015,6,15,3927,8,275,1287,275,603,7,1010,1386,2840,3324
1784.745,6,102,8364,68,66,26637,66,4964,34,60,54079,60,3400
1770.193,1,58,4872,58,56,31056,56,4872,0,0,0,0,0
18.257,17,41,14878,21,503,911,1350,11153,20,158,959,1350,3725
3.632,6,14,3143,8,49,518,92,511,6,579,42,1408,2632
3.247,6,3,144,1,0,0,0,52,2,0,3247,0,92
177.135,6,39,13189,18,528,172,716,3922,21,495,8849,1542,9267
0.577,6,20,7168,13,319,48,602,1960,7,1209,90,1946,5208
1763.696,2,15,480,15,8,125978,8,480,0,0,0,0,0
0.134,6,10,1671,6,552,25,948,1348,4,159,37,159,323
1787.907,6,362,23036,212,69,8473,69,12896,150,69,11999,69,10140
1.313,6,49,20262,28,899,48,1360,14646,21,476,57,2720,5616
1787.905,6,367,25581,214,100,8393,469,14976,153,69,11762,69,10605
0.909,6,10,1687,7,100,151,100,384,3,1179,324,1179,1303
1786.411,6,102,8364,68,66,26662,66,4964,34,60,54130,60,3400
0.058,17,2,602,1,46,0,46,74,1,500,0,500,528
1720.67,17,12,498,11,14,172067,14,462,1,8,0,8,36
2.202,6,20,3833,11,234,220,564,1504,9,463,250,1343,2329
104.086,6,43,10361,14,290,8006,1189,2604,29,263,3716,1420,7757
1799.106,1,58,4872,0,0,0,0,0,58,56,31563,56,4872
0.237,6,23,4494,11,165,23,456,1394,12,493,20,888,3100
1.91,17,3,468,3,128,955,128,468,0,0,0,0,0
1736.427,1,15,840,15,28,124030,28,840,0,0,0,0,0
5.947,17,3,1008,3,308,2973,308,1008,0,0,0,0,0
141.456,6,30,18621,15,708,93,1460,4174,15,1383,10084,3310,14447
249.77,6,14,10673,2,241,186,241,321,12,822,22689,958,10352
1773.868,6,182,15698,120,69,14906,69,8940,62,69,29072,69,6758
1799.364,17,448,39896,403,35,4476,288,25676,45,288,40017,288,14220
1748.753,6,106,8131,68,40,26100,205,4896,38,35,47212,108,3235
0.336,6,24,4571,12,165,30,456,1446,12,415,28,888,3125
0.405,6,49,21177,27,1067,15,1380,16055,22,421,17,1923,5122
0.075,6,11,1711,6,98,15,98,358,5,1149,18,1149,1353
1783.932,6,356,22520,208,69,8618,69,12460,148,69,12135,69,10060
70.662,6,16,652,7,0,8154,0,284,9,0,8830,0,368
133.326,1,2,716,2,330,133326,336,716,0,0,0,0,0
0.184,17,2,157,1,31,0,31,59,1,70,0,70,98
22.686,17,18,9089,9,640,2835,1350,6016,9,313,2828,1350,3073
7.4,6,15,5673,4,106,2463,106,274,11,706,739,1420,5399
3.666,6,33,6129,17,206,229,314,2744,16,456,226,1152,3385
301.368,6,47,26956,25,894,12557,1368,9361,22,1096,1524,2736,17595
1750.928,17,12,498,11,14,175092,14,462,1,8,0,8,36
40.01,17,11,530,10,16,4445,58,446,1,56,0,56,84
0.183,6,32,16225,15,173,13,319,1480,17,1259,10,1588,14745
1795.857,6,391,33127,219,134,8237,789,17767,172,104,10501,645,15360
4.297,6,13,2315,7,188,716,245,660,6,1407,811,1407,1655
2.986,17,18,7157,10,461,327,1350,4895,8,254,421,1350,2262
6.932,6,553,460023,331,1320,20,1368,443815,222,776,30,1473,16208
1700.636,17,13,534,11,14,170045,14,462,2,8,1700436,8,72
1.077,6,25,8805,14,290,82,802,1753,11,942,85,1460,7052
1.62,17,2,322,1,33,0,33,61,1,233,0,233,261
10.321,6,1832,1693492,1138,1408,8,1448,1652740,694,776,14,1448,40752
46.47,6,6,364,4,31,15490,31,222,2,31,46456,31,142
1796.799,1,73,6132,73,56,24955,56,6132,0,0,0,0,0
1786.841,6,104,8376,68,65,26669,65,4930,36,59,51048,59,3446
1799.758,17,452,39568,407,35,4432,288,25844,45,276,39997,288,13724
115.472,6,24,6200,9,267,101,501,1165,15,369,8241,1420,5035
981.654,6,94,12167,46,93,19604,721,4087,48,205,20882,1420,8080
1752.695,6,94,7151,62,38,28732,205,4424,32,33,56530,98,2727
1.486,6,31,6208,16,150,99,267,1699,15,780,92,1459,4509
571.519,1,6,336,6,28,114303,28,336,0,0,0,0,0
126.08,17,3,222,3,46,63040,46,222,0,0,0,0,0
1682.629,17,14,1036,7,30,280431,30,406,7,62,280431,62,630
0.989,6,2,100,1,0,0,0,60,1,0,0,0,40
61.307,6,36,15889,22,799,2919,1408,9163,14,748,4696,2439,6726
1783.771,6,364,25392,212,100,8453,469,14896,152,69,11810,69,10496
201.364,6,28,6562,11,220,5610,516,1325,17,325,12579,1452,5237
1740.791,2,21,672,21,8,87039,8,672,0,0,0,0,0
7.431,6,18,2899,10,211,825,211,1372,8,545,1057,904,1527
1149.0,6,12,1308,12,69,104454,69,1308,0,0,0,0,0
1797.837,1,345,28980,345,56,5226,56,28980,0,0,0,0,0
5.682,6,42,7389,22,218,270,314,3503,20,440,285,1152,3886
1772.246,6,180,15480,120,69,14892,69,8940,60,69,30034,69,6540
9.016,6,13,3137,6,92,1803,92,412,7,2329,1466,2329,2725
1786.642,6,102,8160,68,63,26666,63,4862,34,57,54137,57,3298
96.601,17,4,1344,4,308,32200,308,1344,0,0,0,0,0
1116.463,17,162,31012,81,48,13955,48,6156,81,278,13955,308,24856
3.584,6,20,5196,10,158,398,174,878,10,782,387,1452,4318
1794.251,17,180,11520,180,36,10023,36,11520,0,0,0,0,0
1402.699,17,12,888,6,30,280524,30,348,6,62,280523,62,540
4.905,17,5,514,4,32,1263,32,240,1,246,0,246,274
0.051,17,2,193,1,46,0,46,74,1,91,0,91,119
1787.892,6,102,8364,68,66,26684,66,4964,34,60,54175,60,3400
0.128,17,2,290,1,40,0,40,68,1,194,0,194,222
1768.806,1,58,4872,0,0,0,0,0,58,56,31031,56,4872
10.556,6,20,7026,11,275,1055,275,998,9,1414,722,1414,6028
20.309,6,22,5470,13,107,1692,159,1126,9,773,2531,1418,4344
1.299,6,48,18269,28,882,48,1360,12648,20,437,59,2720,5621
40.497,17,109,81239,45,304,919,1350,14957,64,1007,642,1350,66282
16.961,6,27,7177,13,155,1413,267,1306,14,530,1304,3417,5871
126.229,2,2,64,2,8,126229,8,64,0,0,0,0,0
1745.585,6,97,7307,63,38,28154,205,4476,34,33,52884,98,2831
1.312,6,47,19361,27,905,50,1460,13785,20,433,59,1460,5576
48.247,6,6034,5794061,3839,1427,12,1448,5670893,2195,776,21,1448,123168
13.84,6,2248,2089281,1445,1368,9,1408,2042861,803,931,17,2816,46420
1.661,6,74,51175,43,1254,39,1440,43658,31,842,49,1440,7517
0.028,17,2,154,1,33,0,33,61,1,65,0,65,93
2.679,6,22,5231,12,351,243,1382,2242,10,517,296,2433,2989
0.135,17,2,198,1,39,0,39,67,1,103,0,103,131
120.251,2,2,64,2,8,120251,8,64,0,0,0,0,0
0.065,17,2,198,1,39,0,39,67,1,103,0,103,131
276.185,1,5,420,5,56,69046,56,420,0,0,0,0,0
7.51,17,6,456,6,48,1502,48,456,0,0,0,0,0
6.528,6,868,755715,519,1378,12,1408,732891,349,776,18,1408,22824
1798.799,6,373,26028,216,98,8366,469,15263,157,69,11529,69,10765
1797.324,6,373,24083,215,75,8398,469,13554,158,69,11445,69,10529
100.176,6,30,8739,16,511,6678,1018,2433,14,618,3069,1408,6306
56.344,6,9,529,5,45,14086,45,313,4,0,18777,0,216
1795.828,6,356,22520,208,69,8675,69,12460,148,69,12216,69,10060
1754.416,6,186,11385,93,47,19069,208,6766,93,31,19067,31,4619
0.014,17,3,244,2,32,11,32,120,1,96,0,96,124
1680.465,1,15,840,15,28,120033,28,840,0,0,0,0,0
6.98,6,44,8369,22,227,332,314,4062,22,489,319,1179,4307
0.628,6,4,160,2,0,628,0,80,2,0,0,0,80
11.077,6,20,4442,11,275,1107,275,998,9,768,777,1440,3444
1.641,6,46,18606,27,854,63,1360,13070,19,529,79,4075,5536
0.554,6,22,7333,13,334,46,663,2021,9,1209,63,1946,5312
3.778,6,2,80,1,0,0,0,40,1,0,0,0,40
731.002,6,102,9525,38,81,18945,339,3877,64,93,11603,1062,5648
10.976,6,18,5610,10,275,1219,275,958,8,1440,852,1440,4652
1149.224,6,77,6022,49,65,23942,65,3455,28,57,42523,59,2567
1799.229,17,449,39928,404,35,4464,288,25708,45,288,40021,288,14220
20.15,6,17,2316,10,189,2238,517,1298,7,323,3355,499,1018
1777.223,17,79,3312,78,14,23080,14,3276,1,8,0,8,36
1791.598,17,139,11100,72,48,25233,48,5472,67,56,27145,56,5628
2.803,6,11091,9980454,5507,147,0,269,294252,5584,1683,0,12672,9686202
1747.952,6,100,7860,66,45,26891,205,4896,34,35,52954,98,2964
1740.563,1,15,840,15,28,124325,28,840,0,0,0,0,0
27.324,1,4,224,4,28,9108,28,224,0,0,0,0,0
124.106,6,33,7826,12,155,28,267,1266,21,357,6205,3417,6560
18.752,1,8,832,0,0,0,0,0,8,76,2678,76,832
5.942,6,13,2311,8,188,848,245,700,5,1407,1419,1407,1611
1785.499,6,106,8456,68,65,26649,65,4930,38,59,48252,59,3526
251.744,2,2,64,2,8,251744,8,64,0,0,0,0,0
4.478,6,4,176,4,0,0,0,176,0,0,0,0,0
1741.521,17,29,6815,29,207,62197,207,6815,0,0,0,0,0
300.839,6,113,72359,58,396,5277,986,4609,55,1272,585,1408,67750
60.279,6,39,20411,19,131,3348,134,1520,20,991,3167,1448,18891
0.08,17,4,364,2,52,0,52,160,2,74,38,80,204
1786.968,6,102,8228,68,64,26671,64,4896,34,58,54148,58,3332
1.977,17,2,925,1,548,0,548,576,1,321,0,321,349
1789.953,6,367,23305,212,69,8483,69,12758,155,69,11623,69,10547
1773.237,6,180,15480,120,69,14901,69,8940,60,69,30048,69,6540
1203.181,2,8,256,8,8,171883,8,256,0,0,0,0,0
0.048,17,4,284,2,32,20,32,120,2,54,33,60,164
1785.028,6,362,22898,210,69,8540,69,12678,152,69,11818,69,10220
123.388,6,2422,2241639,1390,606,88,1396,83021,1032,2061,119,12564,2158618
1684.458,2,26,832,26,8,67378,8,832,0,0,0,0,0
280.188,6,28,7352,14,158,21552,267,1357,14,775,21551,4836,5995
1.35,6,51,20657,30,916,46,1360,14996,21,437,59,2715,5661
10.112,6,17,6800,5,106,2525,106,314,12,854,918,1452,6486
0.211,6,3,2880,2,1368,1,1368,2840,1,0,0,0,40
12.046,17,20,4045,10,33,1335,33,610,10,315,1336,327,3435
377.115,6,25,1651,17,177,23569,177,1117,8,110,9264,110,534
0.113,17,2,672,2,308,113,308,672,0,0,0,0,0
1785.149,17,84,3522,83,14,21770,14,3486,1,8,0,8,36
0.275,17,2,180,1,30,0,30,58,1,94,0,94,122
144.265,17,4,240,2,32,144263,32,120,2,32,144263,32,120
13.076,6,24,6993,13,275,1089,275,1078,11,910,806,1440,5915
123.167,6,138,121246,92,938,52,1360,12258,46,2895,2734,12240,108988
16.767,6,24,5870,13,275,1397,275,1086,11,1440,1175,1440,4784
116.745,6,27,7312,12,158,10613,267,1277,15,678,8334,2045,6035
11.73,6,1854,1611419,1137,1362,10,1380,1578494,717,467,16,2760,32925
1791.452,6,356,22520,208,69,8654,69,12460,148,69,12186,69,10060
280.285,6,31,7472,14,158,21560,267,1357,17,543,17512,1400,6115
1773.17,6,4144,3826536,1490,159,1190,970,88152,2654,1397,668,2836,3738384
1773.141,6,180,15480,120,69,14900,69,8940,60,69,30052,69,6540
1308.333,17,248,18848,248,48,5296,48,18848,0,0,0,0,0
1794.972,17,447,39864,402,35,4476,288,25644,45,288,40016,288,14220
1.63,6,50,19892,28,872,60,1360,14236,22,433,66,1360,5656
0.284,17,2,558,1,32,0,32,60,1,470,0,470,498
16.13,6,2,88,0,0,0,0,0,2,0,0,0,88
0.031,17,2,382,1,32,0,32,60,1,294,0,294,322
334.934,6,16,1138,12,180,30448,180,812,4,110,20059,110,326
1781.77,6,365,25501,212,100,8444,469,14896,153,69,11722,69,10605
280.314,17,4,296,2,30,280301,30,116,2,62,280287,62,180
0.595,6,7,295,4,0,198,0,164,3,7,170,7,131
1.334,6,38,8254,19,321,74,1164,2718,19,433,63,1460,5536
159.879,6,23,4396,7,407,1165,722,1186,16,197,10647,1408,3210
0.363,6,26,8890,13,232,30,569,1614,13,1098,28,2804,7276
43.128,6,344,189736,173,366,250,1019,16690,171,1109,253,3832,173046
1359.685,6,101,10753,57,76,24280,721,5188,44,93,30974,1448,5565
1770.583,6,104,9648,68,65,26426,65,5758,36,59,50584,59,3890
12.24,17,10,965,5,46,3058,46,370,5,91,3057,91,595
3.204,17,28,13818,14,697,246,1350,10155,14,233,124,1350,3663
0.888,6,10,1687,7,100,148,100,384,3,1179,313,1179,1303
5.523,6,40,7309,22,218,263,314,3503,18,513,310,1179,3806
0.634,6,24,7492,14,273,48,663,2104,10,1209,64,1946,5388
7.494,6,38,7245,19,218,416,314,3383,19,516,398,1179,3862
1794.992,17,447,39864,402,35,4476,288,25644,45,288,40021,288,14220
1773.89,6,180,15480,120,69,14906,69,8940,60,69,30061,69,6540
300.882,6,47,14591,26,866,12035,1360,8904,21,371,434,1360,5687
0.873,6,10,1687,7,100,145,100,384,3,1179,306,1179,1303
280.263,6,30,7432,13,158,23355,267,1317,17,543,17511,1400,6115
1.417,6,53,19318,29,880,50,1360,13537,24,400,53,1360,5781
61.579,6,45,24741,28,1024,2280,1440,17859,17,665,3831,1440,6882
0.217,17,2,152,1,48,0,48,76,1,48,0,48,76
1795.136,1,142,7952,142,28,12731,28,7952,0,0,0,0,0
1.775,6,45,18244,26,882,71,1360,12612,19,486,88,4075,5632
33.748,6,9,396,2,0,2970,0,88,7,0,5582,0,308
0.093,17,4,336,2,45,0,45,146,2,67,51,73,190
280.521,6,30,7432,13,158,23376,267,1317,17,603,17527,2760,6115
1774.706,1,164,17384,164,78,10887,78,17384,0,0,0,0,0
1794.43,1,192,10752,192,28,9394,28,10752,0,0,0,0,0
1.502,6,8,4624,4,1247,422,1247,1407,4,1019,500,1360,3217
226.53,17,6,360,3,32,113264,32,180,3,32,113264,32,180
366.78,6,25,1651,17,177,22923,177,1117,8,110,9204,110,534
1787.346,6,138,21352,84,292,21534,1259,15642,54,84,33720,193,5710
0.63,6,130,94013,78,1301,8,1420,87712,52,467,12,1883,6301
281.644,6,32,7512,14,158,21664,267,1357,18,603,16565,1400,6155
1791.845,17,87,3648,86,14,21080,14,3612,1,8,0,8,36
0.96,6,10,1687,7,100,160,100,384,3,1179,350,1179,1303
1772.477,6,180,15480,120,69,14894,69,8940,60,69,30040,69,6540
41.391,6,45,8913,21,371,747,766,2045,24,327,1794,1460,6868
1729.265,6,61,4452,40,33,44340,33,2740,21,31,86453,31,1712
0.292,6,26,9013,13,257,24,669,1714,13,945,23,1402,7299
0.145,6,6,718,3,304,67,304,460,3,102,65,102,258
1781.762,6,366,24534,212,87,8444,469,14096,154,69,11645,69,10438
1680.017,17,24,1368,24,29,73044,29,1368,0,0,0,0,0
5.837,6,42,7389,22,218,277,314,3503,20,440,293,1152,3886
0.497,17,3,543,2,39,459,39,134,1,381,0,381,409
85.712,6,40,9514,17,290,2433,1189,2724,23,418,3895,1420,6790
0.451,17,8,4717,4,630,150,1350,2635,4,492,93,1350,2082
925.556,17,45,1890,45,14,21035,14,1890,0,0,0,0,0
39.51,6,27,8644,13,520,3292,1034,2280,14,625,3007,2899,6364
0.012,17,2,200,1,40,0,40,68,1,104,0,104,132
1777.299,17,73,3060,72,14,25032,14,3024,1,8,0,8,36
2.845,6,2,1520,0,0,0,0,0,2,1440,2845,1440,1520
1741.03,6,103,7455,65,31,27203,31,4439,38,31,47054,31,3016
7.383,17,6,528,3,48,3680,48,228,3,72,3673,72,300
4.956,6,41,7349,22,218,236,314,3503,19,513,261,1179,3846
1788.192,6,356,22520,208,69,8638,69,12460,148,69,12164,69,10060
1740.482,17,30,31620,30,1026,60016,1026,31620,0,0,0,0,0
1796.435,17,449,39928,404,35,4457,288,25708,45,288,40019,288,14220
0.007,6,3,128,2,0,1,0,88,1,0,0,0,40
0.013,17,2,338,1,33,0,33,61,1,249,0,249,277
0.197,1,2,112,2,28,197,28,112,0,0,0,0,0
1680.34,1,15,840,15,28,120024,28,840,0,0,0,0,0
1141.803,6,98,13267,58,109,20031,502,5507,40,219,27800,1420,7760
1768.605,6,354,23778,204,88,8712,469,13707,150,69,11869,69,10071
1.452,6,44,10145,23,440,66,1360,4484,21,400,62,1360,5661
280.409,6,29,7392,12,158,25491,267,1277,17,543,17521,1400,6115
107.933,17,4,352,2,60,107932,60,176,2,60,107932,60,176
362.697,6,47,11351,29,356,12953,1360,5829,18,399,506,1360,5522
1798.076,1,345,28980,345,56,5226,56,28980,0,0,0,0,0
2.278,17,28,13226,13,696,189,1350,9422,15,225,114,1350,3804
975.26,17,15,5040,15,308,69661,308,5040,0,0,0,0,0
147.457,17,8,2688,8,308,21065,308,2688,0,0,0,0,0
2.97,17,2,124,2,34,2970,34,124,0,0,0,0,0
43.823,17,5,1672,5,306,10955,308,1672,0,0,0,0,0
4.272,6,22,6427,11,268,419,517,1386,11,893,419,2448,5041
1.311,6,50,19747,29,919,46,1360,14086,21,437,56,2715,5661
1782.924,17,142,11360,71,48,25470,48,5396,71,56,25470,56,5964
1790.637,6,359,22709,209,69,8608,69,12569,150,69,12017,69,10140
56.036,17,4,308,2,33,56001,33,122,2,65,56004,65,186
1740.495,17,29,19517,29,645,62160,645,19517,0,0,0,0,0
233.193,6,37,13592,21,618,11659,1440,6065,16,950,15534,1440,7527
1780.624,17,141,11276,71,48,25437,48,5396,70,56,25806,56,5880
4.081,17,5,295,5,31,1020,31,295,0,0,0,0,0
1786.944,6,102,8296,68,65,26670,65,4930,34,59,54147,59,3366
0.183,17,2,178,1,35,0,35,63,1,87,0,87,115
1790.773,6,355,22480,207,69,8693,69,12420,148,69,12181,69,10060
60.307,6,9,484,5,0,15076,0,268,4,0,20092,0,216
289.432,6,31,8348,16,153,19295,516,1720,15,502,20667,1452,6628
141.792,6,30,5277,14,201,4473,516,1572,16,278,9433,1452,3705
1785.87,6,368,24683,213,87,8423,469,14205,155,69,11596,69,10478
0.029,6,10,1671,6,552,5,948,1348,4,159,9,159,323
1798.223,17,140,11200,70,48,26061,48,5320,70,56,26061,56,5880
11.793,6,88,24725,46,533,262,1152,18904,42,459,280,1179,5821
1.407,6,47,18961,26,944,56,1460,13345,21,433,60,1460,5616
0.006,17,2,430,1,59,0,59,87,1,315,0,315,343
7.007,6,241,271645,168,133,41,201,8019,73,3778,95,21210,263626
1793.114,17,179,11456,179,36,10073,36,11456,0,0,0,0,0
1773.768,6,180,15480,120,69,14905,69,8940,60,69,30058,69,6540
10.886,6,1718,1503928,1041,1391,10,1420,1472627,677,467,16,1883,31301
0.121,17,2,255,1,43,0,43,71,1,156,0,156,184
1799.291,6,373,26028,217,98,8330,469,15303,156,69,11608,69,10725
293.827,6,161,123512,101,1288,2938,1408,110880,60,731,2095,3847,12632
18.759,17,12,1056,6,48,3749,48,456,6,72,3749,72,600
0.009,17,2,2754,2,1349,9,1349,2754,0,0,0,0,0
225.285,17,10,880,5,48,56318,48,380,5,72,56318,72,500
11.727,6,1891,1624784,1145,1363,10,1380,1590702,746,383,15,1380,34082
0.284,17,2,268,1,54,0,54,82,1,158,0,158,186
1799.995,6,206,14266,76,46,23999,46,6076,130,46,13891,46,8190
362.544,6,25,1654,16,180,24169,180,1068,9,110,8981,110,586
0.136,17,2,148,1,32,0,32,60,1,60,0,60,88
1743.696,6,95,7203,63,38,28124,205,4476,32,33,56236,98,2727
50.15,17,9,3248,9,332,6268,548,3248,0,0,0,0,0
33.544,6,34,5297,16,154,2236,722,1911,18,271,1962,1408,3386
0.42,6,7,295,4,0,140,0,164,3,7,102,7,131
3.961,17,5,1160,5,204,990,204,1160,0,0,0,0,0
1771.516,6,99,9174,66,64,27254,64,5544,33,58,55356,58,3630
31.968,6,26,6776,10,154,3552,267,872,16,525,2123,1460,5904
1.387,6,218,216741,140,234,9,256,10108,78,2665,17,9856,206633
0.415,6,52,22830,30,966,14,1380,15785,22,558,17,1923,7045
21.854,17,30,17679,13,409,1818,1350,5685,17,677,1364,1350,11994
1743.682,6,95,7203,63,38,28123,205,4476,32,33,56233,98,2727
219.071,17,3,195,3,37,109535,47,195,0,0,0,0,0
1.046,17,4,624,2,64,929,64,184,2,192,979,192,440
1775.647,1,342,28728,342,56,5207,56,28728,0,0,0,0,0
1789.239,17,142,11360,71,48,25560,48,5396,71,56,25560,56,5964
369.819,6,17,1190,13,180,30818,180,864,4,110,20124,110,326
1798.747,6,378,26366,219,97,8251,469,15521,159,69,11381,69,10845
6.761,6,19,3445,10,211,751,211,986,9,665,844,904,2459
367.354,6,58,7284,27,109,14122,722,2736,31,140,12239,1408,4548
378.525,6,18,1242,14,180,29117,180,916,4,110,20073,110,326
0.051,17,4,352,2,37,44,37,130,2,83,43,89,222
2.936,17,3,468,3,128,1468,128,468,0,0,0,0,0
12.135,6,92,27229,46,544,269,1152,20907,46,447,263,1179,6322
32.01,6,7,308,1,0,0,0,44,6,0,6318,0,264
1749.376,6,163,10080,88,43,20107,208,6181,75,31,21984,31,3899
1740.981,6,87,6322,58,31,30543,31,3915,29,31,62176,31,2407
1783.856,6,256,25843,105,66,17151,594,9701,151,134,11891,4658,16142
5.492,6,41,7349,21,218,274,314,3463,20,440,273,1152,3886
9.989,6,81,24765,40,560,256,1152,18968,41,461,243,1179,5797
1788.114,1,208,22048,208,78,8638,78,22048,0,0,0,0,0
0.272,6,22,4467,11,165,27,456,1394,11,498,26,888,3073
274.522,6,25,4788,10,271,582,515,1223,15,327,19601,1452,3565
1791.436,17,87,3648,86,14,21075,14,3612,1,8,0,8,36
7.508,6,12,9352,4,113,2502,113,277,8,1458,1040,1460,9075
300.578,6,10,811,5,177,75099,177,445,5,110,75099,110,366
0.355,17,8,2758,8,316,50,355,2758,0,0,0,0,0
1795.36,1,58,4872,58,56,31497,56,4872,0,0,0,0,0
1798.99,17,448,39896,403,35,4475,288,25676,45,288,40019,288,14220
4.314,6,37,7189,19,218,239,314,3383,18,513,237,1179,3806
207.897,17,4,352,2,60,207896,60,176,2,60,207895,60,176
232.319,17,4,352,2,60,232318,60,176,2,60,232318,60,176
1773.369,6,180,15480,120,69,14902,69,8940,60,69,30050,69,6540
0.441,6,12,1653,6,288,82,288,548,6,426,53,434,1105
1.434,6,16,3843,7,288,238,288,900,9,639,156,853,2943
0.016,17,2,477,1,48,0,48,76,1,373,0,373,401
0.104,6,2,100,1,0,0,0,60,1,0,0,0,40
0.568,6,23,7428,14,273,43,663,2104,9,1209,62,1946,5324
0.277,17,2,152,1,48,0,48,76,1,48,0,48,76
4.772,6,40,7309,20,218,251,314,3423,20,513,236,1179,3886
8.133,6,69,20230,35,561,239,1152,15443,34,427,238,1152,4787
1.473,6,58,17934,28,697,54,1360,8825,30,438,50,1360,9109
316.018,6,75,19342,37,325,8778,1360,9657,38,339,8537,1360,9685
0.07,17,2,157,1,31,0,31,59,1,70,0,70,98
1791.224,1,58,4872,58,56,31424,56,4872,0,0,0,0,0
34.416,6,37,7679,18,154,2024,722,2063,19,462,1901,1408,5616
1.671,6,27,10127,16,276,111,561,1473,11,1026,149,1420,8654
1630.634,1,8,448,8,28,232947,28,448,0,0,0,0,0
0.08,17,2,212,1,46,0,46,74,1,110,0,110,138
0.428,6,6,324,4,0,142,0,216,2,0,221,0,108
1796.591,1,284,15904,284,28,6348,28,15904,0,0,0,0,0
0.907,17,2,677,1,300,0,300,328,1,321,0,321,349
1020.061,1,5,280,5,28,255015,28,280,0,0,0,0,0
1681.851,1,14,784,14,28,129373,28,784,0,0,0,0,0
1753.383,6,184,11305,92,47,19267,208,6695,92,31,19265,31,4610
1406.836,6,106,10977,65,65,21981,722,5622,41,103,29726,2026,5355
8.158,6,70,20766,35,559,239,1152,15939,35,489,232,1179,4827
77.874,6,94,67304,60,1233,1319,1408,57402,34,812,2265,3847,9902
1741.97,6,98,7390,63,38,28096,205,4476,35,33,51222,98,2914
54.771,6,19,780,10,0,6084,0,404,9,0,6845,0,376
6.143,6,1402,1260570,865,1380,6,1408,1227982,537,931,11,2801,32588
2.926,17,4,624,4,128,975,128,624,0,0,0,0,0
0.229,17,3,286,2,46,0,46,148,1,110,0,110,138
1.691,6,25,8769,15,286,120,590,1462,10,986,167,1420,7307
15.416,17,25,13906,13,861,1282,1350,11561,12,167,1398,1350,2345
0.014,17,2,482,1,63,0,63,91,1,363,0,363,391
6.449,6,1352,1231620,845,1380,7,1408,1200592,507,931,12,2816,31028
1790.274,17,178,13884,178,50,10114,50,13884,0,0,0,0,0
1779.659,17,140,11200,70,48,25792,48,5320,70,56,25792,56,5880
0.107,17,2,400,1,53,0,53,81,1,291,0,291,319
2.951,6,6,340,3,0,1475,0,160,3,0,993,0,180
0.697,6,23,6199,13,268,55,679,1865,10,982,75,1691,4334
11.369,6,26,11315,12,275,1033,275,1038,14,1078,761,1414,10277
2.254,17,3,507,2,39,984,39,134,1,345,0,345,373
0.475,6,20,7165,12,318,42,599,1905,8,1209,66,1906,5260
1752.424,6,95,7234,62,38,28728,205,4424,33,33,54752,98,2810
16.128,6,2,96,0,0,0,0,0,2,0,0,0,96
1674.335,1,7,742,7,78,279055,78,742,0,0,0,0,0
1773.251,6,184,15916,120,69,14901,69,8940,64,69,28140,69,6976
4.415,6,23,14396,14,220,339,517,1604,9,3079,547,11264,12792
0.385,6,27,9069,13,261,32,683,1728,14,943,29,1408,7341
3.098,6,4,220,3,0,1542,0,180,1,0,0,0,40
1707.169,1,73,6132,0,0,0,0,0,73,56,23710,56,6132
1741.48,6,87,6322,58,31,30552,31,3915,29,31,62195,31,2407
1744.267,1,56,4704,56,56,31713,56,4704,0,0,0,0,0
0.181,17,4,284,2,32,152,32,120,2,54,30,60,164
0.82,17,23,16642,14,984,59,1350,14178,9,245,92,1350,2464
1783.335,17,83,3480,82,14,22016,14,3444,1,8,0,8,36
3.148,6,2,88,2,0,0,0,88,0,0,0,0,0
17.649,6,23,4938,13,210,1468,210,1338,10,616,1960,904,3600
2.021,17,2,279,1,36,0,36,64,1,187,0,187,215
386.231,6,18,1242,14,180,29710,180,916,4,110,20061,110,326
1787.226,17,138,11040,69,48,26282,48,5244,69,56,26282,56,5796
0.009,6,2,100,1,0,0,0,60,1,0,0,0,40
0.043,17,2,280,1,48,0,48,76,1,176,0,176,204
16.836,17,19,8917,9,682,2100,1350,6397,10,224,1867,1350,2520
314.46,6,26,5635,9,133,39306,159,887,17,967,19653,1669,4748
394.534,1,6,336,6,28,78906,28,336,0,0,0,0,0
1.36,6,766,858448,292,330,4,332,18534,474,1734,2,4104,839914
300.25,6,47,29747,26,190,12010,444,2205,21,1762,12088,9856,27542
0.295,6,21,7281,13,334,24,663,2021,8,967,40,1471,5260
252.05,2,2,64,2,8,252050,8,64,0,0,0,0,0
1770.619,6,99,9240,66,65,27240,65,5577,33,59,55329,59,3663
1795.926,17,448,39896,403,35,4467,288,25676,45,288,40012,288,14220
1681.242,17,38,3232,38,57,45438,355,3232,0,0,0,0,0
1651.039,1,7,742,7,78,275173,78,742,0,0,0,0,0
0.835,17,2,784,2,364,835,364,784,0,0,0,0,0
1788.934,6,356,22520,208,69,8642,69,12460,148,69,12167,69,10060
31.089,1,36,3744,0,0,0,0,0,36,76,888,76,3744
0.429,6,5,315,1,31,0,31,83,4,0,143,0,232
35.1,17,22,1936,11,48,3502,48,836,11,72,3503,72,1100
0.246,17,2,152,1,48,0,48,76,1,48,0,48,76
1.079,6,30,6220,16,138,71,267,1755,14,650,73,1452,4465
15.11,17,17,8598,8,656,2154,1350,5476,9,318,1884,1350,3122
120.88,6,14,5716,4,106,40293,106,274,10,718,13406,1452,5442
7.199,6,1790,1649459,1127,1385,6,1408,1610319,663,931,10,2801,39140
0.007,17,2,410,1,37,0,37,65,1,317,0,317,345
0.029,17,4,352,2,60,28,60,176,2,60,28,60,176
0.372,17,2,166,1,47,0,47,75,1,63,0,63,91
97.354,17,4,240,2,32,97353,32,120,2,32,97353,32,120
1791.967,1,341,28644,341,56,5270,56,28644,0,0,0,0,0
1785.853,6,363,24745,211,94,8504,469,14387,152,69,11826,69,10358
32.399,6,528,464419,220,125,147,299,14417,308,1427,105,4254,450002
1764.813,2,17,544,17,8,110300,8,544,0,0,0,0,0
280.422,6,28,7352,12,158,25492,267,1277,16,678,18692,2085,6075
840.684,17,8,2168,4,30,280203,30,232,4,456,280226,463,1936
1797.459,6,424,25629,209,69,8641,69,12500,215,35,8399,64,13129
10.67,6,1703,1456230,1029,1362,10,1380,1423117,674,558,15,1923,33113
6.659,6,21,10757,9,275,832,275,639,12,963,493,2840,10118
0.349,6,27,9069,13,261,29,683,1728,14,943,26,1408,7341
19.699,17,2,778,2,361,19699,361,778,0,0,0,0,0
69.815,17,2,148,2,46,69815,46,148,0,0,0,0,0
1797.637,17,416,139776,416,308,4331,308,139776,0,0,0,0,0
10.62,6,16,3819,9,275,1327,275,643,7,1440,1435,1440,3176
0.735,6,23,7394,13,335,61,668,2026,10,1210,78,1946,5368
1.576,6,29,10388,17,373,98,851,1803,12,1012,135,1420,8585
1.184,6,206,155854,120,1326,9,1432,148114,86,389,13,1432,7740
1796.045,6,379,26406,219,97,8238,469,15521,160,69,11293,69,10885
1792.188,17,87,3648,86,14,21084,14,3612,1,8,0,8,36
116.711,6,965,472167,514,850,227,1152,448281,451,417,258,1179,23886
0.051,17,4,284,2,32,36,32,120,2,54,33,60,164
1.206,6,27,8160,14,164,79,267,1392,13,869,85,1448,6768
195.825,2,5,160,5,8,48956,8,160,0,0,0,0,0
650.918,6,75,10901,41,86,16268,721,3711,34,306,19719,2840,7190
11.951,6,1843,1675409,1157,1369,10,1408,1635073,686,931,17,2801,40336
8.465,6,1240,1105006,744,1405,11,1448,1074490,496,776,16,1448,30516
1.612,6,37,8212,19,320,89,1162,2716,18,476,81,2715,5496
0.255,17,3,507,2,39,12,39,134,1,345,0,345,373
0.18,6,26,7256,13,155,15,267,1301,13,678,13,2045,5955
0.014,17,4,364,2,52,0,52,160,2,74,0,80,204
1770.431,6,101,9278,66,64,27237,64,5544,35,58,52068,58,3734
1741.786,1,56,4704,56,56,31668,56,4704,0,0,0,0,0
0.394,6,25,8961,13,257,32,669,1714,12,1102,34,2804,7247
1738.878,6,87,6322,58,31,30506,31,3915,29,31,62102,31,2407
1693.399,17,14,1036,7,30,282227,30,406,7,62,282227,62,630
0.387,6,49,21565,27,1020,14,1380,16443,22,421,15,1923,5122
1.252,6,9,1878,5,666,312,666,934,4,728,417,728,944
1789.265,17,142,11360,71,48,25560,48,5396,71,56,25560,56,5964
0.348,6,12,3702,6,170,66,170,490,6,964,56,1448,3212
1769.476,1,52,4368,52,56,34695,56,4368,0,0,0,0,0
256.742,17,4,240,2,32,256741,32,120,2,32,256741,32,120
1.266,6,50,18838,29,852,45,1360,13177,21,400,54,1360,5661
280.251,6,30,7432,13,158,23354,267,1317,17,543,17510,1400,6115
3.11,6,21,6505,11,141,311,275,730,10,894,308,1380,5775
0.028,6,13,4361,7,126,4,126,498,6,1181,5,1930,3863
1798.026,1,54,4536,0,0,0,0,0,54,56,33925,56,4536
1.37,6,54,19509,29,890,48,1360,13688,25,400,49,1360,5821
261.415,17,4,304,4,48,87138,48,304,0,0,0,0,0
0.036,17,2,519,1,40,0,40,68,1,423,0,423,451
1.57,6,4,284,0,0,0,0,0,4,31,523,31,284
19.723,6,16,1327,8,222,2816,222,768,8,231,2815,231,559
0.668,2,2,64,2,8,668,8,64,0,0,0,0,0
0.385,6,18,6971,11,249,38,517,1483,7,1039,58,2676,5488
1757.898,6,95,7203,63,38,28353,205,4476,32,33,56699,98,2727
15.137,6,5,407,3,69,7568,69,189,2,69,15127,69,218
0.006,6,2,1494,1,1402,0,1402,1454,1,0,0,0,40
92.031,17,4,272,2,40,92030,47,136,2,40,92030,47,136
367.342,6,21,1419,15,177,26238,177,989,6,110,12227,110,430
1785.857,6,358,22738,210,69,8544,69,12678,148,69,12148,69,10060
90.273,6,9,472,5,0,22568,0,256,4,0,30090,0,216
1645.505,1,26,1456,26,28,65820,28,1456,0,0,0,0,0
1.678,6,49,19285,27,894,64,1360,13629,22,476,69,2715,5656
6.135,17,4,332,2,47,6128,47,150,2,63,6127,63,182
577.903,1,6,336,6,28,115580,28,336,0,0,0,0,0
301.208,6,55,27540,28,894,11155,1408,9541,27,921,1285,1491,17999
11.655,6,89,26730,45,549,264,1152,20488,44,447,264,1179,6242
0.501,17,3,451,2,39,433,39,134,1,289,0,289,317
381.747,1,35,4769,35,108,11227,351,4769,0,0,0,0,0
1032.064,6,59,4587,39,43,27159,205,2856,20,34,54297,98,1731
154.296,6,15,3196,7,92,25716,92,452,8,387,22016,1408,2744
2.44,17,3,366,3,94,1220,94,366,0,0,0,0,0
8.172,6,16,2358,9,210,1016,210,908,7,545,1309,904,1450
601.641,2,8,256,8,8,85948,8,256,0,0,0,0,0
245.231,6,81,21807,39,520,6453,1408,13514,42,358,5981,2816,8293
280.201,6,25,7094,11,181,28020,267,1168,14,595,21552,1400,5926
5.566,6,38,7245,20,218,292,314,3423,18,516,311,1179,3822
0.02,17,2,475,1,40,0,40,68,1,379,0,379,407
150.818,17,4,352,2,60,150817,60,176,2,60,150817,60,176
1795.729,17,447,39864,402,35,4478,288,25644,45,288,40023,288,14220
38.358,6,41,9143,23,102,1743,320,1870,18,594,1912,1642,7273
70.371,17,4,1344,4,308,23457,308,1344,0,0,0,0,0
0.906,6,11,1727,7,100,151,100,384,4,589,214,1152,1343
1792.619,6,355,22480,207,69,8702,69,12420,148,69,12194,69,10060
0.288,17,2,138,1,33,0,33,61,1,49,0,49,77
8.838,6,77,22430,40,537,226,1152,17182,37,470,238,1179,5248
139.238,6,37,5797,13,165,2096,722,1841,24,169,6046,1408,3956
250.649,6,35,7139,17,304,15664,517,2183,18,363,14743,1418,4956
0.267,6,26,8991,13,247,22,624,1672,13,1105,22,2816,7319
240.109,6,36,9132,17,180,15006,577,1972,19,561,13339,1408,7160
2.06,17,4,1556,4,361,686,361,1556,0,0,0,0,0
23.902,6,26,6336,14,117,1838,159,1337,12,727,2171,1418,4999
1789.539,1,135,7560,135,28,13354,28,7560,0,0,0,0,0
0.009,6,3,120,1,0,0,0,40,2,0,3,0,80
34.187,17,10,760,10,48,3798,48,760,0,0,0,0,0
0.013,17,2,378,1,30,0,30,58,1,292,0,292,320
1658.88,1,8,943,8,89,236982,173,943,0,0,0,0,0
1786.949,6,356,22520,208,69,8632,69,12460,148,69,12156,69,10060
20.139,6,23,6180,14,117,1549,159,1337,9,1091,2516,3077,4843
11.833,6,1851,1633917,1156,1363,10,1380,1601830,695,387,16,1923,32087
1.352,6,29,11163,16,466,90,1360,3468,13,1193,97,2720,7695
15.642,6,32,8952,14,158,1203,267,1357,18,624,919,1400,7595
5.049,17,3,208,2,36,5005,36,128,1,52,0,52,80
1795.3,1,58,4872,0,0,0,0,0,58,56,31496,56,4872
1776.663,6,82,7703,38,36,48016,36,2276,44,445,41316,445,5427
374.05,6,23,1535,16,177,24936,177,1053,7,110,10397,110,482
25.404,6,48,13014,23,199,1154,721,2518,25,632,1050,1420,10496
1793.911,6,365,27368,211,110,8542,981,15278,154,89,11724,421,12090
61.98,6,7087,6590802,4423,1406,13,1448,6439638,2664,776,23,1448,151164
1760.234,1,114,6384,114,28,15577,28,6384,0,0,0,0,0
0.501,17,2,196,1,46,0,46,74,1,94,0,94,122
1797.785,6,363,23007,211,69,8560,69,12787,152,69,11905,69,10220
1796.931,17,446,39264,403,35,4469,288,25676,43,288,41926,288,13588
1.114,6,35,26677,20,685,58,1360,4283,15,1980,62,8160,22394
15.561,6,9,500,4,0,5187,0,216,5,0,3880,0,284
65.88,6,9,468,9,0,0,0,468,0,0,0,0,0
120.919,2,4,128,4,8,40306,8,128,0,0,0,0,0
1777.771,6,247,25224,100,67,17955,659,9380,147,134,12175,1938,15844
1778.712,6,408,40347,235,89,7600,327,20448,173,67,10339,177,19899
0.501,17,3,451,2,39,446,39,134,1,289,0,289,317
44.234,1,2,112,2,28,44234,28,112,0,0,0,0,0
21.82,6,26,6797,12,181,1983,267,1212,14,627,1677,1400,5585
70.453,6,29,7395,13,155,5871,267,1306,16,453,4696,3417,6089
61.593,6,26,7137,12,155,5599,267,1266,14,530,4737,2840,5871
0.049,17,4,288,2,33,0,33,122,2,55,1,61,166
107.635,6,22,8752,11,314,71,634,1415,11,983,10749,1360,7337
1790.569,17,31,32736,31,1028,59685,1028,32736,0,0,0,0,0
5.023,17,4,288,2,36,4981,36,128,2,52,4992,52,160
368.766,6,37,8492,19,248,20483,517,2003,18,924,21687,2448,6489
715.62,1,24,2016,0,0,0,0,0,24,56,31113,56,2016
1797.163,6,361,23065,208,69,8681,69,12529,153,69,11823,69,10536
1785.122,1,337,28308,337,56,5312,56,28308,0,0,0,0,0
0.03,17,2,410,1,46,0,46,74,1,308,0,308,336
1.825,6,13,2311,8,188,260,245,700,5,1407,382,1407,1611
1797.737,6,277,37403,113,137,16050,1460,15970,164,176,11028,1642,21433
6.618,6,32,13894,19,683,367,1360,6262,13,1420,539,3934,7632
1759.576,17,72,24160,72,307,24782,308,24160,0,0,0,0,0
253.348,17,4,240,2,32,253347,32,120,2,32,253347,32,120
9.421,6,82,24501,42,550,229,1152,18760,40,459,235,1179,5741
0.999,6,53,13909,25,551,41,1429,4880,28,438,36,1460,9029
6.176,6,14,2355,7,188,1029,245,660,7,1407,986,1407,1695
1744.682,2,29,928,29,8,62310,8,928,0,0,0,0,0
46.009,6,27,7177,13,155,3834,267,1306,14,530,3538,3417,5871
0.999,17,4,624,2,64,978,64,184,2,192,524,192,440
65.183,6,50,14061,22,459,116,1189,6864,28,357,2413,1917,7197
1.681,17,2,194,1,61,0,61,89,1,77,0,77,105
1789.634,17,142,11360,71,48,25566,48,5396,71,56,25566,56,5964
1786.732,6,104,8444,68,66,26667,66,4964,36,60,51039,60,3480
1.737,6,13,2311,8,188,248,245,700,5,1407,365,1407,1611
7.725,6,1777,1664011,1138,1385,6,1408,1626119,639,776,11,1408,37892
12.829,6,80,24421,40,550,328,1152,18680,40,459,322,1179,5741
3.118,17,3,228,2,48,3049,48,152,1,48,0,48,76
1789.955,6,369,23454,212,69,8483,69,12965,157,69,11474,69,10489
2.026,6,38,9761,18,320,119,1162,2700,20,480,96,1440,7061
1787.353,6,421,36876,224,113,8015,1189,18158,197,125,9117,1917,18718
9.957,6,86,24997,44,544,231,1152,19176,42,413,236,1152,5821
1780.658,6,269,32469,110,130,16335,1360,15402,159,135,11269,3302,17067
280.222,6,28,7352,12,158,25474,267,1277,16,603,18679,1400,6075
6.298,17,4,1344,4,308,2099,308,1344,0,0,0,0,0
1791.096,1,58,4872,58,56,31422,56,4872,0,0,0,0,0
118.401,6,22,8961,11,514,80,1236,2014,11,927,11822,1460,6947
88.203,17,22,1936,11,48,8819,48,836,11,72,8819,72,1100
1.123,17,8,1360,4,33,360,33,244,4,251,371,323,1116
1782.212,6,104,8444,68,66,26600,66,4964,36,60,50917,60,3480
10.999,6,20,4402,11,275,1099,275,998,9,758,777,1420,3404
1787.761,6,275,33106,114,132,15819,1360,15726,161,134,11172,2720,17380
31.657,6,7,396,1,0,0,0,60,6,0,6294,0,336
0.607,17,6,2069,6,316,121,354,2069,0,0,0,0,0
11.457,6,1794,1580798,1095,1390,10,1420,1548617,699,467,16,1883,32181
0.004,17,4,352,2,60,2,60,176,2,60,3,60,176
1793.265,17,144,11520,72,48,25257,48,5472,72,56,25257,56,6048
1798.43,1,192,20352,192,78,9415,78,20352,0,0,0,0,0
299.742,1,4,224,4,28,99914,28,224,0,0,0,0,0
37.369,17,22,1936,11,48,3736,48,836,11,72,3735,72,1100
9.847,6,31,6579,14,338,757,1314,2254,17,303,613,1460,4325
181.254,17,4,1284,2,300,155720,300,656,2,286,67718,286,628
69.651,6,15,2236,9,324,8706,584,1124,6,396,13904,580,1112
1750.609,17,12,498,11,14,175060,14,462,1,8,0,8,36
1739.844,6,87,6322,58,31,30523,31,3915,29,31,62136,31,2407
0.533,17,3,451,2,39,363,39,134,1,289,0,289,317
1.47,2,3,96,3,8,735,8,96,0,0,0,0,0
1740.337,6,87,6322,58,31,30532,31,3915,29,31,62152,31,2407
1505.98,1,26,1456,26,28,60239,28,1456,0,0,0,0,0
262.384,17,8,480,4,32,87460,32,240,4,32,87461,32,240
300.204,6,44,9936,23,547,13639,1360,4249,21,371,15001,1360,5687
2.93,6,11,467,6,0,586,0,248,5,7,689,7,219
60.14,2,2,64,2,8,60140,8,64,0,0,0,0,0
43.795,17,8,1648,4,48,14595,48,304,4,308,14594,308,1344
1791.607,1,162,9072,162,28,11127,28,9072,0,0,0,0,0
20.161,6,21,5418,12,107,1832,159,1074,9,967,2516,1669,4344
280.261,6,28,7352,13,158,23355,267,1317,15,678,20014,4200,6035
151.322,17,4,352,2,60,151321,60,176,2,60,151321,60,176
3.997,17,4,244,4,33,1332,33,244,0,0,0,0,0
47.309,6,43,8725,21,345,560,720,1967,22,391,2246,3488,6758
1796.0,17,449,39928,404,35,4456,288,25708,45,288,40020,288,14220
1.201,6,34,12255,18,525,70,1360,3402,16,745,67,1360,8853
15.874,17,20,2940,10,48,1762,48,760,10,190,1762,308,2180
9.985,6,14,2243,8,210,1425,210,844,6,545,1991,905,1399
0.368,6,12,1304,6,256,70,256,756,6,304,70,304,548
1743.196,6,96,7286,63,38,28116,205,4476,33,33,54463,98,2810
0.325,17,2,152,1,48,0,48,76,1,48,0,48,76
1776.635,17,73,3060,72,14,25023,14,3024,1,8,0,8,36
1773.654,6,180,15480,120,69,14904,69,8940,60,69,30054,69,6540
0.014,17,2,357,1,34,0,34,62,1,267,0,267,295
1626.816,17,23,7024,23,277,73946,696,7024,0,0,0,0,0
366.797,6,27,1767,18,177,21576,177,1181,9,110,8789,110,586
0.065,6,119,127198,32,127,2,303,2045,87,1436,0,2804,125153
1767.702,6,130,7920,70,26,25618,26,4234,60,26,29960,26,3686
1790.48,6,361,24297,209,83,8608,965,13465,152,74,11854,405,10832
1789.959,6,364,25392,212,100,8483,469,14896,152,69,11854,69,10496
48.552,6,2745,2481318,1785,1311,27,1368,2423982,960,776,50,2736,57336
1792.234,1,58,4872,58,56,31442,56,4872,0,0,0,0,0
0.121,17,2,672,2,308,121,308,672,0,0,0,0,0
1798.153,17,142,11360,71,48,25686,48,5396,71,56,25686,56,5964
659.518,6,97,12257,50,82,13456,721,4485,47,245,14333,1420,7772
1798.498,17,448,39896,403,35,4473,288,25676,45,288,40018,288,14220
1.197,17,4,360,2,30,1160,30,116,2,94,1132,94,244
1787.378,17,87,3648,86,14,21027,14,3612,1,8,0,8,36
1791.089,6,401,24867,223,69,8067,69,13198,178,52,10118,69,11669
0.537,17,2,144,1,36,0,36,64,1,52,0,52,80
134.014,6,44,6441,23,149,6091,722,2683,21,204,6690,1408,3758
5.085,6,39,7285,20,218,267,314,3423,19,516,267,1179,3862
913.205,1,10,560,10,28,101467,28,560,0,0,0,0,0
213.527,6,61,9434,28,102,7908,267,2458,33,332,6672,1460,6976
2.686,17,18,7290,9,502,335,1350,4772,9,251,328,1350,2518
1775.293,6,181,15589,121,69,14794,69,9049,60,69,30085,69,6540
0.077,17,4,588,2,48,72,48,152,2,190,70,308,436
1787.119,6,105,8475,68,65,26673,65,4930,37,59,49638,59,3545
1786.591,6,102,8364,68,66,26665,66,4964,34,60,54136,60,3400
1720.679,17,13,534,11,14,172049,14,462,2,8,1720493,8,72
1791.675,6,361,22858,210,69,8572,69,12678,151,69,11942,69,10180
240.274,6,54,18280,29,765,8580,1418,15296,25,209,10010,580,2984
5.745,6,11,467,5,0,1436,0,208,6,7,553,7,259
23.98,17,4,304,2,48,23955,48,152,2,48,23960,48,152
1773.399,17,140,11200,70,48,25701,48,5320,70,56,25701,56,5880
0.018,17,2,152,1,48,0,48,76,1,48,0,48,76
1769.949,1,60,6360,60,78,29999,78,6360,0,0,0,0,0
0.018,1,2,652,2,298,18,306,652,0,0,0,0,0
1787.322,6,108,8468,68,64,26676,64,4896,40,58,45826,58,3572
4.636,17,21,7414,9,399,579,1350,3850,12,269,348,1350,3564
388.322,17,11,3886,11,325,38832,548,3886,0,0,0,0,0
1776.93,1,110,6160,110,28,16302,28,6160,0,0,0,0,0
317.836,6,82,21481,40,382,8149,1360,11216,42,342,7746,1929,10265
1.378,6,41,8443,21,321,68,1164,2822,20,400,63,1360,5621
1.016,6,55,13906,27,533,39,1301,4868,28,439,36,1986,9038
8.083,6,72,22246,37,556,224,1152,17078,35,470,230,1179,5168
282.148,6,32,7516,14,158,21703,267,1357,18,543,16590,1400,6159
1736.625,17,158,28153,158,150,11061,422,28153,0,0,0,0,0
0.014,6,9,1878,5,666,3,666,934,4,728,4,728,944
6.671,6,47,8489,23,227,303,314,4102,24,427,276,1152,4387
370.485,6,312,140115,154,900,2421,1440,113331,158,392,2355,1698,26784
311.542,6,87,61760,30,142,10742,517,2989,57,1360,5563,4254,58771
1777.466,17,73,3060,72,14,25034,14,3024,1,8,0,8,36
1799.125,1,59,4956,59,56,31019,56,4956,0,0,0,0,0
1.76,6,29,7088,14,154,135,267,1644,15,806,115,1460,5444
280.448,6,30,7432,13,158,23370,267,1317,17,678,17523,3456,6115
0.513,17,3,543,2,39,301,39,134,1,381,0,381,409
1696.072,17,16,1265,8,30,242291,37,471,8,71,242290,136,794
1796.198,17,448,39896,403,35,4468,288,25676,45,288,40018,288,14220
1798.075,1,91,5096,91,28,19978,28,5096,0,0,0,0,0
1778.167,17,142,11360,71,48,25401,48,5396,71,56,25401,56,5964
18.71,6,2167,2007359,1342,1414,13,1448,1957899,825,776,22,1448,49460
1737.121,1,56,4704,0,0,0,0,0,56,56,31584,56,4704
4.058,17,8,1176,4,48,1348,48,304,4,190,1348,308,872
1780.913,6,354,22440,207,69,8645,69,12420,147,69,12197,69,10020
1783.261,17,83,3480,82,14,22015,14,3444,1,8,0,8,36
8.64,6,77,22866,38,539,233,1152,17181,39,457,220,1179,5685
4.411,17,4,240,2,32,4410,32,120,2,32,4410,32,120
0.163,6,28,7336,14,155,12,267,1341,14,543,11,1400,5995
3.621,6,26,9338,13,422,285,1205,2374,13,1046,284,2491,6964
1770.702,1,58,4872,58,56,31064,56,4872,0,0,0,0,0
1786.561,6,104,8504,69,66,26272,66,5004,35,60,52543,60,3500
5.383,17,3,208,2,36,5005,36,128,1,52,0,52,80
1.028,17,4,716,2,32,1016,32,120,2,270,7,294,596
4.289,6,39,7285,19,218,238,314,3383,20,516,212,1179,3902
83.961,6,806,396191,444,825,189,1152,376920,362,398,231,1152,19271
481.27,2,5,160,5,8,120317,8,160,0,0,0,0,0
220.006,6,125,91036,76,1273,2933,1448,80374,49,675,2465,1448,10662
1.628,6,34,13557,19,254,90,658,1857,15,1008,93,1460,11700
1786.671,6,106,8456,68,65,26666,65,4930,38,59,48284,59,3526
2.521,6,54,19154,30,911,86,1460,13122,24,361,94,1460,6032
1.456,6,24,8004,13,164,104,267,1340,11,1014,123,2491,6664
0.27,6,24,6064,12,181,24,537,1526,12,781,23,2224,4538
11.421,17,8,2688,8,308,1631,308,2688,0,0,0,0,0
62.256,17,7,1573,7,196,10376,207,1573,0,0,0,0,0
1794.078,1,98,5488,98,28,18495,28,5488,0,0,0,0,0
21.093,6,24,6232,14,117,1622,159,1337,10,727,2341,1418,4895
1775.83,1,59,4956,59,56,30617,56,4956,0,0,0,0,0
59.857,6,22,5472,8,152,955,267,782,14,412,4584,1179,4690
0.324,6,27,9124,13,271,27,726,1783,14,943,24,1408,7341
0.051,17,2,136,1,32,0,32,60,1,48,0,48,76
36.12,17,20,1760,10,48,4012,48,760,10,72,4012,72,1000
3.701,17,5,738,4,32,1128,32,240,1,470,0,470,498
171.317,6,25,4925,15,295,12236,594,2254,10,357,19033,1328,2671
1741.167,6,87,6322,58,31,30546,31,3915,29,31,62184,31,2407
8.712,6,21,9342,11,275,871,275,723,10,1367,846,2840,8619
898.432,2,14,448,14,8,69110,8,448,0,0,0,0,0
35.278,17,44,6468,22,48,1676,48,1672,22,190,1677,308,4796
52.11,6,44,8945,20,401,588,889,2108,24,345,2259,1360,6837
3.827,17,5,290,5,30,956,30,290,0,0,0,0,0
0.229,6,47,23099,27,1131,8,1432,18078,20,420,11,1432,5021
1786.496,6,102,8364,68,66,26664,66,4964,34,60,54133,60,3400
0.083,2,2,64,2,8,83,8,64,0,0,0,0,0
180.138,17,4,352,2,60,180137,60,176,2,60,180137,60,176
1794.14,17,144,11520,72,48,25269,48,5472,72,56,25269,56,6048
1795.633,17,448,39896,403,35,4466,288,25676,45,288,40020,288,14220
160.711,2,9,288,9,8,20088,8,288,0,0,0,0,0
1781.451,6,358,22807,207,69,8604,69,12489,151,69,11876,69,10318
1740.986,6,91,6604,59,31,30017,31,3998,32,31,56160,31,2606
285.169,6,31,7541,13,158,23764,267,1317,18,550,16769,2076,6224
6.952,6,23,4478,12,213,632,597,1689,11,441,677,1408,2789
1795.484,17,142,11360,71,48,25649,48,5396,71,56,25649,56,5964
1280.817,17,1354,102745,744,40,1723,41,51081,610,56,2103,57,51664
280.369,6,29,7392,13,158,23364,267,1317,16,603,18687,2036,6075
68.575,6,71,11418,34,304,2078,304,7564,37,83,1904,83,3854
5.197,6,34,8096,18,317,305,636,1703,16,521,334,3488,6393
1772.088,6,181,15589,120,69,14891,69,8940,61,69,29534,69,6649
0.14,17,4,336,2,34,0,34,124,2,78,93,84,212
0.737,17,15,8404,8,705,105,1350,5869,7,334,113,1350,2535
78.473,17,6,528,3,60,39235,60,264,3,60,39236,60,264
1772.002,6,180,15480,120,69,14890,69,8940,60,69,30032,69,6540
1638.127,2,13,416,13,8,136510,8,416,0,0,0,0,0
59.34,6,7,10500,7,1448,9890,1448,10500,0,0,0,0,0
0.999,17,4,368,2,64,998,64,184,2,64,998,64,184
0.701,17,14,7347,7,665,116,1350,4854,7,328,107,1350,2493
3.003,6,14,2351,8,188,429,245,700,6,1407,552,1407,1651
1783.815,6,438,28490,218,99,8220,469,15274,220,34,8145,64,13216
0.261,1,2,112,2,28,261,28,112,0,0,0,0,0
1787.561,6,102,8296,68,65,26680,65,4930,34,59,54164,59,3366
1.248,6,10,1687,7,100,208,100,384,3,1179,492,1179,1303
216.617,6,28,7352,13,158,18051,267,1317,15,678,15471,3436,6035
1795.242,17,447,39864,402,35,4476,288,25644,45,288,40021,288,14220
1799.165,6,3738,3781697,1454,128,1238,353,90846,2284,1615,788,5608,3690851
7.985,6,80,24970,42,568,194,1152,19309,38,459,209,1179,5661
2.109,6,3,172,2,0,2109,0,120,1,0,0,0,52
1680.599,1,15,840,15,28,120042,28,840,0,0,0,0,0
1772.887,6,180,15480,120,69,14898,69,8940,60,69,30048,69,6540
240.426,6,55,24490,25,548,10017,1418,6246,30,980,8290,1418,18244
280.526,6,30,7432,13,158,23377,267,1317,17,543,17527,1400,6115
1791.544,6,5110,4843008,1816,121,987,324,110586,3294,1416,544,2836,4732422
191.83,1,4,224,4,28,63943,28,224,0,0,0,0,0
6.369,6,19,6510,9,275,796,275,639,10,910,510,2760,5871
1797.435,17,449,39928,404,35,4460,288,25708,45,288,40015,288,14220
1.488,6,39,11097,21,591,74,1360,5601,18,433,76,1360,5496
1795.545,17,140,11200,70,48,26022,48,5320,70,56,26022,56,5880
1796.422,17,449,39928,404,35,4457,288,25708,45,288,40018,288,14220
0.008,17,8,2454,8,278,1,317,2454,0,0,0,0,0
1794.928,6,363,23508,212,76,8506,501,13121,151,69,11966,69,10387
132.106,6,50,10265,20,263,3437,1189,2919,30,323,4554,1460,7346
1783.349,17,84,3516,82,14,22014,14,3444,2,8,1783155,8,72
6.773,17,32,7679,10,230,752,1350,2582,22,203,321,1350,5097
1787.356,6,104,8504,69,66,26284,66,5004,35,60,52566,60,3500
15.786,17,14,7753,7,746,2597,1350,5420,7,305,2590,1350,2333
1682.244,17,14,1036,7,30,280366,30,406,7,62,280366,62,630
5.01,17,4,558,2,36,5004,36,128,2,187,5006,187,430
1764.888,2,14,448,14,8,135760,8,448,0,0,0,0,0
280.297,6,31,7472,14,158,21561,267,1357,17,543,17514,1400,6115
1640.201,1,7,392,7,28,273366,28,392,0,0,0,0,0
0.858,6,20,5966,11,287,85,562,1306,9,716,96,1420,4660
6.548,2,2,64,2,8,6548,8,64,0,0,0,0,0
1.278,6,38,8254,19,321,71,1164,2718,19,433,61,1460,5536
1658.239,1,7,392,7,28,276373,28,392,0,0,0,0,0
240.662,2,3,96,3,8,120331,8,96,0,0,0,0,0
0.563,6,22,7342,12,335,50,668,1974,10,1210,61,1906,5368
0.508,6,10,767,5,186,124,186,454,5,45,97,45,313
0.05,17,4,420,2,33,0,33,122,2,121,1,145,298
1796.429,6,357,22629,209,69,8636,69,12569,148,69,12220,69,10060
1785.858,6,365,25570,211,100,8504,469,14856,154,69,11672,69,10714
1661.851,1,7,392,7,28,276975,28,392,0,0,0,0,0
2.45,6,3,555,1,304,0,304,356,2,83,2450,83,199
1.562,6,13,2311,8,188,223,245,700,5,1407,326,1407,1611
80.518,6,10,520,0,0,0,0,0,10,0,0,0,520
1771.903,6,182,15629,121,69,14765,69,8980,61,69,29530,69,6649
1793.706,6,356,22520,208,69,8665,69,12460,148,69,12201,69,10060
0.067,17,2,382,1,37,0,37,65,1,289,0,289,317
35.634,1,8,448,8,28,5090,28,448,0,0,0,0,0
20.676,17,51,22130,24,547,897,1350,13807,27,280,794,1350,8323
0.204,17,2,1920,2,932,204,932,1920,0,0,0,0,0
238.0,17,2,386,2,165,238000,165,386,0,0,0,0,0
0.187,17,2,778,2,361,187,361,778,0,0,0,0,0
1734.374,17,144,23472,144,135,12128,392,23472,0,0,0,0,0
125.153,2,2,64,2,8,125153,8,64,0,0,0,0,0
1754.676,1,84,7056,84,56,21140,56,7056,0,0,0,0,0
1791.77,6,367,23305,211,69,8532,69,12925,156,69,11559,69,10380
1.579,6,49,19118,27,882,60,1360,13462,22,433,65,1360,5656
1.64,17,2,519,1,40,0,40,68,1,423,0,423,451
63.536,6,47,13988,23,1012,605,1360,8102,24,307,2754,1360,5886
0.014,6,4,220,2,0,14,0,104,2,0,12,0,116
31.89,6,9,388,3,0,15945,0,124,6,0,6295,0,264
1784.159,6,104,8444,68,66,26629,66,4964,36,60,50973,60,3480
0.972,6,26,9593,14,290,74,802,1753,12,1469,71,3930,7840
3.995,17,3,264,3,60,1997,60,264,0,0,0,0,0
0.065,17,2,323,1,69,0,69,97,1,198,0,198,226
0.29,6,26,8890,13,232,24,569,1614,13,1098,23,2804,7276
1775.15,6,180,15480,120,69,14917,69,8940,60,69,30085,69,6540
1789.635,6,357,22629,208,69,8645,69,12460,149,69,12090,69,10169
88.787,6,21,8102,11,510,88,1223,2002,10,948,9844,1631,6100
13.812,6,27,4866,13,154,1131,722,1767,14,394,1047,1408,3099
1736.857,1,72,6048,0,0,0,0,0,72,56,24462,56,6048
1301.07,6,19,1163,12,31,118279,31,666,7,31,216841,31,497
2.999,1,3,168,3,28,1499,28,168,0,0,0,0,0
373.871,6,19,1303,14,177,28759,177,925,5,110,18523,110,378
1799.809,17,142,11360,71,48,25711,48,5396,71,56,25711,56,5964
2.949,6,14,1435,7,283,462,283,938,7,105,462,105,497
61.989,6,77,53661,48,1192,1318,1408,45419,29,960,2205,3847,8242
547.716,1,3,168,3,28,273858,28,168,0,0,0,0,0
395.491,1,20,1120,20,28,20815,28,1120,0,0,0,0,0
0.061,6,11,3653,6,171,10,171,491,5,1447,12,2676,3162
640.189,1,7,896,7,100,106698,320,896,0,0,0,0,0
0.163,1,6,624,0,0,0,0,0,6,76,32,76,624
0.712,17,4,1116,2,32,707,32,120,2,470,708,470,996
1.366,6,10,1687,7,100,227,100,384,3,1179,550,1179,1303
0.313,6,25,8816,13,227,26,547,1592,12,1098,28,2816,7224
1799.219,17,142,11360,71,48,25702,48,5396,71,56,25702,56,5964
6.159,6,19,9250,10,275,684,275,679,9,1172,733,2840,8571
31.427,6,7,336,1,0,0,0,48,6,0,6272,0,288
9.942,6,16,3911,9,275,1242,275,643,7,992,833,1440,3268
1.448,6,49,19798,27,930,55,1460,14142,22,476,60,2615,5656
1787.268,6,121,15375,77,113,23516,1257,7299,44,166,41561,2642,8076
262.909,6,192,53828,98,555,2710,1360,38615,94,259,2825,1938,15213
280.233,6,28,7352,12,158,25475,267,1277,16,543,18680,1400,6075
5.237,6,16,3252,6,92,1047,92,400,10,387,551,1448,2852
1772.311,6,180,15480,120,69,14893,69,8940,60,69,30031,69,6540
0.343,6,21,6671,12,189,31,409,1391,9,960,41,1408,5280
0.06,17,2,158,1,34,0,34,62,1,68,0,68,96
1770.33,6,104,9648,68,65,26422,65,5758,36,59,50577,59,3890
18.45,6,2963,2848883,1969,1371,9,1408,2792531,994,776,18,1408,56352
1769.466,6,101,9344,66,65,27222,65,5577,35,59,52039,59,3767
14.096,6,26,4775,12,204,1281,722,1643,14,300,1069,1408,3132
174.794,17,6,3742,6,595,34958,893,3742,0,0,0,0,0
1796.471,17,447,39580,403,35,4468,288,25676,44,288,40948,288,13904
976.623,6,2409,2269281,851,175,1148,937,51927,1558,1408,627,2836,2217354
7.682,6,14,2242,8,210,1092,210,844,6,545,1533,904,1398
1788.875,17,87,3648,86,14,21045,14,3612,1,8,0,8,36
1.286,6,50,19389,27,898,49,1360,13693,23,433,49,1360,5696
1.176,6,55,23236,30,985,40,1380,17982,25,421,47,1923,5254
1785.857,6,360,24156,210,88,8544,469,13878,150,69,11985,69,10278
345.138,17,8,1904,8,210,49305,371,1904,0,0,0,0,0
61.479,6,36,15882,22,800,2927,1440,9156,14,748,4708,2375,6726
1765.267,6,90,6521,59,31,30435,31,3998,31,31,58771,31,2523
0.135,17,2,196,1,62,0,62,90,1,78,0,78,106
1590.011,1,8,448,8,28,227144,28,448,0,0,0,0,0
1.408,6,50,18884,27,862,54,1360,13188,23,433,55,1360,5696
0.277,6,2,113,1,21,0,21,73,1,0,0,0,40
142.577,17,9,684,9,48,17822,48,684,0,0,0,0,0
1775.957,17,142,11360,71,48,25370,48,5396,71,56,25370,56,5964
1791.171,6,241,46492,150,483,12020,483,36780,91,83,19901,83,9712
78.596,17,4,352,2,60,78595,60,176,2,60,78595,60,176
1782.861,17,142,11360,71,48,25469,48,5396,71,56,25469,56,5964
18.539,17,16,6280,8,470,2643,1350,3985,8,258,2643,1350,2295
44.607,17,22,14845,12,558,4055,1350,7039,10,752,1728,1350,7806
245.769,6,536,421410,299,730,824,1408,34648,237,1817,1041,8448,386762
16.489,6,29,5000,14,180,1268,722,1818,15,342,1149,1448,3182
5.081,6,44,8369,21,227,254,314,4022,23,427,219,1152,4347
12.56,6,9,588,4,106,4186,106,274,5,90,3099,90,314
1771.77,6,103,9448,66,65,27258,65,5577,37,59,49213,59,3871
1795.653,1,222,23532,222,78,8125,78,23532,0,0,0,0,0
1421.794,17,140,11663,130,30,11021,37,7575,10,380,151344,463,4088
1773.599,6,183,15738,121,69,14779,69,8980,62,69,29069,69,6758
1744.678,2,19,608,19,8,96926,8,608,0,0,0,0,0
1680.616,1,15,870,15,30,120044,30,870,0,0,0,0,0
280.402,6,28,7352,13,158,23366,267,1317,15,678,20026,2800,6035
15.798,17,17,8968,8,472,2252,1350,4007,9,523,1970,1350,4961
35.365,17,6,528,3,48,17562,48,228,3,72,17551,72,300
1785.219,17,87,3648,86,14,21002,14,3612,1,8,0,8,36
33.752,6,32,5343,15,154,2410,722,1859,17,324,2097,1402,3484
11.407,6,2083,1955235,1344,1376,8,1408,1912143,739,931,15,2816,43092
1684.337,17,28,5005,20,34,88648,37,1251,8,441,240617,463,3754
1684.057,1,27,3316,27,94,64771,176,3316,0,0,0,0,0
1781.925,6,104,8376,68,65,26595,65,4930,36,59,50909,59,3446
1779.923,1,342,28728,342,56,5219,56,28728,0,0,0,0,0
0.897,6,10,1687,7,100,149,100,384,3,1179,318,1179,1303
61.398,6,37,15936,22,800,2923,1448,9158,15,665,4364,1448,6778
20.151,6,22,6128,12,147,1831,318,1233,10,727,2238,1402,4895
183.195,1,6,636,6,78,36639,78,636,0,0,0,0,0
15.603,17,20,12220,11,884,1550,1350,10039,9,214,1938,1350,2181
1772.497,6,180,15480,120,69,14894,69,8940,60,69,30039,69,6540
7.033,17,6,528,3,48,3478,48,228,3,72,3478,72,300
11.988,17,4,824,2,48,11972,48,152,2,308,11968,308,672
0.007,17,2,199,1,32,0,32,60,1,111,0,111,139
1783.458,17,73,3060,72,14,25119,14,3024,1,8,0,8,36
2.1,17,3,174,3,30,1050,30,174,0,0,0,0,0
2.01,17,2,122,2,33,2010,33,122,0,0,0,0,0
1.883,17,24,7506,10,389,209,1350,4174,14,210,100,1350,3332
1792.127,17,179,46301,179,230,10068,364,46301,0,0,0,0,0
1793.559,6,407,71729,254,304,7089,304,52772,153,83,11799,83,18957
1.317,6,47,18873,26,937,52,1460,13257,21,433,57,1460,5616
80.338,1,4,224,4,28,26779,28,224,0,0,0,0,0
162.937,17,3,418,2,32,162937,32,120,1,270,0,270,298
345.966,6,15,1148,9,226,43245,226,702,6,110,12971,110,446
1714.205,1,8,448,8,28,244886,28,448,0,0,0,0,0
1.419,6,24,8004,12,164,110,267,1288,12,1014,107,2736,6716
0.419,6,12,1653,6,288,80,288,548,6,426,45,434,1105
36.063,1,42,4368,0,0,0,0,0,42,76,879,76,4368
1778.113,6,27,4077,18,241,104594,241,2889,9,92,222240,92,1188
11.984,6,3,120,1,0,0,0,40,2,0,1,0,80
2.032,6,30,10405,18,367,119,833,1825,12,1012,178,1420,8580
33.584,6,32,5145,15,154,2398,722,1859,17,299,2087,1448,3286
0.061,17,2,1152,1,548,0,548,576,1,548,0,548,576
61.815,6,30,7297,14,155,4755,267,1346,16,441,4120,1420,5951
1785.348,6,355,22549,207,69,8666,69,12420,148,69,12145,69,10129
383.758,6,18,1242,14,180,29519,180,916,4,110,20068,110,326
0.082,17,2,672,2,308,82,308,672,0,0,0,0,0
1796.151,6,389,27082,222,96,8127,469,15917,167,69,10819,69,11165
55.932,17,8,2688,8,308,7990,308,2688,0,0,0,0,0
1786.175,17,140,11200,70,48,25886,48,5320,70,56,25886,56,5880
1.086,6,23,6511,13,333,88,1005,2191,10,979,119,1691,4320
1783.542,17,83,3480,82,14,22019,14,3444,1,8,0,8,36
3.347,17,5,290,5,30,836,30,290,0,0,0,0,0
31.626,6,7,308,1,0,0,0,44,6,0,6307,0,264
17.157,6,2674,2531342,1699,1411,9,1448,2475978,975,776,17,1448,55364
323.594,6,41,7918,18,143,13358,516,1870,23,256,14704,1452,6048
137.206,17,4,240,2,32,137205,32,120,2,32,137204,32,120
2.335,6,13,2311,8,188,333,245,700,5,1407,517,1407,1611
1740.328,6,87,6322,58,31,30532,31,3915,29,31,62154,31,2407
0.113,17,2,273,1,35,0,35,63,1,182,0,182,210
0.767,17,2,778,2,361,767,361,778,0,0,0,0,0
1796.996,6,361,22996,211,69,8557,69,12649,150,69,12060,69,10347
71.464,6,13,1079,12,43,6496,43,1019,1,0,0,0,60
1798.498,6,367,25650,214,99,8443,469,15045,153,69,11831,69,10605
16.483,6,24,6674,10,133,1831,267,941,14,573,1254,1420,5733
6.731,6,27,4096,12,256,610,256,2276,15,304,480,304,1820
0.033,17,4,284,2,32,15,32,120,2,54,19,60,164
1.168,6,22,7900,12,164,90,267,1288,10,1521,110,5227,6612
0.501,17,8,2758,8,316,71,355,2758,0,0,0,0,0
0.427,6,6,324,4,0,142,0,216,2,0,210,0,108
280.214,6,27,7312,13,158,23351,267,1317,14,775,21549,3445,5995
1.936,6,12,1304,6,256,385,256,756,6,304,385,304,548
0.042,17,8,2758,8,316,6,355,2758,0,0,0,0,0
0.275,17,4,368,2,32,19,32,120,2,96,40,96,248
0.39,17,2,144,1,36,0,36,64,1,52,0,52,80
2.343,6,13,2311,8,188,334,245,700,5,1407,515,1407,1611
6.94,6,66,20206,33,565,216,1152,15459,33,489,209,1179,4747
2.277,6,18,1855,10,222,247,222,1296,8,231,320,231,559
0.448,6,13,1693,7,288,70,288,588,6,426,50,434,1105
1684.429,2,27,864,27,8,64785,8,864,0,0,0,0,0
0.044,6,4,239,2,0,42,0,104,2,31,0,31,135
1791.876,6,369,24776,213,81,8452,501,13720,156,75,11559,469,11056
15.569,17,147,68925,78,639,202,1350,52076,69,216,227,1350,16849
1790.712,1,268,15008,268,28,6706,28,15008,0,0,0,0,0
89.482,6,44,9812,18,290,2723,1189,2764,26,352,3578,1420,7048
152.104,6,25,11358,12,433,98,990,1823,13,1000,12663,1360,9535
0.377,6,10,968,5,256,91,256,460,5,304,91,304,508
20.571,17,24,8204,10,446,2285,1350,4748,14,218,1562,1350,3456
4.686,6,40,7309,20,218,246,314,3423,20,513,231,1179,3886
0.263,6,27,6202,13,181,21,537,1578,14,555,19,1542,4624
25.975,6,44,13637,21,299,1298,721,3241,23,728,1171,1440,10396
1.138,17,6,552,3,32,562,32,180,3,96,561,96,372
2.021,17,2,677,1,300,0,300,328,1,321,0,321,349
493.367,6,77,11892,45,304,11212,304,8204,32,83,15878,83,3688
1786.939,6,106,8524,68,66,26670,66,4964,38,60,48293,60,3560
0.009,17,2,180,1,30,0,30,58,1,94,0,94,122
4.274,17,5,290,5,30,1068,30,290,0,0,0,0,0
1745.523,6,95,7203,63,38,28153,205,4476,32,33,56301,98,2727
1793.621,6,357,22698,207,69,8706,69,12420,150,69,12037,69,10278
1790.702,1,280,15680,280,28,6418,28,15680,0,0,0,0,0
0.333,17,4,368,2,32,97,32,120,2,96,98,96,248
4.074,17,22,5808,10,293,448,1350,3218,12,187,367,1350,2590
0.04,17,2,198,1,37,0,37,65,1,105,0,105,133
1734.618,17,278,55239,278,170,6262,358,55239,0,0,0,0,0
1.507,6,50,20697,28,925,55,1440,15041,22,433,62,1440,5656
5.055,17,5,320,5,36,1263,36,320,0,0,0,0,0
0.495,6,27,7296,13,155,41,267,1301,14,603,36,1400,5995
1792.62,17,142,11360,71,48,25608,48,5396,71,56,25608,56,5964
19.155,6,3044,2926235,2028,1367,9,1408,2868739,1016,776,18,1408,57496
0.432,6,22,7255,12,318,38,600,1906,10,803,47,1408,5349
79.471,17,6,456,6,48,15894,48,456,0,0,0,0,0
1788.225,17,29,9512,29,300,63865,300,9512,0,0,0,0,0
1774.895,1,66,5544,66,56,27306,56,5544,0,0,0,0,0
0.369,6,20,7238,12,335,33,668,1974,8,1210,52,1906,5264
0.171,17,2,180,1,30,0,30,58,1,94,0,94,122
1.214,17,44,35016,18,407,71,1350,7847,26,1016,45,1350,27169
74.056,17,4,352,2,60,74055,60,176,2,60,74055,60,176
376.112,6,39,7417,23,132,17096,501,2115,16,358,25067,1420,5302
1795.174,17,87,3648,86,14,21119,14,3612,1,8,0,8,36
0.028,17,4,308,2,33,1,33,122,2,65,16,65,186
372.114,6,18,1696,14,509,28624,509,1089,4,435,64135,435,607
1787.105,17,87,3648,86,14,21024,14,3612,1,8,0,8,36
300.56,6,37,8570,21,308,15028,885,2176,16,574,562,4848,6394
1684.503,2,18,576,18,8,99088,8,576,0,0,0,0,0
7.809,6,1250,1081147,752,1389,10,1420,1057006,498,467,15,1883,24141
240.165,6,55,18516,30,782,8281,1402,15660,25,193,10006,580,2856
272.639,6,16,2035,16,109,18175,162,2035,0,0,0,0,0
44.274,17,12,4032,12,308,4024,308,4032,0,0,0,0,0
0.075,17,6,462,3,33,0,33,183,3,65,0,65,279
1787.952,6,356,22520,208,69,8637,69,12460,148,69,12162,69,10060
0.049,17,2,912,1,308,0,308,336,1,548,0,548,576
20.255,6,20,5366,12,107,1841,159,1074,8,967,2892,1659,4292
300.687,6,38,8580,20,318,15825,928,2107,18,441,500,1360,6473
9.944,6,19,3696,6,92,1988,92,400,13,370,811,1408,3296
0.016,17,4,308,2,33,1,33,122,2,65,1,65,186
0.025,17,4,825,2,37,13,37,130,2,319,13,331,695
296.536,1,4,326,4,53,98845,78,326,0,0,0,0,0
1009.119,17,46,7116,23,48,45868,48,1748,23,205,45868,308,5368
1.516,17,2,784,2,364,1516,364,784,0,0,0,0,0
1795.313,17,140,11200,70,48,26018,48,5320,70,56,26018,56,5880
1.976,17,22,5698,22,231,94,388,5698,0,0,0,0,0
1773.147,17,140,11200,70,48,25697,48,5320,70,56,25697,56,5880
1787.568,6,102,8296,68,65,26680,65,4930,34,59,54164,59,3366
1740.305,17,28,18844,28,645,64455,645,18844,0,0,0,0,0
1638.581,2,14,448,14,8,126044,8,448,0,0,0,0,0
317.034,6,66,18664,38,325,8568,1360,9701,28,559,11736,4649,8963
60.614,6,11,851,11,31,6061,31,851,0,0,0,0,0
1.571,17,6,1425,3,40,775,40,204,3,379,775,379,1221
296.147,6,52,8248,27,129,11388,517,2345,25,417,12337,1418,5903
1.095,17,23,11895,11,725,109,1350,8293,12,272,69,1350,3602
1770.38,17,304,59100,304,166,5842,422,59100,0,0,0,0,0
1794.153,6,206,18345,104,121,17418,208,13180,102,31,17760,31,5165
1764.962,1,58,4872,58,56,30964,56,4872,0,0,0,0,0
0.719,17,22,6466,9,331,86,1350,3235,13,220,57,1350,3231
23.237,6,33,8178,16,175,1549,721,2045,17,778,1441,2840,6133
164.237,17,4,352,2,60,164236,60,176,2,60,164236,60,176
1787.728,17,87,3648,86,14,21032,14,3612,1,8,0,8,36
9.083,6,16,3911,9,275,1135,275,643,7,992,706,1440,3268
0.023,17,3,244,2,32,15,32,120,1,96,0,96,124
13.446,6,95,28943,47,563,292,1152,22152,48,442,280,1179,6791
1638.385,2,9,288,9,8,204798,8,288,0,0,0,0,0
11.835,6,10892,10313172,5153,256,2,256,279176,5739,1699,2,29568,10033996
280.464,6,30,7432,13,158,23372,267,1317,17,543,17526,1400,6115
1.349,6,7,376,4,0,449,0,216,3,0,386,0,160
0.499,17,2,180,1,30,0,30,58,1,94,0,94,122
9.064,2,2,64,2,8,9064,8,64,0,0,0,0,0
10.774,6,19,4362,11,275,1077,275,998,8,1010,855,2840,3364
1791.242,2,24,768,24,8,77880,8,768,0,0,0,0,0
1743.5,1,63,5292,63,56,28120,56,5292,0,0,0,0,0
1.974,17,4,314,2,31,1032,31,118,2,70,0,70,196
0.06,17,2,251,1,36,0,36,64,1,159,0,159,187
23.383,6,29,7392,13,158,1948,267,1317,16,603,1553,2800,6075
1796.732,17,449,39928,404,35,4458,288,25708,45,288,40021,288,14220
15.507,17,5,380,5,48,3876,48,380,0,0,0,0,0
1741.504,2,27,864,27,8,66980,8,864,0,0,0,0,0
1799.85,17,431,38784,387,36,4662,288,24880,44,288,40944,288,13904
17.955,6,4,1183,1,0,0,0,40,3,341,7390,341,1143
0.047,17,2,2386,2,1165,47,1165,2386,0,0,0,0,0
1694.556,17,16,1265,8,30,242074,37,471,8,71,242074,136,794
1.682,6,12,1163,6,222,334,222,688,6,231,335,231,475
10.775,6,20,7130,11,275,1077,275,998,9,1440,758,1440,6132
0.001,6,2,87,0,0,0,0,0,2,7,1,7,87
1777.586,1,68,5712,68,56,26531,56,5712,0,0,0,0,0
0.061,17,2,152,1,48,0,48,76,1,48,0,48,76
6.819,6,13,2311,7,125,1136,245,660,6,1407,1312,1407,1651
1688.085,17,14,1036,7,30,281342,30,406,7,62,281342,62,630
252.302,2,2,64,2,8,252302,8,64,0,0,0,0,0
1768.064,1,58,4872,58,56,31018,56,4872,0,0,0,0,0
1772.602,1,58,4872,58,56,31098,56,4872,0,0,0,0,0
1772.942,6,180,15480,120,69,14898,69,8940,60,69,30045,69,6540
1.34,6,38,8258,19,321,74,1168,2722,19,433,63,1360,5536
60.162,2,2,64,2,8,60162,8,64,0,0,0,0,0
121.932,6,20,8994,11,301,83,595,1376,9,1449,15223,3928,7618
28.557,6,26,5236,12,288,2596,722,2061,14,342,2182,1440,3175
121.422,6,26,13021,13,759,89,1360,3602,13,1269,10103,3639,9419
8.566,17,3,228,3,48,4283,48,228,0,0,0,0,0
1741.408,17,29,19517,29,645,62193,645,19517,0,0,0,0,0
21.278,17,2,642,1,300,0,300,328,1,286,0,286,314
13.017,17,4,352,2,48,12994,48,152,2,72,12999,72,200
3.959,6,39,7269,19,218,219,314,3383,20,513,195,1179,3886
1742.041,1,15,840,15,28,124431,28,840,0,0,0,0,0
1772.361,6,181,15589,120,69,14893,69,8940,61,69,29534,69,6649
134.447,17,4,352,2,60,134446,60,176,2,60,134446,60,176
1785.707,6,112,8956,71,66,25510,66,5216,41,60,44639,60,3740
1773.296,6,181,15589,120,69,14901,69,8940,61,69,29550,69,6649
45.63,6,27,7177,13,155,3802,267,1306,14,530,3509,3417,5871
1797.237,17,449,39928,404,35,4459,288,25708,45,288,40015,288,14220
1750.535,17,12,498,11,14,175053,14,462,1,8,0,8,36
9.276,6,14,2257,7,211,1545,211,806,7,545,1545,904,1451
0.483,6,10,861,5,222,119,222,426,5,231,119,231,435
1794.835,17,142,11360,71,48,25640,48,5396,71,56,25640,56,5964
244.221,1,32,3392,32,78,7878,78,3392,0,0,0,0,0
1186.694,6,239,24626,122,118,9450,469,10702,117,133,10229,1452,13924
1516.039,6,303,49412,135,327,11313,1360,28787,168,118,9077,4649,20625
55.622,17,6,764,3,48,27806,48,228,3,150,27806,308,536
10.006,6,14,1247,7,222,1666,222,728,7,231,1666,231,519
0.36,17,8,2758,8,316,51,355,2758,0,0,0,0,0
280.477,6,29,7392,14,158,21575,267,1357,15,678,20030,3456,6035
0.074,6,4,239,2,0,39,0,104,2,31,1,31,135
16.6,6,13,5577,4,106,5530,106,274,9,985,2073,1420,5303
1773.293,6,182,15629,121,69,14777,69,8980,61,69,29546,69,6649
1003.681,6,177,12248,72,46,14105,46,4874,105,46,9650,46,7374
0.639,6,27,17458,16,708,42,1360,4214,11,1827,49,4416,13244
381.065,6,18,1242,14,180,29312,180,916,4,110,20059,110,326
5.347,6,41,7349,20,218,281,314,3423,21,440,253,1152,3926
240.231,6,54,19202,29,824,8579,1408,16354,25,192,10009,580,2848
65.909,17,4,352,2,48,65899,48,152,2,72,65899,72,200
1787.332,6,102,8296,68,65,26676,65,4930,34,59,54157,59,3366
347.423,6,1360,1004010,762,1326,456,1360,968217,598,177,97,1360,35793
432.851,6,55,6986,28,109,16031,722,2802,27,154,16292,1448,4184
281.815,6,30,7432,13,158,23484,267,1317,17,543,17590,1400,6115
372.243,6,21,1419,15,177,26588,177,989,6,110,12252,110,430
1797.763,6,480,130156,230,561,7849,1460,101623,250,154,7219,1638,28533
19.089,17,6,456,6,48,3817,48,456,0,0,0,0,0
58.331,6,27,7177,13,155,4860,267,1306,14,530,4486,3417,5871
787.164,17,10,821,5,31,196783,37,297,5,76,196782,136,524
1.41,6,50,21611,28,986,52,1460,15955,22,433,58,1460,5656
1.354,6,51,19804,29,920,48,1360,14103,22,437,55,2715,5701
0.136,17,2,402,1,54,0,54,82,1,292,0,292,320
179.574,6,8002,7146528,5076,1325,35,1368,6979766,2926,1124,61,2736,166762
28.457,6,19,4237,10,296,3161,722,1441,9,464,3531,2026,2796
1782.142,6,357,22629,208,69,8609,69,12460,149,69,12041,69,10169
1772.769,6,180,15480,120,69,14897,69,8940,60,69,30039,69,6540
0.407,17,2,290,1,40,0,40,68,1,194,0,194,222
0.437,6,12,1653,6,288,82,288,548,6,426,46,434,1105
0.066,6,9,1339,5,145,16,145,349,4,826,12,826,990
4.286,6,34,6169,17,206,267,314,2744,17,548,249,1179,3425
316.55,6,10,560,5,112,79137,112,320,5,0,3837,0,240
33.789,6,31,5094,15,154,2413,722,1859,16,342,2239,1440,3235
20.082,6,23,5590,9,150,86,174,664,14,396,1537,1452,4926
1.463,6,4,192,4,0,0,0,192,0,0,0,0,0
1744.503,6,94,7151,62,38,28598,205,4424,32,33,56267,98,2727
902.444,2,9,288,9,8,112805,8,288,0,0,0,0,0
1786.766,6,105,8416,68,65,26668,65,4930,37,59,49629,59,3486
3.911,17,32,17031,17,608,244,1350,10818,15,386,166,1350,6213
1740.63,6,87,6322,58,31,30537,31,3915,29,31,62165,31,2407
28.781,17,4,240,2,32,28780,32,120,2,32,28780,32,120
1779.76,17,142,11360,71,48,25425,48,5396,71,56,25425,56,5964
12.272,6,31,4710,17,155,767,293,2396,14,437,922,1179,2314
1792.433,1,342,28728,342,56,5256,56,28728,0,0,0,0,0
2.31,2,2,64,2,8,2310,8,64,0,0,0,0,0
4.984,17,4,558,2,36,4979,36,128,2,187,4979,187,430
298.718,1,4,326,4,53,99572,78,326,0,0,0,0,0
0.747,17,2,144,1,36,0,36,64,1,52,0,52,80
224.12,6,30,8056,12,127,20370,267,1887,18,418,13182,1460,6169
1.75,2,3,96,3,8,875,8,96,0,0,0,0,0
27.673,6,38,9864,19,702,489,1440,4302,19,399,1527,1440,5562
11.008,17,8,704,4,48,3665,48,304,4,72,3665,72,400
0.104,17,4,368,2,32,69,32,120,2,96,70,96,248
1772.518,6,180,15480,120,69,14895,69,8940,60,69,30039,69,6540
0.353,17,2,198,1,39,0,39,67,1,103,0,103,131
9.193,17,40,14896,13,503,765,1350,6904,27,268,352,1350,7992
123.062,6,127,99339,81,1301,1538,1448,88787,46,679,1714,1448,10552
501.148,17,20,1520,20,48,26376,48,1520,0,0,0,0,0
1798.054,17,19,6276,19,302,99891,1438,6276,0,0,0,0,0
1786.655,6,105,8348,68,64,26666,64,4896,37,58,49626,58,3452
0.156,6,3,132,2,0,1,0,92,1,0,0,0,40
1.357,17,22,14786,11,726,135,1350,8301,11,561,110,1350,6485
0.889,6,11,1727,7,100,148,100,384,4,589,213,1152,1343
40.015,6,47,9152,22,419,750,944,2243,25,327,1661,1460,6909
0.571,6,3,156,2,0,571,0,100,1,0,0,0,56
0.296,17,4,524,2,39,285,39,134,2,167,281,167,390
1761.431,6,184,43544,122,483,14557,483,35332,62,83,28875,83,8212
3.049,17,4,240,2,32,3048,32,120,2,32,3048,32,120
1791.125,6,356,22520,208,69,8652,69,12460,148,69,12184,69,10060
102.342,17,9,2007,9,195,12792,207,2007,0,0,0,0,0
1.633,6,46,18486,27,845,62,1360,12950,19,476,79,2720,5536
15.859,17,28,22022,16,945,1052,1350,15578,12,509,1433,1350,6444
54.298,6,30,11492,15,719,3877,1448,4407,15,701,3877,1448,7085
0.632,6,10,861,5,222,156,222,426,5,231,156,231,435
5.019,17,4,288,2,36,5005,36,128,2,52,5003,52,160
1744.764,2,23,736,23,8,79307,8,736,0,0,0,0,0
4.039,17,7,7079,2,723,4039,1350,1503,5,1087,570,1350,5576
1788.049,17,288,61748,288,186,6230,422,61748,0,0,0,0,0
0.075,17,2,158,1,34,0,34,62,1,68,0,68,96
0.301,6,27,8922,13,232,25,567,1612,14,939,22,1408,7310
69.469,6,47,8959,22,345,1191,720,2019,25,312,2888,1360,6940
1795.293,6,356,22520,208,69,8672,69,12460,148,69,12212,69,10060
280.338,6,30,7432,13,158,23361,267,1317,17,543,17519,1400,6115
0.672,6,19,5064,11,226,48,226,1032,8,1198,89,1448,4032
0.515,6,26,8956,13,253,42,653,1698,13,1095,40,2736,7258
10.968,6,20,4350,11,275,1096,275,998,9,992,775,1440,3352
4.591,17,2,656,2,300,4591,300,656,0,0,0,0,0
25.916,17,4,240,2,32,25915,32,120,2,32,25915,32,120
1.489,6,258,196416,146,1355,10,1432,187564,112,389,12,1432,8852
280.367,6,29,7392,13,158,23363,267,1317,16,603,18689,2036,6075
1782.068,6,137,17049,82,196,22000,1258,11331,55,85,32960,248,5718
1790.179,1,67,5628,67,56,27123,56,5628,0,0,0,0,0
1740.733,17,26,6110,26,207,69629,207,6110,0,0,0,0,0
0.046,17,2,904,1,300,0,300,328,1,548,0,548,576
331.925,6,54,25944,23,241,15087,241,1510,31,748,11058,1610,24434
1796.674,1,59,4956,59,56,30977,56,4956,0,0,0,0,0
1797.057,17,448,39896,403,35,4470,288,25676,45,288,40016,288,14220
71.188,6,25,10829,12,380,73,832,1665,13,959,5920,1440,9164
1772.716,6,181,15589,120,69,14896,69,8940,61,69,29537,69,6649
2.459,17,10,3616,10,333,273,361,3616,0,0,0,0,0
0.429,6,50,22628,28,1088,15,1380,17506,22,421,19,1923,5122
1792.097,6,363,23145,209,69,8615,69,12569,154,69,11712,69,10576
102.322,17,6,528,3,60,51160,60,264,3,60,51160,60,264
9.922,6,1454,1347303,953,1363,10,1432,1322972,501,475,19,1871,24331
0.072,6,9,1339,5,145,18,145,349,4,826,20,826,990
0.44,6,24,6040,13,108,36,147,959,11,772,41,1608,5081
0.08,17,2,572,1,39,0,39,67,1,477,0,477,505
172.065,17,4,240,2,32,172064,32,120,2,32,172064,32,120
1.293,6,49,18302,28,882,47,1360,12641,21,437,56,2715,5661
1784.449,6,102,8296,68,65,26633,65,4930,34,59,54071,59,3366
1795.161,17,421,37044,380,35,4736,288,24088,41,288,44025,288,12956
1773.396,6,180,15480,120,69,14902,69,8940,60,69,30050,69,6540
1788.607,17,87,3648,86,14,21042,14,3612,1,8,0,8,36
64.463,6,15,636,7,0,2246,0,296,8,0,9208,0,340
33.296,6,62,19114,32,534,1065,1152,15169,30,548,1139,1179,3945
78.204,6,51,11713,20,372,4116,1189,4534,31,370,2596,1460,7179
1730.221,6,71,5191,45,33,39323,33,3102,26,31,69201,31,2089
599.066,6,9,546,6,31,119813,31,333,3,31,299525,31,213
188.554,2,2,64,2,8,188554,8,64,0,0,0,0,0
0.581,6,25,6541,14,323,44,955,2181,11,783,56,1414,4360
3.536,17,2,144,1,36,0,36,64,1,52,0,52,80
1792.369,6,368,25690,215,99,8375,469,15085,153,69,11790,69,10605
12.005,6,6,328,4,0,4001,0,216,2,0,11990,0,112
240.257,6,55,18742,30,795,8284,1418,15885,25,193,10010,580,2857
5.007,17,4,542,2,36,4999,36,128,2,179,5000,187,414
1798.082,1,58,4872,0,0,0,0,0,58,56,31545,56,4872
1792.846,17,142,11360,71,48,25611,48,5396,71,56,25611,56,5964
1789.425,17,83,3480,82,14,22091,14,3444,1,8,0,8,36
207.436,17,4,352,2,60,207435,60,176,2,60,207435,60,176
1686.622,17,20,5172,10,31,187398,37,594,10,429,187400,463,4578
504.83,2,4,128,4,8,168276,8,128,0,0,0,0,0
11.835,6,1756,1612324,1140,1363,10,1432,1583324,616,389,19,1432,29000
30.689,6,12,724,4,106,10204,106,274,8,90,4368,90,450
4.706,6,39,7269,19,218,261,314,3383,20,513,233,1179,3886
0.06,17,2,2756,2,1350,60,1350,2756,0,0,0,0,0
107.015,6,116,87754,75,1246,1446,1408,77498,41,676,2164,1408,10256
268.808,6,27,6494,11,220,5602,516,1326,16,348,17914,1452,5168
1.415,6,38,8252,19,320,78,1162,2716,19,433,68,1360,5536
1787.222,6,104,8252,68,63,26674,64,4868,36,57,51059,58,3384
1770.507,6,99,9240,66,65,27238,65,5577,33,59,55325,59,3663
0.054,6,10,1512,5,503,13,503,771,5,473,13,473,741
75.387,6,15,620,7,0,4089,0,284,8,0,10768,0,336
1745.709,6,95,7203,63,38,28156,205,4476,32,33,56302,98,2727
1792.632,6,356,22520,208,69,8660,69,12460,148,69,12194,69,10060
0.093,17,2,348,1,39,0,39,67,1,253,0,253,281
721.952,2,10,320,10,8,80216,8,320,0,0,0,0,0
327.348,6,3278,1721236,1887,847,173,1152,1648529,1391,363,235,1179,72707
174.213,6,30,7432,13,158,14517,267,1317,17,543,10885,1400,6115
32.133,6,9,396,2,0,3484,0,88,7,0,5340,0,308
2.601,6,116,87221,50,131,53,232,2529,66,1367,34,1430,84692
1788.75,6,182,15629,121,69,14906,69,8980,61,69,29806,69,6649
39.223,17,22,1936,11,48,3920,48,836,11,72,3917,72,1100
0.387,6,12,1653,6,288,75,288,548,6,426,42,434,1105
2.371,6,14,2309,8,288,335,288,1204,6,426,427,434,1105
17.118,6,2883,2718278,1869,1376,9,1408,2660886,1014,931,16,2801,57392
0.26,2,3,128,3,18,130,24,128,0,0,0,0,0
0.159,17,2,214,1,39,0,39,67,1,119,0,119,147
280.388,6,30,7432,13,158,23365,267,1317,17,543,17518,1400,6115
1.371,6,50,19279,27,890,52,1460,13583,23,433,54,1460,5696
0.351,17,2,558,1,32,0,32,60,1,470,0,470,498
7.016,6,899,784530,538,1417,13,1432,764493,361,396,19,1871,20037
0.664,17,2,378,1,30,0,30,58,1,292,0,292,320
3.278,6,21,6367,9,268,404,517,1281,12,744,294,1418,5086
0.037,17,2,212,1,46,0,46,74,1,110,0,110,138
0.59,6,20,7168,13,319,49,602,1960,7,1209,90,1946,5208
1789.449,17,453,65824,210,197,8561,1350,47260,243,48,7394,1350,18564
5.231,17,3,208,2,36,5002,36,128,1,52,0,52,80
0.915,2,2,64,2,8,915,8,64,0,0,0,0,0
0.147,6,10,1569,5,627,36,627,895,5,406,36,406,674
1791.713,6,242,25010,97,68,18662,681,9248,145,136,12441,2720,15762
1.153,6,23,7952,12,164,89,267,1288,11,1216,98,3819,6664
3.444,6,2693,2460647,1364,217,2,230,75953,1329,1744,2,16413,2384694
108.959,6,25,6318,9,272,93,516,1180,16,345,7258,1452,5138
1.545,17,18,7085,9,479,189,1350,4570,9,251,189,1350,2515
1.713,17,2,464,2,204,1713,204,464,0,0,0,0,0
0.277,17,3,451,2,39,135,39,134,1,289,0,289,317
10.698,6,19,7636,10,177,1168,229,775,9,1622,1314,3921,6861
0.029,17,2,178,1,37,0,37,65,1,85,0,85,113
1778.578,17,142,11360,71,48,25408,48,5396,71,56,25408,56,5964
18.495,6,2956,2773192,1854,1414,9,1448,2708980,1102,776,16,1448,64212
1609.207,1,8,848,8,78,229886,78,848,0,0,0,0,0
1786.026,6,388,36000,223,172,8045,1189,20274,165,118,10889,970,15726
240.283,6,41,8663,20,523,12646,1408,5758,21,200,12013,618,2905
16.156,17,15,9137,8,821,2302,1350,6798,7,306,2685,1350,2339
11.474,6,27,11355,13,275,956,275,1078,14,1078,852,1414,10277
300.871,6,44,13173,25,815,12536,1360,7566,19,402,480,2667,5607
368.317,6,23,1538,16,180,24554,180,1056,7,110,10441,110,482
0.074,6,2,80,1,0,0,0,40,1,0,0,0,40
0.367,6,14,1733,7,288,57,288,588,7,284,35,434,1145
15.681,17,10,880,5,48,3917,48,380,5,72,3917,72,500
1789.362,17,83,3480,82,14,22090,14,3444,1,8,0,8,36
241.712,17,4,352,2,60,241711,60,176,2,60,241711,60,176
0.512,17,17,6700,8,480,73,1350,4064,9,264,55,1350,2636
600.127,6,10,617,6,31,120025,31,333,4,31,199955,31,284
1798.999,6,370,25839,216,99,8367,469,15125,154,69,11756,69,10714
41.845,6,27,10749,14,380,3218,832,1745,13,941,3475,1440,9004
1794.276,17,144,11520,72,48,25271,48,5472,72,56,25271,56,6048
368.952,6,25,1651,17,177,23059,177,1117,8,110,9217,110,534
0.014,17,2,174,1,45,0,45,73,1,73,0,73,101
263.141,6,40,5923,22,304,12530,304,3900,18,83,15477,83,2023
0.414,6,7,295,4,0,138,0,164,3,7,110,7,131
658.892,17,130,9880,130,48,5107,48,9880,0,0,0,0,0
1783.301,17,83,3480,82,14,22016,14,3444,1,8,0,8,36
1792.548,1,250,14000,250,28,7198,28,14000,0,0,0,0,0
4.945,6,45,8409,21,227,247,314,4022,24,427,203,1152,4387
114.686,6,34,19217,16,708,51,1460,4226,18,1096,6738,1460,14991
1786.757,6,102,8228,68,64,26668,64,4896,34,58,54141,58,3332
1765.3,1,89,7476,89,56,20060,56,7476,0,0,0,0,0
17.488,17,34,10808,14,392,1343,1350,5887,20,218,918,1350,4921
2.673,6,22,5231,12,351,243,1382,2242,10,517,296,2433,2989
817.085,17,66,5280,33,48,25532,48,2508,33,56,25532,56,2772
37.104,17,4,1344,4,308,12368,308,1344,0,0,0,0,0
176.227,6,25,11358,12,433,70,990,1823,13,1000,14674,1360,9535
68.081,6,35,11519,19,127,3782,127,1336,16,950,4534,1704,10183
1789.417,17,142,11360,71,48,25562,48,5396,71,56,25562,56,5964
1787.911,6,366,25541,213,100,8433,469,14936,153,69,11762,69,10605
23.511,17,6,764,3,48,11749,48,228,3,150,11749,308,536
0.012,17,4,284,2,32,5,32,120,2,54,2,60,164
6.814,17,34,20599,17,711,423,1350,12578,17,443,423,1350,8021
18.94,1,6,336,6,28,3788,28,336,0,0,0,0,0
1746.383,6,97,7307,63,38,28167,205,4476,34,33,52909,98,2831
1791.073,1,342,28728,342,56,5252,56,28728,0,0,0,0,0
7.253,6,68,20558,34,554,219,1152,15771,34,427,212,1152,4787
1.046,6,28,8460,15,222,62,540,1964,13,994,70,1791,6496
1764.357,2,15,480,15,8,126025,8,480,0,0,0,0,0
0.028,1,4,416,0,0,0,0,0,4,76,9,76,416
301.743,6,54,21943,31,981,10058,1360,15992,23,358,434,1360,5951
1777.715,17,140,11200,70,48,25763,48,5320,70,56,25763,56,5880
240.266,6,57,18422,29,759,8580,1418,15184,28,221,8898,580,3238
11.428,6,26,9953,13,275,952,275,1078,13,1042,865,1440,8875
0.087,17,4,284,2,32,45,32,120,2,54,45,60,164
10.222,17,3,3213,3,1043,5111,1043,3213,0,0,0,0,0
7.316,6,7,420,2,0,1068,0,120,5,0,1780,0,300
1796.297,17,426,33228,402,35,4479,288,25644,24,288,76568,288,7584
0.186,17,2,152,1,48,0,48,76,1,48,0,48,76
0.171,17,4,314,2,31,139,31,118,2,70,126,70,196
0.752,6,23,5560,12,121,68,267,1215,11,650,68,1420,4345
281.473,6,30,7432,13,158,23456,267,1317,17,543,17570,1400,6115
0.322,6,10,887,5,248,76,248,452,5,231,76,231,435
5.15,6,40,7666,20,218,271,314,3423,20,491,258,1179,4243
1772.497,6,331,20968,194,69,9183,69,11624,137,69,13032,69,9344
244.896,6,48,13989,29,387,8746,1360,6665,19,546,13595,1360,7324
121.421,6,31,17618,16,708,53,1360,4214,15,1279,8659,2720,13404
0.776,17,13,5954,6,551,155,1350,3476,7,326,101,1350,2478
0.424,6,20,7196,12,325,38,626,1932,8,1210,59,1906,5264
240.785,6,132,81914,55,555,4458,1402,7311,77,1086,3168,2425,74603
1.858,6,14,2351,8,188,265,245,700,6,703,320,1152,1651
1786.559,6,102,8364,68,66,26665,66,4964,34,60,54135,60,3400
0.385,6,22,7255,12,318,35,600,1906,10,964,40,1471,5349
1794.067,17,66,2766,65,14,28032,14,2730,1,8,0,8,36
8.102,6,26,8718,8,156,1157,267,798,18,553,470,1420,7920
1629.335,1,17,952,17,28,101833,28,952,0,0,0,0,0
1742.114,6,96,7255,62,38,28559,205,4424,34,33,52781,98,2831
276.845,17,4,352,2,60,276844,60,176,2,60,276844,60,176
222.544,6,71,50448,46,1212,4945,1408,42413,25,961,2567,3847,8035
0.176,1,2,112,2,28,176,28,112,0,0,0,0,0
0.081,17,4,352,2,37,74,37,130,2,83,73,89,222
4.078,17,10,1415,5,31,1016,31,295,5,196,1016,196,1120
2.233,17,4,360,2,30,2048,30,116,2,94,2002,94,244
6.428,6,47,16791,23,674,292,1360,5738,24,718,271,1360,11053
240.211,6,53,17591,28,779,8896,1418,14715,25,196,10008,580,2876
1748.516,6,95,7203,63,38,28201,205,4476,32,33,56395,98,2727
1785.046,6,102,8296,68,65,26642,65,4930,34,59,54089,59,3366
1780.719,6,281,35831,116,154,15483,1360,18297,165,134,10857,4662,17534
1744.527,6,99,7411,63,38,28137,205,4476,36,33,49836,98,2935
5.23,6,15,6442,5,275,1307,275,479,10,694,537,1420,5963
6.896,6,66,20622,34,559,208,1152,15915,32,427,214,1152,4707
1797.213,1,345,28980,345,56,5224,56,28980,0,0,0,0,0
39.519,6,27,7177,13,155,3293,267,1306,14,530,3039,3417,5871
1794.205,17,323,71909,323,194,5572,361,71909,0,0,0,0,0
1795.161,1,258,14448,258,28,6985,28,14448,0,0,0,0,0
3.933,17,10,2386,5,30,980,30,290,5,391,980,484,2096
1.726,6,36,11635,18,456,101,1440,3950,18,869,88,1440,7685
1744.651,2,18,576,18,8,102626,8,576,0,0,0,0,0
24.869,17,42,19545,21,507,1241,1350,11237,21,367,1241,1350,8308
3.241,6,10,2933,3,92,1620,92,244,7,579,452,2026,2689
0.855,6,20,5952,11,282,85,548,1292,9,716,96,1420,4660
61.61,6,52,29664,31,1064,2053,1448,21850,21,839,3069,2359,7814
0.335,17,8,2742,8,314,47,353,2742,0,0,0,0,0
0.021,6,6,300,4,0,2,0,208,2,0,18,0,92
0.506,6,27,9047,13,252,42,647,1692,14,945,38,1408,7355
2.952,6,11,467,6,0,590,0,248,5,7,690,7,219
12.817,6,21,5922,10,275,1424,275,958,11,902,1206,1440,4964
271.091,17,4,352,2,60,271090,60,176,2,60,271090,60,176
1.262,6,40,11338,22,547,60,1360,5842,18,476,63,2715,5496
0.582,17,18,7428,9,496,72,1350,4717,9,273,65,1350,2711
125.7,6,6,1225,4,319,41900,398,799,2,173,125500,254,426
1794.121,6,508,69655,281,256,6407,1189,35816,227,182,7938,906,33839
1.885,6,2,1520,1,0,0,0,40,1,1440,0,1440,1480
0.445,6,12,1653,6,288,88,288,548,6,426,52,434,1105
1787.4,6,104,8308,68,64,26677,64,4896,36,58,51064,58,3412
1740.742,17,29,30624,29,1028,62169,1028,30624,0,0,0,0,0
1790.834,6,367,25581,213,99,8447,469,15005,154,69,11701,69,10576
20.255,6,25,4950,13,198,1687,722,1875,12,489,1816,1448,3075
0.239,17,2,152,1,48,0,48,76,1,48,0,48,76
8.839,6,42,12826,22,892,420,1360,7193,20,370,451,1360,5633
44.864,6,13,3937,8,307,6409,722,1345,5,2328,11167,2328,2592
1792.831,1,250,14000,250,28,7200,28,14000,0,0,0,0,0
70.138,6,16,652,7,0,7967,0,284,9,0,8765,0,368
1770.151,6,101,9344,66,65,27233,65,5577,35,59,52060,59,3767
1747.344,6,146,9174,79,48,22401,208,5595,67,31,26471,31,3579
1770.843,6,99,9240,66,65,27243,65,5577,33,59,55336,59,3663
25.336,6,3364,3132966,2107,1406,11,1448,3062902,1257,776,20,1448,70064
0.249,17,2,420,1,39,0,39,67,1,325,0,325,353
0.529,17,3,543,2,39,460,39,134,1,381,0,381,409
283.713,17,4,352,2,60,283712,60,176,2,60,283711,60,176
10.774,6,18,4226,10,275,1197,275,958,8,978,857,1420,3268
1795.576,6,361,22858,209,69,8632,69,12638,152,69,11889,69,10220
0.258,6,22,5040,10,137,28,267,1092,12,577,22,1400,3948
1781.76,6,357,22629,208,69,8607,69,12460,149,69,12038,69,10169
0.169,6,29,7376,15,155,12,267,1381,14,603,12,2036,5995
0.363,6,26,9017,13,261,30,683,1728,13,943,29,1438,7289
0.473,17,4,284,2,32,249,32,120,2,54,225,60,164
1772.305,6,180,15480,120,69,14893,69,8940,60,69,30038,69,6540
0.129,6,11,1170,6,135,25,135,379,5,587,31,587,791
85.712,6,793,382862,422,838,203,1152,363231,371,435,230,1179,19631
3.946,17,5,290,5,30,986,30,290,0,0,0,0,0
110.814,6,39,8735,17,401,1880,889,1916,22,370,5270,4848,6819
1793.733,17,144,11520,72,48,25263,48,5472,72,56,25263,56,6048
258.503,17,4,352,2,60,258501,60,176,2,60,258502,60,176
15.577,17,5,3575,5,687,3894,687,3575,0,0,0,0,0
0.041,17,4,352,2,37,0,37,130,2,83,10,89,222
0.393,6,114,88178,58,131,6,232,2849,56,1629,7,4260,85329
0.063,17,2,672,2,308,63,308,672,0,0,0,0,0
648.63,6,70,7919,37,89,18017,721,3367,33,140,20263,1448,4552
1773.104,1,272,15232,272,28,6542,28,15232,0,0,0,0,0
178.951,17,43,3225,43,47,4260,47,3225,0,0,0,0,0
1.231,6,41,9968,21,440,61,1360,4392,20,433,55,1360,5576
126.697,6,7,385,3,0,63348,0,152,4,7,42159,7,233
7.682,17,12,1764,6,48,1533,48,456,6,190,1533,308,1308
947.128,17,186,14136,186,48,5119,48,14136,0,0,0,0,0
1.654,6,48,18935,27,871,63,1360,13319,21,433,72,1360,5616
0.347,17,4,360,2,30,331,30,116,2,94,330,94,244
1786.884,6,104,8444,68,66,26669,66,4964,36,60,51051,60,3480
1794.475,17,322,55131,322,143,5590,386,55131,0,0,0,0,0
1795.746,6,267,32619,110,134,16473,1360,15632,157,137,11510,4662,16987
3.045,17,4,304,2,48,3037,48,152,2,48,3037,48,152
1799.141,1,57,4788,57,56,32127,56,4788,0,0,0,0,0
0.342,6,25,7498,13,335,27,668,2026,12,806,30,1448,5472
22.359,6,9,9768,9,1045,2794,1460,9768,0,0,0,0,0
0.595,6,23,5975,12,108,54,147,919,11,922,53,1581,5056
11.671,6,3015,2864267,1954,1388,5,1408,2804431,1061,931,10,2801,59836
4.093,6,5,260,3,0,100,0,156,2,0,4062,0,104
162.136,6,28,7352,13,158,13511,267,1317,15,678,11579,3436,6035
1793.894,17,194,55546,194,258,9294,422,55546,0,0,0,0,0
33.69,6,35,5360,17,154,2094,722,1975,18,271,1971,1402,3385
121.388,2,2,64,2,8,121388,8,64,0,0,0,0,0
1750.731,17,13,534,11,14,175054,14,462,2,8,1750548,8,72
1795.682,6,150,19350,90,302,20176,302,13740,60,83,30435,83,5610
1090.771,17,216,16416,216,48,5073,48,16416,0,0,0,0,0
1770.916,6,101,9344,66,65,27244,65,5577,35,59,52083,59,3767
441.186,17,6,3881,6,618,88237,1316,3881,0,0,0,0,0
0.506,17,3,451,2,39,248,39,134,1,289,0,289,317
0.619,6,10,861,5,222,152,222,426,5,231,152,231,435
1794.008,1,275,15400,275,28,6547,28,15400,0,0,0,0,0
1786.794,17,87,3648,86,14,21021,14,3612,1,8,0,8,36
1775.85,6,133,13038,76,61,23678,722,6287,57,78,31705,1448,6751
27.76,6,43,8640,22,161,1321,721,2339,21,681,1336,1440,6301
0.186,17,2,152,1,48,0,48,76,1,48,0,48,76
1799.68,17,144,11520,72,48,25347,48,5472,72,56,25347,56,6048
0.112,17,2,348,1,39,0,39,67,1,253,0,253,281
1781.37,6,354,22440,207,69,8647,69,12420,147,69,12201,69,10020
1.719,6,6,252,3,0,768,0,132,3,0,777,0,120
601.65,2,4,128,4,8,200550,8,128,0,0,0,0,0
300.231,6,37,9014,19,441,16679,1178,2834,18,402,3808,1408,6180
1661.199,1,7,392,7,28,276866,28,392,0,0,0,0,0
230.117,17,4,530,2,36,230112,36,128,2,173,230113,187,402
42.88,17,4,1344,4,308,14293,308,1344,0,0,0,0,0
1744.631,2,28,896,28,8,64615,8,896,0,0,0,0,0
1747.334,1,80,4480,80,28,22118,28,4480,0,0,0,0,0
0.081,17,6,6312,6,1024,16,1024,6312,0,0,0,0,0
1785.31,6,102,8228,68,64,26646,64,4896,34,58,54097,58,3332
300.946,6,53,10670,27,433,11574,910,3362,26,329,604,2720,7308
1644.169,1,14,1887,14,106,126474,176,1887,0,0,0,0,0
0.487,6,10,1671,6,552,97,948,1348,4,159,162,159,323
1655.816,1,24,1344,24,28,71992,28,1344,0,0,0,0,0
1783.389,17,83,3480,82,14,22017,14,3444,1,8,0,8,36
65.615,6,21,852,11,0,6560,0,444,10,0,7289,0,408
125.325,2,2,64,2,8,125325,8,64,0,0,0,0,0
0.713,17,21,12411,11,828,71,1350,9425,10,270,40,1350,2986
1797.972,6,366,24603,213,87,8480,469,14136,153,69,11826,69,10467
1.919,6,18,4743,9,290,239,517,1045,9,1071,215,1418,3698
0.065,17,2,440,1,40,0,40,68,1,344,0,344,372
1790.996,1,240,13440,240,28,7493,28,13440,0,0,0,0,0
0.011,17,2,390,1,30,0,30,58,1,304,0,304,332
14.572,6,85,24605,44,550,338,1152,18824,41,459,357,1179,5781
280.402,6,29,7392,13,158,23366,267,1317,16,603,18688,2036,6075
1795.049,1,16,1304,16,53,119669,78,1304,0,0,0,0,0
0.064,17,4,420,2,33,9,33,122,2,121,50,145,298
40.073,6,44,8823,21,410,653,882,2150,23,478,1815,2720,6673
240.394,6,63,24652,33,546,7512,1408,6681,30,964,8289,2816,17971
0.224,6,45,22123,27,1072,8,1420,17182,18,467,12,1883,4941
0.192,6,10,767,5,186,40,186,454,5,45,46,45,313
0.055,17,2,180,1,30,0,30,58,1,94,0,94,122
243.314,6,64,8649,28,197,9011,585,3881,36,190,6951,698,4768
0.763,6,13,1344,7,256,123,256,796,6,304,149,304,548
0.107,6,9,1002,5,213,26,213,417,4,421,27,421,585
12.875,6,1994,1776917,1237,1383,10,1420,1742392,757,420,17,1420,34525
842.252,2,8,256,8,8,120321,8,256,0,0,0,0,0
300.822,2,4,128,4,8,100274,8,128,0,0,0,0,0
503.708,2,4,128,4,8,167902,8,128,0,0,0,0,0
3.606,6,19,3452,10,49,400,92,627,9,336,52,1448,2825
218.885,17,4,352,2,60,218884,60,176,2,60,218884,60,176
1792.412,17,179,13962,179,50,10069,50,13962,0,0,0,0,0
146.834,17,3,1012,3,309,73417,320,1012,0,0,0,0,0
10.568,6,6,328,4,0,3522,0,216,2,0,10344,0,112
165.952,6,22,9636,11,380,68,832,1613,11,1081,16582,1460,8023
1799.599,17,449,39928,404,35,4465,288,25708,45,288,40019,288,14220
0.028,17,2,122,1,33,0,33,61,1,33,0,33,61
300.67,6,48,9195,24,315,13072,917,2327,24,327,669,1460,6868
1796.145,6,364,25530,212,99,8512,469,14965,152,69,11894,69,10565
1772.129,6,180,15480,120,69,14891,69,8940,60,69,30034,69,6540
1793.272,6,356,22520,208,69,8663,69,12460,148,69,12198,69,10060
12.718,6,910,807155,579,1322,21,1368,785279,331,776,37,1473,21876
13.81,6,23,8345,13,275,1150,275,1078,10,1371,975,1440,7267
0.173,17,2,144,1,36,0,36,64,1,52,0,52,80
1788.537,6,115,12377,74,83,24500,516,5958,41,129,44703,1452,6419
2.349,17,2,204,1,34,0,34,62,1,114,0,114,142
1789.239,6,356,22520,208,69,8643,69,12460,148,69,12171,69,10060
1775.75,6,271,32749,112,132,15996,1360,15644,159,135,11238,4662,17105
1716.129,1,171,9576,171,28,10094,28,9576,0,0,0,0,0
1796.979,17,448,39896,403,35,4470,288,25676,45,288,40019,288,14220
1776.698,1,153,8568,153,28,11688,28,8568,0,0,0,0,0
1133.73,2,9,288,9,8,141716,8,288,0,0,0,0,0
165.075,6,25,11358,12,433,88,990,1823,13,1000,13743,1360,9535
160.683,6,31,13654,14,493,64,1460,2579,17,943,10034,1460,11075
269.84,2,5,160,5,8,67460,8,160,0,0,0,0,0
1.403,6,49,18939,29,865,50,1360,13318,20,480,63,4075,5621
280.237,6,30,7432,13,158,23353,267,1317,17,543,17514,1400,6115
45.463,6,25,6757,12,181,4133,267,1212,13,717,3787,2800,5545
240.633,6,52,19058,29,781,8593,1418,16362,23,186,10937,580,2696
1.287,6,47,18160,26,882,51,1360,12544,21,433,55,1360,5616
1.701,6,53,19098,29,865,60,1360,13317,24,400,64,1360,5781
1.419,17,2,780,2,362,1419,362,780,0,0,0,0,0
261.009,17,4,352,2,60,261007,60,176,2,60,261008,60,176
0.168,6,3,2637,2,1258,0,1460,2597,1,0,0,0,40
152.65,6,33,8992,16,158,10176,267,1437,17,687,9534,1781,7555
1787.137,6,276,36038,112,151,16099,1460,17434,164,143,10963,1460,18604
52.829,6,10,1006,4,202,8897,241,766,6,0,10524,0,240
0.022,17,2,193,1,43,0,43,71,1,94,0,94,122
1773.39,6,180,15480,120,69,14902,69,8940,60,69,30048,69,6540
1771.186,6,99,9240,66,65,27249,65,5577,33,59,55346,59,3663
0.438,6,10,968,5,256,105,256,460,5,304,105,304,508
70.633,6,24,10049,12,531,60,1360,2637,12,1153,6409,2574,7412
0.169,17,2,527,1,39,0,39,67,1,432,0,432,460
5.261,6,39,7269,20,218,276,314,3423,19,513,277,1179,3846
3.907,6,120,87488,56,131,70,232,2769,64,1416,61,2840,84719
22.613,17,4,352,2,60,22612,60,176,2,60,22612,60,176
0.002,17,2,142,1,35,0,35,63,1,51,0,51,79
1770.321,17,390,65190,390,139,4550,366,65190,0,0,0,0,0
1792.655,6,357,22629,209,69,8618,69,12569,148,69,12192,69,10060
1.542,6,47,18161,26,882,61,1360,12545,21,433,66,1360,5616
1799.059,1,92,9752,92,78,19769,78,9752,0,0,0,0,0
11.917,6,1931,1644085,1160,1363,10,1380,1609003,771,421,15,1923,35082
300.876,6,46,10280,23,433,13676,910,3154,23,344,685,1360,7126
236.114,6,336,281356,219,1309,1083,1368,261582,117,594,1680,2519,19774
1786.761,6,104,8435,69,65,26275,65,4970,35,59,52548,59,3465
0.088,17,4,284,2,32,1,32,120,2,54,81,60,164
1793.631,6,295,20149,177,69,10191,69,11289,118,69,15330,69,8860
263.831,17,4,352,2,60,263829,60,176,2,60,263830,60,176
97.098,6,32,5522,16,332,6473,1056,3166,16,216,6472,580,2356
263.239,6,46,9254,23,178,11963,517,2477,23,556,11963,2407,6777
0.8,6,15,1785,8,288,89,288,640,7,426,102,434,1145
0.312,1,2,112,2,28,312,28,112,0,0,0,0,0
26.823,6,20,3871,11,211,2681,211,1225,9,545,3350,904,2646
16.862,17,6,1486,3,30,8424,30,174,3,409,8417,468,1312
1681.546,17,16,1265,8,30,240216,37,471,8,71,240216,136,794
0.377,17,19,7408,9,507,47,1350,4821,10,230,35,1350,2587
168.064,6,25,10220,13,549,77,1360,2749,12,1161,15264,2720,7471
60.905,17,3,228,3,48,30452,48,228,0,0,0,0,0
1795.865,17,142,11360,71,48,25655,48,5396,71,56,25655,56,5964
269.118,17,4,240,2,32,269117,32,120,2,32,269117,32,120
0.037,17,8,2750,8,315,5,354,2750,0,0,0,0,0
0.055,17,4,350,2,34,0,34,124,2,85,0,91,226
1787.126,6,104,8376,68,65,26673,65,4930,36,59,51058,59,3446
3.497,6,13,1466,8,304,499,304,1032,5,83,865,83,434
209.692,6,43,19089,21,912,1483,1460,8205,22,768,9970,1460,10884
0.005,17,2,418,1,37,0,37,65,1,325,0,325,353
1787.555,6,104,8376,68,65,26679,65,4930,36,59,51069,59,3446
1744.604,2,30,960,30,8,60158,8,960,0,0,0,0,0
1.805,6,24,6041,13,108,150,147,959,11,773,155,1608,5082
1.57,6,55,17914,28,707,58,1360,8925,27,464,60,2186,8989
1787.629,6,364,23047,211,69,8512,69,12787,153,69,11757,69,10260
0.045,17,4,344,2,47,0,47,150,2,69,11,75,194
1.245,6,40,9928,21,440,62,1360,4392,19,476,58,2715,5536
1681.911,17,14,1036,7,30,280316,30,406,7,62,280316,62,630
1.25,17,3,2906,3,940,625,1451,2906,0,0,0,0,0
1773.645,17,140,11200,70,48,25704,48,5320,70,56,25704,56,5880
6.902,6,1312,1210156,824,1391,8,1408,1180104,488,776,13,1408,30052
280.585,6,30,7432,13,158,23382,267,1317,17,543,17534,1400,6115
95.14,6,723,351430,387,839,246,1152,332144,336,417,283,1179,19286
15.304,6,28,6611,16,440,1020,679,2222,12,417,1288,1780,4389
1741.138,17,30,20190,30,645,60039,645,20190,0,0,0,0,0
1795.119,6,184,15208,97,103,18699,208,10705,87,31,20868,31,4503
1778.38,6,355,22963,200,70,8936,138,12209,155,69,11547,69,10754
1.109,6,216,159576,119,1370,9,1432,151463,97,420,11,1432,8113
1772.527,6,180,15480,120,69,14895,69,8940,60,69,30037,69,6540
1785.051,6,104,8308,68,64,26642,64,4896,36,58,50998,58,3412
5.835,17,2,672,2,308,5835,308,672,0,0,0,0,0
0.002,17,2,2027,2,985,2,1409,2027,0,0,0,0,0
24.17,6,13,540,7,0,4027,0,284,6,0,4832,0,256
1796.814,6,247,36274,153,302,11821,302,26386,94,83,19320,83,9888
1786.808,6,104,8376,68,65,26668,65,4930,36,59,51048,59,3446
1772.94,6,180,15480,120,69,14898,69,8940,60,69,30041,69,6540
0.511,6,15,5386,8,965,73,1360,3217,7,269,45,272,2169
0.0,17,1,138,1,110,0,110,138,0,0,0,0,0
373.649,6,23,1535,16,177,24909,177,1053,7,110,10398,110,482
0.899,6,2,1235,1,0,0,0,40,1,1155,0,1155,1195
6.676,6,15,1080,9,92,834,92,648,6,92,900,92,432
1678.979,1,7,392,7,28,279829,28,392,0,0,0,0,0
1.47,6,48,19126,26,953,58,1460,13470,22,433,60,1460,5656
3.538,17,19,11780,8,283,505,1350,2492,11,816,347,1350,9288
1764.081,2,13,416,13,8,147006,8,416,0,0,0,0,0
81.431,6,47,9140,23,412,659,889,2272,24,368,3534,2720,6868
299.427,1,4,224,4,28,99809,28,224,0,0,0,0,0
375.994,6,18,1242,14,180,28922,180,916,4,110,20062,110,326
300.578,6,19,1279,6,177,60080,177,497,13,110,25033,110,782
2.286,17,22,16547,11,727,228,1350,8307,11,721,179,1350,8240
4.887,6,44,8369,22,227,232,314,4062,22,489,221,1179,4307
11.848,1,10,1040,0,0,0,0,0,10,76,1316,76,1040
0.53,17,3,451,2,39,211,39,134,1,289,0,289,317
1786.497,6,356,22520,208,69,8630,69,12460,148,69,12149,69,10060
407.71,1,8,448,8,28,58244,28,448,0,0,0,0,0
0.284,17,2,152,1,48,0,48,76,1,48,0,48,76
1720.83,17,13,534,11,14,172065,14,462,2,8,1720653,8,72
1789.978,6,195,19118,127,97,14206,965,11150,68,77,26710,256,7968
3.545,17,2,656,2,300,3545,300,656,0,0,0,0,0
1793.032,6,356,22520,208,69,8661,69,12460,148,69,12195,69,10060
1797.118,1,207,11592,207,28,8723,28,11592,0,0,0,0,0
4.001,17,4,244,4,33,1333,33,244,0,0,0,0,0
0.0,6,1,44,1,0,0,0,44,0,0,0,0,0
0.005,17,2,251,1,31,0,31,59,1,164,0,164,192
151.794,6,23,9956,12,660,76,1360,3154,11,1270,15161,3595,6802
0.701,6,20,7168,13,319,58,602,1960,7,1209,109,1946,5208
40.962,17,6,1236,3,48,20475,48,228,3,308,20475,308,1008
908.06,6,80,8775,43,75,21615,721,3835,37,112,25218,1448,4940
0.112,17,2,304,1,60,0,60,88,1,188,0,188,216
120.811,6,16,1991,9,302,15101,302,1370,7,83,20131,83,621
582.6,1,6,336,6,28,116520,28,336,0,0,0,0,0
13.981,6,110,35898,56,600,254,1152,29256,54,407,258,1152,6642
1781.631,6,185,15887,123,69,14603,69,9129,62,69,29199,69,6758
0.321,6,27,9081,13,261,26,683,1740,14,943,23,1408,7341
95.648,6,135,66479,76,837,1275,1360,53372,59,487,1646,1938,13107
300.586,6,71,53543,47,1244,6534,1368,47282,24,834,981,2939,6261
1.216,6,40,9928,21,440,60,1360,4392,19,476,58,2720,5536
145.454,6,16,3253,6,92,29090,92,400,10,1164,16138,1408,2853
0.388,6,13,1693,7,288,60,288,588,6,426,41,434,1105
6.012,17,4,724,2,41,6005,41,138,2,265,6002,265,586
1.167,17,4,560,2,64,938,64,184,2,160,862,160,376
241.5,6,154,120819,58,534,4236,1418,7299,96,1307,2541,1418,113520
1764.201,2,14,448,14,8,135707,8,448,0,0,0,0,0
1744.954,6,98,7390,63,38,28144,205,4476,35,33,51316,98,2914
0.349,17,2,152,1,48,0,48,76,1,48,0,48,76
1740.899,1,15,840,15,28,124349,28,840,0,0,0,0,0
11.723,6,1860,1619837,1129,1381,10,1420,1586376,731,467,16,1883,33461
0.006,17,2,366,1,36,0,36,64,1,274,0,274,302
0.04,6,17,7194,9,139,5,139,615,8,1231,5,1682,6579
1741.11,6,87,6322,58,31,30545,31,3915,29,31,62179,31,2407
1764.098,6,198,26051,106,304,16800,304,17744,92,83,19385,83,8307
0.845,6,12,1304,6,256,166,256,756,6,304,166,304,548
230.205,17,4,352,2,48,230196,48,152,2,72,230195,72,200
0.284,6,16,5821,9,290,35,517,1045,7,1101,42,1418,4776
280.383,6,29,7392,13,158,23365,267,1317,16,603,18682,1400,6075
71.581,6,44,8905,20,363,1068,774,2005,24,329,3106,2720,6900
0.19,17,2,1920,2,932,190,932,1920,0,0,0,0,0
1.096,6,29,10521,16,616,64,1360,3768,13,777,77,2720,6753
122.195,6,30,9715,15,430,64,1360,2378,15,840,8715,1791,7337
24.061,6,34,8167,15,188,1718,722,1923,19,608,1318,1380,6244
0.701,6,23,5529,12,140,63,267,1184,11,650,63,1420,4345
255.539,17,4,352,2,60,255538,60,176,2,60,255538,60,176
36.345,6,45,9005,21,401,696,888,2136,24,327,1574,1440,6869
142.245,6,50,11033,20,291,7486,1189,2850,30,348,4898,1420,8183
1795.958,17,140,11200,70,48,26028,48,5320,70,56,26028,56,5880
4.594,6,40,7293,20,218,241,314,3423,20,511,228,1179,3870
1.952,17,22,5698,22,231,92,388,5698,0,0,0,0,0
3.629,17,5,340,5,40,907,40,340,0,0,0,0,0
1667.503,17,27,8856,27,300,64134,300,8856,0,0,0,0,0
0.235,6,19,4286,11,165,23,456,1394,8,493,31,888,2892
1791.182,6,161,13624,88,107,20588,208,9743,73,31,24873,31,3881
50.233,6,35,8297,18,371,515,797,1865,17,574,3129,4848,6432
47.502,6,395,174274,205,796,232,1152,161835,190,402,249,1152,12439
3.343,17,2,656,2,300,3343,300,656,0,0,0,0,0
1.574,6,55,36309,33,1197,49,1408,29260,22,1179,66,2816,7049
61.56,6,20,5392,7,152,1512,267,742,13,412,5108,1179,4650
301.271,6,52,10209,29,428,10759,882,3443,23,364,432,1440,6766
0.098,6,2,80,1,0,0,0,40,1,0,0,0,40
1796.067,6,416,24920,208,69,8676,69,12460,208,34,8676,48,12460
126.342,6,51,12054,19,144,7019,267,1637,32,434,4071,1420,10417
1456.158,6,322,37688,156,177,9394,924,25800,166,88,8815,224,11888
7.809,6,23,7167,8,138,1115,267,883,15,567,554,1452,6284
0.409,6,12,1653,6,288,75,288,548,6,426,47,434,1105
0.016,6,14,4439,7,92,2,92,464,7,900,2,1448,3975
1794.502,17,144,11520,72,48,25274,48,5472,72,56,25274,56,6048
22.733,17,14,1232,7,48,3787,48,532,7,72,3786,72,700
49.38,6,44,9020,20,412,709,889,2152,24,327,2141,1360,6868
0.729,6,10,924,5,283,120,283,551,5,105,122,105,373
1792.667,6,356,22520,208,69,8660,69,12460,148,69,12194,69,10060
0.857,6,10,1687,7,100,142,100,384,3,1179,304,1179,1303
1791.999,1,67,5628,67,56,27151,56,5628,0,0,0,0,0
840.649,17,8,2196,4,30,280214,30,232,4,463,280214,463,1964
0.234,17,2,677,1,300,0,300,328,1,321,0,321,349
1770.956,6,99,9240,66,65,27245,65,5577,33,59,55338,59,3663
153.967,6,36,12517,19,406,312,1360,4858,17,1161,9613,2720,7659
1795.827,1,118,6608,118,28,15348,28,6608,0,0,0,0,0
0.115,17,4,588,2,48,109,48,152,2,190,106,308,436
0.02,17,4,352,2,37,12,37,130,2,83,9,89,222
1787.619,1,276,15456,276,28,6500,28,15456,0,0,0,0,0
5.396,6,40,7309,21,218,269,314,3463,19,440,285,1152,3846
0.057,6,11,911,6,181,11,181,489,5,77,13,133,422
1773.342,6,181,15589,120,69,14902,69,8940,61,69,29547,69,6649
230.517,17,4,240,2,32,230516,32,120,2,32,230516,32,120
1665.156,6,203,15889,76,72,22200,376,7709,127,49,13214,143,8180
23.21,6,8,440,5,0,5802,0,268,3,0,11595,0,172
4.918,6,38,7229,20,218,258,314,3423,18,513,272,1179,3806
0.217,17,2,136,1,32,0,32,60,1,48,0,48,76
1.134,6,19,8662,11,296,113,577,1360,8,1394,138,3932,7302
14.569,6,9,594,3,112,7280,112,240,6,90,2912,90,354
82.325,17,19,1200,6,26,8434,29,324,13,39,6860,84,876
0.314,6,20,7238,12,335,28,668,1974,8,1210,43,1906,5264
169.974,6,281,230378,181,1304,944,1368,212879,100,614,1452,2519,17499
300.867,6,45,13235,24,814,13081,1360,7531,21,346,432,1360,5704
200.57,6,14,3205,3,245,136,245,369,11,299,20030,299,2836
6.032,17,4,428,2,47,6024,47,150,2,111,6024,111,278
241.257,6,53,6953,23,183,10964,585,3229,30,178,8317,580,3724
1793.886,17,142,11360,71,48,25626,48,5396,71,56,25626,56,5964
1769.986,6,99,9240,66,65,27230,65,5577,33,59,55302,59,3663
0.052,17,4,336,2,45,0,45,146,2,67,10,73,190
280.406,6,30,7432,13,158,23367,267,1317,17,603,17523,2076,6115
0.041,6,3,151,1,0,0,0,40,2,31,2,31,111
9.876,6,92,30225,48,580,210,1152,23983,44,447,223,1179,6242
159.429,6,30,10672,14,431,55,1360,2331,16,768,10620,2720,8341
1.989,6,24,5755,13,158,165,370,1315,11,799,197,1420,4440
1.385,6,51,20242,30,888,47,1360,14581,21,437,59,2715,5661
1796.008,1,58,4872,58,56,31508,56,4872,0,0,0,0,0
1780.427,6,106,9736,68,64,26573,64,5776,38,58,48116,58,3960
1.313,6,47,20157,27,962,50,1460,14581,20,433,59,1460,5576
0.033,6,3,2399,1,0,0,0,40,2,1127,0,1448,2359
0.324,6,25,8943,13,252,27,647,1692,12,1103,29,2816,7251
53.08,6,28,7217,13,155,4423,267,1306,15,482,3790,2840,5911
11.294,17,15,17706,15,1152,806,1449,17706,0,0,0,0,0
0.064,6,9,1339,5,145,16,145,349,4,826,19,826,990
280.309,6,30,7432,13,158,23359,267,1317,17,543,17518,1400,6115
0.587,6,92,77239,36,147,16,281,2457,56,1355,10,2816,74782
14.675,17,4,352,2,60,14674,60,176,2,60,14674,60,176
4.997,17,4,558,2,36,4987,36,128,2,187,4986,187,430
0.248,17,2,180,1,30,0,30,58,1,94,0,94,122
288.794,6,35,8140,11,152,28863,267,1667,24,367,12540,1460,6473
11.044,6,66,20595,33,558,345,1152,15848,33,489,336,1179,4747
224.357,17,4,352,2,60,224356,60,176,2,60,224356,60,176
0.404,6,8,423,4,0,134,0,204,4,7,73,7,219
0.357,6,10,968,5,256,87,256,460,5,304,87,304,508
241.836,6,61,24003,28,239,8956,1081,3392,33,944,7557,2816,20611
376.017,6,19,1306,14,180,28924,180,928,5,110,15196,110,378
1796.929,6,365,34210,181,389,9982,841,13050,184,65,9818,1548,21160
1781.134,6,142,10352,74,26,24398,26,4478,68,90,26583,427,5874
0.602,6,123,75916,64,1282,9,1432,69253,59,427,10,1432,6663
0.264,6,22,5040,10,137,29,267,1092,12,577,21,1400,3948
0.468,6,28,9029,14,239,36,597,1694,14,942,34,1438,7335
2.472,6,13,2311,8,188,353,245,700,5,1407,550,1407,1611
301.263,6,24,2113,10,177,33453,177,1059,14,110,23160,110,1054
3.509,17,23,12286,10,284,385,1350,3121,13,677,289,1350,9165
0.399,6,21,7217,12,318,35,599,1905,9,967,48,1471,5312
184.653,6,37,18759,22,739,8789,1368,9325,15,865,13185,1368,9434
10.1,6,13,616,6,0,2020,0,280,7,0,1350,0,336
0.292,17,2,152,1,48,0,48,76,1,48,0,48,76
370.908,6,18,1242,14,180,28531,180,916,4,110,20068,110,326
184.379,17,3,1022,3,312,92189,322,1022,0,0,0,0,0
109.284,6,6,1257,4,327,36428,414,815,2,181,109116,270,442
18.18,6,31,8912,14,158,1398,267,1357,17,687,1132,1781,7555
1798.374,6,356,22520,208,69,8687,69,12460,148,69,12233,69,10060
300.204,1,4,224,4,28,100068,28,224,0,0,0,0,0
10.512,1,4,224,4,28,3504,28,224,0,0,0,0,0
1772.392,6,180,15480,120,69,14894,69,8940,60,69,30032,69,6540
0.686,17,8,2750,8,315,98,354,2750,0,0,0,0,0
14.82,6,39,8528,21,363,741,774,2009,18,445,538,1928,6519
59.113,17,28,2383,26,30,2364,37,1515,2,406,359,463,868
39.073,17,22,1672,22,48,1860,48,1672,0,0,0,0,0
0.045,17,2,322,1,33,0,33,61,1,233,0,233,261
0.01,17,2,405,1,35,0,35,63,1,314,0,314,342
1797.278,1,85,7140,0,0,0,0,0,85,56,21396,56,7140
105.319,6,30,7744,9,162,454,267,1343,21,347,5265,1460,6401
1258.454,2,12,384,12,8,114404,8,384,0,0,0,0,0
0.046,17,2,272,1,60,0,60,88,1,156,0,156,184
2.486,17,23,7487,10,393,276,1350,4215,13,223,155,1350,3272
1.408,6,41,11972,22,613,67,1360,6436,19,476,67,2715,5536
0.333,6,26,8868,13,227,27,547,1592,13,941,27,1408,7276
1.652,17,2,214,1,39,0,39,67,1,119,0,119,147
18.282,6,6,328,4,0,6094,0,216,2,0,18270,0,112
1788.227,17,141,11276,71,48,25545,48,5396,70,56,25915,56,5880
1684.485,2,15,480,15,8,120320,8,480,0,0,0,0,0
421.124,2,6,192,6,8,84224,8,192,0,0,0,0,0
1484.445,6,177,28179,62,225,14815,1360,12056,115,129,13020,1360,16123
0.287,6,27,9085,13,257,23,667,1715,14,947,21,1408,7370
1795.095,17,449,39928,404,35,4454,288,25708,45,288,40022,288,14220
8.185,6,41,7802,21,219,409,314,3916,20,513,416,1179,3886
73.428,17,4,1344,4,308,24476,308,1344,0,0,0,0,0
300.757,6,38,8534,20,307,15829,882,2061,18,441,505,1440,6473
3.072,17,4,240,4,32,1024,32,240,0,0,0,0,0
1.569,6,38,8254,19,321,87,1164,2718,19,433,75,1360,5536
1524.603,1,81,4536,81,28,19057,28,4536,0,0,0,0,0
0.309,17,3,234,2,39,268,39,134,1,72,0,72,100
1798.23,17,144,11520,72,48,25327,48,5472,72,56,25327,56,6048
300.724,6,37,8426,21,287,15036,802,2032,16,522,569,3488,6394
240.305,6,43,8839,21,519,12014,1402,5778,22,212,11442,619,3061
3.634,17,5,295,5,31,908,31,295,0,0,0,0,0
3.93,17,8,1864,4,64,1308,64,368,4,346,1308,356,1496
33.973,6,22,3955,7,92,5662,92,452,15,334,2410,2026,3503
0.429,6,12,3704,6,171,85,171,491,6,964,58,1448,3213
782.131,2,8,256,8,8,111733,8,256,0,0,0,0,0
1790.561,6,365,25501,212,100,8486,469,14896,153,69,11779,69,10605
62.016,6,47,10301,23,533,420,910,3135,24,364,2690,2128,7166
288.239,1,4,326,4,53,96079,78,326,0,0,0,0,0
1790.887,17,326,56102,326,144,5510,385,56102,0,0,0,0,0
1799.867,17,448,39612,404,35,4466,288,25708,44,288,40945,288,13904
1.284,6,37,8218,19,321,71,1168,2722,18,476,65,2715,5496
0.086,6,10,1378,5,145,21,145,349,5,825,16,825,1029
0.02,17,4,368,2,32,9,32,120,2,96,12,96,248
1341.005,6,91,7247,56,66,24381,66,3956,35,59,39437,60,3291
87.336,6,12,2522,7,327,14556,413,1600,5,180,21766,269,922
0.007,17,2,340,1,32,0,32,60,1,252,0,252,280
1793.237,17,87,3648,86,14,21096,14,3612,1,8,0,8,36
0.082,17,2,144,1,36,0,36,64,1,52,0,52,80
1795.436,17,449,39928,404,35,4455,288,25708,45,288,40021,288,14220
16.268,17,6,528,3,48,8130,48,228,3,72,8129,72,300
75.776,6,35,7773,14,155,5828,267,1346,21,348,3788,1420,6427
0.679,17,25,19036,14,980,49,1350,14113,11,419,64,1350,4923
36.104,17,20,1760,10,48,4010,48,760,10,72,4010,72,1000
0.394,6,10,968,5,256,94,256,460,5,304,94,304,508
1785.607,6,102,8228,68,64,26650,64,4896,34,58,54106,58,3332
1797.989,17,449,39928,404,35,4461,288,25708,45,288,40021,288,14220
367.047,6,27,1767,18,177,21591,177,1181,9,110,8772,110,586
0.113,17,4,284,2,32,54,32,120,2,54,60,60,164
9.051,17,4,532,2,41,9042,41,138,2,169,9039,169,394
0.005,17,2,394,1,42,0,42,70,1,296,0,296,324
0.019,17,4,284,2,32,9,32,120,2,54,15,60,164
1772.043,6,103,9528,68,64,26447,64,5724,35,58,52111,58,3804
3.001,17,2,148,2,46,3001,46,148,0,0,0,0,0
2.03,6,19,3309,11,99,183,182,976,8,477,262,1343,2333
34.126,17,21,10454,11,665,3409,1350,7630,10,254,3788,1350,2824
153.972,17,4,352,2,60,153971,60,176,2,60,153971,60,176
1744.663,2,15,480,15,8,124618,8,480,0,0,0,0,0
1747.977,1,37,2072,37,28,48554,28,2072,0,0,0,0,0
1.091,17,4,352,2,37,0,37,130,2,83,0,89,222
162.365,17,4,352,2,60,162364,60,176,2,60,162364,60,176
11.689,6,1847,1624199,1149,1363,10,1380,1590081,698,475,16,1923,34118
11.491,6,29,7467,14,155,883,267,1341,15,552,579,1400,6126
175.407,6,28,7352,13,158,14617,267,1317,15,678,12522,3436,6035
1751.253,6,100,7525,65,38,27363,205,4611,35,33,51495,98,2914
1798.24,1,345,28980,345,56,5227,56,28980,0,0,0,0,0
1786.653,6,154,19574,92,302,19633,302,13852,62,83,29289,83,5722
1.772,17,3,1173,3,363,886,363,1173,0,0,0,0,0
1798.427,1,208,11648,208,28,8688,28,11648,0,0,0,0,0
0.073,17,2,2386,2,1165,73,1165,2386,0,0,0,0,0
1788.434,17,87,3648,86,14,21040,14,3612,1,8,0,8,36
0.035,6,10,1514,5,503,8,503,771,5,475,8,475,743
115.225,17,2,72,1,8,0,8,36,1,8,0,8,36
1782.475,17,83,3480,82,14,22005,14,3444,1,8,0,8,36
0.174,6,46,21507,26,1101,6,1420,16486,20,467,8,1883,5021
1774.455,17,140,11200,70,48,25716,48,5320,70,56,25716,56,5880
82.078,6,755,350239,390,829,210,1152,330848,365,435,224,1179,19391
1763.687,6,142,15384,76,86,23514,517,5795,66,218,27132,2451,9589
31.151,17,4,352,2,48,31143,48,152,2,72,31142,72,200
1775.939,17,142,11360,71,48,25369,48,5396,71,56,25370,56,5964
280.544,6,30,7432,13,158,23378,267,1317,17,603,17525,2076,6115
35.022,17,80,20168,34,265,1061,1350,9983,46,193,777,1350,10185
280.227,6,30,7432,13,158,23352,267,1317,17,543,17511,1300,6115
1786.5,6,104,8308,68,64,26664,64,4896,36,58,51040,58,3412
10.238,6,32,9333,13,155,853,267,1306,19,483,568,2840,8027
0.017,6,10,1800,6,616,3,1073,1477,4,159,5,159,323
0.399,17,16,12780,9,1004,49,1350,9293,7,470,46,1350,3487
32.299,6,25,13240,7,412,5360,896,1560,18,782,1891,1702,11680
1786.421,6,106,8524,68,66,26663,66,4964,38,60,48279,60,3560
372.129,6,15,1086,11,180,37212,180,760,4,110,20063,110,326
401.587,6,18,1242,14,180,30891,180,916,4,110,20082,110,326
21.897,6,3761,3388374,2239,1424,9,1448,3294946,1522,776,14,1448,93428
183.922,6,24,6329,7,272,317,516,1100,17,324,11489,1452,5229
7.148,6,1911,1783949,1217,1388,5,1408,1743197,694,931,10,2801,40752
238.264,6,30,7432,13,158,19855,267,1317,17,603,14889,2076,6115
1798.585,6,364,24523,212,88,8524,469,14027,152,69,11908,69,10496
1737.028,1,56,4704,0,0,0,0,0,56,56,31582,56,4704
1187.306,17,218,16568,218,48,5471,48,16568,0,0,0,0,0
0.012,17,3,576,2,60,1,60,176,1,372,0,372,400
37.893,17,11,836,11,48,3789,48,836,0,0,0,0,0
312.491,6,9,522,2,106,312480,106,194,7,0,52075,0,328
1786.234,17,87,3648,86,14,21014,14,3612,1,8,0,8,36
219.187,1,12,672,12,28,19926,28,672,0,0,0,0,0
79.53,6,41,8700,20,367,570,787,1982,21,391,3970,2720,6718
757.062,2,5,160,5,8,189265,8,160,0,0,0,0,0
0.113,17,7,3482,4,418,37,1350,1787,3,537,25,1350,1695
115.733,6,24,10963,12,414,88,935,1768,12,1087,10506,2368,9195
2.121,6,29,10365,17,367,132,833,1785,12,1012,184,1420,8580
1749.222,6,95,7203,63,38,28213,205,4476,32,33,56414,98,2727
1772.763,6,180,15480,120,69,14897,69,8940,60,69,30040,69,6540
1.258,6,24,6408,13,297,104,830,2011,11,988,118,1731,4397
1.071,17,36,22988,20,947,56,1350,19517,16,188,54,1350,3471
7.857,6,15,5472,5,121,1964,121,389,10,911,872,911,5083
1799.332,17,3522,169056,1753,20,1027,20,84144,1769,20,1017,20,84912
2.443,6,44,11555,23,616,111,1460,5894,21,400,103,1460,5661
15.01,6,2474,2281689,1577,1368,9,1408,2230381,897,931,16,2816,51308
1681.305,17,14,3843,7,30,280215,30,406,7,463,280215,463,3437
1789.853,17,143,11436,72,48,25208,48,5472,71,56,25569,56,5964
0.214,6,26,7256,13,155,17,267,1301,13,678,15,2045,5955
1788.605,17,87,3648,86,14,21042,14,3612,1,8,0,8,36
622.705,2,6,192,6,8,124541,8,192,0,0,0,0,0
1740.437,17,29,6815,29,207,62158,207,6815,0,0,0,0,0
7.7,6,111,80854,46,545,171,772,4066,65,1196,113,2864,76788
10.812,17,15,17682,15,1150,772,1451,17682,0,0,0,0,0
0.018,17,2,235,1,36,0,36,64,1,143,0,143,171
1777.024,6,102,8364,68,66,26522,66,4964,34,60,53846,60,3400
90.281,6,22,9190,11,419,69,954,1729,11,1001,9015,1440,7461
0.901,6,25,9025,14,270,69,722,1673,11,1150,73,2570,7352
280.301,6,30,7432,13,158,23358,267,1317,17,543,17514,1300,6115
1788.458,6,434,28197,217,100,8279,469,15096,217,34,8279,64,13101
33.389,6,30,5243,15,180,2384,722,1859,15,371,2371,2026,3384
20.17,6,17,2316,10,189,2241,517,1298,7,323,3358,499,1018
0.007,17,2,263,1,36,0,36,64,1,171,0,171,199
35.47,1,4,454,4,85,11823,142,454,0,0,0,0,0
1781.768,6,359,22709,209,69,8566,69,12569,150,69,11958,69,10140
1772.643,6,180,15480,120,69,14896,69,8940,60,69,30037,69,6540
0.063,17,8,2446,8,277,9,316,2446,0,0,0,0,0
125.033,6,22,9126,12,304,68,597,1425,10,1214,13874,3081,7701
1776.246,6,102,8464,67,40,26912,205,4782,35,53,52230,549,3682
1794.208,17,68,2847,66,13,27600,14,2767,2,12,1794020,16,80
93.302,17,7,532,7,48,15550,48,532,0,0,0,0,0
61.332,6,37,15909,22,797,2920,1408,9131,15,665,4362,1408,6778
1.977,6,27,8825,16,281,131,577,1489,11,984,179,1452,7336
1741.859,6,133,12036,72,96,24533,205,7594,61,31,29025,33,4442
0.096,17,2,574,1,32,0,32,60,1,486,0,486,514
2.733,6,34,6258,18,122,160,267,1709,16,780,178,1491,4549
240.199,6,54,17654,28,783,8896,1402,14781,26,189,9607,580,2873
1797.953,6,356,22520,208,69,8685,69,12460,148,69,12230,69,10060
0.133,17,2,184,1,32,0,32,60,1,96,0,96,124
1787.092,6,104,8376,68,65,26673,65,4930,36,59,51057,59,3446
253.411,6,25,3376,17,183,15838,183,919,8,531,3387,853,2457
0.684,17,4,368,2,32,652,32,120,2,96,653,96,248
41.524,17,44,6468,22,48,1976,48,1672,22,190,1976,308,4796
136.911,17,4,352,2,60,136910,60,176,2,60,136910,60,176
293.072,17,4,352,2,60,293071,60,176,2,60,293071,60,176
1782.413,17,207,45441,207,191,8652,373,45441,0,0,0,0,0
1770.464,6,99,9306,66,66,27237,66,5610,33,60,55324,60,3696
1798.029,6,356,22520,208,69,8686,69,12460,148,69,12231,69,10060
6.873,6,14,1247,7,222,1143,222,728,7,231,1143,231,519
12.126,17,10,750,10,47,1347,47,750,0,0,0,0,0
11.694,17,8,2688,8,308,1670,308,2688,0,0,0,0,0
1.661,6,42,11864,23,613,75,1101,4633,19,430,85,2720,7231
0.005,17,3,618,2,32,3,32,120,1,470,0,470,498
300.928,6,24,8991,15,156,21494,285,1415,9,1183,8312,2736,7576
6.771,6,27,7177,13,155,564,267,1306,14,530,519,3417,5871
65.442,6,42,10164,14,327,208,1189,2535,28,270,2423,1420,7629
8.484,6,11,640,5,0,2121,0,280,6,0,1400,0,360
15.12,17,16,6435,8,480,2155,1350,4065,8,268,2154,1350,2370
1660.453,6,104,12987,66,89,21685,498,5425,38,177,44874,1420,7562
61.789,6,70,48237,44,1182,1436,1408,40152,26,840,2463,2816,8085
1763.255,6,121,12122,76,62,23510,722,6311,45,93,40068,2026,5811
33.73,6,31,5096,15,154,2409,722,1860,16,342,2236,1448,3236
1799.568,17,447,39296,404,35,4465,288,25708,43,288,41928,288,13588
69.547,6,26,7206,12,155,6322,267,1266,14,537,5349,3426,5940
33.538,6,27,4886,14,180,2579,721,1806,13,480,2776,2118,3080
11.592,6,25,8473,13,275,966,275,1078,12,986,758,1440,7395
4.211,6,38,7229,19,218,233,314,3383,19,440,219,1152,3846
16.409,17,18,5684,8,313,2338,1350,2735,10,266,1819,1350,2949
8.678,17,4,240,2,32,8677,32,120,2,32,8677,32,120
1793.697,17,336,58166,336,145,5354,391,58166,0,0,0,0,0
280.18,6,26,7272,12,158,25470,267,1277,14,775,21549,3445,5995
1772.68,6,180,15480,120,69,14896,69,8940,60,69,30041,69,6540
280.468,6,28,7352,13,158,23372,267,1317,15,603,20028,2076,6035
129.029,6,23,8369,11,521,97,1257,2036,12,834,11713,1360,6333
282.399,6,29,7392,13,158,23533,267,1317,16,603,18807,2600,6075
0.128,6,9,1339,5,145,32,145,349,4,826,21,826,990
0.547,6,42,16673,25,753,22,1420,11548,17,555,32,1420,5125
1770.433,6,101,9410,66,66,27237,66,5610,35,60,52067,60,3800
8.115,6,534,463349,337,1309,23,1368,448441,197,776,40,1473,14908
1681.142,17,14,3799,7,30,280188,30,406,7,456,280188,463,3393
60.902,17,3,228,3,48,30451,48,228,0,0,0,0,0
102.994,17,4,352,2,60,102993,60,176,2,60,102993,60,176
60.424,6,13,3818,7,407,10070,722,1174,6,1164,12042,1408,2644
1795.003,1,58,4872,58,56,31491,56,4872,0,0,0,0,0
317.08,6,85,17802,43,272,7549,1460,8312,42,324,7730,3098,9490
1786.439,6,104,8252,68,63,26663,64,4868,36,57,51038,58,3384
0.089,2,2,64,2,8,89,8,64,0,0,0,0,0
2.704,6,48,18875,26,930,108,1460,13174,22,400,117,1460,5701
1795.97,6,356,22520,208,69,8676,69,12460,148,69,12216,69,10060
1771.316,6,101,9344,66,65,27251,65,5577,35,59,52094,59,3767
0.476,6,28,9199,13,263,39,688,1736,15,832,31,1368,7463
1773.099,6,180,15480,120,69,14899,69,8940,60,69,30048,69,6540
1655.458,1,7,392,7,28,275909,28,392,0,0,0,0,0
0.042,17,3,484,2,46,0,46,148,1,308,0,308,336
1.399,6,23,7952,12,164,109,267,1288,11,1521,120,5227,6664
1.212,17,4,1344,4,308,404,308,1344,0,0,0,0,0
50.659,6,47,10332,22,533,611,910,3095,25,327,2105,1460,7237
31.056,17,5,3575,5,687,7764,687,3575,0,0,0,0,0
1741.309,17,30,20190,30,645,60045,645,20190,0,0,0,0,0
0.015,17,6,462,3,33,0,33,183,3,65,0,65,279
1772.577,6,180,15480,120,69,14895,69,8940,60,69,30037,69,6540
0.773,17,4,368,2,32,636,32,120,2,96,659,96,248
505.972,6,60,7313,30,98,17447,721,2942,30,140,14801,1448,4371
1757.882,6,95,7203,63,38,28352,205,4476,32,33,56692,98,2727
28.392,6,41,13580,21,1015,444,1440,7978,20,399,1484,1440,5602
0.06,17,4,588,2,48,55,48,152,2,190,52,308,436
47.493,6,25,6757,12,181,4317,267,1212,13,717,3956,2036,5545
7.606,6,70,21554,37,534,211,1152,16450,33,472,229,1179,5104
32.753,6,5055,4780463,3301,1370,9,1408,4684493,1754,950,18,2801,95970
140.244,6,22,8752,11,314,73,634,1415,11,983,14010,1360,7337
1749.71,17,13,534,11,14,174952,14,462,2,8,1749527,8,72
10.998,6,18,5610,10,275,1222,275,958,8,1440,855,1440,4652
1.782,17,20,5190,20,231,93,389,5190,0,0,0,0,0
149.794,17,4,5512,4,1350,49931,1350,5512,0,0,0,0,0
360.936,2,6,192,6,8,72187,8,192,0,0,0,0,0
0.658,6,10,924,5,283,114,283,551,5,105,112,105,373
128.471,17,3,228,3,48,64235,48,228,0,0,0,0,0
0.599,6,23,6397,13,310,49,891,2077,10,979,65,1731,4320
47.693,6,45,10209,21,533,782,910,3043,24,344,2067,1360,7166
1745.414,6,95,7203,63,38,28151,205,4476,32,33,56294,98,2727
0.023,17,2,357,1,66,0,66,94,1,235,0,235,263
1776.633,6,104,8376,68,65,26516,65,4930,36,59,50755,59,3446
17.661,1,4,424,4,78,5887,78,424,0,0,0,0,0
3.001,17,6,460,3,40,1493,41,206,3,56,1493,57,254
0.039,17,4,336,2,34,0,34,124,2,78,1,84,212
1.414,6,38,9848,20,502,74,1460,4352,18,476,71,2615,5496
0.008,17,2,2750,2,1347,8,1347,2750,0,0,0,0,0
0.075,17,2,245,1,32,0,32,60,1,157,0,157,185
0.004,17,2,378,1,30,0,30,58,1,292,0,292,320
260.992,6,29,5332,14,168,12646,515,1574,15,262,18624,1452,3758
31.765,6,6,360,0,0,0,0,0,6,0,0,0,360
1772.08,6,180,15480,120,69,14891,69,8940,60,69,30032,69,6540
1.416,6,19,3781,10,234,157,564,1452,9,463,154,1343,2329
1786.308,6,4210,3791628,1596,147,1119,916,90084,2614,1402,683,1418,3701544
1754.465,6,102,7970,66,45,26991,205,4902,36,35,50119,98,3068
5.237,17,5,460,4,31,975,31,236,1,196,0,196,224
0.127,17,2,382,1,32,0,32,60,1,294,0,294,322
1.566,6,11,1727,7,100,261,100,384,4,589,427,1152,1343
137.126,17,4,352,2,60,137124,60,176,2,60,137125,60,176
11.334,6,2180,2064360,1413,1384,7,1408,2019812,767,931,14,2816,44548
1779.611,17,130,10400,65,48,27806,48,4940,65,56,27806,56,5460
0.891,17,3,201,3,39,445,39,201,0,0,0,0,0
3.661,6,5,272,3,0,1830,0,144,2,0,12,0,128
1770.234,6,101,9410,66,66,27234,66,5610,35,60,52063,60,3800
30.032,17,27,6369,11,239,3002,1350,2941,16,186,1999,1350,3428
0.013,17,2,316,1,36,0,36,64,1,224,0,224,252
135.909,1,6,336,6,28,27181,28,336,0,0,0,0,0
55.827,6,27,7177,13,155,4652,267,1306,14,530,4293,3417,5871
149.066,6,32,8952,14,158,11466,267,1357,18,624,8764,1400,7595
9.995,6,10,634,6,43,1999,43,406,4,0,3330,0,228
1745.319,6,95,7203,63,38,28150,205,4476,32,33,56291,98,2727
269.956,17,4,352,2,60,269955,60,176,2,60,269955,60,176
157.332,6,34,9420,15,155,11238,267,1542,19,546,8739,2045,7878
1779.03,1,339,28476,339,56,5263,56,28476,0,0,0,0,0
0.024,6,10,1903,5,657,5,657,925,5,710,5,710,978
153.433,17,3,2822,3,912,76716,1427,2822,0,0,0,0,0
240.231,6,54,18140,29,768,8579,1418,15348,25,185,10009,580,2792
170.218,6,25,11118,12,433,74,990,1823,13,973,14173,1440,9295
1772.213,6,180,15480,120,69,14892,69,8940,60,69,30035,69,6540
1794.789,6,360,22818,209,69,8628,69,12569,151,69,11962,69,10249
0.072,17,2,366,1,32,0,32,60,1,278,0,278,306
97.93,1,6,336,6,28,19586,28,336,0,0,0,0,0
27.856,17,4,240,2,32,27855,32,120,2,32,27855,32,120
1775.574,17,142,11360,71,48,25364,48,5396,71,56,25364,56,5964
10.721,6,10,1687,6,100,2144,100,344,4,1179,3487,1179,1343
375.583,6,14,1018,12,180,34143,180,804,2,110,72547,110,214
1777.84,17,142,11360,71,48,25396,48,5396,71,56,25397,56,5964
1796.647,17,449,39928,404,35,4458,288,25708,45,288,40023,288,14220
366.469,6,19,1303,14,177,28189,177,925,5,110,15158,110,378
28.603,6,38,9581,19,806,525,1440,4019,19,399,1579,1440,5562
1667.027,1,7,392,7,28,277837,28,392,0,0,0,0,0
1787.142,6,102,8228,68,64,26673,64,4896,34,58,54153,58,3332
8.202,6,18,6871,9,275,1025,275,643,9,1171,661,1440,6228
0.517,17,4,240,2,32,516,32,120,2,32,516,32,120
1742.815,6,95,7203,63,38,28109,205,4476,32,33,56212,98,2727
0.367,6,14,1733,7,288,57,288,588,7,284,34,434,1145
1745.451,6,95,7203,63,38,28152,205,4476,32,33,56297,98,2727
11.862,6,1871,1638976,1136,1387,10,1420,1605355,735,467,16,1883,33621
1.334,6,23,7952,11,164,114,267,1236,12,1014,103,2736,6716
3.56,17,8,736,4,32,1172,32,240,4,96,1170,96,496
1793.148,17,83,3480,82,14,22137,14,3444,1,8,0,8,36
1759.84,6,74,3900,38,26,47563,26,2002,36,26,48847,26,1898
1747.882,6,95,7203,63,38,28191,205,4476,32,33,56371,98,2727
1786.561,6,359,22709,209,69,8589,69,12569,150,69,11990,69,10140
0.36,17,6,912,3,60,7,60,264,3,188,5,188,648
1785.877,6,104,8376,68,65,26654,65,4930,36,59,51021,59,3446
1796.536,6,381,26955,219,103,8240,469,15990,162,69,11157,69,10965
26.212,6,26,6492,13,296,2184,826,2007,13,988,2174,1691,4485
1.646,6,19,3781,10,234,182,564,1452,9,463,184,1343,2329
529.769,17,13,988,13,48,44147,48,988,0,0,0,0,0
8.168,6,1214,1110447,742,1418,10,1448,1081227,472,776,16,1448,29220
7.014,6,6,260,2,0,15,0,84,4,0,2335,0,176
1775.607,17,136,10880,68,48,26501,48,5168,68,56,26501,56,5712
5.009,17,4,288,2,36,4977,36,128,2,52,4966,52,160
240.22,6,54,18009,29,800,8578,1418,15129,25,196,10008,580,2880
11.585,6,24,9520,13,275,965,275,1078,11,1331,834,1420,8442
279.021,1,4,224,4,28,93007,28,224,0,0,0,0,0
519.56,6,375,61272,213,304,2450,304,43268,162,83,3225,83,18004
1797.574,6,356,22520,208,69,8683,69,12460,148,69,12228,69,10060
1788.693,17,87,3648,86,14,21043,14,3612,1,8,0,8,36
1744.616,2,28,896,28,8,64615,8,896,0,0,0,0,0
1772.631,6,180,15480,120,69,14896,69,8940,60,69,30037,69,6540
3.074,17,4,834,2,44,2993,44,144,2,317,3046,317,690
0.557,17,5,373,3,31,269,31,177,2,70,527,70,196
0.638,6,15,1785,8,288,71,288,640,7,426,77,434,1145
1796.017,17,447,39864,402,35,4478,288,25644,45,288,40018,288,14220
0.309,17,8,2774,8,318,44,357,2774,0,0,0,0,0
1729.225,6,64,4684,41,33,43230,33,2825,23,31,78592,31,1859
1770.262,6,104,9654,68,65,26421,65,5811,36,59,50575,59,3843
226.697,17,40,5880,20,48,11930,48,1520,20,190,11930,308,4360
1777.87,17,73,3060,72,14,25040,14,3024,1,8,0,8,36
1795.783,17,142,11360,71,48,25653,48,5396,71,56,25653,56,5964
0.282,6,2,336,1,0,0,0,40,1,256,0,256,296
1624.419,2,14,448,14,8,124955,8,448,0,0,0,0,0
0.354,17,15,8445,8,705,50,1350,5870,7,339,50,1350,2575
0.02,6,10,1512,5,503,4,503,771,5,473,4,473,741
5.043,6,37,7189,19,218,280,314,3383,18,513,280,1179,3806
1779.857,1,342,28728,342,56,5219,56,28728,0,0,0,0,0
1785.759,17,142,11360,71,48,25510,48,5396,71,56,25510,56,5964
1792.302,17,138,11040,69,48,26357,48,5244,69,56,26357,56,5796
240.577,6,45,9343,20,589,12661,1408,5765,25,222,10023,617,3578
60.232,6,7,526,4,214,19984,214,394,3,0,30029,0,132
183.334,6,171,132364,108,1280,1713,1408,119578,63,730,2050,3847,12786
1765.678,17,37,12424,37,307,49046,308,12424,0,0,0,0,0
1778.019,1,72,6048,0,0,0,0,0,72,56,25042,56,6048
0.051,17,2,212,1,46,0,46,74,1,110,0,110,138
0.017,17,2,330,1,30,0,30,58,1,244,0,244,272
60.248,6,130,116700,78,442,782,995,5670,52,2166,1180,8448,111030
575.218,6,80,11643,47,88,12504,267,3839,33,223,17974,1460,7804
1132.546,17,12,888,6,30,226499,30,348,6,62,226496,62,540
1.589,6,25,8056,12,164,121,267,1288,13,869,111,1448,6768
1.144,6,31,10760,16,513,76,1360,3250,15,689,65,1360,7510
1795.967,17,142,11360,71,48,25656,48,5396,71,56,25656,56,5964
9.302,17,4,1344,4,308,3100,308,1344,0,0,0,0,0
1786.134,6,104,8444,68,66,26658,66,4964,36,60,51029,60,3480
37.319,17,40,5880,20,48,1963,48,1520,20,190,1963,308,4360
240.962,6,45,6333,21,213,12045,585,3020,24,187,10474,580,3313
0.446,6,25,6054,13,108,37,147,959,12,768,38,1581,5095
0.037,17,2,454,1,37,0,37,65,1,361,0,361,389
0.332,6,4,220,2,0,332,0,100,2,0,305,0,120
1681.177,17,16,4225,8,30,240167,37,471,8,441,240167,463,3754
1788.19,6,356,22520,208,69,8638,69,12460,148,69,12164,69,10060
3.806,6,37,11641,18,234,213,561,2192,19,867,201,1440,9449
1.672,6,46,18453,27,843,64,1360,12917,19,476,81,2715,5536
1.888,6,15,3491,6,288,343,288,560,9,639,213,853,2931
1775.406,17,140,11200,70,48,25730,48,5320,70,56,25730,56,5880
6.361,6,680,592799,421,1335,14,1368,574667,259,776,23,1473,18132
12.586,6,1989,1728256,1205,1378,10,1420,1692675,784,467,16,1883,35581
0.496,17,3,451,2,39,473,39,134,1,289,0,289,317
373.885,17,7,2344,7,306,62314,308,2344,0,0,0,0,0
240.172,6,30,3766,15,181,17154,595,1878,15,220,17154,580,1888
211.552,17,4,240,2,32,211550,32,120,2,32,211551,32,120
1785.83,6,104,8376,68,65,26654,65,4930,36,59,51021,59,3446
0.314,17,4,368,2,32,314,32,120,2,96,6,96,248
1.449,6,46,18791,26,934,57,1460,13215,20,476,66,2615,5576
20.474,17,4,240,2,32,20473,32,120,2,32,20472,32,120
7.688,17,4,1344,4,308,2562,308,1344,0,0,0,0,0
1776.982,17,142,11360,71,48,25384,48,5396,71,56,25384,56,5964
0.044,17,4,344,2,47,43,47,150,2,69,43,75,194
5.49,6,40,7309,20,218,288,314,3423,20,513,272,1179,3886
1783.304,17,83,3480,82,14,22016,14,3444,1,8,0,8,36
1.318,6,47,19172,27,891,50,1440,13596,20,433,60,1440,5576
1786.74,6,102,8364,68,66,26667,66,4964,34,60,54140,60,3400
2.459,17,8,704,4,37,334,37,260,4,83,819,89,444
96.469,6,121,97519,82,1259,1190,1368,87368,39,676,2196,1368,10151
280.257,6,26,7272,11,158,28025,267,1237,15,603,20014,1400,6035
12.538,6,21,2705,15,211,895,211,1306,6,545,2504,904,1399
280.744,6,30,7432,13,158,23395,267,1317,17,543,17540,1400,6115
1096.629,17,216,16416,216,48,5100,48,16416,0,0,0,0,0
21.932,6,38,8566,18,410,507,882,1982,20,412,1147,1440,6584
65.476,6,37,9321,16,310,167,1189,2818,21,514,3273,1917,6503
1793.083,1,24,2887,24,92,77960,173,2887,0,0,0,0,0
369.878,6,30,2700,16,184,24658,184,856,14,424,4128,434,1844
1.342,6,48,20158,27,959,51,1460,14542,21,433,58,1460,5616
17.27,6,20,5882,10,275,1918,275,958,10,902,1375,1440,4924
3.801,17,4,268,4,39,1267,39,268,0,0,0,0,0
1793.179,17,142,11360,71,48,25616,48,5396,71,56,25616,56,5964
1795.683,1,58,4872,0,0,0,0,0,58,56,31503,56,4872
1786.675,6,105,8416,68,65,26666,65,4930,37,59,49625,59,3486
1.321,6,50,19573,27,911,50,1360,13877,23,433,51,1360,5696
103.581,6,25,6273,9,267,93,502,1166,16,343,6899,1420,5107
0.001,17,2,518,2,231,1,388,518,0,0,0,0,0
0.964,6,11,1727,7,100,160,100,384,4,589,239,1152,1343
1720.427,17,12,498,11,14,172042,14,462,1,8,0,8,36
6.855,6,526,456514,333,1306,20,1368,441814,193,931,34,2841,14700
0.12,17,2,198,1,39,0,39,67,1,103,0,103,131
3.392,2,2,64,2,8,3392,8,64,0,0,0,0,0
0.308,17,8,2774,8,318,44,357,2774,0,0,0,0,0
0.044,6,11,819,6,186,8,186,506,5,45,10,45,313
1740.612,17,28,29568,28,1028,64467,1028,29568,0,0,0,0,0
1.298,6,44,16616,25,837,54,1360,11080,19,433,62,1360,5536
0.509,17,2,384,1,39,0,39,67,1,289,0,289,317
61.384,6,37,15697,22,776,2923,1368,8919,15,665,4363,1368,6778
368.397,6,23,1538,16,180,24559,180,1056,7,110,10397,110,482
11.242,6,27,11355,13,275,936,275,1078,14,1078,823,1414,10277
1779.798,6,354,22440,207,69,8639,69,12420,147,69,12190,69,10020
1.248,6,25,8068,12,164,97,267,1300,13,1014,89,2411,6768
1792.175,6,5299,4349508,2437,128,735,346,140587,2862,1454,626,2816,4208921
113.552,6,28,9617,15,563,74,1351,2358,13,840,9446,3151,7259
1769.305,17,170,14512,157,30,11341,37,9155,13,384,142456,463,5357
1792.362,6,356,22520,208,69,8658,69,12460,148,69,12192,69,10060
280.036,6,28,7352,13,158,23336,267,1317,15,678,20000,3436,6035
207.753,17,4,352,2,60,207752,60,176,2,60,207752,60,176
1.125,6,24,8004,11,164,95,267,1236,13,869,79,1440,6768
1794.559,17,237,55531,237,206,7604,422,55531,0,0,0,0,0
0.236,6,9,1002,5,213,59,213,417,4,421,61,421,585
269.01,17,4,352,2,60,269009,60,176,2,60,269009,60,176
0.174,1,2,112,2,28,174,28,112,0,0,0,0,0
4.218,17,10,1255,5,31,1052,31,295,5,164,1051,164,960
0.536,6,23,7397,13,334,44,663,2021,10,1209,53,1946,5376
0.207,17,2,152,1,48,0,48,76,1,48,0,48,76
1206.704,6,138,17915,75,304,16306,304,12152,63,83,19446,83,5763
2.445,17,4,624,4,128,815,128,624,0,0,0,0,0
3.516,6,19,6692,10,185,390,275,961,9,766,105,1380,5731
12.508,6,2210,2006100,1376,1378,8,1408,1958068,834,776,14,1408,48032
0.202,17,2,154,1,33,0,33,61,1,65,0,65,93
1798.074,17,448,39896,403,35,4472,288,25676,45,288,40019,288,14220
0.037,17,2,335,1,39,0,39,67,1,240,0,240,268
0.005,17,4,344,2,36,1,36,128,2,80,0,92,216
210.53,17,4,352,2,60,210529,60,176,2,60,210528,60,176
0.271,17,4,420,2,33,0,33,122,2,121,1,145,298
7.858,17,2,778,2,361,7858,361,778,0,0,0,0,0
0.11,17,2,279,1,36,0,36,64,1,187,0,187,215
80.707,6,15,2860,8,428,74,1360,2055,7,256,13432,361,805
55.203,17,4,240,2,32,55202,32,120,2,32,55202,32,120
1794.274,17,180,11520,180,36,10023,36,11520,0,0,0,0,0
1781.029,6,104,8424,68,64,26582,64,4896,36,58,50879,58,3528
2.286,6,20,3833,11,234,228,564,1504,9,463,260,1343,2329
0.179,6,9,1002,5,213,44,213,417,4,421,47,421,585
1.373,6,51,23822,30,998,47,1360,18206,21,476,59,2715,5616
1.356,6,48,19550,27,915,52,1440,13934,21,433,56,1440,5616
4.915,6,41,7349,21,218,245,314,3463,20,513,245,1179,3886
62.337,6,12,915,5,177,15584,177,433,7,110,10361,110,482
1.095,6,12,1653,6,288,215,288,548,6,426,112,434,1105
1620.091,1,14,812,14,30,124622,30,812,0,0,0,0,0
689.706,6,130,8512,69,69,10142,69,4209,61,69,11495,69,4303
367.2,6,23,1535,16,177,24480,177,1053,7,110,10363,110,482
0.353,17,4,1038,2,40,336,40,136,2,423,342,423,902
300.133,6,39,9638,20,648,15787,1440,4076,19,399,16664,1440,5562
0.012,6,4,160,2,0,12,0,80,2,0,0,0,80
8.772,6,80,24725,39,560,230,1152,18928,41,461,212,1179,5797
1625.126,1,22,2332,22,78,77386,78,2332,0,0,0,0,0
1796.508,17,447,39864,402,35,4480,288,25644,45,288,40021,288,14220
16.258,17,20,9409,9,434,2022,1350,4160,11,449,1616,1350,5249
1795.336,17,448,39896,403,35,4466,288,25676,45,288,40019,288,14220
240.338,6,42,8946,21,519,12016,1402,5776,21,258,12016,618,3170
32.121,6,110,98903,39,116,845,272,2378,71,1385,458,1418,96525
0.997,17,5,880,4,60,327,60,352,1,500,0,500,528
1789.992,17,180,26820,180,121,9999,121,26820,0,0,0,0,0
1.21,6,26,8903,13,234,100,575,1620,13,942,84,1448,7283
1.804,6,13,2311,8,188,257,245,700,5,1407,380,1407,1611
1681.259,17,14,3843,7,30,280197,30,406,7,463,280209,463,3437
1799.332,17,179,13962,179,50,10108,50,13962,0,0,0,0,0
0.622,6,21,9714,12,410,56,922,1742,9,1266,60,4080,7972
1171.681,17,236,34692,118,48,10014,48,8968,118,190,10014,308,25724
0.383,6,26,9039,13,266,31,705,1750,13,943,30,1438,7289
0.162,17,4,624,2,64,147,64,184,2,192,144,192,440
212.463,6,30,7432,14,158,16343,267,1357,16,678,14158,3536,6075
0.199,17,2,167,1,39,0,39,67,1,72,0,72,100
0.058,17,2,288,1,59,0,59,87,1,173,0,173,201
2.581,17,2,214,1,39,0,39,67,1,119,0,119,147
1793.262,1,186,19716,186,78,9693,78,19716,0,0,0,0,0
1681.508,17,14,1036,7,30,280246,30,406,7,62,280242,62,630
61.669,6,58,37577,36,1159,1761,1408,29700,22,960,2926,3847,7877
300.565,6,47,9142,23,315,13662,917,2275,24,327,542,1460,6867
1.461,17,24,17922,13,734,121,1350,9912,11,700,138,1350,8010
1.36,6,50,21492,28,978,50,1440,15836,22,433,56,1440,5656
51.064,1,16,1664,0,0,0,0,0,16,76,3404,76,1664
1777.637,17,73,3060,72,14,25037,14,3024,1,8,0,8,36
30.949,17,4,1344,4,308,10316,308,1344,0,0,0,0,0
1798.198,17,437,38408,394,34,4575,288,24820,43,288,41926,288,13588
0.295,17,2,152,1,48,0,48,76,1,48,0,48,76
174.677,2,2,64,2,8,174677,8,64,0,0,0,0,0
0.006,6,2,80,1,0,0,0,40,1,0,0,0,40
0.038,17,4,368,2,32,23,32,120,2,96,25,96,248
251.424,2,2,64,2,8,251424,8,64,0,0,0,0,0
107.897,6,31,14269,15,836,68,1460,5660,16,884,7181,1460,8609
1749.989,6,96,7255,62,38,28688,205,4424,34,33,53023,98,2831
366.417,6,23,1535,16,177,24427,177,1053,7,110,10359,110,482
1796.041,17,447,39580,403,35,4467,288,25676,44,288,40955,288,13904
1799.045,17,448,39896,403,35,4475,288,25676,45,288,40022,288,14220
44.392,6,44,8791,21,399,671,882,2118,23,478,2012,2720,6673
68.524,6,29,7257,13,155,5710,267,1306,16,441,4567,1420,5951
0.899,6,10,1687,7,100,149,100,384,3,1179,318,1179,1303
335.571,6,17,1236,13,226,27964,226,910,4,110,20057,110,326
1680.551,17,12,498,11,14,168055,14,462,1,8,0,8,36
1782.458,6,362,24305,211,88,8487,469,13987,151,69,11882,69,10318
1786.538,6,104,8444,68,66,26664,66,4964,36,60,51040,60,3480
1750.705,17,13,534,11,14,175052,14,462,2,8,1750521,8,72
0.359,6,12,988,7,181,59,181,565,5,77,83,134,423
240.398,6,54,17806,28,794,8903,1418,14963,26,185,9615,580,2843
0.005,17,2,340,1,39,0,39,67,1,245,0,245,273
194.444,17,2,152,2,48,194444,48,152,0,0,0,0,0
0.352,6,7,716,4,226,117,226,442,3,110,88,110,274
19.892,17,34,13177,14,476,1527,1350,7060,20,277,1044,1350,6117
9.52,6,90,28193,45,549,216,1152,21570,45,401,210,1152,6623
3.908,17,3,1176,3,364,1954,364,1176,0,0,0,0,0
34.764,17,20,1760,10,48,3861,48,760,10,72,3861,72,1000
55.658,17,4,304,4,48,18552,48,304,0,0,0,0,0
280.096,6,27,7312,13,158,23341,267,1317,14,775,21538,2800,5995
77.277,6,31,8064,11,152,7727,267,1364,20,420,4057,1452,6700
0.446,6,26,7256,13,155,37,267,1301,13,678,34,2045,5955
1.088,6,14,3463,6,288,215,288,572,8,639,130,853,2891
0.042,17,4,304,2,37,0,37,130,2,59,37,65,174
240.1,6,44,17296,22,169,11433,517,2179,22,1396,11433,7040,15117
5.993,6,21,3568,10,49,665,92,615,11,297,579,1408,2953
278.809,17,16,1408,8,48,39828,48,608,8,72,39828,72,800
1762.797,6,28,4117,18,241,103693,241,2889,10,92,195847,92,1228
249.463,6,37,12262,19,704,13858,1402,4567,18,676,14673,2804,7695
1786.323,6,134,11705,80,66,22611,205,6701,54,43,33697,131,5004
7.767,6,15,4006,8,275,1109,275,874,7,1420,1171,1420,3132
1.025,6,20,5926,11,286,102,559,1303,9,709,112,1380,4623
6.23,6,7,1548,3,100,3115,100,224,4,1152,1985,1152,1324
116.347,6,10,982,4,226,505,226,442,6,110,23231,110,540
3.269,6,5,216,2,0,10,0,84,3,0,1630,0,132
20.298,6,24,5586,13,107,1691,159,1126,11,967,2022,1709,4460
36.602,6,24,4077,14,234,2815,564,1688,10,463,2964,1343,2389
1778.881,17,142,11360,71,48,25412,48,5396,71,56,25412,56,5964
1028.587,17,204,15504,204,48,5066,48,15504,0,0,0,0,0
4.216,6,33,6145,17,206,263,314,2744,16,551,264,1179,3401
3.56,6,605,494666,351,1374,10,1420,480009,254,467,14,1883,14657
7.177,6,21,4331,10,288,778,288,1296,11,639,699,853,3035
1.612,6,51,18863,29,851,57,1360,13162,22,437,66,2715,5701
1798.027,17,430,37048,389,33,4634,288,24092,41,288,44023,288,12956
0.698,6,54,19240,29,909,24,1380,13941,25,355,27,1380,5299
0.855,6,20,5937,11,279,85,539,1283,9,715,95,1414,4654
0.77,6,10,1687,7,100,128,100,384,3,1179,261,1179,1303
3.22,6,6,340,3,0,1610,0,160,3,0,555,0,180
0.156,2,3,96,3,8,78,8,96,0,0,0,0,0
0.056,17,2,152,1,48,0,48,76,1,48,0,48,76
24.921,17,22,6889,10,361,2769,1350,3898,12,221,2168,1350,2991
139.26,17,4,352,2,60,139259,60,176,2,60,139259,60,176
4.945,6,39,7626,20,218,260,314,3423,19,491,259,1179,4203
11.447,6,27,11433,13,275,953,275,1078,14,1087,840,1440,10355
1792.002,6,364,25392,212,100,8492,469,14896,152,69,11867,69,10496
73.79,6,123,95897,79,1268,946,1408,84078,44,865,1711,4224,11819
1.242,6,25,8056,12,164,95,267,1288,13,869,87,1408,6768
168.636,2,6,192,6,8,33727,8,192,0,0,0,0,0
0.973,6,25,6648,14,344,74,1061,2288,11,783,96,1420,4360
0.044,17,2,201,1,36,0,36,64,1,109,0,109,137
360.975,2,6,192,6,8,72195,8,192,0,0,0,0,0
1740.525,17,29,19517,29,645,62161,645,19517,0,0,0,0,0
180.396,17,5,1203,5,212,45099,687,1203,0,0,0,0,0
124.575,17,16,21956,16,1344,8305,1348,21956,0,0,0,0,0
840.782,17,8,2196,4,30,280235,30,232,4,463,280256,463,1964
300.621,6,36,17773,22,931,14315,1368,12325,14,785,4733,1571,5448
68.918,17,4,352,2,60,68917,60,176,2,60,68917,60,176
6.03,6,290,209468,146,373,41,401,9674,144,1363,41,1368,199794
1670.471,1,8,448,8,28,238638,28,448,0,0,0,0,0
1794.997,17,142,11360,71,48,25642,48,5396,71,56,25642,56,5964
0.07,6,11,3653,6,171,13,171,491,5,1447,17,2676,3162
192.035,6,86,60174,51,682,506,1360,12336,35,2110,5644,8684,47838
1367.033,1,12,672,12,28,124275,28,672,0,0,0,0,0
0.399,6,26,9017,13,261,33,683,1728,13,943,31,1448,7289
0.09,6,7,364,0,0,0,0,0,7,0,0,0,364
1.233,1,10,840,10,56,137,56,840,0,0,0,0,0
92.87,2,3,96,3,8,46435,8,96,0,0,0,0,0
15.255,6,24,6993,13,275,1271,275,1078,11,910,1021,1440,5915
137.217,6,24,8025,12,377,55,797,1644,12,736,12463,1360,6381
372.179,6,25,1651,17,177,23261,177,1117,8,110,9236,110,534
0.508,6,12,1653,6,288,97,288,548,6,426,55,434,1105
1786.551,6,102,8364,68,66,26664,66,4964,34,60,54134,60,3400
280.054,6,29,7392,13,158,23337,267,1317,16,603,18666,2036,6075
0.213,6,27,7296,13,155,17,267,1301,14,603,15,2036,5995
280.228,6,28,7352,12,158,25475,267,1277,16,603,18679,1400,6075
280.066,6,29,7392,14,158,21543,267,1357,15,678,19999,3436,6035
1.228,17,6,552,3,64,613,64,276,3,64,613,64,276
45.928,6,48,10415,23,533,710,910,3147,25,329,1907,2720,7268
25.17,6,23,5538,14,107,1936,159,1194,9,773,2517,1402,4344
5.021,17,4,288,2,36,5020,36,128,2,52,5020,52,160
262.714,6,33,20174,22,964,12510,1295,14653,11,705,2998,1448,5521
706.253,6,138,8832,78,71,9171,138,4983,60,69,11970,69,3849
10.821,6,19,4402,10,275,1202,275,958,9,768,800,1440,3444
1795.247,17,80,3354,79,14,23015,14,3318,1,8,0,8,36
1799.369,6,367,25650,214,99,8447,469,15045,153,69,11837,69,10605
1793.514,1,170,9520,170,28,10612,28,9520,0,0,0,0,0
0.028,6,2,80,1,0,0,0,40,1,0,0,0,40
0.12,17,2,586,1,46,0,46,74,1,484,0,484,512
1742.35,6,99,7814,65,45,27224,205,4850,34,35,52791,98,2964
0.366,6,12,1304,6,256,71,256,756,6,304,71,304,548
0.023,17,4,680,2,33,15,33,122,2,251,13,323,558
7.762,6,26,4695,13,184,646,597,1790,13,441,579,1368,2905
300.66,6,46,8907,23,266,13666,720,2078,23,327,580,1460,6829
1340.205,6,139,11839,90,69,15058,69,6774,49,69,27920,69,5065
1794.6,17,179,13962,179,50,10082,50,13962,0,0,0,0,0
51.208,17,6,528,3,48,25599,48,228,3,72,25599,72,300
1787.265,6,106,8644,70,66,25902,66,5044,36,60,51061,60,3600
0.288,6,28,9166,13,257,24,667,1715,15,832,20,1408,7451
1.328,6,41,11378,21,616,66,1440,5802,20,433,59,1440,5576
0.091,6,13,4387,7,92,15,92,464,6,1201,18,2121,3923
1.4,6,51,21432,29,911,50,1360,15776,22,433,57,1360,5656
0.173,6,9,1339,5,145,43,145,349,4,826,43,826,990
4.811,6,36,8352,18,367,283,787,1878,18,441,275,1360,6474
280.456,6,31,7472,13,158,23371,267,1317,18,543,16493,1380,6155
38.94,17,22,1936,11,48,3893,48,836,11,72,3892,72,1100
1751.465,1,74,4144,74,28,23992,28,4144,0,0,0,0,0
70.117,6,16,652,7,0,8099,0,284,9,0,8763,0,368
60.427,6,9,820,5,226,15106,226,494,4,110,20065,110,326
1771.103,6,30,4450,19,241,98394,241,3182,11,92,177091,92,1268
3.606,6,2,88,2,0,0,0,88,0,0,0,0,0
1777.164,6,40,6078,23,241,80780,241,4294,17,92,111061,92,1784
1.68,6,13,2311,8,188,240,245,700,5,1407,355,1407,1611
14.546,17,5,4158,5,803,3636,1451,4158,0,0,0,0,0
38.253,17,22,1936,11,48,3824,48,836,11,72,3823,72,1100
865.322,17,23,7664,23,305,39332,308,7664,0,0,0,0,0
1799.858,17,142,11360,71,48,25712,48,5396,71,56,25712,56,5964
416.856,6,172,66886,87,701,4847,1440,54748,85,229,4958,1440,12138
0.4,6,7,670,4,180,133,180,396,3,110,104,110,274
1.042,6,10,1687,7,100,173,100,384,3,1179,398,1179,1303
62.792,17,4,352,2,60,62791,60,176,2,60,62791,60,176
11.94,6,1964,1647466,1163,1363,10,1380,1609204,801,515,14,1923,38262
1797.798,17,449,39928,404,35,4461,288,25708,45,288,40020,288,14220
285.754,6,26,2853,14,324,21978,585,1385,12,282,25974,580,1468
1786.784,6,106,8644,70,66,25895,66,5044,36,60,51048,60,3600
1755.182,1,58,4872,58,56,30792,56,4872,0,0,0,0,0
355.762,1,10,560,10,28,39529,28,560,0,0,0,0,0
246.669,1,30,1680,30,28,8505,28,1680,0,0,0,0,0
18.117,6,9,527,5,43,4529,43,311,4,0,6033,0,216
296.79,17,4,352,2,60,296789,60,176,2,60,296789,60,176
460.793,6,99,6742,43,46,10885,46,2754,56,46,8378,46,3988
1798.372,17,142,11360,71,48,25690,48,5396,71,56,25690,56,5964
33.422,6,31,5129,16,154,2228,721,1946,15,399,1183,2026,3183
301.569,1,43,4472,0,0,0,0,0,43,76,7180,76,4472
9.278,6,83,24845,41,560,231,1152,19008,42,415,219,1152,5837
54.266,6,27,7177,13,155,4522,267,1306,14,530,4173,3417,5871
1752.441,1,63,5292,0,0,0,0,0,63,56,28265,56,5292
0.14,6,2,80,1,0,0,0,40,1,0,0,0,40
595.374,6,9,546,6,31,119074,31,333,3,31,297634,31,213
1786.518,6,102,8364,68,66,26664,66,4964,34,60,54133,60,3400
322.498,6,50,7786,22,269,15357,1056,4113,28,184,11942,580,3673
1788.367,17,87,3648,86,14,21039,14,3612,1,8,0,8,36
58.877,2,2,64,2,8,58877,8,64,0,0,0,0,0
76.282,17,10,880,5,48,19068,48,380,5,72,19068,72,500
55.583,1,4,224,4,28,18527,28,224,0,0,0,0,0
1793.146,1,342,28728,342,56,5258,56,28728,0,0,0,0,0
0.464,6,10,1677,6,555,92,951,1354,4,159,153,159,323
0.048,6,9,1348,5,145,12,145,349,4,835,14,835,999
1772.347,6,180,15480,120,69,14893,69,8940,60,69,30036,69,6540
0.067,17,3,244,2,32,37,32,120,1,96,0,96,124
1401.124,17,12,3250,6,30,280210,30,348,6,455,280224,463,2902
8.94,6,4,240,4,0,0,0,240,0,0,0,0,0
4.945,6,62,27505,30,965,170,1360,16694,32,475,154,1360,10811
1790.374,1,262,14672,262,28,6859,28,14672,0,0,0,0,0
1786.737,6,102,8364,68,66,26667,66,4964,34,60,54140,60,3400
3.781,17,5,290,5,30,945,30,290,0,0,0,0,0
0.385,17,2,290,1,40,0,40,68,1,194,0,194,222
4.883,6,39,7269,19,218,271,314,3383,20,513,243,1179,3886
180.415,2,2,64,2,8,180415,8,64,0,0,0,0,0
6.196,6,1505,1457349,997,1388,6,1408,1426269,508,931,11,2801,31080
37.597,6,4359,4229529,1555,334,24,338,90508,2804,1429,13,2876,4139021
378.425,6,18,1242,14,180,29109,180,916,4,110,20060,110,326
0.005,17,2,350,1,33,0,33,61,1,261,0,261,289
8.41,6,72,20846,36,538,240,1152,15979,36,489,233,1179,4867
3.135,6,58,23271,29,1008,111,1440,17335,29,433,103,1440,5936
1772.377,6,180,15480,120,69,14893,69,8940,60,69,30038,69,6540
1122.012,17,10,740,5,30,280492,30,290,5,62,280493,62,450
41.163,6,43,13897,22,917,422,1360,8255,21,399,2049,1360,5642
1778.255,17,140,11200,70,48,25771,48,5320,70,56,25771,56,5880
1781.125,6,27,4077,18,241,104772,241,2889,9,92,222617,92,1188
359.517,6,22,6701,3,106,3750,106,234,19,355,19972,1917,6467
240.294,6,57,17150,29,746,8581,1418,14221,28,162,8899,580,2929
1744.64,2,27,864,27,8,67101,8,864,0,0,0,0,0
1773.301,6,180,15480,120,69,14901,69,8940,60,69,30050,69,6540
105.946,2,2,64,2,8,105946,8,64,0,0,0,0,0
281.521,6,30,7570,13,158,23460,267,1317,17,556,17577,3456,6253
1.676,1,30,840,30,0,0,0,840,0,0,0,0,0
0.218,6,27,7296,13,155,18,267,1301,14,543,16,1400,5995
127.909,17,29,5305,29,154,4568,352,5305,0,0,0,0,0
0.921,17,4,352,2,60,920,60,176,2,60,919,60,176
1751.264,6,95,7203,63,38,28246,205,4476,32,33,56479,98,2727
116.591,6,952,468276,520,835,224,1152,445150,432,417,269,1179,23126
5.439,6,45,8409,22,227,259,314,4062,23,427,235,1152,4347
1799.46,1,57,4788,57,56,32133,56,4788,0,0,0,0,0
240.68,6,48,11096,22,566,11460,1418,5709,26,402,9626,1418,5387
272.716,1,4,224,4,28,90905,28,224,0,0,0,0,0
1.136,17,15,7095,7,606,187,1350,4438,8,304,157,1350,2657
382.55,6,24,2055,17,141,23909,141,853,7,227,3873,356,1202
1.351,6,11,1727,7,100,225,100,384,4,589,363,1152,1343
0.137,17,2,152,1,48,0,48,76,1,48,0,48,76
20.362,6,13,2080,8,124,2908,267,697,5,589,3505,1152,1383
1790.62,17,390,49231,175,179,10290,1350,36280,215,32,8366,60,12951
0.151,17,4,284,2,32,139,32,120,2,54,13,60,164
1225.345,1,14,784,14,28,94257,28,784,0,0,0,0,0
9.368,6,41,7456,21,218,468,314,3463,20,455,479,1179,3993
366.371,6,21,1419,15,177,26169,177,989,6,110,15113,110,430
1.579,6,14,2351,8,188,225,245,700,6,703,262,1152,1651
104.586,6,41,8813,19,401,550,889,2056,22,366,4974,2128,6757
308.7,17,8,608,8,48,44100,48,608,0,0,0,0,0
1541.003,1,84,4704,84,28,18566,28,4704,0,0,0,0,0
6.674,6,39,7269,19,218,370,314,3383,20,513,338,1179,3886
61.276,17,4,352,2,60,61275,60,176,2,60,61274,60,176
1.475,6,48,19284,27,895,56,1360,13668,21,433,63,1360,5616
67.857,6,33,7939,10,155,404,267,1186,23,306,3083,1460,6753
5.09,6,41,7349,20,218,267,314,3423,21,440,241,1152,3926
0.049,17,6,936,3,64,5,64,276,3,192,0,192,660
1783.434,17,83,3480,82,14,22017,14,3444,1,8,0,8,36
5.038,17,4,288,2,36,5006,36,128,2,52,5008,52,160
643.148,6,41,2895,24,31,27953,31,1589,17,31,40183,31,1306
1749.103,1,56,4704,56,56,31801,56,4704,0,0,0,0,0
1744.105,6,97,7307,63,38,28130,205,4476,34,33,52843,98,2831
1796.459,6,415,24880,208,69,8678,69,12460,207,34,8720,69,12420
0.132,6,3,151,2,31,8,31,111,1,0,0,0,40
1794.212,6,24,3624,16,241,119614,241,2568,8,92,256282,92,1056
0.339,6,25,8965,13,261,28,683,1728,12,1100,30,2816,7237
1786.573,6,102,8296,68,65,26665,65,4930,34,59,54134,59,3366
299.964,1,4,326,4,53,99988,78,326,0,0,0,0,0
376.065,17,2329,1645066,2268,696,165,1252,1642626,61,12,4414,12,2440
0.15,17,2,465,2,204,150,360,465,0,0,0,0,0
0.168,17,4,842,2,47,158,47,150,2,318,153,318,692
1797.369,17,142,11360,71,48,25676,48,5396,71,56,25676,56,5964
13.047,6,24,6993,13,275,1087,275,1078,11,910,789,1440,5915
125.8,2,2,64,2,8,125800,8,64,0,0,0,0,0
31.499,6,6,288,1,0,0,0,48,5,0,7870,0,240
1773.593,17,140,11200,70,48,25704,48,5320,70,56,25704,56,5880
1.659,6,50,19348,29,889,59,1360,13687,21,437,72,2715,5661
16.955,6,55,12189,24,221,737,314,4512,31,535,555,1152,7677
120.924,17,5,380,5,48,30231,48,380,0,0,0,0,0
1743.364,6,95,7203,63,38,28118,205,4476,32,33,56224,98,2727
65.303,6,5,291,3,0,32650,0,156,2,31,1,31,135
236.545,6,61,37198,37,1136,6570,1408,29207,24,841,2671,2439,7991
256.662,17,2,908,2,426,256662,687,908,0,0,0,0,0
46.959,17,71,22174,32,250,1513,1350,8907,39,312,1234,1350,13267
1.707,6,42,8469,21,320,85,1162,2808,21,400,74,1460,5661
0.103,1,2,112,2,28,103,28,112,0,0,0,0,0
0.012,17,3,372,2,64,9,64,184,1,160,0,160,188
1.367,6,25,8056,12,164,105,267,1288,13,869,97,1368,6768
6.882,17,4,524,2,39,6868,39,134,2,167,6868,167,390
63.791,17,6,2016,6,308,12758,308,2016,0,0,0,0,0
1798.024,6,344,22247,201,69,8990,69,12318,143,69,12662,69,9929
0.44,6,12,1653,6,288,83,288,548,6,426,47,434,1105
0.153,17,2,2382,2,1163,153,1163,2382,0,0,0,0,0
0.668,6,2,87,1,0,0,0,40,1,7,0,7,47
280.237,6,28,7352,13,158,23353,267,1317,15,603,20016,2036,6035
29.52,6,2014,1832943,1282,1374,23,1380,1795497,732,383,40,1380,37446
1.624,6,3,160,2,0,972,0,120,1,0,0,0,40
1740.533,17,30,31680,30,1028,60018,1028,31680,0,0,0,0,0
1.291,6,50,18874,27,861,49,1360,13178,23,433,50,1360,5696
0.462,6,24,6040,13,108,38,147,959,11,772,44,1608,5081
0.415,6,26,8892,13,237,34,589,1634,13,939,32,1438,7258
4.737,17,16,9035,7,273,789,1350,2113,9,741,434,1350,6922
11.72,6,1878,1617128,1141,1363,10,1380,1583418,737,421,15,1923,33710
7.822,17,12,1764,6,48,1562,48,456,6,190,1562,308,1308
1761.435,6,104,8136,67,45,26688,205,4985,37,35,48922,98,3151
69.624,17,4,1344,4,308,23208,308,1344,0,0,0,0,0
1154.707,1,44,2464,44,28,26853,28,2464,0,0,0,0,0
0.245,17,2,780,2,362,245,362,780,0,0,0,0,0
4.443,6,38,7229,20,218,233,314,3423,18,513,245,1179,3806
1782.339,17,296,63865,296,187,6041,422,63865,0,0,0,0,0
1783.674,6,359,22847,208,69,8616,69,12460,151,69,11888,69,10387
6.248,6,43,7429,23,218,284,314,3543,20,513,313,1179,3886
8.291,6,1347,1143224,810,1361,10,1380,1117502,537,383,15,1380,25722
240.277,6,42,8791,21,519,12013,1402,5775,21,239,12013,619,3016
1.382,6,24,8004,12,164,107,267,1288,12,1014,107,2736,6716
240.296,6,55,18003,28,797,8899,1402,15014,27,197,9241,580,2989
1769.415,1,60,5040,0,0,0,0,0,60,56,29990,56,5040
1.162,6,29,9195,16,541,77,1440,3381,13,754,76,1587,5814
300.918,6,38,9915,21,593,15045,1460,4433,17,435,539,2567,5482
1795.081,17,80,3354,79,14,23013,14,3318,1,8,0,8,36
240.674,2,4,128,4,8,80224,8,128,0,0,0,0,0
5.012,17,4,542,2,36,5006,36,128,2,179,5007,187,414
1791.429,17,87,3648,86,14,21075,14,3612,1,8,0,8,36
41.285,17,19,1444,19,48,2293,48,1444,0,0,0,0,0
122.264,17,4,240,2,32,122263,32,120,2,32,122263,32,120
0.384,17,4,1375,4,315,128,354,1375,0,0,0,0,0
6.277,6,1380,1253271,860,1379,7,1408,1221567,520,931,11,2816,31704
374.805,6,18,1242,14,180,28831,180,916,4,110,20065,110,326
316.998,6,71,18734,37,339,8805,1460,9655,34,350,9601,3089,9079
103.156,17,10,3390,10,311,11461,329,3390,0,0,0,0,0
1.408,6,46,19002,26,950,56,1460,13426,20,476,64,2615,5576
0.398,6,26,8868,13,227,33,547,1592,13,941,30,1408,7276
1773.299,6,180,15480,120,69,14901,69,8940,60,69,30050,69,6540
1.307,17,6,360,3,32,653,32,180,3,32,653,32,180
240.239,6,54,17734,29,747,8579,1418,14977,25,181,10009,580,2757
20.507,6,23,11768,7,122,3417,122,446,16,1184,1357,1360,11322
300.547,6,11,866,6,180,60073,180,500,5,110,75091,110,366
154.218,6,76,55211,50,1203,3147,1368,47124,26,840,2474,2519,8087
0.232,17,2,178,1,29,0,29,57,1,93,0,93,121
1795.976,6,368,25828,213,99,8471,469,15074,155,69,11661,69,10754
0.303,6,12,1938,7,209,50,209,581,5,544,74,891,1357
98.17,17,4,240,2,32,98169,32,120,2,32,98169,32,120
110.646,17,5,1912,5,354,27661,548,1912,0,0,0,0,0
239.213,17,4,240,2,32,239212,32,120,2,32,239212,32,120
1749.771,6,95,7203,63,38,28222,205,4476,32,33,56435,98,2727
1778.037,17,142,11360,71,48,25399,48,5396,71,56,25399,56,5964
38.444,17,12,912,12,48,3494,48,912,0,0,0,0,0
5.542,2,2,64,2,8,5542,8,64,0,0,0,0,0
1.051,17,25,12104,11,566,105,1350,6538,14,369,75,1350,5566
1799.275,17,490,164608,490,307,3679,308,164608,0,0,0,0,0
104.39,6,17,1572,6,226,336,226,772,11,110,10421,110,800
1769.767,6,99,9240,66,65,27227,65,5577,33,59,55301,59,3663
10.998,6,18,5610,10,275,1222,275,958,8,1440,857,1440,4652
64.48,6,21,6506,6,154,12896,267,712,15,518,4571,1420,5794
6.178,6,45,8409,23,227,280,314,4102,22,489,281,1179,4307
0.207,17,2,144,1,36,0,36,64,1,52,0,52,80
10.002,17,2,298,2,121,10002,121,298,0,0,0,0,0
1789.909,1,342,28728,342,56,5249,56,28728,0,0,0,0,0
4.99,6,7,519,0,0,0,0,0,7,31,831,31,519
1769.976,6,99,9240,66,65,27230,65,5577,33,59,55308,59,3663
1.374,6,23,7952,11,164,116,267,1236,12,1014,107,2491,6716
10.038,6,7,1168,3,564,5019,564,708,4,126,1664,221,460
1.785,6,52,37070,33,960,55,1360,11921,19,2216,91,4878,25149
20.159,6,23,6180,14,117,1550,159,1337,9,873,2518,1659,4843
206.148,17,4,240,2,32,206147,32,120,2,32,206147,32,120
222.734,6,35,6873,14,189,8819,516,1510,21,251,11132,1452,5363
1785.86,6,387,27333,221,102,8117,469,16208,166,69,10823,69,11125
20.394,6,19,2432,10,189,2266,517,1298,9,323,2543,499,1134
1661.948,1,7,742,7,78,276991,78,742,0,0,0,0,0
1797.707,6,383,26635,220,97,8208,469,15630,163,69,11095,69,11005
1022.728,2,9,288,9,8,127841,8,288,0,0,0,0,0
8.292,17,39,11747,12,447,753,1350,5705,27,195,317,1350,6042
93.268,17,22,3352,11,48,9325,48,836,11,200,9325,308,2516
1741.935,1,86,4816,86,28,20493,28,4816,0,0,0,0,0
140.057,6,20,6941,5,275,35014,275,479,15,487,9168,1440,6462
280.003,6,27,7312,13,158,23333,267,1317,14,775,21538,2800,5995
125.363,6,22,4367,10,296,13929,722,1405,12,291,11379,1448,2962
161.162,6,32,7188,12,333,1217,1152,3148,20,538,8469,1179,4040
1.27,6,45,18084,25,882,52,1360,12508,20,433,56,1360,5576
240.194,6,52,17963,27,805,9237,1418,15099,25,194,10007,580,2864
282.566,6,31,8154,13,158,23547,267,1317,18,555,16590,1400,6837
158.256,6,25,8226,12,417,58,949,1776,13,657,13177,1360,6450
1744.408,6,94,7151,62,38,28596,205,4424,32,33,56260,98,2727
0.232,6,36,33487,20,180,12,250,1590,16,2218,8,5608,31897
23.014,17,7,532,7,48,3835,48,532,0,0,0,0,0
1684.474,2,14,448,14,8,129574,8,448,0,0,0,0,0
0.267,17,2,904,2,424,267,548,904,0,0,0,0,0
1782.014,6,363,24745,211,94,8485,469,14387,152,69,11801,69,10358
4.038,6,15,6519,5,186,1007,267,581,10,920,447,1997,5938
23.726,17,14,1232,7,48,3952,48,532,7,72,3952,72,700
92.884,17,10,880,5,48,23218,48,380,5,72,23218,72,500
8.279,6,1361,1303858,867,1428,9,1448,1273506,494,776,16,1448,30352
0.014,6,13,3980,7,88,2,88,388,6,1670,2,1880,3592
1795.65,17,448,39896,403,35,4466,288,25676,45,288,40022,288,14220
1.344,6,50,19389,27,898,51,1440,13693,23,433,53,1440,5696
1755.342,6,82,3800,41,0,43883,0,2120,41,1,43881,1,1680
1749.283,6,97,7338,64,38,27766,205,4528,33,33,54655,98,2810
80.305,6,16,660,7,0,13384,0,284,9,0,9484,0,376
0.003,17,2,150,1,39,0,39,67,1,55,0,55,83
1.411,6,51,23335,29,1030,50,1460,17679,22,476,57,2615,5656
2.736,17,34,7019,15,203,193,1350,3478,19,158,150,1350,3541
1788.639,6,3619,3587877,1231,128,1454,338,74580,2388,1462,749,5608,3513297
1.556,17,6,936,3,64,610,64,276,3,192,621,192,660
1797.872,6,356,22520,208,69,8685,69,12460,148,69,12230,69,10060
1744.672,2,30,960,30,8,60161,8,960,0,0,0,0,0
1.822,17,22,5709,22,231,86,389,5709,0,0,0,0,0
0.107,17,2,2752,2,1348,107,1348,2752,0,0,0,0,0
368.858,6,22,1483,16,177,24590,177,1053,6,110,12449,110,430
1.377,6,32,11235,16,458,91,1312,3420,16,1193,81,2720,7815
0.041,6,11,1566,6,503,8,503,823,5,475,10,475,743
1779.483,17,83,3480,82,14,21968,14,3444,1,8,0,8,36
1795.107,17,448,39896,403,35,4465,288,25676,45,288,40014,288,14220
0.492,6,23,9766,12,536,44,1301,2242,11,992,46,1448,7524
12.675,6,898,800413,580,1309,21,1368,779213,318,931,39,2841,21200
16.506,6,21,12897,6,98,3297,106,445,15,987,1177,1460,12452
1746.776,6,95,7203,63,38,28173,205,4476,32,33,56341,98,2727
1681.946,17,14,1036,7,30,280319,30,406,7,62,280318,62,630
1.413,6,47,18160,26,882,56,1360,12544,21,433,61,1360,5616
1.442,17,6,552,3,32,720,32,180,3,96,649,96,372
241.203,6,49,6478,23,213,10961,585,3150,26,164,9646,580,3328
0.258,17,3,234,2,39,82,39,134,1,72,0,72,100
130.006,6,22,4518,10,336,465,938,2423,12,537,11796,1179,2095
0.424,6,13,1693,7,288,65,288,588,6,426,49,434,1105
0.489,17,3,451,2,39,288,39,134,1,289,0,289,317
1.691,6,39,8294,19,321,93,1164,2718,20,433,76,1460,5576
727.481,17,34,11424,34,308,22044,308,11424,0,0,0,0,0
258.348,17,4,240,2,32,258346,32,120,2,32,258347,32,120
0.506,17,3,451,2,39,102,39,134,1,289,0,289,317
138.004,6,24,8050,12,377,74,798,1657,12,841,12531,2720,6393
382.436,6,11,808,7,112,63737,112,624,4,0,127474,0,184
0.0,17,2,317,1,43,0,43,71,1,218,0,218,246
0.385,6,27,9047,13,252,32,647,1692,14,945,28,1438,7355
5.346,17,3,208,2,36,5006,36,128,1,52,0,52,80
8.375,6,1516,1342862,926,1370,8,1408,1307518,590,931,13,2816,35344
1.185,6,24,8004,12,164,91,267,1288,12,1014,91,2411,6716
1780.681,6,354,22440,207,69,8644,69,12420,147,69,12196,69,10020
62.69,6,42,10612,15,152,4477,267,1524,27,347,2410,1420,9088
198.805,17,4,352,2,60,198804,60,176,2,60,198804,60,176
1770.095,6,107,9792,67,65,26819,65,5694,40,59,45384,59,4098
17.805,17,17,6684,8,470,2538,1350,3988,9,271,2220,1350,2696
26.957,6,14,2257,8,211,3848,211,858,6,545,5385,904,1399
503.79,2,3,96,3,8,251895,8,96,0,0,0,0,0
71.679,6,39,8721,19,401,660,889,2044,20,418,3765,4848,6677
0.823,17,4,560,2,64,805,64,184,2,160,421,160,376
15.111,17,17,11548,10,900,1675,1350,9289,7,294,2513,1350,2259
0.098,17,4,368,2,32,65,32,120,2,96,56,96,248
99.455,6,31,7656,10,155,164,267,1186,21,330,4972,1460,6470
1778.858,1,342,28728,342,56,5216,56,28728,0,0,0,0,0
250.988,17,4,304,2,48,250987,64,152,2,48,250987,64,152
1796.137,17,448,39896,403,35,4468,288,25676,45,288,40015,288,14220
0.254,17,2,157,1,31,0,31,59,1,70,0,70,98
1.225,6,42,10008,21,440,61,1360,4392,21,433,53,1360,5616
1775.117,6,281,34096,118,140,15170,1360,16642,163,133,10956,3302,17454
0.493,17,3,451,2,39,113,39,134,1,289,0,289,317
10.008,6,14,2242,8,210,1428,210,844,6,545,2000,904,1398
7.986,17,3,330,3,82,3993,82,330,0,0,0,0,0
4.56,6,37,7189,19,218,253,314,3383,18,513,251,1179,3806
0.035,17,2,362,1,46,0,46,74,1,260,0,260,288
6.863,6,40,7313,21,218,343,314,3463,19,513,366,1179,3850
5.22,6,38,23157,18,144,307,255,1508,20,1211,269,1448,21649
240.226,6,53,17775,28,794,8896,1418,14972,25,186,10008,580,2803
1784.809,6,276,33411,112,137,16078,1460,16363,164,127,10948,1642,17048
1795.17,17,446,39548,402,35,4476,288,25644,44,288,40951,288,13904
1.139,6,29,8200,15,222,67,540,1964,14,809,72,1460,6236
0.314,6,26,8927,13,234,26,575,1644,13,942,25,1408,7283
1.463,6,50,19694,27,920,56,1440,13998,23,433,57,1440,5696
0.071,17,2,390,1,46,0,46,74,1,288,0,288,316
5.758,6,39,7269,20,218,303,314,3423,19,513,303,1179,3846
145.953,1,30,2520,30,56,5032,56,2520,0,0,0,0,0
942.63,17,72,5760,36,48,26931,48,2736,36,56,26932,56,3024
38.943,17,11,836,11,48,3894,48,836,0,0,0,0,0
1772.502,6,203,22290,130,75,13740,267,10057,73,134,24612,2840,12233
1744.05,6,94,7151,62,38,28590,205,4424,32,33,56253,98,2727
0.044,17,2,212,1,53,0,53,81,1,103,0,103,131
0.709,17,2,144,1,36,0,36,64,1,52,0,52,80
21.197,6,23,2616,11,189,2118,517,1338,12,323,1926,499,1278
315.727,6,20,2429,7,242,52620,517,1111,13,323,26310,499,1318
180.484,2,3,96,3,8,90242,8,96,0,0,0,0,0
1675.087,1,7,392,7,28,279181,28,392,0,0,0,0,0
155.12,17,14,1120,7,48,25851,48,532,7,56,25851,56,588
116.571,6,24,980,10,0,5321,0,404,14,0,8966,0,576
1799.989,1,16,896,16,28,119999,28,896,0,0,0,0,0
1749.75,6,185,11668,94,53,18814,208,7160,91,31,19438,31,4508
0.916,6,25,9085,14,306,70,867,1818,11,973,73,1460,7267
105.414,17,4,352,2,60,105413,60,176,2,60,105413,60,176
368.521,17,56,4678,52,30,7224,37,3030,4,384,102280,463,1648
1785.975,6,114,9150,72,66,25154,66,5190,42,60,43558,60,3960
1680.451,1,11,638,11,30,168045,30,638,0,0,0,0,0
21.664,6,9,527,5,43,5416,43,311,4,0,7220,0,216
2.379,17,3,1167,3,361,1189,361,1167,0,0,0,0,0
61.798,6,71,47143,43,1184,1471,1448,38960,28,746,2280,1448,8183
5.797,6,41,7349,21,218,289,314,3463,20,513,290,1179,3886
0.278,17,2,166,1,47,0,47,75,1,63,0,63,91
0.854,6,20,5948,11,281,85,544,1288,9,716,95,1420,4660
0.112,17,2,157,1,31,0,31,59,1,70,0,70,98
4.854,6,39,7269,19,218,269,314,3383,20,440,242,1152,3886
240.411,6,44,8447,22,449,11447,1418,5648,22,205,11447,580,2799
0.025,17,2,306,1,33,0,33,61,1,217,0,217,245
1798.575,17,448,39896,403,35,4474,288,25676,45,288,40020,288,14220
381.49,1,3,348,3,88,190745,88,348,0,0,0,0,0
266.085,17,4,352,2,60,266084,60,176,2,60,266084,60,176
6.925,6,28,7424,11,155,692,267,1226,17,423,432,2006,6198
0.262,6,24,5980,12,164,23,453,1442,12,651,22,1408,4538
20.32,6,23,5534,13,107,1693,159,1126,10,967,2250,1709,4408
20.173,6,19,3078,11,183,2017,517,1509,8,381,2880,499,1569
270.518,17,4,358,2,33,270483,34,123,2,89,270482,114,235
1770.894,6,117,10836,74,66,24258,66,6284,43,60,42161,60,4552
352.752,2,3,96,3,8,176376,8,96,0,0,0,0,0
6.632,6,41,7658,22,224,315,314,3796,19,516,354,1179,3862
1787.293,6,103,8336,68,65,26676,65,4930,35,59,52564,59,3406
10.291,17,4,352,2,60,10290,60,176,2,60,10289,60,176
1793.177,17,142,11360,71,48,25616,48,5396,71,56,25616,56,5964
0.281,17,2,214,1,39,0,39,67,1,119,0,119,147
1797.077,17,448,39896,403,35,4470,288,25676,45,288,40021,288,14220
1.59,6,38,8254,19,321,88,1164,2718,19,433,78,1460,5536
1787.304,6,104,8376,68,65,26676,65,4930,36,59,51061,59,3446
1786.483,6,356,22520,208,69,8630,69,12460,148,69,12151,69,10060
0.983,6,29,10669,17,511,61,1360,3280,12,766,71,2561,7389
0.956,6,10,1687,7,100,159,100,384,3,1179,352,1179,1303
23.804,17,20,8511,9,478,2975,1350,4557,11,331,2377,1350,3954
35.006,6,29,4990,14,180,2692,722,1807,15,342,2465,1448,3183
84.261,6,29,13436,15,488,357,1360,3075,14,1223,6468,2568,10361
30.237,17,15,1216,11,35,3023,288,696,4,102,1726,288,520
1798.335,17,449,39928,404,35,4462,288,25708,45,288,40021,288,14220
300.625,6,37,8526,20,315,15822,882,2093,17,478,527,2720,6433
0.648,17,4,352,2,60,647,60,176,2,60,647,60,176
1.302,6,49,16756,27,827,50,1360,11055,22,400,53,1360,5701
421.134,2,6,192,6,8,84226,8,192,0,0,0,0,0
1798.194,17,449,39928,404,35,4462,288,25708,45,288,40017,288,14220
280.259,6,29,7392,13,158,23354,267,1317,16,603,18676,2036,6075
541.456,2,6,192,6,8,108291,8,192,0,0,0,0,0
1684.576,2,27,864,27,8,64791,8,864,0,0,0,0,0
1750.65,6,102,7970,66,45,26933,205,4902,36,35,50005,98,3068
9.562,6,1986,1831633,1254,1382,7,1408,1788905,732,931,12,2816,42728
48.923,1,4,224,4,28,16307,28,224,0,0,0,0,0
1.191,6,10,1687,7,100,198,100,384,3,1179,469,1179,1303
1748.158,6,107,8037,68,38,26091,205,4798,39,32,45993,98,3239
0.061,17,2,304,1,60,0,60,88,1,188,0,188,216
10.961,6,18,4146,10,275,1217,275,958,8,952,882,1380,3188
1793.757,17,179,13962,179,50,10077,50,13962,0,0,0,0,0
11.926,6,1787,1629468,1150,1364,10,1432,1599637,637,427,18,1432,29831
1795.193,17,80,3354,79,14,23015,14,3318,1,8,0,8,36
72.301,17,4,352,2,60,72300,60,176,2,60,72300,60,176
17.338,6,21,1539,10,222,1925,222,848,11,231,1732,231,691
0.02,17,4,624,2,64,0,64,184,2,192,4,192,440
38.512,17,11,836,11,48,3851,48,836,0,0,0,0,0
3.955,6,33,6145,17,206,247,314,2744,16,551,246,1179,3401
0.067,6,10,1380,5,145,16,145,349,5,827,12,827,1031
1.199,6,13,3766,7,170,171,170,554,6,964,227,1448,3212
15.637,6,6,264,1,0,0,0,44,5,0,3867,0,220
1799.612,6,356,22520,208,69,8693,69,12460,148,69,12240,69,10060
2.514,6,13,2311,8,188,359,245,700,5,1407,567,1407,1611
258.131,6,26,2346,12,69,13686,69,894,14,68,19855,69,1452
1.308,17,2,178,1,29,0,29,57,1,93,0,93,121
589.351,17,18,6032,18,307,34667,308,6032,0,0,0,0,0
24.789,6,18,4372,9,352,3098,722,1520,9,793,3072,1448,2852
376.467,6,16,1184,11,226,37646,226,806,5,110,25030,110,378
1.589,6,51,18973,29,862,56,1360,13272,22,400,66,1360,5701
51.454,6,28,8733,9,166,430,267,1035,19,462,2858,1420,7698
1772.472,1,64,5376,64,56,28134,56,5376,0,0,0,0,0
1785.854,6,356,22520,208,69,8627,69,12460,148,69,12148,69,10060
1790.663,1,342,28728,342,56,5251,56,28728,0,0,0,0,0
4.137,17,10,2399,5,40,1031,40,340,5,383,1030,407,2059
127.941,6,14,576,6,0,25588,0,244,8,0,17182,0,332
0.034,17,2,303,1,53,0,53,81,1,194,0,194,222
661.983,6,57,9945,28,161,24513,455,2283,29,590,23637,1440,7662
10.994,6,18,4266,10,275,1221,275,958,8,992,890,1440,3308
32.726,17,21,12321,11,400,3271,1350,4709,10,733,3635,1350,7612
1785.253,17,87,3648,86,14,21002,14,3612,1,8,0,8,36
4.082,6,37,7189,19,218,226,314,3383,18,513,225,1179,3806
8.398,6,2,239,2,79,8398,128,239,0,0,0,0,0
0.377,6,20,7238,12,335,33,668,1974,8,1210,52,1906,5264
0.02,17,4,352,2,37,14,37,130,2,83,13,89,222
12.248,17,20,3900,10,32,1359,32,600,10,302,1359,308,3300
1781.87,1,65,5460,0,0,0,0,0,65,56,27841,56,5460
1383.675,2,15,480,15,8,98833,8,480,0,0,0,0,0
1756.061,6,104,6218,60,27,29762,27,3525,44,27,40837,27,2693
1680.64,17,12,498,11,14,168064,14,462,1,8,0,8,36
300.892,2,6,192,6,8,60178,8,192,0,0,0,0,0
9.274,6,5,284,3,0,4549,0,164,2,0,9099,0,120
80.037,17,4,352,2,60,80036,60,176,2,60,80036,60,176
1790.054,6,165,10182,86,46,21059,208,6092,79,31,22945,31,4090
107.514,6,46,21483,23,526,231,1024,5179,23,959,4880,1696,16304
315.039,6,26,5635,9,133,39379,159,887,17,967,19689,1669,4748
61.686,6,21,4400,10,195,6833,722,1506,11,463,6150,1408,2894
5.198,17,66,54217,24,317,226,1350,8299,42,1065,124,1350,45918
138.573,6,29,7392,13,158,11547,267,1317,16,603,9236,2036,6075
1789.039,1,65,5460,0,0,0,0,0,65,56,27953,56,5460
41.015,17,15,3480,15,204,2929,204,3480,0,0,0,0,0
781.245,1,40,2240,40,28,20031,28,2240,0,0,0,0,0
229.805,17,4,352,2,60,229804,60,176,2,60,229804,60,176
1.135,6,23,6464,13,324,93,958,2144,10,979,124,1699,4320
105.364,6,43,8949,21,410,663,915,2162,22,368,5010,3488,6787
3.627,17,21,12547,9,478,453,1350,4554,12,638,326,1350,7993
15.875,6,24,6605,10,154,1763,267,872,14,516,1219,1420,5733
4.014,17,5,738,4,32,1332,32,240,1,470,0,470,498
3.774,17,5,295,5,31,943,31,295,0,0,0,0,0
1512.566,2,10,320,10,8,168062,8,320,0,0,0,0,0
0.274,6,24,6064,12,181,24,537,1526,12,651,22,1448,4538
52.602,6,25,7094,11,181,5260,267,1168,14,595,4044,1400,5926
3.64,17,10,1351,5,31,907,31,295,5,183,906,196,1056
0.082,17,2,198,1,63,0,63,91,1,79,0,79,107
1787.537,6,102,8364,68,66,26679,66,4964,34,60,54155,60,3400
1799.3,17,450,39960,405,35,4453,288,25740,45,288,40017,288,14220
0.142,6,11,1170,6,135,26,135,379,5,587,33,587,791
1788.876,6,358,22669,209,69,8600,69,12500,149,69,12086,69,10169
88.048,17,4,288,2,36,88047,36,128,2,52,88047,52,160
17.311,17,26,13978,12,478,1570,1350,6082,14,536,1328,1350,7896
7.343,6,28,10681,14,579,549,1205,3631,14,902,550,2491,7050
4.028,6,11,1727,6,100,159,100,344,5,1179,942,1179,1383
729.209,1,44,2464,44,28,16958,28,2464,0,0,0,0,0
8.84,6,12,5223,5,100,2210,100,304,7,927,1431,1152,4919
1788.087,6,287,27398,171,92,10518,1189,12955,116,136,15548,1420,14443
280.51,6,29,7392,13,158,23375,267,1317,16,775,18696,4836,6075
86.731,1,3,168,3,28,43365,28,168,0,0,0,0,0
881.658,2,6,192,6,8,176331,8,192,0,0,0,0,0
1766.448,6,80,4250,40,26,45292,26,2132,40,26,45292,26,2118
22.553,6,3741,3379518,2237,1423,10,1448,3289690,1504,776,14,1448,89828
14.849,6,15,2318,9,210,1855,210,920,6,545,2962,904,1398
63.23,6,13,772,3,106,31610,106,234,10,90,7024,90,538
1785.182,6,107,9035,70,71,25872,292,5302,37,64,49585,247,3733
49.149,17,2,122,2,33,49149,33,122,0,0,0,0,0
318.898,6,7,280,7,0,0,0,280,0,0,0,0,0
1740.544,17,29,6815,29,207,62162,207,6815,0,0,0,0,0
16.63,6,15,4683,9,290,2078,517,1057,6,1653,3292,1858,3626
1799.951,1,16,896,16,28,119996,28,896,0,0,0,0,0
0.013,17,2,398,1,32,0,32,60,1,310,0,310,338
207.082,17,4,240,2,32,207081,32,120,2,32,207081,32,120
60.24,1,4,498,4,96,20080,117,498,0,0,0,0,0
1764.487,2,12,384,12,8,160407,8,384,0,0,0,0,0
185.428,17,4,352,2,60,185427,60,176,2,60,185427,60,176
1780.883,6,106,9656,68,64,26580,64,5684,38,58,48127,58,3972
160.793,17,6,2032,6,310,32158,316,2032,0,0,0,0,0
1.394,6,49,19547,27,912,53,1460,13891,22,476,57,2615,5656
1795.28,6,354,22440,206,69,8757,69,12380,148,69,12212,69,10060
7.013,6,29,7464,12,155,637,267,1266,17,423,437,3417,6198
0.338,17,2,166,1,39,0,39,67,1,71,0,71,99
12.855,6,1978,1775946,1256,1362,10,1420,1742589,722,363,17,1420,33357
0.362,17,2,152,1,48,0,48,76,1,48,0,48,76
1772.655,6,182,15560,120,69,14896,69,8940,62,69,29055,69,6620
250.085,6,144,52712,68,700,1012,1152,44057,76,373,3331,1179,8655
1713.608,1,8,448,8,28,244801,28,448,0,0,0,0,0
7.985,6,19,8351,9,275,998,275,643,10,1216,847,1440,7708
233.835,17,10,3592,10,331,25981,548,3592,0,0,0,0,0
508.333,1,10,560,10,28,56481,28,560,0,0,0,0,0
1798.006,6,356,22520,208,69,8686,69,12460,148,69,12231,69,10060
0.225,17,2,166,1,47,0,47,75,1,63,0,63,91
0.437,6,12,1653,6,288,83,288,548,6,426,48,434,1105
0.01,17,4,970,2,52,1,52,160,2,377,0,425,810
210.414,17,4,288,2,36,210383,36,128,2,52,210382,52,160
181.032,17,4,352,2,60,181031,60,176,2,60,181031,60,176
73.323,17,20,1760,10,48,8146,48,760,10,72,8146,72,1000
1799.637,1,178,9968,178,28,10167,28,9968,0,0,0,0,0
1.592,6,19,3781,10,234,176,564,1452,9,463,174,1343,2329
3.804,6,34,13018,16,265,253,764,1987,18,917,223,1408,11031
1730.997,6,357,25602,190,101,8930,469,13878,167,60,10427,69,11724
2.437,17,3,543,2,39,916,39,134,1,381,0,381,409
0.137,6,44,21109,26,1079,5,1420,16168,18,467,7,1883,4941
6.349,6,59,11685,28,242,235,314,5979,31,446,203,1179,5706
4.003,6,41,7349,21,218,200,314,3463,20,440,198,1152,3886
1777.57,1,58,4872,58,56,31185,56,4872,0,0,0,0,0
1792.199,17,142,11360,71,48,25602,48,5396,71,56,25602,56,5964
1799.911,17,449,39928,404,35,4466,288,25708,45,288,40019,288,14220
90.115,6,23,10128,12,549,65,1360,2709,11,1393,8996,3934,7419
0.095,17,2,672,2,308,95,308,672,0,0,0,0,0
1.289,6,25,8469,15,175,92,362,1666,10,1045,112,2491,6803
0.038,17,2,178,1,29,0,29,57,1,93,0,93,121
1786.452,6,104,8376,68,65,26663,65,4930,36,59,51037,59,3446
164.846,6,41,27916,18,665,55,1460,4081,23,1272,7485,1460,23835
15.704,6,2065,1858167,1298,1375,12,1380,1812597,767,630,20,3303,45570
0.081,1,2,112,2,28,81,28,112,0,0,0,0,0
1771.731,6,102,9455,66,65,27257,65,5577,36,59,50618,59,3878
38.034,17,11,836,11,48,3803,48,836,0,0,0,0,0
1.945,6,32,10889,17,559,121,1360,4070,15,689,125,1360,6819
1.735,6,48,19181,27,889,66,1460,13565,21,433,75,1460,5616
0.112,6,11,1971,6,451,22,500,1222,5,481,28,481,749
1681.379,1,15,840,15,28,120098,28,840,0,0,0,0,0
280.472,6,28,7352,13,158,23372,267,1317,15,775,20030,4836,6035
2.998,17,3,1021,2,308,2000,308,672,1,321,0,321,349
4.841,6,39,7285,19,218,268,314,3383,20,516,241,1179,3902
369.441,6,27,1767,18,177,21731,177,1181,9,110,8614,110,586
1785.764,6,102,8296,68,65,26653,65,4930,34,59,54110,59,3366
1772.237,17,138,11040,69,48,26062,48,5244,69,56,26062,56,5796
0.275,6,26,9063,13,257,22,667,1715,13,833,22,1402,7348
12.229,17,10,850,5,37,3055,37,325,5,77,3055,77,525
1799.251,17,769,46429,769,32,2342,37,46429,0,0,0,0,0
235.638,6,7,280,7,0,0,0,280,0,0,0,0,0
1792.008,6,359,22709,209,69,8615,69,12569,150,69,12026,69,10140
1794.56,17,72,23968,72,304,25275,308,23968,0,0,0,0,0
7.716,6,42,8503,20,241,392,314,4180,22,491,354,1179,4323
0.012,17,2,390,1,30,0,30,58,1,304,0,304,332
1.006,6,10,1687,7,100,167,100,384,3,1179,377,1179,1303
0.386,6,13,1693,7,288,60,288,588,6,426,41,434,1105
1799.15,17,450,39960,405,35,4453,288,25740,45,288,40021,288,14220
1796.649,17,449,39928,404,35,4458,288,25708,45,288,40018,288,14220
1792.702,17,179,11456,179,36,10071,36,11456,0,0,0,0,0
1775.012,1,61,3416,61,28,29583,28,3416,0,0,0,0,0
1787.348,6,104,8376,68,65,26676,65,4930,36,59,51063,59,3446
3.509,17,4,352,2,48,3503,48,152,2,72,3499,72,200
3.981,17,8,616,4,33,1326,33,244,4,65,1323,65,372
2.226,6,15,2391,9,188,278,245,740,6,703,394,1152,1651
1798.481,17,450,39960,405,35,4451,288,25740,45,288,40025,288,14220
1746.223,17,150,24194,150,133,11719,373,24194,0,0,0,0,0
1725.49,17,12,498,11,14,172549,14,462,1,8,0,8,36
1786.631,6,170,22411,97,316,18610,316,15820,73,83,24814,83,6591
4.233,17,23,8203,11,451,423,1350,5278,12,215,382,1350,2925
1786.572,6,102,8296,68,65,26665,65,4930,34,59,54135,59,3366
0.163,17,2,152,1,48,0,48,76,1,48,0,48,76
101.182,6,32,5289,11,204,1357,722,1604,21,198,5049,1448,3685
1786.702,17,140,11200,70,48,25894,48,5320,70,56,25894,56,5880
285.357,17,4,352,2,60,285356,60,176,2,60,285356,60,176
1789.122,6,356,22520,208,69,8643,69,12460,148,69,12170,69,10060
1794.379,6,352,22360,206,69,8753,69,12380,146,69,12374,69,9980
1561.67,1,64,3584,64,28,24788,28,3584,0,0,0,0,0
46.89,17,5,207,4,12,15630,14,163,1,16,0,16,44
1.959,17,8,1718,4,37,647,37,260,4,336,645,348,1458
1699.04,1,8,448,8,28,242720,28,448,0,0,0,0,0
1786.76,6,359,22709,209,69,8590,69,12569,150,69,11991,69,10140
20.205,17,4,240,2,32,20204,32,120,2,32,20205,32,120
0.035,17,2,499,1,39,0,39,67,1,404,0,404,432
197.101,17,4,352,2,60,197100,60,176,2,60,197100,60,176
1687.927,1,7,392,7,28,281321,28,392,0,0,0,0,0
1774.376,6,180,15480,120,69,14910,69,8940,60,69,30071,69,6540
0.443,6,25,6055,13,108,36,147,959,12,768,39,1581,5096
2.835,17,3,276,3,64,1417,64,276,0,0,0,0,0
1680.717,17,13,534,11,14,168053,14,462,2,8,1680531,8,72
1772.209,6,180,15480,120,69,14892,69,8940,60,69,30029,69,6540
240.942,6,50,15220,25,720,10037,1368,12121,25,223,10037,580,3099
135.783,17,4,240,2,32,135782,32,120,2,32,135782,32,120
1787.654,17,87,3648,86,14,21031,14,3612,1,8,0,8,36
0.314,17,2,198,1,37,0,37,65,1,105,0,105,133
1781.149,6,353,22400,206,69,8688,69,12380,147,69,12199,69,10020
280.225,6,25,7232,12,158,25475,267,1277,13,905,23348,4845,5955
1791.513,17,180,14040,180,50,10008,50,14040,0,0,0,0,0
1764.849,17,176,42977,176,216,10084,422,42977,0,0,0,0,0
0.077,6,15,4534,8,135,11,136,695,7,869,12,1448,3839
585.584,6,26,1170,15,0,41827,0,720,11,1,40515,1,450
0.171,17,15,9475,8,832,19,1350,6884,7,342,22,1350,2591
152.267,17,4,352,2,60,152266,60,176,2,60,152266,60,176
7.703,17,3,228,3,48,3851,48,228,0,0,0,0,0
1680.447,17,28,6580,28,207,62238,207,6580,0,0,0,0,0
280.196,6,29,7392,13,158,23349,267,1317,16,603,18677,1400,6075
0.081,17,2,241,1,52,0,52,80,1,133,0,133,161
22.957,17,8,1176,4,48,7578,48,304,4,190,7645,308,872
0.039,17,2,672,2,308,39,308,672,0,0,0,0,0
0.774,6,22,8109,12,201,70,290,1127,10,938,64,2720,6982
0.91,6,12,3702,6,170,162,170,490,6,964,172,1448,3212
0.336,6,132,111977,81,217,4,256,5693,51,2114,6,5632,106284
8.772,6,51,9549,27,233,337,314,4821,24,470,369,1179,4728
89.222,6,21,10120,11,433,58,990,1771,10,1322,9899,2720,8349
1762.136,6,213,16332,80,69,22303,309,7799,133,48,13348,78,8533
0.028,17,2,138,1,33,0,33,61,1,49,0,49,77
2.999,17,8,608,4,37,997,37,260,4,59,997,65,348
1798.786,17,448,39896,403,35,4474,288,25676,45,288,40025,288,14220
1790.051,1,288,16128,288,28,6237,28,16128,0,0,0,0,0
0.768,6,5,260,3,0,224,0,156,2,0,360,0,104
4.09,6,16,3456,7,49,681,92,459,9,420,486,1448,2997
53.001,2,2,64,2,8,53001,8,64,0,0,0,0,0
377.745,2,6,192,6,8,75549,8,192,0,0,0,0,0
4.587,6,32,8952,14,158,352,267,1357,18,624,266,1400,7595
81.389,6,21,864,10,0,6156,0,404,11,0,8137,0,460
1770.206,6,100,9424,67,66,26821,66,5728,33,60,55314,60,3696
11.561,6,41,25500,26,1058,462,1368,19352,15,1072,812,2736,6148
0.019,6,2,80,1,0,0,0,40,1,0,0,0,40
487.196,2,8,256,8,8,69599,8,256,0,0,0,0,0
1790.467,1,58,4872,58,56,31411,56,4872,0,0,0,0,0
3.763,6,10,2929,5,92,940,92,348,5,1158,807,1448,2581
1783.81,6,364,23047,211,69,8494,69,12787,153,69,11735,69,10260
13.864,6,31,7682,11,155,9,267,1226,20,353,729,2840,6456
0.046,17,2,283,1,31,0,31,59,1,196,0,196,224
0.787,6,20,5984,11,282,78,548,1292,9,721,89,1452,4692
16.605,17,17,6889,7,316,2760,1350,2414,10,419,1840,1350,4475
0.343,1,2,112,2,28,343,28,112,0,0,0,0,0
301.213,6,51,13284,26,783,12048,1360,7375,25,326,369,1360,5909
1770.341,1,58,4872,58,56,31058,56,4872,0,0,0,0,0
1796.35,17,449,39416,404,34,4457,288,25444,45,282,40015,288,13972
1.386,6,10,1687,7,100,231,100,384,3,1179,562,1179,1303
1178.388,1,112,11872,112,78,10616,78,11872,0,0,0,0,0
519.997,6,66,8041,36,96,14857,721,3617,30,149,17923,1448,4424
53.511,6,35,8345,18,371,515,797,1913,17,521,3334,3488,6432
48.311,6,20,876,8,0,6901,0,348,12,0,4189,0,528
15.88,6,26,7271,11,133,1588,267,981,15,568,1121,1420,6290
1.11,17,4,660,2,33,1070,33,122,2,241,19,249,538
133.437,1,4,224,4,28,44479,28,224,0,0,0,0,0
3.947,17,8,736,4,32,1309,32,240,4,96,1311,96,496
1798.409,6,366,24603,213,87,8483,469,14136,153,69,11828,69,10467
377.326,2,3,96,3,8,188663,8,96,0,0,0,0,0
280.436,6,28,7352,13,158,23369,267,1317,15,678,20027,2045,6035
1787.823,6,360,22680,209,69,8595,69,12569,151,69,11892,69,10111
1.377,6,37,8214,19,321,76,1164,2718,18,476,69,2615,5496
0.98,6,54,20420,29,926,35,1380,15121,25,387,38,1923,5299
1.228,6,23,7952,12,164,95,267,1288,11,1216,104,3819,6664
4.126,17,4,244,4,33,1375,33,244,0,0,0,0,0
1798.562,17,447,39864,402,35,4485,288,25644,45,288,40015,288,14220
2.251,6,15,1513,8,222,320,222,994,7,231,371,231,519
1797.521,17,444,39200,400,35,4505,288,25296,44,288,40951,288,13904
109.943,6,116,89028,74,1290,1506,1448,78731,42,675,2639,1448,10297
0.081,17,2,193,1,43,0,43,71,1,94,0,94,122
1784.633,6,102,8364,68,66,26636,66,4964,34,60,54077,60,3400
0.143,6,46,20445,25,1024,5,1420,15384,21,420,6,1420,5061
1787.551,6,102,8228,68,64,26679,64,4896,34,58,54165,58,3332
33.79,6,30,5042,15,154,2413,722,1859,15,399,2398,2026,3183
1751.873,1,56,4704,56,56,31852,56,4704,0,0,0,0,0
11.72,17,4,824,2,48,11698,48,152,2,308,11701,308,672
0.063,6,10,766,5,185,13,185,453,5,45,15,45,313
12.227,17,10,965,5,46,3055,46,370,5,91,3055,91,595
3.769,17,5,290,5,30,942,30,290,0,0,0,0,0
170.217,17,4,240,2,32,170216,32,120,2,32,170216,32,120
189.038,6,48,9424,18,132,7409,267,2055,30,246,6518,1452,7369
1778.138,17,142,11360,71,48,25401,48,5396,71,56,25401,56,5964
1787.48,6,104,8308,68,64,26678,64,4896,36,58,51068,58,3412
17.276,17,4,830,2,43,17271,43,142,2,316,17272,316,688
7.148,17,27,12136,11,552,710,1350,6382,16,331,474,1350,5754
83.886,6,10629,11731889,3704,191,22,423,207692,6925,1613,12,8688,11524197
1.636,6,50,19839,29,923,58,1360,14178,21,480,71,4075,5661
1.11,6,25,8056,12,164,85,267,1288,13,869,78,1402,6768
1203.269,2,16,512,16,8,80217,8,512,0,0,0,0,0
1786.026,6,111,9294,70,70,25884,273,5283,41,64,44648,247,4011
0.489,6,56,25680,31,1010,16,1380,18503,25,558,18,1923,7177
155.765,17,6,528,3,48,77878,48,228,3,72,77878,72,300
61.417,6,11,2994,5,92,15354,92,348,6,1165,12219,1448,2646
0.469,6,21,7203,13,318,39,600,1958,8,1607,64,3299,5245
0.014,6,2,123,1,0,0,0,40,1,31,0,31,83
4.754,6,38,7245,19,218,264,314,3383,19,516,249,1179,3862
1.444,6,24,8004,12,164,113,267,1288,12,1014,111,2491,6716
1786.943,6,159,25854,94,483,19214,483,19881,65,83,27920,83,5973
1786.676,6,102,8296,68,65,26666,65,4930,34,59,54139,59,3366
6.309,6,65,20102,32,562,203,1152,15339,33,491,189,1179,4763
1789.215,17,87,3648,86,14,21049,14,3612,1,8,0,8,36
124.215,17,4,304,2,48,124208,48,152,2,48,124207,48,152
1702.529,17,12,498,11,14,170252,14,462,1,8,0,8,36
0.001,6,2,80,2,0,0,0,80,0,0,0,0,0
0.054,17,2,224,1,58,0,58,86,1,110,0,110,138
1795.239,17,80,3354,79,14,23015,14,3318,1,8,0,8,36
366.966,6,18,1239,14,177,28228,177,913,4,110,22216,110,326
1746.717,6,102,8001,65,45,27292,205,4850,37,35,48512,98,3151
1799.998,6,212,16438,79,69,23076,313,7844,133,48,13636,78,8594
1.629,6,41,11378,22,547,77,1360,5842,19,433,77,1360,5536
70.85,6,9,468,9,0,0,0,468,0,0,0,0,0
91.091,6,17,1597,10,182,5737,182,920,7,96,14849,134,677
1746.719,6,95,7203,63,38,28172,205,4476,32,33,56335,98,2727
240.413,6,47,18582,24,1040,10452,1408,15821,23,194,10927,580,2761
0.651,6,17,4194,10,119,72,267,999,7,970,84,1380,3195
242.558,6,51,7117,23,209,11025,585,3152,28,166,8983,580,3965
0.379,17,7,2438,7,320,63,354,2438,0,0,0,0,0
14.196,6,14,2242,8,210,2019,210,844,6,545,2834,904,1398
1780.487,17,142,11360,71,48,25435,48,5396,71,56,25435,56,5964
125.203,2,2,64,2,8,125203,8,64,0,0,0,0,0
1786.479,17,87,3648,86,14,21017,14,3612,1,8,0,8,36
300.694,6,34,8435,19,204,16705,467,1872,15,481,4873,1408,6563
126.079,6,169,134989,108,1296,1178,1408,122306,61,731,2097,3847,12683
98.183,6,43,8300,16,131,6365,267,1702,27,393,3775,1452,6598
0.056,17,4,350,2,34,0,34,124,2,85,0,91,226
0.21,6,28,7336,13,155,17,267,1301,15,543,13,1400,6035
0.432,17,15,8367,8,705,61,1350,5871,7,328,63,1350,2496
372.147,6,18,1242,14,180,28626,180,916,4,110,20065,110,326
61.006,6,10,884,5,226,15251,226,506,5,110,15167,110,378
201.473,6,278,221192,171,1310,1185,1368,204202,107,646,1776,2519,16990
11.713,6,1897,1618658,1143,1363,10,1380,1584211,754,387,15,1923,34447
1787.226,6,362,22898,210,69,8551,69,12678,152,69,11835,69,10220
1783.034,6,355,22480,207,69,8655,69,12420,148,69,12129,69,10060
0.017,17,2,443,1,40,0,40,68,1,347,0,347,375
1791.768,6,381,78341,171,366,10539,1460,51937,210,179,8572,1642,26404
1746.733,6,95,7203,63,38,28173,205,4476,32,33,56335,98,2727
1761.748,17,329,66573,329,174,5371,422,66573,0,0,0,0,0
0.151,6,7,423,4,43,38,43,259,3,0,24,0,164
287.528,17,4,352,2,60,287527,60,176,2,60,287527,60,176
1680.722,17,13,534,11,14,168053,14,462,2,8,1680529,8,72
1.882,17,4,314,2,31,1870,31,118,2,70,1860,70,196
1789.166,17,142,11360,71,48,25559,48,5396,71,56,25559,56,5964
280.52,6,30,7432,13,158,23376,267,1317,17,543,17527,1400,6115
17.869,17,34,12989,17,404,1114,1350,7347,17,303,1114,1350,5642
397.784,6,44,19411,29,299,14206,1360,5686,15,1192,48,2720,13725
1787.204,1,246,13776,246,28,7294,28,13776,0,0,0,0,0
56.139,17,4,240,2,32,56138,32,120,2,32,56138,32,120
1672.454,1,8,448,8,28,238922,28,448,0,0,0,0,0
0.394,6,26,9026,13,263,32,691,1736,13,943,31,1438,7290
97.346,17,4,240,2,32,97345,32,120,2,32,97345,32,120
631.361,6,44,8307,27,132,14650,498,2668,17,330,39454,1420,5639
1.17,6,23,7952,11,164,99,267,1236,12,1014,90,2423,6716
124.619,1,9,756,9,56,15577,56,756,0,0,0,0,0
13.573,6,4,168,3,0,6786,0,124,1,0,0,0,44
9.256,6,1474,1257853,892,1362,10,1380,1228363,582,515,15,1923,29490
1.372,6,50,19471,27,904,52,1460,13775,23,433,53,1460,5696
1786.795,6,104,8376,68,65,26668,65,4930,36,59,51046,59,3446
1699.031,1,8,848,8,78,242718,78,848,0,0,0,0,0
286.112,17,2,768,2,356,286112,356,768,0,0,0,0,0
85.65,6,22,9131,11,419,71,955,1730,11,992,8551,1460,7401
280.325,6,30,7432,13,158,23360,267,1317,17,543,17514,1300,6115
0.127,1,2,112,2,28,127,28,112,0,0,0,0,0
0.914,6,25,9560,14,351,70,1045,1996,11,1016,73,1460,7564
1775.381,1,60,5040,0,0,0,0,0,60,56,30091,56,5040
772.981,6,134,16140,67,138,11711,1189,6141,67,203,7505,1460,9999
2.512,17,2,178,1,29,0,29,57,1,93,0,93,121
116.362,6,127,95409,79,1260,1491,1408,84791,48,811,2471,3847,10618
1786.899,6,106,8524,68,66,26670,66,4964,38,60,48286,60,3560
1.687,6,27,10191,16,287,112,593,1505,11,1030,151,1420,8686
0.821,6,23,5482,13,125,66,212,1026,10,675,88,1460,4456
1.564,6,46,18120,26,882,62,1360,12544,20,476,71,2715,5576
0.077,17,4,284,2,32,25,32,120,2,54,53,60,164
77.517,6,109,17218,56,304,1409,304,11832,53,83,1480,83,5386
5.211,6,32,6089,17,206,325,314,2744,15,548,352,1179,3345
2.419,6,61,23785,33,962,75,1460,14882,28,485,82,1460,8903
0.803,17,28,20349,16,933,51,1350,15380,12,386,69,1350,4969
2.132,17,4,518,3,39,805,39,201,1,289,0,289,317
87.334,17,6,528,3,60,43666,60,264,3,60,43666,60,264
0.126,17,2,157,1,31,0,31,59,1,70,0,70,98
0.01,17,3,370,2,34,0,34,124,1,218,0,218,246
269.215,6,66,45587,43,1180,6409,1368,37655,23,747,2814,1368,7932
64.183,6,74,49390,46,1175,1426,1408,41201,28,960,2282,3847,8189
36.075,6,51,16097,23,560,1639,1360,2788,28,579,1327,1360,13309
360.071,1,3,168,3,28,180035,28,168,0,0,0,0,0
11.757,6,20,8164,11,275,1175,275,998,9,1358,1341,1420,7166
1105.164,17,216,16416,216,48,5140,48,16416,0,0,0,0,0
10.259,6,82,24501,42,533,250,1152,18760,40,459,255,1179,5741
1772.09,6,180,15480,120,69,14891,69,8940,60,69,30033,69,6540
280.475,6,30,7432,13,158,23372,267,1317,17,603,17527,2760,6115
1784.2,6,102,8296,68,65,26629,65,4930,34,59,54063,59,3366
1795.563,1,57,4788,57,56,32063,56,4788,0,0,0,0,0
1784.23,17,142,11360,71,48,25488,48,5396,71,56,25488,56,5964
0.553,6,3,156,1,0,0,0,40,2,0,122,0,116
1063.255,6,57,4161,32,31,34293,31,2160,25,31,44295,31,2001
21.122,6,20,3130,12,183,1920,517,1561,8,381,3015,499,1569
2.916,6,29,9050,17,371,182,845,1797,12,846,255,1380,7253
1732.792,6,88,16864,54,118,32694,1440,5797,34,343,52503,1440,11067
0.085,17,4,288,2,36,39,36,128,2,52,53,52,160
0.093,6,9,1340,5,145,23,145,349,4,827,29,827,991
23.899,6,33,8958,15,327,142,1189,2575,18,471,1405,1420,6383
230.197,17,4,352,2,48,230186,48,152,2,72,230185,72,200
0.013,17,2,384,1,32,0,32,60,1,296,0,296,324
1747.988,1,79,4424,79,28,22410,28,4424,0,0,0,0,0
1741.066,6,90,6521,59,31,30018,31,3998,31,31,58033,31,2523
1.381,6,45,15410,24,800,60,1460,9794,21,433,57,1460,5616
285.953,17,2,122,2,33,285953,33,122,0,0,0,0,0
1771.298,6,101,9344,66,65,27250,65,5577,35,59,52094,59,3767
18.579,17,21,5523,10,255,2061,1350,2834,11,216,1854,1350,2689
60.234,6,7,380,5,0,15058,0,268,2,0,60017,0,112
536.75,17,26,1976,26,48,21470,48,1976,0,0,0,0,0
0.183,6,43,19123,25,1012,7,1420,14182,18,467,10,1883,4941
0.015,6,4,222,2,31,15,31,111,2,31,2,31,111
1.117,6,11,1864,6,262,223,517,844,5,752,277,752,1020
0.164,6,43,20683,26,1051,6,1420,15782,17,526,9,3303,4901
0.012,17,3,576,2,60,0,60,176,1,372,0,372,400
0.278,17,14,5174,6,366,55,1350,2366,8,323,28,1350,2808
1777.751,17,73,3060,72,14,25038,14,3024,1,8,0,8,36
0.465,6,10,968,5,256,113,256,460,5,304,113,304,508
1792.75,1,124,6944,124,28,14575,28,6944,0,0,0,0,0
1786.18,6,104,8376,68,65,26659,65,4930,36,59,51030,59,3446
1745.023,6,97,7307,63,38,28145,205,4476,34,33,52869,98,2831
0.465,17,2,784,2,364,465,364,784,0,0,0,0,0
1787.089,17,87,3648,86,14,21024,14,3612,1,8,0,8,36
1.305,6,47,19207,27,894,50,1440,13631,20,433,59,1440,5576
10.975,17,2,672,2,308,10975,308,672,0,0,0,0,0
59.406,6,47,9132,22,401,680,889,2224,25,346,2469,2128,6908
1741.718,6,87,6322,58,31,30556,31,3915,29,31,62203,31,2407
1741.346,6,92,6668,60,31,29514,31,4062,32,31,56171,31,2606
2.159,6,15,7123,7,272,359,516,1100,8,949,289,1452,6023
100.554,6,29,12012,16,388,6703,800,2612,13,985,8367,1360,9400
1772.509,6,201,22279,129,75,13847,267,10017,72,137,24958,3426,12262
1798.336,17,449,39928,404,35,4462,288,25708,45,288,40022,288,14220
0.333,6,4,160,2,0,165,0,80,2,0,169,0,80
300.807,6,29,16117,17,195,18800,431,1684,12,1380,6447,4154,14433
1764.449,2,12,384,12,8,160404,8,384,0,0,0,0,0
1797.109,17,449,39928,404,35,4459,288,25708,45,288,40018,288,14220
1638.005,1,8,448,8,28,234000,28,448,0,0,0,0,0
1799.897,17,775,46742,775,32,2325,37,46742,0,0,0,0,0
150.405,6,29,13436,15,488,346,1360,3075,14,1223,11556,2720,10361
1788.884,17,140,11200,70,48,25925,48,5320,70,56,25925,56,5880
1796.602,6,356,22520,208,69,8679,69,12460,148,69,12221,69,10060
1786.765,6,107,8486,68,64,26668,64,4896,39,58,47017,58,3590
3.526,17,5,556,4,64,1168,64,368,1,160,0,160,188
3.619,17,5,295,5,31,904,31,295,0,0,0,0,0
1775.034,17,140,11200,70,48,25725,48,5320,70,56,25725,56,5880
991.571,6,414,28227,210,31,4744,62,14435,204,31,4735,31,13792
135.696,6,28,10548,13,431,51,1360,2279,15,850,9683,2720,8269
1796.536,6,755,57021,382,38,4715,1448,27174,373,53,4829,1983,29847
1.706,6,26,8797,16,284,113,584,1496,10,985,168,1420,7301
247.055,17,2,368,2,156,247055,156,368,0,0,0,0,0
15.177,6,42,7389,20,218,275,314,3423,22,513,710,1179,3966
4.498,6,29,6157,16,154,299,267,1728,13,780,339,1460,4429
41.654,6,32,11642,13,372,2352,808,1680,19,1021,2306,1460,9962
61.348,6,37,15894,22,796,2921,1448,9115,15,665,4363,1448,6779
1735.505,2,14,448,14,8,133500,8,448,0,0,0,0,0
2.439,2,2,64,2,8,2439,8,64,0,0,0,0,0
6.0,6,44,8369,21,227,300,314,4022,23,489,259,1179,4347
174.199,1,22,1232,22,28,8295,28,1232,0,0,0,0,0
0.001,6,2,144,1,0,0,0,40,1,64,0,64,104
0.277,6,27,9066,13,247,23,624,1696,14,947,20,1408,7370
20.164,6,8,506,0,0,0,0,0,8,31,2880,31,506
2.096,17,2,685,1,308,0,308,336,1,321,0,321,349
1795.099,1,167,17702,167,78,10813,78,17702,0,0,0,0,0
6.327,6,1567,1443587,987,1385,6,1408,1408763,580,931,10,2801,34824
1.278,6,47,18637,27,853,49,1360,13061,20,476,58,2715,5576
0.497,6,54,22936,30,967,17,1380,15811,24,558,19,1923,7125
1742.811,6,98,7359,63,38,28109,205,4476,35,33,51250,98,2883
1772.617,6,180,15480,120,69,14895,69,8940,60,69,30039,69,6540
0.462,6,9,1340,5,145,115,145,349,4,827,151,827,991
0.34,17,2,167,1,39,0,39,67,1,72,0,72,100
0.025,6,12,3644,6,99,4,99,419,6,968,4,1448,3225
0.193,17,4,560,2,64,192,64,184,2,160,82,160,376
8.296,6,22,9370,11,275,829,275,723,11,1170,784,1414,8647
1793.287,17,75,3141,73,13,24906,14,3061,2,12,135298,16,80
0.338,17,2,136,1,32,0,32,60,1,48,0,48,76
7.961,6,14,1247,7,222,1325,222,728,7,231,1325,231,519
23.126,6,30,6246,17,286,1445,1314,2405,13,414,498,1401,3841
1797.202,1,225,12600,225,28,8023,28,12600,0,0,0,0,0
1768.679,1,119,6664,119,28,14988,28,6664,0,0,0,0,0
3.017,17,2,152,2,48,3017,48,152,0,0,0,0,0
4.069,17,12,11344,4,708,1356,1350,2945,8,1021,547,1350,8399
8.945,6,3,180,3,0,0,0,180,0,0,0,0,0
2.169,6,6,340,3,0,1084,0,160,3,0,507,0,180
470.493,6,44,7824,27,120,18095,502,2414,17,337,29400,1420,5410
1799.031,6,362,22898,210,69,8607,69,12678,152,69,11914,69,10220
0.049,17,2,187,1,45,0,45,73,1,86,0,86,114
0.514,17,2,476,1,39,0,39,67,1,381,0,381,409
3.36,6,2,88,2,0,0,0,88,0,0,0,0,0
81.507,6,45,7509,20,218,253,314,3423,25,513,3385,1179,4086
0.537,17,8,2758,8,316,76,355,2758,0,0,0,0,0
0.018,17,4,288,2,33,0,33,122,2,55,1,61,166
1741.184,17,29,6699,29,203,62185,203,6699,0,0,0,0,0
1776.904,17,73,3060,72,14,25026,14,3024,1,8,0,8,36
85.121,6,27,7448,7,155,13860,267,1066,20,348,4477,2077,6382
7.558,17,16,1344,8,45,1078,45,584,8,67,1078,73,760
1772.015,6,180,15480,120,69,14890,69,8940,60,69,30033,69,6540
119.04,6,53,10457,22,249,5668,1189,3131,31,319,3966,1420,7326
3.448,6,7,280,4,0,1149,0,160,3,0,1309,0,120
11.24,6,27,11355,13,275,936,275,1078,14,1078,835,1414,10277
1105.926,6,223,16440,128,119,8292,469,9880,95,69,11765,69,6560
165.516,1,6,336,6,28,33103,28,336,0,0,0,0,0
112.852,17,4,1344,4,308,37617,308,1344,0,0,0,0,0
10.649,6,18,5610,10,275,1183,275,958,8,1440,805,1440,4652
1798.256,17,449,39928,404,35,4462,288,25708,45,288,40018,288,14220
1260.051,2,8,256,8,8,180007,8,256,0,0,0,0,0
0.261,6,23,7313,12,176,23,331,1336,11,1079,24,1588,5977
1777.031,1,342,28728,342,56,5211,56,28728,0,0,0,0,0
1.323,6,46,17930,26,867,52,1360,12354,20,476,60,2715,5576
56.3,6,59,7358,27,161,2165,630,3200,32,154,1813,580,4158
29.367,17,14,7736,8,655,4195,1350,5471,6,349,53,1350,2265
1772.119,6,180,15480,120,69,14891,69,8940,60,69,30031,69,6540
1792.412,6,112,7119,67,45,27157,208,4358,45,31,40727,31,2761
8.29,6,1895,1721184,1179,1380,6,1408,1679288,716,931,11,2816,41896
0.059,6,10,1173,6,160,11,160,480,4,477,13,477,693
1682.841,17,14,1036,7,30,280463,30,406,7,62,280459,62,630
15.995,17,22,9082,12,538,1451,1350,6799,10,200,1774,1350,2283
1781.765,6,360,24156,210,88,8525,469,13878,150,69,11958,69,10278
282.519,6,30,7432,13,158,23543,267,1317,17,543,17654,1400,6115
1781.758,6,279,33962,114,141,15766,1440,16794,165,128,10863,1702,17168
1796.699,1,76,6384,0,0,0,0,0,76,56,23955,56,6384
0.009,6,2,88,1,0,0,0,48,1,0,0,0,40
12.789,6,1930,1762545,1244,1363,10,1420,1730730,686,475,18,1883,31815
0.082,6,2,175,1,0,0,0,40,1,83,0,83,135
1.461,6,50,21483,29,917,52,1360,15867,21,476,63,2715,5616
0.76,17,4,768,2,39,755,39,134,2,289,755,289,634
1793.297,6,357,22629,208,69,8663,69,12460,149,69,12116,69,10169
4.731,6,36,7149,18,218,278,314,3343,18,513,263,1179,3806
1740.541,17,30,7050,30,207,60018,207,7050,0,0,0,0,0
0.507,17,2,384,1,39,0,39,67,1,289,0,289,317
2.184,17,27,11757,12,557,198,1350,7027,15,287,142,1350,4730
1630.248,1,8,448,8,28,232892,28,448,0,0,0,0,0
290.276,17,4,352,2,60,290275,60,176,2,60,290275,60,176
1680.251,1,7,742,7,78,280041,78,742,0,0,0,0,0
1798.489,17,448,39612,404,35,4462,288,25708,44,288,40948,288,13904
115.513,1,4,224,4,28,38504,28,224,0,0,0,0,0
1734.592,17,108,20585,108,162,16211,422,20585,0,0,0,0,0
1771.892,6,102,9643,68,68,26446,232,5880,34,58,53691,81,3763
12.756,6,1889,1668287,1172,1369,10,1380,1633677,717,383,17,1380,34610
280.258,6,29,7392,13,158,23354,267,1317,16,603,18677,1400,6075
0.293,17,2,154,1,33,0,33,61,1,65,0,65,93
1784.974,17,128,10240,64,48,28332,48,4864,64,56,28332,56,5376
16.93,6,14,5729,8,290,2418,517,1005,6,1101,141,1408,4724
0.922,2,3,96,3,8,461,8,96,0,0,0,0,0
1.306,6,44,10157,23,440,59,1360,4496,21,400,56,1360,5661
1787.148,17,87,3648,86,14,21025,14,3612,1,8,0,8,36
0.202,6,3,120,2,0,202,0,80,1,0,0,0,40
4.021,17,20,6963,9,430,502,1350,4124,11,230,398,1350,2839
189.752,6,34,7412,15,201,4007,498,1814,19,302,10536,1420,5598
61.607,6,51,28506,31,1043,2053,1408,21467,20,665,3231,1408,7039
79.596,6,756,349743,385,838,207,1152,329057,371,417,214,1179,20686
0.006,17,3,543,2,39,0,39,134,1,381,0,381,409
851.165,6,939,735344,423,131,2016,349,28727,516,1413,1652,5672,706617
1144.545,6,228,14433,132,69,8736,69,7971,96,69,12047,69,6462
191.684,6,83,59188,53,1203,3686,1368,50893,30,747,2132,1368,8295
1783.304,17,110,20784,110,160,16360,422,20784,0,0,0,0,0
168.756,6,25,4374,7,92,569,92,464,18,198,9916,1408,3910
1793.035,17,407,35460,368,34,4885,288,23136,39,288,46336,288,12324
1796.345,6,253,25682,103,67,17609,659,9582,150,131,12054,2720,16100
1796.482,6,373,26028,216,98,8355,469,15263,157,69,11514,69,10765
50.657,6,36,8272,17,349,543,731,1759,19,441,2806,1460,6513
1773.202,6,180,15480,120,69,14900,69,8940,60,69,30045,69,6540
19.22,17,30,6202,15,209,1370,1350,3569,15,147,1370,1350,2633
77.043,6,22,8174,11,520,94,1223,2034,11,948,7687,1631,6140
0.172,17,2,362,1,46,0,46,74,1,260,0,260,288
0.044,17,4,288,2,33,2,33,122,2,55,6,61,166
1788.053,6,357,22629,208,69,8637,69,12460,149,69,12081,69,10169
1.36,6,40,10551,21,517,68,1460,5015,19,433,65,1460,5536
0.035,17,4,608,2,60,0,60,176,2,188,0,188,432
37.928,17,22,1936,11,48,3791,48,836,11,72,3791,72,1100
1.357,6,47,19586,27,920,52,1360,14010,20,476,61,2715,5576
47.041,17,89,53425,50,919,959,1350,47392,39,126,1237,1350,6033
35.801,6,38,8535,18,410,1233,882,1982,20,441,1877,1440,6553
1786.867,6,102,8364,68,66,26669,66,4964,34,60,54144,60,3400
280.193,6,29,7392,13,158,23349,267,1317,16,603,18676,2036,6075
1.48,6,30,12063,16,525,98,1360,3310,14,909,82,1380,8753
3.94,6,2,88,2,0,0,0,88,0,0,0,0,0
7.819,6,42,7778,22,218,372,314,3503,20,495,395,1179,4275
50.54,6,18,5405,7,142,8423,174,710,11,707,2506,1452,4695
139.201,6,30,7432,13,158,11600,267,1317,17,543,8694,1400,6115
0.685,6,10,924,5,283,114,283,551,5,105,115,105,373
1.156,17,28,17136,15,840,82,1350,13022,13,288,69,1350,4114
10.967,6,86,26573,45,548,249,1152,20451,41,447,267,1179,6122
1796.172,6,393,27642,226,102,7982,469,16408,167,67,10819,69,11234
48.297,6,29,7257,13,155,4024,267,1306,16,441,3219,1420,5951
1783.833,6,416,24920,208,69,8617,69,12460,208,34,8617,48,12460
394.779,6,21,1407,13,177,32898,177,873,8,110,10256,110,534
1787.221,6,104,8444,68,66,26674,66,4964,36,60,51059,60,3480
31.297,6,9,520,3,0,15648,0,160,6,0,3237,0,360
2.025,1,3,252,3,56,1012,56,252,0,0,0,0,0
240.322,6,44,8447,22,449,11443,1408,5648,22,205,11443,580,2799
1680.467,1,14,784,14,28,129266,28,784,0,0,0,0,0
1740.022,17,26,1482,26,29,69600,29,1482,0,0,0,0,0
324.199,6,47,8038,25,134,13508,516,2216,22,290,15432,1452,5822
1785.898,1,342,28728,342,56,5237,56,28728,0,0,0,0,0
781.707,6,78,9050,41,91,19542,722,3973,37,125,21708,1448,5077
1753.333,1,56,4704,56,56,31878,56,4704,0,0,0,0,0
1.394,6,41,11378,21,616,69,1460,5802,20,433,63,1460,5576
9.136,6,71,20646,38,512,246,1152,15883,33,491,277,1179,4763
1799.063,6,78,4108,39,26,47342,26,2054,39,26,47342,26,2054
0.56,6,10,968,5,256,138,256,460,5,304,138,304,508
6.51,6,1292,1163633,798,1380,7,1408,1133281,494,931,12,2816,30352
64.643,17,4,352,2,60,64642,60,176,2,60,64642,60,176
1773.57,6,180,15480,120,69,14903,69,8940,60,69,30053,69,6540
1699.428,17,12,498,11,14,169942,14,462,1,8,0,8,36
2.183,6,25,5795,13,158,181,370,1315,12,799,197,1452,4480
6.514,6,1264,1142325,783,1381,8,1408,1112649,481,931,13,2816,29676
0.008,17,2,154,1,33,0,33,61,1,65,0,65,93
1774.854,6,244,25039,99,66,18109,594,9275,145,138,12324,4658,15764
2.5,17,8,1376,4,36,831,36,256,4,252,831,318,1120
15.404,6,13,760,5,0,3851,0,280,8,0,2179,0,480
61.289,6,35,15923,22,809,2918,1408,9249,13,855,5087,3847,6674
241.776,6,29,7392,13,158,20148,267,1317,16,603,16116,2036,6075
10.247,6,86,26461,45,545,232,1152,20339,41,447,249,1179,6122
1773.997,6,190,16225,124,69,14422,69,9169,66,69,27289,69,7056
50.502,1,4,517,4,101,16834,177,517,0,0,0,0,0
1743.918,6,144,12794,77,94,22946,205,7885,67,31,26416,33,4909
0.134,1,2,112,2,28,134,28,112,0,0,0,0,0
32.105,6,40,10048,18,149,1888,267,1920,22,556,1524,1420,8128
16.127,17,4,304,2,48,16117,48,152,2,48,16116,48,152
1796.915,1,345,28980,345,56,5223,56,28980,0,0,0,0,0
317.056,6,42,11871,22,267,15097,1305,3316,20,553,16679,4649,8555
240.216,6,53,17555,28,779,8896,1418,14716,25,191,10008,580,2839
0.95,17,2,312,2,128,950,128,312,0,0,0,0,0
0.254,6,9,1002,5,213,63,213,417,4,421,64,421,585
0.023,17,2,405,1,34,0,34,62,1,315,0,315,343
0.036,17,2,211,1,45,0,45,73,1,110,0,110,138
11.642,6,1858,1603849,1114,1384,10,1420,1569844,744,467,15,1883,34005
125.71,6,63,14925,30,145,4334,580,4624,33,659,3928,2039,10301
0.909,17,16,10309,9,887,109,1350,8240,7,267,145,1350,2069
238.773,17,6,7180,6,1168,47754,1451,7180,0,0,0,0,0
1772.479,6,180,15480,120,69,14894,69,8940,60,69,30041,69,6540
10.99,6,20,4442,11,275,1099,275,998,9,768,785,1440,3444
1.423,6,40,9928,21,440,71,1360,4392,19,476,67,2715,5536
3.233,17,3,228,2,48,2989,48,152,1,48,0,48,76
349.51,1,8,448,8,28,49930,28,448,0,0,0,0,0
154.89,17,3,1008,3,308,77445,308,1008,0,0,0,0,0
1458.699,1,47,3948,47,56,31710,56,3948,0,0,0,0,0
840.627,17,8,592,4,30,280201,30,232,4,62,280202,62,360
243.931,17,4,240,2,32,243930,32,120,2,32,243929,32,120
19.011,17,20,14068,11,936,1897,1350,10612,9,356,2372,1350,3456
19.723,6,22,4749,11,232,1972,722,1731,11,810,1914,2328,3018
112.993,6,237,178113,123,888,43,1460,11192,114,1517,997,3400,166921
300.771,6,38,8638,18,308,17684,889,2023,20,414,15822,2720,6615
0.155,17,2,152,1,48,0,48,76,1,48,0,48,76
154.654,6,24,6248,9,272,998,516,1180,15,372,11039,1452,5068
0.675,17,2,204,1,34,0,34,62,1,114,0,114,142
11.844,6,1880,1638076,1113,1416,10,1432,1603163,767,420,15,1432,34913
1786.939,6,102,8296,68,65,26670,65,4930,34,59,54146,59,3366
365.671,6,23,1538,16,180,24378,180,1056,7,110,10359,110,482
5.007,17,4,288,2,36,4953,36,128,2,52,4959,52,160
1798.244,17,1062,335236,507,565,3528,1350,301106,555,33,3245,1350,34130
0.41,6,12,1653,6,288,79,288,548,6,426,46,434,1105
299.584,6,6,364,4,31,99861,31,222,2,31,299540,31,142
3.013,2,2,64,2,8,3013,8,64,0,0,0,0,0
82.113,17,6,360,3,32,41056,32,180,3,32,41056,32,180
1798.677,6,367,25650,214,99,8444,469,15045,153,69,11832,69,10605
1.278,6,38,9848,20,502,67,1460,4352,18,433,65,1460,5496
0.128,17,3,305,2,32,1,32,120,1,157,0,157,185
1774.936,1,58,4872,58,56,31139,56,4872,0,0,0,0,0
9.813,2,2,64,2,8,9813,8,64,0,0,0,0,0
2.341,6,26,6767,14,350,179,1089,2316,12,661,211,1420,4451
27.876,17,8,608,8,48,3982,48,608,0,0,0,0,0
0.458,6,12,1653,6,288,88,288,548,6,426,50,434,1105
0.114,17,2,144,1,36,0,36,64,1,52,0,52,80
0.046,17,4,420,2,33,0,33,122,2,121,8,145,298
0.013,17,2,384,1,32,0,32,60,1,296,0,296,324
48.679,6,28,7217,13,155,4056,267,1306,15,482,3475,1420,5911
5.058,17,3,208,2,36,5002,36,128,1,52,0,52,80
11.117,6,30,7466,16,380,741,885,3491,14,645,839,1767,3975
1792.49,6,356,22520,208,69,8659,69,12460,148,69,12193,69,10060
0.039,17,2,190,1,59,0,59,87,1,75,0,75,103
3.555,6,169,170933,128,967,27,1360,16775,41,5083,85,28560,154158
915.439,1,28,1568,28,28,33905,28,1568,0,0,0,0,0
0.073,6,11,911,6,181,14,181,489,5,77,14,133,422
1.127,17,8,1718,4,37,372,37,260,4,336,371,348,1458
1.682,6,48,19295,27,897,64,1360,13679,21,476,71,2715,5616
7.83,17,37,12988,12,447,710,1350,5705,25,263,324,1350,7283
126.173,17,4,318,2,34,126160,37,125,2,68,126161,77,193
18.951,6,2736,2345163,1561,1409,12,1448,2269691,1175,776,15,1448,75472
289.511,17,4,604,4,123,96503,348,604,0,0,0,0,0
1776.286,17,73,3060,72,14,25018,14,3024,1,8,0,8,36
0.506,17,2,384,1,39,0,39,67,1,289,0,289,317
1781.215,6,360,22818,209,69,8563,69,12638,151,69,11874,69,10180
1792.526,6,356,22520,208,69,8659,69,12460,148,69,12193,69,10060
8.18,6,18,6791,9,275,1022,275,643,9,1155,894,1420,6148
26.547,6,41,14170,20,186,1397,721,2479,21,1084,1305,2840,11691
1791.472,17,144,11520,72,48,25231,48,5472,72,56,25231,56,6048
0.054,6,3,160,2,0,54,0,100,1,0,0,0,60
1720.428,17,12,498,11,14,172042,14,462,1,8,0,8,36
788.739,6,121,18812,61,102,13142,721,6528,60,449,13360,1440,12284
1786.403,17,87,3648,86,14,21016,14,3612,1,8,0,8,36
1774.7,6,180,15480,120,69,14913,69,8940,60,69,30077,69,6540
0.009,17,2,152,1,48,0,48,76,1,48,0,48,76
1773.199,6,180,15480,120,69,14900,69,8940,60,69,30046,69,6540
300.594,6,37,8526,19,315,16699,882,2053,18,441,497,1440,6473
93.918,6,22,8758,11,316,83,640,1421,11,983,9376,1360,7337
37.929,17,22,1936,11,48,3792,48,836,11,72,3791,72,1100
178.318,6,26,10298,13,561,49,1360,2799,13,995,14849,1360,7499
2.003,17,24,10876,11,605,200,1350,6971,13,272,150,1350,3905
10.773,6,20,4442,11,275,1077,275,998,9,768,744,1440,3444
2.723,6,2,88,2,0,0,0,88,0,0,0,0,0
4.279,17,6,536,5,40,1069,40,340,1,168,0,168,196
0.952,6,23,6376,13,299,79,838,2019,10,988,104,1731,4357
10.445,2,4,128,4,8,3481,8,128,0,0,0,0,0
0.246,6,23,4494,11,165,24,456,1394,12,493,21,888,3100
20.277,6,12,1313,7,185,3379,185,557,5,244,5053,476,756
1793.104,17,180,11520,180,36,10017,36,11520,0,0,0,0,0
367.118,6,25,1651,17,177,22944,177,1117,8,110,9177,110,534
4.58,6,23,4490,12,213,416,597,1701,11,441,438,1408,2789
1.448,6,50,19824,28,867,53,1360,14168,22,476,59,2715,5656
280.046,6,26,7272,12,158,25458,267,1277,14,775,21538,2800,5995
138.237,17,6,1236,3,48,69115,48,228,3,308,69116,308,1008
1727.621,17,12,498,11,14,172762,14,462,1,8,0,8,36
1.491,6,37,13182,19,225,82,561,2193,18,932,77,1440,10989
743.518,6,158,9866,84,69,8392,69,5085,74,53,10185,69,4781
43.268,6,27,7177,13,155,3605,267,1306,14,530,3327,3417,5871
14.441,6,31,17601,18,708,849,1360,4294,13,1596,1189,4416,13307
31.172,17,10,760,10,48,3463,48,760,0,0,0,0,0
1.008,6,3,160,2,0,976,0,120,1,0,0,0,40
180.75,2,3,96,3,8,90375,8,96,0,0,0,0,0
1747.035,6,95,7203,63,38,28177,205,4476,32,33,56342,98,2727
18.397,6,2796,2639060,1822,1372,10,1408,2583748,974,931,18,2801,55312
101.282,6,52,16049,22,146,4816,512,2834,30,610,3487,1639,13215
1787.826,6,363,24814,212,94,8473,469,14427,151,69,11916,69,10387
57.267,6,8,432,5,0,14316,0,268,3,0,28618,0,164
0.005,17,4,288,2,33,1,33,122,2,55,1,61,166
84.92,17,4,352,2,60,84918,60,176,2,60,84919,60,176
0.291,17,2,290,1,40,0,40,68,1,194,0,194,222
4.91,6,36,6249,18,206,288,314,2784,18,456,274,1152,3465
90.895,6,38,11834,19,560,5042,1166,4917,19,423,5042,1559,6917
10.794,6,1612,1476389,1043,1363,10,1420,1449302,569,475,18,1883,27087
0.935,6,30,8240,15,222,55,540,1964,15,809,54,1460,6276
0.272,6,152,327999,71,201,3,486,4505,81,4146,2,12672,323494
2.203,6,411,372364,168,343,13,344,12222,243,1441,8,2896,360142
0.219,2,2,80,2,16,219,16,80,0,0,0,0,0
172.425,6,24,10407,13,721,217,1309,3437,11,931,17225,1591,6970
0.065,17,2,179,1,32,0,32,60,1,91,0,91,119
0.007,17,2,306,1,33,0,33,61,1,217,0,217,245
1794.254,1,59,4956,59,56,30935,56,4956,0,0,0,0,0
1773.251,6,181,15589,120,69,14901,69,8940,61,69,29549,69,6649
1798.354,17,449,39928,404,35,4462,288,25708,45,288,40014,288,14220
0.916,6,10,1687,7,100,152,100,384,3,1179,326,1179,1303
15.041,6,2077,1921005,1293,1407,11,1448,1875549,784,776,18,1448,45456
7.115,6,18,2300,9,210,889,210,734,9,545,879,904,1566
10.854,6,20,7026,11,275,1085,275,998,9,1414,758,1414,6028
1.337,6,45,18263,27,832,51,1360,12767,18,529,67,4075,5496
5.675,6,40,7309,20,218,298,314,3423,20,513,283,1179,3886
280.428,6,29,7392,13,158,23369,267,1317,16,603,18693,2076,6075
39.97,17,8,1176,4,48,13317,48,304,4,190,13317,308,872
7.656,17,6,528,3,48,3822,48,228,3,72,3821,72,300
280.031,6,28,7352,12,158,25457,267,1277,16,603,18666,2036,6075
60.375,6,14,3888,8,127,8625,127,467,6,1056,12065,1704,3421
1783.194,17,83,3480,82,14,22014,14,3444,1,8,0,8,36
0.007,17,2,186,1,33,0,33,61,1,97,0,97,125
1680.538,1,13,754,13,30,140044,30,754,0,0,0,0,0
0.589,6,13,4758,7,290,98,517,941,6,1165,114,1499,3817
504.293,6,32,5787,17,260,31518,1382,2504,15,297,36019,1460,3283
1744.655,2,30,960,30,8,60160,8,960,0,0,0,0,0
1680.828,1,15,840,15,28,120059,28,840,0,0,0,0,0
117.162,2,2,64,2,8,117162,8,64,0,0,0,0,0
5.216,6,38,7245,19,218,289,314,3383,19,516,273,1179,3862
211.979,6,26,3257,14,324,16306,585,1409,12,304,19269,580,1848
0.083,17,2,237,1,72,0,72,100,1,109,0,109,137
0.525,6,27,9141,13,268,43,710,1758,14,947,36,1368,7383
1787.215,17,87,3648,86,14,21026,14,3612,1,8,0,8,36
65.206,17,4,3334,4,805,21735,1438,3334,0,0,0,0,0
2.862,17,23,7974,9,272,357,1350,2706,14,348,121,1350,5268
0.366,17,2,152,1,48,0,48,76,1,48,0,48,76
2.288,17,2,120,2,32,2288,32,120,0,0,0,0,0
1.556,17,14,9432,8,833,221,1350,6888,6,396,305,1350,2544
1777.818,17,142,11360,71,48,25396,48,5396,71,56,25396,56,5964
275.134,17,11,5616,3,308,137567,308,1008,8,548,38138,548,4608
75.562,6,21,868,10,0,5524,0,408,11,0,7554,0,460
2.376,6,29,10366,17,367,148,833,1785,12,1012,208,1420,8581
1797.323,17,440,55648,207,174,8661,1350,42018,233,30,7747,60,13630
154.18,6,34,9318,12,181,14016,267,1212,22,451,7341,2800,8106
1700.698,17,14,1036,7,30,283447,30,406,7,62,283447,62,630
0.214,17,12,4401,12,338,19,361,4401,0,0,0,0,0
1744.851,6,95,7203,63,38,28142,205,4476,32,33,56276,98,2727
43.801,1,16,1664,0,0,0,0,0,16,76,2920,76,1664
327.444,6,24,6200,10,267,90,501,1205,14,369,25181,1420,4995
0.229,6,4,529,2,259,229,259,339,2,110,4,110,190
0.005,17,2,492,1,64,0,64,92,1,372,0,372,400
0.054,17,4,352,2,37,0,37,130,2,83,1,89,222
1796.859,17,448,39896,403,35,4469,288,25676,45,288,40022,288,14220
1795.205,17,80,3354,79,14,23015,14,3318,1,8,0,8,36
31.382,6,7,336,1,0,0,0,48,6,0,6274,0,288
14.877,6,40,7313,20,218,783,314,3423,20,513,770,1179,3890
0.236,6,22,5960,12,181,21,537,1526,10,651,25,1402,4434
1.372,6,47,18538,26,911,54,1440,12922,21,433,58,1440,5616
23.884,6,31,7472,13,158,1990,267,1317,18,543,1400,1380,6155
1770.219,17,213,42387,213,171,8350,379,42387,0,0,0,0,0
4.489,6,39,7285,20,218,236,314,3423,19,516,234,1179,3862
0.307,6,9,1338,5,549,76,549,753,4,421,77,421,585
0.036,17,8,2438,8,276,5,315,2438,0,0,0,0,0
1772.254,6,180,15480,120,69,14892,69,8940,60,69,30036,69,6540
1785.546,6,104,8376,68,65,26649,65,4930,36,59,51013,59,3446
126.412,6,15,1560,10,71,14027,126,746,5,188,31413,277,814
1772.071,6,180,15480,120,69,14891,69,8940,60,69,30032,69,6540
0.178,17,2,157,1,31,0,31,59,1,70,0,70,98
1739.378,6,90,6521,59,31,29989,31,3998,31,31,57978,31,2523
1.199,6,24,8004,11,164,101,267,1236,13,869,84,1440,6768
1143.018,2,9,288,9,8,142877,8,288,0,0,0,0,0
5.475,6,40,7325,20,218,288,314,3423,20,516,274,1179,3902
299.662,6,40,10007,21,593,14974,1360,4445,19,399,16638,1360,5562
3.218,6,4,176,1,0,0,0,44,3,0,1518,0,132
1787.068,6,103,8464,68,66,26672,66,4964,35,60,52557,60,3500
1798.335,17,449,39928,404,35,4462,288,25708,45,288,40020,288,14220
19.947,17,2,152,2,48,19947,48,152,0,0,0,0,0
188.6,6,7,320,3,0,94300,0,128,4,0,2393,0,192
3.511,6,26,6095,14,108,268,147,999,12,768,317,1581,5096
86.393,2,2,64,2,8,86393,8,64,0,0,0,0,0
280.211,6,30,7432,14,158,21554,267,1357,16,603,18678,2036,6075
1772.18,6,180,15480,120,69,14892,69,8940,60,69,30035,69,6540
0.851,6,11,1727,7,100,141,100,384,4,589,202,1152,1343
0.009,17,4,624,2,36,2,36,128,2,220,0,292,496
1288.991,6,257,16628,146,70,8889,138,8945,111,69,11717,69,7683
0.006,17,2,192,1,37,0,37,65,1,99,0,99,127
256.85,17,4,240,2,32,256849,32,120,2,32,256849,32,120
0.326,6,27,8963,13,237,27,590,1635,14,941,23,1408,7328
0.502,17,4,644,2,36,497,36,128,2,230,497,230,516
25.395,6,22,4612,9,341,3174,722,1487,13,271,2083,1408,3125
240.259,6,55,17774,29,772,8579,1418,14645,26,221,9609,580,3129
688.684,2,7,224,7,8,114780,8,224,0,0,0,0,0
1778.169,17,140,11200,70,48,25770,48,5320,70,56,25770,56,5880
0.047,17,4,368,2,32,19,32,120,2,96,0,96,248
1444.654,17,80,27259,80,312,18286,548,27259,0,0,0,0,0
34.227,17,8,2688,8,308,4889,308,2688,0,0,0,0,0
1784.81,6,104,8376,68,65,26638,65,4930,36,59,50992,59,3446
0.017,17,2,283,1,31,0,31,59,1,196,0,196,224
456.193,6,8575,8247867,3143,388,145,426,182244,5432,1434,80,4314,8065623
268.894,17,4,240,2,32,268893,32,120,2,32,268893,32,120
1750.613,17,12,498,11,14,175061,14,462,1,8,0,8,36
240.234,6,54,18399,29,815,8579,1408,15379,25,214,10009,580,3020
1.277,6,50,20006,27,942,49,1460,14310,23,433,50,1460,5696
6.863,6,4,240,4,0,0,0,240,0,0,0,0,0
0.269,6,25,8981,13,257,22,667,1715,12,1105,24,2816,7266
280.476,6,30,7432,13,158,23373,267,1317,17,603,17522,2076,6115
1750.152,6,94,7151,62,38,28691,205,4424,32,33,56447,98,2727
22.888,6,36,15778,20,694,1204,945,4509,16,1158,1523,1592,11269
0.011,17,3,1543,3,486,5,514,1543,0,0,0,0,0
7.299,6,41,7349,20,218,384,314,3423,21,440,352,1152,3926
300.966,6,36,8526,20,325,15840,923,2134,16,521,565,3488,6392
1.324,6,30,10829,17,563,82,1360,4090,13,886,95,3494,6739
13.905,6,23,6953,13,275,1158,275,1078,10,1092,988,2391,5875
565.227,17,112,8512,112,48,5092,48,8512,0,0,0,0,0
1796.0,17,142,11360,71,48,25657,48,5396,71,56,25657,56,5964
0.614,17,2,144,1,36,0,36,64,1,52,0,52,80
33.614,6,32,5153,16,154,2240,722,1910,16,343,2229,2026,3243
0.141,17,4,364,2,52,0,52,160,2,74,127,80,204
5.029,17,3,208,2,36,5007,36,128,1,52,0,52,80
0.483,6,13,1693,6,288,93,288,548,7,426,45,434,1145
1790.021,17,140,11200,70,48,25942,48,5320,70,56,25942,56,5880
1776.078,17,73,3060,72,14,25015,14,3024,1,8,0,8,36
240.184,6,56,18349,28,773,8895,1402,15390,28,186,8895,580,2959
1.391,6,39,8294,19,321,77,1164,2718,20,433,63,1460,5576
23.173,17,34,20286,15,478,1652,1350,7599,19,639,1285,1350,12687
123.628,6,22,8195,12,224,59,359,1184,10,1099,13719,4428,7011
1787.308,6,365,23087,211,69,8510,69,12787,154,69,11681,69,10300
0.006,6,2,104,2,0,0,0,104,0,0,0,0,0
371.153,6,23,1535,16,177,24743,177,1053,7,110,10384,110,482
1770.672,6,101,9410,66,66,27241,66,5610,35,60,52074,60,3800
1794.569,17,144,11520,72,48,25275,48,5472,72,56,25275,56,6048
1772.373,6,180,15480,120,69,14893,69,8940,60,69,30037,69,6540
0.608,6,18,7400,10,321,67,517,1384,8,947,76,1380,6016
24.334,6,50,15425,24,168,1058,267,2485,26,849,971,3436,12940
0.181,17,3,1170,3,362,90,362,1170,0,0,0,0,0
0.242,6,9,1339,5,145,60,145,349,4,826,54,826,990
1681.163,17,16,4209,8,30,240165,37,471,8,439,240165,463,3738
219.196,17,4,1576,4,366,73065,548,1576,0,0,0,0,0
1541.164,6,205,22287,109,110,14270,721,11561,96,137,16221,1414,10726
1799.432,17,459,50012,209,141,8646,1350,35394,250,30,7226,60,14618
241.95,1,2,112,2,28,241950,28,112,0,0,0,0,0
1.078,1,10,280,10,0,0,0,280,0,0,0,0,0
28.063,6,36,8230,18,334,955,688,1756,18,478,1642,2880,6474
1799.905,17,449,39928,404,35,4466,288,25708,45,288,40020,288,14220
281.379,6,28,7352,13,158,23448,267,1317,15,603,20084,2036,6035
0.053,17,2,424,1,44,0,44,72,1,324,0,324,352
1785.867,6,104,8444,68,66,26654,66,4964,36,60,51022,60,3480
0.099,17,2,255,1,43,0,43,71,1,156,0,156,184
0.134,17,4,288,2,36,95,36,128,2,52,102,52,160
8.955,6,70,69472,35,151,263,253,2423,35,2329,263,7010,67049
1788.363,6,99,6444,63,47,28844,208,4074,36,31,51083,31,2370
118.014,6,140,107505,89,1295,1341,1408,95319,51,635,2209,1408,12186
164.868,6,20,9096,11,499,83,1193,1971,9,1350,20585,3639,7125
289.91,17,90,11937,42,150,7070,1350,7502,48,64,6128,1350,4435
0.279,6,9,1002,5,213,69,213,417,4,421,75,421,585
142.571,17,4,240,2,32,142570,32,120,2,32,142570,32,120
4.913,2,2,64,2,8,4913,8,64,0,0,0,0,0
145.723,6,29,13155,14,489,382,1440,3040,15,1055,10399,1440,10115
954.584,6,43,3459,28,64,26090,64,2016,15,56,68179,58,1443
3.859,6,144,126180,57,1018,68,1460,13515,87,1399,43,1607,112665
274.826,6,615,292861,321,833,310,1152,275287,294,415,937,1179,17574
3.91,17,4,1568,4,364,1303,364,1568,0,0,0,0,0
1791.749,6,251,36672,155,302,11634,302,26514,96,83,18860,83,10158
8.492,6,78,21586,40,524,217,1152,16298,38,418,222,1152,5288
1.917,6,19,3781,10,234,213,564,1452,9,463,218,1343,2329
1775.125,6,180,15480,120,69,14917,69,8940,60,69,30079,69,6540
1784.183,6,2175,2273237,698,127,2559,350,44685,1477,1533,1208,4206,2228552
1.527,17,19,7641,9,501,190,1350,4765,10,259,163,1350,2876
1699.475,17,12,498,11,14,169947,14,462,1,8,0,8,36
300.854,2,3,96,3,8,150427,8,96,0,0,0,0,0
0.121,17,2,602,1,46,0,46,74,1,500,0,500,528
240.342,6,43,8884,21,524,12016,1418,5820,22,212,11444,639,3064
33.762,6,32,5147,15,154,2411,722,1860,17,299,2099,1440,3287
1785.538,6,416,24920,208,69,8625,69,12460,208,34,8625,48,12460
0.236,17,2,602,1,46,0,46,74,1,500,0,500,528
38.101,17,11,836,11,48,3810,48,836,0,0,0,0,0
1.266,17,7,2368,7,310,211,354,2368,0,0,0,0,0
1793.051,17,180,11520,180,36,10017,36,11520,0,0,0,0,0
120.098,6,25,7094,11,181,12009,267,1168,14,595,9236,1400,5926
240.186,6,59,18235,32,804,7747,1408,15364,27,162,9237,580,2871
1.097,6,22,7900,11,164,93,267,1236,11,1216,93,3819,6664
2.828,17,39,11479,16,279,186,1350,4917,23,257,127,1350,6562
0.538,6,106,73168,62,1292,8,1432,67117,44,427,12,1432,6051
0.049,17,4,284,2,32,36,32,120,2,54,16,60,164
293.526,17,4,352,2,60,293525,60,176,2,60,293525,60,176
1717.944,1,15,840,15,28,122710,28,840,0,0,0,0,0
101.403,6,33,8992,15,158,7243,267,1397,18,624,5961,1400,7595
1794.994,17,448,39896,403,35,4465,288,25676,45,288,40019,288,14220
1795.127,17,80,3354,79,14,23014,14,3318,1,8,0,8,36
8.991,6,75,23313,38,570,243,1152,18065,37,470,242,1179,5248
94.696,17,4,352,2,60,94695,60,176,2,60,94695,60,176
280.372,6,29,7392,13,158,23364,267,1317,16,603,18688,2600,6075
0.037,17,4,608,2,60,13,60,176,2,188,4,188,432
160.952,17,14,1064,14,48,12380,48,1064,0,0,0,0,0
1798.402,17,449,39928,404,35,4462,288,25708,45,288,40015,288,14220
0.718,17,4,1344,4,308,239,308,1344,0,0,0,0,0
32.997,6,4621,4314342,2996,1361,10,1408,4225178,1625,776,20,1408,89164
1297.487,6,283,19390,123,46,10635,46,7884,160,46,8160,46,11506
280.722,6,28,7352,13,158,23393,267,1317,15,678,20044,2045,6035
4.896,6,36,6249,20,206,257,314,2864,16,456,308,1152,3385
1791.623,6,357,22629,209,69,8613,69,12569,148,69,12187,69,10060
162.796,17,4,352,2,60,162795,60,176,2,60,162794,60,176
1685.629,17,12,498,11,14,168562,14,462,1,8,0,8,36
1785.864,6,347,22022,203,69,8840,69,12191,144,69,12488,69,9831
299.221,17,4,240,2,32,299220,32,120,2,32,299220,32,120
127.77,6,198,155628,125,1280,1030,1368,142245,73,684,1768,2519,13383
0.234,17,2,148,1,32,0,32,60,1,60,0,60,88
300.81,6,49,10510,25,433,12533,910,3282,24,329,559,1928,7228
1787.292,6,104,8308,68,64,26676,64,4896,36,58,51063,58,3412
3.072,6,12,3462,6,75,614,75,395,6,1373,614,1448,3067
5.041,6,39,7285,20,218,265,314,3423,19,516,266,1179,3862
0.493,6,282,270128,189,194,2,230,10971,93,2794,5,14080,259157
300.616,6,38,8448,20,286,15821,797,1976,18,441,499,1360,6472
0.108,6,3,144,2,0,108,0,104,1,0,0,0,40
1.97,17,2,122,2,33,1970,33,122,0,0,0,0,0
1797.826,1,190,10640,190,28,9512,28,10640,0,0,0,0,0
1789.949,6,356,22520,208,69,8647,69,12460,148,69,12176,69,10060
4.96,17,31,11385,12,307,450,1350,4022,19,359,180,1350,7363
44.325,17,4,240,2,32,44324,32,120,2,32,44324,32,120
1789.888,6,359,22709,209,69,8605,69,12569,150,69,12012,69,10140
37.498,17,44,6468,22,48,1782,48,1672,22,190,1782,308,4796
280.51,6,29,7392,13,158,23375,267,1317,16,603,18692,2076,6075
0.141,17,2,212,1,46,0,46,74,1,110,0,110,138
1.443,17,8,672,4,34,478,34,248,4,78,478,84,424
124.122,1,40,3360,40,56,3182,56,3360,0,0,0,0,0
1.269,6,46,18594,27,853,48,1360,13058,19,476,61,2715,5536
33.975,6,30,5066,15,154,2426,721,1883,15,399,2410,2026,3183
27.702,6,28,7217,13,155,2308,267,1306,15,482,1978,2840,5911
2.487,17,25,17949,13,676,207,1350,9158,12,704,165,1350,8791
358.787,17,6,768,6,100,71757,355,768,0,0,0,0,0
109.788,6,21,8786,11,327,76,640,1489,10,1147,12184,2720,7297
0.349,1,2,112,2,28,349,28,112,0,0,0,0,0
2.859,6,75,18707,38,551,77,1429,5520,37,417,70,1460,13187
1.667,6,13,2311,8,188,238,245,700,5,1407,353,1407,1611
4.168,6,33,6129,17,206,260,314,2744,16,548,260,1179,3385
8.265,6,1556,1414594,969,1381,8,1408,1379406,587,931,13,2801,35188
1779.813,17,142,11360,71,48,25425,48,5396,71,56,25425,56,5964
1796.679,6,356,22520,208,69,8679,69,12460,148,69,12219,69,10060
288.711,6,35,3537,17,324,18044,585,1589,18,169,16982,580,1948
1.441,6,9,379,5,0,360,0,204,4,7,403,7,175
1.126,6,28,6140,16,138,75,267,1755,12,780,93,1460,4385
3.884,17,2,134,2,39,3884,39,134,0,0,0,0,0
0.001,6,4,160,4,0,0,0,160,0,0,0,0,0
1715.516,17,229,58725,229,228,7524,422,58725,0,0,0,0,0
135.093,6,49,31939,25,884,49,1360,6409,24,1444,5867,5440,25530
1297.424,1,14,784,14,28,99801,28,784,0,0,0,0,0
1798.049,1,58,4872,58,56,31544,56,4872,0,0,0,0,0
3.399,6,59,15081,28,555,125,1429,5641,31,409,105,1986,9440
1792.433,17,258,76955,258,270,6974,438,76955,0,0,0,0,0
1780.186,17,140,11200,70,48,25799,48,5320,70,56,25799,56,5880
0.41,1,2,112,2,28,410,28,112,0,0,0,0,0
461.26,6,74,11670,40,104,11827,267,3688,34,228,13973,3417,7982
60.258,6,17,5888,9,290,7532,517,1057,8,1469,8590,2459,4831
319.782,1,6,336,6,28,63956,28,336,0,0,0,0,0
1680.462,1,15,840,15,28,120033,28,840,0,0,0,0,0
1743.883,2,27,864,27,8,67072,8,864,0,0,0,0,0
280.074,6,27,7312,13,158,23339,267,1317,14,775,21538,3445,5995
0.224,17,2,152,1,48,0,48,76,1,48,0,48,76
1.315,6,49,19236,27,890,50,1460,13580,22,433,54,1460,5656
11.921,6,1881,1646408,1143,1386,10,1420,1612667,738,467,16,1883,33741
7.582,1,13,1352,0,0,0,0,0,13,76,631,76,1352
1.853,17,26,13644,12,563,168,1350,7103,14,439,139,1350,6541
17.315,17,36,25882,17,684,1079,1350,12120,19,696,959,1350,13762
6.256,17,4,424,2,46,6009,46,148,2,110,6246,110,276
915.965,6,162,20887,66,117,14091,971,6210,96,146,9640,4649,14677
2.119,17,4,1560,4,362,706,362,1560,0,0,0,0,0
1699.969,17,14,587,12,14,154542,15,505,2,13,428290,18,82
1788.636,6,357,22629,208,69,8640,69,12460,149,69,12085,69,10169
8.628,6,82,24501,41,550,215,1152,18720,41,459,209,1179,5781
31.278,17,18,1368,18,48,1839,48,1368,0,0,0,0,0
1637.741,6,97,7836,56,65,26528,65,4060,41,53,40941,59,3776
280.451,6,29,7392,13,158,23370,267,1317,16,678,18693,2085,6075
109.657,6,32,5356,16,170,7301,722,2030,16,413,7299,1448,3326
145.233,17,7,2328,7,304,24205,308,2328,0,0,0,0,0
1789.561,6,356,22520,208,69,8645,69,12460,148,69,12171,69,10060
300.223,6,57,20866,33,961,9376,1360,14830,24,361,13045,2667,6036
1741.383,6,91,6604,59,31,30023,31,3998,32,31,56173,31,2606
0.0,17,1,92,1,64,0,64,92,0,0,0,0,0
1773.487,6,180,15480,120,69,14903,69,8940,60,69,30056,69,6540
282.181,6,30,7432,13,158,23515,267,1317,17,543,17614,1400,6115
212.195,6,51,9800,21,112,9138,267,1971,30,264,7316,1452,7829
1.228,6,25,8056,12,164,95,267,1288,13,869,86,1448,6768
150.369,17,4,352,2,60,150368,60,176,2,60,150368,60,176
240.263,6,63,18196,30,729,8284,1408,14718,33,194,7508,580,3478
1772.95,6,180,15480,120,69,14898,69,8940,60,69,30046,69,6540
1748.839,6,95,7203,63,38,28207,205,4476,32,33,56401,98,2727
51.258,6,38,10559,14,327,690,1189,2535,24,415,2228,1420,8024
1797.038,6,338,30932,193,103,9346,469,15060,145,125,12479,2840,15872
0.389,6,10,767,5,186,97,186,454,5,45,77,45,313
2.981,6,3,180,3,0,0,0,180,0,0,0,0,0
300.806,6,41,24174,21,724,15039,1360,5946,20,1339,15823,2720,18228
6.799,6,30,8872,14,158,523,267,1357,16,763,448,2045,7515
2.182,17,6,1377,3,40,1087,40,204,3,363,1088,379,1173
4.743,17,37,16452,20,534,247,1350,11243,17,278,294,1350,5209
0.384,6,7,295,4,0,128,0,164,3,7,109,7,131
1741.369,17,30,7050,30,207,60047,207,7050,0,0,0,0,0
0.931,6,9,1647,6,100,186,100,344,3,1179,333,1179,1303
240.217,6,52,17740,27,781,9238,1402,14694,25,217,10008,580,3046
0.107,17,2,362,1,46,0,46,74,1,260,0,260,288
1680.505,17,12,498,11,14,168050,14,462,1,8,0,8,36
6.076,17,16,1344,8,45,867,45,584,8,67,866,73,760
92.286,17,4,1328,4,304,30762,308,1328,0,0,0,0,0
7.266,6,5,220,1,0,0,0,44,4,0,2388,0,176
268.802,17,4,272,2,40,268801,47,136,2,40,268800,47,136
60.293,6,4,168,3,0,30146,0,124,1,0,0,0,44
1797.615,1,122,6832,122,28,14856,28,6832,0,0,0,0,0
280.398,6,27,7312,12,158,25490,267,1277,15,678,20025,2045,6035
2.671,2,6,288,6,24,534,32,288,0,0,0,0,0
1771.935,6,184,15778,122,69,14644,69,9020,62,69,29046,69,6758
1624.353,2,13,416,13,8,135362,8,416,0,0,0,0,0
47.92,17,4,240,2,32,47919,32,120,2,32,47919,32,120
0.019,6,10,1677,6,555,3,951,1354,4,159,5,159,323
0.861,6,3,127,1,0,0,0,40,2,7,1,7,87
11.897,6,1886,1643755,1141,1386,10,1420,1609734,745,420,15,1420,34021
1387.082,17,66,2769,65,13,21673,14,2725,1,16,0,16,44
204.697,6,72,48867,45,1199,4652,1408,40731,27,960,2369,3847,8136
0.429,6,46,17787,25,971,17,1380,12692,21,421,20,1924,5095
667.342,17,48,3824,26,48,26693,48,1976,22,56,26927,56,1848
240.25,6,55,18245,30,771,8284,1402,15456,25,185,10010,580,2789
280.472,6,31,7472,13,158,23372,267,1317,18,603,16495,2760,6155
0.345,17,8,2758,8,316,49,355,2758,0,0,0,0,0
1.675,6,27,10179,16,285,111,587,1499,11,1029,150,1420,8680
1.308,6,50,18986,27,869,50,1360,13290,23,433,51,1360,5696
34.009,6,21,6384,10,274,3774,517,1350,11,744,3396,1408,5034
43.082,6,16,660,9,0,5381,0,368,7,0,7175,0,292
204.115,17,2,148,2,46,204115,46,148,0,0,0,0,0
10.738,6,3,972,0,0,0,0,0,3,272,5369,272,972
174.448,6,127,70630,76,1132,2323,1360,61956,51,245,3485,2667,8674
4.32,6,37,20216,18,335,254,689,1973,19,1231,237,2736,18243
1794.984,17,447,39864,402,35,4476,288,25644,45,288,40021,288,14220
14.519,6,4,240,4,0,0,0,240,0,0,0,0,0
1772.281,6,180,15480,120,69,14893,69,8940,60,69,30032,69,6540
1.236,6,24,8004,12,164,95,267,1288,12,1014,95,2331,6716
8.957,6,44,10303,23,706,407,1460,4554,21,349,436,2567,5749
5.006,17,3,208,2,36,4992,36,128,1,52,0,52,80
188.91,6,30,7432,13,158,15742,267,1317,17,543,11804,1400,6115
16.291,17,13,6659,7,613,2709,1350,4489,6,333,3251,1350,2170
1774.41,17,140,11200,70,48,25715,48,5320,70,56,25715,56,5880
15.957,17,14,6335,7,559,2653,1350,4114,7,289,2653,1350,2221
1798.035,1,340,28560,340,56,5303,56,28560,0,0,0,0,0
1739.358,6,87,6322,58,31,30515,31,3915,29,31,62119,31,2407
1784.762,6,102,8296,68,65,26638,65,4930,34,59,54081,59,3366
0.284,6,12,3702,6,170,56,170,490,6,964,25,1448,3212
624.292,6,73,11900,42,117,15226,721,4747,31,328,19973,2840,7153
1.306,6,48,19107,26,952,52,1460,13451,22,433,53,1460,5656
1793.252,6,388,33421,194,103,9291,469,15031,194,85,9291,1452,18390
145.613,6,24,9863,12,410,61,922,1742,12,953,13223,1696,8121
1790.136,1,59,4956,59,56,30864,56,4956,0,0,0,0,0
1.332,6,115,87032,50,131,27,232,2529,65,1364,20,1430,84503
0.758,17,15,8101,7,656,126,1350,4794,8,385,103,1350,3307
167.553,17,4,240,2,32,167552,32,120,2,32,167552,32,120
186.447,6,29,7392,14,158,14342,267,1357,15,678,13315,3436,6035
1787.874,1,186,19716,186,78,9664,78,19716,0,0,0,0,0
1770.177,6,218,17178,83,72,21585,313,8421,135,49,13210,80,8757
0.024,6,12,3705,6,171,4,171,491,6,964,3,1448,3214
661.711,2,12,384,12,8,60155,8,384,0,0,0,0,0
8.19,6,1365,1205155,831,1370,9,1408,1172723,534,931,15,2801,32432
5.55,17,7,1580,7,197,925,208,1580,0,0,0,0,0
91.117,6,24,8707,13,641,73,1460,3117,11,856,9093,1547,5590
0.299,6,20,7151,11,318,29,600,1854,9,964,36,1471,5297
1791.686,1,58,4872,58,56,31433,56,4872,0,0,0,0,0
11.876,6,18,4266,10,275,1319,275,958,8,992,1015,1440,3308
300.824,6,42,13650,23,892,13673,1360,8088,19,399,480,1360,5562
300.835,6,49,11029,26,315,12033,882,2393,23,428,395,1440,8636
490.355,6,46,7979,23,125,17258,501,2180,23,243,22284,1420,5799
1771.203,6,100,9292,66,65,27249,65,5577,34,59,53668,59,3715
1779.007,17,80,3355,71,13,25414,14,2967,9,15,14869,16,388
165.076,6,38,15994,23,801,7503,1448,9215,15,665,4362,1448,6779
243.699,17,4,240,2,32,243698,32,120,2,32,243698,32,120
0.056,17,2,2754,2,1349,56,1349,2754,0,0,0,0,0
0.013,17,2,410,1,36,0,36,64,1,318,0,318,346
1.425,6,10,1687,7,100,237,100,384,3,1179,588,1179,1303
0.143,17,2,152,2,48,143,48,152,0,0,0,0,0
11.338,17,17,18138,17,1038,708,1450,18138,0,0,0,0,0
318.744,6,912,804470,569,1412,561,1440,782816,343,184,90,1440,21654
20.485,17,4,240,2,32,20484,32,120,2,32,20484,32,120
888.091,6,103,7064,38,46,24002,46,2992,65,46,13874,46,4072
528.466,6,102,14202,50,145,10785,1189,5355,52,250,6204,1460,8847
882.23,2,7,224,7,8,147038,8,224,0,0,0,0,0
1797.196,17,448,39896,403,35,4470,288,25676,45,288,40020,288,14220
1.303,6,50,18782,27,855,50,1360,13086,23,433,51,1360,5696
1.318,6,50,19232,27,887,50,1440,13536,23,433,51,1440,5696
1778.964,1,198,20988,198,78,9030,78,20988,0,0,0,0,0
280.367,6,30,7432,13,158,23363,267,1317,17,543,17518,1400,6115
0.02,6,3,120,2,0,20,0,80,1,0,0,0,40
0.032,17,4,368,2,32,1,32,120,2,96,0,96,248
0.683,17,4,608,2,60,315,60,176,2,188,299,188,432
0.524,6,23,6673,10,181,45,267,1128,13,627,38,1400,5545
300.77,6,52,10618,26,433,12030,910,3310,26,312,601,1460,7308
280.227,6,29,7392,14,158,21555,267,1357,15,678,20010,3436,6035
9.255,6,9,527,5,43,2313,43,311,4,0,3084,0,216
1786.478,6,102,8296,68,65,26663,65,4930,34,59,54133,59,3366
1743.226,6,96,7286,63,38,28116,205,4476,33,33,54463,98,2810
0.215,1,2,112,2,28,215,28,112,0,0,0,0,0
1.057,17,2,120,2,32,1057,32,120,0,0,0,0,0
1784.623,6,384,23757,210,69,8538,69,12609,174,49,10315,69,11148
1772.647,6,180,15480,120,69,14896,69,8940,60,69,30040,69,6540
21.738,6,19,2541,10,211,2415,211,986,9,545,2688,904,1555
0.557,6,21,7281,13,334,46,663,2021,8,1209,73,1946,5260
530.043,6,109,17759,48,365,11277,1056,9939,61,190,8833,580,7820
1.393,17,6,552,3,32,696,32,180,3,96,689,96,372
125.722,2,2,64,2,8,125722,8,64,0,0,0,0,0
280.156,1,3,180,3,32,140078,32,180,0,0,0,0,0
0.837,6,19,5908,11,281,83,544,1288,8,859,107,2642,4620
30.146,17,36,5292,18,48,1772,48,1368,18,190,1772,308,3924
1742.346,6,97,7307,63,38,28102,205,4476,34,33,52787,98,2831
8.388,6,18,8215,9,275,1048,275,643,9,1440,854,1440,7572
0.131,17,2,304,1,32,0,32,60,1,216,0,216,244
1797.324,6,380,26915,219,103,8244,469,15990,161,69,11230,69,10925
1772.964,6,180,15480,120,69,14898,69,8940,60,69,30048,69,6540
1.393,6,38,8252,19,320,77,1162,2716,19,433,67,1460,5536
0.011,6,16,6416,8,126,1,126,550,8,1088,1,1448,5866
80.782,6,9910,9327415,6497,1357,12,1402,9145267,3413,665,23,1402,182148
11.681,6,1876,1594745,1125,1362,10,1380,1560463,751,421,15,1923,34282
1790.017,1,77,4312,77,28,23552,28,4312,0,0,0,0,0
3.965,17,10,785,5,31,980,31,295,5,70,980,70,490
125.665,2,2,64,2,8,125665,8,64,0,0,0,0,0
0.175,6,9,1002,5,213,43,213,417,4,421,45,421,585
1771.608,6,103,9514,66,66,27255,66,5610,37,60,49208,60,3904
240.651,6,428,389942,249,461,970,1408,17124,179,2189,1351,9856,372818
1.521,6,53,19432,29,888,54,1360,13651,24,400,57,1360,5781
1.603,6,29,7088,14,154,123,267,1644,15,806,105,1460,5444
37.746,17,22,1936,11,48,3773,48,836,11,72,3773,72,1100
1792.018,6,356,22520,208,69,8657,69,12460,148,69,12190,69,10060
0.034,17,2,194,1,61,0,61,89,1,77,0,77,105
1773.897,6,182,15698,120,69,14906,69,8940,62,69,29075,69,6758
1799.219,17,448,39612,404,35,4464,288,25708,44,288,40949,288,13904
0.013,17,6,460,3,40,0,41,206,3,56,0,57,254
1.236,6,48,19088,27,882,47,1360,13472,21,433,53,1360,5616
5.912,17,3,1008,3,308,2956,308,1008,0,0,0,0,0
11.769,6,1800,1625185,1151,1363,10,1380,1594950,649,387,18,1923,30235
0.778,6,10,1687,7,100,129,100,384,3,1179,263,1179,1303
1742.671,2,14,448,14,8,134051,8,448,0,0,0,0,0
280.602,6,32,7853,14,158,21584,267,1357,18,524,16505,1400,6496
1794.994,6,124,12361,77,62,23618,722,6402,47,94,39016,1408,5959
7.161,6,5,220,1,0,0,0,44,4,0,2357,0,176
1799.424,1,16,896,16,28,119961,28,896,0,0,0,0,0
1773.415,1,25,3260,25,102,73892,351,3260,0,0,0,0,0
1782.503,17,83,3480,82,14,22006,14,3444,1,8,0,8,36
1.365,6,50,20358,27,967,52,1460,14662,23,433,53,1460,5696
0.017,17,2,243,1,53,0,53,81,1,134,0,134,162
0.097,17,4,284,2,32,90,32,120,2,54,88,60,164
3.054,6,2,88,2,0,0,0,88,0,0,0,0,0
1794.953,6,356,22520,208,69,8671,69,12460,148,69,12209,69,10060
240.329,6,44,8448,22,449,11443,1418,5648,22,206,11443,580,2800
1795.2,17,379,49487,186,176,9703,1350,38046,193,31,9349,60,11441
1793.749,6,758,51393,379,31,4745,31,25877,379,31,4744,31,25516
16.015,6,26,6988,13,275,1334,275,1078,13,895,1254,1440,5910
0.015,17,4,624,2,64,13,64,184,2,192,2,192,440
1117.41,1,142,7952,142,28,7924,28,7952,0,0,0,0,0
302.144,6,38,8665,20,322,15902,944,2123,18,446,586,1460,6542
315.969,6,74,13523,30,188,10895,1305,3902,44,245,7344,1629,9621
115.245,17,2,72,1,8,0,8,36,1,8,0,8,36
1766.322,6,135,15492,83,85,21540,501,6823,52,156,34631,1420,8669
13.999,6,21,6825,12,275,1272,275,1038,9,1353,1121,1440,5787
9.351,6,1839,1674171,1153,1373,7,1408,1633835,686,931,13,2801,40336
0.896,6,50,13773,24,549,38,1429,4824,26,493,34,3446,8949
0.879,6,21,5988,12,281,79,544,1328,9,716,97,1420,4660
16.027,6,29,5170,14,154,1215,722,1819,15,366,1131,1408,3351
1788.284,17,344,26144,344,48,5213,48,26144,0,0,0,0,0
1788.58,1,248,13888,248,28,7241,28,13888,0,0,0,0,0
46.488,6,40,13882,21,1064,444,1460,8320,19,399,2573,1460,5562
27.112,6,1715,1548575,1118,1310,24,1368,1511323,597,776,45,2736,37252
0.035,6,11,3285,6,80,6,80,400,5,872,8,1448,2885
1.316,6,47,19333,27,903,50,1360,13757,20,476,60,2715,5576
1741.866,6,89,6426,58,31,30559,31,3915,31,31,58061,31,2511
4.296,6,38,8553,20,401,226,889,2068,18,478,243,2128,6485
2.188,6,14,2351,9,188,273,245,740,5,1407,483,1407,1611
63.721,6,29,9454,8,154,9103,267,792,21,488,3182,1420,8662
1744.676,2,30,960,30,8,60161,8,960,0,0,0,0,0
4.503,6,40,7309,21,218,225,314,3463,19,440,236,1152,3846
11.811,6,1544,1304378,854,1427,13,1448,1253862,690,776,16,1448,50516
33.831,6,33,5198,16,154,2255,722,1910,17,300,2097,1448,3288
0.155,6,17,3016,9,282,19,531,1606,8,493,20,828,1410
220.873,1,22,1232,22,28,10517,28,1232,0,0,0,0,0
3.232,6,47,9317,25,321,134,1164,3018,22,360,131,2920,6299
8.326,6,69,20550,36,512,237,1152,15803,33,489,251,1179,4747
1786.486,6,102,8296,68,65,26663,65,4930,34,59,54133,59,3366
5.201,17,3,3228,3,1048,2600,1072,3228,0,0,0,0,0
5.605,6,40,7309,20,218,295,314,3423,20,513,279,1179,3886
1.458,17,4,377,2,33,1447,37,123,2,99,1243,136,254
1790.995,6,356,22520,208,69,8652,69,12460,148,69,12183,69,10060
21.078,6,26,4614,13,275,1756,275,1090,13,992,1676,1440,3524
1672.83,1,64,3584,64,28,26552,28,3584,0,0,0,0,0
125.949,17,4,352,2,60,125948,60,176,2,60,125948,60,176
5.507,17,2,2200,2,1072,5507,1072,2200,0,0,0,0,0
3.938,17,201,40040,198,172,19,172,39600,3,118,25,172,440
1.462,6,52,19356,29,886,52,1360,13615,23,437,57,2715,5741
344.396,17,52,3952,52,48,6752,48,3952,0,0,0,0,0
630.208,2,4,128,4,8,210069,8,128,0,0,0,0,0
0.434,6,21,7203,13,318,36,600,1958,8,964,58,1471,5245
0.007,17,2,912,1,308,0,308,336,1,548,0,548,576
0.744,6,71,38316,42,1150,18,1380,29414,29,630,25,3303,8902
1707.289,1,8,448,8,28,243898,28,448,0,0,0,0,0
1795.65,17,142,11360,71,48,25651,48,5396,71,56,25651,56,5964
1794.547,17,179,13962,179,50,10081,50,13962,0,0,0,0,0
0.159,17,2,132,1,30,0,30,58,1,46,0,46,74
7.857,6,15,1362,8,275,1122,275,878,7,96,982,96,484
1.298,17,2,144,1,36,0,36,64,1,52,0,52,80
1786.679,6,102,8364,68,66,26666,66,4964,34,60,54139,60,3400
7.222,6,1361,1237513,849,1380,8,1408,1206225,512,776,13,1408,31288
1.622,6,48,18999,27,876,62,1360,13383,21,433,71,1360,5616
1792.449,6,358,22669,208,69,8659,69,12529,150,69,12029,69,10140
83.76,6,44,7469,18,218,348,314,3343,26,513,3340,1179,4126
59.326,6,16,2297,9,324,7415,585,1125,7,396,9881,580,1172
0.091,6,9,1339,5,145,22,145,349,4,826,27,826,990
173.963,17,3,1480,1,300,0,300,328,2,548,152827,548,1152
9.496,6,83,24605,42,552,231,1152,18824,41,459,231,1179,5781
34.932,17,20,1760,10,48,3880,48,760,10,72,3880,72,1000
5.095,6,5,293,3,0,2547,0,168,2,21,2958,21,125
665.358,6,12,1812,8,241,95051,241,1284,4,92,221718,92,528
1786.7,6,105,8544,68,66,26667,66,4964,37,60,49628,60,3580
2.188,17,3,174,3,30,1094,30,174,0,0,0,0,0
157.618,6,36,8132,13,140,13134,267,1513,23,316,7164,1420,6619
1788.601,6,351,22320,205,69,8767,69,12340,146,69,12334,69,9980
1763.268,2,13,416,13,8,146939,8,416,0,0,0,0,0
1780.169,6,107,8695,68,52,26569,205,5307,39,36,46838,98,3388
1788.59,1,123,6888,123,28,14660,28,6888,0,0,0,0,0
1799.029,17,448,39896,403,35,4475,288,25676,45,288,40017,288,14220
1790.728,6,186,23918,103,304,17556,304,16368,83,83,21838,83,7550
1799.606,1,16,896,16,28,119973,28,896,0,0,0,0,0
300.867,6,41,9775,23,540,13675,1360,4208,18,402,508,2667,5567
1186.026,6,70,5559,46,65,26356,65,3270,24,57,51559,59,2289
1787.217,6,102,8296,68,65,26674,65,4930,34,59,54154,59,3366
20.222,6,20,3130,12,183,1838,517,1561,8,381,2887,499,1569
298.464,17,10,3272,10,299,33162,308,3272,0,0,0,0,0
112.318,2,4,128,4,8,37439,8,128,0,0,0,0,0
42.582,6,45,15047,21,132,2129,517,2463,24,806,1846,2816,12584
162.02,17,343,236465,337,672,482,1252,236181,6,19,9720,56,284
6.956,6,1518,1380727,943,1385,7,1408,1346163,575,931,11,2816,34564
1772.791,1,62,6572,62,78,29062,78,6572,0,0,0,0,0
42.547,17,24,2112,12,48,3867,48,912,12,72,3867,72,1200
1.252,6,3,189,1,0,0,0,40,2,69,1245,69,149
240.984,6,411,384801,145,519,1673,1418,11183,266,1416,908,2836,373618
1798.341,17,449,39928,404,35,4462,288,25708,45,288,40016,288,14220
1133.661,2,7,224,7,8,188943,8,224,0,0,0,0,0
0.104,17,2,179,1,32,0,32,60,1,91,0,91,119
1781.446,6,351,22527,201,69,8907,69,12180,150,69,11955,69,10347
29.226,6,10,8098,3,92,10450,92,256,7,1494,4840,2329,7842
240.331,6,45,9016,22,515,11444,1402,5795,23,224,10923,639,3221
365.66,6,18,1242,14,180,28127,180,916,4,110,20056,110,326
0.319,6,20,4960,10,137,35,267,1092,10,692,34,1467,3868
5.781,6,41,7349,22,201,275,314,3503,19,513,306,1179,3846
0.106,17,2,602,1,46,0,46,74,1,500,0,500,528
61.839,6,70,47068,43,1183,1472,1448,38933,27,747,2369,1448,8135
1.647,6,25,8711,15,276,117,561,1433,10,982,164,1420,7278
0.463,17,2,152,1,48,0,48,76,1,48,0,48,76
4.02,6,38,7229,19,218,223,314,3383,19,513,209,1179,3846
0.121,17,2,390,1,46,0,46,74,1,288,0,288,316
36.154,17,4,352,2,60,36153,60,176,2,60,36153,60,176
0.49,6,11,2033,7,326,81,589,1025,4,396,28,580,1008
13.676,1,19,1976,0,0,0,0,0,19,76,759,76,1976
1774.307,6,182,15629,121,69,14785,69,9049,61,69,29566,69,6580
0.691,6,10,1102,6,483,138,483,803,4,83,228,83,299
13.279,17,4,824,2,48,13213,48,152,2,308,13137,308,672
378.552,6,25,1654,17,180,23659,180,1120,8,110,9429,110,534
53.679,6,7028,6761901,4707,1359,11,1408,6636545,2321,931,23,2801,125356
0.048,6,3,187,1,0,0,0,52,2,31,0,31,135
1797.234,17,80,3354,79,14,23041,14,3318,1,8,0,8,36
240.208,6,54,18177,28,806,8896,1408,15176,26,205,9608,580,3001
161.065,17,4,352,2,60,161064,60,176,2,60,161063,60,176
11.363,6,13,2133,8,324,1623,585,1073,5,396,2836,580,1060
1786.097,6,104,8376,68,65,26658,65,4930,36,59,51028,59,3446
1789.056,6,103,8336,68,65,26702,65,4930,35,59,52616,59,3406
0.196,6,18,3068,9,282,24,531,1606,9,493,22,828,1462
280.254,6,27,7312,12,158,25477,267,1277,15,678,20015,2045,6035
1782.591,6,119,13874,77,81,23455,500,6029,42,162,43475,1420,7845
1773.082,6,180,15480,120,69,14899,69,8940,60,69,30050,69,6540
12.295,6,24,3414,12,270,1117,698,1982,12,160,1117,503,1432
1787.541,1,111,6216,111,28,16250,28,6216,0,0,0,0,0
0.929,6,10,1687,7,100,154,100,384,3,1179,337,1179,1303
0.5,6,24,7461,14,334,38,663,2085,10,967,52,1946,5376
368.573,6,23,1535,16,177,24571,177,1053,7,110,10376,110,482
7.231,6,1292,1164168,798,1380,8,1408,1133816,494,931,14,2801,30352
3.783,6,33,6145,17,206,236,314,2744,16,551,235,1179,3401
71.605,6,19,780,9,0,6327,0,368,10,0,7953,0,412
24.48,6,3004,2820195,1907,1399,12,1448,2758487,1097,776,22,1448,61708
382.48,6,13,894,7,106,63746,106,606,6,0,6323,0,288
300.021,1,4,326,4,53,100007,78,326,0,0,0,0,0
273.786,6,27,7312,13,158,22815,267,1317,14,775,21056,4836,5995
1771.753,6,105,9759,68,65,26444,65,5758,37,59,49212,59,4001
56.393,17,4,244,2,33,56390,33,122,2,33,56392,33,122
373.557,1,3,180,3,32,186778,32,180,0,0,0,0,0
0.026,17,4,1116,2,32,22,32,120,2,470,21,470,996
8.12,6,70,21219,36,575,232,1152,16416,34,491,238,1179,4803
0.467,6,5,1564,3,413,233,413,946,2,269,220,269,618
1.393,6,4,212,2,0,1393,0,100,2,0,0,0,112
24.362,6,2,142,2,31,24362,31,142,0,0,0,0,0
33.474,6,47,10375,23,533,820,910,3147,24,347,1448,3488,7228
3.997,17,3,264,3,60,1998,60,264,0,0,0,0,0
1783.809,6,364,24923,212,94,8454,469,14427,152,69,11813,69,10496
1795.144,17,449,39928,404,35,4454,288,25708,45,288,40020,288,14220
1786.579,6,102,8228,68,64,26665,64,4896,34,58,54136,58,3332
31.49,17,4,352,2,60,31488,60,176,2,60,31489,60,176
1772.513,6,202,22250,130,75,13740,267,10057,72,136,24961,4260,12193
0.009,17,3,716,2,64,1,64,184,1,504,0,504,532
114.416,6,26,6430,9,272,338,516,1180,17,326,7144,1452,5250
12.766,6,27,2672,13,222,1063,222,1634,14,231,981,231,1038
4.469,6,39,7269,19,218,248,314,3383,20,440,221,1152,3886
241.467,6,166,105212,66,150,3714,571,5867,100,1162,2438,1795,99345
756.4,2,6,192,6,8,151280,8,192,0,0,0,0,0
1078.37,1,10,560,10,28,119818,28,560,0,0,0,0,0
1794.525,1,277,29362,277,78,6501,78,29362,0,0,0,0,0
0.268,17,2,776,2,360,268,360,776,0,0,0,0,0
1796.287,1,202,11312,202,28,8936,28,11312,0,0,0,0,0
0.113,17,2,396,1,39,0,39,67,1,301,0,301,329
0.69,17,27,15721,15,691,47,1350,10792,12,382,59,1350,4929
1.145,6,24,8016,12,164,88,267,1300,12,1014,88,2411,6716
280.451,6,30,7432,13,158,23370,267,1317,17,543,17523,1400,6115
2.457,6,14,2351,8,188,351,245,700,6,703,442,1152,1651
257.67,1,4,224,4,28,85890,28,224,0,0,0,0,0
17.456,17,19,8130,8,318,2489,1350,2775,11,458,1742,1350,5355
842.248,2,9,288,9,8,105281,8,288,0,0,0,0,0
16.684,6,43,11029,24,523,725,1360,4145,19,470,482,2222,6884
0.814,17,4,368,2,32,649,32,120,2,96,652,96,248
1796.275,6,416,24920,208,69,8677,69,12460,208,34,8677,48,12460
0.083,17,2,2728,2,1336,83,1336,2728,0,0,0,0,0
355.986,6,31,9046,22,114,16951,673,2173,9,1083,61,2720,6873
4.128,6,38,7229,19,218,229,314,3383,19,513,215,1179,3846
1796.32,6,1194,361275,555,817,3242,1418,309557,639,65,2815,580,51718
10.069,17,2,150,2,47,10069,47,150,0,0,0,0,0
300.801,6,49,16486,27,955,11569,1460,10711,22,375,522,4027,5775
0.368,6,10,968,5,256,89,256,460,5,304,89,304,508
1785.344,6,106,8644,68,66,26646,66,4964,38,60,48250,60,3680
5.016,17,4,288,2,36,5000,36,128,2,52,5000,52,160
17.476,17,16,2352,8,48,2494,48,608,8,190,2494,308,1744
127.589,6,18,7702,5,92,31897,92,372,13,604,10615,2026,7330
0.182,6,12,1938,7,209,30,209,581,5,544,42,891,1357
511.802,17,10,3384,10,310,56866,320,3384,0,0,0,0,0
9.671,6,1619,1488333,985,1427,9,1448,1447345,634,776,15,1448,40988
575.27,1,6,336,6,28,115054,28,336,0,0,0,0,0
822.504,17,66,5280,33,48,25703,48,2508,33,56,25703,56,2772
37.088,17,5,380,5,48,9272,48,380,0,0,0,0,0
319.511,6,35,12250,19,593,17750,1408,4569,16,851,17296,1578,7681
280.35,6,28,7352,13,158,23362,267,1317,15,678,20013,2800,6035
2.758,6,11,467,6,0,551,0,248,5,7,640,7,219
7.96,6,5,232,3,0,3980,0,136,2,0,3073,0,96
1685.3,1,8,448,8,28,240757,28,448,0,0,0,0,0
1.814,17,2,685,1,308,0,308,336,1,321,0,321,349
634.099,17,12,4000,12,305,57645,308,4000,0,0,0,0,0
1745.003,6,99,7411,63,38,28145,205,4476,36,33,49843,98,2935
0.08,17,4,284,2,32,34,32,120,2,54,48,60,164
1.028,6,52,13874,25,549,42,1429,4876,27,465,37,4380,8998
280.688,6,32,7853,14,158,21591,267,1357,18,524,16509,1400,6496
124.779,6,34,7935,12,155,29,267,1266,22,340,5941,3417,6669
1770.506,6,105,9942,72,65,24936,65,6279,33,59,55324,59,3663
421.651,17,6,456,3,48,210817,48,228,3,48,210817,48,228
1783.814,6,367,25581,213,99,8414,469,15005,154,69,11658,69,10576
282.348,17,6,1496,3,32,141171,37,181,3,410,141169,463,1315
0.039,6,12,3940,7,88,6,88,388,5,3340,9,3340,3552
154.131,6,13,532,4,0,4058,0,164,9,0,19265,0,368
1799.185,6,356,22520,208,69,8691,69,12460,148,69,12239,69,10060
0.821,6,52,13869,24,551,35,1429,4840,28,438,29,1460,9029
0.109,17,2,396,1,39,0,39,67,1,301,0,301,329
0.065,17,2,390,1,48,0,48,76,1,286,0,286,314
1781.887,17,83,3480,82,14,21998,14,3444,1,8,0,8,36
1788.529,6,356,22520,208,69,8640,69,12460,148,69,12166,69,10060
77.087,17,4,352,2,60,77086,60,176,2,60,77086,60,176
1790.815,6,441,26559,220,69,8177,69,13147,221,35,8140,69,13412
0.32,6,117,143119,56,183,5,230,3481,61,2312,4,7010,139638
1738.483,1,56,4704,56,56,31608,56,4704,0,0,0,0,0
24.08,17,4,352,2,60,24078,60,176,2,60,24079,60,176
248.925,6,33,7060,13,186,9929,516,1644,20,307,13096,1452,5416
137.049,6,20,8704,11,325,61,634,1447,9,1377,17115,3928,7257
0.052,17,2,156,1,34,0,34,62,1,66,0,66,94
1788.808,17,142,11360,71,48,25554,48,5396,71,56,25554,56,5964
7.352,6,3,136,2,0,7352,0,88,1,0,0,0,48
1773.185,6,180,15480,120,69,14900,69,8940,60,69,30046,69,6540
0.48,6,25,6081,13,108,40,147,959,12,773,40,1608,5122
2.971,6,2,88,2,0,0,0,88,0,0,0,0,0
102.672,2,4,128,4,8,34224,8,128,0,0,0,0,0
7.406,6,1441,1390875,956,1381,7,1408,1360991,485,931,14,2801,29884
0.482,17,2,384,1,39,0,39,67,1,289,0,289,317
0.046,17,2,180,1,30,0,30,58,1,94,0,94,122
0.204,6,133,124635,48,181,4,253,3047,85,1411,1,1448,121588
1782.276,17,83,3480,82,14,22003,14,3444,1,8,0,8,36
0.131,6,2,748,1,668,0,668,708,1,0,0,0,40
289.713,17,16,1216,16,48,19314,48,1216,0,0,0,0,0
0.078,17,2,180,1,30,0,30,58,1,94,0,94,122
0.161,1,6,624,0,0,0,0,0,6,76,32,76,624
0.004,17,2,380,1,40,0,40,68,1,284,0,284,312
54.44,6,40,10410,21,783,441,1360,4803,19,402,3014,2667,5607
0.082,17,2,572,1,39,0,39,67,1,477,0,477,505
0.075,17,2,390,1,46,0,46,74,1,288,0,288,316
2.123,17,4,706,3,39,999,39,201,1,477,0,477,505
1772.621,6,180,15480,120,69,14895,69,8940,60,69,30039,69,6540
0.979,6,20,9096,11,499,97,1193,1971,9,1350,93,3639,7125
0.156,17,4,420,2,33,1,33,122,2,121,0,145,298
249.635,6,61,12717,23,297,11346,1189,4498,38,247,6746,1420,8219
0.018,17,2,434,1,36,0,36,64,1,342,0,342,370
0.383,6,12,1653,6,288,76,288,548,6,426,44,434,1105
1770.478,6,99,9240,66,65,27238,65,5577,33,59,55323,59,3663
1767.394,6,233,19944,90,77,19857,337,9111,143,70,12445,1062,10833
4.272,6,40,7309,19,218,237,314,3383,21,440,200,1152,3926
1.948,6,42,11191,21,587,97,1440,5575,21,433,87,1440,5616
2.593,6,102,88639,50,337,52,339,4635,52,1766,50,2736,84004
1677.629,1,7,742,7,78,279604,78,742,0,0,0,0,0
1680.53,17,12,498,11,14,168053,14,462,1,8,0,8,36
0.052,17,2,912,1,308,0,308,336,1,548,0,548,576
1797.764,6,366,25610,213,99,8480,469,15005,153,69,11824,69,10605
0.536,6,26,9054,13,263,44,688,1736,13,947,39,1368,7318
300.871,6,69,53406,47,1245,6540,1368,47286,22,828,1504,1571,6120
0.964,17,6,1390,3,46,463,46,222,3,361,466,369,1168
0.04,6,9,1339,5,145,10,145,349,4,826,10,826,990
1196.977,17,648,45832,564,40,2126,41,38725,84,56,468,57,7107
1740.011,6,96,6962,62,31,28524,31,4209,34,31,52727,31,2753
254.56,6,6,272,3,0,127280,0,128,3,0,1524,0,144
1796.722,1,345,28980,345,56,5223,56,28980,0,0,0,0,0
1.057,6,22,7900,12,164,96,267,1288,10,1216,96,4224,6612
1770.117,6,35,5087,22,241,84291,241,3555,13,92,147494,92,1532
1751.28,6,238,18727,119,92,14841,208,13068,119,31,14839,31,5659
368.824,6,25,1651,17,177,23051,177,1117,8,110,9217,110,534
11.036,6,20,4442,11,275,1103,275,998,9,768,777,1440,3444
3.483,6,3,132,2,0,3483,0,88,1,0,0,0,44
1740.422,17,29,30624,29,1028,62157,1028,30624,0,0,0,0,0
0.051,17,2,154,1,33,0,33,61,1,65,0,65,93
0.042,17,2,152,1,48,0,48,76,1,48,0,48,76
1794.272,17,316,62455,316,169,5696,422,62455,0,0,0,0,0
1720.839,17,12,498,11,14,172083,14,462,1,8,0,8,36
5.107,6,8,464,4,0,1642,0,216,4,0,1641,0,248
1780.774,1,77,6468,77,56,23431,56,6468,0,0,0,0,0
1784.511,6,396,34517,225,119,7966,1189,17460,171,132,10497,1420,17057
57.919,6,29,7645,10,155,10,267,1186,19,379,3217,3426,6459
393.979,1,4,464,4,88,131326,88,464,0,0,0,0,0
78.42,6,42,9594,17,327,4901,1189,2655,25,370,3261,1420,6939
1792.821,6,356,22520,208,69,8660,69,12460,148,69,12196,69,10060
1795.564,6,355,22480,207,69,8716,69,12420,148,69,12214,69,10060
1773.357,6,192,20906,125,110,14301,965,11939,67,93,26864,485,8967
74.104,6,16,16410,3,142,83,142,266,13,1420,6168,1420,16144
1772.982,6,182,15698,120,69,14899,69,8940,62,69,29057,69,6758
0.025,6,2,80,1,0,0,0,40,1,0,0,0,40
89.483,6,25,9968,12,549,66,1440,2709,13,961,7445,1440,7259
0.112,6,10,520,0,0,0,0,0,10,0,0,0,520
0.295,6,26,8868,13,227,24,547,1592,13,1098,24,2816,7276
1.56,17,8,672,4,45,517,45,292,4,67,516,73,380
1.082,6,12,1040,6,283,180,283,615,6,105,180,105,425
0.062,17,4,284,2,32,49,32,120,2,54,14,60,164
16.171,17,23,9916,11,604,1614,1350,6956,12,218,1467,1350,2960
45.196,6,14,2189,8,326,6456,589,1077,6,396,8893,580,1112
311.994,6,24,5555,9,133,38998,159,911,15,773,22285,1408,4644
1751.645,6,186,11385,93,47,19039,208,6766,93,31,19036,31,4619
0.413,6,22,7300,12,325,37,626,1932,10,1210,45,1906,5368
1795.905,17,448,39896,403,35,4467,288,25676,45,288,40018,288,14220
34.206,17,11,836,11,48,3420,48,836,0,0,0,0,0
1770.293,6,99,9306,66,66,27235,66,5610,33,60,55318,60,3696
9.805,17,26,11385,13,431,814,1350,5979,13,387,814,1350,5406
59.734,1,16,1664,0,0,0,0,0,16,76,3982,76,1664
4.348,6,2,88,2,0,0,0,88,0,0,0,0,0
2.367,6,20,3833,11,234,236,564,1504,9,463,271,1343,2329
0.948,6,10,1687,7,100,158,100,384,3,1179,352,1179,1303
1798.849,17,346,26296,346,48,5214,48,26296,0,0,0,0,0
14.335,6,15,2302,9,210,1791,210,904,6,545,2645,904,1398
69.708,6,15,2237,9,324,8713,585,1125,6,396,13912,580,1112
458.563,1,10,560,10,28,50951,28,560,0,0,0,0,0
10.824,17,15,17706,15,1152,773,1449,17706,0,0,0,0,0
34.169,6,32,5145,15,180,2440,722,1858,17,299,2120,1448,3287
1799.511,17,449,39928,404,35,4465,288,25708,45,288,40021,288,14220
17.097,6,12,937,6,222,3412,222,462,6,231,3419,231,475
0.006,17,2,146,1,37,0,37,65,1,53,0,53,81
766.986,1,6,336,6,28,153397,28,336,0,0,0,0,0
0.166,1,2,112,2,28,166,28,112,0,0,0,0,0
9.986,6,16,5255,9,275,1248,275,643,7,1440,828,1440,4612
932.12,6,112,14624,60,304,15798,304,9856,52,83,18239,83,4768
599.058,6,10,586,6,31,119811,31,333,4,31,199683,31,253
1776.522,17,140,11200,70,48,25746,48,5320,70,56,25746,56,5880
1798.106,17,450,39960,405,35,4450,288,25740,45,288,40024,288,14220
2.263,6,13,2311,8,188,323,245,700,5,1407,502,1407,1611
300.347,6,30,9549,17,374,18771,938,2436,13,714,1829,1408,7113
1799.207,17,769,46394,769,32,2342,37,46394,0,0,0,0,0
10.354,6,86,24661,44,533,240,1152,18840,42,459,246,1179,5821
0.172,1,2,112,2,28,172,28,112,0,0,0,0,0
1.11,6,25,8056,12,164,85,267,1288,13,869,78,1448,6768
1767.788,6,120,12091,74,63,24216,722,6215,46,96,39274,1402,5876
0.303,6,10,1380,6,145,60,145,389,4,827,44,827,991
1792.426,17,140,11200,70,48,25977,48,5320,70,56,25977,56,5880
1.675,6,13,2311,8,188,239,245,700,5,1407,350,1407,1611
0.127,6,11,1598,6,135,25,135,395,5,999,28,999,1203
4.845,6,54,19399,30,883,167,1360,13639,24,433,201,1360,5760
281.256,6,29,7392,13,158,23438,267,1317,16,603,18745,2036,6075
287.036,6,33,3741,17,237,17939,585,1629,16,254,19135,580,2112
300.589,6,46,8984,23,286,13663,766,2156,23,327,579,1460,6828
0.357,6,12,3705,6,171,52,171,491,6,964,56,1448,3214
1772.109,6,212,16708,78,73,23012,375,8017,134,49,13323,143,8691
0.049,17,4,330,2,33,44,33,122,2,76,10,82,208
0.211,6,12,3705,6,171,40,171,491,6,964,41,1448,3214
9.866,17,4,5484,4,1343,3288,1348,5484,0,0,0,0,0
1750.603,6,95,7203,63,38,28235,205,4476,32,33,56457,98,2727
124.655,6,26,7272,12,158,11332,267,1277,14,775,9585,3445,5995
240.369,6,43,8395,22,449,11445,1408,5648,21,205,12018,580,2747
0.265,17,2,588,1,39,0,39,67,1,493,0,493,521
91.281,6,36,9080,19,258,4107,486,1627,17,676,5697,4421,7453
7.644,6,35,6662,19,154,424,267,2012,16,572,414,1420,4650
1773.636,6,180,15480,120,69,14904,69,8940,60,69,30056,69,6540
1795.096,17,449,39928,404,35,4454,288,25708,45,288,40017,288,14220
181.219,6,51,8358,23,98,8235,517,2215,28,385,6710,1418,6143
0.202,6,25,7216,13,155,16,267,1301,12,775,17,3445,5915
0.062,17,2,237,1,72,0,72,100,1,109,0,109,137
237.545,17,4,352,2,60,237544,60,176,2,60,237544,60,176
1.302,6,48,20238,28,900,48,1360,14662,20,476,59,2715,5576
1.325,6,48,19639,27,922,50,1440,14023,21,433,57,1440,5616
10.211,6,6,340,2,0,10211,0,100,4,0,2352,0,240
1778.583,6,180,15480,120,69,14946,69,8940,60,69,30142,69,6540
280.86,6,29,7392,13,158,23405,267,1317,16,603,18714,2036,6075
39.353,17,44,6468,22,48,1873,48,1672,22,190,1873,308,4796
1772.395,6,180,15480,120,69,14894,69,8940,60,69,30035,69,6540
1.498,6,3176,4807125,825,145,1,264,43491,2351,1977,0,16896,4763634
1776.647,1,62,5208,0,0,0,0,0,62,56,29125,56,5208
300.374,6,32,19326,19,417,16687,1114,2678,13,1995,5115,5711,16648
244.96,17,4,240,2,32,244958,32,120,2,32,244959,32,120
1781.78,1,239,13384,239,28,7486,28,13384,0,0,0,0,0
0.877,6,10,1687,7,100,146,100,384,3,1179,313,1179,1303
0.017,17,2,476,1,39,0,39,67,1,381,0,381,409
280.306,6,28,7352,13,158,23358,267,1317,15,678,20020,2045,6035
0.058,6,9,1343,5,145,14,145,349,4,830,16,830,994
1106.41,1,10,815,10,53,122934,78,815,0,0,0,0,0
0.205,6,2,592,1,0,0,0,40,1,512,0,512,552
9.917,17,2,128,2,36,9917,36,128,0,0,0,0,0
1.046,6,27,9632,14,350,80,1041,1992,13,1184,71,2370,7640
233.516,6,46,13687,21,181,11675,267,2296,25,692,9728,3436,11391
1745.453,6,95,7203,63,38,28152,205,4476,32,33,56297,98,2727
1.25,6,48,18257,28,882,46,1360,12636,20,480,57,4075,5621
12.142,17,4,824,2,48,12121,48,152,2,308,12125,308,672
223.755,17,4,352,2,60,223754,60,176,2,60,223753,60,176
0.088,17,5,1506,5,273,22,316,1506,0,0,0,0,0
81.019,6,44,10624,21,769,567,1360,4778,23,327,3674,2667,5846
116.03,17,2,400,2,172,116030,172,400,0,0,0,0,0
1799.149,1,58,4872,0,0,0,0,0,58,56,31564,56,4872
32.672,6,2,296,2,96,32672,128,296,0,0,0,0,0
1679.709,17,13,534,11,14,167952,14,462,2,8,1679525,8,72
368.438,6,25,1651,17,177,23027,177,1117,8,110,9202,110,534
240.224,6,57,17757,30,770,8283,1402,14674,27,208,9239,580,3083
2.7,17,19,13126,11,928,270,1350,10522,8,297,235,1350,2604
1.245,6,41,11378,22,547,59,1360,5842,19,433,59,1360,5536
0.204,17,2,290,1,40,0,40,68,1,194,0,194,222
15.987,6,26,3035,14,304,1229,304,1956,12,83,1412,83,1079
7.157,6,1529,1375400,944,1378,7,1408,1340316,585,931,11,2816,35084
1768.112,1,58,4872,58,56,31019,56,4872,0,0,0,0,0
280.568,6,29,7392,13,158,23380,267,1317,16,678,18696,3456,6075
1320.022,17,84,6720,42,48,32194,48,3192,42,56,32194,56,3528
40.875,17,22,1936,11,48,4086,48,836,11,72,4086,72,1100
180.893,6,30,8595,16,229,12049,778,1988,14,653,13903,2736,6607
367.036,6,25,1651,17,177,22939,177,1117,8,110,9180,110,534
1775.717,17,140,11200,70,48,25734,48,5320,70,56,25734,56,5880
1775.063,6,185,15887,122,69,14669,69,9020,63,69,28619,69,6867
1.224,6,49,18930,27,868,47,1360,13274,22,433,50,1360,5656
1745.731,6,95,7203,63,38,28156,205,4476,32,33,56304,98,2727
33.436,17,12,1764,6,48,6685,48,456,6,190,6684,308,1308
191.458,6,9,514,3,106,95728,106,234,6,0,38289,0,280
0.867,6,3,2655,1,0,0,0,40,2,1267,22,1440,2615
0.029,17,2,904,1,300,0,300,328,1,548,0,548,576
1746.614,6,153,9578,80,47,22109,208,5728,73,31,24252,31,3850
0.377,17,2,152,1,48,0,48,76,1,48,0,48,76
1799.332,17,449,39928,404,35,4464,288,25708,45,288,40017,288,14220
0.434,6,4,1037,2,0,221,0,104,2,853,215,853,933
0.152,17,2,392,1,40,0,40,68,1,296,0,296,324
67.192,6,58,37196,37,1142,1866,1408,29361,21,841,3074,2439,7835
0.416,17,2,152,1,48,0,48,76,1,48,0,48,76
1799.676,17,449,39928,404,35,4465,288,25708,45,288,40021,288,14220
0.261,17,2,572,1,39,0,39,67,1,477,0,477,505
1797.343,17,142,11360,71,48,25676,48,5396,71,56,25676,56,5964
8.948,6,80,24970,41,568,223,1152,19269,39,459,229,1179,5701
69.072,6,26,7137,12,155,6279,267,1266,14,530,5312,2006,5871
0.103,6,13,2037,8,329,14,500,1082,5,687,25,687,955
1.433,17,4,808,3,64,708,64,276,1,504,0,504,532
10.863,6,760,717186,506,1351,21,1368,699302,254,776,42,2736,17884
5.034,17,4,288,2,36,4986,36,128,2,52,4985,52,160
1783.744,6,354,22440,207,69,8658,69,12420,147,69,12217,69,10020
261.934,1,2,220,2,82,261934,88,220,0,0,0,0,0
0.431,6,12,1653,6,288,78,288,548,6,426,52,434,1105
825.309,6,54,4143,34,64,25009,64,2384,20,56,43429,58,1759
124.247,6,35,7906,12,155,28,267,1266,23,317,5647,1420,6640
0.495,6,20,7238,13,335,41,668,2026,7,1210,75,1946,5212
0.416,17,23,17159,14,845,29,1350,12222,9,520,47,1350,4937
118.531,6,24,6314,13,189,9877,516,1472,11,549,11838,1452,4842
0.435,17,2,146,1,37,0,37,65,1,53,0,53,81
1681.701,17,18,1413,9,30,210209,37,529,9,70,210210,136,884
1772.834,6,180,15480,120,69,14897,69,8940,60,69,30046,69,6540
5.017,17,4,558,2,36,5008,36,128,2,187,5007,187,430
1746.102,6,96,7493,63,43,28162,205,4681,33,33,54558,98,2812
182.06,17,4,240,2,32,182059,32,120,2,32,182059,32,120
1744.635,2,26,832,26,8,69785,8,832,0,0,0,0,0
27.135,17,6,2016,6,308,5427,308,2016,0,0,0,0,0
0.31,17,2,214,1,39,0,39,67,1,119,0,119,147
0.357,17,2,193,1,46,0,46,74,1,91,0,91,119
0.669,6,10,1677,6,555,125,951,1354,4,159,207,159,323
1784.601,6,361,22858,210,69,8538,69,12678,151,69,11897,69,10180
0.217,6,9,1339,5,145,54,145,349,4,826,48,826,990
0.092,17,4,364,2,52,0,52,160,2,74,46,80,204
34.281,6,34,5918,17,154,2142,722,2012,17,377,2131,1408,3906
377.346,2,3,96,3,8,188673,8,96,0,0,0,0,0
247.236,6,40,13340,26,387,9889,1360,6497,14,783,19004,3494,6843
0.447,17,2,144,1,36,0,36,64,1,52,0,52,80
1795.389,17,446,39548,402,35,4477,288,25644,44,288,40945,288,13904
0.828,17,16,10530,9,881,103,1350,8181,7,307,132,1350,2349
1.388,17,26,20722,15,932,93,1350,14407,11,546,131,1350,6315
0.01,17,2,427,1,39,0,39,67,1,332,0,332,360
3.28,17,22,17486,11,847,325,1350,9631,11,686,324,1350,7855
1787.441,6,102,8228,68,64,26678,64,4896,34,58,54161,58,3332
315.716,17,20,6720,20,308,16616,308,6720,0,0,0,0,0
208.693,17,22,7336,22,305,9937,308,7336,0,0,0,0,0
33.527,6,31,5096,15,154,2394,722,1860,16,342,2222,1408,3236
1741.73,6,87,6322,58,31,30556,31,3915,29,31,62204,31,2407
1799.954,6,376,26217,217,98,8333,469,15372,159,69,11391,69,10845
0.029,2,2,64,2,8,29,8,64,0,0,0,0,0
6.18,17,40,22626,21,847,309,1350,18393,19,194,216,1350,4233
1791.115,1,342,28728,342,56,5252,56,28728,0,0,0,0,0
1.617,6,49,19728,29,918,57,1360,14107,20,480,74,4075,5621
1799.644,17,4424,212352,2212,20,813,20,106176,2212,20,813,20,106176
1792.966,1,342,28728,342,56,5257,56,28728,0,0,0,0,0
1797.066,6,362,22898,210,69,8598,69,12678,152,69,11897,69,10220
0.335,17,7,2429,7,319,55,354,2429,0,0,0,0,0
280.502,6,28,7352,13,158,23375,267,1317,15,775,20026,4836,6035
1785.859,6,356,22589,207,69,8669,69,12420,149,69,12066,69,10169
3.264,17,4,1564,4,363,1088,363,1564,0,0,0,0,0
1.18,6,24,8004,12,164,91,267,1288,12,1014,91,2423,6716
2.239,6,38,13612,21,764,111,1460,6249,17,606,120,1460,7363
43.977,17,24,1392,24,30,1912,30,1392,0,0,0,0,0
25.095,6,23,3291,10,821,2787,1420,2058,13,231,2090,231,1233
1779.185,1,61,5124,0,0,0,0,0,61,56,29653,56,5124
0.511,17,3,451,2,39,59,39,134,1,289,0,289,317
99.328,6,28,13146,14,493,125,832,2589,14,998,7631,2568,10557
3.56,6,7,519,0,0,0,0,0,7,31,593,31,519
365.939,6,18,1239,14,177,28149,177,913,4,110,20055,110,326
1788.521,6,130,15498,81,90,22356,502,6763,49,157,37259,1420,8735
0.0,17,3,901,3,272,0,316,901,0,0,0,0,0
1387.121,2,11,352,11,8,138712,8,352,0,0,0,0,0
0.519,17,3,451,2,39,458,39,134,1,289,0,289,317
0.895,6,24,9006,14,275,68,743,1694,10,1150,80,2570,7312
540.946,1,6,336,6,28,108189,28,336,0,0,0,0,0
83.942,6,809,399505,449,826,187,1152,380655,360,444,233,1179,18850
1793.354,6,164,20964,95,304,19078,304,14688,69,83,26372,83,6276
1777.968,17,50,16776,50,307,36285,308,16776,0,0,0,0,0
1.407,6,38,8254,19,321,78,1164,2718,19,433,66,1440,5536
0.144,17,2,158,1,34,0,34,62,1,68,0,68,96
0.94,2,2,80,2,16,940,16,80,0,0,0,0,0
6.241,6,61,14453,30,263,215,1440,3698,31,474,200,1440,10755
15.448,17,12,6255,6,649,3083,1350,4064,6,337,3082,1350,2191
2.232,6,35,6403,19,135,124,267,1854,16,780,143,1491,4549
1.753,17,20,5180,20,231,92,388,5180,0,0,0,0,0
0.16,1,2,112,2,28,160,28,112,0,0,0,0,0
4.518,17,19,7630,9,496,564,1350,4719,10,263,496,1350,2911
44.552,6,41,8844,20,401,791,889,2096,21,393,2219,4848,6748
669.153,17,13,962,13,46,55762,46,962,0,0,0,0,0
75.834,6,72,45722,43,1174,1805,1408,37483,29,960,2196,3847,8239
1799.902,17,144,11520,72,48,25350,48,5472,72,56,25350,56,6048
1783.812,6,366,24672,213,88,8414,469,14067,153,69,11735,69,10605
807.467,1,25,1400,25,28,33644,28,1400,0,0,0,0,0
1681.701,17,14,1036,7,30,280276,30,406,7,62,280278,62,630
1799.537,17,449,39928,404,35,4465,288,25708,45,288,40018,288,14220
309.328,17,22,7216,22,300,14729,300,7216,0,0,0,0,0
1740.688,17,30,31680,30,1028,60023,1028,31680,0,0,0,0,0
0.0,17,1,102,1,74,0,74,102,0,0,0,0,0
1489.683,17,65,5311,65,53,23276,355,5311,0,0,0,0,0
300.019,6,1048,816023,601,1344,499,1360,790233,447,207,672,1360,25790
1.461,6,45,18684,26,928,58,1460,13148,19,476,70,2615,5536
2.4,6,2,100,1,0,0,0,60,1,0,0,0,40
1750.759,17,13,534,11,14,175054,14,462,2,8,1750576,8,72
35.272,6,27,7177,13,155,2939,267,1306,14,530,2712,3417,5871
22.005,6,24,6231,14,117,1692,159,1337,10,727,2443,1418,4894
798.404,6,66,8418,36,102,18818,516,3184,30,161,27527,1452,5234
298.862,1,4,224,4,28,99620,28,224,0,0,0,0,0
38.479,17,11,836,11,48,3847,48,836,0,0,0,0,0
1798.069,1,220,12320,220,28,8210,28,12320,0,0,0,0,0
12.111,1,4,424,4,78,4037,78,424,0,0,0,0,0
102.034,17,4,308,4,49,34011,49,308,0,0,0,0,0
0.907,17,4,624,2,64,883,64,184,2,192,872,192,440
1793.258,6,132,13196,82,66,22138,722,6931,50,87,36592,1440,6265
0.032,17,2,396,1,40,0,40,68,1,300,0,300,328
1763.453,17,168,43259,168,229,10559,422,43259,0,0,0,0,0
287.713,1,4,224,4,28,95904,28,224,0,0,0,0,0
0.33,6,27,8634,14,219,25,531,1613,13,1056,26,1408,7021
1740.504,17,30,7050,30,207,60017,207,7050,0,0,0,0,0
5.06,17,4,288,2,36,5003,36,128,2,52,5017,52,160
4.039,17,7,7079,2,723,4039,1350,1503,5,1087,767,1350,5576
3.778,17,5,290,5,30,944,30,290,0,0,0,0,0
126.61,6,8,466,5,106,31652,106,322,3,0,540,0,144
1792.364,1,152,8512,152,28,11869,28,8512,0,0,0,0,0
1783.751,17,83,3480,82,14,22021,14,3444,1,8,0,8,36
1794.24,6,357,22629,208,69,8667,69,12460,149,69,12122,69,10169
0.102,6,9,1002,5,213,25,213,417,4,421,30,421,585
1.405,6,49,19192,26,955,56,1460,13496,23,433,55,1460,5696
300.238,6,26,8428,13,409,25019,1050,2334,13,676,3300,2816,6094
1.3,6,47,18717,26,925,52,1460,13101,21,433,56,1460,5616
1786.409,6,104,8435,69,65,26270,65,4970,35,59,52538,59,3465
162.444,17,6,528,3,48,81215,48,228,3,72,81213,72,300
1783.913,6,354,22440,207,69,8659,69,12420,147,69,12218,69,10020
1743.222,1,74,6216,74,56,23879,56,6216,0,0,0,0,0
13.137,17,2,152,2,48,13137,48,152,0,0,0,0,0
679.65,17,20,6736,20,308,35771,316,6736,0,0,0,0,0
152.149,6,23,11278,12,433,68,990,1823,11,1286,15202,3928,9455
92.659,17,4,240,2,32,92657,32,120,2,32,92658,32,120
0.141,17,4,334,2,39,126,39,134,2,72,123,72,200
61.319,6,35,15994,22,816,2919,1408,9320,13,855,5089,3847,6674
5.022,17,4,288,2,36,5004,36,128,2,52,5007,52,160
64.733,6,36,9147,15,327,145,1189,2575,21,440,3235,1460,6572
0.462,6,2,104,1,0,0,0,40,1,0,0,0,64
1680.12,1,7,392,7,28,280020,28,392,0,0,0,0,0
152.896,6,34,15566,19,576,57,1360,3685,15,1126,10910,2720,11881
1788.413,1,124,6944,124,28,14539,28,6944,0,0,0,0,0
101.738,6,11,719,11,31,10173,31,719,0,0,0,0,0
1.501,6,49,19069,26,946,60,1460,13373,23,433,59,1460,5696
0.288,17,2,152,1,48,0,48,76,1,48,0,48,76
25.003,6,30,16439,17,665,1562,1360,4062,13,1480,2070,3943,12377
0.381,6,12,1777,6,125,76,125,385,6,1148,61,1148,1392
8.525,6,1580,1452743,997,1379,8,1408,1417763,583,931,14,2801,34980
1794.783,17,87,3648,86,14,21115,14,3612,1,8,0,8,36
0.258,17,2,384,1,39,0,39,67,1,289,0,289,317
0.033,17,2,138,1,33,0,33,61,1,49,0,49,77
361.022,2,6,192,6,8,72204,8,192,0,0,0,0,0
39.529,17,11,836,11,48,3952,48,836,0,0,0,0,0
0.414,17,4,368,2,32,205,32,120,2,96,200,96,248
0.123,6,4,160,2,0,14,0,80,2,0,110,0,80
12.0,6,1902,1650597,1165,1364,10,1380,1616887,737,421,16,1923,33710
0.416,6,27,9076,13,252,34,647,1692,14,831,30,1438,7384
5.945,17,5,738,4,32,1329,32,240,1,470,0,470,498
1775.506,6,203,22290,130,75,13763,267,10057,73,134,24653,1917,12233
1620.804,1,7,392,7,28,270134,28,392,0,0,0,0,0
19.523,17,6,1236,3,48,9756,48,228,3,308,9755,308,1008
7.922,6,23,4478,13,213,660,597,1741,10,441,858,1408,2737
2.353,6,14,2351,8,188,336,245,700,6,703,419,1152,1651
1799.924,1,56,4704,56,56,32725,56,4704,0,0,0,0,0
3.948,17,5,295,5,31,987,31,295,0,0,0,0,0
2.519,6,13,2311,8,188,359,245,700,5,1407,564,1407,1611
0.448,6,20,7229,13,334,37,663,2021,7,1209,69,1946,5208
1776.132,1,58,4872,58,56,31160,56,4872,0,0,0,0,0
255.843,1,4,224,4,28,85281,28,224,0,0,0,0,0
300.429,6,28,10232,15,421,21459,1130,2474,13,786,2543,1503,7758
0.014,17,2,607,1,43,0,43,71,1,508,0,508,536
1780.934,17,140,11200,70,48,25810,48,5320,70,56,25810,56,5880
28.168,6,42,9094,18,218,1656,314,3343,24,398,1209,1152,5751
61.34,6,9,372,5,0,15335,0,204,4,0,20441,0,168
1783.201,17,83,3480,82,14,22014,14,3444,1,8,0,8,36
156.747,1,4,224,4,28,52249,28,224,0,0,0,0,0
1740.304,6,87,6322,58,31,30531,31,3915,29,31,62153,31,2407
1774.316,1,59,4956,59,56,30591,56,4956,0,0,0,0,0
0.237,1,2,112,2,28,237,28,112,0,0,0,0,0
0.219,17,4,360,2,30,188,30,116,2,94,187,94,244
1771.73,6,99,9306,66,66,27257,66,5610,33,60,55364,60,3696
162.579,6,75,19256,32,418,799,1221,8398,43,260,3870,2608,10858
1337.401,1,48,5088,48,78,28455,78,5088,0,0,0,0,0
0.536,17,3,451,2,39,444,39,134,1,289,0,289,317
143.396,6,43,29387,24,243,6234,444,2102,19,1877,7964,5632,27285
1.823,6,37,8202,18,321,107,1164,2666,19,433,89,1360,5536
88.079,17,4,352,2,60,88077,60,176,2,60,88078,60,176
1772.594,6,180,15480,120,69,14895,69,8940,60,69,30036,69,6540
282.97,6,19,6476,2,106,200,106,194,17,372,17685,1460,6282
11.842,6,25,8473,13,275,986,275,1078,12,986,854,1440,7395
1800.0,6,401,37659,173,180,10302,1360,21416,228,46,7929,143,16243
106.174,6,32,14236,17,519,69,884,2825,15,981,7574,1503,11411
1.814,17,2,214,1,39,0,39,67,1,119,0,119,147
1.862,6,33,9027,15,327,133,1189,2575,18,440,108,1420,6452
3.145,6,3,180,3,0,0,0,180,0,0,0,0,0
1772.654,6,180,15480,120,69,14896,69,8940,60,69,30042,69,6540
0.24,17,2,2754,2,1349,240,1349,2754,0,0,0,0,0
60.977,6,31,7911,8,156,326,267,1112,23,309,2771,1997,6799
1789.401,1,192,10752,192,28,9368,28,10752,0,0,0,0,0
56.472,6,31,7725,11,155,8,267,1226,20,355,2971,3417,6499
11.089,6,28,11569,13,275,924,275,1078,15,987,718,1440,10491
2.793,6,35,18902,20,760,147,1360,6213,15,1341,190,2759,12689
239.579,6,28,8578,11,181,23957,267,1168,17,560,14965,2036,7410
1.005,6,27,8420,15,222,60,540,1964,12,1192,75,3151,6456
3.74,6,146,109758,85,1354,44,1432,102338,61,428,56,1871,7420
1.777,17,2,204,1,34,0,34,62,1,114,0,114,142
1.182,6,23,7952,12,164,92,267,1288,11,1216,101,3819,6664
1787.585,6,102,8296,68,65,26680,65,4930,34,59,54166,59,3366
6.846,6,1397,1314722,893,1396,7,1408,1283838,504,931,13,2801,30884
0.037,17,4,352,2,60,36,60,176,2,60,31,60,176
1786.479,6,102,8364,68,66,26663,66,4964,34,60,54132,60,3400
1742.761,6,95,7203,63,38,28109,205,4476,32,33,56209,98,2727
22.237,6,3159,2895401,1923,1420,11,1448,2822317,1236,776,17,1448,73084
1791.175,6,367,23236,212,69,8488,69,12896,155,69,11630,69,10340
1746.28,6,173,10533,87,46,20305,208,6194,86,31,20541,31,4339
8.034,6,32,8952,14,158,618,267,1357,18,624,453,1300,7595
1798.618,17,767,46250,767,32,2348,37,46250,0,0,0,0,0
0.218,17,2,152,1,48,0,48,76,1,48,0,48,76
335.033,1,10,560,10,28,37225,28,560,0,0,0,0,0
159.703,6,208,169512,136,1296,1182,1408,154866,72,680,2191,3847,14646
0.033,17,2,198,1,39,0,39,67,1,103,0,103,131
301.03,6,56,23532,31,1088,10034,1440,17637,25,325,374,1440,5895
9.371,6,81,24797,42,561,228,1152,19096,39,413,239,1152,5701
59.399,1,17,1428,17,56,3712,56,1428,0,0,0,0,0
240.872,6,49,13856,25,693,10034,1368,11021,24,197,10469,580,2835
5.042,17,4,558,2,36,5031,36,128,2,187,5033,187,430
21.01,6,3112,2979089,2109,1338,9,1368,2922269,1003,776,20,1473,56820
0.015,6,14,4044,8,88,2,88,452,6,1670,2,1880,3592
15.809,17,12,5989,6,619,3140,1350,3885,6,322,3148,1350,2104
0.456,6,14,5618,6,106,91,106,354,8,822,8,1420,5264
38.621,17,2,2116,2,1030,38621,1030,2116,0,0,0,0,0
1252.044,6,262,19311,147,112,8575,469,11399,115,69,10982,69,7912
60.681,6,10,536,5,0,15170,0,268,5,0,15167,0,268
366.636,6,43,22408,26,248,14665,682,2390,17,1593,15017,2816,20018
0.406,17,2,152,1,48,0,48,76,1,48,0,48,76
4.029,17,3,264,3,60,2014,60,264,0,0,0,0,0
240.19,6,41,26471,23,179,10917,179,1383,18,1609,14124,2736,25088
1798.054,17,449,39928,404,35,4461,288,25708,45,288,40019,288,14220
1.361,6,24,8004,12,164,104,267,1288,12,1014,104,2736,6716
1789.504,6,358,22669,209,69,8603,69,12500,149,69,12091,69,10169
0.767,17,2,784,2,364,767,364,784,0,0,0,0,0
22.151,6,52,29739,28,243,820,444,2194,24,1383,956,2876,27545
207.485,6,103,74734,65,1249,3241,1408,64617,38,677,2533,1408,10117
8.105,6,80,24986,41,569,202,1152,19285,39,413,206,1152,5701
1797.397,6,367,25650,214,99,8438,469,15045,153,69,11823,69,10605
0.274,17,4,644,2,36,257,36,128,2,230,246,230,516
0.155,6,2,80,1,0,0,0,40,1,0,0,0,40
1684.809,17,12,498,11,14,168480,14,462,1,8,0,8,36
0.504,6,22,7333,13,334,41,663,2021,9,967,61,1471,5312
0.096,6,9,1340,5,145,24,145,349,4,827,24,827,991
143.599,6,39,19096,22,982,6838,1360,10740,17,1094,8962,3957,8356
0.966,17,2,244,2,94,966,94,244,0,0,0,0,0
1779.735,6,216,20240,109,70,16479,721,9489,107,174,16787,1440,10751
0.154,17,2,184,1,32,0,32,60,1,96,0,96,124
2.989,17,4,624,4,128,996,128,624,0,0,0,0,0
0.973,17,23,15824,13,986,81,1350,13191,10,235,104,1350,2633
1767.092,1,58,4872,58,56,31001,56,4872,0,0,0,0,0
1744.718,6,95,7203,63,38,28140,205,4476,32,33,56268,98,2727
120.262,2,2,64,2,8,120262,8,64,0,0,0,0,0
1786.642,17,87,3648,86,14,21019,14,3612,1,8,0,8,36
3.597,17,4,1556,4,361,1199,361,1556,0,0,0,0,0
126.435,2,2,64,2,8,126435,8,64,0,0,0,0,0
0.085,6,12,3462,6,75,16,75,395,6,1373,17,1448,3067
4.722,6,22,4522,12,226,429,597,1753,10,560,504,1767,2769
2.441,6,14,2351,8,188,348,245,700,6,703,436,1152,1651
67.687,6,28,7445,11,150,6767,267,1502,17,477,4229,1420,5943
0.105,6,10,1512,5,503,26,503,771,5,473,26,473,741
1793.954,6,240,35580,150,302,12039,302,25920,90,83,20156,83,9660
0.904,6,52,21231,28,1056,33,1380,15984,24,387,36,1923,5247
1364.438,17,20,7017,20,322,71812,548,7017,0,0,0,0,0
160.875,6,25,1028,10,0,5495,0,408,15,0,11490,0,620
1741.333,17,29,30624,29,1028,62190,1028,30624,0,0,0,0,0
52.539,6,1056,913585,699,1333,46,1360,890634,357,179,147,2667,22951
0.137,17,2,152,1,48,0,48,76,1,48,0,48,76
0.054,17,2,154,1,33,0,33,61,1,65,0,65,93
325.699,6,9,546,6,31,65139,31,333,3,31,162845,31,213
3.941,6,34,6185,17,206,246,314,2744,17,551,229,1179,3441
40.788,17,3,228,3,48,20394,48,228,0,0,0,0,0
6.939,6,14,2254,8,210,990,210,856,6,545,1384,904,1398
1.282,6,41,9968,21,440,64,1360,4392,20,476,58,2715,5576
188.905,6,41,8565,18,123,11112,267,1713,23,329,8586,3426,6852
521.192,17,10,902,5,32,130288,37,304,5,91,130287,136,598
83.447,17,3348,3341953,929,43,89,1350,66246,2419,1326,34,1350,3275707
601.643,2,6,192,6,8,120328,8,192,0,0,0,0,0
1118.747,6,55,2525,27,0,43028,0,1380,28,1,41434,1,1145
1771.204,6,99,9174,66,64,27249,64,5544,33,58,55347,58,3630
1798.182,17,390,34632,351,35,5137,288,22308,39,288,46339,288,12324
11.616,6,1839,1605324,1115,1384,10,1420,1572143,724,420,16,1420,33181
502.388,17,10,3360,10,308,55820,308,3360,0,0,0,0,0
12.045,6,24,8433,13,275,1003,275,1078,11,986,936,1440,7355
17.831,6,13,2972,4,510,5939,595,1236,9,212,2227,212,1736
280.182,6,26,7272,13,158,23348,267,1317,13,905,23345,4845,5955
300.892,6,40,10539,22,682,14328,1360,5017,18,399,510,1360,5522
125.663,6,37,8055,13,155,26,267,1306,24,304,5463,1420,6749
9.202,6,66,20478,34,554,278,1152,15771,32,427,288,1152,4707
1.476,6,218,185800,141,1349,10,1432,178420,77,428,18,1871,7380
1657.219,1,7,392,7,28,276203,28,392,0,0,0,0,0
1.34,6,24,8004,12,164,103,267,1288,12,1014,103,2331,6716
62.409,6,68,49732,45,1195,1418,1368,41802,23,840,2824,2519,7930
125.976,6,30,8872,13,158,10498,267,1317,17,687,7868,2036,7555
300.703,6,38,8566,20,315,15826,882,2093,18,441,498,1440,6473
1.204,6,205,160514,120,1358,10,1432,152881,85,420,14,1432,7633
12.43,6,1965,1717661,1195,1383,10,1420,1682640,770,467,16,1883,35021
75.449,6,15,3214,5,92,177,92,360,10,1165,8361,1448,2854
8.533,1,9,756,9,56,1066,56,756,0,0,0,0,0
758.791,1,26,2184,26,56,30351,56,2184,0,0,0,0,0
38.186,6,10,580,3,0,19093,0,160,7,0,5285,0,420
2.048,17,4,240,2,32,2047,32,120,2,32,2047,32,120
37.867,6,49,16730,26,1080,651,1360,10853,23,309,1713,2667,5877
172.035,6,33,14863,16,894,85,1460,6049,17,812,10741,1460,8814
11.667,6,21,6825,12,275,1060,275,1038,9,1353,832,1440,5787
1799.473,6,424,25405,212,69,8528,69,12620,212,34,8528,48,12785
189.947,6,69434,73416102,22718,650,8,652,1251389,46716,1492,4,10087,72164713
1772.319,6,101,9410,66,66,27266,66,5610,35,60,52124,60,3800
8.969,6,86,27943,44,588,208,1152,21781,42,447,212,1179,6162
1794.417,1,146,8176,146,28,12375,28,8176,0,0,0,0,0
300.56,6,41,8746,22,308,14312,889,2171,19,414,467,2720,6575
0.381,6,10,967,5,256,91,256,460,5,303,91,303,507
0.399,6,10,968,5,256,97,256,460,5,304,97,304,508
240.213,6,55,18962,30,797,8283,1402,15922,25,216,10008,580,3040
0.082,6,12,3705,6,171,15,171,491,6,964,15,1448,3214
300.16,6,34,9077,19,404,16675,1243,2674,15,802,4941,1448,6403
37.646,6,5016,4821042,3344,1365,11,1408,4729410,1672,776,22,1408,91632
11.723,6,25,8473,13,275,976,275,1078,12,986,816,1440,7395
9.786,6,52,21496,28,732,362,1460,7832,24,845,385,1460,13664
1799.605,17,525,64019,239,164,7520,1350,45999,286,35,6314,1350,18020
368.327,6,21,1422,15,180,26309,180,992,6,110,12240,110,430
0.04,17,2,912,1,308,0,308,336,1,548,0,548,576
1773.013,6,204,22468,130,75,13744,267,10057,74,134,24283,2006,12411
5.036,6,39,7269,20,218,265,314,3423,19,513,265,1179,3846
1730.878,17,130,25016,130,164,13417,422,25016,0,0,0,0,0
0.509,17,3,451,2,39,497,39,134,1,289,0,289,317
242.486,6,1816,886649,964,845,251,1152,841890,852,395,284,1179,44759
1798.328,17,448,39896,403,35,4473,288,25676,45,288,40018,288,14220
1.293,17,4,240,2,32,1292,32,120,2,32,1292,32,120
1739.431,6,92,6668,60,31,29481,31,4062,32,31,56110,31,2606
1785.288,6,128,18320,80,250,22598,1307,13214,48,79,37976,191,5106
0.016,6,2,402,1,0,0,0,40,1,322,0,322,362
4.766,17,5,4930,5,958,1191,1437,4930,0,0,0,0,0
300.145,6,46,14032,21,892,14999,1360,8013,25,278,12499,2667,6019
1796.505,6,356,22520,208,69,8678,69,12460,148,69,12221,69,10060
16.657,6,8,506,8,31,2379,31,506,0,0,0,0,0
0.093,17,2,362,1,46,0,46,74,1,260,0,260,288
902.749,6,39,6761,21,222,45137,1314,2627,18,284,53094,1460,4134
1772.438,6,180,15480,120,69,14894,69,8940,60,69,30037,69,6540
5.542,6,38,25973,16,883,334,1402,9682,22,1080,263,1402,16291
5.552,6,12,3042,4,92,1850,92,296,8,387,647,1408,2746
1788.399,6,100,6484,64,47,28387,208,4114,36,31,51085,31,2370
240.345,6,58,20654,32,804,7752,1418,17766,26,191,9613,580,2888
1795.146,17,80,3354,79,14,23014,14,3318,1,8,0,8,36
84.455,6,9,515,5,43,21113,43,299,4,0,28150,0,216
1757.336,6,4611,4412210,1601,147,1098,916,97368,3010,1415,584,5672,4314842
1677.598,1,7,392,7,28,279599,28,392,0,0,0,0,0
13.623,6,27,4867,13,154,1117,722,1767,14,394,1034,1448,3100
96.109,1,6,336,6,28,19221,28,336,0,0,0,0,0
1796.918,1,345,28980,345,56,5223,56,28980,0,0,0,0,0
1569.6,6,311,19685,181,69,8719,69,10897,130,69,12167,69,8788
1682.569,17,14,3811,7,30,280426,30,406,7,458,280426,463,3405
1783.878,6,106,8515,69,65,26233,65,4970,37,59,49549,59,3545
0.287,6,9,1340,5,145,71,145,349,4,827,39,827,991
6.27,6,8,1874,5,183,1497,267,571,3,1179,3015,1179,1303
280.512,6,30,7432,13,158,23376,267,1317,17,603,17528,1380,6115
1772.766,6,268,32210,109,127,16413,1360,15143,159,137,11219,4662,17067
1786.061,6,103,8395,68,65,26657,65,4930,35,59,52528,59,3465
82.014,17,20,1520,20,48,4316,48,1520,0,0,0,0,0
0.023,17,4,284,2,32,16,32,120,2,54,12,60,164
252.003,2,2,64,2,8,252003,8,64,0,0,0,0,0
2.164,17,2,146,1,37,0,37,65,1,53,0,53,81
280.473,6,30,7432,13,158,23372,267,1317,17,603,17525,2760,6115
1783.015,17,140,11200,70,48,25840,48,5320,70,56,25840,56,5880
1787.09,17,1087,337998,552,526,3239,1350,306032,535,31,3346,340,31966
5.499,6,41,7349,22,218,261,314,3503,19,513,291,1179,3846
0.399,6,13,1997,8,329,56,500,1082,5,647,99,647,915
280.034,6,29,7392,14,158,21541,267,1357,15,678,20000,2045,6035
599.504,1,9,504,9,28,74938,28,504,0,0,0,0,0
0.117,6,20,9025,10,121,12,121,649,10,1121,13,1448,8376
280.515,6,29,7392,13,158,23376,267,1317,16,603,18693,2076,6075
1710.613,17,13,534,11,14,171043,14,462,2,8,1710435,8,72
1789.94,6,357,22629,208,69,8646,69,12460,149,69,12094,69,10169
1791.473,6,145,15724,87,79,20831,501,6755,58,144,31427,1420,8969
4.972,17,4,288,2,36,4957,36,128,2,52,4959,52,160
0.113,17,2,166,1,39,0,39,67,1,71,0,71,99
1798.568,17,142,11360,71,48,25693,48,5396,71,56,25693,56,5964
3.521,6,33,6129,17,206,220,314,2744,16,456,218,1152,3385
1116.84,6,238,17454,135,114,8334,469,10436,103,69,10949,69,7018
296.852,6,4375,3777084,1954,348,151,349,122281,2421,1461,122,2736,3654803
0.29,6,24,8313,12,269,26,699,1710,12,995,25,1402,6603
3.815,17,4,352,2,60,3814,60,176,2,60,3813,60,176
0.783,6,31,8081,18,456,46,1360,3059,13,498,50,1384,5022
97.745,6,194,83444,95,786,1039,1152,72988,99,405,993,1179,10456
1781.519,1,58,4872,58,56,31254,56,4872,0,0,0,0,0
15.195,6,5,752,3,46,7597,46,166,2,506,15016,506,586
7.997,6,15,4050,8,275,1142,275,878,7,1440,1006,1440,3172
55.794,17,5,380,5,48,13948,48,380,0,0,0,0,0
1784.55,1,190,10640,190,28,9442,28,10640,0,0,0,0,0
1740.973,6,87,6322,58,31,30543,31,3915,29,31,62176,31,2407
1785.138,17,87,3648,86,14,21001,14,3612,1,8,0,8,36
15.255,6,8,344,3,0,7627,0,124,5,0,3811,0,220
1758.022,6,103,6238,57,26,31393,26,3378,46,26,39066,26,2860
15.024,17,8,1116,4,36,5003,36,256,4,187,5004,187,860
317.502,6,650,561458,421,1331,755,1360,545435,229,236,110,2667,16023
0.13,6,9,1340,5,145,32,145,349,4,827,29,827,991
1789.039,17,87,3648,86,14,21047,14,3612,1,8,0,8,36
59.25,17,5,1640,5,300,14812,300,1640,0,0,0,0,0
1.674,6,51,19429,29,892,59,1360,13728,22,437,69,2715,5701
0.725,6,10,968,5,256,153,256,460,5,304,155,304,508
0.151,17,2,212,1,46,0,46,74,1,110,0,110,138
809.715,1,10,560,10,28,89968,28,560,0,0,0,0,0
0.004,6,18,32388,1,0,0,0,40,17,1850,0,2736,32348
1284.586,1,42,3528,42,56,31331,56,3528,0,0,0,0,0
0.919,6,11,1727,7,100,153,100,384,4,589,217,1152,1343
12.186,6,1805,1671531,1125,1406,10,1448,1631507,680,776,17,1448,40024
1793.671,1,246,13776,246,28,7321,28,13776,0,0,0,0,0
21.964,17,44,11396,44,231,510,388,11396,0,0,0,0,0
280.343,6,29,7392,13,158,23361,267,1317,16,603,18681,1400,6075
24.857,6,12,708,5,106,6211,106,314,7,90,4141,90,394
12.7,6,83,25074,42,568,309,1152,19293,41,459,311,1179,5781
280.235,6,28,7352,13,158,23352,267,1317,15,678,20014,2800,6035
0.021,17,2,124,1,34,0,34,62,1,34,0,34,62
1746.21,1,8,448,8,28,249458,28,448,0,0,0,0,0
1789.83,6,373,23821,213,69,8388,69,12867,160,69,11256,69,10954
4.299,6,21,6420,10,286,472,517,1388,11,892,425,2407,5032
1792.248,6,360,24215,210,83,8575,981,13521,150,75,12025,485,10694
1772.284,6,180,15480,120,69,14893,69,8940,60,69,30035,69,6540
0.444,6,126,90487,62,131,7,232,3009,64,1439,6,3337,87478
1773.397,1,96,10176,96,78,18667,78,10176,0,0,0,0,0
30.564,17,2,563,2,253,30564,341,563,0,0,0,0,0
1631.782,1,7,392,7,28,271963,28,392,0,0,0,0,0
1790.623,6,366,25541,213,100,8446,469,14936,153,69,11780,69,10605
1786.935,6,105,8348,68,64,26670,64,4896,37,58,49634,58,3452
48.406,6,7,426,2,106,48389,106,194,5,0,12095,0,232
133.252,17,8,2688,8,308,19036,308,2688,0,0,0,0,0
11.624,6,25,8473,13,275,968,275,1078,12,986,772,1440,7395
4.345,6,33,6129,17,206,271,314,2744,16,548,273,1179,3385
0.192,6,46,20494,26,1029,7,1420,15473,20,467,9,1883,5021
31.446,17,8,1648,4,48,10474,48,304,4,308,10475,308,1344
280.507,6,29,7392,13,158,23375,267,1317,16,603,18696,2036,6075
507.672,6,35,7136,17,151,13568,501,1745,18,291,29857,1420,5391
0.601,17,2,136,1,32,0,32,60,1,48,0,48,76
0.595,6,10,924,5,283,103,283,551,5,105,102,105,373
1785.858,17,142,11360,71,48,25512,48,5396,71,56,25512,56,5964
1.066,6,9,1647,6,100,213,100,344,3,1179,403,1179,1303
1788.969,6,355,22480,207,69,8684,69,12420,148,69,12169,69,10060
7.465,17,3,228,3,48,3732,48,228,0,0,0,0,0
1.362,6,48,19980,28,883,50,1360,14404,20,476,62,2715,5576
10.77,6,20,4442,11,275,1077,275,998,9,768,752,1440,3444
299.53,6,6,364,4,31,99843,31,222,2,31,299513,31,142
1656.026,6,122,19377,71,89,23657,721,7515,51,516,12730,2535,11862
1797.44,17,142,11360,71,48,25677,48,5396,71,56,25677,56,5964
300.793,6,44,13788,25,892,12533,1460,8181,19,402,478,2567,5607
175.25,17,2,72,1,8,0,8,36,1,8,0,8,36
1044.655,17,263,27815,115,136,9163,1350,18954,148,31,7106,60,8861
361.022,2,3,96,3,8,180511,8,96,0,0,0,0,0
1.394,6,49,19370,29,896,49,1360,13749,20,437,63,2715,5621
35.027,17,40,5880,20,48,1842,48,1520,20,190,1842,308,4360
1.177,6,51,21240,29,899,42,1360,15584,22,476,48,2720,5656
2.77,17,21,7036,8,280,395,1350,2467,13,323,132,1350,4569
5.2,6,45,8425,23,227,236,314,4102,22,491,236,1179,4323
0.034,6,11,1864,6,262,6,517,844,5,752,8,752,1020
0.334,6,26,9003,13,252,27,647,1704,13,945,26,1408,7299
599.227,6,11,657,7,31,99871,31,373,4,31,199739,31,284
1798.258,17,448,39896,403,35,4473,288,25676,45,288,40023,288,14220
0.188,17,9,665,6,40,1,41,411,3,56,85,57,254
61.688,6,63,41364,39,1160,1623,1448,33363,24,749,2671,1448,8001
26.833,6,51,10547,24,533,667,910,3199,27,312,1027,1460,7348
1789.47,17,87,3648,86,14,21052,14,3612,1,8,0,8,36
1673.222,6,24,3973,16,262,111548,413,2740,8,114,239002,269,1233
1784.837,6,355,22480,207,69,8664,69,12420,148,69,12141,69,10060
195.164,17,5,680,5,108,48791,348,680,0,0,0,0,0
4.553,6,40,7309,20,218,239,314,3423,20,440,226,1152,3886
5.101,17,3,208,2,36,5005,36,128,1,52,0,52,80
165.13,6,25,1020,10,0,6142,0,404,15,0,11794,0,616
11.171,17,4,240,2,32,11170,32,120,2,32,11170,32,120
1.712,6,25,8769,15,286,122,590,1462,10,986,169,1414,7307
1798.887,6,237,24652,93,68,19551,659,9020,144,136,12578,2720,15632
1786.443,17,87,3648,86,14,21016,14,3612,1,8,0,8,36
1772.641,6,180,15480,120,69,14896,69,8940,60,69,30042,69,6540
10.042,17,2,138,2,41,10042,41,138,0,0,0,0,0
924.242,17,74,5920,37,48,25673,48,2812,37,56,25673,56,3108
1.187,6,24,8016,12,164,91,267,1300,12,1014,91,2411,6716
1757.305,1,58,4872,58,56,30829,56,4872,0,0,0,0,0
300.645,6,39,8489,20,286,15823,797,1976,19,441,472,1460,6513
31.628,6,6,360,0,0,0,0,0,6,0,0,0,360
1796.693,6,368,23276,212,69,8515,69,12896,156,69,11588,69,10380
0.319,6,10,1669,6,551,63,947,1346,4,159,106,159,323
280.617,6,32,7853,14,158,21585,267,1357,18,524,16506,1400,6496
0.256,17,2,440,1,39,0,39,67,1,345,0,345,373
0.429,6,10,1992,5,288,99,288,508,5,424,59,434,1484
1775.153,6,180,15480,120,69,14917,69,8940,60,69,30079,69,6540
60.692,6,9,774,5,180,15173,180,448,4,110,20148,110,326
0.234,6,10,1669,6,551,46,947,1346,4,159,77,159,323
0.079,17,4,588,2,48,70,48,152,2,190,65,308,436
1793.918,1,214,11984,214,28,8422,28,11984,0,0,0,0,0
0.325,17,2,212,1,46,0,46,74,1,110,0,110,138
1629.782,1,7,392,7,28,271630,28,392,0,0,0,0,0
375.896,6,21,1422,15,180,26849,180,992,6,110,12228,110,430
291.982,6,32,6921,15,262,20852,517,1576,17,744,18246,1418,5345
1.325,6,50,18698,27,849,50,1360,13002,23,433,52,1360,5696
6.149,6,1883,1753442,1196,1388,5,1408,1713054,687,931,8,2801,40388
0.036,6,6,716,3,302,12,302,458,3,102,7,102,258
1771.26,1,60,5040,0,0,0,0,0,60,56,30021,56,5040
1.957,17,22,5709,22,231,93,389,5709,0,0,0,0,0
1797.836,17,448,39896,403,35,4472,288,25676,45,288,40013,288,14220
0.105,6,9,2074,6,596,20,1033,1437,3,513,51,513,637
19.436,6,1311,1202279,878,1298,21,1368,1175099,433,776,44,1473,27180
15.708,6,17,2434,11,210,1567,210,1036,6,545,3079,904,1398
1777.31,17,142,11360,71,48,25389,48,5396,71,56,25389,56,5964
1797.588,6,356,22520,208,69,8684,69,12460,148,69,12228,69,10060
114.061,1,8,448,8,28,16294,28,448,0,0,0,0,0
0.393,6,14,1733,7,288,65,288,588,7,284,34,434,1145
0.319,6,22,7333,13,334,26,663,2021,9,1209,39,1906,5312
1785.113,17,142,11360,71,48,25501,48,5396,71,56,25501,56,5964
1744.052,6,95,7203,63,38,28129,205,4476,32,33,56250,98,2727
189.528,17,10,880,5,48,47380,48,380,5,72,47379,72,500
1769.237,6,90,6521,59,31,30504,31,3998,31,31,58963,31,2523
0.946,17,6,654,3,33,469,33,183,3,129,469,145,471
1788.028,6,139,8502,73,26,24833,26,4426,66,26,27507,26,4076
16.553,17,37,9685,15,279,1180,1350,4612,22,202,786,1350,5073
1798.002,6,356,22520,208,69,8686,69,12460,148,69,12230,69,10060
541.427,2,8,256,8,8,77346,8,256,0,0,0,0,0
1.279,6,52,21786,29,930,45,1360,16090,23,433,50,1360,5696
321.654,6,42,8254,20,374,16929,841,2604,22,236,15316,1418,5650
1754.976,6,359,56327,219,304,8050,304,40912,140,83,12625,83,15415
1772.377,6,180,15480,120,69,14893,69,8940,60,69,30033,69,6540
1777.614,17,140,11200,70,48,25762,48,5320,70,56,25762,56,5880
1776.606,17,140,11200,70,48,25747,48,5320,70,56,25747,56,5880
1586.018,6,322,24058,165,104,9670,469,12464,157,65,10166,69,11594
2.574,6,14,2351,8,188,367,245,700,6,703,462,1152,1651
0.007,17,2,511,1,35,0,35,63,1,420,0,420,448
64.022,6,39,11365,17,297,4001,1189,3069,22,529,3047,4837,8296
1694.483,1,76,8056,76,78,22593,78,8056,0,0,0,0,0
0.124,6,33,30325,19,290,6,392,2449,14,2261,9,4224,27876
5.33,6,40,7325,21,218,266,314,3463,19,516,281,1179,3862
46.798,6,25,1982,11,275,4679,275,1010,14,96,2766,96,972
198.269,6,251,113429,127,812,439,1152,102564,124,393,1610,1179,10865
493.01,6,41,7999,19,167,9132,502,2102,22,263,23472,1452,5897
0.014,17,2,471,1,39,0,39,67,1,376,0,376,404
0.032,17,2,132,1,30,0,30,58,1,46,0,46,74
280.467,6,24,7054,11,181,28046,267,1168,13,670,23369,2036,5886
45.715,6,6133,5812624,4038,1361,11,1408,5699020,2095,931,21,2801,113604
1.55,6,57,17564,30,426,53,1360,9331,27,595,53,1360,8233
0.116,6,22,10013,11,136,11,136,716,11,1245,11,1448,9297
1785.25,6,102,8296,68,65,26645,65,4930,34,59,54094,59,3366
7.768,6,15,4050,8,275,1109,275,878,7,1440,971,1440,3172
331.959,6,91,30816,46,594,7376,1418,11316,45,714,7544,1418,19500
4.09,17,5,340,5,40,1022,40,340,0,0,0,0,0
0.032,17,2,306,1,33,0,33,61,1,217,0,217,245
2.553,6,27,7563,14,174,196,267,1608,13,678,207,2800,5955
1794.46,17,140,11200,70,48,26006,48,5320,70,56,26006,56,5880
0.312,17,2,152,1,48,0,48,76,1,48,0,48,76
1797.643,1,345,28980,345,56,5225,56,28980,0,0,0,0,0
1682.73,17,16,1265,8,30,240380,37,471,8,71,240382,136,794
1.231,6,7,312,4,0,410,0,180,3,0,522,0,132
3.67,17,10,1450,5,40,909,40,340,5,194,909,194,1110
0.177,17,2,152,1,48,0,48,76,1,48,0,48,76
1.376,6,38,8252,19,320,76,1162,2716,19,476,66,2715,5536
548.765,1,8,448,8,28,78395,28,448,0,0,0,0,0
0.111,17,2,404,1,44,0,44,72,1,304,0,304,332
0.09,17,4,2876,2,689,90,1350,1434,2,693,41,1350,1442
2.869,6,23,7374,12,357,260,722,1556,11,895,236,2760,5818
5.999,6,40,7325,22,218,285,314,3503,18,516,337,1179,3822
8.365,6,1641,1504108,1004,1418,8,1448,1466308,637,776,12,1448,37800
19.935,17,21,6621,10,387,2211,1350,4159,11,195,1990,1350,2462
1786.575,6,148,26841,90,360,20073,1291,19819,58,104,31341,242,7022
1792.653,6,354,22647,202,69,8822,69,12289,152,69,11871,69,10358
0.262,17,2,198,1,39,0,39,67,1,103,0,103,131
1785.724,6,359,22847,208,69,8626,69,12460,151,69,11901,69,10387
1793.491,17,179,11456,179,36,10075,36,11456,0,0,0,0,0
11.474,6,1689,1585717,1118,1369,10,1432,1558385,571,389,20,1432,27332
1775.16,6,184,15778,122,69,14670,69,9158,62,69,29095,69,6620
9.543,17,3,3300,3,1072,4771,1072,3300,0,0,0,0,0
1789.153,6,380,29370,217,75,8283,267,13537,163,134,11044,1460,15833
299.175,17,4,502,2,36,299169,36,128,2,159,299170,159,374
0.066,17,2,367,1,64,0,64,92,1,247,0,247,275
0.032,1,2,112,2,28,32,28,112,0,0,0,0,0
0.089,6,12,1587,6,507,17,507,779,6,556,17,556,808
0.016,17,6,462,3,33,1,33,183,3,65,0,65,279
11.879,6,1874,1637375,1157,1363,10,1380,1602530,717,558,16,1923,34845
369.641,6,23,1535,16,177,24642,177,1053,7,110,10393,110,482
1796.265,1,276,15456,276,28,6531,28,15456,0,0,0,0,0
8.577,6,23,3444,12,152,779,267,1400,11,400,830,1179,2044
0.44,17,4,288,2,36,406,36,128,2,52,408,52,160
1797.226,17,449,39928,404,35,4459,288,25708,45,288,40021,288,14220
1783.569,1,8,448,8,28,254795,28,448,0,0,0,0,0
36.858,17,2,150,2,47,36858,47,150,0,0,0,0,0
1772.437,6,240,17880,120,69,14894,69,8940,120,34,14894,64,8940
0.543,17,2,384,1,39,0,39,67,1,289,0,289,317
1741.248,6,92,6668,60,31,29512,31,4062,32,31,56168,31,2606
11.876,6,145,128844,89,430,134,647,5962,56,2263,212,8448,122882
1783.558,6,369,23661,210,69,8533,69,12747,159,69,11287,69,10914
266.964,17,4,240,2,32,266962,32,120,2,32,266962,32,120
1786.586,6,102,8172,68,63,26665,64,4868,34,57,54136,58,3304
1763.661,2,12,384,12,8,160332,8,384,0,0,0,0,0
1790.734,6,275,33771,113,139,15987,1360,16403,162,134,11121,2720,17368
0.485,6,12,1653,6,288,92,288,548,6,426,60,434,1105
264.979,6,29,8559,10,189,12358,516,1350,19,379,14716,1452,7209
11.899,6,1793,1637003,1156,1364,10,1432,1606992,637,427,18,1432,30011
0.301,17,2,180,1,30,0,30,58,1,94,0,94,122
1798.633,6,368,24752,214,87,8444,469,14245,154,69,11753,69,10507
1798.759,17,406,36280,365,35,4941,288,23324,41,288,44021,288,12956
4.828,6,19,5841,11,366,482,517,1678,8,931,667,2201,4163
1773.129,6,181,15589,120,69,14900,69,8940,61,69,29550,69,6649
280.268,6,31,7472,14,158,21559,267,1357,17,543,17509,1400,6115
782.068,2,8,256,8,8,111724,8,256,0,0,0,0,0
119.019,2,3,96,3,8,59509,8,96,0,0,0,0,0
183.361,6,49,10379,19,269,10186,1189,2921,30,328,6322,2006,7458
280.209,17,4,1098,2,30,280204,30,116,2,463,280203,463,982
31.678,6,5,220,1,0,0,0,44,4,0,9513,0,176
0.011,17,2,547,1,40,0,40,68,1,451,0,451,479
38.051,17,22,1936,11,48,3804,48,836,11,72,3803,72,1100
240.51,6,72,25109,37,534,6680,1418,6745,35,751,7073,1418,18364
1.18,6,30,10206,16,605,73,1460,3713,14,740,76,1937,6493
1797.063,17,447,39580,403,35,4470,288,25676,44,288,40949,288,13904
299.533,6,6,364,4,31,99844,31,222,2,31,299515,31,142
1.306,6,31,6260,15,138,93,267,1715,16,650,75,1452,4545
0.141,6,5,260,0,0,0,0,0,5,0,0,0,260
0.507,17,2,237,1,72,0,72,100,1,109,0,109,137
1791.266,1,187,10472,187,28,9630,28,10472,0,0,0,0,0
0.127,17,4,352,2,37,0,37,130,2,83,123,89,222
161.015,17,4,352,2,60,161014,60,176,2,60,161014,60,176
0.035,6,3,136,2,0,35,0,88,1,0,0,0,48
6.706,1,6,937,6,128,1341,197,937,0,0,0,0,0
0.289,6,27,7296,13,155,24,267,1301,14,603,19,2036,5995
0.108,17,2,231,1,34,0,34,62,1,141,0,141,169
10.826,17,4,974,2,40,10804,40,136,2,391,10815,419,838
1.614,6,13,2311,8,188,230,245,700,5,1407,343,1407,1611
30.382,2,4,160,4,16,10127,16,160,0,0,0,0,0
280.441,6,29,7392,13,158,23370,267,1317,16,678,18690,3456,6075
615.936,6,135,37995,71,484,8799,1360,25762,64,268,9774,4649,12233
3.923,6,58,19981,29,910,140,1440,13952,29,400,132,1440,6029
1.206,6,23,7952,12,164,92,267,1288,11,1216,102,3819,6664
1.393,6,37,9808,20,502,73,1460,4352,17,476,73,2615,5456
5.082,17,4,304,4,48,1694,48,304,0,0,0,0,0
343.287,6,34,7420,15,202,4005,502,1818,19,302,19067,1420,5602
11.548,6,90,26818,46,567,256,1152,20576,44,407,262,1152,6242
128.117,2,5,264,5,28,32029,32,264,0,0,0,0,0
0.005,17,2,309,1,34,0,34,62,1,219,0,219,247
0.106,17,2,176,1,60,0,60,88,1,60,0,60,88
277.595,6,24,2325,4,302,12662,302,530,20,83,14609,83,1795
1.092,6,10,1687,7,100,182,100,384,3,1179,414,1179,1303
244.538,17,6,528,3,60,122268,60,264,3,60,122268,60,264
62.935,6,73,50609,46,1178,1398,1368,42468,27,841,2411,2736,8141
2.386,6,5,288,2,0,2201,0,112,3,0,1101,0,176
1639.927,1,7,392,7,28,273321,28,392,0,0,0,0,0
1745.496,6,95,7203,63,38,28153,205,4476,32,33,56295,98,2727
0.877,6,11,1727,7,100,146,100,384,4,589,208,1152,1343
2.184,17,26,13419,13,719,182,1350,9712,13,257,132,1350,3707
3.567,6,14,2355,7,188,594,245,660,7,703,551,1152,1695
369.6,6,21,1419,15,177,26400,177,989,6,110,13086,110,430
1786.556,6,102,8364,68,66,26665,66,4964,34,60,54134,60,3400
0.078,6,7,423,4,43,6,43,259,3,0,36,0,164
1.361,6,47,18161,26,882,54,1360,12545,21,433,59,1360,5616
176.904,17,8,2672,8,306,25272,308,2672,0,0,0,0,0
1789.953,6,372,23574,214,69,8403,69,13114,158,69,11400,69,10460
1625.339,1,8,448,8,28,232191,28,448,0,0,0,0,0
10.962,6,20,4442,11,275,1096,275,998,9,768,785,1440,3444
1772.118,6,180,15480,120,69,14891,69,8940,60,69,30031,69,6540
1.025,6,32,9238,15,195,73,453,2178,17,768,63,1448,7060
2.287,6,13,2311,8,188,326,245,700,5,1407,508,1407,1611
1769.376,6,101,9410,66,66,27221,66,5610,35,60,52036,60,3800
16.177,6,2696,2542960,1752,1374,9,1408,2489208,944,776,16,1408,53752
0.056,6,10,1495,5,507,13,507,727,5,556,13,556,768
0.588,2,2,64,2,8,588,8,64,0,0,0,0,0
120.533,6,6,481,3,0,60266,0,124,3,233,60133,233,357
1784.032,17,83,3480,82,14,22025,14,3444,1,8,0,8,36
0.138,17,2,148,1,32,0,32,60,1,60,0,60,88
1773.34,6,181,15589,120,69,14902,69,8940,61,69,29550,69,6649
1787.363,6,106,8388,68,64,26677,64,4896,38,58,48305,58,3492
7.097,6,22,4426,12,213,645,597,1689,10,552,768,1767,2737
1779.585,6,141,8735,77,45,23413,208,5276,64,31,28244,31,3459
176.58,6,7,418,4,106,58860,106,274,3,0,1508,0,144
4.213,6,39,7269,19,218,234,314,3383,20,440,209,1152,3886
300.89,6,40,13572,23,892,13676,1360,8090,17,479,542,4027,5482
0.321,6,12,3705,6,171,64,171,491,6,964,63,1448,3214
0.012,17,2,391,1,43,0,43,71,1,292,0,292,320
1787.196,1,213,22578,213,78,8430,78,22578,0,0,0,0,0
1700.872,1,8,448,8,28,242981,28,448,0,0,0,0,0
1788.775,1,206,11536,206,28,8725,28,11536,0,0,0,0,0
462.728,6,55,4360,32,66,14926,66,2600,23,60,20645,60,1760
9.334,17,318,169971,316,509,28,1472,169891,2,12,4648,12,80
11.525,6,26,4213,14,234,886,564,1704,12,463,1018,1343,2509
1787.896,6,356,22520,208,69,8637,69,12460,148,69,12162,69,10060
141.449,6,21,8712,11,314,79,634,1415,10,1147,15699,2720,7297
1785.5,6,359,22709,209,69,8584,69,12569,150,69,11983,69,10140
24.947,1,4,224,4,28,8315,28,224,0,0,0,0,0
1.1,17,4,368,2,32,1000,32,120,2,96,1021,96,248
1680.472,1,14,784,14,28,129267,28,784,0,0,0,0,0
1796.235,6,414,24840,207,69,8719,69,12420,207,34,8719,69,12420
300.877,6,43,14696,24,904,13081,1460,9134,19,399,481,1460,5562
300.375,6,24,8520,13,401,25031,1050,2290,11,807,3808,2736,6230
298.926,6,479,211841,235,828,798,1152,198330,244,249,1229,1179,13511
1749.641,6,104,8166,65,45,27338,205,4844,39,36,46032,98,3322
0.938,6,11,1727,7,100,156,100,384,4,589,224,1152,1343
0.014,17,2,384,1,39,0,39,67,1,289,0,289,317
1.303,6,50,21647,28,927,48,1360,15991,22,476,53,2720,5656
13.534,17,19,1629,10,47,1356,47,750,9,69,1690,75,879
70.007,1,2,232,2,88,70007,88,232,0,0,0,0,0
280.167,6,30,7432,13,158,23347,267,1317,17,543,17509,1400,6115
1783.807,6,410,24680,205,69,8744,69,12340,205,35,8744,69,12340
1771.945,6,180,15480,120,69,14890,69,8940,60,69,30032,69,6540
364.796,6,25,1899,16,65,24319,65,1095,9,55,45587,59,804
377.291,6,25,1651,17,177,23580,177,1117,8,110,9228,110,534
1781.036,17,142,11360,71,48,25443,48,5396,71,56,25443,56,5964
1796.936,6,287,18380,164,69,11024,69,9941,123,69,14728,69,8439
1761.971,6,122,7390,67,26,26695,26,4000,55,26,32628,26,3390
11.274,6,65,33763,34,716,341,1438,6075,31,1133,375,1565,27688
1795.647,17,448,39896,403,35,4466,288,25676,45,288,40022,288,14220
3.675,6,30,8872,13,158,306,267,1317,17,687,228,1400,7555
60.435,2,5,160,5,8,15108,8,160,0,0,0,0,0
1792.084,1,58,4872,58,56,31440,56,4872,0,0,0,0,0
1.363,6,41,17140,22,529,64,1460,3606,19,911,65,1460,13534
1749.316,6,95,7203,63,38,28214,205,4476,32,33,56420,98,2727
0.035,6,2,1460,1,0,0,0,40,1,1380,0,1380,1420
1792.665,6,382,29805,221,131,8148,1189,17772,161,81,11204,485,12033
5.194,17,4,1354,2,300,4199,300,656,2,321,4200,321,698
658.089,2,5,160,5,8,164522,8,160,0,0,0,0,0
1774.741,17,140,11200,70,48,25720,48,5320,70,56,25720,56,5880
0.188,6,46,20300,26,1015,7,1420,15279,20,467,9,1883,5021
0.068,6,17,7360,10,321,7,517,1384,7,1136,9,2676,5976
252.082,2,2,64,2,8,252082,8,64,0,0,0,0,0
72.415,6,8,428,3,0,36207,0,152,5,0,18059,0,276
1782.655,1,160,16960,160,78,11211,78,16960,0,0,0,0,0
1593.217,17,82,6560,41,48,39830,48,3116,41,56,39830,56,3444
0.105,17,4,624,2,64,104,64,184,2,192,58,192,440
0.14,17,2,672,2,308,140,308,672,0,0,0,0,0
29.987,6,12,1310,7,182,4997,182,554,5,244,7486,476,756
1785.722,17,337,25612,337,48,5314,48,25612,0,0,0,0,0
1784.293,6,356,22520,208,69,8619,69,12460,148,69,12137,69,10060
919.941,6,58,4681,34,50,25006,205,2570,24,37,39988,108,2111
0.241,6,13,3722,7,125,36,125,509,6,964,27,1448,3213
1787.203,6,104,8376,68,65,26674,65,4930,36,59,51060,59,3446
589.406,1,8,1013,8,98,84200,117,1013,0,0,0,0,0
1794.105,17,188,46535,188,219,9594,422,46535,0,0,0,0,0
35.956,6,28,6951,16,117,2397,159,1453,12,811,3268,2816,5498
0.087,17,4,336,2,34,0,34,124,2,78,41,84,212
243.981,6,46,12972,21,111,12198,235,1943,25,648,10165,2373,11029
823.892,6,191,20683,101,127,8238,1189,8639,90,187,9245,1420,12044
0.049,17,4,588,2,48,42,48,152,2,190,41,308,436
1768.679,1,58,4872,58,56,31029,56,4872,0,0,0,0,0
280.314,6,30,7432,13,158,23359,267,1317,17,543,17512,1400,6115
17.834,6,30,5052,15,154,1273,721,1869,15,399,1261,2026,3183
0.859,17,3,216,2,31,289,31,118,1,70,0,70,98
1.921,17,21,6483,7,317,320,1350,2415,14,262,121,1350,4068
245.014,6,47,22952,21,307,31,640,2021,26,978,9798,1480,20931
1738.742,6,87,6322,58,31,30504,31,3915,29,31,62097,31,2407
0.072,17,2,322,1,33,0,33,61,1,233,0,233,261
0.542,6,119,87821,56,131,9,232,2769,63,1422,8,3901,85052
1772.263,6,180,15480,120,69,14892,69,8940,60,69,30033,69,6540
0.88,6,23,6168,13,264,72,662,1848,10,979,96,1731,4320
35.074,17,10,760,10,48,3897,48,760,0,0,0,0,0
1773.287,6,180,15480,120,69,14901,69,8940,60,69,30048,69,6540
88.036,17,4,352,2,60,88035,60,176,2,60,88035,60,176
0.163,6,10,1569,5,627,40,627,895,5,406,40,406,674
18.752,17,42,10899,42,231,457,389,10899,0,0,0,0,0
171.588,6,18,4463,7,272,347,516,1100,11,364,17120,1452,3363
1788.028,17,87,3648,86,14,21035,14,3612,1,8,0,8,36
1797.402,1,345,28980,345,56,5225,56,28980,0,0,0,0,0
1797.778,17,142,11360,71,48,25682,48,5396,71,56,25682,56,5964
1771.367,6,99,9306,66,66,27251,66,5610,33,60,55352,60,3696
2.415,6,14,2351,8,188,345,245,700,6,703,431,1152,1651
0.016,6,4,172,2,0,16,0,80,2,0,14,0,92
280.034,6,27,7312,12,158,25457,267,1277,15,678,20000,2800,6035
146.262,1,14,784,14,28,11250,28,784,0,0,0,0,0
0.602,6,16,1825,8,288,62,288,640,8,284,61,434,1185
20.842,6,27,9769,9,154,2605,267,832,18,586,1211,1420,8937
1.142,6,25,8805,14,290,87,802,1753,11,942,91,1460,7052
1737.577,1,56,4704,0,0,0,0,0,56,56,31592,56,4704
1740.489,17,30,31170,30,1011,60016,1011,31170,0,0,0,0,0
17.117,6,26,7137,12,155,1556,267,1266,14,530,1315,2006,5871
366.967,6,18,1242,14,180,28228,180,916,4,110,20058,110,326
0.022,6,2,100,1,0,0,0,60,1,0,0,0,40
2.065,17,6,552,3,32,534,32,180,3,96,0,96,372
2.707,17,2,144,1,36,0,36,64,1,52,0,52,80
587.701,17,284,20802,202,40,2923,41,13865,82,56,453,57,6937
0.966,6,24,6041,12,108,86,147,919,12,773,71,1608,5122
29.654,6,29,7666,10,155,13,267,1186,19,380,1647,3426,6480
176.131,6,28,12107,13,452,69,1460,2361,15,1014,12570,1460,9746
0.53,6,124,87485,58,131,9,232,2849,66,1344,8,2840,84636
578.751,17,98,7448,98,48,5966,48,7448,0,0,0,0,0
1790.476,6,362,22898,210,69,8566,69,12678,152,69,11854,69,10220
1767.228,1,58,4872,0,0,0,0,0,58,56,31004,56,4872
1.257,6,41,10025,22,502,59,1460,4444,19,400,60,1460,5581
39.274,1,3,333,3,83,19637,142,333,0,0,0,0,0
0.388,17,2,412,1,33,0,33,61,1,323,0,323,351
0.046,17,2,144,1,36,0,36,64,1,52,0,52,80
0.883,17,2,784,2,364,883,364,784,0,0,0,0,0
20.492,6,23,6180,14,117,1576,159,1337,9,873,2559,1669,4843
1786.843,6,104,8376,68,65,26669,65,4930,36,59,51050,59,3446
60.421,6,11,2993,6,92,12084,92,400,5,1164,15055,1408,2593
5.534,6,47,8489,23,227,251,314,4102,24,427,229,1152,4387
270.075,1,6,336,6,28,54015,28,336,0,0,0,0,0
0.438,6,8,335,4,0,146,0,164,4,7,74,7,171
0.098,6,11,3653,6,171,18,171,491,5,1447,23,2676,3162
601.516,2,7,224,7,8,100252,8,224,0,0,0,0,0
0.927,6,16,2297,8,324,132,585,1061,8,396,108,580,1236
58.78,6,12,891,11,31,5876,31,851,1,0,0,0,40
0.521,17,3,451,2,39,217,39,134,1,289,0,289,317
0.849,6,10,1687,7,100,141,100,384,3,1179,302,1179,1303
2.637,17,2,677,1,300,0,300,328,1,321,0,321,349
0.965,6,31,12783,16,511,64,1460,3239,15,812,55,1460,9544
1753.865,6,127,7726,69,26,25791,26,4142,58,26,30768,26,3584
285.448,1,4,224,4,28,95149,28,224,0,0,0,0,0
204.065,6,23,1675,17,43,12754,43,1315,6,0,40812,0,360
4.038,17,8,8457,2,723,4038,1350,1503,6,1131,405,1350,6954
236.215,17,6,488,3,53,118107,64,244,3,53,118107,64,244
1781.823,6,385,29915,217,75,8249,267,13744,168,131,10669,1452,16171
282.422,17,8,2688,8,308,40346,308,2688,0,0,0,0,0
0.048,6,3,182,2,31,48,31,111,1,31,0,31,71
1787.436,6,102,8296,68,65,26678,65,4930,34,59,54160,59,3366
1777.808,17,33,26490,33,774,55556,1451,26490,0,0,0,0,0
0.043,17,2,152,1,48,0,48,76,1,48,0,48,76
1799.978,6,127,8228,73,51,24999,208,5169,54,31,33917,31,3059
1.95,17,3,468,3,128,975,128,468,0,0,0,0,0
1.004,17,2,677,1,300,0,300,328,1,321,0,321,349
1.356,6,50,20245,27,959,52,1460,14549,23,433,53,1460,5696
1735.067,17,71,2976,70,14,25145,14,2940,1,8,0,8,36
1785.855,6,102,8296,68,65,26654,65,4930,34,59,54114,59,3366
1788.361,6,355,22480,207,69,8681,69,12420,148,69,12165,69,10060
360.965,2,4,128,4,8,120321,8,128,0,0,0,0,0
1680.784,1,15,840,15,28,120056,28,840,0,0,0,0,0
1617.041,1,7,392,7,28,269506,28,392,0,0,0,0,0
0.019,17,2,358,1,30,0,30,58,1,272,0,272,300
10.854,6,94,28919,49,574,226,1152,22637,45,407,241,1152,6282
2.328,17,4,610,3,39,896,39,201,1,381,0,381,409
241.399,6,155,125375,58,545,4234,1418,7403,97,1344,2514,2510,117972
1782.375,17,83,3480,82,14,22004,14,3444,1,8,0,8,36
7.925,17,6,528,3,48,3958,48,228,3,72,3957,72,300
1788.759,17,87,3648,86,14,21044,14,3612,1,8,0,8,36
619.325,17,11,3656,11,304,61932,308,3656,0,0,0,0,0
0.293,6,20,4960,10,137,32,267,1092,10,866,31,2867,3868
114.662,6,51,10507,21,242,3073,1189,3028,30,298,3953,1420,7479
1773.645,6,191,16334,124,69,14419,69,9169,67,69,26870,69,7165
53.728,6,11,1583,11,127,5372,127,1583,0,0,0,0,0
14.803,6,39,8428,19,188,812,721,2082,20,503,770,2840,6346
0.034,17,2,347,1,29,0,29,57,1,262,0,262,290
1.2,6,10,1687,7,100,200,100,384,3,1179,465,1179,1303
0.002,6,8,11988,1,0,0,0,40,7,1654,0,2896,11948
1782.567,6,104,8376,68,65,26605,65,4930,36,59,50927,59,3446
1794.953,1,59,4956,59,56,30947,56,4956,0,0,0,0,0
3.898,6,2,88,2,0,0,0,88,0,0,0,0,0
372.288,6,23,1535,16,177,24819,177,1053,7,110,10397,110,482
1800.0,6,224,17343,79,68,23076,296,7717,145,48,12499,78,9626
1771.985,6,180,15480,120,69,14890,69,8940,60,69,30032,69,6540
1795.718,17,446,38980,404,35,4455,288,25708,42,288,42952,288,13272
0.033,17,2,456,1,60,0,60,88,1,340,0,340,368
2.999,17,4,248,4,34,999,34,248,0,0,0,0,0
299.822,6,44,10370,22,607,14275,1360,4595,22,325,14267,1360,5775
1787.443,6,105,8481,69,65,26285,65,5035,36,59,51015,59,3446
1795.001,1,236,13216,236,28,7638,28,13216,0,0,0,0,0
0.176,17,2,170,1,37,0,37,65,1,77,0,77,105
9.575,6,81,24797,41,561,239,1152,19056,40,413,238,1152,5741
1784.832,6,361,24265,210,88,8539,469,13878,151,69,11898,69,10387
0.432,6,48,21335,27,1010,16,1380,16262,21,467,18,2760,5073
3.484,17,5,295,5,31,871,31,295,0,0,0,0,0
16.028,6,26,7066,7,154,2671,267,752,19,396,888,1460,6314
1.191,17,2,334,1,39,0,39,67,1,239,0,239,267
280.249,6,30,7432,14,158,21557,267,1357,16,603,18678,2036,6075
29.979,6,6,312,1,0,0,0,52,5,0,6736,0,260
87.466,6,121,24922,62,286,1431,1440,14113,59,324,1505,1440,10809
1786.885,1,86,4816,86,28,21022,28,4816,0,0,0,0,0
0.517,17,2,144,1,36,0,36,64,1,52,0,52,80
1747.201,17,289,67003,289,203,6066,422,67003,0,0,0,0,0
79.888,6,30,12544,17,380,4993,832,1889,13,1124,6642,3928,10655
4.058,17,63,48373,28,370,150,1350,11155,35,1035,103,1350,37218
61.329,6,37,15936,22,800,2920,1440,9157,15,665,4362,1440,6779
1.296,6,27,4269,13,240,108,630,2127,14,200,98,580,2142
5.023,17,4,288,2,36,4981,36,128,2,52,4991,52,160
8.43,6,1286,1165833,797,1415,10,1432,1142040,489,420,17,1432,23793
11.795,6,1876,1630792,1138,1379,10,1420,1597051,738,467,15,1883,33741
0.534,17,4,952,2,39,520,39,134,2,381,14,381,818
31.848,6,8,440,5,0,7962,0,268,3,0,15916,0,172
103.334,17,10,800,5,48,25829,48,380,5,56,25830,56,420
1772.264,6,180,15480,120,69,14892,69,8940,60,69,30034,69,6540
280.246,6,28,7352,12,158,25476,267,1277,16,603,18680,1400,6075
63.18,6,39,9474,18,271,3716,1189,2902,21,477,3157,1460,6572
1.286,6,48,17063,27,790,49,1360,11402,21,400,55,1360,5661
1.665,6,2,80,1,0,0,0,40,1,0,0,0,40
0.015,17,2,202,1,43,0,43,71,1,103,0,103,131
1799.635,17,179,13962,179,50,10110,50,13962,0,0,0,0,0
12.612,6,19,4402,9,275,1576,275,918,10,768,1224,1440,3484
0.822,6,244,227095,82,269,10,517,4463,162,1359,5,1871,222632
0.119,6,10,766,5,185,21,185,453,5,45,29,45,313
33.517,6,31,5093,15,154,2394,722,1859,16,342,2220,1408,3234
1.334,6,48,19366,27,902,51,1360,13750,21,476,57,2715,5616
14.53,6,15,3779,8,275,2075,275,603,7,1440,1424,1440,3176
0.199,6,9,1340,5,145,49,145,349,4,827,28,827,991
76.923,17,4,352,2,60,76922,60,176,2,60,76922,60,176
1789.393,17,83,3480,82,14,22091,14,3444,1,8,0,8,36
219.521,6,55,9855,22,123,10453,267,2741,33,321,5313,1917,7114
4.918,6,11,1731,5,100,1229,100,304,6,589,931,1152,1427
1796.126,17,449,39928,404,35,4456,288,25708,45,288,40019,288,14220
0.034,17,3,634,2,32,29,32,120,1,486,0,486,514
179.817,17,4,352,2,60,179815,60,176,2,60,179816,60,176
111.665,6,16,656,6,0,3435,0,244,10,0,12406,0,412
225.702,17,6,2016,6,308,45140,308,2016,0,0,0,0,0
1788.234,6,283,35411,117,155,15412,1460,18239,166,126,10835,1642,17172
680.548,17,9,3016,9,307,85068,308,3016,0,0,0,0,0
300.725,6,40,8732,20,315,15827,882,2117,20,386,450,1460,6615
21.491,6,21,6005,10,275,2387,275,1233,11,1440,1846,1440,4772
0.016,17,2,476,1,39,0,39,67,1,381,0,381,409
0.711,17,2,152,1,48,0,48,76,1,48,0,48,76
0.041,17,4,284,2,32,22,32,120,2,54,29,60,164
0.204,6,46,21226,26,1081,8,1420,16205,20,467,10,1883,5021
270.799,6,18,1440,12,63,24618,63,858,6,57,54141,57,582
1.384,6,39,8292,19,320,76,1162,2716,20,433,63,1360,5576
125.286,6,36,8015,13,155,26,267,1306,23,321,5694,2840,6709
1680.455,1,15,840,15,28,120032,28,840,0,0,0,0,0
1779.53,6,369,23385,212,69,8433,69,12965,157,69,11406,69,10420
0.031,17,2,398,1,43,0,43,71,1,299,0,299,327
1.54,6,48,19258,27,895,59,1460,13642,21,476,66,2615,5616
300.68,6,42,8749,19,266,16704,720,1858,23,331,2616,2720,6891
1772.345,6,180,15480,120,69,14893,69,8940,60,69,30031,69,6540
251.914,2,2,64,2,8,251914,8,64,0,0,0,0,0
245.974,1,6,636,6,78,49194,78,636,0,0,0,0,0
10.043,6,31,9293,13,155,836,267,1306,18,518,590,3417,7987
5.708,6,1483,1348600,920,1387,6,1408,1314660,563,931,9,2801,33940
1.533,6,4,253,3,31,766,31,182,1,31,0,31,71
0.17,17,2,136,1,32,0,32,60,1,48,0,48,76
30.394,6,11,684,3,106,15192,106,234,8,90,4340,90,450
696.583,6,71,6083,46,69,15479,69,3496,25,69,29023,69,2587
1.421,6,48,21573,28,989,52,1440,15997,20,433,64,1440,5576
40.962,6,12,756,7,69,6826,69,418,5,69,10240,69,338
0.0,17,6,1828,6,276,0,316,1828,0,0,0,0,0
301.994,2,3,96,3,8,150997,8,96,0,0,0,0,0
1648.823,1,8,448,8,28,235546,28,448,0,0,0,0,0
1794.049,17,284,61297,284,187,6339,379,61297,0,0,0,0,0
1798.731,17,450,39960,405,35,4452,288,25740,45,288,40018,288,14220
68.611,6,8,1812,2,0,68533,0,92,6,1408,13721,1408,1720
373.754,6,25,1651,17,177,23359,177,1117,8,110,9230,110,534
15.373,17,23,16350,12,926,1391,1350,11451,11,417,1530,1350,4899
0.213,6,26,7256,13,155,17,267,1301,13,678,16,2800,5955
1798.426,6,368,25690,215,99,8403,469,15085,153,69,11830,69,10605
1738.535,1,54,4536,0,0,0,0,0,54,56,32802,56,4536
1792.076,6,149,11250,80,84,22684,208,7405,69,31,26348,31,3845
0.015,17,2,424,1,44,0,44,72,1,324,0,324,352
295.779,6,35,8318,13,158,23413,267,1317,22,407,14083,2036,7001
1777.632,1,143,8008,143,28,12518,28,8008,0,0,0,0,0
3.014,17,4,338,2,34,3007,34,124,2,79,3005,79,214
1.36,6,50,18920,27,865,52,1360,13224,23,433,53,1360,5696
1794.473,1,126,7056,126,28,14355,28,7056,0,0,0,0,0
318.232,17,18,6048,18,308,18719,308,6048,0,0,0,0,0
1786.236,6,104,8376,68,65,26660,65,4930,36,59,51032,59,3446
5.17,6,30,6061,15,156,369,267,1542,15,489,363,1452,4519
1046.66,17,18,1152,18,36,61568,36,1152,0,0,0,0,0
1681.167,1,14,784,14,28,129320,28,784,0,0,0,0,0
1082.934,2,16,512,16,8,72195,8,512,0,0,0,0,0
1786.592,6,102,8364,68,66,26665,66,4964,34,60,54136,60,3400
280.231,6,30,7432,13,158,23352,267,1317,17,543,17513,1400,6115
0.105,17,2,152,1,48,0,48,76,1,48,0,48,76
0.26,6,26,7256,13,155,21,267,1301,13,603,20,2036,5955
1772.952,6,181,15589,120,69,14898,69,8940,61,69,29544,69,6649
33.365,6,34,5459,15,180,2383,722,1871,19,236,1843,1402,3588
0.052,6,13,3980,7,88,8,88,388,6,1670,10,1880,3592
31.162,17,4,352,2,48,31151,48,152,2,72,31152,72,200
1042.201,6,130,10455,49,79,21708,375,5237,81,49,13024,143,5218
1770.927,17,168,14050,156,30,11425,37,9090,12,385,155479,463,4960
1787.905,6,371,23534,214,69,8393,69,13114,157,69,11460,69,10420
1795.565,17,448,39612,404,35,4455,288,25708,44,288,40952,288,13904
75.622,6,26,7272,12,158,6874,267,1277,14,678,5816,2800,5995
1.441,6,49,19491,27,907,55,1360,13835,22,433,59,1360,5656
2.114,17,4,236,2,31,2038,31,118,2,31,2056,31,118
506.29,6,38,7297,17,152,13563,502,1750,21,276,25310,1420,5547
1784.661,6,360,22956,205,69,8748,69,12478,155,69,11587,69,10478
18.342,6,1139,979700,717,1291,25,1368,953092,422,776,43,2736,26608
1770.561,6,109,11784,70,108,25660,820,7425,39,66,46591,192,4359
0.411,6,25,6081,13,108,34,147,959,12,773,36,1608,5122
1787.601,6,102,6595,63,47,28832,208,4074,39,31,47033,31,2521
0.571,6,24,7489,14,274,43,668,2109,10,1210,57,1946,5380
576.0,6,8,4852,8,566,82285,925,4852,0,0,0,0,0
10.005,6,455,390992,288,1295,34,1368,377644,167,776,59,2736,13348
0.5,6,50,21846,28,1038,18,1380,16724,22,421,21,2760,5122
10.379,17,4,1643,4,382,3459,394,1643,0,0,0,0,0
1.888,6,29,10365,17,367,118,833,1785,12,1012,163,1420,8580
124.803,6,31,7197,13,233,157,516,1690,18,318,7337,1420,5507
1787.489,6,104,8376,68,65,26678,65,4930,36,59,51067,59,3446
0.611,6,10,924,5,283,106,283,551,5,105,105,105,373
1772.779,6,182,15698,120,69,14897,69,8940,62,69,29055,69,6758
1770.706,6,99,9174,66,64,27241,64,5544,33,58,55331,58,3630
129.888,6,23,10009,12,531,55,1360,2637,11,1384,12976,3934,7372
1785.857,6,369,25730,213,99,8423,469,15074,156,69,11521,69,10656
0.6,17,31,13583,16,564,40,1350,9484,15,245,39,1350,4099
1794.236,17,144,11520,72,48,25270,48,5472,72,56,25270,56,6048
1786.943,17,86,3606,85,14,21273,14,3570,1,8,0,8,36
0.072,17,2,455,2,199,72,354,455,0,0,0,0,0
8.916,6,24,8313,12,481,810,721,2411,12,774,626,1414,5902
0.574,6,23,7367,14,261,44,602,2043,9,1209,67,2736,5324
104.013,1,36,3744,0,0,0,0,0,36,76,2971,76,3744
2.898,6,55,22563,29,972,103,1440,16747,26,433,108,1440,5816
1782.295,6,102,8296,68,65,26601,65,4930,34,59,54005,59,3366
84.528,6,39,9757,17,290,1993,1189,2724,22,472,4024,1997,7033
0.03,17,2,543,1,34,0,34,62,1,453,0,453,481
229.719,17,6,2282,6,352,45943,548,2282,0,0,0,0,0
1.507,6,47,20466,28,918,55,1360,14930,19,476,72,2715,5536
462.636,17,28,2232,15,48,33045,48,1140,13,56,30072,56,1092
105.986,6,45,10306,21,263,3071,1189,2959,24,455,4607,1420,7347
5.225,6,4,303,2,131,5225,131,215,2,0,1022,0,88
310.221,1,5,280,5,28,77555,28,280,0,0,0,0,0
1791.695,17,180,14040,180,50,10009,50,14040,0,0,0,0,0
29.391,6,46,13829,21,289,1469,721,3449,25,669,1181,1440,10380
1203.219,2,12,384,12,8,109383,8,384,0,0,0,0,0
0.188,17,2,574,1,32,0,32,60,1,486,0,486,514
178.994,6,29,8832,14,158,13768,267,1357,15,858,12781,3436,7475
10.017,17,2,154,2,49,10017,49,154,0,0,0,0,0
1.356,6,50,21530,28,981,50,1440,15874,22,433,55,1440,5656
280.451,6,30,7432,13,158,23370,267,1317,17,543,17521,1400,6115
1772.334,6,180,15480,120,69,14893,69,8940,60,69,30035,69,6540
0.031,17,2,396,1,39,0,39,67,1,301,0,301,329
11.997,6,1897,1656369,1148,1387,10,1420,1622188,749,467,16,1883,34181
73.028,17,4,304,2,48,73012,48,152,2,48,73012,48,152
33.567,6,33,5398,17,180,2097,722,2010,16,319,2225,2026,3388
0.01,17,2,219,1,50,0,50,78,1,113,0,113,141
1.38,6,47,19315,27,901,53,1360,13739,20,476,62,2715,5576
5.14,6,5,232,2,0,5140,0,88,3,0,1522,0,144
10.511,6,86,25210,44,568,244,1152,19389,42,413,250,1152,5821
1725.133,17,12,498,11,14,172513,14,462,1,8,0,8,36
1.659,6,48,19245,27,894,63,1360,13629,21,433,72,1360,5616
300.663,6,47,9005,24,286,13072,766,2208,23,366,483,2720,6797
0.066,6,10,766,5,185,15,185,453,5,45,14,45,313
280.499,6,30,7432,13,158,23374,267,1317,17,603,17527,2600,6115
10.653,6,20,6462,11,275,1065,275,723,9,1073,704,1440,5739
1790.713,6,356,22520,208,69,8650,69,12460,148,69,12181,69,10060
3.973,6,35,6209,18,206,233,314,2784,17,548,231,1179,3425
0.062,17,4,334,2,39,62,39,134,2,72,6,72,200
6.699,17,36,8802,11,280,669,1350,3396,25,188,277,1350,5406
2.661,17,2,214,1,39,0,39,67,1,119,0,119,147
63.132,2,3,96,3,8,31566,8,96,0,0,0,0,0
1.416,6,26,8108,12,164,109,267,1288,14,869,93,1368,6820
30.386,6,46,7872,25,188,1266,517,2537,21,373,1517,1794,5335
385.537,17,4,601,4,122,128512,354,601,0,0,0,0,0
4.402,17,30,13348,14,635,338,1350,9282,16,226,213,1350,4066
280.187,6,30,7432,14,158,21552,267,1357,16,603,18677,2800,6075
11.601,6,1815,1593655,1106,1386,10,1420,1561074,709,467,16,1883,32581
68.914,6,30,7297,14,155,5301,267,1346,16,441,4593,1420,5951
1785.764,6,362,22898,210,69,8544,69,12678,152,69,11823,69,10220
882.227,2,8,256,8,8,126032,8,256,0,0,0,0,0
0.031,17,2,664,1,308,0,308,336,1,300,0,300,328
1785.988,6,102,8160,68,63,26656,63,4862,34,57,54118,57,3298
1784.655,6,104,8444,68,66,26636,66,4964,36,60,50987,60,3480
1792.991,17,142,11360,71,48,25613,48,5396,71,56,25613,56,5964
82.686,17,10,760,10,48,9187,48,760,0,0,0,0,0
268.359,1,30,2520,30,56,9253,56,2520,0,0,0,0,0
0.013,17,2,442,1,35,0,35,63,1,351,0,351,379
163.353,6,34,15420,16,585,53,1440,3609,18,923,9601,1440,11811
82.789,17,3665,3450170,1192,41,69,1350,82468,2473,1333,33,1350,3367702
280.051,6,30,7432,14,158,21542,267,1357,16,603,18667,2800,6075
0.196,6,2,149,1,0,0,0,40,1,69,0,69,109
1443.824,2,15,480,15,8,103130,8,480,0,0,0,0,0
1.403,6,49,19084,27,879,53,1440,13428,22,433,58,1440,5656
10.751,6,20,4442,11,275,1075,275,998,9,768,718,1440,3444
555.859,17,16,1408,8,48,79407,48,608,8,72,79407,72,800
0.533,6,26,6093,14,108,41,147,999,12,768,46,1581,5094
57.228,17,4,352,2,60,57227,60,176,2,60,57227,60,176
0.127,6,88,57414,46,337,2,337,3062,42,1372,2,1460,54352
1792.264,6,712,45304,356,23,5048,23,22652,356,23,5048,23,22652
25.933,6,65,15207,34,371,785,800,2671,31,469,418,1360,12536
4.142,17,6,1350,6,197,828,206,1350,0,0,0,0,0
301.401,6,94,31285,46,589,6696,1418,11235,48,649,6411,1418,20050
300.77,6,43,8957,19,315,16701,915,2089,24,327,13070,1360,6868
0.006,6,2,129,1,0,0,0,40,1,37,0,37,89
1740.498,6,87,6322,58,31,30535,31,3915,29,31,62160,31,2407
29.649,6,17,10958,4,106,27,106,274,13,923,2470,2006,10684
1265.65,1,6,336,6,28,253130,28,336,0,0,0,0,0
60.199,6,9,774,6,69,12039,69,447,3,69,30032,69,327
12.929,6,95,29844,48,598,275,1152,23466,47,449,275,1179,6378
174.565,6,84,58206,52,1207,3422,1368,49794,32,841,2008,2519,8412
1794.97,17,140,11200,70,48,26013,48,5320,70,56,26013,56,5880
230.801,1,6,504,6,56,46160,56,504,0,0,0,0,0
1781.676,17,87,3643,86,13,20960,14,3607,1,8,0,8,36
1743.373,6,95,7203,63,38,28118,205,4476,32,33,56230,98,2727
1788.186,17,87,3648,86,14,21037,14,3612,1,8,0,8,36
39.807,17,22,1936,11,48,3980,48,836,11,72,3980,72,1100
1.4,1,10,840,10,56,155,56,840,0,0,0,0,0
0.17,6,33,8537,17,293,10,517,1873,16,601,10,1999,6664
3.213,6,7,371,4,0,1071,0,204,3,7,1459,7,167
1754.866,6,99,7540,65,38,27419,205,4580,34,35,53170,98,2960
170.634,17,4,352,2,60,170632,60,176,2,60,170633,60,176
99.122,6,43,12580,23,753,4497,1360,6978,20,399,5207,1360,5602
4.331,6,718,605925,427,1383,10,1420,590064,291,420,14,1420,15861
0.095,17,4,414,2,50,0,50,156,2,101,8,107,258
240.171,6,59,16559,28,703,8894,1402,13420,31,189,8005,580,3139
61.306,6,37,15950,22,802,2919,1408,9172,15,665,4361,1408,6778
11.646,6,19,2744,10,92,1294,92,708,9,766,1267,1440,2036
0.06,6,9,1343,5,145,15,145,349,4,830,13,830,994
23.633,6,1338,1224860,887,1308,26,1368,1196720,451,776,52,1473,28140
721.886,6,147,9330,86,69,8492,69,5165,61,69,12031,69,4165
1786.697,6,345,31543,197,107,9115,469,15758,148,126,12153,1452,15785
142.94,6,44,13270,21,181,7147,267,2300,23,836,6496,2800,10970
1787.906,6,373,25959,216,98,8315,469,15263,157,69,11460,69,10696
240.206,6,52,18020,27,799,9238,1402,14996,25,214,10008,580,3024
1681.76,1,15,840,15,28,120125,28,840,0,0,0,0,0
377.221,6,18,1239,14,177,29017,177,913,4,110,20065,110,326
0.02,6,16,6417,8,127,2,127,551,8,1088,1,1448,5866
301.058,6,41,13064,21,814,15043,1360,7400,20,373,15835,2667,5664
62.229,6,84,56372,49,1222,1296,1368,47792,35,844,1823,2736,8580
1781.26,17,142,11360,71,48,25446,48,5396,71,56,25446,56,5964
0.612,6,7,958,4,241,204,241,654,3,92,213,92,304
1781.193,17,79,3312,78,14,23132,14,3276,1,8,0,8,36
281.107,6,30,7432,13,158,23425,267,1317,17,543,17548,1400,6115
1790.297,1,62,5208,62,56,29349,56,5208,0,0,0,0,0
1681.675,17,14,1036,7,30,280273,30,406,7,62,280273,62,630
1772.488,6,180,15480,120,69,14894,69,8940,60,69,30033,69,6540
0.753,6,29,9216,15,215,53,683,1863,14,943,55,1448,7353
1777.006,17,73,3060,72,14,25028,14,3024,1,8,0,8,36
0.791,6,36,8311,19,271,43,738,1877,17,441,40,1440,6434
1772.433,6,180,15480,120,69,14894,69,8940,60,69,30033,69,6540
246.046,17,4,352,2,60,246045,60,176,2,60,246045,60,176
0.155,6,10,1380,6,145,31,145,389,4,827,46,827,991
0.499,6,6,324,4,0,166,0,216,2,0,290,0,108
0.264,17,2,440,1,39,0,39,67,1,345,0,345,373
291.592,6,35,7085,17,262,18221,517,1680,18,744,17149,1418,5405
32.887,6,4371,4093284,2770,1397,11,1448,4005356,1601,776,20,1448,87928
60.137,6,14,3888,8,127,8591,127,467,6,1056,12017,2920,3421
1771.582,6,101,9344,66,65,27255,65,5577,35,59,52102,59,3767
2.149,6,32,13534,16,525,143,1360,3322,16,869,130,1379,10212
3.123,17,3,228,2,48,3049,48,152,1,48,0,48,76
1780.17,6,354,22440,207,69,8641,69,12420,147,69,12192,69,10020
299.913,17,4,352,2,60,299911,60,176,2,60,299912,60,176
22.7,6,29,7392,13,158,1891,267,1317,16,603,1510,2076,6075
1704.908,1,8,848,8,78,243558,78,848,0,0,0,0,0
2.863,6,22,7004,12,185,260,275,1041,10,694,231,1420,5963
0.301,6,27,9136,13,271,25,726,1795,14,943,22,1408,7341
10.726,6,71,20342,37,541,297,1152,15555,34,489,315,1179,4787
1787.317,6,102,8296,68,65,26676,65,4930,34,59,54157,59,3366
240.253,6,58,20174,32,814,7749,1408,17141,26,209,9609,580,3033
282.808,6,29,7396,14,158,21754,267,1361,15,678,20019,3436,6035
0.137,17,2,201,1,40,0,40,68,1,105,0,105,133
1.919,17,2,672,2,308,1919,308,672,0,0,0,0,0
1734.704,1,106,5936,106,28,16520,28,5936,0,0,0,0,0
1792.002,6,363,23076,210,69,8574,69,12609,153,69,11789,69,10467
0.005,17,2,422,1,61,0,61,89,1,305,0,305,333
1786.491,6,359,22709,209,69,8588,69,12569,150,69,11986,69,10140
295.301,1,4,224,4,28,98433,28,224,0,0,0,0,0
0.309,6,22,7342,12,335,27,668,1974,10,1210,33,1906,5368
11.751,6,1859,1624186,1100,1420,10,1432,1589569,759,420,15,1432,34617
0.0,17,5,5260,5,1024,0,1024,5260,0,0,0,0,0
371.69,17,24,8751,24,336,16160,548,8751,0,0,0,0,0
62.265,6,22,8563,11,549,89,1308,2119,11,998,6209,1791,6444
1784.753,17,73,3060,72,14,25137,14,3024,1,8,0,8,36
17.124,6,27,7395,13,512,1426,1018,2236,14,733,1316,1408,5159
182.668,6,30,7432,13,158,15222,267,1317,17,543,11414,1400,6115
0.011,17,2,236,1,43,0,43,71,1,137,0,137,165
11.85,6,25,8453,13,275,987,275,1078,12,983,863,1420,7375
1797.484,6,366,24534,213,88,8478,469,14067,153,69,11825,69,10467
15.255,17,2,778,2,361,15255,361,778,0,0,0,0,0
1783.812,6,364,25392,212,100,8454,469,14896,152,69,11813,69,10496
1798.634,6,367,25719,213,99,8484,469,15005,154,69,11755,69,10714
1788.563,6,356,22520,208,69,8640,69,12460,148,69,12167,69,10060
240.326,6,43,8971,21,519,12015,1402,5778,22,226,11443,618,3193
1770.646,17,188,42847,188,199,9468,358,42847,0,0,0,0,0
0.946,17,2,241,1,36,0,36,64,1,149,0,149,177
34.133,17,20,1520,20,48,1796,48,1520,0,0,0,0,0
300.615,6,36,8391,19,291,16700,786,1957,17,478,528,2720,6434
1795.578,17,447,39864,402,35,4477,288,25644,45,288,40017,288,14220
0.007,17,2,278,1,36,0,36,64,1,186,0,186,214
0.514,6,149,129171,91,236,5,255,7898,58,2111,8,8746,121273
1799.758,17,142,11360,71,48,25710,48,5396,71,56,25710,56,5964
179.756,6,24,1759,18,43,10573,43,1399,6,0,35337,0,360
0.483,17,3,451,2,39,120,39,134,1,289,0,289,317
1792.339,17,87,3648,86,14,21086,14,3612,1,8,0,8,36
3.191,17,4,1556,4,361,1063,361,1556,0,0,0,0,0
1110.318,1,18,1008,18,28,65312,28,1008,0,0,0,0,0
177.407,17,4,352,2,60,177406,60,176,2,60,177406,60,176
2.739,6,23,5272,12,351,249,1382,2242,11,431,273,1420,3030
161.26,17,4,240,2,32,161259,32,120,2,32,161259,32,120
1226.237,6,248,15716,142,69,8696,69,8578,106,69,11678,69,7138
1797.897,6,356,22520,208,69,8685,69,12460,148,69,12230,69,10060
0.512,6,53,21233,30,983,17,1380,16026,23,387,21,1923,5207
0.025,17,2,537,1,32,0,32,60,1,449,0,449,477
125.914,17,8,2688,8,308,17987,308,2688,0,0,0,0,0
0.868,17,4,368,2,32,636,32,120,2,96,657,96,248
1.21,6,454,401726,260,152,4,290,15972,194,1977,6,7965,385754
0.17,17,4,588,2,48,158,48,152,2,190,158,308,436
32.896,17,8,608,8,48,4699,48,608,0,0,0,0,0
25.746,6,36,10396,17,275,1609,275,1254,19,927,1298,1440,9142
1790.151,17,87,3648,86,14,21060,14,3612,1,8,0,8,36
0.499,6,2,92,1,0,0,0,40,1,0,0,0,52
1787.852,17,87,3648,86,14,21033,14,3612,1,8,0,8,36
667.492,6,40,3095,26,64,26699,64,1808,14,55,51338,58,1287
0.346,6,26,9017,13,261,28,683,1728,13,943,28,1448,7289
5.901,6,1620,1520007,1038,1388,5,1408,1485079,582,931,9,2816,34928
1543.543,6,92,7366,60,65,26161,65,4285,32,58,49788,59,3081
5.915,6,43,7429,23,218,268,314,3543,20,513,298,1179,3886
1794.897,1,168,17808,168,78,10747,78,17808,0,0,0,0,0
0.548,17,2,152,1,48,0,48,76,1,48,0,48,76
3.035,6,2,88,2,0,0,0,88,0,0,0,0,0
0.493,6,21,7281,13,334,41,663,2021,8,967,62,1471,5260
40.842,6,39,8998,22,541,1944,1244,5468,17,202,2551,1282,3530
73.713,6,19,8082,7,272,12285,516,1100,12,722,6666,1452,6982
0.398,6,10,1992,5,288,96,288,508,5,424,54,434,1484
300.384,6,56,27937,30,435,10358,1130,3628,26,1092,1458,2850,24309
10.743,6,1715,1491009,1035,1386,10,1414,1459528,680,467,15,1889,31481
68.164,6,22,8752,11,314,69,634,1415,11,983,6804,1360,7337
446.74,6,28,2326,13,94,37218,138,1279,15,49,7332,69,1047
240.341,6,47,9162,24,524,10449,1418,5974,23,220,10924,618,3188
43.86,2,3,96,3,8,21930,8,96,0,0,0,0,0
126.741,6,43,10118,21,541,858,910,3063,22,385,6028,2128,7055
3.455,17,5,290,5,30,863,30,290,0,0,0,0,0
0.288,6,18,4942,11,193,27,358,1218,7,860,45,1420,3724
20.149,6,19,2408,11,189,2014,517,1338,8,323,2877,499,1070
1744.665,2,29,928,29,8,62309,8,928,0,0,0,0,0
1740.602,17,30,31680,30,1028,60020,1028,31680,0,0,0,0,0
630.446,2,5,160,5,8,157611,8,160,0,0,0,0,0
4.884,6,14,3169,8,49,697,92,523,6,1165,929,1448,2646
82.282,6,17,692,7,0,8214,0,284,10,0,9140,0,408
6.063,6,13,1993,7,210,1003,210,582,6,545,1208,905,1411
0.174,1,2,112,2,28,174,28,112,0,0,0,0,0
1746.729,1,74,6216,0,0,0,0,0,74,56,23927,56,6216
1.635,6,48,18790,27,861,62,1360,13174,21,433,70,1360,5616
0.1,6,11,1864,6,262,19,517,844,5,752,24,752,1020
1.261,6,50,18500,27,835,48,1360,12804,23,433,49,1360,5696
1739.0,6,87,6322,58,31,30508,31,3915,29,31,62106,31,2407
0.038,17,2,200,1,64,0,64,92,1,80,0,80,108
1786.161,6,150,19350,90,302,20069,302,13740,60,83,30273,83,5610
1711.873,1,18,1908,18,78,100698,78,1908,0,0,0,0,0
0.0,17,6,1895,6,287,0,317,1895,0,0,0,0,0
1.374,6,38,8252,19,320,76,1162,2716,19,433,66,1440,5536
1772.809,6,181,15589,120,69,14897,69,8940,61,69,29544,69,6649
1.035,6,31,6231,16,135,69,267,1726,15,650,68,1420,4505
0.344,6,26,8870,13,232,28,567,1612,13,939,27,1438,7258
1787.031,17,87,3648,86,14,21023,14,3612,1,8,0,8,36
1799.597,17,140,11200,70,48,26080,48,5320,70,56,26080,56,5880
307.459,6,74,11444,38,304,8309,304,7808,36,83,8765,83,3636
1775.291,6,180,15480,120,69,14918,69,8940,60,69,30081,69,6540
60.668,17,8,1648,4,48,20220,48,304,4,308,20219,308,1344
48.319,6,26,7137,13,155,4026,267,1306,13,589,4025,4837,5831
241.415,6,47,6580,22,182,11493,585,3157,25,175,10057,580,3423
9.387,6,1612,1495487,1032,1372,8,1408,1460663,580,931,15,2801,34824
286.364,1,4,224,4,28,95454,28,224,0,0,0,0,0
0.091,6,9,1343,5,145,22,145,349,4,830,23,830,994
1679.563,17,12,498,11,14,167956,14,462,1,8,0,8,36
10.221,6,18,1415,9,222,1270,222,808,9,231,1272,231,607
12.012,17,12,864,6,33,2401,33,366,6,55,2401,61,498
0.514,6,25,14202,13,127,30,127,811,12,1417,45,2457,13391
601.673,2,7,224,7,8,100278,8,224,0,0,0,0,0
245.119,6,53,9844,27,139,9427,346,2318,26,440,9804,2801,7526
1771.166,6,111,10154,70,65,25669,65,5886,41,59,44276,59,4268
731.733,6,42,3052,24,31,31814,31,1620,18,31,38257,31,1432
87.574,17,17,1296,9,40,10946,41,618,8,56,9631,57,678
0.611,6,25,6053,13,108,50,147,959,12,768,52,1581,5094
1790.103,6,367,23305,212,69,8483,69,12758,155,69,11623,69,10547
20.16,6,20,5366,12,107,1832,159,1074,8,967,2878,1659,4292
111.115,6,35,8415,17,410,550,882,1942,18,478,6527,2128,6473
280.68,6,31,7813,13,158,23390,267,1317,18,524,16498,1400,6496
20.089,6,21,5418,12,107,1826,159,1074,9,967,2509,2816,4344
62.051,6,27,7177,13,155,5170,267,1306,14,530,4772,3417,5871
3.351,17,6,552,3,32,849,32,180,3,96,0,96,372
1721.053,17,108,8640,54,48,32472,48,4104,54,56,32472,56,4536
31.905,6,22,6912,6,156,6381,267,718,16,462,2117,4380,6194
19.953,6,25,6757,12,181,1813,267,1212,13,717,1661,2036,5545
68.334,6,84,56485,51,1194,1366,1368,48033,33,841,2064,2519,8452
1772.775,6,180,15480,120,69,14897,69,8940,60,69,30043,69,6540
0.02,6,9,1878,5,666,4,666,934,4,728,6,728,944
1798.995,17,734,44308,734,32,2454,37,44308,0,0,0,0,0
1782.939,17,85,3561,83,13,21740,14,3481,2,12,1782754,16,80
1772.016,6,180,15480,120,69,14890,69,8940,60,69,30033,69,6540
0.0,6,1,343,0,0,0,0,0,1,303,0,303,343
0.967,6,11,1727,7,100,161,100,384,4,589,236,1152,1343
383.519,6,8,654,7,106,63919,106,606,1,0,0,0,48
1795.14,6,120,7709,71,48,25644,208,4788,49,31,37388,31,2921
1796.644,6,406,32848,226,90,7985,1189,15569,180,136,10036,2086,17279
17.253,17,31,7497,14,182,1325,1350,2946,17,239,1076,1350,4551
280.464,6,31,7472,13,158,23372,267,1317,18,603,16495,2076,6155
366.005,6,25,1651,17,177,22875,177,1117,8,110,9172,110,534
1784.211,6,104,8444,68,66,26630,66,4964,36,60,50974,60,3480
1796.696,17,449,39928,404,35,4458,288,25708,45,288,40021,288,14220
0.424,6,13,1693,7,288,69,288,588,6,426,47,434,1105
280.283,6,29,7392,13,158,23356,267,1317,16,603,18681,2036,6075
372.135,6,21,1422,15,180,26581,180,992,6,110,12259,110,430
0.216,17,2,146,1,37,0,37,65,1,53,0,53,81
1.757,17,20,5190,20,231,92,389,5190,0,0,0,0,0
0.909,6,11,1727,7,100,151,100,384,4,589,215,1152,1343
1799.762,17,142,11360,71,48,25710,48,5396,71,56,25710,56,5964
280.444,6,29,7392,13,158,23370,267,1317,16,603,18692,2076,6075
1791.062,1,280,15680,280,28,6419,28,15680,0,0,0,0,0
1779.828,17,142,11360,71,48,25426,48,5396,71,56,25426,56,5964
1682.739,1,15,840,15,28,120195,28,840,0,0,0,0,0
280.215,6,28,7352,12,158,25474,267,1277,16,603,18680,1400,6075
0.975,6,10,1687,7,100,162,100,384,3,1179,346,1179,1303
0.759,17,2,144,1,36,0,36,64,1,52,0,52,80
1796.273,17,448,39896,403,35,4468,288,25676,45,288,40016,288,14220
1748.6,6,103,7681,65,38,27321,205,4580,38,33,47251,98,3101
0.411,17,20,7592,10,452,42,1350,4802,10,251,41,1350,2790
258.025,17,6,528,3,60,129012,60,264,3,60,129012,60,264
0.438,6,28,7336,13,155,36,267,1301,15,543,27,1400,6035
161.6,6,31,7943,10,147,17954,267,1590,21,367,8079,1460,6353
1.222,6,38,9848,21,440,61,1360,4392,17,476,65,2720,5456
1741.399,17,28,6580,28,207,64496,207,6580,0,0,0,0,0
280.454,6,29,7392,12,158,25495,267,1277,17,603,17525,1380,6115
76.97,6,36,9460,18,631,643,1360,3907,18,401,4517,2720,5553
280.712,6,30,7432,13,158,23392,267,1317,17,543,17536,1400,6115
172.537,6,20772,20045660,13993,1355,12,1408,19688488,6779,931,25,2801,357172
1796.513,17,142,11360,71,48,25664,48,5396,71,56,25664,56,5964
1776.703,6,278,33693,112,140,16005,1460,16565,166,126,10767,1460,17128
5.187,6,18,2181,9,120,648,197,970,9,421,648,752,1211
1798.911,17,295,62115,295,182,6118,422,62115,0,0,0,0,0
0.048,6,10,1512,5,503,11,503,771,5,473,12,473,741
120.375,2,2,64,2,8,120375,8,64,0,0,0,0,0
2.151,17,56,40093,22,341,102,1350,8130,34,912,53,1350,31963
44.892,17,29,7424,13,269,3734,1350,3864,16,194,2988,1350,3560
0.013,17,2,354,1,36,0,36,64,1,262,0,262,290
1.113,6,24,8004,12,164,86,267,1288,12,1014,86,2804,6716
9.433,2,2,64,2,8,9433,8,64,0,0,0,0,0
75.536,6,32,7653,12,155,29,267,1266,20,371,3975,1420,6387
1.361,6,47,19677,27,927,52,1360,14101,20,476,62,2715,5576
0.001,17,2,1152,1,548,0,548,576,1,548,0,548,576
28.604,6,25,6757,12,181,2600,267,1212,13,717,2380,2800,5545
0.076,6,13,4282,7,111,12,111,483,6,1159,15,2896,3799
85.628,6,45,8916,22,378,515,787,2118,23,391,3886,3488,6798
1681.572,17,14,1036,7,30,280255,30,406,7,62,280255,62,630
1681.249,17,14,3827,7,30,280207,30,406,7,460,280207,463,3421
1783.81,6,372,25850,212,98,8454,469,15103,160,69,11218,69,10747
1787.95,17,87,3648,86,14,21034,14,3612,1,8,0,8,36
1785.684,6,102,8364,68,66,26652,66,4964,34,60,54108,60,3400
0.089,17,4,304,2,37,0,37,130,2,59,1,65,174
1788.979,17,142,11360,71,48,25556,48,5396,71,56,25556,56,5964
1764.461,17,170,14432,157,30,11310,37,9155,13,377,141899,463,5277
1764.077,2,15,480,15,8,126005,8,480,0,0,0,0,0
0.104,6,9,1148,5,145,26,145,349,4,635,27,635,799
101.947,17,2,148,2,46,101947,46,148,0,0,0,0,0
5.422,6,18,9250,8,275,774,275,599,10,1030,286,1440,8651
131.022,6,78,55824,50,1216,2673,1368,47634,28,840,2403,2736,8190
1778.211,17,79,3312,78,14,23093,14,3276,1,8,0,8,36
63.666,6,26,7137,13,155,5305,267,1306,13,589,5304,4837,5831
4.474,6,6,628,3,188,2237,245,500,3,0,744,0,128
1787.764,6,396,34448,226,119,7945,1189,17500,170,137,10578,4837,16948
180.993,6,30,3045,16,239,12066,517,1856,14,102,13916,323,1189
1.927,6,13,2311,8,188,275,245,700,5,1407,405,1407,1611
0.086,17,2,148,2,46,86,46,148,0,0,0,0,0
0.005,17,2,519,1,40,0,40,68,1,423,0,423,451
1.345,6,38,9848,20,502,70,1440,4352,18,433,68,1440,5496
18.16,6,12,1068,3,106,9080,106,234,9,90,2247,90,834
0.262,17,2,204,1,34,0,34,62,1,114,0,114,142
30.806,17,4,240,2,32,30805,32,120,2,32,30805,32,120
1784.546,6,366,25541,212,99,8457,469,14965,154,69,11663,69,10576
24.258,6,32,8889,15,303,1732,721,2725,17,685,1488,2840,6164
300.89,6,38,9783,21,571,15044,1360,4301,17,435,542,2667,5482
40.775,17,153,11693,78,40,529,41,5349,75,56,550,57,6344
1.575,6,38,8092,19,294,87,1003,2556,19,433,75,1360,5536
58.303,6,7415,7144091,4832,1399,12,1448,7005111,2583,776,22,1448,138980
45.697,6,48,12760,24,833,647,1360,6874,24,307,1978,1360,5886
10.048,6,33,11173,18,666,591,1360,7421,15,625,705,1360,3752
82.533,6,29,8828,8,154,4867,267,792,21,513,4126,1997,8036
1.721,6,13,2311,8,188,245,245,700,5,1407,364,1407,1611
1798.326,6,356,22520,208,69,8687,69,12460,148,69,12233,69,10060
0.036,17,2,410,1,46,0,46,74,1,308,0,308,336
0.419,17,2,144,1,36,0,36,64,1,52,0,52,80
0.048,17,2,904,1,300,0,300,328,1,548,0,548,576
1792.999,17,170,10880,170,36,10609,36,10880,0,0,0,0,0
1792.588,1,246,13776,246,28,7316,28,13776,0,0,0,0,0
7.253,6,1523,1409299,964,1384,7,1408,1375567,559,931,12,2816,33732
0.408,6,2,87,1,0,0,0,40,1,7,0,7,47
9.523,6,80,24421,39,550,250,1152,18640,41,459,230,1179,5781
82.483,17,20,1760,10,48,9163,48,760,10,72,9163,72,1000
96.815,6,60,15640,31,346,3227,770,5776,29,362,3454,3396,9864
46.776,6,27,7177,13,155,3898,267,1306,14,530,3597,3417,5871
0.187,6,45,22316,27,1085,7,1420,17375,18,467,10,1883,4941
18.965,6,3034,2956301,2042,1372,9,1408,2900053,992,931,18,2801,56248
280.588,6,30,7432,13,158,23382,267,1317,17,603,17534,2760,6115
27.442,17,4,352,2,60,27441,60,176,2,60,27440,60,176
246.757,17,4,352,2,60,246756,60,176,2,60,246756,60,176
1.562,6,50,20221,27,958,60,1460,14525,23,433,61,1460,5696
1740.488,17,30,31680,30,1028,60016,1028,31680,0,0,0,0,0
219.95,1,3,440,3,118,109975,142,440,0,0,0,0,0
1776.595,1,58,4872,58,56,31168,56,4872,0,0,0,0,0
7.357,6,5,284,1,0,0,0,60,4,0,2391,0,224
1.5,6,46,19304,27,904,57,1360,13768,19,476,72,2715,5536
1783.714,17,130,10400,65,48,27869,48,4940,65,56,27869,56,5460
27.7,1,26,9682,26,344,1108,346,9682,0,0,0,0,0
0.495,17,8,2758,8,316,70,355,2758,0,0,0,0,0
0.266,17,8,2758,8,316,38,355,2758,0,0,0,0,0
14.019,6,21,6825,12,275,1274,275,1038,9,1353,1123,1440,5787
11.368,6,1872,1574675,1111,1363,10,1380,1538070,761,558,14,1923,36605
1746.343,6,97,7338,64,38,27719,205,4559,33,33,54560,98,2779
281.563,6,623,131877,372,343,758,1368,62646,251,231,1125,1328,69231
2.162,6,51,14907,27,502,83,1440,4704,24,543,85,1440,10203
174.453,6,29,12656,16,561,219,832,3501,13,958,14510,2368,9155
1782.68,6,354,22440,207,69,8653,69,12420,147,69,12209,69,10020
36.058,6,4179,3964618,2611,1434,13,1448,3872438,1568,776,22,1448,92180
1791.016,17,144,11520,72,48,25225,48,5472,72,56,25225,56,6048
58.06,2,2,64,2,8,58060,8,64,0,0,0,0,0
220.577,17,10,585,10,30,24508,31,585,0,0,0,0,0
0.024,6,4,208,2,0,17,0,104,2,0,18,0,104
47.668,17,6,1087,3,38,23702,39,198,3,268,23831,289,889
1780.225,6,355,22549,208,69,8600,69,12529,147,69,12193,69,10020
0.026,6,2,116,1,0,0,0,52,1,0,0,0,64
1781.374,17,83,3480,82,14,21992,14,3444,1,8,0,8,36
21.285,17,26,12351,12,434,1932,1350,5548,14,457,1634,1350,6803
240.299,6,56,17726,30,732,8285,1418,14748,26,202,9611,580,2978
311.873,17,23,26076,23,1105,14176,1450,26076,0,0,0,0,0
296.197,6,8,506,4,31,98732,31,222,4,31,98720,31,284
0.008,17,4,284,2,32,4,32,120,2,54,1,60,164
1772.649,6,180,15480,120,69,14896,69,8940,60,69,30037,69,6540
1771.384,6,99,9240,66,65,27252,65,5577,33,59,55352,59,3663
1779.279,1,126,7056,126,28,14234,28,7056,0,0,0,0,0
280.198,6,30,7432,13,158,23349,267,1317,17,543,17510,1300,6115
1.29,6,48,19542,27,915,49,1460,13926,21,433,55,1460,5616
2.24,6,9,527,5,43,560,43,311,4,0,742,0,216
1789.742,1,268,28408,268,78,6703,78,28408,0,0,0,0,0
1.202,6,25,8056,12,164,93,267,1288,13,869,85,1448,6768
1794.133,17,80,3354,79,14,23001,14,3318,1,8,0,8,36
0.028,6,14,4044,8,88,4,88,452,6,1670,5,1880,3592
189.612,17,4,352,2,60,189611,60,176,2,60,189611,60,176
1799.839,17,449,39928,404,35,4466,288,25708,45,288,40023,288,14220
240.8,6,42,5983,19,248,13377,582,2749,23,253,10945,580,3234
4.111,17,4,244,4,33,1370,33,244,0,0,0,0,0
5.137,6,1191,951561,619,1434,8,1448,910165,572,776,8,1448,41396
30.697,6,6,360,0,0,0,0,0,6,0,0,0,360
0.053,17,2,591,1,41,0,41,69,1,494,0,494,522
69.332,6,24,7824,10,261,93,467,1313,14,525,5318,2688,6511
1.728,17,28,15569,14,740,132,1350,10756,14,315,75,1350,4813
18.925,17,29,6757,12,268,1717,1350,3553,17,160,1180,1350,3204
10.481,6,20,3494,11,210,1047,210,1036,9,664,1309,904,2458
1789.04,6,356,22520,208,69,8642,69,12460,148,69,12166,69,10060
1799.053,17,438,36736,403,35,4475,288,25676,35,288,50604,288,11060
0.258,6,16,7452,8,88,36,88,440,8,2226,36,3340,7012
1798.778,17,447,39580,403,35,4474,288,25676,44,288,40953,288,13904
1740.463,1,15,840,15,28,124318,28,840,0,0,0,0,0
182.542,6,178,27821,96,304,1921,304,19456,82,83,2237,83,8365
0.116,17,2,245,1,32,0,32,60,1,157,0,157,185
4.086,17,5,295,5,31,1021,31,295,0,0,0,0,0
1.025,6,25,5609,12,140,93,267,1184,13,650,77,1452,4425
1772.39,6,180,15480,120,69,14894,69,8940,60,69,30031,69,6540
1751.389,17,259,44067,259,142,6788,385,44067,0,0,0,0,0
10.563,6,28,8857,14,481,812,721,2491,14,644,590,2840,6366
1.303,6,48,19191,27,890,50,1360,13575,21,476,56,2715,5616
1780.522,6,136,8389,73,27,24728,27,4417,63,27,28717,27,3972
334.999,17,8,2688,8,308,47857,308,2688,0,0,0,0,0
6.756,17,4,240,4,32,2252,32,240,0,0,0,0,0
1783.566,17,138,11040,69,48,26228,48,5244,69,56,26228,56,5796
1027.13,6,20,21056,2,174,4904,174,258,18,1433,60414,1452,20798
1772.599,6,183,15738,121,69,14771,69,8980,62,69,29052,69,6758
0.042,6,3,168,1,0,0,0,52,2,0,5,0,116
1.162,6,25,8080,12,164,89,267,1312,13,869,82,1408,6768
0.092,6,10,861,6,182,18,182,490,4,77,12,134,371
71.087,6,28,7355,12,155,6462,267,1266,16,494,4738,3426,6089
1742.041,17,395,68510,395,145,4421,357,68510,0,0,0,0,0
0.004,17,2,207,1,37,0,37,65,1,114,0,114,142
226.258,6,32,8952,15,158,16161,267,1397,17,687,14139,1781,7555
13.168,6,34,8018,18,461,774,1368,5554,16,232,858,580,2464
5.167,6,4,176,3,0,2583,0,128,1,0,0,0,48
1781.773,6,374,23792,213,69,8404,69,13143,161,69,11135,69,10649
1785.517,6,105,8484,68,66,26649,66,4964,37,60,49595,60,3520
296.422,1,4,224,4,28,98807,28,224,0,0,0,0,0
20.041,6,59,15385,31,488,668,1152,11504,28,459,444,1152,3881
1777.582,17,140,11200,70,48,25761,48,5320,70,56,25761,56,5880
1123.201,17,12,3055,6,31,224622,37,355,6,422,224637,463,2700
0.932,6,52,13869,24,551,40,1429,4840,28,438,33,1460,9029
1.467,6,50,18371,28,885,54,1460,12670,22,400,60,1460,5701
300.692,6,38,8609,21,315,15034,882,2145,17,481,531,2720,6464
0.153,17,2,241,1,52,0,52,80,1,133,0,133,161
310.182,6,42,12131,16,278,20678,766,1804,26,441,723,1360,10327
1787.471,6,104,8376,68,65,26678,65,4930,36,59,51066,59,3446
0.486,17,2,152,1,48,0,48,76,1,48,0,48,76
6.238,6,5,216,2,0,6238,0,84,3,0,1489,0,132
1774.784,6,180,15480,120,69,14914,69,8940,60,69,30079,69,6540
0.175,6,40,16826,23,998,7,1420,11925,17,467,10,1883,4901
9.93,6,81,24813,42,561,242,1152,19096,39,461,254,1179,5717
251.319,6,30,4892,14,138,2025,174,1116,16,261,16749,1420,3776
240.324,6,43,8846,21,519,12015,1402,5776,22,213,11443,618,3070
1775.676,6,181,15589,120,69,14921,69,8940,61,69,29592,69,6649
1756.041,6,2363,2292125,720,112,2442,955,43220,1643,1379,1069,4224,2248905
7.89,17,4,1658,4,386,2630,394,1658,0,0,0,0,0
1.735,6,13,2311,8,188,247,245,700,5,1407,362,1407,1611
1785.425,17,362,57952,362,132,4945,389,57952,0,0,0,0,0
0.0,17,1,64,1,36,0,36,64,0,0,0,0,0
1785.968,6,111,8970,72,66,25154,66,5190,39,60,46996,60,3780
43.992,6,44,10371,21,727,510,1360,4556,23,325,1992,1360,5815
1791.664,6,763,59604,383,46,4690,1448,29146,380,56,4726,1448,30458
0.308,6,25,6116,12,181,28,537,1526,13,558,24,1448,4590
1.207,6,58,18046,28,707,44,1360,8937,30,438,41,1360,9109
630.162,2,5,160,5,8,157540,8,160,0,0,0,0,0
1797.008,6,826,67918,413,46,4361,1448,30893,413,71,4360,1448,37025
0.036,17,6,912,3,60,10,60,264,3,188,10,188,648
9.444,6,6,516,0,0,0,0,0,6,69,1888,69,516
1741.221,17,30,7050,30,207,60042,207,7050,0,0,0,0,0
76.305,6,36,8137,15,147,5450,267,1641,21,403,3808,4837,6496
0.029,6,10,1794,6,613,5,1070,1471,4,159,9,159,323
1795.026,17,448,39896,403,35,4465,288,25676,45,288,40021,288,14220
51.823,6,61,24344,29,994,1850,1440,18102,32,426,1665,1440,6242
62.474,6,64,39073,39,1157,1644,1448,30989,25,677,2595,1448,8084
0.111,17,4,588,2,48,102,48,152,2,190,100,308,436
240.238,6,54,18059,29,802,8579,1418,15160,25,198,10009,580,2899
7.236,6,1541,1438271,986,1381,7,1408,1404747,555,931,12,2816,33524
0.392,6,12,1653,6,288,76,288,548,6,426,42,434,1105
914.207,6,77,8707,40,79,21007,722,3682,37,123,25389,2328,5025
1.576,6,49,21272,28,966,58,1460,15656,21,529,66,4075,5616
4.557,6,2,88,2,0,0,0,88,0,0,0,0,0
122.715,6,57,35836,36,1135,3506,1448,27989,21,843,3069,2359,7847
0.009,17,2,308,1,38,0,38,66,1,214,0,214,242
0.169,6,25,7216,12,155,15,267,1261,13,678,13,2045,5955
1784.138,6,354,22440,207,69,8660,69,12420,147,69,12220,69,10020
61.421,6,37,15984,22,805,2924,1408,9206,15,665,4369,1408,6778
0.509,17,3,543,2,39,389,39,134,1,381,0,381,409
0.115,6,32,8066,16,289,7,517,1829,16,465,6,1420,6237
1790.318,1,342,28728,342,56,5250,56,28728,0,0,0,0,0
0.915,6,31,12136,16,525,61,1360,3322,15,745,53,1360,8814
1773.085,6,180,15480,120,69,14899,69,8940,60,69,30050,69,6540
1775.736,1,177,9912,177,28,10089,28,9912,0,0,0,0,0
10.275,6,846,757076,503,1427,20,1448,734124,343,1164,28,4209,22952
1775.627,17,73,3060,72,14,25008,14,3024,1,8,0,8,36
1680.734,17,12,498,11,14,168073,14,462,1,8,0,8,36
241.561,17,4,240,2,32,241560,32,120,2,32,241559,32,120
9.829,6,79,24930,40,568,252,1152,19229,39,459,251,1179,5701
1798.587,17,449,39928,404,35,4462,288,25708,45,288,40015,288,14220
1789.956,6,385,27184,219,102,8210,469,16059,166,69,10848,69,11125
1.737,17,2,204,1,34,0,34,62,1,114,0,114,142
125.405,6,14,3144,7,92,20900,92,452,7,464,20867,1408,2692
0.014,17,2,431,1,37,0,37,65,1,338,0,338,366
1786.36,6,104,8308,68,64,26662,64,4896,36,58,51036,58,3412
234.615,17,6,2040,6,312,46923,326,2040,0,0,0,0,0
1.42,6,38,8254,19,321,78,1164,2718,19,476,68,2615,5536
4.139,6,24,6515,11,262,409,517,1368,13,744,341,1418,5147
1785.867,6,369,23937,203,69,8816,69,12605,166,69,10823,69,11332
1788.125,17,83,3480,82,14,22075,14,3444,1,8,0,8,36
92.223,6,21,8712,11,314,72,634,1415,10,1147,10232,2568,7297
104.536,6,43,10080,21,670,736,1360,4274,22,327,4969,2667,5806
615.972,6,118,17001,47,142,13390,757,4920,71,167,8797,1629,12081
1.19,6,10,1687,7,100,198,100,384,3,1179,472,1179,1303
1.1,17,2,124,2,34,1100,34,124,0,0,0,0,0
280.641,6,31,7813,14,158,21587,267,1357,17,577,17539,1400,6456
289.106,6,290,47542,166,304,1752,304,34052,124,83,2347,83,13490
1794.828,6,396,27900,224,101,8048,469,16535,172,69,10495,69,11365
157.036,17,12,4032,12,308,14276,308,4032,0,0,0,0,0
240.199,6,52,18022,27,815,9238,1418,15272,25,180,10007,580,2750
235.803,6,51,17537,29,741,8421,1408,14866,22,217,11228,580,2671
1740.907,6,92,6668,60,31,29506,31,4062,32,31,56157,31,2606
8.302,6,2142,2033361,1387,1389,5,1408,1989437,755,931,10,2816,43924
1790.278,6,359,22709,209,69,8607,69,12569,150,69,12015,69,10140
2.904,17,29,8240,14,334,220,1350,5074,15,183,204,1350,3166
11.579,6,21,6825,12,275,1052,275,1038,9,1353,819,1440,5787
92.722,6,119,85687,75,1229,1253,1408,75246,44,740,2122,3847,10441
101.489,6,21,5191,8,296,14498,722,1301,13,291,8437,1408,3890
1406.593,6,161,16444,85,70,16743,721,7131,76,189,18752,1414,9313
280.186,6,28,7352,13,158,23348,267,1317,15,678,20010,2600,6035
1798.769,17,448,39896,403,35,4474,288,25676,45,288,40024,288,14220
0.56,6,55,52180,30,155,19,270,2203,25,2317,22,9814,49977
0.811,6,15,1817,8,288,88,288,672,7,426,102,434,1145
79.874,6,79,57059,51,1216,1597,1368,48869,28,840,2288,2736,8190
0.931,17,26,9576,12,328,81,1350,4277,14,350,69,1350,5299
300.781,6,42,27513,25,1194,12532,1448,21616,17,715,1786,1448,5897
1790.238,6,367,25581,213,99,8444,469,15005,154,69,11700,69,10576
61.808,6,85,58440,51,1199,1236,1408,47109,34,868,1866,1408,11331
1775.839,6,181,15589,120,69,14923,69,8940,61,69,29593,69,6649
1773.294,6,182,15629,121,69,14777,69,8980,61,69,29547,69,6649
1795.949,17,447,39580,403,35,4467,288,25676,44,288,40947,288,13904
71.333,6,55,34206,35,1117,2098,1448,26413,20,843,3235,2359,7793
1704.778,17,14,1036,7,30,284126,30,406,7,62,284127,62,630
655.461,17,12,1050,6,32,131082,37,362,6,86,131082,136,688
378.862,2,4,128,4,8,126287,8,128,0,0,0,0,0
1747.216,6,123,12397,76,62,23296,721,6285,47,93,37976,1448,6112
0.79,6,9,1878,5,908,197,908,1176,4,486,263,486,702
0.482,17,3,1164,3,360,241,360,1164,0,0,0,0,0
73.079,6,643,309184,344,833,213,1152,292135,299,391,244,1179,17049
37.884,17,22,1936,11,48,3787,48,836,11,72,3787,72,1100
286.969,6,31,3558,16,323,19130,582,1510,15,254,20497,580,2048
317.0,6,75,19345,38,329,8567,1360,9792,37,366,8801,4649,9553
19.019,6,104,91044,65,1293,297,1360,57004,39,1803,495,10880,34040
1665.021,1,7,742,7,78,277503,78,742,0,0,0,0,0
0.326,6,28,9044,13,237,27,590,1635,15,827,22,1408,7409
1750.677,17,12,498,11,14,175067,14,462,1,8,0,8,36
7.389,6,8,448,4,0,2407,0,240,4,0,2407,0,208
11.02,6,19,4362,11,275,1102,275,998,8,1010,892,2840,3364
61.64,6,3,534,3,126,30820,126,534,0,0,0,0,0
98.361,6,10749,10197301,6933,1390,14,1448,9994193,3816,776,25,1448,203108
63.752,6,125,49346,68,691,951,1360,36637,57,452,1136,1360,12709
3.11,17,27,11673,12,557,282,1350,7027,15,281,127,1350,4646
0.014,17,2,290,1,40,0,40,68,1,194,0,194,222
4.716,6,20,6332,9,274,584,517,1298,11,744,467,1408,5034
280.339,6,28,7352,12,158,25485,267,1277,16,603,18681,1400,6075
0.004,17,2,400,1,128,0,128,156,1,216,0,216,244
31.615,6,7,396,1,0,0,0,60,6,0,6282,0,336
280.492,6,30,7432,13,158,23374,267,1317,17,603,17526,2076,6115
1788.256,6,356,22520,208,69,8638,69,12460,148,69,12162,69,10060
13.654,6,21,6825,12,275,1241,275,1038,9,1353,1080,1440,5787
0.379,6,22,5934,12,108,34,147,919,10,922,41,1581,5015
1770.746,6,127,20556,57,84,31619,517,4392,70,519,25662,1408,16164
1795.442,6,364,25530,211,99,8549,469,14925,153,69,11809,69,10605
7.355,6,1336,1188676,817,1375,8,1408,1157024,519,931,13,2816,31652
11.944,6,1868,1655216,1170,1363,10,1380,1622586,698,359,17,1380,32630
280.495,6,30,7432,13,158,23374,267,1317,17,603,17523,2076,6115
240.212,6,56,18020,30,750,8282,1402,15091,26,174,9608,580,2929
0.03,6,14,4329,7,127,2,127,499,7,864,4,1448,3830
51.596,6,27,7312,12,158,4690,267,1277,15,775,3682,3465,6035
1.472,6,19,3781,10,234,163,564,1452,9,463,162,1343,2329
0.425,6,3,124,1,0,0,0,40,2,0,425,0,84
1.654,6,25,8056,12,164,127,267,1288,13,869,123,1448,6768
1798.578,1,158,8848,158,28,11455,28,8848,0,0,0,0,0
46.37,6,9,527,5,43,11592,43,311,4,0,15454,0,216
0.091,6,10,1673,6,553,17,949,1350,4,159,29,159,323
4.803,6,40,7309,19,218,266,314,3383,21,513,225,1179,3926
16.278,17,6,528,3,48,8135,48,228,3,72,8134,72,300
1746.347,6,95,7203,63,38,28166,205,4476,32,33,56321,98,2727
5.236,6,46,8449,23,227,238,314,4102,23,427,226,1152,4347
1775.111,17,142,11360,71,48,25358,48,5396,71,56,25358,56,5964
1785.856,6,360,25439,205,100,8754,469,14616,155,69,11596,69,10823
61.318,6,35,15876,22,804,2919,1408,9201,13,855,5089,3847,6675
1.048,6,27,8420,15,222,61,540,1964,12,1192,77,3151,6456
1740.967,6,90,6521,59,31,30016,31,3998,31,31,58031,31,2523
0.18,6,10,1379,5,145,45,145,349,5,826,35,826,1030
0.008,17,2,243,1,35,0,35,63,1,152,0,152,180
1787.907,6,364,23185,210,69,8554,69,12609,154,69,11685,69,10576
280.297,6,28,7352,12,158,25481,267,1277,16,603,18683,1400,6075
0.01,17,2,441,1,36,0,36,64,1,349,0,349,377
14.149,6,14,2245,8,211,2018,211,846,6,545,2828,904,1399
60.802,17,12,912,12,48,5527,48,912,0,0,0,0,0
1758.437,17,313,61962,313,169,5636,356,61962,0,0,0,0,0
1.519,6,45,17023,26,801,60,1360,11487,19,476,73,2715,5536
0.274,6,5,296,1,0,0,0,64,4,0,91,0,232
1744.902,6,95,7203,63,38,28143,205,4476,32,33,56275,98,2727
7.339,6,17,2422,9,210,917,210,920,8,545,1042,904,1502
282.284,17,6,1480,3,32,141136,37,181,3,405,141137,463,1299
34.048,6,3982,3719176,2519,1396,13,1448,3638436,1463,776,23,1448,80740
3.115,17,3,201,3,39,1557,39,201,0,0,0,0,0
0.264,17,2,144,1,36,0,36,64,1,52,0,52,80
186.771,17,4,352,2,60,186770,60,176,2,60,186770,60,176
1794.958,1,264,27984,264,78,6824,78,27984,0,0,0,0,0
0.112,17,2,167,1,39,0,39,67,1,72,0,72,100
1752.241,6,95,7203,63,38,28261,205,4476,32,33,56513,98,2727
15.444,17,19,12285,8,541,2195,1350,4554,11,674,1537,1350,7731
1658.749,1,8,448,8,28,236964,28,448,0,0,0,0,0
4.056,6,50,26590,25,825,169,1408,11222,25,878,153,1408,15368
4.518,6,4,172,2,0,4518,0,84,2,0,4078,0,88
1740.744,17,28,6580,28,207,64472,207,6580,0,0,0,0,0
0.442,6,78,70838,29,183,15,230,2065,49,1408,7,1448,68773
1796.106,17,448,39612,404,35,4456,288,25708,44,288,40952,288,13904
1.322,17,6,2047,6,313,264,354,2047,0,0,0,0,0
0.064,17,4,588,2,48,54,48,152,2,190,52,308,436
1.289,6,48,18067,26,872,51,1360,12411,22,433,53,1360,5656
1681.431,1,14,784,14,28,129340,28,784,0,0,0,0,0
240.218,6,54,17934,29,801,8579,1402,15145,25,185,10008,580,2789
2.251,17,2,685,1,308,0,308,336,1,321,0,321,349
4.837,17,4,824,2,48,4824,48,152,2,308,4823,308,672
0.0,17,4,1658,4,386,0,394,1658,0,0,0,0,0
280.976,6,30,7432,13,158,23414,267,1317,17,543,17550,1400,6115
0.019,17,2,179,1,32,0,32,60,1,91,0,91,119
2.867,17,3,468,3,128,1433,128,468,0,0,0,0,0
271.28,1,4,224,4,28,90426,28,224,0,0,0,0,0
1788.717,6,135,9358,76,61,23849,208,5913,59,31,30175,31,3445
1772.492,6,180,15480,120,69,14894,69,8940,60,69,30038,69,6540
264.158,17,4,288,2,36,264157,36,128,2,52,264157,52,160
242.064,17,4,352,2,60,242063,60,176,2,60,242063,60,176
1.387,6,46,18124,26,882,55,1460,12548,20,476,63,2615,5576
387.895,6,20,1638,14,226,29838,226,1188,6,110,12343,110,450
1742.73,6,97,7307,63,38,28108,205,4476,34,33,52802,98,2831
1794.333,6,356,22520,208,69,8668,69,12460,148,69,12205,69,10060
51.479,17,4,352,2,60,51478,60,176,2,60,51478,60,176
0.975,6,11,1727,7,100,162,100,384,4,589,240,1152,1343
118.568,17,2751,3713799,2750,1322,43,1472,3713759,1,12,0,12,40
317.099,6,91,18150,42,271,7734,1460,7966,49,234,6603,1638,10184
23.67,6,33,8900,16,303,1578,721,2767,17,681,1468,1440,6133
17.197,17,15,8120,8,539,2452,1350,4542,7,483,2860,1350,3578
1750.534,17,12,498,11,14,175053,14,462,1,8,0,8,36
26.183,6,33,7552,14,158,2014,267,1357,19,543,1453,1400,6195
1737.276,17,346,44164,167,171,10465,1350,33256,179,32,9759,61,10908
5.211,6,44,24292,27,840,200,1360,6155,17,1585,313,3944,18137
282.475,6,32,7650,13,158,23539,267,1317,19,464,15670,1400,6333
1.703,6,116,87524,52,131,33,232,2609,64,1419,26,2840,84915
144.426,6,32,8952,14,158,11109,267,1357,18,624,8490,1400,7595
124.239,6,34,7935,12,155,28,267,1266,22,340,5915,3417,6669
0.195,17,2,152,1,48,0,48,76,1,48,0,48,76
140.892,6,22,8319,11,525,87,1237,2048,11,831,14071,1360,6271
1798.281,6,361,22996,211,69,8563,69,12718,150,69,12068,69,10278
3.317,17,4,368,4,64,1105,64,368,0,0,0,0,0
60.113,17,4,358,2,33,60113,34,123,2,89,60069,114,235
75.449,6,22,7972,11,511,87,1194,2005,11,787,7527,1440,5967
0.223,17,8,2750,8,315,31,354,2750,0,0,0,0,0
1.105,6,24,8004,12,164,85,267,1288,12,1014,85,2816,6716
457.894,17,26,2080,13,48,38157,48,988,13,56,38156,56,1092
1744.602,2,26,832,26,8,69784,8,832,0,0,0,0,0
1797.756,6,240,35580,150,302,12065,302,25920,90,83,20199,83,9660
68.6,6,27,7177,13,155,5716,267,1306,14,530,5276,3417,5871
89.556,17,4,352,2,60,89555,60,176,2,60,89555,60,176
0.071,17,2,602,1,46,0,46,74,1,500,0,500,528
16.259,6,27,7177,13,155,1354,267,1306,14,530,1249,3417,5871
71.119,6,32,7515,13,155,5926,267,1306,19,388,3950,1420,6209
1787.508,6,357,22629,208,69,8635,69,12460,149,69,12075,69,10169
0.784,6,10,1687,7,100,130,100,384,3,1179,263,1179,1303
1783.814,6,364,25392,212,100,8454,469,14896,152,69,11813,69,10496
1.026,17,3,238,2,30,997,30,116,1,94,0,94,122
49.877,6,10,1085,3,517,24934,517,681,7,0,8311,0,404
4.129,6,9,4636,4,174,1376,174,338,5,1364,798,1452,4298
1.126,6,23,6512,13,333,93,1006,2192,10,979,123,1731,4320
1770.455,6,101,9410,66,66,27237,66,5610,35,60,52069,60,3800
1.24,6,24,8004,12,164,96,267,1288,12,1014,95,2896,6716
15.322,17,10,880,5,48,3828,48,380,5,72,3827,72,500
1784.189,6,108,8778,69,65,26238,65,5035,39,59,46949,59,3743
300.228,6,35,12118,15,588,21444,1438,4319,20,614,15801,1488,7799
0.632,6,24,6015,13,108,52,147,959,11,922,58,2602,5056
1771.663,6,99,9174,66,64,27256,64,5544,33,58,55361,58,3630
1745.085,2,24,768,24,8,75873,8,768,0,0,0,0,0
0.01,17,8,2438,8,276,1,315,2438,0,0,0,0,0
0.085,6,10,1677,6,555,16,951,1354,4,159,27,159,323
0.282,6,3,327,2,103,30,138,287,1,0,0,0,40
0.395,6,10,1673,6,553,78,949,1350,4,159,128,159,323
1762.029,17,168,14022,156,30,11367,37,9090,12,383,154749,463,4932
1762.593,17,167,13992,155,30,11445,37,9032,12,385,154796,463,4960
5.009,17,4,558,2,36,5003,36,128,2,187,4998,187,430
1.696,17,6,360,3,32,847,32,180,3,32,847,32,180
10.929,6,20,4442,11,275,1092,275,998,9,768,772,1440,3444
280.618,6,32,7853,14,158,21586,267,1357,18,524,16505,1400,6496
300.274,6,24,8359,14,385,23098,986,2277,10,793,7581,2899,6082
1787.072,6,102,8296,68,65,26672,65,4930,34,59,54149,59,3366
83.133,6,29,6317,15,198,5938,501,1596,14,519,6383,1420,4721
0.021,17,2,167,1,31,0,31,59,1,80,0,80,108
0.222,6,12,3462,6,75,44,75,395,6,1373,44,1448,3067
244.513,6,72,23485,36,817,6985,1418,19105,36,190,6985,580,4380
280.241,6,28,7352,13,158,23353,267,1317,15,678,20012,4200,6035
0.398,6,5,1564,3,413,199,413,946,2,269,177,269,618
0.267,6,24,6064,12,181,24,537,1526,12,651,23,1408,4538
1786.5,17,87,3648,86,14,21017,14,3612,1,8,0,8,36
13.29,17,4,352,2,48,13280,48,152,2,72,13280,72,200
1.378,6,46,19509,27,915,53,1460,13973,19,529,66,4075,5536
1790.696,17,144,11520,72,48,25220,48,5472,72,56,25220,56,6048
1786.428,6,102,8296,68,65,26663,65,4930,34,59,54131,59,3366
0.155,17,12,3114,12,231,14,389,3114,0,0,0,0,0
1043.558,6,208,17206,106,125,9882,469,9745,102,69,10331,69,7461
31.768,6,6,360,0,0,0,0,0,6,0,0,0,360
3.445,6,2,88,2,0,0,0,88,0,0,0,0,0
1751.3,17,21,6770,21,294,87565,1323,6770,0,0,0,0,0
285.125,6,21,1509,11,330,28511,330,910,10,83,31679,83,599
850.367,1,16,896,16,28,56691,28,896,0,0,0,0,0
121.397,6,66,46817,44,1182,2823,1408,38940,22,960,2931,3847,7877
0.06,6,9,1339,5,145,15,145,349,4,826,10,826,990
5.624,6,41,7349,21,218,281,314,3463,20,513,279,1179,3886
1795.419,17,132,10560,66,48,27621,48,5016,66,56,27621,56,5544
1772.27,6,242,17981,121,69,14768,69,8980,121,34,14768,48,9001
1756.671,6,107,6374,60,27,29773,27,3525,47,27,38187,27,2849
0.363,6,20,4960,11,137,36,267,1132,9,866,42,2867,3828
0.216,6,10,1671,6,552,43,948,1348,4,159,71,159,323
0.267,17,2,198,1,63,0,63,91,1,79,0,79,107
230.654,6,28,8792,13,158,19221,267,1317,15,981,16470,3465,7475
368.523,6,23,1535,16,177,24568,177,1053,7,110,10373,110,482
3.861,17,4,352,2,48,3853,48,152,2,72,3852,72,200
142.348,6,36,7994,12,155,59,267,1266,24,303,6188,1460,6728
4.75,6,39,7269,20,218,250,314,3423,19,440,250,1152,3846
0.059,17,2,182,1,39,0,39,67,1,87,0,87,115
3.029,6,2,88,2,0,0,0,88,0,0,0,0,0
4.002,17,4,244,4,33,1334,33,244,0,0,0,0,0
9.495,6,43,35302,29,1319,339,1368,34512,14,54,714,54,790
37.533,17,44,6468,22,48,1786,48,1672,22,190,1786,308,4796
9.936,6,37,13187,16,440,662,721,2845,21,633,487,1414,10342
300.835,6,37,8420,21,286,15041,797,2028,16,521,565,3488,6392
280.632,6,31,7813,14,158,21587,267,1357,17,577,17538,2036,6456
1756.129,6,105,6270,60,27,29764,27,3525,45,27,39911,27,2745
1787.901,6,370,25301,214,93,8393,469,14714,156,69,11534,69,10587
1757.901,6,3555,3464621,1157,152,1520,989,70736,2398,1406,733,2836,3393885
39.718,6,32,7650,13,158,3309,267,1317,19,464,2181,1400,6333
184.474,2,3,96,3,8,92237,8,96,0,0,0,0,0
1799.485,1,16,896,16,28,119965,28,896,0,0,0,0,0
39.406,17,11,836,11,48,3940,48,836,0,0,0,0,0
559.681,6,31,2220,19,31,31093,31,1255,12,31,50862,31,965
1740.703,6,104,7550,66,31,26780,31,4503,38,31,47045,31,3047
14.131,17,5,3570,5,686,3532,1438,3570,0,0,0,0,0
1763.828,2,14,448,14,8,135679,8,448,0,0,0,0,0
1786.404,6,154,25004,92,483,19630,483,19282,62,83,29285,83,5722
0.018,17,4,352,2,37,14,37,130,2,83,12,89,222
74.279,6,6,275,0,0,0,0,0,6,7,14855,7,275
1659.208,1,8,448,8,28,237029,28,448,0,0,0,0,0
444.876,1,5,580,5,88,111219,88,580,0,0,0,0,0
1766.614,6,1046,304942,488,798,3627,1418,260338,558,64,3171,580,44604
1770.847,6,99,9306,66,66,27243,66,5610,33,60,55336,60,3696
45.448,2,3,96,3,8,22724,8,96,0,0,0,0,0
0.857,17,28,17486,15,797,59,1350,12375,13,365,68,1350,5111
1790.416,1,270,15120,270,28,6655,28,15120,0,0,0,0,0
1745.501,6,95,7203,63,38,28153,205,4476,32,33,56298,98,2727
34.206,17,40,5880,20,48,1799,48,1520,20,190,1799,308,4360
1787.904,6,378,23952,216,69,8315,69,13263,162,69,11104,69,10689
1539.544,17,122,9760,61,48,25656,48,4636,61,56,25658,56,5124
467.265,6,53,6826,27,103,14470,722,2756,26,150,18682,1408,4070
1.299,17,2,778,2,361,1299,361,778,0,0,0,0,0
1782.42,17,83,3480,82,14,22005,14,3444,1,8,0,8,36
1681.501,17,14,3843,7,30,280248,30,406,7,463,280247,463,3437
55.635,6,544,257260,289,822,193,1152,241896,255,430,218,1179,15364
13.236,6,75,28373,37,983,367,1440,17345,38,494,352,1440,11028
1772.002,6,180,15480,120,69,14890,69,8940,60,69,30033,69,6540
1546.889,1,28,1568,28,28,57292,28,1568,0,0,0,0,0
813.324,17,160,12160,160,48,5115,48,12160,0,0,0,0,0
1787.188,6,104,8444,68,66,26674,66,4964,36,60,51058,60,3480
0.019,17,2,588,1,39,0,39,67,1,493,0,493,521
1.289,6,49,20888,28,941,47,1360,15272,21,433,55,1360,5616
1750.476,6,104,7807,67,38,26522,205,4715,37,33,48612,98,3092
1781.765,6,358,22669,209,69,8566,69,12569,149,69,12038,69,10100
1797.822,6,356,22520,208,69,8685,69,12460,148,69,12230,69,10060
21.406,6,14,2676,6,821,4280,1420,1886,8,231,3057,231,790
1740.244,6,87,6322,58,31,30530,31,3915,29,31,62151,31,2407
0.728,1,2,112,2,28,728,28,112,0,0,0,0,0
1745.094,17,20,6555,20,299,91847,1284,6555,0,0,0,0,0
366.91,6,25,1651,17,177,22931,177,1117,8,110,9174,110,534
97.217,6,46,14845,23,633,4418,1360,4803,23,607,4398,1360,10042
0.012,17,2,1152,1,548,0,548,576,1,548,0,548,576
1671.709,1,8,448,8,28,238815,28,448,0,0,0,0,0
280.866,6,147,62363,69,802,1341,1152,54149,78,363,3644,1179,8214
1768.12,1,56,3136,56,28,32147,28,3136,0,0,0,0,0
1737.534,1,56,4704,56,56,31591,56,4704,0,0,0,0,0
0.338,6,10,767,5,186,84,186,454,5,45,80,45,313
1781.41,17,142,11360,71,48,25448,48,5396,71,56,25448,56,5964
1.385,1,2,208,2,76,1385,76,208,0,0,0,0,0
0.699,6,10,924,5,283,128,283,551,5,105,129,105,373
280.376,6,30,7432,13,158,23364,267,1317,17,678,17521,2085,6115
0.803,6,56,26496,32,1056,25,1380,19335,24,558,32,1923,7161
1654.607,1,8,448,8,28,236372,28,448,0,0,0,0,0
1739.762,1,56,4704,0,0,0,0,0,56,56,31632,56,4704
1786.474,6,106,8524,68,66,26663,66,4964,38,60,48280,60,3560
0.941,6,11,1727,7,100,156,100,384,4,589,225,1152,1343
848.787,1,43,2408,43,28,20209,28,2408,0,0,0,0,0
0.005,17,2,616,2,280,5,315,616,0,0,0,0,0
0.052,17,4,368,2,32,12,32,120,2,96,0,96,248
1744.48,6,97,7307,63,38,28136,205,4476,34,33,52854,98,2831
1760.201,1,92,5152,92,28,19342,28,5152,0,0,0,0,0
1797.935,1,345,28980,345,56,5226,56,28980,0,0,0,0,0
1791.758,17,89,3729,87,13,20832,14,3649,2,12,1791581,16,80
22.774,6,23,5822,12,275,2070,275,1042,11,1440,1632,1440,4780
113.693,6,184,146653,118,1288,971,1368,133708,66,633,1620,1368,12945
1786.459,6,104,8444,68,66,26663,66,4964,36,60,51039,60,3480
2.413,6,13,2311,8,188,344,245,700,5,1407,540,1407,1611
3.303,17,4,304,2,48,3034,48,152,2,48,2905,48,152
7.119,6,1695,1571226,1077,1381,6,1408,1534426,618,931,11,2801,36800
12.271,6,13,2133,8,324,1753,585,1073,5,396,3052,580,1060
93.508,6,328,355180,236,803,15,1360,15973,92,4091,1026,29920,339207
115.064,6,32,7781,11,162,269,267,1423,21,393,5752,1997,6358
1.175,6,24,8016,12,164,91,267,1300,12,1014,91,2411,6716
250.221,6,32,6389,15,205,17872,517,1671,17,423,15638,1418,4718
87.414,1,5,140,5,0,0,0,140,0,0,0,0,0
1723.991,1,8,448,8,28,246284,28,448,0,0,0,0,0
13.135,17,4,824,2,48,13110,48,152,2,308,13117,308,672
242.459,6,169,114018,77,554,3190,1418,9135,92,1266,2664,1862,104883
5.027,6,35,6209,19,206,279,314,2824,16,548,317,1179,3385
248.625,6,43,8645,21,119,12430,267,2040,22,357,11838,2840,6605
0.094,6,10,1495,5,507,23,507,727,5,556,23,556,768
1798.496,6,355,22480,207,69,8730,69,12420,148,69,12234,69,10060
1.233,6,23,7952,12,164,96,267,1288,11,1216,105,3819,6664
299.037,1,4,224,4,28,99679,28,224,0,0,0,0,0
2.209,6,13,2311,8,188,315,245,700,5,1407,487,1407,1611
0.564,17,2,152,2,48,564,48,152,0,0,0,0,0
0.009,17,2,335,1,39,0,39,67,1,240,0,240,268
0.646,6,12,1163,6,222,127,222,688,6,231,127,231,475
281.266,6,28,7352,13,158,23438,267,1317,15,678,20076,2045,6035
0.66,6,80,53676,48,1245,14,1432,48036,32,434,19,1871,5640
1799.842,17,444,39768,399,36,4522,288,25548,45,288,40020,288,14220
1792.325,17,29,9512,29,300,64011,300,9512,0,0,0,0,0
2.171,17,4,518,3,39,867,39,201,1,289,0,289,317
1784.906,1,48,4032,48,56,37976,56,4032,0,0,0,0,0
10.987,6,18,5610,10,275,1220,275,958,8,1440,823,1440,4652
2.659,17,2,230,1,40,0,40,68,1,134,0,134,162
0.347,17,8,2766,8,317,49,356,2766,0,0,0,0,0
22.841,17,59,38487,25,303,950,1350,8289,34,860,691,1350,30198
0.136,17,2,702,2,323,136,329,702,0,0,0,0,0
265.397,17,4,352,2,60,265396,60,176,2,60,265396,60,176
1786.453,6,102,8228,68,64,26663,64,4896,34,58,54132,58,3332
1.357,6,46,19379,27,909,52,1360,13843,19,476,65,2715,5536
3.462,6,2,88,2,0,0,0,88,0,0,0,0,0
6.989,6,53,23978,30,1002,241,1460,18282,23,433,296,1460,5696
1.255,17,4,368,2,32,982,32,120,2,96,975,96,248
0.084,17,4,284,2,32,67,32,120,2,54,20,60,164
1092.609,6,240,22593,127,107,8671,1189,9401,113,157,9754,1420,13192
180.545,2,4,128,4,8,60181,8,128,0,0,0,0,0
1.412,6,40,8389,21,320,70,1162,2808,19,480,68,4075,5581
19.508,6,15,9654,3,124,9754,124,264,12,1271,1446,1440,9390
2.859,6,2,80,1,0,0,0,40,1,0,0,0,40
3.596,17,4,1560,4,362,1198,362,1560,0,0,0,0,0
4.002,17,8,736,4,32,1331,32,240,4,96,1330,96,496
1763.46,17,344,60453,344,147,5141,386,60453,0,0,0,0,0
1789.437,1,74,6216,74,56,24512,56,6216,0,0,0,0,0
1741.504,6,87,6322,58,31,30552,31,3915,29,31,62195,31,2407
0.09,17,2,157,1,31,0,31,59,1,70,0,70,98
281.996,6,29,7392,14,158,21692,267,1357,15,678,20121,3436,6035
1789.952,6,379,23992,216,69,8325,69,13332,163,69,11049,69,10660
0.003,6,2,1480,1,0,0,0,40,1,1400,0,1400,1440
191.699,17,20,6370,20,290,10089,314,6370,0,0,0,0,0
1.266,6,2,87,1,0,0,0,40,1,7,0,7,47
1758.598,1,8,448,8,28,251228,28,448,0,0,0,0,0
1.466,6,48,19152,26,955,58,1460,13496,22,433,60,1460,5656
0.475,6,29,7523,18,306,27,1090,2869,11,701,45,1688,4654
280.311,6,29,7392,13,158,23359,267,1317,16,603,18685,1400,6075
637.895,6,148,19243,61,175,10631,1189,6846,87,118,7417,1452,12397
300.829,6,70,53458,47,1245,6539,1368,47286,23,1242,1462,4307,6172
0.096,1,2,112,2,28,96,28,112,0,0,0,0,0
5.318,17,3,208,2,36,5007,36,128,1,52,0,52,80
0.243,6,20,4960,10,137,27,267,1092,10,692,25,1467,3868
0.079,6,9,1339,5,145,19,145,349,4,826,17,826,990
390.032,6,27,1767,18,177,22943,177,1181,9,110,9528,110,586
116.349,17,4,352,2,60,116348,60,176,2,60,116348,60,176
280.277,6,30,7432,13,158,23356,267,1317,17,543,17513,1400,6115
0.187,17,2,2384,2,1164,187,1164,2384,0,0,0,0,0
1742.738,6,95,7203,63,38,28108,205,4476,32,33,56207,98,2727
213.404,17,15,2235,15,121,15243,121,2235,0,0,0,0,0
1702.888,17,130,10400,65,48,26607,48,4940,65,56,26607,56,5460
1799.132,1,58,4872,0,0,0,0,0,58,56,31563,56,4872
0.899,6,11,1727,7,100,149,100,384,4,589,212,1152,1343
1798.279,6,371,25948,215,99,8403,469,15154,156,69,11600,69,10794
190.067,6,39,8485,15,117,8960,267,1662,24,292,8263,1452,6823
164.253,17,10,880,5,48,41060,48,380,5,72,41060,72,500
1.247,17,3,1167,3,361,623,361,1167,0,0,0,0,0
1.005,17,2,464,2,204,1005,204,464,0,0,0,0,0
3.839,6,23,8559,9,158,478,370,1155,14,976,294,1420,7404
0.041,6,10,1060,6,517,8,517,837,4,7,13,7,223
8.13,1,9,756,9,56,1016,56,756,0,0,0,0,0
1.363,6,38,8252,19,320,75,1162,2716,19,433,65,1460,5536
1777.579,17,73,3060,72,14,25036,14,3024,1,8,0,8,36
25.766,6,27,7177,13,155,2147,267,1306,14,530,1981,3417,5871
1.644,6,25,8791,15,289,117,601,1473,10,987,162,1420,7318
0.966,17,3,392,2,60,854,60,176,1,188,0,188,216
1.128,17,2,124,2,34,1128,34,124,0,0,0,0,0
0.047,6,2,80,1,0,0,0,40,1,0,0,0,40
70.249,6,43,8445,19,147,3902,267,2243,24,475,3038,1460,6202
0.01,17,4,284,2,32,2,32,120,2,54,0,60,164
1784.819,6,102,8364,68,66,26639,66,4964,34,60,54082,60,3400
1.868,17,5,807,4,40,611,40,272,1,507,0,507,535
47.492,17,4,240,2,32,47491,32,120,2,32,47491,32,120
1.261,6,50,20536,28,915,46,1360,14880,22,476,51,2720,5656
1788.232,17,87,3648,86,14,21038,14,3612,1,8,0,8,36
12.218,17,10,2196,5,46,3053,46,370,5,337,3053,346,1826
504.398,2,3,96,3,8,252199,8,96,0,0,0,0,0
1764.314,2,15,480,15,8,126022,8,480,0,0,0,0,0
1785.238,6,354,22440,207,69,8666,69,12420,147,69,12227,69,10020
1796.751,1,345,28980,345,56,5223,56,28980,0,0,0,0,0
1383.717,2,12,384,12,8,125792,8,384,0,0,0,0,0
1787.306,6,109,8694,71,65,25532,65,5050,38,59,48297,59,3644
0.187,6,3,156,2,0,186,0,104,1,0,0,0,52
12.329,6,9,527,5,43,3082,43,311,4,0,4082,0,216
301.195,6,35,9469,19,540,16733,1360,4036,16,478,602,2667,5433
81.494,6,39,8766,15,401,41,889,1836,24,331,3537,4080,6930
1786.667,6,138,19919,84,248,21526,1286,13789,54,94,33708,267,6130
1434.033,6,79,16504,46,189,31867,1440,6442,33,320,44798,1440,10062
810.338,6,160,10057,92,69,8904,69,5543,68,69,12094,69,4514
1.621,6,25,8769,15,286,115,590,1462,10,986,158,1420,7307
1790.365,6,383,24221,217,69,8288,69,13441,166,69,10848,69,10780
1772.588,6,181,15589,120,69,14895,69,8940,61,69,29539,69,6649
1790.516,6,362,22967,210,69,8567,69,12609,152,69,11857,69,10358
0.134,17,2,266,1,41,0,41,69,1,169,0,169,197
1772.89,6,180,15480,120,69,14898,69,8940,60,69,30046,69,6540
0.479,17,3,451,2,39,141,39,134,1,289,0,289,317
5.269,6,7,400,3,0,2634,0,160,4,0,1341,0,240
0.626,6,14,2598,7,288,92,288,600,7,568,75,853,1998
1746.619,6,164,10288,86,49,20548,208,6269,78,31,22679,31,4019
14.434,6,1673,1334251,741,1155,19,1360,58027,932,1367,15,4080,1276224
1786.509,6,102,8296,68,65,26664,65,4930,34,59,54133,59,3366
119.398,6,31,8912,14,158,9184,267,1357,17,687,7459,1781,7555
12.041,17,4,768,2,32,12036,32,120,2,296,12036,296,648
76.12,6,15,844,8,0,10874,0,440,7,0,12685,0,404
297.597,1,4,224,4,28,99199,28,224,0,0,0,0,0
1792.215,17,87,3648,86,14,21084,14,3612,1,8,0,8,36
70.496,6,16,652,7,0,8254,0,284,9,0,8810,0,368
35.034,6,30,5043,15,180,2502,722,1859,15,342,2465,1448,3184
36.127,6,5002,4842910,3196,1433,11,1448,4739604,1806,792,19,1448,103306
1776.785,17,140,11200,70,48,25750,48,5320,70,56,25750,56,5880
942.687,17,76,6080,38,48,25477,48,2888,38,56,25477,56,3192
10.424,17,4,304,4,48,3474,48,304,0,0,0,0,0
1790.765,6,375,30200,206,75,8735,267,13442,169,126,10659,1460,16758
365.263,6,46,10135,29,266,13045,1360,4653,17,435,538,2667,5482
0.548,6,7,466,5,43,99,43,354,2,0,487,0,112
0.849,6,21,5988,12,281,77,544,1328,9,716,95,1420,4660
2.659,17,27,10922,11,349,265,1350,4147,16,395,116,1350,6775
0.774,17,2,154,1,33,0,33,61,1,65,0,65,93
11.614,6,3060,2452745,1424,218,8,230,78863,1636,1404,7,2816,2373882
135.886,6,38,8687,13,156,11323,267,1312,25,318,5656,1420,7375
297.286,1,4,224,4,28,99095,28,224,0,0,0,0,0
1720.632,17,13,534,11,14,172045,14,462,2,8,1720452,8,72
0.33,17,8,2766,8,317,47,356,2766,0,0,0,0,0
1796.956,1,345,28980,345,56,5223,56,28980,0,0,0,0,0
1783.247,6,128,15294,80,92,22572,501,6715,48,166,37939,1420,8579
1741.387,17,27,6237,27,203,66976,203,6237,0,0,0,0,0
527.337,1,8,448,8,28,75333,28,448,0,0,0,0,0
2.767,6,2,1520,1,0,0,0,40,1,1440,0,1440,1480
22.989,6,22,6245,11,272,2298,517,1261,11,567,2290,2642,4984
1.2,6,27,5724,16,121,80,267,1379,11,780,86,1459,4345
183.296,17,4,352,2,60,183295,60,176,2,60,183294,60,176
1781.763,6,417,25008,209,69,8564,69,12500,208,34,8607,69,12508
240.32,6,42,8949,21,523,12015,1418,5815,21,254,12015,618,3134
293.291,17,6,528,3,60,146645,60,264,3,60,146644,60,264
1797.402,6,373,26028,216,98,8360,469,15263,157,69,11520,69,10765
142.069,6,35,7529,18,134,8357,516,1936,17,409,8870,1452,5593
1773.849,6,182,15698,120,69,14906,69,8940,62,69,29075,69,6758
1786.615,17,80,3354,79,14,22905,14,3318,1,8,0,8,36
1.225,6,24,8004,12,164,94,267,1288,12,1014,94,2411,6716
41.9,17,6,528,3,48,20938,48,228,3,72,20943,72,300
1771.554,6,99,9306,66,66,27254,66,5610,33,60,55358,60,3696
194.295,1,2,208,2,76,194295,76,208,0,0,0,0,0
63.939,17,4,1370,2,308,63939,308,672,2,321,1012,321,698
280.311,6,24,7054,10,181,31145,267,1128,14,595,21557,1400,5926
61.338,6,37,15930,22,799,2920,1448,9151,15,665,4362,1448,6779
1785.103,6,145,19091,86,129,21001,1230,8735,59,177,30775,1420,10356
5.949,6,1756,1645316,1121,1393,5,1408,1607616,635,776,9,1408,37700
1.372,6,25,8056,12,164,107,267,1288,13,869,92,1448,6768
28.064,6,24,10609,15,568,2004,733,3630,9,1083,3506,1846,6979
1.451,17,23,16821,11,641,145,1350,7369,12,759,99,1350,9452
0.291,17,2,166,1,47,0,47,75,1,63,0,63,91
1799.186,17,449,39928,404,35,4464,288,25708,45,288,40019,288,14220
1797.626,1,345,28980,345,56,5225,56,28980,0,0,0,0,0
1687.832,1,8,448,8,28,241118,28,448,0,0,0,0,0
1797.348,1,341,28644,341,56,5286,56,28644,0,0,0,0,0
3.785,17,10,1415,5,31,943,31,295,5,196,942,196,1120
0.949,17,24,12243,12,556,83,1350,7018,12,407,83,1350,5225
5.954,17,3,228,3,48,2977,48,228,0,0,0,0,0
61.809,6,70,47164,43,1186,1471,1448,39029,27,747,2368,1448,8135
96.32,6,10,728,10,26,10702,26,728,0,0,0,0,0
0.238,6,46,20300,26,1015,9,1420,15279,20,467,12,1883,5021
0.956,6,26,8211,14,315,61,586,2170,12,1109,70,3132,6041
30.348,6,22,3506,10,302,3372,302,2340,12,83,2747,83,1166
1785.88,6,373,26359,215,104,8345,469,15623,158,69,11374,69,10736
0.642,17,2,778,2,361,642,361,778,0,0,0,0,0
1706.508,6,1890,1880110,693,147,2466,864,46424,1197,1566,1426,8508,1833686
6.448,6,819,657648,440,1400,14,1448,629520,379,776,16,1448,28128
24.632,6,18,1952,9,125,3079,245,990,9,299,3046,299,962
62.016,6,80,56343,50,1195,1265,1368,48048,30,840,2130,2519,8295
0.0,17,1,76,1,48,0,48,76,0,0,0,0,0
3.012,6,2,88,2,0,0,0,88,0,0,0,0,0
1771.494,6,102,9296,64,65,28118,65,5420,38,59,47875,59,3876
2.308,6,2,1520,1,0,0,0,40,1,1440,0,1440,1480
157.576,6,31,13398,16,846,4581,1329,4918,15,874,11238,1791,8480
0.05,17,2,136,1,32,0,32,60,1,48,0,48,76
4.002,17,4,240,4,32,1334,32,240,0,0,0,0,0
2.162,6,49,19268,27,891,83,1360,13612,22,433,93,1360,5656
1.678,6,25,8056,12,164,136,267,1288,13,869,125,1448,6768
0.285,6,9,1002,5,213,71,213,417,4,421,81,421,585
0.005,17,2,329,1,44,0,44,72,1,229,0,229,257
12.321,6,2016,1855375,1282,1369,9,1408,1812543,734,931,16,2801,42832
1781.758,6,360,23687,210,81,8525,469,13478,150,69,11958,69,10209
0.813,6,30,9122,15,227,58,547,1696,15,828,57,1438,7426
347.914,17,6,456,6,48,69582,48,456,0,0,0,0,0
1696.802,1,8,448,8,28,242400,28,448,0,0,0,0,0
843.117,1,7,961,7,109,140519,173,961,0,0,0,0,0
8.374,6,1640,1485154,978,1434,8,1448,1443582,662,776,12,1448,41572
128.554,17,4,240,2,32,128553,32,120,2,32,128553,32,120
300.376,6,59,28414,31,427,10012,1098,3388,28,1024,1886,1537,25026
1.184,6,24,8004,11,164,100,267,1236,13,869,83,1440,6768
77.918,2,2,64,2,8,77918,8,64,0,0,0,0,0
1.364,6,50,19433,27,901,52,1440,13737,23,433,53,1440,5696
1780.325,6,102,8296,68,65,26572,65,4930,34,59,53946,59,3366
0.53,17,3,543,2,39,391,39,134,1,381,0,381,409
371.15,6,25,1651,17,177,23196,177,1117,8,110,9214,110,534
0.005,17,2,602,1,46,0,46,74,1,500,0,500,528
231.68,17,4,368,2,36,231665,39,128,2,92,231664,119,240
0.018,17,2,214,1,36,0,36,64,1,122,0,122,150
240.166,6,45,5706,23,225,10916,752,3021,22,169,11436,514,2685
34.345,17,10,760,10,48,3816,48,760,0,0,0,0,0
36.187,17,40,5880,20,48,1904,48,1520,20,190,1904,308,4360
1744.579,2,28,896,28,8,64614,8,896,0,0,0,0,0
1.782,6,54,19542,27,898,68,1440,13686,27,433,61,1440,5856
1783.095,1,76,8056,76,78,23774,78,8056,0,0,0,0,0
1781.759,6,373,26828,216,110,8287,469,16063,157,69,11421,69,10765
300.682,6,39,8480,21,280,15034,775,2006,18,478,524,2720,6474
300.828,6,52,10618,26,433,12033,910,3310,26,312,602,1460,7308
1.04,17,14,5733,6,481,202,1350,3058,8,306,143,1350,2675
0.28,17,3,234,2,39,247,39,134,1,72,0,72,100
2.96,6,10,420,6,0,592,0,248,4,0,921,0,172
53.931,17,4,240,2,32,53930,32,120,2,32,53930,32,120
1.302,6,53,19307,29,879,46,1360,13526,24,400,48,1360,5781
2.987,2,2,64,2,8,2987,8,64,0,0,0,0,0
1.006,17,4,644,2,33,883,33,122,2,233,0,233,522
1.659,6,2,120,2,0,0,0,120,0,0,0,0,0
4.852,17,3,2906,3,940,2426,1451,2906,0,0,0,0,0
1.333,6,48,18204,26,882,53,1360,12548,22,433,54,1360,5656
211.896,17,4,352,2,60,211895,60,176,2,60,211895,60,176
1.095,6,23,7952,12,164,85,267,1288,11,1216,93,3819,6664
92.937,6,40,25787,19,840,38,1460,5847,21,1193,4640,1460,19940
17.452,17,32,23368,15,717,1244,1350,11181,17,688,1088,1350,12187
0.243,6,23,5928,12,164,22,453,1442,11,781,23,2224,4486
1561.508,6,453,152771,207,562,7577,1460,79881,246,488,6373,2920,72890
32.825,17,18,1584,9,48,4101,48,684,9,72,4101,72,900
1744.647,2,16,512,16,8,116309,8,512,0,0,0,0,0
158.732,1,4,224,4,28,52910,28,224,0,0,0,0,0
1.299,6,10,1687,7,100,216,100,384,3,1179,521,1179,1303
1.291,6,47,18572,27,848,49,1360,12996,20,476,58,2715,5576
280.05,6,29,7392,14,158,21542,267,1357,15,678,20000,4200,6035
0.13,17,4,420,2,33,0,33,122,2,121,1,145,298
1799.163,17,447,39580,403,35,4475,288,25676,44,288,40951,288,13904
280.442,6,28,7352,12,158,25494,267,1277,16,678,18694,2085,6075
0.544,6,22,7368,13,337,45,674,2032,9,1212,62,1946,5336
7.734,6,699,595579,426,1329,17,1368,576719,273,931,27,2841,18860
12.455,6,106,37220,55,619,230,1152,30698,51,407,244,1152,6522
0.048,17,4,284,2,32,35,32,120,2,54,36,60,164
0.474,6,13,1693,6,288,92,288,548,7,426,42,434,1145
1681.989,17,16,1265,8,30,240282,37,471,8,71,240282,136,794
11.699,17,2,672,2,308,11699,308,672,0,0,0,0,0
1787.202,6,232,20298,87,81,20779,337,9338,145,70,12410,1062,10960
0.673,6,21,5865,12,181,61,537,1526,9,643,73,1542,4339
264.551,6,29,8832,13,158,22045,267,1317,16,763,17631,2045,7515
72.709,6,25,11373,12,346,68,719,1562,13,1031,6047,1440,9811
75.883,6,29,7533,11,155,32,267,1226,18,429,4463,3426,6307
1793.748,17,180,11520,180,36,10020,36,11520,0,0,0,0,0
0.786,1,10,840,10,56,87,56,840,0,0,0,0,0
1799.597,17,450,39960,405,35,4454,288,25740,45,288,40025,288,14220
1.998,6,13,1399,5,304,499,304,560,8,83,252,83,839
1795.077,17,80,3354,79,14,23013,14,3318,1,8,0,8,36
0.188,6,43,17838,24,989,8,1420,12857,19,467,9,1883,4981
13.971,6,25,4654,14,275,1074,275,1122,11,768,920,1440,3532
18.944,6,1294,1098217,798,1297,23,1368,1066237,496,776,37,1473,31980
1344.891,6,79,6341,52,66,26370,66,3730,27,58,51722,60,2611
1681.281,17,18,4834,9,30,210159,37,529,9,450,210159,463,4305
1.311,6,38,8254,19,321,72,1164,2718,19,476,63,2720,5536
5.24,6,22,4906,12,233,476,613,1785,10,518,562,1408,3121
1.722,6,14,2351,8,188,246,245,700,6,703,291,1152,1651
3.392,17,33,13184,16,457,223,1350,7770,17,290,209,1350,5414
1.264,6,48,18767,27,859,48,1360,13151,21,433,54,1360,5616
3.959,6,24,13069,11,423,377,721,1715,13,1353,314,1414,11354
1700.655,17,15,3774,15,223,121475,1030,3774,0,0,0,0,0
1797.461,17,448,39896,403,35,4471,288,25676,45,288,40020,288,14220
6.616,6,34,8096,17,317,413,636,1663,17,441,402,1360,6433
0.963,6,24,8028,12,164,87,267,1312,12,869,71,1408,6716
0.104,6,13,2037,8,329,14,500,1082,5,687,25,687,955
1740.419,17,30,31680,30,1028,60014,1028,31680,0,0,0,0,0
0.139,6,10,583,5,43,34,43,311,5,0,33,0,272
1792.053,1,58,4872,0,0,0,0,0,58,56,31439,56,4872
1783.483,17,83,3480,82,14,22018,14,3444,1,8,0,8,36
6.05,6,86,76209,30,481,208,835,3037,56,1325,109,1440,73172
57.032,6,44,10169,22,533,420,910,3083,22,387,2709,4080,7086
1799.781,6,105,7308,66,60,27688,208,4818,39,31,47029,31,2490
1786.623,6,112,9369,71,72,25523,292,5442,41,65,44653,247,3927
1749.848,17,12,498,11,14,174984,14,462,1,8,0,8,36
0.131,6,2,80,1,0,0,0,40,1,0,0,0,40
0.193,6,27,7296,13,155,16,267,1301,14,603,14,2800,5995
1763.503,17,152,26004,152,143,11678,376,26004,0,0,0,0,0
28.404,6,30,7432,13,158,2367,267,1317,17,543,1774,1400,6115
0.063,6,13,4362,7,127,10,127,499,6,1181,11,1930,3863
1782.201,17,83,3480,82,14,22002,14,3444,1,8,0,8,36
24.244,6,5,264,3,0,12122,0,160,2,0,1016,0,104
54.831,6,11,4453,3,92,27415,92,244,8,1259,7791,1448,4209
56.834,6,540,241265,277,811,205,1152,225240,263,423,215,1179,16025
0.906,6,11,1727,7,100,151,100,384,4,589,216,1152,1343
1795.726,6,374,70773,161,332,11222,1460,45480,213,164,8469,1460,25293
0.014,17,2,461,1,34,0,34,62,1,371,0,371,399
1791.049,6,416,24920,208,69,8652,69,12460,208,34,8652,64,12460
15.576,17,15,4526,7,300,2591,1350,2297,8,250,2220,1350,2229
0.02,6,12,3462,6,75,4,75,395,6,1373,4,1448,3067
61.349,6,34,15669,22,789,2921,1448,9047,12,998,5554,5255,6622
304.333,6,92,78426,40,349,1761,517,2692,52,1796,5967,9940,75734
1740.737,17,30,7050,30,207,60025,207,7050,0,0,0,0,0
1242.307,17,10,2000,10,172,138034,172,2000,0,0,0,0,0
1737.485,1,56,4704,56,56,31590,56,4704,0,0,0,0,0
1765.764,1,103,5768,103,28,17311,28,5768,0,0,0,0,0
0.122,6,10,767,5,186,28,186,454,5,45,24,45,313
1783.342,1,207,11592,207,28,8657,28,11592,0,0,0,0,0
0.429,6,10,767,5,186,106,186,454,5,45,106,45,313
1772.063,6,180,15480,120,69,14891,69,8940,60,69,30032,69,6540
1748.485,6,94,7151,62,38,28663,205,4424,32,33,56389,98,2727
6.362,6,41,7349,21,218,318,314,3463,20,513,319,1179,3886
0.046,17,2,194,1,61,0,61,89,1,77,0,77,105
1783.621,6,365,23087,211,69,8493,69,12787,154,69,11655,69,10300
0.363,6,26,7256,13,155,30,267,1301,13,603,29,2800,5955
0.124,17,2,176,1,36,0,36,64,1,84,0,84,112
1786.268,6,194,16523,127,69,14176,69,9427,67,69,27055,69,7096
1742.1,6,95,7203,63,38,28098,205,4476,32,33,56187,98,2727
229.351,6,18,1296,7,31,38225,31,445,11,31,22859,31,851
0.245,17,2,144,1,36,0,36,64,1,52,0,52,80
6.738,6,45,8425,23,227,306,314,4102,22,491,308,1179,4323
115.012,6,21,8194,11,511,85,1194,2005,10,1155,12759,3151,6189
6.076,6,40,7325,21,218,303,314,3463,19,516,323,1179,3862
7.102,6,6,280,2,0,7102,0,88,4,0,2364,0,192
1795.397,1,272,28832,272,78,6625,78,28832,0,0,0,0,0
4.832,17,4,352,2,48,4819,48,152,2,72,4820,72,200
1003.664,6,84,9503,47,83,19620,721,4375,37,118,27874,1448,5128
0.005,17,2,382,1,37,0,37,65,1,289,0,289,317
10.029,6,81,24765,41,560,250,1152,19008,40,461,250,1179,5757
193.643,17,4,240,2,32,193642,32,120,2,32,193642,32,120
1.387,6,35,11542,18,443,81,1268,3426,17,928,76,2720,8116
6.442,6,578,524118,376,1329,16,1368,508950,202,931,31,2736,15168
0.196,6,2,142,1,62,0,62,102,1,0,0,0,40
240.195,6,56,10920,30,220,8282,517,3121,26,429,9607,1498,7799
439.427,6,116,12829,61,93,7323,267,4421,55,269,8136,3417,8408
0.284,6,25,6116,12,181,25,537,1526,13,651,22,1440,4590
0.023,17,2,298,1,40,0,40,68,1,202,0,202,230
0.19,17,2,136,1,32,0,32,60,1,48,0,48,76
1.745,17,20,5190,20,231,91,389,5190,0,0,0,0,0
193.376,1,44,4608,4,84,25983,84,448,40,76,891,76,4160
0.37,6,6,324,4,0,123,0,216,2,0,200,0,108
1786.801,6,104,8376,68,65,26668,65,4930,36,59,51047,59,3446
159.519,6,40,2971,16,86,10634,138,1330,24,52,6935,69,1641
1783.317,17,83,3480,82,14,22016,14,3444,1,8,0,8,36
1.311,17,22,16258,9,566,163,1350,5350,13,811,91,1350,10908
4.075,17,4,244,4,33,1358,33,244,0,0,0,0,0
1794.426,6,245,35856,152,302,11883,302,26032,93,83,19503,83,9824
280.452,17,4,296,2,30,280412,30,116,2,62,280409,62,180
1798.122,17,142,11360,71,48,25687,48,5396,71,56,25687,56,5964
1788.329,6,99,6444,63,47,28844,208,4074,36,31,51082,31,2370
126.873,6,867,397567,445,825,285,1152,374500,422,412,300,1179,23067
119.629,6,21,8279,11,525,97,1237,2048,10,969,13271,1791,6231
0.455,17,2,152,1,48,0,48,76,1,48,0,48,76
9.388,6,1825,1678732,1147,1385,8,1408,1638812,678,931,13,2801,39920
300.761,6,37,8374,20,277,15829,761,1940,17,522,534,3488,6434
300.322,6,36,12204,19,592,16684,1408,4612,17,744,15063,1578,7592
0.087,1,2,112,2,28,87,28,112,0,0,0,0,0
1766.056,1,58,4872,58,56,30983,56,4872,0,0,0,0,0
1773.087,6,184,15778,122,69,14653,69,9020,62,69,29058,69,6758
1797.639,6,367,23236,212,69,8519,69,12896,155,69,11672,69,10340
1741.15,6,88,6405,59,31,30019,31,3998,29,31,62181,31,2407
1799.745,17,445,39800,400,35,4510,288,25580,45,288,40018,288,14220
102.702,17,4,240,2,32,102700,32,120,2,32,102701,32,120
1781.147,17,142,11360,71,48,25444,48,5396,71,56,25444,56,5964
126.282,6,34,7935,12,155,30,267,1266,22,340,6013,3417,6669
122.2,1,10,560,10,28,13577,28,560,0,0,0,0,0
1796.642,17,442,39704,397,36,4536,288,25484,45,288,40017,288,14220
20.124,6,21,5442,12,107,1829,159,1098,9,773,2514,1408,4344
294.818,1,4,224,4,28,98272,28,224,0,0,0,0,0
316.999,6,69,18608,37,325,8805,1460,9655,32,383,10221,3089,8953
0.031,17,4,560,2,64,9,64,184,2,160,14,160,376
1679.531,1,7,392,7,28,279921,28,392,0,0,0,0,0
32.027,6,4,172,3,0,16012,0,132,1,0,0,0,40
39.329,17,44,6468,22,48,1872,48,1672,22,190,1872,308,4796
4.955,6,39,7269,19,218,275,314,3383,20,513,244,1179,3886
1.894,17,3,174,3,30,947,30,174,0,0,0,0,0
1798.687,6,362,24374,211,88,8565,469,13987,151,69,11991,69,10387
13.294,6,2037,1803851,1273,1363,10,1380,1769061,764,421,17,1923,34790
0.072,6,14,3448,8,106,10,106,530,6,866,14,1448,2918
1743.992,6,95,7203,63,38,28128,205,4476,32,33,56246,98,2727
1773.994,1,58,4872,58,56,31122,56,4872,0,0,0,0,0
1772.304,6,180,15480,120,69,14893,69,8940,60,69,30031,69,6540
0.012,17,2,138,1,33,0,33,61,1,49,0,49,77
1772.979,6,180,15480,120,69,14898,69,8940,60,69,30049,69,6540
0.324,6,27,8971,13,232,27,569,1614,14,827,24,1402,7357
0.028,6,6,374,3,31,14,31,187,3,31,0,31,187
1793.189,6,356,22520,208,69,8662,69,12460,148,69,12198,69,10060
2.708,6,21,6348,10,262,295,517,1316,11,744,266,1418,5032
280.034,6,30,8077,14,158,21541,267,1357,16,675,18666,3436,6720
1798.732,17,768,46308,768,32,2345,37,46308,0,0,0,0,0
1328.195,6,159,10914,59,46,22899,46,4614,100,46,13416,46,6300
2.916,17,8,1320,4,30,968,30,232,4,244,968,244,1088
7.526,6,23,6767,7,138,1254,267,843,16,479,500,1452,5924
1.476,6,37,8212,19,320,82,1162,2716,18,476,75,2715,5496
1.003,17,23,15198,12,1008,91,1350,12438,11,222,96,1350,2760
1791.732,17,180,14040,180,50,10009,50,14040,0,0,0,0,0
1786.42,1,82,4592,82,28,22054,28,4592,0,0,0,0,0
0.054,17,4,284,2,32,43,32,120,2,54,43,60,164
675.562,17,54,4320,27,48,25982,48,2052,27,56,25982,56,2268
11.692,6,1873,1590601,1122,1362,10,1380,1556319,751,421,15,1923,34282
9.157,6,17,5680,9,272,1144,516,1180,8,835,1287,1452,4500
79.003,6,104,79377,68,1266,1179,1448,69389,36,675,2097,1448,9988
8.434,6,77,24637,39,561,221,1152,18976,38,413,220,1152,5661
1789.916,6,373,26028,215,98,8364,469,15223,158,69,11398,69,10805
15.187,6,21,6745,5,189,3796,189,409,16,473,742,1460,6336
0.106,17,2,152,1,48,0,48,76,1,48,0,48,76
1681.28,17,16,4241,8,30,240182,37,471,8,443,240182,463,3770
1798.635,1,121,6776,121,28,14988,28,6776,0,0,0,0,0
0.0,17,7,2445,7,321,0,355,2445,0,0,0,0,0
0.202,17,2,152,1,48,0,48,76,1,48,0,48,76
17.049,2,2,64,2,8,17049,8,64,0,0,0,0,0
1761.606,6,78,3588,39,0,46357,0,2028,39,0,46358,0,1560
24.251,6,35,8258,17,175,1515,721,2085,18,681,1365,2840,6173
1790.68,6,358,22669,209,69,8609,69,12569,149,69,12099,69,10100
1795.24,17,80,3354,79,14,23015,14,3318,1,8,0,8,36
0.823,6,26,5887,13,156,68,267,1462,13,780,62,1460,4425
300.726,6,37,8388,21,280,15036,775,1994,16,522,568,3488,6394
33.756,6,31,5093,15,154,2411,722,1858,16,342,2236,1440,3235
1788.126,17,142,11360,71,48,25543,48,5396,71,56,25543,56,5964
1795.177,17,448,39896,403,35,4465,288,25676,45,288,40024,288,14220
1750.401,6,95,7203,63,38,28232,205,4476,32,33,56453,98,2727
1787.408,6,102,8296,68,65,26677,65,4930,34,59,54159,59,3366
1799.61,6,421,25253,210,69,8610,69,12540,211,34,8569,64,12713
223.882,17,81,5562,81,40,2798,41,5562,0,0,0,0,0
1718.93,1,8,448,8,28,245561,28,448,0,0,0,0,0
0.396,6,12,1653,6,288,75,288,548,6,426,44,434,1105
23.404,6,23,6658,11,275,2340,275,735,12,1353,1722,1420,5923
2.803,17,17,10393,9,888,345,1350,8252,8,239,393,1350,2141
3.548,6,14,3180,9,49,443,92,599,5,772,53,2118,2581
0.389,6,4,1037,2,0,389,0,104,2,853,41,853,933
0.974,6,12,1055,6,256,193,256,504,6,303,192,303,551
135.155,6,34,5510,17,152,8447,722,2113,17,358,8435,1408,3397
1740.826,6,87,6322,58,31,30540,31,3915,29,31,62172,31,2407
1773.686,6,204,22330,130,75,13749,267,10057,74,132,24291,1460,12273
0.931,6,10,1687,7,100,155,100,384,3,1179,340,1179,1303
1.377,6,53,19545,29,897,49,1460,13764,24,400,50,1460,5781
1797.554,1,345,28980,345,56,5225,56,28980,0,0,0,0,0
241.706,6,122,83772,68,1289,3607,1448,74491,54,587,1262,1448,9281
240.178,6,54,17546,29,769,8577,1408,14596,25,205,10007,580,2950
1778.178,17,140,11200,70,48,25770,48,5320,70,56,25770,56,5880
756.122,2,5,160,5,8,189030,8,160,0,0,0,0,0
1.306,6,37,8214,19,321,72,1164,2718,18,476,65,2715,5496
11.059,6,88,26829,44,570,257,1152,20587,44,407,251,1152,6242
64.125,17,18,1584,9,48,8014,48,684,9,72,8014,72,900
1795.175,17,448,39896,403,35,4465,288,25676,45,288,40026,288,14220
1.504,6,24,8004,12,164,117,267,1288,12,1014,117,2491,6716
1.4,6,46,18916,27,876,53,1360,13380,19,529,68,4075,5536
272.038,1,2,748,2,346,272038,346,748,0,0,0,0,0
1770.424,6,105,9618,66,66,27237,66,5610,39,60,46587,60,4008
84.833,6,47,12703,23,824,655,1360,6786,24,309,3681,2667,5917
0.112,17,2,245,1,32,0,32,60,1,157,0,157,185
111.86,17,4,352,2,60,111859,60,176,2,60,111859,60,176
0.021,17,2,144,1,36,0,36,64,1,52,0,52,80
0.568,6,10,924,5,283,97,283,551,5,105,96,105,373
1.052,6,27,8518,14,275,66,583,1979,13,1001,71,1791,6539
358.192,1,5,475,5,67,89548,121,475,0,0,0,0,0
1756.688,6,1593,1878531,476,146,3698,880,32663,1117,1710,1574,7010,1845868
0.192,6,9,1340,5,145,48,145,349,4,827,41,827,991
0.072,6,14,4328,7,126,11,126,498,7,864,11,1448,3830
0.027,17,4,284,2,32,16,32,120,2,54,15,60,164
29.119,6,46,10693,22,773,427,1360,4838,24,325,1258,1360,5855
0.181,6,53,25792,30,1079,6,1432,20651,23,420,7,1432,5141
4.624,6,34,5782,16,229,308,314,3159,18,380,254,741,2623
0.083,1,2,112,2,28,83,28,112,0,0,0,0,0
1772.928,6,180,15480,120,69,14898,69,8940,60,69,30045,69,6540
961.393,6,99,8514,66,69,14790,69,4917,33,69,30033,69,3597
6.831,6,911,800698,556,1359,11,1368,773758,355,776,18,1473,26940
0.921,6,27,8420,14,266,58,540,1924,13,994,62,1791,6496
15.66,6,910,784048,573,1295,27,1368,761860,337,776,45,2736,22188
1768.294,1,8,448,8,28,252613,28,448,0,0,0,0,0
1796.708,17,142,11360,71,48,25667,48,5396,71,56,25667,56,5964
3.984,17,2,176,2,60,3984,60,176,0,0,0,0,0
296.571,1,4,224,4,28,98857,28,224,0,0,0,0,0
1063.275,1,11,616,11,28,106327,28,616,0,0,0,0,0
2.003,6,57,26146,31,1100,66,1380,18941,26,558,77,1923,7205
1795.25,17,80,3354,79,14,23016,14,3318,1,8,0,8,36
7.069,17,3,2145,3,687,3534,687,2145,0,0,0,0,0
1.274,6,47,18785,27,864,49,1360,13209,20,433,58,1360,5576
37.912,17,11,836,11,48,3791,48,836,0,0,0,0,0
0.176,6,12,3705,6,171,34,171,491,6,964,33,1448,3214
386.627,6,157,123722,102,1275,3827,1408,109944,55,727,1785,2439,13778
174.413,17,8,2688,8,308,24916,308,2688,0,0,0,0,0
0.124,17,6,2123,6,325,24,355,2123,0,0,0,0,0
1770.181,6,314,24964,136,86,13111,337,13313,178,49,10001,143,11651
11.883,6,32,10492,16,306,792,1087,2786,16,881,791,1728,7706
2.313,6,14,2351,8,188,330,245,700,6,703,409,1152,1651
128.423,6,27,7218,5,154,32105,267,672,22,332,6114,1420,6546
33.595,6,30,5065,15,154,2399,722,1883,15,399,2385,2026,3182
6.581,6,696,602858,433,1322,15,1368,584518,263,776,24,2736,18340
1790.156,6,360,23687,209,81,8606,469,13438,151,69,11933,69,10249
3.201,17,5,290,5,30,800,30,290,0,0,0,0,0
1757.998,6,218,21648,107,89,16584,721,10851,111,171,15979,1440,10797
0.039,6,2,87,1,0,0,0,40,1,7,0,7,47
9.05,6,5,355,0,0,0,0,0,5,31,2262,31,355
1777.806,17,142,11360,71,48,25396,48,5396,71,56,25396,56,5964
244.486,6,26,7272,12,158,22226,267,1277,14,775,18803,3445,5995
1.43,6,44,19455,26,920,57,1360,13959,18,476,72,2715,5496
175.201,17,2,72,1,8,0,8,36,1,8,0,8,36
120.779,2,3,96,3,8,60389,8,96,0,0,0,0,0
0.089,6,10,767,5,186,21,186,454,5,45,18,45,313
378.353,2,3,96,3,8,189176,8,96,0,0,0,0,0
189.211,17,4,272,2,32,189194,32,120,2,48,189198,48,152
1787.973,6,119,12658,77,81,23525,515,6174,42,126,43603,1452,6484
0.04,17,2,510,1,37,0,37,65,1,417,0,417,445
53.482,6,23,4814,10,296,5942,722,1405,13,341,4439,1448,3409
3.051,6,28,9845,15,322,217,1197,2217,13,1184,253,1731,7628
4.271,6,715,597045,422,1379,10,1420,581104,293,420,14,1420,15941
1797.874,6,258,25630,111,67,16343,616,9805,147,132,12313,1360,15825
0.996,17,2,685,1,308,0,308,336,1,321,0,321,349
0.009,17,2,2166,2,1055,9,1055,2166,0,0,0,0,0
3.121,17,28,10179,14,329,237,1350,4998,14,342,237,1350,5181
300.512,6,87,14720,40,308,7704,1368,7329,47,214,6531,1368,7391
9.494,6,20,6503,9,275,1186,275,639,11,602,623,1414,5864
0.443,6,12,1653,6,288,82,288,548,6,426,55,434,1105
0.077,17,2,396,1,39,0,39,67,1,301,0,301,329
2.395,17,3,1170,3,362,1197,362,1170,0,0,0,0,0
2.238,17,25,6290,10,257,248,1350,2852,15,201,114,1350,3438
1786.199,6,384,27696,212,103,8465,469,15641,172,69,10444,69,12055
1.443,6,48,21064,28,955,53,1360,15488,20,529,66,4075,5576
280.408,6,29,7392,13,158,23367,267,1317,16,678,18690,3456,6075
1799.49,17,448,39896,403,35,4476,288,25676,45,288,40015,288,14220
1772.513,6,203,22359,130,75,13740,267,10057,73,135,24614,3417,12302
1786.796,17,142,11360,71,48,25524,48,5396,71,56,25525,56,5964
300.662,6,41,8786,21,318,15033,928,2171,20,386,447,1360,6615
0.91,6,10,1687,7,100,151,100,384,3,1179,323,1179,1303
164.519,17,4,352,2,60,164518,60,176,2,60,164517,60,176
1786.563,6,102,8364,68,66,26665,66,4964,34,60,54135,60,3400
9.375,6,16,3911,9,275,1171,275,643,7,992,749,1440,3268
1786.53,6,104,8444,68,66,26664,66,4964,36,60,51041,60,3480
1.475,17,24,17591,12,779,133,1350,9687,12,630,130,1350,7904
1798.248,1,59,4956,59,56,31004,56,4956,0,0,0,0,0
120.341,2,3,96,3,8,60170,8,96,0,0,0,0,0
1797.565,1,269,15064,269,28,6707,28,15064,0,0,0,0,0
10.47,6,15,2309,8,211,1492,211,858,7,545,1736,904,1451
297.89,1,2,112,2,28,297890,28,112,0,0,0,0,0
2.617,6,3,1580,3,1460,1308,1460,1580,0,0,0,0,0
145.293,6,24,11556,13,645,52,1360,3778,11,1221,14516,2720,7778
388.493,17,228,15656,228,40,1711,41,15656,0,0,0,0,0
0.091,17,2,154,1,33,0,33,61,1,65,0,65,93
2.99,17,3,451,2,39,2972,39,134,1,289,0,289,317
1662.259,1,8,448,8,28,237465,28,448,0,0,0,0,0
50.52,17,25,3392,17,60,3157,288,1500,8,208,5778,308,1892
215.384,6,27,8853,9,267,97,502,1166,18,435,12664,1420,7687
4.196,6,12,1133,5,283,1005,283,551,7,105,669,105,582
0.513,6,22,7345,13,334,42,663,2021,9,1209,60,1946,5324
1.597,6,19,3781,10,234,177,564,1452,9,463,173,1343,2329
34.142,17,4,352,2,60,34141,60,176,2,60,34141,60,176
0.511,17,3,451,2,39,125,39,134,1,289,0,289,317
144.812,6,18,2393,10,324,16090,585,1177,8,396,20665,580,1216
0.011,17,2,322,1,36,0,36,64,1,230,0,230,258
1.409,17,24,9679,12,481,128,1350,6113,12,269,125,1350,3566
40.494,2,4,128,4,8,13498,8,128,0,0,0,0,0
0.186,6,25,7216,13,155,15,267,1301,12,678,16,2045,5915
0.016,17,2,586,1,47,0,47,75,1,483,0,483,511
465.584,1,28,1568,28,28,17243,28,1568,0,0,0,0,0
240.47,6,41,8831,20,524,12655,1418,5764,21,218,12022,618,3067
2.036,6,20,3833,11,234,203,564,1504,9,463,231,1343,2329
57.163,6,27,7748,11,266,5716,499,1243,16,450,3804,1420,6505
280.345,6,30,7432,13,158,23362,267,1317,17,543,17516,1400,6115
1773.022,6,182,15629,121,69,14775,69,8980,61,69,29548,69,6649
240.731,6,463,390017,189,460,1280,1418,14570,274,1383,881,1827,375447
11.77,6,1831,1624922,1124,1392,10,1420,1592421,707,467,16,1883,32501
0.411,17,17,8228,8,578,58,1350,4852,9,347,42,1350,3376
1799.669,17,142,11360,71,48,25709,48,5396,71,56,25709,56,5964
1776.48,17,73,3060,72,14,25020,14,3024,1,8,0,8,36
1755.563,1,186,10416,186,28,9489,28,10416,0,0,0,0,0
24.75,6,10,644,3,106,12375,106,234,7,90,4086,90,410
1751.126,6,94,7151,62,38,28706,205,4424,32,33,56481,98,2727
1793.487,17,144,11520,72,48,25260,48,5472,72,56,25260,56,6048
1784.15,6,104,8376,68,65,26629,65,4930,36,59,50972,59,3446
280.489,6,29,7392,13,158,23374,267,1317,16,678,18695,3456,6075
159.25,6,25,7367,13,1151,13270,1408,6442,12,293,14458,293,925
1795.352,6,430,26599,226,75,7979,501,13750,204,41,8844,69,12849
1770.723,6,99,9306,66,66,27241,66,5610,33,60,55332,60,3696
12.097,6,1914,1657726,1158,1376,10,1420,1623265,756,467,16,1883,34461
1173.78,6,268,32123,133,141,8892,721,19999,135,181,7960,1414,12124
1721.452,17,12,498,11,14,172145,14,462,1,8,0,8,36
0.209,6,46,21615,27,1035,8,1420,16634,19,467,11,1883,4981
0.459,6,12,1653,6,288,88,288,548,6,426,52,434,1105
721.93,2,10,320,10,8,80214,8,320,0,0,0,0,0
1680.967,1,15,840,15,28,120069,28,840,0,0,0,0,0
1681.742,17,14,1036,7,30,280288,30,406,7,62,280287,62,630
0.004,17,2,279,1,36,0,36,64,1,187,0,187,215
316.363,6,10,617,6,31,63272,31,333,4,31,105300,31,284
1.304,6,45,10185,23,440,59,1360,4484,22,400,53,1360,5701
0.021,17,2,367,1,33,0,33,61,1,278,0,278,306
1794.656,6,236,23373,122,141,14829,208,17790,114,31,15878,31,5583
1750.15,17,12,498,11,14,175015,14,462,1,8,0,8,36
1679.518,17,12,498,11,14,167951,14,462,1,8,0,8,36
240.213,6,54,18300,29,782,8578,1408,15594,25,174,10008,580,2706
0.244,6,24,6064,12,181,22,537,1526,12,651,21,1408,4538
2.194,17,4,314,2,31,2175,31,118,2,70,2168,70,196
1797.21,1,282,15792,282,28,6395,28,15792,0,0,0,0,0
5.142,17,3,208,2,36,5002,36,128,1,52,0,52,80
10.399,6,12,1355,7,284,1733,517,940,5,147,2598,147,415
1.935,6,32,8952,14,158,148,267,1357,18,624,109,1400,7595
7.595,6,44,8389,22,227,361,314,4062,22,491,349,1179,4327
36.689,17,44,6468,22,48,1743,48,1672,22,190,1746,308,4796
1799.415,17,449,39928,404,35,4465,288,25708,45,288,40019,288,14220
1.652,6,71,51109,44,1257,38,1440,43800,27,842,56,1440,7309
280.442,6,28,7352,13,158,23370,267,1317,15,678,20027,2085,6035
0.047,17,2,148,1,38,0,38,66,1,54,0,54,82
1671.214,1,103,5768,103,28,16384,28,5768,0,0,0,0,0
1740.495,17,28,6580,28,207,64462,207,6580,0,0,0,0,0
1.004,17,8,688,4,47,333,47,300,4,69,334,75,388
314.496,6,56,12496,22,221,14975,1189,3328,34,354,9529,1917,9168
75.542,6,180,130465,90,430,848,647,6026,90,1392,844,1440,124439
0.011,17,2,200,1,48,0,48,76,1,96,0,96,124
0.019,17,2,142,1,35,0,35,63,1,51,0,51,79
0.701,17,6,660,3,78,350,84,320,3,85,197,104,340
7.479,6,14,1247,7,222,1244,222,728,7,231,1244,231,519
2.239,17,4,1556,4,361,746,361,1556,0,0,0,0,0
369.506,6,21,1419,15,177,26393,177,989,6,110,12238,110,430
87.326,6,13,2484,4,92,17004,92,308,9,421,10892,1408,2176
1778.52,1,174,18444,174,78,10280,78,18444,0,0,0,0,0
9.865,6,3,134,0,0,0,0,0,3,7,4932,7,134
281.501,6,20,1462,9,31,35187,31,580,11,31,27884,31,882
3.502,6,28,7474,13,141,291,267,1370,15,550,202,1400,6104
0.141,6,2,112,1,0,0,0,60,1,0,0,0,52
0.453,6,12,1653,6,288,87,288,548,6,426,46,434,1105
1770.45,6,99,9240,66,65,27237,65,5577,33,59,55322,59,3663
457.544,6,83,12177,42,94,11159,267,3777,41,211,11438,1460,8400
1795.253,17,80,3354,79,14,23016,14,3318,1,8,0,8,36
7.379,6,1671,1439323,940,1440,7,1448,1392455,731,776,9,1448,46868
299.211,17,16,1184,8,30,42742,30,464,8,62,42742,62,720
8.141,6,78,24645,40,560,208,1152,18968,38,461,213,1179,5677
11.234,6,26,9953,13,275,936,275,1078,13,1042,691,1440,8875
1793.554,17,66,2766,65,14,28024,14,2730,1,8,0,8,36
0.163,6,46,20440,26,1025,6,1420,15419,20,467,8,1883,5021
0.186,17,2,1918,2,931,186,931,1918,0,0,0,0,0
0.024,6,10,1677,6,555,4,951,1354,4,159,6,159,323
2.041,17,3,174,3,30,1020,30,174,0,0,0,0,0
1797.672,6,374,26068,217,98,8322,469,15303,157,69,11520,69,10765
1786.623,6,106,8524,68,66,26666,66,4964,38,60,48284,60,3560
0.005,6,13,4282,7,111,0,111,483,6,1159,1,1863,3799
65.901,6,50,14790,25,983,661,1360,8957,25,401,2738,2667,5833
1795.703,17,448,39896,403,35,4466,288,25676,45,288,40016,288,14220
1791.226,6,369,29105,211,76,8529,267,13541,158,133,11408,1420,15564
11.062,17,15,17682,15,1150,790,1451,17682,0,0,0,0,0
1798.68,6,272,34219,111,146,16350,1360,16891,161,135,11241,4662,17328
363.389,1,4,240,4,32,121129,32,240,0,0,0,0,0
4.858,6,22,4906,13,233,404,613,1837,9,648,584,1767,3069
1790.984,1,342,28728,342,56,5252,56,28728,0,0,0,0,0
1790.855,1,342,28728,342,56,5251,56,28728,0,0,0,0,0
155.147,17,4,352,2,60,155146,60,176,2,60,155146,60,176
0.078,17,2,168,1,48,0,48,76,1,64,0,64,92
3.172,17,2,152,1,48,0,48,76,1,48,0,48,76
124.964,17,4,352,2,60,124963,60,176,2,60,124963,60,176
1.571,6,75,55905,46,1280,34,1408,48492,29,842,50,1408,7413
4.216,17,5,290,5,30,1054,30,290,0,0,0,0,0
240.174,6,55,19682,30,845,8281,1402,16795,25,197,10007,580,2887
1.096,6,29,7519,17,305,68,1086,2825,12,701,98,1728,4694
1798.269,17,449,39928,404,35,4462,288,25708,45,288,40019,288,14220
