flow_duration,protocol,TotPackets,TotBytes,tot_fwd_pkts,totlen_fwd_pkts,fwd_iat_mean,fwd_pkt_len_max,fwd_pkt_len_mean,tot_bwd_pkts,totlen_bwd_pkts,bwd_iat_mean,bwd_pkt_len_max,bwd_pkt_len_mean
11.61,6,22,6817,12,275,1055,275,1038,10,1073,732,1440,5779
292.835,6,50,12980,24,135,12729,517,2213,26,626,11711,1418,10767
5.228,6,40,7309,21,218,261,314,3463,19,513,276,1179,3846
0.34,6,27,9047,13,252,28,647,1692,14,945,23,1408,7355
1786.743,6,354,22440,207,69,8673,69,12420,147,69,12237,69,10020
85.157,6,750,359064,401,827,212,1152,340313,349,435,243,1179,18751
300.961,6,53,20600,30,1045,10377,1460,14833,23,402,397,2567,5767
0.61,17,2,152,1,48,0,48,76,1,48,0,48,76
0.335,6,13,1693,7,288,55,288,588,6,284,33,434,1105
198.175,6,160,125603,103,1282,1942,1408,113130,57,730,2883,3847,12473
0.5,17,6,2084,6,319,100,355,2084,0,0,0,0,0
1259.761,2,7,224,7,8,209960,8,224,0,0,0,0,0
29.005,17,4,352,2,60,29004,60,176,2,60,29003,60,176
0.242,6,9,527,5,43,60,43,311,4,0,77,0,216
19.264,6,18,14363,3,161,9547,196,462,15,1208,1363,1360,13901
37.945,17,44,6468,22,48,1806,48,1672,22,190,1806,308,4796
194.434,17,4,352,2,60,194432,60,176,2,60,194433,60,176
136.95,6,29,7392,13,158,11412,267,1317,16,603,9124,2800,6075
1798.357,17,448,39612,404,35,4462,288,25708,44,288,40896,288,13904
1.329,6,49,19926,27,939,51,1460,14270,22,433,53,1460,5656
36.297,17,20,1760,10,48,4031,48,760,10,72,4031,72,1000
1740.601,17,30,31680,30,1028,60020,1028,31680,0,0,0,0,0
17.489,17,64,48881,27,480,670,1350,13739,37,921,483,1350,35142
16.302,6,5,476,0,0,0,0,0,5,69,4075,69,476
47.458,6,27,7177,13,155,3954,267,1306,14,530,3649,2840,5871
1.217,6,25,8068,12,164,94,267,1300,13,869,86,1408,6768
17.954,6,7,308,7,0,0,0,308,0,0,0,0,0
85.94,6,32,7462,10,121,905,267,1016,22,370,4091,1420,6446
0.504,6,23,7321,12,318,45,599,1905,11,967,49,1906,5416
0.09,6,12,3462,6,75,18,75,395,6,1373,17,1448,3067
1792.342,17,29,10353,29,329,64012,329,10353,0,0,0,0,0
1.637,6,52,22777,30,934,56,1360,17121,22,433,67,1360,5656
280.04,6,29,7392,13,158,23336,267,1317,16,603,18667,2036,6075
144.232,17,8,2688,8,308,20604,308,2688,0,0,0,0,0
1632.2,1,7,392,7,28,272033,28,392,0,0,0,0,0
201.069,6,45,8932,18,119,11827,267,1920,27,282,7732,1420,7012
111.294,17,3,1008,3,308,55647,308,1008,0,0,0,0,0
1787.572,6,104,8444,68,66,26680,66,4964,36,60,51069,60,3480
1794.841,6,358,22669,209,69,8629,69,12569,149,69,12127,69,10100
0.169,6,10,1514,5,503,42,503,771,5,475,42,475,743
1789.707,6,274,33466,111,144,16268,1460,16458,163,127,11046,1642,17008
0.547,17,2,776,2,360,547,360,776,0,0,0,0,0
0.622,6,50,22425,28,1076,23,1380,17303,22,468,25,3303,5122
87.723,6,79,51018,47,1181,1907,1368,42620,32,840,2002,2736,8398
280.203,17,4,296,2,30,280184,30,116,2,62,280183,62,180
1076.931,17,1708,81984,854,20,1262,20,40992,854,20,1262,20,40992
20.139,6,23,6180,14,117,1549,159,1337,9,873,2516,1675,4843
0.037,17,4,608,2,60,3,60,176,2,188,0,188,432
0.014,17,2,160,1,44,0,44,72,1,60,0,60,88
0.024,17,2,384,1,32,0,32,60,1,296,0,296,324
9.041,6,44,8385,21,227,452,314,4022,23,429,399,1152,4363
1.841,17,3,204,3,40,920,40,204,0,0,0,0,0
71.89,1,20,1680,20,56,3783,56,1680,0,0,0,0,0
2.861,17,2,144,1,36,0,36,64,1,52,0,52,80
81.196,6,82,55584,50,1204,1657,1440,47166,32,749,1988,1440,8418
360.937,2,6,192,6,8,72187,8,192,0,0,0,0,0
126.076,17,4,558,2,36,126068,36,128,2,187,126071,187,430
2.994,17,4,1370,2,308,2001,308,672,2,321,2000,321,698
1786.451,6,103,8464,68,66,26663,66,4964,35,60,52539,60,3500
1787.908,6,371,29180,214,116,8393,965,15883,157,101,11460,453,13297
9.974,17,2,138,2,41,9974,41,138,0,0,0,0,0
1679.187,1,68,3808,68,28,25062,28,3808,0,0,0,0,0
292.461,1,4,224,4,28,97487,28,224,0,0,0,0,0
0.014,6,9,1612,5,636,3,636,904,4,492,4,492,708
43.0,17,24,2112,12,48,3903,48,912,12,72,3903,72,1200
12.344,6,22,6502,9,280,1537,517,1330,13,642,1025,1408,5172
291.242,1,4,224,4,28,97080,28,224,0,0,0,0,0
302.483,6,50,16622,30,571,10430,1402,9006,20,504,3575,2694,7616
0.649,6,25,6627,12,137,59,267,1172,13,704,53,1467,5455
12.245,17,10,830,5,47,3059,47,375,5,63,3050,63,455
2.252,17,10,3616,10,333,250,361,3616,0,0,0,0,0
6.271,6,30,8848,13,155,522,267,1306,17,527,391,3417,7542
1787.37,6,104,8444,68,66,26677,66,4964,36,60,51063,60,3480
13.934,6,5,407,0,0,0,0,0,5,69,3483,69,407
1729.798,6,69,13259,45,119,39313,1408,4853,24,340,75200,3851,8406
12.493,6,34,8893,16,482,832,722,2577,18,507,664,1380,6316
1.799,17,2,179,1,43,0,43,71,1,80,0,80,108
1.701,6,13,2311,8,188,243,245,700,5,1407,360,1407,1611
1783.813,6,365,25432,213,100,8414,469,14936,152,69,11813,69,10496
0.038,17,2,158,1,34,0,34,62,1,68,0,68,96
41.563,17,152,11638,76,40,554,41,5211,76,56,554,57,6427
124.64,6,25,3378,10,183,13848,517,1457,15,381,8902,499,1921
11.484,6,27,11373,13,275,957,275,1078,14,1080,852,1420,10295
297.727,6,5,293,3,31,148863,31,151,2,31,297693,31,142
12.007,6,1914,1658239,1161,1372,10,1420,1623826,753,467,15,1883,34413
170.103,17,4,240,2,32,170102,32,120,2,32,170102,32,120
7.775,17,4,352,2,48,7766,48,152,2,72,7765,72,200
1799.282,17,450,39960,405,35,4453,288,25740,45,288,40024,288,14220
10.369,17,4,352,2,48,10360,48,152,2,72,10359,72,200
1719.438,17,12,498,11,14,171943,14,462,1,8,0,8,36
0.136,17,2,237,1,72,0,72,100,1,109,0,109,137
0.854,6,12,1767,8,100,122,100,424,4,589,203,1152,1343
1684.469,2,27,864,27,8,64787,8,864,0,0,0,0,0
280.866,6,31,7813,14,158,21605,267,1357,17,577,17534,2036,6456
0.599,6,14,1745,7,288,68,288,600,7,426,68,434,1145
107.767,17,24,8754,24,336,4685,359,8754,0,0,0,0,0
280.227,6,28,7352,13,158,23352,267,1317,15,678,20014,3436,6035
8.924,6,65,24983,30,849,307,1460,13981,35,478,248,1460,11002
2.051,17,2,677,1,300,0,300,328,1,321,0,321,349
1787.914,6,417,25852,217,69,8277,69,13234,200,44,8984,69,12618
1768.216,1,59,4956,59,56,30486,56,4956,0,0,0,0,0
49.681,17,4,240,2,32,49680,32,120,2,32,49680,32,120
75.816,17,4,352,2,60,75815,60,176,2,60,75815,60,176
1739.331,6,106,7692,64,31,27608,31,4394,42,31,42422,31,3298
1787.139,6,102,8364,68,66,26673,66,4964,34,60,54150,60,3400
1120.834,17,10,2745,5,30,280207,30,290,5,463,280207,463,2455
1791.107,17,87,3648,86,14,21071,14,3612,1,8,0,8,36
15.447,6,33,9087,17,440,965,721,2890,16,616,1016,1414,6197
280.039,6,31,7472,15,158,20002,267,1397,16,603,18666,2036,6075
1779.15,6,106,8644,70,66,25784,66,5044,36,60,50829,60,3600
0.071,17,2,574,1,32,0,32,60,1,486,0,486,514
291.217,6,35,4214,18,323,17130,582,1638,17,242,18200,580,2576
1772.011,6,180,15480,120,69,14890,69,8940,60,69,30032,69,6540
2.422,6,22,6421,10,268,264,517,1333,12,744,216,1418,5088
243.389,6,179,177942,69,263,3579,843,5200,110,1739,2232,2804,172742
2.97,6,34,16751,18,760,174,1360,6077,16,1431,184,2720,10674
1774.805,6,180,15480,120,69,14914,69,8940,60,69,30079,69,6540
100.062,6,12397,11968393,8342,1358,11,1408,11752771,4055,792,24,1408,215622
5.042,17,4,288,2,36,5002,36,128,2,52,5010,52,160
1726.955,17,264,52656,264,171,6566,358,52656,0,0,0,0,0
0.474,6,3,144,2,0,474,0,92,1,0,0,0,52
130.001,6,21,1316,8,43,14285,46,535,13,43,10833,46,781
5.004,17,4,558,2,36,4998,36,128,2,187,4999,187,430
1786.604,6,106,8584,69,66,26273,66,5004,37,60,49625,60,3580
351.376,6,135,101947,84,1276,4233,1368,91168,51,738,1583,2519,10779
27.55,6,13,2132,8,324,3935,584,1072,5,396,6865,580,1060
1786.905,6,104,8376,68,65,26670,65,4930,36,59,51050,59,3446
1785.962,6,372,25919,215,98,8345,469,15223,157,69,11448,69,10696
1785.655,6,365,23294,211,69,8503,69,12787,154,69,11670,69,10507
280.405,6,29,7392,13,158,23367,267,1317,16,678,18690,3456,6075
1744.655,2,14,448,14,8,134204,8,448,0,0,0,0,0
9.766,6,1781,1659029,1137,1382,8,1408,1620877,644,931,14,2816,38152
0.006,6,2,111,1,0,0,0,40,1,31,0,31,71
378.225,2,3,96,3,8,189112,8,96,0,0,0,0,0
145.081,6,27,4683,10,296,16120,722,1429,17,197,9054,1408,3254
0.175,6,26,7256,13,155,14,267,1301,13,678,13,2800,5955
234.278,6,30,7432,13,158,19523,267,1317,17,543,14641,1400,6115
66.473,6,29,8788,16,430,4431,648,2167,13,593,5521,1408,6621
20.969,6,16,3262,9,210,2620,210,908,7,664,3494,904,2354
1215.915,6,129,7945,67,46,18420,208,4845,62,31,19930,31,3100
40.091,6,2388,2228657,1473,1432,27,1448,2176365,915,776,43,1448,52292
0.013,6,2,104,1,0,0,0,64,1,0,0,0,40
5.904,6,14,1247,7,222,981,222,728,7,231,980,231,519
1789.954,6,383,24221,217,69,8286,69,13441,166,69,10848,69,10780
0.039,6,4,222,2,31,39,31,111,2,31,0,31,111
280.19,6,28,7352,13,158,23349,267,1317,15,678,20011,3536,6035
1072.088,17,745,52362,669,40,1604,41,45933,76,56,543,57,6429
0.237,17,2,136,1,32,0,32,60,1,48,0,48,76
6.146,6,52,22011,28,907,227,1460,14815,24,565,256,2615,7196
219.89,17,4,352,2,60,219889,60,176,2,60,219889,60,176
920.062,6,74,10486,36,101,17683,516,3170,38,175,24864,1452,7316
1773.736,17,140,11200,70,48,25706,48,5320,70,56,25706,56,5880
1776.365,17,140,11200,70,48,25744,48,5320,70,56,25744,56,5880
1756.769,6,120,12344,67,68,26616,517,4724,53,231,33783,1418,7620
2.346,17,5,354,4,30,781,30,232,1,94,0,94,122
1771.634,6,99,9174,66,64,27255,64,5544,33,58,55360,58,3630
1787.02,6,108,8412,68,63,26671,64,4868,40,57,45816,58,3544
240.16,6,42,5363,21,247,12007,833,2832,21,178,12007,510,2531
10.922,6,14,2245,8,211,1560,211,846,6,545,2178,904,1399
115.706,17,4,240,2,32,115705,32,120,2,32,115705,32,120
78.778,6,30,7432,13,158,6564,267,1317,17,543,4921,1400,6115
257.166,17,4,352,2,60,257165,60,176,2,60,257165,60,176
1558.611,6,44,16157,20,229,82032,241,3093,24,605,67757,1460,13064
53.72,6,11,1583,11,127,5372,127,1583,0,0,0,0,0
1786.514,6,104,8510,69,66,26272,66,5070,35,60,52541,60,3440
0.028,17,2,194,1,61,0,61,89,1,77,0,77,105
1795.932,17,448,39896,403,35,4467,288,25676,45,288,40020,288,14220
0.202,6,20,5813,12,181,18,537,1526,8,772,27,2181,4287
0.051,6,19,9136,10,127,5,127,655,9,1334,5,2896,8481
1786.398,6,102,8296,68,65,26662,65,4930,34,59,54130,59,3366
1787.432,6,102,8296,68,65,26678,65,4930,34,59,54160,59,3366
1773.246,6,100,9292,66,65,27280,65,5577,34,59,53731,59,3715
258.195,17,2,152,2,48,258195,48,152,0,0,0,0,0
0.562,6,20,4960,10,137,62,267,1092,10,692,46,1467,3868
1781.762,6,356,22589,207,69,8649,69,12420,149,69,12038,69,10169
1790.226,1,202,11312,202,28,8906,28,11312,0,0,0,0,0
1799.775,17,1921,145972,1044,40,1725,41,71688,877,56,2054,57,74284
1.016,17,4,360,2,30,981,30,116,2,94,992,94,244
20.196,17,19,5017,11,40,2017,41,755,8,504,2881,505,4262
126.203,6,33,14370,16,488,324,1460,3127,17,959,7879,1460,11243
12.275,6,1937,1695386,1183,1379,10,1420,1660981,754,420,16,1420,34405
0.419,6,15,2237,7,324,69,585,1009,8,396,51,580,1228
11.688,6,1723,1601294,1130,1365,10,1432,1573271,593,427,19,1432,28023
1770.785,6,99,9240,66,65,27242,65,5577,33,59,55334,59,3663
0.052,17,4,352,2,37,46,37,130,2,83,44,89,222
1772.687,6,180,15480,120,69,14896,69,8940,60,69,30038,69,6540
1771.127,6,104,9815,68,69,26434,233,5914,36,59,50601,82,3901
1785.412,6,356,22520,208,69,8625,69,12460,148,69,12145,69,10060
0.09,6,13,3514,7,75,15,75,447,6,1373,17,1448,3067
1781.037,17,142,11360,71,48,25442,48,5396,71,56,25442,56,5964
0.037,17,2,426,1,50,0,50,78,1,320,0,320,348
0.425,6,6,324,4,0,141,0,216,2,0,218,0,108
61.269,6,35,16003,22,816,2917,1408,9329,13,855,5088,3847,6674
612.915,17,43,3428,23,48,27859,48,1748,20,56,26915,56,1680
0.159,6,27,7296,14,155,12,267,1341,13,678,12,3436,5955
1.606,6,38,8252,19,320,89,1162,2716,19,433,77,1360,5536
0.921,6,10,861,5,222,225,222,426,5,231,225,231,435
280.378,6,31,7472,13,158,23364,267,1317,18,543,16490,1380,6155
6.517,6,40,7309,20,218,343,314,3423,20,513,329,1179,3886
280.591,6,31,7472,13,158,23382,267,1317,18,543,16500,1380,6155
10.135,6,36,8175,18,296,596,575,1642,18,446,584,1360,6533
20.028,17,28,12180,13,459,1666,1350,6333,15,361,1428,1350,5847
8.541,6,79,24685,41,560,213,1152,19008,38,415,224,1152,5677
26.316,6,2103,1852552,1293,1374,20,1380,1811278,810,383,32,1380,41274
1785.629,17,83,3480,82,14,22044,14,3444,1,8,0,8,36
317.184,6,525,469818,361,1323,881,1360,456395,164,228,153,1360,13423
4.924,17,3,228,3,48,2462,48,228,0,0,0,0,0
2.113,17,60,48006,25,495,88,1350,13084,35,969,59,1350,34922
16.132,17,4,488,4,94,5377,94,488,0,0,0,0,0
10.325,6,85,24637,44,550,240,1152,18840,41,415,251,1152,5797
242.75,17,4,352,2,60,242749,60,176,2,60,242748,60,176
58.13,6,38,10057,14,327,130,1189,2535,24,327,2527,1420,7522
32.995,17,40,5880,20,48,1735,48,1520,20,190,1732,308,4360
296.761,6,84,12447,41,179,6068,1189,4167,43,273,7065,1917,8280
1791.712,17,178,13884,178,50,10122,50,13884,0,0,0,0,0
1.5,6,45,18080,26,882,60,1360,12544,19,476,72,2715,5536
0.011,17,2,176,1,60,0,60,88,1,60,0,60,88
0.437,6,47,18732,26,967,17,1380,13650,21,421,20,1923,5082
11.297,6,8,642,7,46,1861,46,602,1,0,0,0,40
1795.387,17,80,3354,79,14,23017,14,3318,1,8,0,8,36
9.999,6,11,10897,11,950,999,1460,10897,0,0,0,0,0
0.261,17,2,167,1,39,0,39,67,1,72,0,72,100
10.008,6,20,2615,11,188,1000,245,832,9,703,1036,1152,1783
0.526,6,53,21350,30,993,18,1380,16143,23,387,21,1923,5207
72.83,6,28,7545,15,324,5202,925,2552,13,558,6065,1688,4993
198.377,6,18,1648,4,106,66125,106,274,14,79,15258,90,1374
1798.739,6,368,25221,214,93,8444,469,14645,154,69,11753,69,10576
0.011,17,2,401,1,36,0,36,64,1,309,0,309,337
10.81,6,18,5610,10,275,1201,275,958,8,1440,829,1440,4652
1745.382,6,171,121448,61,630,29089,1460,5830,110,1039,16011,1843,115618
5.518,6,40,7309,21,218,275,314,3463,19,513,292,1179,3846
1622.061,6,24,3973,16,262,108137,413,2740,8,114,231698,269,1233
5.769,6,570,517461,369,1338,15,1368,502345,201,776,27,1473,15116
0.653,6,9,1343,5,145,163,145,349,4,830,179,830,994
1773.003,6,205,22439,130,75,13744,267,10057,75,132,23953,1460,12382
126.755,17,4,240,2,32,126754,32,120,2,32,126754,32,120
1786.521,6,104,8376,68,65,26664,65,4930,36,59,51040,59,3446
64.269,6,10,648,10,31,7141,31,648,0,0,0,0,0
0.441,6,24,6042,13,108,36,147,959,11,773,42,1608,5083
1166.398,6,56,15782,36,348,33325,1360,8114,20,527,61379,3494,7668
902.449,2,9,288,9,8,112806,8,288,0,0,0,0,0
5.019,17,3,250,2,50,5006,50,156,1,66,0,66,94
379.059,6,21,1419,15,177,27075,177,989,6,110,12259,110,430
164.709,6,21,8321,11,532,83,1257,2068,10,973,18281,2720,6253
1770.068,6,99,9306,66,66,27231,66,5610,33,60,55311,60,3696
293.111,6,46,7903,23,129,13321,517,2125,23,456,13320,1418,5778
0.066,17,2,154,1,33,0,33,61,1,65,0,65,93
162.531,6,392,379401,230,696,18,1360,13016,162,2307,1008,13600,366385
0.522,17,3,543,2,39,447,39,134,1,381,0,381,409
3.056,17,8,736,4,32,1018,32,240,4,96,442,96,496
2.679,17,5,1192,3,32,1339,32,180,2,478,2675,486,1012
1793.857,17,87,3648,86,14,21104,14,3612,1,8,0,8,36
10.415,6,1571,1428031,1009,1363,10,1420,1401212,562,475,18,2840,26819
1775.533,1,256,14336,256,28,6962,28,14336,0,0,0,0,0
1741.454,6,87,6322,58,31,30551,31,3915,29,31,62194,31,2407
0.383,6,10,1992,5,288,90,288,508,5,424,51,434,1484
9.729,6,697,618167,450,1305,21,1368,600659,247,776,38,1473,17508
1.307,6,24,8004,11,164,110,267,1236,13,869,91,1448,6768
10.042,17,2,130,2,37,10042,37,130,0,0,0,0,0
1740.445,6,87,6322,58,31,30534,31,3915,29,31,62158,31,2407
0.585,6,25,8343,12,264,53,677,1688,13,995,47,1438,6655
1.524,6,37,8214,19,321,84,1164,2718,18,476,78,2715,5496
2.292,6,20,3833,11,234,229,564,1504,9,463,259,1343,2329
1772.301,6,180,15480,120,69,14893,69,8940,60,69,30036,69,6540
1783.16,17,83,3480,82,14,22014,14,3444,1,8,0,8,36
3.508,17,10,2242,5,30,872,30,290,5,362,873,468,1952
0.16,6,10,1187,6,145,32,145,389,4,634,47,634,798
1.915,6,71,57692,47,1265,41,1368,50539,24,982,74,2736,7153
151.93,17,2,810,2,377,151930,377,810,0,0,0,0,0
0.002,6,2,1232,1,0,0,0,40,1,1140,0,1140,1192
7.138,6,1556,1437298,988,1377,7,1408,1403098,568,931,12,2816,34200
0.45,6,48,20851,27,977,17,1380,15769,21,421,20,1923,5082
1798.835,6,356,22520,208,69,8690,69,12460,148,69,12236,69,10060
15.334,6,19,2538,10,210,1703,210,984,9,545,1816,904,1554
595.081,6,9,546,6,31,119016,31,333,3,31,297527,31,213
1786.467,6,107,8496,68,65,26663,65,4930,39,59,47009,59,3566
1792.781,6,276,33099,113,138,16005,1460,16194,163,128,11065,1642,16905
0.132,17,2,457,2,200,132,356,457,0,0,0,0,0
1740.695,17,30,7050,30,207,60023,207,7050,0,0,0,0,0
1700.698,17,12,498,11,14,170069,14,462,1,8,0,8,36
16.702,17,25,6882,11,279,1666,1350,3379,14,222,1281,1350,3503
318.585,6,95,34893,52,593,6246,1460,25274,43,355,7575,1629,9619
1788.675,17,88,3684,86,14,21041,14,3612,2,8,1788493,8,72
5.36,6,5,208,3,0,2599,0,124,2,0,5198,0,84
4.155,17,2,656,2,300,4155,300,656,0,0,0,0,0
1785.859,6,353,22400,205,69,8754,69,12340,148,69,12148,69,10060
12.791,6,8,440,5,0,3197,0,268,3,0,6389,0,172
29.086,17,4,352,2,60,29085,60,176,2,60,29084,60,176
1710.385,6,162,17334,83,89,19728,722,7606,79,163,21925,1380,9728
1799.998,6,3406,4400548,1261,145,1428,907,73929,2145,2033,818,9814,4326619
1786.883,17,87,3648,86,14,21022,14,3612,1,8,0,8,36
0.253,17,2,420,1,39,0,39,67,1,325,0,325,353
0.009,6,3,160,2,0,9,0,100,1,0,0,0,60
7.917,17,4,1344,4,308,2639,308,1344,0,0,0,0,0
280.034,6,32,7512,15,158,20002,267,1397,17,543,17499,1400,6115
280.534,6,28,7352,12,158,25503,267,1277,16,603,18695,1400,6075
16.922,17,6,528,3,48,8457,48,228,3,72,8456,72,300
3.365,17,10,1472,5,40,838,40,340,5,198,838,216,1132
0.286,6,23,7385,13,334,23,663,2021,10,806,31,1402,5364
0.358,17,2,152,1,48,0,48,76,1,48,0,48,76
4.864,6,44,8369,21,227,243,314,4022,23,427,209,1152,4347
170.782,1,6,336,6,28,34156,28,336,0,0,0,0,0
1786.45,1,184,10304,184,28,9762,28,10304,0,0,0,0,0
374.665,6,23,1538,16,180,24977,180,1056,7,110,10406,110,482
1423.062,6,161,11086,58,46,24441,46,4620,103,46,13951,46,6466
270.64,6,52,27917,30,528,9332,1066,3272,22,1381,1783,5632,24645
26.691,6,8,1232,3,564,13259,564,720,5,126,6629,221,512
1.311,6,47,18791,26,931,52,1460,13175,21,433,56,1460,5616
0.142,6,10,767,5,186,30,186,454,5,45,34,45,313
1786.892,6,102,8296,68,65,26670,65,4930,34,59,54145,59,3366
1756.738,17,30,31680,30,1028,60577,1028,31680,0,0,0,0,0
265.401,6,32,8952,14,158,20415,267,1357,18,624,15611,1400,7595
1775.083,17,142,11360,71,48,25357,48,5396,71,56,25357,56,5964
1787.272,6,102,8364,68,66,26675,66,4964,34,60,54156,60,3400
12.272,6,1322,1081833,710,1421,16,1448,1036369,612,776,19,1448,45464
280.029,6,28,7352,13,158,23335,267,1317,15,678,19999,2045,6035
0.019,6,10,1806,6,619,3,1079,1483,4,159,5,159,323
1.569,6,34,11182,17,416,98,1460,3626,17,980,86,1460,7556
6.527,17,4,240,2,32,6527,32,120,2,32,6527,32,120
0.608,6,14,1745,7,288,75,288,600,7,426,69,434,1145
126.121,1,2,208,2,76,126121,76,208,0,0,0,0,0
1708.246,17,42,1758,41,14,42706,14,1722,1,8,0,8,36
1.621,6,14,2351,8,188,231,245,700,6,703,275,1152,1651
0.35,17,8,2766,8,317,50,356,2766,0,0,0,0,0
1.078,6,27,8420,15,222,65,540,1964,12,1192,81,3151,6456
851.537,6,202,21521,102,148,8431,1189,9443,100,171,8599,1420,12078
1795.66,6,202,19109,100,69,18136,721,8061,102,126,17777,2840,11048
240.183,6,54,18190,29,809,8577,1418,15279,25,200,10007,580,2911
1743.579,6,99,7411,63,38,28122,205,4476,36,33,49808,98,2935
1799.942,17,450,39960,405,35,4455,288,25740,45,288,40015,288,14220
1.375,6,16,6161,4,159,455,267,647,12,718,124,1420,5514
37.841,17,22,1672,22,48,1801,48,1672,0,0,0,0,0
1.411,6,8,335,4,0,470,0,164,4,7,150,7,171
6.056,17,12,2571,6,45,1200,45,438,6,327,1208,339,2133
1.314,6,49,19951,28,878,48,1360,14335,21,476,57,2720,5616
49.216,6,45,10209,22,533,742,910,3083,23,364,2230,2720,7126
1409.791,6,145,12562,94,70,15158,138,7141,51,69,28195,69,5421
4.815,6,38,7229,19,218,267,314,3383,19,513,253,1179,3846
439.956,6,324,262445,203,1354,2178,1448,240845,121,527,2486,1448,21600
341.334,6,17,1190,13,180,28444,180,864,4,110,20062,110,326
14.48,6,11,674,4,112,4823,112,280,7,90,2411,90,394
46.503,6,28,7217,13,155,3875,267,1306,15,482,3320,2840,5911
160.804,17,4,352,2,60,160803,60,176,2,60,160803,60,176
21.846,17,3,366,3,94,10923,94,366,0,0,0,0,0
385.004,6,18,1242,14,180,29615,180,916,4,110,20073,110,326
1787.282,6,102,8296,68,65,26675,65,4930,34,59,54155,59,3366
1773.01,6,180,15480,120,69,14899,69,8940,60,69,30043,69,6540
280.396,6,30,7432,13,158,23366,267,1317,17,543,17519,1400,6115
0.366,6,14,1733,7,288,56,288,588,7,284,33,434,1145
31.923,6,172,138672,83,121,389,286,4752,89,1521,362,2816,133920
280.253,6,30,7432,14,158,21557,267,1357,16,603,18680,2036,6075
3.909,17,5,290,5,30,977,30,290,0,0,0,0,0
83.866,6,35,18801,20,702,39,1360,5059,15,1313,5981,3056,13742
1750.783,17,12,498,11,14,175078,14,462,1,8,0,8,36
12.934,6,24,6993,13,275,1077,275,1078,11,910,755,1440,5915
8.119,17,4,1344,4,308,2706,308,1344,0,0,0,0,0
1443.051,1,76,4256,76,28,19240,28,4256,0,0,0,0,0
91.783,1,6,336,6,28,18356,28,336,0,0,0,0,0
0.427,6,49,20259,27,933,16,1380,15137,22,421,18,1923,5122
316.935,6,74,13490,32,132,10223,615,3825,42,274,7687,2720,9665
21.271,6,40,8489,20,348,474,730,1890,20,413,1112,1460,6599
18.71,6,13,2133,8,324,2672,585,1073,5,396,4595,580,1060
1.309,6,46,18756,26,931,52,1460,13180,20,433,59,1460,5576
371.485,6,25,1651,17,177,23217,177,1117,8,110,9215,110,534
0.447,6,21,5894,12,108,40,147,919,9,1152,55,2601,4975
164.393,1,5,420,5,56,41098,56,420,0,0,0,0,0
1776.418,6,352,31672,156,63,11457,659,12832,196,104,9107,1638,18840
504.161,2,5,160,5,8,126040,8,160,0,0,0,0,0
3.306,6,2,88,2,0,0,0,88,0,0,0,0,0
1793.043,6,110,11912,70,109,25986,824,7466,40,67,45975,193,4446
1.56,6,48,19694,27,926,60,1360,14078,21,433,67,1360,5616
240.382,6,10,628,4,106,80124,106,274,6,90,48074,90,354
0.021,6,12,3462,6,75,4,75,395,6,1373,4,1448,3067
34.973,6,754,660334,461,1357,76,1368,638892,293,899,119,2736,21442
1720.51,17,13,534,11,14,172051,14,462,2,8,172021,8,72
393.827,6,86,13780,40,338,10098,1111,6914,46,185,8751,1255,6866
4.868,17,55,40569,23,442,212,1350,10821,32,901,148,1350,29748
315.83,6,125,35250,68,464,4713,1360,24171,57,283,5620,4649,11079
0.042,17,2,435,1,29,0,29,57,1,350,0,350,378
1786.563,6,105,8484,68,66,26665,66,4964,37,60,49624,60,3520
1740.32,6,87,6322,58,31,30531,31,3915,29,31,62153,31,2407
3.366,17,10,1287,5,31,838,31,295,5,170,823,196,992
1739.224,6,87,6322,58,31,30512,31,3915,29,31,62113,31,2407
588.427,1,6,489,6,53,117685,78,489,0,0,0,0,0
61.699,6,58,37160,36,1141,1762,1448,29265,22,749,2927,1448,7895
0.422,6,5,248,3,0,211,0,144,2,0,420,0,104
19.844,6,30,7432,13,158,1653,267,1317,17,543,1239,1400,6115
1797.172,17,448,39896,403,35,4470,288,25676,45,288,40017,288,14220
0.285,6,10,1677,6,555,56,951,1354,4,159,94,159,323
1.795,6,12,2271,7,188,299,245,660,5,1407,381,1407,1611
5.675,6,35,6209,19,206,315,314,2824,16,548,361,1179,3385
1786.532,17,87,3648,86,14,21018,14,3612,1,8,0,8,36
1788.436,17,83,3480,82,14,22079,14,3444,1,8,0,8,36
1.043,6,24,6501,13,323,86,955,2141,11,783,103,1420,4360
1774.98,6,209,24070,133,89,13446,981,11158,76,137,23662,2077,12912
4.429,6,3,151,1,0,0,0,40,2,31,4422,31,111
0.467,6,17,6992,10,146,51,175,956,7,1132,56,2521,6036
5.489,6,40,7309,20,218,288,314,3423,20,513,273,1179,3886
16.345,17,38,9460,17,239,1019,1350,4547,21,205,815,1350,4913
1798.593,17,449,39928,404,35,4463,288,25708,45,288,40021,288,14220
1788.74,17,85,3564,84,14,21551,14,3528,1,8,0,8,36
124.111,1,2,319,2,131,124111,142,319,0,0,0,0,0
1774.36,17,347,68452,347,169,5128,391,68452,0,0,0,0,0
0.901,17,4,334,2,39,870,39,134,2,72,606,72,200
15.673,6,2629,2460647,1697,1372,9,1408,2407519,932,931,16,2816,53128
11.771,6,1816,1615062,1141,1363,10,1380,1583820,675,383,17,1380,31242
58.852,2,2,64,2,8,58852,8,64,0,0,0,0,0
310.078,6,27,5492,14,298,23852,1382,2353,13,373,25838,1460,3139
240.314,6,43,8922,21,523,12015,1418,5815,22,217,11443,618,3107
0.321,17,2,204,1,34,0,34,62,1,114,0,114,142
1.095,6,39,12848,22,758,52,1360,6300,17,488,57,1360,6548
12.135,6,1929,1664934,1176,1362,10,1380,1628649,753,558,16,1923,36285
1.915,6,19,3781,10,234,212,564,1452,9,463,216,1343,2329
24.479,6,12,5538,5,106,6119,106,314,7,987,4061,1917,5224
1743.181,1,59,4956,59,56,30054,56,4956,0,0,0,0,0
1792.023,17,140,11200,70,48,25971,48,5320,70,56,25971,56,5880
1680.388,1,15,840,15,28,120027,28,840,0,0,0,0,0
211.818,17,4,352,2,60,211817,60,176,2,60,211817,60,176
0.012,17,3,383,2,33,0,33,122,1,233,0,233,261
3.918,6,2,88,2,0,0,0,88,0,0,0,0,0
0.053,17,2,396,1,39,0,39,67,1,301,0,301,329
1786.175,1,86,9116,86,78,21013,78,9116,0,0,0,0,0
179.27,6,15,3202,7,92,29878,92,452,8,388,25578,2026,2750
4.006,17,8,616,4,33,1329,33,244,4,65,1330,65,372
23.799,17,4,304,4,48,7933,48,304,0,0,0,0,0
1793.089,6,359,22847,208,69,8662,69,12460,151,69,11953,69,10387
0.156,17,2,198,1,37,0,37,65,1,105,0,105,133
2.58,17,2,178,1,29,0,29,57,1,93,0,93,121
1740.539,1,15,840,15,28,124324,28,840,0,0,0,0,0
0.355,6,26,8995,13,252,29,647,1692,13,945,28,1448,7303
1729.185,6,61,4464,41,33,43229,33,2804,20,31,91000,31,1660
0.082,17,6,1844,6,279,16,315,1844,0,0,0,0,0
0.303,17,2,198,1,63,0,63,91,1,79,0,79,107
0.046,17,4,284,2,32,30,32,120,2,54,31,60,164
5.015,17,4,558,2,36,5005,36,128,2,187,4998,187,430
1400.359,1,14,784,14,28,107719,28,784,0,0,0,0,0
1.259,6,50,19184,27,884,48,1360,13488,23,433,49,1360,5696
1767.302,17,44,14784,44,308,41100,308,14784,0,0,0,0,0
0.103,17,2,152,1,48,0,48,76,1,48,0,48,76
1767.126,17,367,64676,367,148,4828,372,64676,0,0,0,0,0
0.094,17,2,304,1,60,0,60,88,1,188,0,188,216
3.049,17,4,1564,4,363,1016,363,1564,0,0,0,0,0
1773.096,1,134,7504,134,28,13331,28,7504,0,0,0,0,0
287.97,17,4,352,2,60,287969,60,176,2,60,287969,60,176
0.23,6,22,5040,10,137,25,267,1092,12,577,20,1400,3948
61.792,6,76,52226,47,1186,1343,1408,43982,29,961,2198,3847,8244
1387.942,6,276,17457,160,69,8729,69,9643,116,69,12068,69,7814
1731.181,17,13,534,11,14,173099,14,462,2,8,1730996,8,72
0.061,6,9,1340,5,145,15,145,349,4,827,18,827,991
280.23,6,28,7352,13,158,23352,267,1317,15,678,20013,4200,6035
1785.717,17,337,25612,337,48,5314,48,25612,0,0,0,0,0
12.604,6,22,7982,12,275,1145,275,763,10,1134,843,1440,7219
20.318,6,24,5585,13,107,1693,159,1126,11,773,2025,1368,4459
0.036,17,2,146,1,37,0,37,65,1,53,0,53,81
8.551,6,17,5391,9,275,1068,275,643,8,1104,974,1440,4748
0.523,6,12,3702,6,170,104,170,490,6,964,103,1448,3212
1785.859,6,360,22887,208,69,8627,69,12529,152,69,11826,69,10358
9.705,6,46,8742,24,231,421,314,4435,22,489,448,1179,4307
0.264,17,3,234,2,39,148,39,134,1,72,0,72,100
1745.191,6,90,6540,60,31,29579,31,4050,30,31,60170,31,2490
0.398,6,2,80,1,0,0,0,40,1,0,0,0,40
1.451,6,52,19258,29,879,51,1360,13517,23,437,57,2715,5741
72.118,6,31,7544,13,155,6009,267,1306,18,423,4241,3417,6238
225.409,6,29,7392,13,158,18784,267,1317,16,603,15025,2760,6075
60.678,6,9,771,5,177,15169,177,445,4,110,20103,110,326
1772.111,6,180,15480,120,69,14891,69,8940,60,69,30035,69,6540
1793.033,17,87,3648,86,14,21094,14,3612,1,8,0,8,36
1.506,6,4,740,1,0,0,0,40,3,272,656,272,700
1798.906,17,449,39928,404,35,4463,288,25708,45,288,40016,288,14220
51.87,6,34,8741,18,162,3051,541,2429,16,547,3457,1408,6312
15.593,17,19,12945,11,952,1553,1350,10790,8,241,2218,1350,2155
1789.956,6,362,25830,210,106,8564,1189,14998,152,74,11853,405,10832
1793.08,6,356,22520,208,69,8662,69,12460,148,69,12197,69,10060
3.263,17,2,778,2,361,3263,361,778,0,0,0,0,0
6.087,6,14,2242,8,210,842,210,844,6,545,1199,904,1398
1.314,6,8,342,4,0,438,0,164,4,7,319,7,178
2.953,6,6,340,3,0,1476,0,160,3,0,513,0,180
0.762,6,17,5132,9,150,95,174,664,8,828,95,1420,4468
1793.213,1,84,8904,84,78,21604,78,8904,0,0,0,0,0
190.379,6,6,378,3,106,95189,106,234,3,0,1522,0,144
5.015,17,4,558,2,36,5003,36,128,2,187,5005,187,430
0.409,6,52,22403,28,1069,15,1380,17189,24,421,16,1923,5214
0.183,17,2,154,1,33,0,33,61,1,65,0,65,93
0.066,17,4,284,2,32,63,32,120,2,54,62,60,164
847.012,17,7,532,7,48,141168,48,532,0,0,0,0,0
246.689,1,7,2215,7,288,41114,338,2215,0,0,0,0,0
1.106,6,8,342,4,0,368,0,164,4,7,260,7,178
39.869,17,22,1672,22,48,1898,48,1672,0,0,0,0,0
1.517,2,3,96,3,8,758,8,96,0,0,0,0,0
14.49,6,2,212,0,0,0,0,0,2,132,14490,132,212
186.052,6,35,4445,20,171,9792,447,3721,15,31,13150,31,724
36.904,17,22,1672,22,48,1757,48,1672,0,0,0,0,0
0.575,17,4,624,2,64,307,64,184,2,192,308,192,440
27.559,6,1427,1281293,888,1362,30,1368,1244913,539,776,50,1473,36380
1796.182,17,144,11520,72,48,25298,48,5472,72,56,25298,56,6048
199.77,6,32,8952,14,158,15366,267,1357,18,624,11744,1400,7595
1797.173,17,452,40136,405,35,4448,288,25780,47,277,38281,288,14356
300.638,6,38,8677,20,343,15823,1025,2204,18,441,499,1440,6473
0.157,17,2,198,1,37,0,37,65,1,105,0,105,133
1753.601,6,175,13808,93,93,19060,208,9536,82,31,21645,31,4272
803.298,17,12,969,6,31,160653,37,355,6,74,160653,136,614
1792.489,17,140,11200,70,48,25977,48,5320,70,56,25977,56,5880
300.704,6,38,8539,20,308,15826,888,2067,18,441,501,1360,6472
1.426,17,19,5923,10,318,158,1350,3465,9,245,173,1350,2458
197.147,6,8,506,8,31,28163,31,506,0,0,0,0,0
1.187,6,24,8004,11,164,100,267,1236,13,869,83,1440,6768
902.413,2,8,256,8,8,128916,8,256,0,0,0,0,0
0.131,6,3,258,2,126,108,126,218,1,0,0,0,40
1796.769,1,345,28980,345,56,5223,56,28980,0,0,0,0,0
4.422,6,24,13069,11,423,442,721,1715,13,1353,282,1414,11354
3.116,17,6,471,3,31,1542,31,177,3,70,1536,70,294
0.934,6,10,1687,7,100,155,100,384,3,1179,346,1179,1303
1786.854,6,362,22967,210,69,8549,69,12747,152,69,11833,69,10220
1738.228,1,49,4116,49,56,36213,56,4116,0,0,0,0,0
1795.409,1,56,4704,56,56,32643,56,4704,0,0,0,0,0
0.022,6,4,222,2,31,22,31,111,2,31,3,31,111
0.009,17,2,672,2,308,9,308,672,0,0,0,0,0
0.03,6,3,120,2,0,30,0,80,1,0,0,0,40
1787.507,6,119,13980,76,82,23833,515,6004,43,160,42557,1452,7976
287.624,17,4,240,2,32,287623,32,120,2,32,287623,32,120
1798.153,17,346,26296,346,48,5212,48,26296,0,0,0,0,0
1772.341,6,180,15480,120,69,14893,69,8940,60,69,30036,69,6540
0.459,6,22,5961,12,108,41,147,919,10,927,48,1608,5042
1797.086,17,447,39864,402,35,4481,288,25644,45,288,40019,288,14220
1795.747,17,140,11200,70,48,26025,48,5320,70,56,26025,56,5880
11.667,6,29,7257,14,155,897,267,1346,15,482,832,1997,5911
1778.205,17,79,3312,78,14,23093,14,3276,1,8,0,8,36
43.795,6,23,9134,12,528,3981,1066,2216,11,792,4373,1605,6918
0.272,6,9,1346,5,145,68,145,349,4,833,28,833,997
0.492,17,3,451,2,39,206,39,134,1,289,0,289,317
1795.931,17,448,39896,403,35,4467,288,25676,45,288,40022,288,14220
28.665,6,40,9372,21,321,1433,721,3100,19,687,1581,2840,6272
299.523,6,6,364,4,31,99841,31,222,2,31,299511,31,142
288.196,6,39,14224,16,793,19213,1408,7995,23,321,13099,1408,6229
0.019,17,2,373,1,45,0,45,73,1,272,0,272,300
290.946,17,4,352,2,60,290944,60,176,2,60,290945,60,176
1624.354,2,16,512,16,8,108290,8,512,0,0,0,0,0
0.18,6,24,7660,12,176,16,334,1339,12,1137,15,1648,6321
1795.542,17,447,39864,402,35,4477,288,25644,45,288,40019,288,14220
0.91,6,8,389,6,69,182,69,309,2,0,0,0,80
1782.689,6,364,23116,210,69,8529,69,12816,154,69,11651,69,10300
3.623,17,5,295,5,31,905,31,295,0,0,0,0,0
1769.89,6,99,9240,66,65,27229,65,5577,33,59,55306,59,3663
451.0,6,7504,7472933,2577,386,175,426,145238,4927,1437,85,2876,7327695
94.529,6,122,86847,73,1247,1312,1408,76176,49,676,1964,1408,10671
0.726,17,4,240,2,32,725,32,120,2,32,724,32,120
1795.718,17,445,38664,404,35,4455,288,25708,41,288,44013,288,12956
0.121,17,4,336,2,45,0,45,146,2,67,73,73,190
66.488,6,32,13665,18,489,295,1360,3212,14,1097,5103,2720,10453
0.016,17,2,384,1,39,0,39,67,1,289,0,289,317
0.239,6,4,160,3,0,119,0,120,1,0,0,0,40
0.051,17,2,152,1,48,0,48,76,1,48,0,48,76
5.254,6,41,7349,22,201,250,314,3503,19,513,277,1179,3846
0.946,17,4,624,2,64,945,64,184,2,192,794,192,440
0.005,17,2,607,1,43,0,43,71,1,508,0,508,536
1680.475,1,15,870,15,30,120033,30,870,0,0,0,0,0
0.124,1,2,163,2,53,124,78,163,0,0,0,0,0
1.637,6,47,18265,28,882,60,1360,12684,19,480,78,4075,5581
1789.37,1,98,10388,98,78,18447,78,10388,0,0,0,0,0
12.47,17,32,13901,15,682,888,1350,10660,17,162,777,1350,3241
244.942,6,88,22202,45,520,5566,1408,13814,43,341,5831,2420,8388
31.22,6,11,476,4,0,90,0,168,7,0,5200,0,308
5.642,6,586,548054,394,1328,13,1368,533406,192,776,28,2736,14648
113.119,6,49,13566,22,181,5386,267,2340,27,633,4348,2036,11226
1.438,6,46,18632,27,856,55,1360,13096,19,476,70,2715,5536
30.524,6,6,360,0,0,0,0,0,6,0,0,0,360
7.373,6,39,7867,19,132,409,267,1698,20,764,383,1452,6169
721.9,2,6,192,6,8,144380,8,192,0,0,0,0,0
4.946,6,5,288,3,0,2469,0,164,2,0,4938,0,124
83.479,6,45,8927,21,367,849,787,2058,24,327,3622,1360,6869
11.618,6,1829,1598863,1109,1386,10,1420,1565818,720,467,16,1883,33045
0.043,17,4,420,2,33,1,33,122,2,121,1,145,298
1786.652,6,123,13955,77,81,23508,501,6030,46,152,39701,1420,7925
1633.592,1,7,392,7,28,272265,28,392,0,0,0,0,0
31.661,6,7,308,1,0,0,0,44,6,0,6315,0,264
6.301,6,1409,1266585,867,1382,7,1408,1233737,542,931,11,2801,32848
2.16,6,20,3833,11,234,216,564,1504,9,463,248,1343,2329
110.603,1,6,336,6,28,22120,28,336,0,0,0,0,0
1786.431,6,102,8364,68,66,26663,66,4964,34,60,54131,60,3400
0.729,17,2,184,1,32,0,32,60,1,96,0,96,124
1789.762,1,168,9408,168,28,10717,28,9408,0,0,0,0,0
0.098,17,2,428,1,34,0,34,62,1,338,0,338,366
3.674,6,35,6209,18,206,216,314,2784,17,456,213,1152,3425
0.001,6,3,195,1,0,0,0,40,2,51,0,51,155
103.061,6,30,5228,15,170,7361,722,1966,15,413,7349,1408,3262
0.02,17,2,256,1,59,0,59,87,1,141,0,141,169
0.006,6,14,4334,7,111,0,111,483,7,869,0,1448,3851
1795.084,17,87,3648,86,14,21118,14,3612,1,8,0,8,36
1770.895,6,152,10216,83,55,21596,208,6221,69,38,26038,112,3995
0.543,6,27,8990,13,247,45,627,1672,14,938,38,1368,7318
376.323,6,25,1651,17,177,23520,177,1117,8,110,9261,110,534
25.329,17,5,380,5,48,6332,48,380,0,0,0,0,0
3.455,6,105,74247,50,891,70,1440,11875,55,1336,59,1440,62372
0.021,6,3,136,2,0,21,0,88,1,0,0,0,48
1794.985,17,448,39896,403,35,4465,288,25676,45,288,40022,288,14220
316.989,6,101,34371,53,574,6095,1360,23468,48,320,6741,1360,10903
125.497,6,12,3040,6,92,25099,92,400,6,581,25046,1408,2640
1771.679,6,99,9306,66,66,27256,66,5610,33,60,55362,60,3696
100.255,6,188,149434,120,1288,842,1368,136381,68,633,1308,1368,13053
1792.532,6,372,65898,246,302,7316,302,49350,126,83,14340,83,16548
1783.81,6,414,24840,206,69,8701,69,12380,208,34,8617,48,12460
1321.842,6,73,5749,47,70,28735,270,4337,26,31,27453,31,1412
12.655,6,1989,1730645,1221,1363,10,1380,1693760,768,511,16,1923,36885
12.577,6,2498,2327166,1599,1377,7,1408,2275754,899,931,13,2801,51412
1776.877,17,142,11360,71,48,25383,48,5396,71,56,25383,56,5964
0.397,17,8,2766,8,317,56,356,2766,0,0,0,0,0
9.938,6,70,20286,37,520,276,1152,15539,33,489,301,1179,4747
1.802,17,15,8007,7,657,298,1350,4796,8,373,250,1350,3211
1786.927,17,87,3648,86,14,21022,14,3612,1,8,0,8,36
300.214,6,39,9921,21,579,15002,1360,4399,18,479,17649,4027,5522
17.743,17,35,14359,16,450,1180,1350,7653,19,324,983,1350,6706
1772.25,6,180,15480,120,69,14892,69,8940,60,69,30030,69,6540
85.231,6,43,10253,20,287,1676,1189,3111,23,478,3873,1997,7142
30.703,6,6,360,0,0,0,0,0,6,0,0,0,360
280.296,6,31,7472,14,158,21561,267,1357,17,543,17516,1400,6115
1.721,17,2,778,2,361,1721,361,778,0,0,0,0,0
0.262,6,24,11400,13,705,21,1408,4212,11,1101,21,1578,7188
1772.581,6,180,15480,120,69,14895,69,8940,60,69,30036,69,6540
1.824,6,17,5801,9,272,228,516,1180,8,716,247,1452,4621
7.515,6,1007,775637,516,1404,14,1448,741545,491,776,14,1448,34092
20.076,17,4,1344,4,308,6692,308,1344,0,0,0,0,0
54.885,17,12,4032,12,308,4989,308,4032,0,0,0,0,0
10.05,6,15,2307,8,210,1427,210,856,7,545,1670,905,1451
3.704,17,5,1940,5,360,926,360,1940,0,0,0,0,0
1773.192,6,183,15738,121,69,14776,69,8980,62,69,29063,69,6758
283.812,6,31,7748,11,158,28022,267,1237,20,439,14936,1400,6511
3.325,6,4,176,1,0,0,0,44,3,0,1634,0,132
1745.592,6,95,7203,63,38,28154,205,4476,32,33,56303,98,2727
1792.045,6,184,17079,122,83,14810,965,9985,62,74,29370,405,7094
0.303,17,2,168,1,48,0,48,76,1,64,0,64,92
369.589,6,18,1242,14,180,28429,180,916,4,110,20071,110,326
300.713,6,36,8486,19,315,16706,882,2053,17,478,535,2720,6433
1796.887,17,448,39896,403,35,4469,288,25676,45,288,40018,288,14220
280.587,6,29,7392,13,158,23382,267,1317,16,603,18703,1380,6075
1784.17,17,142,11360,71,48,25487,48,5396,71,56,25487,56,5964
1750.444,6,97,7307,63,38,28232,205,4476,34,33,53036,98,2831
1.186,6,25,8056,12,164,91,267,1288,13,869,84,1440,6768
1785.977,6,365,61877,160,266,11232,1360,41644,205,133,8753,2720,20233
8.253,1,9,756,0,0,0,0,0,9,56,1031,56,756
0.062,6,2,80,2,0,0,0,80,0,0,0,0,0
191.833,17,4,352,2,60,191832,60,176,2,60,191832,60,176
1.151,6,56,14615,28,553,42,1429,5096,28,465,41,3446,9519
17.196,6,10,560,6,0,3439,0,328,4,0,4994,0,232
1799.093,6,375,26177,217,98,8329,469,15303,158,69,11458,69,10874
0.549,6,12,1304,6,256,100,256,756,6,304,104,304,548
1675.148,1,7,742,7,78,279191,78,742,0,0,0,0,0
1.29,6,51,23809,30,997,44,1360,18193,21,476,55,2715,5616
1797.364,17,445,38948,403,35,4471,288,25676,42,288,42949,288,13272
0.008,6,2,80,1,0,0,0,40,1,0,0,0,40
3.763,17,2,154,1,33,0,33,61,1,65,0,65,93
1744.598,2,24,768,24,8,75852,8,768,0,0,0,0,0
421.075,2,4,128,4,8,140358,8,128,0,0,0,0,0
1799.494,6,6796,899436,3449,215,521,1360,659980,3347,104,537,3831,239456
1773.308,6,316,35124,136,123,13132,1460,17113,180,118,9904,1642,18011
1799.498,17,296,64663,296,190,6099,422,64663,0,0,0,0,0
0.141,6,38,16554,22,981,6,1420,11693,16,526,9,3303,4861
1769.123,1,58,4872,0,0,0,0,0,58,56,31037,56,4872
2.115,6,14,2351,8,188,302,245,700,6,703,371,1152,1651
280.185,6,29,7392,13,158,23348,267,1317,16,603,18678,2036,6075
293.18,6,3,3828,3,1236,146590,1236,3828,0,0,0,0,0
0.703,6,10,767,5,186,175,186,454,5,45,170,45,313
0.252,6,46,22126,27,1069,9,1420,17145,19,467,13,1883,4981
32.882,6,8,348,2,0,32882,0,84,6,0,6294,0,264
280.419,6,26,7272,12,158,25492,267,1277,14,775,21566,3465,5995
132.767,6,25,9968,12,549,64,1440,2709,13,961,11052,1440,7259
0.955,6,31,9394,16,203,63,458,1498,15,809,55,1360,7896
1781.475,6,352,22360,205,69,8732,69,12340,147,69,12201,69,10020
0.0,17,2,683,2,313,0,333,683,0,0,0,0,0
0.035,6,10,1669,6,551,7,947,1346,4,159,11,159,323
0.368,6,10,968,5,256,89,256,460,5,304,88,304,508
39.106,17,44,6468,22,48,1861,48,1672,22,190,1861,308,4796
0.003,17,2,144,1,36,0,36,64,1,52,0,52,80
1788.427,17,87,3648,86,14,21040,14,3612,1,8,0,8,36
1797.234,1,58,4872,0,0,0,0,0,58,56,31530,56,4872
99.673,6,913,448058,503,826,198,1152,426867,410,435,243,1179,21191
484.184,6,65,9171,39,302,12741,302,6554,26,83,19366,83,2617
280.467,6,28,7352,12,158,25497,267,1277,16,678,18694,2085,6075
1794.132,6,288,25828,171,75,10553,267,11835,117,134,15466,1460,13993
84.676,6,14,3404,6,167,16935,243,655,8,1164,9061,1448,2749
0.394,6,10,968,5,256,95,256,460,5,304,95,304,508
21.997,17,33,8333,16,281,1464,1350,4958,17,170,1372,1350,3375
3.579,17,5,340,5,40,894,40,340,0,0,0,0,0
1786.67,6,106,8524,68,66,26666,66,4964,38,60,48286,60,3560
1679.844,1,14,784,14,28,129218,28,784,0,0,0,0,0
19.241,17,4,824,2,48,19227,48,152,2,308,19227,308,672
60.307,6,47,11052,23,855,814,1360,5290,24,435,2614,2667,5762
11.575,17,8,704,4,48,3855,48,304,4,72,3855,72,400
79.495,6,38,11648,20,482,259,1287,4258,18,665,4665,1562,7390
1.263,6,48,19221,27,892,48,1460,13605,21,433,54,1460,5616
55.583,17,4,352,2,48,55574,48,152,2,72,55572,72,200
0.866,17,2,685,1,308,0,308,336,1,321,0,321,349
0.171,6,6,362,3,31,85,31,175,3,31,0,31,187
2.146,17,2,238,1,44,0,44,72,1,138,0,138,166
3.983,17,29,12655,13,621,331,1350,8444,16,235,213,1350,4211
300.626,6,39,8606,20,315,15822,882,2093,19,441,470,1440,6513
1681.244,17,16,4257,8,30,240176,37,471,8,445,240176,463,3786
1668.9,6,206,20210,107,75,15744,721,9872,99,193,17019,2535,10338
0.059,17,2,351,1,33,0,33,61,1,262,0,262,290
5.455,6,41,7349,20,218,287,314,3423,21,440,260,1152,3926
1786.097,17,87,3648,86,14,21012,14,3612,1,8,0,8,36
1786.929,6,196,21358,126,109,14295,965,12048,70,93,25895,917,9310
383.489,6,10,734,8,106,54783,106,646,2,0,383483,0,88
25.081,17,4,240,2,32,25080,32,120,2,32,25080,32,120
1771.209,1,58,4872,0,0,0,0,0,58,56,31073,56,4872
1785.155,1,58,4872,0,0,0,0,0,58,56,31318,56,4872
1738.691,6,96,6962,62,31,28503,31,4209,34,31,52687,31,2753
9.869,6,69,21179,36,554,281,1152,16416,33,429,300,1152,4763
1219.592,17,231,17556,231,48,5302,48,17556,0,0,0,0,0
1784.114,17,401,78230,401,167,4460,364,78230,0,0,0,0,0
53.177,2,2,64,2,8,53177,8,64,0,0,0,0,0
0.045,6,9,1339,5,145,11,145,349,4,826,10,826,990
17.083,17,4,240,2,32,17082,32,120,2,32,17081,32,120
12.368,6,25,4853,12,204,1109,722,1655,13,503,1016,1402,3198
10.407,6,33,9806,17,568,643,1460,3553,16,622,681,1460,6253
1789.96,6,358,22669,208,69,8647,69,12529,150,69,12013,69,10140
233.315,17,4,240,2,32,233313,32,120,2,32,233314,32,120
2.338,6,14,2351,8,188,334,245,700,6,703,416,1152,1651
1787.222,6,115,13714,75,81,24151,500,5949,40,162,45823,1420,7765
2.252,6,33,14750,18,396,132,986,2541,15,1269,153,1514,12209
0.008,17,2,150,1,39,0,39,67,1,55,0,55,83
0.167,6,4,208,0,0,0,0,0,4,0,0,0,208
1.476,6,47,18164,26,882,59,1460,12548,21,433,63,1460,5616
0.891,17,22,9265,11,359,84,1350,4262,11,426,84,1350,5003
1744.675,2,17,544,17,8,109042,8,544,0,0,0,0,0
1684.539,2,18,576,18,8,99090,8,576,0,0,0,0,0
1638.286,2,14,448,14,8,126022,8,448,0,0,0,0,0
373.379,6,18,1242,14,180,28721,180,916,4,110,20070,110,326
35.748,17,4,352,2,60,35747,60,176,2,60,35747,60,176
0.026,17,2,166,1,39,0,39,67,1,71,0,71,99
1791.669,6,356,22520,208,69,8655,69,12460,148,69,12188,69,10060
0.372,6,27,8920,13,227,31,547,1592,14,941,27,1438,7328
1740.18,6,90,6521,59,31,30003,31,3998,31,31,58005,31,2523
72.442,6,19,4134,7,407,12073,722,1174,12,1164,6414,1408,2960
1799.769,17,448,39896,403,35,4477,288,25676,45,288,40023,288,14220
0.003,6,3,136,1,0,0,0,40,2,0,0,0,96
1798.537,17,449,39928,404,35,4462,288,25708,45,288,40015,288,14220
240.181,6,54,18388,28,812,8895,1402,15291,26,193,9607,580,3097
0.59,17,16,8847,8,446,84,1350,3794,8,603,48,1350,5053
0.018,17,3,244,2,32,0,32,120,1,96,0,96,124
215.96,17,4,240,2,32,215959,32,120,2,32,215958,32,120
0.165,6,46,22028,27,1063,6,1420,17047,19,467,8,1883,4981
17.276,6,22,3987,12,211,1570,211,1289,10,545,1915,904,2698
0.217,6,26,7256,13,155,18,267,1301,13,678,17,3436,5955
1739.37,1,15,840,15,28,124240,28,840,0,0,0,0,0
0.866,6,21,5988,12,281,78,544,1328,9,716,96,1420,4660
46.03,17,4,514,2,36,46023,36,128,2,165,46026,187,386
1795.766,17,449,39928,404,35,4455,288,25708,45,288,40019,288,14220
0.326,6,29,9231,14,261,25,683,1804,15,829,22,1408,7427
115.252,17,2,72,1,8,0,8,36,1,8,0,8,36
9.095,2,2,64,2,8,9095,8,64,0,0,0,0,0
352.022,6,21,8719,6,106,70404,106,354,15,596,25143,3426,8365
50.776,6,15,1375,6,275,10155,275,523,9,96,6243,96,852
1772.733,6,180,15480,120,69,14896,69,8940,60,69,30045,69,6540
1786.816,6,102,8228,68,64,26668,64,4896,34,58,54142,58,3332
280.441,6,28,7352,12,158,25494,267,1277,16,603,18687,1400,6075
1797.219,17,448,39896,403,35,4470,288,25676,45,288,40017,288,14220
1.989,17,3,180,3,32,994,32,180,0,0,0,0,0
1.778,6,116,87329,50,131,36,232,2529,66,1369,24,2860,84800
6.804,6,9,520,4,0,2268,0,220,5,0,1286,0,300
92.37,6,22,2009,9,177,11546,177,995,13,110,7683,110,1014
1787.406,6,135,19752,82,268,22066,1257,14289,53,81,34370,191,5463
10.746,6,20,4442,11,275,1074,275,998,9,768,746,1440,3444
1740.932,6,127,16250,76,79,23212,877,7060,51,171,34817,1448,9190
1741.955,17,30,31680,30,1028,60067,1028,31680,0,0,0,0,0
6.405,6,30,8848,13,155,533,267,1306,17,527,399,2840,7542
0.043,6,3,120,2,0,43,0,80,1,0,0,0,40
157.036,6,24,6248,9,272,101,516,1180,15,372,11209,1452,5068
7.896,6,18,6871,9,275,987,275,643,9,1171,678,1440,6228
0.195,6,2,104,1,0,0,0,52,1,0,0,0,52
1787.715,6,114,11528,72,129,25179,1253,7528,42,64,43600,191,4000
164.222,17,4,1808,4,424,54740,548,1808,0,0,0,0,0
1.387,6,38,8258,19,321,77,1168,2722,19,433,67,1360,5536
280.261,6,31,7472,14,158,21558,267,1357,17,543,17514,1400,6115
247.253,6,44,13725,27,387,9509,1360,6573,17,587,15441,1360,7152
7.984,6,6,1257,4,327,2661,414,815,2,181,7803,270,442
310.152,6,31,4464,12,200,28195,517,1836,19,411,17230,499,2628
285.395,1,6,336,6,28,57079,28,336,0,0,0,0,0
2.081,17,2,677,1,300,0,300,328,1,321,0,321,349
1785.373,6,104,8444,68,66,26647,66,4964,36,60,51008,60,3480
9.918,6,27,3969,19,211,550,211,1562,8,665,1416,904,2407
3.692,6,4,617,1,302,0,302,354,3,83,1846,83,263
1799.252,17,448,39896,403,35,4475,288,25676,45,288,40022,288,14220
1797.951,17,180,14040,180,50,10044,50,14040,0,0,0,0,0
1777.986,6,245,45642,119,868,15067,1418,33158,126,61,14223,580,12484
31.848,6,6,360,0,0,0,0,0,6,0,0,0,360
20.149,6,21,5418,12,107,1831,159,1074,9,773,2517,1402,4344
0.009,6,7,9040,1,0,0,0,40,6,1448,1,1448,9000
131.121,17,4,352,2,60,131120,60,176,2,60,131120,60,176
9.995,17,76,49960,23,328,454,1350,8189,53,760,191,1350,41771
11.641,6,1846,1607783,1118,1383,10,1420,1574442,728,526,16,3303,33341
22.321,6,30,8480,16,732,1488,1147,3831,14,355,1044,1408,4649
44.144,17,5,207,4,12,14714,14,163,1,16,0,16,44
255.774,17,4,352,2,60,255773,60,176,2,60,255773,60,176
1798.264,17,448,39612,404,35,4462,288,25708,44,288,40948,288,13904
68.4,6,10,648,10,31,7600,31,648,0,0,0,0,0
1742.553,2,11,352,11,8,174255,8,352,0,0,0,0,0
11.084,6,6,328,4,0,3694,0,216,2,0,11014,0,112
822.296,6,46,3415,24,31,28804,31,1620,22,31,39148,31,1795
1733.197,6,77,5636,48,33,36876,33,3336,29,31,61893,31,2300
1.287,6,46,19152,27,893,49,1360,13616,19,476,61,2715,5536
1770.474,6,101,9344,66,65,27238,65,5577,35,59,52070,59,3767
142.08,17,4,1344,4,308,47360,308,1344,0,0,0,0,0
12.429,6,1908,1684073,1192,1362,10,1380,1651146,716,387,17,1923,32927
1783.456,17,83,3480,82,14,22017,14,3444,1,8,0,8,36
0.005,17,2,235,1,36,0,36,64,1,143,0,143,171
0.301,6,9,1346,5,145,75,145,349,4,833,85,833,997
0.017,17,4,608,2,60,16,60,176,2,188,14,188,432
1.315,6,48,19198,27,889,50,1360,13582,21,433,57,1360,5616
311.702,6,106,74515,62,1268,5109,1448,65364,44,843,1522,2359,9151
0.647,6,24,7492,14,273,49,663,2104,10,1209,68,1946,5388
0.125,17,2,2104,2,1024,125,1024,2104,0,0,0,0,0
195.132,17,3,528,3,148,97566,352,528,0,0,0,0,0
0.5,6,23,4531,11,165,50,456,1394,12,498,42,888,3137
3.914,6,47,19165,26,959,156,1460,13549,21,433,186,1460,5616
0.1,6,10,2115,6,597,19,1034,1438,4,513,33,513,677
0.258,6,25,6032,12,164,23,453,1442,13,651,20,1402,4590
240.121,6,43,10950,21,174,12005,517,2195,22,760,11434,2816,8755
0.373,17,2,184,1,32,0,32,60,1,96,0,96,124
234.607,17,4,352,2,60,234606,60,176,2,60,234606,60,176
11.324,6,1798,1564214,1096,1373,10,1420,1531913,702,467,16,1883,32301
1795.054,17,449,39928,404,35,4454,288,25708,45,288,40019,288,14220
1783.813,6,420,25176,210,69,8534,69,12540,210,34,8534,48,12636
96.294,6,34,7871,13,155,8024,267,1306,21,357,4814,3417,6565
0.443,6,12,1653,6,288,86,288,548,6,426,48,434,1105
3.267,6,8,427,4,0,1089,0,204,4,7,1016,7,223
1768.551,1,58,4872,58,56,31027,56,4872,0,0,0,0,0
0.004,17,2,338,1,37,0,37,65,1,245,0,245,273
31.604,6,7,336,1,0,0,0,48,6,0,6319,0,288
1786.475,6,106,8524,68,66,26663,66,4964,38,60,48280,60,3560
72.547,17,4,240,2,32,72546,32,120,2,32,72546,32,120
0.142,17,2,412,1,33,0,33,61,1,323,0,323,351
271.13,6,10,564,3,0,135565,0,152,7,0,45167,0,412
6.334,6,1707,1563100,1064,1390,5,1408,1525000,643,931,9,2801,38100
60.146,2,2,64,2,8,60146,8,64,0,0,0,0,0
1779.387,17,140,11200,70,48,25788,48,5320,70,56,25788,56,5880
0.0,6,1,1006,0,0,0,0,0,1,966,0,966,1006
2.574,6,8,1720,5,1233,640,1233,1437,3,159,1282,159,283
1.069,6,18,4454,10,282,118,547,1251,8,575,139,1420,3203
421.128,2,6,192,6,8,84225,8,192,0,0,0,0,0
1787.064,6,102,8364,68,66,26672,66,4964,34,60,54150,60,3400
8.156,6,27,7177,13,155,679,267,1306,14,530,626,3417,5871
127.245,6,23,9132,12,401,88,925,1716,11,1160,12707,2555,7416
0.548,17,2,152,1,48,0,48,76,1,48,0,48,76
64.379,6,17,1608,9,226,8047,226,964,8,110,8934,110,644
301.005,6,45,13951,25,787,12541,1360,8120,20,386,464,2667,5831
1.244,6,50,20076,28,884,46,1360,14420,22,433,51,1360,5656
22.958,6,8299,6848591,3754,328,6,338,205924,4545,1411,5,2816,6642667
1782.325,6,356,22520,208,69,8610,69,12460,148,69,12121,69,10060
1719.711,17,13,534,11,14,171951,14,462,2,8,1719516,8,72
1773.186,6,180,15480,120,69,14900,69,8940,60,69,30046,69,6540
1797.779,6,490,30570,272,99,6633,469,17365,218,34,8283,64,13205
0.135,1,2,112,2,28,135,28,112,0,0,0,0,0
0.162,6,3,175,2,31,0,31,135,1,0,0,0,40
1773.195,1,58,4872,58,56,31108,56,4872,0,0,0,0,0
0.477,6,22,7354,13,335,39,668,2026,9,1210,55,1946,5328
1.421,6,49,19297,27,894,54,1460,13641,22,476,57,2615,5656
1776.492,17,142,11360,71,48,25377,48,5396,71,56,25378,56,5964
4.804,6,40,7309,20,218,252,314,3423,20,513,239,1179,3886
1.029,6,11,988,5,283,213,283,563,6,105,170,105,425
4.99,17,4,530,2,36,4985,36,128,2,173,4985,187,402
1776.985,17,142,11360,71,48,25384,48,5396,71,56,25384,56,5964
0.233,6,22,5040,11,137,23,267,1132,11,577,22,1400,3908
250.592,17,4,352,2,60,250590,60,176,2,60,250591,60,176
0.355,6,20,7229,12,334,31,663,1969,8,1209,49,2816,5260
3.448,6,33,6145,17,206,215,314,2744,16,551,213,1179,3401
1773.504,6,180,15480,120,69,14903,69,8940,60,69,30048,69,6540
23.348,17,45,12296,19,329,1295,1350,6798,26,183,932,1350,5498
1786.698,6,359,22709,209,69,8589,69,12569,150,69,11991,69,10140
1787.921,17,142,11360,71,48,25541,48,5396,71,56,25541,56,5964
1653.898,1,8,448,8,28,236271,28,448,0,0,0,0,0
33.184,6,13,2133,8,324,4740,585,1073,5,396,8255,580,1060
0.304,17,8,2750,8,315,43,354,2750,0,0,0,0,0
1546.553,17,20,5144,10,31,171838,37,594,10,427,171834,463,4550
4.127,6,2,88,2,0,0,0,88,0,0,0,0,0
0.482,6,52,22165,29,988,17,1380,17003,23,383,20,1380,5162
679.64,17,14,4704,14,308,52280,308,4704,0,0,0,0,0
286.674,17,6,528,3,60,143336,60,264,3,60,143336,60,264
26.731,6,37,9291,18,321,1572,721,2976,19,555,1428,2840,6315
407.521,1,9,504,9,28,50940,28,504,0,0,0,0,0
1.617,6,45,18080,26,882,64,1360,12544,19,476,78,2720,5536
354.102,6,17,2046,5,106,1471,106,314,12,113,32190,577,1732
1700.257,1,62,3472,62,28,27873,28,3472,0,0,0,0,0
46.167,6,43,11174,18,321,60,469,4587,25,348,1923,1420,6587
280.238,6,30,7432,14,158,21556,267,1357,16,603,18679,2036,6075
5.783,6,41,7365,21,201,289,314,3463,20,516,290,1179,3902
1748.205,1,56,4704,56,56,31785,56,4704,0,0,0,0,0
1638.082,2,13,416,13,8,136506,8,416,0,0,0,0,0
1797.085,17,178,13884,178,50,10153,50,13884,0,0,0,0,0
363.786,6,29,1883,19,177,20210,177,1245,10,110,8403,110,638
1773.605,6,180,15480,120,69,14904,69,8940,60,69,30052,69,6540
445.767,1,9,954,9,78,55720,78,954,0,0,0,0,0
179.905,17,4,352,2,60,179904,60,176,2,60,179904,60,176
9.325,6,15,2666,8,152,1332,267,782,7,400,1507,1179,1884
141.589,6,64,12124,27,284,5445,1460,4781,37,292,3932,1460,7343
240.236,6,53,17596,28,786,8897,1418,14840,25,181,10009,580,2756
40.055,6,26,7143,12,156,3641,267,1272,14,530,3080,2006,5871
0.497,6,10,968,5,256,113,256,460,5,304,113,304,508
1787.699,17,83,3480,82,14,22070,14,3444,1,8,0,8,36
33.361,6,32,5159,16,154,2224,721,1923,16,342,1043,1408,3236
0.815,6,10,1687,6,100,163,100,344,4,589,182,1152,1343
1789.955,6,358,22669,208,69,8647,69,12529,150,69,12013,69,10140
1783.38,17,334,25384,334,48,5355,48,25384,0,0,0,0,0
12.277,17,20,9324,9,660,1531,1350,6195,11,256,1224,1350,3129
21.443,17,22,3116,11,48,2142,48,836,11,179,2142,308,2280
16.561,17,22,12439,13,764,1377,1350,10303,9,209,2066,1350,2136
0.391,6,24,5980,12,164,35,453,1442,12,651,33,1440,4538
30.793,6,6,324,2,0,30793,0,104,4,0,7185,0,220
0.02,17,4,352,2,37,15,37,130,2,83,15,89,222
202.993,6,15,1096,4,65,17974,65,290,11,36,20290,59,806
0.343,6,13,1693,7,288,57,288,588,6,284,35,434,1105
1.92,17,4,560,2,64,1891,64,184,2,160,1878,160,376
1744.656,2,30,960,30,8,60160,8,960,0,0,0,0,0
240.66,2,5,160,5,8,60165,8,160,0,0,0,0,0
2.53,6,15,6105,6,186,502,267,621,9,852,313,2920,5484
318.86,6,86,21876,44,373,7415,1460,12261,42,339,7768,1629,9615
6.728,6,743,652389,463,1332,14,1368,630385,280,776,23,1473,22004
18.964,17,4,824,2,48,18913,48,152,2,308,18920,308,672
0.068,6,10,1331,5,333,16,333,601,5,462,16,462,730
1597.53,1,8,448,8,28,228218,28,448,0,0,0,0,0
240.217,6,54,17901,29,755,8579,1408,15115,25,184,10008,580,2786
289.349,1,4,224,4,28,96449,28,224,0,0,0,0,0
1248.939,6,2022,2356807,700,125,1786,344,40784,1322,1761,945,5608,2316023
24.739,6,1456,1290488,940,1298,26,1368,1258968,516,776,47,1473,31520
294.328,6,57,14321,25,178,12261,517,2790,32,655,9492,1418,11531
6.277,6,31,8912,14,158,482,267,1357,17,687,388,1781,7555
1786.206,6,104,8308,68,64,26659,64,4896,36,58,51031,58,3412
233.987,6,29,7392,13,158,19498,267,1317,16,678,15595,3456,6075
14.347,6,2520,2361614,1590,1406,8,1448,2308590,930,776,15,1448,53024
1773.42,6,180,15480,120,69,14902,69,8940,60,69,30054,69,6540
1694.184,17,14,1036,7,30,282314,30,406,7,62,282308,62,630
44.278,6,40,9152,22,151,2108,449,1835,18,548,1968,1642,7317
0.049,1,2,300,2,122,49,122,300,0,0,0,0,0
0.245,17,3,451,2,39,35,39,134,1,289,0,289,317
1785.01,6,102,8296,68,65,26641,65,4930,34,59,54088,59,3366
104.501,17,14,4704,14,308,8038,308,4704,0,0,0,0,0
0.054,6,9,1343,5,145,13,145,349,4,830,10,830,994
0.265,6,23,5994,12,181,24,537,1526,11,777,25,2206,4468
726.209,1,102,5712,102,28,7190,28,5712,0,0,0,0,0
0.102,6,20,4244,10,101,11,101,629,10,441,11,500,3615
0.058,6,5,260,0,0,0,0,0,5,0,0,0,260
209.0,6,1967,994619,1091,845,191,1152,947840,876,366,238,1152,46779
8.588,6,17,5391,9,275,1073,275,643,8,1104,983,1440,4748
1740.495,17,29,30624,29,1028,62160,1028,30624,0,0,0,0,0
483.169,17,10,3360,10,308,53685,308,3360,0,0,0,0,0
105.773,17,4,240,2,32,105772,32,120,2,32,105772,32,120
0.356,1,10,840,10,56,39,56,840,0,0,0,0,0
1779.023,6,283,29793,148,103,12102,469,13191,135,88,13276,1420,16602
1776.247,17,73,3060,72,14,25017,14,3024,1,8,0,8,36
1726.433,17,328,55636,328,141,5279,385,55636,0,0,0,0,0
0.167,6,68,57514,42,198,4,250,3068,26,2211,5,7781,54446
1785.259,17,140,11200,70,48,25873,48,5320,70,56,25873,56,5880
15.141,17,17,8132,9,594,1888,1350,5598,8,288,2158,1350,2534
1752.764,6,181,11154,91,48,19475,208,6624,90,31,19691,31,4530
99.65,6,33,7779,11,142,9963,267,1301,22,371,4744,1460,6478
64.001,6,4,372,4,106,21333,106,372,0,0,0,0,0
280.411,6,26,7272,12,158,25491,267,1277,14,678,21567,2085,5995
1759.787,1,76,4256,76,28,23463,28,4256,0,0,0,0,0
23.588,6,16,4268,9,263,2948,722,1519,7,1190,3896,2330,2749
1741.38,6,91,6604,59,31,30023,31,3998,32,31,56173,31,2606
6.919,6,547,443109,321,1309,20,1368,426693,226,776,29,1473,16416
1786.263,6,104,8444,68,66,26660,66,4964,36,60,51032,60,3480
1799.999,6,231,20281,86,82,20823,374,9275,145,70,12499,1062,11006
0.04,17,2,218,1,65,0,65,93,1,97,0,97,125
40.009,6,44,10396,26,568,1600,1228,6460,18,187,2351,1282,3936
1788.589,6,419,25168,209,69,8598,69,12500,210,34,8557,64,12668
1768.488,1,260,14560,260,28,6828,28,14560,0,0,0,0,0
1.133,17,4,334,2,39,592,39,134,2,72,0,72,200
0.896,6,10,1687,7,100,149,100,384,3,1179,324,1179,1303
1789.912,6,280,34516,117,143,15428,1360,17026,163,132,11047,3302,17490
0.064,17,2,180,1,30,0,30,58,1,94,0,94,122
0.066,6,11,913,6,182,13,182,490,5,77,3,134,423
0.433,17,4,317,2,39,432,39,134,2,63,419,72,183
3.357,17,5,290,5,30,839,30,290,0,0,0,0,0
0.002,6,2,104,1,0,0,0,64,1,0,0,0,40
1741.279,6,138,8761,76,49,23217,208,5382,62,31,28538,31,3379
1787.074,17,87,3648,86,14,21024,14,3612,1,8,0,8,36
0.744,17,10,5415,5,653,186,1350,3405,5,374,101,1350,2010
0.956,17,2,312,2,128,956,128,312,0,0,0,0,0
1789.543,1,123,6888,123,28,14668,28,6888,0,0,0,0,0
1785.013,6,105,8416,68,65,26641,65,4930,37,59,49581,59,3486
249.1,17,4,352,2,60,249099,60,176,2,60,249099,60,176
6.105,6,13,1811,6,100,1221,100,344,7,1179,971,1179,1467
28.044,6,16,2358,9,210,3505,210,908,7,545,4673,904,1450
0.153,6,10,1380,6,145,30,145,389,4,827,49,827,991
361.431,6,45,10412,29,290,12908,1360,4970,16,479,577,4027,5442
1.161,6,24,8016,12,164,89,267,1300,12,1014,89,2411,6716
1777.508,17,73,3060,72,14,25035,14,3024,1,8,0,8,36
1786.513,6,104,8504,69,66,26272,66,5004,35,60,52541,60,3500
1794.111,17,86,3612,86,14,21107,14,3612,0,0,0,0,0
0.18,1,2,112,2,28,180,28,112,0,0,0,0,0
10.463,6,2,1175,1,0,0,0,40,1,1095,0,1095,1135
253.127,17,4,558,2,36,253122,36,128,2,187,253123,187,430
0.188,6,12,963,7,181,31,181,541,5,77,25,133,422
0.071,17,4,296,4,46,23,46,296,0,0,0,0,0
1771.579,6,103,9514,66,66,27255,66,5610,37,60,49207,60,3904
13.288,6,7,280,7,0,0,0,280,0,0,0,0,0
3.218,17,5,290,5,30,804,30,290,0,0,0,0,0
23.266,6,35,8177,17,188,1454,721,2004,18,605,1357,2840,6173
1.22,6,41,11378,22,547,58,1360,5842,19,433,57,1360,5536
0.032,17,2,218,1,65,0,65,93,1,97,0,97,125
0.069,6,10,1903,5,657,17,657,925,5,710,17,710,978
240.33,6,38,5343,18,235,14134,751,2594,20,212,12645,664,2749
0.063,17,2,245,1,32,0,32,60,1,157,0,157,185
0.228,6,28,7336,13,155,19,267,1301,15,543,14,1400,6035
20.109,6,21,5441,12,107,1828,159,1098,9,966,2512,2816,4343
5.008,17,4,772,2,46,4996,46,148,2,284,4999,284,624
90.173,17,4,352,2,60,90172,60,176,2,60,90171,60,176
240.283,6,43,8968,21,519,12013,1402,5775,22,226,11441,618,3193
48.905,6,14,1103,9,105,4506,105,691,5,52,12226,64,412
0.395,17,2,152,1,48,0,48,76,1,48,0,48,76
11.23,17,4,352,2,60,11229,60,176,2,60,11229,60,176
0.1,6,9,1339,5,145,25,145,349,4,826,30,826,990
1798.093,17,448,39896,403,35,4472,288,25676,45,288,40015,288,14220
35.025,17,20,1760,10,48,3890,48,760,10,72,3890,72,1000
1748.902,17,302,50554,302,139,5810,357,50554,0,0,0,0,0
10.154,6,71,20326,36,540,290,1152,15499,35,489,289,1179,4827
1795.395,17,449,39928,404,35,4455,288,25708,45,288,40017,288,14220
15.145,6,5,706,3,46,7572,46,166,2,460,15008,460,540
1700.515,17,12,498,11,14,170051,14,462,1,8,0,8,36
1682.751,17,14,1036,7,30,280451,30,406,7,62,280448,62,630
1789.827,17,140,11200,70,48,25939,48,5320,70,56,25939,56,5880
5.586,6,41,7349,21,218,279,314,3463,20,513,278,1179,3886
0.348,6,3,151,1,0,0,0,40,2,31,0,31,111
180.512,2,3,96,3,8,90256,8,96,0,0,0,0,0
5.178,6,40,7325,21,201,258,314,3463,19,516,273,1179,3862
24.479,6,34,8969,16,303,1631,721,2765,18,608,1415,2840,6204
1.97,6,28,8885,17,285,123,588,1540,11,862,179,1336,7345
17.496,17,13,6578,7,613,2910,1350,4487,6,320,3492,1350,2091
320.554,6,77,17729,40,136,8219,721,5142,37,740,8875,2535,12587
1746.528,6,94,7151,62,38,28631,205,4424,32,33,56326,98,2727
1787.808,6,372,25988,216,99,8315,469,15194,156,69,11534,69,10794
1753.685,6,116,9563,75,55,23698,205,5839,41,38,43830,98,3724
1797.647,17,180,14040,180,50,10042,50,14040,0,0,0,0,0
0.104,17,2,179,1,43,0,43,71,1,80,0,80,108
16.964,17,36,6681,16,169,1128,1350,3155,20,148,890,1350,3526
0.92,17,4,768,2,39,911,39,134,2,289,659,289,634
0.026,6,2,100,1,0,0,0,60,1,0,0,0,40
240.749,6,90,27251,44,559,5598,1408,14631,46,536,5349,2816,12620
0.074,17,2,362,1,46,0,46,74,1,260,0,260,288
1771.066,6,99,9306,66,66,27247,66,5610,33,60,55343,60,3696
1772.199,6,182,15629,121,69,14768,69,8980,61,69,29531,69,6649
1773.566,6,180,15480,120,69,14903,69,8940,60,69,30059,69,6540
39.584,17,44,6468,22,48,1884,48,1672,22,190,1884,308,4796
66.083,6,12,976,4,226,142,226,442,8,110,9412,110,534
9.249,2,2,64,2,8,9249,8,64,0,0,0,0,0
1.227,6,50,19832,28,868,45,1360,14176,22,433,50,1360,5656
1752.503,6,97,7338,64,38,27817,205,4528,33,33,54753,98,2810
71.046,1,2,112,2,28,71046,28,112,0,0,0,0,0
315.921,6,67,12727,31,211,10530,1305,3886,36,273,8951,1629,8841
280.192,6,27,7312,13,158,23349,267,1317,14,775,21550,2800,5995
1767.317,1,129,7224,129,28,13807,28,7224,0,0,0,0,0
1785.846,6,241,24529,96,67,18796,616,9131,145,131,12400,1698,15398
1.342,6,39,8294,19,321,74,1164,2718,20,433,61,1440,5576
1732.478,17,278,59322,278,185,6254,422,59322,0,0,0,0,0
1.273,17,2,154,1,33,0,33,61,1,65,0,65,93
0.328,6,7,466,5,43,72,43,354,2,0,324,0,112
0.009,17,2,152,1,48,0,48,76,1,48,0,48,76
255.655,17,3,1000,3,305,127827,308,1000,0,0,0,0,0
0.016,17,2,395,1,33,0,33,61,1,306,0,306,334
33.507,6,31,5138,15,180,2393,721,1857,16,305,2220,2026,3281
1744.64,2,16,512,16,8,116309,8,512,0,0,0,0,0
0.302,17,8,2766,8,317,43,356,2766,0,0,0,0,0
114.729,17,4,352,2,60,114728,60,176,2,60,114728,60,176
0.006,17,4,288,2,33,2,33,122,2,55,2,61,166
1787.167,6,104,8308,68,64,26674,64,4896,36,58,51059,58,3412
0.01,17,2,206,1,44,0,44,72,1,106,0,106,134
31.712,6,6,360,0,0,0,0,0,6,0,0,0,360
1776.959,17,140,11200,70,48,25752,48,5320,70,56,25752,56,5880
240.334,6,39,8187,19,562,13351,1408,5492,20,205,12648,580,2695
0.06,6,34,38514,21,216,3,517,1964,13,3985,3,15488,36550
1799.882,17,424,37424,382,35,4724,288,24152,42,288,42945,288,13272
1761.36,17,170,14432,157,30,11290,37,9155,13,377,141811,463,5277
2.502,17,4,518,3,39,926,39,201,1,289,0,289,317
1791.473,6,359,22709,209,69,8612,69,12569,150,69,12020,69,10140
33.836,17,23,9367,10,469,3755,1350,4976,13,309,2817,1350,4391
1779.784,1,342,28728,342,56,5219,56,28728,0,0,0,0,0
0.051,17,2,180,1,30,0,30,58,1,94,0,94,122
7.37,6,31,8912,14,158,566,267,1357,17,687,459,1781,7555
0.283,17,2,144,1,36,0,36,64,1,52,0,52,80
280.397,6,30,7432,13,158,23366,267,1317,17,543,17519,1400,6115
31.911,6,164,160147,52,131,625,315,3097,112,1400,287,2804,157050
43.033,6,41,8562,19,371,558,766,1929,22,441,2043,1460,6633
0.418,6,10,1992,5,288,96,288,508,5,424,61,434,1484
1797.617,6,191,18610,126,99,14380,469,11525,65,69,28083,69,7085
2.998,17,4,624,4,128,999,128,624,0,0,0,0,0
756.059,6,74,10124,42,113,18440,474,4601,32,147,24321,1448,5523
1.923,17,2,154,1,33,0,33,61,1,65,0,65,93
0.016,17,4,865,2,47,0,47,150,2,329,5,341,715
99.631,6,37,9507,19,638,501,1360,3985,18,435,5848,2667,5522
280.029,6,26,7272,13,158,23335,267,1317,13,905,23332,4845,5955
4.733,6,23,4996,11,288,458,288,1068,12,682,414,853,3928
300.858,6,49,10486,24,433,13080,910,3218,25,312,552,1460,7268
0.015,17,6,471,3,31,0,31,177,3,70,0,70,294
0.01,6,3,151,1,0,0,0,40,2,31,1,31,111
2.632,17,2,136,1,32,0,32,60,1,48,0,48,76
1799.941,17,449,39928,404,35,4466,288,25708,45,288,40022,288,14220
1785.851,6,356,22520,208,69,8627,69,12460,148,69,12148,69,10060
1798.836,6,361,24941,210,94,8606,469,14416,151,69,11991,69,10525
302.101,6,33,6397,17,286,18881,1314,2405,16,334,20139,1420,3992
19.324,17,31,7796,13,306,1607,1350,4342,18,163,1134,1350,3454
379.021,2,4,128,4,8,126340,8,128,0,0,0,0,0
0.954,17,5,1176,3,32,474,32,180,2,470,7,470,996
1.153,17,5,952,3,32,497,32,180,2,358,158,470,772
1786.512,6,102,8296,68,65,26664,65,4930,34,59,54132,59,3366
7.976,6,44,8691,23,175,362,721,2328,21,551,389,1420,6363
300.863,6,39,8725,21,308,15043,888,2119,18,489,510,3488,6606
38.327,17,4,352,2,60,38325,60,176,2,60,38326,60,176
1774.058,6,307,38246,121,157,14782,1460,19408,186,116,9588,3102,18838
257.694,17,4,352,2,60,257693,60,176,2,60,257693,60,176
1789.954,6,478,32638,253,105,7102,981,17159,225,48,7990,240,15479
378.497,2,3,96,3,8,189248,8,96,0,0,0,0,0
0.2,6,9,1339,5,145,50,145,349,4,826,53,826,990
1783.813,6,363,24414,210,88,8534,469,13947,153,69,11735,69,10467
1.4,6,48,19210,27,891,53,1460,13594,21,476,60,2615,5616
166.716,6,1345,715687,785,852,212,1152,686759,560,407,297,1179,28928
31.681,6,7,308,1,0,0,0,44,6,0,6287,0,264
13.19,6,19,2875,14,152,1014,267,1492,5,589,1992,643,1383
280.542,6,30,7432,13,158,23378,267,1317,17,603,17528,2076,6115
1797.379,17,448,39896,403,35,4471,288,25676,45,288,40020,288,14220
0.672,6,14,2598,7,288,93,288,600,7,568,75,853,1998
1187.444,6,100,10560,55,74,21986,722,4885,45,95,26983,2026,5675
505.768,17,15,1140,15,48,36126,48,1140,0,0,0,0,0
0.244,17,2,2128,2,1036,244,1036,2128,0,0,0,0,0
0.186,6,5,260,3,0,93,0,156,2,0,170,0,104
615.949,6,127,17817,58,100,10806,615,5709,69,198,9056,4649,12108
1403.172,17,12,888,6,30,280628,30,348,6,62,280628,62,540
0.916,6,9,1647,6,100,183,100,344,3,1179,326,1179,1303
157.659,6,989,479521,522,848,302,933,458885,467,488,337,1179,20636
262.801,17,3,228,3,48,131400,48,228,0,0,0,0,0
1.524,6,48,19403,27,905,58,1460,13787,21,433,65,1460,5616
111.102,6,35,18789,18,702,48,1360,4967,17,1094,6936,2167,13822
313.144,6,77,54171,38,546,8463,1306,4326,39,1328,1880,4206,49845
189.846,6,55,9436,26,145,7593,721,2499,29,320,6586,1420,6937
0.082,17,2,348,1,39,0,39,67,1,253,0,253,281
280.056,6,32,7512,15,158,20004,267,1397,17,543,17499,1400,6115
1741.553,1,76,6384,0,0,0,0,0,76,56,23220,56,6384
1799.536,17,142,11360,71,48,25707,48,5396,71,56,25707,56,5964
360.946,2,5,160,5,8,90236,8,160,0,0,0,0,0
400.902,6,28,1971,15,31,28623,31,997,13,31,33394,31,974
1796.697,6,367,25857,211,99,8555,469,14925,156,69,11590,69,10932
1772.651,6,180,15480,120,69,14896,69,8940,60,69,30037,69,6540
229.763,1,4,224,4,28,76587,28,224,0,0,0,0,0
0.383,17,2,266,1,41,0,41,69,1,169,0,169,197
0.495,6,2,80,1,0,0,0,40,1,0,0,0,40
0.336,1,2,112,2,28,336,28,112,0,0,0,0,0
1795.846,17,448,39896,403,35,4467,288,25676,45,288,40019,288,14220
0.264,6,9,1339,5,145,66,145,349,4,826,54,826,990
4.412,6,2,88,2,0,0,0,88,0,0,0,0,0
23.784,6,15,1287,8,222,3395,222,768,7,231,3961,231,519
3.112,6,28,5850,15,135,222,267,1421,13,780,226,1459,4429
1799.444,17,994,331414,472,603,3820,1350,297897,522,36,3453,1350,33517
1781.983,6,354,22440,207,69,8650,69,12420,147,69,12204,69,10020
3.001,6,57,40249,26,783,120,1460,6556,31,1410,95,2374,33693
240.202,6,57,21014,30,855,8282,1408,17816,27,223,9238,580,3198
416.1,6,8,475,6,31,83220,31,333,2,31,299830,31,142
1786.455,6,102,8364,68,66,26663,66,4964,34,60,54132,60,3400
163.566,6,23,8502,12,322,56,623,1480,11,938,16343,1708,7022
1785.857,6,359,22847,208,69,8627,69,12460,151,69,11905,69,10387
6.946,6,39,7269,20,218,365,314,3423,19,513,370,1179,3846
0.414,17,2,144,1,36,0,36,64,1,52,0,52,80
1772.424,6,180,15480,120,69,14894,69,8940,60,69,30039,69,6540
1757.203,6,203,23866,103,84,17227,721,9460,100,247,17747,1414,14406
57.458,6,38,9587,20,642,523,1360,4065,18,435,3309,2667,5522
4.126,17,8,692,4,37,1373,37,260,4,80,1373,89,432
107.02,6,22,9783,12,410,55,922,1742,10,1271,11876,3056,8041
446.356,6,106,25347,50,634,9109,1408,19175,56,140,8115,584,6172
1767.566,6,149,12042,80,100,22374,208,8321,69,31,25986,31,3721
0.213,6,21,5781,12,164,19,453,1442,9,643,25,1402,4339
64.384,17,12,2796,12,205,5853,205,2796,0,0,0,0,0
10.776,6,20,4442,11,275,1077,275,998,9,768,714,1440,3444
4.521,17,4,352,2,60,4520,60,176,2,60,4520,60,176
18.95,6,5,264,3,0,9475,0,160,2,0,2292,0,104
1794.409,17,144,11520,72,48,25273,48,5472,72,56,25273,56,6048
379.857,6,18,1242,14,180,29219,180,916,4,110,20057,110,326
0.486,17,2,204,1,34,0,34,62,1,114,0,114,142
1786.455,6,104,8308,68,64,26663,64,4896,36,58,51039,58,3412
3.971,17,4,368,4,64,1323,64,368,0,0,0,0,0
1783.351,17,83,3480,82,14,22016,14,3444,1,8,0,8,36
240.269,6,42,8780,21,523,12013,1408,5809,21,207,12013,639,2971
35.345,6,26,8782,14,362,2718,773,1680,12,826,3201,1360,7102
1680.799,17,12,498,11,14,168079,14,462,1,8,0,8,36
300.739,6,49,10409,25,564,12530,1460,4492,24,290,656,1460,5917
3.083,6,38,20283,19,778,171,1460,6250,19,1205,161,1460,14033
256.613,6,29,7001,14,229,147,498,1712,15,390,18323,1420,5289
0.033,17,4,1148,2,32,19,32,120,2,486,19,486,1028
1755.94,6,105,6270,60,27,29761,27,3525,45,27,39906,27,2745
0.927,6,24,8978,14,254,71,658,1609,10,1391,83,3930,7369
5.031,17,2,150,2,47,5031,47,150,0,0,0,0,0
0.959,6,28,8481,15,225,57,561,1985,13,994,65,1791,6496
255.266,6,63,9550,27,273,9817,686,4215,36,191,7293,809,5335
1.565,6,47,19461,27,912,60,1360,13885,20,433,71,1360,5576
70.163,6,36,8479,18,410,523,882,2006,18,478,4117,2128,6473
7.271,17,2,136,2,40,7271,40,136,0,0,0,0,0
1770.39,6,125,11326,76,65,23605,65,6429,49,59,36880,59,4897
15.115,17,18,11842,10,929,1676,1350,9575,8,255,2154,1350,2267
240.524,6,53,17762,28,784,8905,1418,14793,25,207,10019,580,2969
6.284,1,4,224,4,28,2094,28,224,0,0,0,0,0
369.554,6,21,1422,15,180,26396,180,992,6,110,12244,110,430
0.503,17,15,8570,8,705,71,1350,5871,7,357,74,1350,2699
0.03,17,4,368,2,32,30,32,120,2,96,1,96,248
15.813,6,8,352,2,0,3359,0,88,6,0,3144,0,264
5.353,6,40,7309,19,218,297,314,3383,21,513,252,1179,3926
1795.818,6,474,34413,244,129,7390,1237,18298,230,48,7841,240,16115
5.621,6,42,7389,22,218,267,314,3503,20,440,282,1152,3886
0.391,6,14,4576,8,290,55,517,993,6,1087,77,1408,3583
0.074,17,2,334,1,39,0,39,67,1,239,0,239,267
11.47,6,113,39451,59,634,197,1152,32809,54,407,211,1152,6642
0.5,6,22,5040,11,137,50,267,1132,11,577,48,1400,3908
0.108,17,2,245,1,32,0,32,60,1,157,0,157,185
744.975,6,68,8455,42,81,18170,722,4147,26,164,23700,2329,4308
1793.254,1,266,28196,266,78,6766,78,28196,0,0,0,0,0
29.915,17,4,1344,4,308,9971,308,1344,0,0,0,0,0
1.402,6,37,8212,19,320,77,1162,2716,18,476,71,2715,5496
8.061,17,2,778,2,361,8061,361,778,0,0,0,0,0
1795.449,6,427,25828,212,69,8509,69,12758,215,36,8389,69,13070
20.97,17,19,12254,12,824,1903,1350,10230,7,261,3489,1350,2024
4.132,17,2,656,2,300,4132,300,656,0,0,0,0,0
1.174,17,2,782,2,363,1174,363,782,0,0,0,0,0
0.397,6,9,527,5,43,99,43,311,4,0,75,0,216
5.105,6,43,8329,21,227,255,314,4022,22,489,230,1179,4307
1744.687,2,24,768,24,8,75855,8,768,0,0,0,0,0
0.847,6,24,6420,13,299,70,842,2023,11,988,84,1731,4397
6.136,6,23,4478,13,213,511,597,1741,10,552,658,1767,2737
11.332,6,1656,1538296,1088,1365,10,1432,1511204,568,395,19,1432,27092
0.322,6,27,8955,13,234,26,575,1620,14,942,23,1408,7335
162.807,1,8,448,8,28,23258,28,448,0,0,0,0,0
1770.117,6,111,11023,71,85,25287,817,6709,40,61,45384,192,4314
1738.709,6,87,6322,58,31,30503,31,3915,29,31,62096,31,2407
0.006,17,2,306,1,36,0,36,64,1,214,0,214,242
0.0,17,3,1063,3,326,0,354,1063,0,0,0,0,0
1776.599,17,73,3060,72,14,25022,14,3024,1,8,0,8,36
195.157,17,4,352,2,60,195156,60,176,2,60,195156,60,176
1.358,6,45,19155,27,896,52,1360,13659,18,476,69,2715,5496
1443.834,2,16,512,16,8,96255,8,512,0,0,0,0,0
1720.528,17,12,498,11,14,172052,14,462,1,8,0,8,36
2.977,2,2,64,2,8,2977,8,64,0,0,0,0,0
755.65,2,5,160,5,8,188912,8,160,0,0,0,0,0
1742.35,6,141,11598,78,103,22627,208,8179,63,31,28095,31,3419
1700.79,1,8,448,8,28,242970,28,448,0,0,0,0,0
60.278,6,30,4664,16,142,4018,174,1070,14,303,4626,1452,3594
4.066,17,5,290,5,30,1016,30,290,0,0,0,0,0
155.905,17,4,352,2,60,155904,60,176,2,60,155903,60,176
0.005,6,2,87,1,0,0,0,40,1,7,0,7,47
1680.941,17,12,498,11,14,168094,14,462,1,8,0,8,36
3.227,6,281,234923,134,222,24,230,11900,147,1485,22,2896,223023
0.342,6,19,13890,13,127,23,127,811,6,4253,45,11584,13079
1796.038,17,448,39896,403,35,4467,288,25676,45,288,40075,288,14220
17.898,17,22,14187,13,900,1488,1350,12075,9,206,2232,1350,2112
10.803,6,18,4266,10,275,1200,275,958,8,992,855,1440,3308
13.616,1,5,280,5,28,3404,28,280,0,0,0,0,0
0.0,17,2,2752,2,1348,0,1348,2752,0,0,0,0,0
0.517,6,10,924,5,283,87,283,551,5,105,88,105,373
1680.689,1,156,8736,156,28,10843,28,8736,0,0,0,0,0
0.289,6,25,6014,12,164,26,453,1442,13,648,23,1408,4572
1777.074,17,73,3060,72,14,25029,14,3024,1,8,0,8,36
1789.31,17,136,10880,68,48,26705,48,5168,68,56,26705,56,5712
1778.582,6,184,17079,122,83,14699,965,9985,62,74,29149,405,7094
19.999,17,4,304,4,48,6666,48,304,0,0,0,0,0
2.971,6,14,2351,8,188,424,245,700,6,1407,543,1407,1651
300.731,6,43,8787,23,266,13669,720,2078,20,393,808,4848,6709
155.091,6,53,10656,21,249,7754,1189,3097,32,298,5002,1420,7559
295.36,17,4,352,2,60,295359,60,176,2,60,295359,60,176
1.249,6,38,8266,19,321,69,1164,2730,19,433,60,1360,5536
0.387,17,2,384,1,39,0,39,67,1,289,0,289,317
0.877,6,12,1163,6,222,173,222,688,6,231,174,231,475
5.233,17,19,14370,12,968,475,1350,11956,7,316,563,1350,2414
240.215,6,57,20537,31,809,8006,1418,17801,26,172,9608,580,2736
1738.156,1,57,4788,57,56,31038,56,4788,0,0,0,0,0
0.425,6,25,7711,16,339,28,949,3017,9,721,51,1420,4694
5.184,6,38,7229,19,218,288,314,3383,19,513,274,1179,3846
6.996,6,613,542149,388,1330,17,1368,525785,225,776,30,2736,16364
0.47,6,49,21208,27,1069,18,1380,16086,22,421,20,1923,5122
1785.875,6,364,23047,211,69,8504,69,12718,153,69,11749,69,10329
0.131,17,2,152,1,48,0,48,76,1,48,0,48,76
3.103,17,25,8536,12,367,278,1350,4744,13,263,255,1350,3792
1.286,6,52,21804,29,931,45,1360,16108,23,433,49,1360,5696
15.917,17,32,6777,14,192,1222,1350,3091,18,176,934,1350,3686
1785.858,6,369,25730,214,99,8384,469,15045,155,69,11596,69,10685
11.853,6,21,6825,12,275,1077,275,1038,9,1353,855,1440,5787
41.544,17,22,1672,22,48,1978,48,1672,0,0,0,0,0
1772.129,6,181,15589,120,69,14891,69,8940,61,69,29531,69,6649
0.917,6,10,1687,7,100,152,100,384,3,1179,327,1179,1303
1771.373,6,103,9448,66,65,27251,65,5577,37,59,49202,59,3871
229.812,17,4,352,2,60,229811,60,176,2,60,229811,60,176
203.52,17,4,1348,4,309,67840,312,1348,0,0,0,0,0
39.265,17,22,1936,11,48,3925,48,836,11,72,3925,72,1100
42.546,17,24,2112,12,48,3866,48,912,12,72,3866,72,1200
2.818,17,24,7813,12,382,253,1350,4921,12,213,253,1350,2892
615.218,6,68,8227,36,102,17573,722,3619,32,155,19840,1408,4608
782.113,2,8,256,8,8,111730,8,256,0,0,0,0,0
1786.431,6,102,8296,68,65,26663,65,4930,34,59,54131,59,3366
1227.497,6,77,10947,49,99,20356,498,4241,28,214,45459,1420,6706
0.268,6,25,6098,12,181,24,537,1526,13,555,20,1448,4572
377.687,6,23,1499,14,177,29052,177,913,9,110,12297,110,586
0.449,6,28,6181,15,108,32,147,1043,13,768,36,1581,5138
11.358,6,24,11830,11,275,1135,275,998,13,1287,862,1420,10832
49.652,17,4,1344,4,308,16550,308,1344,0,0,0,0,0
1798.078,17,448,39896,403,35,4472,288,25676,45,288,40020,288,14220
1.458,6,50,21015,28,947,54,1460,15359,22,476,60,2615,5656
239.666,6,29,7392,13,158,19972,267,1317,16,603,15974,2036,6075
1797.584,1,188,10528,188,28,9612,28,10528,0,0,0,0,0
0.939,6,10,1687,7,100,156,100,384,3,1179,337,1179,1303
1796.978,17,448,39896,403,35,4470,288,25676,45,288,40019,288,14220
1797.433,17,448,39896,403,35,4471,288,25676,45,288,40019,288,14220
62.832,6,37,26174,21,1430,3135,1448,16838,16,1414,4179,1448,9336
38.819,17,22,1936,11,48,3873,48,836,11,72,3876,72,1100
5.021,17,4,288,2,36,5003,36,128,2,52,4998,52,160
833.771,1,36,2016,36,28,23822,28,2016,0,0,0,0,0
1.442,17,11,4461,5,432,360,1350,2302,6,331,139,1350,2159
8.565,6,11,2231,7,188,1427,245,660,4,1407,174,1407,1571
10.601,17,2,152,2,48,10601,48,152,0,0,0,0,0
28.364,6,30,7637,11,155,9,267,1226,19,376,1575,3417,6411
154.879,6,53,10379,27,241,5956,1189,3262,26,357,6194,1917,7117
0.898,6,10,1687,7,100,149,100,384,3,1179,319,1179,1303
179.868,6,24,8810,12,649,78,1440,3109,12,868,16335,1587,5701
1388.006,17,108,8640,54,48,25695,48,4104,54,56,26188,56,4536
0.018,6,10,912,5,121,4,121,389,5,259,4,259,523
1786.592,6,102,8296,68,65,26665,65,4930,34,59,54136,59,3366
1792.727,6,132,8437,73,49,24898,208,4837,59,31,30905,31,3600
3.669,6,199,202542,150,1019,24,1360,18278,49,4797,72,16320,184264
8.809,6,19,2382,10,187,978,187,898,9,247,1099,462,1484
100.819,6,11,719,11,31,10081,31,719,0,0,0,0,0
399.974,17,9,984,9,81,49996,348,984,0,0,0,0,0
10.096,17,3,244,2,48,10064,48,152,1,64,0,64,92
1740.519,17,30,7050,30,207,60017,207,7050,0,0,0,0,0
1797.894,17,450,39960,405,35,4450,288,25740,45,288,40021,288,14220
0.038,17,4,608,2,60,21,60,176,2,188,22,188,432
0.141,17,2,2899,2,1421,141,1427,2899,0,0,0,0,0
15.414,17,2,672,2,308,15414,308,672,0,0,0,0,0
0.357,6,10,1185,6,279,71,279,587,4,191,59,272,598
1.053,17,4,820,2,36,1048,36,128,2,318,1045,318,692
565.81,6,82,15017,41,155,14145,1189,5064,41,319,5229,1460,9953
337.59,17,16,1516,16,66,22506,348,1516,0,0,0,0,0
304.57,6,6,256,5,0,76142,0,208,1,0,0,0,48
10.007,17,2,128,2,36,10007,36,128,0,0,0,0,0
4.906,17,5,320,5,36,1226,36,320,0,0,0,0,0
1786.288,17,87,3648,86,14,21015,14,3612,1,8,0,8,36
1795.306,6,356,22520,208,69,8672,69,12460,148,69,12212,69,10060
135.167,1,8,448,8,28,19309,28,448,0,0,0,0,0
0.221,17,4,284,2,32,0,32,120,2,54,0,60,164
75.377,17,4,240,2,32,75376,32,120,2,32,75376,32,120
4.21,17,10,2320,10,204,467,204,2320,0,0,0,0,0
0.129,17,2,1918,2,931,129,931,1918,0,0,0,0,0
981.197,17,56,8976,56,132,17839,464,8976,0,0,0,0,0
1773.048,6,180,15480,120,69,14899,69,8940,60,69,30048,69,6540
1787.007,6,150,19350,90,302,20078,302,13740,60,83,30288,83,5610
1792.736,6,356,22520,208,69,8660,69,12460,148,69,12194,69,10060
305.554,17,10,3935,10,365,33950,373,3935,0,0,0,0,0
1745.442,6,95,7203,63,38,28152,205,4476,32,33,56297,98,2727
1662.499,1,7,742,7,78,277083,78,742,0,0,0,0,0
77.79,6,35,7614,12,115,773,267,1181,23,367,3535,1420,6433
14.047,6,7,545,2,245,13804,245,329,5,0,3450,0,216
1785.907,6,104,8444,68,66,26655,66,4964,36,60,51023,60,3480
1748.605,6,99,7411,63,38,28203,205,4476,36,33,49947,98,2935
5.807,6,39,7269,21,218,290,314,3463,18,513,325,1179,3806
300.715,6,39,8488,20,286,15827,797,1976,19,441,472,1460,6512
0.015,17,2,212,1,46,0,46,74,1,110,0,110,138
42.577,17,24,1824,24,48,1851,48,1824,0,0,0,0,0
1739.289,6,87,6322,58,31,30513,31,3915,29,31,62116,31,2407
58.605,6,581,264597,301,810,195,1152,247892,280,392,209,1152,16705
207.418,1,7,392,7,28,34569,28,392,0,0,0,0,0
0.005,17,2,518,1,30,0,30,58,1,432,0,432,460
6.483,6,585,490225,353,1319,17,1368,473497,232,776,27,1473,16728
5.79,6,21,4369,12,213,526,597,1713,9,543,697,1408,2656
0.582,17,4,352,2,60,581,60,176,2,60,581,60,176
1.31,6,28,8160,15,222,88,540,1964,13,944,94,1591,6196
101.356,6,11,657,7,31,16863,31,435,4,31,20369,31,222
0.005,17,2,506,1,45,0,45,73,1,405,0,405,433
1.395,17,4,420,2,33,1388,33,122,2,121,1387,145,298
1785.888,6,466,26984,257,69,6976,69,14420,209,34,8585,64,12564
148.739,6,30,10997,16,409,308,783,3540,14,1147,11429,2568,7457
0.1,17,2,258,1,60,0,60,88,1,142,0,142,170
1772.147,6,180,15480,120,69,14891,69,8940,60,69,30035,69,6540
1793.198,6,359,22709,209,69,8620,69,12569,150,69,12031,69,10140
665.354,17,50,3984,27,48,25590,48,2052,23,56,25560,56,1932
1785.502,6,102,8364,68,66,26649,66,4964,34,60,54103,60,3400
26.84,6,16,2930,4,106,8946,106,274,12,269,2422,512,2656
1795.894,6,212,19740,112,127,16179,208,14779,100,31,18131,31,4961
1771.242,6,101,9278,66,64,27249,64,5544,35,58,52092,58,3734
4.974,6,56,25106,32,947,160,1460,19310,24,433,198,1460,5796
157.264,17,4,352,2,60,157263,60,176,2,60,157262,60,176
240.249,6,60,18363,31,796,8007,1418,15161,29,210,8579,580,3202
0.247,17,8,2750,8,315,35,354,2750,0,0,0,0,0
4.48,6,15,2636,9,207,560,245,985,6,1407,839,1407,1651
1772.502,6,205,22439,130,75,13740,267,10057,75,132,23949,1460,12382
0.503,17,3,451,2,39,441,39,134,1,289,0,289,317
53.102,6,30,7297,14,155,4084,267,1346,16,441,3539,1420,5951
1779.756,1,342,28728,342,56,5219,56,28728,0,0,0,0,0
4.316,6,32,8952,14,158,332,267,1357,18,624,252,1400,7595
2.708,17,2,152,1,48,0,48,76,1,48,0,48,76
169.222,17,3,120,2,14,169222,14,84,1,8,0,8,36
1682.738,17,14,1036,7,30,280446,30,406,7,62,280449,62,630
0.019,17,3,234,2,39,1,39,134,1,72,0,72,100
5.0,17,2,138,2,41,5000,41,138,0,0,0,0,0
1760.054,1,150,8400,150,28,11812,28,8400,0,0,0,0,0
1.551,6,50,21705,29,931,55,1360,16089,21,476,67,2715,5616
3.001,6,24,5758,14,158,220,370,1359,10,998,155,1691,4399
9.752,6,652,544954,397,1301,24,1368,527030,255,776,37,1473,17924
0.219,17,2,349,1,36,0,36,64,1,257,0,257,285
36.017,17,20,1760,10,48,4001,48,760,10,72,4000,72,1000
3.079,6,2,88,2,0,0,0,88,0,0,0,0,0
1779.443,6,298,27430,160,75,11191,267,11257,138,79,12988,1420,16173
960.433,6,134,15337,63,92,15488,721,6419,71,216,13718,1440,8918
14.743,6,2544,2396948,1657,1371,8,1408,2346160,887,931,16,2801,50788
1.011,6,8,335,4,0,337,0,164,4,7,242,7,171
0.002,6,2,1175,1,0,0,0,40,1,1095,0,1095,1135
368.543,6,27,1767,18,177,21679,177,1181,9,110,8607,110,586
0.378,6,10,1671,6,552,75,948,1348,4,159,125,159,323
240.287,6,42,8766,21,524,12013,1418,5817,21,231,12013,617,2949
1.611,6,45,10185,23,440,73,1360,4484,22,400,66,1360,5701
1786.712,6,377,28326,216,101,8310,485,15205,161,96,11165,453,13121
15.695,17,23,13019,14,745,1204,1350,10835,9,214,1957,1350,2184
5.85,6,521,465677,332,1339,17,1368,451185,189,776,29,1473,14492
1772.783,6,269,32625,112,130,15969,1360,15638,157,137,11363,4662,16987
3.083,17,6,870,3,40,1524,40,204,3,194,1467,194,666
1797.03,1,341,28644,341,56,5285,56,28644,0,0,0,0,0
3.962,2,2,64,2,8,3962,8,64,0,0,0,0,0
3.016,6,2,88,2,0,0,0,88,0,0,0,0,0
1789.662,6,356,22520,208,69,8645,69,12460,148,69,12174,69,10060
1798.835,1,345,28980,345,56,5229,56,28980,0,0,0,0,0
0.016,17,4,865,2,47,0,47,150,2,329,2,341,715
1771.007,6,114,10530,72,66,24943,66,6102,42,60,43192,60,4428
25.561,6,26,6994,16,124,1704,159,1600,10,811,2839,1675,5394
1784.918,6,360,22818,210,69,8540,69,12678,150,69,11977,69,10140
462.691,6,33,2808,25,64,19278,64,2024,8,58,54149,58,784
19.77,17,4,240,2,32,19769,32,120,2,32,19769,32,120
0.179,6,46,20191,26,1007,7,1420,15170,20,467,9,1883,5021
3.547,6,6,416,4,92,1182,92,288,2,0,0,0,128
0.005,6,2,170,1,0,0,0,40,1,90,0,90,130
1746.459,1,69,5796,69,56,25683,56,5796,0,0,0,0,0
1795.397,1,58,4872,58,56,31498,56,4872,0,0,0,0,0
10.61,6,28,7487,8,159,1514,267,1127,20,370,557,1420,6360
0.013,17,2,142,1,43,0,43,71,1,43,0,43,71
1773.852,6,180,15480,120,69,14906,69,8940,60,69,30056,69,6540
1671.887,1,7,392,7,28,278647,28,392,0,0,0,0,0
0.039,17,2,904,1,300,0,300,328,1,548,0,548,576
1796.473,6,119,9602,75,65,24276,65,5600,44,59,41776,59,4002
1176.329,1,16,896,16,28,78421,28,896,0,0,0,0,0
95.067,1,4,224,4,28,31689,28,224,0,0,0,0,0
4.896,6,40,7309,21,218,244,314,3463,19,513,256,1179,3846
481.337,2,7,224,7,8,80222,8,224,0,0,0,0,0
2.205,6,13,2311,8,188,315,245,700,5,1407,486,1407,1611
0.659,6,21,5000,11,137,65,267,1132,10,692,59,1467,3868
0.008,6,2,149,1,69,0,69,109,1,0,0,0,40
5.539,17,34,17309,15,651,395,1350,10198,19,346,193,1350,7111
1778.692,6,133,8155,71,27,25409,27,4304,62,27,29158,27,3851
1797.64,17,449,39928,404,35,4460,288,25708,45,288,40019,288,14220
272.265,17,8,2688,8,308,38895,308,2688,0,0,0,0,0
0.007,17,2,588,1,39,0,39,67,1,493,0,493,521
1783.81,6,364,25461,211,100,8494,469,14856,153,69,11735,69,10605
2.004,6,26,6125,14,108,154,147,999,12,773,156,1608,5126
2.079,6,20,3833,11,234,207,564,1504,9,463,237,1343,2329
0.083,17,2,334,1,32,0,32,60,1,246,0,246,274
0.004,17,2,160,1,48,0,48,76,1,56,0,56,84
0.197,17,2,180,1,30,0,30,58,1,94,0,94,122
69.19,6,28,8674,15,434,4942,659,2138,13,650,5617,2688,6536
0.045,6,11,911,7,181,7,181,541,4,77,5,133,370
0.008,6,3,211,2,91,1,91,171,1,0,0,0,40
1778.642,17,138,11040,69,48,26156,48,5244,69,56,26156,56,5796
280.034,6,30,7432,13,158,23336,267,1317,17,543,17499,1400,6115
2.701,17,2,214,1,39,0,39,67,1,119,0,119,147
2.948,6,3,180,3,0,0,0,180,0,0,0,0,0
0.47,6,108,86873,55,131,8,232,2729,53,1708,8,4260,84144
1765.136,2,14,448,14,8,135779,8,448,0,0,0,0,0
0.036,17,4,608,2,60,2,60,176,2,188,21,188,432
1744.666,2,30,960,30,8,60160,8,960,0,0,0,0,0
69.313,6,24,10725,14,612,45,1360,3655,10,1331,7687,4428,7070
1782.47,17,82,3438,81,14,22280,14,3402,1,8,0,8,36
1762.043,1,53,4452,0,0,0,0,0,53,56,33885,56,4452
1.368,6,10,1687,7,100,228,100,384,3,1179,554,1179,1303
0.93,6,10,1687,7,100,155,100,384,3,1179,335,1179,1303
0.836,6,116,87420,51,131,16,232,2569,65,1370,12,1540,84851
3.797,17,5,340,5,40,949,40,340,0,0,0,0,0
0.021,17,2,136,1,40,0,40,68,1,40,0,40,68
114.307,17,4,240,2,32,114305,32,120,2,32,114306,32,120
1666.965,1,7,392,7,28,277827,28,392,0,0,0,0,0
0.019,17,3,676,2,46,0,46,148,1,500,0,500,528
143.296,17,4,352,2,60,143295,60,176,2,60,143294,60,176
31.654,6,7,308,1,0,0,0,44,6,0,6312,0,264
124.9,6,25,9908,13,549,51,1460,2749,12,952,11342,1460,7159
1772.669,6,183,15738,121,69,14772,69,8980,62,69,29056,69,6758
153.831,6,25,10447,13,721,92,1309,3437,12,931,13967,1591,7010
3.994,17,8,616,4,33,1330,33,244,4,65,1331,65,372
0.079,17,2,246,1,67,0,67,95,1,123,0,123,151
10.782,6,18,5610,10,275,1198,275,958,8,1440,823,1440,4652
1599.148,1,8,448,8,28,228449,28,448,0,0,0,0,0
2.019,6,10,909,5,38,504,38,306,5,335,503,335,603
0.197,6,41,19764,24,1067,8,1420,14863,17,467,11,1883,4901
300.275,6,42,13235,23,840,13640,1360,7673,19,399,16672,1360,5562
1135.817,17,303,51038,142,216,8055,1350,34649,161,73,7097,1350,16389
40.886,17,45,19245,24,546,1776,1350,13795,21,231,2042,1350,5450
87.809,6,30,7432,13,158,7317,267,1317,17,543,5486,1400,6115
16.392,17,23,10246,10,530,1817,1350,5588,13,330,1363,1350,4658
0.766,6,7,426,3,31,383,31,187,4,31,206,31,239
15.367,6,20,1495,10,222,1703,222,848,10,231,1703,231,647
1.059,6,24,9512,14,350,81,1041,1992,10,1184,96,2370,7520
19.4,17,3,1167,3,361,9700,361,1167,0,0,0,0,0
12.246,17,10,830,5,47,3059,47,375,5,63,3060,63,455
1778.159,1,50,4200,0,0,0,0,0,50,56,36288,56,4200
866.746,6,112,14441,65,82,13542,267,5180,47,175,18819,1460,9261
2.947,6,21,5000,10,137,327,267,1092,11,692,268,1467,3908
22.6,6,21,3182,12,183,2054,517,1561,9,381,2823,499,1621
4.293,6,38,7229,19,218,238,314,3383,19,513,224,1179,3846
1684.177,17,14,1036,7,30,280693,30,406,7,62,280685,62,630
1773.18,6,180,15480,120,69,14900,69,8940,60,69,30051,69,6540
57.334,6,20,6475,10,322,6365,517,1494,10,744,6365,1408,4981
280.37,6,30,7432,13,158,23364,267,1317,17,543,17511,1400,6115
1745.413,6,95,7203,63,38,28151,205,4476,32,33,56290,98,2727
72.711,17,20,1760,10,48,8078,48,760,10,72,8078,72,1000
0.932,2,2,64,2,8,932,8,64,0,0,0,0,0
1.404,6,38,8266,19,321,78,1164,2730,19,433,67,1360,5536
179.485,6,370,310248,230,1365,783,1448,289172,140,574,1289,1448,21076
1788.534,17,87,3648,86,14,21041,14,3612,1,8,0,8,36
0.634,6,8,335,4,0,211,0,164,4,7,66,7,171
128.001,17,4,240,2,32,128000,32,120,2,32,128000,32,120
369.545,6,25,1651,17,177,23096,177,1117,8,110,9211,110,534
3.056,6,54,19659,27,906,117,1440,13803,27,433,110,1440,5856
1786.896,6,102,8172,68,63,26670,64,4868,34,57,54145,58,3304
0.045,17,2,194,1,61,0,61,89,1,77,0,77,105
1785.968,6,155,20046,92,316,19625,316,14272,63,83,28805,83,5774
4.801,6,38,7229,19,218,266,314,3383,19,513,253,1179,3846
0.056,17,5,1740,5,320,14,355,1740,0,0,0,0,0
110.194,6,8298,9160748,2448,645,45,652,155428,5850,1489,18,7240,9005320
0.035,17,2,603,1,40,0,40,68,1,507,0,507,535
0.062,17,2,262,1,39,0,39,67,1,167,0,167,195
1789.311,6,213,23389,111,63,16266,721,8808,102,228,17713,1414,14581
1.685,6,19,3781,10,234,187,564,1452,9,463,185,1343,2329
45.316,6,15,616,9,0,5664,0,364,6,0,6771,0,252
219.017,6,32,8952,14,158,16847,267,1357,18,624,12880,1300,7595
0.026,6,2,364,1,0,0,0,40,1,272,0,272,324
7.087,6,62,11805,32,242,228,314,6139,30,446,235,1179,5666
0.523,17,17,6690,7,342,87,1350,2593,10,381,43,1350,4097
4.728,6,33,6145,18,206,278,314,2784,15,551,319,1179,3361
0.009,17,3,612,2,30,0,30,116,1,468,0,468,496
1785.243,6,364,25392,212,100,8460,469,14896,152,69,11822,69,10496
0.094,17,2,442,1,46,0,46,74,1,340,0,340,368
0.758,17,4,768,2,39,749,39,134,2,289,254,289,634
1781.868,1,266,28196,266,78,6724,78,28196,0,0,0,0,0
10.945,6,20,4442,11,275,1094,275,998,9,768,771,1440,3444
33.823,6,34,5249,16,154,2254,722,1910,18,266,1977,1440,3339
5.011,6,42,7389,21,218,250,314,3463,21,440,238,1152,3926
231.604,17,4,240,2,32,231602,32,120,2,32,231603,32,120
0.727,6,22,5936,11,108,72,147,879,11,922,69,1581,5057
1772.308,6,180,15480,120,69,14893,69,8940,60,69,30038,69,6540
0.057,17,2,167,1,39,0,39,67,1,72,0,72,100
1740.18,6,87,6322,58,31,30529,31,3915,29,31,62148,31,2407
2.246,6,14,2351,8,188,320,245,700,6,703,398,1152,1651
4.998,17,2,128,2,36,4998,36,128,0,0,0,0,0
1749.205,1,214,11984,214,28,8212,28,11984,0,0,0,0,0
1.2,6,24,8004,12,164,92,267,1288,12,1014,92,2804,6716
902.174,2,8,256,8,8,128882,8,256,0,0,0,0,0
1771.627,6,99,9306,66,66,27255,66,5610,33,60,55360,60,3696
7.06,6,14,2245,8,211,1007,211,846,6,545,1411,904,1399
2.466,17,22,7106,9,336,308,1350,3280,13,266,133,1350,3826
0.012,6,3,144,1,0,0,0,52,2,0,12,0,92
300.716,6,38,8444,20,284,15827,792,1971,18,441,502,1440,6473
9.639,6,22,2019,11,222,958,222,1332,11,231,959,231,687
2.105,17,4,566,2,31,2095,31,118,2,196,2095,196,448
9.284,6,1436,1281831,907,1361,10,1420,1256308,529,427,17,1420,25523
1.136,6,23,7952,11,164,96,267,1236,12,1014,87,2411,6716
32.476,17,4,1344,4,308,10825,308,1344,0,0,0,0,0
209.063,6,31,8912,14,158,16081,267,1357,17,687,13062,1781,7555
1786.816,6,102,8296,68,65,26668,65,4930,34,59,54143,59,3366
0.873,6,30,8941,18,639,51,1360,3959,12,561,62,2744,4982
1772.768,6,180,15480,120,69,14897,69,8940,60,69,30039,69,6540
1743.221,6,176,17177,90,68,19586,722,6977,86,132,20504,1440,10200
7.096,6,1154,977849,695,1359,10,1380,955247,459,421,15,1923,22602
3.44,6,28,8903,17,288,215,597,1549,11,863,323,1456,7354
1796.58,17,448,39896,403,35,4469,288,25676,45,288,40016,288,14220
21.809,6,36,8455,17,410,542,882,1942,19,441,1204,1440,6513
1798.146,6,356,22520,208,69,8686,69,12460,148,69,12232,69,10060
3.581,6,36,6443,20,135,188,267,1894,16,650,233,1420,4549
1799.656,17,4196,201408,2098,20,858,20,100704,2098,20,858,20,100704
71.271,17,4,304,4,48,23757,48,304,0,0,0,0,0
1773.356,6,181,15589,120,69,14902,69,8940,61,69,29547,69,6649
1696.81,1,8,848,8,78,242401,78,848,0,0,0,0,0
1.009,17,4,308,2,33,1000,33,122,2,65,1001,65,186
9.875,17,2,112,2,28,9875,28,112,0,0,0,0,0
592.264,1,26,1456,26,28,23690,28,1456,0,0,0,0,0
1794.551,6,407,36961,236,148,7636,485,19540,171,127,10555,453,17421
9.821,6,48,18013,25,525,409,1440,3778,23,947,418,1440,14235
0.445,6,10,1669,6,551,89,947,1346,4,159,148,159,323
1767.798,6,99,7531,64,40,28060,205,4655,35,33,51986,98,2876
63.009,6,191,163207,79,741,805,1448,14495,112,1428,566,5792,148712
1795.618,17,346,46437,170,183,10624,1350,35929,176,31,10260,61,10508
10.692,6,115,86856,48,131,227,232,2449,67,1361,161,1430,84407
45.143,17,46,6644,23,48,2051,48,1748,23,184,2051,308,4896
8.191,6,17,2961,11,173,819,245,1310,6,1407,1585,1407,1651
300.713,6,38,9783,21,571,15035,1360,4301,17,435,534,2667,5482
29.284,6,37,9546,17,289,1830,721,3293,20,605,1487,1440,6253
4.497,6,34,6169,18,206,264,314,2784,16,548,282,1179,3385
1788.178,1,342,28728,342,56,5243,56,28728,0,0,0,0,0
39.02,1,45,4680,0,0,0,0,0,45,76,886,76,4680
5.504,6,42,7389,22,218,262,314,3503,20,440,276,1152,3886
12.246,17,12,1297,10,33,1360,33,610,2,315,1,327,687
1794.861,6,117,7589,68,49,26788,208,4637,49,31,37386,31,2952
4.194,17,5,290,5,30,1048,30,290,0,0,0,0,0
15.406,6,5,240,1,0,0,0,48,4,0,5132,0,192
61.424,6,36,15864,22,798,2924,1448,9138,14,748,4701,2359,6726
1.21,6,4,184,2,0,1210,0,88,2,0,1027,0,96
1763.991,2,14,448,14,8,135691,8,448,0,0,0,0,0
31.744,6,7,308,1,0,0,0,44,6,0,6286,0,264
0.206,17,4,1148,2,32,192,32,120,2,486,108,486,1028
1.959,6,40,10345,21,492,97,1440,4809,19,433,96,1440,5536
1797.695,17,448,39896,403,35,4471,288,25676,45,288,40016,288,14220
1775.687,17,304,49462,304,134,5860,366,49462,0,0,0,0,0
0.127,1,2,112,2,28,127,28,112,0,0,0,0,0
0.095,6,12,1843,7,138,15,138,510,5,532,12,891,1333
142.854,6,9,503,2,0,15634,0,112,7,7,23760,7,391
0.049,6,9,1342,5,145,12,145,349,4,829,13,829,993
4.912,6,40,7309,19,218,272,314,3383,21,513,229,1179,3926
1.3,6,42,10602,21,514,65,1460,4986,21,433,55,1460,5616
144.391,17,4,240,2,32,144390,32,120,2,32,144390,32,120
30.873,6,49,10455,23,533,694,910,3147,26,312,1229,1460,7308
1134.231,2,11,352,11,8,113423,8,352,0,0,0,0,0
0.011,6,20,10009,12,125,1,125,781,8,2201,1,4344,9228
11.601,6,25,8473,13,275,966,275,1078,12,986,763,1440,7395
33.901,6,37,9527,19,642,494,1360,4005,18,435,1983,2667,5522
205.406,6,30,7432,13,158,17117,267,1317,17,543,12835,1400,6115
1769.502,6,114,10304,69,65,26022,65,5875,45,59,40212,59,4429
0.041,6,2,92,2,0,0,0,92,0,0,0,0,0
6.198,2,2,64,2,8,6198,8,64,0,0,0,0,0
280.523,6,30,7432,13,158,23376,267,1317,17,543,17529,1400,6115
1786.408,6,110,8816,70,66,25889,66,5176,40,60,45802,60,3640
1746.465,17,187,47642,187,226,9389,422,47642,0,0,0,0,0
0.356,6,29,9185,14,261,27,683,1780,15,943,24,1408,7405
252.194,2,3,96,3,8,126097,8,96,0,0,0,0,0
1.491,6,47,19230,27,895,57,1460,13654,20,476,68,2615,5576
1777.142,17,138,11040,69,48,26133,48,5244,69,56,26134,56,5796
1682.756,17,14,1036,7,30,280451,30,406,7,62,280450,62,630
661.351,6,115,38961,58,602,11602,1460,22921,57,597,11806,1460,16040
18.502,17,49,17535,22,474,879,1350,11060,27,211,710,1350,6475
1.113,17,18,6937,10,424,120,1350,4524,8,273,154,1350,2413
1745.481,1,56,4704,0,0,0,0,0,56,56,31736,56,4704
290.406,1,8,448,8,28,41486,28,448,0,0,0,0,0
0.016,17,2,306,1,33,0,33,61,1,217,0,217,245
3.789,6,13,3116,8,49,541,92,523,5,1164,900,1448,2593
1781.099,6,354,22440,207,69,8646,69,12420,147,69,12199,69,10020
15.135,17,24,5948,10,256,1676,1350,2848,14,193,1160,1350,3100
2.316,17,2,778,2,361,2316,361,778,0,0,0,0,0
219.699,1,50,6534,46,109,4882,173,6310,4,28,59004,28,224
1773.093,6,180,15480,120,69,14899,69,8940,60,69,30046,69,6540
1795.308,17,80,3354,79,14,23016,14,3318,1,8,0,8,36
1.356,6,51,20420,30,901,46,1360,14759,21,480,58,4075,5661
210.924,6,699,602574,455,1327,464,1360,585035,244,209,867,2667,17539
0.089,17,2,260,1,61,0,61,89,1,143,0,143,171
1790.928,17,767,46243,767,32,2338,37,46243,0,0,0,0,0
1795.469,6,240,35580,150,302,12050,302,25920,90,83,20173,83,9660
0.963,6,20,9674,12,410,87,922,1742,8,1520,112,4416,7932
0.681,17,4,580,2,40,618,40,136,2,194,488,194,444
3.994,17,3,183,3,33,1997,33,183,0,0,0,0,0
3.801,6,33,14867,14,231,292,669,1916,19,1085,209,1438,12951
1779.108,6,82,4406,42,26,43391,26,2262,40,26,45617,26,2144
15.026,6,14,1025,7,222,2503,222,506,7,231,2502,231,519
180.443,2,4,128,4,8,60147,8,128,0,0,0,0,0
11.721,6,1843,1612726,1139,1362,10,1380,1580324,704,421,16,1923,32402
1745.653,6,97,7307,63,38,28155,205,4476,34,33,52887,98,2831
1790.624,6,354,22440,207,69,8692,69,12420,147,69,12264,69,10020
373.765,6,21,1419,15,177,26697,177,989,6,110,12250,110,430
0.369,6,3,199,1,31,0,31,83,2,0,369,0,116
1795.292,17,140,11200,70,48,26018,48,5320,70,56,26018,56,5880
1740.593,17,30,7050,30,207,60020,207,7050,0,0,0,0,0
0.02,17,3,451,2,39,6,39,134,1,289,0,289,317
110.034,17,4,352,2,60,110033,60,176,2,60,110033,60,176
1799.962,17,140,11200,70,48,26086,48,5320,70,56,26086,56,5880
358.284,6,16,1184,12,226,32571,226,858,4,110,20095,110,326
1784.143,6,106,8574,70,65,25857,65,5010,36,59,50972,59,3564
300.482,6,40,29177,22,190,14308,444,1913,18,2024,14132,7010,27264
38.746,1,44,4576,0,0,0,0,0,44,76,901,76,4576
1744.697,2,30,960,30,8,60161,8,960,0,0,0,0,0
1680.433,17,29,6815,29,207,60015,207,6815,0,0,0,0,0
0.156,17,2,245,1,32,0,32,60,1,157,0,157,185
367.341,6,23,1535,16,177,24489,177,1053,7,110,10361,110,482
74.756,6,31,9819,17,520,48,954,2853,14,639,5740,4080,6966
1745.674,2,29,928,29,8,62345,8,928,0,0,0,0,0
4.594,6,39,7269,20,218,241,314,3423,19,513,241,1179,3846
252.606,2,3,96,3,8,126303,8,96,0,0,0,0,0
7.753,17,6,528,3,48,3863,48,228,3,72,3870,72,300
5.068,6,35,6225,18,206,298,314,2784,17,551,301,1179,3441
253.143,17,4,514,2,36,253138,36,128,2,165,253138,187,386
1.078,6,24,8016,12,164,83,267,1300,12,1014,83,2816,6716
1772.837,6,182,15698,120,69,14897,69,8940,62,69,29058,69,6758
1772.82,6,180,15480,120,69,14897,69,8940,60,69,30043,69,6540
9.481,6,67,20166,35,562,278,1152,15459,32,489,297,1179,4707
4.983,17,5,4754,5,922,1245,1451,4754,0,0,0,0,0
1681.341,17,14,1036,7,30,280221,30,406,7,62,280221,62,630
0.629,17,12,7180,6,654,125,1350,4094,6,486,90,1350,3086
1348.843,6,315,18879,157,69,8646,69,9454,158,34,8591,48,9425
0.457,6,20,7238,12,335,41,668,1974,8,1210,64,1906,5264
1770.152,6,200,13888,72,46,24929,46,5824,128,46,13938,46,8064
0.141,17,2,144,1,36,0,36,64,1,52,0,52,80
240.249,6,54,17951,29,785,8580,1408,14875,25,221,10010,580,3076
37.506,6,28,7352,13,158,3125,267,1317,15,678,2677,2800,6035
0.689,6,6,248,4,0,229,0,164,2,0,201,0,84
0.147,17,2,290,1,40,0,40,68,1,194,0,194,222
1.812,6,28,8989,17,367,113,833,1785,11,965,172,1420,7204
2.731,6,13,1204,8,181,390,181,782,5,77,336,133,422
1777.394,1,64,5376,64,56,28212,56,5376,0,0,0,0,0
0.123,6,12,1948,7,329,20,500,1030,5,650,30,650,918
1793.873,17,66,2766,65,14,28029,14,2730,1,8,0,8,36
1743.26,6,146,9351,80,51,22066,208,5843,66,31,26816,31,3508
0.055,17,4,588,2,48,50,48,152,2,190,47,308,436
0.032,6,16,6004,8,88,4,88,452,8,1305,4,1880,5552
125.917,6,11,1727,5,100,126,100,304,6,1179,25135,1179,1423
1787.434,6,102,8296,68,65,26678,65,4930,34,59,54160,59,3366
0.416,6,5,1564,3,413,208,413,946,2,269,187,269,618
1797.184,17,448,39896,403,35,4470,288,25676,45,288,40021,288,14220
0.007,17,2,429,1,34,0,34,62,1,339,0,339,367
360.984,2,5,160,5,8,90246,8,160,0,0,0,0,0
1799.189,17,449,39928,404,35,4464,288,25708,45,288,40021,288,14220
5.75,6,699,579279,413,1329,13,1368,559743,286,776,19,2736,19536
1769.274,6,100,9223,67,63,26807,63,5626,33,57,55282,57,3597
1798.479,17,144,11520,72,48,25330,48,5472,72,56,25330,56,6048
0.312,6,20,4960,10,137,34,267,1092,10,692,33,1467,3868
0.97,17,2,464,2,204,970,204,464,0,0,0,0,0
23.632,17,4,352,2,60,23631,60,176,2,60,23631,60,176
0.307,6,30,6370,15,181,21,537,1694,15,486,21,1408,4676
32.015,6,6,360,0,0,0,0,0,6,0,0,0,360
0.328,17,4,420,2,33,309,33,122,2,121,307,145,298
0.104,6,9,1339,5,145,26,145,349,4,826,28,826,990
206.398,17,3,219,3,45,103199,45,219,0,0,0,0,0
0.806,6,28,7336,13,155,67,267,1301,15,543,52,1400,6035
11.874,17,8,608,8,48,1696,48,608,0,0,0,0,0
1779.35,1,262,14672,262,28,6817,28,14672,0,0,0,0,0
65.463,17,4,352,2,60,65462,60,176,2,60,65462,60,176
0.133,6,10,766,5,185,31,185,453,5,45,33,45,313
2.833,6,30,7496,14,161,217,267,1531,16,760,184,1420,5965
241.268,17,4,240,2,32,241267,32,120,2,32,241267,32,120
1.321,6,45,18084,26,882,52,1360,12548,19,529,62,4075,5536
1.95,6,30,6111,16,142,130,267,1646,14,650,127,1452,4465
1.768,6,5,262,4,31,309,31,222,1,0,0,0,40
0.221,6,43,17935,24,997,9,1420,12954,19,467,11,1883,4981
1.393,6,35,8275,18,363,81,774,1842,17,521,78,3488,6433
22.835,6,14,2242,8,210,3261,210,844,6,545,4563,904,1398
0.15,17,2,144,1,36,0,36,64,1,52,0,52,80
13.133,6,21,6825,12,275,1193,275,1038,9,1353,1015,1440,5787
1799.005,17,444,39200,400,35,4508,288,25296,44,288,40948,288,13904
1772.739,6,281,33513,115,134,15549,1440,16305,166,128,10743,1702,17208
690.993,1,12,672,12,28,62817,28,672,0,0,0,0,0
4.0,17,2,122,2,33,4000,33,122,0,0,0,0,0
6.219,6,1599,1443408,984,1386,6,1408,1406764,615,931,9,2801,36644
1796.16,17,1056,335848,514,558,3501,1350,301582,542,35,3320,1350,34266
187.424,1,12,672,12,28,17038,28,672,0,0,0,0,0
20.47,6,20,3130,12,183,1860,517,1561,8,381,2922,499,1569
1795.204,6,762,51706,380,31,4736,31,25960,382,31,4710,31,25746
1800.0,6,230,28273,88,139,20344,1360,13571,142,125,12765,2459,14702
20.119,6,18,2368,10,189,2235,517,1298,8,323,2873,499,1070
240.098,6,50,29413,26,183,9603,517,2482,24,1975,10438,7040,26931
45.009,6,28,7217,13,155,3750,267,1306,15,482,3214,2840,5911
113.054,6,123,90355,76,1263,1507,1408,79789,47,811,1625,3847,10566
1778.497,17,142,11360,71,48,25407,48,5396,71,56,25407,56,5964
0.287,6,20,7229,12,334,25,663,1969,8,1209,39,1906,5260
716.269,1,20,1120,20,28,37698,28,1120,0,0,0,0,0
0.533,6,26,9012,13,252,44,646,1694,13,947,42,1438,7318
4.237,17,10,629,5,31,1053,31,295,5,38,1053,70,334
0.408,6,26,9026,13,263,34,691,1736,13,943,32,1448,7290
1783.196,1,339,28476,339,56,5275,56,28476,0,0,0,0,0
1483.883,6,77,5647,46,31,32975,31,3105,31,31,45816,31,2542
0.814,6,28,5967,13,156,67,267,1462,15,650,52,1452,4505
13.122,6,19,4402,9,275,1640,275,918,10,768,1404,1440,3484
1776.27,17,128,10240,64,48,28194,48,4864,64,56,28194,56,5376
0.534,17,2,384,1,39,0,39,67,1,289,0,289,317
0.04,17,2,152,1,48,0,48,76,1,48,0,48,76
240.781,6,49,10589,22,201,11460,517,2760,27,491,9253,1497,7829
1772.254,6,180,15480,120,69,14892,69,8940,60,69,30034,69,6540
0.018,6,18,6108,10,88,1,88,556,8,1305,2,1880,5552
1793.572,17,87,3648,86,14,21100,14,3612,1,8,0,8,36
80.337,6,34,10579,12,156,176,267,1272,22,495,3825,1420,9307
0.25,6,25,6032,12,164,22,453,1442,13,651,20,1402,4590
1755.505,6,273,40258,165,302,10704,302,28906,108,83,16403,83,11352
0.022,6,10,1369,5,134,5,134,402,5,351,5,380,967
1795.036,6,133,12862,81,59,22437,722,6609,52,88,35187,1448,6253
94.868,6,22,8570,11,333,74,692,1473,11,949,9472,1440,7097
1742.92,2,29,928,29,8,62247,8,928,0,0,0,0,0
4.417,6,23,4490,12,213,401,597,1701,11,441,422,1408,2789
105.263,17,3,1000,3,305,52631,308,1000,0,0,0,0,0
36.66,17,16,2352,8,48,5236,48,608,8,190,5235,308,1744
0.769,6,10,924,5,283,149,283,551,5,105,148,105,373
123.538,6,32,8952,14,158,9502,267,1357,18,624,7264,1400,7595
1777.294,17,73,3060,72,14,25032,14,3024,1,8,0,8,36
198.642,6,34,10093,12,258,67,486,1287,22,527,9452,1460,8806
1.601,6,11,1727,7,100,266,100,384,4,589,448,1152,1343
1681.368,17,27,6345,27,207,64668,207,6345,0,0,0,0,0
0.056,17,2,146,1,37,0,37,65,1,53,0,53,81
119.405,6,114,49440,62,806,23,1360,36395,52,365,2338,2720,13045
0.007,6,31,46488,1,0,0,0,40,30,1496,0,2896,46448
92.386,17,4,352,2,60,92385,60,176,2,60,92385,60,176
61.376,17,4,352,2,60,61375,60,176,2,60,61375,60,176
248.117,6,27,5317,17,156,15507,516,1938,10,425,25383,1452,3379
0.42,6,10,968,5,256,101,256,460,5,304,101,304,508
0.795,6,10,1687,7,100,132,100,384,3,1179,268,1179,1303
41.458,17,3,228,3,48,20729,48,228,0,0,0,0,0
0.277,6,5,260,3,0,45,0,156,2,0,0,0,104
0.0,6,2,104,2,0,0,0,104,0,0,0,0,0
1114.272,6,66,5032,42,42,27177,205,3031,24,34,48436,98,2001
3.78,17,5,290,5,30,945,30,290,0,0,0,0,0
1681.261,17,14,1045,7,30,280206,30,406,7,63,280207,71,639
19.094,6,20,2605,10,211,2121,211,998,10,545,2121,904,1607
57.346,6,14,2195,8,329,8192,595,1083,6,396,11467,580,1112
1745.721,6,211,25809,106,80,16625,721,9665,105,284,16783,2840,16144
0.042,17,4,608,2,60,12,60,176,2,188,0,188,432
1.161,17,4,566,2,31,1145,31,118,2,196,1120,196,448
3.231,17,19,7150,9,477,403,1350,4548,10,232,355,1350,2602
5.03,17,4,288,2,36,4999,36,128,2,52,4998,52,160
1.222,6,25,8068,12,164,94,267,1300,13,869,86,1408,6768
1795.863,17,327,79068,327,213,5508,422,79068,0,0,0,0,0
33.625,6,27,4166,13,72,2802,92,1034,14,342,2571,1408,3132
1799.664,17,449,39928,404,35,4465,288,25708,45,288,40020,288,14220
3.852,1,8,672,8,56,550,56,672,0,0,0,0,0
1789.952,6,375,26508,216,104,8325,469,15663,159,69,11328,69,10845
1788.045,6,123,14275,78,82,23221,516,6184,45,161,40635,1452,8091
1772.147,6,180,15480,120,69,14891,69,8940,60,69,30034,69,6540
1798.794,17,448,39896,403,35,4474,288,25676,45,288,40022,288,14220
0.325,17,2,304,1,60,0,60,88,1,188,0,188,216
2.96,17,2,1430,2,687,2960,687,1430,0,0,0,0,0
20.918,6,3037,2854053,1978,1365,10,1408,2794321,1059,931,19,2816,59732
0.192,1,2,163,2,53,192,78,163,0,0,0,0,0
1786.35,6,154,19574,92,302,19630,302,13852,62,83,29284,83,5722
0.177,6,9,1346,5,145,44,145,349,4,833,52,833,997
0.198,17,2,235,1,36,0,36,64,1,143,0,143,171
280.421,6,23,7014,11,181,28042,267,1168,12,766,25489,2760,5846
38.084,6,32,7773,10,149,539,267,1303,22,348,1813,1420,6470
1772.567,6,180,15480,120,69,14895,69,8940,60,69,30041,69,6540
21.029,6,23,2758,13,210,1742,210,1120,10,545,2226,904,1638
2.235,6,13,2311,8,188,319,245,700,5,1407,493,1407,1611
1.778,6,25,8705,15,275,127,558,1430,10,981,175,1420,7275
0.478,6,13,1693,7,288,78,288,588,6,426,54,434,1105
3.392,6,62,63736,35,735,99,1360,5109,27,2739,125,12240,58627
13.38,6,10,726,3,106,6690,106,234,7,90,2202,90,492
1787.531,6,390,32439,223,104,8051,469,16239,167,133,10768,3417,16200
24.676,1,3,168,3,28,12338,28,168,0,0,0,0,0
4.777,6,37,7205,19,218,265,314,3383,18,516,266,1179,3822
139.081,17,3,181,3,32,69540,33,181,0,0,0,0,0
1795.395,17,448,39612,404,35,4455,288,25708,44,288,40948,288,13904
10.734,6,20,4442,11,275,1073,275,998,9,768,745,1440,3444
0.033,6,6,897,3,483,9,483,639,3,102,7,102,258
1789.956,6,359,22709,209,69,8605,69,12569,150,69,12013,69,10140
0.107,17,2,572,1,39,0,39,67,1,477,0,477,505
29.42,6,14,5716,4,106,9806,106,274,10,718,3240,1460,5442
1794.669,6,356,22520,208,69,8669,69,12460,148,69,12208,69,10060
3.069,17,4,332,2,47,3062,47,150,2,63,3062,63,182
223.013,6,136,106440,88,1267,2563,1368,95819,48,737,1561,2519,10621
82.485,6,10403,9687459,6460,1414,12,1448,9464236,3943,669,20,1448,223223
1045.522,6,134,16356,81,80,13069,267,6372,53,160,20105,1452,9984
0.652,6,14,1745,7,288,74,288,600,7,426,75,434,1145
1790.589,6,355,22480,207,69,8692,69,12420,148,69,12180,69,10060
61.011,6,15,1666,9,180,7626,180,1016,6,110,12159,110,650
15.281,6,8,440,5,0,3820,0,268,3,0,7425,0,172
7.301,6,6,280,2,0,7301,0,88,4,0,2430,0,192
0.038,17,4,352,2,37,31,37,130,2,83,31,89,222
300.689,6,38,8566,20,315,15825,882,2093,18,441,501,1440,6473
280.536,6,28,7352,12,158,25503,267,1277,16,678,18699,2760,6075
0.101,17,2,154,1,33,0,33,61,1,65,0,65,93
59.566,6,49,11671,24,615,399,921,4106,25,344,2475,2128,7565
0.043,17,4,284,2,32,20,32,120,2,54,26,60,164
1741.176,6,88,6405,59,31,30020,31,3998,29,31,62179,31,2407
1.345,6,41,8431,21,321,67,1164,2810,20,400,61,1360,5621
0.47,6,10,1185,6,279,94,279,587,4,191,60,272,598
1795.034,1,223,23638,223,78,8085,78,23638,0,0,0,0,0
17.02,6,93,26921,46,519,378,1152,20559,47,447,363,1179,6362
1771.491,6,99,9306,66,66,27253,66,5610,33,60,55356,60,3696
2.949,17,2,136,1,32,0,32,60,1,48,0,48,76
1776.068,1,58,4872,58,56,31159,56,4872,0,0,0,0,0
4.089,6,3383,3149304,1770,201,2,230,95685,1613,1843,2,14080,3053619
1781.961,6,356,22796,205,69,8735,69,12340,151,69,11879,69,10456
0.709,17,19,9467,10,437,75,1350,4654,9,506,84,1350,4813
0.882,17,2,122,2,33,882,33,122,0,0,0,0,0
0.051,17,2,472,1,60,0,60,88,1,356,0,356,384
10.006,6,672,499098,335,286,29,286,21206,337,1374,29,2736,477892
0.425,6,13,1693,7,288,70,288,588,6,426,48,434,1105
0.326,17,2,152,1,48,0,48,76,1,48,0,48,76
1680.759,1,15,840,15,28,120054,28,840,0,0,0,0,0
0.355,17,2,136,1,32,0,32,60,1,48,0,48,76
95.669,6,38,20463,21,559,56,1029,3121,17,1280,5971,5440,17342
0.829,6,27,5927,13,156,69,267,1462,14,650,57,1452,4465
240.418,6,55,18236,29,811,8585,1418,15319,26,194,9616,580,2917
1793.06,1,190,12600,190,56,9487,56,12600,0,0,0,0,0
300.883,6,50,10526,25,433,12536,910,3258,25,312,538,1460,7268
0.036,17,4,352,2,37,0,37,130,2,83,11,89,222
1790.889,6,123,12307,77,62,23564,722,6402,46,94,39791,1440,5905
0.072,6,10,1495,5,507,18,507,727,5,556,18,556,768
280.44,6,32,7512,13,158,23370,267,1317,19,543,15578,1380,6195
15.106,6,23,3280,10,266,450,517,1602,13,493,1258,828,1678
23.08,6,24,4089,13,234,1923,564,1640,11,463,1948,1343,2449
6.432,6,40,7309,20,218,338,314,3423,20,513,323,1179,3886
0.208,17,8,2766,8,317,29,356,2766,0,0,0,0,0
13.464,6,21,6825,12,275,1224,275,1038,9,1353,1057,1440,5787
318.956,6,50,20826,26,666,12758,666,2692,24,1205,13853,1448,18134
0.314,17,2,198,1,39,0,39,67,1,103,0,103,131
1799.783,17,142,11360,71,48,25711,48,5396,71,56,25711,56,5964
378.241,2,4,128,4,8,126080,8,128,0,0,0,0,0
2.292,6,13,2311,8,188,327,245,700,5,1407,509,1407,1611
0.219,6,45,21269,26,1087,8,1420,16288,19,467,11,1883,4981
3.17,17,3,1176,3,364,1585,364,1176,0,0,0,0,0
0.023,17,2,382,1,32,0,32,60,1,294,0,294,322
1768.367,1,58,4872,0,0,0,0,0,58,56,31023,56,4872
11.42,6,37,13039,19,440,634,721,2966,18,849,546,2007,10073
1.003,17,2,685,1,308,0,308,336,1,321,0,321,349
25.304,6,649,536433,381,1428,66,1460,518101,268,205,94,2567,18332
0.388,6,10,1992,5,288,93,288,508,5,424,52,434,1484
191.475,6,10,562,3,106,95730,106,234,7,0,31911,0,328
1759.514,6,96,6262,61,47,29325,208,3963,35,31,51741,31,2299
0.464,6,8,820,4,302,151,302,510,4,102,151,102,310
295.137,6,45,13071,20,777,15524,1360,7052,25,278,12290,2667,6019
367.377,6,23,1535,16,177,24491,177,1053,7,110,10361,110,482
300.636,6,37,8527,19,315,16702,882,2053,18,441,499,1440,6474
0.52,17,3,451,2,39,85,39,134,1,289,0,289,317
0.201,17,2,180,1,30,0,30,58,1,94,0,94,122
1745.835,6,95,7203,63,38,28158,205,4476,32,33,56307,98,2727
1.345,6,50,21001,28,946,49,1360,15345,22,433,56,1360,5656
0.273,17,4,680,2,33,265,33,122,2,251,184,323,558
26.306,6,44,13574,21,330,1315,721,3158,23,730,1187,2840,10416
1793.07,6,524,66371,299,227,6017,485,33326,225,178,8004,1753,33045
0.102,17,8,2454,8,278,14,317,2454,0,0,0,0,0
5.001,17,4,288,2,36,4985,36,128,2,52,4988,52,160
6.343,6,8,835,6,169,1268,245,751,2,0,5231,0,84
630.409,2,4,128,4,8,210136,8,128,0,0,0,0,0
0.487,6,12,1304,6,256,94,256,756,6,304,94,304,548
1701.47,1,66,6996,66,78,26176,78,6996,0,0,0,0,0
0.352,17,2,180,1,30,0,30,58,1,94,0,94,122
10.624,6,1692,1470638,1024,1382,10,1420,1439697,668,526,15,3303,30941
14.537,17,3,195,3,37,7268,47,195,0,0,0,0,0
1783.701,6,356,22520,208,69,8616,69,12460,148,69,12132,69,10060
1740.439,17,30,7050,30,207,60015,207,7050,0,0,0,0,0
1.378,6,25,8056,12,164,107,267,1288,13,1014,98,2736,6768
1778.216,17,137,10948,70,48,25770,48,5320,67,56,25602,56,5628
125.955,2,2,64,2,8,125955,8,64,0,0,0,0,0
1793.333,17,178,13884,178,50,10131,50,13884,0,0,0,0,0
353.533,6,28,6515,11,216,5469,501,1310,17,322,22090,1420,5205
0.016,17,2,162,1,36,0,36,64,1,70,0,70,98
1770.141,6,101,9344,66,65,27232,65,5577,35,59,52060,59,3767
1788.165,6,27,4077,18,241,105186,241,2889,9,92,223498,92,1188
0.092,6,12,3705,6,171,14,171,491,6,964,18,1448,3214
312.23,17,11,3696,11,308,31223,308,3696,0,0,0,0,0
22.081,6,36,8360,18,378,513,786,1886,18,478,1289,2128,6474
1786.498,6,104,8308,68,64,26664,64,4896,36,58,51040,58,3412
1779.41,17,140,11200,70,48,25788,48,5320,70,56,25788,56,5880
10.194,6,85,24621,43,550,242,1152,18800,42,459,241,1179,5821
1.135,6,17,3583,9,288,130,288,692,8,639,137,853,2891
1770.459,6,99,9306,66,66,27237,66,5610,33,60,55321,60,3696
1798.356,17,448,39896,403,35,4473,288,25676,45,288,40022,288,14220
1786.922,6,356,22520,208,69,8632,69,12460,148,69,12155,69,10060
0.003,6,4,191,1,0,0,0,40,3,31,0,31,151
40.736,6,32,8952,14,158,3133,267,1357,18,624,2394,1300,7595
0.625,6,700,534333,351,183,1,230,20585,349,1428,1,5632,513748
0.011,17,2,442,1,67,0,67,95,1,319,0,319,347
140.784,6,28,11021,13,663,71,1360,3229,15,797,10044,1360,7792
7.383,6,1093,1004592,718,1360,10,1380,985305,375,387,19,1923,19287
0.615,6,15,1785,8,288,63,288,640,7,426,73,434,1145
0.251,17,2,465,2,204,251,360,465,0,0,0,0,0
15.335,6,6,288,1,0,0,0,48,5,0,3828,0,240
286.877,17,4,352,2,60,286876,60,176,2,60,286876,60,176
4.208,17,5,290,5,30,1052,30,290,0,0,0,0,0
61.424,17,4,352,2,60,61423,60,176,2,60,61423,60,176
4.223,6,38,10629,18,126,248,517,2141,20,572,133,1510,8488
0.394,6,12,1653,6,288,76,288,548,6,426,46,434,1105
0.012,17,2,251,1,36,0,36,64,1,159,0,159,187
0.618,6,3,182,1,0,0,0,40,2,31,608,31,142
1788.43,1,55,4620,55,56,33119,56,4620,0,0,0,0,0
220.074,17,4,240,2,32,220073,32,120,2,32,220073,32,120
0.003,6,2,123,1,0,0,0,40,1,31,0,31,83
1.345,6,47,19574,27,920,51,1360,13998,20,476,61,2715,5576
90.695,6,23,9823,12,410,55,922,1742,11,1089,9056,2720,8081
1784.991,17,142,11360,71,48,25499,48,5396,71,56,25499,56,5964
1799.942,6,355,22480,207,69,8737,69,12420,148,69,12244,69,10060
58.515,6,10,748,7,92,9752,92,556,3,0,2312,0,192
0.025,6,13,3980,7,88,4,88,388,6,1670,4,1880,3592
157.813,1,4,240,4,32,52604,32,240,0,0,0,0,0
88.396,6,25,10447,13,721,1613,1309,3437,12,931,8019,1591,7010
1755.135,1,40,4616,40,87,45003,105,4616,0,0,0,0,0
1750.519,17,12,498,11,14,175051,14,462,1,8,0,8,36
10.383,6,12,945,6,222,2074,222,466,6,231,2074,231,479
120.222,6,17,2043,10,302,13358,302,1422,7,83,20018,83,621
299.126,1,4,224,4,28,99708,28,224,0,0,0,0,0
280.05,6,29,7392,13,158,23337,267,1317,16,603,18666,2036,6075
0.207,1,2,112,2,28,207,28,112,0,0,0,0,0
1774.475,6,180,15480,120,69,14911,69,8940,60,69,30074,69,6540
54.543,17,4,352,2,60,54542,60,176,2,60,54542,60,176
149.826,6,161,131022,107,1285,1413,1408,118702,54,731,2588,3847,12320
230.333,6,70,11091,35,143,6774,721,3979,35,317,6769,1440,7112
18.294,6,3092,2866914,1979,1369,9,1408,2804374,1113,931,16,2801,62540
1787.912,6,102,8296,68,65,26685,65,4930,34,59,54176,59,3366
0.375,17,2,472,1,60,0,60,88,1,356,0,356,384
1741.282,17,30,31680,30,1028,60044,1028,31680,0,0,0,0,0
3.188,17,2,656,2,300,3188,300,656,0,0,0,0,0
298.857,1,4,224,4,28,99619,28,224,0,0,0,0,0
1011.359,6,88,9699,48,82,21518,721,4397,40,103,23874,1448,5302
301.998,6,65,27268,36,1148,8628,1460,21046,29,336,428,1460,6222
240.324,6,46,9171,24,524,10448,1418,5972,22,227,11443,639,3199
280.228,6,25,7094,11,181,28022,267,1168,14,595,21554,1400,5926
1728.172,1,8,448,8,28,246881,28,448,0,0,0,0,0
389.265,6,28,1819,18,177,22897,177,1181,10,110,8169,110,638
1770.619,6,99,9306,66,66,27240,66,5610,33,60,55329,60,3696
1776.285,17,73,3060,72,14,25018,14,3024,1,8,0,8,36
5.37,1,3,252,3,56,2685,56,252,0,0,0,0,0
1699.397,17,12,498,11,14,169939,14,462,1,8,0,8,36
1782.809,17,142,11360,71,48,25468,48,5396,71,56,25468,56,5964
15.481,17,17,6518,8,484,2199,1350,4098,9,240,1924,1350,2420
1770.223,6,107,9863,68,65,26421,65,5758,39,59,46582,59,4105
488.025,6,9,546,6,31,97605,31,333,3,31,244006,31,213
280.24,17,4,296,2,30,280227,30,116,2,62,280227,62,180
86.062,6,40,9696,16,290,2296,1189,2684,24,402,3741,3377,7012
1799.512,1,56,4704,0,0,0,0,0,56,56,32718,56,4704
1.006,17,2,685,1,308,0,308,336,1,321,0,321,349
1786.325,17,85,3564,84,14,21517,14,3528,1,8,0,8,36
1770.557,6,109,10186,70,66,25660,66,5974,39,60,46591,60,4212
2.847,17,2,204,1,34,0,34,62,1,114,0,114,142
125.889,6,29,13167,14,488,387,1440,3035,15,1057,8982,1440,10132
0.146,6,12,3462,6,75,29,75,395,6,1373,29,1448,3067
240.14,6,48,8085,25,139,10005,346,2166,23,428,10915,1408,5919
0.012,17,2,309,1,37,0,37,65,1,216,0,216,244
0.751,6,23,5715,13,158,62,370,1315,10,999,82,1731,4400
1.199,17,2,152,1,48,0,48,76,1,48,0,48,76
0.05,17,4,284,2,32,44,32,120,2,54,44,60,164
1796.876,17,448,39896,403,35,4469,288,25676,45,288,40019,288,14220
5.032,6,36,6249,19,206,279,314,2824,17,548,297,1179,3425
1706.332,1,8,448,8,28,243761,28,448,0,0,0,0,0
115.43,6,48,13476,23,934,575,1360,7550,25,307,4801,1360,5926
27.533,6,21,11964,4,214,2806,214,406,17,1207,1712,1702,11558
280.909,6,25,7435,11,181,28090,267,1168,14,633,21605,2036,6267
317.075,6,59,12827,29,163,11324,684,3642,30,398,10928,4649,9185
8.192,6,18,6767,9,275,1024,275,643,9,1150,922,1414,6124
0.018,6,4,270,2,31,0,31,135,2,31,0,31,135
16.532,1,8,832,0,0,0,0,0,8,76,2361,76,832
1.108,6,16,2678,8,288,141,288,640,8,568,133,853,2038
0.005,17,2,483,1,43,0,43,71,1,384,0,384,412
30.34,1,4,224,4,28,10113,28,224,0,0,0,0,0
580.002,6,49,9362,23,164,26360,517,2193,26,726,23197,2450,7169
1787.91,6,453,26400,245,69,7327,69,13940,208,34,8637,64,12460
0.177,17,2,378,1,42,0,42,70,1,280,0,280,308
1794.833,6,380,26180,164,46,10868,46,10594,216,46,8347,46,15586
5.026,17,4,288,2,36,4993,36,128,2,52,4994,52,160
0.083,17,2,144,1,36,0,36,64,1,52,0,52,80
1797.257,17,448,39896,403,35,4470,288,25676,45,288,40018,288,14220
1776.37,6,175,14935,116,69,15446,69,8573,59,69,30620,69,6362
1799.459,1,16,896,16,28,119963,28,896,0,0,0,0,0
1784.221,6,108,8700,68,64,26630,64,4896,40,58,45747,58,3804
0.137,17,4,368,2,32,122,32,120,2,96,116,96,248
1782.142,17,83,3480,82,14,22001,14,3444,1,8,0,8,36
1.942,17,27,9565,11,332,194,1350,3969,16,321,116,1350,5596
201.79,6,32,6905,16,203,13452,517,2063,16,571,13449,1408,4842
66.002,6,20,7162,11,321,6600,517,1223,9,910,8211,1408,5939
1.33,6,52,21678,29,924,47,1360,15982,23,476,52,2715,5696
300.942,6,50,10526,25,433,12539,910,3258,25,312,567,1460,7268
1.337,6,25,8056,12,164,104,267,1288,13,869,93,1448,6768
1796.227,17,443,38032,404,35,4457,288,25708,39,288,46336,288,12324
0.021,17,2,570,1,30,0,30,58,1,484,0,484,512
1795.441,17,449,39928,404,35,4455,288,25708,45,288,40021,288,14220
165.288,6,22,9754,12,410,52,922,1742,10,1266,18351,2720,8012
1797.686,1,339,28476,339,56,5318,56,28476,0,0,0,0,0
0.098,17,8,2446,8,277,14,316,2446,0,0,0,0,0
99.611,6,762,361861,401,838,249,1152,341234,361,412,275,1179,20627
1747.972,6,143,9586,79,54,22409,208,5729,64,38,27740,112,3857
53.484,17,4,352,2,60,53483,60,176,2,60,53483,60,176
16.306,17,22,5709,11,277,1627,1350,3365,11,185,1627,1350,2344
1770.505,1,96,5376,96,28,18636,28,5376,0,0,0,0,0
0.689,17,2,204,1,34,0,34,62,1,114,0,114,142
280.51,6,31,7813,14,158,21577,267,1357,17,577,17531,2036,6456
1786.766,6,105,8550,69,66,26275,66,5070,36,60,51043,60,3480
1772.349,6,180,15480,120,69,14893,69,8940,60,69,30033,69,6540
1.498,6,24,8004,12,164,114,267,1288,12,1014,113,2331,6716
0.025,17,2,254,1,34,0,34,62,1,164,0,164,192
0.297,17,2,179,1,43,0,43,71,1,80,0,80,108
1783.364,17,86,3606,85,14,21230,14,3570,1,8,0,8,36
0.214,17,4,284,2,32,102,32,120,2,54,114,60,164
1729.18,6,60,4400,40,33,44337,33,2740,20,31,90999,31,1660
1797.217,6,240,46440,150,483,12061,483,36780,90,83,20193,83,9660
0.199,6,44,18274,24,1022,8,1432,13253,20,420,9,1432,5021
9.124,2,2,64,2,8,9124,8,64,0,0,0,0,0
1644.754,1,8,448,8,28,234964,28,448,0,0,0,0,0
1.537,6,46,19081,27,888,59,1360,13545,19,476,74,2720,5536
0.186,17,2,2754,2,1349,186,1349,2754,0,0,0,0,0
0.566,6,13,1119,7,185,93,185,742,6,45,112,45,377
23.45,6,17,3951,5,151,5816,211,579,12,303,1298,2026,3372
1793.093,17,66,2766,65,14,28017,14,2730,1,8,0,8,36
1795.936,6,383,26704,219,97,8238,469,15659,164,69,11016,69,11045
1782.695,1,110,6160,110,28,16355,28,6160,0,0,0,0,0
88.607,1,69,7176,0,0,0,0,0,69,76,1303,76,7176
0.004,17,2,322,1,36,0,36,64,1,230,0,230,258
1798.544,2,27,864,27,8,69174,8,864,0,0,0,0,0
300.868,6,46,10280,24,433,13081,910,3194,22,364,730,2128,7086
152.47,6,11,478,3,0,76235,0,124,8,7,21243,7,354
12.964,6,24,6993,13,275,1080,275,1078,11,910,795,1440,5915
1408.536,6,143,12275,95,69,14984,69,7112,48,69,29968,69,5163
1793.095,1,342,28728,342,56,5258,56,28728,0,0,0,0,0
2.887,17,3,468,3,128,1443,128,468,0,0,0,0,0
0.023,17,4,352,2,60,22,60,176,2,60,22,60,176
11.465,6,26,11958,13,275,955,275,1078,13,1293,900,1414,10880
280.688,6,31,7563,14,158,21591,267,1357,17,552,17539,2036,6206
51.728,17,4,352,2,60,51726,60,176,2,60,51727,60,176
1740.304,6,87,6322,58,31,30531,31,3915,29,31,62152,31,2407
0.073,17,3,996,3,304,36,333,996,0,0,0,0,0
541.441,2,7,224,7,8,90240,8,224,0,0,0,0,0
1794.13,6,457,26629,248,69,7263,69,14129,209,34,8625,64,12500
31.992,1,12,1248,0,0,0,0,0,12,76,2908,76,1248
10.462,6,17,2425,9,211,1306,211,922,8,545,1493,904,1503
3.259,6,12,2271,7,188,543,245,660,5,1407,731,1407,1611
1159.265,6,72,5743,47,66,25201,66,3332,25,58,48298,60,2411
1785.855,6,360,22956,207,69,8669,69,12558,153,69,11749,69,10398
5.02,17,4,558,2,36,5006,36,128,2,187,5010,187,430
60.401,6,11,2994,6,92,12080,92,400,5,1165,15052,1408,2594
1.472,17,4,308,2,33,999,33,122,2,65,0,65,186
1.483,6,49,18669,26,915,59,1460,12973,23,433,57,1460,5696
38.726,17,44,6468,22,48,1843,48,1672,22,190,1843,308,4796
0.317,6,26,9017,13,261,26,683,1728,13,1100,25,2816,7289
0.445,17,3,1164,3,360,222,360,1164,0,0,0,0,0
55.284,6,28,7472,10,155,10,267,1186,18,397,3251,2006,6286
1.298,6,14,1084,8,181,185,181,601,6,77,40,134,483
72.378,6,81,13012,45,304,1644,304,9388,36,83,2051,83,3624
273.231,17,4,352,2,60,273230,60,176,2,60,273230,60,176
0.349,6,23,7397,13,334,28,663,2033,10,806,37,1408,5364
1797.628,17,449,39928,404,35,4460,288,25708,45,288,40022,288,14220
0.034,17,4,368,2,32,5,32,120,2,96,0,96,248
1.59,6,50,19099,27,877,61,1360,13403,23,433,63,1360,5696
0.546,6,23,7831,14,318,42,599,2021,9,1066,62,1906,5810
38.637,17,22,1672,22,48,1839,48,1672,0,0,0,0,0
4.934,6,6,324,1,0,0,0,52,5,0,980,0,272
3.349,6,5,284,3,0,1579,0,164,2,0,3164,0,120
1787.445,6,104,8376,68,65,26678,65,4930,36,59,51065,59,3446
1121.039,17,17,5748,17,310,70064,336,5748,0,0,0,0,0
0.029,6,10,860,6,181,5,181,489,4,77,7,134,371
1776.077,17,140,11200,70,48,25740,48,5320,70,56,25740,56,5880
1799.551,1,57,4788,0,0,0,0,0,57,56,32134,56,4788
0.437,17,3,511,2,39,432,39,134,1,349,0,349,377
2.707,17,2,384,1,39,0,39,67,1,289,0,289,317
1786.387,17,88,3684,86,14,21014,14,3612,2,8,1786211,8,72
1743.371,6,92,6985,61,38,29056,205,4341,31,33,58102,98,2644
5.45,6,5,224,3,0,2725,0,128,2,0,1028,0,96
1.661,17,6,1230,3,36,828,36,192,3,318,828,318,1038
91.92,6,17,5057,8,307,13106,722,1345,9,1084,11468,1408,3712
240.871,6,58,17929,31,779,8028,1418,14903,27,179,9263,580,3026
1794.756,17,142,11360,71,48,25639,48,5396,71,56,25639,56,5964
3.882,17,3,201,3,39,1941,39,201,0,0,0,0,0
0.258,6,23,4494,11,165,25,456,1394,12,493,22,888,3100
326.655,6,17,888,9,0,40831,0,476,8,0,46664,0,412
0.017,6,10,1901,5,657,4,657,925,5,708,4,708,976
1783.363,17,83,3480,82,14,22016,14,3444,1,8,0,8,36
6.793,6,14,2296,9,152,849,267,822,5,635,1637,1179,1474
28.447,6,46,8785,22,311,741,618,1918,24,346,1230,2720,6867
6.021,17,4,390,2,44,6009,44,144,2,95,6008,95,246
5.703,6,40,7325,20,218,300,314,3423,20,516,285,1179,3902
0.187,6,16,2993,9,282,23,531,1606,7,338,29,777,1387
3.165,6,22,6402,11,262,311,517,1368,11,744,311,1418,5034
4.119,6,39,7269,20,218,216,314,3423,19,513,214,1179,3846
172.474,2,3,96,3,8,86237,8,96,0,0,0,0,0
14.123,17,34,17037,15,360,1006,1350,5829,19,561,783,1350,11208
0.185,6,3,120,2,0,185,0,80,1,0,0,0,40
89.625,17,4,240,2,32,89624,32,120,2,32,89624,32,120
1787.53,6,102,8228,68,64,26679,64,4896,34,58,54164,58,3332
7.138,6,617,517901,371,1324,18,1368,500073,246,776,28,1473,17828
1.214,6,3,128,2,0,1214,0,84,1,0,0,0,44
10.163,17,20,6965,10,430,1124,1350,4583,10,210,1088,1350,2382
1.763,6,27,10135,16,277,117,565,1477,11,1026,158,1420,8658
0.143,17,2,322,1,33,0,33,61,1,233,0,233,261
1762.084,6,240,35700,150,304,11826,304,26040,90,83,19796,83,9660
0.342,6,27,7296,13,155,28,267,1301,14,543,25,1400,5995
1776.06,1,259,14504,259,28,6883,28,14504,0,0,0,0,0
1.998,17,3,183,3,33,999,33,183,0,0,0,0,0
64.79,6,21,6596,7,154,10798,267,752,14,586,4959,3417,5844
1764.965,2,17,544,17,8,110310,8,544,0,0,0,0,0
16.255,6,71,16687,34,317,488,636,3450,37,419,447,1360,13237
6.921,6,752,680818,488,1327,13,1368,662426,264,776,25,2736,18392
280.236,6,31,7472,14,158,21556,267,1357,17,543,17510,1400,6115
1779.679,17,138,11040,69,48,26171,48,5244,69,56,26171,56,5796
0.174,6,27,7296,13,155,14,267,1301,14,603,12,2036,5995
4.086,17,5,588,4,64,1333,64,368,1,192,0,192,220
1793.715,17,87,3648,86,14,21102,14,3612,1,8,0,8,36
0.054,17,2,167,1,39,0,39,67,1,72,0,72,100
11.767,6,1863,1622399,1147,1363,10,1380,1589472,716,387,16,1923,32927
1740.456,17,30,7050,30,207,60015,207,7050,0,0,0,0,0
34.443,6,30,7432,13,158,2870,267,1317,17,543,2150,1400,6115
1741.354,6,87,6322,58,31,30550,31,3915,29,31,62188,31,2407
0.055,6,10,767,5,186,12,186,454,5,45,13,45,313
65.123,6,38,10409,14,327,624,1189,2535,24,345,2831,1420,7874
54.44,6,20,820,11,0,5444,0,444,9,0,6089,0,376
1799.252,17,448,39896,403,35,4475,288,25676,45,288,40017,288,14220
1799.572,6,136,15087,85,79,21423,502,6510,51,145,35988,1420,8577
90.217,6,25,5458,11,332,270,515,1774,14,312,6932,1452,3684
126.118,6,25,10798,13,745,46,1460,3534,12,967,11453,1460,7264
211.712,17,4,300,2,47,211710,47,150,2,47,211710,47,150
61.49,6,27,7177,13,155,5124,267,1306,14,530,4729,3417,5871
240.109,6,41,8756,22,165,11433,517,2146,19,623,13339,1408,6610
179.411,2,3,96,3,8,89705,8,96,0,0,0,0,0
3.857,6,33,6145,17,206,241,314,2744,16,551,240,1179,3401
1741.078,6,89,6426,58,31,30545,31,3915,31,31,58035,31,2511
1.413,17,32,13412,14,384,108,1350,5778,18,396,77,1350,7634
0.265,6,24,6071,12,181,24,537,1526,12,652,23,1408,4545
1749.084,6,95,7203,63,38,28211,205,4476,32,33,56412,98,2727
88.601,17,6,1984,6,302,17720,308,1984,0,0,0,0,0
1.09,6,27,7447,15,142,77,267,1602,12,893,92,1460,5845
280.256,6,29,7392,13,158,23354,267,1317,16,603,18682,1400,6075
1488.803,6,131,12981,76,64,19850,722,6174,55,89,27565,1408,6807
1508.207,6,188,14227,72,67,21240,295,6774,116,48,13114,78,7453
0.173,6,43,18425,24,1038,7,1420,13444,19,467,9,1883,4981
3.667,6,14,3145,8,49,523,92,511,6,579,42,1408,2634
0.199,6,46,21401,26,1094,7,1420,16380,20,467,10,1883,5021
0.055,17,4,352,2,37,1,37,130,2,83,11,89,222
1.354,6,40,8403,21,321,67,1164,2822,19,437,65,2715,5581
1791.264,1,215,12040,215,28,8370,28,12040,0,0,0,0,0
381.115,6,22,2259,16,141,25407,141,813,6,398,4656,419,1446
114.935,6,28,14339,16,512,334,1360,3749,12,1442,10437,3928,10590
1788.407,17,87,3648,86,14,21040,14,3612,1,8,0,8,36
1772.737,6,180,15480,120,69,14896,69,8940,60,69,30040,69,6540
1770.189,6,223,17642,84,74,21325,374,8673,139,50,12827,143,8969
0.313,6,24,5980,12,164,28,453,1442,12,651,27,1440,4538
1791.978,6,356,22589,207,69,8698,69,12420,149,69,12107,69,10169
216.809,6,31,8912,15,158,15486,267,1397,16,763,14452,2036,7515
81.378,6,22,900,10,0,5390,0,404,12,0,7397,0,496
1744.853,6,95,7203,63,38,28142,205,4476,32,33,56271,98,2727
345.787,6,901,544083,464,1251,746,1438,319695,437,895,793,1893,224388
1.301,17,3,1167,3,361,650,361,1167,0,0,0,0,0
298.664,1,4,326,4,53,99554,78,326,0,0,0,0,0
0.043,17,2,396,1,39,0,39,67,1,301,0,301,329
1741.422,6,87,6322,58,31,30551,31,3915,29,31,62193,31,2407
1785.86,6,364,23185,208,69,8627,69,12667,156,69,11521,69,10518
1758.136,6,103,6166,58,27,30843,27,3421,45,27,39956,27,2745
12.337,6,60,42901,38,1186,333,1368,36389,22,1072,577,2519,6512
280.682,1,4,326,4,53,93560,78,326,0,0,0,0,0
91.826,17,4,240,2,32,91825,32,120,2,32,91825,32,120
0.263,17,3,234,2,39,145,39,134,1,72,0,72,100
1789.455,17,142,11360,71,48,25563,48,5396,71,56,25563,56,5964
1772.975,6,180,15480,120,69,14898,69,8940,60,69,30045,69,6540
488.016,17,6,528,3,60,244007,60,264,3,60,244007,60,264
1791.309,6,356,22520,208,69,8653,69,12460,148,69,12185,69,10060
9.419,17,4,240,2,32,9418,32,120,2,32,9417,32,120
114.07,17,2,152,2,48,114070,48,152,0,0,0,0,0
301.51,6,59,31817,32,190,9726,444,2505,27,1268,9254,2188,29312
1155.088,17,74,5920,37,48,32085,48,2812,37,56,32084,56,3108
3.886,17,4,268,4,39,1295,39,268,0,0,0,0,0
316.851,6,117,34884,59,486,5462,1360,23811,58,291,5501,4649,11073
0.026,17,2,448,2,196,26,346,448,0,0,0,0,0
1786.167,6,356,22520,208,69,8628,69,12460,148,69,12150,69,10060
1.306,6,30,10145,18,372,76,849,1841,12,977,110,1420,8304
3.458,6,2,88,2,0,0,0,88,0,0,0,0,0
0.382,17,2,184,1,32,0,32,60,1,96,0,96,124
83.89,6,28,5004,11,256,8389,722,1592,17,229,5229,1408,3412
0.021,17,2,664,1,308,0,308,336,1,300,0,300,328
1788.248,17,140,11200,70,48,25916,48,5320,70,56,25916,56,5880
0.182,6,4,3531,3,1123,0,1360,3491,1,0,0,0,40
253.042,6,77,6725,61,138,776,174,2996,16,280,16862,1452,3729
4.884,6,38,7245,19,218,271,314,3383,19,516,257,1179,3862
1679.68,1,7,392,7,28,279946,28,392,0,0,0,0,0
1780.196,6,354,22440,207,69,8641,69,12420,147,69,12193,69,10020
14.7,6,32,5207,15,142,1037,722,1929,17,297,907,1402,3278
51.937,6,6910,6523742,4516,1366,11,1408,6394566,2394,931,21,2801,129176
1772.147,6,180,15480,120,69,14891,69,8940,60,69,30032,69,6540
1712.117,17,70,2934,69,14,25178,14,2898,1,8,0,8,36
42.358,17,3,228,3,48,21179,48,228,0,0,0,0,0
0.241,6,22,6633,10,181,20,267,1128,12,717,20,1400,5505
306.305,6,12,850,2,64,76,64,144,10,34,34025,58,706
0.005,17,2,207,1,36,0,36,64,1,115,0,115,143
0.8,17,40,8825,40,192,20,220,8825,0,0,0,0,0
14.477,6,37,8301,19,345,804,721,1828,18,441,497,1360,6473
238.076,2,2,64,2,8,238076,8,64,0,0,0,0,0
1.357,17,4,352,2,60,1356,60,176,2,60,1356,60,176
1263.022,1,119,6664,119,28,10703,28,6664,0,0,0,0,0
1758.166,17,302,49940,302,137,5841,366,49940,0,0,0,0,0
1.454,6,25,6079,13,108,121,147,959,12,772,131,1608,5120
1683.852,17,15,1094,8,30,240538,30,464,7,62,280464,62,630
8.396,6,996,743583,493,341,17,351,32139,503,1376,16,2736,711444
1.202,6,25,8056,12,164,93,267,1288,13,869,85,1408,6768
440.537,17,8,2888,8,333,62933,548,2888,0,0,0,0,0
280.231,17,4,1098,2,30,280218,30,116,2,463,280221,463,982
0.416,6,21,7203,12,318,36,600,1906,9,964,49,1471,5297
16.482,17,34,13365,15,555,1174,1350,8755,19,214,913,1350,4610
1.764,6,25,8785,15,288,126,598,1470,10,987,175,1452,7315
1723.396,1,80,4480,80,28,21815,28,4480,0,0,0,0,0
0.036,6,14,4020,7,88,5,88,388,7,1113,5,1460,3632
300.916,6,47,16162,27,939,11573,1360,10515,20,402,459,2667,5647
142.003,17,4,352,2,60,142002,60,176,2,60,142001,60,176
0.057,6,7,423,4,43,8,43,259,3,0,27,0,164
28.974,17,4,352,2,60,28972,60,176,2,60,28973,60,176
1162.501,1,10,560,10,28,129166,28,560,0,0,0,0,0
1785.987,6,361,22858,210,69,8545,69,12678,151,69,11905,69,10180
185.923,17,22,4532,11,48,18591,48,836,11,308,18591,308,3696
11.47,6,2034,1892249,1299,1379,8,1408,1849365,735,931,15,2816,42884
0.168,17,2,2384,2,1164,168,1164,2384,0,0,0,0,0
300.131,6,40,10599,22,694,14284,1360,5077,18,435,17645,2720,5522
240.666,6,59,19413,32,773,7763,1418,15633,27,236,9256,611,3780
2.152,6,20,3833,11,234,215,564,1504,9,463,247,1343,2329
292.346,1,4,326,4,53,97448,78,326,0,0,0,0,0
0.02,6,10,1510,5,657,5,657,925,5,317,4,317,585
1.269,6,37,8212,19,320,70,1162,2716,18,476,64,2715,5496
1797.659,17,29,9512,29,300,64202,300,9512,0,0,0,0,0
1.32,6,45,15456,24,804,57,1460,9840,21,433,57,1460,5616
100.081,6,23,2616,8,189,14296,517,1194,15,323,7148,499,1422
1786.474,17,142,11360,71,48,25521,48,5396,71,56,25521,56,5964
1656.587,1,7,392,7,28,276097,28,392,0,0,0,0,0
56.102,6,569,264400,296,828,190,1152,247959,273,424,205,1179,16441
0.333,6,22,4442,11,165,33,456,1394,11,493,32,888,3048
1794.073,6,244,35804,152,302,11881,302,26032,92,83,19714,83,9772
297.383,1,4,224,4,28,99127,28,224,0,0,0,0,0
1742.226,6,133,8322,74,46,23866,208,5063,59,31,30029,31,3259
11.789,1,16,1664,0,0,0,0,0,16,76,785,76,1664
3.067,17,3,228,2,48,3049,48,152,1,48,0,48,76
0.018,17,2,411,1,33,0,33,61,1,322,0,322,350
369.616,6,18,1242,14,180,28432,180,916,4,110,20066,110,326
1798.311,1,345,28980,345,56,5227,56,28980,0,0,0,0,0
84.899,6,150,114128,92,1273,932,1368,102838,58,738,1485,2519,11290
0.011,17,2,362,1,32,0,32,60,1,274,0,274,302
0.049,6,10,1677,6,555,9,951,1354,4,159,15,159,323
68.502,6,9,558,6,43,13700,43,394,3,0,34247,0,164
1638.362,2,13,416,13,8,136530,8,416,0,0,0,0,0
842.264,2,10,320,10,8,93584,8,320,0,0,0,0,0
220.594,6,14,1186,10,65,24510,65,790,4,59,54008,59,396
0.451,6,50,22619,28,1088,16,1380,17497,22,421,18,1923,5122
240.187,6,54,18063,29,805,8577,1402,15216,25,192,10007,580,2847
1792.71,6,367,24761,212,86,8496,1189,13947,155,74,11640,405,10814
0.013,17,2,389,1,35,0,35,63,1,298,0,298,326
1.016,6,25,9552,14,350,78,1041,1992,11,1015,83,1460,7560
1.868,17,3,468,3,128,934,128,468,0,0,0,0,0
9.487,6,81,24861,42,546,231,1152,19160,39,459,243,1179,5701
1.171,6,26,7495,16,302,78,693,2761,10,721,128,1414,4734
1.161,6,25,9512,13,164,82,267,1388,12,1248,89,4224,8124
0.129,17,4,368,2,32,47,32,120,2,96,49,96,248
1759.724,6,160,8320,80,0,22274,0,4160,80,0,22274,0,4160
16.501,6,12,708,5,106,4120,106,314,7,90,2747,90,394
112.51,6,23,6972,4,154,5486,267,632,19,371,6249,1460,6340
81.626,6,22,8961,11,514,79,1236,2014,11,927,8145,1460,6947
280.516,6,29,7392,13,158,23376,267,1317,16,603,18696,2076,6075
2.905,6,9,1043,4,222,965,222,608,5,231,724,231,435
0.016,17,2,431,1,34,0,34,62,1,341,0,341,369
138.201,6,13,1807,6,100,27640,100,344,7,1179,22990,1179,1463
5.022,17,4,288,2,36,5007,36,128,2,52,5006,52,160
0.029,17,2,1152,1,548,0,548,576,1,548,0,548,576
1772.232,6,180,15480,120,69,14892,69,8940,60,69,30034,69,6540
1488.032,2,10,320,10,8,165336,8,320,0,0,0,0,0
165.419,6,25,1020,10,0,6108,0,404,15,0,11814,0,616
83.843,6,10500,10072431,7031,1355,11,1408,9887379,3469,931,24,2801,185052
374.724,6,18,1242,14,180,28824,180,916,4,110,20071,110,326
121.354,6,10,1687,6,100,24270,100,344,4,1179,40362,1179,1343
11.048,6,20,4390,11,275,1104,275,998,9,755,780,1414,3392
0.99,6,175,132092,104,1312,9,1432,124961,71,427,13,1432,7131
1793.294,6,139,13562,85,64,21348,722,7087,54,83,33829,1440,6475
0.013,17,2,158,1,34,0,34,62,1,68,0,68,96
71.325,17,8,1176,4,48,23773,48,304,4,190,23772,308,872
4.96,17,4,288,2,36,4960,36,128,2,52,4960,52,160
1689.537,17,22,6897,22,285,80454,725,6897,0,0,0,0,0
10.412,17,4,352,2,48,10403,48,152,2,72,10402,72,200
29.404,6,14,580,8,0,4200,0,324,6,0,4766,0,256
1.051,6,22,7284,13,319,87,602,1960,9,1209,126,1946,5324
4.865,2,2,64,2,8,4865,8,64,0,0,0,0,0
5.845,6,40,7309,21,218,292,314,3463,19,513,309,1179,3846
0.4,6,14,1733,7,288,62,288,588,7,284,39,434,1145
1785.979,17,87,3648,86,14,21011,14,3612,1,8,0,8,36
2.433,17,4,518,3,39,522,39,201,1,289,0,289,317
36.123,17,5,2055,5,383,9030,392,2055,0,0,0,0,0
291.856,6,66,10541,22,105,13897,267,2149,44,174,6782,1452,8392
1770.784,6,99,9306,66,66,27242,66,5610,33,60,55334,60,3696
253.913,6,25,3168,13,304,21159,304,2192,12,83,23073,83,976
8.883,6,34,8376,18,410,522,916,1983,16,521,581,2720,6393
0.003,17,4,368,2,64,1,64,184,2,64,2,64,184
0.362,17,2,166,1,39,0,39,67,1,71,0,71,99
292.46,6,52,8290,24,116,12713,517,2215,28,417,10830,1418,6075
280.444,6,29,7392,13,158,23370,267,1317,16,543,18694,1400,6075
1787.294,6,102,8364,68,66,26676,66,4964,34,60,54157,60,3400
281.933,6,28,7352,13,158,23494,267,1317,15,603,20116,2036,6035
2.054,6,14,2351,8,188,293,245,700,6,703,359,1152,1651
1791.242,6,338,52361,212,302,8489,302,38236,126,83,14329,83,14125
251.952,2,3,96,3,8,125976,8,96,0,0,0,0,0
0.3,17,2,272,1,60,0,60,88,1,156,0,156,184
19.965,6,33,8018,16,138,1331,267,1888,17,778,367,1460,6130
0.13,6,10,1569,5,627,32,627,895,5,406,32,406,674
0.047,17,2,378,1,50,0,50,78,1,272,0,272,300
0.019,17,2,570,1,30,0,30,58,1,484,0,484,512
0.282,17,2,152,1,48,0,48,76,1,48,0,48,76
1799.17,17,764,46076,764,32,2358,37,46076,0,0,0,0,0
0.303,6,25,8938,13,247,25,624,1672,12,1105,26,2816,7266
0.901,6,25,6707,14,353,68,1106,2333,11,786,89,1420,4374
280.473,6,29,7392,13,158,23372,267,1317,16,678,18694,2760,6075
1787.909,6,380,24032,216,69,8315,69,13332,164,69,10968,69,10700
1.104,17,2,170,1,37,0,37,65,1,77,0,77,105
58.119,6,38,11092,13,181,12,421,1796,25,414,2421,1420,9296
12.026,6,2191,2019653,1350,1415,8,1448,1971245,841,776,14,1448,48408
2.971,17,3,468,3,128,1485,128,468,0,0,0,0,0
1.446,6,43,19414,26,920,57,1360,13958,17,529,79,4075,5456
9.743,6,78,24345,39,550,256,1152,18640,39,459,248,1179,5705
1741.412,17,29,30624,29,1028,62193,1028,30624,0,0,0,0,0
1764.381,2,12,384,12,8,160398,8,384,0,0,0,0,0
367.066,6,18,1242,14,180,28235,180,916,4,110,20057,110,326
1681.076,1,15,840,15,28,120076,28,840,0,0,0,0,0
11.701,6,32,8952,14,158,900,267,1357,18,624,686,1400,7595
1797.249,1,76,4256,76,28,23963,28,4256,0,0,0,0,0
1795.256,6,132,12794,81,62,22440,722,6578,51,82,35895,1448,6216
0.174,6,12,3704,6,171,34,171,491,6,964,34,1448,3213
1782.13,17,83,3480,82,14,22001,14,3444,1,8,0,8,36
1797.038,1,220,23320,220,78,8205,78,23320,0,0,0,0,0
0.144,17,2,152,2,48,144,48,152,0,0,0,0,0
1.187,17,3,192,3,36,593,36,192,0,0,0,0,0
1740.455,17,30,31680,30,1028,60015,1028,31680,0,0,0,0,0
11.867,6,25,8453,13,275,988,275,1078,12,983,862,1420,7375
122.888,6,45,13780,23,1015,546,1360,8098,22,435,5843,2667,5682
3.382,6,2277,1935764,1057,737,3,1396,63604,1220,1488,2,6980,1872160
1785.871,17,84,3522,83,14,21778,14,3486,1,8,0,8,36
0.441,6,111,68061,59,1288,7,1420,61664,52,526,8,3303,6397
1786.102,6,106,8456,68,65,26658,65,4930,38,59,48271,59,3526
1772.413,6,208,23961,132,89,13529,981,11118,76,136,23631,1420,12843
1755.686,6,4154,4548358,1447,148,1214,868,86017,2707,1639,648,11216,4462341
4.293,6,40,7309,19,218,238,314,3383,21,440,202,1152,3926
5.019,17,4,824,2,48,5010,48,152,2,308,5009,308,672
2.293,6,14,2351,8,188,327,245,700,6,703,406,1152,1651
61.471,6,41,21355,25,958,2561,1448,13770,16,843,4080,2359,7585
16.319,6,13,2143,8,329,2331,595,1083,5,396,4073,580,1060
0.052,17,2,158,1,34,0,34,62,1,68,0,68,96
240.286,6,46,9387,24,523,10447,1408,5976,22,225,11442,617,3411
1740.507,17,30,31680,30,1028,60017,1028,31680,0,0,0,0,0
130.175,6,31,9608,9,191,16264,469,1706,22,467,6196,2760,7902
1751.036,17,12,498,11,14,175103,14,462,1,8,0,8,36
1792.644,17,297,70902,297,210,6056,422,70902,0,0,0,0,0
1780.632,6,173,13879,93,85,19352,208,8574,80,53,22536,336,5305
1795.29,17,80,3354,79,14,23016,14,3318,1,8,0,8,36
0.298,17,2,152,1,48,0,48,76,1,48,0,48,76
33.389,6,31,5308,15,180,2373,722,1872,16,371,2215,2026,3436
5.842,6,955,812711,572,1377,10,1420,793158,383,467,15,1883,19553
300.881,6,41,11317,22,685,14327,1360,5724,19,401,868,2667,5593
8.692,6,468,385758,275,1335,30,1368,370838,193,776,44,1473,14920
1791.319,6,354,22509,205,69,8780,69,12340,149,69,12102,69,10169
318.359,6,8,564,5,106,79589,106,420,3,0,1512,0,144
1301.878,17,67,22549,67,308,19725,342,22549,0,0,0,0,0
240.642,2,2,64,2,8,240642,8,64,0,0,0,0,0
696.585,17,10,2578,5,31,174143,37,297,5,428,174143,463,2281
15.319,6,2593,2510119,1730,1376,8,1408,2460579,863,776,17,1408,49540
0.691,6,10,924,5,283,116,283,551,5,105,119,105,373
387.237,17,9,3031,9,308,48404,315,3031,0,0,0,0,0
1744.6,2,24,768,24,8,75852,8,768,0,0,0,0,0
1219.382,6,235,57440,111,476,5650,1360,39519,124,166,9912,1360,17921
31.908,6,9,396,2,0,3482,0,88,7,0,5303,0,308
0.538,6,51,22264,27,1063,20,1380,17062,24,421,21,1923,5202
31.23,6,25,8719,13,246,2602,431,1292,12,990,2822,1440,7427
355.093,1,10,560,10,28,39454,28,560,0,0,0,0,0
473.773,6,48,8994,19,128,26320,267,1928,29,280,16920,1460,7066
6.608,6,659,607059,434,1333,14,1368,590695,225,931,28,2736,16364
0.016,17,2,656,1,300,0,300,328,1,300,0,300,328
0.84,6,21,5988,12,281,76,544,1328,9,716,94,1420,4660
481.255,2,5,160,5,8,120313,8,160,0,0,0,0,0
0.009,17,2,254,1,53,0,53,81,1,145,0,145,173
0.01,17,2,218,1,65,0,65,93,1,97,0,97,125
99.658,6,40,5773,24,137,4332,722,2496,16,347,1334,1448,3277
25.054,17,4,320,2,48,25044,48,152,2,56,25043,56,168
0.593,6,22,7333,13,334,49,663,2021,9,1209,68,1946,5312
1790.138,1,292,16352,292,28,6151,28,16352,0,0,0,0,0
0.598,6,27,9145,13,273,49,733,1778,14,945,41,1368,7367
0.801,6,116,106543,43,145,18,230,2824,73,1427,10,2858,103719
300.592,6,76,53914,46,1249,6679,1368,47378,30,828,987,1571,6536
936.601,17,70,5584,37,48,26016,48,2812,33,56,26057,56,2772
300.541,6,11,912,6,226,60073,226,546,5,110,75092,110,366
340.29,17,6,1984,6,302,68058,308,1984,0,0,0,0,0
33.684,6,35,5513,16,154,2245,722,1923,19,259,1859,1402,3590
1788.925,17,87,3648,86,14,21046,14,3612,1,8,0,8,36
280.453,6,30,7432,13,158,23371,267,1317,17,603,17525,2076,6115
1.135,6,226,163885,123,1356,9,1432,155520,103,420,10,1432,8365
39.83,17,22,1936,11,48,3982,48,836,11,72,3982,72,1100
0.578,17,2,138,1,33,0,33,61,1,49,0,49,77
373.596,6,25,1651,17,177,23349,177,1117,8,110,9253,110,534
3.619,6,2,88,2,0,0,0,88,0,0,0,0,0
280.447,6,29,7392,13,158,23370,267,1317,16,603,18693,2076,6075
3.922,6,6,248,4,0,1307,0,164,2,0,2892,0,84
55.174,6,174,160496,58,151,967,232,3081,116,1388,477,1430,157415
1744.199,6,95,7203,63,38,28132,205,4476,32,33,56256,98,2727
3.994,17,8,736,4,32,1331,32,240,4,96,484,96,496
240.308,6,43,8837,21,524,12014,1418,5816,22,207,11442,618,3021
1785.533,6,356,22520,208,69,8625,69,12460,148,69,12146,69,10060
1788.363,6,468,27000,260,69,6904,69,14540,208,34,8639,64,12460
24.968,17,4,320,2,48,24958,48,152,2,56,24958,56,168
1786.702,17,87,3648,86,14,21020,14,3612,1,8,0,8,36
25.913,6,3583,3251265,2131,1435,12,1448,3159577,1452,776,17,1448,91688
1776.045,1,190,20140,190,78,9397,78,20140,0,0,0,0,0
11.899,6,17,4134,8,275,1699,275,878,9,1440,1348,1440,3256
180.413,2,3,96,3,8,90206,8,96,0,0,0,0,0
3.365,6,15,1968,8,241,480,241,1320,7,92,284,92,648
0.01,17,2,547,1,40,0,40,68,1,451,0,451,479
34.824,6,24,3183,14,411,2678,411,1159,10,1448,1864,1448,2024
0.862,6,24,9890,12,698,78,1460,3305,12,870,58,1460,6585
1008.109,2,9,288,9,8,126013,8,288,0,0,0,0,0
18.426,6,25,6082,13,275,1535,275,1078,12,902,1221,1440,5004
41.382,6,82,36526,47,210,899,517,4417,35,976,1216,5170,32109
120.791,1,3,168,3,28,60395,28,168,0,0,0,0,0
142.12,17,2,386,2,165,142120,165,386,0,0,0,0,0
0.423,6,9,1339,5,145,105,145,349,4,826,132,826,990
242.353,6,39,15578,20,1324,12754,1418,14289,19,293,13463,293,1289
22.017,6,2642,2474512,1677,1397,13,1448,2419660,965,776,22,1448,54852
14.702,6,2333,2167886,1450,1414,10,1448,2117102,883,776,16,1448,50784
0.341,17,2,167,1,39,0,39,67,1,72,0,72,100
0.232,1,2,112,2,28,232,28,112,0,0,0,0,0
382.431,6,18,1242,14,180,29417,180,916,4,110,20058,110,326
415.429,6,56,7033,26,109,16610,722,2674,30,140,14319,1408,4359
5.888,6,45,8425,23,227,267,314,4102,22,491,268,1179,4323
1.321,6,26,8905,14,288,101,796,1747,12,1111,98,2370,7158
110.414,17,4,1344,4,308,36804,308,1344,0,0,0,0,0
1776.806,17,140,11200,70,48,25750,48,5320,70,56,25750,56,5880
280.381,6,29,7392,13,158,23365,267,1317,16,775,18689,4836,6075
72.932,6,34,8815,12,246,370,469,2210,22,317,3472,1420,6605
11.748,17,22,9415,10,597,1305,1350,6251,12,235,1065,1350,3164
0.398,6,22,7342,12,335,35,668,1974,10,1210,43,1906,5368
0.56,6,27,9145,13,277,46,747,1792,14,943,37,1368,7353
240.182,6,54,18416,29,774,8577,1402,15465,25,205,10007,580,2951
6.155,6,12,1052,5,283,1494,283,559,7,105,996,105,493
32.176,6,17,2422,9,210,4021,210,920,8,545,4596,904,1502
1533.026,6,82,6212,50,38,31286,205,3518,32,33,45984,98,2694
0.065,17,2,632,1,288,0,288,316,1,288,0,288,316
4.233,17,5,290,5,30,1058,30,290,0,0,0,0,0
1799.067,6,107,8544,69,64,26456,64,4936,38,58,48620,58,3608
1795.244,17,448,39896,403,35,4465,288,25676,45,288,40017,288,14220
481.275,2,6,192,6,8,96255,8,192,0,0,0,0,0
35.254,17,20,1760,10,48,3916,48,760,10,72,3916,72,1000
5.949,6,5,220,5,0,0,0,220,0,0,0,0,0
1790.942,6,240,46440,150,483,12019,483,36780,90,83,20122,83,9660
1632.171,1,7,392,7,28,272028,28,392,0,0,0,0,0
0.132,17,2,2750,2,1347,132,1347,2750,0,0,0,0,0
0.067,17,2,144,1,36,0,36,64,1,52,0,52,80
0.425,6,23,7307,12,318,38,600,1906,11,964,41,1471,5401
300.58,6,18,1227,6,177,60079,177,497,12,110,27309,110,730
0.51,17,2,340,1,39,0,39,67,1,245,0,245,273
41.719,6,27,7177,13,155,3476,267,1306,14,530,3208,3417,5871
366.25,6,21,1419,15,177,26160,177,989,6,110,12230,110,430
6.999,6,21,4374,12,213,636,597,1689,9,552,852,1767,2685
10.757,6,19,7010,11,275,1075,275,998,8,1893,856,2840,6012
62.457,6,21,8524,11,549,80,1309,2120,10,998,6921,1791,6404
92.531,6,22,8752,11,314,85,634,1415,11,983,9238,1360,7337
0.11,17,4,1108,2,30,94,30,116,2,468,96,468,992
1789.119,6,356,22520,208,69,8643,69,12460,148,69,12170,69,10060
0.027,17,2,194,1,61,0,61,89,1,77,0,77,105
84.589,6,25,10961,13,742,52,1460,3520,12,992,7677,1460,7441
1.253,6,27,6100,15,138,89,267,1715,12,780,100,1460,4385
38.187,17,22,1672,22,48,1818,48,1672,0,0,0,0,0
12.194,17,10,965,5,46,3047,46,370,5,91,3046,91,595
1746.04,6,96,7286,63,38,28161,205,4476,33,33,54554,98,2810
8.469,6,4,220,2,0,8469,0,104,2,0,142,0,116
1769.032,6,100,9424,67,66,26803,66,5728,33,60,55267,60,3696
120.843,6,24,10168,12,549,58,1360,2709,12,1161,10974,2720,7459
0.982,6,29,8512,15,222,57,540,1976,14,994,62,1791,6536
0.651,6,10,924,5,283,116,283,551,5,105,117,105,373
23.882,6,1450,1300992,951,1294,24,1368,1270380,499,776,47,1473,30612
0.162,17,2,152,1,48,0,48,76,1,48,0,48,76
313.603,6,4,196,0,0,0,0,0,4,9,104534,9,196
9.658,6,1576,1509353,998,1433,9,1448,1472737,578,776,16,1448,36616
1777.115,17,73,3060,72,14,25029,14,3024,1,8,0,8,36
14.102,6,107,31416,55,544,261,1152,24513,52,438,270,1179,6903
280.023,6,28,7352,13,158,23335,267,1317,15,678,20000,2800,6035
256.993,17,4,240,2,32,256992,32,120,2,32,256992,32,120
1748.905,6,95,7203,63,38,28208,205,4476,32,33,56403,98,2727
1542.941,6,337,28846,182,96,8524,1189,12912,155,136,10018,1420,15934
300.627,6,36,8359,20,283,15822,786,1965,16,522,563,2720,6394
2.259,17,4,518,3,39,858,39,201,1,289,0,289,317
481.25,2,7,224,7,8,80208,8,224,0,0,0,0,0
3.814,6,19,6338,9,293,467,517,1355,10,893,414,2450,4983
12.323,6,1932,1701151,1177,1391,10,1420,1666730,755,467,16,1883,34421
1783.27,17,83,3480,82,14,22015,14,3444,1,8,0,8,36
49.378,6,120,41666,61,638,822,1152,34392,59,409,847,1179,7274
196.088,6,16,6411,11,403,19608,722,3806,5,1164,4607,1448,2605
165.228,17,8,2688,8,308,23604,308,2688,0,0,0,0,0
2.031,6,14,2351,8,188,290,245,700,6,703,355,1152,1651
1772.442,6,180,15480,120,69,14894,69,8940,60,69,30034,69,6540
0.249,17,3,1008,3,308,124,308,1008,0,0,0,0,0
1789.96,1,244,13664,244,28,7366,28,13664,0,0,0,0,0
1786.681,6,102,8296,68,65,26666,65,4930,34,59,54139,59,3366
1.914,17,3,370,2,34,1896,34,124,1,218,0,218,246
82.22,6,71,50564,47,1180,1787,1408,42582,24,960,2681,3847,7982
1792.984,6,356,22520,208,69,8661,69,12460,148,69,12197,69,10060
1746.892,6,95,7203,63,38,28175,205,4476,32,33,56340,98,2727
1798.124,17,87,3648,86,14,21154,14,3612,1,8,0,8,36
1.553,6,49,19615,27,917,59,1360,13959,22,476,64,2720,5656
17.504,17,2,152,2,48,17504,48,152,0,0,0,0,0
511.232,6,31,2530,20,57,26906,205,1546,11,37,51105,98,984
0.013,17,3,990,3,302,6,331,990,0,0,0,0,0
0.495,6,7,466,5,43,114,43,354,2,0,493,0,112
8.343,6,932,1551459,725,1157,11,1360,69169,207,8010,39,65280,1482290
1799.974,6,617,157742,284,421,6360,1440,104119,333,306,5421,1440,53623
0.412,6,14,1733,7,288,64,288,588,7,284,39,434,1145
1786.685,6,104,8444,68,66,26666,66,4964,36,60,51045,60,3480
0.004,17,2,394,1,36,0,36,64,1,302,0,302,330
10.443,6,6,340,2,0,10443,0,100,4,0,2361,0,240
0.302,1,10,840,10,56,33,56,840,0,0,0,0,0
1644.561,1,7,392,7,28,274093,28,392,0,0,0,0,0
56.725,17,6,360,3,32,28362,32,180,3,32,28361,32,180
3.328,17,5,295,5,31,832,31,295,0,0,0,0,0
5.14,6,33,6129,18,206,302,314,2784,15,548,344,1179,3345
0.011,17,2,330,1,30,0,30,58,1,244,0,244,272
1795.823,17,448,39896,403,35,4467,288,25676,45,288,40015,288,14220
31.027,17,6,570,6,67,6205,84,570,0,0,0,0,0
1.028,6,25,9259,14,350,79,1041,1992,11,973,84,1460,7267
0.506,17,2,904,2,424,506,548,904,0,0,0,0,0
0.627,6,21,10774,11,410,62,922,1702,10,1237,50,1460,9072
1794.144,17,66,2766,65,14,28033,14,2730,1,8,0,8,36
1797.825,6,365,25032,213,94,8480,469,14536,152,69,11902,69,10496
289.108,1,4,224,4,28,96369,28,224,0,0,0,0,0
1786.693,6,102,8296,68,65,26667,65,4930,34,59,54139,59,3366
618.855,17,18,1494,9,31,77354,37,536,9,78,77354,136,958
1626.47,1,7,742,7,78,271078,78,742,0,0,0,0,0
1794.203,17,345,69925,345,174,5215,422,69925,0,0,0,0,0
1784.007,6,104,8308,68,64,26626,64,4896,36,58,50969,58,3412
26.316,6,47,13172,22,194,1253,722,2636,25,733,1086,1380,10536
1777.393,6,94,10211,46,203,39495,517,3214,48,748,37815,2736,6997
1791.541,6,432,28112,216,100,8332,469,15056,216,34,8332,64,13056
69.091,6,28,7217,13,155,5757,267,1306,15,482,4934,1997,5911
0.039,17,2,180,1,30,0,30,58,1,94,0,94,122
0.524,6,51,21003,28,978,19,1380,15829,23,421,21,1923,5174
0.266,6,25,6014,12,164,24,453,1442,13,648,21,2176,4572
10.343,6,1138,1005924,664,1432,15,1448,975520,474,776,21,1448,30404
0.017,6,10,1755,5,657,4,657,925,5,562,4,562,830
65.141,17,8,704,4,48,21711,48,304,4,72,21711,72,400
1740.803,17,30,31680,30,1028,60027,1028,31680,0,0,0,0,0
1682.876,17,16,1184,8,30,240408,30,464,8,62,240408,62,720
1786.565,6,104,8444,68,66,26665,66,4964,36,60,51042,60,3480
1787.903,6,152,10392,81,65,22348,208,6622,71,31,25537,31,3770
1.335,6,25,8056,12,164,104,267,1288,13,869,96,1448,6768
1787.905,6,361,22858,210,69,8554,69,12678,151,69,11919,69,10180
1779.86,17,142,11360,71,48,25426,48,5396,71,56,25426,56,5964
48.618,6,17,700,9,0,6075,0,364,8,0,6943,0,336
60.901,6,23,2695,13,177,5075,177,1593,10,110,6738,110,1102
0.298,6,23,7394,13,335,24,668,2026,10,1210,32,1906,5368
280.517,6,31,7472,13,158,23376,267,1317,18,543,16495,1380,6155
240.55,6,8,376,2,0,240550,0,88,6,0,6308,0,288
27.79,6,3648,3432443,2376,1366,11,1408,3361635,1272,931,21,2816,70808
63.848,6,26,11767,8,154,9121,267,792,18,731,3754,1420,10975
0.401,17,17,7380,8,533,57,1350,4492,9,292,42,1350,2888
280.274,6,28,7352,13,158,23356,267,1317,15,678,20013,2045,6035
58.059,17,6,528,3,48,29025,48,228,3,72,29025,72,300
0.347,17,7,2390,7,313,57,354,2390,0,0,0,0,0
1771.526,6,113,10394,71,65,25307,65,6003,42,59,43205,59,4391
1794.331,6,355,22411,207,69,8708,69,12351,148,69,12203,69,10060
1782.205,17,83,3480,82,14,22002,14,3444,1,8,0,8,36
9.944,6,1498,1377181,975,1361,10,1420,1351910,523,475,19,1883,25271
0.793,6,20,5953,11,272,79,517,1261,9,721,89,1452,4692
1.087,6,23,7952,13,164,76,267,1340,10,1216,102,3819,6612
299.99,2,2,64,2,8,299990,8,64,0,0,0,0,0
1788.447,6,100,6484,64,47,28388,208,4114,36,31,51086,31,2370
365.95,6,18,1239,14,177,28150,177,913,4,110,20055,110,326
0.08,6,19,9933,10,125,8,125,653,9,1467,10,1564,9280
1.877,17,3,183,3,33,938,33,183,0,0,0,0,0
1770.289,17,281,58505,281,180,6322,422,58505,0,0,0,0,0
0.853,17,24,17422,14,1048,65,1350,15077,10,206,75,1350,2345
0.402,6,6,324,4,0,134,0,216,2,0,210,0,108
3.681,6,34,6169,18,206,216,314,2784,16,548,228,1179,3385
44.001,6,45,10209,22,533,723,910,3083,23,364,1993,2720,7126
25.121,6,6,328,4,0,8373,0,216,2,0,25108,0,112
365.729,6,18,1288,14,226,28133,226,962,4,110,20058,110,326
18.791,17,12,1056,6,48,3756,48,456,6,72,3755,72,600
1055.76,17,152,11552,152,48,6991,48,11552,0,0,0,0,0
1743.653,1,15,840,15,28,124546,28,840,0,0,0,0,0
253.297,1,9,252,9,0,0,0,252,0,0,0,0,0
281.336,6,32,7516,14,158,21641,267,1357,18,543,16544,1400,6159
36.963,6,29,7209,12,165,3360,267,1149,17,413,2308,1452,6060
4.988,17,4,558,2,36,4974,36,128,2,187,4979,187,430
184.322,6,37,3001,20,158,7063,693,1907,17,69,11520,69,1094
3.159,17,2,204,1,34,0,34,62,1,114,0,114,142
0.053,17,2,459,2,201,53,357,459,0,0,0,0,0
28.493,6,39,10313,19,783,494,1360,4711,20,399,1489,1360,5602
367.031,6,18,1242,14,180,28233,180,916,4,110,20059,110,326
3.076,17,8,1806,4,46,1020,46,296,4,349,1021,369,1510
3.365,6,133,178976,60,281,57,868,4838,73,2468,46,7040,174138
14.434,6,29,4971,14,154,1093,722,1819,15,338,993,1448,3152
245.881,6,74,21583,31,181,8196,267,3424,43,586,5848,1400,18159
1798.961,17,142,11360,71,48,25699,48,5396,71,56,25699,56,5964
1173.697,1,98,10388,98,78,12099,78,10388,0,0,0,0,0
1.421,6,15,2638,7,288,211,288,600,8,568,177,853,2038
3.044,6,3,180,3,0,0,0,180,0,0,0,0,0
241.122,6,127,81230,48,551,5129,1418,6913,79,1063,3091,2407,74317
11.063,6,24,5290,14,233,834,613,1901,10,712,1206,1767,3389
1.195,6,55,14470,27,549,45,1429,4956,28,465,38,2920,9514
0.029,17,4,368,2,32,10,32,120,2,96,13,96,248
280.206,6,30,7432,13,158,23350,267,1317,17,543,17512,1400,6115
0.109,17,2,144,1,36,0,36,64,1,52,0,52,80
1.368,6,50,21648,29,927,48,1360,16032,21,476,59,2715,5616
1792.151,17,180,14040,180,50,10012,50,14040,0,0,0,0,0
0.231,17,2,198,1,39,0,39,67,1,103,0,103,131
1772.951,6,181,15589,120,69,14898,69,8940,61,69,29543,69,6649
0.04,17,2,290,1,40,0,40,68,1,194,0,194,222
1782.655,17,333,61265,333,155,5369,385,61265,0,0,0,0,0
1772.262,6,180,15480,120,69,14892,69,8940,60,69,30035,69,6540
7.524,6,47,14066,22,201,358,416,2232,25,829,293,1440,11834
1799.739,6,356,22589,207,69,8736,69,12420,149,69,12160,69,10169
96.336,6,34,7871,13,155,8028,267,1306,21,357,4816,2840,6565
421.068,2,3,96,3,8,210534,8,96,0,0,0,0,0
840.793,17,8,2196,4,30,280237,30,232,4,463,280259,463,1964
0.919,6,28,8460,15,222,55,540,1964,13,1192,61,3151,6496
1.578,17,2,152,1,48,0,48,76,1,48,0,48,76
20.157,6,20,5365,12,107,1832,159,1074,8,966,2877,1658,4291
1785.01,6,245,25166,98,67,18400,659,9312,147,134,12224,1938,15854
0.083,17,2,334,1,39,0,39,67,1,239,0,239,267
72.37,17,4,352,2,60,72369,60,176,2,60,72369,60,176
1781.761,6,359,22709,209,69,8566,69,12569,150,69,11958,69,10140
98.932,6,137,104770,87,1295,1150,1408,92637,50,680,1725,2439,12133
1770.345,6,103,9514,66,66,27236,66,5610,37,60,49173,60,3904
1792.02,6,356,22520,208,69,8657,69,12460,148,69,12190,69,10060
1787.206,6,102,8296,68,65,26674,65,4930,34,59,54155,59,3366
1274.54,1,69,3864,69,28,18743,28,3864,0,0,0,0,0
280.256,6,30,7432,13,158,23354,267,1317,17,543,17514,1300,6115
1.468,17,17,10560,9,881,182,1350,8181,8,269,204,1350,2379
0.531,17,3,543,2,39,372,39,134,1,381,0,381,409
21.551,6,23,1790,12,275,1959,275,1042,11,96,1832,96,748
1797.334,17,448,39896,403,35,4470,288,25676,45,288,40018,288,14220
1.556,6,50,19403,29,893,55,1360,13742,21,437,66,2715,5661
0.015,6,2,80,1,0,0,0,40,1,0,0,0,40
4.064,17,4,244,4,33,1354,33,244,0,0,0,0,0
299.62,17,4,352,2,60,299618,60,176,2,60,299619,60,176
1797.27,17,772,46624,772,32,2331,37,46624,0,0,0,0,0
1799.074,1,58,4872,58,56,31562,56,4872,0,0,0,0,0
1751.257,6,132,16492,82,113,21620,1234,7833,50,162,35738,1420,8659
1789.481,17,83,3480,82,14,22092,14,3444,1,8,0,8,36
2.321,6,30,14595,12,266,211,705,1722,18,1084,134,1438,12873
0.006,17,2,412,1,49,0,49,77,1,307,0,307,335
1609.193,1,14,784,14,28,123784,28,784,0,0,0,0,0
0.027,6,14,4044,8,88,3,88,452,6,1670,5,1880,3592
236.486,1,15,1260,15,56,16891,56,1260,0,0,0,0,0
85.938,17,4,1344,4,308,28646,308,1344,0,0,0,0,0
1.001,17,2,120,2,32,1001,32,120,0,0,0,0,0
0.036,17,2,152,1,48,0,48,76,1,48,0,48,76
617.925,6,140,39054,61,602,10298,1360,25439,79,197,7920,2720,13615
280.263,6,28,7352,13,158,23355,267,1317,15,678,20015,2045,6035
104.193,6,30,7432,13,158,8682,267,1317,17,543,6510,1400,6115
299.553,6,6,364,4,31,99851,31,222,2,31,299545,31,142
1.349,6,47,18666,26,921,53,1460,13050,21,433,58,1460,5616
0.398,6,86,56219,49,1275,8,1432,50448,37,475,10,1871,5771
0.766,6,22,5040,11,137,76,267,1132,11,577,66,1400,3908
1786.839,6,494,30799,274,98,6545,469,17583,220,34,8156,64,13216
0.631,17,3,451,2,39,453,39,134,1,289,0,289,317
1.496,17,3,1167,3,361,748,361,1167,0,0,0,0,0
4.887,6,23,6482,11,268,481,517,1386,12,893,435,2451,5096
2.006,17,2,120,2,32,2006,32,120,0,0,0,0,0
129.56,17,4,352,2,60,129559,60,176,2,60,129559,60,176
11.334,6,26,11958,13,275,944,275,1078,13,1293,909,1414,10880
0.005,17,2,448,1,64,0,64,92,1,328,0,328,356
77.655,6,76,51156,47,1190,1688,1448,42917,29,747,2200,1448,8239
71.726,6,28,7352,13,158,5977,267,1317,15,678,5120,3436,6035
3.349,6,2,88,2,0,0,0,88,0,0,0,0,0
45.068,6,24,10858,8,214,931,214,780,16,1178,2995,1702,10078
1786.727,6,102,8296,68,65,26667,65,4930,34,59,54140,59,3366
0.589,17,2,152,1,48,0,48,76,1,48,0,48,76
31.939,6,113,128666,25,142,1330,350,1728,88,1439,367,2804,126938
240.397,6,46,8920,24,519,10451,1402,5930,22,204,11447,618,2990
1787.341,6,106,8388,68,64,26676,64,4896,38,58,48304,58,3492
1740.599,17,30,31680,30,1028,60020,1028,31680,0,0,0,0,0
6.066,6,43,8345,22,227,288,314,4062,21,491,290,1179,4283
1773.24,6,180,15480,120,69,14901,69,8940,60,69,30053,69,6540
11.497,6,1789,1602672,1129,1367,10,1380,1570998,660,421,17,1923,31674
20.145,6,18,2897,10,255,2238,517,1815,8,323,2876,499,1082
12.037,6,1842,1629588,1154,1362,10,1380,1595858,688,475,17,1923,33730
3.764,17,5,290,5,30,941,30,290,0,0,0,0,0
1770.679,6,108,9927,69,65,26039,65,5822,39,59,46594,59,4105
1774.257,6,180,15480,120,69,14909,69,8940,60,69,30065,69,6540
6.567,6,24,4449,13,212,547,564,1746,11,422,586,1343,2703
0.874,6,10,1687,7,100,145,100,384,3,1179,311,1179,1303
2.465,6,54,19951,27,927,94,1440,14095,27,433,87,1440,5856
5.005,17,3,343,2,36,5000,36,128,1,187,0,187,215
0.62,6,12,3702,6,170,123,170,490,6,964,110,1448,3212
4.587,6,39,7269,19,218,254,314,3383,20,513,227,1179,3886
1756.219,6,105,6240,60,26,29765,26,3510,45,26,39912,26,2730
1792.334,6,4771,4201816,2293,126,781,338,136726,2478,1633,723,8448,4065090
382.391,6,23,1499,14,177,29414,177,913,9,110,10223,110,586
1788.683,6,293,36623,120,140,15029,1460,17464,173,140,10398,1642,19159
1782.339,17,83,3480,82,14,22004,14,3444,1,8,0,8,36
1.18,6,56,17954,28,707,43,1360,8925,28,464,43,2186,9029
1782.454,17,83,3480,82,14,22005,14,3444,1,8,0,8,36
34.709,17,20,1760,10,48,3855,48,760,10,72,3855,72,1000
0.04,17,2,554,1,47,0,47,75,1,451,0,451,479
42.347,17,46,6644,23,48,1922,48,1748,23,184,1921,308,4896
117.519,6,23,940,9,0,6071,0,364,14,0,9039,0,576
0.142,17,2,780,2,362,142,362,780,0,0,0,0,0
1.417,6,50,19944,28,875,52,1360,14288,22,476,58,2715,5656
1797.459,17,768,46392,768,32,2343,37,46392,0,0,0,0,0
51.819,17,4,352,2,60,51818,60,176,2,60,51817,60,176
180.46,6,3677,3180744,2188,1365,82,1368,3091238,1489,899,121,2736,89506
7.862,6,67,20662,34,559,238,1152,15915,33,489,237,1179,4747
0.005,17,2,351,1,39,0,39,67,1,256,0,256,284
1796.877,1,56,4704,0,0,0,0,0,56,56,32670,56,4704
1697.235,1,258,14448,258,28,6604,28,14448,0,0,0,0,0
1795.675,17,82,3443,80,14,22730,15,3361,2,13,767637,18,82
37.123,17,6,2016,6,308,7424,308,2016,0,0,0,0,0
1764.006,2,10,320,10,8,196000,8,320,0,0,0,0,0
142.984,17,8,2688,8,308,20426,308,2688,0,0,0,0,0
1740.544,17,30,7050,30,207,60018,207,7050,0,0,0,0,0
0.279,17,7,2172,7,282,46,316,2172,0,0,0,0,0
31.319,6,1152,1023579,713,1357,43,1368,994227,439,776,71,1473,29352
0.078,17,2,144,1,36,0,36,64,1,52,0,52,80
335.547,1,12,672,12,28,30504,28,672,0,0,0,0,0
1765.255,17,46,15456,46,308,39227,308,15456,0,0,0,0,0
1.767,17,20,5180,20,231,93,388,5180,0,0,0,0,0
7.312,6,5,284,1,0,0,0,60,4,0,2379,0,224
0.433,6,6,324,4,0,144,0,216,2,0,239,0,108
0.677,6,2,84,1,0,0,0,40,1,0,0,0,44
130.97,17,4,352,2,60,130969,60,176,2,60,130969,60,176
505.013,2,3,96,3,8,252506,8,96,0,0,0,0,0
119.783,17,8,480,4,32,39927,32,240,4,32,39927,32,240
2.201,17,2,154,1,33,0,33,61,1,65,0,65,93
0.017,6,38,73554,1,0,0,0,40,37,1934,0,5764,73514
240.423,6,59,24089,27,539,9246,1402,6264,32,850,7755,2804,17825
218.421,17,11006,2194480,10922,172,20,172,2184400,84,92,2469,172,10080
1787.237,6,104,8376,68,65,26675,65,4930,36,59,51059,59,3446
2.284,6,12,2271,7,188,380,245,660,5,1407,505,1407,1611
1799.524,17,449,39928,404,35,4465,288,25708,45,288,40023,288,14220
1771.556,6,99,9240,66,65,27254,65,5577,33,59,55358,59,3663
1.292,6,45,18080,26,882,51,1360,12544,19,529,61,4075,5536
1799.999,6,224,17372,85,70,21428,343,8538,139,48,13043,78,8834
1788.986,17,140,11200,70,48,25927,48,5320,70,56,25927,56,5880
1771.988,6,180,15480,120,69,14890,69,8940,60,69,30032,69,6540
1745.083,1,56,4704,0,0,0,0,0,56,56,31728,56,4704
0.091,6,11,819,6,186,17,186,506,5,45,21,45,313
721.922,2,6,192,6,8,144384,8,192,0,0,0,0,0
0.259,6,21,7281,12,334,23,663,1969,9,967,31,1906,5312
0.113,17,4,588,2,48,90,48,152,2,190,92,308,436
1781.866,6,112,9062,70,65,25824,65,5140,42,59,43456,59,3922
197.073,6,30,7432,13,158,16422,267,1317,17,543,12315,1400,6115
1753.578,1,61,5124,0,0,0,0,0,61,56,29226,56,5124
1770.302,17,256,56944,256,194,6942,422,56944,0,0,0,0,0
168.712,6,266,212258,160,1357,1061,1448,195720,106,579,1551,1448,16538
541.458,2,5,160,5,8,135364,8,160,0,0,0,0,0
0.0,6,2,3000,2,1448,0,1448,3000,0,0,0,0,0
1.039,6,28,8546,15,229,61,583,2007,13,1201,71,3151,6539
0.17,17,8,2446,8,277,24,316,2446,0,0,0,0,0
1787.966,6,106,8388,68,64,26686,64,4896,38,58,48321,58,3492
280.19,6,26,7272,12,158,25471,267,1277,14,775,21550,2800,5995
211.768,17,4,240,2,32,211767,32,120,2,32,211767,32,120
1788.323,6,99,6444,63,47,28843,208,4074,36,31,51083,31,2370
504.92,2,4,128,4,8,168306,8,128,0,0,0,0,0
20.191,6,23,5773,13,107,1682,159,1138,10,684,2241,1418,4635
0.248,6,21,5000,10,137,27,267,1092,11,577,24,1400,3908
1791.508,6,356,22520,208,69,8654,69,12460,148,69,12186,69,10060
0.042,6,10,520,0,0,0,0,0,10,0,0,0,520
0.359,6,49,19862,27,931,13,1380,11437,22,683,15,3303,8425
1775.467,17,142,11360,71,48,25362,48,5396,71,56,25363,56,5964
9.809,6,83,25074,42,568,239,1152,19293,41,459,238,1179,5781
361.029,2,4,128,4,8,120343,8,128,0,0,0,0,0
12.018,17,10,830,5,47,3003,47,375,5,63,3003,63,455
0.338,6,3,144,2,0,338,0,92,1,0,0,0,52
0.14,17,2,132,1,30,0,30,58,1,46,0,46,74
236.589,2,2,64,2,8,236589,8,64,0,0,0,0,0
1791.914,17,143,11436,72,48,25237,48,5472,71,56,25598,56,5964
1644.891,1,7,742,7,78,274148,78,742,0,0,0,0,0
0.035,17,2,348,1,39,0,39,67,1,253,0,253,281
12.794,6,1184,1071728,705,1437,17,1448,1039876,479,776,26,1448,31852
300.802,6,49,10486,25,433,12533,910,3258,24,329,551,2128,7228
7.219,6,1644,1535752,1027,1418,6,1448,1499004,617,776,11,1448,36748
3.045,17,3,228,2,48,2903,48,152,1,48,0,48,76
0.153,6,21,13448,12,226,13,389,1347,9,1660,12,2816,12101
13.77,1,5,501,5,72,3442,111,501,0,0,0,0,0
1795.754,17,434,35188,404,35,4455,288,25708,30,288,60713,288,9480
1768.904,6,99,9240,66,65,27213,65,5577,33,59,55274,59,3663
17.347,17,28,18952,12,550,1574,1350,6945,16,722,1154,1350,12007
1.323,6,25,8056,12,164,105,267,1288,13,869,96,1448,6768
1.128,6,25,8056,12,164,87,267,1288,13,869,79,1448,6768
1782.164,17,83,3480,82,14,22002,14,3444,1,8,0,8,36
3.627,6,62,23749,34,949,109,1460,14750,28,462,125,1460,8999
6.972,6,39,7285,21,218,348,314,3463,18,516,394,1179,3822
0.099,17,2,1922,2,933,99,933,1922,0,0,0,0,0
164.719,17,4,352,2,60,164718,60,176,2,60,164718,60,176
4.075,6,1183,1148118,425,326,9,326,22434,758,1436,5,1438,1125684
15.31,17,18,10381,10,798,1692,1350,8260,8,237,2174,1350,2121
1772.515,6,180,15480,120,69,14895,69,8940,60,69,30037,69,6540
31.551,6,68,52682,42,1297,769,1408,46317,26,715,1260,1491,6365
0.479,6,21,7203,13,318,39,600,1958,8,964,65,1471,5245
0.001,6,2,1524,1,0,0,0,40,1,1432,0,1432,1484
15.025,6,5,292,3,46,7512,46,166,2,46,8780,46,126
4.188,17,5,295,5,31,1047,31,295,0,0,0,0,0
7.33,6,14,4213,4,106,2440,106,274,10,704,813,1420,3939
23.702,6,25,6284,14,117,1823,159,1337,11,727,2368,1418,4947
0.932,6,12,1653,6,288,182,288,548,6,426,91,434,1105
1.448,6,37,8214,19,321,80,1164,2718,18,433,73,1460,5496
371.613,6,25,1651,17,177,23225,177,1117,8,110,9238,110,534
1783.415,17,80,3354,79,14,22864,14,3318,1,8,0,8,36
1.003,6,23,6460,13,323,83,954,2140,10,979,110,1731,4320
1.382,6,50,18722,27,849,53,1360,13026,23,433,53,1360,5696
1762.209,1,118,6608,118,28,15061,28,6608,0,0,0,0,0
165.272,6,20,10080,11,433,68,990,1771,9,1587,20643,3928,8309
0.337,17,2,162,1,34,0,34,62,1,72,0,72,100
1532.384,6,110,11414,62,70,23049,722,5404,48,94,32600,1408,6010
1601.181,1,26,1456,26,28,64047,28,1456,0,0,0,0,0
1063.305,6,49,3911,32,63,26214,63,2288,17,55,66451,57,1623
0.171,1,2,112,2,28,171,28,112,0,0,0,0,0
7.697,6,134,106607,72,551,108,616,9064,62,1697,120,19320,97543
0.572,6,12,3704,6,171,114,171,491,6,964,114,1448,3213
1787.993,17,142,11360,71,48,25542,48,5396,71,56,25542,56,5964
1787.301,6,102,8296,68,65,26676,65,4930,34,59,54156,59,3366
5.008,17,4,288,2,36,5008,36,128,2,52,5008,52,160
2.003,6,20,3833,11,234,200,564,1504,9,463,227,1343,2329
1770.838,6,101,9344,66,65,27243,65,5577,35,59,52080,59,3767
10.847,6,18,5610,10,275,1205,275,958,8,1440,839,1440,4652
1745.293,6,95,7203,63,38,28149,205,4476,32,33,56287,98,2727
369.665,6,20,1355,15,177,26404,177,977,5,110,15164,110,378
61.619,6,62,41930,39,1183,1621,1408,33999,23,961,2791,3847,7931
1792.56,1,58,4872,0,0,0,0,0,58,56,31448,56,4872
1773.71,17,320,54278,320,141,5560,386,54278,0,0,0,0,0
19.03,17,5,444,5,60,4757,288,444,0,0,0,0,0
1795.49,17,442,148504,442,307,4071,308,148504,0,0,0,0,0
2.726,6,2,88,2,0,0,0,88,0,0,0,0,0
1789.946,6,356,22520,208,69,8647,69,12460,148,69,12176,69,10060
0.056,17,2,180,1,30,0,30,58,1,94,0,94,122
1775.006,6,131,8012,70,27,25724,27,4225,61,27,29582,27,3787
67.152,6,6,1255,4,327,22384,413,814,2,180,66948,269,441
8.627,6,4,208,2,0,7400,0,104,2,0,7485,0,104
1.393,6,50,19678,27,919,53,1460,13982,23,433,54,1460,5696
98.966,6,21,6018,11,216,9896,501,1310,10,614,10979,1420,4708
0.749,6,14,1745,7,288,88,288,600,7,426,91,434,1145
1794.173,17,87,3648,86,14,21107,14,3612,1,8,0,8,36
0.167,17,4,560,2,64,166,64,184,2,160,46,160,376
280.23,6,28,7352,12,158,25475,267,1277,16,603,18678,1400,6075
1787.134,6,104,8444,68,66,26673,66,4964,36,60,51057,60,3480
0.008,17,2,402,1,59,0,59,87,1,287,0,287,315
0.015,6,10,1800,6,616,2,1073,1477,4,159,4,159,323
93.532,6,6,328,4,0,31177,0,216,2,0,93517,0,112
12.114,6,1908,1665283,1157,1384,10,1420,1631022,751,467,16,1883,34261
1682.808,17,14,1036,7,30,280458,30,406,7,62,280458,62,630
759.383,6,96,6508,37,46,21093,46,2814,59,46,13090,46,3694
385.1,6,21,1422,15,180,27507,180,992,6,110,12233,110,430
1769.68,6,101,9344,66,65,27225,65,5577,35,59,52043,59,3767
1656.123,1,8,448,8,28,236589,28,448,0,0,0,0,0
280.398,6,30,7432,13,158,23366,267,1317,17,543,17519,1400,6115
54.575,17,4,352,2,60,54574,60,176,2,60,54574,60,176
160.22,6,112,85415,73,1253,2225,1408,75264,39,811,2607,3847,10151
150.428,6,24,10168,13,549,69,1360,2749,11,1161,15028,2720,7419
14.867,17,4,824,2,48,14846,48,152,2,308,14845,308,672
1.079,6,25,8962,14,208,83,475,1426,11,1012,88,1360,7536
3.03,17,2,456,1,60,0,60,88,1,340,0,340,368
0.953,6,3,1592,3,1460,476,1460,1592,0,0,0,0,0
300.85,6,49,10486,24,433,13080,910,3218,25,312,542,1460,7268
0.57,6,10,968,5,256,127,256,460,5,304,120,304,508
48.983,6,57,17261,24,367,252,1189,5750,33,424,1530,1997,11511
1.603,6,40,9854,19,321,89,1168,2778,21,518,71,1460,7076
0.181,17,6,2056,6,314,36,354,2056,0,0,0,0,0
5.012,17,4,288,2,36,4980,36,128,2,52,4996,52,160
43.81,6,35,9182,14,328,136,1189,2541,21,413,2190,1420,6641
538.081,6,265,107334,124,940,4374,1368,94977,141,135,3843,580,12357
300.835,6,34,8447,19,204,16713,467,1884,15,481,4928,1408,6563
5.714,17,4,240,2,32,5713,32,120,2,32,5713,32,120
4.928,6,23,7240,11,309,483,517,2128,12,893,441,2451,5112
281.34,6,32,7650,13,158,23445,267,1317,19,464,15603,1400,6333
0.072,17,2,140,1,34,0,34,62,1,50,0,50,78
126.267,17,4,288,2,36,126236,36,128,2,52,126236,52,160
0.044,6,3,120,2,0,44,0,80,1,0,0,0,40
9.422,6,6,1255,4,327,3140,413,814,2,180,9234,269,441
0.102,17,2,279,1,36,0,36,64,1,187,0,187,215
1787.393,6,104,8376,68,65,26677,65,4930,36,59,51064,59,3446
300.141,6,39,10324,21,655,14999,1360,4802,18,435,17646,2667,5522
314.186,6,31,1736,15,31,22430,31,879,16,31,20935,31,857
10.997,6,18,5610,10,275,1221,275,958,8,1440,841,1440,4652
84.319,17,2489,3027674,294,66,287,1350,27832,2195,1338,38,1350,2999842
1504.015,2,14,448,14,8,115693,8,448,0,0,0,0,0
1785.709,1,22,1232,22,28,85033,28,1232,0,0,0,0,0
1680.561,17,12,498,11,14,168056,14,462,1,8,0,8,36
12.389,6,1960,1714226,1191,1385,10,1420,1679221,769,467,16,1883,35005
1784.462,6,393,24069,208,69,8620,69,12529,185,42,9698,69,11540
1796.456,6,316,30066,157,93,11515,1189,12661,159,125,11369,3377,17405
0.22,17,2,136,1,32,0,32,60,1,48,0,48,76
0.137,17,2,672,2,308,137,308,672,0,0,0,0,0
1743.015,6,95,7203,63,38,28113,205,4476,32,33,56214,98,2727
281.519,6,29,7392,13,158,23459,267,1317,16,603,18694,2036,6075
1.473,6,1299,1155545,565,153,2,288,32664,734,1483,1,5608,1122881
23.339,6,35,8177,17,188,1458,721,2004,18,605,1361,1420,6173
1794.466,6,359,22709,209,69,8627,69,12569,150,69,12042,69,10140
192.634,17,2,672,2,308,192634,308,672,0,0,0,0,0
0.031,17,2,192,1,60,0,60,88,1,76,0,76,104
0.042,17,5,696,3,60,9,60,264,2,188,16,188,432
0.085,6,14,5117,7,273,14,517,919,7,1275,12,1418,4198
12.709,6,1862,1628475,1153,1362,11,1380,1593905,709,515,17,1923,34570
300.822,6,45,10240,24,433,13079,910,3194,21,387,764,2720,7046
126.066,6,16,3249,8,92,18009,92,504,8,387,17937,1448,2745
112.891,6,141,22014,74,304,1546,304,15212,67,83,1710,83,6802
1738.379,1,83,6972,83,56,21199,56,6972,0,0,0,0,0
1681.626,17,16,1265,8,30,240230,37,471,8,71,240230,136,794
1760.334,6,109,8855,71,51,25147,205,5488,38,36,47569,98,3367
163.495,6,73,51835,47,1214,3554,1448,43732,26,842,2466,2359,8103
445.973,1,6,336,6,28,89194,28,336,0,0,0,0,0
6.073,17,6,1254,3,37,3029,37,195,3,325,3029,325,1059
0.015,17,2,136,1,32,0,32,60,1,48,0,48,76
32.942,17,18,1368,18,48,1937,48,1368,0,0,0,0,0
610.524,6,88,46620,40,239,15653,517,3284,48,1361,12987,2896,43336
1786.744,17,88,3684,86,14,21014,14,3612,2,8,1786575,8,72
1787.562,1,160,8960,160,28,11242,28,8960,0,0,0,0,0
1.154,17,2,312,2,128,1154,128,312,0,0,0,0,0
1.297,6,47,19118,27,886,49,1360,13542,20,433,59,1360,5576
63.121,6,7,420,7,0,0,0,420,0,0,0,0,0
1798.942,1,19,1064,19,28,99941,28,1064,0,0,0,0,0
20.146,6,2382,2229866,1549,1362,12,1408,2181874,833,931,24,2801,47992
1754.751,6,191,19232,99,84,17905,721,9060,92,162,19279,1420,10172
260.674,17,26,4242,13,40,21721,40,884,13,230,21721,249,3358
1.368,6,51,19723,27,919,52,1440,13987,24,433,51,1440,5736
7.382,17,42,7595,13,207,614,1350,3061,29,128,262,1350,4534
84.18,6,30,7432,13,158,7015,267,1317,17,543,5257,1400,6115
10.607,6,18,5610,10,275,1178,275,958,8,1440,800,1440,4652
0.033,17,2,295,1,35,0,35,63,1,204,0,204,232
1796.289,1,281,15736,281,28,6415,28,15736,0,0,0,0,0
0.058,17,2,166,1,47,0,47,75,1,63,0,63,91
0.015,6,11,3287,6,81,3,81,401,5,872,3,1448,2886
4.09,6,38,7229,19,218,227,314,3383,19,440,213,1152,3846
1099.565,17,14,3541,7,32,183259,37,420,7,417,183258,463,3121
24.421,6,3087,2934530,2041,1362,11,1408,2875474,1046,776,23,1408,59056
240.191,6,56,17497,30,761,8282,1408,14533,26,200,9607,580,2964
0.2,6,24,7176,12,155,18,267,1261,12,775,17,3445,5915
10.985,6,18,4266,10,275,1220,275,958,8,992,882,1440,3308
1793.986,17,144,11520,72,48,25267,48,5472,72,56,25267,56,6048
370.981,6,18,1242,14,180,28537,180,916,4,110,20084,110,326
0.007,17,2,574,1,32,0,32,60,1,486,0,486,514
240.27,6,55,20985,30,880,8284,1418,18300,25,196,10010,580,2685
10.978,2,3,96,3,8,5489,8,96,0,0,0,0,0
56.097,17,4,352,2,60,56095,60,176,2,60,56096,60,176
6.786,6,34,9032,16,158,452,267,1437,18,624,396,1400,7595
1.482,6,42,12828,23,634,67,1360,7292,19,476,71,2715,5536
0.031,17,6,1112,4,64,9,64,368,2,344,26,344,744
4.54,6,38,7229,19,218,252,314,3383,19,513,237,1179,3846
1799.389,17,142,11360,71,48,25705,48,5396,71,56,25705,56,5964
0.053,17,2,510,1,37,0,37,65,1,417,0,417,445
1777.049,17,142,11360,71,48,25385,48,5396,71,56,25385,56,5964
1750.481,17,387,91944,387,209,4534,422,91944,0,0,0,0,0
1681.424,1,15,870,15,30,120101,30,870,0,0,0,0,0
0.291,6,23,7394,12,335,25,668,1974,11,968,28,1912,5420
1789.222,1,342,28728,342,56,5246,56,28728,0,0,0,0,0
1787.866,6,357,28726,206,75,8721,267,13304,151,137,11919,3426,15422
1.907,17,2,312,2,128,1907,128,312,0,0,0,0,0
1.278,6,37,8638,20,335,67,1360,3182,17,476,69,2715,5456
4.494,6,39,7285,20,218,236,314,3423,19,516,235,1179,3862
12.456,6,1915,1737205,1218,1371,10,1380,1701531,697,421,17,1923,35674
19.57,17,26,6996,12,330,1776,1350,4305,14,164,1503,1350,2691
744.168,17,11,4724,11,401,74416,1438,4724,0,0,0,0,0
280.416,6,29,7392,13,158,23368,267,1317,16,678,18690,3456,6075
277.408,6,30,7432,13,158,23117,267,1317,17,543,17336,1400,6115
1.221,6,9,382,4,0,407,0,164,5,7,192,7,218
0.924,1,10,280,10,0,0,0,280,0,0,0,0,0
1682.853,17,15,1094,8,30,240403,30,464,7,62,280470,62,630
8.441,6,1559,1411791,970,1377,8,1408,1376499,589,931,14,2816,35292
30.872,17,4,5476,4,1341,10290,1346,5476,0,0,0,0,0
219.426,17,4,240,2,32,219425,32,120,2,32,219424,32,120
0.71,6,188,158828,79,338,9,338,5118,109,1409,4,1568,153710
13.702,6,27,4865,13,154,1123,722,1766,14,394,1040,1448,3099
20.521,6,27,6399,15,117,1465,159,1389,12,873,1860,1708,5010
0.065,6,9,1340,5,145,16,145,349,4,827,14,827,991
1779.292,17,140,11200,70,48,25786,48,5320,70,56,25786,56,5880
1786.383,6,102,8364,68,66,26662,66,4964,34,60,54130,60,3400
0.006,17,2,312,1,41,0,41,69,1,215,0,215,243
369.53,6,21,1422,15,180,26395,180,992,6,110,12243,110,430
2.328,17,20,5180,20,231,122,388,5180,0,0,0,0,0
338.644,1,5,280,5,28,84661,28,280,0,0,0,0,0
4.917,6,39,7269,20,218,258,314,3423,19,513,259,1179,3846
0.014,17,2,122,1,33,0,33,61,1,33,0,33,61
280.234,6,29,7392,13,158,23352,267,1317,16,603,18679,1400,6075
87.929,6,115,87547,74,1241,1204,1408,75885,41,793,2192,2816,11662
0.105,17,2,146,1,37,0,37,65,1,53,0,53,81
1391.332,6,277,17497,161,69,8695,69,9683,116,69,12098,69,7814
31.678,6,24,6918,8,138,4525,267,883,16,448,2110,1420,6035
1.251,6,48,18200,26,882,50,1460,12544,22,433,51,1460,5656
10.376,6,2314,2171139,1487,1382,6,1408,2123471,827,776,12,1408,47668
1.211,6,26,9564,13,164,85,267,1388,13,1070,85,2816,8176
0.779,17,8,2750,8,315,111,354,2750,0,0,0,0,0
0.74,6,8,440,4,0,246,0,216,4,0,243,0,224
0.746,17,17,5829,8,388,106,1350,3335,9,249,89,1350,2494
661.401,17,50,3984,27,48,25438,48,2052,23,56,25455,56,1932
0.192,1,2,112,2,28,192,28,112,0,0,0,0,0
11.617,6,1835,1592493,1109,1380,10,1420,1559232,726,467,16,1883,33261
61.84,6,73,50049,45,1196,1405,1440,41838,28,749,2281,1440,8211
1.353,6,47,18536,26,911,54,1440,12920,21,433,58,1440,5616
0.03,17,2,184,1,32,0,32,60,1,96,0,96,124
1798.309,1,64,3584,64,28,28544,28,3584,0,0,0,0,0
1795.19,17,178,13884,178,50,10142,50,13884,0,0,0,0,0
0.954,6,30,9416,16,208,63,475,1542,14,811,58,1360,7874
317.011,6,106,34453,57,518,5660,1360,23602,49,355,6600,3289,10851
1697.245,17,20,5160,10,31,188581,37,594,10,428,188581,463,4566
31.862,6,130,124435,45,134,724,326,2744,85,1447,379,2836,121691
61.359,6,37,15893,22,796,2921,1448,9115,15,665,4363,1448,6778
12.868,6,14,2242,8,210,1837,210,844,6,545,2573,904,1398
30.446,6,12,3628,4,106,10132,106,274,8,756,4315,1460,3354
222.612,17,4,352,2,60,222611,60,176,2,60,222611,60,176
240.315,6,43,9133,21,197,12014,751,2481,22,550,11442,2381,6652
854.734,17,38,3040,19,48,47484,48,1444,19,56,47484,56,1596
1774.038,1,57,4788,0,0,0,0,0,57,56,31679,56,4788
45.159,6,4945,4716411,3134,1423,14,1448,4612715,1811,776,24,1448,103696
1797.959,6,386,27224,220,102,8209,469,16099,166,69,10896,69,11125
46.112,6,19,1084,7,0,7685,0,396,12,0,4180,0,688
1799.678,17,449,39928,404,35,4465,288,25708,45,288,40021,288,14220
300.697,6,48,9206,24,318,13073,927,2337,24,327,629,1360,6869
1786.697,6,243,24972,97,67,18610,659,9214,146,135,12321,2720,15758
0.08,17,2,167,1,39,0,39,67,1,72,0,72,100
7.291,17,4,240,2,32,7290,32,120,2,32,7290,32,120
1798.189,17,445,39232,401,35,4495,288,25328,44,288,40949,288,13904
1785.866,6,299,19136,175,69,10263,69,10588,124,69,14519,69,8548
283.398,6,31,7748,12,158,25468,267,1277,19,475,15743,3436,6471
1787.839,17,87,3648,86,14,21033,14,3612,1,8,0,8,36
0.017,6,5,5127,1,0,0,0,40,4,1231,0,2760,5087
1798.195,1,268,15008,268,28,6734,28,15008,0,0,0,0,0
11.322,17,8,704,4,48,3770,48,304,4,72,3770,72,400
280.428,6,28,7352,12,158,25493,267,1277,16,603,18687,1400,6075
1008.206,2,7,224,7,8,168034,8,224,0,0,0,0,0
296.205,1,4,224,4,28,98735,28,224,0,0,0,0,0
0.042,17,3,210,2,35,42,58,126,1,56,0,56,84
0.354,17,2,198,1,39,0,39,67,1,103,0,103,131
0.016,6,10,1806,6,619,3,1079,1483,4,159,5,159,323
1786.72,6,105,8546,70,65,25894,65,5140,35,59,52402,59,3406
0.126,17,2,624,1,64,0,64,92,1,504,0,504,532
1680.71,17,13,534,11,14,168051,14,462,2,8,1680518,8,72
368.329,6,21,1422,15,180,26309,180,992,6,110,12265,110,430
1789.377,1,264,14784,264,28,6803,28,14784,0,0,0,0,0
1789.224,17,142,11360,71,48,25560,48,5396,71,56,25560,56,5964
755.431,2,6,192,6,8,151086,8,192,0,0,0,0,0
1784.315,17,202,54034,202,239,8877,422,54034,0,0,0,0,0
0.006,17,2,380,1,62,0,62,90,1,262,0,262,290
0.916,6,10,1687,7,100,152,100,384,3,1179,338,1179,1303
900.633,17,504,35683,436,40,2070,41,29933,68,56,602,57,5750
1741.53,17,30,7050,30,207,60052,207,7050,0,0,0,0,0
0.87,6,10,1687,7,100,145,100,384,3,1179,310,1179,1303
1797.47,17,448,39896,403,35,4471,288,25676,45,288,40017,288,14220
1.445,6,37,8212,19,320,80,1162,2716,18,476,74,2715,5496
1782.322,17,83,3480,82,14,22003,14,3444,1,8,0,8,36
16.295,1,15,1560,0,0,0,0,0,15,76,1163,76,1560
93.987,6,25,9674,13,525,153,1237,2152,12,878,8498,1591,7522
0.307,6,21,5000,10,137,34,267,1092,11,692,29,1467,3908
0.563,6,10,924,5,283,97,283,551,5,105,95,105,373
1789.95,6,369,25730,214,99,8403,469,15114,155,69,11623,69,10616
193.162,6,29,6653,11,220,5635,516,1325,18,306,11357,1452,5328
139.723,6,131,19666,70,304,2024,304,13532,61,83,2325,83,6134
15.436,17,20,14260,12,981,1397,1350,12109,8,240,2193,1350,2151
0.089,1,2,112,2,28,89,28,112,0,0,0,0,0
19.791,6,132,69418,65,1237,309,1360,57205,67,474,290,1360,12213
7.497,6,27,7104,10,146,833,267,1138,17,479,446,1460,5966
313.158,6,1024,877297,647,1382,484,1460,849994,377,154,56,1460,27303
1.351,6,49,21315,28,969,50,1440,15699,21,433,58,1440,5616
19.969,1,8,832,0,0,0,0,0,8,76,2852,76,832
1328.266,6,137,11759,89,69,15093,69,6665,48,69,28260,69,5094
0.146,17,2,193,1,34,0,34,62,1,103,0,103,131
1792.829,1,342,28728,342,56,5257,56,28728,0,0,0,0,0
55.775,6,42,8811,21,401,449,888,2124,21,416,2782,3488,6687
0.103,17,4,624,2,64,102,64,184,2,192,62,192,440
5.409,17,4,240,2,32,5408,32,120,2,32,5408,32,120
0.167,6,9,1346,5,145,41,145,349,4,833,24,833,997
2.511,17,22,13103,11,608,251,1350,6997,11,527,190,1350,6106
0.019,17,4,1116,2,32,14,32,120,2,470,14,470,996
80.239,6,61,14187,31,359,397,763,2542,30,453,2761,2720,11645
0.226,17,6,2047,6,313,45,354,2047,0,0,0,0,0
280.532,6,29,7392,13,158,23377,267,1317,16,678,18698,3456,6075
0.013,17,2,152,1,48,0,48,76,1,48,0,48,76
0.009,17,4,624,2,36,2,36,128,2,220,1,292,496
1.368,6,51,19993,28,876,50,1360,14297,23,433,53,1360,5696
7.661,6,30,8872,13,158,638,267,1317,17,763,472,1781,7555
1773.091,6,180,15480,120,69,14899,69,8940,60,69,30049,69,6540
1.291,6,26,8108,13,164,92,267,1340,13,869,92,1440,6768
1793.235,6,241,35632,150,302,12035,302,25920,91,83,19924,83,9712
33.644,6,33,5211,17,154,2091,722,1975,16,342,2230,1440,3236
1785.178,6,106,8456,68,65,26644,65,4930,38,59,48245,59,3526
26.451,17,16,1408,8,48,3776,48,608,8,72,3776,72,800
0.056,17,2,176,1,52,0,52,80,1,68,0,68,96
19.029,17,15,6238,7,500,3166,1350,3696,8,289,2714,1350,2542
0.893,17,4,368,2,64,891,64,184,2,64,892,64,184
0.054,17,2,196,1,62,0,62,90,1,78,0,78,106
0.197,17,6,870,3,40,0,40,204,3,194,0,194,666
4.003,17,8,1304,4,33,1333,33,244,4,237,1332,249,1060
0.435,6,20,7165,12,318,38,599,1905,8,1209,61,1906,5260
1744.777,6,97,7307,63,38,28141,205,4476,34,33,52865,98,2831
1797.209,17,349,26524,349,48,5164,48,26524,0,0,0,0,0
26.405,17,39,10153,16,265,1758,1350,4699,23,209,1198,1350,5454
318.122,6,77,17062,40,276,8156,1460,7726,37,326,8832,3098,9336
0.081,17,2,672,2,308,81,308,672,0,0,0,0,0
1745.944,6,98,7359,63,38,28160,205,4476,35,33,51341,98,2883
0.003,6,3,120,2,0,2,0,80,1,0,0,0,40
60.274,6,21,8940,11,746,6027,1448,3566,10,807,6689,1448,5374
0.109,6,13,2024,8,329,15,500,1082,5,674,27,674,942
0.105,17,2,373,1,34,0,34,62,1,283,0,283,311
1799.431,1,16,896,16,28,119962,28,896,0,0,0,0,0
1772.08,6,180,15480,120,69,14891,69,8940,60,69,30033,69,6540
0.012,17,2,364,1,43,0,43,71,1,265,0,265,293
36.594,2,2,64,2,8,36594,8,64,0,0,0,0,0
0.324,17,2,144,1,36,0,36,64,1,52,0,52,80
0.008,17,2,408,1,44,0,44,72,1,308,0,308,336
2.808,17,4,1564,4,363,936,363,1564,0,0,0,0,0
1772.363,6,180,15480,120,69,14893,69,8940,60,69,30036,69,6540
0.156,6,13,2121,7,324,26,585,1009,6,396,27,580,1112
3.482,17,35,18151,15,710,248,1350,11078,20,325,174,1350,7073
13.985,6,6,328,4,0,4661,0,216,2,0,13895,0,112
143.734,6,9,503,2,0,16546,0,112,7,7,23927,7,391
0.105,17,2,558,1,32,0,32,60,1,470,0,470,498
1.666,6,14,2351,8,188,238,245,700,6,703,282,1152,1651
1772.428,6,180,15480,120,69,14894,69,8940,60,69,30037,69,6540
0.014,6,2,116,1,0,0,0,64,1,0,0,0,52
76.242,17,4,304,4,48,25414,48,304,0,0,0,0,0
1798.079,6,371,25948,214,98,8441,469,15183,157,69,11524,69,10765
1673.691,17,389,42629,177,141,9493,1350,29940,212,31,7932,60,12689
1797.361,6,367,25650,214,99,8438,469,15045,153,69,11823,69,10605
1778.008,17,73,3060,72,14,25042,14,3024,1,8,0,8,36
8.173,6,1515,1435063,986,1382,8,1408,1402891,529,931,15,2816,32172
43.854,17,4,352,2,60,43853,60,176,2,60,43853,60,176
1799.17,6,356,22658,204,69,8605,69,12231,152,69,11915,69,10427
5.037,17,4,288,2,36,5005,36,128,2,52,4998,52,160
1772.184,6,180,15480,120,69,14892,69,8940,60,69,30034,69,6540
240.226,6,57,20361,31,832,8007,1418,17446,26,194,9608,580,2915
1042.99,17,205,15580,205,48,5112,48,15580,0,0,0,0,0
104.271,1,6,336,6,28,20854,28,336,0,0,0,0,0
4.075,6,10,1687,7,100,679,100,384,3,1179,1911,1179,1303
15.132,6,15,3937,6,181,3026,267,969,9,520,1857,1179,2968
1790.127,1,59,4956,59,56,30864,56,4956,0,0,0,0,0
1.217,6,50,20355,28,903,45,1360,14699,22,433,50,1360,5656
1788.249,6,105,14062,66,86,27511,502,5228,39,201,47056,1420,8834
0.904,17,15,9155,8,822,129,1350,6803,7,308,137,1350,2352
20.915,6,18,2844,8,821,2986,1420,1966,10,231,2323,231,878
1788.774,1,64,3584,64,28,28393,28,3584,0,0,0,0,0
85.951,17,4,352,2,60,85950,60,176,2,60,85950,60,176
370.822,6,23,1538,16,180,24721,180,1056,7,110,10404,110,482
0.005,17,2,459,1,39,0,39,67,1,364,0,364,392
1261.821,1,6,336,6,28,252364,28,336,0,0,0,0,0
5.016,17,4,530,2,36,5006,36,128,2,173,5006,187,402
0.317,17,2,152,1,48,0,48,76,1,48,0,48,76
62.401,6,9,372,5,0,15600,0,204,4,0,20793,0,168
2.107,17,2,148,1,32,0,32,60,1,60,0,60,88
30.031,17,4,750,2,33,30020,33,122,2,286,30021,294,628
8.166,6,1742,1604512,1097,1384,7,1408,1566308,645,776,12,1408,38204
3.992,17,8,1120,4,64,1330,64,368,4,160,1330,160,752
5.944,6,1000,912788,616,1405,9,1448,888156,384,776,15,1448,24632
1742.743,6,94,7151,62,38,28569,205,4424,32,33,56208,98,2727
1786.709,6,103,8326,68,64,26667,64,4896,35,58,52547,58,3430
0.104,17,2,396,1,39,0,39,67,1,301,0,301,329
22.028,6,3168,2947831,2040,1366,10,1408,2884511,1128,931,19,2816,63320
210.364,17,4,352,2,60,210363,60,176,2,60,210363,60,176
1.201,6,24,8004,12,164,92,267,1288,12,1014,92,2804,6716
17.49,6,22,7916,8,154,2498,267,792,14,728,1309,1917,7124
3.494,17,5,295,5,31,873,31,295,0,0,0,0,0
4.882,17,4,558,2,36,4872,36,128,2,187,4867,187,430
1772.191,6,180,15480,120,69,14892,69,8940,60,69,30032,69,6540
1785.314,6,362,22898,210,69,8542,69,12678,152,69,11823,69,10220
2.202,17,3,174,3,30,1101,30,174,0,0,0,0,0
37.002,1,43,4472,0,0,0,0,0,43,76,881,76,4472
0.936,6,26,9194,14,203,72,458,1418,12,1040,69,3926,7776
1681.711,17,14,1036,7,30,280280,30,406,7,62,280282,62,630
4.622,6,2,88,2,0,0,0,88,0,0,0,0,0
0.418,6,12,2069,7,324,69,585,1009,5,396,73,580,1060
192.105,17,4,352,2,60,192104,60,176,2,60,192104,60,176
829.826,17,26,8704,26,306,33193,308,8704,0,0,0,0,0
0.469,6,3,210,1,0,0,0,40,2,90,313,90,170
287.488,1,6,2002,6,305,57497,327,2002,0,0,0,0,0
1799.881,6,203,14100,74,46,24655,46,5996,129,46,14060,46,8104
1796.923,1,58,4872,58,56,31524,56,4872,0,0,0,0,0
4.498,6,37,7189,19,218,249,314,3383,18,513,246,1179,3806
0.107,17,4,624,2,64,94,64,184,2,192,88,192,440
11.486,6,101,32046,51,603,229,1152,25564,50,447,229,1179,6482
341.758,1,33,2772,33,56,10679,56,2772,0,0,0,0,0
24.857,6,5507,6381540,2185,479,11,1432,90680,3322,1856,6,15752,6290860
20.122,6,18,2368,10,189,2235,517,1298,8,323,2872,499,1070
0.174,17,2,376,1,39,0,39,67,1,281,0,281,309
1772.658,6,242,17981,121,69,14772,69,8980,121,34,14772,48,9001
1794.501,6,127,12474,78,62,23305,722,6423,49,85,37377,1408,6051
1793.356,1,184,10304,184,28,9799,28,10304,0,0,0,0,0
1799.034,17,455,40516,408,36,4420,288,26160,47,277,38319,288,14356
0.023,17,2,392,1,32,0,32,60,1,304,0,304,332
280.246,6,28,7352,12,158,25476,267,1277,16,603,18677,1400,6075
1798.511,6,356,22520,208,69,8688,69,12460,148,69,12234,69,10060
1764.957,2,14,448,14,8,135765,8,448,0,0,0,0,0
1787.455,6,104,8308,68,64,26678,64,4896,36,58,51067,58,3412
1.09,17,6,519,3,34,543,34,186,3,83,542,91,333
26.301,6,9,492,5,0,6575,0,268,4,0,8725,0,224
0.112,6,9,1338,5,549,28,549,753,4,421,30,421,585
24.278,6,27,5050,11,204,2427,722,1592,16,262,1599,1448,3458
1280.012,6,12,1722,12,103,116364,138,1722,0,0,0,0,0
0.518,17,2,384,1,39,0,39,67,1,289,0,289,317
1741.342,17,30,7050,30,207,60046,207,7050,0,0,0,0,0
0.174,17,2,152,1,48,0,48,76,1,48,0,48,76
1794.493,17,180,11520,180,36,10025,36,11520,0,0,0,0,0
0.122,17,2,180,1,30,0,30,58,1,94,0,94,122
1340.696,6,131,96765,52,241,24220,241,2923,79,1147,17188,1460,93842
280.436,6,30,7432,13,158,23369,267,1317,17,543,17525,1400,6115
240.382,6,45,9033,21,520,12016,1418,5786,24,221,10450,618,3247
20.052,17,29,2135,20,40,1054,41,1373,9,56,2017,57,762
0.373,6,51,23114,29,1050,13,1380,17992,22,421,16,1923,5122
1799.065,1,56,4704,56,56,32710,56,4704,0,0,0,0,0
1.562,6,2,92,1,0,0,0,40,1,0,0,0,52
1169.524,1,120,6720,120,28,9827,28,6720,0,0,0,0,0
1711.148,17,16,1184,8,30,244445,30,464,8,62,244445,62,720
2.328,6,25,8056,12,164,179,267,1288,13,869,166,1448,6768
1798.14,17,450,39960,405,35,4450,288,25740,45,288,40019,288,14220
4.575,6,38,7229,19,218,254,314,3383,19,513,240,1179,3846
0.504,6,6,328,4,0,168,0,216,2,0,431,0,112
0.439,6,43,20845,24,189,19,682,2391,19,1454,23,4580,18454
1.085,6,24,5836,13,161,90,267,1491,11,780,97,1460,4345
0.489,17,2,136,1,32,0,32,60,1,48,0,48,76
0.104,17,2,519,1,40,0,40,68,1,423,0,423,451
1756.732,6,111,6628,62,26,28798,26,3652,49,26,36596,26,2976
1.057,6,11,1264,5,256,261,256,716,6,304,208,304,548
1.355,6,50,18386,28,882,50,1360,12685,22,400,54,1360,5701
15.216,6,12,656,5,0,3804,0,276,7,0,2502,0,380
0.163,17,2,300,1,58,0,58,86,1,186,0,186,214
1799.999,6,206,14278,75,46,23919,46,6002,131,46,13846,46,8276
1772.646,6,180,15480,120,69,14896,69,8940,60,69,30037,69,6540
1740.092,6,87,6322,58,31,30527,31,3915,29,31,62145,31,2407
1797.233,17,449,39928,404,35,4459,288,25708,45,288,40020,288,14220
19.804,17,25,1891,14,40,1523,41,960,11,56,1978,57,931
1759.341,1,98,5488,98,28,18137,28,5488,0,0,0,0,0
1772.849,6,131,8039,71,27,25325,27,4277,60,27,30047,27,3762
4.267,6,38,7245,19,218,237,314,3383,19,442,222,1152,3862
119.091,17,4,1374,4,315,39697,329,1374,0,0,0,0,0
229.163,17,8,704,4,60,76387,60,352,4,60,76387,60,352
0.045,17,2,227,1,44,0,44,72,1,127,0,127,155
3.51,17,10,2770,5,30,874,30,290,5,468,870,468,2480
1770.976,6,104,9648,68,65,26432,65,5758,36,59,50596,59,3890
8.577,6,37,8539,18,402,504,891,1994,19,412,467,1360,6545
95.63,6,28,7376,11,141,9563,267,1295,17,414,5968,1460,6081
953.167,6,97,8434,60,69,14773,69,4470,37,69,26476,69,3964
130.55,17,10,3360,10,308,14505,308,3360,0,0,0,0,0
4.471,6,37,7189,19,218,248,314,3383,18,513,247,1179,3806
1.066,6,23,7952,12,164,82,267,1288,11,1216,90,3819,6664
1764.859,1,58,4872,58,56,30962,56,4872,0,0,0,0,0
1696.167,17,14,1036,7,30,282689,30,406,7,62,282686,62,630
17.759,6,17,6035,9,290,2219,517,1069,8,1135,2536,1408,4966
374.493,6,52,10688,30,279,12913,1360,4913,22,325,430,1360,5775
240.813,6,48,6376,24,209,10468,585,3166,24,195,10469,580,3210
223.838,6,33,8271,11,141,22382,267,1295,22,358,10658,1460,6976
902.485,2,11,352,11,8,90248,8,352,0,0,0,0,0
1795.636,17,447,39864,402,35,4477,288,25644,45,288,40022,288,14220
7.619,6,429,481808,255,249,29,255,23358,174,2658,43,16824,458450
1793.521,6,410,34385,217,91,8303,1189,15475,193,131,9341,1917,18910
0.187,6,26,7256,12,155,17,267,1261,14,603,12,1400,5995
121.182,6,43,8801,21,412,803,889,2168,22,521,5764,4080,6633
2.696,17,30,13561,15,627,192,1350,9831,15,220,117,1350,3730
1785.517,17,87,3648,86,14,21006,14,3612,1,8,0,8,36
4.295,6,38,7245,20,218,226,314,3423,18,516,237,1179,3822
1759.223,1,8,448,8,28,251317,28,448,0,0,0,0,0
1799.151,17,362,84564,362,205,4983,422,84564,0,0,0,0,0
60.172,6,21,15266,7,142,38,142,426,14,1297,4622,1452,14840
126.764,6,34,7935,12,155,29,267,1266,22,340,6036,3417,6669
297.766,1,4,224,4,28,99255,28,224,0,0,0,0,0
151.293,17,7,2352,7,308,25215,308,2352,0,0,0,0,0
124.388,6,34,7797,13,155,10365,267,1306,21,352,6219,1997,6491
1797.919,6,356,22520,208,69,8685,69,12460,148,69,12230,69,10060
1744.319,6,94,7151,62,38,28595,205,4424,32,33,56257,98,2727
1799.293,17,458,95960,458,181,3937,353,95960,0,0,0,0,0
1.136,17,24,12029,11,606,113,1350,6979,13,360,60,1350,5050
300.708,6,38,8510,19,308,16706,888,2027,19,475,497,1440,6483
0.697,6,4,160,2,0,615,0,80,2,0,91,0,80
32.941,6,31,4342,14,304,2533,304,2584,17,83,1994,83,1758
696.775,6,83,12593,41,152,17419,721,6253,42,296,16989,2026,6340
45.501,6,28,7217,13,155,3791,267,1306,15,482,3249,2840,5911
226.337,17,4,352,2,60,226336,60,176,2,60,226335,60,176
48.28,1,8,848,8,78,6897,78,848,0,0,0,0,0
59.617,6,544,259460,288,838,207,1152,244573,256,422,232,1179,14887
46.562,6,23,6677,11,181,4656,267,1172,12,836,4230,2045,5505
280.627,6,30,7432,13,158,23385,267,1317,17,543,17538,1400,6115
60.079,17,28,2339,26,30,2402,37,1515,2,384,367,463,824
1754.221,6,96,7286,63,38,28293,205,4476,33,33,54809,98,2810
1798.092,17,517,45884,405,35,4450,288,25784,112,151,15911,308,20100
1259.393,2,9,288,9,8,157424,8,288,0,0,0,0,0
421.264,17,10,3668,10,338,46807,548,3668,0,0,0,0,0
5.232,6,13,6174,5,275,1308,275,479,8,1073,408,2007,5695
1793.962,17,139,11108,71,48,25626,48,5396,68,56,26774,56,5712
372.301,6,27,1767,18,177,21900,177,1181,9,110,8592,110,586
5.465,6,40,7309,21,218,273,314,3463,19,513,289,1179,3846
1739.468,1,56,4704,56,56,31626,56,4704,0,0,0,0,0
0.037,6,9,1340,5,145,9,145,349,4,827,10,827,991
1798.905,17,772,46568,772,32,2333,37,46568,0,0,0,0,0
1787.309,6,99,8118,66,66,27497,66,4818,33,60,55847,60,3300
1759.986,6,178,11003,90,48,19775,208,6553,88,31,20226,31,4450
1763.847,2,15,480,15,8,125989,8,480,0,0,0,0,0
61.775,17,6,1236,3,48,30880,48,228,3,308,30880,308,1008
0.239,17,2,266,1,41,0,41,69,1,169,0,169,197
92.821,17,3,228,3,48,46410,48,228,0,0,0,0,0
60.642,17,4,240,2,32,60641,32,120,2,32,60641,32,120
0.0,6,1,64,1,0,0,0,64,0,0,0,0,0
178.323,17,4,530,2,36,178318,36,128,2,173,178318,187,402
1700.505,17,12,498,11,14,170050,14,462,1,8,0,8,36
1773.203,6,181,15589,120,69,14900,69,8940,61,69,29547,69,6649
1111.783,17,220,16720,220,48,5076,48,16720,0,0,0,0,0
0.013,17,2,200,1,64,0,64,92,1,80,0,80,108
299.331,17,4,352,2,60,299329,60,176,2,60,299330,60,176
76.7,6,32,7452,14,156,5900,267,1352,18,447,4501,1917,6100
394.479,6,89,15567,41,312,9861,1368,7450,48,255,8392,1368,8117
1.946,6,18,4563,11,327,193,634,1888,7,575,322,1328,2675
4.194,17,24,7225,9,295,524,1350,2915,15,259,228,1350,4310
0.914,17,2,290,1,40,0,40,68,1,194,0,194,222
0.059,17,4,284,2,32,0,32,120,2,54,0,60,164
1782.0,17,140,11200,70,48,25825,48,5320,70,56,25825,56,5880
1761.573,1,57,4788,57,56,31456,56,4788,0,0,0,0,0
1741.331,6,87,6322,58,31,30549,31,3915,29,31,62188,31,2407
1795.607,17,448,39896,403,35,4466,288,25676,45,288,40018,288,14220
301.025,6,46,13127,21,783,15042,1360,7139,25,292,12535,2667,5988
1788.485,6,116,13902,75,82,24168,515,5964,41,161,44709,1452,7938
1784.592,17,285,61939,285,189,6283,422,61939,0,0,0,0,0
0.152,17,2,348,1,39,0,39,67,1,253,0,253,281
1778.901,6,104,8376,68,65,26550,65,4930,36,59,50823,59,3446
1.019,6,65,41998,39,1244,26,1360,36456,26,561,33,2744,5542
280.543,6,28,7352,12,158,25503,267,1277,16,603,18694,2036,6075
0.611,6,12,2084,6,288,85,288,560,6,424,86,434,1524
241.82,6,42,8984,19,165,13434,517,2022,23,575,10991,2684,6962
31.735,6,7,308,1,0,0,0,44,6,0,6310,0,264
1771.132,1,58,4872,0,0,0,0,0,58,56,31072,56,4872
4.446,6,39,7269,21,218,222,314,3463,18,513,245,1179,3806
1772.288,6,180,15480,120,69,14893,69,8940,60,69,30034,69,6540
300.467,6,74,48497,39,263,7907,474,3102,35,1405,973,2736,45395
108.993,17,4,352,2,60,108992,60,176,2,60,108992,60,176
0.029,6,9,1557,5,515,7,515,783,4,558,9,558,774
1795.753,6,161,15154,81,55,22446,517,5780,80,164,22730,1418,9374
4.887,6,39,7269,19,218,271,314,3383,20,440,243,1152,3886
1792.657,1,74,6216,0,0,0,0,0,74,56,24556,56,6216
3.336,17,2,778,2,361,3336,361,778,0,0,0,0,0
70.144,6,25,6252,10,139,332,159,1098,15,873,5009,1658,5154
280.26,6,30,7432,13,158,23355,267,1317,17,543,17511,1400,6115
1740.804,17,28,6580,28,207,64474,207,6580,0,0,0,0,0
1.026,17,2,312,2,128,1026,128,312,0,0,0,0,0
1772.735,6,180,15480,120,69,14896,69,8940,60,69,30045,69,6540
66.982,6,148,132964,87,423,778,628,5863,61,2136,1112,7040,127101
9.727,6,12,4994,4,517,3242,517,721,8,1275,1302,1408,4273
14.56,6,4,172,2,0,14550,0,88,2,0,14550,0,84
1772.537,6,181,15520,120,69,14895,69,8940,61,69,29533,69,6580
1740.023,6,87,6322,58,31,30526,31,3915,29,31,62143,31,2407
0.454,6,12,1653,6,288,85,288,548,6,426,52,434,1105
0.013,6,10,1514,5,503,3,503,771,5,475,2,475,743
1.223,6,4,160,3,0,249,0,120,1,0,0,0,40
1796.001,17,477,160284,477,308,3773,320,160284,0,0,0,0,0
5.515,6,40,7309,21,218,275,314,3463,19,513,292,1179,3846
75.626,6,736,346725,384,841,197,1152,326799,352,417,214,1179,19926
1624.37,2,16,512,16,8,108291,8,512,0,0,0,0,0
0.116,6,10,1671,6,552,23,948,1348,4,159,38,159,323
1741.12,6,91,6604,59,31,30019,31,3998,32,31,56163,31,2606
0.789,17,2,672,2,308,789,308,672,0,0,0,0,0
2.838,6,2,88,2,0,0,0,88,0,0,0,0,0
1680.387,1,15,840,15,28,120027,28,840,0,0,0,0,0
1787.148,6,102,8296,68,65,26673,65,4930,34,59,54152,59,3366
3.98,17,8,1176,4,48,1323,48,304,4,190,1322,308,872
0.609,6,10,924,5,283,107,283,551,5,105,107,105,373
3.197,6,4,228,1,0,0,0,60,3,0,1514,0,168
29.565,6,121,49186,64,736,469,1360,36477,57,452,525,1360,12709
0.006,17,2,346,1,37,0,37,65,1,253,0,253,281
1790.967,1,333,27972,333,56,5394,56,27972,0,0,0,0,0
198.187,6,35,8931,23,191,9008,1258,3321,12,622,2350,1448,5610
1744.724,2,26,832,26,8,69788,8,832,0,0,0,0,0
3.777,17,4,1564,4,363,1259,363,1564,0,0,0,0,0
0.735,6,20,7238,12,335,63,668,1974,8,1210,101,1946,5264
0.016,17,4,398,2,46,11,46,148,2,97,11,103,250
27.755,6,45,12935,21,199,1387,722,2439,24,733,1162,1380,10496
1782.397,17,83,3480,82,14,22004,14,3444,1,8,0,8,36
1772.181,6,180,15480,120,69,14892,69,8940,60,69,30035,69,6540
481.282,2,5,160,5,8,120320,8,160,0,0,0,0,0
0.274,17,2,166,1,47,0,47,75,1,63,0,63,91
1789.554,1,255,14280,255,28,7045,28,14280,0,0,0,0,0
1793.624,17,144,11520,72,48,25262,48,5472,72,56,25262,56,6048
4.913,17,6,432,3,36,2405,36,192,3,52,2416,52,240
1796.678,6,182,15698,118,69,14894,69,8791,64,69,28518,69,6907
61.298,6,34,12290,20,564,3226,1440,5564,14,665,4696,1440,6726
10.987,6,90,27101,45,558,249,1152,20803,45,449,244,1179,6298
11.603,17,8,704,4,48,3864,48,304,4,72,3864,72,400
1637.913,2,14,448,14,8,125993,8,448,0,0,0,0,0
1787.436,6,112,8944,72,65,25175,65,5220,40,59,45821,59,3724
23.439,6,31,8738,15,340,1674,721,2645,16,605,1550,1440,6093
5.226,6,34,6169,18,206,307,314,2784,16,548,327,1179,3385
0.068,1,2,112,2,28,68,28,112,0,0,0,0,0
0.547,6,24,7449,13,334,45,663,2021,11,806,49,1368,5428
0.105,6,3,160,2,0,105,0,100,1,0,0,0,60
0.935,17,19,7559,9,501,116,1350,4761,10,251,97,1350,2798
1700.431,17,12,498,11,14,170043,14,462,1,8,0,8,36
438.082,6,107266,106276124,37459,66,11,533,2043849,69807,1441,6,4254,104232275
125.908,2,2,64,2,8,125908,8,64,0,0,0,0,0
1649.369,1,8,448,8,28,235624,28,448,0,0,0,0,0
1745.013,6,95,7203,63,38,28145,205,4476,32,33,56282,98,2727
1.63,6,38,8252,19,320,90,1162,2716,19,433,78,1360,5536
280.387,6,23,7014,11,181,28038,267,1168,12,766,25487,2045,5846
1799.714,6,127,12504,78,62,23372,722,6422,49,86,37488,1408,6082
2.912,6,2,88,2,0,0,0,88,0,0,0,0,0
69.089,6,25,7097,12,155,6280,267,1266,13,589,5756,2840,5831
60.09,6,11,3103,11,230,6009,250,3103,0,0,0,0,0
0.047,17,2,283,1,31,0,31,59,1,196,0,196,224
1787.903,6,365,25501,213,99,8433,469,15005,152,69,11840,69,10496
35.06,17,4,240,2,32,35059,32,120,2,32,35059,32,120
21.982,6,31,8912,14,158,1690,267,1357,17,763,1366,2076,7555
1795.637,1,82,4592,82,28,22168,28,4592,0,0,0,0,0
91.159,6,9,820,5,226,22789,226,494,4,110,30128,110,326
1.429,6,42,10077,23,440,64,1360,4496,19,400,69,1360,5581
0.114,6,10,1669,6,551,22,947,1346,4,159,37,159,323
1680.504,17,12,498,11,14,168050,14,462,1,8,0,8,36
280.254,6,28,7352,13,158,23354,267,1317,15,603,20016,2036,6035
0.892,6,11,1727,7,100,148,100,384,4,589,212,1152,1343
128.691,17,4,352,2,60,128690,60,176,2,60,128690,60,176
101.291,6,25,10953,12,380,62,832,1709,13,968,8429,1360,9244
164.918,6,22,900,8,0,6947,0,324,14,0,12685,0,576
2.076,17,2,677,1,300,0,300,328,1,321,0,321,349
0.087,6,3,160,2,0,87,0,100,1,0,0,0,60
29.463,17,19,12022,10,663,3273,1350,6913,9,539,47,1350,5109
33.812,17,4,352,2,60,33810,60,176,2,60,33810,60,176
0.056,17,3,244,2,32,9,32,120,1,96,0,96,124
377.88,2,3,96,3,8,188940,8,96,0,0,0,0,0
1682.706,17,12,498,11,14,168270,14,462,1,8,0,8,36
1783.452,6,184,33187,121,304,14862,304,24836,63,83,28765,83,8351
11.555,6,9,376,5,0,2886,0,204,4,0,3846,0,172
0.877,17,2,677,1,300,0,300,328,1,321,0,321,349
9.142,6,1800,1672042,1146,1381,7,1408,1633370,654,931,13,2816,38672
0.611,17,2,167,1,39,0,39,67,1,72,0,72,100
1770.761,6,99,9240,66,65,27242,65,5577,33,59,55333,59,3663
0.001,6,3,120,1,0,0,0,40,2,0,1,0,80
1112.615,6,53,2744,27,0,42790,0,1404,26,0,44501,0,1340
300.595,6,40,8630,21,308,15029,885,2116,19,441,470,1360,6514
281.797,1,3,180,3,32,140898,32,180,0,0,0,0,0
0.811,6,52,13885,24,553,35,1429,4856,28,438,29,1460,9029
0.139,17,2,178,1,37,0,37,65,1,85,0,85,113
32.211,6,8,448,2,0,32211,0,112,6,0,6318,0,336
1798.07,17,449,39928,404,35,4461,288,25708,45,288,40018,288,14220
0.315,6,29,9065,14,227,24,547,1644,15,827,22,1408,7421
5.493,6,869,789893,338,851,16,1440,23009,531,1433,10,2880,766884
0.376,6,12,1653,6,288,72,288,548,6,426,42,434,1105
0.004,6,17,44520,1,0,0,0,40,16,2728,0,8448,44480
267.799,6,31,8912,14,158,20599,267,1357,17,687,16736,1781,7555
2.654,17,4,624,4,128,884,128,624,0,0,0,0,0
1.193,6,29,13163,15,549,85,1309,2328,14,933,73,1440,10835
106.522,6,23,9705,11,380,70,832,1613,12,950,9671,1460,8092
1790.078,1,82,4592,82,28,22099,28,4592,0,0,0,0,0
1790.988,1,257,14392,257,28,6996,28,14392,0,0,0,0,0
37.133,1,4,224,4,28,12377,28,224,0,0,0,0,0
31.563,6,7,396,1,0,0,0,60,6,0,6274,0,336
232.118,6,29,6633,17,168,14507,516,1695,12,494,21092,1452,4938
11.898,6,17,4226,9,275,1487,275,918,8,992,890,1440,3308
1781.858,17,142,11360,71,48,25454,48,5396,71,56,25454,56,5964
1774.636,6,181,15589,120,69,14912,69,8940,61,69,29574,69,6649
213.426,17,4,352,2,60,213425,60,176,2,60,213425,60,176
1.399,6,39,8408,19,340,77,1278,2832,20,433,64,1440,5576
0.555,17,2,152,1,48,0,48,76,1,48,0,48,76
1.685,6,14,2351,8,188,240,245,700,6,703,284,1152,1651
1796.407,17,449,39928,404,35,4457,288,25708,45,288,40019,288,14220
348.89,6,21,1680,6,103,69490,138,654,15,42,24920,48,1026
1776.887,17,73,3060,72,14,25026,14,3024,1,8,0,8,36
1747.704,6,94,7151,62,38,28650,205,4424,32,33,56365,98,2727
165.675,6,9,515,5,43,41418,43,299,4,0,55223,0,216
1788.442,17,87,3648,86,14,21040,14,3612,1,8,0,8,36
1774.423,6,184,15778,122,69,14664,69,9020,62,69,29081,69,6758
5.014,17,2,128,2,36,5014,36,128,0,0,0,0,0
1.815,6,25,8705,15,275,129,558,1430,10,981,180,1420,7275
17.54,17,33,24297,15,395,1252,1350,6346,18,969,1026,1350,17951
0.413,6,12,1653,6,288,77,288,548,6,426,45,434,1105
0.097,6,9,1002,5,213,24,213,417,4,421,28,421,585
0.309,6,3,322,2,190,92,190,282,1,0,0,0,40
238.092,6,34,9036,14,158,18314,267,1357,20,624,12530,1400,7679
252.206,2,5,160,5,8,63051,8,160,0,0,0,0,0
293.719,1,4,224,4,28,97906,28,224,0,0,0,0,0
0.012,6,2,80,1,0,0,0,40,1,0,0,0,40
1.363,6,38,9848,20,502,71,1440,4352,18,433,68,1440,5496
280.251,6,28,7352,13,158,23354,267,1317,15,678,20013,3436,6035
240.254,6,52,17801,27,797,9240,1418,14974,25,189,10010,580,2827
204.345,6,29,7392,13,158,17028,267,1317,16,603,13620,2036,6075
0.477,6,13,1693,7,288,76,288,588,6,426,55,434,1105
636.573,1,14,784,14,28,48967,28,784,0,0,0,0,0
1760.174,6,101,8156,66,50,27079,205,5107,35,35,51762,98,3049
0.092,17,2,279,1,36,0,36,64,1,187,0,187,215
300.243,6,31,11810,17,588,18765,1438,4435,14,948,18481,1488,7375
11.33,17,6,528,3,48,5659,48,228,3,72,5657,72,300
0.214,6,11,1905,6,649,42,1141,1542,5,159,53,159,363
109.481,6,53,33968,31,1221,3649,1360,26916,22,1026,5204,2720,7052
1775.363,6,180,15480,120,69,14919,69,8940,60,69,30087,69,6540
2.319,6,13,2311,8,188,331,245,700,5,1407,517,1407,1611
0.786,17,4,240,2,32,785,32,120,2,32,785,32,120
0.011,17,4,352,2,60,10,60,176,2,60,10,60,176
352.596,17,22,7392,22,308,16790,308,7392,0,0,0,0,0
1785.252,6,359,22709,209,69,8582,69,12569,150,69,11981,69,10140
102.729,17,8,1176,4,48,34240,48,304,4,190,34240,308,872
1751.178,17,13,534,11,14,175093,14,462,2,8,1750950,8,72
1.32,6,48,18877,26,934,52,1460,13221,22,433,54,1460,5656
9.213,6,26,7275,8,152,1316,267,1244,18,441,536,1460,6031
1799.679,17,601,36286,601,32,2999,37,36286,0,0,0,0,0
221.265,6,29,7392,13,158,18438,267,1317,16,603,14745,2036,6075
250.443,17,4,352,2,60,250442,60,176,2,60,250442,60,176
23.703,1,4,224,4,28,7901,28,224,0,0,0,0,0
4.066,2,2,64,2,8,4066,8,64,0,0,0,0,0
1747.462,6,95,7203,63,38,28184,205,4476,32,33,56360,98,2727
13.678,6,28,7493,11,155,1367,267,1226,17,429,854,3426,6267
0.076,6,10,1495,5,507,19,507,727,5,556,18,556,768
1512.261,17,399,41448,190,126,8001,1350,29306,209,30,7270,60,12142
158.464,6,21,8224,11,549,89,1309,2120,10,948,17587,1591,6104
539.412,2,5,160,5,8,134853,8,160,0,0,0,0,0
0.017,17,4,624,2,64,3,64,184,2,192,0,192,440
1740.433,17,29,6699,29,203,62158,203,6699,0,0,0,0,0
1.421,6,58,17938,30,699,49,1360,8909,28,493,52,3546,9029
1743.08,6,96,7286,63,38,28114,205,4476,33,33,54465,98,2810
1786.626,6,102,8228,68,64,26666,64,4896,34,58,54137,58,3332
30.148,6,42,9912,20,251,1586,721,3575,22,681,1379,1440,6337
112.52,6,7,434,2,106,112520,106,194,5,0,3830,0,240
0.897,6,11,1727,7,100,149,100,384,4,589,213,1152,1343
1787.111,17,87,3648,86,14,21024,14,3612,1,8,0,8,36
10.259,6,33,7029,18,238,603,314,3343,15,513,328,1179,3686
458.752,17,6,360,3,32,229375,32,180,3,32,229375,32,180
1.164,6,22,7900,11,164,98,267,1236,11,1216,98,3819,6664
0.29,6,27,9112,13,271,24,726,1771,14,943,21,1408,7341
1797.408,17,448,39896,403,35,4471,288,25676,45,288,40017,288,14220
1785.337,17,87,3648,86,14,21003,14,3612,1,8,0,8,36
1747.573,6,127,8020,71,47,24965,208,4850,56,31,31727,31,3170
13.648,17,6,5144,6,829,2729,1451,5144,0,0,0,0,0
1798.196,1,345,28980,345,56,5227,56,28980,0,0,0,0,0
0.042,17,4,284,2,32,35,32,120,2,54,35,60,164
11.709,6,1829,1600825,1131,1362,10,1380,1568663,698,421,16,1923,32162
0.053,17,4,420,2,33,0,33,122,2,121,17,145,298
463.594,17,45,5210,45,87,10536,355,5210,0,0,0,0,0
5.106,17,3,208,2,36,5008,36,128,1,52,0,52,80
1795.063,17,448,39896,403,35,4465,288,25676,45,288,40018,288,14220
714.399,1,4,224,4,28,238133,28,224,0,0,0,0,0
596.715,1,7,2803,7,372,99452,432,2803,0,0,0,0,0
0.412,6,27,8955,13,234,34,575,1620,14,942,30,1448,7335
1793.161,6,363,22938,210,69,8579,69,12678,153,69,11796,69,10260
0.575,6,10,1840,5,901,143,901,1169,5,403,143,403,671
541.421,2,5,160,5,8,135355,8,160,0,0,0,0,0
0.383,17,8,2750,8,315,54,354,2750,0,0,0,0,0
28.782,6,43,8876,20,410,469,882,2110,23,364,1302,1440,6766
1799.092,6,390,25628,208,81,8670,469,13398,182,52,9939,69,12230
11.837,6,25,8453,13,275,986,275,1078,12,983,870,1420,7375
1772.656,6,181,15589,120,69,14896,69,8940,61,69,29543,69,6649
375.709,17,7,824,7,89,62618,352,824,0,0,0,0,0
0.111,17,2,180,1,30,0,30,58,1,94,0,94,122
1786.562,6,104,8308,68,64,26665,64,4896,36,58,51042,58,3412
6.602,6,40,7325,19,218,255,314,3383,21,516,317,1179,3942
40.934,6,30,7297,14,155,3148,267,1346,16,441,2728,1420,5951
11.628,6,90,26845,46,551,258,1152,20587,44,449,264,1179,6258
1776.262,17,73,3060,72,14,25017,14,3024,1,8,0,8,36
3.094,17,8,720,4,30,1016,30,232,4,94,1012,94,488
0.002,17,6,1786,6,269,0,317,1786,0,0,0,0,0
114.211,6,45,6300,16,144,1219,722,1998,29,146,4072,1408,4302
1781.172,1,232,12992,232,28,7710,28,12992,0,0,0,0,0
280.216,6,29,7392,13,158,23351,267,1317,16,543,18680,1400,6075
446.872,6,56,12672,28,244,16550,1189,5523,28,401,3538,1926,7149
1.174,17,25,13006,12,773,106,1350,9621,13,232,65,1350,3385
1781.781,6,83,4444,42,26,43457,26,2248,41,26,44543,26,2196
124.287,6,42,10031,15,269,3332,1189,2762,27,343,4779,1926,7269
4.163,6,102,72619,58,909,73,1360,13270,44,1556,92,5295,59349
470.313,6,56,9877,23,107,21377,267,2327,33,248,7443,1452,7550
1.079,6,37,23990,19,840,59,1360,5835,18,1340,49,2720,18155
1786.516,6,112,8944,71,66,25521,66,5084,41,60,44660,60,3860
1798.663,6,83,4458,42,26,43868,26,2248,41,26,44965,26,2210
2.287,6,13,2002,7,279,381,279,918,6,191,312,272,1084
0.668,6,25,6053,13,108,55,147,959,12,768,57,1581,5094
60.25,6,24,10824,13,651,5020,1408,3967,11,896,6019,1408,6857
280.038,6,28,7352,12,158,25458,267,1277,16,603,18666,1400,6075
2.714,6,22,5937,9,108,338,147,799,13,768,225,1581,5138
0.329,17,12,6477,6,615,65,1350,3860,6,408,48,1350,2617
0.217,17,2,692,2,318,217,353,692,0,0,0,0,0
367.001,6,18,1242,14,180,28230,180,916,4,110,20068,110,326
0.023,6,2,116,1,0,0,0,64,1,0,0,0,52
1713.147,6,222,17300,83,73,20885,375,8240,139,49,12414,143,9060
0.41,17,2,144,1,36,0,36,64,1,52,0,52,80
4.122,1,5,420,5,56,1030,56,420,0,0,0,0,0
3.359,17,5,290,5,30,839,30,290,0,0,0,0,0
4.999,17,4,488,4,94,1666,94,488,0,0,0,0,0
1787.172,6,104,8376,68,65,26674,65,4930,36,59,51058,59,3446
1770.793,6,103,9448,66,65,27242,65,5577,37,59,49186,59,3871
0.425,6,26,7751,16,339,28,949,3017,10,721,45,1420,4734
7.549,6,43,7818,21,218,377,314,3463,22,433,347,1152,4355
12.065,17,4,5488,4,1344,4021,1349,5488,0,0,0,0,0
372.092,6,25,1651,17,177,23255,177,1117,8,110,9259,110,534
5.333,6,73,27745,37,949,148,1440,16787,36,521,147,1440,10958
0.014,6,3,2880,1,0,0,0,40,2,1368,12,1368,2840
1756.249,6,147,9276,79,48,22516,208,5595,68,31,26207,31,3681
1592.206,1,8,448,8,28,227458,28,448,0,0,0,0,0
0.043,6,12,3656,6,124,8,124,444,6,964,8,1448,3212
1786.517,6,106,8524,68,66,26664,66,4964,38,60,48281,60,3560
280.365,6,31,7472,13,158,23363,267,1317,18,603,16489,2760,6155
173.078,6,34,16521,18,960,1234,1360,8438,16,928,11526,2720,8083
2.696,17,48,37126,20,439,141,1350,9342,28,964,91,1350,27784
281.506,6,27,7312,13,158,23458,267,1317,14,775,21636,4836,5995
0.006,6,17,41912,1,0,0,0,40,16,2565,0,6840,41872
0.045,6,10,1512,5,503,11,503,771,5,473,11,473,741
0.741,17,2,196,1,46,0,46,74,1,94,0,94,122
0.263,6,2,133,1,0,0,0,40,1,53,0,53,93
7.602,6,1212,1054899,734,1388,10,1420,1031558,478,467,15,1883,23341
17.602,6,12,2352,7,211,2899,211,1005,5,545,4400,904,1347
12.204,6,1900,1676774,1184,1363,10,1380,1643892,716,421,17,1923,32882
13.928,6,1942,1782166,1252,1371,11,1380,1745788,690,436,20,3303,36378
1792.793,17,142,11360,71,48,25610,48,5396,71,56,25610,56,5964
0.417,6,53,21810,30,1022,14,1380,16603,23,387,17,1923,5207
374.351,17,6,424,3,42,187174,64,212,3,42,187174,64,212
99.602,6,50,14089,26,891,3978,1460,8265,24,346,4323,1460,5824
1709.982,1,8,448,8,28,244283,28,448,0,0,0,0,0
1.115,6,32,10643,20,294,58,1305,3190,12,994,84,4649,7453
0.384,17,2,304,1,60,0,60,88,1,188,0,188,216
300.756,2,3,96,3,8,150378,8,96,0,0,0,0,0
0.297,17,2,136,1,32,0,32,60,1,48,0,48,76
22.741,6,32,8056,15,188,1624,721,1923,17,681,1410,1440,6133
1.64,6,30,10317,18,368,96,837,1829,12,1000,140,1452,8488
15.74,6,8,440,4,0,5246,0,216,4,0,5049,0,224
1136.041,6,259,18477,113,119,10143,469,9280,146,36,7833,48,9197
1681.28,17,13,534,11,14,168053,14,462,2,8,1681095,8,72
1796.44,6,475,27280,267,69,6753,69,14820,208,34,8678,64,12460
0.07,17,2,912,1,308,0,308,336,1,548,0,548,576
1794.137,17,143,11436,72,48,25264,48,5472,71,56,25628,56,5964
372.392,6,27,1767,18,177,21905,177,1181,9,110,8767,110,586
12.11,6,1942,1671491,1166,1377,10,1420,1636218,776,420,15,1420,35273
0.012,17,2,182,1,39,0,39,67,1,87,0,87,115
1794.353,1,57,4788,57,56,32042,56,4788,0,0,0,0,0
1791.104,1,60,5040,60,56,30357,56,5040,0,0,0,0,0
0.634,17,2,178,1,29,0,29,57,1,93,0,93,121
1.739,17,6,1054,3,36,867,36,192,3,259,867,274,862
104.47,6,29,9644,14,521,57,955,2689,15,576,7453,1360,6955
152.714,17,4,352,2,60,152713,60,176,2,60,152712,60,176
1039.1,17,204,15504,204,48,5118,48,15504,0,0,0,0,0
5.263,17,3,208,2,36,5005,36,128,1,52,0,52,80
1797.12,17,80,3354,79,14,23040,14,3318,1,8,0,8,36
115.122,6,23,6098,13,216,9593,501,1390,10,614,12780,1420,4708
0.104,17,2,2384,2,1164,104,1164,2384,0,0,0,0,0
3.068,17,19,5691,8,319,438,1350,2777,11,236,298,1350,2914
240.239,6,51,18449,27,825,9239,1408,15443,24,218,10445,580,3006
0.016,17,4,350,2,34,10,34,124,2,85,9,91,226
160.767,1,6,336,6,28,32153,28,336,0,0,0,0,0
0.079,6,2,111,1,0,0,0,40,1,31,0,31,71
1789.993,6,417,24960,209,69,8605,69,12500,208,34,8647,48,12460
1.31,6,50,18350,28,882,48,1360,12649,22,400,53,1360,5701
177.615,6,275,219808,173,1305,1032,1408,202217,102,646,1515,3847,17591
20.463,6,27,6388,15,117,1461,159,1389,12,727,1859,1418,4999
37.34,17,11,836,11,48,3734,48,836,0,0,0,0,0
3.302,17,16,2048,16,100,220,355,2048,0,0,0,0,0
0.295,6,25,4623,12,165,26,456,1446,13,415,23,888,3177
1764.028,1,138,7728,138,28,12876,28,7728,0,0,0,0,0
260.211,6,312,256704,201,1325,1301,1408,235811,111,581,2333,2439,20893
48.319,17,4,5456,4,1336,16106,1336,5456,0,0,0,0,0
1793.238,6,356,22520,208,69,8662,69,12460,148,69,12197,69,10060
1784.046,17,138,11040,69,48,26235,48,5244,69,56,26235,56,5796
1787.519,6,115,13719,75,81,24155,505,5954,40,162,45831,1420,7765
14.735,6,8,440,5,0,3683,0,268,3,0,7059,0,172
0.92,6,21,7842,11,501,92,1196,1975,10,909,75,1591,5867
0.593,6,10,861,5,222,145,222,426,5,231,145,231,435
1760.815,6,108,8664,70,66,25519,66,5044,38,60,47323,60,3620
0.719,6,4,172,2,0,300,0,92,2,0,560,0,80
1795.829,17,449,39928,404,35,4456,288,25708,45,288,40021,288,14220
1794.01,17,144,11520,72,48,25267,48,5472,72,56,25267,56,6048
0.059,17,4,420,2,33,9,33,122,2,121,47,145,298
3.871,6,32,6089,17,206,241,314,2744,15,548,257,1179,3345
60.094,6,28,6832,14,255,4622,517,2002,14,454,4621,1408,4830
240.18,6,53,17690,28,796,8895,1402,15001,25,172,10007,580,2689
1770.842,6,101,9344,66,65,27243,65,5577,35,59,52081,59,3767
1786.33,6,108,8536,68,65,26661,65,4930,40,59,45800,59,3606
5.161,17,12,864,6,33,1031,33,366,6,55,1030,61,498
9.608,17,49,21294,25,491,399,1350,12989,24,318,416,1350,8305
1.094,6,777,585859,386,183,2,230,21497,391,1398,2,1451,564362
127.421,6,19,3818,5,92,31855,92,348,14,248,9784,1408,3470
2.305,6,30,10406,18,367,135,833,1825,12,1012,202,1420,8581
29.419,6,47,16458,25,1078,499,1360,10776,22,435,1392,2667,5682
1787.887,6,171,19860,96,120,18819,722,11762,75,67,24157,1408,8098
4.849,6,40,7309,21,218,242,314,3463,19,513,255,1179,3846
1799.993,1,16,896,16,28,119999,28,896,0,0,0,0,0
1744.821,1,67,5628,67,56,26436,56,5628,0,0,0,0,0
60.21,2,2,64,2,8,60210,8,64,0,0,0,0,0
137.184,17,4,352,2,60,137183,60,176,2,60,137183,60,176
1793.5,17,83,3480,82,14,22141,14,3444,1,8,0,8,36
1.8,6,9,527,5,43,450,43,311,4,0,598,0,216
128.903,17,4,240,2,32,128901,32,120,2,32,128901,32,120
0.576,6,27,9135,13,268,48,711,1768,14,945,40,1368,7367
0.301,17,2,212,1,46,0,46,74,1,110,0,110,138
11.029,6,18,1415,9,222,1377,222,808,9,231,1377,231,607
0.012,17,3,234,2,39,1,39,134,1,72,0,72,100
1.38,6,37,9808,20,502,72,1440,4352,17,433,75,1440,5456
4.599,17,2,656,2,300,4599,300,656,0,0,0,0,0
0.254,6,26,6168,12,181,23,537,1526,14,558,18,1408,4642
0.233,6,20,4960,10,137,25,267,1092,10,692,25,1467,3868
11.583,6,25,8453,13,275,965,275,1078,12,983,758,1420,7375
184.644,17,4,352,2,60,184643,60,176,2,60,184643,60,176
32.054,6,289,238349,137,122,235,288,7622,152,1505,212,2816,230727
1774.857,1,206,11536,206,28,8657,28,11536,0,0,0,0,0
0.102,6,2,123,1,31,0,31,83,1,0,0,0,40
292.084,6,55,8546,27,106,11232,517,2421,28,356,10816,1418,6125
1776.319,6,182,15698,120,69,14927,69,8940,62,69,29118,69,6758
0.01,1,2,212,2,78,10,78,212,0,0,0,0,0
1595.156,17,156,56901,156,336,10291,359,56901,0,0,0,0,0
348.292,6,52,6847,28,116,12899,721,2744,24,190,15133,1448,4103
1785.496,6,389,24080,222,69,8079,69,13020,167,55,10755,69,11060
1747.984,6,102,7598,63,38,28193,205,4476,39,33,45988,98,3122
280.201,6,27,7312,13,158,23350,267,1317,14,775,21549,2800,5995
0.033,17,2,146,1,37,0,37,65,1,53,0,53,81
0.014,6,2,104,1,0,0,0,52,1,0,0,0,52
1.646,6,27,10177,16,284,109,586,1498,11,1029,148,1420,8679
1798.987,17,449,39928,404,35,4463,288,25708,45,288,40020,288,14220
1.77,17,3,1230,3,382,885,392,1230,0,0,0,0,0
0.239,1,2,112,2,28,239,28,112,0,0,0,0,0
3.078,17,2,656,2,300,3078,300,656,0,0,0,0,0
18.034,6,2758,2641905,1777,1408,10,1440,2586205,981,776,18,1440,55700
5.995,6,552,444002,319,1320,18,1368,427222,233,776,24,1473,16780
17.125,17,4,288,2,36,17108,36,128,2,52,17097,52,160
1740.599,17,30,7050,30,207,60020,207,7050,0,0,0,0,0
1796.312,6,371,26279,214,105,8433,469,15514,157,69,11514,69,10765
0.106,17,2,152,1,48,0,48,76,1,48,0,48,76
2.087,17,6,1674,3,32,820,32,180,3,470,0,470,1494
10.631,6,42,8071,21,218,531,314,3463,21,470,518,1179,4608
66.154,6,24,10008,12,304,117,610,1436,12,1010,5995,2571,8572
3.28,6,10,427,5,0,820,0,208,5,7,772,7,219
0.64,6,22,7354,13,335,53,668,2026,9,1210,76,1946,5328
24.461,6,95,25138,45,471,555,1440,15038,50,351,486,1440,10100
1752.032,1,10,560,10,28,194670,28,560,0,0,0,0,0
316.673,6,66,19383,34,409,9596,1360,9984,32,386,10210,4649,9399
240.198,6,52,17116,28,763,8895,1418,14451,24,201,10442,580,2665
559.644,6,117,7912,52,46,10942,46,3288,65,46,8744,46,4624
374.552,6,50,11838,25,147,15606,516,2921,25,395,15593,1452,8917
0.57,6,10,1689,5,288,97,288,556,5,432,96,446,1133
1764.005,2,13,416,13,8,147000,8,416,0,0,0,0,0
396.494,6,18,1242,14,180,30499,180,916,4,110,20075,110,326
1759.54,6,125,8037,67,27,26659,27,4048,58,48,30843,427,3989
1786.863,6,108,8654,70,65,25896,65,5010,38,59,48291,59,3644
1.822,6,27,8851,16,286,121,591,1503,11,863,161,1380,7348
0.037,17,2,510,1,37,0,37,65,1,417,0,417,445
478.032,2,5,160,5,8,119508,8,160,0,0,0,0,0
1793.689,6,356,22520,208,69,8665,69,12460,148,69,12201,69,10060
0.18,17,2,157,1,31,0,31,59,1,70,0,70,98
3.904,6,2,88,2,0,0,0,88,0,0,0,0,0
13.452,6,2260,2091190,1447,1369,9,1408,2044250,813,931,16,2816,46940
31.489,6,12,724,4,106,10493,106,274,8,90,4497,90,450
240.251,6,53,16390,28,749,8896,1418,13460,25,202,10009,580,2930
5.231,17,4,288,2,36,5003,36,128,2,52,4966,52,160
3.6,6,43,10383,24,503,156,1460,4551,19,421,174,4075,5832
10.829,6,20,4442,11,275,1082,275,998,9,768,751,1440,3444
0.505,17,3,543,2,39,406,39,134,1,381,0,381,409
1787.903,6,364,23254,209,69,8595,69,12569,155,69,11609,69,10685
0.228,6,27,7296,13,155,19,267,1301,14,603,16,1400,5995
1794.712,17,87,3648,86,14,21114,14,3612,1,8,0,8,36
1.821,17,30,14615,13,453,149,1350,6265,17,463,111,1350,8350
1792.686,17,180,14040,180,50,10015,50,14040,0,0,0,0,0
1798.282,1,126,7056,126,28,14386,28,7056,0,0,0,0,0
1739.219,1,54,4536,0,0,0,0,0,54,56,32815,56,4536
1739.565,6,90,6521,59,31,29992,31,3998,31,31,57984,31,2523
0.242,17,2,136,1,32,0,32,60,1,48,0,48,76
240.187,6,54,18245,29,824,8577,1402,15534,25,175,10007,580,2711
11.627,6,1872,1599435,1128,1363,10,1380,1565433,744,421,15,1923,34002
0.147,6,5,464,4,256,49,256,420,1,0,0,0,44
1795.656,17,447,39864,402,35,4477,288,25644,45,288,40015,288,14220
1720.801,17,12,498,11,14,172080,14,462,1,8,0,8,36
0.007,17,2,158,1,37,0,37,65,1,65,0,65,93
26.145,1,4,224,4,28,8715,28,224,0,0,0,0,0
0.013,6,3,151,1,0,0,0,40,2,31,0,31,111
0.301,17,8,2750,8,315,43,354,2750,0,0,0,0,0
1769.791,17,193,41778,193,188,9217,373,41778,0,0,0,0,0
0.005,17,2,424,1,40,0,40,68,1,328,0,328,356
1794.151,6,368,23276,212,69,8503,69,12896,156,69,11572,69,10380
1790.541,6,356,22520,208,69,8649,69,12460,148,69,12180,69,10060
277.657,1,2,112,2,28,277657,28,112,0,0,0,0,0
8.191,1,9,756,9,56,1023,56,756,0,0,0,0,0
11.594,17,16,17877,16,1089,772,1450,17877,0,0,0,0,0
578.748,17,98,7448,98,48,5966,48,7448,0,0,0,0,0
6.315,6,14,5625,5,106,1576,106,322,9,985,788,1420,5303
1628.742,1,158,16748,158,78,10374,78,16748,0,0,0,0,0
0.443,6,23,7307,13,318,36,600,1958,10,964,47,1471,5349
1650.999,6,152,21042,83,88,20134,721,8432,69,364,12105,1440,12610
1782.577,1,58,4872,0,0,0,0,0,58,56,31273,56,4872
409.229,17,22,4532,11,48,40922,48,836,11,308,40921,308,3696
114.284,6,126,97566,81,1275,1428,1408,87104,45,811,2491,3847,10462
0.036,17,4,284,2,32,25,32,120,2,54,23,60,164
3.597,6,9,527,5,43,899,43,311,4,0,1197,0,216
5.544,6,43,8345,21,227,277,314,4022,22,491,251,1179,4323
1790.084,1,144,15264,144,78,12518,78,15264,0,0,0,0,0
176.826,6,49,32121,22,647,99,1460,4796,27,1311,6795,2374,27325
0.451,6,52,20467,29,1002,16,1380,15260,23,387,19,1923,5207
27.282,6,19,2473,10,302,3031,302,1724,9,83,3408,83,749
0.039,17,2,519,1,40,0,40,68,1,423,0,423,451
77.818,6,34,7685,12,165,7074,267,1149,22,332,3699,1460,6536
10.98,6,88,28119,45,591,249,1152,21917,43,447,255,1179,6202
1783.81,6,357,22629,208,69,8617,69,12460,149,69,12052,69,10169
11.055,17,2,672,2,308,11055,308,672,0,0,0,0,0
0.006,17,2,362,1,30,0,30,58,1,276,0,276,304
1045.933,1,14,784,14,28,80456,28,784,0,0,0,0,0
280.227,6,28,7352,12,158,25475,267,1277,16,603,18679,1400,6075
1394.638,1,7,392,7,28,232439,28,392,0,0,0,0,0
13.885,6,102,34325,52,628,272,1152,27843,50,447,277,1179,6482
56.428,6,41,8586,21,371,748,797,2033,20,574,2963,4848,6553
1799.214,17,442,38852,399,35,4520,288,25264,43,288,41922,288,13588
17.213,6,2421,2240144,1507,1406,11,1448,2187940,914,776,18,1448,52204
15.265,6,743,626256,415,1428,35,1448,602896,328,776,45,1448,23360
0.468,6,10,1840,5,901,117,901,1169,5,403,117,403,671
7.305,6,1420,1259971,865,1376,8,1408,1226447,555,776,12,1408,33524
128.578,6,28,10608,6,154,25715,267,712,22,529,6118,1452,9896
29.589,6,15,3543,5,188,1164,245,580,10,1279,3259,1407,2963
3.079,17,3,543,2,39,1546,39,134,1,381,0,381,409
1795.725,17,444,38916,402,35,4478,288,25644,42,288,42950,288,13272
0.013,6,2,218,1,138,0,138,178,1,0,0,0,40
1697.629,1,8,448,8,28,242518,28,448,0,0,0,0,0
0.175,6,15,4577,7,290,29,517,941,8,1070,22,1418,3636
1756.961,6,94,7151,62,38,28802,205,4424,32,33,56666,98,2727
1791.301,17,140,11200,70,48,25960,48,5320,70,56,25960,56,5880
0.183,17,2,223,1,54,0,54,82,1,113,0,113,141
1772.482,6,180,15480,120,69,14894,69,8940,60,69,30033,69,6540
0.878,17,4,240,2,32,877,32,120,2,32,877,32,120
0.176,6,10,767,5,186,35,186,454,5,45,43,45,313
16.517,17,23,6866,10,304,1831,1350,3328,13,244,1373,1350,3538
104.648,6,31,9050,12,158,9513,267,1277,19,584,5792,1400,7773
0.11,17,2,348,1,39,0,39,67,1,253,0,253,281
1795.886,17,449,39928,404,35,4456,288,25708,45,288,40022,288,14220
1769.827,6,102,9462,66,66,27228,66,5610,36,60,50562,60,3852
1786.292,1,260,14560,260,28,6896,28,14560,0,0,0,0,0
59.45,2,2,64,2,8,59450,8,64,0,0,0,0,0
0.583,6,15,1785,8,288,57,288,640,7,426,68,434,1145
8.682,6,36,8307,17,360,542,734,1794,19,441,472,1360,6513
4.522,6,20,3833,11,234,452,564,1504,9,463,513,1343,2329
28.218,6,49,13273,24,164,1226,721,2777,25,791,1167,2840,10496
300.613,6,38,8566,20,315,15821,882,2093,18,478,499,2720,6473
2.622,6,33,9697,16,158,174,267,1437,17,757,161,1781,8260
0.269,6,9,1340,5,145,67,145,349,4,827,48,827,991
0.236,17,2,574,1,32,0,32,60,1,486,0,486,514
110.629,6,21,8247,11,514,85,1237,2016,10,1163,12273,3151,6231
300.523,6,18,1227,5,177,75089,177,445,13,110,25029,110,782
97.945,17,3,1000,3,305,48972,308,1000,0,0,0,0,0
0.015,6,10,1542,5,505,3,505,773,5,501,3,501,769
1797.653,2,26,832,26,8,71906,8,832,0,0,0,0,0
1022.729,2,11,352,11,8,102272,8,352,0,0,0,0,0
202.405,17,4,352,2,60,202404,60,176,2,60,202404,60,176
7.112,6,67,20166,36,540,203,1152,15499,31,489,228,1179,4667
1.426,6,48,18736,26,923,57,1460,13080,22,433,58,1460,5656
0.008,17,2,463,1,37,0,37,65,1,370,0,370,398
0.005,17,2,128,1,36,0,36,64,1,36,0,36,64
1746.532,6,95,7203,63,38,28169,205,4476,32,33,56326,98,2727
1793.759,17,180,14040,180,50,10021,50,14040,0,0,0,0,0
1795.43,17,448,39896,403,35,4466,288,25676,45,288,40019,288,14220
2.118,17,2,134,2,39,2118,39,134,0,0,0,0,0
0.135,6,44,21350,26,1096,5,1420,16409,18,467,7,1883,4941
299.213,1,4,224,4,28,99737,28,224,0,0,0,0,0
13.649,6,93,27769,45,533,310,1152,21026,48,438,285,1179,6743
0.34,17,2,194,1,61,0,61,89,1,77,0,77,105
2.519,6,14,2351,8,188,359,245,700,6,703,451,1152,1651
1795.257,17,80,3354,79,14,23016,14,3318,1,8,0,8,36
298.398,17,8,2688,8,308,42628,308,2688,0,0,0,0,0
157.475,17,4,240,2,32,157474,32,120,2,32,157474,32,120
0.343,6,7,670,4,180,114,180,396,3,110,86,110,274
1799.75,17,768,46364,768,32,2346,37,46364,0,0,0,0,0
21.371,17,12,1056,6,48,4271,48,456,6,72,4271,72,600
1798.655,17,448,39896,403,35,4474,288,25676,45,288,40020,288,14220
0.016,17,2,240,1,62,0,62,90,1,122,0,122,150
0.521,6,4,232,1,0,0,0,52,3,0,260,0,180
0.245,17,2,784,2,364,245,364,784,0,0,0,0,0
1765.607,6,377,68674,246,316,7206,316,51692,131,83,13581,83,16982
0.118,17,2,290,1,40,0,40,68,1,194,0,194,222
0.626,6,128,84021,70,1297,9,1432,75530,58,513,10,1871,8491
0.874,6,2,87,1,0,0,0,40,1,7,0,7,47
1.091,17,2,148,2,46,1091,46,148,0,0,0,0,0
0.171,17,2,1920,2,932,171,932,1920,0,0,0,0,0
7.789,6,583,499956,359,1324,21,1368,483632,224,776,33,1473,16324
0.4,6,10,1992,5,288,95,288,508,5,424,54,434,1484
1740.543,17,28,29568,28,1028,64464,1028,29568,0,0,0,0,0
0.026,17,8,2446,8,277,3,316,2446,0,0,0,0,0
1798.648,6,357,22560,207,69,8731,69,12420,150,69,12071,69,10140
1.05,6,25,6081,13,108,87,147,959,12,773,93,1608,5122
4.868,6,38,7245,19,218,270,314,3383,19,516,255,1179,3862
0.272,6,9,1340,5,145,68,145,349,4,827,69,827,991
1772.227,6,180,15480,120,69,14892,69,8940,60,69,30035,69,6540
3.165,17,4,240,2,32,3163,32,120,2,32,3164,32,120
0.06,17,2,152,1,48,0,48,76,1,48,0,48,76
1771.964,6,101,9344,66,65,27260,65,5577,35,59,52113,59,3767
143.158,17,7,532,7,48,23859,48,532,0,0,0,0,0
115.053,1,20,1120,20,28,6055,28,1120,0,0,0,0,0
1799.662,17,468,139930,468,270,3853,425,139930,0,0,0,0,0
280.005,6,28,7352,13,158,23333,267,1317,15,678,19999,2800,6035
0.109,6,2,80,1,0,0,0,40,1,0,0,0,40
96.159,6,26,8574,11,181,9615,267,1168,15,680,6867,1400,7406
280.419,6,28,7352,13,158,23368,267,1317,15,775,20025,4836,6035
1014.41,6,106,9208,66,69,14814,69,4917,40,69,26010,69,4291
0.173,17,7,2438,7,320,28,354,2438,0,0,0,0,0
1249.907,17,66,22176,66,308,19229,308,22176,0,0,0,0,0
368.564,6,18,1239,14,177,28351,177,913,4,110,20057,110,326
1788.91,6,356,22520,208,69,8642,69,12460,148,69,12169,69,10060
240.173,6,53,17882,28,808,8895,1408,15206,25,171,10007,580,2676
58.673,6,13,1079,12,43,5333,43,1019,1,0,0,0,60
0.27,17,3,1063,3,326,135,354,1063,0,0,0,0,0
1787.389,1,64,5376,64,56,28371,56,5376,0,0,0,0,0
276.686,17,4,352,2,60,276685,60,176,2,60,276685,60,176
4.648,6,34,6169,18,206,273,314,2784,16,548,292,1179,3385
0.026,6,9,1340,5,145,6,145,349,4,827,7,827,991
366.889,6,25,1651,17,177,22930,177,1117,8,110,9175,110,534
1780.494,6,209,22911,115,105,15618,722,11663,94,76,19142,1408,11248
12.401,17,6,528,3,48,6194,48,228,3,72,6194,72,300
1.196,6,23,7952,12,164,92,267,1288,11,1216,101,3825,6664
4.209,17,8,1216,4,60,1311,60,352,4,188,1325,188,864
1771.883,6,99,9306,66,66,27259,66,5610,33,60,55368,60,3696
1781.931,6,124,16426,78,217,23141,1258,11620,46,76,39521,192,4806
33.917,6,31,5093,15,154,2422,721,1858,16,342,2243,1368,3235
368.293,6,17,1190,13,180,30691,180,864,4,110,20069,110,326
158.434,6,10,564,2,0,1318,0,112,8,7,22607,7,452
10.034,17,3,3300,3,1072,5017,1072,3300,0,0,0,0,0
1796.944,17,448,39896,403,35,4470,288,25676,45,288,40014,288,14220
0.271,6,2,92,1,0,0,0,40,1,0,0,0,52
0.891,6,16,5092,8,150,127,174,624,8,828,114,1420,4468
351.736,6,49,20766,22,241,15816,241,1506,27,673,13528,962,19260
1683.248,17,14,1036,7,30,280539,30,406,7,62,280539,62,630
297.756,6,84,30244,42,592,7262,1408,11098,42,770,7262,1408,19146
4.24,6,632,549476,385,1405,11,1432,532816,247,519,16,1871,16660
1.766,17,36,11892,17,457,110,1350,8257,19,163,73,1350,3635
24.542,17,4,352,2,60,24541,60,176,2,60,24541,60,176
1681.747,17,16,4197,8,30,240248,37,471,8,437,240248,463,3726
11.555,6,7,292,4,0,3846,0,164,3,0,5770,0,128
204.503,6,28,6585,11,220,5606,516,1326,17,326,12775,1452,5259
6.507,17,22,10519,10,663,723,1350,6915,12,272,357,1350,3604
1786.087,6,117,9396,75,66,24136,66,5376,42,60,43560,60,4020
381.542,17,22,3588,11,48,38153,48,836,11,222,38153,308,2752
2.842,17,4,624,4,128,947,128,624,0,0,0,0,0
1.846,6,2,1253,1,0,0,0,40,1,1173,0,1173,1213
122.341,6,22,8452,11,314,68,634,1415,11,940,12220,1460,7037
7.652,17,6,528,3,48,3819,48,228,3,72,3819,72,300
1741.517,1,15,870,15,30,124394,30,870,0,0,0,0,0
1743.351,6,159,11296,85,72,20754,208,7437,74,31,23876,31,3859
1790.137,6,362,22898,210,69,8565,69,12678,152,69,11854,69,10220
18.214,6,29,7290,10,139,2023,267,1244,19,479,992,1460,6046
1771.401,6,110,10149,69,65,26050,65,5822,41,59,44282,59,4327
12.529,17,3,984,3,300,6264,300,984,0,0,0,0,0
6.67,6,42,7682,22,224,317,314,3796,20,440,337,1152,3886
0.006,6,3,120,2,0,2,0,80,1,0,0,0,40
1799.901,6,362,24374,211,88,8570,469,13987,151,69,11999,69,10387
1787.345,6,102,8228,68,64,26676,64,4896,34,58,54159,58,3332
1.295,6,15,2650,7,288,187,288,612,8,568,160,853,2038
13.918,6,2200,2034257,1406,1368,9,1408,1988305,794,931,17,2816,45952
400.335,17,16,1408,8,48,57189,48,608,8,72,57189,72,800
0.777,17,4,740,2,30,766,30,116,2,284,766,292,624
63.176,6,49,10736,23,237,2871,1189,3543,26,512,2523,2920,7193
286.901,6,34,7050,15,168,12282,516,1615,19,291,15934,1452,5435
1797.752,17,180,14040,180,50,10043,50,14040,0,0,0,0,0
31.758,1,16,896,16,28,2117,28,896,0,0,0,0,0
4.221,17,5,295,5,31,1055,31,295,0,0,0,0,0
1740.562,17,30,31170,30,1011,60019,1011,31170,0,0,0,0,0
1786.756,6,106,8656,70,66,25895,66,5176,36,60,51047,60,3480
47.231,6,49,13060,20,392,263,1189,5126,29,307,1686,1420,7934
0.624,6,118,87472,52,131,12,232,2609,66,1347,9,1430,84863
4.028,17,8,616,4,33,1332,33,244,4,65,1332,65,372
1.278,6,41,9968,21,440,63,1360,4392,20,476,57,2715,5576
175.575,17,4,288,2,36,175553,36,128,2,52,175375,52,160
1748.771,6,95,7203,63,38,28205,205,4476,32,33,56399,98,2727
1771.682,1,58,4872,58,56,31082,56,4872,0,0,0,0,0
1.142,6,28,8631,15,236,67,625,2049,13,1008,78,2720,6582
0.335,17,2,198,1,37,0,37,65,1,105,0,105,133
1.495,6,50,19235,27,887,57,1360,13539,23,433,58,1360,5696
1.182,17,4,496,3,64,578,64,276,1,192,0,192,220
1796.534,17,449,39928,404,35,4457,288,25708,45,288,40020,288,14220
300.544,6,16,1123,5,177,75093,177,445,11,110,30037,110,678
6.313,6,773,618989,423,1380,14,1448,596125,350,776,17,1448,22864
1790.814,6,436,25784,227,69,7923,69,13220,209,34,8609,64,12564
0.016,17,2,362,1,32,0,32,60,1,274,0,274,302
118.785,6,25,10798,12,745,59,1460,3494,13,967,9888,1460,7304
1784.287,6,356,22520,208,69,8619,69,12460,148,69,12138,69,10060
32.542,6,32,8952,14,158,2503,267,1357,18,624,1911,1400,7595
1737.471,1,56,4704,56,56,31590,56,4704,0,0,0,0,0
1.557,6,46,19170,27,894,59,1360,13634,19,476,73,2720,5536
240.219,6,53,17334,28,766,8896,1402,14492,25,191,10008,580,2842
0.09,6,10,1378,5,145,22,145,349,5,825,18,825,1029
1793.052,17,142,11360,71,48,25614,48,5396,71,56,25614,56,5964
0.969,6,32,12994,17,529,60,1440,3370,15,819,56,1440,9624
235.527,17,4,240,2,32,235526,32,120,2,32,235526,32,120
22.143,17,47,14436,23,423,1004,1350,10382,24,140,961,1350,4054
10.459,6,94,26845,47,521,227,1152,20142,47,438,222,1179,6703
47.586,6,481,217741,249,819,191,1152,203297,232,430,204,1179,14444
0.31,17,2,198,1,39,0,39,67,1,103,0,103,131
1789.433,17,83,3480,82,14,22091,14,3444,1,8,0,8,36
280.27,17,4,296,2,30,280255,30,116,2,62,280258,62,180
180.862,6,29,7392,13,158,15071,267,1317,16,603,12054,2800,6075
300.83,2,3,96,3,8,150415,8,96,0,0,0,0,0
5.448,6,3,258,1,0,0,0,40,2,69,5381,69,218
19.632,17,43,14998,21,481,980,1350,10706,22,167,933,1350,4292
2.51,17,4,518,3,39,501,39,201,1,289,0,289,317
2.358,6,1025,1651125,187,603,12,1396,13350,838,1913,2,9772,1637775
10.815,6,18,5610,10,275,1201,275,958,8,1440,829,1440,4652
0.402,6,13,1693,7,288,67,288,588,6,284,41,434,1105
87.43,6,119,87349,73,1259,1214,1408,76833,46,811,1938,3847,10516
296.629,1,4,224,4,28,98876,28,224,0,0,0,0,0
1782.441,17,79,3312,78,14,23148,14,3276,1,8,0,8,36
0.007,17,2,350,1,33,0,33,61,1,261,0,261,289
7.442,6,13,568,6,0,1488,0,260,7,0,1197,0,308
1697.121,1,8,448,8,28,242445,28,448,0,0,0,0,0
0.059,17,2,152,2,48,59,48,152,0,0,0,0,0
1799.735,2,26,832,26,8,71989,8,832,0,0,0,0,0
1405.638,17,336,43548,164,166,8623,1350,31973,172,39,8215,1350,11575
1785.458,6,102,8296,68,65,26648,65,4930,34,59,54102,59,3366
0.056,1,2,112,2,28,56,28,112,0,0,0,0,0
12.584,17,3,984,3,300,6292,300,984,0,0,0,0,0
9.831,17,4,352,2,60,9830,60,176,2,60,9830,60,176
9.524,6,91,29199,45,584,216,1152,22861,46,449,205,1179,6338
12.085,17,8,704,4,48,4024,48,304,4,72,4024,72,400
0.787,17,2,456,1,60,0,60,88,1,340,0,340,368
1772.531,6,203,22359,130,75,13740,267,10057,73,135,24615,2840,12302
319.883,6,21,7066,8,143,45695,267,1332,13,578,26655,1460,5734
1747.917,6,94,7151,62,38,28654,205,4424,32,33,56370,98,2727
124.466,6,28,7345,15,208,8883,517,1644,13,836,10364,3819,5701
3.994,17,2,120,2,32,3994,32,120,0,0,0,0,0
1788.737,6,275,33803,114,137,15828,1360,16475,161,134,11178,2720,17328
174.774,6,9,456,5,0,43683,0,260,4,0,58244,0,196
3.576,17,24,14860,14,851,272,1350,12315,10,226,393,1350,2545
41.64,17,24,2112,12,48,3784,48,912,12,72,3784,72,1200
1.395,6,50,18570,28,900,51,1460,12869,22,400,57,1460,5701
0.907,6,21,7293,13,334,75,663,2033,8,967,123,1471,5260
11.861,6,24,9520,13,275,988,275,1078,11,1331,952,1420,8442
1783.195,17,83,3480,82,14,22014,14,3444,1,8,0,8,36
1740.907,6,87,6322,58,31,30542,31,3915,29,31,62175,31,2407
280.217,6,31,7472,14,158,21555,267,1357,17,543,17509,1400,6115
2.768,17,8,1552,4,36,921,36,256,4,296,920,318,1296
1.503,6,40,9928,21,440,75,1360,4392,19,476,73,2720,5536
240.207,6,59,18371,33,750,7506,1418,15236,26,197,9607,580,3135
0.016,17,2,180,1,30,0,30,58,1,94,0,94,122
4.557,6,53,13934,26,549,182,1429,4936,27,439,52,1986,8998
2.335,6,27,8825,16,281,155,577,1489,11,984,215,1452,7336
0.25,6,4,493,2,241,250,241,321,2,92,34,92,172
570.005,6,68,4949,24,57,23478,295,2160,44,46,13255,78,2789
1781.195,1,71,5964,0,0,0,0,0,71,56,25445,56,5964
197.39,1,2,232,2,88,197390,88,232,0,0,0,0,0
61.979,6,68,48585,44,1197,1441,1368,40600,24,841,2684,2736,7985
75.122,6,21,860,10,0,6019,0,404,11,0,7511,0,456
0.499,17,3,451,2,39,207,39,134,1,289,0,289,317
1720.496,17,12,498,11,14,172049,14,462,1,8,0,8,36
1770.26,6,184,10951,92,42,19453,208,6279,92,31,19450,31,4672
1797.069,17,448,39896,403,35,4470,288,25676,45,288,40019,288,14220
1.366,6,26,9026,13,263,113,691,1736,13,943,92,1448,7290
14.033,6,31,7288,15,154,987,722,1907,16,568,924,2026,5381
15.587,17,18,11642,10,908,1728,1350,9360,8,257,2222,1350,2282
1.373,6,37,9132,20,176,57,460,1728,17,610,70,1642,7404
61.281,6,37,15978,22,802,2918,1408,9200,15,665,4359,1408,6778
38.199,1,44,4576,0,0,0,0,0,44,76,888,76,4576
22.496,6,9,577,0,0,0,0,0,9,31,2812,31,577
0.06,17,2,238,1,59,0,59,87,1,123,0,123,151
278.552,6,29,8832,14,158,21427,267,1357,15,858,19893,2800,7475
22.233,1,12,1248,0,0,0,0,0,12,76,2021,76,1248
477.536,1,26,2756,26,78,19101,78,2756,0,0,0,0,0
1792.023,17,180,14040,180,50,10011,50,14040,0,0,0,0,0
0.407,6,25,6056,13,108,33,147,959,12,768,35,1581,5097
2.82,6,6,328,4,0,940,0,216,2,0,2802,0,112
185.546,6,59,38674,38,1154,5014,1408,30843,21,841,3070,2439,7831
7.424,6,1677,1564637,1071,1384,6,1408,1528461,606,776,11,1408,36176
1790.755,6,81,4300,40,26,45915,26,2132,41,24,44767,24,2168
1771.814,6,99,9174,66,64,27258,64,5544,33,58,55366,58,3630
599.11,1,8,448,8,28,85587,28,448,0,0,0,0,0
7.294,6,57,10673,29,238,260,314,5460,28,454,260,1179,5213
301.17,6,40,14532,20,676,15850,1408,6493,20,775,15850,1578,8039
5.193,6,22,6127,12,660,472,826,3844,10,269,388,269,2283
176.55,6,4,176,3,0,88275,0,128,1,0,0,0,48
1772.188,6,180,15480,120,69,14892,69,8940,60,69,30031,69,6540
0.424,6,241,187615,116,182,3,256,6976,125,1415,3,1440,180639
280.033,6,27,7312,12,158,25457,267,1277,15,678,20000,2045,6035
7.207,17,4,352,2,60,7206,60,176,2,60,7205,60,176
0.399,6,12,1653,6,288,79,288,548,6,426,44,434,1105
0.094,17,2,176,1,48,0,48,76,1,72,0,72,100
23.226,6,12,6643,3,122,11613,122,262,9,1502,2883,1929,6381
33.544,6,33,5246,16,180,2236,722,1923,17,270,2085,1402,3323
104.941,6,42,22907,21,549,82,1460,3092,21,1264,5230,2920,19815
98.98,6,25,10837,12,740,61,1440,3473,13,976,8237,1440,7364
1798.487,6,371,24941,215,87,8404,469,14354,156,69,11600,69,10587
7.174,6,656,583637,417,1332,16,1368,566545,239,776,29,2736,17092
31.29,6,8,348,2,0,27,0,84,6,0,6254,0,264
1788.254,6,356,22520,208,69,8638,69,12460,148,69,12164,69,10060
1798.324,6,365,24563,213,87,8482,469,14136,152,69,11907,69,10427
1783.276,1,72,6048,0,0,0,0,0,72,56,25116,56,6048
126.77,6,20,8281,11,532,82,1257,2068,9,1168,15824,3151,6213
240.197,6,58,19310,30,775,8282,1402,16297,28,193,8895,580,3013
1790.632,17,180,11520,180,36,10003,36,11520,0,0,0,0,0
0.011,17,2,454,1,39,0,39,67,1,359,0,359,387
0.398,6,26,8862,13,231,33,563,1608,13,938,31,1438,7254
0.022,17,2,439,1,33,0,33,61,1,350,0,350,378
1771.99,6,180,15480,120,69,14890,69,8940,60,69,30030,69,6540
4.764,6,34,6169,18,206,280,314,2784,16,548,300,1179,3385
0.966,6,26,9145,14,290,74,802,1753,12,985,69,1360,7392
98.247,6,34,8348,15,142,7017,516,1745,19,416,5452,1452,6603
8.28,6,1803,1693098,1131,1420,7,1448,1653490,672,776,12,1448,39608
1792.042,17,142,11360,71,48,25599,48,5396,71,56,25599,56,5964
0.419,17,2,148,1,32,0,32,60,1,60,0,60,88
0.281,6,21,5000,10,137,31,267,1092,11,577,26,1400,3908
1772.474,6,180,15480,120,69,14894,69,8940,60,69,30034,69,6540
0.76,17,13,6060,6,551,152,1350,3478,7,340,120,1350,2582
0.036,17,2,383,1,33,0,33,61,1,294,0,294,322
11.347,6,27,11355,13,275,945,275,1078,14,1078,799,1414,10277
280.193,6,26,7272,12,158,25472,267,1277,14,775,21550,3445,5995
101.892,17,8,704,4,48,33961,48,304,4,72,33960,72,400
39.423,17,21,1596,21,48,1971,48,1596,0,0,0,0,0
1772.391,6,180,15480,120,69,14894,69,8940,60,69,30034,69,6540
1589.162,6,95,7065,63,33,25631,93,4559,32,31,46153,31,2506
0.005,17,2,429,1,35,0,35,63,1,338,0,338,366
40.645,17,5,380,5,48,10161,48,380,0,0,0,0,0
1775.379,17,140,11200,70,48,25730,48,5320,70,56,25730,56,5880
842.255,2,10,320,10,8,93583,8,320,0,0,0,0,0
8.061,17,3,228,3,48,4030,48,228,0,0,0,0,0
2.718,6,2,88,2,0,0,0,88,0,0,0,0,0
1792.897,6,359,22709,209,69,8619,69,12569,150,69,12032,69,10140
1.562,6,36,11620,18,448,91,1339,3465,18,824,81,1360,8155
0.871,17,21,14200,12,951,78,1350,11751,9,244,104,1350,2449
0.233,6,5,303,2,0,1,0,116,3,31,27,31,187
280.345,6,30,7432,13,158,23362,267,1317,17,543,17520,1400,6115
1.414,6,48,19527,27,914,54,1360,13911,21,476,61,2715,5616
1789.399,1,179,10024,179,28,10052,28,10024,0,0,0,0,0
1795.233,6,415,24880,207,69,8714,69,12420,208,34,8672,48,12460
3.231,17,5,290,5,30,807,30,290,0,0,0,0,0
19.736,6,33,14478,20,828,944,1041,6860,13,771,1640,1400,7618
21.123,6,16,5606,8,742,2992,958,3288,8,499,2992,509,2318
0.155,6,9,902,5,201,38,201,405,4,333,37,333,497
1788.415,6,389,27482,221,102,8129,469,16208,168,69,10709,69,11274
1.039,6,24,6548,13,332,86,1002,2188,11,783,102,1420,4360
204.999,17,84,3450,43,13,4880,58,1766,41,13,5071,56,1684
1799.821,17,142,11360,71,48,25711,48,5396,71,56,25711,56,5964
1150.883,17,285,24740,259,35,4460,288,16524,26,288,41621,288,8216
1784.29,6,259,18709,159,69,11292,69,10569,100,69,18022,69,8140
1743.86,6,95,7203,63,38,28126,205,4476,32,33,56240,98,2727
1781.22,17,142,11360,71,48,25445,48,5396,71,56,25445,56,5964
1796.882,17,449,39928,404,35,4458,288,25708,45,288,40015,288,14220
61.33,6,37,15905,22,796,2920,1448,9127,15,665,4361,1448,6778
1797.895,17,449,39928,404,35,4461,288,25708,45,288,40117,288,14220
0.046,17,2,180,1,30,0,30,58,1,94,0,94,122
1677.642,1,7,742,7,78,279607,78,742,0,0,0,0,0
2.221,17,2,586,1,46,0,46,74,1,484,0,484,512
10.687,6,26,11484,11,275,1068,275,994,15,823,585,1440,10490
10.727,17,4,352,2,60,10726,60,176,2,60,10726,60,176
0.244,6,9,1002,5,213,61,213,417,4,421,53,421,585
238.094,17,4,240,2,32,238093,32,120,2,32,238093,32,120
1796.021,6,367,23305,213,69,8471,69,12798,154,69,11738,69,10507
0.332,17,8,2774,8,318,47,357,2774,0,0,0,0,0
4.986,17,2,146,2,45,4986,45,146,0,0,0,0,0
1778.929,6,183,15738,121,69,14824,69,8980,62,69,29156,69,6758
0.018,17,3,244,2,32,3,32,120,1,96,0,96,124
240.348,6,48,8698,25,449,10014,1418,5816,23,186,10924,580,2882
66.014,6,13,1807,7,100,11002,100,384,6,1179,13129,1179,1423
1786.812,6,358,22738,208,69,8631,69,12460,150,69,11991,69,10278
0.226,6,3,802,2,413,226,413,493,1,269,0,269,309
1795.458,17,448,39896,403,35,4466,288,25676,45,288,40016,288,14220
381.29,17,10,880,5,48,95320,48,380,5,72,95319,72,500
1758.497,6,190,11992,95,52,18707,208,7262,95,31,18704,31,4730
18.519,6,2635,2298134,1528,1413,12,1448,2228690,1107,776,16,1448,69444
1744.242,17,249,40177,249,133,7033,391,40177,0,0,0,0,0
0.316,6,10,1368,5,304,78,304,892,5,102,77,102,476
8.248,6,8,448,4,0,2702,0,240,4,0,2702,0,208
1786.866,6,356,22520,208,69,8632,69,12460,148,69,12155,69,10060
1763.971,2,14,448,14,8,135690,8,448,0,0,0,0,0
0.682,17,4,524,2,39,671,39,134,2,167,667,167,390
168.52,2,7,288,7,17,28086,24,288,0,0,0,0,0
1799.731,17,142,11360,71,48,25710,48,5396,71,56,25710,56,5964
4.054,17,5,290,5,30,1013,30,290,0,0,0,0,0
1792.764,17,180,11520,180,36,10015,36,11520,0,0,0,0,0
1772.903,6,180,15480,120,69,14898,69,8940,60,69,30042,69,6540
0.111,6,10,767,5,186,27,186,454,5,45,15,45,313
1787.018,6,102,8364,68,66,26671,66,4964,34,60,54148,60,3400
0.064,17,2,910,1,306,0,306,334,1,548,0,548,576
1343.595,6,107,7771,57,26,23992,26,3426,50,89,27416,427,4345
1.034,17,2,312,2,128,1034,128,312,0,0,0,0,0
1.591,6,13,2311,8,188,227,245,700,5,1407,328,1407,1611
1389.757,6,86,11667,55,94,21090,498,4670,31,198,46322,1420,6997
0.08,6,2,104,1,0,0,0,64,1,0,0,0,40
0.361,6,13,1693,7,288,57,288,588,6,426,39,434,1105
0.253,6,20,4960,10,137,28,267,1092,10,692,24,1467,3868
6.63,6,535,479722,345,1327,18,1368,465178,190,776,33,2736,14544
2.003,17,4,580,2,40,1971,40,136,2,194,1959,194,444
265.854,6,20,4547,8,272,334,516,1140,12,364,24159,1452,3407
28.58,6,8,368,3,0,14290,0,128,5,0,3870,0,240
907.118,17,24,8064,24,308,39439,308,8064,0,0,0,0,0
14.375,6,27,4866,13,154,1179,722,1767,14,394,1071,1448,3099
1752.934,1,72,6048,72,56,24689,56,6048,0,0,0,0,0
1778.814,6,280,36033,116,157,15466,1360,18585,164,134,10912,3302,17448
0.084,17,2,136,1,32,0,32,60,1,48,0,48,76
5.515,6,12,6130,4,275,1838,275,439,8,894,757,1440,5691
1743.809,6,94,7151,62,38,28587,205,4424,32,33,56243,98,2727
1730.354,6,61,4485,41,33,43258,33,2825,20,31,91056,31,1660
21.185,6,29,5303,12,170,1925,722,1644,17,277,1311,1402,3659
1769.907,1,58,4872,58,56,31051,56,4872,0,0,0,0,0
4.042,1,8,832,0,0,0,0,0,8,76,577,76,832
280.273,6,29,7392,14,158,21559,267,1357,15,678,20016,3436,6035
1621.296,17,13,2522,13,166,135108,166,2522,0,0,0,0,0
3.092,6,36,10717,19,523,162,1360,3935,17,761,182,3494,6782
12.199,6,2427,2291323,1574,1378,7,1408,2242303,853,931,14,2816,49020
1797.251,6,357,22629,209,69,8640,69,12569,148,69,12225,69,10060
3.718,6,110,86619,44,131,86,232,2289,66,1361,56,1430,84330
0.603,6,14,1745,7,288,71,288,600,7,426,67,434,1145
0.06,17,2,1152,1,548,0,548,576,1,548,0,548,576
9.014,6,17,6735,9,275,1126,275,643,8,1440,1107,1440,6092
8.922,6,24,6984,9,146,1115,267,1098,15,659,618,4837,5886
8.479,6,19,6342,7,156,1413,267,758,12,637,768,1420,5584
119.191,17,4,304,2,48,119189,64,152,2,48,119190,64,152
1795.401,6,415,24880,207,69,8715,69,12420,208,34,8673,64,12460
0.183,1,6,624,0,0,0,0,0,6,76,36,76,624
30.924,6,22,3242,13,183,2577,517,1621,9,381,3728,499,1621
417.558,2,5,160,5,8,104389,8,160,0,0,0,0,0
0.862,6,15,2224,7,288,113,288,620,8,424,97,434,1604
161.392,1,19,1976,0,0,0,0,0,19,76,8966,76,1976
4.746,6,40,7309,20,218,249,314,3423,20,440,236,1152,3886
4.033,17,8,584,4,33,1333,33,244,4,57,1340,65,340
0.006,17,2,407,1,32,0,32,60,1,319,0,319,347
31.206,17,36,5292,18,48,1835,48,1368,18,190,1834,308,3924
1.401,6,47,18540,27,846,53,1360,12964,20,476,63,2715,5576
1.243,6,24,8004,12,164,96,267,1288,12,1014,96,2411,6716
729.238,1,60,3360,60,28,12359,28,3360,0,0,0,0,0
0.508,6,20,7252,13,337,42,674,2032,7,1212,78,1946,5220
10.992,6,20,4442,11,275,1099,275,998,9,768,765,1440,3444
1797.553,6,127,8259,74,51,24624,208,5178,53,31,34562,31,3081
1795.264,6,135,15135,75,75,24260,721,5958,60,147,30420,2840,9177
155.426,6,7444,6975270,4945,1331,31,1368,6830054,2499,931,62,2736,145216
1799.021,17,447,39580,403,35,4475,288,25676,44,288,40948,288,13904
34.289,6,9,577,0,0,0,0,0,9,31,4286,31,577
241.264,6,59,7597,27,181,9277,585,3441,32,164,7781,580,4156
1787.192,6,104,8308,68,64,26674,64,4896,36,58,51060,58,3412
7.719,6,14,6071,4,189,2570,267,547,10,730,856,1460,5524
15.471,6,1562,1440022,946,1440,16,1448,1401850,616,776,24,1448,38172
11.026,6,20,4402,11,275,1102,275,998,9,758,783,1420,3404
1.474,6,53,21407,29,904,52,1360,15671,24,433,55,1360,5736
1787.364,6,104,8308,68,64,26677,64,4896,36,58,51064,58,3412
1787.455,6,102,8228,68,64,26678,64,4896,34,58,54162,58,3332
240.797,6,42,5698,19,247,13377,834,2729,23,176,10945,579,2969
0.449,6,12,1653,6,288,84,288,548,6,426,51,434,1105
12.693,17,23,25191,4,1350,1101,1350,5512,19,1007,703,1350,19679
0.24,17,2,2732,2,1338,240,1338,2732,0,0,0,0,0
58.551,2,2,64,2,8,58551,8,64,0,0,0,0,0
48.035,6,72,25595,34,929,1455,1440,14505,38,471,1282,1440,11090
73.607,6,29,7825,16,208,4904,517,1684,13,683,6130,1418,6141
0.099,17,4,368,2,32,99,32,120,2,96,58,96,248
116.354,17,6,528,3,60,58176,60,264,3,60,58176,60,264
0.14,6,10,1378,5,549,35,549,753,5,421,26,421,625
0.04,6,10,584,5,44,10,44,312,5,0,9,0,272
280.426,6,29,7392,13,158,23368,267,1317,16,678,18691,3456,6075
1800.0,6,211,16220,78,68,22986,291,7626,133,48,13636,78,8594
7.246,6,16,4739,7,125,1207,245,660,9,1237,872,1407,4079
1.63,6,30,10405,18,367,95,833,1825,12,1012,140,1420,8580
4.588,6,29,8288,14,164,339,267,1400,15,869,314,1448,6888
0.881,6,29,8524,15,222,54,540,1988,14,852,54,1360,6536
53.283,6,36,8338,18,371,516,766,1865,18,478,3125,2720,6473
65.875,6,57,37098,37,1140,1829,1408,29315,20,841,3233,2439,7783
1779.277,6,104,8444,68,66,26556,66,4964,36,60,50833,60,3480
1789.576,1,224,12544,224,28,8025,28,12544,0,0,0,0,0
763.505,6,219,22062,115,132,6697,1189,10445,104,196,7412,1460,11617
1772.241,6,180,15480,120,69,14892,69,8940,60,69,30037,69,6540
1.413,6,48,18942,26,939,56,1460,13286,22,433,58,1460,5656
193.694,6,137,107094,89,1291,2201,1408,95060,48,680,2790,2816,12034
1075.731,6,207,13519,116,70,9354,138,7193,91,68,11952,69,6326
6.98,6,41,7349,20,218,367,314,3423,21,440,334,1152,3926
24.126,6,59,11441,30,176,831,876,4197,29,358,861,2087,7244
12.104,6,1899,1658691,1156,1381,10,1420,1624750,743,467,16,1883,33941
1791.993,6,384,26675,219,97,8220,469,15659,165,69,10926,69,11016
504.06,17,13,4392,13,309,42005,326,4392,0,0,0,0,0
729.106,6,1033,961089,427,182,1711,919,28670,606,1564,1205,5672,932419
6.137,6,41,7365,21,218,306,314,3463,20,442,308,1152,3902
300.671,6,37,8526,19,315,16703,882,2053,18,441,501,1440,6473
1791.536,17,144,11520,72,48,25232,48,5472,72,56,25232,56,6048
83.245,6,4148,3724979,2681,1309,31,1368,3639807,1467,931,56,2736,85172
76.431,6,42,10180,17,327,4776,1189,2655,25,407,3179,1420,7525
1759.636,6,125,12501,76,62,23461,721,6285,49,91,36654,1448,6216
240.316,6,53,17966,28,798,8899,1418,15037,25,202,10012,580,2929
1786.258,6,102,8296,68,65,26660,65,4930,34,59,54124,59,3366
0.185,6,12,3702,6,170,36,170,490,6,964,36,1448,3212
1786.971,17,82,3438,81,14,22337,14,3402,1,8,0,8,36
897.464,6,43,3422,26,65,25873,65,1885,17,57,56085,59,1537
37.374,17,22,1936,11,48,3736,48,836,11,72,3736,72,1100
0.013,17,2,553,1,36,0,36,64,1,461,0,461,489
0.154,17,2,2386,2,1165,154,1165,2386,0,0,0,0,0
411.915,6,47,3071,27,49,15836,208,2023,20,31,21671,31,1048
45.223,1,20,1680,20,56,2380,56,1680,0,0,0,0,0
5.128,6,43,8345,21,227,256,314,4022,22,491,231,1179,4323
299.65,6,6,364,4,31,99883,31,222,2,31,299509,31,142
5.613,6,40,7325,22,218,267,314,3503,18,516,314,1179,3822
1.324,6,39,9888,21,440,66,1360,4392,18,476,66,2715,5496
0.13,17,2,144,1,36,0,36,64,1,52,0,52,80
280.021,6,27,7312,13,158,23335,267,1317,14,775,21537,3445,5995
164.459,17,4,352,2,60,164458,60,176,2,60,164458,60,176
0.072,17,2,306,1,33,0,33,61,1,217,0,217,245
9.199,6,92,30153,47,579,199,1152,23903,45,444,203,1179,6250
121.436,17,4,352,2,60,121434,60,176,2,60,121434,60,176
280.471,6,30,7432,13,158,23372,267,1317,17,603,17525,2076,6115
280.393,6,30,7432,14,158,21568,267,1357,16,678,18690,3456,6075
0.553,17,2,167,1,39,0,39,67,1,72,0,72,100
0.983,17,4,396,2,39,982,39,134,2,103,969,103,262
1770.199,6,101,9278,66,64,27233,64,5544,35,58,52062,58,3734
1798.777,17,448,39896,403,35,4474,288,25676,45,288,40022,288,14220
4.884,6,39,7285,19,218,271,314,3383,20,516,243,1179,3902
8.65,6,14,1247,7,222,1436,222,728,7,231,1436,231,519
4.304,17,4,352,2,48,4282,48,152,2,72,4286,72,200
1684.038,17,15,2940,15,168,120288,168,2940,0,0,0,0,0
302.106,6,33,6397,17,286,18881,1314,2405,16,334,20139,1420,3992
0.032,6,13,3980,7,88,5,88,388,6,1670,6,1880,3592
1789.131,6,101,8163,62,66,26615,66,4526,39,54,47079,60,3637
241.32,6,51,10797,25,410,10054,1418,5870,26,323,9652,879,4927
0.096,17,2,162,1,45,0,45,73,1,61,0,61,89
10.591,6,20,4442,11,275,1059,275,998,9,768,728,1440,3444
1684.965,6,78,22774,43,523,40118,1460,14305,35,415,49552,1934,8469
240.288,6,42,8701,21,519,12014,1402,5775,21,228,12014,618,2926
0.012,6,4,490,1,0,0,0,40,3,165,0,261,450
4.275,17,9,778,5,30,1053,30,290,4,94,639,94,488
45.077,17,6,528,3,48,22535,48,228,3,72,22532,72,300
0.262,17,5,1497,5,271,65,316,1497,0,0,0,0,0
3.059,17,4,240,4,32,1019,32,240,0,0,0,0,0
584.876,1,6,336,6,28,116975,28,336,0,0,0,0,0
0.562,6,23,7722,14,318,43,600,2022,9,870,67,1471,5700
1795.275,17,180,14040,180,50,10029,50,14040,0,0,0,0,0
1.75,6,13,2311,8,188,250,245,700,5,1407,370,1407,1611
1797.711,6,384,24330,218,69,8284,69,13550,166,69,10894,69,10780
0.984,17,2,685,1,308,0,308,336,1,321,0,321,349
1772.949,6,180,15480,120,69,14898,69,8940,60,69,30045,69,6540
371.178,6,26,1984,18,180,21834,180,1340,8,110,8950,110,644
1744.749,2,28,896,28,8,64620,8,896,0,0,0,0,0
367.41,6,20,1355,15,177,26243,177,977,5,110,15156,110,378
0.578,17,4,588,2,48,570,48,152,2,190,569,308,436
12.228,17,20,1680,10,34,1357,34,620,10,78,1357,84,1060
1.229,17,20,13930,12,920,111,1350,11377,8,291,141,1350,2553
1784.792,6,363,23007,210,69,8539,69,12747,153,69,11741,69,10260
1789.728,17,140,11200,70,48,25937,48,5320,70,56,25937,56,5880
221.274,6,15,1410,10,66,24586,66,850,5,60,55281,60,560
1782.665,6,356,22520,208,69,8611,69,12460,148,69,12126,69,10060
256.295,6,19,1421,12,66,23299,66,810,7,55,42656,60,611
1795.578,17,448,39896,403,35,4466,288,25676,45,288,40019,288,14220
1790.3,6,374,23861,215,69,8365,69,12947,159,69,11330,69,10914
10.751,6,87,25250,42,534,262,1152,19309,45,413,238,1152,5941
1.107,6,25,8056,12,164,85,267,1288,13,869,78,1402,6768
1712.189,1,8,448,8,28,244598,28,448,0,0,0,0,0
5.696,6,247,223816,106,269,54,517,5351,141,1576,38,5520,218465
377.946,2,4,128,4,8,125982,8,128,0,0,0,0,0
1764.414,2,12,384,12,8,160401,8,384,0,0,0,0,0
9.792,17,4,1344,4,308,3264,308,1344,0,0,0,0,0
300.913,6,43,10651,22,678,14329,1440,5009,21,399,484,1440,5642
64.343,6,33,5554,17,165,4021,722,2207,16,358,4276,1408,3347
2.917,6,5,338,3,69,1458,69,189,2,69,2894,69,149
158.37,17,4,352,2,60,158369,60,176,2,60,158369,60,176
0.423,6,51,20620,28,880,15,1380,13535,23,558,17,1923,7085
61.931,6,24,9776,13,380,5160,832,1693,11,1090,6180,1440,8083
300.104,6,52,11050,26,649,11997,1460,5053,26,290,11997,1460,5997
1.259,6,26,8108,13,164,89,267,1340,13,869,89,1408,6768
1798.123,17,450,39960,405,35,4450,288,25740,45,288,40023,288,14220
1782.466,1,139,7784,139,28,12916,28,7784,0,0,0,0,0
1771.57,6,101,9344,66,65,27254,65,5577,35,59,52102,59,3767
114.715,17,4,352,2,60,114714,60,176,2,60,114714,60,176
1753.051,6,95,7203,63,38,28275,205,4476,32,33,56536,98,2727
3.045,17,4,268,4,39,1015,39,268,0,0,0,0,0
0.18,6,10,766,5,185,44,185,453,5,45,34,45,313
0.027,17,2,330,1,30,0,30,58,1,244,0,244,272
1742.763,6,99,7411,63,38,28109,205,4476,36,33,49780,98,2935
0.223,17,2,180,1,30,0,30,58,1,94,0,94,122
0.142,17,4,284,2,32,71,32,120,2,54,72,60,164
1793.389,17,83,3480,82,14,22140,14,3444,1,8,0,8,36
0.012,6,4,222,2,31,12,31,111,2,31,0,31,111
1787.151,6,102,8296,68,65,26673,65,4930,34,59,54152,59,3366
1637.639,2,9,288,9,8,204704,8,288,0,0,0,0,0
4.773,17,5,320,5,36,1193,36,320,0,0,0,0,0
1.325,6,43,11564,24,547,57,1360,5983,19,480,63,4075,5581
17.145,6,3344,3069077,2011,1435,8,1448,2981533,1333,931,12,2761,87544
689.053,6,124,9024,61,75,11463,86,3431,63,39,11113,63,5593
1741.284,17,30,20190,30,645,60044,645,20190,0,0,0,0,0
1791.362,6,365,23087,211,69,8530,69,12787,154,69,11708,69,10300
1785.951,6,155,20453,92,316,19625,316,14592,63,83,28805,83,5861
1773.139,6,187,15967,123,69,14533,69,9129,64,69,28141,69,6838
154.459,6,37,8156,16,123,10297,267,1639,21,333,3088,1452,6517
88.978,6,40,8468,13,156,7414,267,1621,27,319,3421,1420,6847
128.279,6,98,73442,64,1254,2036,1408,63539,34,738,2511,2439,9903
0.012,17,2,383,1,33,0,33,61,1,294,0,294,322
0.455,6,22,7779,13,318,37,599,1969,9,1066,56,1906,5810
1787.258,6,102,8296,68,65,26675,65,4930,34,59,54154,59,3366
1797.455,6,373,26028,217,99,8321,469,15234,156,69,11595,69,10794
1254.3,1,132,7392,132,28,9574,28,7392,0,0,0,0,0
9.166,6,21,4374,12,213,833,597,1689,9,552,1123,1767,2685
15.11,17,11,4308,5,424,3769,1350,2262,6,313,3015,1350,2046
240.333,6,43,8843,21,519,12016,1402,5774,22,213,11444,618,3069
1783.99,6,364,25392,212,100,8454,469,14896,152,69,11814,69,10496
251.94,2,2,64,2,8,251940,8,64,0,0,0,0,0
1786.571,17,140,11200,70,48,25892,48,5320,70,56,25892,56,5880
1787.087,6,359,22709,209,69,8591,69,12569,150,69,11991,69,10140
573.058,17,280,20494,200,40,2879,41,13727,80,56,488,57,6767
95.032,17,4,304,4,48,31677,48,304,0,0,0,0,0
0.465,6,13,1096,7,256,75,256,544,6,304,91,304,552
185.987,17,74,19166,74,231,2547,388,19166,0,0,0,0,0
0.362,17,8,2758,8,316,51,355,2758,0,0,0,0,0
367.062,6,18,1242,14,180,28235,180,916,4,110,20060,110,326
0.085,6,10,1495,5,507,21,507,727,5,556,21,556,768
1797.033,17,180,14040,180,50,10039,50,14040,0,0,0,0,0
1759.574,6,24,3624,16,241,117304,241,2568,8,92,251339,92,1056
18.28,6,1244,1120445,811,1307,22,1368,1092025,433,776,41,1473,28420
0.779,6,23,6398,13,310,64,892,2078,10,979,85,1737,4320
1799.257,1,57,4788,0,0,0,0,0,57,56,32129,56,4788
6.672,6,30,7432,13,158,556,267,1317,17,543,414,1400,6115
0.11,17,7,3482,4,418,36,1350,1787,3,537,21,1350,1695
1772.307,6,180,15480,120,69,14893,69,8940,60,69,30034,69,6540
17.097,1,18,1872,0,0,0,0,0,18,76,1005,76,1872
306.615,6,64,39095,39,285,8067,1258,4322,25,1594,12774,6840,34773
1776.735,17,142,11360,71,48,25381,48,5396,71,56,25381,56,5964
1798.932,6,191,18610,126,99,14391,469,11525,65,69,28100,69,7085
1773.043,6,180,15480,120,69,14899,69,8940,60,69,30046,69,6540
1795.836,17,447,39580,403,35,4467,288,25676,44,288,40954,288,13904
1772.37,6,180,15480,120,69,14893,69,8940,60,69,30033,69,6540
0.634,6,28,7336,13,155,52,267,1301,15,543,44,1400,6035
1735.915,1,8,448,8,28,247987,28,448,0,0,0,0,0
1781.04,17,142,11360,71,48,25443,48,5396,71,56,25443,56,5964
176.098,6,25,10036,12,660,73,1360,3154,13,907,14661,1360,6882
0.03,6,10,1327,5,299,6,299,567,5,246,6,459,760
0.358,17,2,290,1,40,0,40,68,1,194,0,194,222
0.262,6,7,466,5,43,55,43,354,2,0,260,0,112
1744.695,2,28,896,28,8,64618,8,896,0,0,0,0,0
220.971,6,32,8952,14,158,16997,267,1357,18,624,12992,1400,7595
15.541,17,15,4893,7,355,2578,1350,2683,8,248,2208,1350,2210
1644.0,6,205,15989,77,73,21423,336,7737,128,49,12944,143,8252
216.19,17,6,360,3,32,108094,32,180,3,32,108094,32,180
32.823,6,28,11586,16,579,2188,1440,4325,12,1103,2956,1440,7261
1792.208,1,342,28728,342,56,5255,56,28728,0,0,0,0,0
326.601,6,38,5206,16,272,21773,585,2202,22,226,15548,580,3004
5.473,6,14,3161,4,92,1824,92,296,10,465,541,1408,2865
1770.26,1,58,4872,58,56,31057,56,4872,0,0,0,0,0
1794.535,1,112,6272,112,28,16166,28,6272,0,0,0,0,0
0.847,6,26,8065,14,319,65,602,2036,12,899,73,1906,6029
0.005,17,2,473,1,41,0,41,69,1,376,0,376,404
280.422,6,28,7352,13,158,23368,267,1317,15,603,20027,2076,6035
1.681,6,28,10217,17,284,105,586,1538,11,1029,149,1420,8679
11.438,6,21,6825,12,275,1039,275,1038,9,1353,803,1440,5787
0.785,6,23,5715,13,158,65,370,1315,10,999,86,1731,4400
1737.364,1,65,5460,65,56,27146,56,5460,0,0,0,0,0
3.628,6,33,6129,17,206,226,314,2744,16,548,225,1179,3385
1796.509,6,186,14496,94,94,19317,208,9545,92,31,19738,31,4951
0.342,6,22,4467,11,165,34,456,1394,11,498,32,888,3073
0.455,6,51,22143,29,987,16,1380,17021,22,421,19,1923,5122
10.991,6,16,5255,9,275,1373,275,643,7,1440,996,1440,4612
1.165,6,28,8160,15,222,69,540,1964,13,944,78,1591,6196
8.313,6,78,24341,40,550,213,1152,18680,38,459,217,1179,5661
504.633,2,4,128,4,8,168211,8,128,0,0,0,0,0
15.519,17,16,5482,8,373,2211,1350,3214,8,255,2211,1350,2268
0.008,6,3,144,2,0,8,0,92,1,0,0,0,52
1.391,6,51,19694,27,917,53,1440,13958,24,433,52,1440,5736
72.248,6,38,9535,13,296,940,1189,2601,25,395,2995,1460,6934
1685.464,17,12,498,11,14,168546,14,462,1,8,0,8,36
19.957,17,40,7360,18,176,1172,1350,3687,22,138,948,1350,3673
292.877,2,4,128,4,8,97625,8,128,0,0,0,0,0
0.024,17,2,522,1,72,0,72,100,1,394,0,394,422
6.926,17,4,352,2,60,6924,60,176,2,60,6925,60,176
0.016,6,10,1852,6,108,3,108,428,4,1208,5,1208,1424
0.015,17,2,410,1,36,0,36,64,1,318,0,318,346
1782.41,17,83,3480,82,14,22005,14,3444,1,8,0,8,36
0.078,6,5,260,2,0,0,0,104,3,0,39,0,156
1770.725,6,101,9659,67,69,26829,233,5862,34,59,53655,82,3797
1.32,6,52,21358,29,904,47,1360,15662,23,433,52,1360,5696
1.128,6,211,154574,118,1325,9,1420,146551,93,475,12,1883,8023
1764.747,2,14,448,14,8,135749,8,448,0,0,0,0,0
3.435,17,8,736,4,32,1144,32,240,4,96,1140,96,496
0.005,17,2,561,1,39,0,39,67,1,466,0,466,494
1773.272,6,183,15738,121,69,14777,69,8980,62,69,29062,69,6758
44.965,6,25,7097,12,155,4087,267,1266,13,589,3746,3426,5831
16.27,17,4,352,2,48,16261,48,152,2,72,16261,72,200
1782.746,6,104,8308,68,64,26608,64,4896,36,58,50933,58,3412
39.072,6,32,8952,14,158,3005,267,1357,18,763,2292,2760,7595
0.164,17,2,154,1,33,0,33,61,1,65,0,65,93
384.143,6,21,7511,12,162,34922,267,2117,9,837,744,1917,5394
0.776,6,34,17793,20,708,40,1360,4446,14,1277,48,3056,13347
405.185,1,12,672,12,28,36835,28,672,0,0,0,0,0
0.558,6,23,7270,12,257,50,748,1663,11,1005,50,2364,5607
15.616,17,6,528,3,48,7804,48,228,3,72,7804,72,300
153.125,17,32,11704,32,337,4939,360,11704,0,0,0,0,0
12.724,1,8,832,0,0,0,0,0,8,76,1817,76,832
317.064,6,50,12007,30,136,10933,615,3682,20,751,16680,4649,8325
31.755,6,7,420,1,0,0,0,60,6,0,6350,0,360
0.457,6,24,6076,12,181,41,537,1526,12,781,37,2224,4550
0.045,6,11,913,6,182,9,182,490,5,77,7,134,423
4.798,17,2,237,1,72,0,72,100,1,109,0,109,137
121.16,6,11,7487,3,100,1456,100,224,8,1156,17272,1179,7263
118.673,6,25,9182,12,365,65,794,1621,13,781,9878,1460,7561
0.926,6,10,766,5,185,231,185,453,5,45,152,45,313
93.7,6,45,9030,21,410,715,882,2162,24,327,4068,1360,6868
301.043,6,16,1553,8,187,43004,187,635,8,247,43004,462,918
31.464,6,7,336,1,0,0,0,48,6,0,6290,0,288
1064.129,6,95,19281,56,330,14840,1269,10848,39,228,28001,1420,8433
251.414,2,3,96,3,8,125707,8,96,0,0,0,0,0
1.297,6,43,10105,23,440,58,1360,4484,20,437,58,2715,5621
0.51,6,23,7451,14,275,39,674,2115,9,1212,58,1946,5336
9.888,6,17,3770,9,75,1235,75,583,8,1373,1412,1448,3187
301.488,6,41,8760,21,267,15074,734,2207,20,441,492,1460,6553
1729.172,6,61,4452,40,33,44337,33,2740,21,31,86449,31,1712
15.006,17,5,380,5,48,3751,48,380,0,0,0,0,0
215.657,17,6,1496,3,32,107823,37,181,3,410,107823,463,1315
1685.516,17,12,498,11,14,168551,14,462,1,8,0,8,36
305.541,6,32,8822,16,166,20244,735,2008,16,544,20360,2804,6814
3.476,6,22,7341,10,357,386,722,1476,12,672,285,1380,5865
976.643,6,2826,2718038,1010,158,967,880,61115,1816,1450,538,4254,2656923
1784.298,6,102,8364,68,66,26631,66,4964,34,60,54066,60,3400
1563.487,17,172,57760,172,307,9143,308,57760,0,0,0,0,0
0.221,17,2,152,1,48,0,48,76,1,48,0,48,76
1796.071,17,142,11360,71,48,25657,48,5396,71,56,25657,56,5964
0.345,6,27,9047,13,252,28,647,1692,14,945,26,1408,7355
1786.659,6,103,8404,68,66,26666,66,4964,35,60,52546,60,3440
1.157,6,14,3463,6,288,217,288,572,8,639,140,853,2891
280.406,6,30,7432,13,158,23367,267,1317,17,543,17524,1400,6115
1799.433,1,58,4872,58,56,31569,56,4872,0,0,0,0,0
0.22,6,26,7256,13,155,18,267,1301,13,603,16,2036,5955
1796.425,17,448,39896,403,35,4468,288,25676,45,288,40019,288,14220
4.931,17,4,536,2,54,4760,54,164,2,158,4757,158,372
0.191,17,2,396,1,39,0,39,67,1,301,0,301,329
1.743,6,13,2311,8,188,249,245,700,5,1407,368,1407,1611
1785.886,6,366,25541,213,100,8423,469,14936,153,69,11749,69,10605
0.021,6,10,1671,6,552,4,948,1348,4,159,7,159,323
0.916,6,11,1727,7,100,152,100,384,4,589,217,1152,1343
1740.909,17,30,7050,30,207,60031,207,7050,0,0,0,0,0
9.311,6,1641,1472467,1014,1372,9,1408,1435199,627,931,14,2816,37268
55.094,6,27,7432,10,155,9,267,1186,17,427,3442,3426,6246
180.463,6,34,18732,18,702,46,1360,4967,16,1192,12023,4080,13765
32.003,6,240,239301,80,129,405,310,4548,160,1451,201,2804,234753
1797.213,17,448,39896,403,35,4470,288,25676,45,288,40020,288,14220
1788.208,17,142,11360,71,48,25545,48,5396,71,56,25545,56,5964
0.012,17,2,157,1,31,0,31,59,1,70,0,70,98
1744.748,2,19,608,19,8,96930,8,608,0,0,0,0,0
1781.28,17,140,11192,71,48,25446,48,5396,69,56,25442,56,5796
0.02,17,2,218,1,65,0,65,93,1,97,0,97,125
0.925,17,4,768,2,39,688,39,134,2,289,921,289,634
1770.783,6,111,10212,69,66,26040,66,5856,42,60,43187,60,4356
179.105,6,56,11045,20,224,6631,1189,3051,36,284,5117,1420,7994
33.58,6,30,5065,15,154,2398,721,1882,15,399,2385,1408,3183
1795.235,17,80,3354,79,14,23015,14,3318,1,8,0,8,36
252.816,6,67,46115,44,1157,5879,1408,38186,23,960,2803,3847,7929
0.27,17,4,288,2,36,222,36,128,2,52,222,52,160
0.791,17,4,588,2,48,781,48,152,2,190,779,308,436
300.128,1,4,224,4,28,100042,28,224,0,0,0,0,0
0.123,6,37,14475,22,875,5,1420,9654,15,467,8,1883,4821
23.082,6,30,7297,14,155,1775,267,1346,16,441,1538,1420,5951
16.506,6,1961,1641762,1148,1371,14,1380,1602048,813,468,20,3303,39714
1782.345,17,283,56273,283,170,6320,358,56273,0,0,0,0,0
67.079,1,6,336,6,28,13415,28,336,0,0,0,0,0
5.7,6,40,7309,20,218,300,314,3423,20,513,285,1179,3886
1798.064,6,370,25839,216,99,8363,469,15125,154,69,11751,69,10714
10.802,6,2366,2249712,1545,1381,6,1408,2202356,821,931,12,2816,47356
1795.149,17,449,39928,404,35,4454,288,25708,45,288,40017,288,14220
65.151,6,21,852,11,0,6514,0,444,10,0,7237,0,408
1796.621,17,448,39896,403,35,4469,288,25676,45,288,40018,288,14220
1786.595,6,105,8406,68,64,26665,64,4896,37,58,49625,58,3510
240.334,6,44,8448,22,449,11444,1418,5648,22,206,11443,580,2800
6.348,6,61,11765,30,242,218,314,6059,31,446,203,1179,5706
0.227,17,2,198,1,39,0,39,67,1,103,0,103,131
1.519,6,41,11177,21,591,75,1360,5601,20,433,70,1360,5576
17.265,6,2292,2097934,1428,1389,11,1440,2048342,864,776,19,1440,49592
174.825,17,6635,8229023,665,73,263,1350,67305,5970,1339,29,1350,8161718
1478.521,6,183,18514,90,85,16612,721,8495,93,179,16068,2007,10019
1740.472,17,30,31680,30,1028,60016,1028,31680,0,0,0,0,0
1.91,6,2,80,1,0,0,0,40,1,0,0,0,40
1.441,6,50,21333,29,907,51,1360,15717,21,476,61,2715,5616
0.0,6,1,293,0,0,0,0,0,1,253,0,253,293
1.232,6,10,1687,7,100,205,100,384,3,1179,483,1179,1303
18.743,17,4,824,2,48,18730,48,152,2,308,18727,308,672
149.323,6,22,8564,11,549,81,1309,2120,11,856,14915,1360,6444
1200.112,6,17,1021,11,31,120011,31,595,6,31,239987,31,426
1710.441,17,12,498,11,14,171044,14,462,1,8,0,8,36
1787.53,6,104,8376,68,65,26679,65,4930,36,59,51068,59,3446
0.294,6,20,7229,12,334,26,663,1969,8,1209,41,2816,5260
3.988,6,2,88,2,0,0,0,88,0,0,0,0,0
42.76,6,127,48503,60,1011,724,1440,31932,67,413,642,1702,16571
104.142,6,22,10189,11,433,82,990,1771,11,1138,10397,2568,8418
123.415,6,32,10739,17,594,53,1360,3733,15,639,8805,4080,7006
1788.071,17,142,11360,71,48,25543,48,5396,71,56,25543,56,5964
182.716,6,45,14325,25,289,7610,669,3055,20,871,9604,2269,11270
1189.115,6,121,7563,63,48,19179,208,4592,58,31,20858,31,2971
10.32,6,82,24837,42,561,251,1152,19096,40,413,257,1152,5741
184.389,6,31,8912,14,158,14183,267,1357,17,687,11522,2036,7555
5.748,6,672,590178,418,1337,13,1368,570066,254,776,21,1473,20112
1796.131,17,448,39896,403,35,4467,288,25676,45,288,40016,288,14220
1786.979,6,102,8364,68,66,26671,66,4964,34,60,54148,60,3400
1776.459,17,138,11040,69,48,26124,48,5244,69,56,26124,56,5796
1.576,6,242,193000,146,1345,10,1432,184860,96,389,16,1432,8140
5.751,17,12,852,6,32,1148,32,360,6,54,1148,60,492
0.414,6,20,7238,12,335,37,668,1974,8,1210,58,1906,5264
4.398,6,42,14116,20,393,231,1440,3622,22,872,178,1440,10494
23.374,6,35,8177,16,188,1558,722,1964,19,605,1286,1380,6213
20.516,17,4,352,2,48,20459,48,152,2,72,20496,72,200
1785.335,6,116,13814,75,81,24126,501,5950,41,159,44631,1420,7864
1791.167,1,59,4956,59,56,30882,56,4956,0,0,0,0,0
1739.143,2,19,608,19,8,96619,8,608,0,0,0,0,0
1620.401,1,7,742,7,78,270066,78,742,0,0,0,0,0
0.624,6,21,7232,13,319,52,602,1972,8,967,81,1471,5260
22.832,6,1161,987043,729,1278,31,1368,959915,432,931,52,2841,27128
1.776,6,20,9028,10,124,197,124,652,10,1121,197,1448,8376
99.203,17,4,352,2,60,99202,60,176,2,60,99202,60,176
1740.612,17,29,19517,29,645,62164,645,19517,0,0,0,0,0
0.008,17,2,2752,2,1348,8,1348,2752,0,0,0,0,0
158.373,6,1284,635193,697,845,227,1152,604824,587,404,269,1179,30369
1.632,6,28,10333,16,368,108,837,1749,12,1012,140,1420,8584
14.92,6,14,5716,4,106,4973,106,274,10,718,1648,1420,5442
322.059,6,34,11114,11,305,32205,1189,2889,23,429,14638,1420,8225
1.888,17,4,360,2,30,1871,30,116,2,94,1865,94,244
11.595,6,25,8473,13,275,966,275,1078,12,986,757,1440,7395
0.572,17,20,11253,9,643,64,1350,6041,11,445,49,1350,5212
120.26,2,3,96,3,8,60130,8,96,0,0,0,0,0
437.331,17,32,2544,18,48,25725,48,1368,14,56,25738,56,1176
0.783,17,2,672,2,308,783,308,672,0,0,0,0,0
30.983,6,13,2142,8,329,4426,594,1082,5,396,7742,580,1060
1765.918,1,54,4536,54,56,33319,56,4536,0,0,0,0,0
1772.426,6,180,15480,120,69,14894,69,8940,60,69,30033,69,6540
1.606,17,21,7522,9,400,200,1350,3858,12,277,134,1350,3664
0.099,6,14,4769,7,290,16,517,941,7,1152,15,1468,3828
0.516,17,4,624,2,64,452,64,184,2,192,457,192,440
31.007,17,6,668,6,83,6201,84,668,0,0,0,0,0
1.504,6,55,21967,30,993,51,1460,16146,25,400,54,1460,5821
0.015,6,2,104,1,0,0,0,52,1,0,0,0,52
18.558,6,43,22608,26,238,742,640,2312,17,1940,1158,4400,20296
1795.611,17,448,39896,403,35,4466,288,25676,45,288,40020,288,14220
3.163,17,28,12769,13,649,263,1350,8810,15,235,114,1350,3959
240.172,6,53,17935,28,797,8895,1402,15013,25,201,10006,580,2922
0.914,17,2,176,2,60,914,60,176,0,0,0,0,0
3.053,6,2,88,2,0,0,0,88,0,0,0,0,0
1795.587,1,174,9744,174,28,10379,28,9744,0,0,0,0,0
0.4,6,47,20831,27,1048,15,1380,15789,20,468,18,3303,5042
3.991,6,2,230,1,0,0,0,40,1,138,0,138,190
91.429,6,123,97528,81,1257,1142,1408,87221,42,811,2224,3847,10307
20.487,6,37,8573,14,286,1575,766,1792,23,416,925,1360,6781
1793.802,17,66,2766,65,14,28028,14,2730,1,8,0,8,36
1798.687,6,369,25799,215,99,8405,469,15085,154,69,11753,69,10714
0.387,6,50,21114,28,1055,14,1380,15947,22,387,17,1923,5167
0.529,6,87,58600,52,1239,10,1432,52909,35,427,14,1432,5691
0.097,17,2,158,1,34,0,34,62,1,68,0,68,96
0.016,6,3,160,2,0,16,0,100,1,0,0,0,60
1753.71,1,48,2688,48,28,37312,28,2688,0,0,0,0,0
121.139,6,813,384920,428,837,283,1152,364729,385,435,314,1179,20191
300.661,6,43,8820,19,266,16703,720,1858,24,315,2464,3488,6962
240.264,6,53,17833,29,742,8580,1418,14879,24,242,10445,580,2954
33.602,6,29,4991,14,154,2584,722,1807,15,400,2386,1440,3184
1794.298,17,257,52613,257,176,7008,358,52613,0,0,0,0,0
1.371,6,41,11378,22,547,65,1360,5842,19,476,65,2715,5536
1786.797,6,157,20218,93,302,19421,302,14222,64,83,28361,83,5996
0.074,6,9,1343,5,145,18,145,349,4,830,21,830,994
1779.988,1,341,28644,341,56,5235,56,28644,0,0,0,0,0
1189.211,17,311,36941,147,147,8145,1350,25793,164,39,7288,1350,11148
0.573,6,14,1745,7,288,68,288,600,7,426,68,434,1145
251.084,2,2,64,2,8,251084,8,64,0,0,0,0,0
91.221,17,4,352,2,60,91219,60,176,2,60,91220,60,176
305.177,6,41,9523,14,275,23475,731,1694,27,396,2578,1360,7829
6.601,6,407,409822,221,891,30,1402,37125,186,2226,35,8376,372697
0.307,17,2,152,1,48,0,48,76,1,48,0,48,76
0.531,17,3,451,2,39,456,39,134,1,289,0,289,317
1799.537,1,148,8288,148,28,12241,28,8288,0,0,0,0,0
1739.027,6,130,16354,77,78,22881,877,7090,53,158,33442,1448,9264
38.186,6,6,240,0,0,0,0,0,6,0,0,0,240
75.525,17,8,640,4,48,25169,48,304,4,56,25169,56,336
1.312,6,37,8212,19,320,72,1162,2716,18,476,66,2715,5496
62.171,6,79,56408,50,1198,1268,1368,48164,29,747,2211,1368,8244
15.645,17,27,5586,12,220,1419,1350,2982,15,145,1115,1350,2604
1787.906,6,354,22440,206,69,8721,69,12380,148,69,12162,69,10060
1740.694,17,30,31680,30,1028,60023,1028,31680,0,0,0,0,0
27.039,6,37,8664,19,351,1502,739,1883,18,504,516,1928,6781
0.349,17,8,2742,8,314,49,353,2742,0,0,0,0,0
357.509,6,48,11156,29,338,12768,1360,5594,19,399,478,1360,5562
49.852,17,4,304,4,48,16617,48,304,0,0,0,0,0
120.268,2,2,64,2,8,120268,8,64,0,0,0,0,0
1.438,6,50,19259,27,889,55,1460,13563,23,476,55,2615,5696
22.039,6,126,45846,64,672,349,1152,38884,62,407,356,1152,6962
1.433,6,116,87888,50,131,29,232,2529,66,1355,19,1430,85359
5.572,6,40,7309,20,218,293,314,3423,20,513,278,1179,3886
1796.104,17,448,39896,403,35,4467,288,25676,45,288,40020,288,14220
3.983,17,8,1216,4,60,1317,60,352,4,188,1317,188,864
2.714,6,2,88,2,0,0,0,88,0,0,0,0,0
0.026,17,2,590,1,41,0,41,69,1,493,0,493,521
1787.185,6,104,8308,68,64,26674,64,4896,36,58,51060,58,3412
73.902,6,37,11835,19,633,4105,1360,4595,18,591,4337,1360,7240
0.053,6,2,421,1,0,0,0,40,1,341,0,341,381
60.074,6,18,5249,10,107,6674,159,970,8,966,8581,1668,4279
1762.314,6,98,7421,65,38,27536,205,4611,33,33,55059,98,2810
31.758,6,8,436,2,0,31758,0,100,6,0,6312,0,336
75.875,6,101,75644,65,1269,1185,1448,65608,36,741,2097,2359,10036
163.542,6,28,6712,13,262,13625,517,1472,15,744,11678,1418,5240
1770.451,6,112,10206,70,64,25658,64,5956,42,58,43179,58,4250
6.268,6,1003,867422,594,1380,10,1408,841478,409,931,14,2801,25944
7.148,6,1619,1470144,1004,1385,6,1408,1433500,615,931,11,2801,36644
1798.239,1,59,4956,59,56,31004,56,4956,0,0,0,0,0
879.002,6,15,5108,15,322,62785,322,5108,0,0,0,0,0
3.965,17,5,588,4,64,1321,64,368,1,192,0,192,220
63.817,17,4,284,2,32,63811,32,120,2,54,63810,60,164
240.33,6,42,8809,20,197,12647,751,2429,22,522,11443,2736,6380
1.26,6,47,18699,27,857,48,1360,13123,20,476,57,2715,5576
1788.473,17,87,3648,86,14,21040,14,3612,1,8,0,8,36
0.19,6,28,7336,13,155,15,267,1301,15,543,12,1300,6035
1766.902,6,107,8563,70,49,25607,205,5271,37,36,49075,98,3292
27.896,17,33,13949,15,642,1989,1350,10057,18,188,1638,1350,3892
1798.271,6,366,24603,213,87,8482,469,14136,153,69,11828,69,10467
0.189,1,2,163,2,53,189,78,163,0,0,0,0,0
155.204,17,4,352,2,60,155203,60,176,2,60,155203,60,176
10.866,6,1619,1344907,876,1436,12,1448,1292646,743,927,14,1448,52261
117.307,6,21,7954,11,511,84,1194,2005,10,922,13014,1631,5949
0.616,6,238,313294,108,183,5,230,6173,130,2364,4,7010,307121
12.032,6,9,376,5,0,3006,0,204,4,0,4005,0,172
23.207,6,36,8216,17,188,1450,721,2003,19,544,1277,1420,6213
5.542,6,455,401642,290,1323,18,1368,388398,165,776,32,1473,13244
171.587,6,30,7432,13,158,14298,267,1317,17,543,10721,1400,6115
0.333,6,27,9141,13,271,27,726,1771,14,947,25,2816,7370
0.135,6,10,1380,6,145,27,145,389,4,827,43,827,991
0.295,6,12,3704,6,171,51,171,491,6,964,58,1448,3213
300.89,6,42,8539,23,241,13676,619,2025,19,574,723,4848,6514
282.33,17,4,352,2,60,282329,60,176,2,60,282329,60,176
17.64,17,20,6701,10,398,1956,1350,4269,10,215,1956,1350,2432
2.975,17,2,1430,2,687,2975,687,1430,0,0,0,0,0
13.405,6,11,2033,7,326,2234,589,1025,4,396,67,580,1008
1.623,6,25,8771,15,286,115,591,1463,10,986,161,1420,7308
1786.558,6,104,8444,68,66,26665,66,4964,36,60,51041,60,3480
1256.756,6,252,15945,146,69,8666,69,8807,106,69,11968,69,7138
0.485,17,3,451,2,39,83,39,134,1,289,0,289,317
216.496,6,78,51314,47,1191,4706,1408,42967,31,961,2053,3847,8347
0.537,17,3,451,2,39,478,39,134,1,289,0,289,317
2.751,6,2,88,2,0,0,0,88,0,0,0,0,0
3.009,6,25,8103,11,330,296,517,1914,14,779,227,1418,6189
1.493,6,3,1560,1,0,0,0,40,2,1440,270,1440,1520
174.986,1,6,636,6,78,34997,78,636,0,0,0,0,0
0.094,6,3,327,2,103,0,138,287,1,0,0,0,40
82.745,6,1673,1551727,1033,1421,80,1448,1512229,640,443,129,1448,39498
1.344,6,38,8254,19,321,74,1164,2718,19,433,65,1360,5536
2.375,6,15,1680,8,256,337,256,1092,7,304,393,304,588
71.739,6,30,8716,16,434,4782,659,2190,14,723,5430,1408,6526
315.982,6,72,13857,30,211,10895,1305,3870,42,259,7702,2720,9987
1707.151,1,8,448,8,28,243878,28,448,0,0,0,0,0
1786.602,6,361,22858,210,69,8548,69,12678,151,69,11910,69,10180
0.0,6,1,44,0,0,0,0,0,1,0,0,0,44
1787.965,6,359,22709,209,69,8595,69,12569,150,69,11999,69,10140
1.424,6,46,18875,26,940,56,1460,13299,20,433,65,1460,5576
251.443,2,2,64,2,8,251443,8,64,0,0,0,0,0
0.025,6,10,1800,6,616,4,1076,1477,4,159,7,159,323
156.069,17,4,352,2,60,156067,60,176,2,60,156067,60,176
1749.33,6,153,9547,82,47,21596,208,5808,71,31,24987,31,3739
200.247,6,24,6253,13,290,16687,517,1265,11,1469,20012,2460,4988
133.734,6,25,10263,12,563,56,1360,2764,13,995,11133,1360,7499
300.696,6,37,8526,19,315,16705,882,2053,18,441,498,1440,6473
1.499,6,25,8469,15,175,107,362,1666,10,1045,122,2331,6803
1795.351,17,447,39864,402,35,4477,288,25644,45,288,40022,288,14220
1790.2,1,92,5152,92,28,19672,28,5152,0,0,0,0,0
61.494,6,35,8475,18,410,512,882,2042,17,574,3834,4848,6433
1795.284,17,449,39928,404,35,4454,288,25708,45,288,40020,288,14220
1612.725,1,8,448,8,28,230389,28,448,0,0,0,0,0
0.493,17,3,451,2,39,78,39,134,1,289,0,289,317
178.141,2,4,128,4,8,59380,8,128,0,0,0,0,0
1793.788,17,66,2766,65,14,28027,14,2730,1,8,0,8,36
3.75,17,4,352,2,48,3738,48,152,2,72,3739,72,200
1782.457,6,103,8336,68,65,26603,65,4930,35,59,52345,59,3406
0.025,17,2,144,1,36,0,36,64,1,52,0,52,80
0.243,17,3,451,2,39,173,39,134,1,289,0,289,317
4.608,6,2,288,0,0,0,0,0,2,92,4608,92,288
13.25,6,23,6002,12,275,1204,275,1038,11,902,1206,1440,4964
1720.471,17,12,498,11,14,172047,14,462,1,8,0,8,36
10.022,17,3,3249,3,1055,5011,1055,3249,0,0,0,0,0
12.762,6,2230,1842319,1208,1425,10,1448,1774547,1022,776,12,1448,67772
0.097,17,2,588,1,39,0,39,67,1,493,0,493,521
240.601,2,3,96,3,8,120300,8,96,0,0,0,0,0
3.882,17,3,183,3,33,1941,33,183,0,0,0,0,0
25.147,6,22,3479,11,185,2514,185,890,11,531,2474,853,2589
1798.48,6,375,68629,244,316,7401,316,51564,131,83,13834,83,17065
27.174,6,31,7496,11,165,2717,267,1109,20,348,1429,1420,6387
1797.739,1,82,6888,0,0,0,0,0,82,56,22194,56,6888
0.488,17,2,782,2,363,488,363,782,0,0,0,0,0
21.417,17,12,1056,6,48,4281,48,456,6,72,4280,72,600
0.479,6,12,1653,6,288,89,288,548,6,426,54,434,1105
1.269,6,39,9888,21,440,63,1360,4392,18,433,63,1360,5496
94.685,6,58,37338,32,783,3054,1408,5591,26,1519,3471,8266,31747
21.299,17,34,10805,15,389,1518,1350,6261,19,211,1181,1350,4544
123.062,6,22,3095,12,304,11187,304,2140,10,83,13672,83,955
1794.719,6,279,33771,116,139,15605,1460,16717,163,126,11077,1642,17054
96.194,6,38,8259,14,131,7399,267,1622,24,333,4172,1452,6637
1787.541,6,107,10014,70,100,25906,1257,6301,37,63,49649,193,3713
1796.723,6,364,23047,211,69,8555,69,12787,153,69,11820,69,10260
293.619,1,4,224,4,28,97873,28,224,0,0,0,0,0
0.051,6,10,767,5,186,12,186,454,5,45,10,45,313
1795.593,17,448,39896,403,35,4466,288,25676,45,288,40017,288,14220
481.287,2,4,128,4,8,160429,8,128,0,0,0,0,0
1708.034,6,345,21804,196,69,8522,69,11980,149,69,11540,69,9824
0.134,6,9,1340,5,145,33,145,349,4,827,34,827,991
1794.846,1,58,4872,58,56,31488,56,4872,0,0,0,0,0
63.138,6,34,5261,20,154,3323,721,2129,14,400,1203,2026,3132
240.289,6,43,8953,21,523,12014,1408,5808,22,221,11442,618,3145
1784.938,17,142,11360,71,48,25498,48,5396,71,56,25498,56,5964
1786.159,6,102,8296,68,65,26659,65,4930,34,59,54123,59,3366
1763.578,2,15,480,15,8,125969,8,480,0,0,0,0,0
716.447,6,55,10215,26,268,28654,517,2713,29,748,25584,1368,7502
0.673,6,23,5715,13,158,55,370,1315,10,999,74,1731,4400
33.601,6,31,5094,15,154,2400,722,1859,16,342,2227,1408,3235
1680.17,1,8,448,8,28,240024,28,448,0,0,0,0,0
1263.193,6,71,5459,47,41,27460,205,3396,24,33,54912,98,2063
161.001,6,28,2059,11,79,13100,293,994,17,48,10062,78,1065
1772.539,6,182,15560,120,69,14895,69,8940,62,69,29052,69,6620
1784.874,17,491,143306,491,263,3642,422,143306,0,0,0,0,0
1773.128,6,180,15480,120,69,14900,69,8940,60,69,30050,69,6540
0.938,17,17,10560,9,881,117,1350,8181,8,269,129,1350,2379
3.59,17,8,2804,8,322,512,364,2804,0,0,0,0,0
70.095,17,17,18408,17,1054,4380,1451,18408,0,0,0,0,0
106.625,6,72,48825,45,1197,2423,1408,40678,27,748,2370,1408,8147
1785.119,1,108,11448,108,78,16683,78,11448,0,0,0,0,0
184.363,1,20,2080,0,0,0,0,0,20,76,9703,76,2080
1742.865,6,94,7151,62,38,28571,205,4424,32,33,56213,98,2727
140.171,17,4,288,2,36,140157,36,128,2,52,140156,52,160
40.124,17,3,228,3,48,20062,48,228,0,0,0,0,0
0.046,17,8,2446,8,277,6,316,2446,0,0,0,0,0
300.337,6,53,29951,24,190,13058,444,2053,29,1147,8606,1461,27898
1743.07,6,95,7203,63,38,28114,205,4476,32,33,56214,98,2727
1681.687,17,14,1036,7,30,280278,30,406,7,62,280278,62,630
1.955,6,33,6598,16,152,130,267,2013,17,780,113,1460,4585
1773.798,6,167,10408,85,49,21116,208,6198,82,31,21895,31,4210
1776.004,17,140,11200,70,48,25739,48,5320,70,56,25738,56,5880
0.265,6,2,80,1,0,0,0,40,1,0,0,0,40
9.715,17,28,12255,12,321,883,1350,4198,16,475,636,1350,8057
24.836,6,16,2788,7,837,4137,1452,1958,9,231,3102,231,830
1.419,17,14,7625,7,716,236,1350,5214,7,316,227,1350,2411
362.702,6,52,9433,23,131,16476,722,2505,29,320,12945,1380,6928
1.076,17,6,1092,3,33,536,33,183,3,275,517,323,909
1798.177,1,345,28980,345,56,5227,56,28980,0,0,0,0,0
0.592,6,3,160,2,0,592,0,100,1,0,0,0,60
0.043,17,2,412,1,48,0,48,76,1,308,0,308,336
280.259,6,27,7312,13,158,23354,267,1317,14,775,21556,4836,5995
280.361,6,30,7432,13,158,23363,267,1317,17,543,17519,1400,6115
0.253,17,3,451,2,39,66,39,134,1,289,0,289,317
1744.68,2,26,832,26,8,69787,8,832,0,0,0,0,0
1787.198,17,142,11360,71,48,25530,48,5396,71,56,25530,56,5964
2.052,17,4,314,2,31,2034,31,118,2,70,2036,70,196
299.373,17,4,558,2,36,299367,36,128,2,187,299365,187,430
67.661,6,34,21267,21,549,38,1360,3080,13,2522,5628,8948,18187
1768.529,1,58,4872,58,56,31026,56,4872,0,0,0,0,0
1664.211,1,7,392,7,28,277368,28,392,0,0,0,0,0
0.549,17,2,241,1,36,0,36,64,1,149,0,149,177
825.19,6,107,7866,42,62,20122,329,3791,65,47,12891,78,4075
1769.865,6,99,9240,66,65,27228,65,5577,33,59,55304,59,3663
0.02,6,10,1512,5,503,5,503,771,5,473,4,473,741
180.338,2,2,64,2,8,180338,8,64,0,0,0,0,0
1795.034,6,413,33575,231,93,7804,1189,16423,182,140,9916,4837,17152
1740.737,6,91,6604,59,31,30012,31,3998,32,31,56152,31,2606
1.508,17,19,7284,9,476,183,1350,4536,10,246,163,1350,2748
1772.352,6,180,15480,120,69,14893,69,8940,60,69,30036,69,6540
0.291,6,4,168,3,0,145,0,124,1,0,0,0,44
1787.52,6,106,8456,68,65,26679,65,4930,38,59,48308,59,3526
837.912,2,9,288,9,8,104739,8,288,0,0,0,0,0
1401.313,17,12,888,6,30,280260,30,348,6,62,280259,62,540
0.568,6,29,8832,14,158,43,267,1357,15,687,34,2036,7475
15.673,6,2012,1822613,1214,1418,12,1448,1774725,798,776,19,1448,47888
11.688,6,98,30465,50,595,238,1152,24047,48,449,243,1179,6418
632.465,17,16,1408,8,48,90350,48,608,8,72,90350,72,800
1771.614,1,160,8960,160,28,11142,28,8960,0,0,0,0,0
172.129,17,4,240,2,32,172128,32,120,2,32,172127,32,120
1.516,6,48,18200,26,882,60,1360,12544,22,433,62,1360,5656
10.646,6,20,4442,11,275,1064,275,998,9,768,733,1440,3444
1799.414,17,812,272615,812,307,2218,323,272615,0,0,0,0,0
280.197,17,4,1098,2,30,280191,30,116,2,463,280192,463,982
0.008,17,8,2446,8,277,1,316,2446,0,0,0,0,0
0.015,6,5,5880,1,0,0,0,40,4,1408,0,1408,5840
270.505,1,6,336,6,28,54101,28,336,0,0,0,0,0
12.908,6,88,24741,45,533,293,1152,18880,43,459,300,1179,5861
1792.889,17,67,2802,65,14,28010,14,2730,2,8,1792699,8,72
15.827,6,29,5002,15,154,1130,722,1871,14,399,1204,1448,3131
1740.282,6,87,6322,58,31,30531,31,3915,29,31,62151,31,2407
248.379,6,55,8563,26,287,9935,686,4815,29,185,8870,580,3748
280.236,6,28,7352,13,158,23353,267,1317,15,678,20014,2045,6035
1798.347,6,391,25162,220,69,8211,69,13423,171,69,10578,69,11739
721.996,2,7,224,7,8,120332,8,224,0,0,0,0,0
1779.336,6,125,7909,71,47,25419,208,4850,54,31,33566,31,3059
23.195,6,3249,3115016,2165,1363,10,1408,3053984,1084,931,21,2816,61032
0.391,6,21,7290,12,335,34,668,1974,9,968,47,1912,5316
1.607,17,16,8907,7,317,267,1350,2416,9,693,113,1350,6491
1.639,6,14,2351,8,188,234,245,700,6,703,277,1152,1651
89.184,6,75,49699,46,1183,1981,1448,41467,29,746,2202,1448,8232
0.318,6,27,9112,13,271,26,726,1771,14,943,23,1408,7341
1792.912,17,179,11456,179,36,10072,36,11456,0,0,0,0,0
1799.012,17,449,39928,404,35,4464,288,25708,45,288,40018,288,14220
0.54,17,2,476,1,39,0,39,67,1,381,0,381,409
1787.403,17,87,3648,86,14,21028,14,3612,1,8,0,8,36
31.7,6,8,376,2,0,31700,0,88,6,0,6304,0,288
3.116,6,2,88,2,0,0,0,88,0,0,0,0,0
1799.301,17,449,39928,404,35,4464,288,25708,45,288,40019,288,14220
0.273,6,18,3004,9,266,32,517,1542,9,493,32,828,1462
0.994,6,21,9161,11,500,99,1194,1996,10,964,85,1360,7165
1744.562,1,55,6241,55,85,32306,105,6241,0,0,0,0,0
1763.892,2,15,480,15,8,125992,8,480,0,0,0,0,0
1770.858,1,33,3889,33,89,55339,125,3889,0,0,0,0,0
1787.892,6,356,28254,175,247,10259,528,12055,181,39,9928,76,16199
1797.118,17,87,3648,86,14,21142,14,3612,1,8,0,8,36
5.7,2,2,96,2,24,5700,24,96,0,0,0,0,0
5.988,6,44,8385,22,227,285,314,4062,22,491,272,1179,4323
4.332,6,33,6129,17,206,270,314,2744,16,548,266,1179,3385
11.801,6,2068,1863959,1281,1375,9,1408,1818371,787,931,14,2801,45588
0.002,6,3,3040,1,0,0,0,40,2,1448,0,1448,3000
0.12,17,7,1445,7,178,20,219,1445,0,0,0,0,0
0.228,6,20,9028,10,124,25,124,652,10,1121,25,1448,8376
0.096,6,13,4256,7,85,15,85,457,6,1159,19,2896,3799
0.002,17,2,150,2,47,2,47,150,0,0,0,0,0
23.131,1,8,848,8,78,3304,78,848,0,0,0,0,0
5.361,6,42,8289,21,227,268,314,4022,21,489,255,1179,4267
38.086,17,22,1936,11,48,3807,48,836,11,72,3807,72,1100
0.758,17,4,288,2,36,714,36,128,2,52,710,52,160
11.006,6,84,25210,43,553,262,1152,19429,41,413,268,1152,5781
3.857,17,3,183,3,33,1928,33,183,0,0,0,0,0
0.351,17,2,384,1,36,0,36,64,1,292,0,292,320
1791.515,17,144,11520,72,48,25232,48,5472,72,56,25232,56,6048
1.38,6,38,9848,20,502,72,1460,4352,18,433,70,1460,5496
155.874,6,31,14662,15,489,351,1440,3091,16,1091,10382,1440,11571
862.701,17,162,12312,162,48,5358,48,12312,0,0,0,0,0
0.005,17,3,1007,1,137,0,137,165,2,393,2,393,842
1794.124,1,58,4872,0,0,0,0,0,58,56,31475,56,4872
61.83,6,9,1512,4,202,6763,241,766,5,546,15457,546,746
1787.162,6,356,22520,208,69,8633,69,12460,148,69,12157,69,10060
1.153,17,12,5486,6,491,230,1350,3115,6,367,186,1350,2371
1.373,6,50,19039,29,869,49,1360,13378,21,437,59,2715,5661
1788.154,17,345,56143,345,134,5198,404,56143,0,0,0,0,0
3.353,17,4,420,2,33,0,33,122,2,121,0,145,298
1720.673,17,12,498,11,14,172067,14,462,1,8,0,8,36
10.335,6,1833,1700870,1171,1375,8,1408,1661782,662,931,15,2801,39088
62.059,6,74,56166,50,1199,1266,1368,48183,24,840,2687,2519,7983
1779.911,6,352,22360,205,69,8701,69,12340,147,69,12190,69,10020
1799.482,1,57,4788,0,0,0,0,0,57,56,32133,56,4788
1786.468,6,105,8416,68,65,26663,65,4930,37,59,49621,59,3486
1773.621,6,182,15629,121,69,14780,69,8980,61,69,29553,69,6649
130.136,6,22,1402,9,43,16250,46,621,13,43,10833,46,781
37.081,17,2,152,2,48,37081,48,152,0,0,0,0,0
155.224,6,174,137671,112,1278,1398,1408,123530,62,681,2364,1408,14141
840.641,17,8,2196,4,30,280210,30,232,4,463,280210,463,1964
3.239,6,552,452601,322,1379,10,1420,439180,230,526,14,3303,13421
1771.323,6,105,9690,68,64,26437,64,5724,37,58,49200,58,3966
1768.915,6,27,4077,18,241,104053,241,2889,9,92,221092,92,1188
1790.458,6,251,28469,129,130,13987,721,17025,122,168,14744,2840,11444
0.081,6,10,1514,5,503,20,503,771,5,475,20,475,743
62.979,6,79,57763,50,1200,1285,1408,47071,29,1019,2241,3847,10692
218.951,17,4,240,2,32,218950,32,120,2,32,218950,32,120
1797.364,6,227,19703,84,78,21653,337,8901,143,70,12656,1062,10802
0.085,17,2,152,1,48,0,48,76,1,48,0,48,76
154.013,6,44,9239,16,138,10267,267,2166,28,283,5703,1420,7073
5.017,6,45,8409,23,227,228,314,4102,22,489,226,1179,4307
1771.55,6,99,9240,66,65,27254,65,5577,33,59,55358,59,3663
51.669,6,28,7217,13,155,4305,267,1306,15,482,3689,1420,5911
1.531,6,38,8056,20,351,80,1420,2560,18,477,89,1485,5496
7.389,6,41,7449,20,209,388,314,3523,21,513,355,1179,3926
144.007,6,912,458127,508,835,284,1152,437176,404,435,356,1179,20951
1786.236,6,102,8296,68,65,26660,65,4930,34,59,54125,59,3366
1773.762,6,267,32643,107,140,16732,1440,15856,160,128,11154,1440,16787
1785.854,6,359,22709,209,69,8585,69,12569,150,69,11985,69,10140
0.061,17,3,560,2,60,19,60,176,1,356,0,356,384
8.373,6,1593,1320282,864,1428,9,1448,1268782,729,776,11,1448,51500
0.942,6,25,8703,14,264,72,700,1651,11,942,76,1460,7052
0.899,6,10,1687,7,100,149,100,384,3,1179,322,1179,1303
240.219,6,54,14827,29,643,8579,1402,11816,25,212,10008,580,3011
5.019,17,4,288,2,36,5003,36,128,2,52,4999,52,160
1795.13,17,80,3354,79,14,23014,14,3318,1,8,0,8,36
1.758,6,13,1096,7,283,264,283,663,6,105,316,105,433
6.126,17,12,852,6,32,1223,32,360,6,54,1224,60,492
299.311,1,4,326,4,53,99770,78,326,0,0,0,0,0
1.275,6,31,6467,15,164,91,267,1922,16,650,74,1452,4545
0.231,17,4,240,2,32,230,32,120,2,32,230,32,120
0.51,6,10,924,5,283,87,283,551,5,105,87,105,373
1.582,17,28,16076,13,561,124,1350,7662,15,532,107,1350,8414
0.005,17,2,445,1,45,0,45,73,1,344,0,344,372
1682.461,17,16,1184,8,30,240349,30,464,8,62,240349,62,720
1798.754,17,771,46566,771,32,2336,37,46566,0,0,0,0,0
1779.127,6,104,8504,69,66,26163,66,5004,35,60,52324,60,3500
125.369,6,14,3145,7,92,20894,92,452,7,465,20864,1402,2693
2.038,17,6,460,3,40,1008,41,206,3,56,1010,57,254
8.194,6,19,8351,9,275,1024,275,643,10,1216,857,1440,7708
316.97,6,104,35900,54,566,5980,1360,24871,50,310,6465,1929,11029
2.615,6,14,2351,8,188,373,245,700,6,703,470,1152,1651
1.446,6,49,19416,27,903,55,1460,13760,22,476,59,2920,5656
0.114,6,18,4114,10,75,12,75,603,8,514,16,1000,3511
0.253,17,2,2386,2,1165,253,1165,2386,0,0,0,0,0
1770.878,6,99,9240,66,65,27244,65,5577,33,59,55337,59,3663
7.024,6,13,2080,8,124,967,267,697,5,1179,1693,1179,1383
1796.865,17,448,39896,403,35,4469,288,25676,45,288,40017,288,14220
1798.593,17,448,39612,404,35,4463,288,25708,44,288,40951,288,13904
0.798,6,26,5887,13,156,66,267,1462,13,650,59,1414,4425
1.063,6,10,1687,7,100,177,100,384,3,1179,404,1179,1303
22.344,17,8,608,8,48,3192,48,608,0,0,0,0,0
1786.947,6,104,8376,68,65,26670,65,4930,36,59,51051,59,3446
0.404,2,2,64,2,8,404,8,64,0,0,0,0,0
24.651,6,29,7808,18,129,1450,159,1863,11,766,2463,1659,5945
2.806,6,124,89600,66,1195,43,1402,62029,58,1227,49,2804,27571
1631.479,1,11,1196,11,80,163147,88,1196,0,0,0,0,0
118.907,6,43,10516,15,294,1142,469,3262,28,255,4403,1460,7254
0.411,17,2,144,1,36,0,36,64,1,52,0,52,80
0.531,6,10,924,5,283,92,283,551,5,105,91,105,373
294.851,6,36,8086,13,158,24570,267,1317,23,365,13401,1400,6769
1.154,6,61,18557,35,372,33,1360,10364,26,649,40,1929,8193
1726.002,1,8,448,8,28,246571,28,448,0,0,0,0,0
4.437,17,2,656,2,300,4437,300,656,0,0,0,0,0
94.544,6,42,24174,24,840,31,1360,6035,18,1450,5551,2720,18139
56.47,6,27,7183,13,156,4705,267,1312,14,530,4343,3417,5871
17.762,1,7,728,0,0,0,0,0,7,76,2960,76,728
1704.727,1,15,870,15,30,121766,30,870,0,0,0,0,0
240.339,6,44,8468,23,449,10924,1408,5700,21,208,12016,580,2768
140.252,17,4,352,2,60,140251,60,176,2,60,140251,60,176
47.347,17,52,7644,26,48,1893,48,1976,26,190,1893,308,5668
1756.707,6,105,6240,60,26,29772,26,3510,45,26,39922,26,2730
0.004,17,2,414,1,32,0,32,60,1,326,0,326,354
37.232,17,34,6769,16,218,2480,1350,3949,18,128,2188,1350,2820
2.353,17,4,518,3,39,917,39,201,1,289,0,289,317
0.887,6,10,1687,7,100,147,100,384,3,1179,315,1179,1303
1776.407,1,232,24592,232,78,7690,78,24592,0,0,0,0,0
11.742,6,1910,1625159,1126,1387,10,1420,1589566,784,420,14,1420,35593
340.4,17,8,2688,8,308,48628,308,2688,0,0,0,0,0
1787.87,6,366,61825,217,304,8277,304,44636,149,83,12080,83,17189
142.864,17,4,352,2,60,142863,60,176,2,60,142863,60,176
10.129,6,9,527,5,43,2532,43,311,4,0,3374,0,216
4.766,6,38,7229,19,218,264,314,3383,19,513,250,1179,3846
9.16,17,12,4476,12,345,832,361,4476,0,0,0,0,0
1755.581,6,4351,4176579,1682,147,1044,923,105561,2669,1514,641,8412,4071018
1741.287,6,91,6604,59,31,30022,31,3998,32,31,56167,31,2606
1786.888,6,102,8296,68,65,26669,65,4930,34,59,54145,59,3366
2.883,6,2,88,2,0,0,0,88,0,0,0,0,0
8.351,6,28,11502,16,667,556,1360,4008,12,1400,747,3947,7494
0.052,17,2,138,1,33,0,33,61,1,49,0,49,77
1661.785,1,82,4592,82,28,20515,28,4592,0,0,0,0,0
1789.984,1,170,9520,170,28,10591,28,9520,0,0,0,0,0
0.227,6,10,1840,5,901,56,901,1169,5,403,56,403,671
280.517,6,30,7432,13,158,23376,267,1317,17,603,17524,2076,6115
4.287,17,4,824,2,48,4263,48,152,2,308,4268,308,672
1788.216,17,86,3606,85,14,21288,14,3570,1,8,0,8,36
190.178,6,45,7015,24,210,8268,585,3214,21,300,9496,611,3801
1504.044,2,14,448,14,8,115695,8,448,0,0,0,0,0
0.013,17,4,624,2,64,0,64,184,2,192,0,192,440
1.876,6,61,18063,30,697,64,1360,8905,31,416,61,1360,9158
1.177,6,24,8004,11,164,99,267,1236,13,869,82,1448,6768
0.236,17,2,136,1,32,0,32,60,1,48,0,48,76
1771.056,6,101,9344,66,65,27247,65,5577,35,59,52086,59,3767
10.599,6,20,4442,11,275,1059,275,998,9,768,728,1440,3444
1775.043,17,140,11200,70,48,25725,48,5320,70,56,25725,56,5880
0.127,17,2,152,1,48,0,48,76,1,48,0,48,76
1.013,6,26,8521,15,175,72,362,1666,11,896,79,1448,6855
182.513,6,14,4934,4,150,1693,174,464,10,1354,20269,1420,4470
1786.762,6,356,22520,208,69,8631,69,12460,148,69,12154,69,10060
170.509,6,45,6811,18,148,4607,722,2169,27,170,6551,1408,4642
1.097,6,27,5740,13,125,91,267,1275,14,650,76,1420,4465
0.222,6,10,1671,6,552,44,948,1348,4,159,73,159,323
364.622,6,18,1239,14,177,28047,177,913,4,110,20054,110,326
1777.092,17,72,3018,71,14,25387,14,2982,1,8,0,8,36
0.307,6,3,160,2,0,307,0,100,1,0,0,0,60
1777.055,17,142,11360,71,48,25385,48,5396,71,56,25386,56,5964
95.688,6,32,8218,11,157,9561,267,1706,21,354,4782,2077,6512
0.01,17,2,415,1,34,0,34,62,1,325,0,325,353
45.486,6,10,548,4,0,15162,0,216,6,0,9006,0,332
0.406,1,2,112,2,28,406,28,112,0,0,0,0,0
0.064,6,9,1002,5,213,16,213,417,4,421,18,421,585
858.096,1,8,448,8,28,122585,28,448,0,0,0,0,0
615.937,6,104,22052,49,289,12832,1360,10721,55,246,11403,3289,11331
64.138,6,46,10249,22,533,728,910,3083,24,344,2782,1360,7166
1773.932,6,180,15480,120,69,14906,69,8940,60,69,30058,69,6540
15.544,6,7,380,2,0,15544,0,100,5,0,3844,0,280
1787.542,6,291,20127,175,69,10273,69,11278,116,69,15537,69,8849
0.763,17,17,8156,8,533,100,1350,4493,9,379,86,1350,3663
20.518,17,3,228,3,48,10259,48,228,0,0,0,0,0
280.582,6,30,7432,14,158,21583,267,1357,16,603,18699,2036,6075
8.282,6,1462,1160581,761,1423,10,1448,1113177,701,776,11,1448,47404
1787.245,6,106,8584,69,66,26283,66,5004,37,60,49641,60,3580
1773.841,1,228,12768,228,28,7814,28,12768,0,0,0,0,0
0.645,17,15,9128,8,822,83,1350,6803,7,304,95,1350,2325
1.529,6,37,8214,19,321,84,1164,2718,18,476,78,2715,5496
373.949,6,21,1419,15,177,26710,177,989,6,110,15602,110,430
1796.993,17,85,3564,84,14,21650,14,3528,1,8,0,8,36
1798.337,6,368,25759,214,99,8442,469,15045,154,69,11753,69,10714
65.1,6,53,15099,23,375,153,1189,5806,30,449,2244,1926,9293
0.456,6,50,21513,28,1014,16,1380,16391,22,421,19,1923,5122
300.214,6,24,6782,12,158,27287,267,1277,12,836,27286,3456,5505
53.301,6,16,2289,9,324,6662,585,1125,7,396,8881,580,1164
138.317,6,19,3034,11,323,13831,582,1238,8,457,19699,580,1796
0.012,17,2,362,1,30,0,30,58,1,276,0,276,304
878.767,6,22,25004,3,174,73,174,298,19,1408,48815,1420,24706
1.269,6,47,18534,27,846,48,1360,12958,20,476,57,2715,5576
0.857,17,4,360,2,30,825,30,116,2,94,826,94,244
1769.387,6,101,9350,65,66,27646,66,5558,36,60,50547,60,3792
0.26,17,3,451,2,39,145,39,134,1,289,0,289,317
96.299,6,22,7994,11,511,86,1194,2005,11,922,9612,1631,5989
28.487,6,13,3938,7,307,4747,722,1293,6,1164,5652,1408,2645
1.555,2,3,96,3,8,777,8,96,0,0,0,0,0
1798.297,17,763,46018,763,32,2359,37,46018,0,0,0,0,0
3.618,6,12,507,6,0,723,0,248,6,7,512,7,259
243.34,1,8,4608,8,548,34762,548,4608,0,0,0,0,0
0.282,6,12,3462,6,75,56,75,395,6,1373,56,1448,3067
12.041,17,6,456,6,48,2408,48,456,0,0,0,0,0
0.091,2,3,96,3,8,45,8,96,0,0,0,0,0
0.15,17,2,1922,2,933,150,933,1922,0,0,0,0,0
240.228,6,53,17978,28,800,8896,1418,15077,25,199,10009,580,2901
1775.269,17,142,11360,71,48,25360,48,5396,71,56,25360,56,5964
1743.262,6,97,7307,63,38,28117,205,4476,34,33,52814,98,2831
3.021,17,3,264,3,60,1510,60,264,0,0,0,0,0
45.867,6,28,7217,13,155,3822,267,1306,15,482,3275,2840,5911
7.821,6,28,7352,13,158,651,267,1317,15,678,555,2800,6035
0.112,6,171,252174,110,215,1,517,6660,61,4251,1,12672,245514
300.566,6,19,1279,6,177,60079,177,497,13,110,25032,110,782
1030.887,6,206,13139,116,69,8964,69,6986,90,69,11582,69,6153
1680.682,17,12,498,11,14,168068,14,462,1,8,0,8,36
0.397,6,28,10096,15,247,28,624,1788,13,1089,31,2896,8308
1787.912,6,358,22945,204,69,8807,69,12507,154,69,11685,69,10438
33.689,6,34,5296,16,154,2245,722,1912,18,271,1970,1402,3384
5.031,17,4,558,2,36,5020,36,128,2,187,5016,187,430
65.156,6,36,9499,16,327,254,1189,2615,20,506,3428,1917,6884
11.86,6,25,8453,13,275,988,275,1078,12,983,860,1420,7375
151.587,17,3,3511,3,1142,75793,1444,3511,0,0,0,0,0
0.189,17,4,368,2,32,103,32,120,2,96,101,96,248
1798.592,1,222,12432,222,28,8138,28,12432,0,0,0,0,0
240.317,6,42,8312,21,449,12015,1418,5596,21,230,12015,580,2716
0.105,6,9,1342,5,145,26,145,349,4,829,30,829,993
8.103,6,78,24341,40,550,207,1152,18680,38,459,212,1179,5661
170.675,17,4,352,2,60,170674,60,176,2,60,170674,60,176
0.102,6,7,352,0,0,0,0,0,7,0,0,0,352
709.991,17,66,9834,66,121,10922,121,9834,0,0,0,0,0
1787.002,6,102,8296,68,65,26671,65,4930,34,59,54146,59,3366
0.0,6,1,40,1,0,0,0,40,0,0,0,0,0
91.146,6,17,6300,2,106,230,106,194,15,422,6509,1420,6106
0.975,17,2,312,2,128,975,128,312,0,0,0,0,0
49.305,17,4,352,2,60,49304,60,176,2,60,49303,60,176
0.349,17,2,157,1,31,0,31,59,1,70,0,70,98
0.002,17,8,1670,8,180,0,219,1670,0,0,0,0,0
2.598,6,22,6403,10,262,283,517,1316,12,744,232,1418,5087
0.033,17,4,284,2,32,30,32,120,2,54,27,60,164
280.14,17,4,240,2,32,280138,32,120,2,32,280139,32,120
1741.344,17,30,7050,30,207,60046,207,7050,0,0,0,0,0
1746.045,6,97,7307,63,38,28162,205,4476,34,33,52898,98,2831
1779.818,17,142,11360,71,48,25425,48,5396,71,56,25425,56,5964
0.342,17,2,152,1,48,0,48,76,1,48,0,48,76
1.412,6,44,15087,24,774,61,1440,9511,20,433,64,1440,5576
3.415,6,13,5032,6,517,683,517,825,7,1275,556,1418,4207
1787.103,6,301,28514,128,64,14070,659,11216,173,124,10389,2720,17298
3.348,17,5,295,5,31,837,31,295,0,0,0,0,0
1684.525,2,15,480,15,8,120323,8,480,0,0,0,0,0
5.03,17,4,288,2,36,4982,36,128,2,52,4985,52,160
0.329,17,2,198,1,63,0,63,91,1,79,0,79,107
1799.349,17,449,39928,404,35,4464,288,25708,45,288,40021,288,14220
411.937,6,24,2135,15,65,29424,65,1223,9,55,51481,59,912
1.599,6,40,9194,20,398,84,1440,3618,20,433,74,1440,5576
2.255,6,30,6591,17,159,140,267,2115,13,564,182,1420,4476
726.611,1,9,504,9,28,90826,28,504,0,0,0,0,0
63.351,6,28,7712,7,154,905,267,752,21,382,3166,1452,6960
124.581,6,7,320,2,0,124570,0,88,5,0,31142,0,232
269.226,6,56,3689,30,76,9283,138,1890,26,69,10766,69,1799
1778.967,17,79,3312,78,14,23103,14,3276,1,8,0,8,36
20.422,6,20,2617,13,211,1700,211,1166,7,545,3400,904,1451
0.005,17,2,412,1,64,0,64,92,1,292,0,292,320
5.904,6,40,7309,20,218,310,314,3423,20,513,296,1179,3886
0.032,17,2,152,1,48,0,48,76,1,48,0,48,76
84.674,17,4,352,2,60,84672,60,176,2,60,84673,60,176
0.014,6,2,87,1,0,0,0,40,1,7,0,7,47
0.028,17,2,912,1,308,0,308,336,1,548,0,548,576
1783.32,17,83,3480,82,14,22016,14,3444,1,8,0,8,36
1796.452,17,447,39580,403,35,4468,288,25676,44,288,40948,288,13904
1799.326,17,142,11360,71,48,25704,48,5396,71,56,25704,56,5964
1.687,6,19,3781,10,234,187,564,1452,9,463,183,1343,2329
0.16,17,2,672,2,308,160,308,672,0,0,0,0,0
1771.129,6,99,9240,66,65,27248,65,5577,33,59,55344,59,3663
44.918,6,25,8117,10,181,4990,267,1128,15,638,3206,2045,6989
0.015,6,9,1557,5,515,3,515,783,4,558,5,558,774
1263.411,2,12,384,12,8,114855,8,384,0,0,0,0,0
1782.069,1,270,15120,270,28,6624,28,15120,0,0,0,0,0
1.402,6,47,18900,27,872,53,1360,13324,20,476,63,2715,5576
300.138,6,56,20911,27,1029,11537,1360,14503,29,261,10713,2667,6408
0.024,17,2,904,2,424,24,548,904,0,0,0,0,0
1.634,6,28,6111,16,135,108,267,1726,12,780,131,1460,4385
0.561,17,2,136,1,32,0,32,60,1,48,0,48,76
240.178,6,53,18054,29,761,8577,1402,15228,24,224,10442,580,2826
0.518,6,24,7449,13,334,43,663,2021,11,967,46,1946,5428
139.902,6,1193,593341,660,834,212,1152,565477,533,408,262,1179,27864
13.028,6,35,8131,19,315,723,630,1737,16,522,571,3488,6394
1743.274,6,97,7307,63,38,28117,205,4476,34,33,52819,98,2831
1787.643,17,87,3648,86,14,21031,14,3612,1,8,0,8,36
105.518,17,4,352,2,60,105517,60,176,2,60,105517,60,176
30.173,6,9,376,6,0,6034,0,244,3,0,1553,0,132
1786.89,6,104,8297,68,63,26670,63,4862,36,57,51051,57,3435
233.174,6,5107,4197177,2362,381,98,420,143514,2745,1430,84,7040,4053663
27.478,17,6,528,3,48,13734,48,228,3,72,13734,72,300
1.247,17,2,685,1,308,0,308,336,1,321,0,321,349
261.605,6,24,6022,9,205,32700,517,1287,15,393,18375,1541,4735
171.521,6,34,8112,11,174,200,267,1493,23,316,7795,1460,6619
0.132,17,2,459,1,40,0,40,68,1,363,0,363,391
280.448,17,4,296,2,30,280415,30,116,2,62,280419,62,180
1752.772,1,82,6888,0,0,0,0,0,82,56,21639,56,6888
1747.134,6,109,8729,69,48,25693,205,5250,40,36,44791,98,3479
59.24,17,4,352,2,60,59238,60,176,2,60,59239,60,176
285.879,6,44,13098,21,1160,14293,1418,10429,23,293,12993,293,2669
583.994,6,76,15276,30,93,15976,267,2883,46,257,12977,3417,12393
96.483,17,4,352,2,60,96482,60,176,2,60,96482,60,176
0.354,6,28,7482,17,306,22,1089,2828,11,701,34,1788,4654
1795.792,17,448,39896,403,35,4467,288,25676,45,288,40018,288,14220
1772.014,6,180,15480,120,69,14890,69,8940,60,69,30031,69,6540
2.103,6,11,2231,6,188,420,245,620,5,1407,452,1407,1611
1784.715,6,104,8376,68,65,26637,65,4930,36,59,50989,59,3446
0.145,6,2,80,2,0,0,0,80,0,0,0,0,0
223.052,6,35,11357,19,516,12391,1360,4406,16,629,14858,1360,6951
187.149,17,7,2352,7,308,31191,308,2352,0,0,0,0,0
0.148,17,2,178,1,29,0,29,57,1,93,0,93,121
281.818,6,29,7392,14,158,21678,267,1357,15,678,20108,3436,6035
15.113,17,11,4768,5,509,3771,1350,2685,6,319,3016,1350,2083
1750.6,17,12,498,11,14,175060,14,462,1,8,0,8,36
0.425,17,7,2390,7,313,70,354,2390,0,0,0,0,0
1792.819,17,86,3606,85,14,21343,14,3570,1,8,0,8,36
69.982,17,4,1344,4,308,23327,308,1344,0,0,0,0,0
1745.134,6,95,7203,63,38,28147,205,4476,32,33,56287,98,2727
1782.596,1,136,7616,136,28,13204,28,7616,0,0,0,0,0
0.277,6,9,1002,5,213,69,213,417,4,421,74,421,585
1.325,6,12,1304,6,256,263,256,756,6,304,262,304,548
9.927,6,13,2608,4,256,3309,256,420,9,304,1238,304,2188
46.487,6,25,7097,12,155,4226,267,1266,13,589,3873,3426,5831
1794.52,17,144,11520,72,48,25274,48,5472,72,56,25274,56,6048
1776.656,17,142,11360,71,48,25380,48,5396,71,56,25380,56,5964
1.276,6,46,18762,26,931,51,1460,13186,20,433,58,1460,5576
281.535,6,30,7432,13,158,23461,267,1317,17,603,17528,2076,6115
251.975,2,3,96,3,8,125987,8,96,0,0,0,0,0
2.05,17,3,174,3,30,1025,30,174,0,0,0,0,0
31.321,6,8,348,2,0,15,0,84,6,0,6261,0,264
0.067,17,2,212,1,46,0,46,74,1,110,0,110,138
240.233,6,53,17837,28,790,8897,1408,14895,25,204,10009,580,2942
555.959,17,7,448,7,36,92659,36,448,0,0,0,0,0
1771.394,6,101,9410,66,66,27252,66,5610,35,60,52097,60,3800
481.25,2,3,96,3,8,240625,8,96,0,0,0,0,0
1.141,17,4,560,2,64,878,64,184,2,160,856,160,376
126.019,2,2,64,2,8,126019,8,64,0,0,0,0,0
253.333,17,4,352,2,60,253331,60,176,2,60,253332,60,176
69.091,6,26,7137,12,155,6281,267,1266,14,530,5314,2006,5871
1791.532,1,254,14224,254,28,7081,28,14224,0,0,0,0,0
1788.78,6,260,25953,107,66,16874,616,9779,153,132,11767,1938,16174
1785.417,6,102,8296,68,65,26648,65,4930,34,59,54101,59,3366
79.597,6,22,9920,11,433,72,990,1771,11,1099,7945,1440,8149
0.013,6,8,416,0,0,0,0,0,8,0,0,0,416
1750.956,17,12,498,11,14,175095,14,462,1,8,0,8,36
891.074,6,57,4784,41,65,22276,65,3200,16,59,53860,59,1584
1624.346,2,15,480,15,8,116024,8,480,0,0,0,0,0
166.502,2,4,128,4,8,55500,8,128,0,0,0,0,0
378.254,2,3,96,3,8,189127,8,96,0,0,0,0,0
40.545,6,5237,5038593,3509,1359,11,1408,4944061,1728,931,23,2801,94532
0.73,17,24,15830,13,781,60,1350,10517,11,455,64,1350,5313
1755.739,6,4311,4381599,1626,147,1080,919,100580,2685,1584,654,8412,4281019
342.769,1,5,601,5,92,85692,103,601,0,0,0,0,0
1795.941,17,447,39864,402,35,4478,288,25644,45,288,40017,288,14220
2.534,17,2,178,1,29,0,29,57,1,93,0,93,121
0.013,17,4,865,2,47,3,47,150,2,329,3,341,715
0.326,17,4,950,2,40,316,40,136,2,379,313,379,814
1772.377,6,180,15480,120,69,14893,69,8940,60,69,30032,69,6540
0.188,6,28,7336,13,155,15,267,1301,15,543,12,1300,6035
1769.853,6,101,9344,66,65,27228,65,5577,35,59,52051,59,3767
1745.652,6,90,6540,60,31,29587,31,4050,30,31,60181,31,2490
1772.058,6,180,15480,120,69,14891,69,8940,60,69,30031,69,6540
1775.282,17,73,3060,72,14,25003,14,3024,1,8,0,8,36
51.077,6,28,7217,13,155,4256,267,1306,15,482,3647,1420,5911
1764.058,2,15,480,15,8,126004,8,480,0,0,0,0,0
301.039,6,24,9323,13,382,25072,1193,2118,11,1125,30086,2720,7205
95.924,6,24,6992,6,156,19184,267,718,18,426,5637,1917,6274
37.721,1,43,4472,0,0,0,0,0,43,76,898,76,4472
0.02,17,2,212,1,46,0,46,74,1,110,0,110,138
14.889,6,14,1025,7,222,2479,222,506,7,231,2479,231,519
285.303,6,27,2905,14,324,21943,585,1385,13,282,23771,580,1520
8.733,6,8,707,3,275,4366,275,399,5,96,1503,96,308
1680.058,1,15,840,15,28,120004,28,840,0,0,0,0,0
1775.375,17,138,11040,69,48,26108,48,5244,69,56,26108,56,5796
74.638,6,31,8912,14,158,5741,267,1357,17,687,4663,1781,7555
1744.378,6,151,9613,81,51,21804,208,5914,70,31,25276,31,3699
28.271,6,27,10076,14,644,2174,1360,3194,13,907,2341,1360,6882
18.14,6,16,6055,6,186,3628,267,621,10,718,278,1420,5434
14.867,6,24,6957,13,275,1238,275,1082,11,1353,1382,1440,5875
566.951,6,56,9353,30,93,19550,722,2975,26,334,18885,1448,6378
1611.547,1,36,2016,36,28,46044,28,2016,0,0,0,0,0
1789.255,6,356,22520,208,69,8643,69,12460,148,69,12171,69,10060
5.361,6,39,7269,19,218,297,314,3383,20,513,268,1179,3886
1791.628,17,143,11436,72,48,25233,48,5472,71,56,25594,56,5964
0.998,17,5,1192,3,32,496,32,180,2,478,992,486,1012
70.506,6,45,17136,24,1050,392,1360,11494,21,399,3514,1360,5642
371.381,6,25,1651,17,177,23211,177,1117,8,110,9232,110,534
0.131,17,2,904,2,424,131,548,904,0,0,0,0,0
1744.101,6,98,7421,64,38,27684,205,4528,34,33,52841,98,2893
20.897,6,27,7177,13,155,1741,267,1306,14,530,1606,3417,5871
285.272,1,4,224,4,28,95090,28,224,0,0,0,0,0
0.003,17,8,2454,8,278,0,317,2454,0,0,0,0,0
280.299,6,30,7432,13,158,23358,267,1317,17,543,17514,1300,6115
12.705,6,28,7217,13,155,1058,267,1306,15,482,906,1997,5911
1790.919,6,362,24774,211,94,8528,469,14387,151,69,11936,69,10387
119.33,17,26,3704,13,48,9943,48,988,13,180,9943,308,2716
3.429,6,10,1102,6,483,685,483,803,4,83,1140,83,299
11.284,6,14,4781,9,290,1410,517,1057,5,1152,135,1458,3724
1782.171,17,83,3480,82,14,22002,14,3444,1,8,0,8,36
1692.264,1,48,5088,48,78,36005,78,5088,0,0,0,0,0
60.855,6,36,12553,18,709,3579,1408,5198,18,427,3573,1408,7355
1796.753,17,448,39896,403,35,4469,288,25676,45,288,40018,288,14220
291.848,6,35,7077,17,262,18237,517,1680,18,744,17164,1418,5397
1.073,6,30,7560,17,306,67,1087,2826,13,601,77,1420,4734
238.605,6,13,723,5,43,59651,43,299,8,0,34044,0,424
1795.518,6,183,16138,122,75,14838,469,9489,61,69,29919,69,6649
1.094,6,12,1163,6,222,215,222,688,6,231,211,231,475
299.905,6,6,364,4,31,99968,31,222,2,31,299781,31,142
71.261,17,3,228,3,48,35630,48,228,0,0,0,0,0
1754.513,6,189,11567,94,47,18865,208,6837,95,31,18662,31,4730
758.305,6,53,4190,33,66,23697,66,2310,20,60,39898,60,1880
10.679,6,95,30681,49,588,222,1152,24343,46,449,231,1179,6338
1786.438,6,104,8376,68,65,26663,65,4930,36,59,51038,59,3446
373.861,6,25,1651,17,177,23366,177,1117,8,110,9232,110,534
1740.443,17,30,31620,30,1026,60015,1026,31620,0,0,0,0,0
280.287,6,29,7392,13,158,23357,267,1317,16,603,18681,2800,6075
1789.11,17,83,3480,82,14,22087,14,3444,1,8,0,8,36
1443.802,2,13,416,13,8,120316,8,416,0,0,0,0,0
65.716,6,40,9303,24,133,2857,159,2346,16,678,4379,1659,6957
0.113,6,43,35195,25,210,4,446,1862,18,2328,6,11360,33333
1386.053,2,12,384,12,8,126004,8,384,0,0,0,0,0
5.959,6,16,2099,8,279,826,279,1261,8,191,826,272,838
774.91,17,107,21428,75,40,10471,41,5140,32,481,24963,505,16288
0.049,6,2,111,1,0,0,0,40,1,31,0,31,71
0.019,17,2,358,1,32,0,32,60,1,270,0,270,298
70.27,6,6733,7524541,3186,346,22,348,182978,3547,2025,19,12312,7341563
12.068,17,4,3964,4,963,4022,1451,3964,0,0,0,0,0
1787.874,17,73,3060,72,14,25181,14,3024,1,8,0,8,36
4.095,17,4,240,4,32,1365,32,240,0,0,0,0,0
1092.829,17,15,5463,15,336,78059,1451,5463,0,0,0,0,0
241.726,17,9,684,9,48,30215,48,684,0,0,0,0,0
111.374,6,966,449396,500,828,223,1152,424553,466,413,238,1179,24843
280.418,6,29,7392,13,158,23368,267,1317,16,678,18690,2760,6075
1.743,17,6,1230,3,36,869,36,192,3,318,869,318,1038
300.705,6,41,8876,22,315,14319,916,2270,19,448,751,4848,6606
1744.667,2,29,928,29,8,62309,8,928,0,0,0,0,0
199.269,1,20,1680,20,56,10487,56,1680,0,0,0,0,0
96.5,6,34,7871,13,155,8041,267,1306,21,357,4822,2840,6565
1744.031,6,95,7203,63,38,28129,205,4476,32,33,56249,98,2727
2.12,6,26,6125,14,108,163,147,999,12,773,161,1608,5126
1747.555,6,94,7151,62,38,28648,205,4424,32,33,56359,98,2727
1773.185,6,180,15480,120,69,14900,69,8940,60,69,30048,69,6540
1.712,6,14,2351,8,188,244,245,700,6,703,289,1152,1651
1758.801,1,8,448,8,28,251257,28,448,0,0,0,0,0
1770.958,6,101,9278,66,64,27245,64,5544,35,58,52084,58,3734
240.244,6,55,18565,30,784,8283,1418,15682,25,196,10009,580,2883
1794.574,6,356,22520,208,69,8669,69,12460,148,69,12207,69,10060
58.48,6,50,15143,21,185,2924,438,2237,29,615,2020,1702,12906
1748.579,1,56,3136,56,28,31792,28,3136,0,0,0,0,0
0.223,17,12,1881,12,128,20,220,1881,0,0,0,0,0
1.542,6,6,372,1,0,0,0,40,5,24,173,24,332
1.154,6,24,8004,12,164,89,267,1288,12,1014,89,2816,6716
1.603,17,4,314,2,31,1588,31,118,2,70,1587,70,196
0.171,6,2,80,1,0,0,0,40,1,0,0,0,40
1797.06,1,345,28980,345,56,5224,56,28980,0,0,0,0,0
13.986,6,24,6993,13,275,1165,275,1078,11,910,893,1440,5915
280.748,6,30,7432,13,158,23395,267,1317,17,543,17542,1400,6115
1772.018,6,180,15480,120,69,14890,69,8940,60,69,30033,69,6540
22.045,17,29,8161,14,318,1693,1350,4857,15,192,1572,1350,3304
0.01,17,2,312,1,40,0,40,68,1,216,0,216,244
1756.237,1,57,4788,0,0,0,0,0,57,56,31361,56,4788
377.817,2,3,96,3,8,188908,8,96,0,0,0,0,0
2.311,17,4,580,2,40,2010,40,136,2,194,2039,194,444
1743.226,6,95,7203,63,38,28116,205,4476,32,33,56224,98,2727
8.716,6,17,2734,7,188,1452,245,660,10,554,941,1152,2074
3.863,17,2,152,2,48,3863,48,152,0,0,0,0,0
956.913,1,32,1792,32,28,30868,28,1792,0,0,0,0,0
1738.497,6,94,6803,60,31,29466,31,4081,34,31,52678,31,2722
280.224,6,31,7472,14,158,21555,267,1357,17,543,17513,1400,6115
9.083,6,71,20406,37,565,252,1152,15619,34,427,267,1152,4787
4.217,6,13,2311,8,188,602,245,700,5,1407,987,1407,1611
7.38,6,4,211,2,0,2952,0,80,2,51,1030,51,131
313.52,6,937,818567,601,1388,522,1460,793164,336,157,100,1460,25403
38.022,17,44,6468,22,48,1810,48,1672,22,190,1810,308,4796
9.58,6,44,8093,22,222,456,314,3770,22,491,443,1179,4323
33.381,6,32,5181,16,154,2214,722,1946,16,479,2214,2026,3235
808.287,6,9,1240,9,110,101035,110,1240,0,0,0,0,0
21.673,6,28,7398,9,154,2709,267,832,19,445,1197,1460,6566
1787.905,6,376,28562,219,126,8201,469,17521,157,69,11460,69,11041
1787.186,6,102,8228,68,64,26674,64,4896,34,58,54154,58,3332
12.388,6,105,34104,55,590,229,1152,27606,50,449,247,1179,6498
1786.261,6,103,8404,68,66,26660,66,4964,35,60,52534,60,3440
41.913,17,2,152,2,48,41913,48,152,0,0,0,0,0
5.65,17,24,6770,10,230,627,1350,2585,14,270,291,1350,4185
0.229,17,2,144,1,36,0,36,64,1,52,0,52,80
15.155,6,5,752,3,46,7577,46,166,2,506,14963,506,586
23.236,6,7,400,2,0,23236,0,100,5,0,3867,0,300
7.716,17,6,528,3,48,3851,48,228,3,72,3852,72,300
1621.244,17,18,1494,9,31,202651,37,536,9,78,202650,136,958
1799.881,6,141,9244,76,54,23998,208,5528,65,31,28117,31,3716
0.035,6,10,1863,5,105,8,105,325,5,1326,8,1326,1538
1799.284,17,764,46132,764,32,2358,37,46132,0,0,0,0,0
252.308,2,2,64,2,8,252308,8,64,0,0,0,0,0
0.004,6,2,80,0,0,0,0,0,2,0,0,0,80
0.018,17,2,440,1,60,0,60,88,1,324,0,324,352
0.635,6,49,20978,27,981,24,1380,15856,22,421,25,1923,5122
12.531,6,27,8258,12,339,1135,517,2003,15,781,891,1408,6255
0.017,17,3,442,2,32,0,32,120,1,294,0,294,322
1790.826,1,58,4872,58,56,31418,56,4872,0,0,0,0,0
38.173,17,40,5880,20,48,2008,48,1520,20,190,2008,308,4360
44.285,6,24,10805,6,124,1867,126,520,18,734,2597,1360,10285
12.707,6,11,464,6,0,2539,0,248,5,0,3173,0,216
61.287,6,36,15886,22,799,2918,1408,9159,14,748,4695,2439,6727
1681.317,17,14,3843,7,30,280217,30,406,7,463,280217,463,3437
0.277,6,20,3120,10,266,30,517,1594,10,493,20,828,1526
1.642,6,27,10179,16,285,109,587,1499,11,1029,147,1420,8680
0.008,17,2,467,1,43,0,43,71,1,368,0,368,396
1799.819,17,457,153536,457,307,3946,308,153536,0,0,0,0,0
76.99,6,41,11583,16,263,5132,1189,2753,25,411,2268,1420,8830
1793.461,6,247,36448,153,302,11799,302,26402,94,83,19284,83,10046
962.576,2,10,320,10,8,106952,8,320,0,0,0,0,0
1740.696,17,30,7050,30,207,60024,207,7050,0,0,0,0,0
30.652,17,4,352,2,60,30651,60,176,2,60,30651,60,176
1.166,17,4,252,3,31,582,31,177,1,47,0,47,75
1140.467,2,11,352,11,8,114046,8,352,0,0,0,0,0
0.465,17,17,10561,9,881,57,1350,8181,8,269,61,1350,2380
93.553,6,23,9237,14,183,7196,243,1143,9,1544,11669,3114,8094
3.906,6,39,12366,19,781,217,1408,10383,20,274,204,580,1983
1736.539,1,56,4704,56,56,31573,56,4704,0,0,0,0,0
0.92,6,10,1687,7,100,153,100,384,3,1179,326,1179,1303
1773.368,6,180,15480,120,69,14902,69,8940,60,69,30049,69,6540
0.774,17,4,240,2,32,773,32,120,2,32,773,32,120
243.343,6,7,404,4,31,81114,31,222,3,31,121667,31,182
0.126,17,2,366,1,36,0,36,64,1,274,0,274,302
1775.955,1,56,4704,56,56,32290,56,4704,0,0,0,0,0
118.987,6,22,4688,8,272,262,516,1140,14,298,9145,1452,3548
0.296,6,27,7296,13,155,24,267,1301,14,603,19,2036,5995
13.463,1,5,280,5,28,3365,28,280,0,0,0,0,0
1786.449,6,102,8364,68,66,26663,66,4964,34,60,54132,60,3400
280.067,6,31,7472,14,158,21543,267,1357,17,543,17499,1400,6115
0.091,17,2,152,1,48,0,48,76,1,48,0,48,76
62.374,6,27,7177,13,155,5197,267,1306,14,530,4797,3417,5871
1.1,6,55,17166,33,336,34,1360,9133,22,714,46,4080,8033
240.214,6,53,18193,28,805,8896,1418,15156,25,216,10008,580,3037
1794.046,6,365,23087,211,69,8543,69,12787,154,69,11725,69,10300
1754.304,6,152,10901,80,76,22206,208,6781,72,31,24702,31,4120
1799.235,1,58,4872,58,56,31565,56,4872,0,0,0,0,0
5.603,17,17,6786,8,499,800,1350,4220,9,257,691,1350,2566
0.071,17,2,180,1,30,0,30,58,1,94,0,94,122
303.663,6,312,267685,211,1310,1446,1360,257469,101,268,114,2667,10216
1.837,6,24,6549,13,158,152,370,1315,11,958,182,1731,5234
0.058,6,4,208,2,0,54,0,104,2,0,56,0,104
1798.147,17,440,37424,398,33,4529,288,24400,42,282,42947,288,13024
1418.611,1,64,3584,64,28,22517,28,3584,0,0,0,0,0
1773.022,6,180,15480,120,69,14899,69,8940,60,69,30042,69,6540
2.228,6,13,2311,8,188,318,245,700,5,1407,490,1407,1611
229.586,17,4,352,2,60,229584,60,176,2,60,229584,60,176
1633.017,6,93,10238,46,226,36287,517,3307,47,641,35498,1368,6931
187.035,6,31,7472,14,158,14387,267,1357,17,543,11687,1400,6115
143.599,1,4,224,4,28,47866,28,224,0,0,0,0,0
368.527,6,18,1239,14,177,28348,177,913,4,110,20057,110,326
84.295,6,30,8872,14,158,6484,267,1357,16,763,5619,2036,7515
0.485,6,55,25288,32,964,15,1380,16823,23,683,20,3303,8465
0.071,6,10,861,6,182,14,182,490,4,77,19,134,371
0.28,6,9,1002,5,213,70,213,417,4,421,81,421,585
0.231,6,12,3462,6,75,46,75,395,6,1373,46,1448,3067
3.601,6,17,7291,10,290,400,517,1109,7,1162,597,1402,6182
1797.463,6,369,25261,215,93,8399,469,14685,154,69,11747,69,10576
267.179,17,4,352,2,60,267178,60,176,2,60,267178,60,176
1788.17,6,361,22927,210,69,8555,69,12540,151,69,11920,69,10387
300.575,6,11,912,6,226,60081,226,546,5,110,75101,110,366
1776.138,17,73,3060,72,14,25016,14,3024,1,8,0,8,36
1766.179,17,51,17080,51,306,35323,308,17080,0,0,0,0,0
1786.504,6,102,8228,68,64,26664,64,4896,34,58,54133,58,3332
0.011,17,2,116,1,30,0,30,58,1,30,0,30,58
1741.35,6,91,6604,59,31,30023,31,3998,32,31,56172,31,2606
1773.857,17,326,75359,326,203,5458,422,75359,0,0,0,0,0
1795.863,1,278,15568,278,28,6483,28,15568,0,0,0,0,0
349.66,6,42,6101,23,119,15893,722,2507,19,260,19415,1408,3594
14.484,6,2281,2137717,1474,1373,9,1408,2091089,807,931,17,2816,46628
1259.972,2,8,256,8,8,179996,8,256,0,0,0,0,0
1786.198,6,102,8364,68,66,26659,66,4964,34,60,54124,60,3400
104.319,6,48,23687,27,687,679,1360,8008,21,1235,5209,4432,15679
248.557,1,4,224,4,28,82852,28,224,0,0,0,0,0
20.149,6,17,2316,10,189,2238,517,1298,7,323,3355,499,1018
0.035,17,2,207,1,37,0,37,65,1,114,0,114,142
9.165,17,8,1792,4,46,3049,46,296,4,346,3050,346,1496
1796.45,17,449,39928,404,35,4457,288,25708,45,288,40030,288,14220
782.122,2,8,256,8,8,111731,8,256,0,0,0,0,0
0.01,17,3,604,2,60,0,60,176,1,400,0,400,428
82.177,6,9,372,3,0,561,0,124,6,0,16430,0,248
6.205,6,13,2311,8,188,886,245,700,5,1407,1488,1407,1611
43.153,6,6,328,4,0,14384,0,216,2,0,42924,0,112
89.064,6,30,7432,13,158,7422,267,1317,17,543,5564,1400,6115
1681.537,1,15,870,15,30,120109,30,870,0,0,0,0,0
1769.986,6,99,9306,66,66,27230,66,5610,33,60,55309,60,3696
1799.104,6,367,25650,214,99,8446,469,15045,153,69,11835,69,10605
0.226,6,12,1846,7,139,37,139,511,5,533,55,905,1335
22.746,17,84,61925,48,994,483,1350,49091,36,328,649,1350,12834
302.332,6,58,26645,32,1203,9752,1460,20574,26,358,423,1460,6071
3.014,6,46,9110,24,321,131,1164,2966,22,404,123,4075,6144
801.91,1,8,448,8,28,114558,28,448,0,0,0,0,0
316.009,6,115,35101,60,495,5356,1360,23780,55,314,5848,4649,11321
0.035,17,4,608,2,60,12,60,176,2,188,0,188,432
1787.532,6,283,56829,138,825,13047,1402,41853,145,70,12413,639,14976
17.194,2,5,224,5,20,4298,32,224,0,0,0,0,0
0.335,17,3,1167,3,361,167,361,1167,0,0,0,0,0
1786.752,6,102,8364,68,66,26667,66,4964,34,60,54140,60,3400
10.101,6,2,1175,1,0,0,0,40,1,1095,0,1095,1135
16.491,6,21,5742,11,275,1649,275,1002,10,1440,1276,1440,4740
1.346,6,51,21753,28,993,49,1460,16057,23,433,53,1460,5696
7.086,6,1580,1481118,1013,1385,6,1408,1446970,567,931,12,2816,34148
10.764,6,19,7010,11,275,1076,275,998,8,1893,857,2840,6012
1744.588,2,27,864,27,8,67099,8,864,0,0,0,0,0
2.326,17,14,7158,7,531,387,1350,3915,7,435,186,1350,3243
1.982,17,24,9318,10,380,220,1350,4084,14,345,121,1350,5234
0.231,17,2,586,1,46,0,46,74,1,484,0,484,512
0.014,6,2,80,1,0,0,0,40,1,0,0,0,40
9.659,6,12,945,6,222,1929,222,466,6,231,1930,231,479
5.005,17,4,288,2,36,5004,36,128,2,52,4961,52,160
0.103,6,9,1346,5,145,25,145,349,4,833,29,833,997
300.328,6,42,34327,21,213,15016,517,1940,21,1955,15015,8412,32387
1.187,6,25,8056,12,164,92,267,1288,13,869,84,1448,6768
420.864,17,7,2352,7,308,70144,308,2352,0,0,0,0,0
12.118,6,25,8473,13,275,1009,275,1078,12,986,949,1440,7395
1672.161,1,8,448,8,28,238880,28,448,0,0,0,0,0
0.398,6,12,1653,6,288,72,288,548,6,426,45,434,1105
0.351,6,25,6014,12,164,31,453,1442,13,555,27,1448,4572
1794.189,17,80,3354,79,14,23002,14,3318,1,8,0,8,36
86.59,17,4,352,2,60,86589,60,176,2,60,86589,60,176
1783.371,1,186,10416,186,28,9639,28,10416,0,0,0,0,0
1786.816,6,106,8456,68,65,26668,65,4930,38,59,48288,59,3526
317.058,6,71,18739,35,354,9325,1460,9580,36,321,9054,1460,9159
1764.527,2,16,512,16,8,117635,8,512,0,0,0,0,0
4.834,6,41,7349,20,218,254,314,3423,21,440,229,1152,3926
1.35,6,48,18762,27,859,51,1360,13146,21,476,58,2715,5616
1.03,17,4,1136,2,30,1015,30,116,2,482,1017,496,1020
1764.009,1,86,7224,86,56,20753,56,7224,0,0,0,0,0
26.758,6,3785,3548601,2451,1369,10,1408,3474569,1334,931,19,2801,74032
240.18,6,53,18435,28,818,8895,1402,15378,25,218,10007,580,3057
1.409,6,48,19031,26,946,56,1460,13375,22,433,57,1460,5656
7.538,17,3,1008,3,308,3769,308,1008,0,0,0,0,0
852.063,17,16,5802,16,334,56804,1438,5802,0,0,0,0,0
0.138,17,2,456,1,60,0,60,88,1,340,0,340,368
2.165,17,4,580,2,40,2121,40,136,2,194,2120,194,444
0.261,17,3,543,2,39,256,39,134,1,381,0,381,409
0.443,6,6,324,4,0,147,0,216,2,0,239,0,108
321.936,1,5,598,5,91,80484,125,598,0,0,0,0,0
369.609,6,25,1651,17,177,23100,177,1117,8,110,9214,110,534
1792.645,6,83,4444,42,26,43722,26,2248,41,26,44815,26,2196
9.471,17,2,672,2,308,9471,308,672,0,0,0,0,0
556.08,17,8,608,8,48,79440,48,608,0,0,0,0,0
0.521,6,27,7296,13,155,43,267,1301,14,603,33,2036,5995
280.284,6,28,7352,12,158,25480,267,1277,16,603,18682,1400,6075
0.706,6,10,968,5,256,173,256,460,5,304,173,304,508
6.258,6,40,7650,20,218,329,314,3423,20,489,315,1179,4227
1.162,6,341,440379,171,258,6,517,12257,170,2525,6,22432,428122
1799.567,6,244,35804,152,302,11917,302,26032,92,83,19775,83,9772
11.017,6,18,5610,10,275,1224,275,958,8,1440,856,1440,4652
280.691,6,30,7432,13,158,23390,267,1317,17,603,17540,2076,6115
167.646,6,23,10014,12,532,59,1360,2642,11,1384,16751,3934,7372
132.981,17,3,514,3,143,66490,336,514,0,0,0,0,0
131.518,6,139,102941,83,1306,1603,1440,91868,56,679,1512,1440,11073
0.643,6,18,6377,9,141,80,275,646,9,766,52,1440,5731
0.18,17,2,260,1,61,0,61,89,1,143,0,143,171
0.13,6,18,4665,10,447,14,768,1893,8,782,17,2180,2772
292.952,1,4,224,4,28,97650,28,224,0,0,0,0,0
128.109,6,23,10242,12,433,95,990,1823,11,1138,12794,2720,8419
0.302,17,2,588,1,39,0,39,67,1,493,0,493,521
3.075,17,4,842,2,47,3059,47,150,2,318,3061,318,692
313.79,6,260,258336,106,268,2988,517,8456,154,1714,2050,5472,249880
0.637,17,4,608,2,60,309,60,176,2,188,331,188,432
173.224,6,22,10186,11,304,85,597,1385,11,1192,17303,1460,8801
0.405,6,10,1992,5,288,95,288,508,5,424,55,434,1484
1799.874,17,766,46192,766,32,2352,37,46192,0,0,0,0,0
4.441,6,68,26797,36,854,126,1380,21118,32,421,141,2760,5679
0.011,17,2,427,1,39,0,39,67,1,332,0,332,360
0.478,6,27,9091,13,266,39,705,1750,14,943,35,1438,7341
0.053,17,4,284,2,32,49,32,120,2,54,45,60,164
0.768,6,2,92,1,0,0,0,52,1,0,0,0,40
27.611,6,41,13575,19,315,1524,721,3289,22,783,1306,1414,10286
6.341,6,812,686345,462,1402,13,1448,663481,350,776,17,1448,22864
1772.457,6,180,15480,120,69,14894,69,8940,60,69,30038,69,6540
6.182,17,28,6670,11,240,618,1350,2949,17,190,198,1350,3721
0.087,17,6,462,3,33,1,33,183,3,65,0,65,279
125.229,6,33,17079,15,644,58,1460,3220,18,1093,7358,1460,13859
71.275,6,49,15046,24,1013,388,1360,9151,25,325,2962,1360,5895
0.779,6,26,5887,13,156,64,267,1462,13,650,59,1420,4425
1.749,17,52,37479,21,356,87,1350,8075,31,920,54,1350,29404
1740.553,17,29,6815,29,207,62162,207,6815,0,0,0,0,0
45.541,6,40,8375,20,311,474,618,1778,20,413,2388,1360,6597
1.695,6,26,8797,16,284,113,584,1496,10,985,169,1420,7301
12.186,6,98,28450,50,541,248,1152,22048,48,447,253,1179,6402
1772.749,6,276,33769,112,137,15969,1360,16321,164,134,10874,4080,17448
39.75,17,4,352,2,60,39749,60,176,2,60,39749,60,176
1796.139,17,447,39864,402,35,4479,288,25644,45,288,40022,288,14220
1786.349,6,363,24595,207,83,8671,965,13454,156,75,11487,485,11141
0.469,17,3,451,2,39,411,39,134,1,289,0,289,317
1787.578,6,103,8395,68,65,26680,65,4930,35,59,52572,59,3465
1795.009,17,448,39896,403,35,4465,288,25676,45,288,40021,288,14220
148.909,17,6,1236,3,48,74450,48,228,3,308,74451,308,1008
1749.854,6,95,7203,63,38,28223,205,4476,32,33,56435,98,2727
1.715,17,4,240,2,32,1714,32,120,2,32,1714,32,120
721.832,2,5,160,5,8,180458,8,160,0,0,0,0,0
0.51,17,3,234,2,39,107,39,134,1,72,0,72,100
5.539,6,39,7269,20,218,291,314,3423,19,513,293,1179,3846
1.591,6,20,3833,11,234,159,564,1504,9,463,169,1343,2329
864.714,1,8,448,8,28,123530,28,448,0,0,0,0,0
1741.208,17,29,6815,29,207,62186,207,6815,0,0,0,0,0
92.486,6,47,10070,22,238,4404,1189,3269,25,445,3852,1917,6801
1737.536,1,12,1492,12,96,157957,173,1492,0,0,0,0,0
0.007,17,2,395,1,39,0,39,67,1,300,0,300,328
1774.776,6,180,15480,120,69,14914,69,8940,60,69,30078,69,6540
10.994,6,18,5610,10,275,1221,275,958,8,1440,856,1440,4652
1789.953,6,364,24454,211,88,8523,469,13987,153,69,11776,69,10467
1797.635,17,144,11520,72,48,25318,48,5472,72,56,25318,56,6048
1071.52,17,210,15960,210,48,5126,48,15960,0,0,0,0,0
0.128,17,2,212,1,46,0,46,74,1,110,0,110,138
36.974,17,22,1936,11,48,3696,48,836,11,72,3696,72,1100
12.407,1,2,237,2,90,12407,105,237,0,0,0,0,0
1707.939,1,50,5989,50,91,34855,191,5989,0,0,0,0,0
17.334,17,31,14009,15,643,1235,1350,10072,16,218,1153,1350,3937
1.687,17,25,14683,13,840,140,1350,11296,12,254,103,1350,3387
1787.922,6,4654,4750999,1582,126,1130,336,89193,3072,1501,582,4206,4661806
280.435,6,30,7432,13,158,23369,267,1317,17,543,17522,1400,6115
0.207,6,12,3705,6,171,40,171,491,6,964,41,1448,3214
1.843,6,27,10177,16,284,122,586,1498,11,1029,165,1420,8679
1.268,6,49,21352,29,911,45,1360,15776,20,476,57,2715,5576
125.169,6,29,7459,12,155,30,267,1266,17,423,7822,3417,6193
0.321,6,27,9086,13,262,26,690,1735,14,945,24,1408,7351
1493.954,6,152,13049,101,69,14939,69,7490,51,69,29878,69,5559
280.221,6,31,7472,14,158,21555,267,1357,17,543,17511,1400,6115
1783.158,17,83,3480,82,14,22014,14,3444,1,8,0,8,36
1786.535,17,87,3648,86,14,21018,14,3612,1,8,0,8,36
772.438,17,52,4160,26,48,30897,48,1976,26,56,30897,56,2184
3.757,17,5,295,5,31,939,31,295,0,0,0,0,0
49.44,17,29,12639,15,649,3526,1350,10162,14,148,3796,1350,2477
280.261,6,29,7392,13,158,23355,267,1317,16,603,18681,2036,6075
1738.537,1,8,448,8,28,248362,28,448,0,0,0,0,0
1793.414,17,31,32736,31,1028,59780,1028,32736,0,0,0,0,0
41.409,6,54,19835,24,1052,41,1360,13616,30,263,1421,1360,6219
1796.768,17,448,39896,403,35,4469,288,25676,45,288,40021,288,14220
41.296,6,9,492,5,0,10324,0,268,4,0,13660,0,224
475.771,17,11,3756,11,313,47577,320,3756,0,0,0,0,0
0.872,6,10,1687,7,100,145,100,384,3,1179,307,1179,1303
318.017,6,72,18855,38,324,8595,1360,9330,34,388,9632,3289,9525
8.395,6,79,24381,41,550,209,1152,18704,38,461,219,1179,5677
1738.395,1,52,4368,52,56,34086,56,4368,0,0,0,0,0
11.823,6,1855,1622015,1148,1362,10,1380,1586157,707,630,16,3303,35858
39.689,17,5,380,5,48,9922,48,380,0,0,0,0,0
4.728,6,9,2155,4,188,1576,245,540,5,1407,1016,1407,1615
1797.174,6,367,25650,214,99,8437,469,15045,153,69,11821,69,10605
12.215,6,30,7466,16,380,814,885,3491,14,645,925,1767,3975
2.534,6,14,2351,8,188,362,245,700,6,703,450,1152,1651
0.016,17,4,284,2,32,12,32,120,2,54,11,60,164
241.267,6,151,124303,53,534,4639,1418,7037,98,1319,2487,1418,117266
44.35,1,16,896,16,28,2956,28,896,0,0,0,0,0
1796.383,17,122,9760,61,48,29939,48,4636,61,56,29939,56,5124
28.781,6,25,6379,11,235,2878,515,1385,14,492,2198,1452,4994
1798.666,17,448,39896,403,35,4474,288,25676,45,288,40019,288,14220
0.285,17,2,384,1,39,0,39,67,1,289,0,289,317
252.551,2,2,64,2,8,252551,8,64,0,0,0,0,0
240.218,6,54,18062,29,807,8578,1418,15237,25,189,10008,580,2825
1742.757,6,97,7338,64,38,27662,205,4528,33,33,54454,98,2810
0.017,6,12,3940,7,88,2,88,388,5,3340,4,3340,3552
1797.662,17,449,39928,404,35,4460,288,25708,45,288,40020,288,14220
69.06,6,11,1583,11,127,6906,127,1583,0,0,0,0,0
300.279,6,27,8007,15,356,21448,826,2237,12,734,2245,2899,5770
0.26,6,25,7216,12,155,23,267,1261,13,678,18,2045,5955
280.177,6,26,7272,12,158,25470,267,1277,14,775,21550,3445,5995
4.676,6,39,7269,20,218,246,314,3423,19,513,246,1179,3846
0.321,6,26,6150,13,181,26,537,1578,13,555,24,1542,4572
0.371,17,2,152,1,48,0,48,76,1,48,0,48,76
1798.707,6,436,28410,218,99,8288,469,15205,218,34,8288,64,13205
280.883,6,25,7094,11,181,28088,267,1168,14,595,21601,1400,5926
273.573,17,4,352,2,60,273572,60,176,2,60,273572,60,176
1797.429,17,343,26068,343,48,5255,48,26068,0,0,0,0,0
0.193,6,9,1002,5,213,48,213,417,4,421,51,421,585
2.886,6,13,2311,8,188,412,245,700,5,1407,658,1407,1611
1774.231,6,184,15709,120,69,14909,69,8940,64,69,28158,69,6769
1.394,6,24,8004,12,164,109,267,1288,12,1014,108,2491,6716
1739.278,6,92,6668,60,31,29479,31,4062,32,31,56105,31,2606
1791.535,17,140,11184,72,48,25232,48,5472,68,56,26739,56,5712
1789.6,17,83,3480,82,14,22093,14,3444,1,8,0,8,36
1764.135,2,15,480,15,8,126009,8,480,0,0,0,0,0
1799.945,6,356,22520,208,69,8695,69,12460,148,69,12244,69,10060
240.142,6,42,5406,21,205,12006,517,2547,21,194,12006,851,2859
17.975,6,7,308,7,0,0,0,308,0,0,0,0,0
0.03,17,2,466,1,33,0,33,61,1,377,0,377,405
5.03,17,4,288,2,36,4999,36,128,2,52,4997,52,160
1772.023,6,180,15480,120,69,14890,69,8940,60,69,30033,69,6540
1772.602,6,180,15480,120,69,14895,69,8940,60,69,30039,69,6540
1794.06,6,395,27667,225,96,8008,469,16106,170,69,10615,69,11561
367.244,6,23,1535,16,177,24482,177,1053,7,110,10353,110,482
12.576,6,26,9920,12,275,1143,275,1038,14,923,892,1420,8882
565.383,6,73,10520,30,112,19495,267,2666,43,266,13461,1460,7854
0.358,6,12,1304,6,256,70,256,756,6,304,70,304,548
1011.294,1,42,4452,42,78,24665,78,4452,0,0,0,0,0
0.22,6,24,6070,14,181,16,537,1654,10,648,23,2176,4416
4.512,6,3,132,3,0,0,0,132,0,0,0,0,0
1790.947,1,62,5208,0,0,0,0,0,62,56,29359,56,5208
0.045,17,4,350,2,34,0,34,124,2,85,2,91,226
33.492,6,30,5053,15,180,2392,722,1860,15,344,2378,2026,3193
280.476,6,29,7392,13,158,23373,267,1317,16,678,18691,3456,6075
0.056,6,17,6293,9,406,7,609,1695,8,834,5,1686,4598
1794.759,17,142,11360,71,48,25639,48,5396,71,56,25639,56,5964
5.24,6,40,7309,20,218,275,314,3423,20,513,260,1179,3886
12.557,6,17,2608,11,210,1245,210,1210,6,545,2508,904,1398
0.159,6,16,2993,9,282,19,531,1606,7,338,23,777,1387
0.533,17,3,451,2,39,119,39,134,1,289,0,289,317
1799.994,1,16,896,16,28,119999,28,896,0,0,0,0,0
9.702,6,19,3978,8,152,1386,267,782,11,550,943,1179,3196
1777.443,17,79,3312,78,14,23083,14,3276,1,8,0,8,36
1773.778,6,180,15480,120,69,14905,69,8940,60,69,30055,69,6540
3.34,6,14,1553,8,585,477,585,1005,6,212,652,212,548
63.447,6,12,724,4,106,21144,106,274,8,90,9061,90,450
1681.859,1,15,840,15,28,120132,28,840,0,0,0,0,0
1.389,6,49,19898,28,875,51,1360,14282,21,476,60,2715,5616
3.094,6,39,9469,21,118,154,351,1857,18,625,173,1360,7612
5.666,6,40,7309,20,218,298,314,3423,20,513,282,1179,3886
11.74,6,1879,1620323,1135,1372,10,1414,1586279,744,355,15,1414,34044
1789.619,6,356,22520,208,69,8645,69,12460,148,69,12173,69,10060
1790.3,17,85,3570,85,14,21313,14,3570,0,0,0,0,0
337.739,1,3,1396,3,437,168869,527,1396,0,0,0,0,0
3.213,17,4,352,4,60,1071,60,352,0,0,0,0,0
2.755,17,2,154,1,33,0,33,61,1,65,0,65,93
552.434,6,120,17536,64,304,8768,304,12492,56,83,10015,83,5044
1082.936,2,9,288,9,8,135367,8,288,0,0,0,0,0
68.645,6,671,316083,353,832,195,1152,297858,318,423,215,1179,18225
0.489,6,25,6081,13,108,40,147,959,12,773,42,1608,5122
0.808,17,4,652,2,36,794,36,128,2,234,794,234,524
1770.916,1,59,4956,59,56,30533,56,4956,0,0,0,0,0
257.46,6,28,6961,13,229,162,498,1672,15,390,18383,1420,5289
12.085,6,97,32419,49,601,251,1152,26017,48,447,250,1179,6402
1773.462,6,180,15480,120,69,14903,69,8940,60,69,30049,69,6540
280.199,6,29,7392,13,158,23349,267,1317,16,603,18678,1400,6075
1797.341,6,368,23276,212,69,8518,69,12896,156,69,11595,69,10380
0.141,1,2,112,2,28,141,28,112,0,0,0,0,0
0.237,17,3,451,2,39,27,39,134,1,289,0,289,317
1772.272,6,180,15480,120,69,14893,69,8940,60,69,30032,69,6540
0.201,6,24,7176,12,155,18,267,1261,12,678,17,2045,5915
1.23,1,10,840,10,56,136,56,840,0,0,0,0,0
1794.465,6,121,7926,71,52,25635,208,4996,50,31,36612,31,2930
0.195,17,2,180,1,30,0,30,58,1,94,0,94,122
83.978,17,4,240,2,32,83977,32,120,2,32,83977,32,120
0.126,6,10,584,5,44,31,44,312,5,0,30,0,272
13.194,6,25,9546,12,353,1198,1105,2252,13,967,1098,1420,7294
1798.941,17,354,81317,354,201,5096,422,81317,0,0,0,0,0
4.732,6,39,7285,20,218,249,314,3423,19,516,249,1179,3862
299.551,6,6,364,4,31,99850,31,222,2,31,299525,31,142
0.042,17,2,548,2,246,42,246,548,0,0,0,0,0
540.274,6,98,15396,47,308,11744,1368,7692,51,219,10804,1368,7704
10.455,6,9,527,5,43,2613,43,311,4,0,3465,0,216
14.041,6,850,737873,536,1304,25,1368,716881,314,776,44,1473,20992
1786.303,6,355,22480,207,69,8671,69,12420,148,69,12151,69,10060
148.359,17,2,642,1,300,0,300,328,1,286,0,286,314
1784.879,6,152,27063,90,362,20054,1290,19926,62,103,29258,241,7137
2.062,17,4,580,2,40,2030,40,136,2,194,1881,194,444
218.024,17,3,528,3,148,109012,352,528,0,0,0,0,0
2.059,1,2,112,2,28,2059,28,112,0,0,0,0,0
280.442,6,29,7392,14,158,21572,267,1357,15,678,20028,3456,6035
8.005,6,27,7177,13,155,667,267,1306,14,530,615,3417,5871
0.018,17,2,319,1,39,0,39,67,1,224,0,224,252
0.001,17,2,192,1,60,0,60,88,1,76,0,76,104
1793.007,17,174,11136,174,36,10364,36,11136,0,0,0,0,0
0.014,17,4,791,2,32,0,32,120,2,307,4,319,671
12.616,6,12,700,5,0,3154,0,280,7,0,1198,0,420
1771.868,6,99,9240,66,65,27259,65,5577,33,59,55368,59,3663
1792.166,1,279,15624,279,28,6446,28,15624,0,0,0,0,0
0.438,6,27,9076,13,252,36,647,1692,14,831,32,1438,7384
15.507,17,15,5160,7,356,2579,1350,2690,8,280,2211,1350,2470
0.608,6,21,7290,13,335,50,668,2026,8,1210,85,1906,5264
0.312,6,28,9079,13,244,26,618,1663,15,828,21,1402,7416
15.123,17,14,5247,6,398,3017,1350,2561,8,307,2155,1350,2686
0.178,17,4,624,2,64,177,64,184,2,192,62,192,440
1766.386,17,355,57058,355,132,4989,366,57058,0,0,0,0,0
1750.02,17,116,30123,116,231,15217,422,30123,0,0,0,0,0
1.464,6,51,21541,29,918,52,1360,15885,22,476,60,2715,5656
1799.864,1,192,10752,192,28,9423,28,10752,0,0,0,0,0
1681.92,17,14,1036,7,30,280314,30,406,7,62,280313,62,630
130.784,17,4,352,2,60,130783,60,176,2,60,130783,60,176
1009.33,17,50,2094,49,14,21027,14,2058,1,8,0,8,36
0.204,6,10,1671,6,552,40,948,1348,4,159,68,159,323
1231.358,17,14,1117,7,31,205224,37,413,7,72,205223,136,704
1786.358,6,104,8504,69,66,26269,66,5004,35,60,52537,60,3500
0.123,6,10,767,6,186,24,186,506,4,45,37,45,261
0.39,6,13,1693,7,288,64,288,588,6,426,41,434,1105
280.507,6,29,7392,13,158,23375,267,1317,16,678,18696,3456,6075
1785.76,17,86,3606,85,14,21259,14,3570,1,8,0,8,36
1.766,6,13,2311,8,188,252,245,700,5,1407,376,1407,1611
7.609,6,38,7229,20,218,400,314,3423,18,513,413,1179,3806
0.0,17,8,1670,8,180,0,219,1670,0,0,0,0,0
1788.302,1,194,10864,194,28,9265,28,10864,0,0,0,0,0
1770.619,6,99,9174,66,64,27240,64,5544,33,58,55329,58,3630
1785.901,6,181,15589,121,69,14882,69,9049,60,69,30264,69,6540
2.28,17,3,660,2,46,0,46,148,1,484,0,484,512
0.086,17,2,362,1,46,0,46,74,1,260,0,260,288
369.598,6,20,1358,15,180,26399,180,980,5,110,15175,110,378
388.818,6,17,1190,13,180,32401,180,864,4,110,20157,110,326
240.288,6,57,18766,30,747,8285,1402,15775,27,197,9241,580,2991
11.688,6,1848,1607067,1115,1386,10,1420,1573526,733,467,15,1883,33541
0.249,6,12,3702,6,170,41,170,490,6,964,45,1448,3212
1.366,6,24,5819,13,184,113,385,1446,11,785,136,1420,4373
0.0,1,1,342,1,314,0,314,342,0,0,0,0,0
0.614,6,10,924,5,283,103,283,551,5,105,104,105,373
55.063,6,28,7223,13,156,4588,267,1312,15,482,3932,1997,5911
661.789,2,8,256,8,8,94541,8,256,0,0,0,0,0
1741.483,6,87,6322,58,31,30552,31,3915,29,31,62195,31,2407
281.715,6,36,8423,17,143,17607,267,1546,19,509,15649,1400,6877
5.043,17,3,208,2,36,5003,36,128,1,52,0,52,80
6.869,17,4,240,2,32,6868,32,120,2,32,6868,32,120
639.718,6,22,2686,12,177,58156,177,2048,10,110,8728,110,638
280.114,6,27,7312,13,158,23342,267,1317,14,775,21538,4836,5995
317.758,6,66,4158,39,69,8362,69,2319,27,69,11903,69,1839
0.023,6,10,1512,5,503,5,503,771,5,473,5,473,741
1794.83,6,361,22858,210,69,8587,69,12678,151,69,11965,69,10180
539.959,1,6,336,6,28,107991,28,336,0,0,0,0,0
16.104,17,26,16367,11,481,1603,1350,5602,15,689,1123,1350,10765
54.067,6,42,10046,20,533,914,910,2991,22,385,2567,2128,7055
4.697,6,243,227994,168,991,28,1360,19647,75,3064,61,13600,208347
1.381,6,41,11390,22,547,65,1360,5854,19,433,66,1360,5536
15.115,17,13,7705,7,746,2513,1350,5420,6,352,3016,1350,2285
0.69,6,106,87160,53,131,13,232,2649,53,1716,12,6900,84511
256.157,6,23,6772,7,156,42692,267,758,16,487,17069,1997,6014
1770.049,6,100,9292,66,65,27231,65,5577,34,59,53634,59,3715
1789.327,17,138,11040,69,48,26313,48,5244,69,56,26313,56,5796
1782.131,6,383,27366,219,109,8174,469,16390,164,69,10931,69,10976
4.843,6,90,106688,62,214,79,255,5581,28,3985,179,9675,101107
1.251,6,49,18771,27,857,48,1360,13115,22,433,51,1360,5656
4.397,6,34,6185,18,206,258,314,2784,16,551,275,1179,3401
1.287,6,43,10105,23,440,58,1360,4484,20,400,58,1360,5621
10.756,6,1553,1451230,1025,1367,10,1380,1425000,528,421,20,1923,26230
287.808,1,9,504,9,28,35976,28,504,0,0,0,0,0
287.663,17,4,352,2,60,287662,60,176,2,60,287662,60,176
1588.812,1,7,392,7,28,264802,28,392,0,0,0,0,0
1799.991,17,767,46278,767,32,2349,37,46278,0,0,0,0,0
0.459,6,12,1653,6,288,84,288,548,6,426,50,434,1105
280.542,6,28,7352,12,158,25503,267,1277,16,603,18699,1400,6075
65.619,6,34,7368,16,178,4374,517,1794,18,384,1971,1408,5574
15.257,6,15,11549,3,196,5809,196,336,12,1340,1370,1360,11213
0.026,17,4,368,2,32,0,32,120,2,96,0,96,248
241.555,6,49,12917,23,484,10979,1418,5611,26,540,9661,1497,7306
6.278,6,17,2437,11,211,626,211,1038,6,545,1247,904,1399
280.197,6,28,7352,13,158,23349,267,1317,15,678,20011,3436,6035
280.444,6,28,7352,13,158,23370,267,1317,15,678,20025,3456,6035
240.206,6,52,17287,27,775,9238,1418,14600,25,172,10008,580,2687
0.125,17,2,146,1,37,0,37,65,1,53,0,53,81
300.428,6,41,26120,26,1117,12017,1440,20364,15,828,4384,1440,5756
317.051,6,71,19250,42,288,7732,1360,10402,29,511,11318,1360,8848
1788.779,6,352,22360,206,69,8725,69,12380,146,69,12335,69,9980
7.34,6,5,260,5,0,0,0,260,0,0,0,0,0
1780.044,17,294,60628,294,178,6075,422,60628,0,0,0,0,0
