flow_duration,protocol,TotPackets,TotBytes,tot_fwd_pkts,totlen_fwd_pkts,fwd_iat_mean,fwd_pkt_len_max,fwd_pkt_len_mean,tot_bwd_pkts,totlen_bwd_pkts,bwd_iat_mean,bwd_pkt_len_max,bwd_pkt_len_mean
314289.0,17,4,1400,4,1400,104763.0,350.0,350.0,0,0,0.0,0.0,0.0
120120504.0,6,15,2290,9,1204,15015063.0,188.0,133.77777777777777,6,1086,18026169.2,204.0,181.0
21210.0,6,20,7606,11,978,2121.0,310.0,88.9090909090909,9,6628,2384.375,1514.0,736.4444444444445
864031.0,6,9,1096,6,625,172806.2,287.0,104.16666666666669,3,471,294138.0,331.0,157.0
94023371.0,6,436,69386,222,54966,425445.1176470588,1514.0,247.59459459459453,214,14420,440360.1361502347,214.0,67.38317757009345
104806904.0,17,15,5130,15,5130,7486207.428571428,342.0,342.0,0,0,0.0,0.0,0.0
4407.0,17,2,614,1,72,0.0,72.0,72.0,1,542,0.0,542.0,542.0
5005298.0,17,4,695,2,168,0.0,84.0,84.0,2,527,0.0,363.0,263.5
26073.0,6,14,4740,7,653,3941.0,249.0,93.28571428571428,7,4087,4149.666666666667,1514.0,583.8571428571429
303659.0,6,2,132,1,66,0.0,66.0,66.0,1,66,0.0,66.0,66.0
0.0,17,1,72,1,72,0.0,72.0,72.0,0,0,0.0,0.0,0.0
3071.0,17,2,180,1,90,0.0,90.0,90.0,1,90,0.0,90.0,90.0
120201292.0,6,1003,240332,493,33500,244311.56910569104,214.0,67.95131845841784,510,206832,235708.25736738704,1514.0,405.5529411764706
112233133.0,6,44,2904,22,1452,5344434.904761905,66.0,66.0,22,1452,5329733.095238095,66.0,66.0
300163.0,6,6,412,4,272,100054.33333333331,74.0,68.0,2,140,0.0,74.0,70.0
433.0,17,2,267,1,83,0.0,83.0,83.0,1,184,0.0,184.0,184.0
42312.0,6,10,2032,5,524,10350.75,252.0,104.8,5,1508,10024.25,1236.0,301.6
43809.0,6,14,4740,7,653,7180.833333333333,249.0,93.28571428571428,7,4087,6164.5,1514.0,583.8571428571429
302929.0,6,6,412,4,272,100976.33333333331,74.0,68.0,2,140,0.0,74.0,70.0
304626.0,17,4,1524,4,1524,101542.0,381.0,381.0,0,0,0.0,0.0,0.0
8192.0,17,2,180,1,90,0.0,90.0,90.0,1,90,0.0,90.0,90.0
83.0,17,2,762,2,762,0.0,381.0,381.0,0,0,0.0,0.0,0.0
13599.0,6,12,1393,6,796,2586.0,271.0,132.66666666666666,6,597,2455.0,259.0,99.5
506951.00000000006,6,5,336,2,134,0.0,68.0,67.0,3,202,193233.0,70.0,67.33333333333333
41069.0,6,14,4740,7,653,6724.333333333333,249.0,93.28571428571428,7,4087,6244.333333333333,1514.0,583.8571428571429
90029095.0,17,28,13364,28,13364,3334410.925925926,501.0,477.2857142857143,0,0,0.0,0.0,0.0
1748755.0,6,22,6442,12,1529,158977.72727272726,357.0,127.41666666666669,10,4913,160018.11111111112,1510.0,491.3
118030211.0,6,30,1974,15,1026,8415322.214285715,123.0,68.4,15,948,8415322.5,123.0,63.2
100564.0,17,2,762,2,762,0.0,381.0,381.0,0,0,0.0,0.0,0.0
93144103.0,17,12,778,6,389,18600795.0,174.0,64.83333333333333,6,389,18600158.4,174.0,64.83333333333333
196968.0,17,2,180,1,90,0.0,90.0,90.0,1,90,0.0,90.0,90.0
232622.0,6,3,426,2,280,0.0,214.0,140.0,1,146,0.0,146.0,146.0
116437651.0,6,29,1930,15,948,8316975.071428572,123.0,63.2,14,982,8172059.615384615,139.0,70.14285714285714
103123208.0,17,14,864,7,432,17166837.833333332,174.0,61.71428571428572,7,432,17167694.666666668,174.0,61.71428571428572
37672.0,6,14,4740,7,653,5440.0,249.0,93.28571428571428,7,4087,6123.166666666667,1514.0,583.8571428571429
26518.0,6,14,4740,7,653,3778.3333333333335,249.0,93.28571428571428,7,4087,3966.5,1514.0,583.8571428571429
123000096.0,17,14,864,7,432,17166823.666666668,174.0,61.71428571428572,7,432,17167513.833333332,174.0,61.71428571428572
9787.0,17,2,582,1,83,0.0,83.0,83.0,1,499,0.0,499.0,499.0
313592.0,6,6,412,4,272,104530.66666666669,74.0,68.0,2,140,0.0,74.0,70.0
310232.0,17,4,1400,4,1400,103410.66666666669,350.0,350.0,0,0,0.0,0.0,0.0
36764621.0,6,5,336,2,134,0.0,68.0,67.0,3,202,16989696.5,70.0,67.33333333333333
599455.0,6,3,198,2,132,0.0,66.0,66.0,1,66,0.0,66.0,66.0
2405063.0,6,3,1604,1,753,0.0,753.0,753.0,2,851,0.0,785.0,425.5
108104323.0,17,5,955,5,955,27026080.75,191.0,191.0,0,0,0.0,0.0,0.0
118891617.0,6,34,2334,17,1209,7430726.0625,123.0,71.11764705882354,17,1125,7417169.75,123.0,66.17647058823529
113374088.0,6,32,2220,16,1149,7558272.533333333,123.0,71.8125,16,1071,7543794.2,123.0,66.9375
96053851.0,6,206,23202,103,16182,939594.2941176472,284.0,157.10679611650485,103,7020,939594.1862745098,140.0,68.15533980582525
46041.0,6,14,4740,7,653,7298.5,249.0,93.28571428571428,7,4087,4504.5,1514.0,583.8571428571429
97076935.0,6,176,19872,88,13842,1113353.471264368,284.0,157.29545454545453,88,6030,1113353.8735632184,140.0,68.52272727272727
5527.0,17,2,180,1,90,0.0,90.0,90.0,1,90,0.0,90.0,90.0
108099566.0,17,5,955,5,955,27024891.5,191.0,191.0,0,0,0.0,0.0,0.0
112535474.0,6,46,3036,23,1518,5105436.545454546,66.0,66.0,23,1518,5105437.090909091,66.0,66.0
122687945.0,6,49,3234,25,1650,5111997.708333333,66.0,66.0,24,1584,4996728.0869565215,66.0,66.0
318.0,17,2,174,1,79,0.0,79.0,79.0,1,95,0.0,95.0,95.0
302382.0,6,2,132,1,66,0.0,66.0,66.0,1,66,0.0,66.0,66.0
323203.0,17,4,1400,4,1400,107734.33333333331,350.0,350.0,0,0,0.0,0.0,0.0
143920.0,17,2,180,1,90,0.0,90.0,90.0,1,90,0.0,90.0,90.0
40823.0,6,14,4740,7,653,6301.0,249.0,93.28571428571428,7,4087,6255.666666666667,1514.0,583.8571428571429
10464308.0,6,7,478,4,272,3442536.0,74.0,68.0,3,206,5163675.5,74.0,68.66666666666667
30863.0,6,10,2032,5,524,7455.25,252.0,104.8,5,1508,7476.75,1236.0,301.6
96000693.0,17,13,1083,7,563,16000115.5,174.0,80.42857142857143,6,520,16985422.0,174.0,86.66666666666667
286.0,17,2,174,1,79,0.0,79.0,79.0,1,95,0.0,95.0,95.0
146106.0,6,3,337,2,214,0.0,160.0,107.0,1,123,0.0,123.0,123.0
304292.0,6,6,412,4,272,101430.66666666669,74.0,68.0,2,140,0.0,74.0,70.0
651622.0,6,4,508,2,238,0.0,172.0,119.0,2,270,0.0,135.0,135.0
95301283.0,17,12,778,6,389,19000154.4,174.0,64.83333333333333,6,389,19001273.2,174.0,64.83333333333333
9433.0,17,2,582,1,83,0.0,83.0,83.0,1,499,0.0,499.0,499.0
234363.0,6,3,337,2,214,0.0,160.0,107.0,1,123,0.0,123.0,123.0
1580298.0,6,20,7599,11,1469,158029.8,583.0,133.54545454545453,9,6130,162563.0,1484.0,681.1111111111111
2598331.0,6,2,132,1,66,0.0,66.0,66.0,1,66,0.0,66.0,66.0
123001488.0,17,15,907,8,475,17571641.14285714,174.0,59.375,7,432,17167485.5,174.0,61.71428571428572
328.0,17,2,156,1,78,0.0,78.0,78.0,1,78,0.0,78.0,78.0
74472.0,6,11,1131,6,600,14549.6,262.0,100.0,5,531,15153.5,259.0,106.2
95796941.0,6,28,1992,14,1029,7352394.384615385,123.0,73.5,14,963,7352379.923076923,123.0,68.78571428571429
146144.0,6,3,337,2,214,0.0,160.0,107.0,1,123,0.0,123.0,123.0
472599.0,17,2,346,1,78,0.0,78.0,78.0,1,268,0.0,268.0,268.0
112466.0,17,2,286,2,286,0.0,143.0,143.0,0,0,0.0,0.0,0.0
90533597.0,6,13,2036,8,1016,12933371.0,188.0,127.0,5,1020,22592338.25,204.0,204.0
301526.0,6,6,412,4,272,100508.66666666669,74.0,68.0,2,140,0.0,74.0,70.0
5671.0,17,2,180,1,90,0.0,90.0,90.0,1,90,0.0,90.0,90.0
41485.0,6,14,4740,7,653,5942.166666666667,249.0,93.28571428571428,7,4087,6703.666666666667,1514.0,583.8571428571429
204103.0,17,4,6056,4,6056,68034.33333333333,1514.0,1514.0,0,0,0.0,0.0,0.0
2403.0,17,4,344,2,150,0.0,75.0,75.0,2,194,0.0,103.0,97.0
17518.0,6,20,7606,11,978,1751.8,310.0,88.9090909090909,9,6628,1910.75,1514.0,736.4444444444445
40078.0,6,14,4740,7,653,5886.5,249.0,93.28571428571428,7,4087,6450.833333333333,1514.0,583.8571428571429
524294.0,6,4,270,2,134,0.0,68.0,67.0,2,136,0.0,70.0,68.0
52599.0,6,10,2032,5,524,12670.75,252.0,104.8,5,1508,10843.75,1236.0,301.6
177604.0,17,4,1524,4,1524,59201.333333333336,381.0,381.0,0,0,0.0,0.0,0.0
121317.0,6,3,337,2,214,0.0,160.0,107.0,1,123,0.0,123.0,123.0
88980761.0,17,14,4788,14,4788,6844673.923076923,342.0,342.0,0,0,0.0,0.0,0.0
90755680.0,6,26,2139,14,1245,6977743.076923077,256.0,88.92857142857143,12,894,8224702.0,95.0,74.5
42117.0,6,10,2032,5,524,8994.75,252.0,104.8,5,1508,10260.5,1236.0,301.6
301551.0,6,6,412,4,272,100517.0,74.0,68.0,2,140,0.0,74.0,70.0
107842592.0,6,28,1860,14,966,8278973.923076923,123.0,69.0,14,894,8278980.384615385,123.0,63.85714285714285
120197094.0,6,896,203674,455,173754,264274.0308370044,1514.0,381.8769230769231,441,29920,272686.2681818182,214.0,67.84580498866214
2436.0,17,4,344,2,150,0.0,75.0,75.0,2,194,0.0,103.0,97.0
144036.0,17,2,180,1,90,0.0,90.0,90.0,1,90,0.0,90.0,90.0
34144.0,6,14,4740,7,653,5569.333333333333,249.0,93.28571428571428,7,4087,5554.0,1514.0,583.8571428571429
14643905.0,6,20,1607,10,975,1592380.888888889,315.0,97.5,10,632,1590913.2222222222,78.0,63.2
29200.0,17,2,180,1,90,0.0,90.0,90.0,1,90,0.0,90.0,90.0
91697504.0,6,25,1924,14,1084,7050293.230769231,95.0,77.42857142857143,11,840,9092562.4,95.0,76.36363636363636
59182.0,6,14,4740,7,653,8466.833333333334,249.0,93.28571428571428,7,4087,8482.5,1514.0,583.8571428571429
14396.0,6,11,1133,6,602,2833.6,264.0,100.33333333333331,5,531,3005.75,259.0,106.2
0.0,6,1,66,1,66,0.0,66.0,66.0,0,0,0.0,0.0,0.0
284290.0,17,2,414,1,88,0.0,88.0,88.0,1,326,0.0,326.0,326.0
27255524.0,17,5,1710,5,1710,6813881.0,342.0,342.0,0,0,0.0,0.0,0.0
9284.0,17,2,498,1,80,0.0,80.0,80.0,1,418,0.0,418.0,418.0
40992.0,6,14,4740,7,653,6116.0,249.0,93.28571428571428,7,4087,6159.5,1514.0,583.8571428571429
216671.0,6,3,426,2,280,0.0,214.0,140.0,1,146,0.0,146.0,146.0
90254919.0,6,13,2036,8,1016,12893559.857142856,188.0,127.0,5,1020,22523291.25,204.0,204.0
2045.0,17,4,344,2,150,0.0,75.0,75.0,2,194,0.0,103.0,97.0
68862.0,6,14,4740,7,653,9404.333333333334,249.0,93.28571428571428,7,4087,11206.166666666666,1514.0,583.8571428571429
409.0,17,2,410,1,78,0.0,78.0,78.0,1,332,0.0,332.0,332.0
201789.0,17,2,180,1,90,0.0,90.0,90.0,1,90,0.0,90.0,90.0
48517.0,6,10,2032,5,524,11185.25,252.0,104.8,5,1508,10484.25,1236.0,301.6
203248.0,17,2,762,2,762,0.0,381.0,381.0,0,0,0.0,0.0,0.0
207322.0,6,3,426,2,280,0.0,214.0,140.0,1,146,0.0,146.0,146.0
281277.0,17,2,363,1,79,0.0,79.0,79.0,1,284,0.0,284.0,284.0
34200.0,6,14,4740,7,653,5530.5,249.0,93.28571428571428,7,4087,5327.833333333333,1514.0,583.8571428571429
147964.0,17,2,180,1,90,0.0,90.0,90.0,1,90,0.0,90.0,90.0
90256346.0,6,14,1964,8,1016,12893763.714285716,188.0,127.0,6,948,18011345.4,204.0,158.0
44339.0,6,14,4740,7,653,7041.5,249.0,93.28571428571428,7,4087,6819.166666666667,1514.0,583.8571428571429
90256406.0,6,15,2444,8,1016,12893772.285714284,188.0,127.0,7,1428,15015449.333333334,204.0,204.0
207304.0,6,3,426,2,280,0.0,214.0,140.0,1,146,0.0,146.0,146.0
237490.0,6,3,373,2,238,0.0,172.0,119.0,1,135,0.0,135.0,135.0
40820.0,6,2,132,1,66,0.0,66.0,66.0,1,66,0.0,66.0,66.0
120116412.0,6,14,2240,8,1016,17136056.85714286,188.0,127.0,6,1224,18018941.4,204.0,204.0
153498.0,17,2,180,1,90,0.0,90.0,90.0,1,90,0.0,90.0,90.0
10469000.0,6,7,478,4,272,3444081.0,74.0,68.0,3,206,5166026.5,74.0,68.66666666666667
13687456.0,6,18,1495,9,921,1672573.125,315.0,102.33333333333331,9,574,1672547.625,78.0,63.77777777777778
90027153.0,17,27,12943,27,12943,3462582.8076923075,501.0,479.3703703703704,0,0,0.0,0.0,0.0
1190671.0,6,13,3002,8,2374,170095.85714285713,1514.0,296.75,5,628,228762.0,331.0,125.6
125842425.0,6,70,14099,35,7401,2827852.6764705884,1514.0,211.45714285714288,35,6698,3694894.852941176,1514.0,191.37142857142857
51076.0,6,14,4740,7,653,8346.666666666666,249.0,93.28571428571428,7,4087,8186.833333333333,1514.0,583.8571428571429
209755.0,17,2,180,1,90,0.0,90.0,90.0,1,90,0.0,90.0,90.0
120055970.0,17,29,13785,29,13785,4287713.214285715,501.0,475.3448275862069,0,0,0.0,0.0,0.0
159586.0,6,3,337,2,214,0.0,160.0,107.0,1,123,0.0,123.0,123.0
18091.0,6,14,4740,7,653,2731.0,249.0,93.28571428571428,7,4087,2881.833333333333,1514.0,583.8571428571429
90253287.0,6,14,1964,8,1016,12893326.714285716,188.0,127.0,6,948,18017986.0,204.0,158.0
104270.0,17,2,286,2,286,0.0,143.0,143.0,0,0,0.0,0.0,0.0
316.0,17,2,174,1,79,0.0,79.0,79.0,1,95,0.0,95.0,95.0
2577561.0,6,3,204,2,136,0.0,70.0,68.0,1,68,0.0,68.0,68.0
32501.000000000004,6,14,4740,7,653,4975.833333333333,249.0,93.28571428571428,7,4087,4585.666666666667,1514.0,583.8571428571429
49441.0,6,14,4740,7,653,8032.333333333333,249.0,93.28571428571428,7,4087,7188.166666666667,1514.0,583.8571428571429
90292650.0,6,16,1192,8,596,12892954.285714284,95.0,74.5,8,596,12897406.42857143,95.0,74.5
42862.0,6,10,2032,5,524,9611.75,252.0,104.8,5,1508,10462.25,1236.0,301.6
2601186.0,6,3,1604,1,753,0.0,753.0,753.0,2,851,0.0,785.0,425.5
48614.0,6,10,2032,5,524,11336.0,252.0,104.8,5,1508,11382.0,1236.0,301.6
15055729.0,17,6,2718,6,2718,3011145.8,453.0,453.0,0,0,0.0,0.0,0.0
50789.0,6,10,2032,5,524,6530.75,252.0,104.8,5,1508,12096.25,1236.0,301.6
146164.0,6,3,337,2,214,0.0,160.0,107.0,1,123,0.0,123.0,123.0
103318111.0,6,42,2772,21,1386,5150443.2,66.0,66.0,21,1386,5150444.2,66.0,66.0
2592891.0,6,2,132,1,66,0.0,66.0,66.0,1,66,0.0,66.0,66.0
251165.00000000003,17,4,6056,4,6056,83721.66666666666,1514.0,1514.0,0,0,0.0,0.0,0.0
21844.0,6,14,4740,7,653,2619.1666666666665,249.0,93.28571428571428,7,4087,3435.5,1514.0,583.8571428571429
27690246.0,17,5,1710,5,1710,6922561.5,342.0,342.0,0,0,0.0,0.0,0.0
4377.0,17,2,614,1,72,0.0,72.0,72.0,1,542,0.0,542.0,542.0
2592820.0,6,25,7573,14,3735,199447.6923076923,1514.0,266.7857142857143,11,3838,233937.5,1514.0,348.90909090909093
2382.0,17,4,344,2,150,0.0,75.0,75.0,2,194,0.0,103.0,97.0
108106761.0,17,5,955,5,955,27026690.25,191.0,191.0,0,0,0.0,0.0,0.0
865450.0,6,9,1196,6,725,173090.0,387.0,120.83333333333331,3,471,294985.5,331.0,157.0
155572.0,6,3,337,2,214,0.0,160.0,107.0,1,123,0.0,123.0,123.0
9257.0,6,10,2032,5,524,2086.0,252.0,104.8,5,1508,2074.5,1236.0,301.6
90096463.0,6,11,1644,4,816,30030759.666666668,204.0,204.0,7,828,15015837.166666666,188.0,118.28571428571428
183119.0,17,4,704,2,148,0.0,74.0,74.0,2,556,0.0,280.0,278.0
103211.0,17,2,286,2,286,0.0,143.0,143.0,0,0,0.0,0.0,0.0
112463864.0,6,45,2970,23,1518,5111993.818181818,66.0,66.0,22,1452,5042301.428571428,66.0,66.0
2798634.0,6,2,132,1,66,0.0,66.0,66.0,1,66,0.0,66.0,66.0
27113924.0,17,5,1710,5,1710,6778481.0,342.0,342.0,0,0,0.0,0.0,0.0
889506.0,6,5,1742,3,921,444753.0,785.0,307.0,2,821,0.0,753.0,410.5
143780.0,6,2,132,1,66,0.0,66.0,66.0,1,66,0.0,66.0,66.0
120046276.0,17,29,13785,29,13785,4287367.0,501.0,475.3448275862069,0,0,0.0,0.0,0.0
37024.0,6,14,4740,7,653,6041.5,249.0,93.28571428571428,7,4087,5702.833333333333,1514.0,583.8571428571429
60061.0,6,14,4740,7,653,9765.833333333334,249.0,93.28571428571428,7,4087,8539.5,1514.0,583.8571428571429
115382753.0,6,48,3168,24,1584,5016641.434782608,66.0,66.0,24,1584,5004659.869565218,66.0,66.0
238055.0,6,3,373,2,238,0.0,172.0,119.0,1,135,0.0,135.0,135.0
52683.0,6,13,1394,7,797,8780.5,253.0,113.85714285714286,6,597,8693.4,259.0,99.5
27220626.0,17,5,1718,4,1368,1823858.6666666667,342.0,342.0,1,350,0.0,350.0,350.0
90309105.0,6,16,1192,8,596,12894647.42857143,95.0,74.5,8,596,12900831.42857143,95.0,74.5
228332.0,17,2,180,1,90,0.0,90.0,90.0,1,90,0.0,90.0,90.0
302464.0,6,2,132,1,66,0.0,66.0,66.0,1,66,0.0,66.0,66.0
27191.0,6,14,4740,7,653,4195.333333333333,249.0,93.28571428571428,7,4087,4272.666666666667,1514.0,583.8571428571429
22869.0,6,14,4740,7,653,3465.833333333333,249.0,93.28571428571428,7,4087,3513.5,1514.0,583.8571428571429
349.0,17,2,267,1,83,0.0,83.0,83.0,1,184,0.0,184.0,184.0
16377.0,6,14,4740,7,653,2589.0,249.0,93.28571428571428,7,4087,2591.833333333333,1514.0,583.8571428571429
57817.0,6,14,4740,7,653,8835.333333333334,249.0,93.28571428571428,7,4087,7641.0,1514.0,583.8571428571429
47713719.0,6,18,1306,9,682,5937212.25,139.0,75.77777777777777,9,624,5937211.375,123.0,69.33333333333333
6429.0,17,4,823,2,163,0.0,89.0,81.5,2,660,0.0,443.0,330.0
2400.0,17,4,344,2,150,0.0,75.0,75.0,2,194,0.0,103.0,97.0
97846776.0,6,30,2122,15,1105,6973640.357142857,139.0,73.66666666666667,15,1017,6973648.785714285,123.0,67.8
35200.0,6,14,4740,7,653,5138.5,249.0,93.28571428571428,7,4087,5615.333333333333,1514.0,583.8571428571429
151857.0,17,2,414,1,88,0.0,88.0,88.0,1,326,0.0,326.0,326.0
2356.0,17,4,344,2,150,0.0,75.0,75.0,2,194,0.0,103.0,97.0
0.0,17,1,72,1,72,0.0,72.0,72.0,0,0,0.0,0.0,0.0
11649.0,6,11,2098,6,590,2241.2,252.0,98.33333333333331,5,1508,2660.75,1236.0,301.6
113168230.0,6,45,2970,23,1518,5144010.454545454,66.0,66.0,22,1452,5279953.142857143,66.0,66.0
113618065.0,6,46,3036,23,1518,5150439.181818182,66.0,66.0,23,1518,5150438.7727272725,66.0,66.0
792.0,17,4,438,2,148,0.0,74.0,74.0,2,290,0.0,147.0,145.0
97967178.0,6,30,2106,15,1089,6982225.142857143,123.0,72.6,15,1017,6982225.928571428,123.0,67.8
503041.0,6,5,336,2,134,0.0,68.0,67.0,3,202,194691.0,70.0,67.33333333333333
2360.0,17,4,344,2,150,0.0,75.0,75.0,2,194,0.0,103.0,97.0
570.0,17,2,508,2,508,0.0,257.0,254.0,0,0,0.0,0.0,0.0
1756445.0,17,6,1230,3,234,877994.5,78.0,78.0,3,996,878004.5,332.0,332.0
120370550.0,6,215,24358,108,17000,1124958.4112149533,284.0,157.40740740740742,107,7358,1125836.849056604,140.0,68.76635514018692
40587.0,6,14,4740,7,653,6639.666666666667,249.0,93.28571428571428,7,4087,5304.166666666667,1514.0,583.8571428571429
10464078.0,6,6,412,3,206,5163724.0,74.0,68.66666666666667,3,206,5163591.0,74.0,68.66666666666667
2356.0,17,4,344,2,150,0.0,75.0,75.0,2,194,0.0,103.0,97.0
2796778.0,6,2,132,1,66,0.0,66.0,66.0,1,66,0.0,66.0,66.0
240998.0,6,3,337,2,214,0.0,160.0,107.0,1,123,0.0,123.0,123.0
33780.0,6,10,2032,5,524,8207.0,252.0,104.8,5,1508,8097.75,1236.0,301.6
298218.0,6,6,412,4,272,99406.0,74.0,68.0,2,140,0.0,74.0,70.0
33648.0,6,10,2032,5,524,5937.75,252.0,104.8,5,1508,8146.75,1236.0,301.6
107832881.0,6,28,1860,14,966,8294837.0,123.0,69.0,14,894,8278211.846153846,123.0,63.85714285714285
110180160.0,17,16,1212,8,606,15714432.142857144,174.0,75.75,8,606,15715804.285714284,174.0,75.75
108098434.0,17,5,955,5,955,27024608.5,191.0,191.0,0,0,0.0,0.0,0.0
144005.0,17,2,180,1,90,0.0,90.0,90.0,1,90,0.0,90.0,90.0
10655819.0,6,7,478,4,272,3491306.333333333,74.0,68.0,3,206,5236867.5,74.0,68.66666666666667
90290950.0,6,16,1192,8,596,12892444.42857143,95.0,74.5,8,596,12897672.57142857,95.0,74.5
10454851.0,6,7,478,4,272,3439346.6666666665,74.0,68.0,3,206,5158842.5,74.0,68.66666666666667
60899.0,6,14,4740,7,653,9158.166666666666,249.0,93.28571428571428,7,4087,9348.333333333334,1514.0,583.8571428571429
102112.0,17,2,762,2,762,0.0,381.0,381.0,0,0,0.0,0.0,0.0
148096.0,17,2,180,1,90,0.0,90.0,90.0,1,90,0.0,90.0,90.0
90262109.0,6,12,1832,8,1016,12894587.0,188.0,127.0,4,816,30031773.0,204.0,204.0
15013.0,6,11,2098,6,590,2738.2,252.0,98.33333333333331,5,1508,3256.5,1236.0,301.6
39298.0,6,14,4740,7,653,5758.5,249.0,93.28571428571428,7,4087,5625.333333333333,1514.0,583.8571428571429
45037709.0,6,6,1981,4,1087,15012569.666666666,885.0,271.75,2,894,0.0,826.0,447.0
90257805.0,6,12,1832,8,1016,12893972.142857144,188.0,127.0,4,816,30030887.0,204.0,204.0
35104.0,6,14,4740,7,653,5109.333333333333,249.0,93.28571428571428,7,4087,5599.166666666667,1514.0,583.8571428571429
90034710.0,17,28,13364,28,13364,3334618.888888889,501.0,477.2857142857143,0,0,0.0,0.0,0.0
24316.0,6,14,4740,7,653,3736.0,249.0,93.28571428571428,7,4087,3731.5,1514.0,583.8571428571429
26998.0,17,2,582,1,83,0.0,83.0,83.0,1,499,0.0,499.0,499.0
9005060.0,17,4,300,4,300,3001686.6666666665,75.0,75.0,0,0,0.0,0.0,0.0
284844.0,17,2,363,1,79,0.0,79.0,79.0,1,284,0.0,284.0,284.0
90255457.0,6,15,2444,8,1016,12893636.714285716,188.0,127.0,7,1428,15014855.666666666,204.0,204.0
34321.0,6,10,2032,5,524,8354.75,252.0,104.8,5,1508,8148.0,1236.0,301.6
1261773.0,17,5,961,3,234,630706.5,78.0,78.0,2,727,0.0,395.0,363.5
314417.0,6,3,202,2,128,0.0,74.0,64.0,1,74,0.0,74.0,74.0
491.0,17,2,508,2,508,0.0,257.0,254.0,0,0,0.0,0.0,0.0
90026779.0,17,27,12943,27,12943,3462568.423076923,501.0,479.3703703703704,0,0,0.0,0.0,0.0
143829.0,17,2,180,1,90,0.0,90.0,90.0,1,90,0.0,90.0,90.0
6596.0,17,4,344,2,150,0.0,75.0,75.0,2,194,0.0,103.0,97.0
108107845.0,17,5,955,5,955,27026961.25,191.0,191.0,0,0,0.0,0.0,0.0
2474868.0,6,25,7573,14,3735,190374.4615384616,1514.0,266.7857142857143,11,3838,221917.1,1514.0,348.90909090909093
90098997.0,6,11,1644,4,816,30032521.33333333,204.0,204.0,7,828,15016158.166666666,188.0,118.28571428571428
91845431.0,6,27,1938,14,1029,7065033.153846154,123.0,73.5,13,909,7635763.833333333,123.0,69.92307692307692
36550.0,6,10,2032,5,524,8809.25,252.0,104.8,5,1508,7868.0,1236.0,301.6
2515719.0,6,53,23956,28,19959,93174.77777777778,1514.0,712.8214285714286,25,3997,96137.33333333331,1514.0,159.88
76684.0,6,14,4740,7,653,11913.166666666666,249.0,93.28571428571428,7,4087,12579.833333333334,1514.0,583.8571428571429
105967.0,17,2,286,2,286,0.0,143.0,143.0,0,0,0.0,0.0,0.0
18404.0,6,14,4740,7,653,2795.333333333333,249.0,93.28571428571428,7,4087,2929.0,1514.0,583.8571428571429
9367.0,17,2,539,1,86,0.0,86.0,86.0,1,453,0.0,453.0,453.0
90022343.0,17,28,13364,28,13364,3334160.851851852,501.0,477.2857142857143,0,0,0.0,0.0,0.0
144011.0,17,2,180,1,90,0.0,90.0,90.0,1,90,0.0,90.0,90.0
228512.0,17,2,180,1,90,0.0,90.0,90.0,1,90,0.0,90.0,90.0
808.0,17,4,438,2,148,0.0,74.0,74.0,2,290,0.0,147.0,145.0
3023243.0,6,12,2172,7,664,503817.5,252.0,94.85714285714286,5,1508,2775.25,1236.0,301.6
91755618.0,17,16,5472,16,5472,6117041.2,342.0,342.0,0,0,0.0,0.0,0.0
1321531.0,6,4,264,2,132,0.0,66.0,66.0,2,132,0.0,66.0,66.0
90254848.0,6,13,2036,8,1016,12893549.714285716,188.0,127.0,5,1020,22523286.0,204.0,204.0
137332.0,17,2,176,1,80,0.0,80.0,80.0,1,96,0.0,96.0,96.0
135131665.0,17,6,1206,6,1206,27026333.0,201.0,201.0,0,0,0.0,0.0,0.0
120213900.0,6,229,26144,113,7790,1066416.8035714286,140.0,68.93805309734513,116,18354,1039162.452173913,284.0,158.22413793103448
24185166.0,17,4,1376,3,1026,254132.0,342.0,342.0,1,350,0.0,350.0,350.0
228258.0,17,2,180,1,90,0.0,90.0,90.0,1,90,0.0,90.0,90.0
90034544.0,17,28,13364,28,13364,3334612.7407407407,501.0,477.2857142857143,0,0,0.0,0.0,0.0
111770809.0,6,29,1983,15,1089,7983629.214285715,123.0,72.6,14,894,7989657.230769231,123.0,63.85714285714285
22715.0,6,14,4740,7,653,3617.1666666666665,249.0,93.28571428571428,7,4087,3647.3333333333335,1514.0,583.8571428571429
2408.0,17,4,344,2,150,0.0,75.0,75.0,2,194,0.0,103.0,97.0
0.0,17,1,103,1,103,0.0,103.0,103.0,0,0,0.0,0.0,0.0
4384.0,17,2,626,1,72,0.0,72.0,72.0,1,554,0.0,554.0,554.0
25582.0,6,10,2032,5,524,6054.5,252.0,104.8,5,1508,5436.0,1236.0,301.6
120009182.0,6,26,2990,13,1410,9999990.75,426.0,108.46153846153848,13,1580,9999894.083333334,335.0,121.53846153846152
135129277.0,17,6,1146,6,1146,27025855.4,191.0,191.0,0,0,0.0,0.0,0.0
119789905.0,6,26,1937,14,1043,9214608.076923076,95.0,74.5,12,894,10866151.181818182,95.0,74.5
128520634.0,17,15,907,7,432,18166838.5,174.0,61.71428571428572,8,475,18288505.0,174.0,59.375
104485753.0,6,44,2904,22,1452,4975512.047619048,66.0,66.0,22,1452,4962535.857142857,66.0,66.0
107199852.0,6,28,1860,14,966,8246142.461538462,123.0,69.0,14,894,8229512.461538462,123.0,63.85714285714285
103363060.0,6,33,2428,17,1288,6446701.6875,139.0,75.76470588235294,16,1140,6876482.466666667,123.0,71.25
22851.0,6,11,1132,6,556,3449.8,218.0,92.66666666666669,5,576,5429.5,304.0,115.2
32214961.000000004,6,615,568603,175,11715,185143.4540229885,211.0,66.94285714285714,440,556888,73355.76082004556,1514.0,1265.6545454545455
839581.0,6,9,1118,6,586,167916.2,248.0,97.66666666666669,3,532,281909.0,392.0,177.33333333333334
90011373.0,17,28,13364,28,13364,3333754.5555555555,501.0,477.2857142857143,0,0,0.0,0.0,0.0
513.0,17,2,166,1,75,0.0,75.0,75.0,1,91,0.0,91.0,91.0
33627.0,6,11,2098,6,590,6725.4,252.0,98.33333333333331,5,1508,7129.25,1236.0,301.6
2370.0,17,4,344,2,150,0.0,75.0,75.0,2,194,0.0,103.0,97.0
3112321.0,6,3,1604,2,851,0.0,785.0,425.5,1,753,0.0,753.0,753.0
90015480.0,17,28,13364,28,13364,3333906.6666666665,501.0,477.2857142857143,0,0,0.0,0.0,0.0
108254977.0,6,193,21838,97,6710,1127656.0104166667,140.0,69.17525773195877,96,15128,1130073.894736842,284.0,157.58333333333334
106811.0,17,2,286,2,286,0.0,143.0,143.0,0,0,0.0,0.0,0.0
112538622.0,6,46,3036,23,1518,5105445.5,66.0,66.0,23,1518,5105574.454545454,66.0,66.0
3111569.0,6,3,204,2,136,0.0,70.0,68.0,1,68,0.0,68.0,68.0
108108470.0,17,5,955,5,955,27027117.5,191.0,191.0,0,0,0.0,0.0,0.0
219488.0,6,10,1221,6,636,43897.6,298.0,106.0,4,585,72033.66666666667,379.0,146.25
107142.0,17,2,286,2,286,0.0,143.0,143.0,0,0,0.0,0.0,0.0
6984.0,17,2,582,1,83,0.0,83.0,83.0,1,499,0.0,499.0,499.0
90037597.0,17,27,12943,27,12943,3462984.5,501.0,479.3703703703704,0,0,0.0,0.0,0.0
44898.0,6,14,4740,7,653,7372.833333333333,249.0,93.28571428571428,7,4087,5724.333333333333,1514.0,583.8571428571429
34881.0,6,14,4740,7,653,5678.5,249.0,93.28571428571428,7,4087,4986.666666666667,1514.0,583.8571428571429
47509.0,6,10,2032,5,524,9669.25,252.0,104.8,5,1508,11351.75,1236.0,301.6
302411.0,6,2,132,1,66,0.0,66.0,66.0,1,66,0.0,66.0,66.0
27499.0,6,14,4740,7,653,4244.0,249.0,93.28571428571428,7,4087,3155.5,1514.0,583.8571428571429
2375.0,17,4,344,2,150,0.0,75.0,75.0,2,194,0.0,103.0,97.0
4229.0,17,4,704,2,148,0.0,74.0,74.0,2,556,0.0,280.0,278.0
106340.0,6,11,1131,6,600,21049.2,262.0,100.0,5,531,3189.5,259.0,106.2
46801697.0,6,8,2113,3,960,22331580.0,826.0,320.0,5,1153,11003204.0,885.0,230.6
251795.0,6,3,337,2,214,0.0,160.0,107.0,1,123,0.0,123.0,123.0
196969.0,17,2,180,1,90,0.0,90.0,90.0,1,90,0.0,90.0,90.0
108103846.0,17,5,955,5,955,27025961.5,191.0,191.0,0,0,0.0,0.0,0.0
149680.0,17,2,180,1,90,0.0,90.0,90.0,1,90,0.0,90.0,90.0
517335.0,6,5,367,3,235,258667.5,103.0,78.33333333333333,2,132,0.0,66.0,66.0
1803.0,17,2,664,1,322,0.0,322.0,322.0,1,342,0.0,342.0,342.0
33486.0,6,10,2032,5,524,7823.75,252.0,104.8,5,1508,7878.25,1236.0,301.6
219220.0,6,3,426,2,280,0.0,214.0,140.0,1,146,0.0,146.0,146.0
10472130.0,6,7,478,4,272,3444957.6666666665,74.0,68.0,3,206,5167265.5,74.0,68.66666666666667
100210225.0,6,191,21726,96,6558,1054844.4736842106,140.0,68.3125,95,15168,1055171.5531914893,284.0,159.66315789473686
54952.0,6,14,4740,7,653,8989.5,249.0,93.28571428571428,7,4087,6350.833333333333,1514.0,583.8571428571429
113240618.0,6,213,24152,107,16934,1068307.716981132,284.0,158.26168224299064,106,7218,1068543.2,140.0,68.09433962264151
247866.0,6,10,1221,6,636,49573.2,298.0,106.0,4,585,77220.66666666667,379.0,146.25
113168606.0,6,46,3036,23,1518,5144015.863636363,66.0,66.0,23,1518,5144016.545454546,66.0,66.0
25973.0,6,10,2032,5,524,6263.75,252.0,104.8,5,1508,5929.5,1236.0,301.6
320599.0,17,4,1400,4,1400,106866.33333333331,350.0,350.0,0,0,0.0,0.0,0.0
34060.0,6,14,4740,7,653,5557.5,249.0,93.28571428571428,7,4087,4655.5,1514.0,583.8571428571429
121150204.0,6,216,24328,108,7350,1116097.1869158878,140.0,68.05555555555556,108,16978,1124608.5887850467,284.0,157.2037037037037
103694.0,6,11,1132,6,556,20119.0,218.0,92.66666666666669,5,576,25716.5,304.0,115.2
135141942.0,17,6,1146,6,1146,27028388.4,191.0,191.0,0,0,0.0,0.0,0.0
25491.0,6,10,2032,5,524,5330.0,252.0,104.8,5,1508,5981.25,1236.0,301.6
315212.0,17,4,1400,4,1400,105070.66666666669,350.0,350.0,0,0,0.0,0.0,0.0
90091956.0,6,11,1644,7,828,15015326.0,188.0,118.28571428571428,4,816,20017943.33333333,204.0,204.0
301195.0,6,6,412,4,272,100398.33333333331,74.0,68.0,2,140,0.0,74.0,70.0
90277639.0,6,15,2444,8,1016,12896805.57142857,188.0,127.0,7,1428,15018737.0,204.0,204.0
67130.0,6,10,2032,5,524,15489.5,252.0,104.8,5,1508,15942.25,1236.0,301.6
121332818.0,6,31,2097,16,1149,8088854.533333333,123.0,71.8125,15,948,8102058.0,123.0,63.2
111928.0,17,2,286,2,286,0.0,143.0,143.0,0,0,0.0,0.0,0.0
90037153.0,17,27,12943,27,12943,3462967.423076923,501.0,479.3703703703704,0,0,0.0,0.0,0.0
370117.0,6,11,1021,6,444,50175.6,162.0,74.0,5,577,62639.25,349.0,115.4
4345.0,17,2,762,2,762,0.0,381.0,381.0,0,0,0.0,0.0,0.0
49815.0,6,13,1479,7,882,8302.5,291.0,126.0,6,597,8610.0,259.0,99.5
108102512.0,17,5,1005,5,1005,27025628.0,201.0,201.0,0,0,0.0,0.0,0.0
296.0,17,2,156,1,78,0.0,78.0,78.0,1,78,0.0,78.0,78.0
872520.0,6,12,1354,6,723,172636.0,253.0,120.5,6,631,174340.6,293.0,105.16666666666669
119164639.0,17,34,16284,34,16284,3611049.6666666665,501.0,478.9411764705882,0,0,0.0,0.0,0.0
2799269.0,6,2,132,1,66,0.0,66.0,66.0,1,66,0.0,66.0,66.0
18384.0,6,10,2032,5,524,4384.25,252.0,104.8,5,1508,4282.25,1236.0,301.6
2618165.0,6,25,7573,14,3735,201397.3076923077,1514.0,266.7857142857143,11,3838,236056.5,1514.0,348.90909090909093
1771029.0,6,2,132,1,66,0.0,66.0,66.0,1,66,0.0,66.0,66.0
120292205.0,6,211,23892,106,16740,1145640.0476190476,284.0,157.9245283018868,105,7152,1146672.1057692308,140.0,68.11428571428571
353.0,17,2,166,1,75,0.0,75.0,75.0,1,91,0.0,91.0,91.0
103006.0,17,2,286,2,286,0.0,143.0,143.0,0,0,0.0,0.0,0.0
1311298.0,6,4,264,2,132,0.0,66.0,66.0,2,132,0.0,66.0,66.0
303121.0,6,2,132,1,66,0.0,66.0,66.0,1,66,0.0,66.0,66.0
232341.0,17,2,359,1,75,0.0,75.0,75.0,1,284,0.0,284.0,284.0
44487.0,6,14,4740,7,653,5921.833333333333,249.0,93.28571428571428,7,4087,7171.5,1514.0,583.8571428571429
146193.0,6,3,337,2,214,0.0,160.0,107.0,1,123,0.0,123.0,123.0
93901164.0,17,12,778,6,389,18601228.6,174.0,64.83333333333333,6,389,18600173.8,174.0,64.83333333333333
93043939.0,6,188,21220,94,14868,998158.247311828,284.0,158.17021276595744,94,6352,998158.376344086,140.0,67.57446808510639
143936.0,17,2,180,1,90,0.0,90.0,90.0,1,90,0.0,90.0,90.0
311017.0,17,4,1400,4,1400,103672.33333333331,350.0,350.0,0,0,0.0,0.0,0.0
122021.0,6,3,373,2,238,0.0,172.0,119.0,1,135,0.0,135.0,135.0
2821.0,17,2,224,1,76,0.0,76.0,76.0,1,148,0.0,148.0,148.0
1773786.0,6,2,132,1,66,0.0,66.0,66.0,1,66,0.0,66.0,66.0
56874.0,6,10,2032,5,524,13902.0,252.0,104.8,5,1508,13332.5,1236.0,301.6
120662593.0,6,25,1924,12,935,10969326.636363637,95.0,77.91666666666667,13,989,7534375.083333333,95.0,76.07692307692308
186904.0,17,2,180,1,90,0.0,90.0,90.0,1,90,0.0,90.0,90.0
349319.0,17,2,180,1,90,0.0,90.0,90.0,1,90,0.0,90.0,90.0
42680.0,6,12,1320,7,789,7113.333333333333,253.0,112.71428571428572,5,531,7373.0,259.0,106.2
122356010.0,6,212,23980,106,7292,1128151.380952381,140.0,68.79245283018868,106,16688,1159676.6285714286,284.0,157.43396226415095
108614.0,17,2,286,2,286,0.0,143.0,143.0,0,0,0.0,0.0,0.0
96133371.0,17,12,778,6,389,19200800.6,174.0,64.83333333333333,6,389,19200161.0,174.0,64.83333333333333
93981395.0,6,40,2640,20,1320,4946389.210526316,66.0,66.0,20,1320,4931884.105263158,66.0,66.0
62721.0,6,14,4740,7,653,9976.0,249.0,93.28571428571428,7,4087,8471.0,1514.0,583.8571428571429
307895.0,6,6,412,4,272,102631.66666666669,74.0,68.0,2,140,0.0,74.0,70.0
113383000.0,6,240,27194,120,19052,950990.1176470588,284.0,158.76666666666668,120,8142,950990.487394958,140.0,67.85
325.0,17,2,174,1,79,0.0,79.0,79.0,1,95,0.0,95.0,95.0
2636.0,17,2,762,2,762,0.0,381.0,381.0,0,0,0.0,0.0,0.0
119937276.0,17,35,16705,35,16705,3527566.9411764704,501.0,477.2857142857143,0,0,0.0,0.0,0.0
120125910.0,6,256,29256,128,8670,939493.8188976378,140.0,67.734375,128,20586,939406.2204724408,284.0,160.828125
277179.0,6,10,1221,6,636,55435.8,298.0,106.0,4,585,87016.33333333333,379.0,146.25
212988.0,6,3,426,2,280,0.0,214.0,140.0,1,146,0.0,146.0,146.0
2186053.0,6,19,6869,11,1567,218605.3,408.0,142.45454545454547,8,5302,249877.57142857145,1514.0,662.75
25468.0,6,12,1393,6,796,4822.6,271.0,132.66666666666666,6,597,4723.8,259.0,99.5
116704772.0,6,38,2710,19,1408,6471606.166666667,139.0,74.10526315789474,19,1302,6471604.388888889,123.0,68.52631578947368
10479945.0,6,7,478,4,272,3448105.333333333,74.0,68.0,3,206,5172053.0,74.0,68.66666666666667
112737171.0,6,48,3168,24,1584,4901616.130434782,66.0,66.0,24,1584,4892221.304347826,66.0,66.0
125571612.0,17,15,1169,8,606,17938801.714285713,174.0,75.75,7,563,17576918.5,174.0,80.42857142857143
113610869.0,6,46,3036,23,1518,5150441.818181818,66.0,66.0,23,1518,5150441.2727272725,66.0,66.0
9731560.0,6,5,1736,3,917,4799607.5,785.0,305.6666666666667,2,819,0.0,753.0,409.5
228351.0,17,2,180,1,90,0.0,90.0,90.0,1,90,0.0,90.0,90.0
0.0,17,1,90,1,90,0.0,90.0,90.0,0,0,0.0,0.0,0.0
46127.0,6,14,4740,7,653,7564.333333333333,249.0,93.28571428571428,7,4087,7069.5,1514.0,583.8571428571429
122001.0,6,11,1132,6,556,24004.4,218.0,92.66666666666669,5,576,29730.0,304.0,115.2
310898.0,6,3,202,2,128,0.0,74.0,64.0,1,74,0.0,74.0,74.0
121874.0,6,3,373,2,238,0.0,172.0,119.0,1,135,0.0,135.0,135.0
266180.0,6,10,1221,6,636,53236.0,298.0,106.0,4,585,82981.66666666667,379.0,146.25
37216.0,6,14,4740,7,653,5093.5,249.0,93.28571428571428,7,4087,6067.666666666667,1514.0,583.8571428571429
100306396.0,6,315,38962,158,28378,638894.2420382166,464.0,179.60759493670886,157,10584,641504.6858974359,140.0,67.4140127388535
102648378.0,17,14,864,7,432,17000408.833333332,174.0,61.71428571428572,7,432,17000145.5,174.0,61.71428571428572
108446083.0,17,14,864,7,432,18047861.5,174.0,61.71428571428572,7,432,18058110.33333333,174.0,61.71428571428572
13783.0,6,11,1131,6,600,2227.8,262.0,100.0,5,531,3152.0,259.0,106.2
990752.0,6,4,492,2,280,0.0,214.0,140.0,2,212,0.0,146.0,106.0
1302429.0,6,4,264,2,132,0.0,66.0,66.0,2,132,0.0,66.0,66.0
148043.0,6,3,373,2,238,0.0,172.0,119.0,1,135,0.0,135.0,135.0
144208.0,17,2,180,1,90,0.0,90.0,90.0,1,90,0.0,90.0,90.0
97137204.0,6,26,1746,13,906,8076711.0,123.0,69.6923076923077,13,840,8076313.916666667,123.0,64.61538461538461
216426.0,6,3,426,2,280,0.0,214.0,140.0,1,146,0.0,146.0,146.0
108682451.0,6,32,2220,16,1149,7231096.733333333,123.0,71.8125,16,1071,7231095.866666666,123.0,66.9375
281714.0,17,2,363,1,79,0.0,79.0,79.0,1,284,0.0,284.0,284.0
107696.0,17,2,286,2,286,0.0,143.0,143.0,0,0,0.0,0.0,0.0
120065591.0,17,28,13364,28,13364,4446873.740740741,501.0,477.2857142857143,0,0,0.0,0.0,0.0
799.0,17,4,438,2,148,0.0,74.0,74.0,2,290,0.0,147.0,145.0
108104033.0,17,5,1005,5,1005,27026008.25,201.0,201.0,0,0,0.0,0.0,0.0
1030363.0,6,11,1134,6,558,206072.6,220.0,93.0,5,576,256703.25,304.0,115.2
90532409.0,6,14,2240,8,1016,12933201.285714284,188.0,127.0,6,1224,18073116.6,204.0,204.0
303859.0,6,6,412,4,272,101286.33333333331,74.0,68.0,2,140,0.0,74.0,70.0
234631.0,6,3,337,2,214,0.0,160.0,107.0,1,123,0.0,123.0,123.0
22928.0,6,11,1133,6,602,3245.6,264.0,100.33333333333331,5,531,5066.0,259.0,106.2
40333.0,6,14,4740,7,653,6601.666666666667,249.0,93.28571428571428,7,4087,6561.5,1514.0,583.8571428571429
895.0,17,4,438,2,148,0.0,74.0,74.0,2,290,0.0,147.0,145.0
281672.0,17,2,363,1,79,0.0,79.0,79.0,1,284,0.0,284.0,284.0
135122859.0,17,6,1146,6,1146,27024571.8,191.0,191.0,0,0,0.0,0.0,0.0
154995.0,17,4,6056,4,6056,51665.0,1514.0,1514.0,0,0,0.0,0.0,0.0
36547.0,6,14,4740,7,653,5965.833333333333,249.0,93.28571428571428,7,4087,5767.166666666667,1514.0,583.8571428571429
135133793.0,17,6,1206,6,1206,27026758.6,201.0,201.0,0,0,0.0,0.0,0.0
97057878.0,6,194,22114,97,15564,1008765.9270833334,300.0,160.4536082474227,97,6550,1008765.6145833334,140.0,67.52577319587628
153431.0,17,2,180,1,90,0.0,90.0,90.0,1,90,0.0,90.0,90.0
1303487.0,6,4,264,2,132,0.0,66.0,66.0,2,132,0.0,66.0,66.0
78555.0,6,12,1320,7,789,13092.5,253.0,112.71428571428572,5,531,14572.75,259.0,106.2
496079.0,6,5,336,2,134,0.0,68.0,67.0,3,202,194076.0,70.0,67.33333333333333
3377355.0,6,7,923,4,753,1053764.0,571.0,188.25,3,170,1580967.5,62.0,56.66666666666666
2382.0,17,4,344,2,150,0.0,75.0,75.0,2,194,0.0,103.0,97.0
284291.0,17,2,363,1,79,0.0,79.0,79.0,1,284,0.0,284.0,284.0
149366026.0,17,36,17126,36,17126,4267600.742857143,501.0,475.72222222222223,0,0,0.0,0.0,0.0
13262.0,6,11,1132,6,556,2334.0,218.0,92.66666666666669,5,576,3043.75,304.0,115.2
310495.0,17,4,1400,4,1400,103498.33333333331,350.0,350.0,0,0,0.0,0.0,0.0
47603473.0,6,8,1940,3,887,22585735.5,753.0,295.6666666666667,5,1053,11207534.25,785.0,210.6
21041450.0,17,3,1034,2,684,0.0,342.0,342.0,1,350,0.0,350.0,350.0
135133505.0,17,6,1206,6,1206,27026701.0,201.0,201.0,0,0,0.0,0.0,0.0
34550.0,6,14,4740,7,653,5627.5,249.0,93.28571428571428,7,4087,4647.166666666667,1514.0,583.8571428571429
7002.0,17,2,582,1,83,0.0,83.0,83.0,1,499,0.0,499.0,499.0
119778146.0,6,22,1680,10,745,13308682.888888888,95.0,74.5,12,935,10865957.090909092,95.0,77.91666666666667
120200861.0,6,232,26072,116,7952,1038073.9565217393,140.0,68.55172413793103,116,18120,1038084.0434782607,284.0,156.20689655172413
15305.0,6,14,4740,7,653,2437.833333333333,249.0,93.28571428571428,7,4087,2414.0,1514.0,583.8571428571429
44195.0,6,10,2032,5,524,10804.75,252.0,104.8,5,1508,9608.75,1236.0,301.6
3010846.0,6,12,2172,7,664,501700.0,252.0,94.85714285714286,5,1508,2473.25,1236.0,301.6
23838.0,6,10,2032,5,524,5065.0,252.0,104.8,5,1508,5589.0,1236.0,301.6
209477.0,17,2,180,1,90,0.0,90.0,90.0,1,90,0.0,90.0,90.0
217814.0,6,3,426,2,280,0.0,214.0,140.0,1,146,0.0,146.0,146.0
104813790.0,6,314,40766,157,10658,670595.0769230769,140.0,67.88535031847134,157,30108,666814.0641025641,300.0,191.77070063694268
92567496.0,6,25,1692,13,906,7695973.833333333,123.0,69.6923076923077,12,786,8395617.090909092,123.0,65.5
146322.0,6,3,337,2,214,0.0,160.0,107.0,1,123,0.0,123.0,123.0
20001.0,6,10,2032,5,524,4221.0,252.0,104.8,5,1508,4756.75,1236.0,301.6
113216651.0,6,211,23840,106,7218,1078253.8190476191,140.0,68.09433962264151,105,16622,1078695.8942307692,284.0,158.3047619047619
54366.0,6,14,4740,7,653,8600.833333333334,249.0,93.28571428571428,7,4087,8490.5,1514.0,583.8571428571429
2370.0,17,4,344,2,150,0.0,75.0,75.0,2,194,0.0,103.0,97.0
51955.0,6,14,4740,7,653,8532.5,249.0,93.28571428571428,7,4087,8389.166666666666,1514.0,583.8571428571429
103020947.0,6,44,2904,22,1452,4905759.380952381,66.0,66.0,22,1452,4899047.523809524,66.0,66.0
4043.0,17,2,582,1,83,0.0,83.0,83.0,1,499,0.0,499.0,499.0
10439966.0,6,7,478,4,272,3434722.6666666665,74.0,68.0,3,206,5151924.0,74.0,68.66666666666667
20228.0,17,2,566,1,83,0.0,83.0,83.0,1,483,0.0,483.0,483.0
108107097.0,17,5,1005,5,1005,27026774.25,201.0,201.0,0,0,0.0,0.0,0.0
144914.0,17,2,180,1,70,0.0,70.0,70.0,1,110,0.0,110.0,110.0
67729618.0,6,5,334,2,132,0.0,66.0,66.0,3,202,32989035.500000004,70.0,67.33333333333333
216391.0,17,2,180,1,90,0.0,90.0,90.0,1,90,0.0,90.0,90.0
119413460.0,6,227,25722,114,7746,1056756.2831858408,140.0,67.94736842105263,113,17976,1056918.1964285714,284.0,159.0796460176991
90042370.0,17,28,13364,28,13364,3334902.592592593,501.0,477.2857142857143,0,0,0.0,0.0,0.0
106288.0,17,2,286,2,286,0.0,143.0,143.0,0,0,0.0,0.0,0.0
931046.0,6,12,2711,7,743,155174.33333333334,339.0,106.14285714285714,5,1968,163857.0,1514.0,393.6
300640.0,17,2,230,1,79,0.0,79.0,79.0,1,151,0.0,151.0,151.0
33476.0,6,14,4740,7,653,5462.166666666667,249.0,93.28571428571428,7,4087,5271.333333333333,1514.0,583.8571428571429
247385.0,6,3,337,2,214,0.0,160.0,107.0,1,123,0.0,123.0,123.0
108756.0,17,2,286,2,286,0.0,143.0,143.0,0,0,0.0,0.0,0.0
43433.0,6,10,2032,5,524,9382.75,252.0,104.8,5,1508,10581.75,1236.0,301.6
312358.0,17,4,1400,4,1400,104119.33333333331,350.0,350.0,0,0,0.0,0.0,0.0
731.0,17,4,438,2,148,0.0,74.0,74.0,2,290,0.0,147.0,145.0
197735.0,17,2,180,1,90,0.0,90.0,90.0,1,90,0.0,90.0,90.0
110200070.0,6,30,1974,15,1026,7856063.571428572,123.0,68.4,15,948,7856062.428571428,123.0,63.2
216868.0,6,3,426,2,280,0.0,214.0,140.0,1,146,0.0,146.0,146.0
14534.0,6,10,2032,5,524,3313.75,252.0,104.8,5,1508,2763.0,1236.0,301.6
118939773.0,6,34,2350,17,1225,7420225.875,139.0,72.05882352941177,17,1125,7420227.125,123.0,66.17647058823529
25826.0,6,14,4740,7,653,3873.5,249.0,93.28571428571428,7,4087,3483.1666666666665,1514.0,583.8571428571429
90253050.0,6,12,1832,8,1016,12893292.857142856,188.0,127.0,4,816,30029434.33333333,204.0,204.0
153545.0,17,2,180,1,90,0.0,90.0,90.0,1,90,0.0,90.0,90.0
108106329.0,17,5,1005,5,1005,27026582.25,201.0,201.0,0,0,0.0,0.0,0.0
103724.0,17,2,286,2,286,0.0,143.0,143.0,0,0,0.0,0.0,0.0
120347204.0,6,243,27466,122,19184,994604.9917355372,284.0,157.24590163934425,121,8282,994277.5666666668,140.0,68.44628099173553
45360.0,6,10,2032,5,524,10882.5,252.0,104.8,5,1508,10909.75,1236.0,301.6
1368669.0,6,8,602,5,404,317574.75,103.0,80.8,3,198,204268.0,66.0,66.0
30520.0,6,10,2032,5,524,7405.0,252.0,104.8,5,1508,7213.75,1236.0,301.6
2694770.0,6,20,6935,11,1567,269477.0,408.0,142.45454545454547,9,5368,273481.375,1514.0,596.4444444444445
1028105.0,6,11,1134,6,558,205621.0,220.0,93.0,5,576,256120.75,304.0,115.2
209574.0,17,2,180,1,90,0.0,90.0,90.0,1,90,0.0,90.0,90.0
33474.0,6,10,2032,5,524,7589.5,252.0,104.8,5,1508,8137.75,1236.0,301.6
380.0,17,2,508,2,508,0.0,257.0,254.0,0,0,0.0,0.0,0.0
318061.0,17,4,1400,4,1400,106020.33333333331,350.0,350.0,0,0,0.0,0.0,0.0
229054.0,6,10,1221,6,636,45810.8,298.0,106.0,4,585,72645.33333333333,379.0,146.25
245274.0,6,3,337,2,214,0.0,160.0,107.0,1,123,0.0,123.0,123.0
1583725.0,6,7,499,4,301,487936.0,103.0,75.25,3,198,716358.5,66.0,66.0
90015857.0,17,28,13364,28,13364,3333920.6296296297,501.0,477.2857142857143,0,0,0.0,0.0,0.0
308370.0,6,6,412,4,272,102790.0,74.0,68.0,2,140,0.0,74.0,70.0
234941.0,6,4,439,2,238,0.0,172.0,119.0,2,201,0.0,135.0,100.5
51518.0,6,14,4740,7,653,8247.833333333334,249.0,93.28571428571428,7,4087,7386.166666666667,1514.0,583.8571428571429
2330.0,17,4,344,2,150,0.0,75.0,75.0,2,194,0.0,103.0,97.0
120278966.0,6,220,24900,110,7482,1095937.8073394496,140.0,68.01818181818182,110,17418,1095951.4403669725,284.0,158.34545454545454
43185.0,6,14,4740,7,653,7074.166666666667,249.0,93.28571428571428,7,4087,6687.833333333333,1514.0,583.8571428571429
213848.0,17,2,180,1,90,0.0,90.0,90.0,1,90,0.0,90.0,90.0
313354.0,17,4,704,2,148,0.0,74.0,74.0,2,556,0.0,280.0,278.0
224650.0,6,13,1394,7,797,37441.66666666666,253.0,113.85714285714286,6,597,41056.8,259.0,99.5
90528677.0,6,16,2648,8,1016,12932668.142857144,188.0,127.0,8,1632,12907953.0,204.0,204.0
49926.0,6,13,1386,7,789,7733.833333333333,253.0,112.71428571428572,6,597,7725.6,259.0,99.5
464091.0,6,10,1221,6,636,92818.2,298.0,106.0,4,585,149275.66666666666,379.0,146.25
228760.0,17,2,180,1,90,0.0,90.0,90.0,1,90,0.0,90.0,90.0
51654.0,6,14,4740,7,653,7515.5,249.0,93.28571428571428,7,4087,8383.166666666666,1514.0,583.8571428571429
2121.0,17,4,344,2,150,0.0,75.0,75.0,2,194,0.0,103.0,97.0
205972.0,6,3,426,2,280,0.0,214.0,140.0,1,146,0.0,146.0,146.0
306893.0,6,6,412,4,272,102297.66666666669,74.0,68.0,2,140,0.0,74.0,70.0
179883.0,17,2,180,1,90,0.0,90.0,90.0,1,90,0.0,90.0,90.0
1202457.0,17,7,490,7,490,200409.5,70.0,70.0,0,0,0.0,0.0,0.0
146133.0,6,3,337,2,214,0.0,160.0,107.0,1,123,0.0,123.0,123.0
107790.0,17,2,286,2,286,0.0,143.0,143.0,0,0,0.0,0.0,0.0
71296.0,6,13,1386,7,789,9773.333333333334,253.0,112.71428571428572,6,597,12124.6,259.0,99.5
306826.0,6,6,412,4,272,102275.33333333331,74.0,68.0,2,140,0.0,74.0,70.0
108751159.0,6,32,2236,16,1165,7235676.0,139.0,72.8125,16,1071,7235677.533333333,123.0,66.9375
71266.0,6,10,2032,5,524,17587.25,252.0,104.8,5,1508,15220.25,1236.0,301.6
24748.0,6,14,4740,7,653,3956.5,249.0,93.28571428571428,7,4087,3989.3333333333335,1514.0,583.8571428571429
302463.0,6,2,132,1,66,0.0,66.0,66.0,1,66,0.0,66.0,66.0
309813.0,17,4,571,2,148,0.0,74.0,74.0,2,423,0.0,280.0,211.5
120370083.0,6,241,27366,121,19224,1003084.025,284.0,158.87603305785123,120,8142,994038.1092436976,140.0,67.85
42071.0,6,12,1413,6,816,7485.0,291.0,136.0,6,597,8192.0,259.0,99.5
2826.0,17,2,224,1,76,0.0,76.0,76.0,1,148,0.0,148.0,148.0
107177.0,17,2,286,2,286,0.0,143.0,143.0,0,0,0.0,0.0,0.0
35786.0,6,14,4740,7,653,5843.833333333333,249.0,93.28571428571428,7,4087,5398.833333333333,1514.0,583.8571428571429
90045539.0,17,28,13364,28,13364,3335019.962962963,501.0,477.2857142857143,0,0,0.0,0.0,0.0
205896.0,17,2,180,1,90,0.0,90.0,90.0,1,90,0.0,90.0,90.0
135129515.0,17,6,1146,6,1146,27025903.0,191.0,191.0,0,0,0.0,0.0,0.0
19874.0,6,10,2032,5,524,4747.0,252.0,104.8,5,1508,4615.0,1236.0,301.6
407.0,17,2,410,1,78,0.0,78.0,78.0,1,332,0.0,332.0,332.0
58104.0,6,14,4740,7,653,7647.666666666667,249.0,93.28571428571428,7,4087,8921.5,1514.0,583.8571428571429
92801584.0,6,191,21508,96,6558,976858.7789473684,140.0,68.3125,95,14950,977358.2765957448,284.0,157.3684210526316
100676884.0,17,14,864,7,432,16667474.0,174.0,61.71428571428572,7,432,16666807.166666666,174.0,61.71428571428572
206328.0,17,2,180,1,90,0.0,90.0,90.0,1,90,0.0,90.0,90.0
320930.0,17,4,1400,4,1400,106976.66666666669,350.0,350.0,0,0,0.0,0.0,0.0
103358.0,17,2,286,2,286,0.0,143.0,143.0,0,0,0.0,0.0,0.0
90657243.0,6,15,2302,9,1204,11316788.875,188.0,133.77777777777777,6,1098,18098693.6,204.0,183.0
233145.0,6,3,337,2,214,0.0,160.0,107.0,1,123,0.0,123.0,123.0
4777.0,17,4,625,2,163,0.0,89.0,81.5,2,462,0.0,245.0,231.0
115478188.0,6,30,2043,15,1017,8248442.0,123.0,67.8,15,1026,8232932.928571428,123.0,68.4
46791.0,6,13,1479,7,882,7395.666666666667,291.0,126.0,6,597,8104.6,259.0,99.5
55407.0,6,14,4740,7,653,8830.833333333334,249.0,93.28571428571428,7,4087,6659.833333333333,1514.0,583.8571428571429
94483.0,17,2,762,2,762,0.0,381.0,381.0,0,0,0.0,0.0,0.0
2269.0,17,2,684,1,342,0.0,342.0,342.0,1,342,0.0,342.0,342.0
2801004.0,6,2,132,1,66,0.0,66.0,66.0,1,66,0.0,66.0,66.0
43401.0,6,14,4740,7,653,7119.5,249.0,93.28571428571428,7,4087,6190.0,1514.0,583.8571428571429
120513852.0,6,273,31172,137,21900,886131.2647058824,284.0,159.85401459854015,136,9272,885067.0296296297,140.0,68.17647058823529
2628235.0,6,25,7573,14,3735,202171.92307692303,1514.0,266.7857142857143,11,3838,237508.8,1514.0,348.90909090909093
33788.0,6,14,4740,7,653,5366.833333333333,249.0,93.28571428571428,7,4087,5377.833333333333,1514.0,583.8571428571429
135131790.0,17,6,1206,6,1206,27026358.0,201.0,201.0,0,0,0.0,0.0,0.0
229682.0,6,12,1373,7,714,38280.333333333336,298.0,102.0,5,659,56515.0,379.0,131.8
53212.0,6,10,2032,5,524,13069.5,252.0,104.8,5,1508,12907.25,1236.0,301.6
325.0,17,2,267,1,83,0.0,83.0,83.0,1,184,0.0,184.0,184.0
285634.0,17,4,704,2,148,0.0,74.0,74.0,2,556,0.0,280.0,278.0
506939.0,6,5,336,2,134,0.0,68.0,67.0,3,202,197492.5,70.0,67.33333333333333
209032.0,6,3,426,2,280,0.0,214.0,140.0,1,146,0.0,146.0,146.0
75120.0,6,14,4740,7,653,12178.5,249.0,93.28571428571428,7,4087,12378.0,1514.0,583.8571428571429
23116.0,6,10,2032,5,524,5561.0,252.0,104.8,5,1508,4633.75,1236.0,301.6
306998.0,6,6,412,4,272,102332.66666666669,74.0,68.0,2,140,0.0,74.0,70.0
90496344.0,6,19,1436,10,786,10050165.444444444,95.0,78.6,9,650,11302740.0,95.0,72.22222222222223
2072.0,17,4,344,2,150,0.0,75.0,75.0,2,194,0.0,103.0,97.0
35261.0,6,14,4740,7,653,5767.0,249.0,93.28571428571428,7,4087,5581.666666666667,1514.0,583.8571428571429
26833.0,6,10,2032,5,524,6193.5,252.0,104.8,5,1508,5825.5,1236.0,301.6
1153542.0,6,13,3020,8,2392,164791.7142857143,1514.0,299.0,5,628,220247.5,331.0,125.6
217942.0,6,3,426,2,280,0.0,214.0,140.0,1,146,0.0,146.0,146.0
115592759.0,17,14,864,7,432,19166845.83333333,174.0,61.71428571428572,7,432,19167484.666666668,174.0,61.71428571428572
174457.0,17,2,414,1,88,0.0,88.0,88.0,1,326,0.0,326.0,326.0
120896594.0,6,33,2296,17,1225,7556037.125,139.0,72.05882352941177,16,1071,7380290.4,123.0,66.9375
127624334.0,17,17,1709,8,905,15428719.42857143,394.0,113.125,9,804,15876476.125,250.0,89.33333333333333
114908.0,17,2,286,2,286,0.0,143.0,143.0,0,0,0.0,0.0,0.0
122530474.0,6,49,3234,25,1650,5105436.416666667,66.0,66.0,24,1584,5039725.652173913,66.0,66.0
275621.0,17,2,238,1,74,0.0,74.0,74.0,1,164,0.0,164.0,164.0
24563.0,6,14,4740,7,653,3943.8333333333335,249.0,93.28571428571428,7,4087,3961.0,1514.0,583.8571428571429
306883.0,6,6,412,4,272,102294.33333333331,74.0,68.0,2,140,0.0,74.0,70.0
90022538.0,17,28,13364,28,13364,3334168.074074074,501.0,477.2857142857143,0,0,0.0,0.0,0.0
31790.0,6,14,4740,7,653,5167.833333333333,249.0,93.28571428571428,7,4087,5158.333333333333,1514.0,583.8571428571429
315487.0,17,4,1400,4,1400,105162.33333333331,350.0,350.0,0,0,0.0,0.0,0.0
299.0,17,2,156,1,78,0.0,78.0,78.0,1,78,0.0,78.0,78.0
135132920.0,17,6,1146,6,1146,27026584.0,191.0,191.0,0,0,0.0,0.0,0.0
832.0,17,4,438,2,148,0.0,74.0,74.0,2,290,0.0,147.0,145.0
208963.0,6,3,426,2,280,0.0,214.0,140.0,1,146,0.0,146.0,146.0
362.0,17,2,166,1,75,0.0,75.0,75.0,1,91,0.0,91.0,91.0
128664485.0,6,36,2596,18,1248,6981136.647058823,123.0,69.33333333333333,18,1348,6981148.05882353,139.0,74.88888888888889
30319.0,6,10,2032,5,524,7352.0,252.0,104.8,5,1508,5488.25,1236.0,301.6
100191705.0,17,12,516,6,258,20001025.6,43.0,43.0,6,258,20000162.0,43.0,43.0
54353.0,6,14,4740,7,653,8936.0,249.0,93.28571428571428,7,4087,8760.333333333334,1514.0,583.8571428571429
2004.0,17,4,344,2,150,0.0,75.0,75.0,2,194,0.0,103.0,97.0
4265.0,17,2,614,1,72,0.0,72.0,72.0,1,542,0.0,542.0,542.0
22421.0,6,11,2098,6,590,2279.4,252.0,98.33333333333331,5,1508,5383.0,1236.0,301.6
48049.0,6,14,4740,7,653,7496.166666666667,249.0,93.28571428571428,7,4087,7728.666666666667,1514.0,583.8571428571429
90021628.0,17,28,13364,28,13364,3334134.3703703703,501.0,477.2857142857143,0,0,0.0,0.0,0.0
90531850.0,6,14,2102,8,1016,12933121.42857143,188.0,127.0,6,1086,18074168.6,204.0,181.0
2032.0,17,4,344,2,150,0.0,75.0,75.0,2,194,0.0,103.0,97.0
105621.0,17,2,700,2,700,0.0,350.0,350.0,0,0,0.0,0.0,0.0
147795.0,6,3,337,2,214,0.0,160.0,107.0,1,123,0.0,123.0,123.0
232439.0,6,3,337,2,214,0.0,160.0,107.0,1,123,0.0,123.0,123.0
120091928.0,6,340,40040,170,11516,710603.124260355,140.0,67.74117647058823,170,28524,709248.8698224853,554.0,167.78823529411764
436.0,17,2,267,1,83,0.0,83.0,83.0,1,184,0.0,184.0,184.0
228267.0,17,2,180,1,90,0.0,90.0,90.0,1,90,0.0,90.0,90.0
108001108.0,17,13,821,7,432,18000184.666666668,174.0,61.71428571428572,6,389,17601602.0,174.0,64.83333333333333
125010465.0,17,15,907,8,475,17858637.85714286,174.0,59.375,7,432,17475669.166666668,174.0,61.71428571428572
209002.0,6,10,1221,6,636,41800.4,298.0,106.0,4,585,68475.66666666667,379.0,146.25
34393.0,6,14,4740,7,653,5570.166666666667,249.0,93.28571428571428,7,4087,5319.166666666667,1514.0,583.8571428571429
24556.0,6,14,4740,7,653,3442.0,249.0,93.28571428571428,7,4087,3894.6666666666665,1514.0,583.8571428571429
122119.0,6,3,373,2,238,0.0,172.0,119.0,1,135,0.0,135.0,135.0
90257241.0,6,12,1832,8,1016,12893891.57142857,188.0,127.0,4,816,30030965.666666668,204.0,204.0
1302288.0,6,4,264,2,132,0.0,66.0,66.0,2,132,0.0,66.0,66.0
14678.0,6,10,2032,5,524,3460.25,252.0,104.8,5,1508,3376.0,1236.0,301.6
365045.0,6,11,1021,6,444,49252.4,162.0,74.0,5,577,61397.5,349.0,115.4
45518.0,6,10,2032,5,524,10991.0,252.0,104.8,5,1508,10443.0,1236.0,301.6
38569.0,6,14,4740,7,653,6230.666666666667,249.0,93.28571428571428,7,4087,6224.0,1514.0,583.8571428571429
1035422.0,6,11,1134,6,558,207084.4,220.0,93.0,5,576,256734.0,304.0,115.2
228482.0,17,2,180,1,90,0.0,90.0,90.0,1,90,0.0,90.0,90.0
239316.0,6,3,337,2,214,0.0,160.0,107.0,1,123,0.0,123.0,123.0
179865.0,17,2,402,1,82,0.0,82.0,82.0,1,320,0.0,320.0,320.0
65984.0,6,10,2032,5,524,15553.0,252.0,104.8,5,1508,14938.25,1236.0,301.6
108107839.0,17,5,1005,5,1005,27026959.75,201.0,201.0,0,0,0.0,0.0,0.0
2378.0,17,4,344,2,150,0.0,75.0,75.0,2,194,0.0,103.0,97.0
275618.0,6,10,1221,6,636,55123.6,298.0,106.0,4,585,90727.0,379.0,146.25
143916.0,17,2,180,1,90,0.0,90.0,90.0,1,90,0.0,90.0,90.0
30329.0,6,14,4740,7,653,4877.666666666667,249.0,93.28571428571428,7,4087,4540.5,1514.0,583.8571428571429
153481.0,17,2,180,1,90,0.0,90.0,90.0,1,90,0.0,90.0,90.0
269216.0,6,10,1221,6,636,53843.2,298.0,106.0,4,585,83924.33333333333,379.0,146.25
868643.0,6,9,1270,6,799,173728.6,461.0,133.16666666666666,3,471,296156.0,331.0,157.0
12399.0,17,4,1024,2,163,0.0,89.0,81.5,2,861,0.0,443.0,430.5
90275876.0,6,14,1043,7,542,15045979.333333334,95.0,77.42857142857143,7,501,14998421.333333334,95.0,71.57142857142857
97094911.0,6,30,2106,15,1089,6935350.785714285,123.0,72.6,15,1017,6919891.214285715,123.0,67.8
54161.0,6,14,4740,7,653,8596.166666666666,249.0,93.28571428571428,7,4087,8895.833333333334,1514.0,583.8571428571429
350.0,17,2,160,1,80,0.0,80.0,80.0,1,80,0.0,80.0,80.0
315782.0,17,4,704,2,148,0.0,74.0,74.0,2,556,0.0,280.0,278.0
40732.0,6,10,2032,5,524,9958.0,252.0,104.8,5,1508,9820.0,1236.0,301.6
153327.0,17,2,180,1,90,0.0,90.0,90.0,1,90,0.0,90.0,90.0
353.0,17,2,267,1,83,0.0,83.0,83.0,1,184,0.0,184.0,184.0
50300.0,6,14,4740,7,653,7517.833333333333,249.0,93.28571428571428,7,4087,7376.833333333333,1514.0,583.8571428571429
72192.0,6,14,4740,7,653,11390.0,249.0,93.28571428571428,7,4087,9897.833333333334,1514.0,583.8571428571429
323259.0,6,6,412,4,272,107753.0,74.0,68.0,2,140,0.0,74.0,70.0
33908.0,6,14,4740,7,653,5526.166666666667,249.0,93.28571428571428,7,4087,5519.333333333333,1514.0,583.8571428571429
120180751.0,6,237,26906,119,18822,1018480.940677966,284.0,158.16806722689077,118,8084,1021390.2393162394,140.0,68.50847457627118
108102360.0,17,5,955,5,955,27025590.0,191.0,191.0,0,0,0.0,0.0,0.0
4441.0,17,2,626,1,72,0.0,72.0,72.0,1,554,0.0,554.0,554.0
210958.0,6,10,1221,6,636,42191.6,298.0,106.0,4,585,69338.0,379.0,146.25
290528.0,6,10,1221,6,636,58105.6,298.0,106.0,4,585,95595.33333333331,379.0,146.25
2419.0,17,4,344,2,150,0.0,75.0,75.0,2,194,0.0,103.0,97.0
32684830.0,6,5,336,3,202,14952254.5,70.0,67.33333333333333,2,134,0.0,68.0,67.0
100447761.0,17,12,778,6,389,20085051.8,174.0,64.83333333333333,6,389,20057765.0,174.0,64.83333333333333
105457.0,17,2,700,2,700,0.0,350.0,350.0,0,0,0.0,0.0,0.0
2576165.0,6,2,132,1,66,0.0,66.0,66.0,1,66,0.0,66.0,66.0
107795.0,17,2,286,2,286,0.0,143.0,143.0,0,0,0.0,0.0,0.0
240126.0,6,3,337,2,214,0.0,160.0,107.0,1,123,0.0,123.0,123.0
106534.0,17,2,286,2,286,0.0,143.0,143.0,0,0,0.0,0.0,0.0
208074.0,6,3,426,2,280,0.0,214.0,140.0,1,146,0.0,146.0,146.0
120022306.0,6,253,29302,127,8604,952557.984126984,140.0,67.74803149606299,126,20698,952754.2,300.0,164.2698412698413
2798209.0,6,2,132,1,66,0.0,66.0,66.0,1,66,0.0,66.0,66.0
90725771.0,6,22,1680,12,894,8243933.727272727,95.0,74.5,10,786,10079721.666666666,95.0,78.6
90764.0,6,14,4740,7,653,14688.0,249.0,93.28571428571428,7,4087,14154.5,1514.0,583.8571428571429
111638189.0,6,210,23758,105,16532,1071373.4134615385,284.0,157.44761904761904,105,7226,1071375.8173076925,140.0,68.81904761904762
58237.0,6,14,4740,7,653,7965.5,249.0,93.28571428571428,7,4087,9274.0,1514.0,583.8571428571429
30702.0,6,14,4740,7,653,4992.333333333333,249.0,93.28571428571428,7,4087,4781.166666666667,1514.0,583.8571428571429
259589.0,6,3,337,2,214,0.0,160.0,107.0,1,123,0.0,123.0,123.0
96000825.0,17,11,735,6,389,19200165.0,174.0,64.83333333333333,5,346,18998561.5,174.0,69.2
151403.0,17,2,414,1,88,0.0,88.0,88.0,1,326,0.0,326.0,326.0
305385.0,6,6,412,4,272,101795.0,74.0,68.0,2,140,0.0,74.0,70.0
121703078.0,6,47,3102,23,1518,5155441.136363637,66.0,66.0,24,1584,5277777.173913044,66.0,66.0
9018097.0,17,4,300,4,300,3006032.333333333,75.0,75.0,0,0,0.0,0.0,0.0
100574.0,17,2,286,2,286,0.0,143.0,143.0,0,0,0.0,0.0,0.0
93509649.0,17,12,778,6,389,18600179.4,174.0,64.83333333333333,6,389,18601301.8,174.0,64.83333333333333
120115158.0,6,14,2224,9,1204,15014394.75,188.0,133.77777777777777,5,1020,22521344.0,204.0,204.0
436733.0,6,3,1604,2,851,0.0,785.0,425.5,1,753,0.0,753.0,753.0
135141784.0,17,6,1146,6,1146,27028356.8,191.0,191.0,0,0,0.0,0.0,0.0
100539.0,17,2,762,2,762,0.0,381.0,381.0,0,0,0.0,0.0,0.0
119853449.0,6,14,2102,5,1020,29962718.75,204.0,204.0,9,1082,14981486.375,188.0,120.22222222222224
309664.0,17,4,1400,4,1400,103221.33333333331,350.0,350.0,0,0,0.0,0.0,0.0
136311.0,6,3,337,2,214,0.0,160.0,107.0,1,123,0.0,123.0,123.0
2050.0,17,4,344,2,150,0.0,75.0,75.0,2,194,0.0,103.0,97.0
39150.0,6,10,2032,5,524,9523.0,252.0,104.8,5,1508,8460.25,1236.0,301.6
233068.0,6,3,337,2,214,0.0,160.0,107.0,1,123,0.0,123.0,123.0
123808041.0,6,49,3234,25,1650,5158668.375,66.0,66.0,24,1584,4986309.260869565,66.0,66.0
22688.0,6,10,2032,5,524,4219.25,252.0,104.8,5,1508,5450.5,1236.0,301.6
38790.0,6,14,4740,7,653,6068.833333333333,249.0,93.28571428571428,7,4087,6278.0,1514.0,583.8571428571429
90063859.0,17,28,13364,28,13364,3335698.4814814813,501.0,477.2857142857143,0,0,0.0,0.0,0.0
2375.0,17,4,344,2,150,0.0,75.0,75.0,2,194,0.0,103.0,97.0
108104251.0,17,5,1005,5,1005,27026062.75,201.0,201.0,0,0,0.0,0.0,0.0
120123942.0,6,15,2444,7,1428,20020657.0,204.0,204.0,8,1016,17136926.57142857,188.0,127.0
24741.0,6,10,2032,5,524,5845.25,252.0,104.8,5,1508,5585.5,1236.0,301.6
198125.0,17,2,180,1,90,0.0,90.0,90.0,1,90,0.0,90.0,90.0
120273281.0,6,208,23626,104,7160,1159649.7572815537,140.0,68.84615384615384,104,16466,1159633.932038835,284.0,158.32692307692307
1941.0,17,4,344,2,150,0.0,75.0,75.0,2,194,0.0,103.0,97.0
40337.0,6,14,4740,7,653,6219.333333333333,249.0,93.28571428571428,7,4087,5186.333333333333,1514.0,583.8571428571429
323511.0,17,4,1400,4,1400,107837.0,350.0,350.0,0,0,0.0,0.0,0.0
320311.0,6,6,412,4,272,106770.33333333331,74.0,68.0,2,140,0.0,74.0,70.0
110964144.0,6,30,1974,15,1026,7910597.571428572,123.0,68.4,15,948,7910601.357142857,123.0,63.2
312630.0,17,4,704,2,148,0.0,74.0,74.0,2,556,0.0,280.0,278.0
48746.0,6,10,2032,5,524,11722.75,252.0,104.8,5,1508,10871.0,1236.0,301.6
315431.0,17,4,1400,4,1400,105143.66666666669,350.0,350.0,0,0,0.0,0.0,0.0
326225.0,6,3,202,2,128,0.0,74.0,64.0,1,74,0.0,74.0,74.0
512368.00000000006,6,5,336,2,134,0.0,68.0,67.0,3,202,192895.5,70.0,67.33333333333333
9466.0,17,2,571,1,86,0.0,86.0,86.0,1,485,0.0,485.0,485.0
114167685.0,6,48,3168,24,1584,4963812.391304348,66.0,66.0,24,1584,4950394.826086956,66.0,66.0
90252077.0,6,13,2036,8,1016,12893153.857142856,188.0,127.0,5,1020,22522645.5,204.0,204.0
103207888.0,17,14,864,7,432,17168131.0,174.0,61.71428571428572,7,432,17166838.166666668,174.0,61.71428571428572
313376.0,17,4,1400,4,1400,104458.66666666669,350.0,350.0,0,0,0.0,0.0,0.0
1748434.0,6,2,132,1,66,0.0,66.0,66.0,1,66,0.0,66.0,66.0
108107837.0,17,5,1005,5,1005,27026959.25,201.0,201.0,0,0,0.0,0.0,0.0
153437.0,17,2,180,1,90,0.0,90.0,90.0,1,90,0.0,90.0,90.0
545.0,17,2,508,2,508,0.0,257.0,254.0,0,0,0.0,0.0,0.0
135131369.0,17,6,1146,6,1146,27026273.8,191.0,191.0,0,0,0.0,0.0,0.0
37946.0,6,10,2032,5,524,8679.75,252.0,104.8,5,1508,9230.25,1236.0,301.6
32526.0,6,14,4740,7,653,5203.833333333333,249.0,93.28571428571428,7,4087,5170.0,1514.0,583.8571428571429
107490997.0,6,849,136734,422,28222,255303.9239904988,214.0,66.87677725118483,427,108512,252270.2276995305,1514.0,254.12646370023413
0.0,17,1,72,1,72,0.0,72.0,72.0,0,0,0.0,0.0,0.0
103842.0,17,2,762,2,762,0.0,381.0,381.0,0,0,0.0,0.0,0.0
128012076.0,17,15,907,8,475,18287439.42857143,174.0,59.375,7,432,18000188.5,174.0,61.71428571428572
1315472.0,6,4,264,2,132,0.0,66.0,66.0,2,132,0.0,66.0,66.0
74419.0,6,14,4740,7,653,12100.833333333334,249.0,93.28571428571428,7,4087,12029.666666666666,1514.0,583.8571428571429
56316.0,6,14,4740,7,653,9208.0,249.0,93.28571428571428,7,4087,8871.333333333334,1514.0,583.8571428571429
2055.0,17,4,344,2,150,0.0,75.0,75.0,2,194,0.0,103.0,97.0
304140.0,17,2,363,1,79,0.0,79.0,79.0,1,284,0.0,284.0,284.0
232389.0,6,3,337,2,214,0.0,160.0,107.0,1,123,0.0,123.0,123.0
32418.000000000004,6,10,2032,5,524,7250.0,252.0,104.8,5,1508,5153.5,1236.0,301.6
1375695.0,6,4,276,2,128,0.0,74.0,64.0,2,148,0.0,74.0,74.0
39456.0,6,14,4740,7,653,6398.0,249.0,93.28571428571428,7,4087,6438.166666666667,1514.0,583.8571428571429
120207319.0,6,344,42512,172,11648,698256.8713450292,140.0,67.72093023255815,172,30864,698172.3976608188,300.0,179.4418604651163
334.0,17,2,166,1,75,0.0,75.0,75.0,1,91,0.0,91.0,91.0
27154909.0,17,5,1710,5,1710,6788727.25,342.0,342.0,0,0,0.0,0.0,0.0
103021.0,17,4,1400,4,1400,34340.333333333336,350.0,350.0,0,0,0.0,0.0,0.0
110370.0,17,2,286,2,286,0.0,143.0,143.0,0,0,0.0,0.0,0.0
44290.0,6,14,4740,7,653,7256.166666666667,249.0,93.28571428571428,7,4087,5585.333333333333,1514.0,583.8571428571429
257905.0,6,10,1221,6,636,51581.0,298.0,106.0,4,585,80192.0,379.0,146.25
108104430.0,17,5,955,5,955,27026107.5,191.0,191.0,0,0,0.0,0.0,0.0
147853.0,17,2,180,1,90,0.0,90.0,90.0,1,90,0.0,90.0,90.0
49140.0,6,14,4740,7,653,8009.5,249.0,93.28571428571428,7,4087,7883.0,1514.0,583.8571428571429
90053841.0,17,28,13364,28,13364,3335327.4444444445,501.0,477.2857142857143,0,0,0.0,0.0,0.0
228161.0,17,2,180,1,90,0.0,90.0,90.0,1,90,0.0,90.0,90.0
300196.0,17,2,246,1,76,0.0,76.0,76.0,1,170,0.0,170.0,170.0
302356.0,6,2,132,1,66,0.0,66.0,66.0,1,66,0.0,66.0,66.0
0.0,17,1,381,1,381,0.0,381.0,381.0,0,0,0.0,0.0,0.0
55859.0,6,14,4740,7,653,9127.333333333334,249.0,93.28571428571428,7,4087,7996.833333333333,1514.0,583.8571428571429
2797791.0,6,2,132,1,66,0.0,66.0,66.0,1,66,0.0,66.0,66.0
323365.0,17,4,622,4,622,107788.33333333331,163.0,155.5,0,0,0.0,0.0,0.0
153594.0,6,3,337,2,214,0.0,160.0,107.0,1,123,0.0,123.0,123.0
833.0,17,5,550,5,550,208.25,110.0,110.0,0,0,0.0,0.0,0.0
34065.0,6,14,4740,7,653,5359.5,249.0,93.28571428571428,7,4087,5448.166666666667,1514.0,583.8571428571429
109228507.0,6,29,2052,15,1089,7786618.0,123.0,72.6,14,963,8385586.615384615,123.0,68.78571428571429
323327.0,17,4,1400,4,1400,107775.66666666669,350.0,350.0,0,0,0.0,0.0,0.0
2326.0,17,4,344,2,150,0.0,75.0,75.0,2,194,0.0,103.0,97.0
206956.0,6,3,426,2,280,0.0,214.0,140.0,1,146,0.0,146.0,146.0
321306.0,17,4,1400,4,1400,107102.0,350.0,350.0,0,0,0.0,0.0,0.0
90759613.0,6,22,1680,12,894,8247171.454545454,95.0,74.5,10,786,10083694.555555556,95.0,78.6
1472313.0,17,16,1120,16,1120,98154.2,70.0,70.0,0,0,0.0,0.0,0.0
146239.0,6,3,337,2,214,0.0,160.0,107.0,1,123,0.0,123.0,123.0
120129095.0,6,15,2428,9,1204,15016136.875,188.0,133.77777777777777,6,1224,18072915.6,204.0,204.0
2022668.0,17,4,525,2,150,0.0,75.0,75.0,2,375,0.0,284.0,187.5
42255.0,6,10,2032,5,524,9841.75,252.0,104.8,5,1508,10273.25,1236.0,301.6
56601.0,6,14,4740,7,653,8693.5,249.0,93.28571428571428,7,4087,8569.166666666666,1514.0,583.8571428571429
16512.0,6,10,2032,5,524,3868.5,252.0,104.8,5,1508,3872.5,1236.0,301.6
206977.0,6,10,1221,6,636,41395.4,298.0,106.0,4,585,67699.33333333333,379.0,146.25
90259460.0,6,13,2036,8,1016,12894208.57142857,188.0,127.0,5,1020,22523423.0,204.0,204.0
31413.000000000004,6,14,4740,7,653,4589.166666666667,249.0,93.28571428571428,7,4087,4990.5,1514.0,583.8571428571429
1034182.0,6,11,1134,6,558,206836.4,220.0,93.0,5,576,256979.0,304.0,115.2
104944712.0,6,44,2904,22,1452,4997367.238095238,66.0,66.0,22,1452,4982387.761904762,66.0,66.0
5006226.0,17,4,629,2,156,0.0,78.0,78.0,2,473,0.0,268.0,236.5
99404.0,17,2,762,2,762,0.0,381.0,381.0,0,0,0.0,0.0,0.0
251185.0,6,3,337,2,214,0.0,160.0,107.0,1,123,0.0,123.0,123.0
96686710.0,6,39,2574,20,1320,5077416.842105263,66.0,66.0,19,1254,5105428.555555556,66.0,66.0
114243398.0,6,30,1974,15,1026,8144813.785714285,123.0,68.4,15,948,8144811.5,123.0,63.2
90308664.0,6,16,1192,8,596,12893924.714285716,95.0,74.5,8,596,12899990.285714284,95.0,74.5
0.0,17,1,342,1,342,0.0,342.0,342.0,0,0,0.0,0.0,0.0
49594.0,6,14,4740,7,653,7728.0,249.0,93.28571428571428,7,4087,7910.166666666667,1514.0,583.8571428571429
90290192.0,6,13,2036,8,1016,12898598.857142856,188.0,127.0,5,1020,22527799.5,204.0,204.0
196963.0,17,2,180,1,90,0.0,90.0,90.0,1,90,0.0,90.0,90.0
43417.0,6,14,4740,7,653,6988.833333333333,249.0,93.28571428571428,7,4087,6309.166666666667,1514.0,583.8571428571429
4416.0,17,2,582,1,83,0.0,83.0,83.0,1,499,0.0,499.0,499.0
2951173.0,6,12,2172,7,664,491695.1666666667,252.0,94.85714285714286,5,1508,2408.75,1236.0,301.6
103406.0,17,2,286,2,286,0.0,143.0,143.0,0,0,0.0,0.0,0.0
27098.0,6,14,4740,7,653,3793.3333333333335,249.0,93.28571428571428,7,4087,4058.5,1514.0,583.8571428571429
753.0,17,4,438,2,148,0.0,74.0,74.0,2,290,0.0,147.0,145.0
108107778.0,17,5,1005,5,1005,27026944.5,201.0,201.0,0,0,0.0,0.0,0.0
34645.0,6,10,2032,5,524,7502.0,252.0,104.8,5,1508,8357.0,1236.0,301.6
102030390.0,6,187,21170,94,6426,1097100.9677419355,140.0,68.36170212765957,93,14744,1097903.0217391304,300.0,158.53763440860214
60000578.0,17,6,258,4,172,20000192.666666668,43.0,43.0,2,86,0.0,43.0,43.0
247415.0,17,4,1400,4,1400,82471.66666666667,350.0,350.0,0,0,0.0,0.0,0.0
2674665.0,6,25,7573,14,3735,205743.4615384616,1514.0,266.7857142857143,11,3838,242603.4,1514.0,348.90909090909093
207704.0,17,2,604,1,75,0.0,75.0,75.0,1,529,0.0,529.0,529.0
15319.0,6,10,2032,5,524,3474.75,252.0,104.8,5,1508,3433.25,1236.0,301.6
102791.0,17,2,286,2,286,0.0,143.0,143.0,0,0,0.0,0.0,0.0
47007.0,6,10,2032,5,524,11509.75,252.0,104.8,5,1508,11475.25,1236.0,301.6
22117.0,6,10,2032,5,524,5039.75,252.0,104.8,5,1508,5015.5,1236.0,301.6
2983.0,17,2,762,2,762,0.0,381.0,381.0,0,0,0.0,0.0,0.0
120125149.0,6,220,24756,110,7556,1094445.7798165136,140.0,68.69090909090909,110,17200,1085147.9541284405,284.0,156.36363636363637
36962.0,6,14,4740,7,653,5109.5,249.0,93.28571428571428,7,4087,6023.5,1514.0,583.8571428571429
113504249.0,6,46,3036,23,1518,5159271.681818182,66.0,66.0,23,1518,5159272.545454546,66.0,66.0
118178708.0,6,48,3168,24,1584,5138204.695652174,66.0,66.0,24,1584,5124926.130434782,66.0,66.0
298949.0,6,6,412,4,272,99649.66666666669,74.0,68.0,2,140,0.0,74.0,70.0
120031223.0,17,29,13785,29,13785,4286829.392857143,501.0,475.3448275862069,0,0,0.0,0.0,0.0
2121657.0,6,2,132,1,66,0.0,66.0,66.0,1,66,0.0,66.0,66.0
163386.0,6,3,337,2,214,0.0,160.0,107.0,1,123,0.0,123.0,123.0
525527.0,17,6,2100,6,2100,105105.4,350.0,350.0,0,0,0.0,0.0,0.0
45129.0,17,2,180,1,90,0.0,90.0,90.0,1,90,0.0,90.0,90.0
2673823.0,6,23,7202,13,3681,222818.5833333333,1514.0,283.15384615384613,10,3521,267932.1111111111,1514.0,352.1
207300.0,6,3,426,2,280,0.0,214.0,140.0,1,146,0.0,146.0,146.0
124904193.0,17,14,864,7,432,17501165.166666668,174.0,61.71428571428572,7,432,17500170.166666668,174.0,61.71428571428572
820.0,17,4,438,2,148,0.0,74.0,74.0,2,290,0.0,147.0,145.0
108103248.0,17,5,1005,5,1005,27025812.0,201.0,201.0,0,0,0.0,0.0,0.0
496.0,17,2,508,2,508,0.0,257.0,254.0,0,0,0.0,0.0,0.0
206072.0,6,3,426,2,280,0.0,214.0,140.0,1,146,0.0,146.0,146.0
3202.0,17,4,625,2,163,0.0,89.0,81.5,2,462,0.0,245.0,231.0
2718329.0,6,25,7573,14,3735,209102.2307692308,1514.0,266.7857142857143,11,3838,245822.1,1514.0,348.90909090909093
90257513.0,6,13,2036,8,1016,12893930.42857143,188.0,127.0,5,1020,22521068.75,204.0,204.0
0.0,6,1,66,1,66,0.0,66.0,66.0,0,0,0.0,0.0,0.0
204757.0,17,2,762,2,762,0.0,381.0,381.0,0,0,0.0,0.0,0.0
95553.0,6,14,4740,7,653,15738.666666666666,249.0,93.28571428571428,7,4087,15234.333333333334,1514.0,583.8571428571429
108099565.0,17,5,955,5,955,27024891.25,191.0,191.0,0,0,0.0,0.0,0.0
2588909.0,6,2,132,1,66,0.0,66.0,66.0,1,66,0.0,66.0,66.0
0.0,17,1,381,1,381,0.0,381.0,381.0,0,0,0.0,0.0,0.0
90737877.0,6,18,1341,9,691,11342234.625,95.0,76.77777777777777,9,650,11306253.875,95.0,72.22222222222223
117830464.0,6,30,2043,15,1017,8416430.92857143,123.0,67.8,15,1026,8416428.5,123.0,68.4
106769406.0,6,28,1860,14,966,8196406.692307692,123.0,69.0,14,894,8196426.538461538,123.0,63.85714285714285
120012188.0,6,20,1893,10,704,13333312.666666666,95.0,70.4,10,1189,13333877.111111112,337.0,118.9
46540.0,6,14,4740,7,653,6667.0,249.0,93.28571428571428,7,4087,7520.0,1514.0,583.8571428571429
232129.0,6,3,337,2,214,0.0,160.0,107.0,1,123,0.0,123.0,123.0
300468.0,6,6,412,4,272,100156.0,74.0,68.0,2,140,0.0,74.0,70.0
90257386.0,6,12,1832,8,1016,12893912.285714284,188.0,127.0,4,816,30031113.666666668,204.0,204.0
86432.0,6,10,2032,5,524,20472.75,252.0,104.8,5,1508,20282.5,1236.0,301.6
305041.0,6,6,412,4,272,101680.33333333331,74.0,68.0,2,140,0.0,74.0,70.0
21891.0,17,2,582,1,83,0.0,83.0,83.0,1,499,0.0,499.0,499.0
90257257.0,6,13,2036,8,1016,12893893.857142856,188.0,127.0,5,1020,22522989.75,204.0,204.0
143931.0,17,2,180,1,90,0.0,90.0,90.0,1,90,0.0,90.0,90.0
196880.0,17,2,180,1,90,0.0,90.0,90.0,1,90,0.0,90.0,90.0
101000957.0,17,13,821,7,432,16833492.833333332,174.0,61.71428571428572,6,389,19863325.0,174.0,64.83333333333333
16793.0,17,2,602,1,72,0.0,72.0,72.0,1,530,0.0,530.0,530.0
45999.0,6,14,4740,7,653,7440.833333333333,249.0,93.28571428571428,7,4087,7468.833333333333,1514.0,583.8571428571429
108101376.0,17,5,1005,5,1005,27025344.0,201.0,201.0,0,0,0.0,0.0,0.0
35777.0,6,14,4740,7,653,5721.333333333333,249.0,93.28571428571428,7,4087,5598.166666666667,1514.0,583.8571428571429
62763.0,6,10,2032,5,524,14104.5,252.0,104.8,5,1508,15312.75,1236.0,301.6
234127.0,6,3,337,2,214,0.0,160.0,107.0,1,123,0.0,123.0,123.0
108107620.0,17,5,955,5,955,27026905.0,191.0,191.0,0,0,0.0,0.0,0.0
27167560.0,6,26,7627,14,3735,209622.6923076923,1514.0,266.7857142857143,12,3892,2451065.909090909,1514.0,324.3333333333333
113865917.0,6,48,3168,24,1584,4950509.0,66.0,66.0,24,1584,4943895.608695652,66.0,66.0
247216.0,17,2,180,1,90,0.0,90.0,90.0,1,90,0.0,90.0,90.0
206902.0,17,2,762,2,762,0.0,381.0,381.0,0,0,0.0,0.0,0.0
2310.0,17,4,344,2,150,0.0,75.0,75.0,2,194,0.0,103.0,97.0
605275.0,6,4,508,2,238,0.0,172.0,119.0,2,270,0.0,135.0,135.0
1422505.0,17,16,1120,16,1120,94833.66666666669,70.0,70.0,0,0,0.0,0.0,0.0
234944.0,6,3,373,2,238,0.0,172.0,119.0,1,135,0.0,135.0,135.0
448788.0,6,3,1777,1,826,0.0,826.0,826.0,2,951,0.0,885.0,475.5
2393801.0,6,25,7573,14,3735,184138.53846153847,1514.0,266.7857142857143,11,3838,211598.9,1514.0,348.90909090909093
0.0,6,1,66,1,66,0.0,66.0,66.0,0,0,0.0,0.0,0.0
148183.0,17,2,180,1,90,0.0,90.0,90.0,1,90,0.0,90.0,90.0
114039728.0,6,48,3168,24,1584,4958249.043478261,66.0,66.0,24,1584,4946263.826086956,66.0,66.0
101339.0,17,4,1400,4,1400,33779.666666666664,350.0,350.0,0,0,0.0,0.0,0.0
200597.0,17,4,6056,4,6056,66865.66666666667,1514.0,1514.0,0,0,0.0,0.0,0.0
135130024.0,17,6,1206,6,1206,27026004.8,201.0,201.0,0,0,0.0,0.0,0.0
55743.0,6,14,4740,7,653,9055.166666666666,249.0,93.28571428571428,7,4087,8862.5,1514.0,583.8571428571429
255140.0,6,3,337,2,214,0.0,160.0,107.0,1,123,0.0,123.0,123.0
194590.0,17,4,6056,4,6056,64863.333333333336,1514.0,1514.0,0,0,0.0,0.0,0.0
2595271.0,6,2,132,1,66,0.0,66.0,66.0,1,66,0.0,66.0,66.0
329.0,17,2,168,1,76,0.0,76.0,76.0,1,92,0.0,92.0,92.0
207329.0,6,3,426,2,280,0.0,214.0,140.0,1,146,0.0,146.0,146.0
135136032.0,17,6,1206,6,1206,27027206.4,201.0,201.0,0,0,0.0,0.0,0.0
120055614.0,17,28,13364,28,13364,4446504.222222222,501.0,477.2857142857143,0,0,0.0,0.0,0.0
285778.0,6,10,1221,6,636,57155.6,298.0,106.0,4,585,85308.0,379.0,146.25
14827.0,6,11,1133,6,602,2707.2,264.0,100.33333333333331,5,531,3080.5,259.0,106.2
115026989.0,6,48,3168,24,1584,5001173.434782608,66.0,66.0,24,1584,4989331.782608695,66.0,66.0
855196.0,6,2,132,1,66,0.0,66.0,66.0,1,66,0.0,66.0,66.0
2021283.0,17,4,525,2,150,0.0,75.0,75.0,2,375,0.0,284.0,187.5
208209.0,6,3,426,2,280,0.0,214.0,140.0,1,146,0.0,146.0,146.0
328.0,17,2,174,1,79,0.0,79.0,79.0,1,95,0.0,95.0,95.0
118014912.0,6,36,2596,18,1348,6929330.294117647,139.0,74.88888888888889,18,1248,6929329.882352941,123.0,69.33333333333333
90522122.0,6,27,1954,14,1045,6946627.538461538,139.0,74.64285714285714,13,909,7525522.416666667,123.0,69.92307692307692
3440927.0,6,5,336,2,134,0.0,68.0,67.0,3,202,1423192.5,70.0,67.33333333333333
206399.0,6,3,426,2,280,0.0,214.0,140.0,1,146,0.0,146.0,146.0
503001.00000000006,6,5,336,2,134,0.0,68.0,67.0,3,202,193548.0,70.0,67.33333333333333
12602635.0,6,6,433,4,301,4200878.333333333,103.0,75.25,2,132,0.0,66.0,66.0
90071441.0,17,28,13364,28,13364,3335979.296296296,501.0,477.2857142857143,0,0,0.0,0.0,0.0
108102790.0,17,5,1005,5,1005,27025697.5,201.0,201.0,0,0,0.0,0.0,0.0
2597180.0,6,2,132,1,66,0.0,66.0,66.0,1,66,0.0,66.0,66.0
1033255.0,6,11,1134,6,558,206651.0,220.0,93.0,5,576,257254.75,304.0,115.2
207652.0,6,3,426,2,280,0.0,214.0,140.0,1,146,0.0,146.0,146.0
90037806.0,17,27,12943,27,12943,3462992.5384615385,501.0,479.3703703703704,0,0,0.0,0.0,0.0
2389.0,17,4,344,2,150,0.0,75.0,75.0,2,194,0.0,103.0,97.0
107690256.0,6,32,2236,16,1165,7179350.4,139.0,72.8125,16,1071,7165691.466666667,123.0,66.9375
208348.0,6,10,1221,6,636,41669.6,298.0,106.0,4,585,68218.0,379.0,146.25
98661.0,17,2,762,2,762,0.0,381.0,381.0,0,0,0.0,0.0,0.0
122001147.0,17,15,907,8,475,17428735.285714287,174.0,59.375,7,432,17000852.333333332,174.0,61.71428571428572
101586.0,17,2,286,2,286,0.0,143.0,143.0,0,0,0.0,0.0,0.0
161771.0,6,11,1132,6,556,31559.2,218.0,92.66666666666669,5,576,40247.0,304.0,115.2
37633.0,6,10,2032,5,524,6001.25,252.0,104.8,5,1508,8885.0,1236.0,301.6
120034476.0,17,28,13364,28,13364,4445721.333333333,501.0,477.2857142857143,0,0,0.0,0.0,0.0
3050866.0,6,3,1777,2,951,0.0,885.0,475.5,1,826,0.0,826.0,826.0
22785.0,6,10,2032,5,524,5041.75,252.0,104.8,5,1508,5432.5,1236.0,301.6
92004437.0,17,12,778,6,389,18400887.4,174.0,64.83333333333333,6,389,18200167.8,174.0,64.83333333333333
108108524.0,17,5,1005,5,1005,27027131.0,201.0,201.0,0,0,0.0,0.0,0.0
147009.0,6,3,373,2,238,0.0,172.0,119.0,1,135,0.0,135.0,135.0
2130050.0,6,25,7610,13,2516,177504.16666666666,1034.0,193.53846153846155,12,5094,165345.72727272726,1510.0,424.5
108105692.0,17,5,955,5,955,27026423.0,191.0,191.0,0,0,0.0,0.0,0.0
143001.0,17,4,344,2,150,0.0,75.0,75.0,2,194,0.0,103.0,97.0
22717.0,6,10,2032,5,524,5436.0,252.0,104.8,5,1508,5336.75,1236.0,301.6
26293.0,17,4,823,2,163,0.0,89.0,81.5,2,660,0.0,443.0,330.0
108097766.0,17,5,955,5,955,27024441.5,191.0,191.0,0,0,0.0,0.0,0.0
1980518.0,6,24,6998,12,1981,179934.18181818182,575.0,165.08333333333334,12,5017,152294.0,1510.0,418.0833333333333
228257.0,17,2,180,1,90,0.0,90.0,90.0,1,90,0.0,90.0,90.0
90054480.0,17,28,13364,28,13364,3335351.111111111,501.0,477.2857142857143,0,0,0.0,0.0,0.0
415.0,17,2,508,2,508,0.0,257.0,254.0,0,0,0.0,0.0,0.0
233041.0,6,3,337,2,214,0.0,160.0,107.0,1,123,0.0,123.0,123.0
93057583.0,6,43,3654,24,2007,4045981.869565217,123.0,83.625,19,1647,5157875.444444444,123.0,86.6842105263158
1754642.0,6,2,132,1,66,0.0,66.0,66.0,1,66,0.0,66.0,66.0
25547.0,6,2,145,2,145,0.0,91.0,72.5,0,0,0.0,0.0,0.0
207052.0,6,3,426,2,280,0.0,214.0,140.0,1,146,0.0,146.0,146.0
90021318.0,17,28,13364,28,13364,3334122.888888889,501.0,477.2857142857143,0,0,0.0,0.0,0.0
937635.0,17,10,3736,10,3736,104181.66666666669,390.0,373.6,0,0,0.0,0.0,0.0
148629.0,17,2,414,1,88,0.0,88.0,88.0,1,326,0.0,326.0,326.0
108116119.0,17,5,1005,5,1005,27029029.75,201.0,201.0,0,0,0.0,0.0,0.0
2044.0,17,4,344,2,150,0.0,75.0,75.0,2,194,0.0,103.0,97.0
69420.0,17,2,604,1,75,0.0,75.0,75.0,1,529,0.0,529.0,529.0
98605.0,17,2,762,2,762,0.0,381.0,381.0,0,0,0.0,0.0,0.0
313292.0,6,6,412,4,272,104430.66666666669,74.0,68.0,2,140,0.0,74.0,70.0
846734.0,6,9,1096,6,625,169346.8,287.0,104.16666666666669,3,471,286929.0,331.0,157.0
448789.0,6,10,967,5,390,76240.25,162.0,78.0,5,577,76176.0,349.0,115.4
254664.0,6,3,337,2,214,0.0,160.0,107.0,1,123,0.0,123.0,123.0
843.0,17,2,762,2,762,0.0,381.0,381.0,0,0,0.0,0.0,0.0
101278432.0,17,14,864,7,432,16833699.333333332,174.0,61.71428571428572,7,432,16833489.0,174.0,61.71428571428572
284877.0,17,2,363,1,79,0.0,79.0,79.0,1,284,0.0,284.0,284.0
357.0,17,2,248,1,84,0.0,84.0,84.0,1,164,0.0,164.0,164.0
41863.0,6,14,4740,7,653,6851.5,249.0,93.28571428571428,7,4087,6100.833333333333,1514.0,583.8571428571429
305404.0,6,6,412,4,272,101801.33333333331,74.0,68.0,2,140,0.0,74.0,70.0
21152.0,6,10,1067,5,536,5051.25,264.0,107.2,5,531,3994.25,259.0,106.2
2305.0,17,4,344,2,150,0.0,75.0,75.0,2,194,0.0,103.0,97.0
245780.0,6,3,337,2,214,0.0,160.0,107.0,1,123,0.0,123.0,123.0
128001225.0,17,15,907,8,475,18285889.285714287,174.0,59.375,7,432,18001161.666666668,174.0,61.71428571428572
242023.0,6,3,426,2,280,0.0,214.0,140.0,1,146,0.0,146.0,146.0
305853.0,6,6,412,4,272,101951.0,74.0,68.0,2,140,0.0,74.0,70.0
27409781.0,17,5,1710,5,1710,6852445.25,342.0,342.0,0,0,0.0,0.0,0.0
247253.0,6,3,337,2,214,0.0,160.0,107.0,1,123,0.0,123.0,123.0
508455.0,6,5,336,2,134,0.0,68.0,67.0,3,202,190246.0,70.0,67.33333333333333
153576.0,17,2,180,1,90,0.0,90.0,90.0,1,90,0.0,90.0,90.0
2352.0,17,4,344,2,150,0.0,75.0,75.0,2,194,0.0,103.0,97.0
90247735.0,6,13,2036,8,1016,12892533.57142857,188.0,127.0,5,1020,22520943.0,204.0,204.0
108104701.0,17,5,1005,5,1005,27026175.25,201.0,201.0,0,0,0.0,0.0,0.0
90095957.0,6,17,2351,9,1271,11261508.375,199.0,141.22222222222223,8,1080,12836569.0,204.0,135.0
403632.0,6,3,204,2,136,0.0,70.0,68.0,1,68,0.0,68.0,68.0
101006511.0,17,14,864,7,432,16834418.5,174.0,61.71428571428572,7,432,16833504.333333332,174.0,61.71428571428572
94203795.0,6,40,2640,20,1320,4958094.47368421,66.0,66.0,20,1320,4946721.684210527,66.0,66.0
113254868.0,6,46,3036,23,1518,5135436.590909091,66.0,66.0,23,1518,5135421.0,66.0,66.0
116174971.0,17,14,864,7,432,19333534.0,174.0,61.71428571428572,7,432,19334323.666666668,174.0,61.71428571428572
199782.0,17,4,6056,4,6056,66594.0,1514.0,1514.0,0,0,0.0,0.0,0.0
135159387.0,17,6,1146,6,1146,27031877.4,191.0,191.0,0,0,0.0,0.0,0.0
6457.0,17,4,823,2,163,0.0,89.0,81.5,2,660,0.0,443.0,330.0
301689.0,6,6,412,4,272,100563.0,74.0,68.0,2,140,0.0,74.0,70.0
116785208.0,6,32,2236,16,1165,7785680.533333333,139.0,72.8125,16,1071,7771259.666666667,123.0,66.9375
39703.0,6,10,2032,5,524,9618.5,252.0,104.8,5,1508,9359.5,1236.0,301.6
3030256.0,6,5,336,2,134,0.0,68.0,67.0,3,202,536483.0,70.0,67.33333333333333
108104753.0,17,5,955,5,955,27026188.25,191.0,191.0,0,0,0.0,0.0,0.0
228350.0,17,2,180,1,90,0.0,90.0,90.0,1,90,0.0,90.0,90.0
10433135.0,6,6,412,3,206,5148191.0,74.0,68.66666666666667,3,206,5147984.5,74.0,68.66666666666667
108106820.0,17,5,955,5,955,27026705.0,191.0,191.0,0,0,0.0,0.0,0.0
300918.0,6,6,412,4,272,100306.0,74.0,68.0,2,140,0.0,74.0,70.0
2350.0,17,4,344,2,150,0.0,75.0,75.0,2,194,0.0,103.0,97.0
311333.0,17,2,180,1,90,0.0,90.0,90.0,1,90,0.0,90.0,90.0
90295897.0,6,16,1192,8,596,12899413.857142856,95.0,74.5,8,596,12856952.0,95.0,74.5
19854.0,17,2,582,1,83,0.0,83.0,83.0,1,499,0.0,499.0,499.0
120495132.0,6,213,24008,107,16716,1136746.5283018867,284.0,156.22429906542055,106,7292,1137707.438095238,140.0,68.79245283018868
36529.0,6,14,4740,7,653,5673.833333333333,249.0,93.28571428571428,7,4087,5484.333333333333,1514.0,583.8571428571429
105453.0,17,2,700,2,700,0.0,350.0,350.0,0,0,0.0,0.0,0.0
37371.0,6,10,2032,5,524,4769.5,252.0,104.8,5,1508,8230.0,1236.0,301.6
8200113.999999999,17,3,1034,2,684,0.0,342.0,342.0,1,350,0.0,350.0,350.0
1300467.0,6,4,264,2,132,0.0,66.0,66.0,2,132,0.0,66.0,66.0
28429.0,6,14,4740,7,653,4508.166666666667,249.0,93.28571428571428,7,4087,4602.0,1514.0,583.8571428571429
108711.0,17,2,286,2,286,0.0,143.0,143.0,0,0,0.0,0.0,0.0
103910.0,17,2,700,2,700,0.0,350.0,350.0,0,0,0.0,0.0,0.0
135134447.0,17,6,1146,6,1146,27026889.4,191.0,191.0,0,0,0.0,0.0,0.0
100407.0,17,2,286,2,286,0.0,143.0,143.0,0,0,0.0,0.0,0.0
101462.0,6,14,4740,7,653,16457.833333333332,249.0,93.28571428571428,7,4087,15252.166666666666,1514.0,583.8571428571429
0.0,17,1,381,1,381,0.0,381.0,381.0,0,0,0.0,0.0,0.0
317946.0,17,4,1400,4,1400,105982.0,350.0,350.0,0,0,0.0,0.0,0.0
108148.0,17,2,286,2,286,0.0,143.0,143.0,0,0,0.0,0.0,0.0
55897.0,6,14,4740,7,653,9185.166666666666,249.0,93.28571428571428,7,4087,7790.0,1514.0,583.8571428571429
146238.0,6,3,337,2,214,0.0,160.0,107.0,1,123,0.0,123.0,123.0
711415.0,17,4,1400,4,1400,237138.3333333333,350.0,350.0,0,0,0.0,0.0,0.0
247436.0,6,3,337,2,214,0.0,160.0,107.0,1,123,0.0,123.0,123.0
120149729.0,6,231,27062,122,19440,991160.305785124,284.0,159.34426229508196,109,7622,1110466.8703703703,140.0,69.92660550458716
300236.0,6,6,412,4,272,100078.66666666669,74.0,68.0,2,140,0.0,74.0,70.0
33105.0,6,14,4740,7,653,5354.833333333333,249.0,93.28571428571428,7,4087,4990.5,1514.0,583.8571428571429
108114095.0,17,5,1005,5,1005,27028523.75,201.0,201.0,0,0,0.0,0.0,0.0
90022376.0,17,28,13364,28,13364,3334162.074074074,501.0,477.2857142857143,0,0,0.0,0.0,0.0
123455975.0,6,49,3234,25,1650,5143998.958333333,66.0,66.0,24,1584,4953028.0869565215,66.0,66.0
12664.0,6,10,2032,5,524,2883.0,252.0,104.8,5,1508,2591.5,1236.0,301.6
44442.0,6,14,4740,7,653,7281.666666666667,249.0,93.28571428571428,7,4087,6916.0,1514.0,583.8571428571429
36922.0,6,14,4740,7,653,6030.833333333333,249.0,93.28571428571428,7,4087,5453.833333333333,1514.0,583.8571428571429
261409.0,6,12,1373,7,714,43568.16666666666,298.0,102.0,5,659,61309.75,379.0,131.8
365569.0,17,2,363,1,75,0.0,75.0,75.0,1,288,0.0,288.0,288.0
302422.0,6,6,412,4,272,100807.33333333331,74.0,68.0,2,140,0.0,74.0,70.0
38000.0,6,10,2032,5,524,9266.25,252.0,104.8,5,1508,8582.0,1236.0,301.6
239521.0,17,4,1400,4,1400,79840.33333333333,350.0,350.0,0,0,0.0,0.0,0.0
196948.0,17,2,180,1,90,0.0,90.0,90.0,1,90,0.0,90.0,90.0
120136421.0,6,13,2036,5,1020,30034105.25,204.0,204.0,8,1016,17138474.14285714,188.0,127.0
31317.0,6,14,4740,7,653,4448.166666666667,249.0,93.28571428571428,7,4087,5062.333333333333,1514.0,583.8571428571429
112891860.0,6,32,2220,16,1149,7511734.0,123.0,71.8125,16,1071,7511740.133333334,123.0,66.9375
108106534.0,17,5,1005,5,1005,27026633.5,201.0,201.0,0,0,0.0,0.0,0.0
146181.0,6,3,373,2,238,0.0,172.0,119.0,1,135,0.0,135.0,135.0
528617.0,17,6,2100,6,2100,105723.4,350.0,350.0,0,0,0.0,0.0,0.0
95085470.0,6,26,1746,13,906,7905788.916666667,123.0,69.6923076923077,13,840,7905787.583333333,123.0,64.61538461538461
5628361.0,6,5,336,2,134,0.0,68.0,67.0,3,202,1424037.0,70.0,67.33333333333333
249463.0,6,3,337,2,214,0.0,160.0,107.0,1,123,0.0,123.0,123.0
125004417.0,17,15,907,8,475,17857773.85714286,174.0,59.375,7,432,17500165.333333332,174.0,61.71428571428572
21961.0,6,14,4740,7,653,3540.1666666666665,249.0,93.28571428571428,7,4087,3472.333333333333,1514.0,583.8571428571429
50291152.0,6,9,1479,9,1479,6286394.0,172.0,164.33333333333334,0,0,0.0,0.0,0.0
219563.0,6,3,426,2,280,0.0,214.0,140.0,1,146,0.0,146.0,146.0
117162751.0,6,36,2580,18,1332,6891926.529411765,123.0,74.0,18,1248,6879215.882352941,123.0,69.33333333333333
143812.0,17,2,180,1,90,0.0,90.0,90.0,1,90,0.0,90.0,90.0
118699.0,6,14,4740,7,653,18339.0,249.0,93.28571428571428,7,4087,19612.33333333333,1514.0,583.8571428571429
135136517.0,17,6,1146,6,1146,27027303.4,191.0,191.0,0,0,0.0,0.0,0.0
90092241.0,6,10,1440,7,828,15015373.5,188.0,118.28571428571428,3,612,30030976.5,204.0,204.0
991803.0,17,6,1230,3,234,495717.5,78.0,78.0,3,996,495692.5,332.0,332.0
300137.0,6,6,412,4,272,100045.66666666669,74.0,68.0,2,140,0.0,74.0,70.0
1177290.0,17,6,1230,3,234,588459.0,78.0,78.0,3,996,588440.0,332.0,332.0
90232288.0,6,16,1192,8,596,12852747.57142857,95.0,74.5,8,596,12857912.0,95.0,74.5
92511552.0,6,21,1709,11,799,9247130.0,95.0,72.63636363636364,10,910,10278651.777777778,219.0,91.0
14154.0,6,10,1949,5,441,2769.0,169.0,88.2,5,1508,3220.5,1236.0,301.6
35477.0,6,2,145,2,145,0.0,91.0,72.5,0,0,0.0,0.0,0.0
300590.0,6,6,412,4,272,100196.66666666669,74.0,68.0,2,140,0.0,74.0,70.0
127940177.0,6,31,2034,16,1086,8529345.133333333,123.0,67.875,15,948,8409852.642857144,123.0,63.2
294883.0,17,2,246,1,76,0.0,76.0,76.0,1,170,0.0,170.0,170.0
53055.0,6,10,2032,5,524,10164.5,252.0,104.8,5,1508,12857.75,1236.0,301.6
1773580.0,6,4,276,2,128,0.0,74.0,64.0,2,148,0.0,74.0,74.0
91897987.0,6,37,2442,19,1254,5105443.722222222,66.0,66.0,18,1188,5020554.05882353,66.0,66.0
153471.0,17,2,180,1,90,0.0,90.0,90.0,1,90,0.0,90.0,90.0
296837.0,17,2,246,1,76,0.0,76.0,76.0,1,170,0.0,170.0,170.0
209981.0,17,2,359,1,75,0.0,75.0,75.0,1,284,0.0,284.0,284.0
23317.0,6,11,1132,6,556,4221.6,218.0,92.66666666666669,5,576,5414.0,304.0,115.2
120297410.0,6,241,27260,121,19044,1002478.4166666666,284.0,157.38842975206612,120,8216,1002907.3025210084,140.0,68.46666666666667
47139.0,6,14,4740,7,653,6464.166666666667,249.0,93.28571428571428,7,4087,7716.0,1514.0,583.8571428571429
22745.0,6,14,4740,7,653,3425.833333333333,249.0,93.28571428571428,7,4087,3612.3333333333335,1514.0,583.8571428571429
16024.0,17,2,180,1,90,0.0,90.0,90.0,1,90,0.0,90.0,90.0
2450.0,17,2,762,2,762,0.0,381.0,381.0,0,0,0.0,0.0,0.0
107341.0,17,2,286,2,286,0.0,143.0,143.0,0,0,0.0,0.0,0.0
13743.0,6,2,132,1,66,0.0,66.0,66.0,1,66,0.0,66.0,66.0
108825921.0,6,32,2236,16,1165,7240661.866666666,139.0,72.8125,16,1071,7240651.733333333,123.0,66.9375
68946.0,6,11,1131,6,600,13588.6,262.0,100.0,5,531,2811.75,259.0,106.2
246281.0,6,3,337,2,214,0.0,160.0,107.0,1,123,0.0,123.0,123.0
698655.0,6,2,132,1,66,0.0,66.0,66.0,1,66,0.0,66.0,66.0
41985674.0,6,4,1670,3,917,20992837.0,785.0,305.6666666666667,1,753,0.0,753.0,753.0
5625000.0,6,5,336,2,134,0.0,68.0,67.0,3,202,1421280.5,70.0,67.33333333333333
46427.0,6,14,4740,7,653,6833.666666666667,249.0,93.28571428571428,7,4087,7564.666666666667,1514.0,583.8571428571429
217575.0,6,12,1373,7,714,36262.5,298.0,102.0,5,659,52932.25,379.0,131.8
90528867.0,6,13,2036,8,1016,12932695.285714284,188.0,127.0,5,1020,22591133.0,204.0,204.0
45234.0,17,2,180,1,90,0.0,90.0,90.0,1,90,0.0,90.0,90.0
90256575.0,6,13,2036,8,1016,12893796.42857143,188.0,127.0,5,1020,22523255.25,204.0,204.0
143353.0,6,2,132,1,66,0.0,66.0,66.0,1,66,0.0,66.0,66.0
208765.0,6,3,426,2,280,0.0,214.0,140.0,1,146,0.0,146.0,146.0
120358837.0,6,231,26150,116,18264,1046598.5826086956,284.0,157.44827586206895,115,7886,1046576.3157894736,140.0,68.57391304347826
1345644.0,17,16,1120,16,1120,89709.6,70.0,70.0,0,0,0.0,0.0,0.0
876.0,17,2,508,2,508,0.0,257.0,254.0,0,0,0.0,0.0,0.0
256441.0,17,4,6056,4,6056,85480.33333333333,1514.0,1514.0,0,0,0.0,0.0,0.0
4771.0,17,2,180,1,90,0.0,90.0,90.0,1,90,0.0,90.0,90.0
306284.0,6,6,412,4,272,102094.66666666669,74.0,68.0,2,140,0.0,74.0,70.0
336.0,17,2,166,1,75,0.0,75.0,75.0,1,91,0.0,91.0,91.0
108123127.0,17,5,1005,5,1005,27030781.75,201.0,201.0,0,0,0.0,0.0,0.0
99377852.0,17,14,1126,7,563,16501134.666666666,174.0,80.42857142857143,7,563,16500152.333333334,174.0,80.42857142857143
90259019.0,6,14,2240,8,1016,12894145.57142857,188.0,127.0,6,1224,18018868.6,204.0,204.0
324.0,17,2,174,1,79,0.0,79.0,79.0,1,95,0.0,95.0,95.0
216528.0,17,2,180,1,90,0.0,90.0,90.0,1,90,0.0,90.0,90.0
316874.0,17,4,1400,4,1400,105624.66666666669,350.0,350.0,0,0,0.0,0.0,0.0
114022519.0,6,30,1990,15,1042,8128975.071428572,139.0,69.46666666666667,15,948,8129052.428571428,123.0,63.2
51649.0,6,13,1386,7,789,8557.166666666666,253.0,112.71428571428572,6,597,8438.6,259.0,99.5
143910.0,17,2,180,1,90,0.0,90.0,90.0,1,90,0.0,90.0,90.0
108110095.0,17,5,955,5,955,27027523.75,191.0,191.0,0,0,0.0,0.0,0.0
206101.0,17,2,180,1,90,0.0,90.0,90.0,1,90,0.0,90.0,90.0
120244869.0,6,22,1680,10,786,13333300.888888888,95.0,78.6,12,894,10909086.636363637,95.0,74.5
216767.0,6,3,426,2,280,0.0,214.0,140.0,1,146,0.0,146.0,146.0
495298.0,6,5,336,2,134,0.0,68.0,67.0,3,202,195470.5,70.0,67.33333333333333
302.0,17,2,164,1,82,0.0,82.0,82.0,1,82,0.0,82.0,82.0
83989.0,6,10,1066,5,490,20615.75,218.0,98.0,5,576,20652.75,304.0,115.2
101776420.0,6,34,2466,17,1272,6361026.25,123.0,74.82352941176471,17,1194,6348215.0,123.0,70.23529411764706
493888.0,6,5,336,2,134,0.0,68.0,67.0,3,202,196123.0,70.0,67.33333333333333
334.0,17,2,166,1,75,0.0,75.0,75.0,1,91,0.0,91.0,91.0
15050656.0,17,6,2718,6,2718,3010131.2,453.0,453.0,0,0,0.0,0.0,0.0
32496.0,6,11,2098,6,590,6339.2,252.0,98.33333333333331,5,1508,7679.75,1236.0,301.6
108094670.0,17,5,955,5,955,27023667.5,191.0,191.0,0,0,0.0,0.0,0.0
312998.0,17,4,1400,4,1400,104332.66666666669,350.0,350.0,0,0,0.0,0.0,0.0
205877.0,6,3,426,2,280,0.0,214.0,140.0,1,146,0.0,146.0,146.0
2317.0,17,4,344,2,150,0.0,75.0,75.0,2,194,0.0,103.0,97.0
206355.0,6,3,426,2,280,0.0,214.0,140.0,1,146,0.0,146.0,146.0
113733880.0,6,46,3036,23,1518,5155439.590909091,66.0,66.0,23,1518,5155438.181818182,66.0,66.0
3379149.0,6,7,923,4,753,1054256.0,571.0,188.25,3,170,1580969.5,62.0,56.66666666666666
111793249.0,6,32,2236,16,1165,7438504.866666666,139.0,72.8125,16,1071,7438504.733333333,123.0,66.9375
823328.0,17,2,876,2,876,0.0,438.0,438.0,0,0,0.0,0.0,0.0
4424.0,17,2,602,1,72,0.0,72.0,72.0,1,530,0.0,530.0,530.0
10473802.0,6,7,478,4,272,3445477.333333333,74.0,68.0,3,206,5168152.0,74.0,68.66666666666667
104462796.0,6,21,9487,12,1174,9496617.818181818,408.0,97.83333333333331,9,8313,8510373.0,1514.0,923.6666666666666
90284444.0,6,17,1287,9,691,11279946.125,95.0,76.77777777777777,8,596,12897136.714285716,95.0,74.5
2805441.0,6,2,132,1,66,0.0,66.0,66.0,1,66,0.0,66.0,66.0
120088050.0,6,252,28510,126,8612,954090.44,140.0,68.34920634920636,126,19898,955039.176,284.0,157.9206349206349
300.0,17,2,174,1,79,0.0,79.0,79.0,1,95,0.0,95.0,95.0
105178894.0,17,15,5130,15,5130,7512778.142857143,342.0,342.0,0,0,0.0,0.0,0.0
107762896.0,6,28,1860,14,966,8272853.615384615,123.0,69.0,14,894,8272851.384615385,123.0,63.85714285714285
124135.0,6,3,373,2,238,0.0,172.0,119.0,1,135,0.0,135.0,135.0
149261825.0,6,21,1585,10,745,13284968.444444444,95.0,74.5,11,840,14904524.4,95.0,76.36363636363636
233099.0,6,3,373,2,238,0.0,172.0,119.0,1,135,0.0,135.0,135.0
20285.0,17,2,582,1,83,0.0,83.0,83.0,1,499,0.0,499.0,499.0
37029.0,6,13,1386,7,789,6171.5,253.0,112.71428571428572,6,597,5915.6,259.0,99.5
199118.0,17,2,180,1,90,0.0,90.0,90.0,1,90,0.0,90.0,90.0
207575.0,6,3,426,2,280,0.0,214.0,140.0,1,146,0.0,146.0,146.0
0.0,17,1,381,1,381,0.0,381.0,381.0,0,0,0.0,0.0,0.0
100595511.0,17,13,821,7,432,16666815.833333334,174.0,61.71428571428572,6,389,20001317.2,174.0,64.83333333333333
2416.0,17,4,344,2,150,0.0,75.0,75.0,2,194,0.0,103.0,97.0
120047439.0,17,29,13785,29,13785,4287408.535714285,501.0,475.3448275862069,0,0,0.0,0.0,0.0
46857.0,6,14,4740,7,653,7471.0,249.0,93.28571428571428,7,4087,6734.0,1514.0,583.8571428571429
104195.0,17,2,700,2,700,0.0,350.0,350.0,0,0,0.0,0.0,0.0
220894.0,6,4,492,2,280,0.0,214.0,140.0,2,212,0.0,146.0,106.0
1920551.0,6,19,7533,10,1403,213394.5555555556,583.0,140.3,9,6130,206290.75,1484.0,681.1111111111111
53270.0,6,14,4740,7,653,8193.333333333334,249.0,93.28571428571428,7,4087,7310.166666666667,1514.0,583.8571428571429
1306995.0,6,4,264,2,132,0.0,66.0,66.0,2,132,0.0,66.0,66.0
220376.0,17,2,414,1,88,0.0,88.0,88.0,1,326,0.0,326.0,326.0
308625.0,6,6,412,4,272,102875.0,74.0,68.0,2,140,0.0,74.0,70.0
116331111.0,17,13,821,7,432,19361898.5,174.0,61.71428571428572,6,389,19329415.2,174.0,64.83333333333333
107369.0,17,2,286,2,286,0.0,143.0,143.0,0,0,0.0,0.0,0.0
45924.0,6,14,4740,7,653,7533.5,249.0,93.28571428571428,7,4087,7194.5,1514.0,583.8571428571429
617128.0,17,4,629,3,234,209333.5,78.0,78.0,1,395,0.0,395.0,395.0
770.0,17,4,438,2,148,0.0,74.0,74.0,2,290,0.0,147.0,145.0
135132675.0,17,6,1206,6,1206,27026535.0,201.0,201.0,0,0,0.0,0.0,0.0
9291.0,17,2,582,1,83,0.0,83.0,83.0,1,499,0.0,499.0,499.0
108078.0,17,2,286,2,286,0.0,143.0,143.0,0,0,0.0,0.0,0.0
323.0,17,2,174,1,79,0.0,79.0,79.0,1,95,0.0,95.0,95.0
121500510.0,6,233,26436,117,18558,1047418.1896551724,300.0,158.6153846153846,116,7878,1029717.7217391304,140.0,67.91379310344827
135137169.0,17,6,1206,6,1206,27027433.8,201.0,201.0,0,0,0.0,0.0,0.0
96181585.0,6,174,19756,87,13792,1115884.011627907,374.0,158.5287356321839,87,5964,1115887.6860465116,140.0,68.55172413793103
298.0,17,2,168,1,76,0.0,76.0,76.0,1,92,0.0,92.0,92.0
284393.0,17,2,363,1,79,0.0,79.0,79.0,1,284,0.0,284.0,284.0
40580.0,6,14,4740,7,653,6612.166666666667,249.0,93.28571428571428,7,4087,5913.833333333333,1514.0,583.8571428571429
21654.0,17,2,539,1,86,0.0,86.0,86.0,1,453,0.0,453.0,453.0
63820.0,6,10,2032,5,524,14841.75,252.0,104.8,5,1508,14284.0,1236.0,301.6
205591.0,17,2,180,1,90,0.0,90.0,90.0,1,90,0.0,90.0,90.0
48847.0,6,14,4740,7,653,7621.833333333333,249.0,93.28571428571428,7,4087,7433.833333333333,1514.0,583.8571428571429
1357509.0,6,4,276,2,128,0.0,74.0,64.0,2,148,0.0,74.0,74.0
1555.0,17,2,192,1,88,0.0,88.0,88.0,1,104,0.0,104.0,104.0
43495.0,6,10,2032,5,524,9836.25,252.0,104.8,5,1508,10616.25,1236.0,301.6
299832.0,6,6,412,4,272,99944.0,74.0,68.0,2,140,0.0,74.0,70.0
253341.0,6,10,1221,6,636,50668.2,298.0,106.0,4,585,78586.66666666667,379.0,146.25
96434024.0,6,40,2640,20,1320,5075474.947368421,66.0,66.0,20,1320,5060970.157894737,66.0,66.0
2042195.0,6,19,6869,11,1567,204219.5,408.0,142.45454545454547,8,5302,228844.57142857145,1514.0,662.75
352.0,17,2,267,1,83,0.0,83.0,83.0,1,184,0.0,184.0,184.0
108117189.0,17,5,1005,5,1005,27029297.25,201.0,201.0,0,0,0.0,0.0,0.0
18242.0,6,14,4740,7,653,2667.1666666666665,249.0,93.28571428571428,7,4087,2846.333333333333,1514.0,583.8571428571429
103933.0,17,2,286,2,286,0.0,143.0,143.0,0,0,0.0,0.0,0.0
90373497.0,6,12,1848,5,1020,22593065.25,204.0,204.0,7,828,15061091.166666666,188.0,118.28571428571428
19890.0,6,10,2032,5,524,4275.75,252.0,104.8,5,1508,4799.25,1236.0,301.6
7138.0,17,2,582,1,83,0.0,83.0,83.0,1,499,0.0,499.0,499.0
228545.0,17,2,180,1,90,0.0,90.0,90.0,1,90,0.0,90.0,90.0
90242672.0,6,14,1084,7,542,15040445.333333334,95.0,77.42857142857143,7,542,14959847.333333334,95.0,77.42857142857143
442.0,17,2,267,1,83,0.0,83.0,83.0,1,184,0.0,184.0,184.0
2183293.0,6,24,7544,12,2450,198481.18181818185,1034.0,204.16666666666663,12,5094,170090.63636363635,1510.0,424.5
39302.0,6,10,2032,5,524,8932.5,252.0,104.8,5,1508,9560.5,1236.0,301.6
147943.0,17,2,180,1,90,0.0,90.0,90.0,1,90,0.0,90.0,90.0
244050.0,6,3,373,2,238,0.0,172.0,119.0,1,135,0.0,135.0,135.0
404729.0,6,4,508,2,238,0.0,172.0,119.0,2,270,0.0,135.0,135.0
201840.0,17,2,762,2,762,0.0,381.0,381.0,0,0,0.0,0.0,0.0
322624.0,17,4,1400,4,1400,107541.33333333331,350.0,350.0,0,0,0.0,0.0,0.0
104743844.0,6,44,2904,22,1452,4987802.095238095,66.0,66.0,22,1452,4974684.857142857,66.0,66.0
90590718.0,6,15,2444,8,1016,12941531.142857144,188.0,127.0,7,1428,15065069.0,204.0,204.0
38084.0,6,10,2032,5,524,9109.5,252.0,104.8,5,1508,6983.25,1236.0,301.6
95984259.0,6,26,2099,12,1056,8706275.545454545,216.0,88.0,14,1043,7366839.0,95.0,74.5
250950.0,17,4,6056,4,6056,83649.99999999999,1514.0,1514.0,0,0,0.0,0.0,0.0
206580.0,6,3,426,2,280,0.0,214.0,140.0,1,146,0.0,146.0,146.0
118914479.0,6,34,2350,17,1225,7418637.9375,139.0,72.05882352941177,17,1125,7418585.25,123.0,66.17647058823529
233206.0,6,3,337,2,214,0.0,160.0,107.0,1,123,0.0,123.0,123.0
4435.0,17,4,704,2,148,0.0,74.0,74.0,2,556,0.0,280.0,278.0
23289.0,6,10,2032,5,524,5383.25,252.0,104.8,5,1508,5550.75,1236.0,301.6
629114.0,6,4,508,2,238,0.0,172.0,119.0,2,270,0.0,135.0,135.0
113613323.0,6,46,3036,23,1518,5150443.136363637,66.0,66.0,23,1518,5150438.090909091,66.0,66.0
40315.0,6,10,2032,5,524,9645.75,252.0,104.8,5,1508,9174.75,1236.0,301.6
107014.0,17,4,1400,4,1400,35671.333333333336,350.0,350.0,0,0,0.0,0.0,0.0
22140.0,6,10,2032,5,524,5248.75,252.0,104.8,5,1508,4524.25,1236.0,301.6
106764013.0,6,34,2472,18,1332,6267536.05882353,123.0,74.0,16,1140,7103224.733333333,123.0,71.25
296.0,17,2,156,1,78,0.0,78.0,78.0,1,78,0.0,78.0,78.0
207152.0,6,3,426,2,280,0.0,214.0,140.0,1,146,0.0,146.0,146.0
101322.0,6,14,4740,7,653,16158.333333333334,249.0,93.28571428571428,7,4087,15347.833333333334,1514.0,583.8571428571429
3774560.0,6,5,336,2,134,0.0,68.0,67.0,3,202,1424004.5,70.0,67.33333333333333
1309898.0,6,4,264,2,132,0.0,66.0,66.0,2,132,0.0,66.0,66.0
135127375.0,17,6,1206,6,1206,27025475.0,201.0,201.0,0,0,0.0,0.0,0.0
218238.0,17,2,180,1,90,0.0,90.0,90.0,1,90,0.0,90.0,90.0
123250537.0,6,49,3234,25,1650,5135439.041666667,66.0,66.0,24,1584,4926927.043478261,66.0,66.0
146315.0,6,3,337,2,214,0.0,160.0,107.0,1,123,0.0,123.0,123.0
263151.0,6,12,1373,7,714,43858.5,298.0,102.0,5,659,59273.5,379.0,131.8
6668.0,17,4,823,2,163,0.0,89.0,81.5,2,660,0.0,443.0,330.0
26553.0,6,11,2098,6,590,5184.6,252.0,98.33333333333331,5,1508,6349.0,1236.0,301.6
139322.0,6,2,132,1,66,0.0,66.0,66.0,1,66,0.0,66.0,66.0
217926.0,6,3,426,2,280,0.0,214.0,140.0,1,146,0.0,146.0,146.0
2282706.0,6,19,6869,10,1501,253634.0,408.0,150.1,9,5368,242698.625,1514.0,596.4444444444445
22331.0,6,10,2032,5,524,5242.25,252.0,104.8,5,1508,4944.5,1236.0,301.6
120295043.0,6,192,21776,96,6632,1258544.6,140.0,69.08333333333333,96,15144,1257617.2736842106,284.0,157.75
48635.0,6,12,1328,6,731,9390.0,253.0,121.83333333333331,6,597,8514.8,259.0,99.5
135132604.0,17,6,1146,6,1146,27026520.8,191.0,191.0,0,0,0.0,0.0,0.0
43585.0,6,14,4740,7,653,7146.833333333333,249.0,93.28571428571428,7,4087,6970.833333333333,1514.0,583.8571428571429
12919.0,6,10,2032,5,524,2989.5,252.0,104.8,5,1508,3003.25,1236.0,301.6
784.0,17,4,438,2,148,0.0,74.0,74.0,2,290,0.0,147.0,145.0
108360856.0,6,31,2182,16,1165,7209658.333333333,139.0,72.8125,15,1017,7724631.428571428,123.0,67.8
357724.0,6,3,1604,2,851,0.0,785.0,425.5,1,753,0.0,753.0,753.0
35627.0,6,10,2032,5,524,8096.5,252.0,104.8,5,1508,6949.5,1236.0,301.6
128016141.0,6,65,5929,38,3367,3459895.7027027025,139.0,88.60526315789474,27,2562,4538868.423076923,123.0,94.88888888888889
161254.0,17,2,180,1,90,0.0,90.0,90.0,1,90,0.0,90.0,90.0
252791.0,17,4,6056,4,6056,84263.66666666667,1514.0,1514.0,0,0,0.0,0.0,0.0
58147.0,6,14,4740,7,653,6780.666666666667,249.0,93.28571428571428,7,4087,9131.166666666666,1514.0,583.8571428571429
276901.0,17,4,1524,4,1524,92300.33333333331,381.0,381.0,0,0,0.0,0.0,0.0
297890.0,6,6,412,4,272,99296.66666666669,74.0,68.0,2,140,0.0,74.0,70.0
10130.0,6,10,2032,5,524,2279.75,252.0,104.8,5,1508,2284.0,1236.0,301.6
108105350.0,17,5,955,5,955,27026337.5,191.0,191.0,0,0,0.0,0.0,0.0
107603.0,17,2,286,2,286,0.0,143.0,143.0,0,0,0.0,0.0,0.0
2397.0,17,4,344,2,150,0.0,75.0,75.0,2,194,0.0,103.0,97.0
5001252.0,17,4,629,2,156,0.0,78.0,78.0,2,473,0.0,268.0,236.5
4449.0,17,2,614,1,72,0.0,72.0,72.0,1,542,0.0,542.0,542.0
120122345.0,6,13,2020,9,1204,15015293.125,188.0,133.77777777777777,4,816,30039302.33333333,204.0,204.0
153500.0,17,2,180,1,90,0.0,90.0,90.0,1,90,0.0,90.0,90.0
2408.0,17,4,344,2,150,0.0,75.0,75.0,2,194,0.0,103.0,97.0
277366.0,17,2,363,1,79,0.0,79.0,79.0,1,284,0.0,284.0,284.0
90262891.0,6,12,1832,8,1016,12894698.714285716,188.0,127.0,4,816,30032927.666666668,204.0,204.0
144862.0,17,2,180,1,70,0.0,70.0,70.0,1,110,0.0,110.0,110.0
90020880.0,17,28,13364,28,13364,3334106.6666666665,501.0,477.2857142857143,0,0,0.0,0.0,0.0
1305116.0,6,4,264,2,132,0.0,66.0,66.0,2,132,0.0,66.0,66.0
108733162.0,6,33,2412,17,1272,6782320.0625,123.0,74.82352941176471,16,1140,7234477.533333333,123.0,71.25
108110276.0,17,5,955,5,955,27027569.0,191.0,191.0,0,0,0.0,0.0,0.0
308785.0,6,6,412,4,272,102928.33333333331,74.0,68.0,2,140,0.0,74.0,70.0
90739314.0,6,19,1436,10,745,10076224.0,95.0,74.5,9,691,11341947.0,95.0,76.77777777777777
270498.0,6,12,1373,7,714,45083.0,298.0,102.0,5,659,63390.75,379.0,131.8
110567486.0,6,31,2166,16,1149,7356775.666666667,123.0,71.8125,15,1017,7882256.571428572,123.0,67.8
90066729.0,17,28,13364,28,13364,3335804.777777778,501.0,477.2857142857143,0,0,0.0,0.0,0.0
120123542.0,6,14,2224,9,1204,15015442.75,188.0,133.77777777777777,5,1020,22523554.25,204.0,204.0
2614583.0,6,3,1604,2,851,0.0,785.0,425.5,1,753,0.0,753.0,753.0
121200419.0,6,240,27140,120,8216,1002920.43697479,140.0,68.46666666666667,120,18924,1011599.4957983192,284.0,157.7
14660506.0,6,5,1736,2,819,0.0,753.0,409.5,3,917,7259526.5,785.0,305.6666666666667
112234609.0,6,32,2220,16,1149,7482307.266666667,123.0,71.8125,16,1071,7468612.2,123.0,66.9375
103317076.0,6,42,2772,21,1386,5150437.7,66.0,66.0,21,1386,5150433.9,66.0,66.0
29130.0,6,14,4740,7,653,4737.166666666667,249.0,93.28571428571428,7,4087,4383.166666666667,1514.0,583.8571428571429
26764.0,6,10,2032,5,524,6422.75,252.0,104.8,5,1508,6399.75,1236.0,301.6
284356.0,17,2,363,1,79,0.0,79.0,79.0,1,284,0.0,284.0,284.0
10488706.0,6,7,478,4,272,3450781.6666666665,74.0,68.0,3,206,5145588.0,74.0,68.66666666666667
153480.0,17,2,180,1,90,0.0,90.0,90.0,1,90,0.0,90.0,90.0
103655.0,17,2,286,2,286,0.0,143.0,143.0,0,0,0.0,0.0,0.0
23966.0,6,14,4740,7,653,3791.8333333333335,249.0,93.28571428571428,7,4087,3169.6666666666665,1514.0,583.8571428571429
162252.0,17,2,180,1,90,0.0,90.0,90.0,1,90,0.0,90.0,90.0
99128631.0,17,12,778,6,389,19793935.8,174.0,64.83333333333333,6,389,19751344.4,174.0,64.83333333333333
314167.0,17,4,1400,4,1400,104722.33333333331,350.0,350.0,0,0,0.0,0.0,0.0
21988065.0,17,3,1034,2,684,0.0,342.0,342.0,1,350,0.0,350.0,350.0
90562056.0,6,13,2036,8,1016,12937436.57142857,188.0,127.0,5,1020,22599948.5,204.0,204.0
10851587.0,6,7,478,3,206,5357506.0,74.0,68.66666666666667,4,272,3571589.0,74.0,68.0
333518.0,6,5,336,2,134,0.0,68.0,67.0,3,202,152904.0,70.0,67.33333333333333
306.0,17,2,156,1,78,0.0,78.0,78.0,1,78,0.0,78.0,78.0
211451.0,6,3,426,2,280,0.0,214.0,140.0,1,146,0.0,146.0,146.0
31570.0,6,14,4740,7,653,4358.666666666667,249.0,93.28571428571428,7,4087,5121.833333333333,1514.0,583.8571428571429
1646454.0,6,7,499,3,198,716363.0,66.0,66.0,4,301,493982.3333333333,103.0,75.25
5827809.0,6,5,336,2,134,0.0,68.0,67.0,3,202,1523638.5,70.0,67.33333333333333
0.0,17,1,72,1,72,0.0,72.0,72.0,0,0,0.0,0.0,0.0
0.0,17,1,44,1,44,0.0,44.0,44.0,0,0,0.0,0.0,0.0
90208695.0,6,16,1192,8,596,12853181.857142856,95.0,74.5,8,596,12857745.0,95.0,74.5
250168.0,6,3,337,2,214,0.0,160.0,107.0,1,123,0.0,123.0,123.0
2590952.0,6,2,132,1,66,0.0,66.0,66.0,1,66,0.0,66.0,66.0
10476998.0,6,7,478,4,272,3446809.333333333,74.0,68.0,3,206,5170088.5,74.0,68.66666666666667
2338.0,17,4,344,2,150,0.0,75.0,75.0,2,194,0.0,103.0,97.0
120012574.0,17,28,13364,28,13364,4444910.148148148,501.0,477.2857142857143,0,0,0.0,0.0,0.0
103177.0,17,2,286,2,286,0.0,143.0,143.0,0,0,0.0,0.0,0.0
308326.0,6,6,412,4,272,102775.33333333331,74.0,68.0,2,140,0.0,74.0,70.0
118205371.0,17,14,1126,7,563,19674400.33333333,174.0,80.42857142857143,7,563,19674409.33333333,174.0,80.42857142857143
121166.0,6,3,337,2,214,0.0,160.0,107.0,1,123,0.0,123.0,123.0
43764.0,6,14,4740,7,653,6469.5,249.0,93.28571428571428,7,4087,6302.666666666667,1514.0,583.8571428571429
2571617.0,6,25,7573,14,3735,197816.6923076923,1514.0,266.7857142857143,11,3838,229343.8,1514.0,348.90909090909093
272681.0,6,3,337,2,214,0.0,160.0,107.0,1,123,0.0,123.0,123.0
219201.0,6,10,1221,6,636,43840.2,298.0,106.0,4,585,71807.66666666667,379.0,146.25
100174248.0,17,12,778,6,389,20000165.0,174.0,64.83333333333333,6,389,20000810.2,174.0,64.83333333333333
197352.0,17,2,180,1,90,0.0,90.0,90.0,1,90,0.0,90.0,90.0
224538.0,6,3,426,2,280,0.0,214.0,140.0,1,146,0.0,146.0,146.0
302112.0,6,6,412,4,272,100704.0,74.0,68.0,2,140,0.0,74.0,70.0
121267.0,6,3,337,2,214,0.0,160.0,107.0,1,123,0.0,123.0,123.0
1323853.0,6,4,264,2,132,0.0,66.0,66.0,2,132,0.0,66.0,66.0
1791.0,17,2,192,1,88,0.0,88.0,88.0,1,104,0.0,104.0,104.0
33431.0,6,14,4740,7,653,5395.833333333333,249.0,93.28571428571428,7,4087,4665.166666666667,1514.0,583.8571428571429
887750.0,6,12,2715,7,743,147958.33333333334,339.0,106.14285714285714,5,1972,153828.0,1514.0,394.4
209053.0,6,3,426,2,280,0.0,214.0,140.0,1,146,0.0,146.0,146.0
0.0,17,1,72,1,72,0.0,72.0,72.0,0,0,0.0,0.0,0.0
120117867.0,6,13,2036,8,1016,17136505.0,188.0,127.0,5,1020,22521968.5,204.0,204.0
2801202.0,6,2,132,1,66,0.0,66.0,66.0,1,66,0.0,66.0,66.0
218721.0,6,3,426,2,280,0.0,214.0,140.0,1,146,0.0,146.0,146.0
2592248.0,6,2,132,1,66,0.0,66.0,66.0,1,66,0.0,66.0,66.0
1999.0,17,4,344,2,150,0.0,75.0,75.0,2,194,0.0,103.0,97.0
17445.0,6,11,1132,6,556,2299.2,218.0,92.66666666666669,5,576,4147.0,304.0,115.2
108108355.0,17,5,955,5,955,27027088.75,191.0,191.0,0,0,0.0,0.0,0.0
223236.0,17,4,1400,4,1400,74412.0,350.0,350.0,0,0,0.0,0.0,0.0
123250543.0,6,49,3234,25,1650,5135439.291666667,66.0,66.0,24,1584,5096988.695652174,66.0,66.0
148007.0,17,2,180,1,90,0.0,90.0,90.0,1,90,0.0,90.0,90.0
9130837.0,6,32,9405,16,5446,608722.4666666667,1514.0,340.375,16,3959,538585.8,1514.0,247.4375
298284.0,6,6,412,4,272,99428.0,74.0,68.0,2,140,0.0,74.0,70.0
55188.0,6,14,4740,7,653,9067.5,249.0,93.28571428571428,7,4087,8279.0,1514.0,583.8571428571429
236303.0,6,3,337,2,214,0.0,160.0,107.0,1,123,0.0,123.0,123.0
284889.0,17,2,363,1,79,0.0,79.0,79.0,1,284,0.0,284.0,284.0
762689.0,6,2,132,1,66,0.0,66.0,66.0,1,66,0.0,66.0,66.0
23111119.0,17,3,1034,2,684,0.0,342.0,342.0,1,350,0.0,350.0,350.0
4058834.0,6,6,876,2,292,0.0,214.0,146.0,4,584,965893.0,146.0,146.0
492.00000000000006,17,2,508,2,508,0.0,257.0,254.0,0,0,0.0,0.0,0.0
839307.0,6,9,1196,6,725,167861.4,387.0,120.83333333333331,3,471,283199.5,331.0,157.0
18369.0,6,14,4740,7,653,2660.333333333333,249.0,93.28571428571428,7,4087,2924.833333333333,1514.0,583.8571428571429
97337737.0,6,26,1746,13,906,8111478.083333333,123.0,69.6923076923077,13,840,8093454.416666667,123.0,64.61538461538461
120181400.0,6,252,28420,126,8612,954860.696,140.0,68.34920634920636,126,19808,954874.6,284.0,157.20634920634922
196988.0,17,2,180,1,90,0.0,90.0,90.0,1,90,0.0,90.0,90.0
3176857.0,6,18,1536,9,962,358363.5,315.0,106.88888888888889,9,574,358334.625,78.0,63.77777777777778
1180080.0,6,13,3012,8,2384,168582.85714285713,1514.0,298.0,5,628,226153.5,331.0,125.6
99115.0,6,15,4806,8,719,13392.0,249.0,89.875,7,4087,16103.166666666666,1514.0,583.8571428571429
300371.0,6,6,412,4,272,100123.66666666669,74.0,68.0,2,140,0.0,74.0,70.0
108104477.0,17,5,1005,5,1005,27026119.25,201.0,201.0,0,0,0.0,0.0,0.0
2393063.0,6,25,7573,14,3735,184081.7692307692,1514.0,266.7857142857143,11,3838,213660.7,1514.0,348.90909090909093
156570.0,6,3,337,2,214,0.0,160.0,107.0,1,123,0.0,123.0,123.0
106635526.0,6,44,2904,22,1452,5077882.19047619,66.0,66.0,22,1452,5063183.952380952,66.0,66.0
220911.0,6,3,426,2,280,0.0,214.0,140.0,1,146,0.0,146.0,146.0
120006491.0,17,29,13785,29,13785,4285946.107142857,501.0,475.3448275862069,0,0,0.0,0.0,0.0
120068998.0,17,28,13364,28,13364,4446999.925925926,501.0,477.2857142857143,0,0,0.0,0.0,0.0
319.0,17,2,174,1,79,0.0,79.0,79.0,1,95,0.0,95.0,95.0
319.0,17,2,174,1,79,0.0,79.0,79.0,1,95,0.0,95.0,95.0
101162607.0,17,14,1126,7,563,16833603.333333332,174.0,80.42857142857143,7,563,16833603.5,174.0,80.42857142857143
2201896.0,6,19,6868,10,1500,244655.11111111112,408.0,150.0,9,5368,231950.25,1514.0,596.4444444444445
115202583.0,17,14,864,7,432,19166855.33333333,174.0,61.71428571428572,7,432,19167178.666666668,174.0,61.71428571428572
5306.0,17,2,180,1,90,0.0,90.0,90.0,1,90,0.0,90.0,90.0
101174.0,17,2,762,2,762,0.0,381.0,381.0,0,0,0.0,0.0,0.0
322.0,17,2,174,1,79,0.0,79.0,79.0,1,95,0.0,95.0,95.0
13591.0,6,10,2032,5,524,3128.75,252.0,104.8,5,1508,3170.75,1236.0,301.6
144532.0,17,2,180,1,90,0.0,90.0,90.0,1,90,0.0,90.0,90.0
919947.0,6,12,1354,6,723,182545.8,253.0,120.5,6,631,183230.6,293.0,105.16666666666669
5828206.0,6,5,336,2,134,0.0,68.0,67.0,3,202,1525994.0,70.0,67.33333333333333
45197.0,6,14,4740,7,653,7412.5,249.0,93.28571428571428,7,4087,6897.666666666667,1514.0,583.8571428571429
10709.0,6,10,2032,5,524,2417.25,252.0,104.8,5,1508,2382.5,1236.0,301.6
153622.0,17,2,180,1,90,0.0,90.0,90.0,1,90,0.0,90.0,90.0
20290.0,6,10,2032,5,524,4241.25,252.0,104.8,5,1508,4799.75,1236.0,301.6
290.0,17,2,208,1,72,0.0,72.0,72.0,1,136,0.0,136.0,136.0
120110434.0,6,401,47052,201,33556,600552.17,464.0,166.9452736318408,200,13496,600138.6432160804,140.0,67.48
1194678.0,6,13,3015,8,2387,170668.2857142857,1514.0,298.375,5,628,229886.75,331.0,125.6
153381.0,17,2,180,1,90,0.0,90.0,90.0,1,90,0.0,90.0,90.0
251122.0,6,3,337,2,214,0.0,160.0,107.0,1,123,0.0,123.0,123.0
100227.0,17,2,762,2,762,0.0,381.0,381.0,0,0,0.0,0.0,0.0
92097.0,6,2,132,1,66,0.0,66.0,66.0,1,66,0.0,66.0,66.0
217201.0,17,2,180,1,90,0.0,90.0,90.0,1,90,0.0,90.0,90.0
2362.0,17,4,344,2,150,0.0,75.0,75.0,2,194,0.0,103.0,97.0
91879722.0,6,169,19066,85,5832,1093806.2142857143,140.0,68.61176470588235,84,13234,1094758.6024096385,284.0,157.54761904761904
105112778.0,6,193,21714,97,6624,1094924.7708333333,140.0,68.28865979381443,96,15090,1095548.3578947368,284.0,157.1875
20246.0,6,20,7606,11,978,2024.6,310.0,88.9090909090909,9,6628,2250.625,1514.0,736.4444444444445
90259445.0,6,13,2036,8,1016,12894206.42857143,188.0,127.0,5,1020,22523642.5,204.0,204.0
545.0,17,5,550,5,550,136.25,110.0,110.0,0,0,0.0,0.0,0.0
107645.0,17,2,286,2,286,0.0,143.0,143.0,0,0,0.0,0.0,0.0
845.0,17,4,438,2,148,0.0,74.0,74.0,2,290,0.0,147.0,145.0
5629472.0,6,5,336,2,134,0.0,68.0,67.0,3,202,1524720.0,70.0,67.33333333333333
298394.0,6,6,412,4,272,99464.66666666669,74.0,68.0,2,140,0.0,74.0,70.0
2445.0,17,4,344,2,150,0.0,75.0,75.0,2,194,0.0,103.0,97.0
3164308.0,6,3,1604,1,753,0.0,753.0,753.0,2,851,0.0,785.0,425.5
30218.0,6,14,4740,7,653,4826.166666666667,249.0,93.28571428571428,7,4087,4897.666666666667,1514.0,583.8571428571429
105303.0,17,2,286,2,286,0.0,143.0,143.0,0,0,0.0,0.0,0.0
302397.0,6,2,132,1,66,0.0,66.0,66.0,1,66,0.0,66.0,66.0
108506.0,17,2,286,2,286,0.0,143.0,143.0,0,0,0.0,0.0,0.0
120052074.0,6,48,3168,24,1584,5219655.391304348,66.0,66.0,24,1584,5210253.869565218,66.0,66.0
58248.0,6,14,4740,7,653,8604.0,249.0,93.28571428571428,7,4087,9436.833333333334,1514.0,583.8571428571429
68675.0,6,14,4740,7,653,11215.666666666666,249.0,93.28571428571428,7,4087,11017.5,1514.0,583.8571428571429
204564.0,17,2,180,1,90,0.0,90.0,90.0,1,90,0.0,90.0,90.0
90033587.0,17,28,13364,28,13364,3334577.296296296,501.0,477.2857142857143,0,0,0.0,0.0,0.0
1657105.0,6,8,602,5,404,388568.75,103.0,80.8,3,198,204839.0,66.0,66.0
535.0,17,2,508,2,508,0.0,257.0,254.0,0,0,0.0,0.0,0.0
146915.0,6,3,373,2,238,0.0,172.0,119.0,1,135,0.0,135.0,135.0
2498.0,17,4,344,2,150,0.0,75.0,75.0,2,194,0.0,103.0,97.0
105331.0,6,14,4740,7,653,17156.5,249.0,93.28571428571428,7,4087,15998.5,1514.0,583.8571428571429
409.0,17,2,410,1,78,0.0,78.0,78.0,1,332,0.0,332.0,332.0
121484.0,6,3,337,2,214,0.0,160.0,107.0,1,123,0.0,123.0,123.0
197338.0,17,2,180,1,90,0.0,90.0,90.0,1,90,0.0,90.0,90.0
2101.0,17,2,691,1,349,0.0,349.0,349.0,1,342,0.0,342.0,342.0
10458524.0,6,7,478,4,272,3440912.0,74.0,68.0,3,206,5161221.5,74.0,68.66666666666667
236729.0,6,10,1221,6,636,47345.8,298.0,106.0,4,585,77641.0,379.0,146.25
135120386.0,17,6,1206,6,1206,27024077.2,201.0,201.0,0,0,0.0,0.0,0.0
27677.0,6,14,4740,7,653,3374.833333333333,249.0,93.28571428571428,7,4087,4480.5,1514.0,583.8571428571429
205932.0,6,3,426,2,280,0.0,214.0,140.0,1,146,0.0,146.0,146.0
135130078.0,17,6,1146,6,1146,27026015.6,191.0,191.0,0,0,0.0,0.0,0.0
144438.0,17,2,180,1,90,0.0,90.0,90.0,1,90,0.0,90.0,90.0
15201.0,6,14,4740,7,653,2190.333333333333,249.0,93.28571428571428,7,4087,2396.333333333333,1514.0,583.8571428571429
2310.0,17,4,344,2,150,0.0,75.0,75.0,2,194,0.0,103.0,97.0
248996.0,6,3,337,2,214,0.0,160.0,107.0,1,123,0.0,123.0,123.0
51178.0,17,2,180,1,90,0.0,90.0,90.0,1,90,0.0,90.0,90.0
90207343.0,6,17,1287,8,596,12852747.42857143,95.0,74.5,9,691,11250353.375,95.0,76.77777777777777
0.0,17,1,90,1,90,0.0,90.0,90.0,0,0,0.0,0.0,0.0
113699018.0,6,46,3036,23,1518,5168125.363636363,66.0,66.0,23,1518,5168125.818181818,66.0,66.0
120125186.0,6,13,2020,9,1204,15015648.25,188.0,133.77777777777777,4,816,30034149.666666668,204.0,204.0
34334.0,6,10,2032,5,524,8226.5,252.0,104.8,5,1508,8108.75,1236.0,301.6
108630.0,17,2,286,2,286,0.0,143.0,143.0,0,0,0.0,0.0,0.0
1302401.0,6,4,264,2,132,0.0,66.0,66.0,2,132,0.0,66.0,66.0
300773.0,6,6,412,4,272,100257.66666666669,74.0,68.0,2,140,0.0,74.0,70.0
228516.0,17,2,180,1,90,0.0,90.0,90.0,1,90,0.0,90.0,90.0
17929.0,6,10,2032,5,524,3797.5,252.0,104.8,5,1508,4209.5,1236.0,301.6
92038408.0,17,14,1126,7,563,15333466.5,174.0,80.42857142857143,7,563,15334406.666666666,174.0,80.42857142857143
146151.0,6,3,337,2,214,0.0,160.0,107.0,1,123,0.0,123.0,123.0
304888.0,6,6,412,4,272,101629.33333333331,74.0,68.0,2,140,0.0,74.0,70.0
90048353.0,17,28,13364,28,13364,3335124.185185185,501.0,477.2857142857143,0,0,0.0,0.0,0.0
607.0,17,2,762,2,762,0.0,381.0,381.0,0,0,0.0,0.0,0.0
125824607.0,6,32,2157,16,1071,7722643.8,123.0,66.9375,16,1086,8388207.733333333,123.0,67.875
123620561.0,6,49,3234,25,1650,5150856.708333333,66.0,66.0,24,1584,5118109.652173913,66.0,66.0
21595.0,17,2,582,1,83,0.0,83.0,83.0,1,499,0.0,499.0,499.0
62693.0,6,14,4740,7,653,10317.833333333334,249.0,93.28571428571428,7,4087,10103.666666666666,1514.0,583.8571428571429
90256972.0,6,13,2036,8,1016,12893853.142857144,188.0,127.0,5,1020,22523326.5,204.0,204.0
113168473.0,6,46,3036,23,1518,5144006.7727272725,66.0,66.0,23,1518,5144009.954545454,66.0,66.0
24589.0,6,14,4740,7,653,3764.1666666666665,249.0,93.28571428571428,7,4087,3878.5,1514.0,583.8571428571429
120024398.0,17,28,13364,28,13364,4445348.074074074,501.0,477.2857142857143,0,0,0.0,0.0,0.0
202379.0,17,4,6056,4,6056,67459.66666666667,1514.0,1514.0,0,0,0.0,0.0,0.0
669.0,17,2,248,1,84,0.0,84.0,84.0,1,164,0.0,164.0,164.0
108107009.0,17,5,1005,5,1005,27026752.25,201.0,201.0,0,0,0.0,0.0,0.0
112000955.0,6,32,2236,16,1165,7452319.666666667,139.0,72.8125,16,1071,7452334.533333333,123.0,66.9375
302368.0,6,6,412,4,272,100789.33333333331,74.0,68.0,2,140,0.0,74.0,70.0
97563.0,17,2,762,2,762,0.0,381.0,381.0,0,0,0.0,0.0,0.0
228477.0,17,2,180,1,90,0.0,90.0,90.0,1,90,0.0,90.0,90.0
25418.0,6,14,4740,7,653,3922.3333333333335,249.0,93.28571428571428,7,4087,4068.1666666666665,1514.0,583.8571428571429
218930.0,6,12,1373,7,714,36488.333333333336,298.0,102.0,5,659,53855.0,379.0,131.8
120123015.0,6,13,2020,9,1204,15015376.875,188.0,133.77777777777777,4,816,30023700.33333333,204.0,204.0
187134.0,6,22,9301,12,947,17012.18181818182,213.0,78.91666666666667,10,8354,19645.777777777777,1514.0,835.4
119845777.0,6,15,2306,6,1224,23968685.6,204.0,204.0,9,1082,14980572.875,188.0,120.22222222222224
108104474.0,17,5,955,5,955,27026118.5,191.0,191.0,0,0,0.0,0.0,0.0
103743072.0,6,44,2904,22,1452,4940146.285714285,66.0,66.0,22,1452,4925411.333333333,66.0,66.0
506390.0,6,5,336,2,134,0.0,68.0,67.0,3,202,195508.5,70.0,67.33333333333333
2355.0,17,4,344,2,150,0.0,75.0,75.0,2,194,0.0,103.0,97.0
505166.0,6,4,270,2,134,0.0,68.0,67.0,2,136,0.0,70.0,68.0
239139.0,6,3,337,2,214,0.0,160.0,107.0,1,123,0.0,123.0,123.0
90030531.0,17,27,12943,27,12943,3462712.730769231,501.0,479.3703703703704,0,0,0.0,0.0,0.0
68359.0,6,14,4740,7,653,10158.833333333334,249.0,93.28571428571428,7,4087,11230.166666666666,1514.0,583.8571428571429
23275.0,6,14,4740,7,653,3661.3333333333335,249.0,93.28571428571428,7,4087,3739.6666666666665,1514.0,583.8571428571429
76788.0,6,14,4740,7,653,12627.666666666666,249.0,93.28571428571428,7,4087,12540.0,1514.0,583.8571428571429
313732.0,6,6,412,4,272,104577.33333333331,74.0,68.0,2,140,0.0,74.0,70.0
220938.0,6,3,426,2,280,0.0,214.0,140.0,1,146,0.0,146.0,146.0
433.0,17,2,410,1,78,0.0,78.0,78.0,1,332,0.0,332.0,332.0
30409.0,6,10,2032,5,524,7000.25,252.0,104.8,5,1508,6920.5,1236.0,301.6
76308.0,6,12,1320,7,789,12718.0,253.0,112.71428571428572,5,531,16551.75,259.0,106.2
0.0,17,1,55,1,55,0.0,55.0,55.0,0,0,0.0,0.0,0.0
42938.0,6,14,4740,7,653,6990.5,249.0,93.28571428571428,7,4087,6474.5,1514.0,583.8571428571429
32914.0,6,13,1386,7,789,5100.666666666667,253.0,112.71428571428572,6,597,5887.0,259.0,99.5
209459.0,17,2,180,1,90,0.0,90.0,90.0,1,90,0.0,90.0,90.0
308010.0,6,6,412,4,272,102670.0,74.0,68.0,2,140,0.0,74.0,70.0
153740.0,17,2,180,1,90,0.0,90.0,90.0,1,90,0.0,90.0,90.0
10872951.0,6,8,544,4,272,3578791.333333333,74.0,68.0,4,272,3578731.333333333,74.0,68.0
56137.0,6,10,2032,5,524,13112.0,252.0,104.8,5,1508,13673.0,1236.0,301.6
121208.0,6,3,337,2,214,0.0,160.0,107.0,1,123,0.0,123.0,123.0
264383.0,6,10,1221,6,636,52876.6,298.0,106.0,4,585,82407.66666666667,379.0,146.25
90301442.0,6,16,1192,8,596,12893219.857142856,95.0,74.5,8,596,12898431.42857143,95.0,74.5
2309.0,17,4,344,2,150,0.0,75.0,75.0,2,194,0.0,103.0,97.0
1115330.0,6,13,1394,7,797,185888.3333333333,253.0,113.85714285714286,6,597,220480.2,259.0,99.5
9862.0,17,4,823,2,163,0.0,89.0,81.5,2,660,0.0,443.0,330.0
242160.0,6,3,373,2,238,0.0,172.0,119.0,1,135,0.0,135.0,135.0
135133656.0,17,6,1146,6,1146,27026731.2,191.0,191.0,0,0,0.0,0.0,0.0
1028256.0,6,11,1134,6,558,205651.2,220.0,93.0,5,576,256366.0,304.0,115.2
90012139.0,17,28,13364,28,13364,3333782.925925926,501.0,477.2857142857143,0,0,0.0,0.0,0.0
220810.0,6,10,1221,6,636,44162.0,298.0,106.0,4,585,72728.66666666667,379.0,146.25
323427.0,17,4,1400,4,1400,107809.0,350.0,350.0,0,0,0.0,0.0,0.0
1167707.0,6,13,3011,8,2383,166815.2857142857,1514.0,297.875,5,628,223060.25,331.0,125.6
197233.0,17,2,180,1,90,0.0,90.0,90.0,1,90,0.0,90.0,90.0
90096473.0,6,12,1848,5,1020,22523478.5,204.0,204.0,7,828,15015095.333333334,188.0,118.28571428571428
299622.0,6,6,412,4,272,99874.0,74.0,68.0,2,140,0.0,74.0,70.0
4871.0,17,4,344,2,150,0.0,75.0,75.0,2,194,0.0,103.0,97.0
888198.0,6,10,1334,6,797,177639.6,459.0,132.83333333333334,4,537,204110.66666666663,331.0,134.25
106773.0,17,2,286,2,286,0.0,143.0,143.0,0,0,0.0,0.0,0.0
116328479.0,6,48,3168,24,1584,5057759.956521739,66.0,66.0,24,1584,5045778.391304348,66.0,66.0
14923.0,6,13,1459,7,862,2275.6666666666665,271.0,123.14285714285714,6,597,2705.8,259.0,99.5
231847.0,6,3,337,2,214,0.0,160.0,107.0,1,123,0.0,123.0,123.0
119818.0,17,2,180,1,70,0.0,70.0,70.0,1,110,0.0,110.0,110.0
23406.0,6,14,4740,7,653,3356.333333333333,249.0,93.28571428571428,7,4087,3761.6666666666665,1514.0,583.8571428571429
103042.0,17,2,286,2,286,0.0,143.0,143.0,0,0,0.0,0.0,0.0
201368.0,17,4,6056,4,6056,67122.66666666667,1514.0,1514.0,0,0,0.0,0.0,0.0
120191994.0,6,34,2350,17,1225,7499187.6875,139.0,72.05882352941177,17,1125,7499189.1875,123.0,66.17647058823529
316779.0,17,4,1400,4,1400,105593.0,350.0,350.0,0,0,0.0,0.0,0.0
116354200.0,17,14,864,7,432,19168139.666666668,174.0,61.71428571428572,7,432,19166823.83333333,174.0,61.71428571428572
149037.0,17,2,414,1,88,0.0,88.0,88.0,1,326,0.0,326.0,326.0
90299385.0,6,16,1192,8,596,12892912.0,95.0,74.5,8,596,12898857.714285716,95.0,74.5
206329.0,6,3,426,2,280,0.0,214.0,140.0,1,146,0.0,146.0,146.0
241773.0,6,3,337,2,214,0.0,160.0,107.0,1,123,0.0,123.0,123.0
419.0,17,2,410,1,78,0.0,78.0,78.0,1,332,0.0,332.0,332.0
143903.0,17,2,180,1,90,0.0,90.0,90.0,1,90,0.0,90.0,90.0
120750017.0,6,212,23868,107,16716,1139151.1037735848,284.0,156.22429906542055,105,7152,1148050.798076923,140.0,68.11428571428571
1465.0,17,5,550,5,550,366.25,110.0,110.0,0,0,0.0,0.0,0.0
400.0,17,2,762,2,762,0.0,381.0,381.0,0,0,0.0,0.0,0.0
90252676.0,6,12,1832,8,1016,12893239.42857143,188.0,127.0,4,816,30029382.0,204.0,204.0
351.0,17,2,267,1,83,0.0,83.0,83.0,1,184,0.0,184.0,184.0
116721222.0,6,48,3168,24,1584,5074835.739130435,66.0,66.0,24,1584,5062861.652173913,66.0,66.0
317955.0,6,6,412,4,272,105985.0,74.0,68.0,2,140,0.0,74.0,70.0
113168289.0,6,46,3036,23,1518,5144000.818181818,66.0,66.0,23,1518,5144002.136363637,66.0,66.0
232863.0,6,3,337,2,214,0.0,160.0,107.0,1,123,0.0,123.0,123.0
150758.0,17,4,6056,4,6056,50252.66666666666,1514.0,1514.0,0,0,0.0,0.0,0.0
30754.0,6,14,4740,7,653,4622.666666666667,249.0,93.28571428571428,7,4087,4864.833333333333,1514.0,583.8571428571429
146333.0,6,3,337,2,214,0.0,160.0,107.0,1,123,0.0,123.0,123.0
120125544.0,6,15,2428,9,1204,15015693.0,188.0,133.77777777777777,6,1224,18019028.8,204.0,204.0
5001287.0,17,4,629,2,156,0.0,78.0,78.0,2,473,0.0,268.0,236.5
20418.0,6,10,2032,5,524,4008.75,252.0,104.8,5,1508,4133.25,1236.0,301.6
30106005.0,6,4,270,3,202,15053002.5,70.0,67.33333333333333,1,68,0.0,68.0,68.0
17553.0,6,14,4740,7,653,2762.1666666666665,249.0,93.28571428571428,7,4087,2777.833333333333,1514.0,583.8571428571429
285.0,17,2,174,1,79,0.0,79.0,79.0,1,95,0.0,95.0,95.0
90221592.0,6,16,1192,8,596,12855086.857142856,95.0,74.5,8,596,12859522.42857143,95.0,74.5
298313.0,6,6,412,4,272,99437.66666666669,74.0,68.0,2,140,0.0,74.0,70.0
206878.0,6,3,426,2,280,0.0,214.0,140.0,1,146,0.0,146.0,146.0
122688099.0,6,49,3234,25,1650,5112004.125,66.0,66.0,24,1584,4992368.391304348,66.0,66.0
903878.0,6,10,1332,6,795,180775.6,457.0,132.5,4,537,209405.3333333333,331.0,134.25
209522.0,17,2,180,1,90,0.0,90.0,90.0,1,90,0.0,90.0,90.0
9003.0,17,2,539,1,86,0.0,86.0,86.0,1,453,0.0,453.0,453.0
110514.0,17,4,1400,4,1400,36838.0,350.0,350.0,0,0,0.0,0.0,0.0
313316.0,6,6,412,4,272,104438.66666666669,74.0,68.0,2,140,0.0,74.0,70.0
42068.0,6,10,2032,5,524,10234.75,252.0,104.8,5,1508,10049.75,1236.0,301.6
1155917.0,6,13,3010,8,2382,165131.0,1514.0,297.75,5,628,220774.5,331.0,125.6
297568.0,6,6,412,4,272,99189.33333333331,74.0,68.0,2,140,0.0,74.0,70.0
35686.0,6,14,4740,7,653,5552.0,249.0,93.28571428571428,7,4087,5531.166666666667,1514.0,583.8571428571429
90044725.0,17,28,13364,28,13364,3334989.814814815,501.0,477.2857142857143,0,0,0.0,0.0,0.0
311302.0,17,4,622,4,622,103767.33333333331,163.0,155.5,0,0,0.0,0.0,0.0
135132588.0,17,6,1206,6,1206,27026517.6,201.0,201.0,0,0,0.0,0.0,0.0
103751.0,17,2,700,2,700,0.0,350.0,350.0,0,0,0.0,0.0,0.0
98501466.0,6,32,2368,16,1140,6566764.4,123.0,71.25,16,1228,6509648.533333333,139.0,76.75
94000789.0,17,11,735,6,389,18800157.8,174.0,64.83333333333333,5,346,18501323.5,174.0,69.2
90093545.0,6,12,1848,5,1020,22523007.25,204.0,204.0,7,828,15015392.833333334,188.0,118.28571428571428
316251.0,17,4,1400,4,1400,105417.0,350.0,350.0,0,0,0.0,0.0,0.0
129014.0,6,2,132,1,66,0.0,66.0,66.0,1,66,0.0,66.0,66.0
56111.0,6,14,4740,7,653,9180.333333333334,249.0,93.28571428571428,7,4087,7355.0,1514.0,583.8571428571429
2294.0,17,4,344,2,150,0.0,75.0,75.0,2,194,0.0,103.0,97.0
35302.0,6,14,4740,7,653,5100.833333333333,249.0,93.28571428571428,7,4087,5740.5,1514.0,583.8571428571429
146061.0,6,3,337,2,214,0.0,160.0,107.0,1,123,0.0,123.0,123.0
17358.0,17,2,180,1,90,0.0,90.0,90.0,1,90,0.0,90.0,90.0
120022474.0,6,26,2019,14,1125,9232498.0,95.0,80.35714285714286,12,894,10906531.0,95.0,74.5
171558.0,17,2,180,1,90,0.0,90.0,90.0,1,90,0.0,90.0,90.0
2310.0,17,4,344,2,150,0.0,75.0,75.0,2,194,0.0,103.0,97.0
109000975.0,17,13,821,7,432,18166829.166666668,174.0,61.71428571428572,6,389,17800858.0,174.0,64.83333333333333
44610.0,6,10,2032,5,524,7674.75,252.0,104.8,5,1508,10898.75,1236.0,301.6
1171922.0,6,13,3010,8,2382,167417.42857142858,1514.0,297.75,5,628,224763.75,331.0,125.6
232446.0,6,3,337,2,214,0.0,160.0,107.0,1,123,0.0,123.0,123.0
119186974.0,17,16,1212,8,606,17000139.85714286,174.0,75.75,8,606,17001833.285714287,174.0,75.75
32211.0,6,10,2032,5,524,7333.75,252.0,104.8,5,1508,7494.75,1236.0,301.6
153375.0,17,2,180,1,90,0.0,90.0,90.0,1,90,0.0,90.0,90.0
9191.0,17,2,582,1,83,0.0,83.0,83.0,1,499,0.0,499.0,499.0
32682077.0,6,5,336,2,134,0.0,68.0,67.0,3,202,15053157.0,70.0,67.33333333333333
102945050.0,17,12,1040,6,520,16600188.4,174.0,86.66666666666667,6,520,16600556.8,174.0,86.66666666666667
40725.0,6,14,4740,7,653,5825.833333333333,249.0,93.28571428571428,7,4087,6616.666666666667,1514.0,583.8571428571429
797.0,17,4,438,2,148,0.0,74.0,74.0,2,290,0.0,147.0,145.0
108393.0,17,2,700,2,700,0.0,350.0,350.0,0,0,0.0,0.0,0.0
58105.0,6,14,4740,7,653,7397.0,249.0,93.28571428571428,7,4087,9444.333333333334,1514.0,583.8571428571429
49750.0,6,12,1328,6,731,9100.4,253.0,121.83333333333331,6,597,8902.4,259.0,99.5
120763.0,6,3,373,2,238,0.0,172.0,119.0,1,135,0.0,135.0,135.0
165288.0,17,2,582,1,83,0.0,83.0,83.0,1,499,0.0,499.0,499.0
153437.0,17,2,180,1,90,0.0,90.0,90.0,1,90,0.0,90.0,90.0
9286.0,17,2,571,1,86,0.0,86.0,86.0,1,485,0.0,485.0,485.0
0.0,17,1,80,1,80,0.0,80.0,80.0,0,0,0.0,0.0,0.0
303676.0,6,2,132,1,66,0.0,66.0,66.0,1,66,0.0,66.0,66.0
509455.0,6,5,336,2,134,0.0,68.0,67.0,3,202,194120.5,70.0,67.33333333333333
113859484.0,6,48,3168,24,1584,4950412.347826087,66.0,66.0,24,1584,4941020.695652174,66.0,66.0
108105161.0,17,5,955,5,955,27026290.25,191.0,191.0,0,0,0.0,0.0,0.0
99880.0,6,13,1394,7,797,16646.666666666668,253.0,113.85714285714286,6,597,17523.4,259.0,99.5
16313.999999999998,6,10,2032,5,524,3835.75,252.0,104.8,5,1508,3503.0,1236.0,301.6
3721.0,17,4,344,2,150,0.0,75.0,75.0,2,194,0.0,103.0,97.0
90256903.0,6,12,1832,8,1016,12893843.285714284,188.0,127.0,4,816,30023765.0,204.0,204.0
864930.0,6,9,1270,6,799,172986.0,461.0,133.16666666666666,3,471,294671.0,331.0,157.0
90275980.0,6,12,1832,8,1016,12896568.57142857,188.0,127.0,4,816,30036608.666666668,204.0,204.0
148035.0,17,2,180,1,90,0.0,90.0,90.0,1,90,0.0,90.0,90.0
287871.0,17,4,1400,4,1400,95957.0,350.0,350.0,0,0,0.0,0.0,0.0
2502.0,17,4,344,2,150,0.0,75.0,75.0,2,194,0.0,103.0,97.0
222438.0,6,3,426,2,280,0.0,214.0,140.0,1,146,0.0,146.0,146.0
228109.0,17,2,180,1,90,0.0,90.0,90.0,1,90,0.0,90.0,90.0
19340.0,6,11,2098,6,590,3252.2,252.0,98.33333333333331,5,1508,4466.75,1236.0,301.6
15319.0,6,10,2032,5,524,3609.75,252.0,104.8,5,1508,3549.0,1236.0,301.6
205978.0,17,2,180,1,90,0.0,90.0,90.0,1,90,0.0,90.0,90.0
48357.0,6,14,4740,7,653,7937.0,249.0,93.28571428571428,7,4087,7200.666666666667,1514.0,583.8571428571429
2342.0,17,4,344,2,150,0.0,75.0,75.0,2,194,0.0,103.0,97.0
284665.0,17,2,363,1,79,0.0,79.0,79.0,1,284,0.0,284.0,284.0
2321.0,17,4,344,2,150,0.0,75.0,75.0,2,194,0.0,103.0,97.0
3018857.0,6,17,4938,10,851,174741.33333333334,249.0,85.1,7,4087,503007.6666666667,1514.0,583.8571428571429
108102486.0,17,5,1005,5,1005,27025621.5,201.0,201.0,0,0,0.0,0.0,0.0
120080441.0,6,203,22898,101,15870,1193987.93,284.0,157.12871287128712,102,7028,1186784.8613861387,140.0,68.90196078431373
106335695.0,6,27,1800,14,894,8179668.846153846,123.0,63.85714285714285,13,906,8311054.25,123.0,69.6923076923077
2464538.0,6,20,6935,11,1567,246453.8,408.0,142.45454545454547,9,5368,249059.25,1514.0,596.4444444444445
110993348.0,6,30,1974,15,1026,7912669.071428572,123.0,68.4,15,948,7912679.785714285,123.0,63.2
197010.0,17,2,180,1,90,0.0,90.0,90.0,1,90,0.0,90.0,90.0
101148735.0,17,14,864,7,432,16833517.5,174.0,61.71428571428572,7,432,16834551.333333332,174.0,61.71428571428572
148083.0,17,2,180,1,90,0.0,90.0,90.0,1,90,0.0,90.0,90.0
90288940.0,6,24,1829,13,989,7520379.5,95.0,76.07692307692308,11,840,8999128.2,95.0,76.36363636363636
2056.0,17,4,344,2,150,0.0,75.0,75.0,2,194,0.0,103.0,97.0
228324.0,17,2,180,1,90,0.0,90.0,90.0,1,90,0.0,90.0,90.0
284.0,17,2,164,1,82,0.0,82.0,82.0,1,82,0.0,82.0,82.0
10432486.0,6,7,478,4,272,3432188.0,74.0,68.0,3,206,5148155.0,74.0,68.66666666666667
1310062.0,6,4,264,2,132,0.0,66.0,66.0,2,132,0.0,66.0,66.0
91202590.0,17,12,778,6,389,18200156.8,174.0,64.83333333333333,6,389,18201086.6,174.0,64.83333333333333
42947.0,6,14,4740,7,653,6623.666666666667,249.0,93.28571428571428,7,4087,6975.333333333333,1514.0,583.8571428571429
9174.0,17,2,582,1,83,0.0,83.0,83.0,1,499,0.0,499.0,499.0
40233.0,6,10,2032,5,524,9740.75,252.0,104.8,5,1508,9670.75,1236.0,301.6
25660.0,6,10,2032,5,524,6095.0,252.0,104.8,5,1508,5719.75,1236.0,301.6
228346.0,17,2,180,1,90,0.0,90.0,90.0,1,90,0.0,90.0,90.0
206278.0,6,3,426,2,280,0.0,214.0,140.0,1,146,0.0,146.0,146.0
5826135.0,6,5,336,2,134,0.0,68.0,67.0,3,202,1523704.0,70.0,67.33333333333333
3354781.0,6,171,139606,97,130420,34945.635416666664,1510.0,1344.5360824742268,74,9186,41686.91780821918,1510.0,124.13513513513512
115081604.0,6,37,2656,19,1408,6381439.444444444,139.0,74.10526315789474,18,1248,6756816.823529412,123.0,69.33333333333333
90529819.0,6,15,2444,8,1016,12932831.285714284,188.0,127.0,7,1428,15060482.166666666,204.0,204.0
205980.0,17,2,180,1,90,0.0,90.0,90.0,1,90,0.0,90.0,90.0
242972.0,6,3,337,2,214,0.0,160.0,107.0,1,123,0.0,123.0,123.0
6337.0,17,4,438,2,148,0.0,74.0,74.0,2,290,0.0,147.0,145.0
2786398.0,6,2,132,1,66,0.0,66.0,66.0,1,66,0.0,66.0,66.0
251592.0,6,3,337,2,214,0.0,160.0,107.0,1,123,0.0,123.0,123.0
2127.0,17,4,344,2,150,0.0,75.0,75.0,2,194,0.0,103.0,97.0
307746.0,6,6,412,4,272,102582.0,74.0,68.0,2,140,0.0,74.0,70.0
310371.0,6,6,412,4,272,103457.0,74.0,68.0,2,140,0.0,74.0,70.0
117355678.0,6,219,24712,110,7556,1076657.5963302753,140.0,68.69090909090909,109,17156,1077157.490740741,284.0,157.39449541284404
144044.0,17,2,180,1,90,0.0,90.0,90.0,1,90,0.0,90.0,90.0
118940955.0,6,48,3168,24,1584,5171345.869565218,66.0,66.0,24,1584,5159370.782608695,66.0,66.0
9320.0,17,2,498,1,80,0.0,80.0,80.0,1,418,0.0,418.0,418.0
302169.0,6,6,412,4,272,100723.0,74.0,68.0,2,140,0.0,74.0,70.0
141955.0,6,2,132,1,66,0.0,66.0,66.0,1,66,0.0,66.0,66.0
247150.0,17,4,6056,4,6056,82383.33333333333,1514.0,1514.0,0,0,0.0,0.0,0.0
120144971.0,6,203,23026,101,15998,1192336.43,284.0,158.3960396039604,102,7028,1187423.4851485149,140.0,68.90196078431373
1998.0,17,4,344,2,150,0.0,75.0,75.0,2,194,0.0,103.0,97.0
220237.0,6,12,1373,7,714,36706.16666666666,298.0,102.0,5,659,54420.75,379.0,131.8
90301342.0,6,16,1192,8,596,12893974.285714284,95.0,74.5,8,596,12898584.42857143,95.0,74.5
103278.0,17,2,286,2,286,0.0,143.0,143.0,0,0,0.0,0.0,0.0
56026.0,6,14,4740,7,653,9168.166666666666,249.0,93.28571428571428,7,4087,8450.333333333334,1514.0,583.8571428571429
213177.0,6,10,1221,6,636,42635.4,298.0,106.0,4,585,69628.33333333333,379.0,146.25
301929.0,6,6,412,4,272,100643.0,74.0,68.0,2,140,0.0,74.0,70.0
756.0,17,2,684,2,684,0.0,342.0,342.0,0,0,0.0,0.0,0.0
97991939.0,6,191,21582,96,15090,1031494.094736842,284.0,157.1875,95,6492,1031062.6170212766,140.0,68.33684210526316
109427327.0,17,14,864,7,432,18167681.83333333,174.0,61.71428571428572,7,432,18166890.0,174.0,61.71428571428572
471836.0,6,4,508,2,238,0.0,172.0,119.0,2,270,0.0,135.0,135.0
90097455.0,6,10,1440,7,828,15016242.5,188.0,118.28571428571428,3,612,30031462.5,204.0,204.0
34774.0,6,14,4740,7,653,5647.666666666667,249.0,93.28571428571428,7,4087,5488.333333333333,1514.0,583.8571428571429
137439.0,6,2,132,1,66,0.0,66.0,66.0,1,66,0.0,66.0,66.0
228339.0,17,2,180,1,90,0.0,90.0,90.0,1,90,0.0,90.0,90.0
103765630.0,17,14,864,7,432,17267587.666666668,174.0,61.71428571428572,7,432,17289138.5,174.0,61.71428571428572
73023.0,17,2,762,2,762,0.0,381.0,381.0,0,0,0.0,0.0,0.0
106875.0,17,2,762,2,762,0.0,381.0,381.0,0,0,0.0,0.0,0.0
208356.0,6,3,426,2,280,0.0,214.0,140.0,1,146,0.0,146.0,146.0
209494.0,17,2,180,1,90,0.0,90.0,90.0,1,90,0.0,90.0,90.0
43815.0,6,14,4740,7,653,7172.333333333333,249.0,93.28571428571428,7,4087,6842.666666666667,1514.0,583.8571428571429
205689.0,17,2,180,1,90,0.0,90.0,90.0,1,90,0.0,90.0,90.0
210962.0,17,2,762,2,762,0.0,381.0,381.0,0,0,0.0,0.0,0.0
298232.0,6,6,412,4,272,99410.66666666669,74.0,68.0,2,140,0.0,74.0,70.0
16931068.0,6,20,1607,10,975,1844975.888888889,315.0,97.5,10,632,1844886.7777777773,78.0,63.2
45811.0,6,14,4740,7,653,7364.5,249.0,93.28571428571428,7,4087,5825.333333333333,1514.0,583.8571428571429
232848.0,6,3,337,2,214,0.0,160.0,107.0,1,123,0.0,123.0,123.0
101206963.0,6,204,22980,102,16026,999905.6534653464,284.0,157.11764705882354,102,6954,999905.6633663366,140.0,68.17647058823529
49936.0,6,10,2032,5,524,11441.25,252.0,104.8,5,1508,11905.25,1236.0,301.6
120124587.0,6,14,2224,9,1204,15015573.375,188.0,133.77777777777777,5,1020,22523470.5,204.0,204.0
102202359.0,17,14,864,7,432,17000200.0,174.0,61.71428571428572,7,432,17001757.833333332,174.0,61.71428571428572
1089427.0,6,13,1394,7,797,181571.16666666663,253.0,113.85714285714286,6,597,216091.4,259.0,99.5
120124777.0,6,15,2444,7,1428,20020796.166666668,204.0,204.0,8,1016,17098250.42857143,188.0,127.0
217715.0,6,10,1221,6,636,43543.0,298.0,106.0,4,585,71392.66666666667,379.0,146.25
100545172.0,17,12,778,6,389,20027645.0,174.0,64.83333333333333,6,389,20077243.6,174.0,64.83333333333333
298067.0,6,6,412,4,272,99355.66666666669,74.0,68.0,2,140,0.0,74.0,70.0
5930048.0,6,5,336,2,134,0.0,68.0,67.0,3,202,1572455.0,70.0,67.33333333333333
225758.0,17,2,180,1,90,0.0,90.0,90.0,1,90,0.0,90.0,90.0
19345.0,6,14,4740,7,653,2971.5,249.0,93.28571428571428,7,4087,2966.333333333333,1514.0,583.8571428571429
207187.0,6,3,426,2,280,0.0,214.0,140.0,1,146,0.0,146.0,146.0
279755.0,17,2,363,1,79,0.0,79.0,79.0,1,284,0.0,284.0,284.0
222218.0,6,13,1386,7,789,37036.333333333336,253.0,112.71428571428572,6,597,42441.0,259.0,99.5
40749.0,6,14,4740,7,653,6340.0,249.0,93.28571428571428,7,4087,6367.5,1514.0,583.8571428571429
35166850.0,6,33,10980,18,3951,136541.29411764705,1514.0,219.5,15,7029,2497281.071428572,1514.0,468.6
108106449.0,17,5,955,5,955,27026612.25,191.0,191.0,0,0,0.0,0.0,0.0
105892.0,17,2,700,2,700,0.0,350.0,350.0,0,0,0.0,0.0,0.0
108109010.0,17,5,955,5,955,27027252.5,191.0,191.0,0,0,0.0,0.0,0.0
146687.0,6,3,337,2,214,0.0,160.0,107.0,1,123,0.0,123.0,123.0
981625.0,17,6,1230,3,234,490627.5,78.0,78.0,3,996,490602.0,332.0,332.0
321035.0,17,4,1400,4,1400,107011.66666666669,350.0,350.0,0,0,0.0,0.0,0.0
26421.0,6,14,4740,7,653,3680.0,249.0,93.28571428571428,7,4087,4265.5,1514.0,583.8571428571429
120927789.0,6,23,1895,11,1001,12092778.9,215.0,91.0,12,894,8263534.909090909,95.0,74.5
2455.0,17,4,344,2,150,0.0,75.0,75.0,2,194,0.0,103.0,97.0
720.0,17,4,438,2,148,0.0,74.0,74.0,2,290,0.0,147.0,145.0
105067.0,17,2,762,2,762,0.0,381.0,381.0,0,0,0.0,0.0,0.0
50896.0,17,2,180,1,90,0.0,90.0,90.0,1,90,0.0,90.0,90.0
123416558.0,6,48,3168,24,1584,5065122.130434782,66.0,66.0,24,1584,5236463.565217392,66.0,66.0
90526910.0,6,13,2036,8,1016,12932415.714285716,188.0,127.0,5,1020,22591493.75,204.0,204.0
308575.0,17,2,246,1,76,0.0,76.0,76.0,1,170,0.0,170.0,170.0
216584.0,6,3,426,2,280,0.0,214.0,140.0,1,146,0.0,146.0,146.0
512103.0,6,5,336,2,134,0.0,68.0,67.0,3,202,194044.0,70.0,67.33333333333333
9404.0,17,2,507,1,86,0.0,86.0,86.0,1,421,0.0,421.0,421.0
107712.0,17,2,286,2,286,0.0,143.0,143.0,0,0,0.0,0.0,0.0
97789.0,17,2,762,2,762,0.0,381.0,381.0,0,0,0.0,0.0,0.0
12874.0,6,10,1066,5,490,3002.5,218.0,98.0,5,576,2977.5,304.0,115.2
217193.0,6,3,426,2,280,0.0,214.0,140.0,1,146,0.0,146.0,146.0
560380.0,17,2,363,1,79,0.0,79.0,79.0,1,284,0.0,284.0,284.0
244156.0,6,3,337,2,214,0.0,160.0,107.0,1,123,0.0,123.0,123.0
34047.0,6,10,2032,5,524,7093.0,252.0,104.8,5,1508,5502.5,1236.0,301.6
222861.0,6,10,1221,6,636,44572.2,298.0,106.0,4,585,73343.66666666667,379.0,146.25
120477686.0,6,227,25796,114,18116,1066174.2123893804,284.0,158.91228070175438,113,7680,1066440.2767857143,140.0,67.96460176991151
113614664.0,6,46,3036,23,1518,5150444.318181818,66.0,66.0,23,1518,5150451.409090909,66.0,66.0
326523.0,17,4,1400,4,1400,108841.0,350.0,350.0,0,0,0.0,0.0,0.0
108542365.0,17,14,864,7,432,18001258.833333332,174.0,61.71428571428572,7,432,18000163.5,174.0,61.71428571428572
146231.0,6,3,337,2,214,0.0,160.0,107.0,1,123,0.0,123.0,123.0
31903.0,6,14,4740,7,653,5126.833333333333,249.0,93.28571428571428,7,4087,5046.0,1514.0,583.8571428571429
2490.0,17,2,762,2,762,0.0,381.0,381.0,0,0,0.0,0.0,0.0
270213.0,6,10,1221,6,636,54042.6,298.0,106.0,4,585,84635.0,379.0,146.25
1779729.0,6,2,132,1,66,0.0,66.0,66.0,1,66,0.0,66.0,66.0
19472650.0,6,26,7627,14,3735,196114.6153846153,1514.0,266.7857142857143,12,3892,1750571.2727272727,1514.0,324.3333333333333
2699606.0,6,2,132,1,66,0.0,66.0,66.0,1,66,0.0,66.0,66.0
120002304.0,17,29,13785,29,13785,4285796.571428572,501.0,475.3448275862069,0,0,0.0,0.0,0.0
4515.0,17,2,598,1,72,0.0,72.0,72.0,1,526,0.0,526.0,526.0
90257719.0,6,13,2036,8,1016,12893959.857142856,188.0,127.0,5,1020,22520903.75,204.0,204.0
10476715.0,6,7,478,4,272,3446489.6666666665,74.0,68.0,3,206,5169611.5,74.0,68.66666666666667
94522854.0,17,12,778,6,389,18800813.2,174.0,64.83333333333333,6,389,18800242.8,174.0,64.83333333333333
515.0,17,2,508,2,508,0.0,257.0,254.0,0,0,0.0,0.0,0.0
2349.0,17,4,344,2,150,0.0,75.0,75.0,2,194,0.0,103.0,97.0
1310841.0,6,4,264,2,132,0.0,66.0,66.0,2,132,0.0,66.0,66.0
221195.0,6,3,426,2,280,0.0,214.0,140.0,1,146,0.0,146.0,146.0
120458204.0,6,255,29730,128,21052,948489.7952755904,300.0,164.46875,127,8678,947890.9603174604,140.0,68.33070866141732
45312.0,6,14,4740,7,653,7146.0,249.0,93.28571428571428,7,4087,7077.5,1514.0,583.8571428571429
20162.0,17,2,582,1,83,0.0,83.0,83.0,1,499,0.0,499.0,499.0
90292834.0,6,24,2712,13,1450,7524402.833333333,337.0,111.53846153846152,11,1262,9000293.2,426.0,114.72727272727272
103088.0,17,2,286,2,286,0.0,143.0,143.0,0,0,0.0,0.0,0.0
22863.0,6,10,2032,5,524,4979.25,252.0,104.8,5,1508,5310.5,1236.0,301.6
92007.0,17,3,1143,3,1143,46003.5,381.0,381.0,0,0,0.0,0.0,0.0
108105419.0,17,5,1005,5,1005,27026354.75,201.0,201.0,0,0,0.0,0.0,0.0
1047132.0,17,2,876,2,876,0.0,438.0,438.0,0,0,0.0,0.0,0.0
146723.0,6,3,373,2,238,0.0,172.0,119.0,1,135,0.0,135.0,135.0
319937.0,6,6,412,4,272,106645.66666666669,74.0,68.0,2,140,0.0,74.0,70.0
100085218.0,6,251,29698,126,21226,800681.744,284.0,168.46031746031747,125,8472,805064.0967741936,140.0,67.776
90022206.0,17,28,13364,28,13364,3334155.777777778,501.0,477.2857142857143,0,0,0.0,0.0,0.0
113524165.0,6,46,3036,23,1518,5160174.954545454,66.0,66.0,23,1518,5160176.363636363,66.0,66.0
954186.0,6,12,1427,6,796,189902.8,271.0,132.66666666666666,6,631,190132.2,293.0,105.16666666666669
107841816.0,6,28,1860,14,966,8278901.846153846,123.0,69.0,14,894,8278907.538461538,123.0,63.85714285714285
108104236.0,17,5,955,5,955,27026059.0,191.0,191.0,0,0,0.0,0.0,0.0
2599202.0,6,2,132,1,66,0.0,66.0,66.0,1,66,0.0,66.0,66.0
149703.0,17,2,180,1,90,0.0,90.0,90.0,1,90,0.0,90.0,90.0
10472203.0,6,7,478,4,272,3445633.6666666665,74.0,68.0,3,206,5168347.5,74.0,68.66666666666667
120140027.0,6,222,25106,111,7622,1084694.1363636365,140.0,68.66666666666667,111,17484,1085627.4090909092,284.0,157.51351351351352
255443.0,6,10,1221,6,636,51088.6,298.0,106.0,4,585,79043.0,379.0,146.25
66262.0,6,14,4740,7,653,10427.333333333334,249.0,93.28571428571428,7,4087,10872.666666666666,1514.0,583.8571428571429
2368.0,17,4,344,2,150,0.0,75.0,75.0,2,194,0.0,103.0,97.0
108110942.0,17,5,1005,5,1005,27027735.5,201.0,201.0,0,0,0.0,0.0,0.0
123839725.0,6,48,3168,24,1584,5069336.652173913,66.0,66.0,24,1584,5228059.347826087,66.0,66.0
141630.0,6,2,132,1,66,0.0,66.0,66.0,1,66,0.0,66.0,66.0
90758652.0,6,19,1436,10,745,10079196.111111112,95.0,74.5,9,691,11343200.625,95.0,76.77777777777777
46381.0,6,14,4740,7,653,7561.0,249.0,93.28571428571428,7,4087,7192.666666666667,1514.0,583.8571428571429
153442.0,17,2,180,1,90,0.0,90.0,90.0,1,90,0.0,90.0,90.0
102790119.0,6,30,2106,15,1089,7326746.5,123.0,72.6,15,1017,7326746.357142857,123.0,67.8
301559.0,6,6,412,4,272,100519.66666666669,74.0,68.0,2,140,0.0,74.0,70.0
148085.0,17,2,180,1,90,0.0,90.0,90.0,1,90,0.0,90.0,90.0
31191.0,6,10,2032,5,524,7563.0,252.0,104.8,5,1508,7479.25,1236.0,301.6
2012.0,17,4,344,2,150,0.0,75.0,75.0,2,194,0.0,103.0,97.0
527170.0,17,6,2100,6,2100,105434.0,350.0,350.0,0,0,0.0,0.0,0.0
2429.0,17,4,344,2,150,0.0,75.0,75.0,2,194,0.0,103.0,97.0
120124284.0,6,15,2428,9,1204,15015535.5,188.0,133.77777777777777,6,1224,18073344.8,204.0,204.0
114529636.0,6,47,3102,24,1584,4965979.0,66.0,66.0,23,1518,5155435.409090909,66.0,66.0
107772.0,17,2,286,2,286,0.0,143.0,143.0,0,0,0.0,0.0,0.0
90256130.0,6,12,1832,8,1016,12893732.857142856,188.0,127.0,4,816,30030525.33333333,204.0,204.0
300301.0,6,6,412,4,272,100100.33333333331,74.0,68.0,2,140,0.0,74.0,70.0
45439.0,6,14,4740,7,653,7396.5,249.0,93.28571428571428,7,4087,6095.666666666667,1514.0,583.8571428571429
5627195.0,6,5,336,2,134,0.0,68.0,67.0,3,202,1420204.0,70.0,67.33333333333333
336.0,17,2,160,1,80,0.0,80.0,80.0,1,80,0.0,80.0,80.0
20700.0,17,2,582,1,83,0.0,83.0,83.0,1,499,0.0,499.0,499.0
108103302.0,17,5,955,5,955,27025825.5,191.0,191.0,0,0,0.0,0.0,0.0
36028.0,6,14,4740,7,653,4669.5,249.0,93.28571428571428,7,4087,5866.0,1514.0,583.8571428571429
101763999.0,6,28,1860,14,966,7811384.769230769,123.0,69.0,14,894,7811384.692307692,123.0,63.85714285714285
14649653.0,6,20,1607,10,975,1593789.7777777778,315.0,97.5,10,632,1593762.111111111,78.0,63.2
108299615.0,17,14,864,7,432,18000162.333333332,174.0,61.71428571428572,7,432,18001528.666666668,174.0,61.71428571428572
103533.0,17,2,286,2,286,0.0,143.0,143.0,0,0,0.0,0.0,0.0
126558481.0,6,32,2220,16,1071,7771329.4,123.0,66.9375,16,1149,7994548.133333334,123.0,71.8125
153455.0,17,2,180,1,90,0.0,90.0,90.0,1,90,0.0,90.0,90.0
108106093.0,17,5,1005,5,1005,27026523.25,201.0,201.0,0,0,0.0,0.0,0.0
120059150.0,6,220,24868,110,7556,1093949.614678899,140.0,68.69090909090909,110,17312,1094897.9816513762,284.0,157.38181818181818
118682559.0,6,37,2656,19,1408,6593475.5,139.0,74.10526315789474,18,1248,6381259.588235294,123.0,69.33333333333333
34521.0,6,14,4740,7,653,4893.0,249.0,93.28571428571428,7,4087,5522.166666666667,1514.0,583.8571428571429
153376.0,17,2,180,1,90,0.0,90.0,90.0,1,90,0.0,90.0,90.0
48361.0,6,14,4740,7,653,7782.0,249.0,93.28571428571428,7,4087,7832.0,1514.0,583.8571428571429
97953577.0,6,177,19938,89,6096,1113108.8295454546,140.0,68.49438202247191,88,13842,1101994.4942528736,284.0,157.29545454545453
462687.0,17,2,363,1,75,0.0,75.0,75.0,1,288,0.0,288.0,288.0
24025753.0,17,3,1026,3,1026,12012876.5,342.0,342.0,0,0,0.0,0.0,0.0
2288191.0,6,3,1602,1,752,0.0,752.0,752.0,2,850,0.0,784.0,425.0
197741.0,17,2,180,1,90,0.0,90.0,90.0,1,90,0.0,90.0,90.0
205523.0,6,3,426,2,280,0.0,214.0,140.0,1,146,0.0,146.0,146.0
119869360.0,17,35,16705,35,16705,3525569.411764706,501.0,477.2857142857143,0,0,0.0,0.0,0.0
34119.0,6,14,4740,7,653,5298.5,249.0,93.28571428571428,7,4087,4771.0,1514.0,583.8571428571429
246075.0,6,3,337,2,214,0.0,160.0,107.0,1,123,0.0,123.0,123.0
205856.0,17,2,180,1,90,0.0,90.0,90.0,1,90,0.0,90.0,90.0
207114.0,6,3,426,2,280,0.0,214.0,140.0,1,146,0.0,146.0,146.0
21850.0,6,14,4740,7,653,3531.0,249.0,93.28571428571428,7,4087,3504.5,1514.0,583.8571428571429
743.0,17,4,438,2,148,0.0,74.0,74.0,2,290,0.0,147.0,145.0
10462135.0,6,7,478,4,272,3441947.0,74.0,68.0,3,206,5162827.5,74.0,68.66666666666667
27579.0,6,14,4740,7,653,4351.5,249.0,93.28571428571428,7,4087,4331.666666666667,1514.0,583.8571428571429
90054739.0,17,28,13364,28,13364,3335360.703703704,501.0,477.2857142857143,0,0,0.0,0.0,0.0
1313801.0,6,4,264,2,132,0.0,66.0,66.0,2,132,0.0,66.0,66.0
46362.0,6,13,1386,7,789,7687.833333333333,253.0,112.71428571428572,6,597,8085.4,259.0,99.5
307689.0,6,6,412,4,272,102563.0,74.0,68.0,2,140,0.0,74.0,70.0
219972.0,6,3,426,2,280,0.0,214.0,140.0,1,146,0.0,146.0,146.0
1051429.0,6,11,1134,6,558,210285.8,220.0,93.0,5,576,261908.75,304.0,115.2
6836.0,17,2,565,1,93,0.0,93.0,93.0,1,472,0.0,472.0,472.0
19198348.0,6,5,1736,2,819,0.0,753.0,409.5,3,917,8491569.5,785.0,305.6666666666667
120003.0,17,2,180,1,70,0.0,70.0,70.0,1,110,0.0,110.0,110.0
41794.0,6,10,2032,5,524,10215.5,252.0,104.8,5,1508,9871.75,1236.0,301.6
144004.0,17,2,180,1,90,0.0,90.0,90.0,1,90,0.0,90.0,90.0
90097282.0,6,11,1644,4,816,30031617.33333333,204.0,204.0,7,828,15015836.666666666,188.0,118.28571428571428
35069.0,6,14,4740,7,653,5735.333333333333,249.0,93.28571428571428,7,4087,5146.5,1514.0,583.8571428571429
120003369.0,6,19,1436,9,691,15000421.125,95.0,76.77777777777777,10,745,13305798.888888888,95.0,74.5
233775.0,6,3,337,2,214,0.0,160.0,107.0,1,123,0.0,123.0,123.0
2730935.0,6,25,7573,14,3735,210071.92307692303,1514.0,266.7857142857143,11,3838,245360.5,1514.0,348.90909090909093
112127223.0,6,30,1990,15,1042,7993658.571428572,139.0,69.46666666666667,15,948,7993661.5,123.0,63.2
121931908.0,6,31,2034,16,1086,8128793.866666666,123.0,67.875,15,948,7980795.357142857,123.0,63.2
1312026.0,17,7,490,7,490,218671.0,70.0,70.0,0,0,0.0,0.0,0.0
8993853.0,6,6,396,3,198,4496926.5,66.0,66.0,3,198,3408493.5,66.0,66.0
0.0,6,1,172,1,172,0.0,172.0,172.0,0,0,0.0,0.0,0.0
212609.0,17,2,180,1,90,0.0,90.0,90.0,1,90,0.0,90.0,90.0
69460.0,17,2,610,1,72,0.0,72.0,72.0,1,538,0.0,538.0,538.0
108105114.0,17,5,955,5,955,27026278.5,191.0,191.0,0,0,0.0,0.0,0.0
121347.0,6,3,337,2,214,0.0,160.0,107.0,1,123,0.0,123.0,123.0
103485.0,6,14,4740,7,653,13861.333333333334,249.0,93.28571428571428,7,4087,17116.5,1514.0,583.8571428571429
90256804.0,6,14,2240,8,1016,12893829.142857144,188.0,127.0,6,1224,18018447.0,204.0,204.0
90054101.0,17,28,13364,28,13364,3335337.074074074,501.0,477.2857142857143,0,0,0.0,0.0,0.0
108107098.0,17,5,1005,5,1005,27026774.5,201.0,201.0,0,0,0.0,0.0,0.0
29981.0,6,14,4740,7,653,4254.666666666667,249.0,93.28571428571428,7,4087,4644.0,1514.0,583.8571428571429
107925.0,6,14,4740,7,653,17011.833333333332,249.0,93.28571428571428,7,4087,17057.5,1514.0,583.8571428571429
52318.0,6,10,2032,5,524,12698.5,252.0,104.8,5,1508,12631.75,1236.0,301.6
209581.0,17,2,180,1,90,0.0,90.0,90.0,1,90,0.0,90.0,90.0
135124039.0,17,6,1206,6,1206,27024807.8,201.0,201.0,0,0,0.0,0.0,0.0
22870.0,6,14,4740,7,653,3184.0,249.0,93.28571428571428,7,4087,3564.333333333333,1514.0,583.8571428571429
216336.0,17,2,180,1,90,0.0,90.0,90.0,1,90,0.0,90.0,90.0
108106176.0,17,5,955,5,955,27026544.0,191.0,191.0,0,0,0.0,0.0,0.0
1302457.0,6,4,264,2,132,0.0,66.0,66.0,2,132,0.0,66.0,66.0
237533.0,17,2,180,1,90,0.0,90.0,90.0,1,90,0.0,90.0,90.0
759.0,17,4,438,2,148,0.0,74.0,74.0,2,290,0.0,147.0,145.0
2008.0,17,4,344,2,150,0.0,75.0,75.0,2,194,0.0,103.0,97.0
114043810.0,6,33,2428,17,1288,7114238.5625,139.0,75.76470588235294,16,1140,7588519.133333334,123.0,71.25
151575.0,17,2,414,1,88,0.0,88.0,88.0,1,326,0.0,326.0,326.0
2848.0,17,2,224,1,76,0.0,76.0,76.0,1,148,0.0,148.0,148.0
40566.0,6,14,4740,7,653,6636.5,249.0,93.28571428571428,7,4087,5357.5,1514.0,583.8571428571429
116004386.0,6,45,3922,26,2206,4631536.88,139.0,84.84615384615384,19,1716,6432693.444444444,123.0,90.3157894736842
10921474.0,6,8,544,4,272,3593359.6666666665,74.0,68.0,4,272,3593289.6666666665,74.0,68.0
308333.0,6,6,412,4,272,102777.66666666669,74.0,68.0,2,140,0.0,74.0,70.0
417890.0,6,3,1604,1,753,0.0,753.0,753.0,2,851,0.0,785.0,425.5
2072.0,17,4,344,2,150,0.0,75.0,75.0,2,194,0.0,103.0,97.0
74633776.0,6,9,842,9,842,9329222.0,97.0,93.55555555555556,0,0,0.0,0.0,0.0
114606282.0,6,47,3102,24,1584,4973502.521739131,66.0,66.0,23,1518,5105432.363636363,66.0,66.0
171681.0,17,2,180,1,90,0.0,90.0,90.0,1,90,0.0,90.0,90.0
1186647.0,6,13,3011,8,2383,169521.0,1514.0,297.875,5,628,227729.75,331.0,125.6
47810188.0,6,8,1940,3,887,22788729.5,753.0,295.6666666666667,5,1053,11257119.75,785.0,210.6
300215.0,6,6,412,4,272,100071.66666666669,74.0,68.0,2,140,0.0,74.0,70.0
90256703.0,6,13,2036,8,1016,12893814.714285716,188.0,127.0,5,1020,22522654.5,204.0,204.0
364675.0,6,3,204,2,136,0.0,70.0,68.0,1,68,0.0,68.0,68.0
136483.0,6,2,132,1,66,0.0,66.0,66.0,1,66,0.0,66.0,66.0
59961.0,6,11,2098,6,590,10854.0,252.0,98.33333333333331,5,1508,7743.75,1236.0,301.6
36493.0,6,14,4740,7,653,5778.166666666667,249.0,93.28571428571428,7,4087,4914.333333333333,1514.0,583.8571428571429
299890.0,6,6,412,4,272,99963.33333333331,74.0,68.0,2,140,0.0,74.0,70.0
24827.0,6,14,4740,7,653,3924.0,249.0,93.28571428571428,7,4087,3607.1666666666665,1514.0,583.8571428571429
1184976.0,6,13,3011,8,2383,169282.2857142857,1514.0,297.875,5,628,227401.25,331.0,125.6
144929.0,17,2,180,1,70,0.0,70.0,70.0,1,110,0.0,110.0,110.0
216501.0,17,2,180,1,90,0.0,90.0,90.0,1,90,0.0,90.0,90.0
113225417.0,6,47,3102,24,1584,4913459.608695652,66.0,66.0,23,1518,5105441.590909091,66.0,66.0
219156.0,6,3,426,2,280,0.0,214.0,140.0,1,146,0.0,146.0,146.0
205858.0,17,2,180,1,90,0.0,90.0,90.0,1,90,0.0,90.0,90.0
107791.0,17,2,762,2,762,0.0,381.0,381.0,0,0,0.0,0.0,0.0
108098020.0,17,5,1005,5,1005,27024505.0,201.0,201.0,0,0,0.0,0.0,0.0
310997.0,17,4,1400,4,1400,103665.66666666669,350.0,350.0,0,0,0.0,0.0,0.0
2102.0,17,4,344,2,150,0.0,75.0,75.0,2,194,0.0,103.0,97.0
2801293.0,6,2,132,1,66,0.0,66.0,66.0,1,66,0.0,66.0,66.0
90302122.0,6,16,1192,8,596,12894036.285714284,95.0,74.5,8,596,12898953.142857144,95.0,74.5
113618935.0,6,48,3168,24,1584,4938535.0869565215,66.0,66.0,24,1584,4937077.956521739,66.0,66.0
55610.0,6,13,1386,7,789,9268.333333333334,253.0,112.71428571428572,6,597,9342.8,259.0,99.5
15798.0,6,10,2032,5,524,3096.75,252.0,104.8,5,1508,3713.5,1236.0,301.6
228155.0,17,2,180,1,90,0.0,90.0,90.0,1,90,0.0,90.0,90.0
91528.0,17,4,1400,4,1400,30509.33333333333,350.0,350.0,0,0,0.0,0.0,0.0
1170143.0,6,13,3010,8,2382,167163.2857142857,1514.0,297.75,5,628,224397.5,331.0,125.6
70793.0,6,14,4740,7,653,11372.833333333334,249.0,93.28571428571428,7,4087,11558.833333333334,1514.0,583.8571428571429
120156.0,17,2,180,1,70,0.0,70.0,70.0,1,110,0.0,110.0,110.0
110142655.0,6,331,39028,166,11178,667531.2424242424,140.0,67.33734939759036,165,27850,665355.7865853659,374.0,168.78787878787878
126837973.0,6,36,2602,19,1408,7046554.055555556,139.0,74.10526315789474,17,1194,7289703.6875,123.0,70.23529411764706
2816502.0,6,2,132,1,66,0.0,66.0,66.0,1,66,0.0,66.0,66.0
10813.0,17,2,582,1,83,0.0,83.0,83.0,1,499,0.0,499.0,499.0
104520.0,17,2,286,2,286,0.0,143.0,143.0,0,0,0.0,0.0,0.0
3078981.0,6,3,204,2,134,0.0,68.0,67.0,1,70,0.0,70.0,70.0
120207414.0,6,219,24754,110,17338,1102820.3119266054,300.0,157.61818181818182,109,7416,1105554.4722222222,140.0,68.03669724770643
10504989.0,6,7,478,4,272,3456484.6666666665,74.0,68.0,3,206,5184639.0,74.0,68.66666666666667
299.0,17,2,156,1,78,0.0,78.0,78.0,1,78,0.0,78.0,78.0
4246.0,17,4,344,2,150,0.0,75.0,75.0,2,194,0.0,103.0,97.0
26691481.0,17,5,1710,5,1710,6672870.25,342.0,342.0,0,0,0.0,0.0,0.0
222263.0,6,3,426,2,280,0.0,214.0,140.0,1,146,0.0,146.0,146.0
99961353.0,17,11,604,6,389,19848349.0,174.0,64.83333333333333,5,215,20000163.75,43.0,43.0
41307.0,6,14,4740,7,653,6727.5,249.0,93.28571428571428,7,4087,6551.166666666667,1514.0,583.8571428571429
120000018.0,6,22,1680,12,935,10909092.545454543,95.0,77.91666666666667,10,745,10105500.111111112,95.0,74.5
2871.0,17,2,224,1,76,0.0,76.0,76.0,1,148,0.0,148.0,148.0
162307.0,17,2,180,1,90,0.0,90.0,90.0,1,90,0.0,90.0,90.0
90025768.0,17,28,13364,28,13364,3334287.703703704,501.0,477.2857142857143,0,0,0.0,0.0,0.0
217801.0,6,3,426,2,280,0.0,214.0,140.0,1,146,0.0,146.0,146.0
239138.0,17,4,1400,4,1400,79712.66666666667,350.0,350.0,0,0,0.0,0.0,0.0
99670100.0,6,30,2122,15,1105,7103875.071428572,139.0,73.66666666666667,15,1017,7103875.785714285,123.0,67.8
90338315.0,6,16,1192,8,596,12899781.0,95.0,74.5,8,596,12902744.57142857,95.0,74.5
300355.0,6,6,412,4,272,100118.33333333331,74.0,68.0,2,140,0.0,74.0,70.0
119858191.0,6,14,2102,5,1020,29963981.5,204.0,204.0,9,1082,14982010.75,188.0,120.22222222222224
24509.0,6,14,4740,7,653,3923.3333333333335,249.0,93.28571428571428,7,4087,3429.333333333333,1514.0,583.8571428571429
51524319.0,6,8,2113,3,960,24438431.5,826.0,320.0,5,1153,12237408.25,885.0,230.6
108102940.0,17,5,955,5,955,27025735.0,191.0,191.0,0,0,0.0,0.0,0.0
2093.0,17,4,344,2,150,0.0,75.0,75.0,2,194,0.0,103.0,97.0
69988.0,6,14,4740,7,653,10694.666666666666,249.0,93.28571428571428,7,4087,11467.666666666666,1514.0,583.8571428571429
9697.0,17,2,571,1,86,0.0,86.0,86.0,1,485,0.0,485.0,485.0
50569.0,6,14,4740,7,653,7968.166666666667,249.0,93.28571428571428,7,4087,6527.0,1514.0,583.8571428571429
10497873.0,6,7,478,4,272,3454035.6666666665,74.0,68.0,3,206,5180937.0,74.0,68.66666666666667
2387.0,17,4,344,2,150,0.0,75.0,75.0,2,194,0.0,103.0,97.0
90043490.0,17,28,13364,28,13364,3334944.074074074,501.0,477.2857142857143,0,0,0.0,0.0,0.0
1472706.0,6,20,7599,11,1469,147270.6,583.0,133.54545454545453,9,6130,152014.25,1484.0,681.1111111111111
113729016.0,6,48,3168,24,1584,4944739.826086956,66.0,66.0,24,1584,4935653.478260869,66.0,66.0
197124.0,17,2,180,1,90,0.0,90.0,90.0,1,90,0.0,90.0,90.0
90734.0,6,14,4740,7,653,14384.333333333334,249.0,93.28571428571428,7,4087,14927.833333333334,1514.0,583.8571428571429
135126321.0,17,6,1146,6,1146,27025264.2,191.0,191.0,0,0,0.0,0.0,0.0
224713.0,17,2,180,1,90,0.0,90.0,90.0,1,90,0.0,90.0,90.0
2803716.0,6,2,132,1,66,0.0,66.0,66.0,1,66,0.0,66.0,66.0
120127007.0,6,216,24424,108,7424,1114972.0560747664,140.0,68.74074074074075,108,17000,1122613.7009345794,284.0,157.40740740740742
108135.0,17,2,700,2,700,0.0,350.0,350.0,0,0,0.0,0.0,0.0
120055846.0,17,29,13785,29,13785,4287708.785714285,501.0,475.3448275862069,0,0,0.0,0.0,0.0
287267.0,6,3,337,2,214,0.0,160.0,107.0,1,123,0.0,123.0,123.0
196933.0,17,2,180,1,90,0.0,90.0,90.0,1,90,0.0,90.0,90.0
847358.0,6,9,1196,6,725,169471.6,387.0,120.83333333333331,3,471,285864.0,331.0,157.0
506917.0,6,5,336,2,134,0.0,68.0,67.0,3,202,192217.5,70.0,67.33333333333333
55618.0,6,14,4740,7,653,8404.0,249.0,93.28571428571428,7,4087,9131.166666666666,1514.0,583.8571428571429
120022494.0,17,29,13785,29,13785,4286517.642857143,501.0,475.3448275862069,0,0,0.0,0.0,0.0
27860.0,6,10,2032,5,524,6737.75,252.0,104.8,5,1508,6697.25,1236.0,301.6
22299.0,6,14,4740,7,653,3513.833333333333,249.0,93.28571428571428,7,4087,3490.5,1514.0,583.8571428571429
172029.0,17,2,180,1,90,0.0,90.0,90.0,1,90,0.0,90.0,90.0
3054801.0,6,4,270,3,202,1527400.5,70.0,67.33333333333333,1,68,0.0,68.0,68.0
5005816.0,17,2,174,2,174,0.0,87.0,87.0,0,0,0.0,0.0,0.0
107536.0,17,2,286,2,286,0.0,143.0,143.0,0,0,0.0,0.0,0.0
10455790.0,6,7,478,4,272,3439801.0,74.0,68.0,3,206,5159586.5,74.0,68.66666666666667
153411.0,17,2,180,1,90,0.0,90.0,90.0,1,90,0.0,90.0,90.0
90296697.0,6,17,1287,9,691,11281158.875,95.0,76.77777777777777,8,596,12831962.857142856,95.0,74.5
43009118.0,6,4,1670,3,917,21504559.0,785.0,305.6666666666667,1,753,0.0,753.0,753.0
0.0,6,1,172,1,172,0.0,172.0,172.0,0,0,0.0,0.0,0.0
102338.0,17,2,762,2,762,0.0,381.0,381.0,0,0,0.0,0.0,0.0
120032720.0,17,29,13785,29,13785,4286882.857142857,501.0,475.3448275862069,0,0,0.0,0.0,0.0
122314502.0,6,48,3168,24,1584,5058918.478260869,66.0,66.0,24,1584,5148830.869565218,66.0,66.0
90036608.0,17,28,13364,28,13364,3334689.185185185,501.0,477.2857142857143,0,0,0.0,0.0,0.0
3344.0,17,2,305,1,87,0.0,87.0,87.0,1,218,0.0,218.0,218.0
363.0,17,2,267,1,83,0.0,83.0,83.0,1,184,0.0,184.0,184.0
2600326.0,6,2,132,1,66,0.0,66.0,66.0,1,66,0.0,66.0,66.0
216415.0,17,2,180,1,90,0.0,90.0,90.0,1,90,0.0,90.0,90.0
153459.0,17,2,180,1,90,0.0,90.0,90.0,1,90,0.0,90.0,90.0
13997.0,6,14,4740,7,653,2126.333333333333,249.0,93.28571428571428,7,4087,2197.5,1514.0,583.8571428571429
1310804.0,6,4,264,2,132,0.0,66.0,66.0,2,132,0.0,66.0,66.0
36888.0,6,14,4740,7,653,6023.5,249.0,93.28571428571428,7,4087,5844.333333333333,1514.0,583.8571428571429
348.0,17,2,166,1,75,0.0,75.0,75.0,1,91,0.0,91.0,91.0
115961041.0,6,48,3168,24,1584,5041784.391304348,66.0,66.0,24,1584,5032378.695652174,66.0,66.0
1307199.0,6,4,264,2,132,0.0,66.0,66.0,2,132,0.0,66.0,66.0
5622695.0,6,5,336,2,134,0.0,68.0,67.0,3,202,1525258.5,70.0,67.33333333333333
111795207.0,6,26,2862,13,1409,9316065.166666666,425.0,108.3846153846154,13,1453,9315395.333333334,359.0,111.76923076923076
90091848.0,6,11,1644,7,828,15015308.0,188.0,118.28571428571428,4,816,20019897.666666668,204.0,204.0
217538.0,6,3,426,2,280,0.0,214.0,140.0,1,146,0.0,146.0,146.0
153393.0,17,2,180,1,90,0.0,90.0,90.0,1,90,0.0,90.0,90.0
109130256.0,17,14,1126,7,563,18161892.83333333,174.0,80.42857142857143,7,563,18161890.166666668,174.0,80.42857142857143
124001419.0,17,15,907,8,475,17714488.42857143,174.0,59.375,7,432,17335512.666666668,174.0,61.71428571428572
249917.0,6,3,337,2,214,0.0,160.0,107.0,1,123,0.0,123.0,123.0
4903.0,17,2,180,1,90,0.0,90.0,90.0,1,90,0.0,90.0,90.0
199871.0,17,2,180,1,90,0.0,90.0,90.0,1,90,0.0,90.0,90.0
208285.0,6,3,426,2,280,0.0,214.0,140.0,1,146,0.0,146.0,146.0
103262.0,17,2,286,2,286,0.0,143.0,143.0,0,0,0.0,0.0,0.0
106952.0,17,2,286,2,286,0.0,143.0,143.0,0,0,0.0,0.0,0.0
135120404.0,17,6,1206,6,1206,27024080.8,201.0,201.0,0,0,0.0,0.0,0.0
111007092.0,6,35,2526,18,1332,6517141.529411765,123.0,74.0,17,1194,6924464.875,123.0,70.23529411764706
135126841.0,17,6,1146,6,1146,27025368.2,191.0,191.0,0,0,0.0,0.0,0.0
1304.0,17,2,762,2,762,0.0,381.0,381.0,0,0,0.0,0.0,0.0
90303549.0,6,19,1436,10,745,10028252.222222222,95.0,74.5,9,691,11286502.125,95.0,76.77777777777777
99698.0,17,2,762,2,762,0.0,381.0,381.0,0,0,0.0,0.0,0.0
101944960.0,6,188,21204,94,6426,1087351.2903225806,140.0,68.36170212765957,94,14778,1087298.2688172045,284.0,157.2127659574468
90302933.0,6,23,1775,13,989,7521461.166666667,95.0,76.07692307692308,10,786,9979898.666666666,95.0,78.6
115916.0,17,4,1400,4,1400,38638.66666666666,350.0,350.0,0,0,0.0,0.0,0.0
120233876.0,6,22,1639,11,840,11999590.1,95.0,76.36363636363636,11,799,11999005.9,95.0,72.63636363636364
2161.0,17,4,344,2,150,0.0,75.0,75.0,2,194,0.0,103.0,97.0
90756591.0,6,17,1287,9,691,11338546.875,95.0,76.77777777777777,8,596,12964660.714285716,95.0,74.5
1568020.0,6,4,276,2,128,0.0,74.0,64.0,2,148,0.0,74.0,74.0
108106015.0,17,5,955,5,955,27026503.75,191.0,191.0,0,0,0.0,0.0,0.0
1314914.0,6,4,264,2,132,0.0,66.0,66.0,2,132,0.0,66.0,66.0
61794.0,6,10,2032,5,524,15217.25,252.0,104.8,5,1508,14381.5,1236.0,301.6
100700264.0,6,30,2122,15,1105,7177445.5,139.0,73.66666666666667,15,1017,7177446.642857143,123.0,67.8
311228.0,6,6,412,4,272,103742.66666666669,74.0,68.0,2,140,0.0,74.0,70.0
0.0,17,1,90,1,90,0.0,90.0,90.0,0,0,0.0,0.0,0.0
497382.0,6,5,336,2,134,0.0,68.0,67.0,3,202,193183.5,70.0,67.33333333333333
110134632.0,6,28,1860,14,966,8455270.153846154,123.0,69.0,14,894,8455276.0,123.0,63.85714285714285
108109251.0,17,5,955,5,955,27027312.75,191.0,191.0,0,0,0.0,0.0,0.0
312675.0,17,2,180,1,90,0.0,90.0,90.0,1,90,0.0,90.0,90.0
108101115.0,17,5,1005,5,1005,27025278.75,201.0,201.0,0,0,0.0,0.0,0.0
119768107.0,17,35,16705,35,16705,3522591.382352941,501.0,477.2857142857143,0,0,0.0,0.0,0.0
135130913.0,17,6,1206,6,1206,27026182.6,201.0,201.0,0,0,0.0,0.0,0.0
113148074.0,6,48,3168,24,1584,4919481.478260869,66.0,66.0,24,1584,4910082.739130435,66.0,66.0
121190.0,6,3,337,2,214,0.0,160.0,107.0,1,123,0.0,123.0,123.0
122530492.0,6,49,3234,25,1650,5105437.166666667,66.0,66.0,24,1584,5129577.608695652,66.0,66.0
15229.0,6,13,1459,7,862,2282.1666666666665,271.0,123.14285714285714,6,597,2854.6,259.0,99.5
35383.0,6,14,4740,7,653,5724.166666666667,249.0,93.28571428571428,7,4087,5759.0,1514.0,583.8571428571429
90046059.0,17,27,12943,27,12943,3463309.961538461,501.0,479.3703703703704,0,0,0.0,0.0,0.0
90649561.0,17,12,778,6,389,18001298.0,174.0,64.83333333333333,6,389,18000168.8,174.0,64.83333333333333
162241.0,17,2,180,1,90,0.0,90.0,90.0,1,90,0.0,90.0,90.0
98452.0,6,14,4740,7,653,16236.166666666666,249.0,93.28571428571428,7,4087,13177.0,1514.0,583.8571428571429
2822763.0,6,11,2106,6,598,564380.2,252.0,99.66666666666669,5,1508,2982.0,1236.0,301.6
66107.0,17,2,180,1,90,0.0,90.0,90.0,1,90,0.0,90.0,90.0
116583714.0,6,230,26010,115,18198,1020764.947368421,284.0,158.24347826086955,115,7812,1020766.1403508772,140.0,67.9304347826087
285422.0,6,10,1221,6,636,57084.4,298.0,106.0,4,585,88272.0,379.0,146.25
120125461.0,6,240,27104,120,8142,1002502.462184874,140.0,67.85,120,18962,1003373.7310924368,284.0,158.01666666666668
135132430.0,17,6,1206,6,1206,27026486.0,201.0,201.0,0,0,0.0,0.0,0.0
304389.0,6,6,412,4,272,101463.0,74.0,68.0,2,140,0.0,74.0,70.0
17587.0,6,12,1393,6,796,3385.8,271.0,132.66666666666666,6,597,3270.0,259.0,99.5
120121652.0,6,14,2240,6,1224,24024330.4,204.0,204.0,8,1016,17136732.57142857,188.0,127.0
115902811.0,6,34,2472,18,1332,6805773.176470588,123.0,74.0,16,1140,7713224.133333334,123.0,71.25
298270.0,6,6,412,4,272,99423.33333333331,74.0,68.0,2,140,0.0,74.0,70.0
5634.0,17,2,180,1,90,0.0,90.0,90.0,1,90,0.0,90.0,90.0
90035017.0,17,28,13364,28,13364,3334630.25925926,501.0,477.2857142857143,0,0,0.0,0.0,0.0
2475.0,17,4,344,2,150,0.0,75.0,75.0,2,194,0.0,103.0,97.0
35204.0,6,14,4740,7,653,5550.5,249.0,93.28571428571428,7,4087,4974.333333333333,1514.0,583.8571428571429
90036993.0,17,28,13364,28,13364,3334703.4444444445,501.0,477.2857142857143,0,0,0.0,0.0,0.0
135132544.0,17,6,1146,6,1146,27026508.8,191.0,191.0,0,0,0.0,0.0,0.0
46593.0,6,2,132,1,66,0.0,66.0,66.0,1,66,0.0,66.0,66.0
0.0,17,1,44,1,44,0.0,44.0,44.0,0,0,0.0,0.0,0.0
90034296.0,17,28,13364,28,13364,3334603.5555555555,501.0,477.2857142857143,0,0,0.0,0.0,0.0
966199.0,6,12,1362,6,731,191716.2,253.0,121.83333333333331,6,631,192749.4,293.0,105.16666666666669
211231.0,17,2,180,1,90,0.0,90.0,90.0,1,90,0.0,90.0,90.0
200443.0,17,4,6056,4,6056,66814.33333333333,1514.0,1514.0,0,0,0.0,0.0,0.0
128898519.0,6,35,2394,18,1269,7582265.823529412,123.0,70.5,17,1125,7418581.8125,123.0,66.17647058823529
300513.0,6,6,412,4,272,100171.0,74.0,68.0,2,140,0.0,74.0,70.0
298230.0,6,6,412,4,272,99410.0,74.0,68.0,2,140,0.0,74.0,70.0
90366618.0,6,13,2052,6,1224,18071928.8,204.0,204.0,7,828,15060705.5,188.0,118.28571428571428
122030.0,6,3,373,2,238,0.0,172.0,119.0,1,135,0.0,135.0,135.0
356.0,17,2,214,1,75,0.0,75.0,75.0,1,139,0.0,139.0,139.0
213812.0,6,3,426,2,280,0.0,214.0,140.0,1,146,0.0,146.0,146.0
207049.0,6,3,426,2,280,0.0,214.0,140.0,1,146,0.0,146.0,146.0
107861224.0,6,46,3832,24,2023,4689618.434782608,139.0,84.29166666666667,22,1809,5126490.714285715,123.0,82.22727272727273
2343.0,17,4,344,2,150,0.0,75.0,75.0,2,194,0.0,103.0,97.0
206559.0,6,4,492,2,280,0.0,214.0,140.0,2,212,0.0,146.0,106.0
481007.0,17,2,363,1,79,0.0,79.0,79.0,1,284,0.0,284.0,284.0
328.0,17,2,166,1,75,0.0,75.0,75.0,1,91,0.0,91.0,91.0
323800.0,17,4,1400,4,1400,107933.33333333331,350.0,350.0,0,0,0.0,0.0,0.0
90768189.0,6,20,1531,11,840,9072374.8,95.0,76.36363636363636,9,691,11345259.25,95.0,76.77777777777777
219026.0,6,3,426,2,280,0.0,214.0,140.0,1,146,0.0,146.0,146.0
213726.0,17,2,180,1,90,0.0,90.0,90.0,1,90,0.0,90.0,90.0
196966.0,17,2,180,1,90,0.0,90.0,90.0,1,90,0.0,90.0,90.0
234104.0,6,3,373,2,238,0.0,172.0,119.0,1,135,0.0,135.0,135.0
64712.00000000001,6,10,2032,5,524,15959.75,252.0,104.8,5,1508,13872.75,1236.0,301.6
204841.0,17,2,180,1,90,0.0,90.0,90.0,1,90,0.0,90.0,90.0
115764328.0,6,34,2334,17,1209,7221776.0625,123.0,71.11764705882354,17,1125,7221780.1875,123.0,66.17647058823529
114185120.0,6,48,3168,24,1584,4964570.434782608,66.0,66.0,24,1584,4951323.782608695,66.0,66.0
218702.0,6,10,1221,6,636,43740.4,298.0,106.0,4,585,71651.66666666667,379.0,146.25
101000976.0,17,13,821,7,432,16833496.0,174.0,61.71428571428572,6,389,16401019.6,174.0,64.83333333333333
930307.0,6,12,2717,7,742,155051.16666666666,338.0,106.0,5,1975,163542.0,1514.0,395.0
153192.0,6,3,373,2,238,0.0,172.0,119.0,1,135,0.0,135.0,135.0
122590785.0,17,14,864,7,432,17166816.166666668,174.0,61.71428571428572,7,432,17167758.833333332,174.0,61.71428571428572
90258337.0,6,14,2240,8,1016,12894048.142857144,188.0,127.0,6,1224,18018009.6,204.0,204.0
246187.0,6,3,337,2,214,0.0,160.0,107.0,1,123,0.0,123.0,123.0
310106.0,6,6,412,4,272,103368.66666666669,74.0,68.0,2,140,0.0,74.0,70.0
108109244.0,17,5,1005,5,1005,27027311.0,201.0,201.0,0,0,0.0,0.0,0.0
207187.0,6,3,426,2,280,0.0,214.0,140.0,1,146,0.0,146.0,146.0
108106917.0,17,5,1005,5,1005,27026729.25,201.0,201.0,0,0,0.0,0.0,0.0
9971.0,17,2,582,1,83,0.0,83.0,83.0,1,499,0.0,499.0,499.0
72402.0,6,14,4740,7,653,11892.5,249.0,93.28571428571428,7,4087,10045.333333333334,1514.0,583.8571428571429
48482.0,6,14,4740,7,653,7367.0,249.0,93.28571428571428,7,4087,7673.333333333333,1514.0,583.8571428571429
307852.0,6,6,412,4,272,102617.33333333331,74.0,68.0,2,140,0.0,74.0,70.0
120070122.0,17,29,13785,29,13785,4288218.642857143,501.0,475.3448275862069,0,0,0.0,0.0,0.0
100994591.0,6,197,22158,99,6756,1030557.0510204082,140.0,68.24242424242425,98,15402,1030489.3092783506,284.0,157.16326530612244
241047.0,6,3,337,2,214,0.0,160.0,107.0,1,123,0.0,123.0,123.0
201762.0,17,2,180,1,90,0.0,90.0,90.0,1,90,0.0,90.0,90.0
513683.0,6,5,336,2,134,0.0,68.0,67.0,3,202,178796.0,70.0,67.33333333333333
120019495.0,17,29,13785,29,13785,4286410.535714285,501.0,475.3448275862069,0,0,0.0,0.0,0.0
303108.0,6,2,132,1,66,0.0,66.0,66.0,1,66,0.0,66.0,66.0
27640172.0,17,5,1710,5,1710,6910043.0,342.0,342.0,0,0,0.0,0.0,0.0
2074490.0,6,37,15535,19,10912,115249.44444444444,1514.0,574.3157894736842,18,4623,109384.4705882353,1514.0,256.8333333333333
316369.0,17,4,1400,4,1400,105456.33333333331,350.0,350.0,0,0,0.0,0.0,0.0
311882.0,6,6,412,4,272,103960.66666666669,74.0,68.0,2,140,0.0,74.0,70.0
92971650.0,6,174,19714,87,13750,1078562.0813953488,300.0,158.04597701149424,87,5964,1078563.046511628,140.0,68.55172413793103
65448.99999999999,6,14,4740,7,653,10603.5,249.0,93.28571428571428,7,4087,9794.0,1514.0,583.8571428571429
108605247.0,17,16,1212,8,606,15492329.57142857,174.0,75.75,8,606,15504295.857142856,174.0,75.75
108109842.0,17,5,1005,5,1005,27027460.5,201.0,201.0,0,0,0.0,0.0,0.0
1815.0,17,2,176,1,80,0.0,80.0,80.0,1,96,0.0,96.0,96.0
217301.0,17,2,180,1,90,0.0,90.0,90.0,1,90,0.0,90.0,90.0
309305.0,6,6,412,4,272,103101.66666666669,74.0,68.0,2,140,0.0,74.0,70.0
310712.0,17,4,1400,4,1400,103570.66666666669,350.0,350.0,0,0,0.0,0.0,0.0
10869309.0,6,8,544,4,272,3577741.333333333,74.0,68.0,4,272,3577658.0,74.0,68.0
314311.0,6,3,202,2,128,0.0,74.0,64.0,1,74,0.0,74.0,74.0
315333.0,17,4,1400,4,1400,105111.0,350.0,350.0,0,0,0.0,0.0,0.0
128044008.0,6,31,2034,16,1086,8536267.2,123.0,67.875,15,948,8417253.57142857,123.0,63.2
90030102.0,17,28,13364,28,13364,3334448.222222222,501.0,477.2857142857143,0,0,0.0,0.0,0.0
120113755.0,6,640,81578,320,60162,375853.9874608151,480.0,188.00625,320,21416,375857.3699059561,140.0,66.925
9747923.0,6,5,1736,2,819,0.0,753.0,409.5,3,917,4801142.0,785.0,305.6666666666667
90532091.0,6,14,2240,8,1016,12933155.857142856,188.0,127.0,6,1224,18074137.6,204.0,204.0
120506407.0,6,31,2050,16,1102,8033760.466666667,139.0,68.875,15,948,7878890.0,123.0,63.2
108096176.0,17,5,1005,5,1005,27024044.0,201.0,201.0,0,0,0.0,0.0,0.0
120061278.0,17,28,13364,28,13364,4446714.0,501.0,477.2857142857143,0,0,0.0,0.0,0.0
2157.0,17,4,344,2,150,0.0,75.0,75.0,2,194,0.0,103.0,97.0
211048.0,6,10,1221,6,636,42209.6,298.0,106.0,4,585,69240.33333333333,379.0,146.25
120193095.0,6,905,175592,447,30094,269491.24439461884,214.0,67.32438478747204,458,145498,262508.01750547043,1514.0,317.6812227074236
108484.0,17,2,286,2,286,0.0,143.0,143.0,0,0,0.0,0.0,0.0
90095506.0,6,12,1848,5,1020,22523260.75,204.0,204.0,7,828,15015408.5,188.0,118.28571428571428
135132563.0,17,6,1146,6,1146,27026512.6,191.0,191.0,0,0,0.0,0.0,0.0
148034.0,17,2,180,1,90,0.0,90.0,90.0,1,90,0.0,90.0,90.0
90217851.0,6,16,1192,8,596,12852999.0,95.0,74.5,8,596,12857503.285714284,95.0,74.5
2493.0,17,4,344,2,150,0.0,75.0,75.0,2,194,0.0,103.0,97.0
51274.0,6,10,2032,5,524,11147.25,252.0,104.8,5,1508,11393.5,1236.0,301.6
112339630.0,6,37,2656,19,1408,6229088.611111111,139.0,74.10526315789474,18,1248,6595505.352941177,123.0,69.33333333333333
317069.0,17,4,1400,4,1400,105689.66666666669,350.0,350.0,0,0,0.0,0.0,0.0
108104447.0,17,5,955,5,955,27026111.75,191.0,191.0,0,0,0.0,0.0,0.0
97533258.0,17,15,5138,14,4788,5731635.384615385,342.0,342.0,1,350,0.0,350.0,350.0
53128.0,6,10,2032,5,524,11997.0,252.0,104.8,5,1508,11232.75,1236.0,301.6
135128865.0,17,6,1206,6,1206,27025773.0,201.0,201.0,0,0,0.0,0.0,0.0
33542.0,6,14,4740,7,653,5464.833333333333,249.0,93.28571428571428,7,4087,5424.166666666667,1514.0,583.8571428571429
61350.0,6,10,2032,5,524,13708.5,252.0,104.8,5,1508,14410.5,1236.0,301.6
308086.0,6,6,412,4,272,102695.33333333331,74.0,68.0,2,140,0.0,74.0,70.0
153420.0,17,2,180,1,90,0.0,90.0,90.0,1,90,0.0,90.0,90.0
135137046.0,17,6,1206,6,1206,27027409.2,201.0,201.0,0,0,0.0,0.0,0.0
402.0,17,2,410,1,78,0.0,78.0,78.0,1,332,0.0,332.0,332.0
18188.0,6,10,2032,5,524,4319.5,252.0,104.8,5,1508,4295.5,1236.0,301.6
108114257.0,17,5,1005,5,1005,27028564.25,201.0,201.0,0,0,0.0,0.0,0.0
0.0,17,1,381,1,381,0.0,381.0,381.0,0,0,0.0,0.0,0.0
170914.0,17,2,180,1,90,0.0,90.0,90.0,1,90,0.0,90.0,90.0
2266.0,17,4,344,2,150,0.0,75.0,75.0,2,194,0.0,103.0,97.0
120461692.0,6,19,1563,9,818,12580314.25,222.0,90.88888888888889,10,745,13356670.333333334,95.0,74.5
206282.0,6,3,426,2,280,0.0,214.0,140.0,1,146,0.0,146.0,146.0
707.0,17,4,438,2,148,0.0,74.0,74.0,2,290,0.0,147.0,145.0
97660365.0,6,28,2008,14,1045,7496605.384615385,139.0,74.64285714285714,14,963,7496607.461538462,123.0,68.78571428571429
75232.0,6,14,4740,7,653,12407.333333333334,249.0,93.28571428571428,7,4087,8136.833333333333,1514.0,583.8571428571429
298292.0,6,6,412,4,272,99430.66666666669,74.0,68.0,2,140,0.0,74.0,70.0
50862.0,6,14,4740,7,653,8264.333333333334,249.0,93.28571428571428,7,4087,8301.333333333334,1514.0,583.8571428571429
121593.0,6,3,337,2,214,0.0,160.0,107.0,1,123,0.0,123.0,123.0
228249.0,17,2,180,1,90,0.0,90.0,90.0,1,90,0.0,90.0,90.0
90095047.0,6,11,1644,4,816,30031207.666666668,204.0,204.0,7,828,15015248.833333334,188.0,118.28571428571428
3170790.0,6,18,1495,9,921,358358.625,315.0,102.33333333333331,9,574,358326.25,78.0,63.77777777777778
108110088.0,17,5,955,5,955,27027522.0,191.0,191.0,0,0,0.0,0.0,0.0
297952.0,6,6,412,4,272,99317.33333333331,74.0,68.0,2,140,0.0,74.0,70.0
103207.0,17,2,286,2,286,0.0,143.0,143.0,0,0,0.0,0.0,0.0
51348.0,6,14,4740,7,653,7823.5,249.0,93.28571428571428,7,4087,8313.833333333334,1514.0,583.8571428571429
150837.0,17,2,180,1,90,0.0,90.0,90.0,1,90,0.0,90.0,90.0
4697.0,17,2,610,1,72,0.0,72.0,72.0,1,538,0.0,538.0,538.0
298.0,17,2,156,1,78,0.0,78.0,78.0,1,78,0.0,78.0,78.0
303968.0,6,6,412,4,272,101322.66666666669,74.0,68.0,2,140,0.0,74.0,70.0
383.0,17,2,176,1,88,0.0,88.0,88.0,1,88,0.0,88.0,88.0
104340.0,17,2,286,2,286,0.0,143.0,143.0,0,0,0.0,0.0,0.0
2682949.0,6,28,9195,16,3843,178863.26666666666,1514.0,240.1875,12,5352,219820.2727272728,1514.0,446.0
206486.0,17,2,762,2,762,0.0,381.0,381.0,0,0,0.0,0.0,0.0
110999129.0,6,32,2220,16,1149,7385535.866666666,123.0,71.8125,16,1071,7385474.533333333,123.0,66.9375
27834.0,6,14,4740,7,653,4463.0,249.0,93.28571428571428,7,4087,4451.0,1514.0,583.8571428571429
2054.0,17,4,344,2,150,0.0,75.0,75.0,2,194,0.0,103.0,97.0
2549638.0,6,25,7573,14,3735,196126.0,1514.0,266.7857142857143,11,3838,227881.8,1514.0,348.90909090909093
135127330.0,17,6,1146,6,1146,27025466.0,191.0,191.0,0,0,0.0,0.0,0.0
120425013.0,6,312,38780,156,10592,771627.5225806452,140.0,67.8974358974359,156,28188,776857.4709677419,300.0,180.69230769230768
209454.0,17,2,180,1,90,0.0,90.0,90.0,1,90,0.0,90.0,90.0
957625.0,6,13,1479,7,882,159604.16666666666,291.0,126.0,6,597,189135.0,259.0,99.5
108107539.0,17,5,1005,5,1005,27026884.75,201.0,201.0,0,0,0.0,0.0,0.0
118661933.0,6,234,26422,117,18404,1021092.7844827586,284.0,157.2991452991453,117,8018,1021092.7155172414,140.0,68.52991452991454
5717.0,17,2,239,1,82,0.0,82.0,82.0,1,157,0.0,157.0,157.0
220684.0,17,4,6056,4,6056,73561.33333333333,1514.0,1514.0,0,0,0.0,0.0,0.0
66361.0,6,14,4740,7,653,10899.5,249.0,93.28571428571428,7,4087,10904.833333333334,1514.0,583.8571428571429
120044022.0,17,28,13364,28,13364,4446074.888888889,501.0,477.2857142857143,0,0,0.0,0.0,0.0
205510.0,17,2,762,2,762,0.0,381.0,381.0,0,0,0.0,0.0,0.0
72631470.0,6,9,842,9,842,9078933.75,97.0,93.55555555555556,0,0,0.0,0.0,0.0
316968.0,17,4,1400,4,1400,105656.0,350.0,350.0,0,0,0.0,0.0,0.0
183.0,6,2,169,2,169,0.0,103.0,84.5,0,0,0.0,0.0,0.0
302031.0,6,6,412,4,272,100677.0,74.0,68.0,2,140,0.0,74.0,70.0
44662.0,6,12,1320,6,723,8324.2,253.0,120.5,6,597,8042.4,259.0,99.5
47808.0,6,14,4740,7,653,7482.166666666667,249.0,93.28571428571428,7,4087,5690.333333333333,1514.0,583.8571428571429
17833.0,6,14,4740,7,653,2845.833333333333,249.0,93.28571428571428,7,4087,2839.6666666666665,1514.0,583.8571428571429
90292082.0,6,14,2102,8,1016,12898868.857142856,188.0,127.0,6,1086,18025830.2,204.0,181.0
60262.0,6,10,2032,5,524,14823.75,252.0,104.8,5,1508,13278.5,1236.0,301.6
18648.0,6,10,2032,5,524,4246.5,252.0,104.8,5,1508,4496.75,1236.0,301.6
108109451.0,17,5,955,5,955,27027362.75,191.0,191.0,0,0,0.0,0.0,0.0
307421.0,6,6,412,4,272,102473.66666666669,74.0,68.0,2,140,0.0,74.0,70.0
36000.0,6,10,2032,5,524,7611.75,252.0,104.8,5,1508,6454.0,1236.0,301.6
32665.0,6,13,4416,6,409,6390.8,127.0,68.16666666666667,7,4007,5210.5,1514.0,572.4285714285714
67347.0,6,14,4740,7,653,10723.5,249.0,93.28571428571428,7,4087,10017.666666666666,1514.0,583.8571428571429
207134.0,17,2,180,1,90,0.0,90.0,90.0,1,90,0.0,90.0,90.0
147988.0,17,2,180,1,90,0.0,90.0,90.0,1,90,0.0,90.0,90.0
5605789.0,6,5,336,2,134,0.0,68.0,67.0,3,202,1422139.5,70.0,67.33333333333333
9217.0,17,2,539,1,86,0.0,86.0,86.0,1,453,0.0,453.0,453.0
81366.0,6,10,2032,5,524,19543.75,252.0,104.8,5,1508,19907.5,1236.0,301.6
216650.0,6,3,426,2,280,0.0,214.0,140.0,1,146,0.0,146.0,146.0
120011106.0,6,27,2073,15,1179,8571420.285714285,95.0,78.6,12,894,10875980.545454543,95.0,74.5
42850.0,6,14,4740,7,653,6435.0,249.0,93.28571428571428,7,4087,6977.333333333333,1514.0,583.8571428571429
331061.0,6,3,204,2,136,0.0,70.0,68.0,1,68,0.0,68.0,68.0
38763.0,6,13,1386,7,789,6460.5,253.0,112.71428571428572,6,597,7171.8,259.0,99.5
247027.0,6,3,373,2,238,0.0,172.0,119.0,1,135,0.0,135.0,135.0
110943543.0,6,32,2220,16,1149,7381859.733333333,123.0,71.8125,16,1071,7381859.066666666,123.0,66.9375
216842.0,6,3,426,2,280,0.0,214.0,140.0,1,146,0.0,146.0,146.0
46887.0,6,10,2032,5,524,7504.25,252.0,104.8,5,1508,10757.75,1236.0,301.6
0.0,6,1,66,1,66,0.0,66.0,66.0,0,0,0.0,0.0,0.0
90254893.0,6,13,2036,8,1016,12893556.142857144,188.0,127.0,5,1020,22522356.25,204.0,204.0
17360.0,6,14,4740,7,653,2779.0,249.0,93.28571428571428,7,4087,2756.6666666666665,1514.0,583.8571428571429
108110381.0,17,5,955,5,955,27027595.25,191.0,191.0,0,0,0.0,0.0,0.0
90220512.0,6,16,1192,8,596,12853542.0,95.0,74.5,8,596,12857866.0,95.0,74.5
305278.0,17,4,704,2,148,0.0,74.0,74.0,2,556,0.0,280.0,278.0
48549.0,6,14,4740,7,653,7923.333333333333,249.0,93.28571428571428,7,4087,7955.666666666667,1514.0,583.8571428571429
250268.0,6,3,337,2,214,0.0,160.0,107.0,1,123,0.0,123.0,123.0
98271718.0,17,12,778,6,389,19600925.2,174.0,64.83333333333333,6,389,19600161.6,174.0,64.83333333333333
1425961.0,17,16,1120,16,1120,95064.06666666668,70.0,70.0,0,0,0.0,0.0,0.0
2453.0,17,4,344,2,150,0.0,75.0,75.0,2,194,0.0,103.0,97.0
83065.0,6,10,1065,5,534,20533.0,262.0,106.8,5,531,17887.75,259.0,106.2
0.0,6,1,54,0,0,0.0,0.0,0.0,1,54,0.0,54.0,54.0
258727.0,6,10,1221,6,636,51745.4,298.0,106.0,4,585,80407.0,379.0,146.25
39780.0,6,14,4740,7,653,5728.333333333333,249.0,93.28571428571428,7,4087,6040.5,1514.0,583.8571428571429
91131149.0,6,21,1626,11,840,9089537.3,95.0,76.36363636363636,10,786,10125135.0,95.0,78.6
2595196.0,6,2,132,1,66,0.0,66.0,66.0,1,66,0.0,66.0,66.0
19307.0,17,2,180,1,90,0.0,90.0,90.0,1,90,0.0,90.0,90.0
103021.0,17,2,286,2,286,0.0,143.0,143.0,0,0,0.0,0.0,0.0
505899.0,6,3,1604,1,753,0.0,753.0,753.0,2,851,0.0,785.0,425.5
2169.0,17,2,180,1,90,0.0,90.0,90.0,1,90,0.0,90.0,90.0
305032.0,6,6,412,4,272,101677.33333333331,74.0,68.0,2,140,0.0,74.0,70.0
90255674.0,6,13,2036,8,1016,12893667.714285716,188.0,127.0,5,1020,22521959.75,204.0,204.0
2383.0,17,4,344,2,150,0.0,75.0,75.0,2,194,0.0,103.0,97.0
1286664.0,17,7,490,7,490,214444.0,70.0,70.0,0,0,0.0,0.0,0.0
209880.0,17,2,180,1,90,0.0,90.0,90.0,1,90,0.0,90.0,90.0
4513101.0,6,5,1736,2,819,0.0,753.0,409.5,3,917,963089.5,785.0,305.6666666666667
143978.0,17,2,180,1,90,0.0,90.0,90.0,1,90,0.0,90.0,90.0
499539.0,6,2,132,1,66,0.0,66.0,66.0,1,66,0.0,66.0,66.0
113926617.0,6,47,3102,24,1584,4953320.043478261,66.0,66.0,23,1518,5143992.954545454,66.0,66.0
90031920.0,17,28,13364,28,13364,3334515.5555555555,501.0,477.2857142857143,0,0,0.0,0.0,0.0
1302571.0,6,4,264,2,132,0.0,66.0,66.0,2,132,0.0,66.0,66.0
48876.0,6,14,4740,7,653,7575.5,249.0,93.28571428571428,7,4087,6566.5,1514.0,583.8571428571429
108097100.0,17,5,1005,5,1005,27024275.0,201.0,201.0,0,0,0.0,0.0,0.0
120137550.0,6,243,27408,122,8274,992872.3140495868,140.0,67.81967213114754,121,19134,999400.225,284.0,158.13223140495867
906574.0,6,10,1334,6,797,181314.8,459.0,132.83333333333334,4,537,210437.3333333333,331.0,134.25
113618162.0,6,46,3036,23,1518,5150440.863636363,66.0,66.0,23,1518,5150441.181818182,66.0,66.0
46533.0,6,10,2032,5,524,10765.0,252.0,104.8,5,1508,11209.25,1236.0,301.6
78939.0,6,10,2032,5,524,19480.75,252.0,104.8,5,1508,6782.5,1236.0,301.6
2626317.0,6,154,127975,88,119774,26738.93103448276,1510.0,1361.0681818181818,66,8201,35791.16923076923,1510.0,124.25757575757576
41486.0,6,14,4740,7,653,6761.0,249.0,93.28571428571428,7,4087,6354.0,1514.0,583.8571428571429
69216.0,6,14,4740,7,653,10037.333333333334,249.0,93.28571428571428,7,4087,9576.833333333334,1514.0,583.8571428571429
2599886.0,6,2,132,1,66,0.0,66.0,66.0,1,66,0.0,66.0,66.0
5830102.0,6,5,336,2,134,0.0,68.0,67.0,3,202,1523071.0,70.0,67.33333333333333
54560.0,6,14,4740,7,653,8962.333333333334,249.0,93.28571428571428,7,4087,8371.333333333334,1514.0,583.8571428571429
90262169.0,6,12,1832,8,1016,12894595.57142857,188.0,127.0,4,816,30030510.33333333,204.0,204.0
135129632.0,17,6,1206,6,1206,27025926.4,201.0,201.0,0,0,0.0,0.0,0.0
228262.0,17,2,180,1,90,0.0,90.0,90.0,1,90,0.0,90.0,90.0
362536.0,6,11,1021,6,444,48737.8,162.0,74.0,5,577,60720.25,349.0,115.4
2360.0,17,4,344,2,150,0.0,75.0,75.0,2,194,0.0,103.0,97.0
100073.0,17,2,762,2,762,0.0,381.0,381.0,0,0,0.0,0.0,0.0
818.0,17,4,438,2,148,0.0,74.0,74.0,2,290,0.0,147.0,145.0
111427.0,17,2,286,2,286,0.0,143.0,143.0,0,0,0.0,0.0,0.0
10466487.0,6,7,478,4,272,3443351.0,74.0,68.0,3,206,5164927.5,74.0,68.66666666666667
90060935.0,17,28,13364,28,13364,3335590.185185185,501.0,477.2857142857143,0,0,0.0,0.0,0.0
109768.0,17,2,286,2,286,0.0,143.0,143.0,0,0,0.0,0.0,0.0
334.0,17,2,166,1,75,0.0,75.0,75.0,1,91,0.0,91.0,91.0
1015.0,17,2,508,2,508,0.0,257.0,254.0,0,0,0.0,0.0,0.0
216740.0,6,3,426,2,280,0.0,214.0,140.0,1,146,0.0,146.0,146.0
510209.0,6,5,336,2,134,0.0,68.0,67.0,3,202,195476.5,70.0,67.33333333333333
8260.0,17,3,1026,3,1026,4130.0,342.0,342.0,0,0,0.0,0.0,0.0
103004930.0,17,13,821,7,432,17167488.333333332,174.0,61.71428571428572,6,389,16600175.6,174.0,64.83333333333333
216347.0,17,2,180,1,90,0.0,90.0,90.0,1,90,0.0,90.0,90.0
38053.0,6,12,1320,6,723,6678.6,253.0,120.5,6,597,6523.2,259.0,99.5
196954.0,17,2,180,1,90,0.0,90.0,90.0,1,90,0.0,90.0,90.0
1302525.0,6,4,264,2,132,0.0,66.0,66.0,2,132,0.0,66.0,66.0
367.0,17,2,160,1,80,0.0,80.0,80.0,1,80,0.0,80.0,80.0
314469.0,17,4,1400,4,1400,104823.0,350.0,350.0,0,0,0.0,0.0,0.0
143817.0,17,2,180,1,90,0.0,90.0,90.0,1,90,0.0,90.0,90.0
23578.0,6,10,2032,5,524,5486.0,252.0,104.8,5,1508,5151.5,1236.0,301.6
9561.0,17,2,582,1,83,0.0,83.0,83.0,1,499,0.0,499.0,499.0
198141.0,17,2,180,1,90,0.0,90.0,90.0,1,90,0.0,90.0,90.0
285061.0,17,2,363,1,79,0.0,79.0,79.0,1,284,0.0,284.0,284.0
147940.0,6,3,337,2,214,0.0,160.0,107.0,1,123,0.0,123.0,123.0
776.0,17,4,438,2,148,0.0,74.0,74.0,2,290,0.0,147.0,145.0
1778713.0,6,2,132,1,66,0.0,66.0,66.0,1,66,0.0,66.0,66.0
299544.0,6,6,412,4,272,99848.0,74.0,68.0,2,140,0.0,74.0,70.0
301574.0,6,6,412,4,272,100524.66666666669,74.0,68.0,2,140,0.0,74.0,70.0
14949.0,17,2,180,1,90,0.0,90.0,90.0,1,90,0.0,90.0,90.0
120002915.0,6,501,65994,250,49132,479746.6465863454,480.0,196.528,251,16862,479150.628,140.0,67.1792828685259
153448.0,17,2,180,1,90,0.0,90.0,90.0,1,90,0.0,90.0,90.0
30089.0,6,14,4740,7,653,4898.666666666667,249.0,93.28571428571428,7,4087,4827.666666666667,1514.0,583.8571428571429
120126394.0,6,13,2020,9,1204,15015799.25,188.0,133.77777777777777,4,816,30031811.0,204.0,204.0
147162.0,6,3,373,2,238,0.0,172.0,119.0,1,135,0.0,135.0,135.0
310471.0,17,4,622,4,622,103490.33333333331,163.0,155.5,0,0,0.0,0.0,0.0
460065.0,6,3,204,1,68,0.0,68.0,68.0,2,136,0.0,70.0,68.0
36584.0,6,14,4740,7,653,5987.833333333333,249.0,93.28571428571428,7,4087,5419.0,1514.0,583.8571428571429
23169.0,6,10,2032,5,524,5507.75,252.0,104.8,5,1508,5289.25,1236.0,301.6
254207.00000000003,17,4,6056,4,6056,84735.66666666667,1514.0,1514.0,0,0,0.0,0.0,0.0
120020059.0,17,28,13364,28,13364,4445187.37037037,501.0,477.2857142857143,0,0,0.0,0.0,0.0
211849.0,6,3,426,2,280,0.0,214.0,140.0,1,146,0.0,146.0,146.0
2078.0,17,4,344,2,150,0.0,75.0,75.0,2,194,0.0,103.0,97.0
869914.0,6,10,1335,6,798,173982.8,460.0,133.0,4,537,198138.3333333333,331.0,134.25
14420449.0,17,6,2052,6,2052,2884089.8,342.0,342.0,0,0,0.0,0.0,0.0
240287.0,6,3,337,2,214,0.0,160.0,107.0,1,123,0.0,123.0,123.0
10880230.0,6,8,544,4,272,3581281.0,74.0,68.0,4,272,3581237.6666666665,74.0,68.0
149249.0,6,3,337,2,214,0.0,160.0,107.0,1,123,0.0,123.0,123.0
90038915.0,17,28,13364,28,13364,3334774.6296296297,501.0,477.2857142857143,0,0,0.0,0.0,0.0
29906.0,6,14,4740,7,653,4764.0,249.0,93.28571428571428,7,4087,4569.166666666667,1514.0,583.8571428571429
29725.0,6,10,2032,5,524,7197.25,252.0,104.8,5,1508,6986.0,1236.0,301.6
111292969.0,6,34,2350,17,1225,6955810.5625,139.0,72.05882352941177,17,1125,6942287.875,123.0,66.17647058823529
120016189.0,6,466,58120,233,15674,514743.8275862069,140.0,67.27038626609442,233,42446,513750.8103448276,480.0,182.1716738197425
108109308.0,17,5,1005,5,1005,27027327.0,201.0,201.0,0,0,0.0,0.0,0.0
90916259.0,6,21,1585,11,840,9091012.5,95.0,76.36363636363636,10,745,10099610.777777778,95.0,74.5
178121.0,17,2,180,1,90,0.0,90.0,90.0,1,90,0.0,90.0,90.0
4996.0,17,2,180,1,90,0.0,90.0,90.0,1,90,0.0,90.0,90.0
197094.0,17,2,180,1,90,0.0,90.0,90.0,1,90,0.0,90.0,90.0
153392.0,17,2,180,1,90,0.0,90.0,90.0,1,90,0.0,90.0,90.0
858196.0,6,9,1268,6,797,171639.2,459.0,132.83333333333334,3,471,291337.0,331.0,157.0
300212.0,17,2,346,1,78,0.0,78.0,78.0,1,268,0.0,268.0,268.0
104001005.0,17,13,821,7,432,17333500.833333332,174.0,61.71428571428572,6,389,16800881.0,174.0,64.83333333333333
283571.0,17,4,704,2,148,0.0,74.0,74.0,2,556,0.0,280.0,278.0
298912.0,6,6,412,4,272,99637.33333333331,74.0,68.0,2,140,0.0,74.0,70.0
60276.0,6,10,1065,5,534,14885.5,262.0,106.8,5,531,13294.5,259.0,106.2
29521.0,6,14,4740,7,653,4746.833333333333,249.0,93.28571428571428,7,4087,3967.6666666666665,1514.0,583.8571428571429
20224.0,6,10,2032,5,524,4817.5,252.0,104.8,5,1508,4594.75,1236.0,301.6
96004963.0,6,180,20316,90,14154,1076290.202247191,284.0,157.26666666666668,90,6162,1076289.5842696629,140.0,68.46666666666667
2271.0,17,4,344,2,150,0.0,75.0,75.0,2,194,0.0,103.0,97.0
104726.0,17,2,286,2,286,0.0,143.0,143.0,0,0,0.0,0.0,0.0
320723.0,17,4,1400,4,1400,106907.66666666669,350.0,350.0,0,0,0.0,0.0,0.0
208133.0,6,4,492,2,280,0.0,214.0,140.0,2,212,0.0,146.0,106.0
90032478.0,17,28,13364,28,13364,3334536.222222222,501.0,477.2857142857143,0,0,0.0,0.0,0.0
108100652.0,17,5,955,5,955,27025163.0,191.0,191.0,0,0,0.0,0.0,0.0
144038.0,17,2,180,1,90,0.0,90.0,90.0,1,90,0.0,90.0,90.0
143902.0,17,2,180,1,90,0.0,90.0,90.0,1,90,0.0,90.0,90.0
1242761.0,6,7,499,4,301,379182.6666666667,103.0,75.25,3,198,614437.5,66.0,66.0
22528.0,6,10,2032,5,524,5396.25,252.0,104.8,5,1508,5259.5,1236.0,301.6
162315.0,17,2,180,1,90,0.0,90.0,90.0,1,90,0.0,90.0,90.0
827.0,17,4,438,2,148,0.0,74.0,74.0,2,290,0.0,147.0,145.0
207578.0,6,3,426,2,280,0.0,214.0,140.0,1,146,0.0,146.0,146.0
66027.0,6,13,1394,7,797,10336.666666666666,253.0,113.85714285714286,6,597,8025.8,259.0,99.5
10915408.0,6,8,544,4,272,3592790.6666666665,74.0,68.0,4,272,3592732.6666666665,74.0,68.0
15879.999999999998,6,10,1065,5,534,2793.75,262.0,106.8,5,531,3634.75,259.0,106.2
105490.0,17,2,700,2,700,0.0,350.0,350.0,0,0,0.0,0.0,0.0
107421.0,17,2,286,2,286,0.0,143.0,143.0,0,0,0.0,0.0,0.0
169504.0,17,2,180,1,90,0.0,90.0,90.0,1,90,0.0,90.0,90.0
301057.0,6,6,412,4,272,100352.33333333331,74.0,68.0,2,140,0.0,74.0,70.0
96112129.0,6,56,11632,28,5893,3559708.4814814813,1514.0,210.4642857142857,28,5739,3550146.296296296,1514.0,204.9642857142857
35346.0,6,10,2032,5,524,8612.25,252.0,104.8,5,1508,8161.25,1236.0,301.6
3010271.0,6,11,2106,6,598,601799.6,252.0,99.66666666666669,5,1508,2944.25,1236.0,301.6
122001118.0,17,15,907,8,475,17428731.14285714,174.0,59.375,7,432,17001248.333333332,174.0,61.71428571428572
432.0,17,2,267,1,83,0.0,83.0,83.0,1,184,0.0,184.0,184.0
90286754.0,6,19,1436,10,745,10026638.777777778,95.0,74.5,9,691,11284921.875,95.0,76.77777777777777
2593532.0,6,2,132,1,66,0.0,66.0,66.0,1,66,0.0,66.0,66.0
197009.0,17,2,180,1,90,0.0,90.0,90.0,1,90,0.0,90.0,90.0
158035.0,6,3,337,2,214,0.0,160.0,107.0,1,123,0.0,123.0,123.0
0.0,17,1,55,1,55,0.0,55.0,55.0,0,0,0.0,0.0,0.0
5621258.0,6,4,270,2,134,0.0,68.0,67.0,2,136,0.0,70.0,68.0
748.0,17,2,762,2,762,0.0,381.0,381.0,0,0,0.0,0.0,0.0
240860.0,17,2,180,1,90,0.0,90.0,90.0,1,90,0.0,90.0,90.0
137799.0,6,2,132,1,66,0.0,66.0,66.0,1,66,0.0,66.0,66.0
30691.0,6,10,2032,5,524,7335.25,252.0,104.8,5,1508,6103.0,1236.0,301.6
90290652.0,6,16,1192,8,596,12891615.0,95.0,74.5,8,596,12896706.857142856,95.0,74.5
100185034.0,17,12,516,6,258,20000606.8,43.0,43.0,6,258,20000176.4,43.0,43.0
30734.0,6,14,4740,7,653,4313.833333333333,249.0,93.28571428571428,7,4087,4984.666666666667,1514.0,583.8571428571429
120018351.0,6,21,1585,11,840,8998776.7,95.0,76.36363636363636,10,745,13329712.777777778,95.0,74.5
6935.0,17,2,582,1,83,0.0,83.0,83.0,1,499,0.0,499.0,499.0
120126198.0,6,13,2036,5,1020,30031549.5,204.0,204.0,8,1016,17137387.42857143,188.0,127.0
103363.0,17,2,286,2,286,0.0,143.0,143.0,0,0,0.0,0.0,0.0
306879.0,6,6,412,4,272,102293.0,74.0,68.0,2,140,0.0,74.0,70.0
143938.0,17,2,180,1,90,0.0,90.0,90.0,1,90,0.0,90.0,90.0
5623153.0,6,4,270,2,134,0.0,68.0,67.0,2,136,0.0,70.0,68.0
5612802.0,6,4,270,2,134,0.0,68.0,67.0,2,136,0.0,70.0,68.0
146134.0,6,3,337,2,214,0.0,160.0,107.0,1,123,0.0,123.0,123.0
1002803.0,6,12,1447,6,816,199484.2,291.0,136.0,6,631,200116.6,293.0,105.16666666666669
1067578.0,17,6,1230,3,234,533603.5,78.0,78.0,3,996,533570.5,332.0,332.0
120008161.0,6,17,1246,9,650,15001020.125,95.0,72.22222222222223,8,596,17106869.57142857,95.0,74.5
313258.0,6,3,202,2,128,0.0,74.0,64.0,1,74,0.0,74.0,74.0
400862.0,6,10,1221,6,636,80172.4,298.0,106.0,4,585,128152.33333333331,379.0,146.25
10918714.0,6,8,544,4,272,3593004.6666666665,74.0,68.0,4,272,3592937.6666666665,74.0,68.0
90031078.0,17,28,13364,28,13364,3334484.3703703703,501.0,477.2857142857143,0,0,0.0,0.0,0.0
19743.0,6,2,145,2,145,0.0,91.0,72.5,0,0,0.0,0.0,0.0
109516361.0,6,44,2904,22,1452,5215064.80952381,66.0,66.0,22,1452,5201938.857142857,66.0,66.0
119556110.0,6,226,25624,113,17870,1065542.3392857143,284.0,158.141592920354,113,7754,1065542.6160714286,140.0,68.61946902654867
2321.0,17,4,344,2,150,0.0,75.0,75.0,2,194,0.0,103.0,97.0
10469533.0,6,7,478,4,272,3444568.0,74.0,68.0,3,206,5166747.0,74.0,68.66666666666667
92016452.0,6,38,2508,19,1254,5112010.333333333,66.0,66.0,19,1254,5112011.166666667,66.0,66.0
135127143.0,17,6,1146,6,1146,27025428.6,191.0,191.0,0,0,0.0,0.0,0.0
321091.0,17,4,1400,4,1400,107030.33333333331,350.0,350.0,0,0,0.0,0.0,0.0
905289.0,6,12,2711,7,743,150881.5,339.0,106.14285714285714,5,1968,157436.25,1514.0,393.6
39570.0,6,10,2032,5,524,9667.5,252.0,104.8,5,1508,9634.75,1236.0,301.6
120398336.0,6,215,24374,108,17090,1125218.093457944,284.0,158.24074074074073,107,7284,1106419.5188679246,140.0,68.07476635514018
102848.0,17,2,286,2,286,0.0,143.0,143.0,0,0,0.0,0.0,0.0
123250660.0,6,49,3234,25,1650,5135444.166666667,66.0,66.0,24,1584,5043957.173913044,66.0,66.0
103695.0,17,2,286,2,286,0.0,143.0,143.0,0,0,0.0,0.0,0.0
98191488.0,6,188,21204,94,14778,1053507.0,284.0,157.2127659574468,94,6426,1053507.9892473118,140.0,68.36170212765957
10829414.0,6,8,544,4,272,3564328.333333333,74.0,68.0,4,272,3564238.6666666665,74.0,68.0
205770.0,17,2,180,1,90,0.0,90.0,90.0,1,90,0.0,90.0,90.0
4407157.0,17,2,684,2,684,0.0,342.0,342.0,0,0,0.0,0.0,0.0
861677.0,6,9,1096,6,625,172335.4,287.0,104.16666666666669,3,471,292672.5,331.0,157.0
219350.0,6,3,426,2,280,0.0,214.0,140.0,1,146,0.0,146.0,146.0
228372.0,17,2,180,1,90,0.0,90.0,90.0,1,90,0.0,90.0,90.0
110198340.0,6,39,3040,21,1654,5499125.6,139.0,78.76190476190476,18,1386,6469559.705882353,123.0,77.0
147375.0,6,3,373,2,238,0.0,172.0,119.0,1,135,0.0,135.0,135.0
10541.0,6,10,1067,5,536,2206.75,264.0,107.2,5,531,2365.25,259.0,106.2
312530.0,17,4,1400,4,1400,104176.66666666669,350.0,350.0,0,0,0.0,0.0,0.0
119949518.0,6,24,1788,12,894,10881759.0,95.0,74.5,12,894,10890904.727272728,95.0,74.5
2850.0,17,2,224,1,76,0.0,76.0,76.0,1,148,0.0,148.0,148.0
12947.0,6,10,2032,5,524,3002.75,252.0,104.8,5,1508,2890.5,1236.0,301.6
123610578.0,6,49,3234,25,1650,5150440.75,66.0,66.0,24,1584,4951088.304347826,66.0,66.0
899.0,17,4,438,2,148,0.0,74.0,74.0,2,290,0.0,147.0,145.0
332.0,17,2,160,1,80,0.0,80.0,80.0,1,80,0.0,80.0,80.0
83.0,17,2,762,2,762,0.0,381.0,381.0,0,0,0.0,0.0,0.0
22210.0,6,14,4740,7,653,3575.833333333333,249.0,93.28571428571428,7,4087,3560.5,1514.0,583.8571428571429
27925.0,6,10,2032,5,524,6499.0,252.0,104.8,5,1508,6073.25,1236.0,301.6
144567.0,17,2,180,1,70,0.0,70.0,70.0,1,110,0.0,110.0,110.0
2309.0,17,4,344,2,150,0.0,75.0,75.0,2,194,0.0,103.0,97.0
104083012.0,17,14,864,7,432,17334338.5,174.0,61.71428571428572,7,432,17333495.0,174.0,61.71428571428572
92016033.0,6,37,2442,19,1254,5112001.833333333,66.0,66.0,18,1188,5069722.764705882,66.0,66.0
33786246.0,6,25,6868,15,1574,2413303.285714286,408.0,104.93333333333334,10,5294,2758553.5555555555,1514.0,529.4
209612.0,6,3,426,2,280,0.0,214.0,140.0,1,146,0.0,146.0,146.0
19957.0,6,11,2098,6,590,3911.2,252.0,98.33333333333331,5,1508,3096.75,1236.0,301.6
242063.0,6,3,337,2,214,0.0,160.0,107.0,1,123,0.0,123.0,123.0
10416199.0,6,6,412,3,206,5140136.5,74.0,68.66666666666667,3,206,5140006.5,74.0,68.66666666666667
1771675.0,6,2,132,1,66,0.0,66.0,66.0,1,66,0.0,66.0,66.0
64131.99999999999,6,14,4740,7,653,10562.833333333334,249.0,93.28571428571428,7,4087,9583.166666666666,1514.0,583.8571428571429
100122648.0,17,12,778,6,389,20024529.6,174.0,64.83333333333333,6,389,19988423.2,174.0,64.83333333333333
104779.0,17,2,286,2,286,0.0,143.0,143.0,0,0,0.0,0.0,0.0
103206905.0,6,31,2182,16,1165,6866791.333333333,139.0,72.8125,15,1017,7357275.142857143,123.0,67.8
90300322.0,6,16,1192,8,596,12893877.0,95.0,74.5,8,596,12898264.857142856,95.0,74.5
141.0,17,3,1050,3,1050,70.5,350.0,350.0,0,0,0.0,0.0,0.0
108094269.0,17,5,955,5,955,27023567.25,191.0,191.0,0,0,0.0,0.0,0.0
57200.0,6,14,4740,7,653,8987.833333333334,249.0,93.28571428571428,7,4087,8467.833333333334,1514.0,583.8571428571429
39377.0,6,14,4740,7,653,6331.333333333333,249.0,93.28571428571428,7,4087,6252.0,1514.0,583.8571428571429
120120315.0,6,15,2444,7,1428,20020052.5,204.0,204.0,8,1016,17136363.285714287,188.0,127.0
113733459.0,6,44,3576,24,1944,4944933.0,123.0,81.0,20,1632,5975075.368421053,123.0,81.6
14785.0,6,12,1393,6,796,2542.2,271.0,132.66666666666666,6,597,2744.0,259.0,99.5
157893.0,17,2,180,1,90,0.0,90.0,90.0,1,90,0.0,90.0,90.0
233438.0,6,3,337,2,214,0.0,160.0,107.0,1,123,0.0,123.0,123.0
299889.0,6,6,412,4,272,99963.0,74.0,68.0,2,140,0.0,74.0,70.0
113216706.0,6,32,2236,16,1165,7533366.266666667,139.0,72.8125,16,1071,7533368.2,123.0,66.9375
40072.0,6,14,4740,7,653,6298.833333333333,249.0,93.28571428571428,7,4087,6538.0,1514.0,583.8571428571429
4992469.0,17,4,849,2,166,0.0,83.0,83.0,2,683,0.0,499.0,341.5
143986.0,17,2,180,1,90,0.0,90.0,90.0,1,90,0.0,90.0,90.0
120198301.0,6,38,2773,19,1302,6677683.388888889,123.0,68.52631578947368,19,1471,6631634.388888889,139.0,77.42105263157895
205601.0,17,2,180,1,90,0.0,90.0,90.0,1,90,0.0,90.0,90.0
120028961.0,6,29,1920,15,1026,8573497.214285715,123.0,68.4,14,894,8447831.615384616,123.0,63.85714285714285
41632.0,6,14,4740,7,653,6485.0,249.0,93.28571428571428,7,4087,6066.166666666667,1514.0,583.8571428571429
30357.0,17,2,582,1,83,0.0,83.0,83.0,1,499,0.0,499.0,499.0
120320764.0,6,216,24456,108,7350,1116702.4953271027,140.0,68.05555555555556,108,17106,1120048.887850467,284.0,158.38888888888889
6429.0,17,4,823,2,163,0.0,89.0,81.5,2,660,0.0,443.0,330.0
120131032.0,6,15,2444,7,1428,20021838.666666668,204.0,204.0,8,1016,17098716.285714287,188.0,127.0
148587.0,17,2,414,1,88,0.0,88.0,88.0,1,326,0.0,326.0,326.0
90288871.0,6,16,1192,8,596,12891590.285714284,95.0,74.5,8,596,12896838.714285716,95.0,74.5
317585.0,6,3,202,2,128,0.0,74.0,64.0,1,74,0.0,74.0,74.0
149283815.0,6,21,1585,10,745,13285070.666666666,95.0,74.5,11,840,14907889.4,95.0,76.36363636363636
225151.0,17,2,414,1,88,0.0,88.0,88.0,1,326,0.0,326.0,326.0
90138733.0,6,13,1804,6,928,18027510.4,199.0,154.66666666666666,7,876,15022386.833333334,204.0,125.14285714285714
42851.0,6,14,4740,7,653,7015.5,249.0,93.28571428571428,7,4087,5910.5,1514.0,583.8571428571429
119555374.0,6,17,1246,9,650,14944421.75,95.0,72.22222222222223,8,596,12893480.857142856,95.0,74.5
15010509.0,17,6,2718,6,2718,3002101.8,453.0,453.0,0,0,0.0,0.0,0.0
10510150.0,6,6,412,3,206,5187145.0,74.0,68.66666666666667,3,206,5187038.5,74.0,68.66666666666667
15822.0,6,10,1067,5,536,3698.5,264.0,107.2,5,531,3667.25,259.0,106.2
390441.0,6,10,1221,6,636,78088.2,298.0,106.0,4,585,128838.0,379.0,146.25
1774737.0,6,2,132,1,66,0.0,66.0,66.0,1,66,0.0,66.0,66.0
90280237.0,6,16,1192,8,596,12890805.0,95.0,74.5,8,596,12896222.57142857,95.0,74.5
209633.0,17,2,180,1,90,0.0,90.0,90.0,1,90,0.0,90.0,90.0
98192695.0,6,28,1923,14,1029,7536677.615384615,123.0,73.5,14,894,7536682.923076923,123.0,63.85714285714285
2825.0,17,4,344,2,150,0.0,75.0,75.0,2,194,0.0,103.0,97.0
120121434.0,6,13,2020,9,1204,15015179.25,188.0,133.77777777777777,4,816,30031569.666666668,204.0,204.0
322744.0,17,4,1400,4,1400,107581.33333333331,350.0,350.0,0,0,0.0,0.0,0.0
232595.0,6,3,337,2,214,0.0,160.0,107.0,1,123,0.0,123.0,123.0
0.0,17,1,438,1,438,0.0,438.0,438.0,0,0,0.0,0.0,0.0
135126308.0,17,6,1206,6,1206,27025261.6,201.0,201.0,0,0,0.0,0.0,0.0
204839.0,17,2,762,2,762,0.0,381.0,381.0,0,0,0.0,0.0,0.0
862.0,17,5,550,5,550,215.5,110.0,110.0,0,0,0.0,0.0,0.0
215067.0,6,10,1221,6,636,43013.4,298.0,106.0,4,585,69047.0,379.0,146.25
59422.0,6,14,4740,7,653,9481.666666666666,249.0,93.28571428571428,7,4087,9690.0,1514.0,583.8571428571429
2759846.0,6,51,23848,26,19851,110393.84,1514.0,763.5,25,3997,105979.625,1514.0,159.88
2316.0,17,4,344,2,150,0.0,75.0,75.0,2,194,0.0,103.0,97.0
5001689.0,17,4,534,2,166,0.0,83.0,83.0,2,368,0.0,184.0,184.0
1051084.0,6,3,1604,1,753,0.0,753.0,753.0,2,851,0.0,785.0,425.5
108088.0,17,2,286,2,286,0.0,143.0,143.0,0,0,0.0,0.0,0.0
108104563.0,17,5,1005,5,1005,27026140.75,201.0,201.0,0,0,0.0,0.0,0.0
121271.0,6,4,439,2,238,0.0,172.0,119.0,2,201,0.0,135.0,100.5
1042762.0,6,11,1134,6,558,208552.4,220.0,93.0,5,576,257336.75,304.0,115.2
115524252.0,6,232,26216,116,18338,1002687.4,284.0,158.08620689655172,116,7878,1002687.052173913,140.0,67.91379310344827
250936.0,6,14,4740,7,653,40971.333333333336,249.0,93.28571428571428,7,4087,41640.0,1514.0,583.8571428571429
504337.00000000006,6,5,336,2,134,0.0,68.0,67.0,3,202,195509.5,70.0,67.33333333333333
329.0,17,2,166,1,75,0.0,75.0,75.0,1,91,0.0,91.0,91.0
2337.0,17,4,344,2,150,0.0,75.0,75.0,2,194,0.0,103.0,97.0
216716.0,6,3,426,2,280,0.0,214.0,140.0,1,146,0.0,146.0,146.0
205773.0,17,2,180,1,90,0.0,90.0,90.0,1,90,0.0,90.0,90.0
114278826.0,6,33,2280,17,1209,7128945.4375,123.0,71.11764705882354,16,1071,7604206.133333334,123.0,66.9375
119350881.0,6,24,1829,14,1084,9176790.23076923,95.0,77.42857142857143,10,745,13234370.444444444,95.0,74.5
45737.0,6,10,2032,5,524,11191.0,252.0,104.8,5,1508,9944.0,1236.0,301.6
197072.0,17,2,180,1,90,0.0,90.0,90.0,1,90,0.0,90.0,90.0
46587651.0,6,8,2113,3,960,21906385.0,826.0,320.0,5,1153,11002007.0,885.0,230.6
23049293.0,17,3,1034,2,684,0.0,342.0,342.0,1,350,0.0,350.0,350.0
3628837.0,6,5,336,2,134,0.0,68.0,67.0,3,202,527659.0,70.0,67.33333333333333
206290.0,6,3,426,2,280,0.0,214.0,140.0,1,146,0.0,146.0,146.0
684.0,17,4,438,2,148,0.0,74.0,74.0,2,290,0.0,147.0,145.0
135142750.0,17,6,1146,6,1146,27028550.0,191.0,191.0,0,0,0.0,0.0,0.0
116982968.0,6,48,3168,24,1584,5086216.0,66.0,66.0,24,1584,5071885.956521739,66.0,66.0
35109.0,6,14,4740,7,653,5741.333333333333,249.0,93.28571428571428,7,4087,5717.166666666667,1514.0,583.8571428571429
53464.0,6,14,4740,7,653,8184.666666666667,249.0,93.28571428571428,7,4087,7376.333333333333,1514.0,583.8571428571429
215404.0,17,2,180,1,90,0.0,90.0,90.0,1,90,0.0,90.0,90.0
162320.0,17,2,180,1,90,0.0,90.0,90.0,1,90,0.0,90.0,90.0
108123787.0,17,5,1005,5,1005,27030946.75,201.0,201.0,0,0,0.0,0.0,0.0
852208.0,6,9,1096,6,625,170441.6,287.0,104.16666666666669,3,471,289815.5,331.0,157.0
117577129.0,6,224,25312,112,17624,1057314.8738738738,284.0,157.35714285714286,112,7688,1057314.7297297297,140.0,68.64285714285714
327.0,17,2,174,1,79,0.0,79.0,79.0,1,95,0.0,95.0,95.0
1320625.0,6,4,264,2,132,0.0,66.0,66.0,2,132,0.0,66.0,66.0
20731.0,6,14,4740,7,653,3194.1666666666665,249.0,93.28571428571428,7,4087,3317.0,1514.0,583.8571428571429
108103700.0,17,5,1005,5,1005,27025925.0,201.0,201.0,0,0,0.0,0.0,0.0
832.0,17,5,550,5,550,208.0,110.0,110.0,0,0,0.0,0.0,0.0
90293169.0,6,16,1192,8,596,12892400.57142857,95.0,74.5,8,596,12897111.142857144,95.0,74.5
20777.0,6,11,2098,6,590,3886.2,252.0,98.33333333333331,5,1508,4931.0,1236.0,301.6
90256348.0,6,12,1832,8,1016,12893764.0,188.0,127.0,4,816,30027650.33333333,204.0,204.0
437548.0,6,11,1021,6,444,58743.6,162.0,74.0,5,577,73250.75,349.0,115.4
108626170.0,6,31,2166,16,1149,7227342.866666666,123.0,71.8125,15,1017,7743581.142857143,123.0,67.8
21739.0,17,2,582,1,83,0.0,83.0,83.0,1,499,0.0,499.0,499.0
2290.0,17,4,344,2,150,0.0,75.0,75.0,2,194,0.0,103.0,97.0
58281.0,6,10,2032,5,524,13653.0,252.0,104.8,5,1508,14345.25,1236.0,301.6
128916797.0,17,14,864,7,432,18166830.33333333,174.0,61.71428571428572,7,432,18167380.166666668,174.0,61.71428571428572
4624770.0,6,5,1909,2,892,0.0,826.0,446.0,3,1017,1400250.0,885.0,339.0
61439.0,6,14,4740,7,653,9424.833333333334,249.0,93.28571428571428,7,4087,9104.833333333334,1514.0,583.8571428571429
1519.0,17,5,550,5,550,379.75,110.0,110.0,0,0,0.0,0.0,0.0
2384.0,17,4,344,2,150,0.0,75.0,75.0,2,194,0.0,103.0,97.0
307017.0,6,6,412,4,272,102339.0,74.0,68.0,2,140,0.0,74.0,70.0
682.0,17,4,438,2,148,0.0,74.0,74.0,2,290,0.0,147.0,145.0
104568427.0,17,14,864,7,432,17334471.666666668,174.0,61.71428571428572,7,432,17333529.333333332,174.0,61.71428571428572
48471.0,6,14,4740,7,653,7789.166666666667,249.0,93.28571428571428,7,4087,7440.166666666667,1514.0,583.8571428571429
93012552.0,17,11,735,6,389,18602510.4,174.0,64.83333333333333,5,346,18250231.0,174.0,69.2
38197.0,6,10,1065,5,534,9381.5,262.0,106.8,5,531,5071.0,259.0,106.2
52936.0,6,14,4740,7,653,8703.333333333334,249.0,93.28571428571428,7,4087,6862.0,1514.0,583.8571428571429
90021528.0,17,28,13364,28,13364,3334130.6666666665,501.0,477.2857142857143,0,0,0.0,0.0,0.0
123920618.0,6,49,3234,25,1650,5163359.083333333,66.0,66.0,24,1584,5061590.652173913,66.0,66.0
188869.0,17,2,762,2,762,0.0,381.0,381.0,0,0,0.0,0.0,0.0
120657404.0,6,224,25328,113,17780,1077298.25,284.0,157.34513274336285,111,7548,1083975.4,140.0,68.0
103035.0,17,2,286,2,286,0.0,143.0,143.0,0,0,0.0,0.0,0.0
138050.0,6,2,132,1,66,0.0,66.0,66.0,1,66,0.0,66.0,66.0
120092470.0,17,28,13364,28,13364,4447869.259259259,501.0,477.2857142857143,0,0,0.0,0.0,0.0
240099.0,6,13,1386,7,789,40016.5,253.0,112.71428571428572,6,597,46244.6,259.0,99.5
120077471.0,17,29,13785,29,13785,4288481.107142857,501.0,475.3448275862069,0,0,0.0,0.0,0.0
10884493.0,6,8,544,4,272,3581286.333333333,74.0,68.0,4,272,3581206.333333333,74.0,68.0
0.0,17,1,443,1,443,0.0,443.0,443.0,0,0,0.0,0.0,0.0
299129.0,6,6,412,4,272,99709.66666666669,74.0,68.0,2,140,0.0,74.0,70.0
911.0,17,4,438,2,148,0.0,74.0,74.0,2,290,0.0,147.0,145.0
118889296.0,6,36,2596,18,1348,6980801.882352941,139.0,74.88888888888889,18,1248,6980802.0,123.0,69.33333333333333
104162.0,17,4,1400,4,1400,34720.666666666664,350.0,350.0,0,0,0.0,0.0,0.0
13068.0,6,10,1975,5,467,3030.0,195.0,93.4,5,1508,1705.0,1236.0,301.6
147945.0,6,3,337,2,214,0.0,160.0,107.0,1,123,0.0,123.0,123.0
9922.0,17,2,582,1,83,0.0,83.0,83.0,1,499,0.0,499.0,499.0
99157285.0,6,39,2574,20,1320,5207444.631578947,66.0,66.0,19,1254,5105426.222222222,66.0,66.0
91986047.0,17,16,5472,16,5472,6132403.133333334,342.0,342.0,0,0,0.0,0.0,0.0
15234.0,6,14,4740,7,653,2430.1666666666665,249.0,93.28571428571428,7,4087,2356.1666666666665,1514.0,583.8571428571429
207040.0,6,3,426,2,280,0.0,214.0,140.0,1,146,0.0,146.0,146.0
120009940.0,6,21,1585,11,840,12000994.0,95.0,76.36363636363636,10,745,13305156.777777778,95.0,74.5
153492.0,17,2,180,1,90,0.0,90.0,90.0,1,90,0.0,90.0,90.0
5625415.0,6,5,336,2,134,0.0,68.0,67.0,3,202,1520110.5,70.0,67.33333333333333
2202774.0,6,67,57814,26,1873,88110.96,203.0,72.03846153846153,41,55941,54959.9,1514.0,1364.4146341463415
309651.0,6,6,412,4,272,103217.0,74.0,68.0,2,140,0.0,74.0,70.0
108104505.0,17,5,1005,5,1005,27026126.25,201.0,201.0,0,0,0.0,0.0,0.0
127432.0,17,4,1400,4,1400,42477.333333333336,350.0,350.0,0,0,0.0,0.0,0.0
120121904.0,6,222,24962,111,7622,1084605.6090909091,140.0,68.66666666666667,111,17340,1085621.1181818182,284.0,156.21621621621622
24106.0,6,14,4740,7,653,3733.6666666666665,249.0,93.28571428571428,7,4087,3852.3333333333335,1514.0,583.8571428571429
90051557.0,17,28,13364,28,13364,3335242.851851852,501.0,477.2857142857143,0,0,0.0,0.0,0.0
216906.0,6,11,1132,6,556,42715.6,218.0,92.66666666666669,5,576,51158.5,304.0,115.2
13606619.0,6,21,1661,11,1029,1330860.0,315.0,93.54545454545456,10,632,1478804.4444444445,78.0,63.2
10008.0,6,10,1066,5,490,2337.0,218.0,98.0,5,576,2208.75,304.0,115.2
113642.0,17,4,1400,4,1400,37880.66666666666,350.0,350.0,0,0,0.0,0.0,0.0
120026687.0,17,28,13364,28,13364,4445432.851851852,501.0,477.2857142857143,0,0,0.0,0.0,0.0
41804.0,6,14,4740,7,653,6683.5,249.0,93.28571428571428,7,4087,6627.833333333333,1514.0,583.8571428571429
233777.0,6,3,373,2,238,0.0,172.0,119.0,1,135,0.0,135.0,135.0
95695509.0,6,240,27310,120,8142,802147.5714285715,140.0,67.85,120,19168,780807.5798319328,390.0,159.73333333333332
27515374.0,17,5,1710,5,1710,6878843.5,342.0,342.0,0,0,0.0,0.0,0.0
45740.0,6,14,4740,7,653,7511.333333333333,249.0,93.28571428571428,7,4087,6240.666666666667,1514.0,583.8571428571429
2593056.0,6,2,132,1,66,0.0,66.0,66.0,1,66,0.0,66.0,66.0
21878.0,6,11,2098,6,590,4262.0,252.0,98.33333333333331,5,1508,5176.75,1236.0,301.6
32920.0,6,14,4740,7,653,5351.0,249.0,93.28571428571428,7,4087,5292.666666666667,1514.0,583.8571428571429
19383.0,6,2,145,2,145,0.0,91.0,72.5,0,0,0.0,0.0,0.0
25606.0,6,10,2032,5,524,6171.75,252.0,104.8,5,1508,6154.5,1236.0,301.6
1909.0,17,2,192,1,88,0.0,88.0,88.0,1,104,0.0,104.0,104.0
2640906.0,6,25,7573,14,3735,203146.6153846153,1514.0,266.7857142857143,11,3838,238860.8,1514.0,348.90909090909093
10471356.0,6,7,478,4,272,3443193.333333333,74.0,68.0,3,206,5164685.5,74.0,68.66666666666667
102861.0,6,11,1132,6,556,20149.0,218.0,92.66666666666669,5,576,21307.25,304.0,115.2
2380.0,17,4,344,2,150,0.0,75.0,75.0,2,194,0.0,103.0,97.0
92532966.0,17,11,735,6,389,18474810.2,174.0,64.83333333333333,5,346,18156520.25,174.0,69.2
351087.0,6,3,1604,2,851,0.0,785.0,425.5,1,753,0.0,753.0,753.0
0.0,17,1,103,1,103,0.0,103.0,103.0,0,0,0.0,0.0,0.0
311415.0,6,6,412,4,272,103805.0,74.0,68.0,2,140,0.0,74.0,70.0
120122388.0,6,13,2036,5,1020,30030597.0,204.0,204.0,8,1016,17136765.85714286,188.0,127.0
306954.0,6,3,202,2,128,0.0,74.0,64.0,1,74,0.0,74.0,74.0
108109356.0,17,5,1005,5,1005,27027339.0,201.0,201.0,0,0,0.0,0.0,0.0
438150.0,6,10,967,5,390,73442.5,162.0,78.0,5,577,73380.0,349.0,115.4
39203.0,6,10,2032,5,524,9574.0,252.0,104.8,5,1508,9298.0,1236.0,301.6
103312346.0,6,42,2772,21,1386,5150438.3,66.0,66.0,21,1386,5150438.8,66.0,66.0
304104.0,6,6,412,4,272,101368.0,74.0,68.0,2,140,0.0,74.0,70.0
43692.0,6,14,4740,7,653,5872.833333333333,249.0,93.28571428571428,7,4087,5908.666666666667,1514.0,583.8571428571429
2310.0,17,4,344,2,150,0.0,75.0,75.0,2,194,0.0,103.0,97.0
38801.0,6,14,4740,7,653,6345.833333333333,249.0,93.28571428571428,7,4087,5888.0,1514.0,583.8571428571429
2051126.0,17,4,820,2,156,0.0,78.0,78.0,2,664,0.0,332.0,332.0
228235.0,17,2,180,1,90,0.0,90.0,90.0,1,90,0.0,90.0,90.0
76984.0,6,11,2098,6,590,14373.6,252.0,98.33333333333331,5,1508,18518.0,1236.0,301.6
104568.0,17,2,700,2,700,0.0,350.0,350.0,0,0,0.0,0.0,0.0
16013.0,6,11,2098,6,590,2644.6,252.0,98.33333333333331,5,1508,3752.25,1236.0,301.6
147972.0,17,2,180,1,90,0.0,90.0,90.0,1,90,0.0,90.0,90.0
42605.0,6,14,4740,7,653,6632.0,249.0,93.28571428571428,7,4087,6832.5,1514.0,583.8571428571429
6614.0,17,2,447,1,84,0.0,84.0,84.0,1,363,0.0,363.0,363.0
31606.000000000004,6,14,4740,7,653,5143.166666666667,249.0,93.28571428571428,7,4087,4876.333333333333,1514.0,583.8571428571429
311460.0,6,3,202,2,128,0.0,74.0,64.0,1,74,0.0,74.0,74.0
48418.0,6,13,1394,7,797,7982.0,253.0,113.85714285714286,6,597,7906.4,259.0,99.5
111375.0,17,2,286,2,286,0.0,143.0,143.0,0,0,0.0,0.0,0.0
0.0,6,1,54,0,0,0.0,0.0,0.0,1,54,0.0,54.0,54.0
135122101.0,17,6,1206,6,1206,27024420.2,201.0,201.0,0,0,0.0,0.0,0.0
108107114.0,17,5,955,5,955,27026778.5,191.0,191.0,0,0,0.0,0.0,0.0
232234.0,6,3,337,2,214,0.0,160.0,107.0,1,123,0.0,123.0,123.0
240802.0,6,3,373,2,238,0.0,172.0,119.0,1,135,0.0,135.0,135.0
10870908.0,6,8,544,4,272,3578288.6666666665,74.0,68.0,4,272,3578240.6666666665,74.0,68.0
21633.0,6,10,2032,5,524,4736.5,252.0,104.8,5,1508,5143.5,1236.0,301.6
90223201.0,6,17,1287,8,596,12853775.285714284,95.0,74.5,9,691,11250840.5,95.0,76.77777777777777
119205557.0,17,14,864,7,432,19833499.166666668,174.0,61.71428571428572,7,432,19834285.33333333,174.0,61.71428571428572
162275.0,17,2,180,1,90,0.0,90.0,90.0,1,90,0.0,90.0,90.0
90057151.0,17,28,13364,28,13364,3335450.037037037,501.0,477.2857142857143,0,0,0.0,0.0,0.0
24443.0,6,14,4740,7,653,3843.3333333333335,249.0,93.28571428571428,7,4087,3933.3333333333335,1514.0,583.8571428571429
850372.0,6,9,1268,6,797,170074.4,459.0,132.83333333333334,3,471,288919.5,331.0,157.0
10439741.0,6,7,478,4,272,3434329.333333333,74.0,68.0,3,206,5151395.0,74.0,68.66666666666667
111738736.0,6,31,2166,16,1149,7434846.866666666,123.0,71.8125,15,1017,7965909.071428572,123.0,67.8
43251.0,6,10,2032,5,524,9651.0,252.0,104.8,5,1508,9687.75,1236.0,301.6
23154.0,6,14,4740,7,653,3534.833333333333,249.0,93.28571428571428,7,4087,3724.0,1514.0,583.8571428571429
6668.0,17,2,582,1,83,0.0,83.0,83.0,1,499,0.0,499.0,499.0
322496.0,17,4,1400,4,1400,107498.66666666669,350.0,350.0,0,0,0.0,0.0,0.0
61923.0,6,14,4740,7,653,10129.166666666666,249.0,93.28571428571428,7,4087,10028.666666666666,1514.0,583.8571428571429
204306.0,17,2,762,2,762,0.0,381.0,381.0,0,0,0.0,0.0,0.0
135132641.0,17,6,1146,6,1146,27026528.2,191.0,191.0,0,0,0.0,0.0,0.0
108107802.0,17,5,955,5,955,27026950.5,191.0,191.0,0,0,0.0,0.0,0.0
295005.0,17,2,359,1,75,0.0,75.0,75.0,1,284,0.0,284.0,284.0
10534571.0,6,7,478,4,272,3466173.333333333,74.0,68.0,3,206,5199145.0,74.0,68.66666666666667
106846697.0,6,44,2904,22,1452,5087937.952380952,66.0,66.0,22,1452,5074972.047619048,66.0,66.0
10565467.0,6,7,478,4,272,3476226.6666666665,74.0,68.0,3,206,5204662.5,74.0,68.66666666666667
49892.0,6,14,4740,7,653,8177.5,249.0,93.28571428571428,7,4087,8174.833333333333,1514.0,583.8571428571429
90302874.0,6,16,1192,8,596,12893462.857142856,95.0,74.5,8,596,12900051.285714284,95.0,74.5
59895.0,6,14,4740,7,653,9816.666666666666,249.0,93.28571428571428,7,4087,9652.166666666666,1514.0,583.8571428571429
474.0,17,2,410,1,78,0.0,78.0,78.0,1,332,0.0,332.0,332.0
990998.0,17,2,604,1,75,0.0,75.0,75.0,1,529,0.0,529.0,529.0
15333.0,17,2,414,1,88,0.0,88.0,88.0,1,326,0.0,326.0,326.0
108098989.0,17,5,1005,5,1005,27024747.25,201.0,201.0,0,0,0.0,0.0,0.0
99636.0,17,2,762,2,762,0.0,381.0,381.0,0,0,0.0,0.0,0.0
2314.0,17,4,344,2,150,0.0,75.0,75.0,2,194,0.0,103.0,97.0
90230257.0,6,16,1192,8,596,12853000.142857144,95.0,74.5,8,596,12857628.714285716,95.0,74.5
33593.0,6,14,4740,7,653,5163.666666666667,249.0,93.28571428571428,7,4087,4253.166666666667,1514.0,583.8571428571429
104137.0,17,2,286,2,286,0.0,143.0,143.0,0,0,0.0,0.0,0.0
0.0,17,1,178,1,178,0.0,178.0,178.0,0,0,0.0,0.0,0.0
29890.0,6,14,4740,7,653,4873.0,249.0,93.28571428571428,7,4087,4409.333333333333,1514.0,583.8571428571429
230500.0,17,2,359,1,75,0.0,75.0,75.0,1,284,0.0,284.0,284.0
113617206.0,6,46,3036,23,1518,5150439.5,66.0,66.0,23,1518,5150439.2727272725,66.0,66.0
90295816.0,6,24,1829,13,989,7520598.5,95.0,76.07692307692308,11,840,9001969.5,95.0,76.36363636363636
294.0,17,2,174,1,79,0.0,79.0,79.0,1,95,0.0,95.0,95.0
32130.0,6,14,4740,7,653,5229.166666666667,249.0,93.28571428571428,7,4087,5220.833333333333,1514.0,583.8571428571429
110946057.0,6,31,2182,16,1165,7382019.6,139.0,72.8125,15,1017,7909305.571428572,123.0,67.8
32682124.0,6,5,336,2,134,0.0,68.0,67.0,3,202,15053136.0,70.0,67.33333333333333
397.0,17,2,508,2,508,0.0,257.0,254.0,0,0,0.0,0.0,0.0
250750.0,6,3,337,2,214,0.0,160.0,107.0,1,123,0.0,123.0,123.0
106902.0,17,2,700,2,700,0.0,350.0,350.0,0,0,0.0,0.0,0.0
15433.0,6,12,1393,6,796,2950.8,271.0,132.66666666666666,6,597,2921.8,259.0,99.5
93090611.0,17,12,778,6,389,18601340.2,174.0,64.83333333333333,6,389,18600155.4,174.0,64.83333333333333
2506516.0,6,25,7573,14,3735,192808.92307692303,1514.0,266.7857142857143,11,3838,224058.0,1514.0,348.90909090909093
196925.0,17,2,180,1,90,0.0,90.0,90.0,1,90,0.0,90.0,90.0
10418704.0,6,6,412,3,206,5140510.5,74.0,68.66666666666667,3,206,5140376.0,74.0,68.66666666666667
10532435.0,6,7,478,4,272,3464908.6666666665,74.0,68.0,3,206,5197267.5,74.0,68.66666666666667
3060709.0,6,11,2106,6,598,611754.2,252.0,99.66666666666669,5,1508,11891.25,1236.0,301.6
119893195.0,6,17,2434,10,1270,13321466.111111112,188.0,127.0,7,1164,19974992.33333333,204.0,166.28571428571428
228402.0,17,2,180,1,90,0.0,90.0,90.0,1,90,0.0,90.0,90.0
2438047.0,6,50,23782,26,19851,97521.88,1514.0,763.5,24,3931,95793.1304347826,1514.0,163.79166666666666
146277.0,6,3,337,2,214,0.0,160.0,107.0,1,123,0.0,123.0,123.0
135121764.0,17,6,1146,6,1146,27024352.8,191.0,191.0,0,0,0.0,0.0,0.0
10472880.0,6,7,478,4,272,3445487.333333333,74.0,68.0,3,206,5168137.5,74.0,68.66666666666667
205870.0,6,3,426,2,280,0.0,214.0,140.0,1,146,0.0,146.0,146.0
1448001.0,6,7,499,4,301,451492.6666666667,103.0,75.25,3,198,716936.0,66.0,66.0
317755.0,17,4,1400,4,1400,105918.33333333331,350.0,350.0,0,0,0.0,0.0,0.0
92000880.0,17,11,735,6,389,18400176.0,174.0,64.83333333333333,5,346,19952161.75,174.0,69.2
31665.0,6,14,4740,7,653,5161.166666666667,249.0,93.28571428571428,7,4087,4885.166666666667,1514.0,583.8571428571429
119943053.0,17,35,16705,35,16705,3527736.8529411764,501.0,477.2857142857143,0,0,0.0,0.0,0.0
312513.0,6,6,412,4,272,104171.0,74.0,68.0,2,140,0.0,74.0,70.0
201814.0,17,2,180,1,90,0.0,90.0,90.0,1,90,0.0,90.0,90.0
108106158.0,17,5,955,5,955,27026539.5,191.0,191.0,0,0,0.0,0.0,0.0
218107.0,6,3,426,2,280,0.0,214.0,140.0,1,146,0.0,146.0,146.0
41430.0,6,14,4740,7,653,6785.666666666667,249.0,93.28571428571428,7,4087,6339.166666666667,1514.0,583.8571428571429
454.0,17,2,508,2,508,0.0,257.0,254.0,0,0,0.0,0.0,0.0
103110.0,17,2,286,2,286,0.0,143.0,143.0,0,0,0.0,0.0,0.0
20591.0,17,2,582,1,83,0.0,83.0,83.0,1,499,0.0,499.0,499.0
96156.0,6,14,4740,7,653,15182.833333333334,249.0,93.28571428571428,7,4087,14649.0,1514.0,583.8571428571429
5609771.0,6,5,336,2,134,0.0,68.0,67.0,3,202,1525588.0,70.0,67.33333333333333
90017823.0,17,28,13364,28,13364,3333993.4444444445,501.0,477.2857142857143,0,0,0.0,0.0,0.0
284.0,17,2,174,1,79,0.0,79.0,79.0,1,95,0.0,95.0,95.0
222688.0,17,4,1400,4,1400,74229.33333333333,350.0,350.0,0,0,0.0,0.0,0.0
41115.0,6,14,4740,7,653,6227.166666666667,249.0,93.28571428571428,7,4087,6390.333333333333,1514.0,583.8571428571429
207354.0,6,3,426,2,280,0.0,214.0,140.0,1,146,0.0,146.0,146.0
1136369.0,6,13,3002,8,2374,162338.42857142858,1514.0,296.75,5,628,215068.25,331.0,125.6
807.0,17,4,438,2,148,0.0,74.0,74.0,2,290,0.0,147.0,145.0
113573917.0,6,30,1974,15,1026,8096992.714285715,123.0,68.4,15,948,8096992.928571428,123.0,63.2
410.0,17,2,410,1,78,0.0,78.0,78.0,1,332,0.0,332.0,332.0
153385.0,6,11,1132,6,556,29937.6,218.0,92.66666666666669,5,576,37926.5,304.0,115.2
14419.0,6,10,2032,5,524,3339.5,252.0,104.8,5,1508,3310.0,1236.0,301.6
30842.0,6,14,4740,7,653,4979.833333333333,249.0,93.28571428571428,7,4087,4500.166666666667,1514.0,583.8571428571429
120997491.0,17,15,907,8,475,17285355.85714286,174.0,59.375,7,432,16833499.333333332,174.0,61.71428571428572
300118.0,6,6,412,4,272,100039.33333333331,74.0,68.0,2,140,0.0,74.0,70.0
104215115.0,6,192,21664,96,15106,1094732.1684210526,284.0,157.35416666666666,96,6558,1094735.8736842105,140.0,68.3125
90053036.0,17,28,13364,28,13364,3335297.6296296297,501.0,477.2857142857143,0,0,0.0,0.0,0.0
2101.0,17,4,344,2,150,0.0,75.0,75.0,2,194,0.0,103.0,97.0
34369.0,6,13,1386,7,789,5620.0,253.0,112.71428571428572,6,597,6464.8,259.0,99.5
108117146.0,17,5,955,5,955,27029286.5,191.0,191.0,0,0,0.0,0.0,0.0
222492.0,6,3,426,2,280,0.0,214.0,140.0,1,146,0.0,146.0,146.0
233112.0,6,3,337,2,214,0.0,160.0,107.0,1,123,0.0,123.0,123.0
114747382.0,17,14,864,7,432,18834236.166666668,174.0,61.71428571428572,7,432,19000229.666666668,174.0,61.71428571428572
117543063.0,6,32,2220,16,1149,7821802.6,123.0,71.8125,16,1071,7821801.266666667,123.0,66.9375
20286.0,6,10,2032,5,524,4788.25,252.0,104.8,5,1508,4338.75,1236.0,301.6
120032714.0,17,28,13364,28,13364,4445656.074074074,501.0,477.2857142857143,0,0,0.0,0.0,0.0
237326.0,6,3,426,2,280,0.0,214.0,140.0,1,146,0.0,146.0,146.0
3861863.0,6,174,134753,95,125237,41083.64893617021,1510.0,1318.2842105263155,79,9516,45466.230769230766,1510.0,120.45569620253164
3008013.0,6,11,2106,6,598,601351.8,252.0,99.66666666666669,5,1508,2290.0,1236.0,301.6
74611409.0,6,9,842,9,842,9326426.125,97.0,93.55555555555556,0,0,0.0,0.0,0.0
446801.0,17,4,360,2,140,0.0,70.0,70.0,2,220,0.0,110.0,110.0
59798.0,6,14,4740,7,653,9514.333333333334,249.0,93.28571428571428,7,4087,8609.166666666666,1514.0,583.8571428571429
247063.0,6,3,337,2,214,0.0,160.0,107.0,1,123,0.0,123.0,123.0
25791.0,6,10,2032,5,524,4824.75,252.0,104.8,5,1508,6126.75,1236.0,301.6
207175.0,6,3,426,2,280,0.0,214.0,140.0,1,146,0.0,146.0,146.0
302103.0,6,6,412,4,272,100701.0,74.0,68.0,2,140,0.0,74.0,70.0
232947.0,6,3,337,2,214,0.0,160.0,107.0,1,123,0.0,123.0,123.0
32706.0,6,14,4740,7,653,4949.666666666667,249.0,93.28571428571428,7,4087,5131.833333333333,1514.0,583.8571428571429
99374.0,17,2,762,2,762,0.0,381.0,381.0,0,0,0.0,0.0,0.0
309919.0,17,4,1400,4,1400,103306.33333333331,350.0,350.0,0,0,0.0,0.0,0.0
14545.0,6,10,1067,5,536,3471.75,264.0,107.2,5,531,3039.75,259.0,106.2
16822.0,17,2,180,1,90,0.0,90.0,90.0,1,90,0.0,90.0,90.0
120119083.0,6,12,1832,8,1016,17136880.14285714,188.0,127.0,4,816,30029695.666666668,204.0,204.0
9321.0,17,2,539,1,86,0.0,86.0,86.0,1,453,0.0,453.0,453.0
117300232.0,6,221,24950,111,7622,1066365.7454545454,140.0,68.66666666666667,110,17328,1066725.3577981652,284.0,157.52727272727273
246064.0,17,4,1400,4,1400,82021.33333333333,350.0,350.0,0,0,0.0,0.0,0.0
203101.0,17,2,762,2,762,0.0,381.0,381.0,0,0,0.0,0.0,0.0
307840.0,6,3,202,2,128,0.0,74.0,64.0,1,74,0.0,74.0,74.0
14641471.0,6,20,1607,10,975,1592552.3333333333,315.0,97.5,10,632,1592519.7777777778,78.0,63.2
90258604.0,6,12,1832,8,1016,12894086.285714284,188.0,127.0,4,816,30030786.666666668,204.0,204.0
228381.0,17,2,180,1,90,0.0,90.0,90.0,1,90,0.0,90.0,90.0
2309.0,17,4,344,2,150,0.0,75.0,75.0,2,194,0.0,103.0,97.0
308565.0,6,6,412,4,272,102855.0,74.0,68.0,2,140,0.0,74.0,70.0
59928.0,6,14,4740,7,653,9104.166666666666,249.0,93.28571428571428,7,4087,9791.666666666666,1514.0,583.8571428571429
300041.0,6,6,412,4,272,100013.66666666669,74.0,68.0,2,140,0.0,74.0,70.0
19907.0,17,2,582,1,83,0.0,83.0,83.0,1,499,0.0,499.0,499.0
455819.0,6,10,1221,6,636,91163.8,298.0,106.0,4,585,146538.66666666666,379.0,146.25
44852.0,6,12,1320,7,789,7475.333333333333,253.0,112.71428571428572,5,531,9902.75,259.0,106.2
347.0,17,2,174,1,79,0.0,79.0,79.0,1,95,0.0,95.0,95.0
90773055.0,6,17,1287,9,691,11340334.625,95.0,76.77777777777777,8,596,12965785.0,95.0,74.5
45204.0,6,13,1386,7,789,7172.5,253.0,112.71428571428572,6,597,7743.6,259.0,99.5
14328.0,6,10,1067,5,536,2942.5,264.0,107.2,5,531,3254.25,259.0,106.2
5830245.0,6,5,336,2,134,0.0,68.0,67.0,3,202,1522853.0,70.0,67.33333333333333
211282.0,17,2,762,2,762,0.0,381.0,381.0,0,0,0.0,0.0,0.0
15645.0,17,2,582,1,83,0.0,83.0,83.0,1,499,0.0,499.0,499.0
42446.0,6,14,4740,7,653,6949.5,249.0,93.28571428571428,7,4087,6542.333333333333,1514.0,583.8571428571429
312397.0,6,3,202,2,128,0.0,74.0,64.0,1,74,0.0,74.0,74.0
113732464.0,6,48,3168,24,1584,4942399.304347826,66.0,66.0,24,1584,4938159.260869565,66.0,66.0
247646.0,6,3,337,2,214,0.0,160.0,107.0,1,123,0.0,123.0,123.0
303211.0,6,2,132,1,66,0.0,66.0,66.0,1,66,0.0,66.0,66.0
40417.0,6,10,2032,5,524,9844.25,252.0,104.8,5,1508,9028.25,1236.0,301.6
37090.0,6,10,2032,5,524,9061.0,252.0,104.8,5,1508,8924.0,1236.0,301.6
18358.0,6,11,2098,6,590,3268.8,252.0,98.33333333333331,5,1508,4150.75,1236.0,301.6
275465.0,17,2,238,1,74,0.0,74.0,74.0,1,164,0.0,164.0,164.0
242513.0,6,3,337,2,214,0.0,160.0,107.0,1,123,0.0,123.0,123.0
108101813.0,17,5,1005,5,1005,27025453.25,201.0,201.0,0,0,0.0,0.0,0.0
307608.0,6,6,412,4,272,102536.0,74.0,68.0,2,140,0.0,74.0,70.0
417.0,17,2,410,1,78,0.0,78.0,78.0,1,332,0.0,332.0,332.0
79275.0,6,10,2032,5,524,19520.5,252.0,104.8,5,1508,19087.75,1236.0,301.6
22652.0,6,10,2032,5,524,5032.0,252.0,104.8,5,1508,5406.25,1236.0,301.6
82.0,17,2,762,2,762,0.0,381.0,381.0,0,0,0.0,0.0,0.0
1097158.0,6,4,270,2,134,0.0,68.0,67.0,2,136,0.0,70.0,68.0
41620.0,6,10,2032,5,524,10169.75,252.0,104.8,5,1508,10136.75,1236.0,301.6
144019.0,17,2,180,1,90,0.0,90.0,90.0,1,90,0.0,90.0,90.0
42727.0,6,10,2032,5,524,10506.25,252.0,104.8,5,1508,10046.75,1236.0,301.6
14637346.0,6,20,1648,10,1016,1592247.888888889,315.0,101.6,10,632,1592221.7777777778,78.0,63.2
90099623.0,6,166,18788,83,13162,1096150.8048780488,390.0,158.57831325301206,83,5626,1096151.536585366,140.0,67.78313253012048
135134525.0,17,6,1146,6,1146,27026905.0,191.0,191.0,0,0,0.0,0.0,0.0
81049272.0,17,13,4446,13,4446,6754106.0,342.0,342.0,0,0,0.0,0.0,0.0
321.0,17,2,174,1,79,0.0,79.0,79.0,1,95,0.0,95.0,95.0
90040433.0,17,27,12943,27,12943,3463093.576923077,501.0,479.3703703703704,0,0,0.0,0.0,0.0
15644.000000000002,6,14,4740,7,653,2487.333333333333,249.0,93.28571428571428,7,4087,2473.833333333333,1514.0,583.8571428571429
27979.0,6,20,7606,11,978,2797.9,310.0,88.9090909090909,9,6628,3110.625,1514.0,736.4444444444445
300919.0,6,6,412,4,272,100306.33333333331,74.0,68.0,2,140,0.0,74.0,70.0
264755.0,6,10,1221,6,636,52951.0,298.0,106.0,4,585,82486.0,379.0,146.25
924864.0,6,12,1354,6,723,183683.2,253.0,120.5,6,631,183982.6,293.0,105.16666666666669
14994.0,17,2,180,1,90,0.0,90.0,90.0,1,90,0.0,90.0,90.0
105409572.0,6,44,2904,22,1452,5019503.428571428,66.0,66.0,22,1452,5005022.285714285,66.0,66.0
200995.0,17,2,906,2,906,0.0,453.0,453.0,0,0,0.0,0.0,0.0
111689.0,17,2,286,2,286,0.0,143.0,143.0,0,0,0.0,0.0,0.0
103244.0,17,2,286,2,286,0.0,143.0,143.0,0,0,0.0,0.0,0.0
23665.0,6,10,1975,5,467,5600.0,195.0,93.4,5,1508,4901.25,1236.0,301.6
3172200.0,6,18,1495,9,921,358165.625,315.0,102.33333333333331,9,574,358130.875,78.0,63.77777777777778
441520.0,6,10,967,5,390,74309.5,162.0,78.0,5,577,74244.5,349.0,115.4
1491638.0,6,20,7599,11,1469,149163.8,583.0,133.54545454545453,9,6130,154464.25,1484.0,681.1111111111111
90260853.0,6,14,2240,8,1016,12894407.57142857,188.0,127.0,6,1224,18018411.4,204.0,204.0
365946.0,6,10,1221,6,636,73189.2,298.0,106.0,4,585,120734.66666666669,379.0,146.25
52200.0,6,10,2032,5,524,12555.5,252.0,104.8,5,1508,12121.0,1236.0,301.6
29157.0,6,12,1320,6,723,4790.6,253.0,120.5,6,597,4898.6,259.0,99.5
232430.0,6,3,337,2,214,0.0,160.0,107.0,1,123,0.0,123.0,123.0
153482.0,17,2,180,1,90,0.0,90.0,90.0,1,90,0.0,90.0,90.0
753.0,17,4,438,2,148,0.0,74.0,74.0,2,290,0.0,147.0,145.0
299.0,17,2,168,1,76,0.0,76.0,76.0,1,92,0.0,92.0,92.0
299236.0,6,6,412,4,272,99745.33333333331,74.0,68.0,2,140,0.0,74.0,70.0
16322451.0,17,6,2052,6,2052,3264490.2,342.0,342.0,0,0,0.0,0.0,0.0
10936132.0,6,8,544,4,272,3600283.6666666665,74.0,68.0,4,272,3600221.0,74.0,68.0
54721.0,6,14,4740,7,653,8424.333333333334,249.0,93.28571428571428,7,4087,8149.833333333333,1514.0,583.8571428571429
120120879.0,6,14,2240,6,1224,24024175.8,204.0,204.0,8,1016,17136994.85714286,188.0,127.0
103567420.0,6,44,2904,22,1452,4931781.904761905,66.0,66.0,22,1452,4917044.857142857,66.0,66.0
84938.0,6,14,4740,7,653,14032.666666666666,249.0,93.28571428571428,7,4087,13928.666666666666,1514.0,583.8571428571429
98000779.0,17,11,735,6,389,19600155.8,174.0,64.83333333333333,5,346,19962447.25,174.0,69.2
223195.0,6,3,426,2,280,0.0,214.0,140.0,1,146,0.0,146.0,146.0
8412795.0,17,4,1376,3,1026,893067.0,342.0,342.0,1,350,0.0,350.0,350.0
2438.0,17,4,344,2,150,0.0,75.0,75.0,2,194,0.0,103.0,97.0
17499.0,6,14,4740,7,653,2806.1666666666665,249.0,93.28571428571428,7,4087,2783.1666666666665,1514.0,583.8571428571429
258508.00000000003,17,4,1524,4,1524,86169.33333333333,381.0,381.0,0,0,0.0,0.0,0.0
2340.0,17,4,344,2,150,0.0,75.0,75.0,2,194,0.0,103.0,97.0
25210.0,6,14,4740,7,653,3752.8333333333335,249.0,93.28571428571428,7,4087,4047.6666666666665,1514.0,583.8571428571429
3175524.0,6,18,1495,9,921,358381.5,315.0,102.33333333333331,9,574,358350.125,78.0,63.77777777777778
218479.0,6,13,1394,7,797,36413.16666666666,253.0,113.85714285714286,6,597,42588.4,259.0,99.5
11949.0,6,10,2032,5,524,2617.25,252.0,104.8,5,1508,2682.25,1236.0,301.6
123839765.0,6,48,3168,24,1584,5137247.130434782,66.0,66.0,24,1584,5160151.0869565215,66.0,66.0
41169.0,6,14,4740,7,653,6483.333333333333,249.0,93.28571428571428,7,4087,5873.5,1514.0,583.8571428571429
41577.0,6,10,2032,5,524,8943.5,252.0,104.8,5,1508,9657.0,1236.0,301.6
302953.0,6,6,412,4,272,100984.33333333331,74.0,68.0,2,140,0.0,74.0,70.0
1310965.0,6,4,264,2,132,0.0,66.0,66.0,2,132,0.0,66.0,66.0
94978585.0,6,179,20160,90,6162,1067175.1123595503,140.0,68.46666666666667,89,13998,1067451.6022727273,284.0,157.2808988764045
37512.0,6,14,4740,7,653,6129.833333333333,249.0,93.28571428571428,7,4087,5529.0,1514.0,583.8571428571429
108106395.0,17,5,1005,5,1005,27026598.75,201.0,201.0,0,0,0.0,0.0,0.0
49551.0,6,14,4740,7,653,8022.833333333333,249.0,93.28571428571428,7,4087,7308.166666666667,1514.0,583.8571428571429
82673.0,6,19,7540,10,912,9100.444444444443,310.0,91.2,9,6628,10155.0,1514.0,736.4444444444445
49131.0,6,14,4740,7,653,8064.833333333333,249.0,93.28571428571428,7,4087,7909.166666666667,1514.0,583.8571428571429
108105493.0,17,5,955,5,955,27026373.25,191.0,191.0,0,0,0.0,0.0,0.0
739.0,17,2,508,2,508,0.0,257.0,254.0,0,0,0.0,0.0,0.0
5617207.0,6,5,336,2,134,0.0,68.0,67.0,3,202,1525187.5,70.0,67.33333333333333
74449.0,6,14,4740,7,653,12281.166666666666,249.0,93.28571428571428,7,4087,11201.166666666666,1514.0,583.8571428571429
121203.0,6,3,337,2,214,0.0,160.0,107.0,1,123,0.0,123.0,123.0
203066.0,17,4,1524,4,1524,67688.66666666667,381.0,381.0,0,0,0.0,0.0,0.0
0.0,6,1,66,1,66,0.0,66.0,66.0,0,0,0.0,0.0,0.0
629117.0,17,2,346,1,78,0.0,78.0,78.0,1,268,0.0,268.0,268.0
143965.0,17,2,180,1,90,0.0,90.0,90.0,1,90,0.0,90.0,90.0
302148.0,17,2,246,1,76,0.0,76.0,76.0,1,170,0.0,170.0,170.0
301474.0,6,6,412,4,272,100491.33333333331,74.0,68.0,2,140,0.0,74.0,70.0
107846.0,17,2,286,2,286,0.0,143.0,143.0,0,0,0.0,0.0,0.0
90259868.0,6,12,1832,8,1016,12894266.857142856,188.0,127.0,4,816,30032077.666666668,204.0,204.0
28792.0,6,10,2032,5,524,6654.0,252.0,104.8,5,1508,6628.5,1236.0,301.6
146215.0,6,3,337,2,214,0.0,160.0,107.0,1,123,0.0,123.0,123.0
216454.0,17,2,180,1,90,0.0,90.0,90.0,1,90,0.0,90.0,90.0
303384.0,6,3,202,2,128,0.0,74.0,64.0,1,74,0.0,74.0,74.0
321137.0,6,6,412,4,272,107045.66666666669,74.0,68.0,2,140,0.0,74.0,70.0
31632.0,6,10,2032,5,524,7179.0,252.0,104.8,5,1508,7605.25,1236.0,301.6
19921.0,17,2,582,1,83,0.0,83.0,83.0,1,499,0.0,499.0,499.0
21367.0,6,14,4740,7,653,3439.1666666666665,249.0,93.28571428571428,7,4087,3380.333333333333,1514.0,583.8571428571429
846297.0,6,9,1096,6,625,169259.4,287.0,104.16666666666669,3,471,285391.5,331.0,157.0
0.0,6,1,54,0,0,0.0,0.0,0.0,1,54,0.0,54.0,54.0
90055789.0,17,28,13364,28,13364,3335399.592592593,501.0,477.2857142857143,0,0,0.0,0.0,0.0
153548.0,17,2,180,1,90,0.0,90.0,90.0,1,90,0.0,90.0,90.0
135138241.0,17,6,1206,6,1206,27027648.2,201.0,201.0,0,0,0.0,0.0,0.0
303553.0,6,6,412,4,272,101184.33333333331,74.0,68.0,2,140,0.0,74.0,70.0
316306.0,17,4,1400,4,1400,105435.33333333331,350.0,350.0,0,0,0.0,0.0,0.0
0.0,6,1,66,1,66,0.0,66.0,66.0,0,0,0.0,0.0,0.0
496609.0,6,5,336,2,134,0.0,68.0,67.0,3,202,196246.5,70.0,67.33333333333333
461158.0,17,2,374,1,73,0.0,73.0,73.0,1,301,0.0,301.0,301.0
105731.0,17,2,700,2,700,0.0,350.0,350.0,0,0,0.0,0.0,0.0
303064.0,6,6,412,4,272,101021.33333333331,74.0,68.0,2,140,0.0,74.0,70.0
302371.0,6,2,132,1,66,0.0,66.0,66.0,1,66,0.0,66.0,66.0
146049.0,6,3,337,2,214,0.0,160.0,107.0,1,123,0.0,123.0,123.0
120379886.0,6,221,24912,111,17356,1094362.6,284.0,156.36036036036035,110,7556,1094959.6605504588,140.0,68.69090909090909
85.0,17,2,762,2,762,0.0,381.0,381.0,0,0,0.0,0.0,0.0
34897.0,6,2,145,2,145,0.0,91.0,72.5,0,0,0.0,0.0,0.0
297.0,17,2,164,1,82,0.0,82.0,82.0,1,82,0.0,82.0,82.0
90032422.0,17,27,12943,27,12943,3462785.461538461,501.0,479.3703703703704,0,0,0.0,0.0,0.0
90002842.0,6,15,1097,8,596,12857548.857142856,95.0,74.5,7,501,14950786.166666666,95.0,71.57142857142857
206319.0,6,3,426,2,280,0.0,214.0,140.0,1,146,0.0,146.0,146.0
5621794.0,6,5,336,2,134,0.0,68.0,67.0,3,202,1520754.0,70.0,67.33333333333333
52229.0,6,10,2032,5,524,12683.75,252.0,104.8,5,1508,11242.0,1236.0,301.6
8908.0,6,10,2032,5,524,1978.0,252.0,104.8,5,1508,1928.75,1236.0,301.6
242806.0,6,3,337,2,214,0.0,160.0,107.0,1,123,0.0,123.0,123.0
135132669.0,17,6,1146,6,1146,27026533.8,191.0,191.0,0,0,0.0,0.0,0.0
2355.0,17,4,344,2,150,0.0,75.0,75.0,2,194,0.0,103.0,97.0
13822.0,6,14,4740,7,653,2092.0,249.0,93.28571428571428,7,4087,2168.5,1514.0,583.8571428571429
121993.0,6,3,337,2,214,0.0,160.0,107.0,1,123,0.0,123.0,123.0
120010727.0,17,28,13364,28,13364,4444841.740740741,501.0,477.2857142857143,0,0,0.0,0.0,0.0
2301.0,17,4,344,2,150,0.0,75.0,75.0,2,194,0.0,103.0,97.0
90052001.0,17,28,13364,28,13364,3335259.296296296,501.0,477.2857142857143,0,0,0.0,0.0,0.0
2337.0,17,4,344,2,150,0.0,75.0,75.0,2,194,0.0,103.0,97.0
135137777.0,17,6,1146,6,1146,27027555.4,191.0,191.0,0,0,0.0,0.0,0.0
90539799.0,6,13,2036,8,1016,12934257.0,188.0,127.0,5,1020,22592971.5,204.0,204.0
104331224.0,6,194,21870,97,15246,1084542.3229166667,284.0,157.17525773195877,97,6624,1084542.1770833333,140.0,68.28865979381443
30668.0,6,10,2032,5,524,5791.75,252.0,104.8,5,1508,7377.5,1236.0,301.6
71500.0,6,14,4740,7,653,11293.333333333334,249.0,93.28571428571428,7,4087,10328.666666666666,1514.0,583.8571428571429
107099479.0,6,197,22286,99,6756,1092851.8265306123,140.0,68.24242424242425,98,15530,1093457.329896907,284.0,158.46938775510205
113756370.0,6,46,3036,23,1518,5155894.818181818,66.0,66.0,23,1518,5155921.590909091,66.0,66.0
23747.0,6,2,145,2,145,0.0,91.0,72.5,0,0,0.0,0.0,0.0
1302392.0,6,4,264,2,132,0.0,66.0,66.0,2,132,0.0,66.0,66.0
192606.0,17,4,6056,4,6056,64202.0,1514.0,1514.0,0,0,0.0,0.0,0.0
2335.0,17,4,344,2,150,0.0,75.0,75.0,2,194,0.0,103.0,97.0
51859.0,6,14,4740,7,653,8266.666666666666,249.0,93.28571428571428,7,4087,8113.666666666667,1514.0,583.8571428571429
193152.0,17,2,180,1,90,0.0,90.0,90.0,1,90,0.0,90.0,90.0
315712.0,17,4,1400,4,1400,105237.33333333331,350.0,350.0,0,0,0.0,0.0,0.0
120714247.0,17,13,821,6,389,20177087.6,174.0,64.83333333333333,7,432,20092220.5,174.0,61.71428571428572
120164588.0,6,228,25772,114,7820,1061163.2300884956,140.0,68.59649122807018,114,17952,1056546.1415929203,284.0,157.47368421052633
184862.0,17,2,180,1,90,0.0,90.0,90.0,1,90,0.0,90.0,90.0
16950.0,6,11,1132,6,556,3247.0,218.0,92.66666666666669,5,576,3595.5,304.0,115.2
2235.0,17,4,344,2,150,0.0,75.0,75.0,2,194,0.0,103.0,97.0
216919.0,6,3,426,2,280,0.0,214.0,140.0,1,146,0.0,146.0,146.0
1170568.0,6,13,3009,8,2381,167224.0,1514.0,297.625,5,628,223437.25,331.0,125.6
52741.0,6,14,4740,7,653,8597.0,249.0,93.28571428571428,7,4087,8332.166666666666,1514.0,583.8571428571429
456258.0,6,5,367,2,132,0.0,66.0,66.0,3,235,228129.0,103.0,78.33333333333333
56252.0,6,14,4740,7,653,9102.333333333334,249.0,93.28571428571428,7,4087,9236.166666666666,1514.0,583.8571428571429
118112674.0,6,32,2236,16,1165,7859802.2,139.0,72.8125,16,1071,7859751.933333334,123.0,66.9375
4728.0,17,2,762,2,762,0.0,381.0,381.0,0,0,0.0,0.0,0.0
90040424.0,17,28,13364,28,13364,3334830.5185185187,501.0,477.2857142857143,0,0,0.0,0.0,0.0
120176505.0,6,228,25756,114,7820,1056268.9646017698,140.0,68.59649122807018,114,17936,1056102.8495575222,284.0,157.33333333333334
241804.0,6,3,337,2,214,0.0,160.0,107.0,1,123,0.0,123.0,123.0
177578.0,17,4,1524,4,1524,59192.66666666666,381.0,381.0,0,0,0.0,0.0,0.0
90257547.0,6,12,1832,8,1016,12893935.285714284,188.0,127.0,4,816,30031465.666666668,204.0,204.0
2321.0,17,4,344,2,150,0.0,75.0,75.0,2,194,0.0,103.0,97.0
49853.0,6,14,4740,7,653,6929.666666666667,249.0,93.28571428571428,7,4087,7426.833333333333,1514.0,583.8571428571429
306681.0,6,6,412,4,272,102227.0,74.0,68.0,2,140,0.0,74.0,70.0
94205.0,6,12,1320,7,789,15700.833333333334,253.0,112.71428571428572,5,531,21135.75,259.0,106.2
29276.0,6,14,4740,7,653,4740.833333333333,249.0,93.28571428571428,7,4087,4564.5,1514.0,583.8571428571429
119824402.0,6,208,23536,104,16376,1161042.009708738,284.0,157.46153846153845,104,7160,1161254.7087378642,140.0,68.84615384615384
208829.0,6,3,426,2,280,0.0,214.0,140.0,1,146,0.0,146.0,146.0
123839693.0,6,48,3168,24,1584,5018228.0869565215,66.0,66.0,24,1584,5280034.478260869,66.0,66.0
215351.0,6,10,1221,6,636,43070.2,298.0,106.0,4,585,70793.66666666667,379.0,146.25
120122066.0,6,14,2224,9,1204,15015258.25,188.0,133.77777777777777,5,1020,22591103.25,204.0,204.0
1549989.0,6,2,132,1,66,0.0,66.0,66.0,1,66,0.0,66.0,66.0
101085181.0,6,30,2106,15,1089,7220370.071428572,123.0,72.6,15,1017,7204921.5,123.0,67.8
216377.0,17,2,180,1,90,0.0,90.0,90.0,1,90,0.0,90.0,90.0
106618.0,17,2,700,2,700,0.0,350.0,350.0,0,0,0.0,0.0,0.0
28536.0,6,14,4740,7,653,4544.5,249.0,93.28571428571428,7,4087,4568.666666666667,1514.0,583.8571428571429
90277821.0,6,12,1832,8,1016,12896831.57142857,188.0,127.0,4,816,30026686.666666668,204.0,204.0
15666400.0,17,12,4200,12,4200,1424218.181818182,350.0,350.0,0,0,0.0,0.0,0.0
385.0,17,2,166,1,75,0.0,75.0,75.0,1,91,0.0,91.0,91.0
40927.0,6,14,4740,7,653,6659.166666666667,249.0,93.28571428571428,7,4087,6030.333333333333,1514.0,583.8571428571429
41012.0,6,14,4740,7,653,6114.166666666667,249.0,93.28571428571428,7,4087,6016.833333333333,1514.0,583.8571428571429
643.0,17,2,762,2,762,0.0,381.0,381.0,0,0,0.0,0.0,0.0
310986.0,6,6,412,4,272,103662.0,74.0,68.0,2,140,0.0,74.0,70.0
7279.0,17,2,582,1,83,0.0,83.0,83.0,1,499,0.0,499.0,499.0
13596.0,6,14,4740,7,653,2099.6666666666665,249.0,93.28571428571428,7,4087,2132.833333333333,1514.0,583.8571428571429
185311.0,17,2,180,1,90,0.0,90.0,90.0,1,90,0.0,90.0,90.0
113254671.0,6,46,3036,23,1518,5135430.863636363,66.0,66.0,23,1518,5135429.590909091,66.0,66.0
143935.0,17,2,180,1,90,0.0,90.0,90.0,1,90,0.0,90.0,90.0
43334.0,6,10,2032,5,524,9328.75,252.0,104.8,5,1508,10550.5,1236.0,301.6
90032538.0,17,28,13364,28,13364,3334538.4444444445,501.0,477.2857142857143,0,0,0.0,0.0,0.0
1301857.0,6,4,264,2,132,0.0,66.0,66.0,2,132,0.0,66.0,66.0
92828195.0,6,18,1503,9,853,11603179.625,257.0,94.77777777777776,9,650,11601991.5,95.0,72.22222222222223
98299.0,17,2,762,2,762,0.0,381.0,381.0,0,0,0.0,0.0,0.0
26176.0,6,10,2032,5,524,6220.0,252.0,104.8,5,1508,5971.25,1236.0,301.6
260.0,17,2,700,2,700,0.0,350.0,350.0,0,0,0.0,0.0,0.0
53285.0,6,10,2032,5,524,12420.5,252.0,104.8,5,1508,13067.0,1236.0,301.6
23748.0,6,14,4740,7,653,3757.0,249.0,93.28571428571428,7,4087,3306.833333333333,1514.0,583.8571428571429
5630030.0,6,5,336,2,134,0.0,68.0,67.0,3,202,1522449.5,70.0,67.33333333333333
110594.0,17,2,286,2,286,0.0,143.0,143.0,0,0,0.0,0.0,0.0
14963.0,6,14,4740,7,653,2338.333333333333,249.0,93.28571428571428,7,4087,2181.5,1514.0,583.8571428571429
232290.0,6,3,337,2,214,0.0,160.0,107.0,1,123,0.0,123.0,123.0
17352.0,6,14,4740,7,653,2494.6666666666665,249.0,93.28571428571428,7,4087,2759.333333333333,1514.0,583.8571428571429
2382.0,17,4,344,2,150,0.0,75.0,75.0,2,194,0.0,103.0,97.0
2476.0,17,4,344,2,150,0.0,75.0,75.0,2,194,0.0,103.0,97.0
308715.0,6,6,412,4,272,102905.0,74.0,68.0,2,140,0.0,74.0,70.0
42346.0,6,14,4740,7,653,6191.333333333333,249.0,93.28571428571428,7,4087,6484.666666666667,1514.0,583.8571428571429
108098207.0,17,5,955,5,955,27024551.75,191.0,191.0,0,0,0.0,0.0,0.0
122200.0,6,3,337,2,214,0.0,160.0,107.0,1,123,0.0,123.0,123.0
343.0,17,2,160,1,80,0.0,80.0,80.0,1,80,0.0,80.0,80.0
13104924.0,6,26,7627,14,3735,202082.3076923077,1514.0,266.7857142857143,12,3892,1172678.0,1514.0,324.3333333333333
200501.0,17,4,1524,4,1524,66833.66666666667,381.0,381.0,0,0,0.0,0.0,0.0
2320.0,17,4,344,2,150,0.0,75.0,75.0,2,194,0.0,103.0,97.0
1023343.0,6,11,1134,6,558,204668.60000000003,220.0,93.0,5,576,255300.25,304.0,115.2
92998694.0,6,162,18318,81,12750,1159793.1625,284.0,157.40740740740742,81,5568,1159793.0625,140.0,68.74074074074075
206375.0,6,3,426,2,280,0.0,214.0,140.0,1,146,0.0,146.0,146.0
2358.0,17,4,344,2,150,0.0,75.0,75.0,2,194,0.0,103.0,97.0
50915.0,17,2,180,1,90,0.0,90.0,90.0,1,90,0.0,90.0,90.0
13875.0,17,2,180,1,90,0.0,90.0,90.0,1,90,0.0,90.0,90.0
110547.0,17,2,286,2,286,0.0,143.0,143.0,0,0,0.0,0.0,0.0
103839181.0,6,43,2838,22,1452,4944711.238095238,66.0,66.0,21,1386,5159996.0,66.0,66.0
116572.0,17,4,1400,4,1400,38857.333333333336,350.0,350.0,0,0,0.0,0.0,0.0
149723094.0,6,15,2290,10,1270,16635899.333333334,188.0,127.0,5,1020,22523502.75,204.0,204.0
27997.0,6,10,2032,5,524,6729.75,252.0,104.8,5,1508,6333.75,1236.0,301.6
21665.0,17,2,582,1,83,0.0,83.0,83.0,1,499,0.0,499.0,499.0
2420.0,17,4,344,2,150,0.0,75.0,75.0,2,194,0.0,103.0,97.0
162282.0,17,2,180,1,90,0.0,90.0,90.0,1,90,0.0,90.0,90.0
120125818.0,6,15,2306,7,1290,20020969.666666668,204.0,184.28571428571428,8,1016,17136990.285714287,188.0,127.0
301213.0,6,6,412,4,272,100404.33333333331,74.0,68.0,2,140,0.0,74.0,70.0
118899040.0,6,34,2334,17,1209,7417700.4375,123.0,71.11764705882354,17,1125,7417698.75,123.0,66.17647058823529
135143141.0,17,6,1206,6,1206,27028628.2,201.0,201.0,0,0,0.0,0.0,0.0
120000058.0,6,19,1564,10,745,13333339.777777778,95.0,74.5,9,819,11286122.875,223.0,91.0
122999443.0,17,15,1038,8,606,17571349.0,174.0,75.75,7,432,19921364.83333333,174.0,61.71428571428572
506082.00000000006,6,5,336,2,134,0.0,68.0,67.0,3,202,194820.0,70.0,67.33333333333333
90259120.0,6,12,1832,8,1016,12894160.0,188.0,127.0,4,816,30031001.0,204.0,204.0
120531228.0,17,15,1038,7,432,19279710.33333333,174.0,61.71428571428572,8,606,17151230.57142857,174.0,75.75
314474.0,17,4,1400,4,1400,104824.66666666669,350.0,350.0,0,0,0.0,0.0,0.0
205807.0,17,2,180,1,90,0.0,90.0,90.0,1,90,0.0,90.0,90.0
2592340.0,6,2,132,1,66,0.0,66.0,66.0,1,66,0.0,66.0,66.0
90043489.0,17,28,13364,28,13364,3334944.037037037,501.0,477.2857142857143,0,0,0.0,0.0,0.0
1779907.0,6,2,132,1,66,0.0,66.0,66.0,1,66,0.0,66.0,66.0
2100827.0,17,3,1026,3,1026,1050413.5,342.0,342.0,0,0,0.0,0.0,0.0
3179694.0,6,18,1536,9,962,358374.5,315.0,106.88888888888889,9,574,358334.25,78.0,63.77777777777778
418.0,17,2,174,1,79,0.0,79.0,79.0,1,95,0.0,95.0,95.0
102708.0,17,2,286,2,286,0.0,143.0,143.0,0,0,0.0,0.0,0.0
53867.0,6,14,4740,7,653,8712.166666666666,249.0,93.28571428571428,7,4087,8679.5,1514.0,583.8571428571429
26445.0,6,14,4740,7,653,3931.1666666666665,249.0,93.28571428571428,7,4087,4267.5,1514.0,583.8571428571429
90255360.0,6,14,2240,8,1016,12893622.857142856,188.0,127.0,6,1224,18018313.8,204.0,204.0
10507085.0,6,6,412,3,206,5185412.0,74.0,68.66666666666667,3,206,5185312.0,74.0,68.66666666666667
81081421.0,17,4,764,4,764,27027140.33333333,191.0,191.0,0,0,0.0,0.0,0.0
3098512.0,6,3,1777,1,826,0.0,826.0,826.0,2,951,0.0,885.0,475.5
739.0,17,4,438,2,148,0.0,74.0,74.0,2,290,0.0,147.0,145.0
1563217.0,6,4,276,2,128,0.0,74.0,64.0,2,148,0.0,74.0,74.0
112402615.0,17,13,821,7,432,18733769.166666668,174.0,61.71428571428572,6,389,18507571.6,174.0,64.83333333333333
90053587.0,17,28,13364,28,13364,3335318.037037037,501.0,477.2857142857143,0,0,0.0,0.0,0.0
90289405.0,6,13,2036,8,1016,12898486.42857143,188.0,127.0,5,1020,22531460.25,204.0,204.0
44341.0,6,14,4740,7,653,6959.333333333333,249.0,93.28571428571428,7,4087,5935.833333333333,1514.0,583.8571428571429
48908.0,6,14,4740,7,653,8028.166666666667,249.0,93.28571428571428,7,4087,7860.5,1514.0,583.8571428571429
121161.0,6,3,337,2,214,0.0,160.0,107.0,1,123,0.0,123.0,123.0
32546.0,6,14,4740,7,653,5300.666666666667,249.0,93.28571428571428,7,4087,5119.0,1514.0,583.8571428571429
148113.0,17,2,180,1,90,0.0,90.0,90.0,1,90,0.0,90.0,90.0
1017793.0,6,12,1447,6,816,200352.4,291.0,136.0,6,631,202919.8,293.0,105.16666666666669
284457.0,17,2,363,1,79,0.0,79.0,79.0,1,284,0.0,284.0,284.0
28653.0,6,14,4740,7,653,4531.0,249.0,93.28571428571428,7,4087,4466.333333333333,1514.0,583.8571428571429
2380.0,17,4,344,2,150,0.0,75.0,75.0,2,194,0.0,103.0,97.0
100425.0,17,2,286,2,286,0.0,143.0,143.0,0,0,0.0,0.0,0.0
872167.0,6,9,1267,6,796,174433.4,458.0,132.66666666666666,3,471,298262.0,331.0,157.0
153439.0,17,2,180,1,90,0.0,90.0,90.0,1,90,0.0,90.0,90.0
9639.0,17,2,582,1,83,0.0,83.0,83.0,1,499,0.0,499.0,499.0
307258.0,6,6,412,4,272,102419.33333333331,74.0,68.0,2,140,0.0,74.0,70.0
22689.0,17,2,582,1,83,0.0,83.0,83.0,1,499,0.0,499.0,499.0
90031462.0,17,28,13364,28,13364,3334498.592592593,501.0,477.2857142857143,0,0,0.0,0.0,0.0
135133188.0,17,6,1146,6,1146,27026637.6,191.0,191.0,0,0,0.0,0.0,0.0
305843.0,6,6,412,4,272,101947.66666666669,74.0,68.0,2,140,0.0,74.0,70.0
21791.0,6,14,4740,7,653,3523.5,249.0,93.28571428571428,7,4087,3077.1666666666665,1514.0,583.8571428571429
41039.0,6,10,2032,5,524,10010.0,252.0,104.8,5,1508,9814.25,1236.0,301.6
506383.0,6,5,336,2,134,0.0,68.0,67.0,3,202,193311.0,70.0,67.33333333333333
107245.0,17,2,286,2,286,0.0,143.0,143.0,0,0,0.0,0.0,0.0
111487441.0,6,28,1876,14,982,8559353.76923077,139.0,70.14285714285714,14,894,8559352.307692308,123.0,63.85714285714285
113619151.0,6,46,3036,23,1518,5150446.727272728,66.0,66.0,23,1518,5150448.681818182,66.0,66.0
108721230.0,6,33,2428,17,1288,6795076.875,139.0,75.76470588235294,16,1140,7233662.733333333,123.0,71.25
107857712.0,6,28,1860,14,966,8296747.076923077,123.0,69.0,14,894,8280112.153846154,123.0,63.85714285714285
102597431.0,17,14,864,7,432,17072887.333333332,174.0,61.71428571428572,7,432,17000319.833333332,174.0,61.71428571428572
216582.0,17,2,180,1,90,0.0,90.0,90.0,1,90,0.0,90.0,90.0
19583.0,6,14,4740,7,653,3012.333333333333,249.0,93.28571428571428,7,4087,2867.5,1514.0,583.8571428571429
132571.0,6,3,337,2,214,0.0,160.0,107.0,1,123,0.0,123.0,123.0
135136989.0,17,6,1146,6,1146,27027397.8,191.0,191.0,0,0,0.0,0.0,0.0
107915.0,17,2,286,2,286,0.0,143.0,143.0,0,0,0.0,0.0,0.0
107684.0,17,2,286,2,286,0.0,143.0,143.0,0,0,0.0,0.0,0.0
218717.0,6,3,426,2,280,0.0,214.0,140.0,1,146,0.0,146.0,146.0
13781766.0,17,6,2052,6,2052,2756353.2,342.0,342.0,0,0,0.0,0.0,0.0
98853572.0,6,247,29164,124,20824,803687.5772357724,284.0,167.93548387096774,123,8340,801768.4180327869,140.0,67.8048780487805
118497208.0,6,30,1990,15,1042,8448668.857142856,139.0,69.46666666666667,15,948,8448670.357142856,123.0,63.2
120272731.0,6,230,26248,115,7886,1047917.3245614036,140.0,68.57391304347826,115,18362,1047766.2894736842,284.0,159.6695652173913
91426211.0,6,24,1829,13,989,7618106.5,95.0,76.07692307692308,11,840,9141549.8,95.0,76.36363636363636
106068113.0,17,14,1126,7,563,17632074.0,174.0,80.42857142857143,7,563,17651533.0,174.0,80.42857142857143
19409.0,6,14,4740,7,653,3101.0,249.0,93.28571428571428,7,4087,3001.0,1514.0,583.8571428571429
297142.0,6,6,412,4,272,99047.33333333331,74.0,68.0,2,140,0.0,74.0,70.0
119790018.0,6,23,1693,12,894,10890001.636363637,95.0,74.5,11,799,11954349.5,95.0,72.63636363636364
505720.0,6,5,336,2,134,0.0,68.0,67.0,3,202,196899.0,70.0,67.33333333333333
289784.0,17,4,1400,4,1400,96594.66666666669,350.0,350.0,0,0,0.0,0.0,0.0
83050.0,6,14,4740,7,653,13525.666666666666,249.0,93.28571428571428,7,4087,13702.166666666666,1514.0,583.8571428571429
120197934.0,6,23,1734,11,840,11999318.0,95.0,76.36363636363636,12,894,10908470.727272728,95.0,74.5
162323.0,17,2,180,1,90,0.0,90.0,90.0,1,90,0.0,90.0,90.0
10157.0,6,10,1065,5,534,2330.0,262.0,106.8,5,531,2325.25,259.0,106.2
20210.0,6,10,2032,5,524,4749.25,252.0,104.8,5,1508,4674.25,1236.0,301.6
121366.0,6,3,337,2,214,0.0,160.0,107.0,1,123,0.0,123.0,123.0
97112.0,6,2,132,1,66,0.0,66.0,66.0,1,66,0.0,66.0,66.0
219925.0,6,3,426,2,280,0.0,214.0,140.0,1,146,0.0,146.0,146.0
209470.0,17,2,180,1,90,0.0,90.0,90.0,1,90,0.0,90.0,90.0
102640.0,17,2,286,2,286,0.0,143.0,143.0,0,0,0.0,0.0,0.0
2871.0,17,2,224,1,76,0.0,76.0,76.0,1,148,0.0,148.0,148.0
10643.0,6,10,1066,5,490,2497.0,218.0,98.0,5,576,2411.0,304.0,115.2
5638910.0,6,5,336,2,134,0.0,68.0,67.0,3,202,1429354.0,70.0,67.33333333333333
5505.0,17,4,344,2,150,0.0,75.0,75.0,2,194,0.0,103.0,97.0
120122257.0,6,228,25734,114,7746,1055641.557522124,140.0,67.94736842105263,114,17988,1056789.389380531,284.0,157.78947368421052
38092.0,6,10,2032,5,524,9040.5,252.0,104.8,5,1508,8665.5,1236.0,301.6
293135.0,17,2,180,1,90,0.0,90.0,90.0,1,90,0.0,90.0,90.0
43288.0,6,14,4740,7,653,6981.5,249.0,93.28571428571428,7,4087,6829.333333333333,1514.0,583.8571428571429
216624.0,6,3,426,2,280,0.0,214.0,140.0,1,146,0.0,146.0,146.0
108110194.0,17,5,955,5,955,27027548.5,191.0,191.0,0,0,0.0,0.0,0.0
0.0,6,1,172,1,172,0.0,172.0,172.0,0,0,0.0,0.0,0.0
107893852.0,6,30,2122,15,1105,7706703.714285715,139.0,73.66666666666667,15,1017,7691258.5,123.0,67.8
7137.0,17,2,582,1,83,0.0,83.0,83.0,1,499,0.0,499.0,499.0
817.0,17,4,438,2,148,0.0,74.0,74.0,2,290,0.0,147.0,145.0
7168.0,17,2,231,1,78,0.0,78.0,78.0,1,153,0.0,153.0,153.0
14492.0,6,10,2032,5,524,3298.75,252.0,104.8,5,1508,3292.25,1236.0,301.6
2575025.0,6,2,132,1,66,0.0,66.0,66.0,1,66,0.0,66.0,66.0
117566223.0,6,48,3168,24,1584,5111574.913043479,66.0,66.0,24,1584,5097904.913043479,66.0,66.0
29114.0,6,14,4740,7,653,4730.333333333333,249.0,93.28571428571428,7,4087,4533.333333333333,1514.0,583.8571428571429
12746.0,6,2,132,1,66,0.0,66.0,66.0,1,66,0.0,66.0,66.0
162851.0,6,10,1066,5,490,39505.75,218.0,98.0,5,576,40001.75,304.0,115.2
90358903.0,6,15,2180,8,1016,12908414.714285716,188.0,127.0,7,1164,10055351.0,204.0,166.28571428571428
213696.0,17,2,180,1,90,0.0,90.0,90.0,1,90,0.0,90.0,90.0
280087.0,17,2,180,1,90,0.0,90.0,90.0,1,90,0.0,90.0,90.0
242777.0,6,12,1373,7,714,40462.833333333336,298.0,102.0,5,659,59827.75,379.0,131.8
2068.0,17,4,344,2,150,0.0,75.0,75.0,2,194,0.0,103.0,97.0
2783.0,17,2,224,1,76,0.0,76.0,76.0,1,148,0.0,148.0,148.0
37488.0,6,14,4740,7,653,6098.333333333333,249.0,93.28571428571428,7,4087,5697.333333333333,1514.0,583.8571428571429
103577.0,17,2,286,2,286,0.0,143.0,143.0,0,0,0.0,0.0,0.0
36052.0,6,14,4740,7,653,5118.833333333333,249.0,93.28571428571428,7,4087,4417.833333333333,1514.0,583.8571428571429
324.0,17,2,174,1,79,0.0,79.0,79.0,1,95,0.0,95.0,95.0
51042.0,6,14,4740,7,653,8319.333333333334,249.0,93.28571428571428,7,4087,8269.333333333334,1514.0,583.8571428571429
108104247.0,17,5,1005,5,1005,27026061.75,201.0,201.0,0,0,0.0,0.0,0.0
90250059.0,6,12,1832,8,1016,12892865.57142857,188.0,127.0,4,816,30029194.666666668,204.0,204.0
216492.0,17,2,180,1,90,0.0,90.0,90.0,1,90,0.0,90.0,90.0
30467.0,6,10,2032,5,524,7026.0,252.0,104.8,5,1508,7327.5,1236.0,301.6
120428840.0,6,231,26240,116,18354,1047207.304347826,374.0,158.22413793103448,115,7886,1047392.1842105264,140.0,68.57391304347826
157.0,17,2,3028,2,3028,0.0,1514.0,1514.0,0,0,0.0,0.0,0.0
101056474.0,17,14,864,7,432,16833497.166666668,174.0,61.71428571428572,7,432,16836457.666666668,174.0,61.71428571428572
443.0,17,2,508,2,508,0.0,257.0,254.0,0,0,0.0,0.0,0.0
497980.0,6,5,336,2,134,0.0,68.0,67.0,3,202,195822.5,70.0,67.33333333333333
121067.0,6,3,337,2,214,0.0,160.0,107.0,1,123,0.0,123.0,123.0
23066036.0,17,3,1034,2,684,0.0,342.0,342.0,1,350,0.0,350.0,350.0
301510.0,6,6,412,4,272,100503.33333333331,74.0,68.0,2,140,0.0,74.0,70.0
103723.0,17,2,286,2,286,0.0,143.0,143.0,0,0,0.0,0.0,0.0
306990.0,6,6,412,4,272,102330.0,74.0,68.0,2,140,0.0,74.0,70.0
120002969.0,6,23,1734,12,935,10908184.636363637,95.0,77.91666666666667,11,799,11998921.2,95.0,72.63636363636364
37968.0,6,14,4740,7,653,5980.166666666667,249.0,93.28571428571428,7,4087,5106.833333333333,1514.0,583.8571428571429
125008291.0,17,15,907,8,475,17858327.285714287,174.0,59.375,7,432,17500164.0,174.0,61.71428571428572
108972512.0,6,28,1860,14,966,8365903.769230769,123.0,69.0,14,894,8365902.384615385,123.0,63.85714285714285
104302772.0,6,44,2904,22,1452,4966798.666666667,66.0,66.0,22,1452,4952270.952380952,66.0,66.0
10475532.0,6,7,478,4,272,3446215.6666666665,74.0,68.0,3,206,5169230.0,74.0,68.66666666666667
56626.0,6,14,4740,7,653,9314.333333333334,249.0,93.28571428571428,7,4087,7549.5,1514.0,583.8571428571429
40560.0,6,10,2032,5,524,9834.5,252.0,104.8,5,1508,9885.5,1236.0,301.6
308037.0,17,4,571,2,148,0.0,74.0,74.0,2,423,0.0,276.0,211.5
120141669.0,6,31,2107,16,1002,8009444.6,123.0,62.625,15,1105,8289932.857142857,139.0,73.66666666666667
108097101.0,17,5,1005,5,1005,27024275.25,201.0,201.0,0,0,0.0,0.0,0.0
228244.0,17,2,180,1,90,0.0,90.0,90.0,1,90,0.0,90.0,90.0
148545.0,17,2,414,1,88,0.0,88.0,88.0,1,326,0.0,326.0,326.0
262739.0,6,12,1373,7,714,43789.833333333336,298.0,102.0,5,659,60969.25,379.0,131.8
370404.0,6,10,967,5,390,62760.75,162.0,78.0,5,577,62684.5,349.0,115.4
534.0,17,2,508,2,508,0.0,257.0,254.0,0,0,0.0,0.0,0.0
10470712.0,6,7,478,4,272,3444755.0,74.0,68.0,3,206,5167033.0,74.0,68.66666666666667
189406.0,17,4,1400,4,1400,63135.333333333336,350.0,350.0,0,0,0.0,0.0,0.0
372391.0,6,3,204,2,136,0.0,70.0,68.0,1,68,0.0,68.0,68.0
32681047.0,6,5,336,2,134,0.0,68.0,67.0,3,202,15053122.0,70.0,67.33333333333333
291991.0,17,2,246,1,76,0.0,76.0,76.0,1,170,0.0,170.0,170.0
137809.0,17,2,192,1,88,0.0,88.0,88.0,1,104,0.0,104.0,104.0
48098.0,6,14,4740,7,653,7040.5,249.0,93.28571428571428,7,4087,6511.5,1514.0,583.8571428571429
326.0,17,2,174,1,79,0.0,79.0,79.0,1,95,0.0,95.0,95.0
2971.0,17,2,224,1,76,0.0,76.0,76.0,1,148,0.0,148.0,148.0
216642.0,17,2,180,1,90,0.0,90.0,90.0,1,90,0.0,90.0,90.0
773.0,17,5,550,5,550,193.25,110.0,110.0,0,0,0.0,0.0,0.0
23574.0,6,14,4740,7,653,2944.1666666666665,249.0,93.28571428571428,7,4087,3792.3333333333335,1514.0,583.8571428571429
143977.0,17,2,180,1,90,0.0,90.0,90.0,1,90,0.0,90.0,90.0
52037.0,6,11,2098,6,590,10407.4,252.0,98.33333333333331,5,1508,10340.25,1236.0,301.6
204802.0,17,2,762,2,762,0.0,381.0,381.0,0,0,0.0,0.0,0.0
5005686.0,17,4,849,2,166,0.0,83.0,83.0,2,683,0.0,499.0,341.5
1452389.0,6,4,492,2,280,0.0,214.0,140.0,2,212,0.0,146.0,106.0
3406.0,17,2,414,1,88,0.0,88.0,88.0,1,326,0.0,326.0,326.0
121284.0,6,3,337,2,214,0.0,160.0,107.0,1,123,0.0,123.0,123.0
59107.0,6,14,4740,7,653,9635.833333333334,249.0,93.28571428571428,7,4087,7378.666666666667,1514.0,583.8571428571429
122429553.0,6,36,2602,19,1408,6801641.833333333,139.0,74.10526315789474,17,1194,7014290.625,123.0,70.23529411764706
120926.0,6,3,373,2,238,0.0,172.0,119.0,1,135,0.0,135.0,135.0
216393.0,17,2,180,1,90,0.0,90.0,90.0,1,90,0.0,90.0,90.0
103864.0,17,2,286,2,286,0.0,143.0,143.0,0,0,0.0,0.0,0.0
207366.0,6,3,426,2,280,0.0,214.0,140.0,1,146,0.0,146.0,146.0
63454.0,6,14,4740,7,653,10234.666666666666,249.0,93.28571428571428,7,4087,10105.5,1514.0,583.8571428571429
96267583.0,17,11,735,6,389,19253516.6,174.0,64.83333333333333,5,346,19053413.75,174.0,69.2
1026.0,17,4,438,2,148,0.0,74.0,74.0,2,290,0.0,147.0,145.0
2530.0,17,4,344,2,150,0.0,75.0,75.0,2,194,0.0,103.0,97.0
247096.0,17,2,180,1,90,0.0,90.0,90.0,1,90,0.0,90.0,90.0
120016020.0,17,13,821,7,432,20002670.0,174.0,61.71428571428572,6,389,20079595.2,174.0,64.83333333333333
38653753.0,6,7,1874,3,887,17924039.5,753.0,295.6666666666667,4,987,12016666.333333334,785.0,246.75
26986245.0,17,5,1710,5,1710,6746561.25,342.0,342.0,0,0,0.0,0.0,0.0
2020.0,17,4,344,2,150,0.0,75.0,75.0,2,194,0.0,103.0,97.0
34062.0,6,14,4740,7,653,5154.0,249.0,93.28571428571428,7,4087,5353.0,1514.0,583.8571428571429
50289.0,6,14,4740,7,653,8181.833333333333,249.0,93.28571428571428,7,4087,7899.333333333333,1514.0,583.8571428571429
5005968.0,17,4,695,2,168,0.0,84.0,84.0,2,527,0.0,363.0,263.5
66191.0,17,4,820,2,156,0.0,78.0,78.0,2,664,0.0,332.0,332.0
49712.0,6,14,4740,7,653,7049.166666666667,249.0,93.28571428571428,7,4087,8125.833333333333,1514.0,583.8571428571429
90295322.0,6,19,1436,10,745,10027590.0,95.0,74.5,9,691,11286411.25,95.0,76.77777777777777
97112.0,17,2,762,2,762,0.0,381.0,381.0,0,0,0.0,0.0,0.0
802.0,17,2,762,2,762,0.0,381.0,381.0,0,0,0.0,0.0,0.0
136010.0,6,2,132,1,66,0.0,66.0,66.0,1,66,0.0,66.0,66.0
234948.0,6,3,337,2,214,0.0,160.0,107.0,1,123,0.0,123.0,123.0
8614148.0,17,3,1034,2,684,0.0,342.0,342.0,1,350,0.0,350.0,350.0
90257665.0,6,14,2240,8,1016,12893952.142857144,188.0,127.0,6,1224,18018085.2,204.0,204.0
142524.0,6,2,132,1,66,0.0,66.0,66.0,1,66,0.0,66.0,66.0
2495084.0,6,2,132,1,66,0.0,66.0,66.0,1,66,0.0,66.0,66.0
218335.0,6,3,426,2,280,0.0,214.0,140.0,1,146,0.0,146.0,146.0
103711.0,17,2,286,2,286,0.0,143.0,143.0,0,0,0.0,0.0,0.0
52111.0,6,14,4740,7,653,7515.5,249.0,93.28571428571428,7,4087,8220.833333333334,1514.0,583.8571428571429
2331.0,17,4,344,2,150,0.0,75.0,75.0,2,194,0.0,103.0,97.0
144030.0,17,2,180,1,90,0.0,90.0,90.0,1,90,0.0,90.0,90.0
382494.0,6,3,204,2,136,0.0,70.0,68.0,1,68,0.0,68.0,68.0
53321.0,6,13,1386,7,789,8258.833333333334,253.0,112.71428571428572,6,597,9029.2,259.0,99.5
232503.0,6,3,337,2,214,0.0,160.0,107.0,1,123,0.0,123.0,123.0
135135556.0,17,6,1146,6,1146,27027111.2,191.0,191.0,0,0,0.0,0.0,0.0
208249.0,17,4,1400,4,1400,69416.33333333333,350.0,350.0,0,0,0.0,0.0,0.0
103303.0,17,2,286,2,286,0.0,143.0,143.0,0,0,0.0,0.0,0.0
228333.0,17,2,180,1,90,0.0,90.0,90.0,1,90,0.0,90.0,90.0
90525282.0,6,14,2240,8,1016,12932183.142857144,188.0,127.0,6,1224,18066870.4,204.0,204.0
5622414.0,6,5,336,2,134,0.0,68.0,67.0,3,202,1421894.0,70.0,67.33333333333333
90258881.0,6,12,1832,8,1016,12894125.857142856,188.0,127.0,4,816,30031429.666666668,204.0,204.0
50839.0,17,2,180,1,90,0.0,90.0,90.0,1,90,0.0,90.0,90.0
108860.0,17,2,286,2,286,0.0,143.0,143.0,0,0,0.0,0.0,0.0
108109876.0,17,5,955,5,955,27027469.0,191.0,191.0,0,0,0.0,0.0,0.0
144811.0,6,2,132,1,66,0.0,66.0,66.0,1,66,0.0,66.0,66.0
2313.0,17,4,344,2,150,0.0,75.0,75.0,2,194,0.0,103.0,97.0
197679.0,6,14,4740,7,653,32830.666666666664,249.0,93.28571428571428,7,4087,31639.166666666668,1514.0,583.8571428571429
298294.0,6,6,412,4,272,99431.33333333331,74.0,68.0,2,140,0.0,74.0,70.0
135136908.0,17,6,1146,6,1146,27027381.6,191.0,191.0,0,0,0.0,0.0,0.0
108107190.0,17,5,955,5,955,27026797.5,191.0,191.0,0,0,0.0,0.0,0.0
4311.0,17,4,344,2,150,0.0,75.0,75.0,2,194,0.0,103.0,97.0
90253907.0,6,13,2036,8,1016,12893415.285714284,188.0,127.0,5,1020,22522218.5,204.0,204.0
742304.0,6,6,758,3,410,353734.0,172.0,136.66666666666666,3,348,251294.5,135.0,116.0
2329.0,17,4,344,2,150,0.0,75.0,75.0,2,194,0.0,103.0,97.0
153506.0,17,2,180,1,90,0.0,90.0,90.0,1,90,0.0,90.0,90.0
135127650.0,17,6,1206,6,1206,27025530.0,201.0,201.0,0,0,0.0,0.0,0.0
3628.0,17,4,344,2,150,0.0,75.0,75.0,2,194,0.0,103.0,97.0
257262.0,6,3,337,2,214,0.0,160.0,107.0,1,123,0.0,123.0,123.0
103331.0,17,2,286,2,286,0.0,143.0,143.0,0,0,0.0,0.0,0.0
104191.0,17,2,286,2,286,0.0,143.0,143.0,0,0,0.0,0.0,0.0
54344929.0,17,4,360,2,180,0.0,90.0,90.0,2,180,0.0,90.0,90.0
1772262.0,6,2,132,1,66,0.0,66.0,66.0,1,66,0.0,66.0,66.0
233261.0,6,3,337,2,214,0.0,160.0,107.0,1,123,0.0,123.0,123.0
17384.0,6,14,4740,7,653,2763.5,249.0,93.28571428571428,7,4087,2764.333333333333,1514.0,583.8571428571429
2299.0,17,4,344,2,150,0.0,75.0,75.0,2,194,0.0,103.0,97.0
120000087.0,6,26,2019,15,1179,8571434.785714285,95.0,78.6,11,840,9138288.3,95.0,76.36363636363636
274591.0,6,10,1221,6,636,54918.2,298.0,106.0,4,585,84690.66666666667,379.0,146.25
50449.0,6,14,4740,7,653,8191.333333333333,249.0,93.28571428571428,7,4087,7578.5,1514.0,583.8571428571429
120246176.0,6,212,23980,106,7292,1137604.0,140.0,68.79245283018868,106,16688,1137523.4571428571,284.0,157.43396226415095
50931.0,17,2,180,1,90,0.0,90.0,90.0,1,90,0.0,90.0,90.0
161269.0,17,2,180,1,90,0.0,90.0,90.0,1,90,0.0,90.0,90.0
116682230.0,6,31,2166,16,1149,7764417.4,123.0,71.8125,15,1017,8319014.785714285,123.0,67.8
153420.0,17,2,180,1,90,0.0,90.0,90.0,1,90,0.0,90.0,90.0
298999.0,6,6,412,4,272,99666.33333333331,74.0,68.0,2,140,0.0,74.0,70.0
108107673.0,17,5,1005,5,1005,27026918.25,201.0,201.0,0,0,0.0,0.0,0.0
120136167.0,6,12,1832,8,1016,17137407.714285713,188.0,127.0,4,816,30035960.666666668,204.0,204.0
209319.0,6,3,426,2,280,0.0,214.0,140.0,1,146,0.0,146.0,146.0
103266.0,17,2,762,2,762,0.0,381.0,381.0,0,0,0.0,0.0,0.0
1271130.0,6,7,499,4,301,401309.0,103.0,75.25,3,198,614201.0,66.0,66.0
120332975.0,6,47,3102,23,1518,5159996.909090909,66.0,66.0,24,1584,5231857.826086956,66.0,66.0
112650691.0,17,13,821,7,432,18748627.83333333,174.0,61.71428571428572,6,389,18636472.4,174.0,64.83333333333333
50757.0,17,2,180,1,90,0.0,90.0,90.0,1,90,0.0,90.0,90.0
105119211.0,6,29,1999,15,1017,7508515.071428572,123.0,67.8,14,982,8067400.461538462,139.0,70.14285714285714
119801418.0,17,35,16705,35,16705,3523571.117647059,501.0,477.2857142857143,0,0,0.0,0.0,0.0
59844.0,6,14,4740,7,653,9371.166666666666,249.0,93.28571428571428,7,4087,9322.0,1514.0,583.8571428571429
1058.0,17,4,438,2,148,0.0,74.0,74.0,2,290,0.0,147.0,145.0
59084.0,6,14,4740,7,653,9715.166666666666,249.0,93.28571428571428,7,4087,8056.5,1514.0,583.8571428571429
22413.0,6,11,2098,6,590,4359.0,252.0,98.33333333333331,5,1508,4260.25,1236.0,301.6
90258879.0,6,12,1832,8,1016,12894125.57142857,188.0,127.0,4,816,30031417.0,204.0,204.0
108108043.0,17,5,955,5,955,27027010.75,191.0,191.0,0,0,0.0,0.0,0.0
204559.0,17,2,180,1,90,0.0,90.0,90.0,1,90,0.0,90.0,90.0
237443.0,6,3,373,2,238,0.0,172.0,119.0,1,135,0.0,135.0,135.0
5014951.0,17,4,849,2,166,0.0,83.0,83.0,2,683,0.0,499.0,341.5
122975286.0,6,48,3168,24,1584,4969426.130434782,66.0,66.0,24,1584,5297669.0,66.0,66.0
311983.0,17,4,1400,4,1400,103994.33333333331,350.0,350.0,0,0,0.0,0.0,0.0
90386431.0,6,25,1686,13,840,7532202.583333333,123.0,64.61538461538461,12,846,7290393.363636363,123.0,70.5
310022.0,17,4,1400,4,1400,103340.66666666669,350.0,350.0,0,0,0.0,0.0,0.0
15010.0,17,2,180,1,90,0.0,90.0,90.0,1,90,0.0,90.0,90.0
0.0,6,1,66,1,66,0.0,66.0,66.0,0,0,0.0,0.0,0.0
2781283.0,6,2,132,1,66,0.0,66.0,66.0,1,66,0.0,66.0,66.0
104514465.0,6,43,2838,22,1452,4966599.238095238,66.0,66.0,21,1386,5105440.95,66.0,66.0
409.0,17,2,410,1,78,0.0,78.0,78.0,1,332,0.0,332.0,332.0
122238.0,6,3,337,2,214,0.0,160.0,107.0,1,123,0.0,123.0,123.0
0.0,6,1,172,1,172,0.0,172.0,172.0,0,0,0.0,0.0,0.0
21851146.0,6,6,1981,4,1087,7283715.333333333,885.0,271.75,2,894,0.0,826.0,447.0
120380641.0,6,283,33488,142,23886,853763.4113475177,284.0,168.2112676056338,141,9602,852547.2857142857,140.0,68.09929078014184
146187.0,6,3,337,2,214,0.0,160.0,107.0,1,123,0.0,123.0,123.0
109039061.0,17,14,864,7,432,18167581.33333333,174.0,61.71428571428572,7,432,18166830.33333333,174.0,61.71428571428572
27340.0,6,14,4740,7,653,4435.0,249.0,93.28571428571428,7,4087,4415.833333333333,1514.0,583.8571428571429
2345.0,17,4,344,2,150,0.0,75.0,75.0,2,194,0.0,103.0,97.0
120049769.0,17,29,13785,29,13785,4287491.75,501.0,475.3448275862069,0,0,0.0,0.0,0.0
201518.0,17,2,180,1,90,0.0,90.0,90.0,1,90,0.0,90.0,90.0
203559.0,17,2,762,2,762,0.0,381.0,381.0,0,0,0.0,0.0,0.0
53270.0,6,14,4740,7,653,8709.0,249.0,93.28571428571428,7,4087,8319.333333333334,1514.0,583.8571428571429
12614240.0,6,5,1736,2,819,0.0,753.0,409.5,3,917,6239524.5,785.0,305.6666666666667
2244.0,17,4,344,2,150,0.0,75.0,75.0,2,194,0.0,103.0,97.0
43464.0,6,10,2032,5,524,10649.25,252.0,104.8,5,1508,8522.75,1236.0,301.6
1259457.0,17,6,1230,3,234,629548.5,78.0,78.0,3,996,629518.0,332.0,332.0
9737.0,17,2,539,1,86,0.0,86.0,86.0,1,453,0.0,453.0,453.0
90053545.0,17,28,13364,28,13364,3335316.4814814813,501.0,477.2857142857143,0,0,0.0,0.0,0.0
214395.0,6,10,1221,6,636,42879.0,298.0,106.0,4,585,70357.0,379.0,146.25
0.0,17,1,90,1,90,0.0,90.0,90.0,0,0,0.0,0.0,0.0
90906234.0,6,163,18272,82,5634,1122299.1851851852,140.0,68.70731707317073,81,12638,1123326.675,284.0,156.02469135802468
2416.0,17,4,344,2,150,0.0,75.0,75.0,2,194,0.0,103.0,97.0
104224175.0,17,14,864,7,432,17333526.833333332,174.0,61.71428571428572,7,432,17334879.5,174.0,61.71428571428572
196097.0,17,4,1524,4,1524,65365.66666666666,381.0,381.0,0,0,0.0,0.0,0.0
5313.0,17,4,344,2,150,0.0,75.0,75.0,2,194,0.0,103.0,97.0
90527892.0,6,15,2444,8,1016,12932556.0,188.0,127.0,7,1428,15060648.166666666,204.0,204.0
108108929.0,17,5,1005,5,1005,27027232.25,201.0,201.0,0,0,0.0,0.0,0.0
5627095.0,6,4,270,2,134,0.0,68.0,67.0,2,136,0.0,70.0,68.0
232607.0,6,3,337,2,214,0.0,160.0,107.0,1,123,0.0,123.0,123.0
120584387.0,6,710,96242,355,23652,338356.47740113,140.0,66.62535211267605,355,72590,340562.2994350282,390.0,204.4788732394366
102929.0,17,2,286,2,286,0.0,143.0,143.0,0,0,0.0,0.0,0.0
2152500.0,6,24,7545,13,2516,179375.0,1034.0,193.53846153846155,11,5029,184893.7,1510.0,457.1818181818182
106162.0,17,2,286,2,286,0.0,143.0,143.0,0,0,0.0,0.0,0.0
1073019.0,6,13,1386,7,789,178836.5,253.0,112.71428571428572,6,597,211255.2,259.0,99.5
123484.0,6,3,337,2,214,0.0,160.0,107.0,1,123,0.0,123.0,123.0
48588.0,6,10,2032,5,524,10161.0,252.0,104.8,5,1508,11712.25,1236.0,301.6
145243.0,17,2,180,1,70,0.0,70.0,70.0,1,110,0.0,110.0,110.0
221776.0,6,3,426,2,280,0.0,214.0,140.0,1,146,0.0,146.0,146.0
31552.0,6,10,2032,5,524,7095.5,252.0,104.8,5,1508,7608.0,1236.0,301.6
10521007.0,6,7,478,4,272,3461917.333333333,74.0,68.0,3,206,5192775.5,74.0,68.66666666666667
74569.0,17,2,618,1,82,0.0,82.0,82.0,1,536,0.0,536.0,536.0
1200.0,17,2,762,2,762,0.0,381.0,381.0,0,0,0.0,0.0,0.0
120110785.0,6,250,28558,125,8546,962083.629032258,140.0,68.368,125,20012,966209.9516129032,284.0,160.096
318868.0,17,4,1400,4,1400,106289.33333333331,350.0,350.0,0,0,0.0,0.0,0.0
23184.0,6,14,4740,7,653,3739.1666666666665,249.0,93.28571428571428,7,4087,3726.6666666666665,1514.0,583.8571428571429
213617.0,17,2,180,1,90,0.0,90.0,90.0,1,90,0.0,90.0,90.0
120230873.0,6,242,27326,121,8282,994991.1,140.0,68.44628099173553,121,19044,994968.6333333332,284.0,157.38842975206612
19501.0,6,20,7606,11,978,1908.0,310.0,88.9090909090909,9,6628,2299.25,1514.0,736.4444444444445
83004.0,6,11,2098,6,590,16330.0,252.0,98.33333333333331,5,1508,20045.0,1236.0,301.6
715632.0,6,11,1021,6,444,96603.0,162.0,74.0,5,577,120560.5,349.0,115.4
135132053.0,17,6,1146,6,1146,27026410.6,191.0,191.0,0,0,0.0,0.0,0.0
161109.0,6,2,128,1,74,0.0,74.0,74.0,1,54,0.0,54.0,54.0
102933.0,17,2,286,2,286,0.0,143.0,143.0,0,0,0.0,0.0,0.0
16542.0,6,14,4740,7,653,2535.333333333333,249.0,93.28571428571428,7,4087,2586.6666666666665,1514.0,583.8571428571429
50600.0,6,2,132,1,66,0.0,66.0,66.0,1,66,0.0,66.0,66.0
3010756.0,6,12,2172,7,664,501487.3333333333,252.0,94.85714285714286,5,1508,2574.5,1236.0,301.6
2822.0,17,4,344,2,150,0.0,75.0,75.0,2,194,0.0,103.0,97.0
56346.0,6,14,4740,7,653,7009.0,249.0,93.28571428571428,7,4087,9247.333333333334,1514.0,583.8571428571429
5062964.0,6,5,336,2,134,0.0,68.0,67.0,3,202,1423956.0,70.0,67.33333333333333
310068.0,17,4,1400,4,1400,103356.0,350.0,350.0,0,0,0.0,0.0,0.0
100951701.0,6,197,22312,99,15622,1030119.3979591836,300.0,157.7979797979798,98,6690,1029990.0824742268,140.0,68.26530612244898
270899.0,6,12,1373,7,714,45149.833333333336,298.0,102.0,5,659,63676.0,379.0,131.8
16280.0,6,14,4740,7,653,2596.6666666666665,249.0,93.28571428571428,7,4087,2575.5,1514.0,583.8571428571429
294.0,17,2,156,1,78,0.0,78.0,78.0,1,78,0.0,78.0,78.0
2643.0,17,4,344,2,150,0.0,75.0,75.0,2,194,0.0,103.0,97.0
90226533.0,6,13,2036,8,1016,12889504.714285716,188.0,127.0,5,1020,22515743.25,204.0,204.0
24801.0,6,10,2032,5,524,4842.25,252.0,104.8,5,1508,5817.0,1236.0,301.6
206080.0,6,3,426,2,280,0.0,214.0,140.0,1,146,0.0,146.0,146.0
2996539.0,17,2,906,2,906,0.0,453.0,453.0,0,0,0.0,0.0,0.0
119474787.0,17,16,1212,8,606,17000143.0,174.0,75.75,8,606,17001233.85714286,174.0,75.75
2296891.0,6,32,10926,18,3951,135111.23529411765,1514.0,219.5,14,6975,157146.46153846153,1514.0,498.2142857142857
38110.0,6,14,4740,7,653,6182.333333333333,249.0,93.28571428571428,7,4087,6214.0,1514.0,583.8571428571429
113328987.0,6,48,3168,24,1584,4927347.260869565,66.0,66.0,24,1584,4920350.217391305,66.0,66.0
302394.0,6,2,132,1,66,0.0,66.0,66.0,1,66,0.0,66.0,66.0
2372.0,17,4,344,2,150,0.0,75.0,75.0,2,194,0.0,103.0,97.0
14632695.0,6,20,1648,10,1016,1592691.0,315.0,101.6,10,632,1592663.6666666667,78.0,63.2
108100748.0,17,5,955,5,955,27025187.0,191.0,191.0,0,0,0.0,0.0,0.0
212722.0,6,3,426,2,280,0.0,214.0,140.0,1,146,0.0,146.0,146.0
124956557.0,17,14,995,8,606,17850936.714285713,174.0,75.75,6,389,19893947.4,174.0,64.83333333333333
90296863.0,6,21,1585,11,840,9025068.2,95.0,76.36363636363636,10,745,10000358.333333334,95.0,74.5
26670.0,6,14,4740,7,653,4308.0,249.0,93.28571428571428,7,4087,4293.333333333333,1514.0,583.8571428571429
90762811.0,6,17,1287,9,691,11339445.25,95.0,76.77777777777777,8,596,12963860.0,95.0,74.5
280383.0,17,2,363,1,79,0.0,79.0,79.0,1,284,0.0,284.0,284.0
31798.0,6,13,1479,7,882,5299.666666666667,291.0,126.0,6,597,5412.4,259.0,99.5
90018961.0,17,28,13364,28,13364,3334035.592592593,501.0,477.2857142857143,0,0,0.0,0.0,0.0
34901.0,6,14,4740,7,653,5638.166666666667,249.0,93.28571428571428,7,4087,5464.333333333333,1514.0,583.8571428571429
305056.0,6,6,412,4,272,101685.33333333331,74.0,68.0,2,140,0.0,74.0,70.0
36411.0,6,14,4740,7,653,5949.5,249.0,93.28571428571428,7,4087,5932.333333333333,1514.0,583.8571428571429
173247.0,17,4,704,2,148,0.0,74.0,74.0,2,556,0.0,280.0,278.0
135461.0,6,2,132,1,66,0.0,66.0,66.0,1,66,0.0,66.0,66.0
270674.0,6,12,1373,7,714,45112.333333333336,298.0,102.0,5,659,63283.5,379.0,131.8
11917.0,6,13,1459,7,862,1910.6666666666667,271.0,123.14285714285714,6,597,2230.8,259.0,99.5
277312.0,17,2,180,1,90,0.0,90.0,90.0,1,90,0.0,90.0,90.0
2437.0,17,4,344,2,150,0.0,75.0,75.0,2,194,0.0,103.0,97.0
42744.0,6,14,4740,7,653,6997.5,249.0,93.28571428571428,7,4087,5777.333333333333,1514.0,583.8571428571429
40847.0,6,10,2032,5,524,9801.5,252.0,104.8,5,1508,9634.0,1236.0,301.6
101814234.0,6,32,2358,17,1272,6349241.0,123.0,74.82352941176471,15,1086,7256277.571428572,123.0,72.4
304936.0,17,4,704,2,148,0.0,74.0,74.0,2,556,0.0,280.0,278.0
1049194.0,6,13,1394,7,797,174865.66666666666,253.0,113.85714285714286,6,597,207232.0,259.0,99.5
197015.0,17,2,180,1,90,0.0,90.0,90.0,1,90,0.0,90.0,90.0
91186139.0,6,24,1829,11,840,9118613.9,95.0,76.36363636363636,13,989,7577141.583333333,95.0,76.07692307692308
280441.0,17,2,180,1,90,0.0,90.0,90.0,1,90,0.0,90.0,90.0
255263.00000000003,6,3,337,2,214,0.0,160.0,107.0,1,123,0.0,123.0,123.0
2473.0,17,2,762,2,762,0.0,381.0,381.0,0,0,0.0,0.0,0.0
9688.0,17,2,539,1,86,0.0,86.0,86.0,1,453,0.0,453.0,453.0
235105.0,6,3,337,2,214,0.0,160.0,107.0,1,123,0.0,123.0,123.0
0.0,6,1,160,1,160,0.0,160.0,160.0,0,0,0.0,0.0,0.0
114757925.0,6,48,3168,24,1584,4989475.0,66.0,66.0,24,1584,4975804.173913044,66.0,66.0
2283.0,17,4,344,2,150,0.0,75.0,75.0,2,194,0.0,103.0,97.0
3004725.0,6,11,2106,6,598,600767.2,252.0,99.66666666666669,5,1508,1485.5,1236.0,301.6
365.0,17,2,267,1,83,0.0,83.0,83.0,1,184,0.0,184.0,184.0
153524.0,17,2,180,1,90,0.0,90.0,90.0,1,90,0.0,90.0,90.0
120126948.0,6,13,2020,9,1204,15015868.5,188.0,133.77777777777777,4,816,30030857.0,204.0,204.0
14531900.0,6,19,1553,9,921,1778333.375,315.0,102.33333333333331,10,632,1580714.3333333333,78.0,63.2
334.0,17,2,174,1,79,0.0,79.0,79.0,1,95,0.0,95.0,95.0
4254.0,17,4,344,2,150,0.0,75.0,75.0,2,194,0.0,103.0,97.0
204967.0,17,2,180,1,90,0.0,90.0,90.0,1,90,0.0,90.0,90.0
143890.0,17,2,180,1,90,0.0,90.0,90.0,1,90,0.0,90.0,90.0
3176943.0,6,18,1536,9,962,358405.125,315.0,106.88888888888889,9,574,358388.625,78.0,63.77777777777778
9788.0,17,2,539,1,86,0.0,86.0,86.0,1,453,0.0,453.0,453.0
165855.0,17,2,180,1,90,0.0,90.0,90.0,1,90,0.0,90.0,90.0
5827745.0,6,5,336,2,134,0.0,68.0,67.0,3,202,1523522.0,70.0,67.33333333333333
208466.0,6,3,426,2,280,0.0,214.0,140.0,1,146,0.0,146.0,146.0
38353.0,6,14,4740,7,653,4459.0,249.0,93.28571428571428,7,4087,6194.5,1514.0,583.8571428571429
247267.0,6,3,337,2,214,0.0,160.0,107.0,1,123,0.0,123.0,123.0
507944.0,6,3,1604,1,753,0.0,753.0,753.0,2,851,0.0,785.0,425.5
113630099.0,6,196,22220,98,15530,1169226.3092783506,284.0,158.46938775510205,98,6690,1169226.7835051543,140.0,68.26530612244898
281641.0,17,2,363,1,79,0.0,79.0,79.0,1,284,0.0,284.0,284.0
315875.0,17,4,1400,4,1400,105291.66666666669,350.0,350.0,0,0,0.0,0.0,0.0
207130.0,6,3,426,2,280,0.0,214.0,140.0,1,146,0.0,146.0,146.0
2791862.0,6,2,132,1,66,0.0,66.0,66.0,1,66,0.0,66.0,66.0
205862.0,17,2,180,1,90,0.0,90.0,90.0,1,90,0.0,90.0,90.0
322528.0,17,4,1400,4,1400,107509.33333333331,350.0,350.0,0,0,0.0,0.0,0.0
3006590.0,6,11,2106,6,598,601060.2,252.0,99.66666666666669,5,1508,1677.75,1236.0,301.6
206085.0,6,3,426,2,280,0.0,214.0,140.0,1,146,0.0,146.0,146.0
26946141.0,17,5,1710,5,1710,6736535.25,342.0,342.0,0,0,0.0,0.0,0.0
16222.0,6,10,2032,5,524,3752.5,252.0,104.8,5,1508,3652.5,1236.0,301.6
324.0,17,2,174,1,79,0.0,79.0,79.0,1,95,0.0,95.0,95.0
2452.0,17,4,344,2,150,0.0,75.0,75.0,2,194,0.0,103.0,97.0
307792.0,6,6,412,4,272,102597.33333333331,74.0,68.0,2,140,0.0,74.0,70.0
111001003.0,17,15,1169,8,606,15857286.142857144,174.0,75.75,7,563,15167380.0,174.0,80.42857142857143
6617.0,17,2,582,1,83,0.0,83.0,83.0,1,499,0.0,499.0,499.0
113520267.0,6,46,3036,23,1518,5160000.5,66.0,66.0,23,1518,5160000.909090909,66.0,66.0
2800528.0,6,2,132,1,66,0.0,66.0,66.0,1,66,0.0,66.0,66.0
303605.0,6,2,132,1,66,0.0,66.0,66.0,1,66,0.0,66.0,66.0
5662.0,17,4,344,2,150,0.0,75.0,75.0,2,194,0.0,103.0,97.0
1057760.0,6,13,1386,7,789,176293.33333333334,253.0,112.71428571428572,6,597,210511.8,259.0,99.5
45308.0,6,14,4740,7,653,7371.166666666667,249.0,93.28571428571428,7,4087,7273.166666666667,1514.0,583.8571428571429
205787.0,17,2,180,1,90,0.0,90.0,90.0,1,90,0.0,90.0,90.0
302611.0,6,6,412,4,272,100870.33333333331,74.0,68.0,2,140,0.0,74.0,70.0
12521.0,6,10,2032,5,524,2797.75,252.0,104.8,5,1508,2577.25,1236.0,301.6
107081332.0,17,14,864,7,432,17667965.166666668,174.0,61.71428571428572,7,432,17666876.333333332,174.0,61.71428571428572
24818.0,6,10,2032,5,524,4994.25,252.0,104.8,5,1508,5900.0,1236.0,301.6
149978344.0,17,36,17126,36,17126,4285095.542857143,501.0,475.72222222222223,0,0,0.0,0.0,0.0
2794857.0,6,2,132,1,66,0.0,66.0,66.0,1,66,0.0,66.0,66.0
108103973.0,17,5,1005,5,1005,27025993.25,201.0,201.0,0,0,0.0,0.0,0.0
8242193.0,6,178,163807,57,3927,147182.01785714287,211.0,68.89473684210526,121,159880,68592.5,1514.0,1321.3223140495868
780619.0,6,10,1221,6,636,156123.8,298.0,106.0,4,585,254810.3333333333,379.0,146.25
69551213.0,6,8,1307,8,1307,9935887.57142857,172.0,163.375,0,0,0.0,0.0,0.0
2265.0,17,4,344,2,150,0.0,75.0,75.0,2,194,0.0,103.0,97.0
282337.0,17,2,180,1,90,0.0,90.0,90.0,1,90,0.0,90.0,90.0
300019.0,6,6,412,4,272,100006.33333333331,74.0,68.0,2,140,0.0,74.0,70.0
90287691.0,6,16,1192,8,596,12891882.42857143,95.0,74.5,8,596,12896014.857142856,95.0,74.5
108108398.0,17,5,955,5,955,27027099.5,191.0,191.0,0,0,0.0,0.0,0.0
6825.0,17,2,582,1,83,0.0,83.0,83.0,1,499,0.0,499.0,499.0
313860.0,6,6,412,4,272,104620.0,74.0,68.0,2,140,0.0,74.0,70.0
33891.0,6,14,4740,7,653,5523.666666666667,249.0,93.28571428571428,7,4087,4939.166666666667,1514.0,583.8571428571429
90292726.0,6,19,1436,10,745,10026626.444444444,95.0,74.5,9,691,11285045.125,95.0,76.77777777777777
342.0,17,2,160,1,80,0.0,80.0,80.0,1,80,0.0,80.0,80.0
28619.0,6,10,1067,5,536,6652.25,264.0,107.2,5,531,5499.25,259.0,106.2
104369351.0,17,15,5130,15,5130,7454953.642857143,342.0,342.0,0,0,0.0,0.0,0.0
108104059.0,17,5,955,5,955,27026014.75,191.0,191.0,0,0,0.0,0.0,0.0
7955.999999999999,6,10,2032,5,524,1743.0,252.0,104.8,5,1508,1744.5,1236.0,301.6
903.0,17,4,438,2,148,0.0,74.0,74.0,2,290,0.0,147.0,145.0
51149.0,17,2,180,1,90,0.0,90.0,90.0,1,90,0.0,90.0,90.0
90284212.0,6,16,1192,8,596,12891861.285714284,95.0,74.5,8,596,12897293.857142856,95.0,74.5
2344.0,17,4,344,2,150,0.0,75.0,75.0,2,194,0.0,103.0,97.0
2405.0,17,4,344,2,150,0.0,75.0,75.0,2,194,0.0,103.0,97.0
2783156.0,6,2,132,1,66,0.0,66.0,66.0,1,66,0.0,66.0,66.0
7020.0,17,2,498,1,80,0.0,80.0,80.0,1,418,0.0,418.0,418.0
90679221.0,6,21,1585,10,745,10075469.0,95.0,74.5,11,840,9043041.6,95.0,76.36363636363636
124227.0,17,2,286,2,286,0.0,143.0,143.0,0,0,0.0,0.0,0.0
63909.99999999999,6,14,4740,7,653,10343.333333333334,249.0,93.28571428571428,7,4087,9971.166666666666,1514.0,583.8571428571429
7079.0,17,2,582,1,83,0.0,83.0,83.0,1,499,0.0,499.0,499.0
1025863.0,6,11,1134,6,558,205172.60000000003,220.0,93.0,5,576,255258.25,304.0,115.2
37340.0,6,14,4740,7,653,6009.333333333333,249.0,93.28571428571428,7,4087,5842.833333333333,1514.0,583.8571428571429
48667.0,6,12,1320,6,723,8671.2,253.0,120.5,6,597,6469.6,259.0,99.5
2573550.0,6,25,7573,14,3735,197965.38461538465,1514.0,266.7857142857143,11,3838,232460.8,1514.0,348.90909090909093
10489186.0,6,7,478,4,272,3450863.6666666665,74.0,68.0,3,206,5176207.0,74.0,68.66666666666667
33704115.0,6,5,336,2,134,0.0,68.0,67.0,3,202,15551575.5,70.0,67.33333333333333
108130824.0,17,5,955,5,955,27032706.0,191.0,191.0,0,0,0.0,0.0,0.0
90029317.0,17,27,12943,27,12943,3462666.0384615385,501.0,479.3703703703704,0,0,0.0,0.0,0.0
100678514.0,17,13,821,7,432,16666803.833333334,174.0,61.71428571428572,6,389,20001399.4,174.0,64.83333333333333
42557.0,6,14,4740,7,653,6121.5,249.0,93.28571428571428,7,4087,6854.0,1514.0,583.8571428571429
38373.0,6,12,1320,6,723,7256.8,253.0,120.5,6,597,6881.8,259.0,99.5
9246.0,17,2,498,1,80,0.0,80.0,80.0,1,418,0.0,418.0,418.0
695.0,17,4,438,2,148,0.0,74.0,74.0,2,290,0.0,147.0,145.0
106135.0,17,2,700,2,700,0.0,350.0,350.0,0,0,0.0,0.0,0.0
153447.0,17,2,180,1,90,0.0,90.0,90.0,1,90,0.0,90.0,90.0
317.0,17,2,174,1,79,0.0,79.0,79.0,1,95,0.0,95.0,95.0
10419783.0,6,6,412,3,206,5141759.5,74.0,68.66666666666667,3,206,5141635.0,74.0,68.66666666666667
301687.0,6,6,412,4,272,100562.33333333331,74.0,68.0,2,140,0.0,74.0,70.0
115031066.0,17,15,1300,8,737,16433009.42857143,174.0,92.125,7,563,15863179.833333334,174.0,80.42857142857143
90051149.0,17,27,12943,27,12943,3463505.730769231,501.0,479.3703703703704,0,0,0.0,0.0,0.0
209407.0,17,2,180,1,90,0.0,90.0,90.0,1,90,0.0,90.0,90.0
235465.0,6,3,337,2,214,0.0,160.0,107.0,1,123,0.0,123.0,123.0
299941.0,6,6,412,4,272,99980.33333333331,74.0,68.0,2,140,0.0,74.0,70.0
300152.0,6,6,412,4,272,100050.66666666669,74.0,68.0,2,140,0.0,74.0,70.0
822.0,17,4,438,2,148,0.0,74.0,74.0,2,290,0.0,147.0,145.0
90278916.0,6,12,1832,8,1016,12896988.0,188.0,127.0,4,816,30036595.0,204.0,204.0
102823.0,17,2,286,2,286,0.0,143.0,143.0,0,0,0.0,0.0,0.0
121322002.0,6,235,26556,118,18612,1036940.188034188,284.0,157.72881355932202,117,7944,1029476.0,140.0,67.8974358974359
196873.0,17,2,180,1,90,0.0,90.0,90.0,1,90,0.0,90.0,90.0
120337235.0,6,221,25040,111,17484,1093974.8636363635,284.0,157.51351351351352,110,7556,1094422.119266055,140.0,68.69090909090909
318726.0,17,4,1400,4,1400,106242.0,350.0,350.0,0,0,0.0,0.0,0.0
96608.0,17,2,762,2,762,0.0,381.0,381.0,0,0,0.0,0.0,0.0
352.0,17,2,166,1,75,0.0,75.0,75.0,1,91,0.0,91.0,91.0
228453.0,17,2,180,1,90,0.0,90.0,90.0,1,90,0.0,90.0,90.0
71525.0,6,13,1394,7,797,11766.0,253.0,113.85714285714286,6,597,13489.6,259.0,99.5
110993511.0,6,31,2182,16,1165,7385176.266666667,139.0,72.8125,15,1017,7912678.285714285,123.0,67.8
56933.0,6,14,4740,7,653,9294.0,249.0,93.28571428571428,7,4087,8574.5,1514.0,583.8571428571429
0.0,17,1,90,1,90,0.0,90.0,90.0,0,0,0.0,0.0,0.0
90015108.0,17,28,13364,28,13364,3333892.888888889,501.0,477.2857142857143,0,0,0.0,0.0,0.0
104442304.0,17,14,864,7,432,17334438.0,174.0,61.71428571428572,7,432,17333512.166666668,174.0,61.71428571428572
90092240.0,6,11,1644,4,816,30029990.0,204.0,204.0,7,828,15014875.5,188.0,118.28571428571428
741.0,17,2,762,2,762,0.0,381.0,381.0,0,0,0.0,0.0,0.0
2044.0,17,4,344,2,150,0.0,75.0,75.0,2,194,0.0,103.0,97.0
135130577.0,17,6,1206,6,1206,27026115.4,201.0,201.0,0,0,0.0,0.0,0.0
5844350.0,6,5,336,2,134,0.0,68.0,67.0,3,202,1528878.0,70.0,67.33333333333333
90285079.0,6,12,1832,8,1016,12897868.42857143,188.0,127.0,4,816,30030947.33333333,204.0,204.0
3186205.0,6,6,876,2,292,0.0,214.0,146.0,4,584,989268.6666666666,146.0,146.0
6528585.0,6,192,161133,112,151360,58816.08108108108,1510.0,1351.428571428571,80,9773,77700.59493670886,1510.0,122.1625
205832.0,17,2,180,1,90,0.0,90.0,90.0,1,90,0.0,90.0,90.0
314033.0,17,4,1400,4,1400,104677.66666666669,350.0,350.0,0,0,0.0,0.0,0.0
60169.0,6,14,4740,7,653,9865.666666666666,249.0,93.28571428571428,7,4087,7737.0,1514.0,583.8571428571429
33835.0,6,14,4740,7,653,5520.166666666667,249.0,93.28571428571428,7,4087,5461.666666666667,1514.0,583.8571428571429
28405.0,6,14,4740,7,653,4372.166666666667,249.0,93.28571428571428,7,4087,4600.666666666667,1514.0,583.8571428571429
2104205.0,17,4,1368,4,1368,701401.6666666666,342.0,342.0,0,0,0.0,0.0,0.0
205962.0,17,2,180,1,90,0.0,90.0,90.0,1,90,0.0,90.0,90.0
144825.0,17,4,1524,4,1524,48275.0,381.0,381.0,0,0,0.0,0.0,0.0
27315451.0,17,5,1710,5,1710,6828862.75,342.0,342.0,0,0,0.0,0.0,0.0
209830.0,6,10,1221,6,636,41966.0,298.0,106.0,4,585,68958.0,379.0,146.25
90295482.0,6,21,1639,11,799,9024695.1,95.0,72.63636363636364,10,840,9980776.0,153.0,84.0
6327.0,17,2,335,1,88,0.0,88.0,88.0,1,247,0.0,247.0,247.0
10553158.0,6,5,1736,3,917,5210863.0,785.0,305.6666666666667,2,819,0.0,753.0,409.5
107242.0,17,2,286,2,286,0.0,143.0,143.0,0,0,0.0,0.0,0.0
144803.0,17,2,180,1,70,0.0,70.0,70.0,1,110,0.0,110.0,110.0
90528679.0,6,14,2240,8,1016,12932668.42857143,188.0,127.0,6,1224,18073283.4,204.0,204.0
99914464.0,6,181,20600,91,14438,1110160.711111111,284.0,158.65934065934067,90,6162,1111173.370786517,140.0,68.46666666666667
298826.0,6,6,412,4,272,99608.66666666669,74.0,68.0,2,140,0.0,74.0,70.0
90524391.0,6,14,2240,8,1016,12932055.857142856,188.0,127.0,6,1224,18072098.0,204.0,204.0
2429.0,17,4,344,2,150,0.0,75.0,75.0,2,194,0.0,103.0,97.0
3777779.0,6,5,336,2,134,0.0,68.0,67.0,3,202,1525992.5,70.0,67.33333333333333
100008436.0,17,14,864,7,432,16668072.666666666,174.0,61.71428571428572,7,432,16666810.166666666,174.0,61.71428571428572
35266.0,6,14,4740,7,653,4399.0,249.0,93.28571428571428,7,4087,5700.333333333333,1514.0,583.8571428571429
90047654.0,17,27,12943,27,12943,3463371.3076923075,501.0,479.3703703703704,0,0,0.0,0.0,0.0
33706256.0,6,5,336,2,134,0.0,68.0,67.0,3,202,16784806.5,70.0,67.33333333333333
68986.0,17,2,620,1,75,0.0,75.0,75.0,1,545,0.0,545.0,545.0
121161645.0,6,234,26310,117,8018,1028551.0862068966,140.0,68.52991452991454,117,18292,1037425.6724137932,284.0,156.34188034188034
6706.0,17,2,582,1,83,0.0,83.0,83.0,1,499,0.0,499.0,499.0
372.0,17,2,166,1,75,0.0,75.0,75.0,1,91,0.0,91.0,91.0
11617.0,17,2,180,1,90,0.0,90.0,90.0,1,90,0.0,90.0,90.0
13464.0,6,11,1131,6,600,2203.8,262.0,100.0,5,531,3148.5,259.0,106.2
16396.0,6,10,1067,5,536,3714.75,264.0,107.2,5,531,2762.0,259.0,106.2
50432.0,6,14,4740,7,653,7536.5,249.0,93.28571428571428,7,4087,6882.166666666667,1514.0,583.8571428571429
32594.0,17,2,582,1,83,0.0,83.0,83.0,1,499,0.0,499.0,499.0
245552.0,6,3,337,2,214,0.0,160.0,107.0,1,123,0.0,123.0,123.0
209479.0,17,2,180,1,90,0.0,90.0,90.0,1,90,0.0,90.0,90.0
120188151.0,6,230,25978,115,7886,1047047.0087719298,140.0,68.57391304347826,115,18092,1051414.605263158,284.0,157.3217391304348
26053.0,6,19,7540,11,978,2605.3,310.0,88.9090909090909,8,6562,3330.714285714286,1514.0,820.25
432548.0,6,3,1604,2,851,0.0,785.0,425.5,1,753,0.0,753.0,753.0
24197.0,6,14,4740,7,653,3732.1666666666665,249.0,93.28571428571428,7,4087,3890.5,1514.0,583.8571428571429
2806.0,17,4,344,2,150,0.0,75.0,75.0,2,194,0.0,103.0,97.0
135139027.0,17,6,1206,6,1206,27027805.4,201.0,201.0,0,0,0.0,0.0,0.0
5620117.0,6,4,270,2,134,0.0,68.0,67.0,2,136,0.0,70.0,68.0
5626046.0,6,5,336,2,134,0.0,68.0,67.0,3,202,1525755.0,70.0,67.33333333333333
73182.0,6,14,4740,7,653,10658.833333333334,249.0,93.28571428571428,7,4087,9590.166666666666,1514.0,583.8571428571429
32764.0,6,14,4740,7,653,4821.333333333333,249.0,93.28571428571428,7,4087,5268.166666666667,1514.0,583.8571428571429
3577.0,17,2,346,1,78,0.0,78.0,78.0,1,268,0.0,268.0,268.0
5617288.0,6,5,336,2,134,0.0,68.0,67.0,3,202,1425008.5,70.0,67.33333333333333
93992910.0,6,26,1746,13,906,7814686.083333333,123.0,69.6923076923077,13,840,7814752.666666667,123.0,64.61538461538461
110898.0,17,2,286,2,286,0.0,143.0,143.0,0,0,0.0,0.0,0.0
120177.0,17,2,180,1,70,0.0,70.0,70.0,1,110,0.0,110.0,110.0
299065.0,6,6,412,4,272,99688.33333333331,74.0,68.0,2,140,0.0,74.0,70.0
106596.0,17,2,286,2,286,0.0,143.0,143.0,0,0,0.0,0.0,0.0
120074140.0,6,248,28712,124,8406,969604.211382114,140.0,67.79032258064517,124,20306,969512.593495935,284.0,163.75806451612902
14656450.0,6,20,1771,10,1139,1594227.7777777778,324.0,113.9,10,632,1594710.0,78.0,63.2
52206.0,6,12,1320,6,723,10014.4,253.0,120.5,6,597,9535.0,259.0,99.5
1044939.0,6,11,1134,6,558,208987.8,220.0,93.0,5,576,259342.5,304.0,115.2
302406.0,6,6,412,4,272,100802.0,74.0,68.0,2,140,0.0,74.0,70.0
135139804.0,17,6,1206,6,1206,27027960.8,201.0,201.0,0,0,0.0,0.0,0.0
601472.0,17,3,551,2,156,0.0,78.0,78.0,1,395,0.0,395.0,395.0
147927.0,17,2,180,1,90,0.0,90.0,90.0,1,90,0.0,90.0,90.0
90215255.0,6,19,1436,9,691,11246942.75,95.0,76.77777777777777,10,745,10001145.222222222,95.0,74.5
232956.0,6,3,337,1,123,0.0,123.0,123.0,2,214,0.0,160.0,107.0
175627.0,17,4,571,2,148,0.0,74.0,74.0,2,423,0.0,276.0,211.5
1141734.0,17,5,961,3,234,570676.5,78.0,78.0,2,727,0.0,395.0,363.5
21664.0,6,20,7606,11,978,2166.4,310.0,88.9090909090909,9,6628,1769.5,1514.0,736.4444444444445
135134033.0,17,6,1206,6,1206,27026806.6,201.0,201.0,0,0,0.0,0.0,0.0
1316969.0,6,4,264,2,132,0.0,66.0,66.0,2,132,0.0,66.0,66.0
12742.0,6,10,2032,5,524,2967.75,252.0,104.8,5,1508,2738.25,1236.0,301.6
56063.0,6,14,4740,7,653,8373.0,249.0,93.28571428571428,7,4087,7572.0,1514.0,583.8571428571429
269054.0,6,10,1221,6,636,53810.8,298.0,106.0,4,585,83521.33333333333,379.0,146.25
108108828.0,17,5,955,5,955,27027207.0,191.0,191.0,0,0,0.0,0.0,0.0
1145.0,17,5,550,5,550,286.25,110.0,110.0,0,0,0.0,0.0,0.0
308946.0,6,6,412,4,272,102982.0,74.0,68.0,2,140,0.0,74.0,70.0
92613772.0,6,25,1708,13,922,7699822.083333333,139.0,70.92307692307692,12,786,8399789.818181818,123.0,65.5
8057.999999999999,6,10,1975,5,467,1752.5,195.0,93.4,5,1508,1740.5,1236.0,301.6
76842.0,6,14,4740,7,653,12075.0,249.0,93.28571428571428,7,4087,7140.833333333333,1514.0,583.8571428571429
90255229.0,6,13,2036,8,1016,12893604.142857144,188.0,127.0,5,1020,22521410.75,204.0,204.0
2089.0,17,4,344,2,150,0.0,75.0,75.0,2,194,0.0,103.0,97.0
252290.0,17,2,371,1,81,0.0,81.0,81.0,1,290,0.0,290.0,290.0
10482589.0,6,7,478,4,272,3448752.6666666665,74.0,68.0,3,206,5172986.5,74.0,68.66666666666667
7197.0,17,2,582,1,83,0.0,83.0,83.0,1,499,0.0,499.0,499.0
28045.0,6,10,2032,5,524,5607.75,252.0,104.8,5,1508,6212.25,1236.0,301.6
79139.0,6,14,4740,7,653,12988.5,249.0,93.28571428571428,7,4087,12712.833333333334,1514.0,583.8571428571429
325.0,17,2,174,1,79,0.0,79.0,79.0,1,95,0.0,95.0,95.0
393232.0,6,3,204,2,136,0.0,70.0,68.0,1,68,0.0,68.0,68.0
169002.0,17,2,414,1,88,0.0,88.0,88.0,1,326,0.0,326.0,326.0
219044.0,17,4,344,2,150,0.0,75.0,75.0,2,194,0.0,103.0,97.0
1307222.0,6,4,264,2,132,0.0,66.0,66.0,2,132,0.0,66.0,66.0
111646.0,17,2,286,2,286,0.0,143.0,143.0,0,0,0.0,0.0,0.0
10415670.0,6,7,478,4,272,3426456.0,74.0,68.0,3,206,5139577.5,74.0,68.66666666666667
205998.0,17,2,762,2,762,0.0,381.0,381.0,0,0,0.0,0.0,0.0
279627.0,17,2,180,1,90,0.0,90.0,90.0,1,90,0.0,90.0,90.0
19430.0,6,14,4740,7,653,2970.5,249.0,93.28571428571428,7,4087,3049.333333333333,1514.0,583.8571428571429
136402.0,6,3,337,2,214,0.0,160.0,107.0,1,123,0.0,123.0,123.0
299075.0,6,6,412,4,272,99691.66666666669,74.0,68.0,2,140,0.0,74.0,70.0
4195.0,17,2,359,1,75,0.0,75.0,75.0,1,284,0.0,284.0,284.0
146356.0,6,3,337,2,214,0.0,160.0,107.0,1,123,0.0,123.0,123.0
258313.00000000003,6,3,337,2,214,0.0,160.0,107.0,1,123,0.0,123.0,123.0
135133307.0,17,6,1206,6,1206,27026661.4,201.0,201.0,0,0,0.0,0.0,0.0
288850.0,6,12,1373,7,714,48141.66666666666,298.0,102.0,5,659,68172.25,379.0,131.8
21232.0,6,14,4740,7,653,3428.5,249.0,93.28571428571428,7,4087,3176.5,1514.0,583.8571428571429
218139.0,6,10,1221,6,636,43627.8,298.0,106.0,4,585,71468.66666666667,379.0,146.25
149247626.0,6,18,1341,9,650,14942105.25,95.0,72.22222222222223,9,691,14999993.75,95.0,76.77777777777777
235776.0,6,3,373,2,238,0.0,172.0,119.0,1,135,0.0,135.0,135.0
751615.0,6,11,1021,6,444,100743.2,162.0,74.0,5,577,125721.75,349.0,115.4
147961.0,17,2,180,1,90,0.0,90.0,90.0,1,90,0.0,90.0,90.0
217014.0,6,3,426,2,280,0.0,214.0,140.0,1,146,0.0,146.0,146.0
108100576.0,17,5,955,5,955,27025144.0,191.0,191.0,0,0,0.0,0.0,0.0
102983183.0,17,15,5138,14,4788,6141893.230769231,342.0,342.0,1,350,0.0,350.0,350.0
120251728.0,6,19,1395,10,745,13333311.888888888,95.0,74.5,9,650,14999994.75,95.0,72.22222222222223
307171.0,6,3,202,2,128,0.0,74.0,64.0,1,74,0.0,74.0,74.0
135133060.0,17,6,1146,6,1146,27026612.0,191.0,191.0,0,0,0.0,0.0,0.0
5627729.0,6,5,336,2,134,0.0,68.0,67.0,3,202,1422734.5,70.0,67.33333333333333
100090895.0,17,12,778,6,389,19853559.8,174.0,64.83333333333333,6,389,19985986.4,174.0,64.83333333333333
208152.0,6,3,426,2,280,0.0,214.0,140.0,1,146,0.0,146.0,146.0
120123492.0,6,14,2240,6,1224,24024698.4,204.0,204.0,8,1016,17136902.57142857,188.0,127.0
405605.0,6,4,508,2,238,0.0,172.0,119.0,2,270,0.0,135.0,135.0
301002.0,6,6,412,4,272,100334.0,74.0,68.0,2,140,0.0,74.0,70.0
135132357.0,17,6,1206,6,1206,27026471.4,201.0,201.0,0,0,0.0,0.0,0.0
32854.0,6,14,4740,7,653,5355.833333333333,249.0,93.28571428571428,7,4087,5335.833333333333,1514.0,583.8571428571429
1350802.0,17,16,1120,16,1120,90053.46666666666,70.0,70.0,0,0,0.0,0.0,0.0
301708.0,6,6,412,4,272,100569.33333333331,74.0,68.0,2,140,0.0,74.0,70.0
109464597.0,6,40,3094,21,1654,5462438.45,139.0,78.76190476190476,19,1440,6069374.666666667,123.0,75.78947368421052
219372.0,6,3,426,2,280,0.0,214.0,140.0,1,146,0.0,146.0,146.0
242829.0,6,3,337,2,214,0.0,160.0,107.0,1,123,0.0,123.0,123.0
29951.0,6,10,2032,5,524,7216.5,252.0,104.8,5,1508,6298.25,1236.0,301.6
119145065.0,17,12,516,6,258,20000206.8,43.0,43.0,6,258,20000904.6,43.0,43.0
18105.0,6,13,4515,6,512,3450.8,230.0,85.33333333333333,7,4003,2869.5,1514.0,571.8571428571429
246021.0,6,3,337,2,214,0.0,160.0,107.0,1,123,0.0,123.0,123.0
90055294.0,17,28,13364,28,13364,3335381.25925926,501.0,477.2857142857143,0,0,0.0,0.0,0.0
302233.0,6,6,412,4,272,100744.33333333331,74.0,68.0,2,140,0.0,74.0,70.0
843856.0,6,9,1118,6,586,168771.2,248.0,97.66666666666669,3,532,284004.5,392.0,177.33333333333334
305900.0,6,6,412,4,272,101966.66666666669,74.0,68.0,2,140,0.0,74.0,70.0
234024.0,6,3,337,2,214,0.0,160.0,107.0,1,123,0.0,123.0,123.0
41437.0,6,14,4740,7,653,6603.166666666667,249.0,93.28571428571428,7,4087,6556.333333333333,1514.0,583.8571428571429
19935.0,6,14,4740,7,653,2780.0,249.0,93.28571428571428,7,4087,3179.833333333333,1514.0,583.8571428571429
209543.0,17,2,180,1,90,0.0,90.0,90.0,1,90,0.0,90.0,90.0
58484.0,6,10,1065,5,534,13858.75,262.0,106.8,5,531,10973.25,259.0,106.2
304498.0,6,6,412,4,272,101499.33333333331,74.0,68.0,2,140,0.0,74.0,70.0
49593.0,6,10,2032,5,524,12060.5,252.0,104.8,5,1508,11317.75,1236.0,301.6
293.0,17,2,164,1,82,0.0,82.0,82.0,1,82,0.0,82.0,82.0
2329.0,17,4,344,2,150,0.0,75.0,75.0,2,194,0.0,103.0,97.0
19988.0,6,10,2032,5,524,4751.5,252.0,104.8,5,1508,4369.0,1236.0,301.6
37485.0,6,14,4740,7,653,6123.833333333333,249.0,93.28571428571428,7,4087,5521.166666666667,1514.0,583.8571428571429
209457.0,17,2,180,1,90,0.0,90.0,90.0,1,90,0.0,90.0,90.0
548925.0,17,2,346,1,78,0.0,78.0,78.0,1,268,0.0,268.0,268.0
120195103.0,6,246,27732,123,8414,978501.950819672,140.0,68.40650406504065,123,19318,978570.9426229508,284.0,157.0569105691057
1105.0,17,2,508,2,508,0.0,257.0,254.0,0,0,0.0,0.0,0.0
216060.0,6,12,1373,7,714,36010.0,298.0,102.0,5,659,52454.75,379.0,131.8
31898.000000000004,6,14,4740,7,653,4933.833333333333,249.0,93.28571428571428,7,4087,4979.333333333333,1514.0,583.8571428571429
2679757.0,6,3,1604,1,753,0.0,753.0,753.0,2,851,0.0,785.0,425.5
90041978.0,17,28,13364,28,13364,3334888.074074074,501.0,477.2857142857143,0,0,0.0,0.0,0.0
762.0,17,5,550,5,550,190.5,110.0,110.0,0,0,0.0,0.0,0.0
333.0,17,2,166,1,75,0.0,75.0,75.0,1,91,0.0,91.0,91.0
135138055.0,17,6,1146,6,1146,27027611.0,191.0,191.0,0,0,0.0,0.0,0.0
307840.0,6,6,412,4,272,102613.33333333331,74.0,68.0,2,140,0.0,74.0,70.0
100776768.0,6,30,2106,15,1089,7182922.0,123.0,72.6,15,1017,7182918.5,123.0,67.8
854.0,17,4,438,2,148,0.0,74.0,74.0,2,290,0.0,147.0,145.0
49824.0,6,14,4740,7,653,8082.666666666667,249.0,93.28571428571428,7,4087,7557.0,1514.0,583.8571428571429
135125577.0,17,6,1206,6,1206,27025115.4,201.0,201.0,0,0,0.0,0.0,0.0
120294.0,17,2,180,1,70,0.0,70.0,70.0,1,110,0.0,110.0,110.0
90298172.0,6,19,1436,10,745,10027379.777777778,95.0,74.5,9,691,11286613.625,95.0,76.77777777777777
120040587.0,17,29,13785,29,13785,4287163.821428572,501.0,475.3448275862069,0,0,0.0,0.0,0.0
422.0,17,2,410,1,78,0.0,78.0,78.0,1,332,0.0,332.0,332.0
2849166.0,6,5,336,3,202,1424583.0,70.0,67.33333333333333,2,134,0.0,68.0,67.0
120039240.0,6,12,1832,8,1016,17125656.285714287,188.0,127.0,4,816,30024112.0,204.0,204.0
140559.0,6,2,132,1,66,0.0,66.0,66.0,1,66,0.0,66.0,66.0
15840.0,17,2,180,1,90,0.0,90.0,90.0,1,90,0.0,90.0,90.0
351069.0,6,4,508,2,238,0.0,172.0,119.0,2,270,0.0,135.0,135.0
217295.0,6,3,426,2,280,0.0,214.0,140.0,1,146,0.0,146.0,146.0
10510658.0,6,7,478,4,272,3456587.6666666665,74.0,68.0,3,206,5184793.0,74.0,68.66666666666667
340340.0,6,10,1221,6,636,68068.0,298.0,106.0,4,585,112429.0,379.0,146.25
10461991.0,6,7,478,4,272,3442249.0,74.0,68.0,3,206,5163276.0,74.0,68.66666666666667
44199.0,6,14,4740,7,653,7134.333333333333,249.0,93.28571428571428,7,4087,7226.666666666667,1514.0,583.8571428571429
120054196.0,17,29,13785,29,13785,4287649.857142857,501.0,475.3448275862069,0,0,0.0,0.0,0.0
107857.0,17,2,286,2,286,0.0,143.0,143.0,0,0,0.0,0.0,0.0
3059117.0,6,3,1604,2,851,0.0,785.0,425.5,1,753,0.0,753.0,753.0
143878.0,17,2,180,1,90,0.0,90.0,90.0,1,90,0.0,90.0,90.0
102844.0,17,2,762,2,762,0.0,381.0,381.0,0,0,0.0,0.0,0.0
1023886.0,6,11,1134,6,558,204777.2,220.0,93.0,5,576,255076.0,304.0,115.2
354.0,17,2,160,1,80,0.0,80.0,80.0,1,80,0.0,80.0,80.0
359.0,17,2,166,1,75,0.0,75.0,75.0,1,91,0.0,91.0,91.0
596575.0,6,4,492,2,280,0.0,214.0,140.0,2,212,0.0,146.0,106.0
98222064.0,17,14,1126,7,563,16334787.0,174.0,80.42857142857143,7,563,16333471.833333334,174.0,80.42857142857143
55946.0,17,2,571,1,86,0.0,86.0,86.0,1,485,0.0,485.0,485.0
105630.0,17,2,286,2,286,0.0,143.0,143.0,0,0,0.0,0.0,0.0
59717.0,6,14,4740,7,653,8910.666666666666,249.0,93.28571428571428,7,4087,9099.166666666666,1514.0,583.8571428571429
202294.0,17,4,1400,4,1400,67431.33333333333,350.0,350.0,0,0,0.0,0.0,0.0
5618282.0,6,5,336,2,134,0.0,68.0,67.0,3,202,1423477.5,70.0,67.33333333333333
217828.0,6,3,426,2,280,0.0,214.0,140.0,1,146,0.0,146.0,146.0
100346609.0,17,14,1126,7,563,16667674.333333334,174.0,80.42857142857143,7,563,16666830.5,174.0,80.42857142857143
324360.0,6,6,412,4,272,108120.0,74.0,68.0,2,140,0.0,74.0,70.0
322852.0,17,4,1400,4,1400,107617.33333333331,350.0,350.0,0,0,0.0,0.0,0.0
90213957.0,6,21,1585,10,745,9996328.444444444,95.0,74.5,11,840,8999842.3,95.0,76.36363636363636
2588313.0,6,2,132,1,66,0.0,66.0,66.0,1,66,0.0,66.0,66.0
54934847.0,6,8,1307,8,1307,7847835.285714285,172.0,163.375,0,0,0.0,0.0,0.0
2009944.0,17,4,1368,4,1368,669981.3333333334,342.0,342.0,0,0,0.0,0.0,0.0
183911.0,17,2,180,1,90,0.0,90.0,90.0,1,90,0.0,90.0,90.0
318906.0,17,4,1400,4,1400,106302.0,350.0,350.0,0,0,0.0,0.0,0.0
0.0,17,1,136,1,136,0.0,136.0,136.0,0,0,0.0,0.0,0.0
4008.000000000001,17,2,582,1,83,0.0,83.0,83.0,1,499,0.0,499.0,499.0
90031678.0,17,28,13364,28,13364,3334506.592592593,501.0,477.2857142857143,0,0,0.0,0.0,0.0
119810748.0,17,34,16284,34,16284,3630628.727272727,501.0,478.9411764705882,0,0,0.0,0.0,0.0
59762.0,6,14,4740,7,653,8840.333333333334,249.0,93.28571428571428,7,4087,8159.333333333333,1514.0,583.8571428571429
145793.0,6,13,1386,7,789,24298.83333333333,253.0,112.71428571428572,6,597,24169.6,259.0,99.5
308296.0,17,4,622,4,622,102765.33333333331,163.0,155.5,0,0,0.0,0.0,0.0
106791.0,17,2,286,2,286,0.0,143.0,143.0,0,0,0.0,0.0,0.0
48837229.0,6,8,2113,3,960,22944787.5,826.0,320.0,5,1153,11514622.25,885.0,230.6
2394.0,17,4,344,2,150,0.0,75.0,75.0,2,194,0.0,103.0,97.0
205978.0,6,3,426,2,280,0.0,214.0,140.0,1,146,0.0,146.0,146.0
2360.0,17,4,344,2,150,0.0,75.0,75.0,2,194,0.0,103.0,97.0
300447.0,6,6,412,4,272,100149.0,74.0,68.0,2,140,0.0,74.0,70.0
153493.0,17,2,180,1,90,0.0,90.0,90.0,1,90,0.0,90.0,90.0
0.0,17,1,453,1,453,0.0,453.0,453.0,0,0,0.0,0.0,0.0
125390.0,6,2,132,1,66,0.0,66.0,66.0,1,66,0.0,66.0,66.0
366733.0,17,2,363,1,75,0.0,75.0,75.0,1,288,0.0,288.0,288.0
11254808.0,17,4,1368,4,1368,3751602.6666666665,342.0,342.0,0,0,0.0,0.0,0.0
103712768.0,17,14,1126,7,563,17169812.0,174.0,80.42857142857143,7,563,17166828.5,174.0,80.42857142857143
120240915.0,6,22,1639,11,840,11999706.5,95.0,76.36363636363636,11,799,12000005.7,95.0,72.63636363636364
1188652.0,6,13,3010,8,2382,169807.42857142858,1514.0,297.75,5,628,228978.0,331.0,125.6
2311.0,17,4,344,2,150,0.0,75.0,75.0,2,194,0.0,103.0,97.0
444478.0,6,10,967,5,390,75004.5,162.0,78.0,5,577,74938.0,349.0,115.4
2570.0,17,2,180,1,90,0.0,90.0,90.0,1,90,0.0,90.0,90.0
303396.0,6,6,412,4,272,101132.0,74.0,68.0,2,140,0.0,74.0,70.0
2454.0,17,4,344,2,150,0.0,75.0,75.0,2,194,0.0,103.0,97.0
321240.0,17,4,1400,4,1400,107080.0,350.0,350.0,0,0,0.0,0.0,0.0
36891.0,6,14,4740,7,653,5905.166666666667,249.0,93.28571428571428,7,4087,5903.666666666667,1514.0,583.8571428571429
100004320.0,17,11,473,6,258,20000864.0,43.0,43.0,5,215,20000177.0,43.0,43.0
12743.0,6,11,1133,6,602,2497.4,264.0,100.33333333333331,5,531,2796.0,259.0,106.2
119940454.0,6,33,2290,17,1125,7496250.5,123.0,66.17647058823529,16,1165,7330351.066666666,139.0,72.8125
317575.0,6,6,412,4,272,105858.33333333331,74.0,68.0,2,140,0.0,74.0,70.0
120093283.0,6,228,25772,114,7746,1055588.061946903,140.0,67.94736842105263,114,18026,1055491.442477876,284.0,158.12280701754386
56574.0,6,13,4416,6,409,11170.2,127.0,68.16666666666667,7,4007,9148.333333333334,1514.0,572.4285714285714
216416.0,17,2,180,1,90,0.0,90.0,90.0,1,90,0.0,90.0,90.0
216375.0,17,2,180,1,90,0.0,90.0,90.0,1,90,0.0,90.0,90.0
108101518.0,17,5,955,5,955,27025379.5,191.0,191.0,0,0,0.0,0.0,0.0
228429.0,17,2,180,1,90,0.0,90.0,90.0,1,90,0.0,90.0,90.0
210223.0,17,2,414,1,88,0.0,88.0,88.0,1,326,0.0,326.0,326.0
462243.0,6,3,204,1,68,0.0,68.0,68.0,2,136,0.0,70.0,68.0
406.0,17,2,762,2,762,0.0,381.0,381.0,0,0,0.0,0.0,0.0
66966.0,6,14,4740,7,653,10938.0,249.0,93.28571428571428,7,4087,10910.833333333334,1514.0,583.8571428571429
108109046.0,17,5,1005,5,1005,27027261.5,201.0,201.0,0,0,0.0,0.0,0.0
107402.0,17,2,286,2,286,0.0,143.0,143.0,0,0,0.0,0.0,0.0
39502.0,6,10,2032,5,524,8045.5,252.0,104.8,5,1508,9408.5,1236.0,301.6
308684.0,6,6,412,4,272,102894.66666666669,74.0,68.0,2,140,0.0,74.0,70.0
95198.0,17,2,762,2,762,0.0,381.0,381.0,0,0,0.0,0.0,0.0
118483971.0,6,26,1978,13,989,9853297.5,95.0,76.07692307692308,13,989,9856610.083333334,95.0,76.07692307692308
310756.0,6,3,202,2,128,0.0,74.0,64.0,1,74,0.0,74.0,74.0
433.0,17,2,508,2,508,0.0,257.0,254.0,0,0,0.0,0.0,0.0
34977343.0,6,7,1874,3,887,17394802.0,753.0,295.6666666666667,4,987,11612012.666666666,785.0,246.75
8180.0,17,2,582,1,83,0.0,83.0,83.0,1,499,0.0,499.0,499.0
147102.0,6,3,373,2,238,0.0,172.0,119.0,1,135,0.0,135.0,135.0
20949.0,6,14,4740,7,653,3367.333333333333,249.0,93.28571428571428,7,4087,2971.5,1514.0,583.8571428571429
9173.0,17,2,539,1,86,0.0,86.0,86.0,1,453,0.0,453.0,453.0
246923.0,6,3,373,2,238,0.0,172.0,119.0,1,135,0.0,135.0,135.0
108107775.0,17,5,1005,5,1005,27026943.75,201.0,201.0,0,0,0.0,0.0,0.0
121426.0,6,3,337,2,214,0.0,160.0,107.0,1,123,0.0,123.0,123.0
3101750.0,6,3,1604,2,851,0.0,785.0,425.5,1,753,0.0,753.0,753.0
90252209.0,6,13,2036,8,1016,12893172.714285716,188.0,127.0,5,1020,22521706.0,204.0,204.0
19016.0,6,10,2032,5,524,4530.5,252.0,104.8,5,1508,4111.5,1236.0,301.6
90222195.0,6,16,1192,8,596,12852426.0,95.0,74.5,8,596,12858130.142857144,95.0,74.5
135131859.0,17,6,1206,6,1206,27026371.8,201.0,201.0,0,0,0.0,0.0,0.0
15757.0,6,10,1067,5,536,3415.25,264.0,107.2,5,531,3484.5,259.0,106.2
1801174.0,17,6,1230,3,234,900396.0,78.0,78.0,3,996,900378.5,332.0,332.0
299440.0,6,6,412,4,272,99813.33333333331,74.0,68.0,2,140,0.0,74.0,70.0
324.0,17,2,174,1,79,0.0,79.0,79.0,1,95,0.0,95.0,95.0
101706.0,17,2,762,2,762,0.0,381.0,381.0,0,0,0.0,0.0,0.0
219804.0,6,3,426,2,280,0.0,214.0,140.0,1,146,0.0,146.0,146.0
121982350.0,6,47,3102,23,1518,5160002.409090909,66.0,66.0,24,1584,5303569.130434782,66.0,66.0
212143.0,6,10,1221,6,636,42428.6,298.0,106.0,4,585,69811.33333333333,379.0,146.25
90124763.0,6,10,1440,7,828,15020793.833333334,188.0,118.28571428571428,3,612,30046744.0,204.0,204.0
32222.0,6,10,2032,5,524,7827.0,252.0,104.8,5,1508,7645.0,1236.0,301.6
104116.0,17,2,286,2,286,0.0,143.0,143.0,0,0,0.0,0.0,0.0
60878.0,6,14,4740,7,653,9792.333333333334,249.0,93.28571428571428,7,4087,9572.333333333334,1514.0,583.8571428571429
299.0,17,2,156,1,78,0.0,78.0,78.0,1,78,0.0,78.0,78.0
242944.0,17,2,180,1,90,0.0,90.0,90.0,1,90,0.0,90.0,90.0
3580073.0,6,5,336,2,134,0.0,68.0,67.0,3,202,1424063.0,70.0,67.33333333333333
21338.0,17,2,582,1,83,0.0,83.0,83.0,1,499,0.0,499.0,499.0
2670072.0,6,25,7573,14,3735,205390.15384615384,1514.0,266.7857142857143,11,3838,240041.3,1514.0,348.90909090909093
117504195.0,6,236,26734,118,18650,1002555.8205128204,284.0,158.05084745762713,118,8084,1002555.52991453,140.0,68.50847457627118
90599688.0,6,30,2254,15,1168,6471406.285714285,139.0,77.86666666666666,15,1086,6456736.428571428,123.0,72.4
547.0,17,2,508,2,508,0.0,257.0,254.0,0,0,0.0,0.0,0.0
50509.0,6,14,4740,7,653,8294.5,249.0,93.28571428571428,7,4087,7811.333333333333,1514.0,583.8571428571429
9262.0,17,2,582,1,83,0.0,83.0,83.0,1,499,0.0,499.0,499.0
11884.0,17,4,823,2,163,0.0,89.0,81.5,2,660,0.0,443.0,330.0
102419.0,17,2,700,2,700,0.0,350.0,350.0,0,0,0.0,0.0,0.0
24534.0,17,2,539,1,86,0.0,86.0,86.0,1,453,0.0,453.0,453.0
9558.0,17,2,582,1,83,0.0,83.0,83.0,1,499,0.0,499.0,499.0
746104.0,6,2,132,1,66,0.0,66.0,66.0,1,66,0.0,66.0,66.0
310290.0,17,4,1400,4,1400,103430.0,350.0,350.0,0,0,0.0,0.0,0.0
3577591.0,6,5,336,2,134,0.0,68.0,67.0,3,202,1423692.5,70.0,67.33333333333333
2357.0,17,4,344,2,150,0.0,75.0,75.0,2,194,0.0,103.0,97.0
113301143.0,6,271,31114,136,9272,839267.7259259259,140.0,68.17647058823529,135,21842,837735.4253731343,284.0,161.7925925925926
13825074.0,17,6,2052,6,2052,2765014.8,342.0,342.0,0,0,0.0,0.0,0.0
302384.0,6,2,132,1,66,0.0,66.0,66.0,1,66,0.0,66.0,66.0
108686807.0,6,32,2220,16,1149,7231373.0,123.0,71.8125,16,1071,7231374.0,123.0,66.9375
300135.0,6,6,412,4,272,100045.0,74.0,68.0,2,140,0.0,74.0,70.0
106370174.0,6,32,2236,16,1165,7091344.933333334,139.0,72.8125,16,1071,7076599.4,123.0,66.9375
208954.0,6,10,1221,6,636,41790.8,298.0,106.0,4,585,68643.66666666667,379.0,146.25
330.0,17,2,174,1,79,0.0,79.0,79.0,1,95,0.0,95.0,95.0
306940.0,6,6,412,4,272,102313.33333333331,74.0,68.0,2,140,0.0,74.0,70.0
122559.0,6,3,373,2,238,0.0,172.0,119.0,1,135,0.0,135.0,135.0
205725.0,17,2,180,1,90,0.0,90.0,90.0,1,90,0.0,90.0,90.0
267459.0,17,2,180,1,90,0.0,90.0,90.0,1,90,0.0,90.0,90.0
58415.0,6,14,4740,7,653,8150.333333333333,249.0,93.28571428571428,7,4087,8814.666666666666,1514.0,583.8571428571429
36156.0,6,10,2032,5,524,8432.0,252.0,104.8,5,1508,8527.0,1236.0,301.6
92068441.0,6,182,20538,91,14310,1020586.1111111112,284.0,157.25274725274724,91,6228,1020591.3111111112,140.0,68.43956043956044
36394.0,6,13,1386,7,789,5901.166666666667,253.0,112.71428571428572,6,597,6040.2,259.0,99.5
144055.0,17,2,180,1,90,0.0,90.0,90.0,1,90,0.0,90.0,90.0
2361.0,17,4,344,2,150,0.0,75.0,75.0,2,194,0.0,103.0,97.0
1626384.0,17,6,1230,3,234,813003.0,78.0,78.0,3,996,812993.0,332.0,332.0
30951.0,6,10,2032,5,524,7330.75,252.0,104.8,5,1508,6894.75,1236.0,301.6
308856.0,6,6,412,4,272,102952.0,74.0,68.0,2,140,0.0,74.0,70.0
315169.0,17,4,1400,4,1400,105056.33333333331,350.0,350.0,0,0,0.0,0.0,0.0
207496.0,6,3,426,2,280,0.0,214.0,140.0,1,146,0.0,146.0,146.0
245637.0,6,3,337,2,214,0.0,160.0,107.0,1,123,0.0,123.0,123.0
297991.0,6,6,412,4,272,99330.33333333331,74.0,68.0,2,140,0.0,74.0,70.0
121206.0,6,3,337,2,214,0.0,160.0,107.0,1,123,0.0,123.0,123.0
32922.0,6,14,4740,7,653,4422.0,249.0,93.28571428571428,7,4087,5349.333333333333,1514.0,583.8571428571429
205112.0,17,2,762,2,762,0.0,381.0,381.0,0,0,0.0,0.0,0.0
102181.0,17,2,286,2,286,0.0,143.0,143.0,0,0,0.0,0.0,0.0
34520.0,6,14,4740,7,653,5476.666666666667,249.0,93.28571428571428,7,4087,5613.833333333333,1514.0,583.8571428571429
129809867.0,6,32,2242,17,1225,8113116.6875,139.0,72.05882352941177,15,1017,8543251.214285715,123.0,67.8
103425.0,17,2,286,2,286,0.0,143.0,143.0,0,0,0.0,0.0,0.0
324.0,17,2,174,1,79,0.0,79.0,79.0,1,95,0.0,95.0,95.0
237461.0,6,3,337,2,214,0.0,160.0,107.0,1,123,0.0,123.0,123.0
27232.0,6,10,2032,5,524,5777.75,252.0,104.8,5,1508,6423.0,1236.0,301.6
90023553.0,17,28,13364,28,13364,3334205.6666666665,501.0,477.2857142857143,0,0,0.0,0.0,0.0
28487.0,6,13,1459,7,862,4747.833333333333,271.0,123.14285714285714,6,597,3196.8,259.0,99.5
317146.0,17,4,1400,4,1400,105715.33333333331,350.0,350.0,0,0,0.0,0.0,0.0
30158.0,6,14,4740,7,653,4684.166666666667,249.0,93.28571428571428,7,4087,4671.833333333333,1514.0,583.8571428571429
98317.0,17,2,762,2,762,0.0,381.0,381.0,0,0,0.0,0.0,0.0
2494429.0,6,3,204,1,68,0.0,68.0,68.0,2,136,0.0,70.0,68.0
456536.0,6,6,686,3,374,195156.0,160.0,124.66666666666669,3,312,168350.0,123.0,104.0
113251848.0,6,46,3036,23,1518,5135441.727272728,66.0,66.0,23,1518,5135448.045454546,66.0,66.0
2428.0,17,4,344,2,150,0.0,75.0,75.0,2,194,0.0,103.0,97.0
104298004.0,17,14,1126,7,563,17356174.333333332,174.0,80.42857142857143,7,563,17330518.666666668,174.0,80.42857142857143
10529318.0,6,7,478,4,272,3464415.0,74.0,68.0,3,206,5196495.5,74.0,68.66666666666667
6005028.0,17,3,1359,3,1359,3002514.0,453.0,453.0,0,0,0.0,0.0,0.0
77614.0,17,6,1230,3,234,38590.5,78.0,78.0,3,996,38608.5,332.0,332.0
204140.0,17,4,6056,4,6056,68046.66666666667,1514.0,1514.0,0,0,0.0,0.0,0.0
1022979.0,6,11,1134,6,558,204595.8,220.0,93.0,5,576,255336.25,304.0,115.2
2008650.0,17,4,525,2,150,0.0,75.0,75.0,2,375,0.0,284.0,187.5
27236.0,6,14,4740,7,653,4369.333333333333,249.0,93.28571428571428,7,4087,4147.5,1514.0,583.8571428571429
31270.0,6,14,4740,7,653,4724.833333333333,249.0,93.28571428571428,7,4087,4831.5,1514.0,583.8571428571429
101696.0,6,14,4740,7,653,16775.666666666668,249.0,93.28571428571428,7,4087,12722.166666666666,1514.0,583.8571428571429
37869.0,6,10,2032,5,524,9180.25,252.0,104.8,5,1508,6406.5,1236.0,301.6
309981.0,6,6,412,4,272,103327.0,74.0,68.0,2,140,0.0,74.0,70.0
259889.0,6,10,1221,6,636,51977.8,298.0,106.0,4,585,80544.33333333333,379.0,146.25
26110.0,6,14,4740,7,653,4171.166666666667,249.0,93.28571428571428,7,4087,4131.166666666667,1514.0,583.8571428571429
5625438.0,6,4,270,2,134,0.0,68.0,67.0,2,136,0.0,70.0,68.0
3775075.0,6,5,336,2,134,0.0,68.0,67.0,3,202,1524115.5,70.0,67.33333333333333
218349.0,6,3,426,2,280,0.0,214.0,140.0,1,146,0.0,146.0,146.0
45767.0,6,14,4740,7,653,7020.5,249.0,93.28571428571428,7,4087,7492.0,1514.0,583.8571428571429
33063.0,6,14,4740,7,653,4943.5,249.0,93.28571428571428,7,4087,5325.166666666667,1514.0,583.8571428571429
0.0,17,1,179,1,179,0.0,179.0,179.0,0,0,0.0,0.0,0.0
108997.0,17,2,286,2,286,0.0,143.0,143.0,0,0,0.0,0.0,0.0
359.0,17,2,762,2,762,0.0,381.0,381.0,0,0,0.0,0.0,0.0
374786.0,6,10,1221,6,636,74957.2,298.0,106.0,4,585,123123.0,379.0,146.25
319432.0,17,4,1400,4,1400,106477.33333333331,350.0,350.0,0,0,0.0,0.0,0.0
240576.0,6,3,337,2,214,0.0,160.0,107.0,1,123,0.0,123.0,123.0
1235845.0,17,7,490,7,490,205974.16666666663,70.0,70.0,0,0,0.0,0.0,0.0
153417.0,17,2,180,1,90,0.0,90.0,90.0,1,90,0.0,90.0,90.0
90011495.0,17,28,13364,28,13364,3333759.074074074,501.0,477.2857142857143,0,0,0.0,0.0,0.0
307632.0,6,6,412,4,272,102544.0,74.0,68.0,2,140,0.0,74.0,70.0
26338.0,6,13,4412,6,409,5094.8,127.0,68.16666666666667,7,4003,4176.666666666667,1514.0,571.8571428571429
36099397.0,6,29,9249,16,3843,178529.06666666668,1514.0,240.1875,13,5406,2990328.833333333,1514.0,415.84615384615387
301110.0,6,6,412,4,272,100370.0,74.0,68.0,2,140,0.0,74.0,70.0
239198.0,6,3,373,2,238,0.0,172.0,119.0,1,135,0.0,135.0,135.0
108104183.0,17,5,955,5,955,27026045.75,191.0,191.0,0,0,0.0,0.0,0.0
96530644.0,6,39,2574,20,1320,5066078.842105263,66.0,66.0,19,1254,5135430.111111111,66.0,66.0
2768909.0,6,3,1604,2,851,0.0,785.0,425.5,1,753,0.0,753.0,753.0
10453746.0,6,7,478,4,272,3439230.0,74.0,68.0,3,206,5158717.0,74.0,68.66666666666667
7851.0,17,2,582,1,83,0.0,83.0,83.0,1,499,0.0,499.0,499.0
207520.0,6,3,426,2,280,0.0,214.0,140.0,1,146,0.0,146.0,146.0
16882.0,17,2,180,1,90,0.0,90.0,90.0,1,90,0.0,90.0,90.0
434.0,17,2,166,1,75,0.0,75.0,75.0,1,91,0.0,91.0,91.0
19952.0,6,10,2032,5,524,4233.25,252.0,104.8,5,1508,4731.0,1236.0,301.6
0.0,17,1,55,1,55,0.0,55.0,55.0,0,0,0.0,0.0,0.0
19717.0,6,2,145,2,145,0.0,91.0,72.5,0,0,0.0,0.0,0.0
1653258.0,6,7,499,4,301,544669.0,103.0,75.25,3,198,818243.0,66.0,66.0
27591.0,6,20,7606,11,978,2759.1,310.0,88.9090909090909,9,6628,3145.75,1514.0,736.4444444444445
110026860.0,6,30,2106,15,1089,7844427.642857143,123.0,72.6,15,1017,7844458.428571428,123.0,67.8
350027.0,6,4,508,2,238,0.0,172.0,119.0,2,270,0.0,135.0,135.0
122574.0,6,3,373,2,238,0.0,172.0,119.0,1,135,0.0,135.0,135.0
30935.0,6,14,4740,7,653,4985.333333333333,249.0,93.28571428571428,7,4087,5016.166666666667,1514.0,583.8571428571429
100140731.0,17,12,778,6,389,20028146.2,174.0,64.83333333333333,6,389,19865760.6,174.0,64.83333333333333
2327.0,17,4,344,2,150,0.0,75.0,75.0,2,194,0.0,103.0,97.0
102049.0,17,2,286,2,286,0.0,143.0,143.0,0,0,0.0,0.0,0.0
105001073.0,17,13,821,7,432,17500178.833333332,174.0,61.71428571428572,6,389,19998654.6,174.0,64.83333333333333
496553.0,6,4,270,2,134,0.0,68.0,67.0,2,136,0.0,70.0,68.0
25445.0,6,14,4740,7,653,3721.1666666666665,249.0,93.28571428571428,7,4087,4100.5,1514.0,583.8571428571429
55089.0,6,14,4740,7,653,8839.5,249.0,93.28571428571428,7,4087,8905.0,1514.0,583.8571428571429
241485.0,6,3,337,2,214,0.0,160.0,107.0,1,123,0.0,123.0,123.0
93917968.0,6,25,1686,13,840,7826497.333333333,123.0,64.61538461538461,12,846,8139074.909090909,123.0,70.5
146125.0,6,3,337,2,214,0.0,160.0,107.0,1,123,0.0,123.0,123.0
37589.0,6,14,4740,7,653,6048.5,249.0,93.28571428571428,7,4087,5431.166666666667,1514.0,583.8571428571429
18328.0,6,10,2032,5,524,4338.0,252.0,104.8,5,1508,4029.25,1236.0,301.6
14994.0,17,2,180,1,90,0.0,90.0,90.0,1,90,0.0,90.0,90.0
209950.0,6,12,1373,7,714,34991.666666666664,298.0,102.0,5,659,51436.75,379.0,131.8
5004847.0,17,4,849,2,166,0.0,83.0,83.0,2,683,0.0,499.0,341.5
11836.0,6,10,2032,5,524,2733.5,252.0,104.8,5,1508,2732.0,1236.0,301.6
2050006.0,17,6,1039,4,312,683216.3333333334,78.0,78.0,2,727,0.0,395.0,363.5
90257052.0,6,13,2036,8,1016,12893864.57142857,188.0,127.0,5,1020,22523377.5,204.0,204.0
300.0,17,2,164,1,82,0.0,82.0,82.0,1,82,0.0,82.0,82.0
2736608.0,6,13,1459,7,862,456101.3333333333,271.0,123.14285714285714,6,597,543890.2,259.0,99.5
136409254.0,17,14,995,7,563,19503075.83333333,174.0,80.42857142857143,7,432,19503331.83333333,174.0,61.71428571428572
90754045.0,6,20,1531,11,840,9070244.7,95.0,76.36363636363636,9,691,11343967.0,95.0,76.77777777777777
90257789.0,6,13,2036,8,1016,12893969.857142856,188.0,127.0,5,1020,22523863.75,204.0,204.0
4389.0,17,2,614,1,72,0.0,72.0,72.0,1,542,0.0,542.0,542.0
306895.0,6,6,412,4,272,102298.33333333331,74.0,68.0,2,140,0.0,74.0,70.0
102006048.0,17,13,821,7,432,17001008.0,174.0,61.71428571428572,6,389,16400151.4,174.0,64.83333333333333
120020362.0,17,28,13364,28,13364,4445198.592592592,501.0,477.2857142857143,0,0,0.0,0.0,0.0
234707.0,6,3,373,2,238,0.0,172.0,119.0,1,135,0.0,135.0,135.0
5647085.0,6,4,270,2,134,0.0,68.0,67.0,2,136,0.0,70.0,68.0
231879.0,6,3,337,2,214,0.0,160.0,107.0,1,123,0.0,123.0,123.0
216364.0,17,2,180,1,90,0.0,90.0,90.0,1,90,0.0,90.0,90.0
90033893.0,17,28,13364,28,13364,3334588.6296296297,501.0,477.2857142857143,0,0,0.0,0.0,0.0
2034.0,17,2,691,1,349,0.0,349.0,349.0,1,342,0.0,342.0,342.0
106928780.0,6,31,2176,16,1071,7128555.8,123.0,66.9375,15,1105,6924532.285714285,139.0,73.66666666666667
7132.0,17,4,823,2,163,0.0,89.0,81.5,2,660,0.0,443.0,330.0
307179.0,6,6,412,4,272,102393.0,74.0,68.0,2,140,0.0,74.0,70.0
47164.0,6,10,2032,5,524,11390.0,252.0,104.8,5,1508,10917.0,1236.0,301.6
22328.0,6,14,4740,7,653,2772.6666666666665,249.0,93.28571428571428,7,4087,3553.5,1514.0,583.8571428571429
98000856.0,17,13,1083,7,563,16333476.0,174.0,80.42857142857143,6,520,15400922.2,174.0,86.66666666666667
153514.0,17,2,180,1,90,0.0,90.0,90.0,1,90,0.0,90.0,90.0
95571809.0,17,14,4796,13,4446,6210280.666666667,342.0,342.0,1,350,0.0,350.0,350.0
311423.0,6,6,412,4,272,103807.66666666669,74.0,68.0,2,140,0.0,74.0,70.0
109824658.0,6,33,2428,17,1288,6864041.125,139.0,75.76470588235294,16,1140,7307231.933333334,123.0,71.25
2533149.0,6,3,1604,1,753,0.0,753.0,753.0,2,851,0.0,785.0,425.5
352.0,17,2,267,1,83,0.0,83.0,83.0,1,184,0.0,184.0,184.0
128860864.0,6,37,2640,19,1392,7158936.888888889,123.0,73.26315789473684,18,1248,6979979.235294118,123.0,69.33333333333333
42156.0,6,14,4740,7,653,6896.666666666667,249.0,93.28571428571428,7,4087,6697.166666666667,1514.0,583.8571428571429
15131394.0,17,6,2052,6,2052,3026278.8,342.0,342.0,0,0,0.0,0.0,0.0
43672.0,6,10,2032,5,524,10532.75,252.0,104.8,5,1508,10551.75,1236.0,301.6
205267.0,17,2,762,2,762,0.0,381.0,381.0,0,0,0.0,0.0,0.0
34011.0,6,10,2032,5,524,6758.75,252.0,104.8,5,1508,8157.75,1236.0,301.6
135127663.0,17,6,1146,6,1146,27025532.6,191.0,191.0,0,0,0.0,0.0,0.0
90308377.0,6,28,3008,14,1544,6946798.230769231,337.0,110.28571428571428,14,1464,6923627.230769231,426.0,104.57142857142856
153434.0,17,2,180,1,90,0.0,90.0,90.0,1,90,0.0,90.0,90.0
128870234.0,6,37,2656,19,1408,7159457.444444444,139.0,74.10526315789474,18,1248,6980528.0,123.0,69.33333333333333
26162.0,6,10,2032,5,524,5662.5,252.0,104.8,5,1508,5887.75,1236.0,301.6
381.0,17,2,300,1,80,0.0,80.0,80.0,1,220,0.0,220.0,220.0
311599.0,6,6,412,4,272,103866.33333333331,74.0,68.0,2,140,0.0,74.0,70.0
90257152.0,6,14,2240,8,1016,12893878.857142856,188.0,127.0,6,1224,18018339.0,204.0,204.0
316871.0,17,4,1400,4,1400,105623.66666666669,350.0,350.0,0,0,0.0,0.0,0.0
122244.0,6,3,373,2,238,0.0,172.0,119.0,1,135,0.0,135.0,135.0
10530616.0,6,7,478,4,272,3465092.0,74.0,68.0,3,206,5197573.5,74.0,68.66666666666667
2598521.0,6,2,132,1,66,0.0,66.0,66.0,1,66,0.0,66.0,66.0
32440.0,6,14,4740,7,653,4965.666666666667,249.0,93.28571428571428,7,4087,5193.333333333333,1514.0,583.8571428571429
93242535.0,17,14,1126,7,563,15540422.5,174.0,80.42857142857143,7,563,15479260.666666666,174.0,80.42857142857143
2535.0,17,4,344,2,150,0.0,75.0,75.0,2,194,0.0,103.0,97.0
27929.0,6,11,2098,6,590,4892.8,252.0,98.33333333333331,5,1508,6415.0,1236.0,301.6
118152488.0,6,35,2542,18,1348,6938107.235294118,139.0,74.88888888888889,17,1194,7371739.0,123.0,70.23529411764706
75336.0,6,14,4740,7,653,11193.833333333334,249.0,93.28571428571428,7,4087,12328.5,1514.0,583.8571428571429
106560.0,17,2,762,2,762,0.0,381.0,381.0,0,0,0.0,0.0,0.0
108108310.0,17,5,1005,5,1005,27027077.5,201.0,201.0,0,0,0.0,0.0,0.0
107834602.0,6,28,1860,14,966,8278342.384615385,123.0,69.0,14,894,8278344.692307692,123.0,63.85714285714285
141320.0,6,2,132,1,66,0.0,66.0,66.0,1,66,0.0,66.0,66.0
106452995.0,6,230,26856,115,19044,931911.1842105264,284.0,165.6,115,7812,931910.8771929824,140.0,67.9304347826087
207072.0,6,3,426,2,280,0.0,214.0,140.0,1,146,0.0,146.0,146.0
236813.0,6,3,337,2,214,0.0,160.0,107.0,1,123,0.0,123.0,123.0
2107.0,17,4,344,2,150,0.0,75.0,75.0,2,194,0.0,103.0,97.0
9775.0,17,2,571,1,86,0.0,86.0,86.0,1,485,0.0,485.0,485.0
2157063.0,6,24,7545,13,2516,179755.25,1034.0,193.53846153846155,11,5029,184684.8,1510.0,457.1818181818182
135137707.0,17,6,1206,6,1206,27027541.4,201.0,201.0,0,0,0.0,0.0,0.0
10476033.0,6,7,478,4,272,3446404.6666666665,74.0,68.0,3,206,5169492.5,74.0,68.66666666666667
144260.0,6,2,132,1,66,0.0,66.0,66.0,1,66,0.0,66.0,66.0
36324.0,6,14,4740,7,653,5931.333333333333,249.0,93.28571428571428,7,4087,5910.333333333333,1514.0,583.8571428571429
108105574.0,17,5,955,5,955,27026393.5,191.0,191.0,0,0,0.0,0.0,0.0
45323.0,6,14,4740,7,653,7180.5,249.0,93.28571428571428,7,4087,7416.666666666667,1514.0,583.8571428571429
1308146.0,6,4,264,2,132,0.0,66.0,66.0,2,132,0.0,66.0,66.0
153478.0,17,2,180,1,90,0.0,90.0,90.0,1,90,0.0,90.0,90.0
305088.0,17,2,180,1,90,0.0,90.0,90.0,1,90,0.0,90.0,90.0
2015314.0,6,18,6803,10,1501,223923.7777777777,408.0,150.1,8,5302,225615.4285714285,1514.0,662.75
23513.0,17,2,582,1,83,0.0,83.0,83.0,1,499,0.0,499.0,499.0
100382892.0,17,12,778,6,389,19896454.0,174.0,64.83333333333333,6,389,20044556.4,174.0,64.83333333333333
220653.0,6,3,426,2,280,0.0,214.0,140.0,1,146,0.0,146.0,146.0
120854112.0,6,47,3102,23,1518,5161348.727272728,66.0,66.0,24,1584,5240069.0869565215,66.0,66.0
2642525.0,6,25,7573,14,3735,203271.15384615384,1514.0,266.7857142857143,11,3838,238214.8,1514.0,348.90909090909093
10465358.0,6,7,478,4,272,3442710.0,74.0,68.0,3,206,5163943.5,74.0,68.66666666666667
252787.0,6,10,1221,6,636,50557.4,298.0,106.0,4,585,78486.33333333333,379.0,146.25
1173139.0,6,13,3012,8,2384,167591.2857142857,1514.0,298.0,5,628,224505.0,331.0,125.6
3577573.0,6,5,336,2,134,0.0,68.0,67.0,3,202,1423514.5,70.0,67.33333333333333
103056.0,17,2,286,2,286,0.0,143.0,143.0,0,0,0.0,0.0,0.0
1739244.0,6,4,492,2,280,0.0,214.0,140.0,2,212,0.0,146.0,106.0
149463173.0,17,36,17126,36,17126,4270376.371428572,501.0,475.72222222222223,0,0,0.0,0.0,0.0
441809.0,17,2,363,1,79,0.0,79.0,79.0,1,284,0.0,284.0,284.0
839716.0,6,9,1118,6,586,167943.2,248.0,97.66666666666669,3,532,282286.5,392.0,177.33333333333334
105042995.0,17,15,5130,15,5130,7503071.071428572,342.0,342.0,0,0,0.0,0.0,0.0
293189.0,17,2,180,1,90,0.0,90.0,90.0,1,90,0.0,90.0,90.0
2292.0,17,4,344,2,150,0.0,75.0,75.0,2,194,0.0,103.0,97.0
151790.0,17,2,414,1,88,0.0,88.0,88.0,1,326,0.0,326.0,326.0
120039147.0,17,29,13785,29,13785,4287112.392857143,501.0,475.3448275862069,0,0,0.0,0.0,0.0
90252297.0,6,16,2368,9,1204,11281537.125,188.0,133.77777777777777,7,1164,15014779.833333334,204.0,166.28571428571428
144009.0,17,2,180,1,90,0.0,90.0,90.0,1,90,0.0,90.0,90.0
122544.0,6,3,373,2,238,0.0,172.0,119.0,1,135,0.0,135.0,135.0
1309844.0,6,4,264,2,132,0.0,66.0,66.0,2,132,0.0,66.0,66.0
313708.0,17,4,1400,4,1400,104569.33333333331,350.0,350.0,0,0,0.0,0.0,0.0
104178862.0,17,14,1126,7,563,17336658.333333332,174.0,80.42857142857143,7,563,17336654.333333332,174.0,80.42857142857143
90032067.0,17,27,12943,27,12943,3462771.8076923075,501.0,479.3703703703704,0,0,0.0,0.0,0.0
90048512.0,17,28,13364,28,13364,3335130.074074074,501.0,477.2857142857143,0,0,0.0,0.0,0.0
0.0,17,1,55,1,55,0.0,55.0,55.0,0,0,0.0,0.0,0.0
90000549.0,6,15,1097,8,596,12857221.285714284,95.0,74.5,7,501,14952395.0,95.0,71.57142857142857
34119.0,6,14,4740,7,653,5307.833333333333,249.0,93.28571428571428,7,4087,4709.833333333333,1514.0,583.8571428571429
233838.0,17,2,180,1,90,0.0,90.0,90.0,1,90,0.0,90.0,90.0
9005.0,17,4,823,2,163,0.0,89.0,81.5,2,660,0.0,443.0,330.0
90252187.0,6,13,2036,8,1016,12893169.57142857,188.0,127.0,5,1020,22522087.75,204.0,204.0
301935.0,6,6,412,4,272,100645.0,74.0,68.0,2,140,0.0,74.0,70.0
19114.0,6,14,4740,7,653,3075.6666666666665,249.0,93.28571428571428,7,4087,3048.333333333333,1514.0,583.8571428571429
19629.0,6,14,4740,7,653,3154.5,249.0,93.28571428571428,7,4087,3019.1666666666665,1514.0,583.8571428571429
114360432.0,6,34,2334,17,1209,7134041.5625,123.0,71.11764705882354,17,1125,7134041.75,123.0,66.17647058823529
2591752.0,6,2,132,1,66,0.0,66.0,66.0,1,66,0.0,66.0,66.0
110692.0,17,4,1400,4,1400,36897.333333333336,350.0,350.0,0,0,0.0,0.0,0.0
94089484.0,6,24,1958,13,948,7840790.333333333,95.0,72.92307692307692,11,1010,9382324.3,224.0,91.8181818181818
104173.0,6,12,1328,7,797,17362.166666666668,253.0,113.85714285714286,5,531,24868.5,259.0,106.2
311973.0,17,4,1400,4,1400,103991.0,350.0,350.0,0,0,0.0,0.0,0.0
3175441.0,6,18,1495,9,921,358360.625,315.0,102.33333333333331,9,574,358331.125,78.0,63.77777777777778
5628930.0,6,5,336,2,134,0.0,68.0,67.0,3,202,1522996.5,70.0,67.33333333333333
100003711.0,17,11,473,6,258,20000742.2,43.0,43.0,5,215,20000146.5,43.0,43.0
322227.0,6,6,412,4,272,107409.0,74.0,68.0,2,140,0.0,74.0,70.0
4607.0,17,2,614,1,72,0.0,72.0,72.0,1,542,0.0,542.0,542.0
228420.0,17,2,180,1,90,0.0,90.0,90.0,1,90,0.0,90.0,90.0
317246.0,6,6,412,4,272,105748.66666666669,74.0,68.0,2,140,0.0,74.0,70.0
119982721.0,17,35,16705,35,16705,3528903.5588235296,501.0,477.2857142857143,0,0,0.0,0.0,0.0
7846.000000000001,17,4,823,2,163,0.0,89.0,81.5,2,660,0.0,443.0,330.0
90049301.0,17,27,12943,27,12943,3463434.653846154,501.0,479.3703703703704,0,0,0.0,0.0,0.0
305.0,17,2,164,1,82,0.0,82.0,82.0,1,82,0.0,82.0,82.0
92713067.0,6,38,2508,19,1254,5135436.444444444,66.0,66.0,19,1254,5135433.611111111,66.0,66.0
62713.00000000001,6,14,4740,7,653,9815.833333333334,249.0,93.28571428571428,7,4087,9780.666666666666,1514.0,583.8571428571429
2354.0,17,4,344,2,150,0.0,75.0,75.0,2,194,0.0,103.0,97.0
90298473.0,6,16,1192,8,596,12892874.714285716,95.0,74.5,8,596,12898763.57142857,95.0,74.5
38998.0,6,14,4740,7,653,6128.166666666667,249.0,93.28571428571428,7,4087,6358.166666666667,1514.0,583.8571428571429
2849245.0,6,5,336,3,202,1424622.5,70.0,67.33333333333333,2,134,0.0,68.0,67.0
1308008.0,6,4,264,2,132,0.0,66.0,66.0,2,132,0.0,66.0,66.0
16513.0,6,11,2098,6,590,2924.8,252.0,98.33333333333331,5,1508,3782.25,1236.0,301.6
155473.0,6,3,337,2,214,0.0,160.0,107.0,1,123,0.0,123.0,123.0
41226.0,6,14,4740,7,653,6484.5,249.0,93.28571428571428,7,4087,6631.833333333333,1514.0,583.8571428571429
38059.0,6,14,4740,7,653,5814.666666666667,249.0,93.28571428571428,7,4087,5973.166666666667,1514.0,583.8571428571429
90275379.0,6,14,1043,7,542,15045896.5,95.0,77.42857142857143,7,501,14997687.166666666,95.0,71.57142857142857
309621.0,17,4,1400,4,1400,103207.0,350.0,350.0,0,0,0.0,0.0,0.0
45922.0,6,14,4740,7,653,7532.166666666667,249.0,93.28571428571428,7,4087,6434.833333333333,1514.0,583.8571428571429
60283.0,6,14,4740,7,653,9732.166666666666,249.0,93.28571428571428,7,4087,9621.833333333334,1514.0,583.8571428571429
543218.0,6,6,758,3,410,255445.5,172.0,136.66666666666666,3,348,199348.0,135.0,116.0
17565.0,6,2,145,2,145,0.0,91.0,72.5,0,0,0.0,0.0,0.0
90018187.0,17,28,13364,28,13364,3334006.925925926,501.0,477.2857142857143,0,0,0.0,0.0,0.0
24137.0,6,10,2032,5,524,5782.25,252.0,104.8,5,1508,5626.5,1236.0,301.6
205574.0,6,10,1221,6,636,41114.8,298.0,106.0,4,585,67320.33333333333,379.0,146.25
12779.0,6,10,1065,5,534,2806.25,262.0,106.8,5,531,2972.5,259.0,106.2
107622.0,17,2,286,2,286,0.0,143.0,143.0,0,0,0.0,0.0,0.0
46927.0,6,10,2032,5,524,11411.5,252.0,104.8,5,1508,10834.75,1236.0,301.6
153432.0,17,2,180,1,90,0.0,90.0,90.0,1,90,0.0,90.0,90.0
15102.0,17,2,180,1,90,0.0,90.0,90.0,1,90,0.0,90.0,90.0
233092.0,6,3,373,2,238,0.0,172.0,119.0,1,135,0.0,135.0,135.0
135134062.0,17,6,1206,6,1206,27026812.4,201.0,201.0,0,0,0.0,0.0,0.0
108097059.0,17,5,955,5,955,27024264.75,191.0,191.0,0,0,0.0,0.0,0.0
135124936.0,17,6,1146,6,1146,27024987.2,191.0,191.0,0,0,0.0,0.0,0.0
51177.0,6,14,4740,7,653,8324.833333333334,249.0,93.28571428571428,7,4087,8091.833333333333,1514.0,583.8571428571429
13605065.0,6,20,1607,10,975,1478399.888888889,315.0,97.5,10,632,1478158.4444444445,78.0,63.2
131617.0,6,3,337,2,214,0.0,160.0,107.0,1,123,0.0,123.0,123.0
115358010.0,6,55,4734,25,2178,4806566.416666667,123.0,87.12,30,2556,3819616.793103448,123.0,85.2
90260799.0,6,12,1832,8,1016,12894399.857142856,188.0,127.0,4,816,30032376.0,204.0,204.0
2329.0,17,4,344,2,150,0.0,75.0,75.0,2,194,0.0,103.0,97.0
135135508.0,17,6,1146,6,1146,27027101.6,191.0,191.0,0,0,0.0,0.0,0.0
241929.0,6,3,337,2,214,0.0,160.0,107.0,1,123,0.0,123.0,123.0
90253233.0,6,12,1832,8,1016,12893319.0,188.0,127.0,4,816,30029544.33333333,204.0,204.0
186954.0,6,3,337,2,214,0.0,160.0,107.0,1,123,0.0,123.0,123.0
120008851.0,17,14,864,8,475,17144121.57142857,174.0,59.375,6,389,20000186.4,174.0,64.83333333333333
5834858.0,6,5,336,2,134,0.0,68.0,67.0,3,202,1529722.5,70.0,67.33333333333333
2802698.0,6,11,2106,6,598,560361.0,252.0,99.66666666666669,5,1508,1621.75,1236.0,301.6
2303849.0,6,25,7573,14,3735,177219.15384615384,1514.0,266.7857142857143,11,3838,205729.0,1514.0,348.90909090909093
77908.0,6,14,4740,7,653,12684.166666666666,249.0,93.28571428571428,7,4087,11312.333333333334,1514.0,583.8571428571429
20681.0,17,2,582,1,83,0.0,83.0,83.0,1,499,0.0,499.0,499.0
121388.0,6,3,337,2,214,0.0,160.0,107.0,1,123,0.0,123.0,123.0
119722.0,17,2,180,1,70,0.0,70.0,70.0,1,110,0.0,110.0,110.0
138865.0,6,2,132,1,66,0.0,66.0,66.0,1,66,0.0,66.0,66.0
20287.0,6,14,4740,7,653,3232.6666666666665,249.0,93.28571428571428,7,4087,3174.5,1514.0,583.8571428571429
117676016.0,6,206,23314,103,16220,1151576.1764705882,284.0,157.4757281553398,103,7094,1151576.4019607843,140.0,68.87378640776699
90007031.0,17,28,13364,28,13364,3333593.7407407407,501.0,477.2857142857143,0,0,0.0,0.0,0.0
90225417.0,6,16,1192,8,596,12852213.42857143,95.0,74.5,8,596,12856929.857142856,95.0,74.5
82.0,17,2,700,2,700,0.0,350.0,350.0,0,0,0.0,0.0,0.0
281022.0,6,10,1221,6,636,56204.4,298.0,106.0,4,585,88318.33333333333,379.0,146.25
254750.0,6,3,337,2,214,0.0,160.0,107.0,1,123,0.0,123.0,123.0
90039072.0,6,16,1233,8,596,8606566.42857143,95.0,74.5,8,637,12862222.57142857,95.0,79.625
9540.0,17,2,571,1,86,0.0,86.0,86.0,1,485,0.0,485.0,485.0
292599.0,17,4,704,2,148,0.0,74.0,74.0,2,556,0.0,280.0,278.0
105253.0,17,2,286,2,286,0.0,143.0,143.0,0,0,0.0,0.0,0.0
135130130.0,17,6,1146,6,1146,27026026.0,191.0,191.0,0,0,0.0,0.0,0.0
108102914.0,17,5,955,5,955,27025728.5,191.0,191.0,0,0,0.0,0.0,0.0
113520354.0,6,46,3036,23,1518,5160004.636363637,66.0,66.0,23,1518,5160004.636363637,66.0,66.0
100436.0,17,2,286,2,286,0.0,143.0,143.0,0,0,0.0,0.0,0.0
90055799.0,17,28,13364,28,13364,3335399.962962963,501.0,477.2857142857143,0,0,0.0,0.0,0.0
90259732.0,6,12,1832,8,1016,12894247.42857143,188.0,127.0,4,816,30031791.33333333,204.0,204.0
5627817.0,6,5,336,2,134,0.0,68.0,67.0,3,202,1424101.0,70.0,67.33333333333333
99409113.0,17,12,778,6,389,19800156.8,174.0,64.83333333333333,6,389,19801591.6,174.0,64.83333333333333
222264.0,17,2,180,1,90,0.0,90.0,90.0,1,90,0.0,90.0,90.0
187088.0,17,4,704,2,148,0.0,74.0,74.0,2,556,0.0,280.0,278.0
298900.0,6,6,412,4,272,99633.33333333331,74.0,68.0,2,140,0.0,74.0,70.0
268267.0,6,4,492,2,280,0.0,214.0,140.0,2,212,0.0,146.0,106.0
2338.0,17,4,344,2,150,0.0,75.0,75.0,2,194,0.0,103.0,97.0
90212177.0,6,16,1192,8,596,12853646.42857143,95.0,74.5,8,596,12858092.142857144,95.0,74.5
108677761.0,6,34,2482,17,1288,6778788.375,139.0,75.76470588235294,17,1194,6778880.3125,123.0,70.23529411764706
115351778.0,6,219,24818,110,7556,1058273.1926605504,140.0,68.69090909090909,109,17262,1058339.3703703703,300.0,158.36697247706422
103316.0,17,2,286,2,286,0.0,143.0,143.0,0,0,0.0,0.0,0.0
843275.0,6,9,1118,6,586,168655.0,248.0,97.66666666666669,3,532,283792.5,392.0,177.33333333333334
93943971.0,6,26,1746,13,906,7810663.0,123.0,69.6923076923077,13,840,7810663.583333333,123.0,64.61538461538461
10877784.0,6,8,544,4,272,3580560.333333333,74.0,68.0,4,272,3580472.6666666665,74.0,68.0
10479267.0,6,7,478,4,272,3445813.0,74.0,68.0,3,206,5168614.0,74.0,68.66666666666667
124456878.0,17,14,864,7,432,17666868.5,174.0,61.71428571428572,7,432,17667675.0,174.0,61.71428571428572
90298395.0,6,22,1680,12,935,8204477.636363637,95.0,77.91666666666667,10,745,10001502.888888888,95.0,74.5
107228.0,17,2,286,2,286,0.0,143.0,143.0,0,0,0.0,0.0,0.0
135133889.0,17,6,1146,6,1146,27026777.8,191.0,191.0,0,0,0.0,0.0,0.0
20206.0,17,2,582,1,83,0.0,83.0,83.0,1,499,0.0,499.0,499.0
153302.0,6,14,4740,7,653,24195.83333333333,249.0,93.28571428571428,7,4087,25203.5,1514.0,583.8571428571429
295.0,17,2,174,1,79,0.0,79.0,79.0,1,95,0.0,95.0,95.0
208332.0,6,3,426,2,280,0.0,214.0,140.0,1,146,0.0,146.0,146.0
18987.0,6,14,4740,7,653,2998.1666666666665,249.0,93.28571428571428,7,4087,3029.1666666666665,1514.0,583.8571428571429
143964.0,17,2,180,1,90,0.0,90.0,90.0,1,90,0.0,90.0,90.0
4368.0,17,2,598,1,72,0.0,72.0,72.0,1,526,0.0,526.0,526.0
153437.0,17,2,180,1,90,0.0,90.0,90.0,1,90,0.0,90.0,90.0
123839928.0,6,49,3234,25,1650,5159997.0,66.0,66.0,24,1584,5061794.782608695,66.0,66.0
204641.0,17,2,762,2,762,0.0,381.0,381.0,0,0,0.0,0.0,0.0
37497.0,6,14,4740,7,653,5391.833333333333,249.0,93.28571428571428,7,4087,5591.333333333333,1514.0,583.8571428571429
2359.0,17,4,344,2,150,0.0,75.0,75.0,2,194,0.0,103.0,97.0
153430.0,17,2,180,1,90,0.0,90.0,90.0,1,90,0.0,90.0,90.0
8958.0,17,2,507,1,86,0.0,86.0,86.0,1,421,0.0,421.0,421.0
45435957.0,17,9,3086,8,2736,5138824.428571428,342.0,342.0,1,350,0.0,350.0,350.0
50928.0,17,2,180,1,90,0.0,90.0,90.0,1,90,0.0,90.0,90.0
5632715.0,6,5,336,2,134,0.0,68.0,67.0,3,202,1528646.0,70.0,67.33333333333333
45499.0,6,14,4740,7,653,6683.0,249.0,93.28571428571428,7,4087,7441.833333333333,1514.0,583.8571428571429
90051943.0,17,27,12943,27,12943,3463536.269230769,501.0,479.3703703703704,0,0,0.0,0.0,0.0
306.0,17,2,164,1,82,0.0,82.0,82.0,1,82,0.0,82.0,82.0
144851.0,17,2,180,1,70,0.0,70.0,70.0,1,110,0.0,110.0,110.0
37470.0,6,14,4740,7,653,5791.666666666667,249.0,93.28571428571428,7,4087,5781.0,1514.0,583.8571428571429
205304.0,17,3,1143,3,1143,102652.0,381.0,381.0,0,0,0.0,0.0,0.0
2310.0,17,4,344,2,150,0.0,75.0,75.0,2,194,0.0,103.0,97.0
19298.0,6,14,4740,7,653,3013.6666666666665,249.0,93.28571428571428,7,4087,3077.833333333333,1514.0,583.8571428571429
97730.0,17,2,762,2,762,0.0,381.0,381.0,0,0,0.0,0.0,0.0
22899.0,6,14,4740,7,653,3531.1666666666665,249.0,93.28571428571428,7,4087,3571.5,1514.0,583.8571428571429
101212.0,17,2,762,2,762,0.0,381.0,381.0,0,0,0.0,0.0,0.0
217820.0,6,3,426,2,280,0.0,214.0,140.0,1,146,0.0,146.0,146.0
9354.0,17,2,498,1,80,0.0,80.0,80.0,1,418,0.0,418.0,418.0
120047081.0,17,29,13785,29,13785,4287395.75,501.0,475.3448275862069,0,0,0.0,0.0,0.0
90296967.0,6,16,1192,8,596,12892697.0,95.0,74.5,8,596,12898047.285714284,95.0,74.5
9733.0,17,2,539,1,86,0.0,86.0,86.0,1,453,0.0,453.0,453.0
5625922.0,6,5,336,2,134,0.0,68.0,67.0,3,202,1423502.5,70.0,67.33333333333333
144403.0,17,2,180,1,90,0.0,90.0,90.0,1,90,0.0,90.0,90.0
238796.0,6,3,337,2,214,0.0,160.0,107.0,1,123,0.0,123.0,123.0
358.0,17,2,208,1,72,0.0,72.0,72.0,1,136,0.0,136.0,136.0
340.0,17,2,160,1,80,0.0,80.0,80.0,1,80,0.0,80.0,80.0
49780.0,6,14,4740,7,653,8176.166666666667,249.0,93.28571428571428,7,4087,7888.0,1514.0,583.8571428571429
42439.0,6,14,4740,7,653,6948.5,249.0,93.28571428571428,7,4087,6744.0,1514.0,583.8571428571429
1961.0,17,2,180,1,90,0.0,90.0,90.0,1,90,0.0,90.0,90.0
128667798.0,6,34,2334,17,1125,7417575.5,123.0,66.17647058823529,17,1209,7417588.9375,123.0,71.11764705882354
123647993.0,6,49,3234,25,1650,5151999.708333333,66.0,66.0,24,1584,5144728.782608695,66.0,66.0
43451.0,6,13,1394,7,797,7241.833333333333,253.0,113.85714285714286,6,597,7546.6,259.0,99.5
2345.0,17,4,344,2,150,0.0,75.0,75.0,2,194,0.0,103.0,97.0
505329.0,6,4,270,2,134,0.0,68.0,67.0,2,136,0.0,70.0,68.0
107353.0,17,2,286,2,286,0.0,143.0,143.0,0,0,0.0,0.0,0.0
889996.0,6,12,2710,7,743,148332.66666666666,339.0,106.14285714285714,5,1967,153592.0,1514.0,393.4
138623.0,6,2,132,1,66,0.0,66.0,66.0,1,66,0.0,66.0,66.0
27279.0,6,10,2032,5,524,5837.75,252.0,104.8,5,1508,6145.25,1236.0,301.6
42725.0,6,14,4740,7,653,6431.333333333333,249.0,93.28571428571428,7,4087,5580.0,1514.0,583.8571428571429
90039282.0,17,28,13364,28,13364,3334788.222222222,501.0,477.2857142857143,0,0,0.0,0.0,0.0
48999.0,6,14,4740,7,653,8057.333333333333,249.0,93.28571428571428,7,4087,8023.166666666667,1514.0,583.8571428571429
302256.0,6,6,412,4,272,100752.0,74.0,68.0,2,140,0.0,74.0,70.0
107368.0,17,2,286,2,286,0.0,143.0,143.0,0,0,0.0,0.0,0.0
90012196.0,6,190,21516,95,15024,955286.7978723404,284.0,158.14736842105262,95,6492,955287.0531914892,140.0,68.33684210526316
206883.0,17,2,180,1,90,0.0,90.0,90.0,1,90,0.0,90.0,90.0
2601279.0,6,2,132,1,66,0.0,66.0,66.0,1,66,0.0,66.0,66.0
119860556.0,17,35,16705,35,16705,3525310.470588235,501.0,477.2857142857143,0,0,0.0,0.0,0.0
51614.0,6,14,4740,7,653,8477.0,249.0,93.28571428571428,7,4087,7371.333333333333,1514.0,583.8571428571429
143870.0,17,2,180,1,90,0.0,90.0,90.0,1,90,0.0,90.0,90.0
776.0,17,4,438,2,148,0.0,74.0,74.0,2,290,0.0,147.0,145.0
89191.0,6,2,132,1,66,0.0,66.0,66.0,1,66,0.0,66.0,66.0
167310.0,17,2,180,1,90,0.0,90.0,90.0,1,90,0.0,90.0,90.0
41680726.0,6,788,733083,219,14633,191195.9908256881,213.0,66.81735159817352,569,718450,73376.07218309859,1514.0,1262.6537785588753
321909.0,6,6,412,4,272,107303.0,74.0,68.0,2,140,0.0,74.0,70.0
47608040.0,6,8,1940,3,887,22383589.5,753.0,295.6666666666667,5,1053,11208010.75,785.0,210.6
90528163.0,6,14,2240,8,1016,12932594.714285716,188.0,127.0,6,1224,18072781.4,204.0,204.0
2092683.0,6,18,6803,10,1501,232520.3333333333,408.0,150.1,8,5302,240602.4285714285,1514.0,662.75
3172825.0,6,3,204,1,68,0.0,68.0,68.0,2,136,0.0,70.0,68.0
74872.0,6,10,2032,5,524,18440.25,252.0,104.8,5,1508,18171.0,1236.0,301.6
90526072.0,6,14,2240,8,1016,12932296.0,188.0,127.0,6,1224,18072559.4,204.0,204.0
112216078.0,6,32,2305,16,1140,7481071.866666666,123.0,71.25,16,1165,7466589.066666666,139.0,72.8125
90242672.0,17,12,778,6,389,18000156.4,174.0,64.83333333333333,6,389,18000404.8,174.0,64.83333333333333
27571.0,6,14,4740,7,653,4471.666666666667,249.0,93.28571428571428,7,4087,4071.3333333333335,1514.0,583.8571428571429
118905997.0,6,34,2334,17,1209,7418111.625,123.0,71.11764705882354,17,1125,7418112.25,123.0,66.17647058823529
153431.0,17,2,180,1,90,0.0,90.0,90.0,1,90,0.0,90.0,90.0
90031867.0,17,28,13364,28,13364,3334513.592592593,501.0,477.2857142857143,0,0,0.0,0.0,0.0
103516.0,17,2,286,2,286,0.0,143.0,143.0,0,0,0.0,0.0,0.0
306146.0,6,6,412,4,272,102048.66666666669,74.0,68.0,2,140,0.0,74.0,70.0
108101345.0,17,5,955,5,955,27025336.25,191.0,191.0,0,0,0.0,0.0,0.0
20368.0,6,10,2032,5,524,4853.5,252.0,104.8,5,1508,4868.75,1236.0,301.6
90298023.0,6,16,1192,8,596,12892615.857142856,95.0,74.5,8,596,12897796.285714284,95.0,74.5
143214.0,6,2,132,1,66,0.0,66.0,66.0,1,66,0.0,66.0,66.0
42889.0,6,12,1328,7,797,7148.166666666667,253.0,113.85714285714286,5,531,8705.75,259.0,106.2
90527152.0,6,14,2240,8,1016,12932450.285714284,188.0,127.0,6,1224,18072603.6,204.0,204.0
16689397.0,6,20,1611,9,921,2048062.0,315.0,102.33333333333331,11,690,1638429.6,78.0,62.72727272727273
90265447.0,6,12,1832,8,1016,12895063.857142856,188.0,127.0,4,816,30031196.666666668,204.0,204.0
2024396.0,17,4,525,2,150,0.0,75.0,75.0,2,375,0.0,284.0,187.5
217704.0,6,3,426,2,280,0.0,214.0,140.0,1,146,0.0,146.0,146.0
217687.0,6,10,1221,6,636,43537.4,298.0,106.0,4,585,70769.0,379.0,146.25
90256356.0,6,13,2036,8,1016,12893765.142857144,188.0,127.0,5,1020,22522951.25,204.0,204.0
216657.0,17,2,180,1,90,0.0,90.0,90.0,1,90,0.0,90.0,90.0
206130.0,6,3,426,2,280,0.0,214.0,140.0,1,146,0.0,146.0,146.0
34960.0,6,14,4740,7,653,5633.5,249.0,93.28571428571428,7,4087,5585.666666666667,1514.0,583.8571428571429
233730.0,6,3,337,2,214,0.0,160.0,107.0,1,123,0.0,123.0,123.0
14145.0,6,11,1132,6,556,2829.0,218.0,92.66666666666669,5,576,2847.0,304.0,115.2
1946967.0,6,3,1602,1,752,0.0,752.0,752.0,2,850,0.0,784.0,425.0
504863.0,6,10,1913,5,461,125747.75,233.0,92.2,5,1452,124146.75,1224.0,290.4
1044665.0,6,11,1134,6,558,208933.0,220.0,93.0,5,576,259306.25,304.0,115.2
113706749.0,6,32,2368,16,1140,7580449.933333334,123.0,71.25,16,1228,7053529.266666667,139.0,76.75
90068661.0,17,28,13364,28,13364,3335876.333333333,501.0,477.2857142857143,0,0,0.0,0.0,0.0
119476404.0,6,210,23662,105,16510,1146743.173076923,284.0,157.23809523809524,105,7152,1146743.4615384615,140.0,68.11428571428571
120183738.0,6,230,25994,115,7812,1046845.9736842106,140.0,67.9304347826087,115,18182,1037782.2719298246,284.0,158.10434782608695
108106158.0,17,5,955,5,955,27026539.5,191.0,191.0,0,0,0.0,0.0,0.0
1302547.0,6,4,264,2,132,0.0,66.0,66.0,2,132,0.0,66.0,66.0
120437925.0,6,337,41336,169,30026,716892.4107142857,464.0,177.66863905325442,168,11310,714969.4011976048,140.0,67.32142857142857
138541.0,17,2,192,1,88,0.0,88.0,88.0,1,104,0.0,104.0,104.0
108108417.0,17,5,955,5,955,27027104.25,191.0,191.0,0,0,0.0,0.0,0.0
217752.0,6,3,426,2,280,0.0,214.0,140.0,1,146,0.0,146.0,146.0
238728.0,6,3,337,2,214,0.0,160.0,107.0,1,123,0.0,123.0,123.0
0.0,17,1,44,1,44,0.0,44.0,44.0,0,0,0.0,0.0,0.0
120024205.0,17,29,13785,29,13785,4286578.75,501.0,475.3448275862069,0,0,0.0,0.0,0.0
106997764.0,6,31,2176,16,1071,7133184.266666667,123.0,66.9375,15,1105,6914051.571428572,139.0,73.66666666666667
853.0,17,4,438,2,148,0.0,74.0,74.0,2,290,0.0,147.0,145.0
33705.0,6,2,145,2,145,0.0,91.0,72.5,0,0,0.0,0.0,0.0
204961.0,17,2,180,1,90,0.0,90.0,90.0,1,90,0.0,90.0,90.0
51104.0,6,14,4740,7,653,7319.666666666667,249.0,93.28571428571428,7,4087,7505.166666666667,1514.0,583.8571428571429
32729.0,6,14,4740,7,653,5290.166666666667,249.0,93.28571428571428,7,4087,5162.333333333333,1514.0,583.8571428571429
20431.0,6,11,1133,6,602,3619.8,264.0,100.33333333333331,5,531,4501.25,259.0,106.2
232993.0,6,3,337,2,214,0.0,160.0,107.0,1,123,0.0,123.0,123.0
2417.0,17,4,344,2,150,0.0,75.0,75.0,2,194,0.0,103.0,97.0
10373.0,17,4,823,2,163,0.0,89.0,81.5,2,660,0.0,443.0,330.0
90037545.0,17,27,12943,27,12943,3462982.5,501.0,479.3703703703704,0,0,0.0,0.0,0.0
232718.0,17,2,180,1,90,0.0,90.0,90.0,1,90,0.0,90.0,90.0
26821486.0,17,5,1718,4,1368,930063.3333333334,342.0,342.0,1,350,0.0,350.0,350.0
51367.0,6,14,4740,7,653,7655.5,249.0,93.28571428571428,7,4087,8183.5,1514.0,583.8571428571429
12925.0,6,14,4740,7,653,2039.0,249.0,93.28571428571428,7,4087,2016.3333333333333,1514.0,583.8571428571429
1255.0,17,2,762,2,762,0.0,381.0,381.0,0,0,0.0,0.0,0.0
307.0,17,2,174,1,79,0.0,79.0,79.0,1,95,0.0,95.0,95.0
120012643.0,17,15,1169,8,606,17144663.285714287,174.0,75.75,7,563,16666872.166666666,174.0,80.42857142857143
216551.0,6,3,426,2,280,0.0,214.0,140.0,1,146,0.0,146.0,146.0
5628970.0,6,5,336,2,134,0.0,68.0,67.0,3,202,1528447.0,70.0,67.33333333333333
61787.0,6,10,2032,5,524,15048.0,252.0,104.8,5,1508,14583.0,1236.0,301.6
26617.0,6,10,1066,5,490,4127.5,218.0,98.0,5,576,5874.5,304.0,115.2
90043183.0,17,27,12943,27,12943,3463199.346153846,501.0,479.3703703703704,0,0,0.0,0.0,0.0
2312.0,17,4,344,2,150,0.0,75.0,75.0,2,194,0.0,103.0,97.0
1774125.0,6,2,132,1,66,0.0,66.0,66.0,1,66,0.0,66.0,66.0
143065.0,6,2,132,1,66,0.0,66.0,66.0,1,66,0.0,66.0,66.0
323.0,17,2,174,1,79,0.0,79.0,79.0,1,95,0.0,95.0,95.0
863645.0,6,9,1096,6,625,172729.0,287.0,104.16666666666669,3,471,293906.5,331.0,157.0
2591432.0,6,3,204,1,68,0.0,68.0,68.0,2,136,0.0,70.0,68.0
300718.0,6,3,202,2,128,0.0,74.0,64.0,1,74,0.0,74.0,74.0
100267626.0,17,12,778,6,389,19907998.2,174.0,64.83333333333333,6,389,20021733.2,174.0,64.83333333333333
2416320.0,6,3,1604,1,753,0.0,753.0,753.0,2,851,0.0,785.0,425.5
57441456.0,6,20,1429,10,694,6382384.0,95.0,69.4,10,735,6359484.444444444,95.0,73.5
299861.0,6,6,412,4,272,99953.66666666669,74.0,68.0,2,140,0.0,74.0,70.0
498414.0,6,5,336,2,134,0.0,68.0,67.0,3,202,195437.0,70.0,67.33333333333333
1092375.0,6,13,1386,7,789,182062.5,253.0,112.71428571428572,6,597,216087.2,259.0,99.5
298154.0,6,6,412,4,272,99384.66666666669,74.0,68.0,2,140,0.0,74.0,70.0
142368.0,6,2,132,1,66,0.0,66.0,66.0,1,66,0.0,66.0,66.0
508213.0,6,5,336,2,134,0.0,68.0,67.0,3,202,192800.5,70.0,67.33333333333333
15919.0,6,10,2032,5,524,3626.75,252.0,104.8,5,1508,3006.0,1236.0,301.6
104046.0,17,2,286,2,286,0.0,143.0,143.0,0,0,0.0,0.0,0.0
90097096.0,6,11,1644,4,816,30031592.0,204.0,204.0,7,828,15015942.666666666,188.0,118.28571428571428
322299.0,17,4,1400,4,1400,107433.0,350.0,350.0,0,0,0.0,0.0,0.0
585632.0,6,5,526,3,280,292816.0,160.0,93.33333333333331,2,246,0.0,123.0,123.0
32054.0,6,14,4740,7,653,4582.5,249.0,93.28571428571428,7,4087,4851.833333333333,1514.0,583.8571428571429
36118.0,6,14,4740,7,653,4456.166666666667,249.0,93.28571428571428,7,4087,5294.833333333333,1514.0,583.8571428571429
33704846.0,6,5,336,2,134,0.0,68.0,67.0,3,202,15462535.0,70.0,67.33333333333333
5621420.0,6,5,336,2,134,0.0,68.0,67.0,3,202,1525910.0,70.0,67.33333333333333
119537933.0,17,34,16284,34,16284,3622361.606060606,501.0,478.9411764705882,0,0,0.0,0.0,0.0
108319.0,17,2,286,2,286,0.0,143.0,143.0,0,0,0.0,0.0,0.0
90023758.0,17,27,12943,27,12943,3462452.230769231,501.0,479.3703703703704,0,0,0.0,0.0,0.0
2879.0,17,2,224,1,76,0.0,76.0,76.0,1,148,0.0,148.0,148.0
314346.0,17,4,571,2,148,0.0,74.0,74.0,2,423,0.0,280.0,211.5
91103016.0,6,268,44498,134,35358,683442.8195488722,1514.0,263.86567164179104,134,9140,683442.4360902256,214.0,68.2089552238806
213679.0,17,2,180,1,90,0.0,90.0,90.0,1,90,0.0,90.0,90.0
105029650.0,17,15,5130,15,5130,7502117.857142857,342.0,342.0,0,0,0.0,0.0,0.0
121879006.0,17,14,864,7,432,17166854.666666668,174.0,61.71428571428572,7,432,17001372.0,174.0,61.71428571428572
233850.0,6,3,337,2,214,0.0,160.0,107.0,1,123,0.0,123.0,123.0
27955.0,6,14,4740,7,653,4534.333333333333,249.0,93.28571428571428,7,4087,4521.666666666667,1514.0,583.8571428571429
17065.0,6,14,4740,7,653,2439.333333333333,249.0,93.28571428571428,7,4087,2627.5,1514.0,583.8571428571429
3001831.0,17,6,540,3,210,1441002.5,70.0,70.0,3,330,1440812.5,110.0,110.0
9383.0,17,2,582,1,83,0.0,83.0,83.0,1,499,0.0,499.0,499.0
2999011.0,6,159,125656,89,116734,34079.670454545456,1510.0,1311.6179775280898,70,8922,39057.57971014493,1510.0,127.45714285714286
2992176.0,6,11,2106,6,598,598256.2,252.0,99.66666666666669,5,1508,5908.5,1236.0,301.6
11698.0,17,4,823,2,163,0.0,89.0,81.5,2,660,0.0,443.0,330.0
5005532.0,17,4,849,2,166,0.0,83.0,83.0,2,683,0.0,499.0,341.5
58701.0,6,14,4740,7,653,9664.5,249.0,93.28571428571428,7,4087,4103.5,1514.0,583.8571428571429
120223050.0,6,268,30212,134,9140,897734.8270676691,140.0,68.2089552238806,134,21072,897732.3533834587,284.0,157.2537313432836
90293412.0,6,21,1585,11,840,9024493.1,95.0,76.36363636363636,10,745,10000858.666666666,95.0,74.5
255008.0,6,3,337,2,214,0.0,160.0,107.0,1,123,0.0,123.0,123.0
90035962.0,17,28,13364,28,13364,3334665.25925926,501.0,477.2857142857143,0,0,0.0,0.0,0.0
11384.0,6,11,2098,6,590,1934.2,252.0,98.33333333333331,5,1508,2559.0,1236.0,301.6
1035651.0,6,11,1134,6,558,207130.2,220.0,93.0,5,576,255760.25,304.0,115.2
90530466.0,6,14,2240,8,1016,12932923.714285716,188.0,127.0,6,1224,18073502.4,204.0,204.0
144231.0,17,2,180,1,90,0.0,90.0,90.0,1,90,0.0,90.0,90.0
228948.0,6,12,1373,7,714,38158.0,298.0,102.0,5,659,56210.0,379.0,131.8
10906241.0,6,8,544,4,272,3588314.0,74.0,68.0,4,272,3588265.0,74.0,68.0
143967.0,17,2,180,1,90,0.0,90.0,90.0,1,90,0.0,90.0,90.0
239739.0,6,3,337,2,214,0.0,160.0,107.0,1,123,0.0,123.0,123.0
260542.0,6,3,337,2,214,0.0,160.0,107.0,1,123,0.0,123.0,123.0
146633.0,17,4,704,2,148,0.0,74.0,74.0,2,556,0.0,280.0,278.0
109522508.0,6,236,26696,118,18612,934340.5128205128,336.0,157.72881355932202,118,8084,934340.811965812,140.0,68.50847457627118
45279.0,6,14,4740,7,653,6995.0,249.0,93.28571428571428,7,4087,7247.166666666667,1514.0,583.8571428571429
2401.0,17,4,344,2,150,0.0,75.0,75.0,2,194,0.0,103.0,97.0
32974.0,6,14,4740,7,653,5337.666666666667,249.0,93.28571428571428,7,4087,5248.166666666667,1514.0,583.8571428571429
206143.0,6,3,426,2,280,0.0,214.0,140.0,1,146,0.0,146.0,146.0
90292047.0,6,19,1436,10,745,10027607.333333334,95.0,74.5,9,691,11286041.375,95.0,76.77777777777777
25712.0,6,14,4740,7,653,4176.5,249.0,93.28571428571428,7,4087,3252.0,1514.0,583.8571428571429
22065.0,6,14,4740,7,653,2978.833333333333,249.0,93.28571428571428,7,4087,3506.0,1514.0,583.8571428571429
1322365.0,6,4,264,2,132,0.0,66.0,66.0,2,132,0.0,66.0,66.0
2119869.0,6,24,7543,12,2450,192715.36363636365,1034.0,204.16666666666663,12,5093,165152.0909090909,1510.0,424.4166666666667
21879.0,6,11,1133,6,602,3898.0,264.0,100.33333333333331,5,531,4594.0,259.0,106.2
131848.0,6,3,337,2,214,0.0,160.0,107.0,1,123,0.0,123.0,123.0
143872.0,17,2,180,1,90,0.0,90.0,90.0,1,90,0.0,90.0,90.0
135133884.0,17,6,1206,6,1206,27026776.8,201.0,201.0,0,0,0.0,0.0,0.0
2578320.0,6,3,1604,2,851,0.0,785.0,425.5,1,753,0.0,753.0,753.0
118522709.0,6,238,26866,119,18716,1002605.8050847456,284.0,157.27731092436974,119,8150,1002605.1440677966,140.0,68.4873949579832
107072.0,17,2,286,2,286,0.0,143.0,143.0,0,0,0.0,0.0,0.0
1519612.0,6,8,602,3,198,206600.0,66.0,66.0,5,404,353004.75,103.0,80.8
22011.0,6,10,2032,5,524,5295.25,252.0,104.8,5,1508,5134.25,1236.0,301.6
29249.0,6,14,4740,7,653,4712.333333333333,249.0,93.28571428571428,7,4087,4373.0,1514.0,583.8571428571429
2333.0,17,4,344,2,150,0.0,75.0,75.0,2,194,0.0,103.0,97.0
143945.0,17,2,180,1,90,0.0,90.0,90.0,1,90,0.0,90.0,90.0
103247.0,17,2,286,2,286,0.0,143.0,143.0,0,0,0.0,0.0,0.0
9757.0,17,2,571,1,86,0.0,86.0,86.0,1,485,0.0,485.0,485.0
122530479.0,6,49,3234,25,1650,5105436.625,66.0,66.0,24,1584,5139267.826086956,66.0,66.0
2393.0,17,4,344,2,150,0.0,75.0,75.0,2,194,0.0,103.0,97.0
1304038.0,6,4,264,2,132,0.0,66.0,66.0,2,132,0.0,66.0,66.0
2808286.0,6,2,132,1,66,0.0,66.0,66.0,1,66,0.0,66.0,66.0
287.0,17,2,168,1,76,0.0,76.0,76.0,1,92,0.0,92.0,92.0
110731853.0,6,35,2542,18,1348,6500949.588235294,139.0,74.88888888888889,17,1194,6907257.625,123.0,70.23529411764706
104000991.0,17,13,821,7,432,17333498.5,174.0,61.71428571428572,6,389,16802810.8,174.0,64.83333333333333
10470058.0,6,7,478,4,272,3444601.6666666665,74.0,68.0,3,206,5166765.5,74.0,68.66666666666667
207934.0,6,3,426,2,280,0.0,214.0,140.0,1,146,0.0,146.0,146.0
204809.0,17,2,762,2,762,0.0,381.0,381.0,0,0,0.0,0.0,0.0
61297804.0,6,11,1311,6,706,12259560.8,224.0,117.66666666666669,5,605,15250080.25,251.0,121.0
321.0,17,2,174,1,79,0.0,79.0,79.0,1,95,0.0,95.0,95.0
120119982.0,6,14,2240,6,1224,24023996.4,204.0,204.0,8,1016,17098050.285714287,188.0,127.0
94000785.0,17,11,735,6,389,18800157.0,174.0,64.83333333333333,5,346,18251622.0,174.0,69.2
50594.0,6,10,2032,5,524,11574.75,252.0,104.8,5,1508,12027.75,1236.0,301.6
2805771.0,6,2,132,1,66,0.0,66.0,66.0,1,66,0.0,66.0,66.0
298246.0,6,6,412,4,272,99415.33333333331,74.0,68.0,2,140,0.0,74.0,70.0
2787181.0,6,3,204,2,136,0.0,70.0,68.0,1,68,0.0,68.0,68.0
207420.0,6,3,426,2,280,0.0,214.0,140.0,1,146,0.0,146.0,146.0
20959.0,6,10,2032,5,524,5007.0,252.0,104.8,5,1508,4649.5,1236.0,301.6
24326.0,6,10,2032,5,524,5571.0,252.0,104.8,5,1508,5834.75,1236.0,301.6
2316101.0,6,26,7677,14,2582,171828.3076923077,1034.0,184.42857142857144,12,5095,182950.7272727273,1510.0,424.5833333333333
402.0,17,2,762,2,762,0.0,381.0,381.0,0,0,0.0,0.0,0.0
232926.0,6,3,337,2,214,0.0,160.0,107.0,1,123,0.0,123.0,123.0
41779.0,6,10,2032,5,524,8641.25,252.0,104.8,5,1508,10185.75,1236.0,301.6
25286.0,6,10,2032,5,524,5531.5,252.0,104.8,5,1508,5585.5,1236.0,301.6
34155941.0,6,7,1874,3,887,17002706.5,753.0,295.6666666666667,4,987,11338322.333333334,785.0,246.75
90759183.0,6,19,1436,10,745,10079556.333333334,95.0,74.5,9,691,11344174.0,95.0,76.77777777777777
90251408.0,6,16,2368,9,1204,11281426.0,188.0,133.77777777777777,7,1164,15014708.833333334,204.0,166.28571428571428
507160.00000000006,6,3,1604,2,851,0.0,785.0,425.5,1,753,0.0,753.0,753.0
500.0,17,2,508,2,508,0.0,257.0,254.0,0,0,0.0,0.0,0.0
4711.0,17,2,180,1,90,0.0,90.0,90.0,1,90,0.0,90.0,90.0
31327.0,6,14,4740,7,653,5071.666666666667,249.0,93.28571428571428,7,4087,4977.0,1514.0,583.8571428571429
90394253.0,6,25,1692,13,906,7532854.416666667,123.0,69.6923076923077,12,786,7290283.454545454,123.0,65.5
10453802.0,6,7,478,4,272,3439084.0,74.0,68.0,3,206,5158488.5,74.0,68.66666666666667
315222.0,6,6,412,4,272,105074.0,74.0,68.0,2,140,0.0,74.0,70.0
148745071.0,6,33,3398,16,1653,7931296.466666667,425.0,103.3125,17,1745,9296379.0625,335.0,102.6470588235294
90257036.0,6,14,2240,8,1016,12893862.285714284,188.0,127.0,6,1224,18018506.2,204.0,204.0
123027205.0,6,48,3168,24,1584,4920350.217391305,66.0,66.0,24,1584,5348987.782608695,66.0,66.0
4402.0,17,2,614,1,72,0.0,72.0,72.0,1,542,0.0,542.0,542.0
249.0,17,2,700,2,700,0.0,350.0,350.0,0,0,0.0,0.0,0.0
43080.0,6,13,1386,7,789,6846.166666666667,253.0,112.71428571428572,6,597,7383.6,259.0,99.5
90301957.0,6,19,1436,10,745,10028516.666666666,95.0,74.5,9,691,11287545.5,95.0,76.77777777777777
2261.0,17,4,344,2,150,0.0,75.0,75.0,2,194,0.0,103.0,97.0
90059514.0,17,28,13364,28,13364,3335537.5555555555,501.0,477.2857142857143,0,0,0.0,0.0,0.0
120119297.0,6,12,1832,8,1016,17137091.57142857,188.0,127.0,4,816,30028115.666666668,204.0,204.0
105136570.0,17,15,5130,15,5130,7509755.0,342.0,342.0,0,0,0.0,0.0,0.0
25170.0,6,14,4740,7,653,3237.333333333333,249.0,93.28571428571428,7,4087,4058.3333333333335,1514.0,583.8571428571429
1155271.0,6,13,3020,8,2392,165038.7142857143,1514.0,299.0,5,628,220672.5,331.0,125.6
217850.0,6,3,426,2,280,0.0,214.0,140.0,1,146,0.0,146.0,146.0
54436.0,6,10,2032,5,524,13340.75,252.0,104.8,5,1508,13185.75,1236.0,301.6
2108.0,17,4,344,2,150,0.0,75.0,75.0,2,194,0.0,103.0,97.0
35436.0,6,10,2032,5,524,8631.75,252.0,104.8,5,1508,8526.5,1236.0,301.6
108097190.0,17,5,955,5,955,27024297.5,191.0,191.0,0,0,0.0,0.0,0.0
109063440.0,6,35,2542,18,1348,6402789.764705882,139.0,74.88888888888889,17,1194,6802964.0625,123.0,70.23529411764706
319.0,17,2,174,1,79,0.0,79.0,79.0,1,95,0.0,95.0,95.0
108097023.0,17,5,1005,5,1005,27024255.75,201.0,201.0,0,0,0.0,0.0,0.0
40982.0,6,14,4740,7,653,5930.666666666667,249.0,93.28571428571428,7,4087,6580.0,1514.0,583.8571428571429
118115803.0,6,47,3102,24,1584,5135459.260869565,66.0,66.0,23,1518,5144008.181818182,66.0,66.0
90263233.0,6,12,1832,8,1016,12894747.57142857,188.0,127.0,4,816,30034090.0,204.0,204.0
14965.0,17,2,180,1,90,0.0,90.0,90.0,1,90,0.0,90.0,90.0
10479224.0,6,7,478,4,272,3446094.333333333,74.0,68.0,3,206,5169042.0,74.0,68.66666666666667
100617352.0,6,27,1800,14,894,7739796.307692308,123.0,63.85714285714285,13,906,7726248.25,123.0,69.6923076923077
120262107.0,6,232,26268,116,7878,1038616.052173913,140.0,67.91379310344827,116,18390,1038717.3391304348,284.0,158.5344827586207
2400.0,17,4,344,2,150,0.0,75.0,75.0,2,194,0.0,103.0,97.0
444.0,17,2,166,1,75,0.0,75.0,75.0,1,91,0.0,91.0,91.0
2171.0,17,4,344,2,150,0.0,75.0,75.0,2,194,0.0,103.0,97.0
120208181.0,17,13,690,7,432,19904867.0,174.0,61.71428571428572,6,258,20001041.8,43.0,43.0
90036119.0,17,28,13364,28,13364,3334671.074074074,501.0,477.2857142857143,0,0,0.0,0.0,0.0
42227.0,6,10,2032,5,524,10240.75,252.0,104.8,5,1508,9937.25,1236.0,301.6
1550.0,17,2,192,1,88,0.0,88.0,88.0,1,104,0.0,104.0,104.0
90048697.0,17,28,13364,28,13364,3335136.925925926,501.0,477.2857142857143,0,0,0.0,0.0,0.0
217050.0,17,2,180,1,90,0.0,90.0,90.0,1,90,0.0,90.0,90.0
90306008.0,6,18,1382,10,786,10027280.222222222,95.0,78.6,8,596,12835306.142857144,95.0,74.5
332.0,17,2,160,1,80,0.0,80.0,80.0,1,80,0.0,80.0,80.0
9418.0,17,2,571,1,86,0.0,86.0,86.0,1,485,0.0,485.0,485.0
0.0,6,1,66,1,66,0.0,66.0,66.0,0,0,0.0,0.0,0.0
42056.0,6,14,4740,7,653,6887.5,249.0,93.28571428571428,7,4087,5679.5,1514.0,583.8571428571429
114473923.0,6,35,2526,18,1332,6733760.176470588,123.0,74.0,17,1194,7141112.3125,123.0,70.23529411764706
430.0,17,2,410,1,78,0.0,78.0,78.0,1,332,0.0,332.0,332.0
125090.0,17,4,1400,4,1400,41696.66666666666,350.0,350.0,0,0,0.0,0.0,0.0
119508123.0,6,232,26216,116,18338,1037416.8347826088,284.0,158.08620689655172,116,7878,1037417.0695652174,140.0,67.91379310344827
119001306.0,17,15,1169,8,606,17000186.57142857,174.0,75.75,7,563,17424692.0,174.0,80.42857142857143
5003807.0,17,4,849,2,166,0.0,83.0,83.0,2,683,0.0,499.0,341.5
118461083.0,6,209,23692,105,16532,1139048.875,284.0,157.44761904761904,104,7160,1141174.9805825243,140.0,68.84615384615384
1035100.0,6,11,1134,6,558,207020.00000000003,220.0,93.0,5,576,256366.5,304.0,115.2
218231.0,6,3,426,2,280,0.0,214.0,140.0,1,146,0.0,146.0,146.0
801.0,17,4,438,2,148,0.0,74.0,74.0,2,290,0.0,147.0,145.0
216729.0,6,3,426,2,280,0.0,214.0,140.0,1,146,0.0,146.0,146.0
16072.0,6,14,4740,7,653,2516.1666666666665,249.0,93.28571428571428,7,4087,2466.6666666666665,1514.0,583.8571428571429
241915.0,6,3,373,2,238,0.0,172.0,119.0,1,135,0.0,135.0,135.0
30992.0,6,14,4740,7,653,5001.666666666667,249.0,93.28571428571428,7,4087,4462.5,1514.0,583.8571428571429
103541.0,17,2,286,2,286,0.0,143.0,143.0,0,0,0.0,0.0,0.0
90280672.0,6,16,1192,8,596,12890907.57142857,95.0,74.5,8,596,12895614.285714284,95.0,74.5
4428.0,17,2,626,1,72,0.0,72.0,72.0,1,554,0.0,554.0,554.0
825.0,17,4,438,2,148,0.0,74.0,74.0,2,290,0.0,147.0,145.0
330884.0,6,2,132,1,66,0.0,66.0,66.0,1,66,0.0,66.0,66.0
35665.0,6,14,4740,7,653,5563.5,249.0,93.28571428571428,7,4087,5807.5,1514.0,583.8571428571429
63508.99999999999,6,14,4740,7,653,7595.833333333333,249.0,93.28571428571428,7,4087,8666.833333333334,1514.0,583.8571428571429
328302.0,6,6,412,4,272,109434.0,74.0,68.0,2,140,0.0,74.0,70.0
62019.0,6,14,4740,7,653,10150.833333333334,249.0,93.28571428571428,7,4087,9983.833333333334,1514.0,583.8571428571429
90059483.0,17,28,13364,28,13364,3335536.407407407,501.0,477.2857142857143,0,0,0.0,0.0,0.0
113428109.0,6,48,3168,24,1584,4931656.913043479,66.0,66.0,24,1584,4920400.391304348,66.0,66.0
146152.0,6,3,337,2,214,0.0,160.0,107.0,1,123,0.0,123.0,123.0
205247.0,17,2,762,2,762,0.0,381.0,381.0,0,0,0.0,0.0,0.0
115571957.0,6,38,2848,20,1531,6071382.631578947,139.0,76.55,18,1317,6785661.294117647,123.0,73.16666666666667
247316.0,6,3,373,2,238,0.0,172.0,119.0,1,135,0.0,135.0,135.0
989777.0,17,6,1230,3,234,494703.5,78.0,78.0,3,996,494682.0,332.0,332.0
16740.0,17,2,180,1,90,0.0,90.0,90.0,1,90,0.0,90.0,90.0
97739122.0,6,63,12680,31,6603,3257970.7333333334,1514.0,213.0,32,6077,3144647.935483871,1514.0,189.90625
364.0,17,2,166,1,75,0.0,75.0,75.0,1,91,0.0,91.0,91.0
107904.0,17,2,286,2,286,0.0,143.0,143.0,0,0,0.0,0.0,0.0
15096.0,6,10,1067,5,536,3212.75,264.0,107.2,5,531,3275.5,259.0,106.2
90209750.0,6,16,1192,8,596,12852652.57142857,95.0,74.5,8,596,12857750.0,95.0,74.5
120445131.0,6,24,1870,10,786,10159951.0,95.0,78.6,14,1084,9245391.384615384,95.0,77.42857142857143
285773.0,6,10,1221,6,636,57154.6,298.0,106.0,4,585,89851.66666666667,379.0,146.25
26108.0,6,14,4740,7,653,4218.0,249.0,93.28571428571428,7,4087,4162.666666666667,1514.0,583.8571428571429
90263399.0,6,14,2240,8,1016,12894771.285714284,188.0,127.0,6,1224,18020155.2,204.0,204.0
1303174.0,6,4,264,2,132,0.0,66.0,66.0,2,132,0.0,66.0,66.0
218013.0,6,3,426,2,280,0.0,214.0,140.0,1,146,0.0,146.0,146.0
109197188.0,17,14,864,7,432,18166839.0,174.0,61.71428571428572,7,432,18168326.0,174.0,61.71428571428572
321879.0,17,4,1400,4,1400,107293.0,350.0,350.0,0,0,0.0,0.0,0.0
144676.0,17,4,1524,4,1524,48225.333333333336,381.0,381.0,0,0,0.0,0.0,0.0
1321327.0,6,4,264,2,132,0.0,66.0,66.0,2,132,0.0,66.0,66.0
120360241.0,6,235,26594,118,18576,1028720.0085470084,284.0,157.42372881355934,117,8018,1028632.1896551724,140.0,68.52991452991454
120097057.0,6,15,2168,7,1152,20016176.166666668,204.0,164.57142857142858,8,1016,17132776.57142857,188.0,127.0
108099847.0,17,5,1005,5,1005,27024961.75,201.0,201.0,0,0,0.0,0.0,0.0
2228.0,17,4,344,2,150,0.0,75.0,75.0,2,194,0.0,103.0,97.0
523260.0,6,10,1221,6,636,104652.0,298.0,106.0,4,585,169035.66666666666,379.0,146.25
104004498.0,17,13,821,7,432,17334083.0,174.0,61.71428571428572,6,389,16800212.2,174.0,64.83333333333333
279823.0,17,2,180,1,90,0.0,90.0,90.0,1,90,0.0,90.0,90.0
205688.0,17,2,180,1,90,0.0,90.0,90.0,1,90,0.0,90.0,90.0
39922.0,6,10,2032,5,524,8841.0,252.0,104.8,5,1508,7818.25,1236.0,301.6
539056.0,17,6,2100,6,2100,107811.2,350.0,350.0,0,0,0.0,0.0,0.0
27483.0,6,14,4740,7,653,4046.0,249.0,93.28571428571428,7,4087,4437.666666666667,1514.0,583.8571428571429
304982.0,6,6,412,4,272,101660.66666666669,74.0,68.0,2,140,0.0,74.0,70.0
2052.0,17,4,344,2,150,0.0,75.0,75.0,2,194,0.0,103.0,97.0
146877.0,6,3,373,2,238,0.0,172.0,119.0,1,135,0.0,135.0,135.0
352.0,17,2,267,1,83,0.0,83.0,83.0,1,184,0.0,184.0,184.0
30231.0,6,14,4740,7,653,4928.666666666667,249.0,93.28571428571428,7,4087,4797.166666666667,1514.0,583.8571428571429
336.0,17,2,166,1,75,0.0,75.0,75.0,1,91,0.0,91.0,91.0
50134.0,6,14,4740,7,653,8024.166666666667,249.0,93.28571428571428,7,4087,6717.166666666667,1514.0,583.8571428571429
207092.0,6,3,426,2,280,0.0,214.0,140.0,1,146,0.0,146.0,146.0
102046.0,17,2,762,2,762,0.0,381.0,381.0,0,0,0.0,0.0,0.0
11291.0,17,2,582,1,83,0.0,83.0,83.0,1,499,0.0,499.0,499.0
14646844.0,6,20,1607,10,975,1592956.4444444445,315.0,97.5,10,632,1592926.2222222222,78.0,63.2
90765970.0,6,23,1734,13,989,7560302.5,95.0,76.07692307692308,10,745,10084627.888888888,95.0,74.5
201742.0,17,2,762,2,762,0.0,381.0,381.0,0,0,0.0,0.0,0.0
95360313.0,6,28,2014,15,1105,6796043.285714285,139.0,73.66666666666667,13,909,7928719.166666667,123.0,69.92307692307692
16765.0,6,11,1131,6,600,3146.8,262.0,100.0,5,531,3840.25,259.0,106.2
90075183.0,17,28,13364,28,13364,3336117.888888889,501.0,477.2857142857143,0,0,0.0,0.0,0.0
96785190.0,6,29,2068,15,1105,6897796.428571428,139.0,73.66666666666667,14,963,7428392.692307692,123.0,68.78571428571429
2358.0,17,4,344,2,150,0.0,75.0,75.0,2,194,0.0,103.0,97.0
1314750.0,6,4,264,2,132,0.0,66.0,66.0,2,132,0.0,66.0,66.0
94863062.0,6,177,19986,89,6096,1077989.3409090908,140.0,68.49438202247191,88,13890,1078456.6091954024,300.0,157.8409090909091
108104894.0,17,5,955,5,955,27026223.5,191.0,191.0,0,0,0.0,0.0,0.0
8346.0,6,10,2032,5,524,1875.75,252.0,104.8,5,1508,1788.75,1236.0,301.6
40145.0,6,14,4740,7,653,6167.666666666667,249.0,93.28571428571428,7,4087,6539.0,1514.0,583.8571428571429
1078012.0,6,13,1386,7,789,179668.66666666666,253.0,112.71428571428572,6,597,213436.0,259.0,99.5
2295.0,17,4,344,2,150,0.0,75.0,75.0,2,194,0.0,103.0,97.0
228588.0,17,2,180,1,90,0.0,90.0,90.0,1,90,0.0,90.0,90.0
211415.0,17,2,180,1,90,0.0,90.0,90.0,1,90,0.0,90.0,90.0
114056480.0,17,13,690,6,258,20000179.2,43.0,43.0,7,432,18991370.166666668,174.0,61.71428571428572
110469810.0,17,14,864,7,432,18334892.5,174.0,61.71428571428572,7,432,18333524.666666668,174.0,61.71428571428572
196843.0,17,2,180,1,90,0.0,90.0,90.0,1,90,0.0,90.0,90.0
108106407.0,17,5,955,5,955,27026601.75,191.0,191.0,0,0,0.0,0.0,0.0
30649.0,6,13,4416,6,409,5978.0,127.0,68.16666666666667,7,4007,4893.5,1514.0,572.4285714285714
255439.00000000003,6,3,337,2,214,0.0,160.0,107.0,1,123,0.0,123.0,123.0
28404.0,6,10,2032,5,524,6883.0,252.0,104.8,5,1508,6386.5,1236.0,301.6
14450.0,6,11,1131,6,600,2677.4,262.0,100.0,5,531,3247.0,259.0,106.2
135141986.0,17,6,1146,6,1146,27028397.2,191.0,191.0,0,0,0.0,0.0,0.0
2410.0,17,4,344,2,150,0.0,75.0,75.0,2,194,0.0,103.0,97.0
287290.0,17,2,180,1,90,0.0,90.0,90.0,1,90,0.0,90.0,90.0
91986588.0,17,16,5472,16,5472,6132439.2,342.0,342.0,0,0,0.0,0.0,0.0
1244177.0,6,7,499,4,301,384925.6666666667,103.0,75.25,3,198,613971.5,66.0,66.0
253812.0,6,3,337,2,214,0.0,160.0,107.0,1,123,0.0,123.0,123.0
9111.0,6,10,2032,5,524,2020.0,252.0,104.8,5,1508,2010.25,1236.0,301.6
108076639.0,17,5,1005,5,1005,27019159.75,201.0,201.0,0,0,0.0,0.0,0.0
213140.0,6,10,1221,6,636,42628.0,298.0,106.0,4,585,69770.33333333333,379.0,146.25
853944.0,6,2,132,1,66,0.0,66.0,66.0,1,66,0.0,66.0,66.0
90513658.0,6,13,2036,8,1016,12930522.57142857,188.0,127.0,5,1020,22588016.5,204.0,204.0
2192584.0,6,18,6803,10,1501,243620.44444444444,408.0,150.1,8,5302,251574.7142857143,1514.0,662.75
12290.0,6,11,1131,6,600,2024.4,262.0,100.0,5,531,2852.5,259.0,106.2
47626.0,6,14,4740,7,653,7774.833333333333,249.0,93.28571428571428,7,4087,7403.5,1514.0,583.8571428571429
307171.0,6,6,412,4,272,102390.33333333331,74.0,68.0,2,140,0.0,74.0,70.0
5646958.0,6,4,270,2,134,0.0,68.0,67.0,2,136,0.0,70.0,68.0
113520182.0,6,46,3036,23,1518,5159996.636363637,66.0,66.0,23,1518,5159994.454545454,66.0,66.0
906610.0,6,10,1336,6,799,181322.0,461.0,133.16666666666666,4,537,210342.0,331.0,134.25
108110734.0,17,5,955,5,955,27027683.5,191.0,191.0,0,0,0.0,0.0,0.0
90742556.0,6,19,1436,10,745,10077404.111111112,95.0,74.5,9,691,11340937.5,95.0,76.77777777777777
328.0,17,2,166,1,75,0.0,75.0,75.0,1,91,0.0,91.0,91.0
2056.0,17,4,344,2,150,0.0,75.0,75.0,2,194,0.0,103.0,97.0
217316.0,17,2,180,1,90,0.0,90.0,90.0,1,90,0.0,90.0,90.0
125011910.0,17,15,907,8,475,17858844.285714287,174.0,59.375,7,432,17500161.833333332,174.0,61.71428571428572
97346287.0,6,40,2640,20,1320,5123488.7894736845,66.0,66.0,20,1320,5107240.421052632,66.0,66.0
5627625.0,6,4,270,2,134,0.0,68.0,67.0,2,136,0.0,70.0,68.0
869966.0,6,9,1196,6,725,173993.2,387.0,120.83333333333331,3,471,297146.0,331.0,157.0
1033761.0,6,11,1134,6,558,206752.2,220.0,93.0,5,576,257109.5,304.0,115.2
108104351.0,17,5,1005,5,1005,27026087.75,201.0,201.0,0,0,0.0,0.0,0.0
201542.0,17,2,180,1,90,0.0,90.0,90.0,1,90,0.0,90.0,90.0
27988.0,6,14,4740,7,653,4210.5,249.0,93.28571428571428,7,4087,4113.5,1514.0,583.8571428571429
211440.0,6,3,426,2,280,0.0,214.0,140.0,1,146,0.0,146.0,146.0
302200.0,6,6,412,4,272,100733.33333333331,74.0,68.0,2,140,0.0,74.0,70.0
216348.0,17,2,180,1,90,0.0,90.0,90.0,1,90,0.0,90.0,90.0
308054.0,6,6,412,4,272,102684.66666666669,74.0,68.0,2,140,0.0,74.0,70.0
118039300.0,17,14,864,7,432,19669840.5,174.0,61.71428571428572,7,432,19666823.33333333,174.0,61.71428571428572
2019645.0,17,4,525,2,150,0.0,75.0,75.0,2,375,0.0,284.0,187.5
309036.0,6,6,412,4,272,103012.0,74.0,68.0,2,140,0.0,74.0,70.0
3991.0,17,4,704,2,148,0.0,74.0,74.0,2,556,0.0,280.0,278.0
44823.0,6,20,7606,11,978,4482.3,310.0,88.9090909090909,9,6628,5287.75,1514.0,736.4444444444445
113925063.0,17,13,821,7,432,18834355.33333333,174.0,61.71428571428572,6,389,20041331.4,174.0,64.83333333333333
20019.0,17,2,498,1,80,0.0,80.0,80.0,1,418,0.0,418.0,418.0
2936949.0,6,3,204,2,136,0.0,70.0,68.0,1,68,0.0,68.0,68.0
119793629.0,6,22,1639,11,840,11955015.4,95.0,76.36363636363636,11,799,11954900.9,95.0,72.63636363636364
208709.0,6,10,1221,6,636,41741.8,298.0,106.0,4,585,68165.66666666667,379.0,146.25
117009.0,6,12,1328,7,797,19501.5,253.0,113.85714285714286,5,531,26390.75,259.0,106.2
26676.0,6,14,4740,7,653,4304.0,249.0,93.28571428571428,7,4087,4174.5,1514.0,583.8571428571429
2806729.0,6,2,132,1,66,0.0,66.0,66.0,1,66,0.0,66.0,66.0
294253.0,17,4,1400,4,1400,98084.33333333331,350.0,350.0,0,0,0.0,0.0,0.0
109050.0,17,2,286,2,286,0.0,143.0,143.0,0,0,0.0,0.0,0.0
46541.0,6,14,4740,7,653,7630.166666666667,249.0,93.28571428571428,7,4087,6724.0,1514.0,583.8571428571429
600.0,17,2,762,2,762,0.0,381.0,381.0,0,0,0.0,0.0,0.0
2311.0,17,4,344,2,150,0.0,75.0,75.0,2,194,0.0,103.0,97.0
38259.0,6,14,4740,7,653,5593.166666666667,249.0,93.28571428571428,7,4087,5747.666666666667,1514.0,583.8571428571429
14738820.0,6,20,1689,10,1057,1604088.3333333333,315.0,105.7,10,632,1604085.888888889,78.0,63.2
23498.0,6,11,2098,6,590,4350.4,252.0,98.33333333333331,5,1508,4818.25,1236.0,301.6
159116.0,6,2,128,1,74,0.0,74.0,74.0,1,54,0.0,54.0,54.0
1305638.0,6,4,264,2,132,0.0,66.0,66.0,2,132,0.0,66.0,66.0
153443.0,17,2,180,1,90,0.0,90.0,90.0,1,90,0.0,90.0,90.0
232138.0,6,3,337,2,214,0.0,160.0,107.0,1,123,0.0,123.0,123.0
5823017.0,6,5,336,2,134,0.0,68.0,67.0,3,202,1517864.0,70.0,67.33333333333333
90762068.0,6,19,1436,10,745,10079820.111111112,95.0,74.5,9,691,11344214.0,95.0,76.77777777777777
3775.0,17,4,344,2,150,0.0,75.0,75.0,2,194,0.0,103.0,97.0
206103.0,6,3,426,2,280,0.0,214.0,140.0,1,146,0.0,146.0,146.0
121622949.0,6,48,3168,23,1518,5160698.0,66.0,66.0,25,1650,5067612.458333333,66.0,66.0
953541.0,6,12,1354,6,723,190200.0,253.0,120.5,6,631,189147.8,293.0,105.16666666666669
139883.0,17,4,1524,4,1524,46627.66666666666,381.0,381.0,0,0,0.0,0.0,0.0
112535475.0,6,46,3036,23,1518,5105437.181818182,66.0,66.0,23,1518,5105437.045454546,66.0,66.0
872777.0,6,10,1336,6,799,174555.4,461.0,133.16666666666666,4,537,200044.66666666663,331.0,134.25
132567.0,6,2,132,1,66,0.0,66.0,66.0,1,66,0.0,66.0,66.0
298407.0,6,7,478,4,272,99469.0,74.0,68.0,3,206,74154.0,74.0,68.66666666666667
103023.0,17,2,286,2,286,0.0,143.0,143.0,0,0,0.0,0.0,0.0
108101677.0,17,5,1005,5,1005,27025419.25,201.0,201.0,0,0,0.0,0.0,0.0
2035.0,17,4,344,2,150,0.0,75.0,75.0,2,194,0.0,103.0,97.0
1700918.0,6,23,6509,12,1529,154628.9090909091,357.0,127.41666666666669,11,4980,139608.5,1510.0,452.7272727272728
209521.0,17,2,180,1,90,0.0,90.0,90.0,1,90,0.0,90.0,90.0
104202.0,17,2,700,2,700,0.0,350.0,350.0,0,0,0.0,0.0,0.0
204250.0,17,2,762,2,762,0.0,381.0,381.0,0,0,0.0,0.0,0.0
16471.0,6,10,2032,5,524,3549.25,252.0,104.8,5,1508,3553.0,1236.0,301.6
19311.0,6,14,4740,7,653,2985.6666666666665,249.0,93.28571428571428,7,4087,3082.0,1514.0,583.8571428571429
1732472.0,6,22,6443,12,1529,157497.45454545456,357.0,127.41666666666669,10,4914,157736.77777777778,1510.0,491.4
33770.0,6,14,4740,7,653,5456.666666666667,249.0,93.28571428571428,7,4087,5165.333333333333,1514.0,583.8571428571429
119758530.0,17,14,864,7,432,19959755.0,174.0,61.71428571428572,7,432,19932520.166666668,174.0,61.71428571428572
108110579.0,17,5,1005,5,1005,27027644.75,201.0,201.0,0,0,0.0,0.0,0.0
107380.0,17,2,286,2,286,0.0,143.0,143.0,0,0,0.0,0.0,0.0
101755.0,17,2,286,2,286,0.0,143.0,143.0,0,0,0.0,0.0,0.0
43252.0,6,10,2032,5,524,10599.0,252.0,104.8,5,1508,10406.25,1236.0,301.6
43829.0,6,14,4740,7,653,7185.833333333333,249.0,93.28571428571428,7,4087,6580.166666666667,1514.0,583.8571428571429
120045619.0,17,29,13785,29,13785,4287343.535714285,501.0,475.3448275862069,0,0,0.0,0.0,0.0
121024.0,6,3,373,2,238,0.0,172.0,119.0,1,135,0.0,135.0,135.0
104012.0,17,2,700,2,700,0.0,350.0,350.0,0,0,0.0,0.0,0.0
120003311.0,6,19,1436,9,691,15000413.875,95.0,76.77777777777777,10,745,13306869.111111112,95.0,74.5
62901.0,6,14,4740,7,653,9882.833333333334,249.0,93.28571428571428,7,4087,10130.0,1514.0,583.8571428571429
238048.0,6,3,337,2,214,0.0,160.0,107.0,1,123,0.0,123.0,123.0
307.0,17,2,166,1,75,0.0,75.0,75.0,1,91,0.0,91.0,91.0
29163.0,6,10,2032,5,524,6328.25,252.0,104.8,5,1508,6610.75,1236.0,301.6
269027.0,6,10,1221,6,636,53805.4,298.0,106.0,4,585,83976.0,379.0,146.25
114828166.0,6,47,3102,24,1584,4978866.043478261,66.0,66.0,23,1518,5155446.727272728,66.0,66.0
9210.0,17,2,598,1,72,0.0,72.0,72.0,1,526,0.0,526.0,526.0
76055.0,6,10,2032,5,524,12824.0,252.0,104.8,5,1508,18731.75,1236.0,301.6
104808.0,6,11,2098,6,590,19738.2,252.0,98.33333333333331,5,1508,22773.25,1236.0,301.6
317945.0,17,4,1400,4,1400,105981.66666666669,350.0,350.0,0,0,0.0,0.0,0.0
25500.0,6,10,2032,5,524,6152.25,252.0,104.8,5,1508,5983.5,1236.0,301.6
100679.0,17,2,762,2,762,0.0,381.0,381.0,0,0,0.0,0.0,0.0
117567187.0,17,15,1169,8,606,16772604.0,174.0,75.75,7,563,18327956.666666668,174.0,80.42857142857143
146248.0,6,3,337,2,214,0.0,160.0,107.0,1,123,0.0,123.0,123.0
42062.0,6,10,2032,5,524,9176.75,252.0,104.8,5,1508,8262.25,1236.0,301.6
149039.0,17,2,493,1,88,0.0,88.0,88.0,1,405,0.0,405.0,405.0
215449.0,17,2,180,1,90,0.0,90.0,90.0,1,90,0.0,90.0,90.0
153403.0,17,2,180,1,90,0.0,90.0,90.0,1,90,0.0,90.0,90.0
610091.0,17,4,629,3,234,161616.0,78.0,78.0,1,395,0.0,395.0,395.0
27057.0,6,11,2098,6,590,5282.4,252.0,98.33333333333331,5,1508,5964.25,1236.0,301.6
2035.0,17,4,344,2,150,0.0,75.0,75.0,2,194,0.0,103.0,97.0
107807.0,17,2,286,2,286,0.0,143.0,143.0,0,0,0.0,0.0,0.0
25882.0,6,14,4740,7,653,3786.5,249.0,93.28571428571428,7,4087,4171.166666666667,1514.0,583.8571428571429
120007534.0,6,21,1585,11,840,11999969.3,95.0,76.36363636363636,10,745,13333540.666666666,95.0,74.5
54184.0,6,14,4740,7,653,8761.166666666666,249.0,93.28571428571428,7,4087,8889.166666666666,1514.0,583.8571428571429
197028.0,17,2,180,1,90,0.0,90.0,90.0,1,90,0.0,90.0,90.0
14878.0,6,20,7606,11,978,1487.8,310.0,88.9090909090909,9,6628,1597.5,1514.0,736.4444444444445
0.0,17,1,350,1,350,0.0,350.0,350.0,0,0,0.0,0.0,0.0
52978.0,6,14,4740,7,653,2930.333333333333,249.0,93.28571428571428,7,4087,8694.5,1514.0,583.8571428571429
288150.0,17,4,704,2,148,0.0,74.0,74.0,2,556,0.0,280.0,278.0
108107253.0,17,5,1005,5,1005,27026813.25,201.0,201.0,0,0,0.0,0.0,0.0
0.0,17,1,72,1,72,0.0,72.0,72.0,0,0,0.0,0.0,0.0
421.0,17,2,410,1,78,0.0,78.0,78.0,1,332,0.0,332.0,332.0
27099701.0,17,5,1710,5,1710,6774925.25,342.0,342.0,0,0,0.0,0.0,0.0
94702392.0,6,29,2068,15,1105,6764456.571428572,139.0,73.66666666666667,14,963,7269040.538461538,123.0,68.78571428571429
228334.0,17,2,180,1,90,0.0,90.0,90.0,1,90,0.0,90.0,90.0
3010469.0,6,12,2172,7,664,501640.5,252.0,94.85714285714286,5,1508,3012.25,1236.0,301.6
44742.0,6,14,4740,7,653,5564.333333333333,249.0,93.28571428571428,7,4087,7264.833333333333,1514.0,583.8571428571429
54833.0,6,14,4740,7,653,8793.0,249.0,93.28571428571428,7,4087,8282.5,1514.0,583.8571428571429
10494667.0,6,6,412,3,206,5177196.0,74.0,68.66666666666667,3,206,5177087.0,74.0,68.66666666666667
120016703.0,17,28,13364,28,13364,4445063.074074074,501.0,477.2857142857143,0,0,0.0,0.0,0.0
128005979.0,17,15,907,8,475,18286568.42857143,174.0,59.375,7,432,18000170.333333332,174.0,61.71428571428572
1186649.0,6,14,3066,8,2372,169521.2857142857,1514.0,296.5,6,694,182211.0,331.0,115.66666666666669
324.0,17,2,208,1,72,0.0,72.0,72.0,1,136,0.0,136.0,136.0
188703.0,17,2,180,1,90,0.0,90.0,90.0,1,90,0.0,90.0,90.0
2380.0,17,4,344,2,150,0.0,75.0,75.0,2,194,0.0,103.0,97.0
59419.0,6,10,2032,5,524,13826.0,252.0,104.8,5,1508,14176.0,1236.0,301.6
135135033.0,17,6,1146,6,1146,27027006.6,191.0,191.0,0,0,0.0,0.0,0.0
108110721.0,17,5,1005,5,1005,27027680.25,201.0,201.0,0,0,0.0,0.0,0.0
2025950.0,6,2,132,1,66,0.0,66.0,66.0,1,66,0.0,66.0,66.0
1789972.0,6,23,6509,12,1529,162724.72727272726,357.0,127.41666666666669,11,4980,147121.5,1510.0,452.7272727272728
153482.0,17,2,180,1,90,0.0,90.0,90.0,1,90,0.0,90.0,90.0
75395.0,6,14,4740,7,653,11872.833333333334,249.0,93.28571428571428,7,4087,11369.0,1514.0,583.8571428571429
2588048.0,6,2,132,1,66,0.0,66.0,66.0,1,66,0.0,66.0,66.0
41530.0,6,10,2032,5,524,7540.5,252.0,104.8,5,1508,9922.0,1236.0,301.6
135139328.0,17,6,1206,6,1206,27027865.6,201.0,201.0,0,0,0.0,0.0,0.0
210107.0,17,2,180,1,90,0.0,90.0,90.0,1,90,0.0,90.0,90.0
99620.0,6,11,2098,6,590,18394.4,252.0,98.33333333333331,5,1508,23458.0,1236.0,301.6
31571.000000000004,6,10,2032,5,524,6648.5,252.0,104.8,5,1508,7551.5,1236.0,301.6
103118.0,17,2,286,2,286,0.0,143.0,143.0,0,0,0.0,0.0,0.0
144026.0,17,2,180,1,90,0.0,90.0,90.0,1,90,0.0,90.0,90.0
107076.0,17,2,286,2,286,0.0,143.0,143.0,0,0,0.0,0.0,0.0
306135.0,6,6,412,4,272,102045.0,74.0,68.0,2,140,0.0,74.0,70.0
108105268.0,17,5,1005,5,1005,27026317.0,201.0,201.0,0,0,0.0,0.0,0.0
127006771.0,17,15,907,8,475,18143824.42857143,174.0,59.375,7,432,17833500.5,174.0,61.71428571428572
36683.0,6,14,4740,7,653,4704.5,249.0,93.28571428571428,7,4087,4568.5,1514.0,583.8571428571429
285.0,17,2,174,1,79,0.0,79.0,79.0,1,95,0.0,95.0,95.0
228600.0,17,2,180,1,90,0.0,90.0,90.0,1,90,0.0,90.0,90.0
896507.0,6,12,1362,6,731,178071.4,253.0,121.83333333333331,6,631,178549.0,293.0,105.16666666666669
361.0,17,2,248,1,84,0.0,84.0,84.0,1,164,0.0,164.0,164.0
228219.0,17,2,180,1,90,0.0,90.0,90.0,1,90,0.0,90.0,90.0
13616099.0,6,20,1607,10,975,1478473.3333333333,315.0,97.5,10,632,1478438.888888889,78.0,63.2
306115.0,17,4,1400,4,1400,102038.33333333331,350.0,350.0,0,0,0.0,0.0,0.0
90257774.0,6,12,1832,8,1016,12893967.714285716,188.0,127.0,4,816,30030103.0,204.0,204.0
7356.0,17,4,823,2,163,0.0,89.0,81.5,2,660,0.0,443.0,330.0
108312446.0,6,214,24074,107,16716,1019764.3301886792,284.0,156.22429906542055,107,7358,1019706.0283018867,140.0,68.76635514018692
10508175.0,6,7,478,4,272,3457291.6666666665,74.0,68.0,3,206,5185819.5,74.0,68.66666666666667
108105932.0,17,5,955,5,955,27026483.0,191.0,191.0,0,0,0.0,0.0,0.0
103741.0,17,2,286,2,286,0.0,143.0,143.0,0,0,0.0,0.0,0.0
90009800.0,6,18,1341,10,745,10001088.888888888,95.0,74.5,8,596,12789185.0,95.0,74.5
9774.0,17,2,571,1,86,0.0,86.0,86.0,1,485,0.0,485.0,485.0
303179.0,6,2,132,1,66,0.0,66.0,66.0,1,66,0.0,66.0,66.0
2050689.0,17,8,1640,4,312,683434.9999999999,78.0,78.0,4,1328,683426.3333333334,332.0,332.0
31831.0,6,14,4740,7,653,4981.0,249.0,93.28571428571428,7,4087,5169.833333333333,1514.0,583.8571428571429
332.0,17,2,166,1,75,0.0,75.0,75.0,1,91,0.0,91.0,91.0
23449311.0,17,5,1718,4,1368,885571.3333333334,342.0,342.0,1,350,0.0,350.0,350.0
15061013.0,17,6,2718,6,2718,3012202.6,453.0,453.0,0,0,0.0,0.0,0.0
395.0,17,2,508,2,508,0.0,257.0,254.0,0,0,0.0,0.0,0.0
30934.0,6,10,2032,5,524,6691.5,252.0,104.8,5,1508,7299.75,1236.0,301.6
2374.0,17,4,344,2,150,0.0,75.0,75.0,2,194,0.0,103.0,97.0
409307.0,6,4,508,2,238,0.0,172.0,119.0,2,270,0.0,135.0,135.0
311932.0,17,4,1400,4,1400,103977.33333333331,350.0,350.0,0,0,0.0,0.0,0.0
40857.0,6,10,2032,5,524,9851.25,252.0,104.8,5,1508,9867.5,1236.0,301.6
90776741.0,6,20,1531,11,840,9073287.9,95.0,76.36363636363636,9,691,11346045.625,95.0,76.77777777777777
5831785.0,6,5,336,2,134,0.0,68.0,67.0,3,202,1525876.0,70.0,67.33333333333333
2418.0,17,4,344,2,150,0.0,75.0,75.0,2,194,0.0,103.0,97.0
110597.0,17,2,286,2,286,0.0,143.0,143.0,0,0,0.0,0.0,0.0
153369.0,17,2,180,1,90,0.0,90.0,90.0,1,90,0.0,90.0,90.0
6612.0,17,2,582,1,83,0.0,83.0,83.0,1,499,0.0,499.0,499.0
196896.0,17,2,180,1,90,0.0,90.0,90.0,1,90,0.0,90.0,90.0
46251.0,6,14,4740,7,653,7237.0,249.0,93.28571428571428,7,4087,7571.0,1514.0,583.8571428571429
120039528.0,17,28,13364,28,13364,4445908.444444444,501.0,477.2857142857143,0,0,0.0,0.0,0.0
31511.0,6,10,2032,5,524,7654.25,252.0,104.8,5,1508,7598.25,1236.0,301.6
381101.0,17,2,363,1,75,0.0,75.0,75.0,1,288,0.0,288.0,288.0
119480630.0,6,271,31632,136,22426,885041.7037037037,284.0,164.89705882352942,135,9206,883848.7611940298,140.0,68.19259259259259
147076.0,6,3,373,2,238,0.0,172.0,119.0,1,135,0.0,135.0,135.0
135133872.0,17,6,1146,6,1146,27026774.4,191.0,191.0,0,0,0.0,0.0,0.0
13616.0,6,14,4740,7,653,2108.6666666666665,249.0,93.28571428571428,7,4087,2129.333333333333,1514.0,583.8571428571429
125129.0,6,2,132,1,66,0.0,66.0,66.0,1,66,0.0,66.0,66.0
106001064.0,17,13,821,7,432,17666844.0,174.0,61.71428571428572,6,389,20056587.6,174.0,64.83333333333333
119700780.0,17,13,690,7,432,19939962.166666668,174.0,61.71428571428572,6,258,20002777.0,43.0,43.0
121928.0,6,3,373,2,238,0.0,172.0,119.0,1,135,0.0,135.0,135.0
10461619.0,6,6,412,3,206,5160387.0,74.0,68.66666666666667,3,206,5160281.0,74.0,68.66666666666667
111222740.0,6,213,24062,107,7284,1049271.1320754718,140.0,68.07476635514018,106,16778,1055216.419047619,284.0,158.28301886792454
204762.0,17,2,762,2,762,0.0,381.0,381.0,0,0,0.0,0.0,0.0
18912.0,6,14,4740,7,653,3002.5,249.0,93.28571428571428,7,4087,3013.6666666666665,1514.0,583.8571428571429
477554.0,6,2,132,1,66,0.0,66.0,66.0,1,66,0.0,66.0,66.0
102953052.0,6,185,20810,93,6434,1119054.9130434785,140.0,69.18279569892474,92,14376,1123777.2637362638,284.0,156.2608695652174
44588.0,6,14,4740,7,653,7277.666666666667,249.0,93.28571428571428,7,4087,7195.666666666667,1514.0,583.8571428571429
2261716.0,6,7,499,4,301,701992.0,103.0,75.25,3,198,921057.0,66.0,66.0
47092.0,6,14,4740,7,653,7413.333333333333,249.0,93.28571428571428,7,4087,7260.833333333333,1514.0,583.8571428571429
297644.0,6,6,412,4,272,99214.66666666669,74.0,68.0,2,140,0.0,74.0,70.0
119434295.0,6,213,24062,107,7284,1126738.6320754718,140.0,68.07476635514018,106,16778,1127539.5142857144,284.0,158.28301886792454
206641.0,6,3,426,2,280,0.0,214.0,140.0,1,146,0.0,146.0,146.0
21140.0,6,10,2032,5,524,5051.0,252.0,104.8,5,1508,4306.25,1236.0,301.6
128669810.0,6,36,2580,18,1248,6981464.823529412,123.0,69.33333333333333,18,1332,6981453.94117647,123.0,74.0
118350839.0,6,231,26044,116,7952,1029137.7304347826,140.0,68.55172413793103,115,18092,1029052.5350877192,284.0,157.3217391304348
112197.0,17,2,286,2,286,0.0,143.0,143.0,0,0,0.0,0.0,0.0
408046.0,6,4,508,2,238,0.0,172.0,119.0,2,270,0.0,135.0,135.0
873831.0,6,9,1268,6,797,174766.2,459.0,132.83333333333334,3,471,298954.0,331.0,157.0
90307282.0,6,16,1192,8,596,12893978.57142857,95.0,74.5,8,596,12899385.714285716,95.0,74.5
121403.0,6,3,337,2,214,0.0,160.0,107.0,1,123,0.0,123.0,123.0
822.0,17,4,438,2,148,0.0,74.0,74.0,2,290,0.0,147.0,145.0
44619.0,6,12,1328,6,731,7951.8,253.0,121.83333333333331,6,597,8335.8,259.0,99.5
405983.0,6,4,508,2,238,0.0,172.0,119.0,2,270,0.0,135.0,135.0
3168823.0,6,18,1495,9,921,358379.5,315.0,102.33333333333331,9,574,358354.0,78.0,63.77777777777778
882930.0,6,12,2709,7,742,147155.0,338.0,106.0,5,1967,151820.0,1514.0,393.4
2183.0,17,2,180,1,90,0.0,90.0,90.0,1,90,0.0,90.0,90.0
80037.0,17,2,286,2,286,0.0,143.0,143.0,0,0,0.0,0.0,0.0
14070.0,6,11,1131,6,600,2099.2,262.0,100.0,5,531,3302.5,259.0,106.2
157262.0,6,3,337,2,214,0.0,160.0,107.0,1,123,0.0,123.0,123.0
107113.0,17,2,286,2,286,0.0,143.0,143.0,0,0,0.0,0.0,0.0
135139686.0,17,6,1206,6,1206,27027937.2,201.0,201.0,0,0,0.0,0.0,0.0
108045.0,17,2,700,2,700,0.0,350.0,350.0,0,0,0.0,0.0,0.0
120205040.0,6,19,1436,9,691,14999939.875,95.0,76.77777777777777,10,745,13333284.444444444,95.0,74.5
137981.0,6,2,132,1,66,0.0,66.0,66.0,1,66,0.0,66.0,66.0
2845764.0,6,4,270,3,202,1422882.0,70.0,67.33333333333333,1,68,0.0,68.0,68.0
103019399.0,6,341,41160,171,29718,605996.4647058824,390.0,173.78947368421052,170,11442,608211.8461538461,140.0,67.30588235294118
1171269.0,6,13,3013,8,2385,167324.14285714287,1514.0,298.125,5,628,223558.25,331.0,125.6
10248.0,17,2,684,2,684,0.0,342.0,342.0,0,0,0.0,0.0,0.0
2357.0,17,4,344,2,150,0.0,75.0,75.0,2,194,0.0,103.0,97.0
120059140.0,17,29,13785,29,13785,4287826.428571428,501.0,475.3448275862069,0,0,0.0,0.0,0.0
2046414.0,17,8,1640,4,312,682008.9999999999,78.0,78.0,4,1328,681970.6666666667,332.0,332.0
120054795.0,17,29,13785,29,13785,4287671.25,501.0,475.3448275862069,0,0,0.0,0.0,0.0
245889.0,6,3,337,2,214,0.0,160.0,107.0,1,123,0.0,123.0,123.0
245664.0,6,3,337,2,214,0.0,160.0,107.0,1,123,0.0,123.0,123.0
0.0,17,1,55,1,55,0.0,55.0,55.0,0,0,0.0,0.0,0.0
341112.0,17,2,180,1,90,0.0,90.0,90.0,1,90,0.0,90.0,90.0
307874.0,6,6,412,4,272,102624.66666666669,74.0,68.0,2,140,0.0,74.0,70.0
2622086.0,6,3,1777,1,826,0.0,826.0,826.0,2,951,0.0,885.0,475.5
68879.0,6,14,4740,7,653,11072.666666666666,249.0,93.28571428571428,7,4087,7984.166666666667,1514.0,583.8571428571429
24643814.0,17,4,1376,3,1026,1397445.5,342.0,342.0,1,350,0.0,350.0,350.0
34682.0,6,14,4740,7,653,5541.333333333333,249.0,93.28571428571428,7,4087,5643.0,1514.0,583.8571428571429
301217.0,6,6,412,4,272,100405.66666666669,74.0,68.0,2,140,0.0,74.0,70.0
223770.0,6,3,426,2,280,0.0,214.0,140.0,1,146,0.0,146.0,146.0
301983.0,6,6,412,4,272,100661.0,74.0,68.0,2,140,0.0,74.0,70.0
90216289.0,6,19,1436,9,691,11245889.875,95.0,76.77777777777777,10,745,9999983.333333334,95.0,74.5
309777.0,6,6,412,4,272,103259.0,74.0,68.0,2,140,0.0,74.0,70.0
205466.0,17,2,762,2,762,0.0,381.0,381.0,0,0,0.0,0.0,0.0
120122021.0,6,14,2224,9,1204,15015252.625,188.0,133.77777777777777,5,1020,22523319.25,204.0,204.0
3464839.0,6,5,336,2,134,0.0,68.0,67.0,3,202,1524715.5,70.0,67.33333333333333
107054661.0,17,14,864,7,432,17833508.0,174.0,61.71428571428572,7,432,17833329.166666668,174.0,61.71428571428572
113520063.0,6,46,3036,23,1518,5159991.727272728,66.0,66.0,23,1518,5159991.636363637,66.0,66.0
27787.0,6,14,4740,7,653,4475.833333333333,249.0,93.28571428571428,7,4087,3948.0,1514.0,583.8571428571429
153455.0,17,2,180,1,90,0.0,90.0,90.0,1,90,0.0,90.0,90.0
113119051.0,17,14,1126,7,563,18826551.33333333,174.0,80.42857142857143,7,563,18826550.666666668,174.0,80.42857142857143
90055050.0,17,28,13364,28,13364,3335372.222222222,501.0,477.2857142857143,0,0,0.0,0.0,0.0
2359.0,17,4,344,2,150,0.0,75.0,75.0,2,194,0.0,103.0,97.0
305513.0,17,2,180,1,90,0.0,90.0,90.0,1,90,0.0,90.0,90.0
135138033.0,17,6,1206,6,1206,27027606.6,201.0,201.0,0,0,0.0,0.0,0.0
0.0,17,1,90,1,90,0.0,90.0,90.0,0,0,0.0,0.0,0.0
102996.0,17,2,286,2,286,0.0,143.0,143.0,0,0,0.0,0.0,0.0
216472.0,17,2,180,1,90,0.0,90.0,90.0,1,90,0.0,90.0,90.0
5637146.0,6,5,336,2,134,0.0,68.0,67.0,3,202,1430195.5,70.0,67.33333333333333
0.0,17,1,80,1,80,0.0,80.0,80.0,0,0,0.0,0.0,0.0
470456.0,6,3,1604,2,851,0.0,785.0,425.5,1,753,0.0,753.0,753.0
135217.0,6,2,132,1,66,0.0,66.0,66.0,1,66,0.0,66.0,66.0
108264941.0,6,27,1800,14,894,8328072.384615385,123.0,63.85714285714285,13,906,8172107.0,123.0,69.6923076923077
121233.0,6,3,337,2,214,0.0,160.0,107.0,1,123,0.0,123.0,123.0
304165.0,6,6,412,4,272,101388.33333333331,74.0,68.0,2,140,0.0,74.0,70.0
90049425.0,17,28,13364,28,13364,3335163.888888889,501.0,477.2857142857143,0,0,0.0,0.0,0.0
120120634.0,6,15,2152,9,1204,15015079.25,188.0,133.77777777777777,6,948,18010884.0,204.0,158.0
145444.0,6,3,337,2,214,0.0,160.0,107.0,1,123,0.0,123.0,123.0
98078219.0,17,12,778,6,389,19600157.8,174.0,64.83333333333333,6,389,19601677.6,174.0,64.83333333333333
241350.0,6,3,337,2,214,0.0,160.0,107.0,1,123,0.0,123.0,123.0
143855.0,17,2,180,1,90,0.0,90.0,90.0,1,90,0.0,90.0,90.0
109359024.0,17,13,821,7,432,18199874.166666668,174.0,61.71428571428572,6,389,17976768.0,174.0,64.83333333333333
61687339.0,17,9,3086,8,2736,5217439.428571428,342.0,342.0,1,350,0.0,350.0,350.0
20141.0,6,14,4740,7,653,3233.1666666666665,249.0,93.28571428571428,7,4087,3084.5,1514.0,583.8571428571429
234251.0,6,3,337,2,214,0.0,160.0,107.0,1,123,0.0,123.0,123.0
59359.0,6,14,4740,7,653,9494.833333333334,249.0,93.28571428571428,7,4087,6959.666666666667,1514.0,583.8571428571429
120289323.0,6,222,25118,111,7560,1086102.2,140.0,68.10810810810811,111,17558,1067268.2636363637,284.0,158.18018018018017
108103060.0,17,5,955,5,955,27025765.0,191.0,191.0,0,0,0.0,0.0,0.0
144743.0,17,2,180,1,70,0.0,70.0,70.0,1,110,0.0,110.0,110.0
217084.0,6,3,426,2,280,0.0,214.0,140.0,1,146,0.0,146.0,146.0
19622.0,6,10,2032,5,524,4344.0,252.0,104.8,5,1508,4542.5,1236.0,301.6
108107515.0,17,5,955,5,955,27026878.75,191.0,191.0,0,0,0.0,0.0,0.0
26820.0,6,14,4740,7,653,4340.666666666667,249.0,93.28571428571428,7,4087,4331.0,1514.0,583.8571428571429
199479.0,17,4,6056,4,6056,66493.0,1514.0,1514.0,0,0,0.0,0.0,0.0
102688346.0,6,18,1504,9,854,12834426.125,258.0,94.88888888888889,9,650,12835514.25,95.0,72.22222222222223
29020.0,6,10,2032,5,524,6427.25,252.0,104.8,5,1508,6620.5,1236.0,301.6
884.0,17,4,438,2,148,0.0,74.0,74.0,2,290,0.0,147.0,145.0
18790.0,6,11,2098,6,590,3378.6,252.0,98.33333333333331,5,1508,3902.0,1236.0,301.6
220579.0,6,14,4740,7,653,35805.333333333336,249.0,93.28571428571428,7,4087,35610.333333333336,1514.0,583.8571428571429
22172.0,6,19,7540,11,978,2217.2,310.0,88.9090909090909,8,6562,2885.714285714286,1514.0,820.25
0.0,6,1,66,1,66,0.0,66.0,66.0,0,0,0.0,0.0,0.0
120193147.0,6,1067,245646,546,210520,220141.42935779816,1514.0,385.5677655677656,521,35126,231046.97692307693,214.0,67.42034548944338
5598173.0,6,5,336,2,134,0.0,68.0,67.0,3,202,1523851.0,70.0,67.33333333333333
107023436.0,6,30,2106,15,1089,7629115.571428572,123.0,72.6,15,1017,7629112.285714285,123.0,67.8
107413.0,17,2,286,2,286,0.0,143.0,143.0,0,0,0.0,0.0,0.0
301749.0,6,6,412,4,272,100583.0,74.0,68.0,2,140,0.0,74.0,70.0
114717184.0,6,687,135596,342,23090,336414.0293255132,214.0,67.51461988304094,345,112506,332815.00872093026,1514.0,326.1043478260869
33033.0,6,14,4740,7,653,5383.0,249.0,93.28571428571428,7,4087,5184.666666666667,1514.0,583.8571428571429
90255105.0,6,12,1832,8,1016,12893586.42857143,188.0,127.0,4,816,30030143.0,204.0,204.0
228302.0,17,2,180,1,90,0.0,90.0,90.0,1,90,0.0,90.0,90.0
293979.0,17,2,246,1,76,0.0,76.0,76.0,1,170,0.0,170.0,170.0
153500.0,17,2,180,1,90,0.0,90.0,90.0,1,90,0.0,90.0,90.0
122314659.0,6,48,3168,24,1584,4970673.913043479,66.0,66.0,24,1584,5237085.260869565,66.0,66.0
110355920.0,6,32,2236,16,1165,7357061.333333333,139.0,72.8125,16,1071,7342648.666666667,123.0,66.9375
7397.0,17,2,582,1,83,0.0,83.0,83.0,1,499,0.0,499.0,499.0
120124746.0,6,13,2020,9,1204,15015593.25,188.0,133.77777777777777,4,816,30034652.0,204.0,204.0
2804432.0,6,2,132,1,66,0.0,66.0,66.0,1,66,0.0,66.0,66.0
40953.0,6,12,1320,6,723,7554.8,253.0,120.5,6,597,6945.6,259.0,99.5
88611.0,17,4,820,2,156,0.0,78.0,78.0,2,664,0.0,332.0,332.0
124753026.0,6,33,2280,17,1209,7797064.125,123.0,71.11764705882354,16,1071,7636716.466666667,123.0,66.9375
4331.0,17,2,598,1,72,0.0,72.0,72.0,1,526,0.0,526.0,526.0
158271.0,6,3,337,2,214,0.0,160.0,107.0,1,123,0.0,123.0,123.0
153491.0,17,2,180,1,90,0.0,90.0,90.0,1,90,0.0,90.0,90.0
439041.0,6,11,1021,6,444,59086.4,162.0,74.0,5,577,73668.25,349.0,115.4
770679.0,6,10,1065,5,534,192412.25,262.0,106.8,5,531,192224.0,259.0,106.2
108104981.0,17,5,955,5,955,27026245.25,191.0,191.0,0,0,0.0,0.0,0.0
25585.0,6,14,4740,7,653,3483.1666666666665,249.0,93.28571428571428,7,4087,4034.8333333333335,1514.0,583.8571428571429
108109990.0,17,5,1005,5,1005,27027497.5,201.0,201.0,0,0,0.0,0.0,0.0
299128.0,6,6,412,4,272,99709.33333333331,74.0,68.0,2,140,0.0,74.0,70.0
209579.0,17,2,414,1,88,0.0,88.0,88.0,1,326,0.0,326.0,326.0
99370359.0,6,40,2640,20,1320,5230018.894736842,66.0,66.0,20,1320,5213773.684210527,66.0,66.0
1545143.0,17,2,876,2,876,0.0,438.0,438.0,0,0,0.0,0.0,0.0
39432.0,6,10,2032,5,524,9629.0,252.0,104.8,5,1508,9117.75,1236.0,301.6
37078.0,6,14,4740,7,653,6056.166666666667,249.0,93.28571428571428,7,4087,5823.166666666667,1514.0,583.8571428571429
121306.0,6,3,337,2,214,0.0,160.0,107.0,1,123,0.0,123.0,123.0
9646.0,17,2,582,1,83,0.0,83.0,83.0,1,499,0.0,499.0,499.0
120083961.0,17,29,13785,29,13785,4288712.892857143,501.0,475.3448275862069,0,0,0.0,0.0,0.0
153465.0,17,2,180,1,90,0.0,90.0,90.0,1,90,0.0,90.0,90.0
108095976.0,17,5,955,5,955,27023994.0,191.0,191.0,0,0,0.0,0.0,0.0
120067651.0,17,29,13785,29,13785,4288130.392857143,501.0,475.3448275862069,0,0,0.0,0.0,0.0
246265.0,6,3,337,2,214,0.0,160.0,107.0,1,123,0.0,123.0,123.0
0.0,17,1,44,1,44,0.0,44.0,44.0,0,0,0.0,0.0,0.0
91750794.0,17,12,778,6,389,18318376.0,174.0,64.83333333333333,6,389,18218860.0,174.0,64.83333333333333
297843.0,6,6,412,4,272,99281.0,74.0,68.0,2,140,0.0,74.0,70.0
1052419.0,6,12,2710,7,743,175403.16666666666,339.0,106.14285714285714,5,1967,194902.75,1514.0,393.4
4572.0,17,2,614,1,72,0.0,72.0,72.0,1,542,0.0,542.0,542.0
10502890.0,6,7,478,4,272,3454483.0,74.0,68.0,3,206,5181669.0,74.0,68.66666666666667
0.0,6,1,54,1,54,0.0,54.0,54.0,0,0,0.0,0.0,0.0
1306931.0,6,4,264,2,132,0.0,66.0,66.0,2,132,0.0,66.0,66.0
55676.0,6,10,2032,5,524,13680.0,252.0,104.8,5,1508,12861.0,1236.0,301.6
1766121.0,6,22,6443,11,1463,176612.1,357.0,133.0,11,4980,146039.0,1510.0,452.7272727272728
242611.0,6,3,337,2,214,0.0,160.0,107.0,1,123,0.0,123.0,123.0
19830.0,6,2,145,2,145,0.0,91.0,72.5,0,0,0.0,0.0,0.0
505851.00000000006,6,5,336,2,134,0.0,68.0,67.0,3,202,192657.5,70.0,67.33333333333333
200820.0,17,4,6056,4,6056,66940.0,1514.0,1514.0,0,0,0.0,0.0,0.0
1300185.0,6,4,264,2,132,0.0,66.0,66.0,2,132,0.0,66.0,66.0
191132.0,17,2,180,1,90,0.0,90.0,90.0,1,90,0.0,90.0,90.0
307959.0,6,6,412,4,272,102653.0,74.0,68.0,2,140,0.0,74.0,70.0
104258.0,17,2,286,2,286,0.0,143.0,143.0,0,0,0.0,0.0,0.0
153360.0,17,2,180,1,90,0.0,90.0,90.0,1,90,0.0,90.0,90.0
14632417.0,6,20,1607,10,975,1592622.2222222222,315.0,97.5,10,632,1592470.111111111,78.0,63.2
108105020.0,17,5,955,5,955,27026255.0,191.0,191.0,0,0,0.0,0.0,0.0
198142.0,17,2,180,1,90,0.0,90.0,90.0,1,90,0.0,90.0,90.0
14318.0,17,2,180,1,90,0.0,90.0,90.0,1,90,0.0,90.0,90.0
27111955.0,17,5,1710,5,1710,6777988.75,342.0,342.0,0,0,0.0,0.0,0.0
30229.0,6,14,4740,7,653,4914.166666666667,249.0,93.28571428571428,7,4087,4851.0,1514.0,583.8571428571429
307975.0,6,7,478,4,272,102658.33333333331,74.0,68.0,3,206,79897.5,74.0,68.66666666666667
2406.0,17,4,344,2,150,0.0,75.0,75.0,2,194,0.0,103.0,97.0
213612.0,17,2,180,1,90,0.0,90.0,90.0,1,90,0.0,90.0,90.0
5623401.0,6,4,270,2,134,0.0,68.0,67.0,2,136,0.0,70.0,68.0
120401129.0,6,317,37856,159,27132,762032.4620253164,284.0,170.64150943396226,158,10724,760298.4331210192,140.0,67.87341772151899
228343.0,6,13,1386,7,789,38057.16666666666,253.0,112.71428571428572,6,597,44697.4,259.0,99.5
2399.0,17,4,344,2,150,0.0,75.0,75.0,2,194,0.0,103.0,97.0
108101722.0,17,5,1005,5,1005,27025430.5,201.0,201.0,0,0,0.0,0.0,0.0
102026457.0,17,14,864,7,432,17004409.5,174.0,61.71428571428572,7,432,16955565.166666668,174.0,61.71428571428572
46620.0,6,14,4740,7,653,7348.5,249.0,93.28571428571428,7,4087,7632.833333333333,1514.0,583.8571428571429
2432.0,17,4,344,2,150,0.0,75.0,75.0,2,194,0.0,103.0,97.0
90538384.0,6,16,2648,8,1016,12934054.857142856,188.0,127.0,8,1632,12910288.57142857,204.0,204.0
28624.0,6,10,2032,5,524,6919.5,252.0,104.8,5,1508,5886.75,1236.0,301.6
33794.0,6,14,4740,7,653,4705.166666666667,249.0,93.28571428571428,7,4087,5490.833333333333,1514.0,583.8571428571429
108106984.0,17,5,955,5,955,27026746.0,191.0,191.0,0,0,0.0,0.0,0.0
126842262.0,6,49,4351,29,2512,4530080.785714285,139.0,86.62068965517241,20,1839,6149626.421052632,123.0,91.95
131392.0,6,3,337,2,214,0.0,160.0,107.0,1,123,0.0,123.0,123.0
1163620.0,6,13,3012,8,2384,166231.42857142858,1514.0,298.0,5,628,222751.25,331.0,125.6
30363.0,6,14,4740,7,653,4653.666666666667,249.0,93.28571428571428,7,4087,4816.166666666667,1514.0,583.8571428571429
72856.0,6,14,4740,7,653,11190.666666666666,249.0,93.28571428571428,7,4087,11635.666666666666,1514.0,583.8571428571429
32679721.0,6,5,336,3,202,14950229.5,70.0,67.33333333333333,2,134,0.0,68.0,67.0
46590475.0,6,8,2113,3,960,22179485.5,826.0,320.0,5,1153,11208783.0,885.0,230.6
218729.0,6,10,1221,6,636,43745.8,298.0,106.0,4,585,71333.33333333333,379.0,146.25
318857.0,17,4,1400,4,1400,106285.66666666669,350.0,350.0,0,0,0.0,0.0,0.0
130361.0,6,3,337,2,214,0.0,160.0,107.0,1,123,0.0,123.0,123.0
6432.0,17,4,823,2,163,0.0,89.0,81.5,2,660,0.0,443.0,330.0
5624873.0,6,4,270,2,134,0.0,68.0,67.0,2,136,0.0,70.0,68.0
90253834.0,6,13,2036,8,1016,12893404.857142856,188.0,127.0,5,1020,22522901.25,204.0,204.0
120046283.0,17,28,13364,28,13364,4446158.62962963,501.0,477.2857142857143,0,0,0.0,0.0,0.0
113026108.0,6,47,3102,24,1584,4914167.434782608,66.0,66.0,23,1518,5112001.7727272725,66.0,66.0
90022481.0,17,28,13364,28,13364,3334165.962962963,501.0,477.2857142857143,0,0,0.0,0.0,0.0
36236.0,6,14,4740,7,653,5914.5,249.0,93.28571428571428,7,4087,5510.0,1514.0,583.8571428571429
59443.0,6,14,4740,7,653,9775.0,249.0,93.28571428571428,7,4087,8051.166666666667,1514.0,583.8571428571429
1302430.0,6,4,264,2,132,0.0,66.0,66.0,2,132,0.0,66.0,66.0
115338149.0,6,215,24246,108,16962,1077926.6261682245,284.0,157.05555555555554,107,7284,1078280.8773584906,140.0,68.07476635514018
118562504.0,6,272,32006,136,22808,876646.7925925925,336.0,167.7058823529412,136,9198,876646.4888888889,140.0,67.63235294117646
105342199.0,6,43,2838,22,1452,5016282.095238095,66.0,66.0,21,1386,5159999.75,66.0,66.0
356477.0,6,3,1604,2,851,0.0,785.0,425.5,1,753,0.0,753.0,753.0
299936.0,6,6,412,4,272,99978.66666666669,74.0,68.0,2,140,0.0,74.0,70.0
819.0,17,4,438,2,148,0.0,74.0,74.0,2,290,0.0,147.0,145.0
43594.0,6,13,1394,7,797,7082.333333333333,253.0,113.85714285714286,6,597,8008.4,259.0,99.5
31418.0,6,14,4740,7,653,4989.166666666667,249.0,93.28571428571428,7,4087,4579.333333333333,1514.0,583.8571428571429
876621.0,6,9,1269,6,798,175324.2,460.0,133.0,3,471,300518.0,331.0,157.0
278409.0,17,2,363,1,79,0.0,79.0,79.0,1,284,0.0,284.0,284.0
8722052.0,6,5,1736,2,819,0.0,753.0,409.5,3,917,4288996.5,785.0,305.6666666666667
90748545.0,6,19,1436,10,745,10078551.666666666,95.0,74.5,9,691,11342236.625,95.0,76.77777777777777
5620092.0,6,5,336,2,134,0.0,68.0,67.0,3,202,1526573.5,70.0,67.33333333333333
2346.0,17,4,344,2,150,0.0,75.0,75.0,2,194,0.0,103.0,97.0
237252.0,6,3,337,2,214,0.0,160.0,107.0,1,123,0.0,123.0,123.0
216557.0,17,2,180,1,90,0.0,90.0,90.0,1,90,0.0,90.0,90.0
21729.0,6,14,4740,7,653,3385.6666666666665,249.0,93.28571428571428,7,4087,3476.6666666666665,1514.0,583.8571428571429
103081766.0,6,43,2838,22,1452,4899052.285714285,66.0,66.0,21,1386,5135439.5,66.0,66.0
204205.0,17,2,762,2,762,0.0,381.0,381.0,0,0,0.0,0.0,0.0
4490.0,17,2,610,1,72,0.0,72.0,72.0,1,538,0.0,538.0,538.0
844.0,17,4,438,2,148,0.0,74.0,74.0,2,290,0.0,147.0,145.0
1025282.0,6,11,1134,6,558,205056.4,220.0,93.0,5,576,254715.75,304.0,115.2
382.0,17,2,267,1,83,0.0,83.0,83.0,1,184,0.0,184.0,184.0
120103.0,17,2,180,1,70,0.0,70.0,70.0,1,110,0.0,110.0,110.0
117418775.0,6,33,2280,17,1209,7325191.75,123.0,71.11764705882354,16,1071,7813539.2,123.0,66.9375
6989.0,17,2,582,1,83,0.0,83.0,83.0,1,499,0.0,499.0,499.0
90062283.0,17,27,12943,27,12943,3463933.961538461,501.0,479.3703703703704,0,0,0.0,0.0,0.0
106985306.0,6,44,2904,22,1452,5094538.380952381,66.0,66.0,22,1452,5081556.238095238,66.0,66.0
83008074.0,17,15,5138,14,4788,5908087.307692308,342.0,342.0,1,350,0.0,350.0,350.0
4181.0,17,2,598,1,72,0.0,72.0,72.0,1,526,0.0,526.0,526.0
207480.0,6,3,426,2,280,0.0,214.0,140.0,1,146,0.0,146.0,146.0
4842.0,17,2,180,1,90,0.0,90.0,90.0,1,90,0.0,90.0,90.0
120001054.0,17,13,821,7,432,20000175.666666668,174.0,61.71428571428572,6,389,20037912.8,174.0,64.83333333333333
206100.0,6,10,1221,6,636,41220.0,298.0,106.0,4,585,67249.66666666667,379.0,146.25
159368.0,6,3,337,2,214,0.0,160.0,107.0,1,123,0.0,123.0,123.0
228650.0,17,2,180,1,90,0.0,90.0,90.0,1,90,0.0,90.0,90.0
2075.0,17,4,344,2,150,0.0,75.0,75.0,2,194,0.0,103.0,97.0
55524.0,6,14,4740,7,653,8990.0,249.0,93.28571428571428,7,4087,8904.166666666666,1514.0,583.8571428571429
120495098.0,6,205,23248,103,16220,1181324.4901960783,284.0,157.4757281553398,102,7028,1182765.1485148517,140.0,68.90196078431373
108098652.0,17,5,1005,5,1005,27024663.0,201.0,201.0,0,0,0.0,0.0,0.0
17170.0,6,11,1131,6,600,3194.4,262.0,100.0,5,531,3958.75,259.0,106.2
297730.0,6,6,412,4,272,99243.33333333331,74.0,68.0,2,140,0.0,74.0,70.0
10913200.0,6,8,544,4,272,3592436.333333333,74.0,68.0,4,272,3592362.6666666665,74.0,68.0
226982.0,6,13,1394,7,797,37830.333333333336,253.0,113.85714285714286,6,597,44205.8,259.0,99.5
300721.0,6,6,412,4,272,100240.33333333331,74.0,68.0,2,140,0.0,74.0,70.0
148421.0,17,4,1524,4,1524,49473.66666666666,381.0,381.0,0,0,0.0,0.0,0.0
17093.0,6,14,4740,7,653,2606.333333333333,249.0,93.28571428571428,7,4087,2714.6666666666665,1514.0,583.8571428571429
909.0,17,4,438,2,148,0.0,74.0,74.0,2,290,0.0,147.0,145.0
108106471.0,17,5,955,5,955,27026617.75,191.0,191.0,0,0,0.0,0.0,0.0
90253727.0,6,13,2036,8,1016,12893389.57142857,188.0,127.0,5,1020,22522282.75,204.0,204.0
90017420.0,17,27,12943,27,12943,3462208.461538461,501.0,479.3703703703704,0,0,0.0,0.0,0.0
50857.0,17,2,180,1,90,0.0,90.0,90.0,1,90,0.0,90.0,90.0
122269544.0,6,47,3102,23,1518,5135442.545454546,66.0,66.0,24,1584,5304087.391304348,66.0,66.0
242156.0,6,3,373,2,238,0.0,172.0,119.0,1,135,0.0,135.0,135.0
206743.0,17,2,180,1,90,0.0,90.0,90.0,1,90,0.0,90.0,90.0
31821.000000000004,6,14,4740,7,653,4904.5,249.0,93.28571428571428,7,4087,4661.833333333333,1514.0,583.8571428571429
90255540.0,6,13,2036,8,1016,12893648.57142857,188.0,127.0,5,1020,22523078.25,204.0,204.0
302.0,17,2,168,1,76,0.0,76.0,76.0,1,92,0.0,92.0,92.0
246210.0,6,3,373,2,238,0.0,172.0,119.0,1,135,0.0,135.0,135.0
122975042.0,6,48,3168,24,1584,5066548.173913044,66.0,66.0,24,1584,5200526.391304348,66.0,66.0
9859.0,17,2,582,1,83,0.0,83.0,83.0,1,499,0.0,499.0,499.0
12611.0,6,13,1459,7,862,1952.6666666666667,271.0,123.14285714285714,6,597,1982.0,259.0,99.5
90543120.0,6,16,2648,8,1016,12934731.42857143,188.0,127.0,8,1632,12909587.857142856,204.0,204.0
125027515.0,6,30,1990,15,948,8217285.285714285,123.0,63.2,15,1042,8217307.285714285,139.0,69.46666666666667
32824.0,6,10,2032,5,524,7979.5,252.0,104.8,5,1508,7336.5,1236.0,301.6
120109499.0,6,550,76338,275,18446,435396.5912408759,140.0,67.07636363636364,275,57892,438333.2153284672,480.0,210.51636363636365
162399.0,17,2,180,1,90,0.0,90.0,90.0,1,90,0.0,90.0,90.0
197230.0,17,2,180,1,90,0.0,90.0,90.0,1,90,0.0,90.0,90.0
42582.0,6,10,2032,5,524,9991.75,252.0,104.8,5,1508,9487.0,1236.0,301.6
294.0,17,2,156,1,78,0.0,78.0,78.0,1,78,0.0,78.0,78.0
7653.0,17,2,582,1,83,0.0,83.0,83.0,1,499,0.0,499.0,499.0
362314.0,6,11,1021,6,444,48745.8,162.0,74.0,5,577,60740.5,349.0,115.4
90521946.0,6,15,2444,8,1016,12931706.57142857,188.0,127.0,7,1428,15060172.166666666,204.0,204.0
3910777.0,6,5,336,2,134,0.0,68.0,67.0,3,202,1526457.0,70.0,67.33333333333333
153590.0,17,2,180,1,90,0.0,90.0,90.0,1,90,0.0,90.0,90.0
58250.0,6,14,4740,7,653,9583.833333333334,249.0,93.28571428571428,7,4087,9549.666666666666,1514.0,583.8571428571429
196916.0,17,2,180,1,90,0.0,90.0,90.0,1,90,0.0,90.0,90.0
90256402.0,6,12,1832,8,1016,12893771.714285716,188.0,127.0,4,816,30026465.666666668,204.0,204.0
108107541.0,17,5,955,5,955,27026885.25,191.0,191.0,0,0,0.0,0.0,0.0
107945.0,17,2,286,2,286,0.0,143.0,143.0,0,0,0.0,0.0,0.0
104155208.0,17,14,1126,7,563,17334549.666666668,174.0,80.42857142857143,7,563,17333490.166666668,174.0,80.42857142857143
300454.0,17,2,180,1,90,0.0,90.0,90.0,1,90,0.0,90.0,90.0
23035424.0,17,3,1034,2,684,0.0,342.0,342.0,1,350,0.0,350.0,350.0
106576.0,17,2,286,2,286,0.0,143.0,143.0,0,0,0.0,0.0,0.0
242119.0,6,3,373,2,238,0.0,172.0,119.0,1,135,0.0,135.0,135.0
2800819.0,6,2,132,1,66,0.0,66.0,66.0,1,66,0.0,66.0,66.0
207901.0,17,2,762,2,762,0.0,381.0,381.0,0,0,0.0,0.0,0.0
42797.0,6,10,2032,5,524,9277.0,252.0,104.8,5,1508,8519.25,1236.0,301.6
5521644.0,6,5,336,2,134,0.0,68.0,67.0,3,202,1423593.5,70.0,67.33333333333333
228388.0,17,2,180,1,90,0.0,90.0,90.0,1,90,0.0,90.0,90.0
164699.0,17,2,414,1,88,0.0,88.0,88.0,1,326,0.0,326.0,326.0
110491.0,17,4,1400,4,1400,36830.333333333336,350.0,350.0,0,0,0.0,0.0,0.0
450.0,17,2,160,1,80,0.0,80.0,80.0,1,80,0.0,80.0,80.0
322645.0,6,6,412,4,272,107548.33333333331,74.0,68.0,2,140,0.0,74.0,70.0
210772.0,6,3,426,2,280,0.0,214.0,140.0,1,146,0.0,146.0,146.0
2283.0,17,4,344,2,150,0.0,75.0,75.0,2,194,0.0,103.0,97.0
0.0,17,1,381,1,381,0.0,381.0,381.0,0,0,0.0,0.0,0.0
93168627.0,17,12,778,6,389,18601703.6,174.0,64.83333333333333,6,389,18611002.2,174.0,64.83333333333333
17229.0,17,2,180,1,90,0.0,90.0,90.0,1,90,0.0,90.0,90.0
4429.0,17,2,614,1,72,0.0,72.0,72.0,1,542,0.0,542.0,542.0
16015.999999999998,6,10,2032,5,524,3744.25,252.0,104.8,5,1508,3664.0,1236.0,301.6
233251.0,6,12,1373,7,714,38875.16666666666,298.0,102.0,5,659,57586.0,379.0,131.8
102333307.0,17,14,864,7,432,17000141.833333332,174.0,61.71428571428572,7,432,17000891.0,174.0,61.71428571428572
19922.0,6,13,4515,6,512,3780.6,230.0,85.33333333333333,7,4003,2989.333333333333,1514.0,571.8571428571429
120001537.0,6,25,1924,14,1084,9230887.461538462,95.0,77.42857142857143,11,840,11954611.4,95.0,76.36363636363636
50020.0,6,14,4740,7,653,8073.0,249.0,93.28571428571428,7,4087,8079.5,1514.0,583.8571428571429
90224462.0,6,14,2240,8,1016,12889208.857142856,188.0,127.0,6,1224,18012727.0,204.0,204.0
3518.0,17,2,414,1,88,0.0,88.0,88.0,1,326,0.0,326.0,326.0
2797360.0,6,2,132,1,66,0.0,66.0,66.0,1,66,0.0,66.0,66.0
23448.0,6,14,4740,7,653,3732.1666666666665,249.0,93.28571428571428,7,4087,3532.1666666666665,1514.0,583.8571428571429
228215.0,17,2,180,1,90,0.0,90.0,90.0,1,90,0.0,90.0,90.0
115692336.0,6,48,3168,24,1584,5030101.565217392,66.0,66.0,24,1584,5018125.130434782,66.0,66.0
45401.0,6,14,4740,7,653,5777.166666666667,249.0,93.28571428571428,7,4087,7436.166666666667,1514.0,583.8571428571429
128913559.0,6,35,2394,18,1269,7583150.529411765,123.0,70.5,17,1125,7419431.4375,123.0,66.17647058823529
42036.0,6,14,4740,7,653,6194.833333333333,249.0,93.28571428571428,7,4087,6184.5,1514.0,583.8571428571429
162254.0,6,3,337,2,214,0.0,160.0,107.0,1,123,0.0,123.0,123.0
303.0,17,2,168,1,76,0.0,76.0,76.0,1,92,0.0,92.0,92.0
105446.0,17,2,286,2,286,0.0,143.0,143.0,0,0,0.0,0.0,0.0
22592.0,6,11,1132,6,556,3515.8,218.0,92.66666666666669,5,576,4862.0,304.0,115.2
122975306.0,6,48,3168,24,1584,4920358.521739131,66.0,66.0,24,1584,5346729.652173913,66.0,66.0
90304227.0,6,17,1287,9,691,11282370.125,95.0,76.77777777777777,8,596,12899946.42857143,95.0,74.5
841868.0,6,9,1118,6,586,168373.6,248.0,97.66666666666669,3,532,283150.5,392.0,177.33333333333334
231977.0,6,3,337,2,214,0.0,160.0,107.0,1,123,0.0,123.0,123.0
106065.0,17,2,700,2,700,0.0,350.0,350.0,0,0,0.0,0.0,0.0
5827650.0,6,4,270,2,134,0.0,68.0,67.0,2,136,0.0,70.0,68.0
122975124.0,6,48,3168,24,1584,5122661.478260869,66.0,66.0,24,1584,5144418.869565218,66.0,66.0
263113.0,6,3,337,2,214,0.0,160.0,107.0,1,123,0.0,123.0,123.0
18974943.0,17,3,1034,2,684,0.0,342.0,342.0,1,350,0.0,350.0,350.0
111489.0,6,2,132,1,66,0.0,66.0,66.0,1,66,0.0,66.0,66.0
18853.0,6,14,4740,7,653,3033.1666666666665,249.0,93.28571428571428,7,4087,3001.833333333333,1514.0,583.8571428571429
90406070.0,6,19,1436,9,650,11300758.75,95.0,72.22222222222223,10,786,6789962.222222222,95.0,78.6
103031.0,17,2,286,2,286,0.0,143.0,143.0,0,0,0.0,0.0,0.0
41392.0,6,10,2032,5,524,9682.25,252.0,104.8,5,1508,9981.5,1236.0,301.6
147026.0,6,3,373,2,238,0.0,172.0,119.0,1,135,0.0,135.0,135.0
5450.0,17,2,180,1,90,0.0,90.0,90.0,1,90,0.0,90.0,90.0
129654584.0,6,38,2710,19,1302,6648310.444444444,123.0,68.52631578947368,19,1408,6775848.666666667,139.0,74.10526315789474
4578.0,17,2,473,1,78,0.0,78.0,78.0,1,395,0.0,395.0,395.0
120316734.0,6,229,26018,115,18272,1055409.9473684211,284.0,158.88695652173914,114,7746,1055574.8495575222,140.0,67.94736842105263
2794808.0,6,2,132,1,66,0.0,66.0,66.0,1,66,0.0,66.0,66.0
2389.0,17,4,344,2,150,0.0,75.0,75.0,2,194,0.0,103.0,97.0
253802.00000000003,6,3,337,2,214,0.0,160.0,107.0,1,123,0.0,123.0,123.0
299924.0,6,6,412,4,272,99974.66666666669,74.0,68.0,2,140,0.0,74.0,70.0
3631275.0,17,3,1026,3,1026,1815637.5,342.0,342.0,0,0,0.0,0.0,0.0
16027216.0,17,2,684,2,684,0.0,342.0,342.0,0,0,0.0,0.0,0.0
2595698.0,6,2,132,1,66,0.0,66.0,66.0,1,66,0.0,66.0,66.0
33130.0,6,10,2032,5,524,7960.5,252.0,104.8,5,1508,7492.0,1236.0,301.6
300264.0,6,6,412,4,272,100088.0,74.0,68.0,2,140,0.0,74.0,70.0
446220.0,17,4,360,2,140,0.0,70.0,70.0,2,220,0.0,110.0,110.0
24186540.0,17,3,1034,2,684,0.0,342.0,342.0,1,350,0.0,350.0,350.0
115345273.0,6,33,2412,17,1272,7209079.5625,123.0,74.82352941176471,16,1140,7675265.266666667,123.0,71.25
90026662.0,17,28,13364,28,13364,3334320.814814815,501.0,477.2857142857143,0,0,0.0,0.0,0.0
178257.0,17,2,180,1,90,0.0,90.0,90.0,1,90,0.0,90.0,90.0
101274.0,17,2,286,2,286,0.0,143.0,143.0,0,0,0.0,0.0,0.0
16309.0,6,11,1131,6,600,2808.4,262.0,100.0,5,531,3749.75,259.0,106.2
98695.0,17,2,762,2,762,0.0,381.0,381.0,0,0,0.0,0.0,0.0
447052.0,6,4,508,2,238,0.0,172.0,119.0,2,270,0.0,135.0,135.0
16726.0,17,2,180,1,90,0.0,90.0,90.0,1,90,0.0,90.0,90.0
123244.0,6,3,337,2,214,0.0,160.0,107.0,1,123,0.0,123.0,123.0
206903.0,6,3,426,2,280,0.0,214.0,140.0,1,146,0.0,146.0,146.0
360.0,17,2,166,1,75,0.0,75.0,75.0,1,91,0.0,91.0,91.0
118980860.0,6,47,3102,24,1584,5159672.478260869,66.0,66.0,23,1518,5150439.727272728,66.0,66.0
145488.0,6,3,337,2,214,0.0,160.0,107.0,1,123,0.0,123.0,123.0
285188.0,17,2,363,1,79,0.0,79.0,79.0,1,284,0.0,284.0,284.0
135131864.0,17,6,1146,6,1146,27026372.8,191.0,191.0,0,0,0.0,0.0,0.0
867.0,17,4,438,2,148,0.0,74.0,74.0,2,290,0.0,147.0,145.0
153479.0,17,2,180,1,90,0.0,90.0,90.0,1,90,0.0,90.0,90.0
41972.0,6,10,2032,5,524,10341.5,252.0,104.8,5,1508,9859.0,1236.0,301.6
123455749.0,6,48,3168,24,1584,5165855.565217392,66.0,66.0,24,1584,5101980.956521739,66.0,66.0
144950.0,17,2,180,1,70,0.0,70.0,70.0,1,110,0.0,110.0,110.0
119022964.0,17,15,1169,8,606,17003280.57142857,174.0,75.75,7,563,16500128.166666666,174.0,80.42857142857143
145279.0,17,2,180,1,70,0.0,70.0,70.0,1,110,0.0,110.0,110.0
5638886.0,6,5,336,2,134,0.0,68.0,67.0,3,202,1526949.5,70.0,67.33333333333333
34138.0,6,14,4740,7,653,5555.833333333333,249.0,93.28571428571428,7,4087,5551.666666666667,1514.0,583.8571428571429
29324.0,6,14,4740,7,653,4297.0,249.0,93.28571428571428,7,4087,4747.666666666667,1514.0,583.8571428571429
301723.0,6,6,412,4,272,100574.33333333331,74.0,68.0,2,140,0.0,74.0,70.0
2441.0,17,4,344,2,150,0.0,75.0,75.0,2,194,0.0,103.0,97.0
0.0,17,1,90,1,90,0.0,90.0,90.0,0,0,0.0,0.0,0.0
32272942.0,17,2,322,2,322,0.0,161.0,161.0,0,0,0.0,0.0,0.0
107322.0,17,2,286,2,286,0.0,143.0,143.0,0,0,0.0,0.0,0.0
763311.0,6,10,1221,6,636,152662.2,298.0,106.0,4,585,253465.66666666663,379.0,146.25
144002.0,17,2,180,1,90,0.0,90.0,90.0,1,90,0.0,90.0,90.0
104644358.0,17,15,5130,15,5130,7474597.0,342.0,342.0,0,0,0.0,0.0,0.0
232846.0,6,3,337,2,214,0.0,160.0,107.0,1,123,0.0,123.0,123.0
9003299.0,17,4,300,4,300,3001099.6666666665,75.0,75.0,0,0,0.0,0.0,0.0
116443964.0,6,48,3168,24,1584,5062781.043478261,66.0,66.0,24,1584,5049361.956521739,66.0,66.0
108096542.0,17,5,955,5,955,27024135.5,191.0,191.0,0,0,0.0,0.0,0.0
107429693.0,17,15,1169,8,606,15324230.285714284,174.0,75.75,7,563,17839766.0,174.0,80.42857142857143
67841.0,6,14,4740,7,653,10937.5,249.0,93.28571428571428,7,4087,11010.333333333334,1514.0,583.8571428571429
4152.0,17,2,614,1,72,0.0,72.0,72.0,1,542,0.0,542.0,542.0
0.0,6,1,66,1,66,0.0,66.0,66.0,0,0,0.0,0.0,0.0
103937.0,17,2,286,2,286,0.0,143.0,143.0,0,0,0.0,0.0,0.0
125011733.0,17,15,907,8,475,17858819.0,174.0,59.375,7,432,17500172.333333332,174.0,61.71428571428572
377.0,17,2,267,1,83,0.0,83.0,83.0,1,184,0.0,184.0,184.0
5623791.0,6,5,336,2,134,0.0,68.0,67.0,3,202,1523746.0,70.0,67.33333333333333
537275.0,17,2,346,1,78,0.0,78.0,78.0,1,268,0.0,268.0,268.0
6553.0,17,4,823,2,163,0.0,89.0,81.5,2,660,0.0,443.0,330.0
118920554.0,6,35,2542,18,1348,6982615.94117647,139.0,74.88888888888889,17,1194,7419035.375,123.0,70.23529411764706
0.0,17,1,55,1,55,0.0,55.0,55.0,0,0,0.0,0.0,0.0
329028.0,17,6,2100,6,2100,65805.6,350.0,350.0,0,0,0.0,0.0,0.0
118029.0,17,4,1400,4,1400,39343.0,350.0,350.0,0,0,0.0,0.0,0.0
90051579.0,17,27,12943,27,12943,3463522.269230769,501.0,479.3703703703704,0,0,0.0,0.0,0.0
60042.0,6,14,4740,7,653,9875.333333333334,249.0,93.28571428571428,7,4087,8877.5,1514.0,583.8571428571429
35488.0,6,14,4740,7,653,5193.166666666667,249.0,93.28571428571428,7,4087,4978.333333333333,1514.0,583.8571428571429
10476635.0,6,7,478,4,272,3446595.6666666665,74.0,68.0,3,206,5169821.5,74.0,68.66666666666667
115186050.0,6,568,77954,284,18966,406969.964664311,140.0,66.78169014084507,284,58988,406982.59717314487,480.0,207.70422535211267
1176105.0,17,2,614,1,72,0.0,72.0,72.0,1,542,0.0,542.0,542.0
316328.0,6,6,412,4,272,105442.66666666669,74.0,68.0,2,140,0.0,74.0,70.0
37969.0,6,14,4740,7,653,5951.333333333333,249.0,93.28571428571428,7,4087,6120.333333333333,1514.0,583.8571428571429
316.0,17,2,174,1,79,0.0,79.0,79.0,1,95,0.0,95.0,95.0
108106578.0,17,5,955,5,955,27026644.5,191.0,191.0,0,0,0.0,0.0,0.0
99858.0,17,2,762,2,762,0.0,381.0,381.0,0,0,0.0,0.0,0.0
93015384.0,6,38,2508,19,1254,5150437.111111111,66.0,66.0,19,1254,5150435.555555556,66.0,66.0
10531869.0,6,7,478,4,272,3465072.0,74.0,68.0,3,206,5190856.5,74.0,68.66666666666667
108103823.0,17,5,955,5,955,27025955.75,191.0,191.0,0,0,0.0,0.0,0.0
39334.0,6,12,1320,6,723,7106.2,253.0,120.5,6,597,7395.0,259.0,99.5
6689.0,17,2,582,1,83,0.0,83.0,83.0,1,499,0.0,499.0,499.0
120138080.0,6,231,26088,116,7890,1044678.9565217393,140.0,68.01724137931035,115,18198,1044735.9561403508,284.0,158.24347826086955
329524.0,17,4,704,2,148,0.0,74.0,74.0,2,556,0.0,280.0,278.0
108110360.0,17,5,1005,5,1005,27027590.0,201.0,201.0,0,0,0.0,0.0,0.0
10521613.0,6,7,478,4,272,3460184.6666666665,74.0,68.0,3,206,5190189.0,74.0,68.66666666666667
13001.0,17,3,1026,3,1026,6500.5,342.0,342.0,0,0,0.0,0.0,0.0
90215817.0,6,16,1192,8,596,12853840.714285716,95.0,74.5,8,596,12858727.57142857,95.0,74.5
347.0,17,2,267,1,83,0.0,83.0,83.0,1,184,0.0,184.0,184.0
49599.0,6,10,2032,5,524,11729.75,252.0,104.8,5,1508,10503.25,1236.0,301.6
111378.0,6,14,4740,7,653,18404.33333333333,249.0,93.28571428571428,7,4087,18336.33333333333,1514.0,583.8571428571429
326.0,17,2,174,1,79,0.0,79.0,79.0,1,95,0.0,95.0,95.0
138972.0,6,2,132,1,66,0.0,66.0,66.0,1,66,0.0,66.0,66.0
120123187.0,6,14,2224,9,1204,15015398.375,188.0,133.77777777777777,5,1020,22514268.75,204.0,204.0
1210803.0,6,11,1134,6,558,242160.6,220.0,93.0,5,576,300946.75,304.0,115.2
14743929.0,6,20,1689,10,1057,1603753.7777777778,315.0,105.7,10,632,1603754.6666666667,78.0,63.2
91384309.0,6,24,1829,13,989,7614476.25,95.0,76.07692307692308,11,840,9137933.9,95.0,76.36363636363636
120124248.0,6,16,2356,9,1204,15015531.0,188.0,133.77777777777777,7,1152,15009194.166666666,204.0,164.57142857142858
135131398.0,17,6,1146,6,1146,27026279.6,191.0,191.0,0,0,0.0,0.0,0.0
2020.0,17,4,344,2,150,0.0,75.0,75.0,2,194,0.0,103.0,97.0
1014.0,17,4,438,2,148,0.0,74.0,74.0,2,290,0.0,147.0,145.0
113617997.0,6,46,3036,23,1518,5150434.636363637,66.0,66.0,23,1518,5150435.681818182,66.0,66.0
17904.0,6,10,2032,5,524,4240.75,252.0,104.8,5,1508,4226.25,1236.0,301.6
39186.0,6,14,4740,7,653,6413.833333333333,249.0,93.28571428571428,7,4087,5451.833333333333,1514.0,583.8571428571429
216697.0,6,3,426,2,280,0.0,214.0,140.0,1,146,0.0,146.0,146.0
57669.0,6,10,2032,5,524,14137.25,252.0,104.8,5,1508,13982.25,1236.0,301.6
128785103.0,6,39,2902,20,1531,6778163.315789473,139.0,76.55,19,1371,6588076.166666667,123.0,72.15789473684211
13789.0,17,2,180,1,90,0.0,90.0,90.0,1,90,0.0,90.0,90.0
144713.0,17,2,180,1,70,0.0,70.0,70.0,1,110,0.0,110.0,110.0
20845.0,6,13,1459,7,862,3352.833333333333,271.0,123.14285714285714,6,597,3758.4,259.0,99.5
49679906.0,6,8,2113,3,960,23510843.0,826.0,320.0,5,1153,11724978.0,885.0,230.6
108116549.0,17,5,1005,5,1005,27029137.25,201.0,201.0,0,0,0.0,0.0,0.0
121246.0,6,3,337,2,214,0.0,160.0,107.0,1,123,0.0,123.0,123.0
217586.0,6,13,1394,7,797,36264.333333333336,253.0,113.85714285714286,6,597,42632.0,259.0,99.5
1305115.0,6,4,264,2,132,0.0,66.0,66.0,2,132,0.0,66.0,66.0
2375.0,17,4,344,2,150,0.0,75.0,75.0,2,194,0.0,103.0,97.0
517.0,17,2,508,2,508,0.0,257.0,254.0,0,0,0.0,0.0,0.0
143869.0,17,2,180,1,90,0.0,90.0,90.0,1,90,0.0,90.0,90.0
520635.0,17,4,1400,4,1400,173545.0,350.0,350.0,0,0,0.0,0.0,0.0
303661.0,6,2,132,1,66,0.0,66.0,66.0,1,66,0.0,66.0,66.0
7703.0,17,2,180,1,90,0.0,90.0,90.0,1,90,0.0,90.0,90.0
1027094.0,6,11,1134,6,558,205418.8,220.0,93.0,5,576,255272.75,304.0,115.2
108110111.0,17,5,1005,5,1005,27027527.75,201.0,201.0,0,0,0.0,0.0,0.0
121734.0,17,4,1400,4,1400,40578.0,350.0,350.0,0,0,0.0,0.0,0.0
113011606.0,17,13,952,7,563,18835267.666666668,174.0,80.42857142857143,6,389,18551116.8,174.0,64.83333333333333
108840649.0,6,32,2364,17,1277,6802223.75,95.0,75.11764705882354,15,1087,7771210.571428572,95.0,72.46666666666667
90035238.0,17,28,13364,28,13364,3334638.4444444445,501.0,477.2857142857143,0,0,0.0,0.0,0.0
51902.0,6,10,2032,5,524,12739.0,252.0,104.8,5,1508,12265.0,1236.0,301.6
1827.0,17,2,684,1,342,0.0,342.0,342.0,1,342,0.0,342.0,342.0
2464105.0,6,25,7573,14,3735,189546.53846153847,1514.0,266.7857142857143,11,3838,220298.7,1514.0,348.90909090909093
333699.0,6,6,412,4,272,111233.0,74.0,68.0,2,140,0.0,74.0,70.0
846468.0,6,9,1096,6,625,169293.6,287.0,104.16666666666669,3,471,286934.0,331.0,157.0
49203.0,6,14,4740,7,653,7559.0,249.0,93.28571428571428,7,4087,7893.166666666667,1514.0,583.8571428571429
135113473.0,17,6,1206,6,1206,27022694.6,201.0,201.0,0,0,0.0,0.0,0.0
154841.0,17,4,1524,4,1524,51613.66666666666,381.0,381.0,0,0,0.0,0.0,0.0
235328.0,17,4,1400,4,1400,78442.66666666667,350.0,350.0,0,0,0.0,0.0,0.0
104544586.0,17,15,5130,15,5130,7467470.428571428,342.0,342.0,0,0,0.0,0.0,0.0
2080645.0,6,18,6803,10,1501,231182.7777777777,408.0,150.1,8,5302,235622.4285714285,1514.0,662.75
120007698.0,17,13,559,7,301,20001283.0,43.0,43.0,6,258,20000164.8,43.0,43.0
142386.0,6,2,132,1,66,0.0,66.0,66.0,1,66,0.0,66.0,66.0
233029.0,6,3,337,2,214,0.0,160.0,107.0,1,123,0.0,123.0,123.0
14253.0,17,2,876,2,876,0.0,438.0,438.0,0,0,0.0,0.0,0.0
1534716.0,6,7,499,4,301,493422.6666666667,103.0,75.25,3,198,715364.0,66.0,66.0
104724438.0,6,30,2106,15,1089,7480317.0,123.0,72.6,15,1017,7464853.357142857,123.0,67.8
108105753.0,17,5,955,5,955,27026438.25,191.0,191.0,0,0,0.0,0.0,0.0
110306.0,17,4,1400,4,1400,36768.66666666666,350.0,350.0,0,0,0.0,0.0,0.0
218377.0,17,2,180,1,90,0.0,90.0,90.0,1,90,0.0,90.0,90.0
108101409.0,17,5,1005,5,1005,27025352.25,201.0,201.0,0,0,0.0,0.0,0.0
912709.0,6,10,1334,6,797,182541.8,459.0,132.83333333333334,4,537,212493.3333333333,331.0,134.25
21284.0,6,14,4740,7,653,3343.1666666666665,249.0,93.28571428571428,7,4087,3249.5,1514.0,583.8571428571429
206172.0,6,3,426,2,280,0.0,214.0,140.0,1,146,0.0,146.0,146.0
622373.0,17,3,551,2,156,0.0,78.0,78.0,1,395,0.0,395.0,395.0
228124.0,17,2,180,1,90,0.0,90.0,90.0,1,90,0.0,90.0,90.0
30529.0,6,10,2032,5,524,7001.75,252.0,104.8,5,1508,6483.0,1236.0,301.6
311196.0,17,4,1400,4,1400,103732.0,350.0,350.0,0,0,0.0,0.0,0.0
2780243.0,6,2,132,1,66,0.0,66.0,66.0,1,66,0.0,66.0,66.0
1449720.0,6,2,132,1,66,0.0,66.0,66.0,1,66,0.0,66.0,66.0
2480.0,17,4,344,2,150,0.0,75.0,75.0,2,194,0.0,103.0,97.0
65540.0,6,14,4740,7,653,10744.0,249.0,93.28571428571428,7,4087,10717.333333333334,1514.0,583.8571428571429
2286.0,17,4,344,2,150,0.0,75.0,75.0,2,194,0.0,103.0,97.0
1149344.0,6,13,3018,8,2390,164192.0,1514.0,298.75,5,628,219144.25,331.0,125.6
105575556.0,6,28,1860,14,966,8104592.0,123.0,69.0,14,894,8104594.153846154,123.0,63.85714285714285
39644133.0,6,5,336,2,134,0.0,68.0,67.0,3,202,19753106.0,70.0,67.33333333333333
317462.0,6,7,478,4,272,105820.66666666669,74.0,68.0,3,206,76789.0,74.0,68.66666666666667
244568.0,6,3,337,2,214,0.0,160.0,107.0,1,123,0.0,123.0,123.0
234074.0,6,3,337,2,214,0.0,160.0,107.0,1,123,0.0,123.0,123.0
2104908.0,6,20,6935,11,1567,210490.8,408.0,142.45454545454547,9,5368,216052.75,1514.0,596.4444444444445
135132932.0,17,6,1206,6,1206,27026586.4,201.0,201.0,0,0,0.0,0.0,0.0
2591643.0,6,2,132,1,66,0.0,66.0,66.0,1,66,0.0,66.0,66.0
1907.0,17,2,939,1,590,0.0,590.0,590.0,1,349,0.0,349.0,349.0
120071049.0,6,232,26088,116,7952,1036979.104347826,140.0,68.55172413793103,116,18136,1036959.547826087,284.0,156.3448275862069
108112438.0,17,5,1005,5,1005,27028109.5,201.0,201.0,0,0,0.0,0.0,0.0
0.0,17,1,381,1,381,0.0,381.0,381.0,0,0,0.0,0.0,0.0
1634050.0,6,20,6434,12,1921,148550.0,620.0,160.08333333333334,8,4513,189741.7142857143,1514.0,564.125
46503.0,6,14,4740,7,653,7590.166666666667,249.0,93.28571428571428,7,4087,5145.833333333333,1514.0,583.8571428571429
24024809.0,17,3,1026,3,1026,12012404.5,342.0,342.0,0,0,0.0,0.0,0.0
309906.0,6,3,202,2,128,0.0,74.0,64.0,1,74,0.0,74.0,74.0
108094696.0,17,5,955,5,955,27023674.0,191.0,191.0,0,0,0.0,0.0,0.0
405.0,17,2,410,1,78,0.0,78.0,78.0,1,332,0.0,332.0,332.0
9700.0,17,2,539,1,86,0.0,86.0,86.0,1,453,0.0,453.0,453.0
319635.0,17,4,1400,4,1400,106545.0,350.0,350.0,0,0,0.0,0.0,0.0
284428.0,17,2,363,1,79,0.0,79.0,79.0,1,284,0.0,284.0,284.0
40491.0,6,14,4740,7,653,6260.0,249.0,93.28571428571428,7,4087,6293.833333333333,1514.0,583.8571428571429
33246.0,6,14,4740,7,653,5315.666666666667,249.0,93.28571428571428,7,4087,4794.5,1514.0,583.8571428571429
5005638.0,17,4,849,2,166,0.0,83.0,83.0,2,683,0.0,499.0,341.5
143865.0,17,2,180,1,90,0.0,90.0,90.0,1,90,0.0,90.0,90.0
2408.0,17,4,344,2,150,0.0,75.0,75.0,2,194,0.0,103.0,97.0
109740094.0,6,32,2236,16,1165,7301628.6,139.0,72.8125,16,1071,7301623.733333333,123.0,66.9375
196890.0,17,2,180,1,90,0.0,90.0,90.0,1,90,0.0,90.0,90.0
15864942.0,17,6,2052,6,2052,3172988.4,342.0,342.0,0,0,0.0,0.0,0.0
9007887.0,17,2,160,2,160,0.0,80.0,80.0,0,0,0.0,0.0,0.0
117209384.0,6,31,2097,16,1071,7813929.733333333,123.0,66.9375,15,1026,8371930.142857143,123.0,68.4
2602893.0,6,2,132,1,66,0.0,66.0,66.0,1,66,0.0,66.0,66.0
22133.0,6,10,2032,5,524,5234.5,252.0,104.8,5,1508,4753.5,1236.0,301.6
135133689.0,17,6,1206,6,1206,27026737.8,201.0,201.0,0,0,0.0,0.0,0.0
3054216.0,6,3,204,1,68,0.0,68.0,68.0,2,136,0.0,70.0,68.0
153376.0,17,2,180,1,90,0.0,90.0,90.0,1,90,0.0,90.0,90.0
322396.0,6,6,412,4,272,107465.33333333331,74.0,68.0,2,140,0.0,74.0,70.0
130066.0,6,3,337,2,214,0.0,160.0,107.0,1,123,0.0,123.0,123.0
187014.0,17,2,180,1,90,0.0,90.0,90.0,1,90,0.0,90.0,90.0
331.0,17,2,166,1,75,0.0,75.0,75.0,1,91,0.0,91.0,91.0
243730.0,6,3,337,2,214,0.0,160.0,107.0,1,123,0.0,123.0,123.0
76523047.0,17,14,4788,14,4788,5886388.230769231,342.0,342.0,0,0,0.0,0.0,0.0
110990838.0,6,35,2542,18,1348,6516168.470588235,139.0,74.88888888888889,17,1194,6923426.8125,123.0,70.23529411764706
12156.0,6,13,1459,7,862,1831.8333333333333,271.0,123.14285714285714,6,597,2250.2,259.0,99.5
207686.0,6,3,426,2,280,0.0,214.0,140.0,1,146,0.0,146.0,146.0
120004586.0,6,24,1842,12,989,10909507.818181818,153.0,82.41666666666667,12,853,10887059.0,95.0,71.08333333333333
9655.0,17,2,571,1,86,0.0,86.0,86.0,1,485,0.0,485.0,485.0
101126314.0,17,14,864,7,432,16833494.166666668,174.0,61.71428571428572,7,432,16834094.166666668,174.0,61.71428571428572
2303.0,17,4,344,2,150,0.0,75.0,75.0,2,194,0.0,103.0,97.0
1230403.0,6,11,1134,6,558,246080.6,220.0,93.0,5,576,306535.25,304.0,115.2
15778.0,17,4,823,2,163,0.0,89.0,81.5,2,660,0.0,443.0,330.0
1302484.0,6,4,264,2,132,0.0,66.0,66.0,2,132,0.0,66.0,66.0
58848779.0,17,8,2744,7,2394,5958466.666666667,342.0,342.0,1,350,0.0,350.0,350.0
137776.0,6,2,132,1,66,0.0,66.0,66.0,1,66,0.0,66.0,66.0
100529565.0,17,12,516,6,258,20000152.8,43.0,43.0,6,258,20000933.0,43.0,43.0
307060.0,6,6,412,4,272,102353.33333333331,74.0,68.0,2,140,0.0,74.0,70.0
122292.0,6,3,373,2,238,0.0,172.0,119.0,1,135,0.0,135.0,135.0
245000.0,6,4,439,2,238,0.0,172.0,119.0,2,201,0.0,135.0,100.5
90309055.0,6,12,1832,8,1016,12901293.57142857,188.0,127.0,4,816,30048800.33333333,204.0,204.0
119499178.0,6,31,2371,14,1084,9172917.76923077,95.0,77.42857142857143,17,1287,7457502.8125,95.0,75.70588235294117
147984.0,17,2,180,1,90,0.0,90.0,90.0,1,90,0.0,90.0,90.0
2601895.0,6,2,132,1,66,0.0,66.0,66.0,1,66,0.0,66.0,66.0
97766.0,17,2,762,2,762,0.0,381.0,381.0,0,0,0.0,0.0,0.0
90302634.0,6,22,1680,12,935,8204813.909090909,95.0,77.91666666666667,10,745,9948782.444444444,95.0,74.5
115281155.0,6,199,22614,100,15858,1164456.111111111,284.0,158.58,99,6756,1165581.0408163266,140.0,68.24242424242425
90251760.0,6,12,1832,8,1016,12893108.57142857,188.0,127.0,4,816,30030236.0,204.0,204.0
37396.0,6,14,4740,7,653,5911.5,249.0,93.28571428571428,7,4087,5781.666666666667,1514.0,583.8571428571429
64685.99999999999,6,14,4740,7,653,10533.5,249.0,93.28571428571428,7,4087,10117.333333333334,1514.0,583.8571428571429
206946.0,6,3,426,2,280,0.0,214.0,140.0,1,146,0.0,146.0,146.0
35722.0,6,14,4740,7,653,5627.333333333333,249.0,93.28571428571428,7,4087,4561.5,1514.0,583.8571428571429
1506.0,17,2,762,2,762,0.0,381.0,381.0,0,0,0.0,0.0,0.0
38206.0,6,10,2032,5,524,9320.0,252.0,104.8,5,1508,8777.5,1236.0,301.6
90093488.0,6,12,1848,5,1020,22522772.0,204.0,204.0,7,828,15015179.666666666,188.0,118.28571428571428
90063928.0,17,28,13364,28,13364,3335701.037037037,501.0,477.2857142857143,0,0,0.0,0.0,0.0
46975.0,6,14,4740,7,653,7700.5,249.0,93.28571428571428,7,4087,7325.166666666667,1514.0,583.8571428571429
113619525.0,6,48,3168,24,1584,4939979.347826087,66.0,66.0,24,1584,4928138.347826087,66.0,66.0
107840413.0,6,28,1860,14,966,8278800.384615385,123.0,69.0,14,894,8278800.692307692,123.0,63.85714285714285
5624402.0,6,4,270,2,134,0.0,68.0,67.0,2,136,0.0,70.0,68.0
42303.0,6,14,4740,7,653,6916.5,249.0,93.28571428571428,7,4087,6837.333333333333,1514.0,583.8571428571429
53016.0,6,13,1479,7,882,8836.0,291.0,126.0,6,597,8858.2,259.0,99.5
2322.0,17,4,344,2,150,0.0,75.0,75.0,2,194,0.0,103.0,97.0
99935665.0,6,193,21730,97,6624,1040996.5104166666,140.0,68.28865979381443,96,15106,1041006.4315789472,284.0,157.35416666666666
113255936.0,6,46,3036,23,1518,5135443.227272728,66.0,66.0,23,1518,5135617.727272728,66.0,66.0
19287.0,6,11,2098,6,590,3534.0,252.0,98.33333333333331,5,1508,4195.5,1236.0,301.6
95264656.0,17,12,778,6,389,19021147.2,174.0,64.83333333333333,6,389,19020563.4,174.0,64.83333333333333
103392246.0,17,14,864,7,432,17166846.166666668,174.0,61.71428571428572,7,432,17163425.666666668,174.0,61.71428571428572
204870.0,17,2,762,2,762,0.0,381.0,381.0,0,0,0.0,0.0,0.0
104104688.0,6,44,2904,22,1452,4957366.095238095,66.0,66.0,22,1452,4942492.285714285,66.0,66.0
6442.0,17,2,174,1,79,0.0,79.0,79.0,1,95,0.0,95.0,95.0
1492238.0,6,7,499,3,198,716246.0,66.0,66.0,4,301,447993.6666666667,103.0,75.25
108440140.0,6,31,2160,16,1071,7229314.4,123.0,66.9375,15,1089,7032368.357142857,123.0,72.6
103922.0,17,2,286,2,286,0.0,143.0,143.0,0,0,0.0,0.0,0.0
23123.0,6,14,4740,7,653,3581.333333333333,249.0,93.28571428571428,7,4087,3716.6666666666665,1514.0,583.8571428571429
21829.0,6,10,2032,5,524,4802.5,252.0,104.8,5,1508,4808.5,1236.0,301.6
2387.0,17,4,344,2,150,0.0,75.0,75.0,2,194,0.0,103.0,97.0
90291069.0,6,16,1192,8,596,12892593.57142857,95.0,74.5,8,596,12898314.57142857,95.0,74.5
1822.0,17,2,176,1,80,0.0,80.0,80.0,1,96,0.0,96.0,96.0
120505236.0,6,34,2488,18,1348,7088543.294117647,139.0,74.88888888888889,16,1140,7354409.133333334,123.0,71.25
104246.0,17,2,286,2,286,0.0,143.0,143.0,0,0,0.0,0.0,0.0
108109.0,17,2,286,2,286,0.0,143.0,143.0,0,0,0.0,0.0,0.0
103458.0,17,2,286,2,286,0.0,143.0,143.0,0,0,0.0,0.0,0.0
1306260.0,6,4,264,2,132,0.0,66.0,66.0,2,132,0.0,66.0,66.0
2375.0,17,4,344,2,150,0.0,75.0,75.0,2,194,0.0,103.0,97.0
54355.0,6,14,4740,7,653,7152.333333333333,249.0,93.28571428571428,7,4087,8574.0,1514.0,583.8571428571429
8913.0,6,11,2041,6,533,1593.0,195.0,88.83333333333333,5,1508,1566.5,1236.0,301.6
108098881.0,17,5,955,5,955,27024720.25,191.0,191.0,0,0,0.0,0.0,0.0
166944.0,17,4,704,2,148,0.0,74.0,74.0,2,556,0.0,280.0,278.0
92752540.0,6,689,138582,343,23094,268791.91812865494,214.0,67.32944606413994,346,115488,268772.26376811595,1514.0,333.78034682080926
100999264.0,6,199,22470,100,6822,1020194.585858586,140.0,68.22,99,15648,1020119.9795918368,284.0,158.06060606060606
10470480.0,6,7,478,4,272,3444744.333333333,74.0,68.0,3,206,5167023.0,74.0,68.66666666666667
2164074.0,6,25,7610,13,2516,180279.8333333333,1034.0,193.53846153846155,12,5094,168589.0,1510.0,424.5
12597.0,6,11,1132,6,556,2279.0,218.0,92.66666666666669,5,576,2347.5,304.0,115.2
92241356.0,17,16,5472,16,5472,6149423.733333333,342.0,342.0,0,0,0.0,0.0,0.0
311.0,17,2,174,1,79,0.0,79.0,79.0,1,95,0.0,95.0,95.0
3244390.0,6,3,1777,2,951,0.0,885.0,475.5,1,826,0.0,826.0,826.0
108105359.0,17,5,955,5,955,27026339.75,191.0,191.0,0,0,0.0,0.0,0.0
216337.0,17,2,180,1,90,0.0,90.0,90.0,1,90,0.0,90.0,90.0
90046065.0,17,27,12943,27,12943,3463310.1923076925,501.0,479.3703703703704,0,0,0.0,0.0,0.0
2046493.0,17,8,1640,4,312,681992.0000000001,78.0,78.0,4,1328,682024.6666666667,332.0,332.0
196822.0,17,2,180,1,90,0.0,90.0,90.0,1,90,0.0,90.0,90.0
14632861.0,6,20,1605,10,973,1592402.6666666667,315.0,97.3,10,632,1592374.888888889,78.0,63.2
299.0,17,2,168,1,76,0.0,76.0,76.0,1,92,0.0,92.0,92.0
51939.0,6,14,4740,7,653,8530.5,249.0,93.28571428571428,7,4087,8448.333333333334,1514.0,583.8571428571429
213613.0,17,2,180,1,90,0.0,90.0,90.0,1,90,0.0,90.0,90.0
148027.0,17,2,180,1,90,0.0,90.0,90.0,1,90,0.0,90.0,90.0
5832913.0,6,5,336,2,134,0.0,68.0,67.0,3,202,1523091.0,70.0,67.33333333333333
108109598.0,17,5,955,5,955,27027399.5,191.0,191.0,0,0,0.0,0.0,0.0
217654.0,6,3,426,2,280,0.0,214.0,140.0,1,146,0.0,146.0,146.0
120123139.0,6,13,2020,9,1204,15015392.375,188.0,133.77777777777777,4,816,30036532.33333333,204.0,204.0
360.0,17,2,160,1,80,0.0,80.0,80.0,1,80,0.0,80.0,80.0
138956.0,6,2,132,1,66,0.0,66.0,66.0,1,66,0.0,66.0,66.0
263187.0,6,10,1221,6,636,52637.4,298.0,106.0,4,585,82325.33333333333,379.0,146.25
43896.0,6,10,2032,5,524,10753.25,252.0,104.8,5,1508,10092.25,1236.0,301.6
134309.0,6,2,132,1,66,0.0,66.0,66.0,1,66,0.0,66.0,66.0
120104233.0,6,35,2410,18,1285,7064954.882352941,139.0,71.38888888888889,17,1125,6868902.6875,123.0,66.17647058823529
112607188.0,6,48,3168,24,1584,4895964.695652174,66.0,66.0,24,1584,4889737.434782608,66.0,66.0
312183.0,17,4,1400,4,1400,104061.0,350.0,350.0,0,0,0.0,0.0,0.0
31072.0,6,14,4740,7,653,3438.6666666666665,249.0,93.28571428571428,7,4087,5018.666666666667,1514.0,583.8571428571429
959891.0,6,2,132,1,66,0.0,66.0,66.0,1,66,0.0,66.0,66.0
46784.0,6,14,4740,7,653,7667.0,249.0,93.28571428571428,7,4087,7578.666666666667,1514.0,583.8571428571429
0.0,17,1,90,1,90,0.0,90.0,90.0,0,0,0.0,0.0,0.0
300127.0,6,6,412,4,272,100042.33333333331,74.0,68.0,2,140,0.0,74.0,70.0
90256589.0,6,12,1832,8,1016,12893798.42857143,188.0,127.0,4,816,30018840.33333333,204.0,204.0
37358.0,6,10,2032,5,524,9125.5,252.0,104.8,5,1508,9076.75,1236.0,301.6
16557.0,6,10,1065,5,534,3807.0,262.0,106.8,5,531,2352.25,259.0,106.2
258638.0,6,3,337,2,214,0.0,160.0,107.0,1,123,0.0,123.0,123.0
108106290.0,17,5,955,5,955,27026572.5,191.0,191.0,0,0,0.0,0.0,0.0
46351.0,6,14,4740,7,653,7523.5,249.0,93.28571428571428,7,4087,7502.166666666667,1514.0,583.8571428571429
27771.0,6,14,4740,7,653,4457.666666666667,249.0,93.28571428571428,7,4087,4396.666666666667,1514.0,583.8571428571429
10609463.0,6,6,412,3,206,5214428.0,74.0,68.66666666666667,3,206,5214335.5,74.0,68.66666666666667
216412.0,17,2,180,1,90,0.0,90.0,90.0,1,90,0.0,90.0,90.0
312.0,17,2,174,1,79,0.0,79.0,79.0,1,95,0.0,95.0,95.0
1303614.0,6,4,264,2,132,0.0,66.0,66.0,2,132,0.0,66.0,66.0
90414.0,6,14,4740,7,653,14846.0,249.0,93.28571428571428,7,4087,14916.0,1514.0,583.8571428571429
306874.0,6,6,412,4,272,102291.33333333331,74.0,68.0,2,140,0.0,74.0,70.0
205758.0,17,2,180,1,90,0.0,90.0,90.0,1,90,0.0,90.0,90.0
32681553.0,6,5,336,2,134,0.0,68.0,67.0,3,202,15052928.5,70.0,67.33333333333333
22637.0,6,14,4740,7,653,3467.833333333333,249.0,93.28571428571428,7,4087,3585.5,1514.0,583.8571428571429
5627586.0,6,5,336,2,134,0.0,68.0,67.0,3,202,1525175.0,70.0,67.33333333333333
2674830.0,6,25,7573,14,3735,205756.15384615384,1514.0,266.7857142857143,11,3838,240702.3,1514.0,348.90909090909093
2081829.0,6,19,6869,10,1501,231314.3333333333,408.0,150.1,9,5368,213585.0,1514.0,596.4444444444445
90602544.0,6,26,1762,13,922,7531540.5,139.0,70.92307692307692,13,840,7531221.166666667,123.0,64.61538461538461
2030.0,17,4,344,2,150,0.0,75.0,75.0,2,194,0.0,103.0,97.0
14996.0,17,2,180,1,90,0.0,90.0,90.0,1,90,0.0,90.0,90.0
284758.0,17,2,363,1,79,0.0,79.0,79.0,1,284,0.0,284.0,284.0
109137434.0,17,14,1126,7,563,18162888.83333333,174.0,80.42857142857143,7,563,18162887.0,174.0,80.42857142857143
101820737.0,6,28,1876,14,982,7815753.230769231,139.0,70.14285714285714,14,894,7815758.384615385,123.0,63.85714285714285
1441927.0,6,8,602,3,198,203384.5,66.0,66.0,5,404,337501.25,103.0,80.8
90056856.0,17,28,13364,28,13364,3335439.111111111,501.0,477.2857142857143,0,0,0.0,0.0,0.0
30453.0,6,14,4740,7,653,4849.166666666667,249.0,93.28571428571428,7,4087,4893.666666666667,1514.0,583.8571428571429
216865.0,6,3,426,2,280,0.0,214.0,140.0,1,146,0.0,146.0,146.0
247187.0,6,3,337,2,214,0.0,160.0,107.0,1,123,0.0,123.0,123.0
53723.0,6,14,4740,7,653,8821.5,249.0,93.28571428571428,7,4087,8381.5,1514.0,583.8571428571429
327.0,17,2,174,1,79,0.0,79.0,79.0,1,95,0.0,95.0,95.0
1873.0,17,2,192,1,88,0.0,88.0,88.0,1,104,0.0,104.0,104.0
228538.0,17,2,180,1,90,0.0,90.0,90.0,1,90,0.0,90.0,90.0
204504.0,17,2,762,2,762,0.0,381.0,381.0,0,0,0.0,0.0,0.0
119809015.0,17,35,16705,35,16705,3523794.5588235296,501.0,477.2857142857143,0,0,0.0,0.0,0.0
197068.0,17,2,180,1,90,0.0,90.0,90.0,1,90,0.0,90.0,90.0
299062.0,6,6,412,4,272,99687.33333333331,74.0,68.0,2,140,0.0,74.0,70.0
244212.0,6,3,373,2,238,0.0,172.0,119.0,1,135,0.0,135.0,135.0
120124644.0,6,14,2224,9,1204,15015580.5,188.0,133.77777777777777,5,1020,22592004.0,204.0,204.0
92828537.0,6,187,21064,94,6352,998156.3118279568,140.0,67.57446808510639,93,14712,997678.3695652174,284.0,158.19354838709677
196815.0,17,2,180,1,90,0.0,90.0,90.0,1,90,0.0,90.0,90.0
90296517.0,6,23,1861,12,894,8204694.636363637,95.0,74.5,11,967,9000186.9,222.0,87.9090909090909
10417893.0,6,6,412,3,206,5141118.5,74.0,68.66666666666667,3,206,5141057.0,74.0,68.66666666666667
215364.0,17,2,180,1,90,0.0,90.0,90.0,1,90,0.0,90.0,90.0
205962.0,17,2,180,1,90,0.0,90.0,90.0,1,90,0.0,90.0,90.0
218486.0,6,4,492,2,280,0.0,214.0,140.0,2,212,0.0,146.0,106.0
163944.0,17,4,1524,4,1524,54648.0,381.0,381.0,0,0,0.0,0.0,0.0
213267.0,6,3,426,2,280,0.0,214.0,140.0,1,146,0.0,146.0,146.0
309581.0,17,4,622,4,622,103193.66666666669,163.0,155.5,0,0,0.0,0.0,0.0
192778.0,17,2,180,1,90,0.0,90.0,90.0,1,90,0.0,90.0,90.0
139953.0,6,11,1132,6,556,26533.0,218.0,92.66666666666669,5,576,34783.0,304.0,115.2
2360.0,17,4,344,2,150,0.0,75.0,75.0,2,194,0.0,103.0,97.0
229691.0,6,3,426,2,280,0.0,214.0,140.0,1,146,0.0,146.0,146.0
123250512.0,6,49,3234,25,1650,5135438.0,66.0,66.0,24,1584,5029326.217391305,66.0,66.0
120123659.0,6,13,2020,9,1204,15015457.375,188.0,133.77777777777777,4,816,30028532.33333333,204.0,204.0
135127657.0,17,6,1146,6,1146,27025531.4,191.0,191.0,0,0,0.0,0.0,0.0
333.0,17,2,166,1,75,0.0,75.0,75.0,1,91,0.0,91.0,91.0
112935417.0,6,30,1974,15,1026,8051397.357142857,123.0,68.4,15,948,8051397.5,123.0,63.2
90262809.0,6,12,1832,8,1016,12894687.0,188.0,127.0,4,816,30031860.33333333,204.0,204.0
34957.0,6,14,4740,7,653,5612.833333333333,249.0,93.28571428571428,7,4087,5695.0,1514.0,583.8571428571429
47140.0,6,11,2098,6,590,8998.4,252.0,98.33333333333331,5,1508,11383.5,1236.0,301.6
241279.0,6,3,337,2,214,0.0,160.0,107.0,1,123,0.0,123.0,123.0
90025281.0,17,28,13364,28,13364,3334269.6666666665,501.0,477.2857142857143,0,0,0.0,0.0,0.0
100397636.0,17,12,516,6,258,20001023.2,43.0,43.0,6,258,20000161.4,43.0,43.0
116882006.0,6,240,27284,120,19068,982201.7310924368,284.0,158.9,120,8216,980357.3613445378,140.0,68.46666666666667
123368339.0,6,48,3168,25,1650,5140347.458333333,66.0,66.0,23,1518,5135455.136363637,66.0,66.0
1312267.0,17,7,490,7,490,218711.16666666663,70.0,70.0,0,0,0.0,0.0,0.0
2297.0,17,4,344,2,150,0.0,75.0,75.0,2,194,0.0,103.0,97.0
317.0,17,2,174,1,79,0.0,79.0,79.0,1,95,0.0,95.0,95.0
155210.0,17,4,1524,4,1524,51736.66666666666,381.0,381.0,0,0,0.0,0.0,0.0
63741.00000000001,6,14,4740,7,653,7768.833333333333,249.0,93.28571428571428,7,4087,10236.5,1514.0,583.8571428571429
3092446.0,6,159,127335,90,118479,34725.29213483146,1510.0,1316.4333333333334,69,8856,41079.882352941175,1510.0,128.34782608695653
34779.0,6,14,4740,7,653,5668.666666666667,249.0,93.28571428571428,7,4087,5659.666666666667,1514.0,583.8571428571429
61629.0,6,14,4740,7,653,9650.333333333334,249.0,93.28571428571428,7,4087,9261.5,1514.0,583.8571428571429
1302576.0,6,4,264,2,132,0.0,66.0,66.0,2,132,0.0,66.0,66.0
1766474.0,6,2,132,1,66,0.0,66.0,66.0,1,66,0.0,66.0,66.0
108240.0,17,2,286,2,286,0.0,143.0,143.0,0,0,0.0,0.0,0.0
135131387.0,17,6,1146,6,1146,27026277.4,191.0,191.0,0,0,0.0,0.0,0.0
1651372.0,6,8,602,5,404,386744.75,103.0,80.8,3,198,205031.0,66.0,66.0
205804.0,17,2,180,1,90,0.0,90.0,90.0,1,90,0.0,90.0,90.0
5618528.0,6,5,336,2,134,0.0,68.0,67.0,3,202,1524245.0,70.0,67.33333333333333
60026.0,6,10,2032,5,524,14371.0,252.0,104.8,5,1508,14234.0,1236.0,301.6
247000.0,6,3,337,2,214,0.0,160.0,107.0,1,123,0.0,123.0,123.0
324.0,17,2,208,1,72,0.0,72.0,72.0,1,136,0.0,136.0,136.0
224570.0,17,2,414,1,88,0.0,88.0,88.0,1,326,0.0,326.0,326.0
221240.0,6,3,426,2,280,0.0,214.0,140.0,1,146,0.0,146.0,146.0
1851.0,17,4,344,2,150,0.0,75.0,75.0,2,194,0.0,103.0,97.0
320516.0,6,6,412,4,272,106838.66666666669,74.0,68.0,2,140,0.0,74.0,70.0
1713786.0,6,23,6509,12,1529,155798.72727272726,357.0,127.41666666666669,11,4980,140461.6,1510.0,452.7272727272728
584232.0,6,4,508,2,238,0.0,172.0,119.0,2,270,0.0,135.0,135.0
108101036.0,17,5,955,5,955,27025259.0,191.0,191.0,0,0,0.0,0.0,0.0
135137159.0,17,6,1206,6,1206,27027431.8,201.0,201.0,0,0,0.0,0.0,0.0
308967.0,6,6,412,4,272,102989.0,74.0,68.0,2,140,0.0,74.0,70.0
102287.0,17,4,1400,4,1400,34095.666666666664,350.0,350.0,0,0,0.0,0.0,0.0
90279744.0,6,14,1043,7,542,15046624.0,95.0,77.42857142857143,7,501,15000432.833333334,95.0,71.57142857142857
41427.0,6,14,4740,7,653,6792.0,249.0,93.28571428571428,7,4087,5673.5,1514.0,583.8571428571429
84573.0,6,10,2032,5,524,17806.75,252.0,104.8,5,1508,20178.0,1236.0,301.6
106846.0,17,2,286,2,286,0.0,143.0,143.0,0,0,0.0,0.0,0.0
5007694.0,17,4,849,2,166,0.0,83.0,83.0,2,683,0.0,499.0,341.5
101765.0,6,10,2032,5,524,23354.0,252.0,104.8,5,1508,23250.25,1236.0,301.6
300461.0,6,6,412,4,272,100153.66666666669,74.0,68.0,2,140,0.0,74.0,70.0
99014466.0,17,14,1126,7,563,16501081.5,174.0,80.42857142857143,7,563,16500156.333333334,174.0,80.42857142857143
14641908.0,6,20,1730,10,1098,1592601.5555555555,315.0,109.8,10,632,1592591.2222222222,78.0,63.2
113574220.0,6,206,23186,103,16092,1111282.068627451,284.0,156.23300970873785,103,7094,1111379.9901960783,140.0,68.87378640776699
18034.0,17,3,1026,3,1026,9017.0,342.0,342.0,0,0,0.0,0.0,0.0
17851.0,6,11,1133,6,602,3570.2,264.0,100.33333333333331,5,531,3333.5,259.0,106.2
2422.0,17,4,344,2,150,0.0,75.0,75.0,2,194,0.0,103.0,97.0
871030.0,6,10,1333,6,796,174206.0,458.0,132.66666666666666,4,537,198562.66666666663,331.0,134.25
135131777.0,17,6,1146,6,1146,27026355.4,191.0,191.0,0,0,0.0,0.0,0.0
102092745.0,17,14,864,7,432,17001462.5,174.0,61.71428571428572,7,432,17000175.5,174.0,61.71428571428572
74887.0,6,14,4740,7,653,11530.333333333334,249.0,93.28571428571428,7,4087,11966.833333333334,1514.0,583.8571428571429
321450.0,17,4,1400,4,1400,107150.0,350.0,350.0,0,0,0.0,0.0,0.0
2044003.0,17,8,1640,4,312,681205.3333333334,78.0,78.0,4,1328,681145.3333333334,332.0,332.0
120145884.0,6,635,84246,318,21210,379009.0977917981,140.0,66.69811320754717,317,63036,376972.0284810127,390.0,198.85173501577287
10931.0,6,10,1065,5,534,2505.75,262.0,106.8,5,531,2304.25,259.0,106.2
90051481.0,17,28,13364,28,13364,3335240.037037037,501.0,477.2857142857143,0,0,0.0,0.0,0.0
241917.0,6,3,337,2,214,0.0,160.0,107.0,1,123,0.0,123.0,123.0
35873.0,6,10,2032,5,524,8723.25,252.0,104.8,5,1508,8434.5,1236.0,301.6
0.0,17,1,44,1,44,0.0,44.0,44.0,0,0,0.0,0.0,0.0
301169.0,6,6,412,4,272,100389.66666666669,74.0,68.0,2,140,0.0,74.0,70.0
153480.0,17,2,180,1,90,0.0,90.0,90.0,1,90,0.0,90.0,90.0
108099230.0,17,5,955,5,955,27024807.5,191.0,191.0,0,0,0.0,0.0,0.0
10516897.0,6,7,478,4,272,3459962.0,74.0,68.0,3,206,5189860.0,74.0,68.66666666666667
121766.0,6,3,337,2,214,0.0,160.0,107.0,1,123,0.0,123.0,123.0
166421.0,17,2,180,1,90,0.0,90.0,90.0,1,90,0.0,90.0,90.0
5622296.0,6,4,270,2,134,0.0,68.0,67.0,2,136,0.0,70.0,68.0
114146724.0,6,246,27780,123,8340,928908.7459016392,140.0,67.8048780487805,123,19440,928803.4590163934,300.0,158.0487804878049
124352.0,6,14,4740,7,653,17353.666666666668,249.0,93.28571428571428,7,4087,18082.166666666668,1514.0,583.8571428571429
98372.0,17,2,762,2,762,0.0,381.0,381.0,0,0,0.0,0.0,0.0
2598643.0,6,2,132,1,66,0.0,66.0,66.0,1,66,0.0,66.0,66.0
5645221.0,6,5,336,2,134,0.0,68.0,67.0,3,202,1537295.0,70.0,67.33333333333333
259322.0,6,10,1221,6,636,51864.4,298.0,106.0,4,585,80662.33333333333,379.0,146.25
2804449.0,6,2,132,1,66,0.0,66.0,66.0,1,66,0.0,66.0,66.0
90041158.0,17,28,13364,28,13364,3334857.703703704,501.0,477.2857142857143,0,0,0.0,0.0,0.0
34051.0,6,10,2032,5,524,4885.0,252.0,104.8,5,1508,7533.75,1236.0,301.6
121768518.0,17,14,864,7,432,17006981.833333332,174.0,61.71428571428572,7,432,17000781.166666668,174.0,61.71428571428572
37437.0,6,14,4740,7,653,5954.166666666667,249.0,93.28571428571428,7,4087,5758.5,1514.0,583.8571428571429
120040347.0,17,29,13785,29,13785,4287155.25,501.0,475.3448275862069,0,0,0.0,0.0,0.0
321.0,17,2,168,1,76,0.0,76.0,76.0,1,92,0.0,92.0,92.0
41305.0,6,14,4740,7,653,6671.0,249.0,93.28571428571428,7,4087,6738.833333333333,1514.0,583.8571428571429
41963.0,6,14,4740,7,653,6139.333333333333,249.0,93.28571428571428,7,4087,5312.833333333333,1514.0,583.8571428571429
119316517.0,6,219,24690,110,17274,1094646.9449541285,284.0,157.03636363636363,109,7416,1095045.4074074074,140.0,68.03669724770643
931046.0,6,12,2715,7,743,155174.33333333334,339.0,106.14285714285714,5,1972,163790.25,1514.0,394.4
152235.0,17,2,414,1,88,0.0,88.0,88.0,1,326,0.0,326.0,326.0
124262784.0,6,30,1974,15,948,8162682.5,123.0,63.2,15,1026,8162674.5,123.0,68.4
90073268.0,17,28,13364,28,13364,3336046.962962963,501.0,477.2857142857143,0,0,0.0,0.0,0.0
29815.0,6,10,2032,5,524,6706.75,252.0,104.8,5,1508,7185.0,1236.0,301.6
300936.0,6,6,412,4,272,100312.0,74.0,68.0,2,140,0.0,74.0,70.0
301845.0,6,6,412,4,272,100615.0,74.0,68.0,2,140,0.0,74.0,70.0
9362314.0,17,3,1034,2,684,0.0,342.0,342.0,1,350,0.0,350.0,350.0
397.0,17,2,410,1,78,0.0,78.0,78.0,1,332,0.0,332.0,332.0
72812.0,6,14,4740,7,653,12025.5,249.0,93.28571428571428,7,4087,11039.833333333334,1514.0,583.8571428571429
91135931.0,6,22,1680,10,745,10126214.555555556,95.0,74.5,12,935,8262449.363636363,95.0,77.91666666666667
103834.0,17,2,700,2,700,0.0,350.0,350.0,0,0,0.0,0.0,0.0
106807.0,17,2,286,2,286,0.0,143.0,143.0,0,0,0.0,0.0,0.0
29913.0,6,14,4740,7,653,4860.333333333333,249.0,93.28571428571428,7,4087,4712.166666666667,1514.0,583.8571428571429
133923.0,6,2,132,1,66,0.0,66.0,66.0,1,66,0.0,66.0,66.0
90528808.0,6,14,2240,8,1016,12932686.857142856,188.0,127.0,6,1224,18073134.0,204.0,204.0
135141944.0,17,6,1146,6,1146,27028388.8,191.0,191.0,0,0,0.0,0.0,0.0
113257310.0,6,46,3036,23,1518,5135439.409090909,66.0,66.0,23,1518,5135543.409090909,66.0,66.0
207202.0,6,3,426,2,280,0.0,214.0,140.0,1,146,0.0,146.0,146.0
247234.0,6,3,337,2,214,0.0,160.0,107.0,1,123,0.0,123.0,123.0
139281.0,17,4,344,2,150,0.0,75.0,75.0,2,194,0.0,103.0,97.0
146094.0,6,3,337,2,214,0.0,160.0,107.0,1,123,0.0,123.0,123.0
1308646.0,6,4,264,2,132,0.0,66.0,66.0,2,132,0.0,66.0,66.0
338.0,17,2,166,1,75,0.0,75.0,75.0,1,91,0.0,91.0,91.0
233738.0,6,3,337,2,214,0.0,160.0,107.0,1,123,0.0,123.0,123.0
109800966.0,6,32,2236,16,1165,7305674.533333333,139.0,72.8125,16,1071,7305653.733333333,123.0,66.9375
105531.0,17,2,286,2,286,0.0,143.0,143.0,0,0,0.0,0.0,0.0
234393.0,6,3,337,2,214,0.0,160.0,107.0,1,123,0.0,123.0,123.0
3118335.0,6,3,1604,1,753,0.0,753.0,753.0,2,851,0.0,785.0,425.5
125287530.0,6,34,2419,18,1348,7369854.705882353,139.0,74.88888888888889,16,1071,7825497.866666666,123.0,66.9375
49336.0,6,14,4740,7,653,8094.833333333333,249.0,93.28571428571428,7,4087,5911.0,1514.0,583.8571428571429
39717.0,6,10,2032,5,524,9588.75,252.0,104.8,5,1508,8469.25,1236.0,301.6
90534769.0,6,14,2240,8,1016,12933538.42857143,188.0,127.0,6,1224,18074073.8,204.0,204.0
38472.0,6,14,4740,7,653,6086.666666666667,249.0,93.28571428571428,7,4087,5919.666666666667,1514.0,583.8571428571429
881568.0,6,12,2714,7,742,146928.0,338.0,106.0,5,1972,151458.5,1514.0,394.4
120064096.0,17,29,13785,29,13785,4288003.428571428,501.0,475.3448275862069,0,0,0.0,0.0,0.0
18470.0,6,10,1810,5,358,4030.0,130.0,71.6,5,1452,4181.25,1224.0,290.4
146354.0,6,3,337,2,214,0.0,160.0,107.0,1,123,0.0,123.0,123.0
348.0,17,2,267,1,83,0.0,83.0,83.0,1,184,0.0,184.0,184.0
216513.0,17,2,180,1,90,0.0,90.0,90.0,1,90,0.0,90.0,90.0
234443.0,6,3,337,2,214,0.0,160.0,107.0,1,123,0.0,123.0,123.0
108102968.0,17,5,1005,5,1005,27025742.0,201.0,201.0,0,0,0.0,0.0,0.0
205275.0,17,2,762,2,762,0.0,381.0,381.0,0,0,0.0,0.0,0.0
6772.0,17,2,582,1,83,0.0,83.0,83.0,1,499,0.0,499.0,499.0
90025837.0,17,27,12943,27,12943,3462532.1923076925,501.0,479.3703703703704,0,0,0.0,0.0,0.0
233842.0,6,3,373,2,238,0.0,172.0,119.0,1,135,0.0,135.0,135.0
31508.0,6,14,4740,7,653,5056.166666666667,249.0,93.28571428571428,7,4087,4912.666666666667,1514.0,583.8571428571429
5681611.0,6,91,96685,25,1816,236733.79166666663,212.0,72.64,66,94869,87361.47692307692,1514.0,1437.409090909091
14083980.0,17,6,2052,6,2052,2816796.0,342.0,342.0,0,0,0.0,0.0,0.0
13779.0,6,11,2098,6,590,2480.6,252.0,98.33333333333331,5,1508,3029.5,1236.0,301.6
106058275.0,6,31,2166,16,1149,7056163.266666667,123.0,71.8125,15,1017,7560169.642857143,123.0,67.8
43732.0,6,10,2032,5,524,10664.75,252.0,104.8,5,1508,9567.25,1236.0,301.6
90305852.0,6,16,1192,8,596,12893557.57142857,95.0,74.5,8,596,12900450.857142856,95.0,74.5
499862.0,17,2,363,1,79,0.0,79.0,79.0,1,284,0.0,284.0,284.0
90278413.0,6,17,1287,9,691,11279551.75,95.0,76.77777777777777,8,596,12896118.0,95.0,74.5
96194145.0,6,180,20316,90,14154,1078411.7528089888,284.0,157.26666666666668,90,6162,1078414.191011236,140.0,68.46666666666667
103363.0,17,2,286,2,286,0.0,143.0,143.0,0,0,0.0,0.0,0.0
2386.0,17,4,344,2,150,0.0,75.0,75.0,2,194,0.0,103.0,97.0
94302444.0,6,39,2574,20,1320,4951925.052631579,66.0,66.0,19,1254,5105438.111111111,66.0,66.0
108105287.0,17,5,1005,5,1005,27026321.75,201.0,201.0,0,0,0.0,0.0,0.0
90062744.0,17,28,13364,28,13364,3335657.185185185,501.0,477.2857142857143,0,0,0.0,0.0,0.0
101841.0,17,2,762,2,762,0.0,381.0,381.0,0,0,0.0,0.0,0.0
48665.0,6,14,4740,7,653,7966.333333333333,249.0,93.28571428571428,7,4087,7866.333333333333,1514.0,583.8571428571429
108108436.0,17,5,955,5,955,27027109.0,191.0,191.0,0,0,0.0,0.0,0.0
209668.0,17,2,180,1,90,0.0,90.0,90.0,1,90,0.0,90.0,90.0
320.0,17,2,166,1,75,0.0,75.0,75.0,1,91,0.0,91.0,91.0
755904.0,6,2,132,1,66,0.0,66.0,66.0,1,66,0.0,66.0,66.0
345.0,17,2,267,1,83,0.0,83.0,83.0,1,184,0.0,184.0,184.0
3344.0,17,2,346,1,78,0.0,78.0,78.0,1,268,0.0,268.0,268.0
122314540.0,6,48,3168,24,1584,4941978.695652174,66.0,66.0,24,1584,5265771.956521739,66.0,66.0
119689358.0,17,34,16284,34,16284,3626950.242424242,501.0,478.9411764705882,0,0,0.0,0.0,0.0
310155.0,17,4,1400,4,1400,103385.0,350.0,350.0,0,0,0.0,0.0,0.0
2383396.0,6,25,7573,14,3735,183338.15384615384,1514.0,266.7857142857143,11,3838,212208.2,1514.0,348.90909090909093
13807231.0,17,6,2052,6,2052,2761446.2,342.0,342.0,0,0,0.0,0.0,0.0
108100655.0,17,5,955,5,955,27025163.75,191.0,191.0,0,0,0.0,0.0,0.0
309621.0,17,4,1400,4,1400,103207.0,350.0,350.0,0,0,0.0,0.0,0.0
110513088.0,17,14,864,7,432,18333504.166666668,174.0,61.71428571428572,7,432,18335096.33333333,174.0,61.71428571428572
196789.0,17,2,180,1,90,0.0,90.0,90.0,1,90,0.0,90.0,90.0
135129733.0,17,6,1146,6,1146,27025946.6,191.0,191.0,0,0,0.0,0.0,0.0
50863.0,6,14,4740,7,653,8297.833333333334,249.0,93.28571428571428,7,4087,7323.0,1514.0,583.8571428571429
118042316.0,6,30,1974,15,1026,8416161.5,123.0,68.4,15,948,8416164.785714285,123.0,63.2
130776.0,6,3,337,2,214,0.0,160.0,107.0,1,123,0.0,123.0,123.0
19001.0,6,10,2032,5,524,4525.0,252.0,104.8,5,1508,3933.25,1236.0,301.6
122126.0,6,2,132,1,66,0.0,66.0,66.0,1,66,0.0,66.0,66.0
59470.0,6,14,4740,7,653,9406.0,249.0,93.28571428571428,7,4087,9645.0,1514.0,583.8571428571429
24132.0,6,10,2032,5,524,5803.75,252.0,104.8,5,1508,5787.5,1236.0,301.6
120021010.0,17,29,13785,29,13785,4286464.642857143,501.0,475.3448275862069,0,0,0.0,0.0,0.0
40256.0,6,14,4740,7,653,6383.833333333333,249.0,93.28571428571428,7,4087,6576.0,1514.0,583.8571428571429
123610585.0,6,49,3234,25,1650,5150441.041666667,66.0,66.0,24,1584,5087999.347826087,66.0,66.0
13186.0,6,10,1067,5,536,3073.25,264.0,107.2,5,531,2158.0,259.0,106.2
32611.0,6,10,1066,5,490,6361.25,218.0,98.0,5,576,7579.5,304.0,115.2
16900.0,6,11,1133,6,602,2879.4,264.0,100.33333333333331,5,531,3592.25,259.0,106.2
108092342.0,17,5,955,5,955,27023085.5,191.0,191.0,0,0,0.0,0.0,0.0
44641.0,6,14,4740,7,653,7274.5,249.0,93.28571428571428,7,4087,7156.666666666667,1514.0,583.8571428571429
41380.0,6,10,2032,5,524,6497.0,252.0,104.8,5,1508,9307.75,1236.0,301.6
306391.0,6,6,412,4,272,102130.33333333331,74.0,68.0,2,140,0.0,74.0,70.0
120912776.0,6,34,2488,18,1348,7112516.235294118,139.0,74.88888888888889,16,1140,7381603.933333334,123.0,71.25
5005968.0,17,4,849,2,166,0.0,83.0,83.0,2,683,0.0,499.0,341.5
146290.0,6,3,337,2,214,0.0,160.0,107.0,1,123,0.0,123.0,123.0
74568324.0,6,9,842,9,842,9321040.5,97.0,93.55555555555556,0,0,0.0,0.0,0.0
91387073.0,6,24,1829,13,989,7614694.416666667,95.0,76.07692307692308,11,840,9137739.9,95.0,76.36363636363636
320449.0,17,4,1400,4,1400,106816.33333333331,350.0,350.0,0,0,0.0,0.0,0.0
77936.0,6,14,4740,7,653,12749.0,249.0,93.28571428571428,7,4087,11889.166666666666,1514.0,583.8571428571429
133013.0,17,4,1524,4,1524,44337.66666666666,381.0,381.0,0,0,0.0,0.0,0.0
90291405.0,6,17,1287,9,691,11280538.625,95.0,76.77777777777777,8,596,12897244.285714284,95.0,74.5
71022.0,6,14,4740,7,653,11063.0,249.0,93.28571428571428,7,4087,11011.666666666666,1514.0,583.8571428571429
108135572.0,17,5,955,5,955,27033893.0,191.0,191.0,0,0,0.0,0.0,0.0
254883.00000000003,6,12,1373,7,714,42480.5,298.0,102.0,5,659,59396.25,379.0,131.8
206494.0,17,2,180,1,90,0.0,90.0,90.0,1,90,0.0,90.0,90.0
215378.0,17,2,180,1,90,0.0,90.0,90.0,1,90,0.0,90.0,90.0
57047.0,6,14,4740,7,653,9325.333333333334,249.0,93.28571428571428,7,4087,8463.166666666666,1514.0,583.8571428571429
23260.0,6,10,2032,5,524,5381.0,252.0,104.8,5,1508,5532.75,1236.0,301.6
340.0,17,2,160,1,80,0.0,80.0,80.0,1,80,0.0,80.0,80.0
24732.0,6,14,4740,7,653,3946.0,249.0,93.28571428571428,7,4087,3988.1666666666665,1514.0,583.8571428571429
2910935.0,6,3,204,2,136,0.0,70.0,68.0,1,68,0.0,68.0,68.0
121504733.0,6,31,2034,16,1086,8100315.533333333,123.0,67.875,15,948,7949861.428571428,123.0,63.2
113168242.0,6,46,3036,23,1518,5143999.954545454,66.0,66.0,23,1518,5143996.318181818,66.0,66.0
124505656.0,6,32,2220,16,1071,7634528.866666666,123.0,66.9375,16,1149,7634523.2,123.0,71.8125
70954.0,6,14,4740,7,653,11565.5,249.0,93.28571428571428,7,4087,11330.666666666666,1514.0,583.8571428571429
338.0,17,2,168,1,76,0.0,76.0,76.0,1,92,0.0,92.0,92.0
2340.0,17,4,344,2,150,0.0,75.0,75.0,2,194,0.0,103.0,97.0
20964.0,6,2,145,2,145,0.0,91.0,72.5,0,0,0.0,0.0,0.0
1311154.0,6,4,264,2,132,0.0,66.0,66.0,2,132,0.0,66.0,66.0
304.0,17,2,168,1,76,0.0,76.0,76.0,1,92,0.0,92.0,92.0
112979793.0,6,45,2970,23,1518,5135445.136363637,66.0,66.0,22,1452,4899041.952380952,66.0,66.0
6918.0,17,2,582,1,83,0.0,83.0,83.0,1,499,0.0,499.0,499.0
508815.0,6,5,336,2,134,0.0,68.0,67.0,3,202,191862.0,70.0,67.33333333333333
120234708.0,6,21,1585,10,786,13332892.222222222,95.0,78.6,11,799,11999002.1,95.0,72.63636363636364
323123.0,6,6,412,4,272,107707.66666666669,74.0,68.0,2,140,0.0,74.0,70.0
32184442.0,6,9,754,5,482,8006151.0,210.0,96.4,4,272,10674814.666666666,74.0,68.0
42688.0,6,10,2032,5,524,10348.25,252.0,104.8,5,1508,10027.75,1236.0,301.6
146140.0,6,3,337,2,214,0.0,160.0,107.0,1,123,0.0,123.0,123.0
146202.0,6,3,337,2,214,0.0,160.0,107.0,1,123,0.0,123.0,123.0
384.0,17,2,410,1,78,0.0,78.0,78.0,1,332,0.0,332.0,332.0
102790.0,17,2,762,2,762,0.0,381.0,381.0,0,0,0.0,0.0,0.0
2574939.0,6,2,132,1,66,0.0,66.0,66.0,1,66,0.0,66.0,66.0
119860762.0,17,34,16284,34,16284,3632144.303030303,501.0,478.9411764705882,0,0,0.0,0.0,0.0
33354.0,6,14,4740,7,653,4541.333333333333,249.0,93.28571428571428,7,4087,4581.666666666667,1514.0,583.8571428571429
135122438.0,17,6,1206,6,1206,27024487.6,201.0,201.0,0,0,0.0,0.0,0.0
90257247.0,6,12,1832,8,1016,12893892.42857143,188.0,127.0,4,816,30031042.0,204.0,204.0
297454.0,6,6,412,4,272,99151.33333333331,74.0,68.0,2,140,0.0,74.0,70.0
55291.0,6,13,1386,7,789,8961.666666666666,253.0,112.71428571428572,6,597,7480.8,259.0,99.5
10470601.0,6,7,478,4,272,3444634.333333333,74.0,68.0,3,206,5166825.0,74.0,68.66666666666667
228190.0,17,2,180,1,90,0.0,90.0,90.0,1,90,0.0,90.0,90.0
108103364.0,17,5,1005,5,1005,27025841.0,201.0,201.0,0,0,0.0,0.0,0.0
146140.0,6,3,337,2,214,0.0,160.0,107.0,1,123,0.0,123.0,123.0
11751576.0,17,4,1368,4,1368,3917192.0,342.0,342.0,0,0,0.0,0.0,0.0
103008720.0,6,41,2706,21,1386,5150436.0,66.0,66.0,20,1320,5205516.684210527,66.0,66.0
107109.0,17,2,286,2,286,0.0,143.0,143.0,0,0,0.0,0.0,0.0
311513.0,17,4,1400,4,1400,103837.66666666669,350.0,350.0,0,0,0.0,0.0,0.0
122407.0,6,3,373,2,238,0.0,172.0,119.0,1,135,0.0,135.0,135.0
90809395.0,6,66,13872,33,7362,2831377.5625,1514.0,223.0909090909091,33,6510,2831377.25,1514.0,197.27272727272728
101001060.0,17,13,821,7,432,16833510.0,174.0,61.71428571428572,6,389,20046822.6,174.0,64.83333333333333
120250453.0,6,21,1585,10,786,13332882.777777778,95.0,78.6,11,799,12000002.7,95.0,72.63636363636364
91030405.0,6,178,20184,89,14088,1031991.4659090908,284.0,158.2921348314607,89,6096,1031991.125,140.0,68.49438202247191
120138362.0,6,16,2273,8,1193,17162623.14285714,199.0,149.125,8,1080,17134276.714285713,204.0,135.0
153418.0,17,2,180,1,90,0.0,90.0,90.0,1,90,0.0,90.0,90.0
28197.0,6,13,4519,6,512,5492.0,230.0,85.33333333333333,7,4007,4104.666666666667,1514.0,572.4285714285714
1314701.0,6,4,264,2,132,0.0,66.0,66.0,2,132,0.0,66.0,66.0
120078866.0,17,29,13785,29,13785,4288530.928571428,501.0,475.3448275862069,0,0,0.0,0.0,0.0
352.0,17,2,214,1,75,0.0,75.0,75.0,1,139,0.0,139.0,139.0
18911.0,6,14,4740,7,653,2784.0,249.0,93.28571428571428,7,4087,3020.333333333333,1514.0,583.8571428571429
27890.0,6,13,1479,7,882,4648.333333333333,291.0,126.0,6,597,4116.2,259.0,99.5
1305958.0,6,4,264,2,132,0.0,66.0,66.0,2,132,0.0,66.0,66.0
12832.0,17,4,823,2,163,0.0,89.0,81.5,2,660,0.0,443.0,330.0
7615.0,17,4,823,2,163,0.0,89.0,81.5,2,660,0.0,443.0,330.0
9524727.0,6,4,1843,2,892,0.0,826.0,446.0,2,951,0.0,885.0,475.5
818740.0,6,5,1742,3,921,409370.0,785.0,307.0,2,821,0.0,753.0,410.5
90945044.0,6,21,1585,11,840,9094138.8,95.0,76.36363636363636,10,745,10104210.444444444,95.0,74.5
2804448.0,6,2,132,1,66,0.0,66.0,66.0,1,66,0.0,66.0,66.0
311.0,17,2,174,1,79,0.0,79.0,79.0,1,95,0.0,95.0,95.0
46582494.0,6,8,1940,3,887,22141404.5,753.0,295.6666666666667,5,1053,11002496.75,785.0,210.6
135135016.0,17,6,1146,6,1146,27027003.2,191.0,191.0,0,0,0.0,0.0,0.0
172161.0,17,2,180,1,90,0.0,90.0,90.0,1,90,0.0,90.0,90.0
0.0,6,1,54,0,0,0.0,0.0,0.0,1,54,0.0,54.0,54.0
33843.0,17,4,823,2,163,0.0,89.0,81.5,2,660,0.0,443.0,330.0
1315907.0,6,4,264,2,132,0.0,66.0,66.0,2,132,0.0,66.0,66.0
135138753.0,17,6,1206,6,1206,27027750.6,201.0,201.0,0,0,0.0,0.0,0.0
300772.0,6,6,412,4,272,100257.33333333331,74.0,68.0,2,140,0.0,74.0,70.0
47691.0,6,14,4740,7,653,7820.666666666667,249.0,93.28571428571428,7,4087,7672.333333333333,1514.0,583.8571428571429
25630.0,6,14,4740,7,653,3926.0,249.0,93.28571428571428,7,4087,4131.0,1514.0,583.8571428571429
404.0,17,2,762,2,762,0.0,381.0,381.0,0,0,0.0,0.0,0.0
25726.0,6,14,4740,7,653,4135.5,249.0,93.28571428571428,7,4087,4151.333333333333,1514.0,583.8571428571429
1207338.0,6,13,3004,8,2376,172476.85714285713,1514.0,297.0,5,628,233712.5,331.0,125.6
4454.0,17,2,180,1,90,0.0,90.0,90.0,1,90,0.0,90.0,90.0
120014755.0,17,14,864,8,475,17144965.0,174.0,59.375,6,389,20000160.0,174.0,64.83333333333333
302313.0,6,6,412,4,272,100771.0,74.0,68.0,2,140,0.0,74.0,70.0
228241.0,17,2,180,1,90,0.0,90.0,90.0,1,90,0.0,90.0,90.0
143649.0,6,2,132,1,66,0.0,66.0,66.0,1,66,0.0,66.0,66.0
351.0,17,2,160,1,80,0.0,80.0,80.0,1,80,0.0,80.0,80.0
330.0,17,2,166,1,75,0.0,75.0,75.0,1,91,0.0,91.0,91.0
2042.0,17,4,344,2,150,0.0,75.0,75.0,2,194,0.0,103.0,97.0
25374114.0,17,5,1718,4,1368,735690.6666666666,342.0,342.0,1,350,0.0,350.0,350.0
24455.0,6,14,4740,7,653,3190.333333333333,249.0,93.28571428571428,7,4087,2818.5,1514.0,583.8571428571429
2402.0,17,4,344,2,150,0.0,75.0,75.0,2,194,0.0,103.0,97.0
173825.0,17,4,1524,4,1524,57941.66666666666,381.0,381.0,0,0,0.0,0.0,0.0
2095.0,17,4,344,2,150,0.0,75.0,75.0,2,194,0.0,103.0,97.0
90205704.0,6,21,1712,10,913,9996138.888888888,222.0,91.3,11,799,9000086.2,95.0,72.63636363636364
1162500.0,6,13,3010,8,2382,166071.42857142858,1514.0,297.75,5,628,222399.25,331.0,125.6
103052.0,17,2,286,2,286,0.0,143.0,143.0,0,0,0.0,0.0,0.0
35437.0,6,14,4740,7,653,5757.833333333333,249.0,93.28571428571428,7,4087,5747.5,1514.0,583.8571428571429
146097.0,6,3,337,2,214,0.0,160.0,107.0,1,123,0.0,123.0,123.0
90045146.0,17,28,13364,28,13364,3335005.407407407,501.0,477.2857142857143,0,0,0.0,0.0,0.0
357.0,17,2,267,1,83,0.0,83.0,83.0,1,184,0.0,184.0,184.0
90213281.0,6,17,1287,8,596,12852835.42857143,95.0,74.5,9,691,11251009.625,95.0,76.77777777777777
108001014.0,17,13,821,7,432,18000169.0,174.0,61.71428571428572,6,389,17600895.4,174.0,64.83333333333333
147902.0,17,2,180,1,90,0.0,90.0,90.0,1,90,0.0,90.0,90.0
294144.0,6,6,412,4,272,98048.0,74.0,68.0,2,140,0.0,74.0,70.0
122024.0,6,3,337,2,214,0.0,160.0,107.0,1,123,0.0,123.0,123.0
35950.0,6,14,4740,7,653,5638.333333333333,249.0,93.28571428571428,7,4087,5624.166666666667,1514.0,583.8571428571429
90290606.0,6,16,1192,8,596,12891841.57142857,95.0,74.5,8,596,12898344.857142856,95.0,74.5
1572.0,17,5,550,5,550,393.0,110.0,110.0,0,0,0.0,0.0,0.0
870664.0,6,9,1270,6,799,174132.8,461.0,133.16666666666666,3,471,299046.0,331.0,157.0
120121212.0,6,14,2224,9,1204,15015151.5,188.0,133.77777777777777,5,1020,22521654.0,204.0,204.0
120233859.0,6,24,1829,13,989,9999660.75,95.0,76.07692307692308,11,840,12018529.4,95.0,76.36363636363636
17089.0,6,14,4740,7,653,2738.6666666666665,249.0,93.28571428571428,7,4087,2712.833333333333,1514.0,583.8571428571429
5618337.0,6,5,336,2,134,0.0,68.0,67.0,3,202,1523598.5,70.0,67.33333333333333
100066958.0,17,12,516,6,258,20000393.2,43.0,43.0,6,258,20000246.8,43.0,43.0
46486.0,6,14,4740,7,653,7504.0,249.0,93.28571428571428,7,4087,7168.166666666667,1514.0,583.8571428571429
542423.0,17,2,346,1,78,0.0,78.0,78.0,1,268,0.0,268.0,268.0
844527.0,6,9,1118,6,586,168905.4,248.0,97.66666666666669,3,532,285946.5,392.0,177.33333333333334
54264.0,6,14,4740,7,653,8877.0,249.0,93.28571428571428,7,4087,7572.333333333333,1514.0,583.8571428571429
120504079.0,6,31,2050,16,1102,8033605.266666667,139.0,68.875,15,948,7878725.857142857,123.0,63.2
25893.0,6,10,2032,5,524,6238.75,252.0,104.8,5,1508,6128.25,1236.0,301.6
299560.0,6,6,412,4,272,99853.33333333331,74.0,68.0,2,140,0.0,74.0,70.0
217629.0,6,3,426,2,280,0.0,214.0,140.0,1,146,0.0,146.0,146.0
307693.0,6,6,412,4,272,102564.33333333331,74.0,68.0,2,140,0.0,74.0,70.0
108883417.0,6,28,1860,14,966,8359039.384615385,123.0,69.0,14,894,8359044.153846154,123.0,63.85714285714285
61131.0,6,14,4740,7,653,9343.833333333334,249.0,93.28571428571428,7,4087,8806.666666666666,1514.0,583.8571428571429
120120672.0,6,16,2368,7,1164,20020112.0,204.0,166.28571428571428,9,1204,14994923.75,188.0,133.77777777777777
233961.0,6,3,337,2,214,0.0,160.0,107.0,1,123,0.0,123.0,123.0
135127416.0,17,6,1146,6,1146,27025483.2,191.0,191.0,0,0,0.0,0.0,0.0
136826.0,17,2,176,1,80,0.0,80.0,80.0,1,96,0.0,96.0,96.0
90236039.0,6,17,1287,8,596,12855124.42857143,95.0,74.5,9,691,11252579.625,95.0,76.77777777777777
2031.0,17,4,344,2,150,0.0,75.0,75.0,2,194,0.0,103.0,97.0
123455893.0,6,48,3168,24,1584,4925341.826086956,66.0,66.0,24,1584,5342481.869565218,66.0,66.0
126349539.0,6,33,2296,17,1225,7896846.1875,139.0,72.05882352941177,16,1071,7743248.466666667,123.0,66.9375
196966.0,17,2,180,1,90,0.0,90.0,90.0,1,90,0.0,90.0,90.0
113424035.0,6,46,3036,23,1518,5155626.5,66.0,66.0,23,1518,5155626.409090909,66.0,66.0
2351.0,17,4,344,2,150,0.0,75.0,75.0,2,194,0.0,103.0,97.0
104015.0,17,2,286,2,286,0.0,143.0,143.0,0,0,0.0,0.0,0.0
46646.0,6,14,4740,7,653,6356.833333333333,249.0,93.28571428571428,7,4087,7624.166666666667,1514.0,583.8571428571429
329.0,17,2,160,1,80,0.0,80.0,80.0,1,80,0.0,80.0,80.0
119908013.0,17,34,16284,34,16284,3633576.151515152,501.0,478.9411764705882,0,0,0.0,0.0,0.0
24188.0,6,10,2032,5,524,5809.0,252.0,104.8,5,1508,5726.0,1236.0,301.6
37364.0,6,10,2032,5,524,9073.0,252.0,104.8,5,1508,8759.0,1236.0,301.6
197259.0,17,2,180,1,90,0.0,90.0,90.0,1,90,0.0,90.0,90.0
1167944.0,6,13,3020,8,2392,166849.14285714287,1514.0,299.0,5,628,223128.5,331.0,125.6
120001011.0,17,14,864,8,475,17143001.57142857,174.0,59.375,6,389,20001058.6,174.0,64.83333333333333
17409.0,6,14,4740,7,653,2667.5,249.0,93.28571428571428,7,4087,2692.1666666666665,1514.0,583.8571428571429
292264.0,17,2,363,1,79,0.0,79.0,79.0,1,284,0.0,284.0,284.0
2595141.0,6,3,1604,1,753,0.0,753.0,753.0,2,851,0.0,785.0,425.5
286483.0,17,2,346,1,78,0.0,78.0,78.0,1,268,0.0,268.0,268.0
222228.0,17,2,239,1,82,0.0,82.0,82.0,1,157,0.0,157.0,157.0
244332.0,17,4,1400,4,1400,81444.0,350.0,350.0,0,0,0.0,0.0,0.0
499713.0,6,4,270,2,134,0.0,68.0,67.0,2,136,0.0,70.0,68.0
311.0,17,2,174,1,79,0.0,79.0,79.0,1,95,0.0,95.0,95.0
214149.0,6,10,1221,6,636,42829.8,298.0,106.0,4,585,69955.66666666667,379.0,146.25
573477.0,6,3,204,2,136,0.0,70.0,68.0,1,68,0.0,68.0,68.0
265328.0,6,10,1221,6,636,53065.6,298.0,106.0,4,585,83080.0,379.0,146.25
335.0,17,2,166,1,75,0.0,75.0,75.0,1,91,0.0,91.0,91.0
90284885.0,6,16,1192,8,596,12891475.142857144,95.0,74.5,8,596,12896694.42857143,95.0,74.5
217708.0,6,13,1386,7,789,36284.66666666666,253.0,112.71428571428572,6,597,40540.6,259.0,99.5
2466.0,17,4,344,2,150,0.0,75.0,75.0,2,194,0.0,103.0,97.0
469.0,17,2,508,2,508,0.0,257.0,254.0,0,0,0.0,0.0,0.0
26359.0,6,10,2032,5,524,6355.75,252.0,104.8,5,1508,6366.0,1236.0,301.6
325911.0,6,6,412,4,272,108637.0,74.0,68.0,2,140,0.0,74.0,70.0
92076643.0,17,16,5472,16,5472,6138442.866666666,342.0,342.0,0,0,0.0,0.0,0.0
0.0,17,1,90,1,90,0.0,90.0,90.0,0,0,0.0,0.0,0.0
25525.0,6,11,2098,6,590,4351.0,252.0,98.33333333333331,5,1508,5190.25,1236.0,301.6
117467761.0,6,261,30702,131,8868,903598.1615384616,140.0,67.69465648854961,130,21834,908922.968992248,426.0,167.95384615384614
235616.0,6,3,337,2,214,0.0,160.0,107.0,1,123,0.0,123.0,123.0
2452.0,17,4,344,2,150,0.0,75.0,75.0,2,194,0.0,103.0,97.0
50226.0,6,14,4740,7,653,8241.333333333334,249.0,93.28571428571428,7,4087,7158.666666666667,1514.0,583.8571428571429
8871.0,6,10,771,5,384,1927.0,112.0,76.8,5,387,1937.0,115.0,77.4
120002458.0,6,23,1734,12,935,10909088.454545457,95.0,77.91666666666667,11,799,11999066.3,95.0,72.63636363636364
122105362.0,6,32,2157,16,1071,7474651.2,123.0,66.9375,16,1086,8140242.666666667,123.0,67.875
374895.0,6,10,1221,6,636,74979.0,298.0,106.0,4,585,123559.33333333331,379.0,146.25
0.0,6,1,54,0,0,0.0,0.0,0.0,1,54,0.0,54.0,54.0
1395868.0,17,16,1120,16,1120,93057.86666666668,70.0,70.0,0,0,0.0,0.0,0.0
114651910.0,6,30,1990,15,1042,8173990.5,139.0,69.46666666666667,15,948,8173994.0,123.0,63.2
4298.0,17,2,614,1,72,0.0,72.0,72.0,1,542,0.0,542.0,542.0
162289.0,17,2,180,1,90,0.0,90.0,90.0,1,90,0.0,90.0,90.0
29392.0,6,14,4740,7,653,4654.666666666667,249.0,93.28571428571428,7,4087,4671.166666666667,1514.0,583.8571428571429
10455954.0,6,6,412,3,206,5159515.0,74.0,68.66666666666667,3,206,5159368.0,74.0,68.66666666666667
108002151.0,17,13,821,7,432,18000358.5,174.0,61.71428571428572,6,389,17601309.0,174.0,64.83333333333333
106407.0,17,2,286,2,286,0.0,143.0,143.0,0,0,0.0,0.0,0.0
328.0,17,2,160,1,80,0.0,80.0,80.0,1,80,0.0,80.0,80.0
142564.0,6,2,132,1,66,0.0,66.0,66.0,1,66,0.0,66.0,66.0
107219.0,17,2,286,2,286,0.0,143.0,143.0,0,0,0.0,0.0,0.0
23969.0,6,14,4740,7,653,3833.3333333333335,249.0,93.28571428571428,7,4087,3785.3333333333335,1514.0,583.8571428571429
1036071.0,6,11,1134,6,558,207214.2,220.0,93.0,5,576,257805.0,304.0,115.2
296908.0,17,2,180,1,90,0.0,90.0,90.0,1,90,0.0,90.0,90.0
404223.0,6,4,508,2,238,0.0,172.0,119.0,2,270,0.0,135.0,135.0
1997519.0,6,28,12588,15,4556,142679.92857142858,1510.0,303.7333333333333,13,8032,140868.83333333334,1510.0,617.8461538461538
206387.0,6,4,492,2,280,0.0,214.0,140.0,2,212,0.0,146.0,106.0
328.0,17,2,166,1,75,0.0,75.0,75.0,1,91,0.0,91.0,91.0
3007674.0,6,12,2172,7,664,501185.8333333333,252.0,94.85714285714286,5,1508,2016.0,1236.0,301.6
10467055.0,6,7,478,4,272,3443637.6666666665,74.0,68.0,3,206,5165323.0,74.0,68.66666666666667
302670.0,6,6,412,4,272,100890.0,74.0,68.0,2,140,0.0,74.0,70.0
120514251.0,6,219,24924,110,17508,1105635.3302752294,374.0,159.16363636363636,109,7416,1106266.9722222222,140.0,68.03669724770643
0.0,17,1,90,1,90,0.0,90.0,90.0,0,0,0.0,0.0,0.0
120004827.0,6,19,1477,9,691,15000603.375,95.0,76.77777777777777,10,786,10001347.333333334,95.0,78.6
246234.0,6,3,373,2,238,0.0,172.0,119.0,1,135,0.0,135.0,135.0
120009573.0,6,22,1680,12,935,10909961.181818182,95.0,77.91666666666667,10,745,13306048.222222222,95.0,74.5
46911.0,6,14,4740,7,653,6678.666666666667,249.0,93.28571428571428,7,4087,6404.666666666667,1514.0,583.8571428571429
219897.0,6,10,1221,6,636,43979.4,298.0,106.0,4,585,72432.0,379.0,146.25
90038061.0,17,27,12943,27,12943,3463002.346153846,501.0,479.3703703703704,0,0,0.0,0.0,0.0
213568.0,6,10,1221,6,636,42713.6,298.0,106.0,4,585,70064.66666666667,379.0,146.25
108106283.0,17,5,955,5,955,27026570.75,191.0,191.0,0,0,0.0,0.0,0.0
49011.0,6,14,4740,7,653,7964.0,249.0,93.28571428571428,7,4087,7784.5,1514.0,583.8571428571429
103827.0,17,2,700,2,700,0.0,350.0,350.0,0,0,0.0,0.0,0.0
2689.0,17,4,344,2,150,0.0,75.0,75.0,2,194,0.0,103.0,97.0
105582185.0,6,29,2052,15,1089,7526165.142857143,123.0,72.6,14,963,8105100.461538462,123.0,68.78571428571429
23258.0,6,14,4740,7,653,3644.3333333333335,249.0,93.28571428571428,7,4087,3546.0,1514.0,583.8571428571429
349.0,17,2,267,1,83,0.0,83.0,83.0,1,184,0.0,184.0,184.0
33033.0,6,14,4740,7,653,4546.666666666667,249.0,93.28571428571428,7,4087,4981.0,1514.0,583.8571428571429
52595.0,6,14,4740,7,653,7452.166666666667,249.0,93.28571428571428,7,4087,8626.333333333334,1514.0,583.8571428571429
23182.0,6,10,1066,5,490,4567.75,218.0,98.0,5,576,5178.0,304.0,115.2
148063.0,17,2,180,1,90,0.0,90.0,90.0,1,90,0.0,90.0,90.0
90254000.0,6,12,1832,8,1016,12893428.57142857,188.0,127.0,4,816,30030679.666666668,204.0,204.0
2844708.0,6,3,1604,1,753,0.0,753.0,753.0,2,851,0.0,785.0,425.5
305879.0,6,3,202,2,128,0.0,74.0,64.0,1,74,0.0,74.0,74.0
120696.0,6,15,4806,8,719,14543.285714285714,249.0,89.875,7,4087,19036.33333333333,1514.0,583.8571428571429
43750.0,6,14,4740,7,653,6883.833333333333,249.0,93.28571428571428,7,4087,6671.833333333333,1514.0,583.8571428571429
90041971.0,17,28,13364,28,13364,3334887.814814815,501.0,477.2857142857143,0,0,0.0,0.0,0.0
135128040.0,17,6,1206,6,1206,27025608.0,201.0,201.0,0,0,0.0,0.0,0.0
105635.0,17,2,700,2,700,0.0,350.0,350.0,0,0,0.0,0.0,0.0
261587.0,6,10,1221,6,636,52317.4,298.0,106.0,4,585,80433.66666666667,379.0,146.25
123708494.0,17,14,864,7,432,17334977.5,174.0,61.71428571428572,7,432,19994718.5,174.0,61.71428571428572
316122.0,17,4,704,2,148,0.0,74.0,74.0,2,556,0.0,280.0,278.0
108108230.0,17,5,1005,5,1005,27027057.5,201.0,201.0,0,0,0.0,0.0,0.0
144273.0,17,4,704,2,148,0.0,74.0,74.0,2,556,0.0,280.0,278.0
168168.0,17,2,414,1,88,0.0,88.0,88.0,1,326,0.0,326.0,326.0
16821.0,17,2,180,1,90,0.0,90.0,90.0,1,90,0.0,90.0,90.0
207218.0,6,3,426,2,280,0.0,214.0,140.0,1,146,0.0,146.0,146.0
108097987.0,17,5,955,5,955,27024496.75,191.0,191.0,0,0,0.0,0.0,0.0
147879.0,17,2,180,1,90,0.0,90.0,90.0,1,90,0.0,90.0,90.0
1643695.0,6,19,7533,10,1403,182632.7777777777,583.0,140.3,9,6130,173726.0,1484.0,681.1111111111111
107092410.0,17,14,864,7,432,17833495.833333332,174.0,61.71428571428572,7,432,17835398.833333332,174.0,61.71428571428572
303698.0,6,6,412,4,272,101232.66666666669,74.0,68.0,2,140,0.0,74.0,70.0
3005755.0,6,11,2106,6,598,600967.2,252.0,99.66666666666669,5,1508,1868.75,1236.0,301.6
216474.0,17,2,180,1,90,0.0,90.0,90.0,1,90,0.0,90.0,90.0
108105314.0,17,5,955,5,955,27026328.5,191.0,191.0,0,0,0.0,0.0,0.0
90034831.0,17,28,13364,28,13364,3334623.3703703703,501.0,477.2857142857143,0,0,0.0,0.0,0.0
245779.0,6,3,337,2,214,0.0,160.0,107.0,1,123,0.0,123.0,123.0
2654357.0,6,3,1604,1,753,0.0,753.0,753.0,2,851,0.0,785.0,425.5
90285071.0,6,16,1192,8,596,12892156.57142857,95.0,74.5,8,596,12896741.57142857,95.0,74.5
135145247.0,17,6,1146,6,1146,27029049.4,191.0,191.0,0,0,0.0,0.0,0.0
330.0,17,2,166,1,75,0.0,75.0,75.0,1,91,0.0,91.0,91.0
104394.0,17,2,762,2,762,0.0,381.0,381.0,0,0,0.0,0.0,0.0
119567003.0,6,33,2290,17,1125,7472937.6875,123.0,66.17647058823529,16,1165,7291122.866666666,139.0,72.8125
63118.99999999999,6,14,4740,7,653,8222.666666666666,249.0,93.28571428571428,7,4087,10211.833333333334,1514.0,583.8571428571429
5620427.0,6,5,336,2,134,0.0,68.0,67.0,3,202,1423620.5,70.0,67.33333333333333
108109137.0,17,5,1005,5,1005,27027284.25,201.0,201.0,0,0,0.0,0.0,0.0
499363.0,6,5,336,2,134,0.0,68.0,67.0,3,202,192743.5,70.0,67.33333333333333
332.0,17,2,166,1,75,0.0,75.0,75.0,1,91,0.0,91.0,91.0
284465.0,17,2,363,1,79,0.0,79.0,79.0,1,284,0.0,284.0,284.0
44381.0,6,14,4740,7,653,7272.333333333333,249.0,93.28571428571428,7,4087,7096.833333333333,1514.0,583.8571428571429
238069.0,6,3,337,2,214,0.0,160.0,107.0,1,123,0.0,123.0,123.0
120998189.0,17,14,864,7,432,16833492.666666668,174.0,61.71428571428572,7,432,16834602.0,174.0,61.71428571428572
120266321.0,6,260,29500,130,8888,925935.2558139536,140.0,68.36923076923077,130,20612,925984.1007751938,284.0,158.55384615384617
114852448.0,6,32,2236,16,1165,7656829.866666666,139.0,72.8125,16,1071,7642401.6,123.0,66.9375
146186.0,6,3,337,2,214,0.0,160.0,107.0,1,123,0.0,123.0,123.0
286498.0,17,4,571,2,148,0.0,74.0,74.0,2,423,0.0,280.0,211.5
21815.0,17,2,582,1,83,0.0,83.0,83.0,1,499,0.0,499.0,499.0
43365.0,6,14,4740,7,653,6369.0,249.0,93.28571428571428,7,4087,6802.5,1514.0,583.8571428571429
228730.0,6,12,1373,7,714,38121.66666666666,298.0,102.0,5,659,56153.0,379.0,131.8
40541.0,6,10,2032,5,524,8940.0,252.0,104.8,5,1508,9644.5,1236.0,301.6
35186.0,6,14,4740,7,653,5725.0,249.0,93.28571428571428,7,4087,5617.166666666667,1514.0,583.8571428571429
108780336.0,6,591,79292,296,59600,368746.90169491526,480.0,201.35135135135133,295,19692,369243.5476190476,140.0,66.75254237288135
2389.0,17,4,344,2,150,0.0,75.0,75.0,2,194,0.0,103.0,97.0
2048.0,17,4,344,2,150,0.0,75.0,75.0,2,194,0.0,103.0,97.0
120249686.0,6,212,24008,106,7304,1127541.4285714286,140.0,68.90566037735849,106,16704,1137442.7523809525,284.0,157.58490566037736
90261391.0,6,12,1832,8,1016,12894484.42857143,188.0,127.0,4,816,30031736.666666668,204.0,204.0
135131192.0,17,6,1146,6,1146,27026238.4,191.0,191.0,0,0,0.0,0.0,0.0
2392.0,17,4,344,2,150,0.0,75.0,75.0,2,194,0.0,103.0,97.0
322553.0,17,4,1400,4,1400,107517.66666666669,350.0,350.0,0,0,0.0,0.0,0.0
373.0,17,2,267,1,83,0.0,83.0,83.0,1,184,0.0,184.0,184.0
300202.0,6,6,412,4,272,100067.33333333331,74.0,68.0,2,140,0.0,74.0,70.0
228186.0,17,2,180,1,90,0.0,90.0,90.0,1,90,0.0,90.0,90.0
130502.0,6,3,337,2,214,0.0,160.0,107.0,1,123,0.0,123.0,123.0
160523.0,6,3,337,2,214,0.0,160.0,107.0,1,123,0.0,123.0,123.0
40762.0,6,14,4740,7,653,6680.166666666667,249.0,93.28571428571428,7,4087,5676.0,1514.0,583.8571428571429
14643942.0,6,20,1607,10,975,1592880.3333333333,315.0,97.5,10,632,1592855.2222222222,78.0,63.2
1996.0,17,4,344,2,150,0.0,75.0,75.0,2,194,0.0,103.0,97.0
2015.0,17,4,344,2,150,0.0,75.0,75.0,2,194,0.0,103.0,97.0
99593229.0,6,25,1702,13,840,8299435.75,123.0,64.61538461538461,12,862,8126491.727272727,139.0,71.83333333333333
26436.0,6,10,2032,5,524,6363.75,252.0,104.8,5,1508,6319.0,1236.0,301.6
36638.0,6,14,4740,7,653,5976.666666666667,249.0,93.28571428571428,7,4087,5121.5,1514.0,583.8571428571429
48714.0,6,13,1394,7,797,7654.166666666667,253.0,113.85714285714286,6,597,9126.8,259.0,99.5
9369.0,17,2,582,1,83,0.0,83.0,83.0,1,499,0.0,499.0,499.0
110897931.0,6,30,1974,15,1026,7905848.714285715,123.0,68.4,15,948,7905851.571428572,123.0,63.2
355.0,17,2,267,1,83,0.0,83.0,83.0,1,184,0.0,184.0,184.0
302388.0,6,2,132,1,66,0.0,66.0,66.0,1,66,0.0,66.0,66.0
360.0,17,2,267,1,83,0.0,83.0,83.0,1,184,0.0,184.0,184.0
319.0,17,2,174,1,79,0.0,79.0,79.0,1,95,0.0,95.0,95.0
108105703.0,17,5,1005,5,1005,27026425.75,201.0,201.0,0,0,0.0,0.0,0.0
319.0,17,2,174,1,79,0.0,79.0,79.0,1,95,0.0,95.0,95.0
119948757.0,17,35,16705,35,16705,3527904.617647059,501.0,477.2857142857143,0,0,0.0,0.0,0.0
2049353.0,17,6,1230,3,234,1024486.5,78.0,78.0,3,996,1024471.0,332.0,332.0
216452.0,6,3,426,2,280,0.0,214.0,140.0,1,146,0.0,146.0,146.0
53959.0,6,14,4740,7,653,5983.666666666667,249.0,93.28571428571428,7,4087,8847.0,1514.0,583.8571428571429
90020936.0,17,28,13364,28,13364,3334108.7407407407,501.0,477.2857142857143,0,0,0.0,0.0,0.0
94713306.0,17,12,778,6,389,18801518.2,174.0,64.83333333333333,6,389,18800187.8,174.0,64.83333333333333
317469.0,17,4,1400,4,1400,105823.0,350.0,350.0,0,0,0.0,0.0,0.0
322176.0,17,4,1400,4,1400,107392.0,350.0,350.0,0,0,0.0,0.0,0.0
129006982.0,17,15,907,8,475,18429568.85714286,174.0,59.375,7,432,18166838.0,174.0,61.71428571428572
60288.0,6,14,4740,7,653,8932.666666666666,249.0,93.28571428571428,7,4087,9261.0,1514.0,583.8571428571429
96625.0,6,13,1394,7,797,16104.166666666666,253.0,113.85714285714286,6,597,18025.2,259.0,99.5
209567.0,17,2,180,1,90,0.0,90.0,90.0,1,90,0.0,90.0,90.0
864967.0,6,9,1196,6,725,172993.4,387.0,120.83333333333331,3,471,294617.0,331.0,157.0
90264458.0,6,12,1832,8,1016,12894922.57142857,188.0,127.0,4,816,30033837.666666668,204.0,204.0
10465699.0,6,7,478,4,272,3442997.6666666665,74.0,68.0,3,206,5164352.0,74.0,68.66666666666667
108265896.0,6,163,18384,82,5634,1336616.0,140.0,68.70731707317073,81,12750,1340552.7375,284.0,157.40740740740742
284789.0,17,2,363,1,79,0.0,79.0,79.0,1,284,0.0,284.0,284.0
294850.0,6,6,412,4,272,98283.33333333331,74.0,68.0,2,140,0.0,74.0,70.0
250830.0,6,3,337,2,214,0.0,160.0,107.0,1,123,0.0,123.0,123.0
1995.0,17,4,344,2,150,0.0,75.0,75.0,2,194,0.0,103.0,97.0
46367166.0,6,8,1307,8,1307,6623880.857142857,172.0,163.375,0,0,0.0,0.0,0.0
206048.0,6,3,426,2,280,0.0,214.0,140.0,1,146,0.0,146.0,146.0
152998.0,6,10,2032,5,524,38033.0,252.0,104.8,5,1508,33575.0,1236.0,301.6
42029.0,6,14,4740,7,653,6683.0,249.0,93.28571428571428,7,4087,5369.0,1514.0,583.8571428571429
993450.0,6,12,1447,6,816,197605.4,291.0,136.0,6,631,194384.0,293.0,105.16666666666669
282821.0,6,3,337,2,214,0.0,160.0,107.0,1,123,0.0,123.0,123.0
90292307.0,6,19,1436,10,745,10027359.888888888,95.0,74.5,9,691,11284905.5,95.0,76.77777777777777
135132080.0,17,6,1146,6,1146,27026416.0,191.0,191.0,0,0,0.0,0.0,0.0
220486.0,17,2,180,1,90,0.0,90.0,90.0,1,90,0.0,90.0,90.0
313422.0,6,6,412,4,272,104474.0,74.0,68.0,2,140,0.0,74.0,70.0
310244.0,6,6,412,4,272,103414.66666666669,74.0,68.0,2,140,0.0,74.0,70.0
55806.0,6,14,4740,7,653,9004.5,249.0,93.28571428571428,7,4087,7975.666666666667,1514.0,583.8571428571429
306771.0,6,6,412,4,272,102257.0,74.0,68.0,2,140,0.0,74.0,70.0
108095516.0,17,5,955,5,955,27023879.0,191.0,191.0,0,0,0.0,0.0,0.0
108098172.0,17,5,1005,5,1005,27024543.0,201.0,201.0,0,0,0.0,0.0,0.0
121435353.0,6,33,2280,17,1209,7589709.5625,123.0,71.11764705882354,16,1071,7415616.066666666,123.0,66.9375
9545.0,17,2,571,1,86,0.0,86.0,86.0,1,485,0.0,485.0,485.0
314.0,17,2,174,1,79,0.0,79.0,79.0,1,95,0.0,95.0,95.0
316.0,17,2,174,1,79,0.0,79.0,79.0,1,95,0.0,95.0,95.0
300824.0,6,6,412,4,272,100274.66666666669,74.0,68.0,2,140,0.0,74.0,70.0
146195.0,6,3,337,2,214,0.0,160.0,107.0,1,123,0.0,123.0,123.0
114087639.0,6,200,22680,100,6822,1144085.2727272727,140.0,68.22,100,15858,1144103.9595959596,284.0,158.58
30982.0,6,14,4740,7,653,4997.5,249.0,93.28571428571428,7,4087,4851.666666666667,1514.0,583.8571428571429
154280.0,6,2,132,1,66,0.0,66.0,66.0,1,66,0.0,66.0,66.0
39457.0,6,14,4740,7,653,5770.666666666667,249.0,93.28571428571428,7,4087,6178.166666666667,1514.0,583.8571428571429
153388.0,17,2,180,1,90,0.0,90.0,90.0,1,90,0.0,90.0,90.0
299151.0,6,6,412,4,272,99717.0,74.0,68.0,2,140,0.0,74.0,70.0
33479.0,6,14,4740,7,653,4948.666666666667,249.0,93.28571428571428,7,4087,5441.333333333333,1514.0,583.8571428571429
31900.0,6,14,4740,7,653,4267.333333333333,249.0,93.28571428571428,7,4087,4734.0,1514.0,583.8571428571429
42562.0,6,14,4740,7,653,6868.666666666667,249.0,93.28571428571428,7,4087,6955.5,1514.0,583.8571428571429
329241.0,17,2,604,1,75,0.0,75.0,75.0,1,529,0.0,529.0,529.0
108107623.0,17,5,1005,5,1005,27026905.75,201.0,201.0,0,0,0.0,0.0,0.0
14405.0,6,14,4740,7,653,2259.0,249.0,93.28571428571428,7,4087,2201.333333333333,1514.0,583.8571428571429
14783.0,6,10,1067,5,536,3524.0,264.0,107.2,5,531,2579.5,259.0,106.2
128910677.0,6,38,2716,20,1468,6784772.47368421,139.0,73.4,18,1248,6982941.823529412,123.0,69.33333333333333
109135.0,17,4,1400,4,1400,36378.333333333336,350.0,350.0,0,0,0.0,0.0,0.0
207268.0,6,3,426,2,280,0.0,214.0,140.0,1,146,0.0,146.0,146.0
24484.0,6,14,4740,7,653,3931.6666666666665,249.0,93.28571428571428,7,4087,3441.333333333333,1514.0,583.8571428571429
307353.0,6,6,412,4,272,102451.0,74.0,68.0,2,140,0.0,74.0,70.0
2346.0,17,4,344,2,150,0.0,75.0,75.0,2,194,0.0,103.0,97.0
14083082.0,17,6,2052,6,2052,2816616.4,342.0,342.0,0,0,0.0,0.0,0.0
51513.0,6,10,2032,5,524,11835.75,252.0,104.8,5,1508,11301.75,1236.0,301.6
40319.0,6,14,4740,7,653,6299.5,249.0,93.28571428571428,7,4087,6366.0,1514.0,583.8571428571429
42487.0,6,14,4740,7,653,6509.5,249.0,93.28571428571428,7,4087,6931.5,1514.0,583.8571428571429
3112444.0,6,129,97897,71,89767,44399.514285714286,1510.0,1264.3239436619715,58,8130,49079.52631578947,1510.0,140.17241379310346
90308271.0,6,16,1192,8,596,12894926.285714284,95.0,74.5,8,596,12899758.857142856,95.0,74.5
113893583.0,6,32,2236,16,1165,7592905.533333333,139.0,72.8125,16,1071,7578496.066666666,123.0,66.9375
210807.0,6,3,426,2,280,0.0,214.0,140.0,1,146,0.0,146.0,146.0
1029119.0,6,20,6434,12,1921,93556.27272727272,620.0,160.08333333333334,8,4513,118654.71428571428,1514.0,564.125
317.0,17,2,174,1,79,0.0,79.0,79.0,1,95,0.0,95.0,95.0
75588741.0,6,9,842,9,842,9448592.625,97.0,93.55555555555556,0,0,0.0,0.0,0.0
128970249.0,6,33,2280,17,1209,8060640.5625,123.0,71.11764705882354,16,1071,7917845.6,123.0,66.9375
122361.0,6,3,373,2,238,0.0,172.0,119.0,1,135,0.0,135.0,135.0
1048667.0,6,13,1394,7,797,174777.83333333334,253.0,113.85714285714286,6,597,208203.0,259.0,99.5
2352.0,17,4,344,2,150,0.0,75.0,75.0,2,194,0.0,103.0,97.0
1301527.0,6,4,264,2,132,0.0,66.0,66.0,2,132,0.0,66.0,66.0
108099929.0,17,5,955,5,955,27024982.25,191.0,191.0,0,0,0.0,0.0,0.0
44128.0,6,14,4740,7,653,7194.166666666667,249.0,93.28571428571428,7,4087,6348.5,1514.0,583.8571428571429
257674.0,6,3,337,2,214,0.0,160.0,107.0,1,123,0.0,123.0,123.0
100352791.0,17,13,821,7,432,16666802.666666666,174.0,61.71428571428572,6,389,20001392.6,174.0,64.83333333333333
144145.0,17,2,180,1,90,0.0,90.0,90.0,1,90,0.0,90.0,90.0
338.0,17,2,160,1,80,0.0,80.0,80.0,1,80,0.0,80.0,80.0
90258428.0,6,12,1832,8,1016,12894061.142857144,188.0,127.0,4,816,30031701.33333333,204.0,204.0
10865520.0,6,8,544,4,272,3576243.333333333,74.0,68.0,4,272,3576146.0,74.0,68.0
38733.0,6,10,2032,5,524,8746.75,252.0,104.8,5,1508,8881.75,1236.0,301.6
35745667.0,6,5,336,2,134,0.0,68.0,67.0,3,202,17807333.0,70.0,67.33333333333333
51450.0,17,2,180,1,90,0.0,90.0,90.0,1,90,0.0,90.0,90.0
135126878.0,17,6,1206,6,1206,27025375.6,201.0,201.0,0,0,0.0,0.0,0.0
9388.0,17,2,582,1,83,0.0,83.0,83.0,1,499,0.0,499.0,499.0
196761.0,17,2,180,1,90,0.0,90.0,90.0,1,90,0.0,90.0,90.0
22040.0,6,10,2032,5,524,5059.5,252.0,104.8,5,1508,5108.25,1236.0,301.6
108098186.0,17,5,955,5,955,27024546.5,191.0,191.0,0,0,0.0,0.0,0.0
112000988.0,17,13,821,7,432,18666831.33333333,174.0,61.71428571428572,6,389,18401264.8,174.0,64.83333333333333
156150.0,6,3,337,2,214,0.0,160.0,107.0,1,123,0.0,123.0,123.0
27569587.0,17,5,1710,5,1710,6892396.75,342.0,342.0,0,0,0.0,0.0,0.0
216844.0,6,3,426,2,280,0.0,214.0,140.0,1,146,0.0,146.0,146.0
3043395.0,6,3,204,1,68,0.0,68.0,68.0,2,136,0.0,70.0,68.0
218737.0,6,3,426,2,280,0.0,214.0,140.0,1,146,0.0,146.0,146.0
1598.0,17,2,762,2,762,0.0,381.0,381.0,0,0,0.0,0.0,0.0
113464031.0,6,31,2245,16,1228,7564268.733333333,139.0,76.75,15,1017,7573804.357142857,123.0,67.8
313372.0,17,4,1400,4,1400,104457.33333333331,350.0,350.0,0,0,0.0,0.0,0.0
90019048.0,17,28,13364,28,13364,3334038.814814815,501.0,477.2857142857143,0,0,0.0,0.0,0.0
2370.0,17,4,344,2,150,0.0,75.0,75.0,2,194,0.0,103.0,97.0
120004355.0,17,14,864,7,432,20000725.83333333,174.0,61.71428571428572,7,432,16666804.333333334,174.0,61.71428571428572
190501.0,17,2,180,1,90,0.0,90.0,90.0,1,90,0.0,90.0,90.0
42673.0,6,10,2032,5,524,10435.0,252.0,104.8,5,1508,9176.25,1236.0,301.6
35493.0,6,14,4740,7,653,5708.166666666667,249.0,93.28571428571428,7,4087,5700.833333333333,1514.0,583.8571428571429
314686.0,17,4,1400,4,1400,104895.33333333331,350.0,350.0,0,0,0.0,0.0,0.0
1320106.0,6,4,264,2,132,0.0,66.0,66.0,2,132,0.0,66.0,66.0
197570.0,17,2,180,1,90,0.0,90.0,90.0,1,90,0.0,90.0,90.0
135129796.0,17,6,1206,6,1206,27025959.2,201.0,201.0,0,0,0.0,0.0,0.0
90255983.0,6,12,1832,8,1016,12893711.857142856,188.0,127.0,4,816,30031304.666666668,204.0,204.0
103170215.0,17,14,864,7,432,17166882.0,174.0,61.71428571428572,7,432,17167816.333333332,174.0,61.71428571428572
26159.0,6,10,2032,5,524,6259.75,252.0,104.8,5,1508,5977.25,1236.0,301.6
35898.0,6,14,4740,7,653,5858.0,249.0,93.28571428571428,7,4087,5841.166666666667,1514.0,583.8571428571429
57817.0,6,14,4740,7,653,9308.333333333334,249.0,93.28571428571428,7,4087,8850.333333333334,1514.0,583.8571428571429
10462716.0,6,6,412,3,206,5162546.0,74.0,68.66666666666667,3,206,5162512.0,74.0,68.66666666666667
16440632.0,6,26,7701,14,2115,1264664.0,408.0,151.07142857142858,12,5586,1256639.5454545454,1514.0,465.5
277436.0,17,2,586,1,81,0.0,81.0,81.0,1,505,0.0,505.0,505.0
216878.0,6,3,426,2,280,0.0,214.0,140.0,1,146,0.0,146.0,146.0
34322.0,6,10,2032,5,524,7489.25,252.0,104.8,5,1508,8209.25,1236.0,301.6
117394557.0,6,35,2542,18,1348,6905562.176470588,139.0,74.88888888888889,17,1194,7323464.25,123.0,70.23529411764706
100971.0,17,2,762,2,762,0.0,381.0,381.0,0,0,0.0,0.0,0.0
102276659.0,17,14,864,7,432,17001460.166666668,174.0,61.71428571428572,7,432,17000165.5,174.0,61.71428571428572
298306.0,6,6,412,4,272,99435.33333333331,74.0,68.0,2,140,0.0,74.0,70.0
757.0,17,2,508,2,508,0.0,257.0,254.0,0,0,0.0,0.0,0.0
110694776.0,6,32,2236,16,1165,7379651.733333333,139.0,72.8125,16,1071,7365228.533333333,123.0,66.9375
100714201.0,6,30,2106,15,1089,7193871.5,123.0,72.6,15,1017,7178411.071428572,123.0,67.8
9890.0,17,2,582,1,83,0.0,83.0,83.0,1,499,0.0,499.0,499.0
120080394.0,6,607,97768,301,20236,400267.98,214.0,67.22923588039868,306,77532,392932.3147540984,1514.0,253.37254901960785
153411.0,17,2,180,1,90,0.0,90.0,90.0,1,90,0.0,90.0,90.0
144875.0,17,2,180,1,70,0.0,70.0,70.0,1,110,0.0,110.0,110.0
27854613.0,6,13,5334,8,1316,3979230.4285714286,263.0,164.5,5,4018,6902690.5,988.0,803.6
219837.0,6,3,426,2,280,0.0,214.0,140.0,1,146,0.0,146.0,146.0
99765181.0,17,12,778,6,389,19936936.0,174.0,64.83333333333333,6,389,19921014.8,174.0,64.83333333333333
125829272.0,6,59,12337,29,6449,3433613.4285714286,1514.0,222.3793103448276,30,5888,4331513.517241379,1514.0,196.26666666666668
70051.0,17,2,604,1,75,0.0,75.0,75.0,1,529,0.0,529.0,529.0
327495.0,6,12,1373,7,714,54582.5,298.0,102.0,5,659,77546.0,379.0,131.8
2506983.0,6,3,1604,2,851,0.0,785.0,425.5,1,753,0.0,753.0,753.0
112159808.0,6,32,2236,16,1165,7477320.533333333,139.0,72.8125,16,1071,7462900.4,123.0,66.9375
220402.0,17,2,180,1,90,0.0,90.0,90.0,1,90,0.0,90.0,90.0
108113416.0,17,5,955,5,955,27028354.0,191.0,191.0,0,0,0.0,0.0,0.0
172161.0,17,2,180,1,90,0.0,90.0,90.0,1,90,0.0,90.0,90.0
2109.0,17,4,344,2,150,0.0,75.0,75.0,2,194,0.0,103.0,97.0
90363526.0,6,11,1644,7,828,15060587.666666666,188.0,118.28571428571428,4,816,20111213.33333333,204.0,204.0
3167372.0,6,3,1604,2,851,0.0,785.0,425.5,1,753,0.0,753.0,753.0
90056559.0,17,28,13364,28,13364,3335428.111111111,501.0,477.2857142857143,0,0,0.0,0.0,0.0
115001347.0,17,13,821,7,432,19166891.166666668,174.0,61.71428571428572,6,389,19000478.6,174.0,64.83333333333333
113264884.0,6,46,3036,23,1518,5135894.318181818,66.0,66.0,23,1518,5135897.090909091,66.0,66.0
120184429.0,6,214,24308,107,7358,1116382.952830189,140.0,68.76635514018692,107,16950,1126073.4433962265,284.0,158.41121495327104
38525.0,6,14,4740,7,653,6293.333333333333,249.0,93.28571428571428,7,4087,6236.833333333333,1514.0,583.8571428571429
118457382.0,6,601,83426,301,63404,394857.94,480.0,210.64451827242524,300,20022,395330.4882943144,140.0,66.74
0.0,17,1,44,1,44,0.0,44.0,44.0,0,0,0.0,0.0,0.0
106004860.0,17,13,821,7,432,17667476.666666668,174.0,61.71428571428572,6,389,19882925.2,174.0,64.83333333333333
2305.0,17,4,344,2,150,0.0,75.0,75.0,2,194,0.0,103.0,97.0
39526.0,6,14,4740,7,653,6444.5,249.0,93.28571428571428,7,4087,6392.5,1514.0,583.8571428571429
36184.0,6,14,4740,7,653,5853.166666666667,249.0,93.28571428571428,7,4087,5195.166666666667,1514.0,583.8571428571429
14661256.0,6,19,1594,9,962,1793494.875,315.0,106.88888888888889,10,632,1594192.2222222222,78.0,63.2
220685.0,6,3,426,2,280,0.0,214.0,140.0,1,146,0.0,146.0,146.0
25640.0,6,10,2032,5,524,6018.0,252.0,104.8,5,1508,6168.5,1236.0,301.6
98165.0,17,2,762,2,762,0.0,381.0,381.0,0,0,0.0,0.0,0.0
865779.0,6,9,1267,6,796,173155.8,458.0,132.66666666666666,3,471,295151.0,331.0,157.0
54604.0,6,14,4740,7,653,8449.5,249.0,93.28571428571428,7,4087,8657.666666666666,1514.0,583.8571428571429
104240333.0,6,200,22536,100,15714,1050757.9494949495,284.0,157.14,100,6822,1050759.1717171718,140.0,68.22
90256875.0,6,12,1832,8,1016,12893839.285714284,188.0,127.0,4,816,30030582.33333333,204.0,204.0
48583.0,6,14,4740,7,653,6648.333333333333,249.0,93.28571428571428,7,4087,7922.166666666667,1514.0,583.8571428571429
309350.0,6,6,412,4,272,103116.66666666669,74.0,68.0,2,140,0.0,74.0,70.0
104399443.0,6,44,2904,22,1452,4971402.047619048,66.0,66.0,22,1452,4956704.476190476,66.0,66.0
75055.0,6,14,4740,7,653,11401.333333333334,249.0,93.28571428571428,7,4087,12332.333333333334,1514.0,583.8571428571429
101812807.0,17,14,864,7,432,16833498.0,174.0,61.71428571428572,7,432,16833250.166666668,174.0,61.71428571428572
307104.0,6,10,1221,6,636,61420.8,298.0,106.0,4,585,96948.33333333331,379.0,146.25
97509811.0,6,26,1746,13,906,8107824.75,123.0,69.6923076923077,13,840,8107846.416666667,123.0,64.61538461538461
120121796.0,6,14,2224,9,1204,15015224.5,188.0,133.77777777777777,5,1020,22522099.5,204.0,204.0
121348.0,6,3,337,2,214,0.0,160.0,107.0,1,123,0.0,123.0,123.0
297510.0,6,6,412,4,272,99170.0,74.0,68.0,2,140,0.0,74.0,70.0
90255451.0,6,13,2036,8,1016,12893635.857142856,188.0,127.0,5,1020,22522257.25,204.0,204.0
121007078.0,17,15,907,8,475,17286725.42857143,174.0,59.375,7,432,16833515.666666668,174.0,61.71428571428572
205852.0,17,2,180,1,90,0.0,90.0,90.0,1,90,0.0,90.0,90.0
93904561.0,6,559,109564,283,90904,332994.89716312056,1514.0,321.2155477031802,276,18660,336732.19272727275,214.0,67.6086956521739
1307918.0,6,4,264,2,132,0.0,66.0,66.0,2,132,0.0,66.0,66.0
0.0,17,1,350,1,350,0.0,350.0,350.0,0,0,0.0,0.0,0.0
39849.0,6,10,2032,5,524,9721.25,252.0,104.8,5,1508,9708.0,1236.0,301.6
265634.0,6,10,1221,6,636,53126.8,298.0,106.0,4,585,82811.66666666667,379.0,146.25
119998789.0,6,29,2222,13,1030,9999899.083333334,95.0,79.23076923076923,16,1192,7982847.6,95.0,74.5
138419.0,17,2,176,1,80,0.0,80.0,80.0,1,96,0.0,96.0,96.0
105081.0,17,2,762,2,762,0.0,381.0,381.0,0,0,0.0,0.0,0.0
326.0,17,2,174,1,79,0.0,79.0,79.0,1,95,0.0,95.0,95.0
2349.0,17,4,344,2,150,0.0,75.0,75.0,2,194,0.0,103.0,97.0
33108.0,6,11,2098,6,590,6030.8,252.0,98.33333333333331,5,1508,7343.0,1236.0,301.6
90017701.0,17,28,13364,28,13364,3333988.925925926,501.0,477.2857142857143,0,0,0.0,0.0,0.0
57903.0,6,14,4740,7,653,8827.333333333334,249.0,93.28571428571428,7,4087,9441.0,1514.0,583.8571428571429
149725600.0,17,36,17126,36,17126,4277874.285714285,501.0,475.72222222222223,0,0,0.0,0.0,0.0
144934.0,17,2,180,1,70,0.0,70.0,70.0,1,110,0.0,110.0,110.0
2091.0,17,4,344,2,150,0.0,75.0,75.0,2,194,0.0,103.0,97.0
90301006.0,6,16,1192,8,596,12893152.285714284,95.0,74.5,8,596,12897156.285714284,95.0,74.5
108099627.0,17,5,955,5,955,27024906.75,191.0,191.0,0,0,0.0,0.0,0.0
205731.0,17,2,180,1,90,0.0,90.0,90.0,1,90,0.0,90.0,90.0
102412.0,17,2,286,2,286,0.0,143.0,143.0,0,0,0.0,0.0,0.0
11101860.0,17,4,1368,4,1368,3700620.0,342.0,342.0,0,0,0.0,0.0,0.0
90261073.0,6,14,2240,8,1016,12894439.0,188.0,127.0,6,1224,18019076.0,204.0,204.0
5006169.0,17,4,534,2,166,0.0,83.0,83.0,2,368,0.0,184.0,184.0
815.0,17,4,438,2,148,0.0,74.0,74.0,2,290,0.0,147.0,145.0
41312.0,6,14,4740,7,653,6599.666666666667,249.0,93.28571428571428,7,4087,6712.5,1514.0,583.8571428571429
24782.0,6,14,4740,7,653,4015.3333333333335,249.0,93.28571428571428,7,4087,3941.1666666666665,1514.0,583.8571428571429
90037795.0,17,28,13364,28,13364,3334733.1481481483,501.0,477.2857142857143,0,0,0.0,0.0,0.0
2439.0,17,4,344,2,150,0.0,75.0,75.0,2,194,0.0,103.0,97.0
35165.0,6,14,4740,7,653,5054.0,249.0,93.28571428571428,7,4087,5719.333333333333,1514.0,583.8571428571429
90292860.0,6,19,1436,10,745,10026737.555555556,95.0,74.5,9,691,11283663.625,95.0,76.77777777777777
47670.0,6,13,1386,7,789,7945.0,253.0,112.71428571428572,6,597,6205.2,259.0,99.5
233124.0,6,3,337,2,214,0.0,160.0,107.0,1,123,0.0,123.0,123.0
1435995.0,17,16,1120,16,1120,95733.0,70.0,70.0,0,0,0.0,0.0,0.0
120120932.0,6,14,2240,8,1016,17137329.42857143,188.0,127.0,6,1224,18018793.4,204.0,204.0
103943.0,17,2,286,2,286,0.0,143.0,143.0,0,0,0.0,0.0,0.0
90258837.0,6,12,1832,8,1016,12894119.57142857,188.0,127.0,4,816,30030037.33333333,204.0,204.0
491472.0,6,3,204,2,136,0.0,70.0,68.0,1,68,0.0,68.0,68.0
856869.0,6,9,1196,6,725,171373.8,387.0,120.83333333333331,3,471,292162.5,331.0,157.0
3173853.0,6,18,1495,9,921,358254.125,315.0,102.33333333333331,9,574,358225.125,78.0,63.77777777777778
2998213.0,6,3,1604,2,851,0.0,785.0,425.5,1,753,0.0,753.0,753.0
30335.0,6,10,2032,5,524,7373.75,252.0,104.8,5,1508,5191.75,1236.0,301.6
78126.0,6,14,4740,7,653,12081.0,249.0,93.28571428571428,7,4087,12169.833333333334,1514.0,583.8571428571429
206171.0,6,3,426,2,280,0.0,214.0,140.0,1,146,0.0,146.0,146.0
120106985.0,6,212,23884,106,7218,1135994.1904761903,140.0,68.09433962264151,106,16666,1136009.7238095235,284.0,157.2264150943396
100360174.0,17,12,778,6,389,20001034.4,174.0,64.83333333333333,6,389,20000209.0,174.0,64.83333333333333
206117.0,6,3,426,2,280,0.0,214.0,140.0,1,146,0.0,146.0,146.0
947.0,17,2,762,2,762,0.0,381.0,381.0,0,0,0.0,0.0,0.0
248592.0,17,4,6056,4,6056,82864.0,1514.0,1514.0,0,0,0.0,0.0,0.0
90307086.0,6,16,1192,8,596,12893005.857142856,95.0,74.5,8,596,12899491.42857143,95.0,74.5
90050775.0,17,28,13364,28,13364,3335213.888888889,501.0,477.2857142857143,0,0,0.0,0.0,0.0
110001088.0,17,14,864,7,432,18333514.666666668,174.0,61.71428571428572,7,432,18167982.33333333,174.0,61.71428571428572
90523350.0,6,14,2240,8,1016,12931907.142857144,188.0,127.0,6,1224,18070914.0,204.0,204.0
1276967.0,6,20,6916,11,3099,127696.7,1514.0,281.72727272727275,9,3817,131949.375,1514.0,424.1111111111111
31267.000000000004,6,10,2032,5,524,7492.0,252.0,104.8,5,1508,7319.0,1236.0,301.6
239102.0,17,2,180,1,70,0.0,70.0,70.0,1,110,0.0,110.0,110.0
19814657.0,6,24,10146,13,1735,1651221.4166666667,408.0,133.46153846153845,11,8411,1568907.0,1514.0,764.6363636363636
90303309.0,6,16,1192,8,596,12893449.0,95.0,74.5,8,596,12900096.42857143,95.0,74.5
0.0,6,1,66,1,66,0.0,66.0,66.0,0,0,0.0,0.0,0.0
38972.0,6,10,2032,5,524,9346.25,252.0,104.8,5,1508,7156.0,1236.0,301.6
129131.0,6,2,132,1,66,0.0,66.0,66.0,1,66,0.0,66.0,66.0
205959.0,6,3,426,2,280,0.0,214.0,140.0,1,146,0.0,146.0,146.0
143909.0,17,2,180,1,90,0.0,90.0,90.0,1,90,0.0,90.0,90.0
93140244.0,6,32,2506,17,1351,5821265.25,139.0,79.47058823529412,15,1155,6637411.857142857,123.0,77.0
90912302.0,6,35,2310,18,1188,5347765.647058823,66.0,66.0,17,1122,5457006.0,66.0,66.0
228177.0,17,2,180,1,90,0.0,90.0,90.0,1,90,0.0,90.0,90.0
1063189.0,6,13,1386,7,789,177198.16666666666,253.0,112.71428571428572,6,597,209109.0,259.0,99.5
41021.0,6,14,4740,7,653,6648.166666666667,249.0,93.28571428571428,7,4087,6503.166666666667,1514.0,583.8571428571429
38339.0,6,14,4740,7,653,5713.666666666667,249.0,93.28571428571428,7,4087,5900.5,1514.0,583.8571428571429
18903.0,6,14,4740,7,653,2965.6666666666665,249.0,93.28571428571428,7,4087,2686.6666666666665,1514.0,583.8571428571429
2597082.0,6,2,132,1,66,0.0,66.0,66.0,1,66,0.0,66.0,66.0
90261463.0,6,15,2444,8,1016,12894494.714285716,188.0,127.0,7,1428,15016148.333333334,204.0,204.0
112609618.0,17,14,864,7,432,18668069.666666668,174.0,61.71428571428572,7,432,18666829.166666668,174.0,61.71428571428572
10460616.0,6,7,478,4,272,3441479.0,74.0,68.0,3,206,5162088.0,74.0,68.66666666666667
157824.0,17,2,180,1,90,0.0,90.0,90.0,1,90,0.0,90.0,90.0
210200.0,17,2,180,1,90,0.0,90.0,90.0,1,90,0.0,90.0,90.0
104242182.0,6,28,1876,14,982,8002023.230769231,139.0,70.14285714285714,14,894,8002034.846153846,123.0,63.85714285714285
34692.0,6,14,4740,7,653,4249.166666666667,249.0,93.28571428571428,7,4087,5605.833333333333,1514.0,583.8571428571429
5003614.0,17,4,629,2,156,0.0,78.0,78.0,2,473,0.0,268.0,236.5
120234.0,17,2,180,1,70,0.0,70.0,70.0,1,110,0.0,110.0,110.0
1384279.0,17,16,1120,16,1120,92285.26666666666,70.0,70.0,0,0,0.0,0.0,0.0
320969.0,17,4,1400,4,1400,106989.66666666669,350.0,350.0,0,0,0.0,0.0,0.0
168098.0,17,2,414,1,88,0.0,88.0,88.0,1,326,0.0,326.0,326.0
1029887.0,6,11,1134,6,558,205977.4,220.0,93.0,5,576,256453.75,304.0,115.2
108103430.0,17,5,955,5,955,27025857.5,191.0,191.0,0,0,0.0,0.0,0.0
4635.0,17,2,614,1,72,0.0,72.0,72.0,1,542,0.0,542.0,542.0
48248.0,6,14,4740,7,653,7869.166666666667,249.0,93.28571428571428,7,4087,7757.166666666667,1514.0,583.8571428571429
94651.0,17,2,286,2,286,0.0,143.0,143.0,0,0,0.0,0.0,0.0
95000812.0,17,11,735,6,389,19000162.4,174.0,64.83333333333333,5,346,19939242.25,174.0,69.2
43394.0,6,14,4740,7,653,7075.666666666667,249.0,93.28571428571428,7,4087,7091.833333333333,1514.0,583.8571428571429
323866.0,6,6,412,4,272,107955.33333333331,74.0,68.0,2,140,0.0,74.0,70.0
33065.0,6,14,4740,7,653,4636.666666666667,249.0,93.28571428571428,7,4087,5248.166666666667,1514.0,583.8571428571429
307016.0,6,6,412,4,272,102338.66666666669,74.0,68.0,2,140,0.0,74.0,70.0
42263.0,6,10,2032,5,524,10128.0,252.0,104.8,5,1508,9817.0,1236.0,301.6
15923977.0,17,6,2052,6,2052,3184795.4,342.0,342.0,0,0,0.0,0.0,0.0
56521.0,6,14,4740,7,653,9007.166666666666,249.0,93.28571428571428,7,4087,8249.833333333334,1514.0,583.8571428571429
153491.0,17,2,180,1,90,0.0,90.0,90.0,1,90,0.0,90.0,90.0
2202553.0,6,25,7611,13,2516,183514.5,1034.0,193.53846153846155,12,5095,172811.18181818182,1510.0,424.5833333333333
101040045.0,6,40,2640,20,1320,5317897.105263158,66.0,66.0,20,1320,5301438.421052632,66.0,66.0
59981.0,6,14,4740,7,653,9656.833333333334,249.0,93.28571428571428,7,4087,8920.0,1514.0,583.8571428571429
45287.0,6,14,4740,7,653,6585.333333333333,249.0,93.28571428571428,7,4087,7402.833333333333,1514.0,583.8571428571429
4521.0,17,2,180,1,90,0.0,90.0,90.0,1,90,0.0,90.0,90.0
19632.0,6,14,4740,7,653,3050.5,249.0,93.28571428571428,7,4087,3140.0,1514.0,583.8571428571429
14307.0,6,11,1133,6,602,2861.4,264.0,100.33333333333331,5,531,2871.25,259.0,106.2
206613.0,6,3,426,2,280,0.0,214.0,140.0,1,146,0.0,146.0,146.0
32056.0,6,10,2032,5,524,7762.5,252.0,104.8,5,1508,6735.75,1236.0,301.6
236158.0,6,3,337,2,214,0.0,160.0,107.0,1,123,0.0,123.0,123.0
686656.0,6,4,508,2,238,0.0,172.0,119.0,2,270,0.0,135.0,135.0
48320.0,6,10,2032,5,524,10846.5,252.0,104.8,5,1508,11593.25,1236.0,301.6
146208.0,6,3,337,2,214,0.0,160.0,107.0,1,123,0.0,123.0,123.0
111498812.0,6,32,2220,16,1149,7418850.866666666,123.0,71.8125,16,1071,7418852.2,123.0,66.9375
903.0,17,4,438,2,148,0.0,74.0,74.0,2,290,0.0,147.0,145.0
120564572.0,6,227,25722,114,18042,1066943.1150442478,284.0,158.26315789473685,113,7680,1067127.9375,140.0,67.96460176991151
1575313.0,6,2,132,1,66,0.0,66.0,66.0,1,66,0.0,66.0,66.0
118327204.0,6,223,25156,112,7688,1066010.8468468469,140.0,68.64285714285714,111,17468,1066222.1272727272,284.0,157.36936936936937
217753.0,6,3,426,2,280,0.0,214.0,140.0,1,146,0.0,146.0,146.0
120200344.0,6,47,3102,23,1518,5143988.045454546,66.0,66.0,24,1584,5226090.608695652,66.0,66.0
43392.0,6,14,4740,7,653,6583.666666666667,249.0,93.28571428571428,7,4087,7026.166666666667,1514.0,583.8571428571429
298740.0,6,6,412,4,272,99580.0,74.0,68.0,2,140,0.0,74.0,70.0
1302569.0,6,4,264,2,132,0.0,66.0,66.0,2,132,0.0,66.0,66.0
153542.0,17,2,180,1,90,0.0,90.0,90.0,1,90,0.0,90.0,90.0
42218.0,6,13,4519,6,512,8005.0,230.0,85.33333333333333,7,4007,6570.166666666667,1514.0,572.4285714285714
120049758.0,6,899,168814,457,138902,262794.6688596491,1514.0,303.9431072210066,442,29912,271733.4580498866,214.0,67.67420814479638
159276.0,6,3,337,2,214,0.0,160.0,107.0,1,123,0.0,123.0,123.0
1039320.0,6,13,1386,7,789,173220.0,253.0,112.71428571428572,6,597,205728.6,259.0,99.5
100622381.0,17,12,516,6,258,20000180.8,43.0,43.0,6,258,20001805.6,43.0,43.0
92224.0,6,2,132,1,66,0.0,66.0,66.0,1,66,0.0,66.0,66.0
317562.0,6,3,202,2,128,0.0,74.0,64.0,1,74,0.0,74.0,74.0
90301791.0,6,12,1832,8,1016,12900255.857142856,188.0,127.0,4,816,30045750.0,204.0,204.0
157675.0,6,3,337,2,214,0.0,160.0,107.0,1,123,0.0,123.0,123.0
32297.0,6,14,4740,7,653,4757.5,249.0,93.28571428571428,7,4087,4427.833333333333,1514.0,583.8571428571429
112735.0,17,2,286,2,286,0.0,143.0,143.0,0,0,0.0,0.0,0.0
97253367.0,6,28,2008,14,963,7481028.230769231,123.0,68.78571428571429,14,1045,6696374.461538462,139.0,74.64285714285714
12225.0,17,2,582,1,83,0.0,83.0,83.0,1,499,0.0,499.0,499.0
112953.0,17,2,286,2,286,0.0,143.0,143.0,0,0,0.0,0.0,0.0
2430.0,17,4,344,2,150,0.0,75.0,75.0,2,194,0.0,103.0,97.0
3547.0,17,2,414,1,88,0.0,88.0,88.0,1,326,0.0,326.0,326.0
842.0,17,4,438,2,148,0.0,74.0,74.0,2,290,0.0,147.0,145.0
120309094.0,6,278,32042,139,9396,860786.9130434783,140.0,67.59712230215827,139,22646,865594.2246376812,284.0,162.9208633093525
14799427.0,6,8,602,5,404,2752060.75,103.0,80.8,3,198,2047805.5,66.0,66.0
119644957.0,6,206,23314,103,7094,1172989.774509804,140.0,68.87378640776699,103,16220,1170820.9215686277,284.0,157.4757281553398
63373.0,6,14,4740,7,653,10061.0,249.0,93.28571428571428,7,4087,10420.833333333334,1514.0,583.8571428571429
377225.0,17,8,12112,8,12112,53889.28571428572,1514.0,1514.0,0,0,0.0,0.0,0.0
301.0,17,2,168,1,76,0.0,76.0,76.0,1,92,0.0,92.0,92.0
1619886.0,17,6,1230,3,234,809764.0,78.0,78.0,3,996,809739.0,332.0,332.0
120116496.0,6,13,2036,8,1016,17136286.42857143,188.0,127.0,5,1020,22523452.0,204.0,204.0
3857920.0,6,5,336,2,134,0.0,68.0,67.0,3,202,1423946.0,70.0,67.33333333333333
2383.0,17,4,344,2,150,0.0,75.0,75.0,2,194,0.0,103.0,97.0
90043529.0,17,28,13364,28,13364,3334945.5185185187,501.0,477.2857142857143,0,0,0.0,0.0,0.0
235507.0,6,3,373,2,238,0.0,172.0,119.0,1,135,0.0,135.0,135.0
108099443.0,17,5,955,5,955,27024860.75,191.0,191.0,0,0,0.0,0.0,0.0
197014.0,17,2,180,1,90,0.0,90.0,90.0,1,90,0.0,90.0,90.0
401.0,17,2,410,1,78,0.0,78.0,78.0,1,332,0.0,332.0,332.0
135138388.0,17,6,1146,6,1146,27027677.6,191.0,191.0,0,0,0.0,0.0,0.0
92817861.0,6,37,2442,19,1254,5156547.833333333,66.0,66.0,18,1188,4995928.235294118,66.0,66.0
118883624.0,17,16,1474,8,737,16960675.0,174.0,92.125,8,737,16970507.14285714,174.0,92.125
2550461.0,6,3,1777,2,951,0.0,885.0,475.5,1,826,0.0,826.0,826.0
2437.0,17,4,344,2,150,0.0,75.0,75.0,2,194,0.0,103.0,97.0
6515.0,17,2,239,1,82,0.0,82.0,82.0,1,157,0.0,157.0,157.0
36289.0,6,10,2032,5,524,8577.0,252.0,104.8,5,1508,7750.75,1236.0,301.6
90003355.0,17,28,13364,28,13364,3333457.592592593,501.0,477.2857142857143,0,0,0.0,0.0,0.0
234272.0,6,3,373,2,238,0.0,172.0,119.0,1,135,0.0,135.0,135.0
45131.0,6,14,4740,7,653,7349.666666666667,249.0,93.28571428571428,7,4087,7295.333333333333,1514.0,583.8571428571429
51892.0,6,10,2032,5,524,12754.0,252.0,104.8,5,1508,12561.25,1236.0,301.6
153409.0,17,2,180,1,90,0.0,90.0,90.0,1,90,0.0,90.0,90.0
70115.0,6,14,4740,7,653,11523.833333333334,249.0,93.28571428571428,7,4087,11494.5,1514.0,583.8571428571429
54057.0,6,14,4740,7,653,8277.5,249.0,93.28571428571428,7,4087,7756.333333333333,1514.0,583.8571428571429
233276.0,6,4,439,2,238,0.0,172.0,119.0,2,201,0.0,135.0,100.5
59194.0,6,10,1913,5,461,5259.25,233.0,92.2,5,1452,14461.75,1224.0,290.4
27767897.0,6,5,1736,2,819,0.0,753.0,409.5,3,917,13814437.5,785.0,305.6666666666667
122530433.0,6,49,3234,25,1650,5105434.708333333,66.0,66.0,24,1584,4979379.913043479,66.0,66.0
104915523.0,17,13,4446,13,4446,8742960.25,342.0,342.0,0,0,0.0,0.0,0.0
1307006.0,6,4,264,2,132,0.0,66.0,66.0,2,132,0.0,66.0,66.0
100165706.0,17,12,778,6,389,20033141.2,174.0,64.83333333333333,6,389,19999637.6,174.0,64.83333333333333
42431.0,6,14,4740,7,653,6735.833333333333,249.0,93.28571428571428,7,4087,6936.0,1514.0,583.8571428571429
24631.0,6,14,4740,7,653,3945.3333333333335,249.0,93.28571428571428,7,4087,3824.5,1514.0,583.8571428571429
120008730.0,17,28,13364,28,13364,4444767.777777778,501.0,477.2857142857143,0,0,0.0,0.0,0.0
238287.0,6,12,1373,7,714,39714.5,298.0,102.0,5,659,58322.25,379.0,131.8
302519.0,6,6,412,4,272,100839.66666666669,74.0,68.0,2,140,0.0,74.0,70.0
15500.0,6,10,2032,5,524,3632.0,252.0,104.8,5,1508,3642.0,1236.0,301.6
104889.0,17,2,286,2,286,0.0,143.0,143.0,0,0,0.0,0.0,0.0
214116.0,6,10,1221,6,636,42823.2,298.0,106.0,4,585,70431.66666666667,379.0,146.25
299588.0,6,6,412,4,272,99862.66666666669,74.0,68.0,2,140,0.0,74.0,70.0
37597.0,6,14,4740,7,653,5926.166666666667,249.0,93.28571428571428,7,4087,6134.5,1514.0,583.8571428571429
232927.0,6,3,337,2,214,0.0,160.0,107.0,1,123,0.0,123.0,123.0
5661151.0,6,5,336,2,134,0.0,68.0,67.0,3,202,1546906.0,70.0,67.33333333333333
7024.0,17,4,344,2,150,0.0,75.0,75.0,2,194,0.0,103.0,97.0
25012.0,17,2,582,1,83,0.0,83.0,83.0,1,499,0.0,499.0,499.0
197022.0,17,2,180,1,90,0.0,90.0,90.0,1,90,0.0,90.0,90.0
119385406.0,17,34,16284,34,16284,3617739.575757576,501.0,478.9411764705882,0,0,0.0,0.0,0.0
115239202.0,6,48,3168,24,1584,5010400.0869565215,66.0,66.0,24,1584,4996704.434782608,66.0,66.0
201757.0,17,2,180,1,90,0.0,90.0,90.0,1,90,0.0,90.0,90.0
135133049.0,17,6,1206,6,1206,27026609.8,201.0,201.0,0,0,0.0,0.0,0.0
90290594.0,6,16,1192,8,596,12891093.0,95.0,74.5,8,596,12897111.57142857,95.0,74.5
298966.0,6,6,412,4,272,99655.33333333331,74.0,68.0,2,140,0.0,74.0,70.0
232170.0,6,3,337,2,214,0.0,160.0,107.0,1,123,0.0,123.0,123.0
5623175.0,6,5,336,2,134,0.0,68.0,67.0,3,202,1524026.0,70.0,67.33333333333333
300624.0,6,6,412,4,272,100208.0,74.0,68.0,2,140,0.0,74.0,70.0
19752364.0,6,24,8675,14,1785,1519412.6153846155,408.0,127.5,10,6890,1736190.6666666667,1514.0,689.0
23946.0,6,14,4740,7,653,3814.5,249.0,93.28571428571428,7,4087,3817.8333333333335,1514.0,583.8571428571429
108111873.0,17,5,955,5,955,27027968.25,191.0,191.0,0,0,0.0,0.0,0.0
2383.0,17,4,344,2,150,0.0,75.0,75.0,2,194,0.0,103.0,97.0
33215.0,6,14,4740,7,653,4983.0,249.0,93.28571428571428,7,4087,4290.5,1514.0,583.8571428571429
138992.0,6,2,132,1,66,0.0,66.0,66.0,1,66,0.0,66.0,66.0
90046672.0,17,27,12943,27,12943,3463333.5384615385,501.0,479.3703703703704,0,0,0.0,0.0,0.0
196985.0,17,2,180,1,90,0.0,90.0,90.0,1,90,0.0,90.0,90.0
869377.0,6,9,1270,6,799,173875.4,461.0,133.16666666666666,3,471,297086.5,331.0,157.0
6974.0,17,2,582,1,83,0.0,83.0,83.0,1,499,0.0,499.0,499.0
233712.0,6,3,373,2,238,0.0,172.0,119.0,1,135,0.0,135.0,135.0
960011.0,6,12,1354,6,723,191158.2,253.0,120.5,6,631,191661.0,293.0,105.16666666666669
107460538.0,6,190,21490,95,14998,1140894.2765957448,300.0,157.8736842105263,95,6492,1140896.1382978724,140.0,68.33684210526316
43193.0,6,14,4740,7,653,6949.0,249.0,93.28571428571428,7,4087,7015.5,1514.0,583.8571428571429
120317221.0,6,233,26372,117,18420,1037217.4224137932,284.0,157.43589743589743,116,7952,1038097.1217391304,140.0,68.55172413793103
91478.0,6,15,4806,8,719,12381.42857142857,249.0,89.875,7,4087,14765.0,1514.0,583.8571428571429
5830410.0,6,5,336,2,134,0.0,68.0,67.0,3,202,1522940.5,70.0,67.33333333333333
1178506.0,6,13,3010,8,2382,168358.0,1514.0,297.75,5,628,225659.0,331.0,125.6
2363.0,17,4,344,2,150,0.0,75.0,75.0,2,194,0.0,103.0,97.0
4667.0,17,2,614,1,72,0.0,72.0,72.0,1,542,0.0,542.0,542.0
41216.0,6,14,4740,7,653,6748.0,249.0,93.28571428571428,7,4087,6590.666666666667,1514.0,583.8571428571429
360.0,17,2,166,1,75,0.0,75.0,75.0,1,91,0.0,91.0,91.0
146070.0,6,3,337,2,214,0.0,160.0,107.0,1,123,0.0,123.0,123.0
1988.0,17,4,344,2,150,0.0,75.0,75.0,2,194,0.0,103.0,97.0
206527.0,17,4,1400,4,1400,68842.33333333333,350.0,350.0,0,0,0.0,0.0,0.0
90020175.0,17,28,13364,28,13364,3334080.5555555555,501.0,477.2857142857143,0,0,0.0,0.0,0.0
153417.0,17,2,180,1,90,0.0,90.0,90.0,1,90,0.0,90.0,90.0
136005884.0,17,17,1255,9,649,17000735.5,174.0,72.11111111111111,8,606,16428710.0,174.0,75.75
299860.0,6,7,478,4,272,99953.33333333331,74.0,68.0,3,206,76100.0,74.0,68.66666666666667
216400.0,17,2,180,1,90,0.0,90.0,90.0,1,90,0.0,90.0,90.0
108103084.0,17,5,955,5,955,27025771.0,191.0,191.0,0,0,0.0,0.0,0.0
18643291.0,6,8,602,5,404,3712864.75,103.0,80.8,3,198,2047947.5,66.0,66.0
902.0,17,5,550,5,550,225.5,110.0,110.0,0,0,0.0,0.0,0.0
218500.0,6,3,426,2,280,0.0,214.0,140.0,1,146,0.0,146.0,146.0
284168.0,17,2,363,1,79,0.0,79.0,79.0,1,284,0.0,284.0,284.0
91701817.0,6,21,1626,12,935,8331939.272727272,95.0,77.91666666666667,9,691,11400903.0,95.0,76.77777777777777
2332.0,17,4,344,2,150,0.0,75.0,75.0,2,194,0.0,103.0,97.0
2447.0,17,4,344,2,150,0.0,75.0,75.0,2,194,0.0,103.0,97.0
108101416.0,17,5,955,5,955,27025354.0,191.0,191.0,0,0,0.0,0.0,0.0
1998.0,17,4,344,2,150,0.0,75.0,75.0,2,194,0.0,103.0,97.0
120267812.0,6,246,28410,123,8414,979054.9016393444,140.0,68.40650406504065,123,19996,979073.8852459016,336.0,162.5691056910569
3008802.0,6,11,2106,6,598,601533.8,252.0,99.66666666666669,5,1508,2072.0,1236.0,301.6
228229.0,17,2,180,1,90,0.0,90.0,90.0,1,90,0.0,90.0,90.0
309690.0,6,6,412,4,272,103230.0,74.0,68.0,2,140,0.0,74.0,70.0
90287296.0,6,16,1192,8,596,12891145.0,95.0,74.5,8,596,12897253.714285716,95.0,74.5
300.0,17,2,164,1,82,0.0,82.0,82.0,1,82,0.0,82.0,82.0
2805.0,17,2,762,2,762,0.0,381.0,381.0,0,0,0.0,0.0,0.0
2858418.0,6,12,2172,7,664,476254.0,252.0,94.85714285714286,5,1508,1695.5,1236.0,301.6
1187735.0,6,13,3018,8,2390,169676.42857142858,1514.0,298.75,5,628,228721.75,331.0,125.6
120245196.0,17,13,821,6,389,20108515.4,174.0,64.83333333333333,7,432,20014233.166666668,174.0,61.71428571428572
290360.0,17,2,180,1,90,0.0,90.0,90.0,1,90,0.0,90.0,90.0
90064780.0,6,13,1776,6,948,18012481.8,204.0,158.0,7,828,15010206.333333334,188.0,118.28571428571428
204844.0,17,2,762,2,762,0.0,381.0,381.0,0,0,0.0,0.0,0.0
148054.0,17,2,180,1,90,0.0,90.0,90.0,1,90,0.0,90.0,90.0
9902.0,17,2,582,1,83,0.0,83.0,83.0,1,499,0.0,499.0,499.0
197294.0,17,2,180,1,90,0.0,90.0,90.0,1,90,0.0,90.0,90.0
120853461.0,6,31,2034,16,1086,8056897.4,123.0,67.875,15,948,7903704.071428572,123.0,63.2
137652.0,6,2,132,1,66,0.0,66.0,66.0,1,66,0.0,66.0,66.0
140365.0,6,2,132,1,66,0.0,66.0,66.0,1,66,0.0,66.0,66.0
2008.0,17,4,344,2,150,0.0,75.0,75.0,2,194,0.0,103.0,97.0
1037062.0,6,11,1134,6,558,207412.4,220.0,93.0,5,576,257869.5,304.0,115.2
58904644.0,17,9,3086,8,2736,5110541.714285715,342.0,342.0,1,350,0.0,350.0,350.0
75084.0,6,14,4740,7,653,11755.666666666666,249.0,93.28571428571428,7,4087,12344.833333333334,1514.0,583.8571428571429
10426589.0,6,7,478,4,272,3430030.0,74.0,68.0,3,206,5144938.0,74.0,68.66666666666667
120122818.0,6,14,2224,9,1204,15015352.25,188.0,133.77777777777777,5,1020,22523481.0,204.0,204.0
108108708.0,17,5,1005,5,1005,27027177.0,201.0,201.0,0,0,0.0,0.0,0.0
27070.0,6,14,4740,7,653,3889.8333333333335,249.0,93.28571428571428,7,4087,4142.333333333333,1514.0,583.8571428571429
316396.0,17,4,1400,4,1400,105465.33333333331,350.0,350.0,0,0,0.0,0.0,0.0
92713343.0,6,38,2508,19,1254,5135440.944444444,66.0,66.0,19,1254,5135437.0,66.0,66.0
313.0,17,2,166,1,75,0.0,75.0,75.0,1,91,0.0,91.0,91.0
710.0,17,4,438,2,148,0.0,74.0,74.0,2,290,0.0,147.0,145.0
48634984.0,6,8,1940,3,887,22947454.0,753.0,295.6666666666667,5,1053,11513770.5,785.0,210.6
412499.0,6,4,508,2,238,0.0,172.0,119.0,2,270,0.0,135.0,135.0
32579.0,6,14,4740,7,653,5134.5,249.0,93.28571428571428,7,4087,5081.0,1514.0,583.8571428571429
239146.0,6,3,337,2,214,0.0,160.0,107.0,1,123,0.0,123.0,123.0
0.0,17,1,55,1,55,0.0,55.0,55.0,0,0,0.0,0.0,0.0
311092.0,6,6,412,4,272,103697.33333333331,74.0,68.0,2,140,0.0,74.0,70.0
2415.0,17,4,344,2,150,0.0,75.0,75.0,2,194,0.0,103.0,97.0
120123620.0,6,14,2224,9,1204,15015452.5,188.0,133.77777777777777,5,1020,22517346.0,204.0,204.0
71106.0,6,10,2032,5,524,17563.75,252.0,104.8,5,1508,6039.5,1236.0,301.6
215355.0,6,3,426,2,280,0.0,214.0,140.0,1,146,0.0,146.0,146.0
36041.0,6,14,4740,7,653,5849.333333333333,249.0,93.28571428571428,7,4087,5022.5,1514.0,583.8571428571429
20780.0,17,2,582,1,83,0.0,83.0,83.0,1,499,0.0,499.0,499.0
216657.0,17,2,180,1,90,0.0,90.0,90.0,1,90,0.0,90.0,90.0
28176.0,6,14,4740,7,653,4574.0,249.0,93.28571428571428,7,4087,4221.333333333333,1514.0,583.8571428571429
3050298.0,6,3,204,1,68,0.0,68.0,68.0,2,136,0.0,70.0,68.0
116467593.0,6,48,3168,24,1584,5063808.391304348,66.0,66.0,24,1584,5051833.260869565,66.0,66.0
538.0,17,2,508,2,508,0.0,257.0,254.0,0,0,0.0,0.0,0.0
90259887.0,6,12,1832,8,1016,12894269.57142857,188.0,127.0,4,816,30032614.33333333,204.0,204.0
120004276.0,6,26,1978,14,1084,9230766.846153846,95.0,77.42857142857143,12,894,10838835.727272728,95.0,74.5
508307.0,6,5,336,2,134,0.0,68.0,67.0,3,202,182871.5,70.0,67.33333333333333
142080.0,17,4,704,2,148,0.0,74.0,74.0,2,556,0.0,280.0,278.0
1419719.0,17,16,1120,16,1120,94647.93333333332,70.0,70.0,0,0,0.0,0.0,0.0
123305578.0,6,48,3168,24,1584,5099522.739130435,66.0,66.0,24,1584,5197226.608695652,66.0,66.0
310600.0,6,6,412,4,272,103533.33333333331,74.0,68.0,2,140,0.0,74.0,70.0
120034006.0,17,28,13364,28,13364,4445703.925925926,501.0,477.2857142857143,0,0,0.0,0.0,0.0
1206236.0,6,11,1134,6,558,241247.2,220.0,93.0,5,576,299698.25,304.0,115.2
524294.0,17,6,2100,6,2100,104858.8,350.0,350.0,0,0,0.0,0.0,0.0
99323.0,17,2,762,2,762,0.0,381.0,381.0,0,0,0.0,0.0,0.0
5621391.0,6,5,336,2,134,0.0,68.0,67.0,3,202,1523480.5,70.0,67.33333333333333
120149283.0,6,14,2240,6,1224,24029856.6,204.0,204.0,8,1016,17136959.85714286,188.0,127.0
93795184.0,6,181,20504,91,6228,1042168.7111111112,140.0,68.43956043956044,90,14276,1031815.988764045,300.0,158.62222222222223
158145.0,6,3,337,2,214,0.0,160.0,107.0,1,123,0.0,123.0,123.0
8232.0,17,2,582,1,83,0.0,83.0,83.0,1,499,0.0,499.0,499.0
120248107.0,6,19,1436,9,691,14999073.75,95.0,76.77777777777777,10,745,13333334.111111112,95.0,74.5
14491.0,17,2,267,1,83,0.0,83.0,83.0,1,184,0.0,184.0,184.0
119803706.0,17,35,16705,35,16705,3523638.411764706,501.0,477.2857142857143,0,0,0.0,0.0,0.0
30839.0,6,14,4740,7,653,4517.0,249.0,93.28571428571428,7,4087,4356.333333333333,1514.0,583.8571428571429
20526.0,6,20,7606,11,978,2052.6,310.0,88.9090909090909,9,6628,2004.375,1514.0,736.4444444444445
267744.0,17,2,180,1,90,0.0,90.0,90.0,1,90,0.0,90.0,90.0
439996.0,6,11,1021,6,444,59204.4,162.0,74.0,5,577,73807.25,349.0,115.4
1032.0,17,4,438,2,148,0.0,74.0,74.0,2,290,0.0,147.0,145.0
2411.0,17,4,344,2,150,0.0,75.0,75.0,2,194,0.0,103.0,97.0
112319474.0,6,45,2970,23,1518,5105430.636363637,66.0,66.0,22,1452,5186240.428571428,66.0,66.0
135129527.0,17,6,1146,6,1146,27025905.4,191.0,191.0,0,0,0.0,0.0,0.0
90214191.0,6,16,1192,8,596,12854198.42857143,95.0,74.5,8,596,12858507.42857143,95.0,74.5
85281.0,6,14,4740,7,653,14051.333333333334,249.0,93.28571428571428,7,4087,13937.333333333334,1514.0,583.8571428571429
24139.0,6,10,2032,5,524,5360.5,252.0,104.8,5,1508,4709.25,1236.0,301.6
118704476.0,6,35,2520,18,1248,6982590.235294118,123.0,69.33333333333333,17,1272,6794845.4375,123.0,74.82352941176471
43389.0,6,14,4740,7,653,6599.0,249.0,93.28571428571428,7,4087,7092.666666666667,1514.0,583.8571428571429
106651.0,17,2,286,2,286,0.0,143.0,143.0,0,0,0.0,0.0,0.0
218290.0,17,2,180,1,90,0.0,90.0,90.0,1,90,0.0,90.0,90.0
251906.00000000003,17,4,6056,4,6056,83968.66666666667,1514.0,1514.0,0,0,0.0,0.0,0.0
318.0,17,2,174,1,79,0.0,79.0,79.0,1,95,0.0,95.0,95.0
143421.0,6,2,132,1,66,0.0,66.0,66.0,1,66,0.0,66.0,66.0
178116.0,17,2,180,1,90,0.0,90.0,90.0,1,90,0.0,90.0,90.0
15068.0,17,2,180,1,90,0.0,90.0,90.0,1,90,0.0,90.0,90.0
2344.0,17,4,344,2,150,0.0,75.0,75.0,2,194,0.0,103.0,97.0
9217.0,17,2,582,1,83,0.0,83.0,83.0,1,499,0.0,499.0,499.0
96848810.0,6,199,22380,100,6822,978270.808080808,140.0,68.22,99,15558,977649.6734693878,284.0,157.15151515151516
104684.0,17,2,286,2,286,0.0,143.0,143.0,0,0,0.0,0.0,0.0
363780.0,6,10,967,5,390,61044.75,162.0,78.0,5,577,60985.75,349.0,115.4
1310219.0,6,4,264,2,132,0.0,66.0,66.0,2,132,0.0,66.0,66.0
228433.0,17,2,180,1,90,0.0,90.0,90.0,1,90,0.0,90.0,90.0
23649.0,17,2,498,1,80,0.0,80.0,80.0,1,418,0.0,418.0,418.0
135133094.0,17,6,1146,6,1146,27026618.8,191.0,191.0,0,0,0.0,0.0,0.0
1954850.0,6,23,6507,12,1529,177713.63636363635,357.0,127.41666666666669,11,4978,164708.1,1510.0,452.54545454545456
90287359.0,6,19,1638,10,1029,10031928.777777778,342.0,102.9,9,609,11250356.625,95.0,67.66666666666667
301422.0,6,6,412,4,272,100474.0,74.0,68.0,2,140,0.0,74.0,70.0
216818.0,6,3,426,2,280,0.0,214.0,140.0,1,146,0.0,146.0,146.0
2852274.0,6,3,1604,2,851,0.0,785.0,425.5,1,753,0.0,753.0,753.0
76537.0,6,14,4740,7,653,12312.5,249.0,93.28571428571428,7,4087,8303.5,1514.0,583.8571428571429
116184291.0,6,48,3168,24,1584,5051490.913043479,66.0,66.0,24,1584,5038032.826086956,66.0,66.0
2301.0,17,4,344,2,150,0.0,75.0,75.0,2,194,0.0,103.0,97.0
29887.0,6,14,4740,7,653,4872.5,249.0,93.28571428571428,7,4087,4848.5,1514.0,583.8571428571429
118487700.0,6,574,68730,287,49566,413577.4195804196,336.0,172.70383275261324,287,19164,413577.3041958042,140.0,66.77351916376307
135127758.0,17,6,1146,6,1146,27025551.6,191.0,191.0,0,0,0.0,0.0,0.0
303.0,17,2,168,1,76,0.0,76.0,76.0,1,92,0.0,92.0,92.0
127837228.0,6,30,1974,15,948,8417869.57142857,123.0,63.2,15,1026,8417840.857142856,123.0,68.4
146314.0,6,3,337,2,214,0.0,160.0,107.0,1,123,0.0,123.0,123.0
156685.0,17,2,180,1,90,0.0,90.0,90.0,1,90,0.0,90.0,90.0
859926.0,6,9,1268,6,797,171985.2,459.0,132.83333333333334,3,471,293530.5,331.0,157.0
162368.0,17,2,180,1,90,0.0,90.0,90.0,1,90,0.0,90.0,90.0
100728.0,17,2,762,2,762,0.0,381.0,381.0,0,0,0.0,0.0,0.0
171781.0,17,2,180,1,90,0.0,90.0,90.0,1,90,0.0,90.0,90.0
121476.0,6,3,337,2,214,0.0,160.0,107.0,1,123,0.0,123.0,123.0
143845.0,17,2,180,1,90,0.0,90.0,90.0,1,90,0.0,90.0,90.0
48523.0,6,10,1065,5,534,10423.0,262.0,106.8,5,531,9353.25,259.0,106.2
315264.0,6,6,412,4,272,105088.0,74.0,68.0,2,140,0.0,74.0,70.0
2060.0,17,2,691,1,349,0.0,349.0,349.0,1,342,0.0,342.0,342.0
322628.0,17,4,1400,4,1400,107542.66666666669,350.0,350.0,0,0,0.0,0.0,0.0
119974260.0,17,35,16705,35,16705,3528654.705882353,501.0,477.2857142857143,0,0,0.0,0.0,0.0
73041.0,6,10,2032,5,524,18050.0,252.0,104.8,5,1508,17960.0,1236.0,301.6
107585.0,17,2,286,2,286,0.0,143.0,143.0,0,0,0.0,0.0,0.0
130259.0,6,3,337,2,214,0.0,160.0,107.0,1,123,0.0,123.0,123.0
31252.000000000004,6,14,4740,7,653,5057.833333333333,249.0,93.28571428571428,7,4087,5040.666666666667,1514.0,583.8571428571429
120003510.0,6,17,1287,9,691,15000438.75,95.0,76.77777777777777,8,596,12857871.285714284,95.0,74.5
106008316.0,17,13,821,7,432,17668052.666666668,174.0,61.71428571428572,6,389,17200156.6,174.0,64.83333333333333
1472360.0,17,16,1120,16,1120,98157.33333333331,70.0,70.0,0,0,0.0,0.0,0.0
121277.0,6,3,337,2,214,0.0,160.0,107.0,1,123,0.0,123.0,123.0
317.0,17,2,174,1,79,0.0,79.0,79.0,1,95,0.0,95.0,95.0
306384.0,6,6,412,4,272,102128.0,74.0,68.0,2,140,0.0,74.0,70.0
0.0,17,1,179,1,179,0.0,179.0,179.0,0,0,0.0,0.0,0.0
20826.0,6,14,4740,7,653,3306.6666666666665,249.0,93.28571428571428,7,4087,3279.6666666666665,1514.0,583.8571428571429
150985.0,17,4,6056,4,6056,50328.333333333336,1514.0,1514.0,0,0,0.0,0.0,0.0
1026126.0,6,11,1134,6,558,205225.2,220.0,93.0,5,576,254869.5,304.0,115.2
249181.0,6,3,337,2,214,0.0,160.0,107.0,1,123,0.0,123.0,123.0
318.0,17,2,174,1,79,0.0,79.0,79.0,1,95,0.0,95.0,95.0
4422.0,17,2,602,1,72,0.0,72.0,72.0,1,530,0.0,530.0,530.0
1988.0,17,4,344,2,150,0.0,75.0,75.0,2,194,0.0,103.0,97.0
74644.0,6,14,4740,7,653,12261.833333333334,249.0,93.28571428571428,7,4087,11767.666666666666,1514.0,583.8571428571429
847909.0,6,9,1196,6,725,169581.8,387.0,120.83333333333331,3,471,286116.0,331.0,157.0
232831.0,6,3,337,2,214,0.0,160.0,107.0,1,123,0.0,123.0,123.0
103901460.0,6,196,22092,98,6690,1062608.0721649486,140.0,68.26530612244898,98,15402,1062682.8041237113,284.0,157.16326530612244
91965176.0,6,175,19806,88,6030,1057070.9885057472,140.0,68.52272727272727,87,13776,1057298.3604651163,284.0,158.3448275862069
102981800.0,6,42,2772,21,1386,5135437.6,66.0,66.0,21,1386,5135469.6,66.0,66.0
312912.0,6,3,202,2,128,0.0,74.0,64.0,1,74,0.0,74.0,74.0
2227.0,17,4,344,2,150,0.0,75.0,75.0,2,194,0.0,103.0,97.0
2615143.0,6,3,1604,2,851,0.0,785.0,425.5,1,753,0.0,753.0,753.0
361.0,17,2,166,1,75,0.0,75.0,75.0,1,91,0.0,91.0,91.0
303717.0,6,6,412,4,272,101239.0,74.0,68.0,2,140,0.0,74.0,70.0
120387079.0,6,232,26200,116,7952,1039567.591304348,140.0,68.55172413793103,116,18248,1039588.3217391304,284.0,157.31034482758622
260704.0,6,3,337,2,214,0.0,160.0,107.0,1,123,0.0,123.0,123.0
92502037.0,6,40,2640,20,1320,4868528.263157895,66.0,66.0,20,1320,4857150.263157895,66.0,66.0
40304.0,6,14,4740,7,653,6465.666666666667,249.0,93.28571428571428,7,4087,6019.666666666667,1514.0,583.8571428571429
74777.0,6,14,4740,7,653,11864.666666666666,249.0,93.28571428571428,7,4087,12258.333333333334,1514.0,583.8571428571429
98485449.0,6,31,2314,16,1228,6565696.6,139.0,76.75,15,1086,7019220.785714285,123.0,72.4
90551306.0,6,14,2240,8,1016,12935900.857142856,188.0,127.0,6,1224,18078013.8,204.0,204.0
84.0,17,2,762,2,762,0.0,381.0,381.0,0,0,0.0,0.0,0.0
460077.0,6,6,686,3,374,182673.0,160.0,124.66666666666669,3,312,170083.5,123.0,104.0
49130.0,6,14,4740,7,653,5825.0,249.0,93.28571428571428,7,4087,7789.333333333333,1514.0,583.8571428571429
2340.0,17,4,344,2,150,0.0,75.0,75.0,2,194,0.0,103.0,97.0
197100.0,17,2,180,1,90,0.0,90.0,90.0,1,90,0.0,90.0,90.0
321606.0,17,2,608,1,75,0.0,75.0,75.0,1,533,0.0,533.0,533.0
36619.0,6,10,2032,5,524,8486.25,252.0,104.8,5,1508,6544.75,1236.0,301.6
110139092.0,6,32,2374,17,1288,6870179.4375,139.0,75.76470588235294,15,1086,7851630.357142857,123.0,72.4
31697.000000000004,6,2,132,1,66,0.0,66.0,66.0,1,66,0.0,66.0,66.0
1650904.0,6,20,6434,12,1921,150082.18181818182,620.0,160.08333333333334,8,4513,192164.14285714287,1514.0,564.125
313909.0,6,6,412,4,272,104636.33333333331,74.0,68.0,2,140,0.0,74.0,70.0
5825071.0,6,5,336,2,134,0.0,68.0,67.0,3,202,1523902.5,70.0,67.33333333333333
146870.0,6,3,337,2,214,0.0,160.0,107.0,1,123,0.0,123.0,123.0
135140798.0,17,6,1146,6,1146,27028159.6,191.0,191.0,0,0,0.0,0.0,0.0
37979.0,6,10,2032,5,524,9267.0,252.0,104.8,5,1508,9067.0,1236.0,301.6
21170.0,6,10,2032,5,524,4450.0,252.0,104.8,5,1508,4860.75,1236.0,301.6
116370483.0,6,48,3168,24,1584,5059586.217391305,66.0,66.0,24,1584,5047612.956521739,66.0,66.0
122124.0,6,3,373,2,238,0.0,172.0,119.0,1,135,0.0,135.0,135.0
311746.0,17,6,1230,3,234,155692.5,78.0,78.0,3,996,155667.5,332.0,332.0
108108011.0,17,5,955,5,955,27027002.75,191.0,191.0,0,0,0.0,0.0,0.0
135134094.0,17,6,1206,6,1206,27026818.8,201.0,201.0,0,0,0.0,0.0,0.0
111499.0,17,2,286,2,286,0.0,143.0,143.0,0,0,0.0,0.0,0.0
234929.0,6,13,1394,7,797,39154.833333333336,253.0,113.85714285714286,6,597,45052.8,259.0,99.5
111034903.0,17,14,864,7,432,18500215.5,174.0,61.71428571428572,7,432,18501341.5,174.0,61.71428571428572
7036.0,17,4,344,2,150,0.0,75.0,75.0,2,194,0.0,103.0,97.0
197079.0,17,2,180,1,90,0.0,90.0,90.0,1,90,0.0,90.0,90.0
120034363.0,17,28,13364,28,13364,4445717.148148148,501.0,477.2857142857143,0,0,0.0,0.0,0.0
120125103.0,6,16,2356,9,1204,15015637.875,188.0,133.77777777777777,7,1152,15055334.0,204.0,164.57142857142858
120246607.0,6,228,25628,114,7820,1047593.8584070796,140.0,68.59649122807018,114,17808,1057645.831858407,284.0,156.21052631578948
216586.0,17,2,180,1,90,0.0,90.0,90.0,1,90,0.0,90.0,90.0
316.0,17,2,166,1,75,0.0,75.0,75.0,1,91,0.0,91.0,91.0
245405.0,6,3,337,2,214,0.0,160.0,107.0,1,123,0.0,123.0,123.0
2407.0,17,4,344,2,150,0.0,75.0,75.0,2,194,0.0,103.0,97.0
143975.0,17,2,180,1,90,0.0,90.0,90.0,1,90,0.0,90.0,90.0
156917.0,6,3,337,2,214,0.0,160.0,107.0,1,123,0.0,123.0,123.0
284043.0,17,2,363,1,79,0.0,79.0,79.0,1,284,0.0,284.0,284.0
119938.0,17,2,180,1,70,0.0,70.0,70.0,1,110,0.0,110.0,110.0
22042.0,6,10,2032,5,524,4448.0,252.0,104.8,5,1508,5033.75,1236.0,301.6
205337.0,17,4,6056,4,6056,68445.66666666667,1514.0,1514.0,0,0,0.0,0.0,0.0
5625647.0,6,5,336,2,134,0.0,68.0,67.0,3,202,1344471.5,70.0,67.33333333333333
197376.0,17,2,180,1,90,0.0,90.0,90.0,1,90,0.0,90.0,90.0
870364.0,6,10,1334,6,797,174072.8,459.0,132.83333333333334,4,537,198354.0,331.0,134.25
303183.0,6,6,412,4,272,101061.0,74.0,68.0,2,140,0.0,74.0,70.0
334.0,17,2,267,1,83,0.0,83.0,83.0,1,184,0.0,184.0,184.0
120038575.0,17,28,13364,28,13364,4445873.148148148,501.0,477.2857142857143,0,0,0.0,0.0,0.0
103595.0,17,2,286,2,286,0.0,143.0,143.0,0,0,0.0,0.0,0.0
234132.0,6,4,439,2,238,0.0,172.0,119.0,2,201,0.0,135.0,100.5
117637485.0,6,30,1974,15,1026,8387243.571428572,123.0,68.4,15,948,8387233.285714285,123.0,63.2
119935505.0,6,683,107156,345,84478,348649.7238372093,1514.0,244.86376811594204,338,22678,355229.3501483679,214.0,67.09467455621302
330.0,17,2,166,1,75,0.0,75.0,75.0,1,91,0.0,91.0,91.0
326.0,17,2,208,1,72,0.0,72.0,72.0,1,136,0.0,136.0,136.0
329.0,17,2,166,1,75,0.0,75.0,75.0,1,91,0.0,91.0,91.0
104883529.0,6,44,2904,22,1452,4994453.761904762,66.0,66.0,22,1452,4984163.0,66.0,66.0
218069.0,6,3,426,2,280,0.0,214.0,140.0,1,146,0.0,146.0,146.0
26318.0,6,14,4740,7,653,4261.333333333333,249.0,93.28571428571428,7,4087,4249.0,1514.0,583.8571428571429
104818.0,17,2,700,2,700,0.0,350.0,350.0,0,0,0.0,0.0,0.0
144190.0,17,2,180,1,90,0.0,90.0,90.0,1,90,0.0,90.0,90.0
119782280.0,17,35,16705,35,16705,3523008.2352941176,501.0,477.2857142857143,0,0,0.0,0.0,0.0
90034433.0,17,28,13364,28,13364,3334608.6296296297,501.0,477.2857142857143,0,0,0.0,0.0,0.0
299114.0,6,6,412,4,272,99704.66666666669,74.0,68.0,2,140,0.0,74.0,70.0
2298.0,17,4,344,2,150,0.0,75.0,75.0,2,194,0.0,103.0,97.0
106121.0,17,2,700,2,700,0.0,350.0,350.0,0,0,0.0,0.0,0.0
10470768.0,6,7,478,4,272,3444917.333333333,74.0,68.0,3,206,5167246.0,74.0,68.66666666666667
172777.0,17,2,432,1,86,0.0,86.0,86.0,1,346,0.0,346.0,346.0
107179.0,17,2,700,2,700,0.0,350.0,350.0,0,0,0.0,0.0,0.0
114198589.0,6,48,3168,24,1584,4965156.043478261,66.0,66.0,24,1584,4951493.043478261,66.0,66.0
170264.0,17,2,498,1,80,0.0,80.0,80.0,1,418,0.0,418.0,418.0
24444.0,6,14,4740,7,653,3896.0,249.0,93.28571428571428,7,4087,3850.6666666666665,1514.0,583.8571428571429
303.0,17,2,168,1,76,0.0,76.0,76.0,1,92,0.0,92.0,92.0
121630.0,6,3,337,2,214,0.0,160.0,107.0,1,123,0.0,123.0,123.0
98052829.0,17,12,778,6,389,19600990.4,174.0,64.83333333333333,6,389,19600162.6,174.0,64.83333333333333
118886936.0,6,34,2350,17,1225,7430433.5,139.0,72.05882352941177,17,1125,7416922.875,123.0,66.17647058823529
90525389.0,6,13,2036,8,1016,12932198.42857143,188.0,127.0,5,1020,22590916.75,204.0,204.0
135133231.0,17,6,1206,6,1206,27026646.2,201.0,201.0,0,0,0.0,0.0,0.0
348.0,17,2,250,1,93,0.0,93.0,93.0,1,157,0.0,157.0,157.0
149596666.0,6,17,2572,8,1368,17103912.0,204.0,171.0,9,1204,15015590.375,188.0,133.77777777777777
146009.0,6,3,337,2,214,0.0,160.0,107.0,1,123,0.0,123.0,123.0
19876.0,17,2,582,1,83,0.0,83.0,83.0,1,499,0.0,499.0,499.0
300321.0,6,6,412,4,272,100107.0,74.0,68.0,2,140,0.0,74.0,70.0
153494.0,17,2,180,1,90,0.0,90.0,90.0,1,90,0.0,90.0,90.0
120124606.0,6,16,2494,9,1204,15015575.75,188.0,133.77777777777777,7,1290,15022340.166666666,204.0,184.28571428571428
341.0,17,2,267,1,83,0.0,83.0,83.0,1,184,0.0,184.0,184.0
135170509.0,17,6,1206,6,1206,27034101.8,201.0,201.0,0,0,0.0,0.0,0.0
39494.0,6,14,4740,7,653,4990.666666666667,249.0,93.28571428571428,7,4087,6217.5,1514.0,583.8571428571429
32163.0,6,11,2098,6,590,6305.0,252.0,98.33333333333331,5,1508,6630.75,1236.0,301.6
31510.000000000004,6,10,1065,5,534,7402.25,262.0,106.8,5,531,7408.5,259.0,106.2
90028821.0,17,28,13364,28,13364,3334400.777777778,501.0,477.2857142857143,0,0,0.0,0.0,0.0
108107518.0,17,5,955,5,955,27026879.5,191.0,191.0,0,0,0.0,0.0,0.0
90048282.0,17,28,13364,28,13364,3335121.5555555555,501.0,477.2857142857143,0,0,0.0,0.0,0.0
335.0,17,2,166,1,75,0.0,75.0,75.0,1,91,0.0,91.0,91.0
108102080.0,17,5,955,5,955,27025520.0,191.0,191.0,0,0,0.0,0.0,0.0
992.0,17,2,508,2,508,0.0,257.0,254.0,0,0,0.0,0.0,0.0
307964.0,6,6,412,4,272,102654.66666666669,74.0,68.0,2,140,0.0,74.0,70.0
297558.0,6,6,412,4,272,99186.0,74.0,68.0,2,140,0.0,74.0,70.0
68538.0,6,14,4740,7,653,10665.5,249.0,93.28571428571428,7,4087,11281.5,1514.0,583.8571428571429
124001563.0,17,15,907,8,475,17714509.0,174.0,59.375,7,432,17334000.666666668,174.0,61.71428571428572
10454268.0,6,7,478,4,272,3439403.333333333,74.0,68.0,3,206,5159011.0,74.0,68.66666666666667
181340.0,17,2,180,1,90,0.0,90.0,90.0,1,90,0.0,90.0,90.0
123610583.0,6,49,3234,25,1650,5150440.958333333,66.0,66.0,24,1584,4940416.826086956,66.0,66.0
146351.0,17,2,180,1,90,0.0,90.0,90.0,1,90,0.0,90.0,90.0
1317952.0,6,4,264,2,132,0.0,66.0,66.0,2,132,0.0,66.0,66.0
42259.0,6,14,4740,7,653,5639.166666666667,249.0,93.28571428571428,7,4087,6806.333333333333,1514.0,583.8571428571429
316305.0,17,4,1400,4,1400,105435.0,350.0,350.0,0,0,0.0,0.0,0.0
119368836.0,6,239,26820,120,8142,1003099.462184874,140.0,67.85,119,18678,1002834.3559322034,284.0,156.9579831932773
90012870.0,17,27,12943,27,12943,3462033.461538461,501.0,479.3703703703704,0,0,0.0,0.0,0.0
320785.0,6,6,412,4,272,106928.33333333331,74.0,68.0,2,140,0.0,74.0,70.0
106936346.0,6,32,2236,16,1165,7129089.733333333,139.0,72.8125,16,1071,7114679.6,123.0,66.9375
3011303.0,6,11,2106,6,598,601724.2,252.0,99.66666666666669,5,1508,2827.75,1236.0,301.6
228326.0,17,2,180,1,90,0.0,90.0,90.0,1,90,0.0,90.0,90.0
296.0,17,2,164,1,82,0.0,82.0,82.0,1,82,0.0,82.0,82.0
4340.0,17,4,344,2,150,0.0,75.0,75.0,2,194,0.0,103.0,97.0
60780.0,6,10,2032,5,524,14967.5,252.0,104.8,5,1508,12472.0,1236.0,301.6
303.0,17,2,164,1,82,0.0,82.0,82.0,1,82,0.0,82.0,82.0
154996.0,6,3,337,2,214,0.0,160.0,107.0,1,123,0.0,123.0,123.0
0.0,17,1,90,1,90,0.0,90.0,90.0,0,0,0.0,0.0,0.0
113872158.0,6,48,3168,24,1584,4950963.391304348,66.0,66.0,24,1584,4937291.0,66.0,66.0
90258773.0,6,12,1832,8,1016,12894110.42857143,188.0,127.0,4,816,30028097.33333333,204.0,204.0
3246.0,17,2,334,1,79,0.0,79.0,79.0,1,255,0.0,255.0,255.0
96084804.0,17,14,1126,7,563,16000182.5,174.0,80.42857142857143,7,563,16000794.166666666,174.0,80.42857142857143
119559308.0,6,222,24962,111,17340,1084849.5909090908,284.0,156.21621621621622,111,7622,1084849.4454545456,140.0,68.66666666666667
1306837.0,6,4,264,2,132,0.0,66.0,66.0,2,132,0.0,66.0,66.0
41270.0,6,14,4740,7,653,6440.333333333333,249.0,93.28571428571428,7,4087,6732.166666666667,1514.0,583.8571428571429
0.0,6,1,66,1,66,0.0,66.0,66.0,0,0,0.0,0.0,0.0
21932.0,17,2,539,1,86,0.0,86.0,86.0,1,453,0.0,453.0,453.0
307756.0,6,6,412,4,272,102585.33333333331,74.0,68.0,2,140,0.0,74.0,70.0
2794136.0,6,2,132,1,66,0.0,66.0,66.0,1,66,0.0,66.0,66.0
111662.0,17,4,1400,4,1400,37220.66666666666,350.0,350.0,0,0,0.0,0.0,0.0
182203.0,6,11,1132,6,556,35711.0,218.0,92.66666666666669,5,576,45215.0,304.0,115.2
10446576.0,6,6,412,3,206,5153484.0,74.0,68.66666666666667,3,206,5153326.0,74.0,68.66666666666667
2582983.0,6,2,132,1,66,0.0,66.0,66.0,1,66,0.0,66.0,66.0
211405.0,6,10,1221,6,636,42281.0,298.0,106.0,4,585,68826.66666666667,379.0,146.25
153558.0,17,2,180,1,90,0.0,90.0,90.0,1,90,0.0,90.0,90.0
121395.0,6,3,337,2,214,0.0,160.0,107.0,1,123,0.0,123.0,123.0
106372172.0,6,44,2904,22,1452,5065341.523809524,66.0,66.0,22,1452,5050369.619047619,66.0,66.0
55782.0,6,14,4740,7,653,9036.833333333334,249.0,93.28571428571428,7,4087,9157.833333333334,1514.0,583.8571428571429
44556.0,6,14,4740,7,653,7190.833333333333,249.0,93.28571428571428,7,4087,5813.666666666667,1514.0,583.8571428571429
196806.0,17,2,180,1,90,0.0,90.0,90.0,1,90,0.0,90.0,90.0
119633409.0,17,34,16284,34,16284,3625254.8181818174,501.0,478.9411764705882,0,0,0.0,0.0,0.0
26980451.0,17,5,1710,5,1710,6745112.75,342.0,342.0,0,0,0.0,0.0,0.0
2417.0,17,4,344,2,150,0.0,75.0,75.0,2,194,0.0,103.0,97.0
216755.0,17,2,180,1,90,0.0,90.0,90.0,1,90,0.0,90.0,90.0
33549.0,6,14,4740,7,653,4251.5,249.0,93.28571428571428,7,4087,5352.166666666667,1514.0,583.8571428571429
25845.0,6,14,4740,7,653,4197.166666666667,249.0,93.28571428571428,7,4087,4088.1666666666665,1514.0,583.8571428571429
2340569.0,6,3,1604,1,753,0.0,753.0,753.0,2,851,0.0,785.0,425.5
30165.0,6,14,4740,7,653,4503.666666666667,249.0,93.28571428571428,7,4087,4757.333333333333,1514.0,583.8571428571429
156286.0,6,3,337,2,214,0.0,160.0,107.0,1,123,0.0,123.0,123.0
322391.0,17,4,1400,4,1400,107463.66666666669,350.0,350.0,0,0,0.0,0.0,0.0
111614589.0,6,34,2350,17,1225,6962428.4375,139.0,72.05882352941177,17,1125,6962407.8125,123.0,66.17647058823529
299835.0,6,6,412,4,272,99945.0,74.0,68.0,2,140,0.0,74.0,70.0
97280.0,17,2,762,2,762,0.0,381.0,381.0,0,0,0.0,0.0,0.0
90017194.0,17,28,13364,28,13364,3333970.1481481483,501.0,477.2857142857143,0,0,0.0,0.0,0.0
90069463.0,17,28,13364,28,13364,3335906.037037037,501.0,477.2857142857143,0,0,0.0,0.0,0.0
506632.0,6,5,367,3,235,253316.00000000003,103.0,78.33333333333333,2,132,0.0,66.0,66.0
219891.0,6,3,426,2,280,0.0,214.0,140.0,1,146,0.0,146.0,146.0
861.0,17,4,438,2,148,0.0,74.0,74.0,2,290,0.0,147.0,145.0
28870.0,6,10,2032,5,524,6822.0,252.0,104.8,5,1508,6234.25,1236.0,301.6
220375.0,6,3,426,2,280,0.0,214.0,140.0,1,146,0.0,146.0,146.0
2389.0,17,4,344,2,150,0.0,75.0,75.0,2,194,0.0,103.0,97.0
2284.0,17,4,344,2,150,0.0,75.0,75.0,2,194,0.0,103.0,97.0
108101853.0,17,5,1005,5,1005,27025463.25,201.0,201.0,0,0,0.0,0.0,0.0
233132.0,6,3,337,2,214,0.0,160.0,107.0,1,123,0.0,123.0,123.0
2293.0,17,4,344,2,150,0.0,75.0,75.0,2,194,0.0,103.0,97.0
368307.0,6,4,508,2,238,0.0,172.0,119.0,2,270,0.0,135.0,135.0
13477186.0,6,26,7627,14,3735,195997.6923076923,1514.0,266.7857142857143,12,3892,1205510.818181818,1514.0,324.3333333333333
52278.0,6,14,4740,7,653,8590.333333333334,249.0,93.28571428571428,7,4087,6669.333333333333,1514.0,583.8571428571429
112620637.0,6,43,3532,23,1900,5119119.863636363,139.0,82.6086956521739,20,1632,5916019.52631579,123.0,81.6
2590271.0,6,2,132,1,66,0.0,66.0,66.0,1,66,0.0,66.0,66.0
233218.0,6,3,373,2,238,0.0,172.0,119.0,1,135,0.0,135.0,135.0
122409.0,6,3,373,2,238,0.0,172.0,119.0,1,135,0.0,135.0,135.0
33749.0,6,14,4740,7,653,5109.666666666667,249.0,93.28571428571428,7,4087,5479.333333333333,1514.0,583.8571428571429
120038808.0,6,23,1734,11,840,12003880.8,95.0,76.36363636363636,12,894,10889667.818181818,95.0,74.5
315235.0,6,6,412,4,272,105078.33333333331,74.0,68.0,2,140,0.0,74.0,70.0
103215.0,17,2,286,2,286,0.0,143.0,143.0,0,0,0.0,0.0,0.0
196849.0,17,2,180,1,90,0.0,90.0,90.0,1,90,0.0,90.0,90.0
380.0,17,2,267,1,83,0.0,83.0,83.0,1,184,0.0,184.0,184.0
285073.0,17,2,363,1,79,0.0,79.0,79.0,1,284,0.0,284.0,284.0
2060.0,17,4,344,2,150,0.0,75.0,75.0,2,194,0.0,103.0,97.0
90030722.0,17,28,13364,28,13364,3334471.185185185,501.0,477.2857142857143,0,0,0.0,0.0,0.0
103133164.0,17,14,1126,7,563,17162377.333333332,174.0,80.42857142857143,7,563,17162375.333333332,174.0,80.42857142857143
15612.0,6,10,2032,5,524,3169.0,252.0,104.8,5,1508,3570.5,1236.0,301.6
22284.0,6,14,4740,7,653,2636.0,249.0,93.28571428571428,7,4087,3493.833333333333,1514.0,583.8571428571429
239425.0,6,3,337,2,214,0.0,160.0,107.0,1,123,0.0,123.0,123.0
32415.0,6,14,4740,7,653,5237.666666666667,249.0,93.28571428571428,7,4087,5197.0,1514.0,583.8571428571429
27268.0,6,10,2032,5,524,4042.5,252.0,104.8,5,1508,6435.75,1236.0,301.6
6519.0,17,4,823,2,163,0.0,89.0,81.5,2,660,0.0,443.0,330.0
4606.0,17,2,598,1,72,0.0,72.0,72.0,1,526,0.0,526.0,526.0
120127405.0,6,13,2036,5,1020,30031851.25,204.0,204.0,8,1016,17136295.285714287,188.0,127.0
49100.0,6,10,2032,5,524,11689.25,252.0,104.8,5,1508,11033.0,1236.0,301.6
3170132.0,6,18,1495,9,921,358193.75,315.0,102.33333333333331,9,574,358172.625,78.0,63.77777777777778
43144.0,6,14,4740,7,653,6531.833333333333,249.0,93.28571428571428,7,4087,7049.5,1514.0,583.8571428571429
236696.0,6,3,373,2,238,0.0,172.0,119.0,1,135,0.0,135.0,135.0
20932.0,6,10,2032,5,524,4770.25,252.0,104.8,5,1508,4934.25,1236.0,301.6
90297380.0,6,21,1637,10,704,10027719.333333334,95.0,70.4,11,933,9028512.5,155.0,84.81818181818181
3014110.0,6,11,2106,6,598,602659.6,252.0,99.66666666666669,5,1508,2113.5,1236.0,301.6
135135438.0,17,6,1206,6,1206,27027087.6,201.0,201.0,0,0,0.0,0.0,0.0
91659356.0,6,26,1746,13,906,7620274.75,123.0,69.6923076923077,13,840,7620273.083333333,123.0,64.61538461538461
119428783.0,6,221,24896,111,17340,1085716.209090909,284.0,156.21621621621622,110,7556,1086111.2201834864,140.0,68.69090909090909
1440451.0,6,19,7533,10,1403,160050.11111111112,583.0,140.3,9,6130,148373.125,1484.0,681.1111111111111
112535264.0,6,46,3036,23,1518,5105435.454545454,66.0,66.0,23,1518,5105434.863636363,66.0,66.0
30399.0,6,10,2032,5,524,7367.5,252.0,104.8,5,1508,6473.75,1236.0,301.6
30057.0,6,14,4740,7,653,4870.666666666667,249.0,93.28571428571428,7,4087,4767.333333333333,1514.0,583.8571428571429
2311.0,17,4,344,2,150,0.0,75.0,75.0,2,194,0.0,103.0,97.0
90044172.0,17,28,13364,28,13364,3334969.333333333,501.0,477.2857142857143,0,0,0.0,0.0,0.0
153422.0,17,2,180,1,90,0.0,90.0,90.0,1,90,0.0,90.0,90.0
103615.0,17,2,286,2,286,0.0,143.0,143.0,0,0,0.0,0.0,0.0
463.0,17,2,410,1,78,0.0,78.0,78.0,1,332,0.0,332.0,332.0
304366.0,6,6,412,4,272,101455.33333333331,74.0,68.0,2,140,0.0,74.0,70.0
14918.0,6,14,4740,7,653,2363.833333333333,249.0,93.28571428571428,7,4087,2348.6666666666665,1514.0,583.8571428571429
23623.0,6,10,2032,5,524,5686.5,252.0,104.8,5,1508,5586.5,1236.0,301.6
113628921.0,6,46,3036,23,1518,5150893.909090909,66.0,66.0,23,1518,5150887.681818182,66.0,66.0
90256362.0,6,13,2036,8,1016,12893766.0,188.0,127.0,5,1020,22515082.5,204.0,204.0
208910.0,6,3,426,2,280,0.0,214.0,140.0,1,146,0.0,146.0,146.0
135140805.0,17,6,1206,6,1206,27028161.0,201.0,201.0,0,0,0.0,0.0,0.0
90032114.0,17,28,13364,28,13364,3334522.7407407407,501.0,477.2857142857143,0,0,0.0,0.0,0.0
301862.0,6,10,1221,6,636,60372.4,298.0,106.0,4,585,91067.0,379.0,146.25
135131352.0,17,6,1146,6,1146,27026270.4,191.0,191.0,0,0,0.0,0.0,0.0
2921969.0,17,4,1368,4,1368,973989.6666666666,342.0,342.0,0,0,0.0,0.0,0.0
220448.0,17,2,180,1,90,0.0,90.0,90.0,1,90,0.0,90.0,90.0
8220.0,17,2,762,2,762,0.0,381.0,381.0,0,0,0.0,0.0,0.0
97087499.0,6,178,20094,89,13998,1100822.2727272727,284.0,157.2808988764045,89,6096,1100822.3522727273,140.0,68.49438202247191
110740828.0,6,30,1974,15,1026,7894652.857142857,123.0,68.4,15,948,7894651.928571428,123.0,63.2
36070.0,6,14,4740,7,653,5901.333333333333,249.0,93.28571428571428,7,4087,5657.666666666667,1514.0,583.8571428571429
103409.0,17,2,286,2,286,0.0,143.0,143.0,0,0,0.0,0.0,0.0
103488750.0,17,14,864,7,432,17168095.333333332,174.0,61.71428571428572,7,432,17166875.5,174.0,61.71428571428572
2798009.0,6,2,132,1,66,0.0,66.0,66.0,1,66,0.0,66.0,66.0
9193.0,17,2,498,1,80,0.0,80.0,80.0,1,418,0.0,418.0,418.0
213989.0,6,10,1221,6,636,42797.8,298.0,106.0,4,585,70445.0,379.0,146.25
103446.0,17,2,286,2,286,0.0,143.0,143.0,0,0,0.0,0.0,0.0
39234.0,6,14,4740,7,653,6430.5,249.0,93.28571428571428,7,4087,6111.333333333333,1514.0,583.8571428571429
108095428.0,17,5,1005,5,1005,27023857.0,201.0,201.0,0,0,0.0,0.0,0.0
122276.0,6,3,373,2,238,0.0,172.0,119.0,1,135,0.0,135.0,135.0
108104030.0,17,5,1005,5,1005,27026007.5,201.0,201.0,0,0,0.0,0.0,0.0
217049.0,6,3,426,2,280,0.0,214.0,140.0,1,146,0.0,146.0,146.0
307742.0,6,6,412,4,272,102580.66666666669,74.0,68.0,2,140,0.0,74.0,70.0
2600474.0,6,2,132,1,66,0.0,66.0,66.0,1,66,0.0,66.0,66.0
197097.0,17,2,180,1,90,0.0,90.0,90.0,1,90,0.0,90.0,90.0
2905980.0,6,3,204,2,136,0.0,70.0,68.0,1,68,0.0,68.0,68.0
153435.0,17,2,180,1,90,0.0,90.0,90.0,1,90,0.0,90.0,90.0
2302.0,17,4,344,2,150,0.0,75.0,75.0,2,194,0.0,103.0,97.0
37896.0,6,10,2032,5,524,9237.75,252.0,104.8,5,1508,7784.0,1236.0,301.6
98171845.0,17,12,778,6,389,19601194.8,174.0,64.83333333333333,6,389,19600151.6,174.0,64.83333333333333
28330.0,6,10,2032,5,524,5482.0,252.0,104.8,5,1508,6448.25,1236.0,301.6
2795428.0,6,2,132,1,66,0.0,66.0,66.0,1,66,0.0,66.0,66.0
0.0,17,1,161,1,161,0.0,161.0,161.0,0,0,0.0,0.0,0.0
90257039.0,6,14,2240,8,1016,12893862.714285716,188.0,127.0,6,1224,18018842.8,204.0,204.0
302381.0,6,2,132,1,66,0.0,66.0,66.0,1,66,0.0,66.0,66.0
69922.0,6,10,2032,5,524,17109.5,252.0,104.8,5,1508,17141.5,1236.0,301.6
24967.0,6,20,7606,11,978,2496.7,310.0,88.9090909090909,9,6628,2765.375,1514.0,736.4444444444445
156771.0,6,3,337,2,214,0.0,160.0,107.0,1,123,0.0,123.0,123.0
23097.0,6,14,4740,7,653,3727.3333333333335,249.0,93.28571428571428,7,4087,3721.1666666666665,1514.0,583.8571428571429
228225.0,17,2,180,1,90,0.0,90.0,90.0,1,90,0.0,90.0,90.0
71011879.0,17,8,3624,8,3624,10144554.142857144,453.0,453.0,0,0,0.0,0.0,0.0
90255017.0,6,14,2240,8,1016,12893573.857142856,188.0,127.0,6,1224,18018182.0,204.0,204.0
153422.0,17,2,180,1,90,0.0,90.0,90.0,1,90,0.0,90.0,90.0
114120496.0,6,48,3168,24,1584,4961760.695652174,66.0,66.0,24,1584,4952366.826086956,66.0,66.0
146158.0,6,3,337,2,214,0.0,160.0,107.0,1,123,0.0,123.0,123.0
232306.0,6,3,337,2,214,0.0,160.0,107.0,1,123,0.0,123.0,123.0
31124.0,6,14,4740,7,653,5040.333333333333,249.0,93.28571428571428,7,4087,4742.666666666667,1514.0,583.8571428571429
153401.0,17,2,180,1,90,0.0,90.0,90.0,1,90,0.0,90.0,90.0
31181.0,6,14,4740,7,653,5081.0,249.0,93.28571428571428,7,4087,4496.833333333333,1514.0,583.8571428571429
102408644.0,17,14,864,7,432,17068107.333333332,174.0,61.71428571428572,7,432,16984424.833333332,174.0,61.71428571428572
2404.0,17,4,344,2,150,0.0,75.0,75.0,2,194,0.0,103.0,97.0
8555.0,17,4,823,2,163,0.0,89.0,81.5,2,660,0.0,443.0,330.0
120000015.0,6,17,1287,9,691,15000001.875,95.0,76.77777777777777,8,596,12896620.857142856,95.0,74.5
319691.0,17,4,1400,4,1400,106563.66666666669,350.0,350.0,0,0,0.0,0.0,0.0
102930.0,17,2,286,2,286,0.0,143.0,143.0,0,0,0.0,0.0,0.0
156852.0,6,3,337,2,214,0.0,160.0,107.0,1,123,0.0,123.0,123.0
108105337.0,17,5,955,5,955,27026334.25,191.0,191.0,0,0,0.0,0.0,0.0
10724.0,6,10,2032,5,524,2351.25,252.0,104.8,5,1508,2033.75,1236.0,301.6
49737.0,6,14,4740,7,653,8157.0,249.0,93.28571428571428,7,4087,7804.666666666667,1514.0,583.8571428571429
33538.0,6,11,2098,6,590,5806.8,252.0,98.33333333333331,5,1508,6740.5,1236.0,301.6
113614482.0,6,46,3036,23,1518,5150440.090909091,66.0,66.0,23,1518,5150429.863636363,66.0,66.0
130012016.0,17,17,1255,9,649,16251502.0,174.0,72.11111111111111,8,606,15658276.285714284,174.0,75.75
343.0,17,2,160,1,80,0.0,80.0,80.0,1,80,0.0,80.0,80.0
90873507.0,6,19,1436,10,745,10092396.777777778,95.0,74.5,9,691,11355955.75,95.0,76.77777777777777
59098.0,6,14,4740,7,653,9572.833333333334,249.0,93.28571428571428,7,4087,8310.333333333334,1514.0,583.8571428571429
27739023.0,17,5,1710,5,1710,6934755.75,342.0,342.0,0,0,0.0,0.0,0.0
2288693.0,6,25,7573,14,3735,176053.3076923077,1514.0,266.7857142857143,11,3838,203443.0,1514.0,348.90909090909093
143933.0,17,2,180,1,90,0.0,90.0,90.0,1,90,0.0,90.0,90.0
297953.0,6,6,412,4,272,99317.66666666669,74.0,68.0,2,140,0.0,74.0,70.0
108530061.0,6,40,3364,18,1524,6384121.235294118,123.0,84.66666666666667,22,1840,5038038.333333333,139.0,83.63636363636364
90292828.0,6,21,1585,11,840,9024324.5,95.0,76.36363636363636,10,745,9949988.444444444,95.0,74.5
96787097.0,6,34,2620,18,1411,5693358.647058823,139.0,78.38888888888889,16,1209,6437350.2,123.0,75.5625
135134776.0,17,6,1206,6,1206,27026955.2,201.0,201.0,0,0,0.0,0.0,0.0
205981.0,6,3,426,2,280,0.0,214.0,140.0,1,146,0.0,146.0,146.0
2416.0,17,4,344,2,150,0.0,75.0,75.0,2,194,0.0,103.0,97.0
217896.0,6,3,426,2,280,0.0,214.0,140.0,1,146,0.0,146.0,146.0
73820.0,6,10,2032,5,524,17767.5,252.0,104.8,5,1508,15000.75,1236.0,301.6
233795.0,6,3,337,2,214,0.0,160.0,107.0,1,123,0.0,123.0,123.0
80614.0,6,12,1328,6,731,14730.8,253.0,121.83333333333331,6,597,12489.0,259.0,99.5
1304386.0,6,4,264,2,132,0.0,66.0,66.0,2,132,0.0,66.0,66.0
90049240.0,17,28,13364,28,13364,3335157.037037037,501.0,477.2857142857143,0,0,0.0,0.0,0.0
106976.0,17,2,700,2,700,0.0,350.0,350.0,0,0,0.0,0.0,0.0
305575.0,6,6,412,4,272,101858.33333333331,74.0,68.0,2,140,0.0,74.0,70.0
16943.0,6,11,2098,6,590,2904.8,252.0,98.33333333333331,5,1508,3679.75,1236.0,301.6
69260.0,17,2,624,1,75,0.0,75.0,75.0,1,549,0.0,549.0,549.0
113254889.0,6,46,3036,23,1518,5135436.181818182,66.0,66.0,23,1518,5135438.545454546,66.0,66.0
106188282.0,17,14,864,7,432,17667551.166666668,174.0,61.71428571428572,7,432,17666824.5,174.0,61.71428571428572
256001.0,6,12,1373,7,714,42666.833333333336,298.0,102.0,5,659,59945.5,379.0,131.8
153443.0,17,2,180,1,90,0.0,90.0,90.0,1,90,0.0,90.0,90.0
90541605.0,6,16,2648,8,1016,12934515.0,188.0,127.0,8,1632,12911065.142857144,204.0,204.0
90032331.0,17,28,13364,28,13364,3334530.777777778,501.0,477.2857142857143,0,0,0.0,0.0,0.0
321.0,17,2,174,1,79,0.0,79.0,79.0,1,95,0.0,95.0,95.0
107690.0,17,2,286,2,286,0.0,143.0,143.0,0,0,0.0,0.0,0.0
45040367.0,17,9,3086,8,2736,5123005.714285715,342.0,342.0,1,350,0.0,350.0,350.0
2382.0,17,4,344,2,150,0.0,75.0,75.0,2,194,0.0,103.0,97.0
108935186.0,6,31,2160,16,1071,7262345.733333333,123.0,66.9375,15,1089,7216352.214285715,123.0,72.6
71998.0,6,14,4740,7,653,6802.166666666667,249.0,93.28571428571428,7,4087,11808.5,1514.0,583.8571428571429
118154705.0,17,14,864,7,432,19666827.5,174.0,61.71428571428572,7,432,19667924.5,174.0,61.71428571428572
143928.0,17,2,180,1,90,0.0,90.0,90.0,1,90,0.0,90.0,90.0
120518319.0,6,219,24706,110,17290,1105672.6513761468,284.0,157.1818181818182,109,7416,1106426.8703703703,140.0,68.03669724770643
106945.0,17,2,286,2,286,0.0,143.0,143.0,0,0,0.0,0.0,0.0
90028396.0,17,28,13364,28,13364,3334385.037037037,501.0,477.2857142857143,0,0,0.0,0.0,0.0
1030979.0,6,11,1134,6,558,206195.8,220.0,93.0,5,576,256044.25,304.0,115.2
144125.0,17,2,180,1,90,0.0,90.0,90.0,1,90,0.0,90.0,90.0
110682528.0,17,19,2057,10,1122,12298058.666666666,394.0,112.2,9,935,13623545.875,250.0,103.88888888888889
19636.0,17,4,344,2,150,0.0,75.0,75.0,2,194,0.0,103.0,97.0
16150.000000000002,6,10,2032,5,524,3833.0,252.0,104.8,5,1508,3753.75,1236.0,301.6
90304605.0,6,16,1192,8,596,12894576.142857144,95.0,74.5,8,596,12899787.57142857,95.0,74.5
104427.0,17,2,286,2,286,0.0,143.0,143.0,0,0,0.0,0.0,0.0
218354.0,6,3,426,2,280,0.0,214.0,140.0,1,146,0.0,146.0,146.0
3448.0,17,4,571,2,148,0.0,74.0,74.0,2,423,0.0,280.0,211.5
120122886.0,6,13,2036,5,1020,30030721.5,204.0,204.0,8,1016,17136765.0,188.0,127.0
32681592.000000004,6,5,336,2,134,0.0,68.0,67.0,3,202,15053029.0,70.0,67.33333333333333
38833.0,6,10,2032,5,524,8906.75,252.0,104.8,5,1508,9267.5,1236.0,301.6
135140292.0,17,6,1206,6,1206,27028058.4,201.0,201.0,0,0,0.0,0.0,0.0
26066.0,6,14,4740,7,653,4043.8333333333335,249.0,93.28571428571428,7,4087,3901.1666666666665,1514.0,583.8571428571429
96122917.0,6,58,12293,29,6500,3432961.321428572,1514.0,224.1379310344828,29,5793,3423693.25,1514.0,199.7586206896552
299656.0,6,6,412,4,272,99885.33333333331,74.0,68.0,2,140,0.0,74.0,70.0
143872.0,17,2,180,1,90,0.0,90.0,90.0,1,90,0.0,90.0,90.0
63971.0,6,14,4740,7,653,9439.666666666666,249.0,93.28571428571428,7,4087,10351.666666666666,1514.0,583.8571428571429
119824492.0,6,2462,2130496,1695,2079862,70709.96280991736,1514.0,1227.0572271386432,767,50634,156418.8276762402,78.0,66.01564537157758
20330.0,6,11,1133,6,602,3768.2,264.0,100.33333333333331,5,531,4733.25,259.0,106.2
2783463.0,6,2,132,1,66,0.0,66.0,66.0,1,66,0.0,66.0,66.0
27056915.0,17,5,1710,5,1710,6764228.75,342.0,342.0,0,0,0.0,0.0,0.0
609651.0,6,4,508,2,238,0.0,172.0,119.0,2,270,0.0,135.0,135.0
103711172.0,6,43,2838,22,1452,4938611.666666667,66.0,66.0,21,1386,5144012.9,66.0,66.0
108108905.0,17,5,955,5,955,27027226.25,191.0,191.0,0,0,0.0,0.0,0.0
50211.0,6,14,4740,7,653,8186.0,249.0,93.28571428571428,7,4087,8199.0,1514.0,583.8571428571429
34394.0,6,13,1479,7,882,5732.333333333333,291.0,126.0,6,597,5386.8,259.0,99.5
29287.0,6,14,4740,7,653,4754.666666666667,249.0,93.28571428571428,7,4087,4424.333333333333,1514.0,583.8571428571429
5617602.0,6,5,336,2,134,0.0,68.0,67.0,3,202,1524280.0,70.0,67.33333333333333
14419.0,6,11,2098,6,590,2148.0,252.0,98.33333333333331,5,1508,3285.25,1236.0,301.6
9458.0,17,2,571,1,86,0.0,86.0,86.0,1,485,0.0,485.0,485.0
147948.0,17,2,180,1,90,0.0,90.0,90.0,1,90,0.0,90.0,90.0
3217.0,17,2,359,1,75,0.0,75.0,75.0,1,284,0.0,284.0,284.0
120042.0,17,2,180,1,70,0.0,70.0,70.0,1,110,0.0,110.0,110.0
2395.0,17,4,344,2,150,0.0,75.0,75.0,2,194,0.0,103.0,97.0
196991.0,6,10,1065,5,534,48867.75,262.0,106.8,5,531,2276.0,259.0,106.2
66751.0,6,14,4740,7,653,7402.333333333333,249.0,93.28571428571428,7,4087,10749.166666666666,1514.0,583.8571428571429
106332.0,17,2,762,2,762,0.0,381.0,381.0,0,0,0.0,0.0,0.0
318414.0,6,6,412,4,272,106138.0,74.0,68.0,2,140,0.0,74.0,70.0
90756508.0,6,22,1680,12,894,8246184.909090909,95.0,74.5,10,786,10082687.888888888,95.0,78.6
149563913.0,6,24,1788,12,894,10890013.818181818,95.0,74.5,12,894,13596352.909090908,95.0,74.5
412341.0,6,4,508,2,238,0.0,172.0,119.0,2,270,0.0,135.0,135.0
145469.0,6,3,337,2,214,0.0,160.0,107.0,1,123,0.0,123.0,123.0
10476.0,17,4,823,2,163,0.0,89.0,81.5,2,660,0.0,443.0,330.0
24878.0,17,4,823,2,163,0.0,89.0,81.5,2,660,0.0,443.0,330.0
90091002.0,6,10,1440,7,828,15015167.0,188.0,118.28571428571428,3,612,30030375.5,204.0,204.0
522872.0,6,5,336,2,134,0.0,68.0,67.0,3,202,206368.0,70.0,67.33333333333333
363876.0,6,11,1021,6,444,48872.6,162.0,74.0,5,577,61002.25,349.0,115.4
90070467.0,17,28,13364,28,13364,3335943.222222222,501.0,477.2857142857143,0,0,0.0,0.0,0.0
13968.0,6,10,1067,5,536,3234.25,264.0,107.2,5,531,2613.5,259.0,106.2
144002.0,6,2,132,1,66,0.0,66.0,66.0,1,66,0.0,66.0,66.0
113969827.0,6,31,2166,16,1149,7597988.466666667,123.0,71.8125,15,1017,8125226.785714285,123.0,67.8
1679.0,17,2,508,2,508,0.0,257.0,254.0,0,0,0.0,0.0,0.0
135130951.0,17,6,1146,6,1146,27026190.2,191.0,191.0,0,0,0.0,0.0,0.0
42948.0,6,11,2098,6,590,8319.8,252.0,98.33333333333331,5,1508,10500.0,1236.0,301.6
120315860.0,6,220,24900,110,7482,1096242.6972477064,140.0,68.01818181818182,110,17418,1086754.23853211,284.0,158.34545454545454
207959.0,6,3,426,2,280,0.0,214.0,140.0,1,146,0.0,146.0,146.0
15836.0,6,20,7606,11,978,1583.6,310.0,88.9090909090909,9,6628,1786.875,1514.0,736.4444444444445
35725.0,6,14,4740,7,653,5758.333333333333,249.0,93.28571428571428,7,4087,5787.666666666667,1514.0,583.8571428571429
5011633.0,17,4,849,2,166,0.0,83.0,83.0,2,683,0.0,499.0,341.5
37254.0,6,14,4740,7,653,6087.833333333333,249.0,93.28571428571428,7,4087,5900.5,1514.0,583.8571428571429
236420.0,6,3,337,2,214,0.0,160.0,107.0,1,123,0.0,123.0,123.0
90095482.0,6,12,1848,5,1020,22523140.25,204.0,204.0,7,828,15015499.166666666,188.0,118.28571428571428
153362.0,17,2,180,1,90,0.0,90.0,90.0,1,90,0.0,90.0,90.0
104150679.0,6,44,2904,22,1452,4959556.142857143,66.0,66.0,22,1452,4944585.238095238,66.0,66.0
108106455.0,17,5,955,5,955,27026613.75,191.0,191.0,0,0,0.0,0.0,0.0
1239325.0,17,7,490,7,490,206554.16666666663,70.0,70.0,0,0,0.0,0.0,0.0
126907279.0,17,14,864,7,432,17833502.5,174.0,61.71428571428572,7,432,17834369.166666668,174.0,61.71428571428572
107170080.0,6,34,2482,17,1288,6698130.0,139.0,75.76470588235294,17,1194,6684603.625,123.0,70.23529411764706
683129.0,6,10,1065,5,534,170457.0,262.0,106.8,5,531,170428.0,259.0,106.2
2367.0,17,4,344,2,150,0.0,75.0,75.0,2,194,0.0,103.0,97.0
82.0,17,2,762,2,762,0.0,381.0,381.0,0,0,0.0,0.0,0.0
499.0,17,2,508,2,508,0.0,257.0,254.0,0,0,0.0,0.0,0.0
303816.0,6,6,412,4,272,101272.0,74.0,68.0,2,140,0.0,74.0,70.0
103585.0,17,2,286,2,286,0.0,143.0,143.0,0,0,0.0,0.0,0.0
114239129.0,6,48,3168,24,1584,4966918.652173913,66.0,66.0,24,1584,4957518.260869565,66.0,66.0
241822.0,6,3,337,2,214,0.0,160.0,107.0,1,123,0.0,123.0,123.0
120211437.0,6,27,2073,12,976,10908228.909090908,95.0,81.33333333333333,15,1097,8570735.857142856,95.0,73.13333333333334
237606.0,17,2,180,1,90,0.0,90.0,90.0,1,90,0.0,90.0,90.0
103172.0,17,2,700,2,700,0.0,350.0,350.0,0,0,0.0,0.0,0.0
73775.0,6,10,2032,5,524,17336.5,252.0,104.8,5,1508,15942.5,1236.0,301.6
53299.0,6,14,4740,7,653,8682.666666666666,249.0,93.28571428571428,7,4087,8747.833333333334,1514.0,583.8571428571429
2898998.0,6,2,132,1,66,0.0,66.0,66.0,1,66,0.0,66.0,66.0
120205932.0,6,228,25772,114,7746,1056565.4867256638,140.0,67.94736842105263,114,18026,1056496.8230088495,284.0,158.12280701754386
16256.0,6,14,4740,7,653,2473.1666666666665,249.0,93.28571428571428,7,4087,2332.5,1514.0,583.8571428571429
246035.0,6,3,337,2,214,0.0,160.0,107.0,1,123,0.0,123.0,123.0
100490.0,17,2,762,2,762,0.0,381.0,381.0,0,0,0.0,0.0,0.0
204464.0,17,2,762,2,762,0.0,381.0,381.0,0,0,0.0,0.0,0.0
317082.0,17,4,1400,4,1400,105694.0,350.0,350.0,0,0,0.0,0.0,0.0
90060654.0,17,27,12943,27,12943,3463871.3076923075,501.0,479.3703703703704,0,0,0.0,0.0,0.0
235077.0,6,3,337,2,214,0.0,160.0,107.0,1,123,0.0,123.0,123.0
145077.0,17,2,180,1,70,0.0,70.0,70.0,1,110,0.0,110.0,110.0
105846.0,17,2,286,2,286,0.0,143.0,143.0,0,0,0.0,0.0,0.0
0.0,17,1,381,1,381,0.0,381.0,381.0,0,0,0.0,0.0,0.0
2352.0,17,4,344,2,150,0.0,75.0,75.0,2,194,0.0,103.0,97.0
252804.0,6,10,1221,6,636,50560.8,298.0,106.0,4,585,78496.66666666667,379.0,146.25
1302332.0,6,4,264,2,132,0.0,66.0,66.0,2,132,0.0,66.0,66.0
135133804.0,17,6,1146,6,1146,27026760.8,191.0,191.0,0,0,0.0,0.0,0.0
2337.0,17,4,344,2,150,0.0,75.0,75.0,2,194,0.0,103.0,97.0
179788.0,17,2,180,1,90,0.0,90.0,90.0,1,90,0.0,90.0,90.0
90282030.0,6,24,2710,13,1451,7523502.5,358.0,111.6153846153846,11,1259,8999278.5,427.0,114.45454545454544
90059961.0,17,27,12943,27,12943,3463844.653846154,501.0,479.3703703703704,0,0,0.0,0.0,0.0
108106354.0,17,5,1005,5,1005,27026588.5,201.0,201.0,0,0,0.0,0.0,0.0
35956.0,6,14,4740,7,653,5769.166666666667,249.0,93.28571428571428,7,4087,5348.166666666667,1514.0,583.8571428571429
120038359.0,17,28,13364,28,13364,4445865.148148148,501.0,477.2857142857143,0,0,0.0,0.0,0.0
258635.0,6,10,1221,6,636,51727.0,298.0,106.0,4,585,80772.0,379.0,146.25
99388.0,17,2,762,2,762,0.0,381.0,381.0,0,0,0.0,0.0,0.0
216471.0,17,2,180,1,90,0.0,90.0,90.0,1,90,0.0,90.0,90.0
24487983.0,17,4,1376,3,1026,1256509.0,342.0,342.0,1,350,0.0,350.0,350.0
448830.0,6,3,1604,2,851,0.0,785.0,425.5,1,753,0.0,753.0,753.0
36938.0,6,12,1320,6,723,6491.8,253.0,120.5,6,597,6781.8,259.0,99.5
284543.0,17,2,363,1,79,0.0,79.0,79.0,1,284,0.0,284.0,284.0
898161.0,6,12,2718,7,743,149693.5,339.0,106.14285714285714,5,1975,155627.25,1514.0,395.0
305136.0,6,3,202,2,128,0.0,74.0,64.0,1,74,0.0,74.0,74.0
118858.0,6,14,4740,7,653,18667.0,249.0,93.28571428571428,7,4087,19382.666666666668,1514.0,583.8571428571429
1035262.0,6,11,1134,6,558,207052.4,220.0,93.0,5,576,256574.25,304.0,115.2
37551.0,6,14,4740,7,653,6138.0,249.0,93.28571428571428,7,4087,5674.5,1514.0,583.8571428571429
10371.0,17,2,166,1,75,0.0,75.0,75.0,1,91,0.0,91.0,91.0
219993.0,6,10,1221,6,636,43998.6,298.0,106.0,4,585,72345.33333333333,379.0,146.25
190911.0,17,2,180,1,90,0.0,90.0,90.0,1,90,0.0,90.0,90.0
40802639.0,6,9,510,5,270,10200659.75,54.0,54.0,4,240,10200623.666666666,60.0,60.0
895714.0,6,12,2710,7,742,149285.66666666666,338.0,106.0,5,1968,155761.25,1514.0,393.6
303106.0,6,2,132,1,66,0.0,66.0,66.0,1,66,0.0,66.0,66.0
105497.0,17,2,700,2,700,0.0,350.0,350.0,0,0,0.0,0.0,0.0
39856.0,6,14,4740,7,653,5987.666666666667,249.0,93.28571428571428,7,4087,6227.166666666667,1514.0,583.8571428571429
30317.0,6,10,2032,5,524,7336.75,252.0,104.8,5,1508,7313.5,1236.0,301.6
28244.0,6,14,4740,7,653,4107.5,249.0,93.28571428571428,7,4087,4289.666666666667,1514.0,583.8571428571429
40895.0,6,14,4740,7,653,4448.833333333333,249.0,93.28571428571428,7,4087,6670.833333333333,1514.0,583.8571428571429
0.0,6,1,66,1,66,0.0,66.0,66.0,0,0,0.0,0.0,0.0
305955.0,6,6,412,4,272,101985.0,74.0,68.0,2,140,0.0,74.0,70.0
114731822.0,6,47,3102,24,1584,4974893.347826087,66.0,66.0,23,1518,5150447.409090909,66.0,66.0
153362.0,17,2,180,1,90,0.0,90.0,90.0,1,90,0.0,90.0,90.0
114509674.0,6,47,3102,24,1584,4978666.782608695,66.0,66.0,23,1518,5144000.227272728,66.0,66.0
134011529.0,17,15,907,8,475,19144504.14285714,174.0,59.375,7,432,19062822.33333333,174.0,61.71428571428572
798.0,17,4,438,2,148,0.0,74.0,74.0,2,290,0.0,147.0,145.0
70338.0,6,10,2032,5,524,16299.25,252.0,104.8,5,1508,16673.0,1236.0,301.6
4123.0,17,4,704,2,148,0.0,74.0,74.0,2,556,0.0,280.0,278.0
3012621.0,6,11,2106,6,598,602336.4,252.0,99.66666666666669,5,1508,3009.75,1236.0,301.6
247067.0,6,3,373,2,238,0.0,172.0,119.0,1,135,0.0,135.0,135.0
131345.0,6,2,132,1,66,0.0,66.0,66.0,1,66,0.0,66.0,66.0
100763.0,17,2,700,2,700,0.0,350.0,350.0,0,0,0.0,0.0,0.0
136444.0,6,2,132,1,66,0.0,66.0,66.0,1,66,0.0,66.0,66.0
97413.0,6,2,132,1,66,0.0,66.0,66.0,1,66,0.0,66.0,66.0
98119968.0,6,240,27786,120,19644,822719.218487395,284.0,163.7,120,8142,822718.9579831932,140.0,67.85
2811695.0,6,2,132,1,66,0.0,66.0,66.0,1,66,0.0,66.0,66.0
5624805.0,6,5,336,2,134,0.0,68.0,67.0,3,202,1421880.5,70.0,67.33333333333333
15061.0,6,10,2032,5,524,2965.0,252.0,104.8,5,1508,3033.75,1236.0,301.6
301988.0,6,6,412,4,272,100662.66666666669,74.0,68.0,2,140,0.0,74.0,70.0
99000799.0,17,13,1083,7,563,16500133.166666666,174.0,80.42857142857143,6,520,16906333.8,174.0,86.66666666666667
120172296.0,17,14,864,7,432,19917785.0,174.0,61.71428571428572,7,432,20002026.5,174.0,61.71428571428572
140.0,17,3,1050,3,1050,70.0,350.0,350.0,0,0,0.0,0.0,0.0
153417.0,17,2,180,1,90,0.0,90.0,90.0,1,90,0.0,90.0,90.0
37506.0,6,13,1479,7,882,6251.0,291.0,126.0,6,597,5951.8,259.0,99.5
134688.0,17,4,1524,4,1524,44896.0,381.0,381.0,0,0,0.0,0.0,0.0
33497.0,6,10,2032,5,524,7973.75,252.0,104.8,5,1508,8104.25,1236.0,301.6
120286671.0,6,208,23408,104,7160,1159804.5145631067,140.0,68.84615384615384,104,16248,1149787.990291262,284.0,156.23076923076923
255256.0,6,3,337,2,214,0.0,160.0,107.0,1,123,0.0,123.0,123.0
2022152.0,17,4,525,2,150,0.0,75.0,75.0,2,375,0.0,284.0,187.5
120122757.0,6,14,2240,8,1016,17137225.0,188.0,127.0,6,1224,18018709.0,204.0,204.0
90068650.0,17,28,13364,28,13364,3335875.925925926,501.0,477.2857142857143,0,0,0.0,0.0,0.0
222552.0,17,2,180,1,90,0.0,90.0,90.0,1,90,0.0,90.0,90.0
218029.0,6,3,426,2,280,0.0,214.0,140.0,1,146,0.0,146.0,146.0
16247.000000000002,6,14,4740,7,653,2491.833333333333,249.0,93.28571428571428,7,4087,2136.5,1514.0,583.8571428571429
14637875.0,6,20,1648,10,1016,1592677.7777777778,315.0,101.6,10,632,1592647.6666666667,78.0,63.2
135129846.0,17,6,1206,6,1206,27025969.2,201.0,201.0,0,0,0.0,0.0,0.0
304088.0,6,6,412,4,272,101362.66666666669,74.0,68.0,2,140,0.0,74.0,70.0
108201.0,17,2,286,2,286,0.0,143.0,143.0,0,0,0.0,0.0,0.0
1303242.0,6,4,264,2,132,0.0,66.0,66.0,2,132,0.0,66.0,66.0
59094.0,6,14,4740,7,653,8987.166666666666,249.0,93.28571428571428,7,4087,7890.0,1514.0,583.8571428571429
10460097.0,6,7,478,4,272,3441582.333333333,74.0,68.0,3,206,5162278.0,74.0,68.66666666666667
146273.0,6,3,337,2,214,0.0,160.0,107.0,1,123,0.0,123.0,123.0
120515254.0,6,267,32380,134,23306,906129.7293233082,336.0,173.92537313432837,133,9074,904255.196969697,140.0,68.22556390977444
120273566.0,6,218,24662,109,7416,1106126.5277777778,140.0,68.03669724770643,109,17246,1105977.212962963,284.0,158.22018348623854
123767.0,6,3,373,2,238,0.0,172.0,119.0,1,135,0.0,135.0,135.0
24189.0,6,10,2032,5,524,5639.5,252.0,104.8,5,1508,3237.25,1236.0,301.6
233097.0,6,3,337,2,214,0.0,160.0,107.0,1,123,0.0,123.0,123.0
144960.0,6,2,132,1,66,0.0,66.0,66.0,1,66,0.0,66.0,66.0
37205.0,6,14,4740,7,653,6087.333333333333,249.0,93.28571428571428,7,4087,5614.5,1514.0,583.8571428571429
116748367.0,6,48,3168,24,1584,5076015.956521739,66.0,66.0,24,1584,5064170.478260869,66.0,66.0
120121804.0,6,16,2490,10,1392,13346867.111111112,188.0,139.2,6,1098,18098005.2,204.0,183.0
35176.0,6,10,2032,5,524,8519.25,252.0,104.8,5,1508,8172.5,1236.0,301.6
439112.0,6,10,967,5,390,73721.0,162.0,78.0,5,577,73656.25,349.0,115.4
116469.0,17,4,1400,4,1400,38823.0,350.0,350.0,0,0,0.0,0.0,0.0
90298004.0,6,16,1192,8,596,12893320.714285716,95.0,74.5,8,596,12898287.285714284,95.0,74.5
90027863.0,17,27,12943,27,12943,3462610.1153846155,501.0,479.3703703703704,0,0,0.0,0.0,0.0
17150.0,6,10,2032,5,524,4061.75,252.0,104.8,5,1508,3920.0,1236.0,301.6
0.0,17,1,90,1,90,0.0,90.0,90.0,0,0,0.0,0.0,0.0
16810.0,6,14,4740,7,653,2656.5,249.0,93.28571428571428,7,4087,2671.0,1514.0,583.8571428571429
27461862.0,17,5,1710,5,1710,6865465.5,342.0,342.0,0,0,0.0,0.0,0.0
314435.0,6,6,412,4,272,104811.66666666669,74.0,68.0,2,140,0.0,74.0,70.0
208879.0,17,2,762,2,762,0.0,381.0,381.0,0,0,0.0,0.0,0.0
3425.0,17,2,414,1,88,0.0,88.0,88.0,1,326,0.0,326.0,326.0
333.0,17,2,208,1,72,0.0,72.0,72.0,1,136,0.0,136.0,136.0
207190.0,6,3,426,2,280,0.0,214.0,140.0,1,146,0.0,146.0,146.0
105140.0,17,2,700,2,700,0.0,350.0,350.0,0,0,0.0,0.0,0.0
107662175.0,6,31,2182,16,1165,7163799.333333333,139.0,72.8125,15,1017,7675501.642857143,123.0,67.8
44717.0,6,10,2032,5,524,10564.0,252.0,104.8,5,1508,9746.25,1236.0,301.6
105683.0,17,2,286,2,286,0.0,143.0,143.0,0,0,0.0,0.0,0.0
108106838.0,17,5,955,5,955,27026709.5,191.0,191.0,0,0,0.0,0.0,0.0
90255490.0,6,12,1832,8,1016,12893641.42857143,188.0,127.0,4,816,30031549.33333333,204.0,204.0
747453.0,6,2,132,1,66,0.0,66.0,66.0,1,66,0.0,66.0,66.0
2445.0,17,4,344,2,150,0.0,75.0,75.0,2,194,0.0,103.0,97.0
114603915.0,6,48,3168,24,1584,4982778.913043479,66.0,66.0,24,1584,4970801.521739131,66.0,66.0
121625.0,17,4,1400,4,1400,40541.66666666666,350.0,350.0,0,0,0.0,0.0,0.0
849.0,17,4,438,2,148,0.0,74.0,74.0,2,290,0.0,147.0,145.0
315.0,17,2,174,1,79,0.0,79.0,79.0,1,95,0.0,95.0,95.0
121223.0,6,3,337,2,214,0.0,160.0,107.0,1,123,0.0,123.0,123.0
39703.0,6,14,4740,7,653,6486.666666666667,249.0,93.28571428571428,7,4087,6426.833333333333,1514.0,583.8571428571429
108106561.0,17,5,1005,5,1005,27026640.25,201.0,201.0,0,0,0.0,0.0,0.0
46220.0,6,14,4740,7,653,7582.166666666667,249.0,93.28571428571428,7,4087,7296.666666666667,1514.0,583.8571428571429
51306.0,17,2,180,1,90,0.0,90.0,90.0,1,90,0.0,90.0,90.0
3006534.0,6,11,2106,6,598,601063.4,252.0,99.66666666666669,5,1508,1875.25,1236.0,301.6
135127618.0,17,6,1146,6,1146,27025523.6,191.0,191.0,0,0,0.0,0.0,0.0
313866.0,17,4,1400,4,1400,104622.0,350.0,350.0,0,0,0.0,0.0,0.0
54721.0,6,14,4740,7,653,8744.666666666666,249.0,93.28571428571428,7,4087,8739.666666666666,1514.0,583.8571428571429
39375.0,6,14,4740,7,653,6019.333333333333,249.0,93.28571428571428,7,4087,5015.0,1514.0,583.8571428571429
28599.0,6,14,4740,7,653,4642.666666666667,249.0,93.28571428571428,7,4087,4606.666666666667,1514.0,583.8571428571429
2119986.0,6,20,6935,11,1567,211998.6,408.0,142.45454545454547,9,5368,222265.125,1514.0,596.4444444444445
101150.0,17,2,762,2,762,0.0,381.0,381.0,0,0,0.0,0.0,0.0
2371.0,17,4,344,2,150,0.0,75.0,75.0,2,194,0.0,103.0,97.0
5005595.0,17,4,849,2,166,0.0,83.0,83.0,2,683,0.0,499.0,341.5
316268.0,6,3,202,2,128,0.0,74.0,64.0,1,74,0.0,74.0,74.0
103014.0,17,2,286,2,286,0.0,143.0,143.0,0,0,0.0,0.0,0.0
309091.0,17,2,180,1,90,0.0,90.0,90.0,1,90,0.0,90.0,90.0
90226543.0,6,16,1192,8,596,12854023.857142856,95.0,74.5,8,596,12858604.0,95.0,74.5
27324.0,6,14,4740,7,653,3932.0,249.0,93.28571428571428,7,4087,4157.333333333333,1514.0,583.8571428571429
1051654.0,6,11,1134,6,558,210330.8,220.0,93.0,5,576,255663.25,304.0,115.2
512767.0,6,10,1221,6,636,102553.4,298.0,106.0,4,585,157269.0,379.0,146.25
877.0,17,4,438,2,148,0.0,74.0,74.0,2,290,0.0,147.0,145.0
122023079.0,6,32,2242,17,1225,7626442.4375,139.0,72.05882352941177,15,1017,7987175.357142857,123.0,67.8
791.0,17,4,438,2,148,0.0,74.0,74.0,2,290,0.0,147.0,145.0
90256238.0,6,12,1832,8,1016,12893748.285714284,188.0,127.0,4,816,30030823.0,204.0,204.0
4366017.0,6,11,2118,7,676,678052.1666666666,252.0,96.57142857142856,4,1442,399604.3333333333,1236.0,360.5
209442.0,17,2,180,1,90,0.0,90.0,90.0,1,90,0.0,90.0,90.0
9216.0,17,2,539,1,86,0.0,86.0,86.0,1,453,0.0,453.0,453.0
55124.0,6,14,4740,7,653,7904.833333333333,249.0,93.28571428571428,7,4087,8341.0,1514.0,583.8571428571429
120137845.0,6,324,39214,162,11000,741127.9875776398,140.0,67.90123456790124,162,28214,741173.7204968944,426.0,174.1604938271605
118042526.0,6,30,1974,15,1026,8416177.214285715,123.0,68.4,15,948,8416168.357142856,123.0,63.2
120512943.0,6,225,25468,112,7688,1078276.5135135136,140.0,68.64285714285714,113,17780,1075717.294642857,284.0,157.34513274336285
90033147.0,17,28,13364,28,13364,3334561.0,501.0,477.2857142857143,0,0,0.0,0.0,0.0
1419931.0,6,4,492,2,280,0.0,214.0,140.0,2,212,0.0,146.0,106.0
146055.0,6,3,337,2,214,0.0,160.0,107.0,1,123,0.0,123.0,123.0
104779236.0,17,14,1126,7,563,17463206.0,174.0,80.42857142857143,7,563,17421348.166666668,174.0,80.42857142857143
28778.0,6,10,2032,5,524,6868.75,252.0,104.8,5,1508,6874.25,1236.0,301.6
120059228.0,17,13,821,7,432,20009871.33333333,174.0,61.71428571428572,6,389,20024682.8,174.0,64.83333333333333
219008.0,6,3,426,2,280,0.0,214.0,140.0,1,146,0.0,146.0,146.0
2408.0,17,4,344,2,150,0.0,75.0,75.0,2,194,0.0,103.0,97.0
39786.0,6,10,2032,5,524,9689.0,252.0,104.8,5,1508,9084.75,1236.0,301.6
101837.0,17,2,286,2,286,0.0,143.0,143.0,0,0,0.0,0.0,0.0
5005211.0,17,4,849,2,166,0.0,83.0,83.0,2,683,0.0,499.0,341.5
130791.0,6,3,337,2,214,0.0,160.0,107.0,1,123,0.0,123.0,123.0
2475.0,17,2,762,2,762,0.0,381.0,381.0,0,0,0.0,0.0,0.0
1035649.0,17,10,3776,10,3776,115072.11111111112,394.0,377.6,0,0,0.0,0.0,0.0
306877.0,6,6,412,4,272,102292.33333333331,74.0,68.0,2,140,0.0,74.0,70.0
32106192.0,6,7,1874,3,887,15980125.0,753.0,295.6666666666667,4,987,10654830.333333334,785.0,246.75
2372.0,17,4,344,2,150,0.0,75.0,75.0,2,194,0.0,103.0,97.0
360.0,17,2,166,1,75,0.0,75.0,75.0,1,91,0.0,91.0,91.0
56772.0,6,14,4740,7,653,9254.833333333334,249.0,93.28571428571428,7,4087,8605.5,1514.0,583.8571428571429
113000969.0,17,13,821,7,432,18833494.83333333,174.0,61.71428571428572,6,389,18401403.6,174.0,64.83333333333333
268275.0,6,12,1373,7,714,44712.5,298.0,102.0,5,659,62924.25,379.0,131.8
199568.0,17,2,180,1,90,0.0,90.0,90.0,1,90,0.0,90.0,90.0
319322.0,17,4,1400,4,1400,106440.66666666669,350.0,350.0,0,0,0.0,0.0,0.0
23816.0,6,10,2032,5,524,4762.5,252.0,104.8,5,1508,5708.75,1236.0,301.6
4562.0,17,2,626,1,72,0.0,72.0,72.0,1,554,0.0,554.0,554.0
120120420.0,6,13,2020,9,1204,15015052.5,188.0,133.77777777777777,4,816,30030704.33333333,204.0,204.0
277754.0,17,2,363,1,79,0.0,79.0,79.0,1,284,0.0,284.0,284.0
1235580.0,17,7,490,7,490,205930.0,70.0,70.0,0,0,0.0,0.0,0.0
196856.0,17,2,180,1,90,0.0,90.0,90.0,1,90,0.0,90.0,90.0
317931.0,17,4,1400,4,1400,105977.0,350.0,350.0,0,0,0.0,0.0,0.0
135133253.0,17,6,1146,6,1146,27026650.6,191.0,191.0,0,0,0.0,0.0,0.0
111563572.0,17,14,864,7,432,18501423.166666668,174.0,61.71428571428572,7,432,18500159.0,174.0,61.71428571428572
2859356.0,6,3,1777,1,826,0.0,826.0,826.0,2,951,0.0,885.0,475.5
116191.0,6,12,1328,7,797,19365.166666666668,253.0,113.85714285714286,5,531,24333.75,259.0,106.2
117565620.0,6,236,26654,118,18570,1002995.3247863248,300.0,157.3728813559322,118,8084,1002995.1965811966,140.0,68.50847457627118
99007279.0,17,11,735,6,389,19801455.8,174.0,64.83333333333333,5,346,19750170.75,174.0,69.2
33435.0,6,14,4740,7,653,5406.333333333333,249.0,93.28571428571428,7,4087,5323.0,1514.0,583.8571428571429
1632243.0,17,6,1230,3,234,815932.0,78.0,78.0,3,996,815926.0,332.0,332.0
43371.0,6,10,2032,5,524,10634.0,252.0,104.8,5,1508,9275.25,1236.0,301.6
120321080.0,6,277,31870,139,22466,871891.8840579711,284.0,161.62589928057554,138,9404,870645.9051094891,140.0,68.14492753623189
90779265.0,6,19,1436,10,745,10081252.333333334,95.0,74.5,9,691,11346928.0,95.0,76.77777777777777
2795706.0,6,2,132,1,66,0.0,66.0,66.0,1,66,0.0,66.0,66.0
9596.0,17,4,823,2,163,0.0,89.0,81.5,2,660,0.0,443.0,330.0
39857.0,6,14,4740,7,653,6516.833333333333,249.0,93.28571428571428,7,4087,6097.666666666667,1514.0,583.8571428571429
340.0,17,2,174,1,79,0.0,79.0,79.0,1,95,0.0,95.0,95.0
153438.0,17,2,180,1,90,0.0,90.0,90.0,1,90,0.0,90.0,90.0
305014.0,6,3,202,2,128,0.0,74.0,64.0,1,74,0.0,74.0,74.0
46193.0,6,14,4740,7,653,7367.166666666667,249.0,93.28571428571428,7,4087,6398.833333333333,1514.0,583.8571428571429
303186.0,6,2,132,1,66,0.0,66.0,66.0,1,66,0.0,66.0,66.0
123455988.0,6,49,3234,25,1650,5143999.5,66.0,66.0,24,1584,5087070.043478261,66.0,66.0
107612.0,17,2,286,2,286,0.0,143.0,143.0,0,0,0.0,0.0,0.0
282.0,17,2,156,1,78,0.0,78.0,78.0,1,78,0.0,78.0,78.0
16701602.999999998,6,23,8609,13,1719,1391800.25,408.0,132.23076923076923,10,6890,1397089.7777777778,1514.0,689.0
105622.0,17,2,700,2,700,0.0,350.0,350.0,0,0,0.0,0.0,0.0
205915.0,6,3,426,2,280,0.0,214.0,140.0,1,146,0.0,146.0,146.0
27898.0,6,10,2032,5,524,6488.5,252.0,104.8,5,1508,6437.5,1236.0,301.6
209145.0,6,4,492,2,280,0.0,214.0,140.0,2,212,0.0,146.0,106.0
131006.0,6,2,132,1,66,0.0,66.0,66.0,1,66,0.0,66.0,66.0
120054193.0,17,29,13785,29,13785,4287649.75,501.0,475.3448275862069,0,0,0.0,0.0,0.0
102317120.0,6,451,95288,221,15104,465077.8181818182,214.0,68.34389140271493,230,80184,442265.4585152838,1514.0,348.62608695652176
101000937.0,17,13,1083,7,563,16833489.5,174.0,80.42857142857143,6,520,16200757.8,174.0,86.66666666666667
120066133.0,17,29,13785,29,13785,4288076.178571428,501.0,475.3448275862069,0,0,0.0,0.0,0.0
119203407.0,6,228,25952,114,18132,1054897.407079646,300.0,159.05263157894737,114,7820,1052882.5221238935,140.0,68.59649122807018
108101211.0,17,5,1005,5,1005,27025302.75,201.0,201.0,0,0,0.0,0.0,0.0
90216232.0,6,16,1192,8,596,12853747.285714284,95.0,74.5,8,596,12858638.57142857,95.0,74.5
0.0,17,1,381,1,381,0.0,381.0,381.0,0,0,0.0,0.0,0.0
500595.0,6,5,336,2,134,0.0,68.0,67.0,3,202,196566.5,70.0,67.33333333333333
94352.0,6,2,132,1,66,0.0,66.0,66.0,1,66,0.0,66.0,66.0
21911.0,17,2,582,1,83,0.0,83.0,83.0,1,499,0.0,499.0,499.0
383161.0,17,2,363,1,75,0.0,75.0,75.0,1,288,0.0,288.0,288.0
91627457.0,6,28,1992,14,1029,7031667.923076923,123.0,73.5,14,963,7031667.307692308,123.0,68.78571428571429
1304044.0,6,4,264,2,132,0.0,66.0,66.0,2,132,0.0,66.0,66.0
74153.0,6,14,4740,7,653,12088.5,249.0,93.28571428571428,7,4087,10242.666666666666,1514.0,583.8571428571429
135131718.0,17,6,1146,6,1146,27026343.6,191.0,191.0,0,0,0.0,0.0,0.0
9470.0,17,2,539,1,86,0.0,86.0,86.0,1,453,0.0,453.0,453.0
80106.0,6,14,4740,7,653,13227.333333333334,249.0,93.28571428571428,7,4087,13184.166666666666,1514.0,583.8571428571429
70234.0,6,14,4740,7,653,11597.333333333334,249.0,93.28571428571428,7,4087,11436.166666666666,1514.0,583.8571428571429
157582.0,6,10,1065,5,534,39125.25,262.0,106.8,5,531,2853.0,259.0,106.2
13288.0,6,11,1133,6,602,2428.6,264.0,100.33333333333331,5,531,2447.75,259.0,106.2
101844.0,17,4,6056,4,6056,33948.0,1514.0,1514.0,0,0,0.0,0.0,0.0
308455.0,6,3,202,2,128,0.0,74.0,64.0,1,74,0.0,74.0,74.0
14035.0,6,13,1459,7,862,2075.0,271.0,123.14285714285714,6,597,2485.2,259.0,99.5
16343.0,6,10,2032,5,524,3437.0,252.0,104.8,5,1508,3777.25,1236.0,301.6
142809.0,6,2,132,1,66,0.0,66.0,66.0,1,66,0.0,66.0,66.0
310579.0,17,4,1400,4,1400,103526.33333333331,350.0,350.0,0,0,0.0,0.0,0.0
90326349.0,6,16,1192,8,596,12892679.0,95.0,74.5,8,596,12901705.857142856,95.0,74.5
862936.0,6,9,1096,6,625,172587.2,287.0,104.16666666666669,3,471,293860.0,331.0,157.0
1062787.0,6,6,482,4,338,352095.0,103.0,84.5,2,144,0.0,78.0,72.0
221229.0,17,2,180,1,90,0.0,90.0,90.0,1,90,0.0,90.0,90.0
758.0,17,2,762,2,762,0.0,381.0,381.0,0,0,0.0,0.0,0.0
120192384.0,6,240,27152,120,8216,1003028.1764705882,140.0,68.46666666666667,120,18936,985584.5546218487,300.0,157.8
43210.0,6,14,4740,7,653,6621.666666666667,249.0,93.28571428571428,7,4087,7025.166666666667,1514.0,583.8571428571429
120058868.0,17,29,13785,29,13785,4287816.714285715,501.0,475.3448275862069,0,0,0.0,0.0,0.0
0.0,6,1,66,1,66,0.0,66.0,66.0,0,0,0.0,0.0,0.0
302392.0,6,2,132,1,66,0.0,66.0,66.0,1,66,0.0,66.0,66.0
153415.0,17,2,180,1,90,0.0,90.0,90.0,1,90,0.0,90.0,90.0
233608.0,6,3,337,2,214,0.0,160.0,107.0,1,123,0.0,123.0,123.0
5631663.0,6,5,336,2,134,0.0,68.0,67.0,3,202,1423444.5,70.0,67.33333333333333
9205.0,17,2,571,1,86,0.0,86.0,86.0,1,485,0.0,485.0,485.0
90523968.0,6,14,2240,8,1016,12931995.42857143,188.0,127.0,6,1224,18071384.4,204.0,204.0
18276.0,6,14,4740,7,653,2873.833333333333,249.0,93.28571428571428,7,4087,2761.5,1514.0,583.8571428571429
200640.0,17,2,180,1,90,0.0,90.0,90.0,1,90,0.0,90.0,90.0
0.0,17,1,55,1,55,0.0,55.0,55.0,0,0,0.0,0.0,0.0
2464.0,17,2,762,2,762,0.0,381.0,381.0,0,0,0.0,0.0,0.0
300969.0,6,6,412,4,272,100323.0,74.0,68.0,2,140,0.0,74.0,70.0
90029866.0,17,28,13364,28,13364,3334439.4814814813,501.0,477.2857142857143,0,0,0.0,0.0,0.0
48901.0,6,14,4740,7,653,7414.333333333333,249.0,93.28571428571428,7,4087,8014.166666666667,1514.0,583.8571428571429
1736956.0,6,2,132,1,66,0.0,66.0,66.0,1,66,0.0,66.0,66.0
44767.0,6,10,2032,5,524,10977.75,252.0,104.8,5,1508,7714.0,1236.0,301.6
105914.0,17,2,762,2,762,0.0,381.0,381.0,0,0,0.0,0.0,0.0
257963.0,6,3,337,2,214,0.0,160.0,107.0,1,123,0.0,123.0,123.0
0.0,6,1,66,1,66,0.0,66.0,66.0,0,0,0.0,0.0,0.0
90923168.0,6,26,1762,13,922,7558940.333333333,139.0,70.92307692307692,13,840,7558939.583333333,123.0,64.61538461538461
314094.0,6,3,1604,2,851,0.0,785.0,425.5,1,753,0.0,753.0,753.0
21113.0,6,14,4740,7,653,3338.5,249.0,93.28571428571428,7,4087,3295.0,1514.0,583.8571428571429
1309614.0,6,4,264,2,132,0.0,66.0,66.0,2,132,0.0,66.0,66.0
143893.0,17,2,180,1,90,0.0,90.0,90.0,1,90,0.0,90.0,90.0
105074977.0,17,17,2060,9,1299,13133501.375,394.0,144.33333333333334,8,761,14974779.285714284,250.0,95.125
64470.0,6,12,1328,6,731,11166.8,253.0,121.83333333333331,6,597,10413.2,259.0,99.5
864712.0,6,9,1269,6,798,172942.4,460.0,133.0,3,471,296099.5,331.0,157.0
11122.0,6,10,1975,5,467,2550.5,195.0,93.4,5,1508,2203.25,1236.0,301.6
21131044.0,17,3,1034,2,684,0.0,342.0,342.0,1,350,0.0,350.0,350.0
135139736.0,17,6,1146,6,1146,27027947.2,191.0,191.0,0,0,0.0,0.0,0.0
120054587.0,6,34,2334,17,1209,7489911.5625,123.0,71.11764705882354,17,1125,7489910.5,123.0,66.17647058823529
121559.0,17,6,1230,3,234,60597.5,78.0,78.0,3,996,60557.5,332.0,332.0
16939.0,6,11,2098,6,590,3147.4,252.0,98.33333333333331,5,1508,3886.5,1236.0,301.6
108109087.0,17,5,955,5,955,27027271.75,191.0,191.0,0,0,0.0,0.0,0.0
106627.0,17,2,286,2,286,0.0,143.0,143.0,0,0,0.0,0.0,0.0
302421.0,6,2,132,1,66,0.0,66.0,66.0,1,66,0.0,66.0,66.0
247390.0,6,3,373,2,238,0.0,172.0,119.0,1,135,0.0,135.0,135.0
19952.0,6,14,4740,7,653,3183.833333333333,249.0,93.28571428571428,7,4087,2877.0,1514.0,583.8571428571429
9838.0,17,2,539,1,86,0.0,86.0,86.0,1,453,0.0,453.0,453.0
232990.0,6,3,337,2,214,0.0,160.0,107.0,1,123,0.0,123.0,123.0
56837.0,6,10,2032,5,524,13689.5,252.0,104.8,5,1508,13193.75,1236.0,301.6
2818550.0,6,3,1604,2,851,0.0,785.0,425.5,1,753,0.0,753.0,753.0
90034610.0,17,28,13364,28,13364,3334615.185185185,501.0,477.2857142857143,0,0,0.0,0.0,0.0
0.0,6,1,66,1,66,0.0,66.0,66.0,0,0,0.0,0.0,0.0
209584.0,17,2,180,1,90,0.0,90.0,90.0,1,90,0.0,90.0,90.0
135131200.0,17,6,1206,6,1206,27026240.0,201.0,201.0,0,0,0.0,0.0,0.0
2363.0,17,4,344,2,150,0.0,75.0,75.0,2,194,0.0,103.0,97.0
33362.0,6,14,4740,7,653,5450.5,249.0,93.28571428571428,7,4087,5427.333333333333,1514.0,583.8571428571429
16472.0,6,10,2032,5,524,3851.25,252.0,104.8,5,1508,3878.0,1236.0,301.6
3104996.0,6,3,1604,2,851,0.0,785.0,425.5,1,753,0.0,753.0,753.0
312923.0,6,6,412,4,272,104307.66666666669,74.0,68.0,2,140,0.0,74.0,70.0
306918.0,6,6,412,4,272,102306.0,74.0,68.0,2,140,0.0,74.0,70.0
1112450.0,6,13,1386,7,789,185408.3333333333,253.0,112.71428571428572,6,597,220504.4,259.0,99.5
96865198.0,6,195,21936,98,6690,998610.2886597938,140.0,68.26530612244898,97,15246,998097.46875,284.0,157.17525773195877
146138.0,6,3,337,2,214,0.0,160.0,107.0,1,123,0.0,123.0,123.0
97006130.0,17,14,1126,7,563,16167688.333333334,174.0,80.42857142857143,7,563,16000136.833333334,174.0,80.42857142857143
10035370.0,17,3,1034,2,684,0.0,342.0,342.0,1,350,0.0,350.0,350.0
261597.00000000003,6,10,1221,6,636,52319.4,298.0,106.0,4,585,81490.66666666667,379.0,146.25
170133.0,6,14,4740,7,653,28135.5,249.0,93.28571428571428,7,4087,28007.166666666668,1514.0,583.8571428571429
1284157.0,17,7,490,7,490,214026.16666666663,70.0,70.0,0,0,0.0,0.0,0.0
6995.0,17,2,582,1,83,0.0,83.0,83.0,1,499,0.0,499.0,499.0
1035851.0,6,11,1134,6,558,207170.2,220.0,93.0,5,576,256941.0,304.0,115.2
32681643.0,6,5,336,2,134,0.0,68.0,67.0,3,202,14949462.0,70.0,67.33333333333333
303165.0,6,2,132,1,66,0.0,66.0,66.0,1,66,0.0,66.0,66.0
216362.0,17,2,180,1,90,0.0,90.0,90.0,1,90,0.0,90.0,90.0
2132.0,17,4,344,2,150,0.0,75.0,75.0,2,194,0.0,103.0,97.0
1914.0,17,4,344,2,150,0.0,75.0,75.0,2,194,0.0,103.0,97.0
109805702.0,6,34,2466,17,1272,6862856.375,123.0,74.82352941176471,17,1194,6849319.375,123.0,70.23529411764706
147857.0,17,4,704,2,148,0.0,74.0,74.0,2,556,0.0,280.0,278.0
102269673.0,6,190,21426,95,14934,1085685.7659574468,284.0,157.2,95,6492,1085685.5212765958,140.0,68.33684210526316
299516.0,6,6,412,4,272,99838.66666666669,74.0,68.0,2,140,0.0,74.0,70.0
3171410.0,6,18,1495,9,921,358343.75,315.0,102.33333333333331,9,574,358309.875,78.0,63.77777777777778
501018.0,6,5,336,2,134,0.0,68.0,67.0,3,202,194486.5,70.0,67.33333333333333
228398.0,17,2,180,1,90,0.0,90.0,90.0,1,90,0.0,90.0,90.0
31726.0,6,14,4740,7,653,5134.333333333333,249.0,93.28571428571428,7,4087,4642.833333333333,1514.0,583.8571428571429
120120539.0,6,255,29158,128,8744,945831.0157480316,140.0,68.3125,127,20414,945172.5952380951,284.0,160.74015748031496
2385.0,17,4,344,2,150,0.0,75.0,75.0,2,194,0.0,103.0,97.0
38826.0,6,12,1320,6,723,6590.8,253.0,120.5,6,597,7406.6,259.0,99.5
49647.0,6,14,4740,7,653,6512.833333333333,249.0,93.28571428571428,7,4087,6999.666666666667,1514.0,583.8571428571429
33701908.0,6,5,336,2,134,0.0,68.0,67.0,3,202,15462794.0,70.0,67.33333333333333
2235353.0,6,19,6869,10,1501,248372.5555555556,408.0,150.1,9,5368,236764.0,1514.0,596.4444444444445
216528.0,6,3,426,2,280,0.0,214.0,140.0,1,146,0.0,146.0,146.0
108109340.0,17,5,955,5,955,27027335.0,191.0,191.0,0,0,0.0,0.0,0.0
0.0,6,1,66,1,66,0.0,66.0,66.0,0,0,0.0,0.0,0.0
48510.0,6,14,4740,7,653,7044.166666666667,249.0,93.28571428571428,7,4087,7065.833333333333,1514.0,583.8571428571429
2280.0,17,4,344,2,150,0.0,75.0,75.0,2,194,0.0,103.0,97.0
285674.0,17,2,363,1,79,0.0,79.0,79.0,1,284,0.0,284.0,284.0
34979.0,6,14,4740,7,653,4884.5,249.0,93.28571428571428,7,4087,5693.666666666667,1514.0,583.8571428571429
60018.0,6,10,2032,5,524,14370.0,252.0,104.8,5,1508,14651.75,1236.0,301.6
307086.0,6,3,202,2,128,0.0,74.0,64.0,1,74,0.0,74.0,74.0
27182.0,6,10,1067,5,536,6570.25,264.0,107.2,5,531,6577.75,259.0,106.2
101281.0,17,2,286,2,286,0.0,143.0,143.0,0,0,0.0,0.0,0.0
2056.0,17,4,344,2,150,0.0,75.0,75.0,2,194,0.0,103.0,97.0
120222195.0,6,19,1395,10,745,13331097.777777778,95.0,74.5,9,650,14997488.5,95.0,72.22222222222223
171629.0,17,2,180,1,90,0.0,90.0,90.0,1,90,0.0,90.0,90.0
205815.0,6,4,492,2,280,0.0,214.0,140.0,2,212,0.0,146.0,106.0
118000924.0,17,14,1126,8,606,16857274.85714286,174.0,75.75,6,520,19400772.6,174.0,86.66666666666667
1777125.0,6,2,132,1,66,0.0,66.0,66.0,1,66,0.0,66.0,66.0
146820.0,6,3,337,2,214,0.0,160.0,107.0,1,123,0.0,123.0,123.0
301672.0,6,6,412,4,272,100557.33333333331,74.0,68.0,2,140,0.0,74.0,70.0
790.0,17,2,762,2,762,0.0,381.0,381.0,0,0,0.0,0.0,0.0
107600.0,17,2,286,2,286,0.0,143.0,143.0,0,0,0.0,0.0,0.0
27035.0,6,14,4740,7,653,4092.3333333333335,249.0,93.28571428571428,7,4087,4369.166666666667,1514.0,583.8571428571429
14311.0,6,10,2032,5,524,3051.0,252.0,104.8,5,1508,3317.25,1236.0,301.6
90284404.0,6,17,1287,9,691,11280164.0,95.0,76.77777777777777,8,596,12896237.857142856,95.0,74.5
258937.0,6,10,1221,6,636,51787.4,298.0,106.0,4,585,80893.66666666667,379.0,146.25
2009679.0,17,4,525,2,150,0.0,75.0,75.0,2,375,0.0,284.0,187.5
340.0,17,2,267,1,83,0.0,83.0,83.0,1,184,0.0,184.0,184.0
53664.0,6,10,2032,5,524,11004.5,252.0,104.8,5,1508,13066.5,1236.0,301.6
45073.0,6,14,4740,7,653,7290.833333333333,249.0,93.28571428571428,7,4087,6956.333333333333,1514.0,583.8571428571429
209110.0,6,3,426,2,280,0.0,214.0,140.0,1,146,0.0,146.0,146.0
39878.0,6,14,4740,7,653,6472.666666666667,249.0,93.28571428571428,7,4087,6514.0,1514.0,583.8571428571429
1649591.0,6,20,6434,12,1921,149962.81818181818,620.0,160.08333333333334,8,4513,191988.2857142857,1514.0,564.125
122835988.0,6,37,2656,19,1408,6824221.555555556,139.0,74.10526315789474,18,1248,6625481.05882353,123.0,69.33333333333333
2045170.0,6,18,6803,10,1501,227241.11111111112,408.0,150.1,8,5302,230519.7142857143,1514.0,662.75
118362033.0,6,195,22064,98,6764,1220227.144329897,140.0,69.0204081632653,97,15300,1222206.8541666667,284.0,157.7319587628866
103809028.0,6,44,2904,22,1452,4943287.047619048,66.0,66.0,22,1452,4928994.380952381,66.0,66.0
107000888.0,17,13,821,7,432,17833481.333333332,174.0,61.71428571428572,6,389,19897809.4,174.0,64.83333333333333
209372.0,17,2,180,1,90,0.0,90.0,90.0,1,90,0.0,90.0,90.0
1161143.0,6,13,3010,8,2382,165877.57142857142,1514.0,297.75,5,628,222139.5,331.0,125.6
90771717.0,6,19,1436,10,745,10080891.222222222,95.0,74.5,9,691,11346237.5,95.0,76.77777777777777
9918.0,6,10,1067,5,536,2130.25,264.0,107.2,5,531,2121.25,259.0,106.2
157801.0,17,2,180,1,90,0.0,90.0,90.0,1,90,0.0,90.0,90.0
27530.0,6,10,2032,5,524,6594.0,252.0,104.8,5,1508,6551.0,1236.0,301.6
303603.0,6,2,132,1,66,0.0,66.0,66.0,1,66,0.0,66.0,66.0
146693.0,6,3,373,2,238,0.0,172.0,119.0,1,135,0.0,135.0,135.0
143886.0,17,2,180,1,90,0.0,90.0,90.0,1,90,0.0,90.0,90.0
90070421.0,17,28,13364,28,13364,3335941.5185185187,501.0,477.2857142857143,0,0,0.0,0.0,0.0
108112523.0,17,5,955,5,955,27028130.75,191.0,191.0,0,0,0.0,0.0,0.0
757.0,17,4,438,2,148,0.0,74.0,74.0,2,290,0.0,147.0,145.0
0.0,6,1,66,1,66,0.0,66.0,66.0,0,0,0.0,0.0,0.0
213775.0,17,2,180,1,90,0.0,90.0,90.0,1,90,0.0,90.0,90.0
110497702.0,6,32,2427,15,1155,7892693.0,123.0,77.0,17,1272,6892591.6875,123.0,74.82352941176471
143871.0,17,2,180,1,90,0.0,90.0,90.0,1,90,0.0,90.0,90.0
10524176.0,6,7,478,4,272,3462981.6666666665,74.0,68.0,3,206,5194347.0,74.0,68.66666666666667
20683.0,17,2,582,1,83,0.0,83.0,83.0,1,499,0.0,499.0,499.0
112532.0,17,2,286,2,286,0.0,143.0,143.0,0,0,0.0,0.0,0.0
453.0,17,2,166,1,75,0.0,75.0,75.0,1,91,0.0,91.0,91.0
32501.000000000004,6,14,4740,7,653,5295.166666666667,249.0,93.28571428571428,7,4087,5184.5,1514.0,583.8571428571429
135125560.0,17,6,1146,6,1146,27025112.0,191.0,191.0,0,0,0.0,0.0,0.0
3124139.0,6,150,115613,82,106823,38569.61728395062,1510.0,1302.719512195122,68,8790,41696.835820895525,1510.0,129.26470588235293
97457667.0,17,12,778,6,389,19400160.2,174.0,64.83333333333333,6,389,19401575.4,174.0,64.83333333333333
36841.0,6,14,4740,7,653,5971.833333333333,249.0,93.28571428571428,7,4087,5466.166666666667,1514.0,583.8571428571429
370.0,17,2,267,1,83,0.0,83.0,83.0,1,184,0.0,184.0,184.0
62518.00000000001,6,14,4740,7,653,9756.666666666666,249.0,93.28571428571428,7,4087,10112.666666666666,1514.0,583.8571428571429
121275.0,6,3,337,2,214,0.0,160.0,107.0,1,123,0.0,123.0,123.0
9807.0,17,2,582,1,83,0.0,83.0,83.0,1,499,0.0,499.0,499.0
507862.00000000006,6,5,336,2,134,0.0,68.0,67.0,3,202,195163.0,70.0,67.33333333333333
709726.0,6,5,336,2,134,0.0,68.0,67.0,3,202,195564.0,70.0,67.33333333333333
282785.0,6,12,1373,7,714,47130.833333333336,298.0,102.0,5,659,66688.25,379.0,131.8
5830581.0,6,5,336,2,134,0.0,68.0,67.0,3,202,1526525.5,70.0,67.33333333333333
1188685.0,6,13,3015,8,2387,169812.14285714287,1514.0,298.375,5,628,228265.5,331.0,125.6
146156.0,6,3,337,2,214,0.0,160.0,107.0,1,123,0.0,123.0,123.0
9326.0,6,11,2041,6,533,1659.2,195.0,88.83333333333333,5,1508,1919.5,1236.0,301.6
23052792.0,17,3,1034,2,684,0.0,342.0,342.0,1,350,0.0,350.0,350.0
309.0,17,2,174,1,79,0.0,79.0,79.0,1,95,0.0,95.0,95.0
309823.0,17,4,1400,4,1400,103274.33333333331,350.0,350.0,0,0,0.0,0.0,0.0
74343.0,6,14,4740,7,653,12245.833333333334,249.0,93.28571428571428,7,4087,11919.666666666666,1514.0,583.8571428571429
90095846.0,6,13,2052,6,1224,18018700.0,204.0,204.0,7,828,15015575.0,188.0,118.28571428571428
143868.0,17,2,180,1,90,0.0,90.0,90.0,1,90,0.0,90.0,90.0
265929.0,6,10,1221,6,636,53185.8,298.0,106.0,4,585,80777.33333333333,379.0,146.25
246911.0,6,3,337,2,214,0.0,160.0,107.0,1,123,0.0,123.0,123.0
31482.000000000004,6,14,4740,7,653,5043.666666666667,249.0,93.28571428571428,7,4087,5065.666666666667,1514.0,583.8571428571429
120215.0,17,2,180,1,70,0.0,70.0,70.0,1,110,0.0,110.0,110.0
2594799.0,6,2,132,1,66,0.0,66.0,66.0,1,66,0.0,66.0,66.0
107881.0,17,2,286,2,286,0.0,143.0,143.0,0,0,0.0,0.0,0.0
24741.0,6,10,2032,5,524,5526.75,252.0,104.8,5,1508,5922.5,1236.0,301.6
15226.0,6,10,1067,5,536,3638.5,264.0,107.2,5,531,3252.0,259.0,106.2
98125041.0,6,176,19872,88,13842,1125400.6896551724,284.0,157.29545454545453,88,6030,1125400.6436781608,140.0,68.52272727272727
46206.0,6,10,2032,5,524,9568.75,252.0,104.8,5,1508,10892.0,1236.0,301.6
2287.0,17,4,344,2,150,0.0,75.0,75.0,2,194,0.0,103.0,97.0
123018683.0,17,15,1300,8,737,17574097.57142857,174.0,92.125,7,563,19665132.33333333,174.0,80.42857142857143
26568.0,6,14,4740,7,653,3398.833333333333,249.0,93.28571428571428,7,4087,4292.833333333333,1514.0,583.8571428571429
105248092.0,17,14,864,7,432,17501383.666666668,174.0,61.71428571428572,7,432,17500211.166666668,174.0,61.71428571428572
97747134.0,17,12,4112,11,3762,7476484.2,342.0,342.0,1,350,0.0,350.0,350.0
288460.0,17,2,180,1,90,0.0,90.0,90.0,1,90,0.0,90.0,90.0
431292.0,6,3,1777,2,951,0.0,885.0,475.5,1,826,0.0,826.0,826.0
104272.0,17,2,700,2,700,0.0,350.0,350.0,0,0,0.0,0.0,0.0
11875.0,17,4,823,2,163,0.0,89.0,81.5,2,660,0.0,443.0,330.0
90671976.0,6,17,2434,9,1204,11315504.625,188.0,133.77777777777777,8,1230,12924721.857142856,204.0,153.75
163028.0,6,3,337,2,214,0.0,160.0,107.0,1,123,0.0,123.0,123.0
108101437.0,17,5,1005,5,1005,27025359.25,201.0,201.0,0,0,0.0,0.0,0.0
304.0,17,2,174,1,79,0.0,79.0,79.0,1,95,0.0,95.0,95.0
2430.0,17,4,344,2,150,0.0,75.0,75.0,2,194,0.0,103.0,97.0
117816003.0,6,221,24822,111,7548,1071054.5727272728,140.0,68.0,110,17274,1076178.752293578,284.0,157.03636363636363
106587844.0,17,14,864,7,432,17737955.166666668,174.0,61.71428571428572,7,432,17757345.0,174.0,61.71428571428572
4459.0,17,2,180,1,90,0.0,90.0,90.0,1,90,0.0,90.0,90.0
298978.0,6,6,412,4,272,99659.33333333331,74.0,68.0,2,140,0.0,74.0,70.0
316627.0,6,6,412,4,272,105542.33333333331,74.0,68.0,2,140,0.0,74.0,70.0
25990.0,6,10,2032,5,524,5991.75,252.0,104.8,5,1508,6055.5,1236.0,301.6
90256687.0,6,14,2240,8,1016,12893812.42857143,188.0,127.0,6,1224,18018923.0,204.0,204.0
109745952.0,17,14,864,7,432,18166828.5,174.0,61.71428571428572,7,432,18168755.5,174.0,61.71428571428572
42669.0,6,14,4740,7,653,6957.5,249.0,93.28571428571428,7,4087,6908.666666666667,1514.0,583.8571428571429
105601.0,17,2,286,2,286,0.0,143.0,143.0,0,0,0.0,0.0,0.0
5989.0,17,2,231,1,78,0.0,78.0,78.0,1,153,0.0,153.0,153.0
120120924.0,6,13,2020,9,1204,15015115.5,188.0,133.77777777777777,4,816,30030077.0,204.0,204.0
2309.0,17,4,344,2,150,0.0,75.0,75.0,2,194,0.0,103.0,97.0
0.0,6,1,54,1,54,0.0,54.0,54.0,0,0,0.0,0.0,0.0
201915.0,17,4,6056,4,6056,67305.0,1514.0,1514.0,0,0,0.0,0.0,0.0
153403.0,17,2,180,1,90,0.0,90.0,90.0,1,90,0.0,90.0,90.0
59401475.0,17,9,3086,8,2736,5214199.0,342.0,342.0,1,350,0.0,350.0,350.0
90257885.0,6,17,2572,9,1204,11282235.625,188.0,133.77777777777777,8,1368,12870328.714285716,204.0,171.0
504775.0,6,5,336,2,134,0.0,68.0,67.0,3,202,195897.5,70.0,67.33333333333333
30367.0,6,14,4740,7,653,4904.166666666667,249.0,93.28571428571428,7,4087,4803.0,1514.0,583.8571428571429
153529.0,17,2,180,1,90,0.0,90.0,90.0,1,90,0.0,90.0,90.0
126762.0,6,14,4740,7,653,20223.166666666668,249.0,93.28571428571428,7,4087,20862.166666666668,1514.0,583.8571428571429
146188.0,6,3,337,2,214,0.0,160.0,107.0,1,123,0.0,123.0,123.0
2799809.0,6,2,132,1,66,0.0,66.0,66.0,1,66,0.0,66.0,66.0
327.0,17,2,166,1,75,0.0,75.0,75.0,1,91,0.0,91.0,91.0
94879377.0,6,185,20826,93,6360,1031297.5760869564,140.0,68.38709677419355,92,14466,1031320.868131868,284.0,157.2391304347826
1399191.0,17,7,490,7,490,233198.5,70.0,70.0,0,0,0.0,0.0,0.0
4226.0,17,2,598,1,72,0.0,72.0,72.0,1,526,0.0,526.0,526.0
0.0,6,1,54,0,0,0.0,0.0,0.0,1,54,0.0,54.0,54.0
90393436.0,6,26,1762,13,922,7514784.666666667,139.0,70.92307692307692,13,840,7514785.416666667,123.0,64.61538461538461
108106530.0,17,5,955,5,955,27026632.5,191.0,191.0,0,0,0.0,0.0,0.0
61779.0,6,14,4740,7,653,10172.0,249.0,93.28571428571428,7,4087,7054.166666666667,1514.0,583.8571428571429
2313.0,17,4,344,2,150,0.0,75.0,75.0,2,194,0.0,103.0,97.0
307259.0,6,6,412,4,272,102419.66666666669,74.0,68.0,2,140,0.0,74.0,70.0
206661.0,6,3,426,2,280,0.0,214.0,140.0,1,146,0.0,146.0,146.0
2795648.0,6,2,132,1,66,0.0,66.0,66.0,1,66,0.0,66.0,66.0
1314113.0,6,4,264,2,132,0.0,66.0,66.0,2,132,0.0,66.0,66.0
139354.0,6,2,132,1,66,0.0,66.0,66.0,1,66,0.0,66.0,66.0
849188.0,6,9,1096,6,625,169837.6,287.0,104.16666666666669,3,471,288338.5,331.0,157.0
135126520.0,17,6,1206,6,1206,27025304.0,201.0,201.0,0,0,0.0,0.0,0.0
1192761.0,6,13,3012,8,2384,170394.42857142858,1514.0,298.0,5,628,229376.0,331.0,125.6
110298898.0,6,30,1974,15,1026,7863059.5,123.0,68.4,15,948,7863061.285714285,123.0,63.2
602413.0,17,4,629,3,234,79479.5,78.0,78.0,1,395,0.0,395.0,395.0
2569966.0,6,25,7573,14,3735,197689.6923076923,1514.0,266.7857142857143,11,3838,230727.1,1514.0,348.90909090909093
3366512.0,6,7,923,4,753,1053417.0,571.0,188.25,3,170,1580529.0,62.0,56.66666666666666
340505.0,17,2,618,1,72,0.0,72.0,72.0,1,546,0.0,546.0,546.0
233865.0,6,3,337,2,214,0.0,160.0,107.0,1,123,0.0,123.0,123.0
308133.0,6,6,412,4,272,102711.0,74.0,68.0,2,140,0.0,74.0,70.0
108117696.0,17,5,1005,5,1005,27029424.0,201.0,201.0,0,0,0.0,0.0,0.0
101702.0,17,2,762,2,762,0.0,381.0,381.0,0,0,0.0,0.0,0.0
14639756.0,6,19,1553,9,921,1792058.5,315.0,102.33333333333331,10,632,1592903.111111111,78.0,63.2
120183963.0,6,232,26406,116,7952,1038061.8782608696,140.0,68.55172413793103,116,18454,1037922.5304347826,300.0,159.08620689655172
3004250.0,6,11,2106,6,598,600645.8,252.0,99.66666666666669,5,1508,1777.75,1236.0,301.6
164674.0,17,2,414,1,88,0.0,88.0,88.0,1,326,0.0,326.0,326.0
108108832.0,17,5,1005,5,1005,27027208.0,201.0,201.0,0,0,0.0,0.0,0.0
12199.0,6,10,1067,5,536,2833.5,264.0,107.2,5,531,2438.0,259.0,106.2
2269.0,17,4,344,2,150,0.0,75.0,75.0,2,194,0.0,103.0,97.0
120007648.0,6,22,1680,11,840,12000764.8,95.0,76.36363636363636,11,840,8975645.9,95.0,76.36363636363636
130256.0,6,3,337,2,214,0.0,160.0,107.0,1,123,0.0,123.0,123.0
54831.0,6,14,4740,7,653,8788.666666666666,249.0,93.28571428571428,7,4087,6517.666666666667,1514.0,583.8571428571429
321346.0,17,4,1400,4,1400,107115.33333333331,350.0,350.0,0,0,0.0,0.0,0.0
120796720.0,17,14,995,8,606,17256674.285714287,174.0,75.75,6,389,19897342.2,174.0,64.83333333333333
34050.0,6,10,2032,5,524,8287.25,252.0,104.8,5,1508,8057.75,1236.0,301.6
281572.0,17,2,363,1,79,0.0,79.0,79.0,1,284,0.0,284.0,284.0
90301936.0,6,16,1192,8,596,12893130.42857143,95.0,74.5,8,596,12899447.714285716,95.0,74.5
308269.0,6,6,412,4,272,102756.33333333331,74.0,68.0,2,140,0.0,74.0,70.0
305577.0,6,6,412,4,272,101859.0,74.0,68.0,2,140,0.0,74.0,70.0
20104.0,17,2,582,1,83,0.0,83.0,83.0,1,499,0.0,499.0,499.0
333.0,17,2,166,1,75,0.0,75.0,75.0,1,91,0.0,91.0,91.0
65207.0,6,14,4740,7,653,10285.0,249.0,93.28571428571428,7,4087,9229.0,1514.0,583.8571428571429
14467.0,6,11,1131,6,600,2582.6,262.0,100.0,5,531,3269.75,259.0,106.2
245535.0,6,6,386,4,247,81845.0,85.0,61.75,2,139,0.0,85.0,69.5
91897851.0,6,37,2442,19,1254,5105436.166666667,66.0,66.0,18,1188,5136824.764705882,66.0,66.0
300680.0,6,6,412,4,272,100226.66666666669,74.0,68.0,2,140,0.0,74.0,70.0
37005.0,6,14,4740,7,653,6035.166666666667,249.0,93.28571428571428,7,4087,6029.833333333333,1514.0,583.8571428571429
90218430.0,6,19,1436,9,691,11247274.25,95.0,76.77777777777777,10,745,10001462.222222222,95.0,74.5
236588.0,17,2,180,1,90,0.0,90.0,90.0,1,90,0.0,90.0,90.0
2126664.0,6,25,7610,13,2516,177222.0,1034.0,193.53846153846155,12,5094,164454.36363636365,1510.0,424.5
239025.0,6,3,337,2,214,0.0,160.0,107.0,1,123,0.0,123.0,123.0
101620.0,17,2,286,2,286,0.0,143.0,143.0,0,0,0.0,0.0,0.0
99937044.0,6,24,1500,12,783,9065547.545454543,123.0,65.25,12,717,9065547.454545457,123.0,59.75
63055.0,6,14,4740,7,653,9904.666666666666,249.0,93.28571428571428,7,4087,10284.666666666666,1514.0,583.8571428571429
333.0,17,2,166,1,75,0.0,75.0,75.0,1,91,0.0,91.0,91.0
3013692.0,6,11,2106,6,598,602483.0,252.0,99.66666666666669,5,1508,2490.5,1236.0,301.6
2060.0,17,4,344,2,150,0.0,75.0,75.0,2,194,0.0,103.0,97.0
3209.0,17,4,625,2,163,0.0,89.0,81.5,2,462,0.0,245.0,231.0
123915109.0,6,33,2280,17,1209,7744694.3125,123.0,71.11764705882354,16,1071,7580849.666666667,123.0,66.9375
103009900.0,6,26,2034,14,1043,7920400.538461538,95.0,74.5,12,991,9338513.363636363,155.0,82.58333333333333
22931.0,6,14,4740,7,653,3173.1666666666665,249.0,93.28571428571428,7,4087,3484.1666666666665,1514.0,583.8571428571429
56012.0,6,14,4740,7,653,9122.833333333334,249.0,93.28571428571428,7,4087,8288.166666666666,1514.0,583.8571428571429
307206.0,6,6,412,4,272,102402.0,74.0,68.0,2,140,0.0,74.0,70.0
1303586.0,6,4,264,2,132,0.0,66.0,66.0,2,132,0.0,66.0,66.0
32383.000000000004,6,14,4740,7,653,4937.666666666667,249.0,93.28571428571428,7,4087,5060.666666666667,1514.0,583.8571428571429
310.0,17,2,156,1,78,0.0,78.0,78.0,1,78,0.0,78.0,78.0
34961.0,6,14,4740,7,653,5540.5,249.0,93.28571428571428,7,4087,5123.666666666667,1514.0,583.8571428571429
3010002.0,6,11,2106,6,598,601812.2,252.0,99.66666666666669,5,1508,2880.25,1236.0,301.6
201594.0,17,2,180,1,90,0.0,90.0,90.0,1,90,0.0,90.0,90.0
102906.0,17,2,286,2,286,0.0,143.0,143.0,0,0,0.0,0.0,0.0
90094221.0,6,11,1766,7,950,15015703.5,188.0,135.71428571428572,4,816,20021049.33333333,204.0,204.0
520925.0,6,5,336,2,134,0.0,68.0,67.0,3,202,199336.0,70.0,67.33333333333333
119570348.0,6,238,27204,119,19128,1011484.779661017,284.0,160.73949579831933,119,8076,1011484.3305084746,140.0,67.8655462184874
92698380.0,6,40,2640,20,1320,4878862.105263158,66.0,66.0,20,1320,4867485.157894737,66.0,66.0
349.0,17,2,156,1,78,0.0,78.0,78.0,1,78,0.0,78.0,78.0
307818.0,6,6,412,4,272,102606.0,74.0,68.0,2,140,0.0,74.0,70.0
1034.0,17,2,762,2,762,0.0,381.0,381.0,0,0,0.0,0.0,0.0
147769.0,6,3,337,2,214,0.0,160.0,107.0,1,123,0.0,123.0,123.0
21059.0,6,11,2098,6,590,3895.4,252.0,98.33333333333331,5,1508,4683.0,1236.0,301.6
111906221.0,6,44,2904,22,1452,5328867.666666667,66.0,66.0,22,1452,5313897.476190476,66.0,66.0
32740.0,6,10,2032,5,524,7951.0,252.0,104.8,5,1508,7625.5,1236.0,301.6
33689741.0,6,5,336,2,134,0.0,68.0,67.0,3,202,15452985.0,70.0,67.33333333333333
135129252.0,17,6,1146,6,1146,27025850.4,191.0,191.0,0,0,0.0,0.0,0.0
205994.0,17,2,762,2,762,0.0,381.0,381.0,0,0,0.0,0.0,0.0
232998.0,6,3,337,2,214,0.0,160.0,107.0,1,123,0.0,123.0,123.0
2493524.0,6,2,132,1,66,0.0,66.0,66.0,1,66,0.0,66.0,66.0
101699962.0,17,14,1126,7,563,16829417.5,174.0,80.42857142857143,7,563,16833486.166666668,174.0,80.42857142857143
647.0,17,2,762,2,762,0.0,381.0,381.0,0,0,0.0,0.0,0.0
135142237.0,17,6,1206,6,1206,27028447.4,201.0,201.0,0,0,0.0,0.0,0.0
2590842.0,6,2,132,1,66,0.0,66.0,66.0,1,66,0.0,66.0,66.0
150493.0,6,2,132,1,66,0.0,66.0,66.0,1,66,0.0,66.0,66.0
284875.0,17,2,363,1,79,0.0,79.0,79.0,1,284,0.0,284.0,284.0
205999.0,17,2,180,1,90,0.0,90.0,90.0,1,90,0.0,90.0,90.0
135140968.0,17,6,1146,6,1146,27028193.6,191.0,191.0,0,0,0.0,0.0,0.0
220135.0,17,2,180,1,90,0.0,90.0,90.0,1,90,0.0,90.0,90.0
2965.0,17,2,224,1,76,0.0,76.0,76.0,1,148,0.0,148.0,148.0
120279928.0,6,210,23630,105,7226,1148644.2115384615,140.0,68.81904761904762,105,16404,1148644.2692307692,284.0,156.22857142857143
1239061.0,6,7,499,3,198,612403.5,66.0,66.0,4,301,405976.6666666667,103.0,75.25
293.0,17,2,156,1,78,0.0,78.0,78.0,1,78,0.0,78.0,78.0
119863681.0,6,14,2102,5,1020,29965334.25,204.0,204.0,9,1082,14982819.5,188.0,120.22222222222224
21151.0,6,14,4740,7,653,3008.333333333333,249.0,93.28571428571428,7,4087,3389.333333333333,1514.0,583.8571428571429
1055.0,17,2,700,2,700,0.0,350.0,350.0,0,0,0.0,0.0,0.0
46468.0,6,14,4740,7,653,7628.166666666667,249.0,93.28571428571428,7,4087,6612.5,1514.0,583.8571428571429
196925.0,17,2,180,1,90,0.0,90.0,90.0,1,90,0.0,90.0,90.0
54041.0,6,14,4740,7,653,8856.0,249.0,93.28571428571428,7,4087,8025.333333333333,1514.0,583.8571428571429
123416339.0,6,48,3168,24,1584,4973695.608695652,66.0,66.0,24,1584,5327871.652173913,66.0,66.0
147951.0,6,3,373,2,238,0.0,172.0,119.0,1,135,0.0,135.0,135.0
309812.0,6,6,412,4,272,103270.66666666669,74.0,68.0,2,140,0.0,74.0,70.0
1538405.0,6,4,492,2,280,0.0,214.0,140.0,2,212,0.0,146.0,106.0
319250.0,17,4,1400,4,1400,106416.66666666669,350.0,350.0,0,0,0.0,0.0,0.0
90759337.0,6,19,1477,12,935,8250848.818181818,95.0,77.91666666666667,7,542,15044725.666666666,95.0,77.42857142857143
90055651.0,17,27,12943,27,12943,3463678.8846153845,501.0,479.3703703703704,0,0,0.0,0.0,0.0
92443784.0,17,16,5472,16,5472,6162918.933333334,342.0,342.0,0,0,0.0,0.0,0.0
18908.0,17,2,582,1,83,0.0,83.0,83.0,1,499,0.0,499.0,499.0
113487907.0,6,48,3168,24,1584,4934256.826086956,66.0,66.0,24,1584,4922282.391304348,66.0,66.0
162242.0,17,2,180,1,90,0.0,90.0,90.0,1,90,0.0,90.0,90.0
303132.0,6,2,132,1,66,0.0,66.0,66.0,1,66,0.0,66.0,66.0
120000385.0,6,20,1531,11,840,12000038.5,95.0,76.36363636363636,9,691,11285905.0,95.0,76.77777777777777
228268.0,17,2,180,1,90,0.0,90.0,90.0,1,90,0.0,90.0,90.0
97403420.0,6,181,20600,91,14438,1082260.2222222222,284.0,158.65934065934067,90,6162,1076724.9325842697,140.0,68.46666666666667
220832.0,17,2,180,1,90,0.0,90.0,90.0,1,90,0.0,90.0,90.0
71794.0,6,14,4740,7,653,11668.833333333334,249.0,93.28571428571428,7,4087,8892.333333333334,1514.0,583.8571428571429
298644.0,6,6,412,4,272,99548.0,74.0,68.0,2,140,0.0,74.0,70.0
317.0,17,2,208,1,72,0.0,72.0,72.0,1,136,0.0,136.0,136.0
108099226.0,17,5,1005,5,1005,27024806.5,201.0,201.0,0,0,0.0,0.0,0.0
216629.0,17,4,1400,4,1400,72209.66666666667,350.0,350.0,0,0,0.0,0.0,0.0
166114.0,6,3,337,2,214,0.0,160.0,107.0,1,123,0.0,123.0,123.0
1059487.0,17,6,1230,3,234,529553.0,78.0,78.0,3,996,529534.0,332.0,332.0
1741413.0,6,23,6509,12,1529,157332.0909090909,357.0,127.41666666666669,11,4980,143967.8,1510.0,452.7272727272728
206930.0,17,2,762,2,762,0.0,381.0,381.0,0,0,0.0,0.0,0.0
2841770.0,6,5,336,2,134,0.0,68.0,67.0,3,202,1420885.0,70.0,67.33333333333333
311348.0,17,4,1400,4,1400,103782.66666666669,350.0,350.0,0,0,0.0,0.0,0.0
26337.0,6,14,4740,7,653,4263.833333333333,249.0,93.28571428571428,7,4087,3911.8333333333335,1514.0,583.8571428571429
95953529.0,6,20,1730,10,1026,10638756.444444444,339.0,102.6,10,704,10638768.0,95.0,70.4
23177.0,6,14,4740,7,653,3196.0,249.0,93.28571428571428,7,4087,3728.3333333333335,1514.0,583.8571428571429
1048827.0,6,11,1134,6,558,209765.4,220.0,93.0,5,576,259519.75,304.0,115.2
120907051.0,6,31,2050,16,1102,8060470.066666666,139.0,68.875,15,948,7907647.142857143,123.0,63.2
70060.0,6,12,1320,7,789,11676.666666666666,253.0,112.71428571428572,5,531,16475.25,259.0,106.2
196859.0,17,2,180,1,90,0.0,90.0,90.0,1,90,0.0,90.0,90.0
891403.0,6,12,2717,7,742,148567.16666666666,338.0,106.0,5,1975,153949.25,1514.0,395.0
135124915.0,17,6,1206,6,1206,27024983.0,201.0,201.0,0,0,0.0,0.0,0.0
303526.0,6,6,412,4,272,101175.33333333331,74.0,68.0,2,140,0.0,74.0,70.0
2591747.0,6,2,132,1,66,0.0,66.0,66.0,1,66,0.0,66.0,66.0
40751.0,6,14,4740,7,653,6667.166666666667,249.0,93.28571428571428,7,4087,6385.333333333333,1514.0,583.8571428571429
90026300.0,17,27,12943,27,12943,3462550.0,501.0,479.3703703703704,0,0,0.0,0.0,0.0
2920743.0,6,3,1604,1,753,0.0,753.0,753.0,2,851,0.0,785.0,425.5
216527.0,17,2,180,1,90,0.0,90.0,90.0,1,90,0.0,90.0,90.0
69742.0,17,2,620,1,75,0.0,75.0,75.0,1,545,0.0,545.0,545.0
21670.0,6,2,145,2,145,0.0,91.0,72.5,0,0,0.0,0.0,0.0
441751.0,17,2,363,1,79,0.0,79.0,79.0,1,284,0.0,284.0,284.0
9518.0,17,2,571,1,86,0.0,86.0,86.0,1,485,0.0,485.0,485.0
135132149.0,17,6,1146,6,1146,27026429.8,191.0,191.0,0,0,0.0,0.0,0.0
13636.0,6,11,2098,6,590,2279.2,252.0,98.33333333333331,5,1508,3142.0,1236.0,301.6
120924457.0,6,31,2097,16,1149,8061630.466666667,123.0,71.8125,15,948,8068780.071428572,123.0,63.2
21439.0,17,2,539,1,86,0.0,86.0,86.0,1,453,0.0,453.0,453.0
143860.0,17,2,180,1,90,0.0,90.0,90.0,1,90,0.0,90.0,90.0
42667.0,6,13,1394,7,797,7111.166666666667,253.0,113.85714285714286,6,597,6884.4,259.0,99.5
53770693.0,6,8,2113,3,960,25542551.5,826.0,320.0,5,1153,12749051.75,885.0,230.6
20278.0,6,14,4740,7,653,3229.833333333333,249.0,93.28571428571428,7,4087,3101.333333333333,1514.0,583.8571428571429
315.0,17,2,174,1,79,0.0,79.0,79.0,1,95,0.0,95.0,95.0
148195.0,6,3,337,2,214,0.0,160.0,107.0,1,123,0.0,123.0,123.0
236458.0,6,3,337,2,214,0.0,160.0,107.0,1,123,0.0,123.0,123.0
235629.0,6,13,1386,7,789,39271.5,253.0,112.71428571428572,6,597,45516.2,259.0,99.5
19745.0,6,11,2098,6,590,3742.2,252.0,98.33333333333331,5,1508,4631.25,1236.0,301.6
11587.0,6,10,1067,5,536,2333.25,264.0,107.2,5,531,2436.25,259.0,106.2
108104975.0,17,5,1005,5,1005,27026243.75,201.0,201.0,0,0,0.0,0.0,0.0
91289458.0,6,30,2376,14,1101,7022232.692307692,123.0,78.64285714285714,16,1275,5420283.133333334,123.0,79.6875
77721.0,6,11,1131,6,600,15415.2,262.0,100.0,5,531,19038.75,259.0,106.2
126013250.0,17,15,907,8,475,18001892.85714286,174.0,59.375,7,432,17666834.0,174.0,61.71428571428572
118749719.0,6,33,2274,17,1125,7421831.5,123.0,66.17647058823529,16,1149,7251018.666666667,123.0,71.8125
25882.0,6,14,4740,7,653,4132.833333333333,249.0,93.28571428571428,7,4087,4132.833333333333,1514.0,583.8571428571429
241113.0,6,3,337,2,214,0.0,160.0,107.0,1,123,0.0,123.0,123.0
121211055.0,6,234,26422,117,8018,1028769.8189655172,140.0,68.52991452991454,117,18404,1040196.9827586206,284.0,157.2991452991453
114864413.0,6,48,3168,24,1584,4994104.913043479,66.0,66.0,24,1584,4984707.869565218,66.0,66.0
0.0,6,1,66,0,0,0.0,0.0,0.0,1,66,0.0,66.0,66.0
108104790.0,17,5,955,5,955,27026197.5,191.0,191.0,0,0,0.0,0.0,0.0
146157.0,6,3,337,2,214,0.0,160.0,107.0,1,123,0.0,123.0,123.0
27800.0,6,14,4740,7,653,4352.5,249.0,93.28571428571428,7,4087,4496.5,1514.0,583.8571428571429
153552.0,17,2,180,1,90,0.0,90.0,90.0,1,90,0.0,90.0,90.0
113165259.0,6,225,25282,113,7680,1010404.0982142856,140.0,67.96460176991151,112,17602,1010149.9549549548,284.0,157.16071428571428
34007.0,6,10,2032,5,524,7426.5,252.0,104.8,5,1508,8223.75,1236.0,301.6
24438.0,6,10,2032,5,524,5379.25,252.0,104.8,5,1508,5806.0,1236.0,301.6
46859.0,6,13,1479,7,882,7791.833333333333,291.0,126.0,6,597,8182.2,259.0,99.5
99079396.0,17,14,1126,7,563,16500137.666666666,174.0,80.42857142857143,7,563,16500720.5,174.0,80.42857142857143
143941.0,17,2,180,1,90,0.0,90.0,90.0,1,90,0.0,90.0,90.0
368.0,17,2,160,1,80,0.0,80.0,80.0,1,80,0.0,80.0,80.0
20854.0,6,20,7606,11,978,2085.4,310.0,88.9090909090909,9,6628,2303.125,1514.0,736.4444444444445
3054607.0,6,3,204,2,136,0.0,70.0,68.0,1,68,0.0,68.0,68.0
2354.0,17,4,344,2,150,0.0,75.0,75.0,2,194,0.0,103.0,97.0
163386.0,6,10,1102,5,570,40559.25,298.0,114.0,5,532,40498.25,260.0,106.4
2375.0,17,4,344,2,150,0.0,75.0,75.0,2,194,0.0,103.0,97.0
135134848.0,17,6,1206,6,1206,27026969.6,201.0,201.0,0,0,0.0,0.0,0.0
15931.0,6,14,4740,7,653,2505.1666666666665,249.0,93.28571428571428,7,4087,2518.6666666666665,1514.0,583.8571428571429
106932.0,17,2,286,2,286,0.0,143.0,143.0,0,0,0.0,0.0,0.0
97653746.0,6,26,1746,13,906,8119812.916666667,123.0,69.6923076923077,13,840,8119812.666666667,123.0,64.61538461538461
218449.0,6,3,426,2,280,0.0,214.0,140.0,1,146,0.0,146.0,146.0
318808.0,6,6,412,4,272,106269.33333333331,74.0,68.0,2,140,0.0,74.0,70.0
38562.0,6,14,4740,7,653,6222.666666666667,249.0,93.28571428571428,7,4087,4120.666666666667,1514.0,583.8571428571429
2794081.0,6,2,132,1,66,0.0,66.0,66.0,1,66,0.0,66.0,66.0
11794.0,17,4,823,2,163,0.0,89.0,81.5,2,660,0.0,443.0,330.0
311822.0,6,3,202,2,128,0.0,74.0,64.0,1,74,0.0,74.0,74.0
90284987.0,6,12,1832,8,1016,12897855.285714284,188.0,127.0,4,816,30041021.33333333,204.0,204.0
250406.00000000003,6,3,373,2,238,0.0,172.0,119.0,1,135,0.0,135.0,135.0
13988.0,6,14,4740,7,653,2161.833333333333,249.0,93.28571428571428,7,4087,2207.5,1514.0,583.8571428571429
2554127.0,6,25,7573,14,3735,196471.3076923077,1514.0,266.7857142857143,11,3838,230606.6,1514.0,348.90909090909093
2047.0,17,4,344,2,150,0.0,75.0,75.0,2,194,0.0,103.0,97.0
126004983.0,17,15,907,8,475,18000711.85714286,174.0,59.375,7,432,17666827.5,174.0,61.71428571428572
42272.0,6,14,4740,7,653,6924.5,249.0,93.28571428571428,7,4087,6794.166666666667,1514.0,583.8571428571429
2925.0,17,2,224,1,76,0.0,76.0,76.0,1,148,0.0,148.0,148.0
220479.0,6,10,1221,6,636,44095.8,298.0,106.0,4,585,71862.66666666667,379.0,146.25
2777111.0,6,2,132,1,66,0.0,66.0,66.0,1,66,0.0,66.0,66.0
994.0,17,2,762,2,762,0.0,381.0,381.0,0,0,0.0,0.0,0.0
9595.0,17,2,571,1,86,0.0,86.0,86.0,1,485,0.0,485.0,485.0
90017789.0,17,28,13364,28,13364,3333992.185185185,501.0,477.2857142857143,0,0,0.0,0.0,0.0
90014801.0,17,28,13364,28,13364,3333881.5185185187,501.0,477.2857142857143,0,0,0.0,0.0,0.0
112168001.0,6,32,2220,16,1149,7463476.4,123.0,71.8125,16,1071,7463476.466666667,123.0,66.9375
110795759.0,6,31,2182,16,1165,7386383.933333334,139.0,72.8125,15,1017,7185189.428571428,123.0,67.8
13627.0,6,2,132,1,66,0.0,66.0,66.0,1,66,0.0,66.0,66.0
315944.0,6,6,412,4,272,105314.66666666669,74.0,68.0,2,140,0.0,74.0,70.0
2528.0,17,4,344,2,150,0.0,75.0,75.0,2,194,0.0,103.0,97.0
204767.0,17,2,762,2,762,0.0,381.0,381.0,0,0,0.0,0.0,0.0
49230.0,6,13,1386,7,789,8205.0,253.0,112.71428571428572,6,597,6601.4,259.0,99.5
265718.0,6,10,1221,6,636,53143.6,298.0,106.0,4,585,81961.33333333333,379.0,146.25
537774.0,17,6,2100,6,2100,107554.8,350.0,350.0,0,0,0.0,0.0,0.0
38930.0,6,14,4740,7,653,5735.666666666667,249.0,93.28571428571428,7,4087,5961.166666666667,1514.0,583.8571428571429
50230.0,6,14,4740,7,653,8253.333333333334,249.0,93.28571428571428,7,4087,7351.0,1514.0,583.8571428571429
108111954.0,17,5,955,5,955,27027988.5,191.0,191.0,0,0,0.0,0.0,0.0
3170777.0,6,18,1495,9,921,358298.125,315.0,102.33333333333331,9,574,358277.375,78.0,63.77777777777778
245228.0,6,3,337,2,214,0.0,160.0,107.0,1,123,0.0,123.0,123.0
54717.0,6,14,4740,7,653,4378.833333333333,249.0,93.28571428571428,7,4087,8984.333333333334,1514.0,583.8571428571429
54329.0,6,14,4740,7,653,8042.833333333333,249.0,93.28571428571428,7,4087,8896.333333333334,1514.0,583.8571428571429
5828596.0,6,4,270,2,134,0.0,68.0,67.0,2,136,0.0,70.0,68.0
29602.0,6,10,2032,5,524,5955.0,252.0,104.8,5,1508,6463.25,1236.0,301.6
4290.0,17,2,614,1,72,0.0,72.0,72.0,1,542,0.0,542.0,542.0
90523209.0,6,15,2444,8,1016,12931887.0,188.0,127.0,7,1428,15060016.5,204.0,204.0
108244537.0,17,14,864,7,432,18000165.333333332,174.0,61.71428571428572,7,432,18001244.5,174.0,61.71428571428572
120000006.0,6,25,1924,14,1084,9230769.692307692,95.0,77.42857142857143,11,840,9002354.8,95.0,76.36363636363636
6484272.0,17,8,720,4,360,2066703.6666666667,90.0,90.0,4,360,2099576.0,90.0,90.0
147803.0,6,3,373,2,238,0.0,172.0,119.0,1,135,0.0,135.0,135.0
51360.0,6,12,1320,6,723,8194.8,253.0,120.5,6,597,9626.0,259.0,99.5
216445.0,17,2,180,1,90,0.0,90.0,90.0,1,90,0.0,90.0,90.0
153459.0,17,2,180,1,90,0.0,90.0,90.0,1,90,0.0,90.0,90.0
40811931.0,6,26,7627,14,3735,190099.15384615384,1514.0,266.7857142857143,12,3892,3690516.1818181816,1514.0,324.3333333333333
284.0,17,2,168,1,76,0.0,76.0,76.0,1,92,0.0,92.0,92.0
90257414.0,6,13,2036,8,1016,12893916.285714284,188.0,127.0,5,1020,22523059.5,204.0,204.0
92962778.0,6,30,2317,13,1030,7746898.166666667,95.0,79.23076923076923,17,1287,5794604.375,95.0,75.70588235294117
298.0,17,2,156,1,78,0.0,78.0,78.0,1,78,0.0,78.0,78.0
6927.0,17,2,582,1,83,0.0,83.0,83.0,1,499,0.0,499.0,499.0
120001304.0,17,15,907,8,475,17143043.42857143,174.0,59.375,7,432,16667944.5,174.0,61.71428571428572
1055290.0,6,11,1131,6,600,210852.4,262.0,100.0,5,531,263608.5,259.0,106.2
110135083.0,6,29,2068,15,1105,7851381.857142857,139.0,73.66666666666667,14,963,8455181.923076924,123.0,68.78571428571429
75066961.0,6,9,842,9,842,9383370.125,97.0,93.55555555555556,0,0,0.0,0.0,0.0
298278.0,6,6,412,4,272,99426.0,74.0,68.0,2,140,0.0,74.0,70.0
306894.0,6,3,202,2,128,0.0,74.0,64.0,1,74,0.0,74.0,74.0
26485.0,6,10,2032,5,524,6419.75,252.0,104.8,5,1508,6144.0,1236.0,301.6
156808.0,17,2,180,1,90,0.0,90.0,90.0,1,90,0.0,90.0,90.0
63936.00000000001,6,14,4740,7,653,10508.333333333334,249.0,93.28571428571428,7,4087,9946.666666666666,1514.0,583.8571428571429
107441.0,17,2,286,2,286,0.0,143.0,143.0,0,0,0.0,0.0,0.0
148070.0,17,2,180,1,90,0.0,90.0,90.0,1,90,0.0,90.0,90.0
21438.0,6,14,4740,7,653,3464.6666666666665,249.0,93.28571428571428,7,4087,3439.5,1514.0,583.8571428571429
135119609.0,17,6,1146,6,1146,27023921.8,191.0,191.0,0,0,0.0,0.0,0.0
25237.0,6,14,4740,7,653,3504.5,249.0,93.28571428571428,7,4087,4047.8333333333335,1514.0,583.8571428571429
90942475.0,6,26,2019,15,1179,6495891.071428572,95.0,78.6,11,840,9045805.5,95.0,76.36363636363636
300910.0,6,6,412,4,272,100303.33333333331,74.0,68.0,2,140,0.0,74.0,70.0
10511726.0,6,7,478,4,272,3458456.0,74.0,68.0,3,206,5187583.0,74.0,68.66666666666667
2333.0,17,4,344,2,150,0.0,75.0,75.0,2,194,0.0,103.0,97.0
10525770.0,6,7,478,4,272,3463079.333333333,74.0,68.0,3,206,5194512.5,74.0,68.66666666666667
873940.0,6,9,1267,6,796,174788.0,458.0,132.66666666666666,3,471,299366.0,331.0,157.0
249066.0,6,3,337,2,214,0.0,160.0,107.0,1,123,0.0,123.0,123.0
26922.0,6,14,4740,7,653,4358.666666666667,249.0,93.28571428571428,7,4087,4313.333333333333,1514.0,583.8571428571429
99972.0,17,2,762,2,762,0.0,381.0,381.0,0,0,0.0,0.0,0.0
111015371.0,6,35,2542,18,1348,6517617.411764706,139.0,74.88888888888889,17,1194,6924964.0625,123.0,70.23529411764706
90534469.0,6,14,2240,8,1016,12933495.57142857,188.0,127.0,6,1224,18073343.2,204.0,204.0
106375469.0,6,43,2838,22,1452,5050854.761904762,66.0,66.0,21,1386,5150440.05,66.0,66.0
25187674.0,17,3,1034,2,684,0.0,342.0,342.0,1,350,0.0,350.0,350.0
1538.0,6,2,177,1,123,0.0,123.0,123.0,1,54,0.0,54.0,54.0
47244.0,6,14,4740,7,653,6873.666666666667,249.0,93.28571428571428,7,4087,7698.166666666667,1514.0,583.8571428571429
838782.0,6,9,1196,6,725,167756.4,387.0,120.83333333333331,3,471,283088.0,331.0,157.0
529244.0,6,3,204,2,136,0.0,70.0,68.0,1,68,0.0,68.0,68.0
119527639.0,6,217,24362,109,7490,1106737.398148148,140.0,68.71559633027523,108,16872,1114954.7570093458,284.0,156.22222222222223
141641.0,6,2,132,1,66,0.0,66.0,66.0,1,66,0.0,66.0,66.0
504267.0,6,5,336,2,134,0.0,68.0,67.0,3,202,192496.0,70.0,67.33333333333333
146211.0,6,3,337,2,214,0.0,160.0,107.0,1,123,0.0,123.0,123.0
35552.0,6,14,4740,7,653,4964.666666666667,249.0,93.28571428571428,7,4087,5385.5,1514.0,583.8571428571429
91419145.0,6,22,1680,12,935,8310156.363636363,95.0,77.91666666666667,10,745,10157017.222222222,95.0,74.5
1351906.0,17,16,1120,16,1120,90127.06666666668,70.0,70.0,0,0,0.0,0.0,0.0
135136928.0,17,6,1206,6,1206,27027385.6,201.0,201.0,0,0,0.0,0.0,0.0
216417.0,17,2,180,1,90,0.0,90.0,90.0,1,90,0.0,90.0,90.0
257040.0,6,3,337,2,214,0.0,160.0,107.0,1,123,0.0,123.0,123.0
2251.0,17,4,344,2,150,0.0,75.0,75.0,2,194,0.0,103.0,97.0
103030.0,17,2,286,2,286,0.0,143.0,143.0,0,0,0.0,0.0,0.0
413.0,17,2,410,1,78,0.0,78.0,78.0,1,332,0.0,332.0,332.0
107838896.0,6,28,1860,14,966,8295299.692307692,123.0,69.0,14,894,8278664.153846154,123.0,63.85714285714285
334.0,17,2,166,1,75,0.0,75.0,75.0,1,91,0.0,91.0,91.0
50886.0,17,2,180,1,90,0.0,90.0,90.0,1,90,0.0,90.0,90.0
2320.0,17,4,344,2,150,0.0,75.0,75.0,2,194,0.0,103.0,97.0
171537.0,17,2,180,1,90,0.0,90.0,90.0,1,90,0.0,90.0,90.0
216401.0,17,2,180,1,90,0.0,90.0,90.0,1,90,0.0,90.0,90.0
301.0,17,2,164,1,82,0.0,82.0,82.0,1,82,0.0,82.0,82.0
2398.0,17,4,344,2,150,0.0,75.0,75.0,2,194,0.0,103.0,97.0
130001091.0,17,15,907,8,475,18571584.42857143,174.0,59.375,7,432,18334185.0,174.0,61.71428571428572
299229.0,6,6,412,4,272,99743.0,74.0,68.0,2,140,0.0,74.0,70.0
90034404.0,17,28,13364,28,13364,3334607.5555555555,501.0,477.2857142857143,0,0,0.0,0.0,0.0
9578.0,6,10,1975,5,467,2188.75,195.0,93.4,5,1508,1710.75,1236.0,301.6
105494584.0,17,14,864,7,432,17555767.666666668,174.0,61.71428571428572,7,432,17515221.166666668,174.0,61.71428571428572
308439.0,17,4,571,2,148,0.0,74.0,74.0,2,423,0.0,280.0,211.5
267646.0,6,10,1221,6,636,53529.2,298.0,106.0,4,585,83465.66666666667,379.0,146.25
207279.0,6,3,426,2,280,0.0,214.0,140.0,1,146,0.0,146.0,146.0
120053500.0,6,468,87298,234,71336,514366.8154506438,1514.0,304.85470085470087,234,15962,514280.3261802575,214.0,68.21367521367522
228223.0,17,2,180,1,90,0.0,90.0,90.0,1,90,0.0,90.0,90.0
2174089.0,6,25,7610,13,2516,180596.66666666663,1034.0,193.53846153846155,12,5094,169243.0,1510.0,424.5
1023874.0,6,12,1362,6,731,203984.8,253.0,121.83333333333331,6,631,204463.2,293.0,105.16666666666669
890707.0,6,10,1333,6,796,178141.4,458.0,132.66666666666666,4,537,205033.0,331.0,134.25
113610477.0,6,46,3036,23,1518,5150442.863636363,66.0,66.0,23,1518,5150442.7727272725,66.0,66.0
205323.0,17,2,762,2,762,0.0,381.0,381.0,0,0,0.0,0.0,0.0
76678.0,6,13,1479,7,882,12341.333333333334,291.0,126.0,6,597,14456.8,259.0,99.5
216346.0,17,2,180,1,90,0.0,90.0,90.0,1,90,0.0,90.0,90.0
14642420.0,6,19,1553,9,921,1791487.625,315.0,102.33333333333331,10,632,1592336.4444444445,78.0,63.2
515980.0,6,5,336,2,134,0.0,68.0,67.0,3,202,195993.0,70.0,67.33333333333333
104684.0,17,2,286,2,286,0.0,143.0,143.0,0,0,0.0,0.0,0.0
284611.0,17,2,363,1,79,0.0,79.0,79.0,1,284,0.0,284.0,284.0
44579.0,6,14,4740,7,653,7240.833333333333,249.0,93.28571428571428,7,4087,7189.333333333333,1514.0,583.8571428571429
120130705.0,6,14,2224,9,1204,15016338.125,188.0,133.77777777777777,5,1020,22523213.0,204.0,204.0
69349.0,17,2,614,1,72,0.0,72.0,72.0,1,542,0.0,542.0,542.0
9462.0,17,2,582,1,83,0.0,83.0,83.0,1,499,0.0,499.0,499.0
135128324.0,17,6,1206,6,1206,27025664.8,201.0,201.0,0,0,0.0,0.0,0.0
103381.0,17,2,286,2,286,0.0,143.0,143.0,0,0,0.0,0.0,0.0
58744382.0,17,9,3086,8,2736,5107466.285714285,342.0,342.0,1,350,0.0,350.0,350.0
1302520.0,6,4,264,2,132,0.0,66.0,66.0,2,132,0.0,66.0,66.0
75093183.0,6,9,842,9,842,9386647.875,97.0,93.55555555555556,0,0,0.0,0.0,0.0
117408099.0,6,216,24514,108,17090,1095260.1495327102,284.0,158.24074074074073,108,7424,1095258.0560747664,140.0,68.74074074074075
243951.0,6,3,337,2,214,0.0,160.0,107.0,1,123,0.0,123.0,123.0
26366.0,6,10,2032,5,524,6092.5,252.0,104.8,5,1508,6181.0,1236.0,301.6
216606.0,6,3,426,2,280,0.0,214.0,140.0,1,146,0.0,146.0,146.0
121297.0,6,3,337,2,214,0.0,160.0,107.0,1,123,0.0,123.0,123.0
216403.0,6,3,426,2,280,0.0,214.0,140.0,1,146,0.0,146.0,146.0
207670.0,6,10,1221,6,636,41534.0,298.0,106.0,4,585,68075.66666666667,379.0,146.25
134209.0,6,14,4740,7,653,16635.833333333332,249.0,93.28571428571428,7,4087,16598.5,1514.0,583.8571428571429
1622645.0,6,20,6434,12,1921,147513.18181818182,620.0,160.08333333333334,8,4513,188141.7142857143,1514.0,564.125
341458.0,6,10,1221,6,636,68291.6,298.0,106.0,4,585,108397.66666666669,379.0,146.25
102232.0,17,2,286,2,286,0.0,143.0,143.0,0,0,0.0,0.0,0.0
294251.0,6,6,412,4,272,98083.66666666669,74.0,68.0,2,140,0.0,74.0,70.0
315686.0,17,4,1400,4,1400,105228.66666666669,350.0,350.0,0,0,0.0,0.0,0.0
103527715.0,6,43,2838,22,1452,4919610.619047619,66.0,66.0,21,1386,5105436.25,66.0,66.0
1164985.0,6,13,3010,8,2382,166426.42857142858,1514.0,297.75,5,628,222328.5,331.0,125.6
310001.0,17,4,1400,4,1400,103333.66666666669,350.0,350.0,0,0,0.0,0.0,0.0
106900.0,17,2,286,2,286,0.0,143.0,143.0,0,0,0.0,0.0,0.0
116001299.0,17,13,821,7,432,19333549.83333333,174.0,61.71428571428572,6,389,19201444.4,174.0,64.83333333333333
2243.0,17,2,180,1,90,0.0,90.0,90.0,1,90,0.0,90.0,90.0
140446.0,6,2,132,1,66,0.0,66.0,66.0,1,66,0.0,66.0,66.0
3725.0,17,4,344,2,150,0.0,75.0,75.0,2,194,0.0,103.0,97.0
311479.0,17,4,1400,4,1400,103826.33333333331,350.0,350.0,0,0,0.0,0.0,0.0
108098282.0,17,5,955,5,955,27024570.5,191.0,191.0,0,0,0.0,0.0,0.0
90923161.0,6,21,1585,11,840,9092148.7,95.0,76.36363636363636,10,745,10101192.111111112,95.0,74.5
90044865.0,17,28,13364,28,13364,3334995.0,501.0,477.2857142857143,0,0,0.0,0.0,0.0
120200540.0,6,202,22886,101,6888,1195018.39,140.0,68.1980198019802,101,15998,1193870.05,284.0,158.3960396039604
123839683.0,6,48,3168,24,1584,5097176.608695652,66.0,66.0,24,1584,5204789.217391305,66.0,66.0
308262.0,17,4,1400,4,1400,102754.0,350.0,350.0,0,0,0.0,0.0,0.0
10517308.0,6,7,478,4,272,3460417.6666666665,74.0,68.0,3,206,5190502.5,74.0,68.66666666666667
46688.0,6,14,4740,7,653,6719.166666666667,249.0,93.28571428571428,7,4087,7640.666666666667,1514.0,583.8571428571429
3299.0,17,4,344,2,150,0.0,75.0,75.0,2,194,0.0,103.0,97.0
1168412.0,6,13,3016,8,2388,166916.0,1514.0,298.5,5,628,223213.0,331.0,125.6
13840.0,17,4,344,2,150,0.0,75.0,75.0,2,194,0.0,103.0,97.0
11042.0,6,13,1459,7,862,1727.6666666666667,271.0,123.14285714285714,6,597,2049.6,259.0,99.5
219269.0,6,3,426,2,280,0.0,214.0,140.0,1,146,0.0,146.0,146.0
110431027.0,6,30,2122,15,1017,7887930.5,123.0,67.8,15,1105,7160135.928571428,139.0,73.66666666666667
70849.0,6,14,4740,7,653,11577.333333333334,249.0,93.28571428571428,7,4087,10997.833333333334,1514.0,583.8571428571429
1198729.0,6,13,3010,8,2382,171247.0,1514.0,297.75,5,628,230754.25,331.0,125.6
232520.0,6,3,337,2,214,0.0,160.0,107.0,1,123,0.0,123.0,123.0
90214676.0,6,16,1192,8,596,12851558.857142856,95.0,74.5,8,596,12856897.714285716,95.0,74.5
1940.0,17,2,180,1,90,0.0,90.0,90.0,1,90,0.0,90.0,90.0
120109000.0,6,17,2572,8,1368,17158428.57142857,204.0,171.0,9,1204,14993144.625,188.0,133.77777777777777
22485.0,6,10,2032,5,524,4725.0,252.0,104.8,5,1508,5269.5,1236.0,301.6
62658.00000000001,6,14,4740,7,653,9842.333333333334,249.0,93.28571428571428,7,4087,10298.833333333334,1514.0,583.8571428571429
297815.0,6,6,412,4,272,99271.66666666669,74.0,68.0,2,140,0.0,74.0,70.0
104780.0,17,2,700,2,700,0.0,350.0,350.0,0,0,0.0,0.0,0.0
228606.0,17,2,180,1,90,0.0,90.0,90.0,1,90,0.0,90.0,90.0
47076.0,6,13,1479,7,882,7634.0,291.0,126.0,6,597,8355.2,259.0,99.5
108107129.0,17,5,955,5,955,27026782.25,191.0,191.0,0,0,0.0,0.0,0.0
90836329.0,6,20,1547,10,843,10068923.888888888,156.0,84.3,10,704,10068919.666666666,95.0,70.4
221855.0,6,3,426,2,280,0.0,214.0,140.0,1,146,0.0,146.0,146.0
2368.0,17,4,344,2,150,0.0,75.0,75.0,2,194,0.0,103.0,97.0
17086.0,17,2,180,1,90,0.0,90.0,90.0,1,90,0.0,90.0,90.0
90012365.0,17,28,13364,28,13364,3333791.296296296,501.0,477.2857142857143,0,0,0.0,0.0,0.0
119824.0,17,2,180,1,70,0.0,70.0,70.0,1,110,0.0,110.0,110.0
56482.0,6,10,2032,5,524,13888.75,252.0,104.8,5,1508,13031.25,1236.0,301.6
124728282.0,17,15,1169,7,563,17563585.5,174.0,80.42857142857143,8,606,17795451.285714287,174.0,75.75
108108118.0,17,5,1005,5,1005,27027029.5,201.0,201.0,0,0,0.0,0.0,0.0
102847.0,17,2,286,2,286,0.0,143.0,143.0,0,0,0.0,0.0,0.0
120006231.0,6,17,1287,9,691,15000778.875,95.0,76.77777777777777,8,596,12859335.142857144,95.0,74.5
0.0,6,1,54,0,0,0.0,0.0,0.0,1,54,0.0,54.0,54.0
2793746.0,6,2,132,1,66,0.0,66.0,66.0,1,66,0.0,66.0,66.0
108123535.0,17,5,955,5,955,27030883.75,191.0,191.0,0,0,0.0,0.0,0.0
28618.0,6,11,2098,6,590,4479.6,252.0,98.33333333333331,5,1508,6921.0,1236.0,301.6
261861.0,6,3,337,2,214,0.0,160.0,107.0,1,123,0.0,123.0,123.0
105238150.0,17,15,5130,15,5130,7517010.714285715,342.0,342.0,0,0,0.0,0.0,0.0
298181.0,6,6,412,4,272,99393.66666666669,74.0,68.0,2,140,0.0,74.0,70.0
2330.0,17,4,344,2,150,0.0,75.0,75.0,2,194,0.0,103.0,97.0
97280551.0,17,12,778,6,389,19456110.2,174.0,64.83333333333333,6,389,19406907.2,174.0,64.83333333333333
1388531.0,17,16,1120,16,1120,92568.73333333334,70.0,70.0,0,0,0.0,0.0,0.0
106242615.0,6,29,2046,15,1017,7588758.214285715,123.0,67.8,14,1029,7564353.307692308,123.0,73.5
90057239.0,17,28,13364,28,13364,3335453.296296296,501.0,477.2857142857143,0,0,0.0,0.0,0.0
249522.0,6,3,337,2,214,0.0,160.0,107.0,1,123,0.0,123.0,123.0
481592.0,17,2,363,1,79,0.0,79.0,79.0,1,284,0.0,284.0,284.0
135130792.0,17,6,1146,6,1146,27026158.4,191.0,191.0,0,0,0.0,0.0,0.0
2020.0,17,4,344,2,150,0.0,75.0,75.0,2,194,0.0,103.0,97.0
34550682.0,6,29,11312,14,1822,2657744.769230769,408.0,130.14285714285714,15,9490,2235403.5,1514.0,632.6666666666666
2147.0,17,2,664,1,322,0.0,322.0,322.0,1,342,0.0,342.0,342.0
149800468.0,17,36,17126,36,17126,4280013.371428572,501.0,475.72222222222223,0,0,0.0,0.0,0.0
8410798.0,17,3,1034,2,684,0.0,342.0,342.0,1,350,0.0,350.0,350.0
124854299.0,17,14,995,7,563,17506403.5,174.0,80.42857142857143,7,432,17501779.666666668,174.0,61.71428571428572
871.0,17,2,762,2,762,0.0,381.0,381.0,0,0,0.0,0.0,0.0
14630411.0,6,20,1607,10,975,1592461.6666666667,315.0,97.5,10,632,1592432.7777777778,78.0,63.2
8967.0,17,2,498,1,80,0.0,80.0,80.0,1,418,0.0,418.0,418.0
40873.0,6,10,2032,5,524,9992.75,252.0,104.8,5,1508,9868.25,1236.0,301.6
25709.0,6,11,2098,6,590,4750.8,252.0,98.33333333333331,5,1508,4157.5,1236.0,301.6
90261989.0,6,13,2036,8,1016,12894569.857142856,188.0,127.0,5,1020,22524556.75,204.0,204.0
302534.0,6,6,412,4,272,100844.66666666669,74.0,68.0,2,140,0.0,74.0,70.0
146216.0,6,3,337,2,214,0.0,160.0,107.0,1,123,0.0,123.0,123.0
140.0,17,2,700,2,700,0.0,350.0,350.0,0,0,0.0,0.0,0.0
300577.0,6,6,412,4,272,100192.33333333331,74.0,68.0,2,140,0.0,74.0,70.0
891637.0,6,10,1162,6,625,178327.4,287.0,104.16666666666669,4,537,205217.0,331.0,134.25
135127458.0,17,6,1206,6,1206,27025491.6,201.0,201.0,0,0,0.0,0.0,0.0
120061955.0,17,29,13785,29,13785,4287926.964285715,501.0,475.3448275862069,0,0,0.0,0.0,0.0
4271.0,17,4,344,2,150,0.0,75.0,75.0,2,194,0.0,103.0,97.0
10481970.0,6,7,478,4,272,3448263.333333333,74.0,68.0,3,206,5172311.5,74.0,68.66666666666667
279716.0,17,2,180,1,90,0.0,90.0,90.0,1,90,0.0,90.0,90.0
306871.0,6,6,412,4,272,102290.33333333331,74.0,68.0,2,140,0.0,74.0,70.0
55458.0,6,14,4740,7,653,9059.5,249.0,93.28571428571428,7,4087,8908.5,1514.0,583.8571428571429
303992.0,6,6,412,4,272,101330.66666666669,74.0,68.0,2,140,0.0,74.0,70.0
96312516.0,6,39,2574,20,1320,5053099.842105263,66.0,66.0,19,1254,5150434.833333333,66.0,66.0
125822988.0,6,59,12385,29,6496,3432374.1428571427,1514.0,224.0,30,5889,4331630.827586207,1514.0,196.3
108348110.0,6,44,2904,22,1452,5159433.80952381,66.0,66.0,22,1452,5144679.380952381,66.0,66.0
21968524.0,6,47,16131,26,11147,170909.16,1514.0,428.7307692307692,21,4984,1088138.35,1514.0,237.3333333333333
202730.0,17,4,6056,4,6056,67576.66666666667,1514.0,1514.0,0,0,0.0,0.0,0.0
101094433.0,17,13,821,7,432,16849072.166666668,174.0,61.71428571428572,6,389,16222526.4,174.0,64.83333333333333
90307550.0,6,21,1585,11,840,9025657.2,95.0,76.36363636363636,10,745,10002926.444444444,95.0,74.5
197190.0,17,2,180,1,90,0.0,90.0,90.0,1,90,0.0,90.0,90.0
74661.0,6,10,2032,5,524,18037.25,252.0,104.8,5,1508,17403.75,1236.0,301.6
96131977.0,6,61,12558,30,6614,3314895.7586206896,1514.0,220.46666666666667,31,5944,3195552.066666667,1514.0,191.7419354838709
302158.0,6,6,412,4,272,100719.33333333331,74.0,68.0,2,140,0.0,74.0,70.0
90286237.0,6,16,1192,8,596,12890825.714285716,95.0,74.5,8,596,12897688.142857144,95.0,74.5
9181.0,6,10,2032,5,524,2050.5,252.0,104.8,5,1508,2006.5,1236.0,301.6
190909.0,17,2,180,1,90,0.0,90.0,90.0,1,90,0.0,90.0,90.0
36781.0,6,14,4740,7,653,5277.166666666667,249.0,93.28571428571428,7,4087,5981.333333333333,1514.0,583.8571428571429
120123427.0,6,14,2240,6,1224,24024685.4,204.0,204.0,8,1016,17136935.714285713,188.0,127.0
109121.0,17,2,762,2,762,0.0,381.0,381.0,0,0,0.0,0.0,0.0
5646291.0,6,4,270,2,134,0.0,68.0,67.0,2,136,0.0,70.0,68.0
209543.0,17,2,180,1,90,0.0,90.0,90.0,1,90,0.0,90.0,90.0
108105443.0,17,5,1005,5,1005,27026360.75,201.0,201.0,0,0,0.0,0.0,0.0
1314618.0,6,4,264,2,132,0.0,66.0,66.0,2,132,0.0,66.0,66.0
100747906.0,17,14,864,7,432,16764696.5,174.0,61.71428571428572,7,432,16790757.833333332,174.0,61.71428571428572
21809.0,17,2,180,1,90,0.0,90.0,90.0,1,90,0.0,90.0,90.0
384.0,17,2,410,1,78,0.0,78.0,78.0,1,332,0.0,332.0,332.0
171860.0,17,2,180,1,90,0.0,90.0,90.0,1,90,0.0,90.0,90.0
69102.0,17,2,620,1,75,0.0,75.0,75.0,1,545,0.0,545.0,545.0
218043.0,6,3,426,2,280,0.0,214.0,140.0,1,146,0.0,146.0,146.0
179792.0,17,2,180,1,90,0.0,90.0,90.0,1,90,0.0,90.0,90.0
31603.0,6,11,2098,6,590,6058.2,252.0,98.33333333333331,5,1508,7565.25,1236.0,301.6
69845.0,6,14,4740,7,653,11520.5,249.0,93.28571428571428,7,4087,8811.166666666666,1514.0,583.8571428571429
120120568.0,6,13,2020,9,1204,15015071.0,188.0,133.77777777777777,4,816,30029374.666666668,204.0,204.0
37629.0,6,2,132,1,66,0.0,66.0,66.0,1,66,0.0,66.0,66.0
24701.0,17,2,180,1,90,0.0,90.0,90.0,1,90,0.0,90.0,90.0
157349.0,6,3,337,2,214,0.0,160.0,107.0,1,123,0.0,123.0,123.0
203226.0,17,2,180,1,90,0.0,90.0,90.0,1,90,0.0,90.0,90.0
2138664.0,6,24,7544,12,2450,194424.0,1034.0,204.16666666666663,12,5094,166713.0909090909,1510.0,424.5
120024863.0,17,29,13785,29,13785,4286602.25,501.0,475.3448275862069,0,0,0.0,0.0,0.0
153476.0,17,2,180,1,90,0.0,90.0,90.0,1,90,0.0,90.0,90.0
1284122.0,17,7,490,7,490,214020.3333333333,70.0,70.0,0,0,0.0,0.0,0.0
314830.0,6,6,412,4,272,104943.33333333331,74.0,68.0,2,140,0.0,74.0,70.0
328471.0,6,6,412,4,272,109490.33333333331,74.0,68.0,2,140,0.0,74.0,70.0
298781.0,6,2,138,1,68,0.0,68.0,68.0,1,70,0.0,70.0,70.0
320.0,17,2,174,1,79,0.0,79.0,79.0,1,95,0.0,95.0,95.0
108104667.0,17,5,955,5,955,27026166.75,191.0,191.0,0,0,0.0,0.0,0.0
14646740.0,6,20,1607,10,975,1592899.7777777778,315.0,97.5,10,632,1592862.888888889,78.0,63.2
79794.0,6,2,134,1,68,0.0,68.0,68.0,1,66,0.0,66.0,66.0
228211.0,17,2,180,1,90,0.0,90.0,90.0,1,90,0.0,90.0,90.0
107228.0,17,2,700,2,700,0.0,350.0,350.0,0,0,0.0,0.0,0.0
228386.0,17,2,180,1,90,0.0,90.0,90.0,1,90,0.0,90.0,90.0
2591008.0,6,2,132,1,66,0.0,66.0,66.0,1,66,0.0,66.0,66.0
21560342.0,6,6,1981,4,1087,7186780.666666667,885.0,271.75,2,894,0.0,826.0,447.0
116001132.0,17,15,1169,8,606,16571590.285714284,174.0,75.75,7,563,16000776.5,174.0,80.42857142857143
124001207.0,17,15,907,8,475,17714458.14285714,174.0,59.375,7,432,17334305.0,174.0,61.71428571428572
15047345.0,17,6,2718,6,2718,3009469.0,453.0,453.0,0,0,0.0,0.0,0.0
106712.0,17,2,700,2,700,0.0,350.0,350.0,0,0,0.0,0.0,0.0
2873.0,17,2,224,1,76,0.0,76.0,76.0,1,148,0.0,148.0,148.0
14632853.0,6,20,1648,10,1016,1592499.4444444445,315.0,101.6,10,632,1592238.2222222222,78.0,63.2
146228.0,6,3,337,2,214,0.0,160.0,107.0,1,123,0.0,123.0,123.0
471.0,17,2,174,1,79,0.0,79.0,79.0,1,95,0.0,95.0,95.0
39590.0,6,14,4740,7,653,6186.0,249.0,93.28571428571428,7,4087,6466.666666666667,1514.0,583.8571428571429
18688.0,6,14,4740,7,653,2792.1666666666665,249.0,93.28571428571428,7,4087,2935.0,1514.0,583.8571428571429
299249.0,17,2,224,1,76,0.0,76.0,76.0,1,148,0.0,148.0,148.0
90305885.0,6,16,1192,8,596,12893143.57142857,95.0,74.5,8,596,12899580.142857144,95.0,74.5
92993828.0,6,162,18334,81,12840,1159730.0,284.0,158.5185185185185,81,5494,1159733.6625,140.0,67.82716049382717
100365505.0,17,12,516,6,258,20000780.2,43.0,43.0,6,258,20000172.0,43.0,43.0
233881.0,6,3,373,2,238,0.0,172.0,119.0,1,135,0.0,135.0,135.0
509980.0,6,5,336,2,134,0.0,68.0,67.0,3,202,192217.0,70.0,67.33333333333333
29708.0,6,14,4740,7,653,4593.166666666667,249.0,93.28571428571428,7,4087,4198.0,1514.0,583.8571428571429
95867.0,6,2,132,1,66,0.0,66.0,66.0,1,66,0.0,66.0,66.0
1302547.0,6,4,264,2,132,0.0,66.0,66.0,2,132,0.0,66.0,66.0
205725.0,17,2,180,1,90,0.0,90.0,90.0,1,90,0.0,90.0,90.0
348.0,17,2,214,1,75,0.0,75.0,75.0,1,139,0.0,139.0,139.0
6618.0,17,4,823,2,163,0.0,89.0,81.5,2,660,0.0,443.0,330.0
256070.00000000003,6,3,337,2,214,0.0,160.0,107.0,1,123,0.0,123.0,123.0
44672.0,6,14,4740,7,653,7281.833333333333,249.0,93.28571428571428,7,4087,6695.333333333333,1514.0,583.8571428571429
197891.0,17,2,180,1,90,0.0,90.0,90.0,1,90,0.0,90.0,90.0
90258136.0,6,13,2036,8,1016,12894019.42857143,188.0,127.0,5,1020,22523167.75,204.0,204.0
217444.0,6,3,426,2,280,0.0,214.0,140.0,1,146,0.0,146.0,146.0
277.0,17,3,1050,3,1050,138.5,350.0,350.0,0,0,0.0,0.0,0.0
209642.0,17,2,180,1,90,0.0,90.0,90.0,1,90,0.0,90.0,90.0
1312124.0,6,4,264,2,132,0.0,66.0,66.0,2,132,0.0,66.0,66.0
110941.0,17,2,762,2,762,0.0,381.0,381.0,0,0,0.0,0.0,0.0
108024582.0,6,34,2482,17,1288,6751536.375,139.0,75.76470588235294,17,1194,6738007.3125,123.0,70.23529411764706
49234.0,6,14,4740,7,653,7483.5,249.0,93.28571428571428,7,4087,8023.833333333333,1514.0,583.8571428571429
32486.0,6,14,4740,7,653,4538.333333333333,249.0,93.28571428571428,7,4087,5279.166666666667,1514.0,583.8571428571429
40216.0,6,10,2032,5,524,9424.5,252.0,104.8,5,1508,9294.0,1236.0,301.6
108106842.0,17,5,955,5,955,27026710.5,191.0,191.0,0,0,0.0,0.0,0.0
141874.0,17,4,704,2,148,0.0,74.0,74.0,2,556,0.0,280.0,278.0
203713.0,17,2,762,2,762,0.0,381.0,381.0,0,0,0.0,0.0,0.0
100951616.0,6,28,1876,14,982,7748908.0,139.0,70.14285714285714,14,894,7748918.0,123.0,63.85714285714285
121284119.0,6,198,22458,99,6756,1218579.6326530613,140.0,68.24242424242425,99,15702,1225672.0714285714,284.0,158.6060606060606
99937582.0,6,26,1746,13,906,8310130.416666667,123.0,69.6923076923077,13,840,8310129.583333333,123.0,64.61538461538461
120417072.0,6,237,26832,119,18822,1020483.6610169492,284.0,158.16806722689077,118,8010,1020334.846153846,140.0,67.88135593220339
17188.0,6,14,4740,7,653,2624.6666666666665,249.0,93.28571428571428,7,4087,2633.333333333333,1514.0,583.8571428571429
5830811.0,6,5,336,2,134,0.0,68.0,67.0,3,202,1526036.5,70.0,67.33333333333333
787.0,17,4,438,2,148,0.0,74.0,74.0,2,290,0.0,147.0,145.0
2127.0,17,4,344,2,150,0.0,75.0,75.0,2,194,0.0,103.0,97.0
17340.0,6,11,1131,6,600,3161.2,262.0,100.0,5,531,4123.75,259.0,106.2
505601.0,6,5,336,2,134,0.0,68.0,67.0,3,202,194569.0,70.0,67.33333333333333
107429055.0,6,44,2904,22,1452,5115669.285714285,66.0,66.0,22,1452,5100961.142857143,66.0,66.0
42474.0,6,10,2032,5,524,9421.5,252.0,104.8,5,1508,10434.5,1236.0,301.6
216538.0,17,2,180,1,90,0.0,90.0,90.0,1,90,0.0,90.0,90.0
10421267.0,6,6,412,3,206,5141973.5,74.0,68.66666666666667,3,206,5141878.0,74.0,68.66666666666667
120449281.0,6,469,60192,235,44526,514740.5170940171,480.0,189.4723404255319,234,15666,513511.4506437768,140.0,66.94871794871794
26499.0,6,14,4740,7,653,4147.0,249.0,93.28571428571428,7,4087,4112.833333333333,1514.0,583.8571428571429
0.0,6,1,172,1,172,0.0,172.0,172.0,0,0,0.0,0.0,0.0
21639.0,6,14,4740,7,653,3389.6666666666665,249.0,93.28571428571428,7,4087,3472.1666666666665,1514.0,583.8571428571429
40980.0,6,14,4740,7,653,6716.833333333333,249.0,93.28571428571428,7,4087,6204.833333333333,1514.0,583.8571428571429
156633.0,6,3,337,2,214,0.0,160.0,107.0,1,123,0.0,123.0,123.0
316.0,17,2,174,1,79,0.0,79.0,79.0,1,95,0.0,95.0,95.0
19926.0,6,14,4740,7,653,2549.333333333333,249.0,93.28571428571428,7,4087,3182.0,1514.0,583.8571428571429
66247.0,6,14,4740,7,653,7582.833333333333,249.0,93.28571428571428,7,4087,10253.5,1514.0,583.8571428571429
162312.0,17,2,180,1,90,0.0,90.0,90.0,1,90,0.0,90.0,90.0
145481.0,6,3,373,2,238,0.0,172.0,119.0,1,135,0.0,135.0,135.0
10975.0,6,10,2032,5,524,2463.75,252.0,104.8,5,1508,1882.75,1236.0,301.6
18763.0,6,14,4740,7,653,2978.1666666666665,249.0,93.28571428571428,7,4087,2924.5,1514.0,583.8571428571429
146108.0,17,4,571,2,148,0.0,74.0,74.0,2,423,0.0,280.0,211.5
147872.0,17,2,180,1,90,0.0,90.0,90.0,1,90,0.0,90.0,90.0
31257.0,6,14,4740,7,653,5035.666666666667,249.0,93.28571428571428,7,4087,4960.833333333333,1514.0,583.8571428571429
2498.0,17,4,344,2,150,0.0,75.0,75.0,2,194,0.0,103.0,97.0
115484196.0,6,219,24940,110,7556,1059488.0366972478,140.0,68.69090909090909,109,17384,1059423.537037037,336.0,159.4862385321101
283985.0,17,2,363,1,79,0.0,79.0,79.0,1,284,0.0,284.0,284.0
153595.0,17,2,180,1,90,0.0,90.0,90.0,1,90,0.0,90.0,90.0
0.0,6,1,54,0,0,0.0,0.0,0.0,1,54,0.0,54.0,54.0
396.0,17,2,160,1,80,0.0,80.0,80.0,1,80,0.0,80.0,80.0
90257637.0,6,14,2240,8,1016,12893948.142857144,188.0,127.0,6,1224,18018705.8,204.0,204.0
90056737.0,17,28,13364,28,13364,3335434.703703704,501.0,477.2857142857143,0,0,0.0,0.0,0.0
61672.0,6,12,1320,7,789,10278.666666666666,253.0,112.71428571428572,5,531,11624.5,259.0,106.2
39149.0,6,10,2032,5,524,9501.5,252.0,104.8,5,1508,9399.25,1236.0,301.6
284841.0,17,2,363,1,79,0.0,79.0,79.0,1,284,0.0,284.0,284.0
34660.0,6,14,4740,7,653,5655.833333333333,249.0,93.28571428571428,7,4087,5602.166666666667,1514.0,583.8571428571429
91260363.0,17,12,778,6,389,18202585.0,174.0,64.83333333333333,6,389,18200149.4,174.0,64.83333333333333
309664.0,17,4,1400,4,1400,103221.33333333331,350.0,350.0,0,0,0.0,0.0,0.0
1192670.0,6,13,3010,8,2382,170381.42857142858,1514.0,297.75,5,628,229238.25,331.0,125.6
258729.0,6,3,337,2,214,0.0,160.0,107.0,1,123,0.0,123.0,123.0
1918.0,17,2,176,1,80,0.0,80.0,80.0,1,96,0.0,96.0,96.0
35206.0,6,10,2032,5,524,8562.0,252.0,104.8,5,1508,8205.0,1236.0,301.6
37820.0,6,10,2032,5,524,9223.75,252.0,104.8,5,1508,8740.25,1236.0,301.6
1169112.0,6,13,3000,8,2372,167016.0,1514.0,296.5,5,628,224029.25,331.0,125.6
305.0,17,2,174,1,79,0.0,79.0,79.0,1,95,0.0,95.0,95.0
3005015.0,6,12,2172,7,664,500598.0,252.0,94.85714285714286,5,1508,1741.75,1236.0,301.6
137493.0,6,2,132,1,66,0.0,66.0,66.0,1,66,0.0,66.0,66.0
3260.0,17,2,363,1,79,0.0,79.0,79.0,1,284,0.0,284.0,284.0
32904.0,6,14,4740,7,653,5373.0,249.0,93.28571428571428,7,4087,4231.166666666667,1514.0,583.8571428571429
153457.0,17,2,180,1,90,0.0,90.0,90.0,1,90,0.0,90.0,90.0
33135370.0,6,7,1874,3,887,16464693.000000002,753.0,295.6666666666667,4,987,10997287.0,785.0,246.75
90259599.0,6,14,1964,8,1016,12894228.42857143,188.0,127.0,6,948,18011905.4,204.0,158.0
108104884.0,17,5,1005,5,1005,27026221.0,201.0,201.0,0,0,0.0,0.0,0.0
857544.0,6,9,1196,6,725,171508.8,387.0,120.83333333333331,3,471,291216.5,331.0,157.0
90255086.0,6,13,2036,8,1016,12893583.714285716,188.0,127.0,5,1020,22522612.25,204.0,204.0
10472846.0,6,6,412,3,206,5168231.0,74.0,68.66666666666667,3,206,5168107.5,74.0,68.66666666666667
83.0,17,2,762,2,762,0.0,381.0,381.0,0,0,0.0,0.0,0.0
90027795.0,17,28,13364,28,13364,3334362.777777778,501.0,477.2857142857143,0,0,0.0,0.0,0.0
94225719.0,17,14,1126,7,563,15666803.666666666,174.0,80.42857142857143,7,563,15668155.833333334,174.0,80.42857142857143
219047.0,6,3,426,2,280,0.0,214.0,140.0,1,146,0.0,146.0,146.0
148006.0,17,2,180,1,90,0.0,90.0,90.0,1,90,0.0,90.0,90.0
217688.0,6,3,426,2,280,0.0,214.0,140.0,1,146,0.0,146.0,146.0
90084144.0,17,28,13364,28,13364,3336449.777777778,501.0,477.2857142857143,0,0,0.0,0.0,0.0
120350750.0,6,214,24202,107,7358,1127672.6603773586,140.0,68.76635514018692,107,16844,1127527.6886792453,284.0,157.42056074766356
120939390.0,6,27,2114,12,935,10994490.0,95.0,77.91666666666667,15,1179,6496281.857142857,95.0,78.6
322056.0,17,4,1400,4,1400,107352.0,350.0,350.0,0,0,0.0,0.0,0.0
207220.0,17,2,180,1,90,0.0,90.0,90.0,1,90,0.0,90.0,90.0
2772287.0,6,3,1604,2,851,0.0,785.0,425.5,1,753,0.0,753.0,753.0
216325.0,17,2,180,1,90,0.0,90.0,90.0,1,90,0.0,90.0,90.0
216362.0,17,2,180,1,90,0.0,90.0,90.0,1,90,0.0,90.0,90.0
91000666.0,17,11,735,6,389,18200133.2,174.0,64.83333333333333,5,346,17751730.75,174.0,69.2
2383.0,17,4,344,2,150,0.0,75.0,75.0,2,194,0.0,103.0,97.0
50808.0,17,2,180,1,90,0.0,90.0,90.0,1,90,0.0,90.0,90.0
153465.0,17,2,180,1,90,0.0,90.0,90.0,1,90,0.0,90.0,90.0
45371.0,6,10,2032,5,524,10561.5,252.0,104.8,5,1508,9893.5,1236.0,301.6
19047058.0,6,6,1981,4,1087,6349019.333333333,885.0,271.75,2,894,0.0,826.0,447.0
90366371.0,6,11,1644,7,828,15061061.833333334,188.0,118.28571428571428,4,816,20112360.33333333,204.0,204.0
33701413.0,6,5,336,2,134,0.0,68.0,67.0,3,202,16783703.5,70.0,67.33333333333333
41103.0,6,11,2098,6,590,6919.8,252.0,98.33333333333331,5,1508,4010.25,1236.0,301.6
247962.0,6,3,337,2,214,0.0,160.0,107.0,1,123,0.0,123.0,123.0
90258782.0,6,13,2036,8,1016,12894111.714285716,188.0,127.0,5,1020,22522899.0,204.0,204.0
148022.0,17,2,180,1,90,0.0,90.0,90.0,1,90,0.0,90.0,90.0
1253.0,17,5,550,5,550,313.25,110.0,110.0,0,0,0.0,0.0,0.0
104033978.0,6,283,32616,142,23088,737829.6312056738,300.0,162.59154929577466,141,9528,736484.8928571428,140.0,67.57446808510639
127834.0,6,14,4740,7,653,18782.83333333333,249.0,93.28571428571428,7,4087,20786.5,1514.0,583.8571428571429
28906.0,6,10,1067,5,536,7037.25,264.0,107.2,5,531,5326.25,259.0,106.2
135140210.0,17,6,1146,6,1146,27028042.0,191.0,191.0,0,0,0.0,0.0,0.0
215600.0,17,4,1400,4,1400,71866.66666666667,350.0,350.0,0,0,0.0,0.0,0.0
303477.0,6,6,412,4,272,101159.0,74.0,68.0,2,140,0.0,74.0,70.0
109077041.0,17,14,864,7,432,18167949.33333333,174.0,61.71428571428572,7,432,18166830.166666668,174.0,61.71428571428572
50428.0,6,14,4740,7,653,7679.0,249.0,93.28571428571428,7,4087,7858.666666666667,1514.0,583.8571428571429
207345.0,6,3,426,2,280,0.0,214.0,140.0,1,146,0.0,146.0,146.0
36349.0,6,14,4740,7,653,5826.0,249.0,93.28571428571428,7,4087,5840.333333333333,1514.0,583.8571428571429
15779.000000000002,6,14,4740,7,653,2183.1666666666665,249.0,93.28571428571428,7,4087,2493.6666666666665,1514.0,583.8571428571429
17907.0,6,20,7606,11,978,1790.7,310.0,88.9090909090909,9,6628,1976.0,1514.0,736.4444444444445
104039.0,17,2,286,2,286,0.0,143.0,143.0,0,0,0.0,0.0,0.0
18261.0,6,14,4740,7,653,2891.0,249.0,93.28571428571428,7,4087,2857.333333333333,1514.0,583.8571428571429
0.0,17,1,381,1,381,0.0,381.0,381.0,0,0,0.0,0.0,0.0
304.0,17,2,174,1,79,0.0,79.0,79.0,1,95,0.0,95.0,95.0
26931.0,6,14,4740,7,653,4203.166666666667,249.0,93.28571428571428,7,4087,3943.6666666666665,1514.0,583.8571428571429
45507.0,6,14,4740,7,653,7054.833333333333,249.0,93.28571428571428,7,4087,7449.166666666667,1514.0,583.8571428571429
127310079.0,6,34,2413,17,1125,7476200.375,123.0,66.17647058823529,17,1288,7332762.0,139.0,75.76470588235294
311434.0,6,6,412,4,272,103811.33333333331,74.0,68.0,2,140,0.0,74.0,70.0
160291.0,6,2,128,1,74,0.0,74.0,74.0,1,54,0.0,54.0,54.0
38148.0,6,14,4740,7,653,5601.0,249.0,93.28571428571428,7,4087,5916.5,1514.0,583.8571428571429
25326.0,6,10,2032,5,524,5805.75,252.0,104.8,5,1508,5946.75,1236.0,301.6
26517.0,6,2,145,2,145,0.0,91.0,72.5,0,0,0.0,0.0,0.0
46174.0,6,14,4740,7,653,6091.5,249.0,93.28571428571428,7,4087,7472.333333333333,1514.0,583.8571428571429
232233.0,6,3,337,2,214,0.0,160.0,107.0,1,123,0.0,123.0,123.0
2393597.0,6,3,1777,1,826,0.0,826.0,826.0,2,951,0.0,885.0,475.5
46753.0,6,14,4740,7,653,7661.166666666667,249.0,93.28571428571428,7,4087,7596.0,1514.0,583.8571428571429
135136590.0,17,6,1146,6,1146,27027318.0,191.0,191.0,0,0,0.0,0.0,0.0
90043792.0,17,28,13364,28,13364,3334955.25925926,501.0,477.2857142857143,0,0,0.0,0.0,0.0
123415686.0,6,48,3168,24,1584,5104982.913043479,66.0,66.0,24,1584,5196560.521739131,66.0,66.0
42023.0,6,10,2032,5,524,10274.25,252.0,104.8,5,1508,10331.0,1236.0,301.6
6258.0,17,4,344,2,150,0.0,75.0,75.0,2,194,0.0,103.0,97.0
0.0,6,1,66,1,66,0.0,66.0,66.0,0,0,0.0,0.0,0.0
22821.0,6,14,4740,7,653,3636.8333333333335,249.0,93.28571428571428,7,4087,3663.6666666666665,1514.0,583.8571428571429
2663361.0,6,3,1777,2,951,0.0,885.0,475.5,1,826,0.0,826.0,826.0
20846276.0,17,3,1034,2,684,0.0,342.0,342.0,1,350,0.0,350.0,350.0
308199.0,6,6,412,4,272,102733.0,74.0,68.0,2,140,0.0,74.0,70.0
102719511.0,6,28,1860,14,966,7884910.923076923,123.0,69.0,14,894,7884889.615384615,123.0,63.85714285714285
108101379.0,17,5,955,5,955,27025344.75,191.0,191.0,0,0,0.0,0.0,0.0
207356.0,17,2,180,1,90,0.0,90.0,90.0,1,90,0.0,90.0,90.0
45329.0,6,14,4740,7,653,7431.5,249.0,93.28571428571428,7,4087,6865.5,1514.0,583.8571428571429
398585.0,17,2,539,1,86,0.0,86.0,86.0,1,453,0.0,453.0,453.0
14787.0,17,2,180,1,90,0.0,90.0,90.0,1,90,0.0,90.0,90.0
228359.0,17,2,180,1,90,0.0,90.0,90.0,1,90,0.0,90.0,90.0
143888.0,17,2,180,1,90,0.0,90.0,90.0,1,90,0.0,90.0,90.0
837876.0,6,9,1118,6,586,167575.2,248.0,97.66666666666669,3,532,280897.0,392.0,177.33333333333334
143886.0,17,2,180,1,90,0.0,90.0,90.0,1,90,0.0,90.0,90.0
318607.0,17,4,1400,4,1400,106202.33333333331,350.0,350.0,0,0,0.0,0.0,0.0
149573833.0,6,24,1788,12,894,10889090.0,95.0,74.5,12,894,13596547.0,95.0,74.5
206200.0,17,2,180,1,90,0.0,90.0,90.0,1,90,0.0,90.0,90.0
207324.0,6,3,426,2,280,0.0,214.0,140.0,1,146,0.0,146.0,146.0
99111.0,17,2,286,2,286,0.0,143.0,143.0,0,0,0.0,0.0,0.0
9262.0,17,2,582,1,83,0.0,83.0,83.0,1,499,0.0,499.0,499.0
296.0,17,2,156,1,78,0.0,78.0,78.0,1,78,0.0,78.0,78.0
120112735.0,6,12,1832,8,1016,17136085.14285714,188.0,127.0,4,816,30025512.666666668,204.0,204.0
113187553.0,17,14,1126,7,563,18837905.166666668,174.0,80.42857142857143,7,563,18837912.0,174.0,80.42857142857143
135132973.0,17,6,1206,6,1206,27026594.6,201.0,201.0,0,0,0.0,0.0,0.0
113520274.0,6,46,3036,23,1518,5159999.818181818,66.0,66.0,23,1518,5160001.181818182,66.0,66.0
90382991.0,6,13,2052,7,828,15063831.833333334,188.0,118.28571428571428,6,1224,12065472.0,204.0,204.0
25099.0,6,14,4740,7,653,4058.3333333333335,249.0,93.28571428571428,7,4087,4046.5,1514.0,583.8571428571429
2299.0,17,4,344,2,150,0.0,75.0,75.0,2,194,0.0,103.0,97.0
1935335.0,6,19,6869,11,1567,193533.5,408.0,142.45454545454547,8,5302,215025.7142857143,1514.0,662.75
2394.0,17,4,344,2,150,0.0,75.0,75.0,2,194,0.0,103.0,97.0
118556319.0,6,47,3102,24,1584,5154612.043478261,66.0,66.0,23,1518,5159996.818181818,66.0,66.0
99984035.0,6,191,21582,96,15016,1052463.5263157894,284.0,156.41666666666666,95,6566,1060241.829787234,140.0,69.11578947368422
1155033.0,6,13,3012,8,2384,165004.7142857143,1514.0,298.0,5,628,220582.0,331.0,125.6
48416.0,6,14,4740,7,653,7952.166666666667,249.0,93.28571428571428,7,4087,7883.666666666667,1514.0,583.8571428571429
26042.0,6,14,4740,7,653,3769.0,249.0,93.28571428571428,7,4087,4205.5,1514.0,583.8571428571429
16414.0,17,2,180,1,90,0.0,90.0,90.0,1,90,0.0,90.0,90.0
284223.0,17,2,363,1,79,0.0,79.0,79.0,1,284,0.0,284.0,284.0
120130848.0,6,274,32392,137,9338,879779.0441176471,140.0,68.16058394160584,137,23054,883194.0735294118,284.0,168.27737226277372
111005258.0,6,30,1974,15,1026,7913484.785714285,123.0,68.4,15,948,7913531.0,123.0,63.2
2032.0,17,4,344,2,150,0.0,75.0,75.0,2,194,0.0,103.0,97.0
2056.0,17,4,344,2,150,0.0,75.0,75.0,2,194,0.0,103.0,97.0
90312495.0,6,16,1192,8,596,12892674.42857143,95.0,74.5,8,596,12900873.0,95.0,74.5
90093002.0,6,11,1644,7,828,15015500.333333334,188.0,118.28571428571428,4,816,20020337.666666668,204.0,204.0
103495573.0,6,44,2904,22,1452,4928360.619047619,66.0,66.0,22,1452,4914279.285714285,66.0,66.0
39196721.0,6,5,336,2,134,0.0,68.0,67.0,3,202,19549602.0,70.0,67.33333333333333
205084.0,17,4,6056,4,6056,68361.33333333333,1514.0,1514.0,0,0,0.0,0.0,0.0
122812961.0,6,31,2034,16,1086,8187530.733333333,123.0,67.875,15,948,8044505.142857143,123.0,63.2
246145.0,6,3,337,2,214,0.0,160.0,107.0,1,123,0.0,123.0,123.0
508081.0,6,3,1604,2,851,0.0,785.0,425.5,1,753,0.0,753.0,753.0
17617.0,6,11,1133,6,602,2282.6,264.0,100.33333333333331,5,531,3888.25,259.0,106.2
135119293.0,17,6,1146,6,1146,27023858.6,191.0,191.0,0,0,0.0,0.0,0.0
90259353.0,6,12,1832,8,1016,12894193.285714284,188.0,127.0,4,816,30021288.0,204.0,204.0
0.0,17,1,55,1,55,0.0,55.0,55.0,0,0,0.0,0.0,0.0
260520.0,6,3,337,2,214,0.0,160.0,107.0,1,123,0.0,123.0,123.0
110496960.0,6,194,21982,97,15284,1148768.9166666667,284.0,157.56701030927834,97,6698,1149323.21875,140.0,69.05154639175258
51202.0,6,14,4740,7,653,7830.666666666667,249.0,93.28571428571428,7,4087,5790.5,1514.0,583.8571428571429
35500.0,6,10,2032,5,524,8655.75,252.0,104.8,5,1508,8263.5,1236.0,301.6
216385.0,17,2,180,1,90,0.0,90.0,90.0,1,90,0.0,90.0,90.0
48394.0,6,14,4740,7,653,7038.333333333333,249.0,93.28571428571428,7,4087,7739.833333333333,1514.0,583.8571428571429
0.0,6,1,54,0,0,0.0,0.0,0.0,1,54,0.0,54.0,54.0
146.0,17,2,700,2,700,0.0,350.0,350.0,0,0,0.0,0.0,0.0
2362247.0,6,49,23728,25,19797,98426.95833333331,1514.0,791.88,24,3931,93016.82608695651,1514.0,163.79166666666666
103842273.0,6,44,2904,22,1452,4944870.142857143,66.0,66.0,22,1452,4930175.857142857,66.0,66.0
123610630.0,6,49,3234,25,1650,5150442.916666667,66.0,66.0,24,1584,5186753.869565218,66.0,66.0
299778.0,6,6,412,4,272,99926.0,74.0,68.0,2,140,0.0,74.0,70.0
306753.0,6,6,412,4,272,102251.0,74.0,68.0,2,140,0.0,74.0,70.0
312616.0,17,4,1400,4,1400,104205.33333333331,350.0,350.0,0,0,0.0,0.0,0.0
266243.0,6,10,1221,6,636,53248.6,298.0,106.0,4,585,83422.66666666667,379.0,146.25
1136904.0,6,13,3010,8,2382,162414.85714285713,1514.0,297.75,5,628,215264.5,331.0,125.6
25044.0,6,14,4740,7,653,2546.833333333333,249.0,93.28571428571428,7,4087,4008.8333333333335,1514.0,583.8571428571429
38748.0,6,10,2032,5,524,9122.5,252.0,104.8,5,1508,9441.25,1236.0,301.6
98921933.0,6,376,46964,188,12630,524582.1283422459,140.0,67.18085106382979,188,34334,524579.5989304812,480.0,182.62765957446808
209588.0,17,2,180,1,90,0.0,90.0,90.0,1,90,0.0,90.0,90.0
24209.0,6,14,4740,7,653,3642.0,249.0,93.28571428571428,7,4087,3896.0,1514.0,583.8571428571429
3318952.0,6,147,124672,89,116542,37677.51136363636,1510.0,1309.4606741573034,58,8130,52942.0701754386,1510.0,140.17241379310346
129573548.0,6,36,2734,17,1263,7474273.5625,123.0,74.29411764705883,19,1471,6767932.333333333,139.0,77.42105263157895
102288.0,17,2,286,2,286,0.0,143.0,143.0,0,0,0.0,0.0,0.0
159900.0,6,3,337,2,214,0.0,160.0,107.0,1,123,0.0,123.0,123.0
106670.0,17,2,286,2,286,0.0,143.0,143.0,0,0,0.0,0.0,0.0
117338591.0,6,213,24040,107,16822,1106967.8396226414,284.0,157.21495327102804,106,7218,1107635.6285714286,140.0,68.09433962264151
510266.0,6,5,336,2,134,0.0,68.0,67.0,3,202,195573.5,70.0,67.33333333333333
219243.0,6,4,492,2,280,0.0,214.0,140.0,2,212,0.0,146.0,106.0
120123077.0,6,14,2224,9,1204,15015384.625,188.0,133.77777777777777,5,1020,22592144.25,204.0,204.0
209917.0,17,2,180,1,90,0.0,90.0,90.0,1,90,0.0,90.0,90.0
95943139.0,6,189,21810,95,6492,1020671.6914893616,140.0,68.33684210526316,94,15318,1021141.2150537636,284.0,162.95744680851064
273417.0,6,10,1221,6,636,54683.4,298.0,106.0,4,585,85738.66666666667,379.0,146.25
99192.0,17,4,1400,4,1400,33064.0,350.0,350.0,0,0,0.0,0.0,0.0
48064.0,6,10,2032,5,524,11639.75,252.0,104.8,5,1508,11484.75,1236.0,301.6
4656.0,17,4,797,2,144,0.0,72.0,72.0,2,653,0.0,526.0,326.5
90260682.0,6,13,2036,8,1016,12894383.142857144,188.0,127.0,5,1020,22523385.75,204.0,204.0
118001118.0,17,13,821,7,432,19666853.0,174.0,61.71428571428572,6,389,19601630.2,174.0,64.83333333333333
32311.0,6,14,4740,7,653,5144.833333333333,249.0,93.28571428571428,7,4087,5101.833333333333,1514.0,583.8571428571429
120000419.0,6,25,2086,14,1246,9230801.461538462,257.0,89.0,11,840,9697196.5,95.0,76.36363636363636
38173.0,6,10,2032,5,524,9282.5,252.0,104.8,5,1508,8583.25,1236.0,301.6
758.0,17,4,438,2,148,0.0,74.0,74.0,2,290,0.0,147.0,145.0
27266.0,6,11,2098,6,590,5299.6,252.0,98.33333333333331,5,1508,5672.0,1236.0,301.6
120212477.0,6,18,1341,9,691,14999569.75,95.0,76.77777777777777,9,650,14999502.0,95.0,72.22222222222223
113520249.0,6,46,3036,23,1518,5159997.318181818,66.0,66.0,23,1518,5160000.090909091,66.0,66.0
207617.0,6,10,1221,6,636,41523.4,298.0,106.0,4,585,68041.66666666667,379.0,146.25
10512615.0,6,7,478,4,272,3456991.6666666665,74.0,68.0,3,206,5185372.5,74.0,68.66666666666667
206270.0,17,2,180,1,90,0.0,90.0,90.0,1,90,0.0,90.0,90.0
108120527.0,17,5,1005,5,1005,27030131.75,201.0,201.0,0,0,0.0,0.0,0.0
31365.0,6,14,4740,7,653,4993.166666666667,249.0,93.28571428571428,7,4087,4933.333333333333,1514.0,583.8571428571429
14719.0,17,2,180,1,90,0.0,90.0,90.0,1,90,0.0,90.0,90.0
5031667.0,6,154,120044,85,111190,59900.79761904762,1510.0,1308.1176470588234,69,8854,69478.70588235294,1510.0,128.31884057971016
2376.0,17,4,344,2,150,0.0,75.0,75.0,2,194,0.0,103.0,97.0
90889073.0,6,18,1382,8,637,12954843.142857144,95.0,79.625,10,745,10075953.888888888,95.0,74.5
217768.0,6,3,426,2,280,0.0,214.0,140.0,1,146,0.0,146.0,146.0
310351.0,17,4,1400,4,1400,103450.33333333331,350.0,350.0,0,0,0.0,0.0,0.0
107625147.0,6,27,1800,14,894,8278857.461538462,123.0,63.85714285714285,13,906,8118676.833333333,123.0,69.6923076923077
79.0,17,2,762,2,762,0.0,381.0,381.0,0,0,0.0,0.0,0.0
4486.0,17,2,614,1,72,0.0,72.0,72.0,1,542,0.0,542.0,542.0
60231.0,6,12,1320,6,723,10846.8,253.0,120.5,6,597,11054.4,259.0,99.5
21281.0,6,10,2032,5,524,4882.0,252.0,104.8,5,1508,4954.0,1236.0,301.6
228273.0,17,2,180,1,90,0.0,90.0,90.0,1,90,0.0,90.0,90.0
18312.0,6,10,1066,5,490,4216.75,218.0,98.0,5,576,4268.5,304.0,115.2
108105070.0,17,5,1005,5,1005,27026267.5,201.0,201.0,0,0,0.0,0.0,0.0
2476139.0,6,3,1604,1,753,0.0,753.0,753.0,2,851,0.0,785.0,425.5
5812.0,17,2,180,1,90,0.0,90.0,90.0,1,90,0.0,90.0,90.0
127416.0,6,11,2098,6,590,24278.4,252.0,98.33333333333331,5,1508,30359.75,1236.0,301.6
10039.0,6,10,1067,5,536,2290.0,264.0,107.2,5,531,2318.75,259.0,106.2
28111.0,6,14,4740,7,653,4172.666666666667,249.0,93.28571428571428,7,4087,3891.8333333333335,1514.0,583.8571428571429
165534.0,17,5,961,3,234,82416.5,78.0,78.0,2,727,0.0,395.0,363.5
32808.0,6,10,2032,5,524,6293.0,252.0,104.8,5,1508,7899.25,1236.0,301.6
146631.0,6,3,373,2,238,0.0,172.0,119.0,1,135,0.0,135.0,135.0
120003641.0,6,21,1585,10,745,13333737.888888888,95.0,74.5,11,840,11974115.0,95.0,76.36363636363636
209582.0,17,2,180,1,90,0.0,90.0,90.0,1,90,0.0,90.0,90.0
2019.0,17,4,344,2,150,0.0,75.0,75.0,2,194,0.0,103.0,97.0
107842.0,17,2,286,2,286,0.0,143.0,143.0,0,0,0.0,0.0,0.0
119729974.0,6,27,2152,14,1204,9209998.0,256.0,86.0,13,948,9940898.916666666,95.0,72.92307692307692
310.0,17,2,168,1,76,0.0,76.0,76.0,1,92,0.0,92.0,92.0
315471.0,17,4,1400,4,1400,105157.0,350.0,350.0,0,0,0.0,0.0,0.0
46445.0,6,14,4740,7,653,6651.5,249.0,93.28571428571428,7,4087,7380.833333333333,1514.0,583.8571428571429
31500805.0,6,23,6481,12,1348,2863709.5454545454,408.0,112.33333333333331,11,5133,3119617.4,1514.0,466.6363636363636
209504.0,17,2,180,1,90,0.0,90.0,90.0,1,90,0.0,90.0,90.0
91418399.0,6,24,1829,13,989,7617778.416666667,95.0,76.07692307692308,11,840,9141487.4,95.0,76.36363636363636
170842.0,17,2,414,1,88,0.0,88.0,88.0,1,326,0.0,326.0,326.0
2300.0,17,4,344,2,150,0.0,75.0,75.0,2,194,0.0,103.0,97.0
120438360.0,6,237,26816,119,18732,1020664.0677966102,284.0,157.41176470588235,118,8084,1020511.4615384616,140.0,68.50847457627118
90011670.0,17,28,13364,28,13364,3333765.5555555555,501.0,477.2857142857143,0,0,0.0,0.0,0.0
241589.0,6,3,337,2,214,0.0,160.0,107.0,1,123,0.0,123.0,123.0
111453.0,17,4,1400,4,1400,37151.0,350.0,350.0,0,0,0.0,0.0,0.0
104228.0,17,2,286,2,286,0.0,143.0,143.0,0,0,0.0,0.0,0.0
452279.0,17,4,360,2,140,0.0,70.0,70.0,2,220,0.0,110.0,110.0
1451099.0,6,7,499,4,301,460338.6666666667,103.0,75.25,3,198,717200.5,66.0,66.0
33157.0,6,10,2032,5,524,8063.25,252.0,104.8,5,1508,7075.5,1236.0,301.6
26530.0,6,10,2032,5,524,6412.75,252.0,104.8,5,1508,4703.5,1236.0,301.6
290885.0,17,2,180,1,90,0.0,90.0,90.0,1,90,0.0,90.0,90.0
22232.0,6,14,4740,7,653,3574.833333333333,249.0,93.28571428571428,7,4087,3550.6666666666665,1514.0,583.8571428571429
1314906.0,6,4,264,2,132,0.0,66.0,66.0,2,132,0.0,66.0,66.0
107460.0,17,2,286,2,286,0.0,143.0,143.0,0,0,0.0,0.0,0.0
304872.0,6,6,412,4,272,101624.0,74.0,68.0,2,140,0.0,74.0,70.0
5725585.0,6,5,336,2,134,0.0,68.0,67.0,3,202,1524482.5,70.0,67.33333333333333
90026198.0,17,28,13364,28,13364,3334303.6296296297,501.0,477.2857142857143,0,0,0.0,0.0,0.0
120450800.0,6,213,24152,107,16860,1136328.3018867923,284.0,157.57009345794393,106,7292,1137271.2571428572,140.0,68.79245283018868
104360296.0,6,182,20538,91,14236,1157168.4555555556,284.0,156.43956043956044,91,6302,1157168.4777777777,140.0,69.25274725274726
152079.0,17,2,414,1,88,0.0,88.0,88.0,1,326,0.0,326.0,326.0
5623092.0,6,4,270,2,134,0.0,68.0,67.0,2,136,0.0,70.0,68.0
2349.0,17,4,344,2,150,0.0,75.0,75.0,2,194,0.0,103.0,97.0
497188.0,6,4,270,2,134,0.0,68.0,67.0,2,136,0.0,70.0,68.0
90032350.0,17,28,13364,28,13364,3334531.4814814813,501.0,477.2857142857143,0,0,0.0,0.0,0.0
284468.0,17,2,363,1,79,0.0,79.0,79.0,1,284,0.0,284.0,284.0
109187.0,17,2,286,2,286,0.0,143.0,143.0,0,0,0.0,0.0,0.0
299426.0,6,6,412,4,272,99808.66666666669,74.0,68.0,2,140,0.0,74.0,70.0
0.0,17,1,350,1,350,0.0,350.0,350.0,0,0,0.0,0.0,0.0
108097525.0,17,5,955,5,955,27024381.25,191.0,191.0,0,0,0.0,0.0,0.0
93608035.0,6,32,2352,16,1212,6240535.666666667,123.0,75.75,16,1140,6226115.066666666,123.0,71.25
2440614.0,6,25,7573,14,3735,187739.53846153847,1514.0,266.7857142857143,11,3838,218377.8,1514.0,348.90909090909093
217788.0,6,3,426,2,280,0.0,214.0,140.0,1,146,0.0,146.0,146.0
1391732.0,17,16,1120,16,1120,92782.13333333332,70.0,70.0,0,0,0.0,0.0,0.0
2337.0,17,4,344,2,150,0.0,75.0,75.0,2,194,0.0,103.0,97.0
1139482.0,6,20,6434,12,1921,103589.27272727272,620.0,160.08333333333334,8,4513,134160.14285714287,1514.0,564.125
3088430.0,6,159,125434,90,116578,34701.4606741573,1510.0,1295.3111111111111,69,8856,40782.52941176471,1510.0,128.34782608695653
108104748.0,17,5,955,5,955,27026187.0,191.0,191.0,0,0,0.0,0.0,0.0
100001035.0,17,11,473,6,258,20000207.0,43.0,43.0,5,215,20001181.5,43.0,43.0
5828543.0,6,5,336,2,134,0.0,68.0,67.0,3,202,1527690.0,70.0,67.33333333333333
206231.0,6,3,426,2,280,0.0,214.0,140.0,1,146,0.0,146.0,146.0
206077.0,17,2,180,1,90,0.0,90.0,90.0,1,90,0.0,90.0,90.0
127791.0,6,2,132,1,66,0.0,66.0,66.0,1,66,0.0,66.0,66.0
215330.0,17,2,180,1,90,0.0,90.0,90.0,1,90,0.0,90.0,90.0
2494.0,17,4,438,2,148,0.0,74.0,74.0,2,290,0.0,147.0,145.0
153446.0,17,2,180,1,90,0.0,90.0,90.0,1,90,0.0,90.0,90.0
60961.0,6,14,4740,7,653,9132.833333333334,249.0,93.28571428571428,7,4087,9786.666666666666,1514.0,583.8571428571429
10451535.0,6,7,478,4,272,3438585.333333333,74.0,68.0,3,206,5157748.0,74.0,68.66666666666667
106862.0,17,2,286,2,286,0.0,143.0,143.0,0,0,0.0,0.0,0.0
10111.0,6,11,2098,6,590,1888.8,252.0,98.33333333333331,5,1508,1934.0,1236.0,301.6
143954.0,17,2,180,1,90,0.0,90.0,90.0,1,90,0.0,90.0,90.0
207772.0,17,2,630,1,82,0.0,82.0,82.0,1,548,0.0,548.0,548.0
16233.999999999998,6,10,2032,5,524,3792.5,252.0,104.8,5,1508,2974.5,1236.0,301.6
351.0,17,2,160,1,80,0.0,80.0,80.0,1,80,0.0,80.0,80.0
228277.0,17,2,180,1,90,0.0,90.0,90.0,1,90,0.0,90.0,90.0
495.0,17,2,410,1,78,0.0,78.0,78.0,1,332,0.0,332.0,332.0
463870.0,6,2,132,1,66,0.0,66.0,66.0,1,66,0.0,66.0,66.0
213588.0,17,2,180,1,90,0.0,90.0,90.0,1,90,0.0,90.0,90.0
59209.0,6,14,4740,7,653,9646.5,249.0,93.28571428571428,7,4087,9094.5,1514.0,583.8571428571429
97108137.0,17,12,778,6,389,19421627.4,174.0,64.83333333333333,6,389,19374034.2,174.0,64.83333333333333
29585.0,6,10,2032,5,524,7159.75,252.0,104.8,5,1508,7124.5,1236.0,301.6
252841.0,6,3,337,2,214,0.0,160.0,107.0,1,123,0.0,123.0,123.0
2390.0,17,4,344,2,150,0.0,75.0,75.0,2,194,0.0,103.0,97.0
26424.0,6,10,2032,5,524,5978.75,252.0,104.8,5,1508,6204.75,1236.0,301.6
330.0,17,2,166,1,75,0.0,75.0,75.0,1,91,0.0,91.0,91.0
148056.0,17,2,180,1,90,0.0,90.0,90.0,1,90,0.0,90.0,90.0
198639.0,17,2,180,1,90,0.0,90.0,90.0,1,90,0.0,90.0,90.0
90256487.0,6,13,1898,8,1016,12893783.857142856,188.0,127.0,5,882,22523733.25,204.0,176.4
762.0,17,4,438,2,148,0.0,74.0,74.0,2,290,0.0,147.0,145.0
49112.0,6,14,4740,7,653,7972.166666666667,249.0,93.28571428571428,7,4087,7526.5,1514.0,583.8571428571429
90043748.0,17,28,13364,28,13364,3334953.6296296297,501.0,477.2857142857143,0,0,0.0,0.0,0.0
228567.0,17,2,180,1,90,0.0,90.0,90.0,1,90,0.0,90.0,90.0
90255754.0,6,12,1832,8,1016,12893679.142857144,188.0,127.0,4,816,30031251.0,204.0,204.0
299148.0,6,6,412,4,272,99716.0,74.0,68.0,2,140,0.0,74.0,70.0
116004614.0,17,13,821,7,432,19334102.33333333,174.0,61.71428571428572,6,389,19200160.6,174.0,64.83333333333333
301617.0,6,20,10040,11,892,30161.7,224.0,81.0909090909091,9,9148,36224.125,1514.0,1016.4444444444443
90990272.0,6,29,2068,15,1105,6484680.0,139.0,73.66666666666667,14,963,6983522.846153846,123.0,68.78571428571429
695.0,17,4,438,2,148,0.0,74.0,74.0,2,290,0.0,147.0,145.0
51159.0,17,2,180,1,90,0.0,90.0,90.0,1,90,0.0,90.0,90.0
54912.0,6,14,4740,7,653,9027.5,249.0,93.28571428571428,7,4087,8300.166666666666,1514.0,583.8571428571429
2270957.0,6,3,1604,2,851,0.0,785.0,425.5,1,753,0.0,753.0,753.0
10424544.0,6,6,412,3,206,5143870.0,74.0,68.66666666666667,3,206,5143740.0,74.0,68.66666666666667
312245.0,17,4,1400,4,1400,104081.66666666669,350.0,350.0,0,0,0.0,0.0,0.0
108109675.0,17,5,1005,5,1005,27027418.75,201.0,201.0,0,0,0.0,0.0,0.0
309510.0,17,4,1400,4,1400,103170.0,350.0,350.0,0,0,0.0,0.0,0.0
24287.0,6,10,2032,5,524,3527.0,252.0,104.8,5,1508,5833.5,1236.0,301.6
100291145.0,17,12,516,6,258,20000878.0,43.0,43.0,6,258,20000192.8,43.0,43.0
101699340.0,6,30,2122,15,1105,7248831.0,139.0,73.66666666666667,15,1017,7248832.214285715,123.0,67.8
120257614.0,6,344,41846,172,11648,701125.6198830409,140.0,67.72093023255815,172,30198,703178.1695906433,480.0,175.56976744186048
100079758.0,6,39,2574,20,1320,5267343.368421053,66.0,66.0,19,1254,5152215.833333333,66.0,66.0
148682.0,17,2,414,1,88,0.0,88.0,88.0,1,326,0.0,326.0,326.0
298.0,17,2,164,1,82,0.0,82.0,82.0,1,82,0.0,82.0,82.0
2673089.0,6,25,7573,14,3735,205622.2307692308,1514.0,266.7857142857143,11,3838,241470.0,1514.0,348.90909090909093
91341317.0,6,1846,1627756,566,37356,161666.04778761062,66.0,66.0,1280,1590400,71406.3807662236,1514.0,1242.5
120228985.0,6,19,1436,10,745,13332732.777777778,95.0,74.5,9,691,15023397.5,95.0,76.77777777777777
108109876.0,17,5,955,5,955,27027469.0,191.0,191.0,0,0,0.0,0.0,0.0
2367.0,17,4,344,2,150,0.0,75.0,75.0,2,194,0.0,103.0,97.0
123128784.0,6,47,3102,23,1518,5135440.045454546,66.0,66.0,24,1584,5341455.130434782,66.0,66.0
1722596.0,6,23,6507,12,1529,156599.63636363635,357.0,127.41666666666669,11,4978,141523.1,1510.0,452.54545454545456
284619.0,17,2,363,1,79,0.0,79.0,79.0,1,284,0.0,284.0,284.0
6670.0,17,2,582,1,83,0.0,83.0,83.0,1,499,0.0,499.0,499.0
2364.0,17,4,344,2,150,0.0,75.0,75.0,2,194,0.0,103.0,97.0
46324.0,6,14,4740,7,653,7598.0,249.0,93.28571428571428,7,4087,7327.666666666667,1514.0,583.8571428571429
120323921.0,6,264,30128,132,9008,912218.1145038168,140.0,68.24242424242425,132,21120,912529.4427480916,284.0,160.0
39506.0,6,14,4740,7,653,6364.833333333333,249.0,93.28571428571428,7,4087,5883.333333333333,1514.0,583.8571428571429
114416308.0,6,212,23884,106,16666,1087629.2761904765,284.0,157.2264150943396,106,7218,1087628.5714285714,140.0,68.09433962264151
303913.0,6,6,412,4,272,101304.33333333331,74.0,68.0,2,140,0.0,74.0,70.0
44828.0,6,14,4740,7,653,7100.0,249.0,93.28571428571428,7,4087,6234.0,1514.0,583.8571428571429
10486296.0,6,7,478,4,272,3448649.6666666665,74.0,68.0,3,206,5172901.5,74.0,68.66666666666667
324.0,17,2,174,1,79,0.0,79.0,79.0,1,95,0.0,95.0,95.0
90093887.0,6,11,1644,4,816,30030479.33333333,204.0,204.0,7,828,15015229.833333334,188.0,118.28571428571428
206168.0,6,3,426,2,280,0.0,214.0,140.0,1,146,0.0,146.0,146.0
55463.0,6,14,4740,7,653,8070.166666666667,249.0,93.28571428571428,7,4087,8845.666666666666,1514.0,583.8571428571429
838357.0,6,9,1096,6,625,167671.4,287.0,104.16666666666669,3,471,282800.5,331.0,157.0
23925.0,6,11,1133,6,602,3873.4,264.0,100.33333333333331,5,531,5507.5,259.0,106.2
135136038.0,17,6,1146,6,1146,27027207.6,191.0,191.0,0,0,0.0,0.0,0.0
18426.0,6,10,2032,5,524,4277.0,252.0,104.8,5,1508,4041.5,1236.0,301.6
1047009.0,6,13,1386,7,789,174501.50000000003,253.0,112.71428571428572,6,597,208593.2,259.0,99.5
206318.0,6,3,426,2,280,0.0,214.0,140.0,1,146,0.0,146.0,146.0
120000073.0,6,25,1924,14,1084,9230774.846153846,95.0,77.42857142857143,11,840,9181578.2,95.0,76.36363636363636
108107567.0,17,5,1005,5,1005,27026891.75,201.0,201.0,0,0,0.0,0.0,0.0
196955.0,17,2,180,1,90,0.0,90.0,90.0,1,90,0.0,90.0,90.0
28819.0,6,10,2032,5,524,6830.25,252.0,104.8,5,1508,6406.25,1236.0,301.6
120011932.0,17,29,13785,29,13785,4286140.428571428,501.0,475.3448275862069,0,0,0.0,0.0,0.0
303850.0,6,6,412,4,272,101283.33333333331,74.0,68.0,2,140,0.0,74.0,70.0
207146.0,17,2,762,2,762,0.0,381.0,381.0,0,0,0.0,0.0,0.0
10799.0,6,10,1975,5,467,2356.0,195.0,93.4,5,1508,2270.5,1236.0,301.6
6698.0,17,2,582,1,83,0.0,83.0,83.0,1,499,0.0,499.0,499.0
108088646.0,17,5,955,5,955,27022161.5,191.0,191.0,0,0,0.0,0.0,0.0
29111591.0,6,26,7627,14,3735,211269.92307692303,1514.0,266.7857142857143,12,3892,2626838.8181818184,1514.0,324.3333333333333
64908831.00000001,17,13,3085,13,3085,5409069.25,313.0,237.30769230769232,0,0,0.0,0.0,0.0
119847.0,17,2,180,1,70,0.0,70.0,70.0,1,110,0.0,110.0,110.0
90249309.0,6,14,2102,8,1016,12892758.42857143,188.0,127.0,6,1086,18017836.8,204.0,181.0
153439.0,17,2,180,1,90,0.0,90.0,90.0,1,90,0.0,90.0,90.0
300685.0,6,6,412,4,272,100228.33333333331,74.0,68.0,2,140,0.0,74.0,70.0
65017.00000000001,6,10,2032,5,524,15162.5,252.0,104.8,5,1508,15917.25,1236.0,301.6
209532.0,17,2,180,1,90,0.0,90.0,90.0,1,90,0.0,90.0,90.0
90094305.0,6,11,1644,4,816,30030471.33333333,204.0,204.0,7,828,15015331.166666666,188.0,118.28571428571428
270724.0,6,10,1221,6,636,54144.8,298.0,106.0,4,585,84529.66666666667,379.0,146.25
2055.0,17,4,344,2,150,0.0,75.0,75.0,2,194,0.0,103.0,97.0
109793633.0,6,31,2166,16,1149,7305174.733333333,123.0,71.8125,15,1017,7826970.071428572,123.0,67.8
340294.0,6,3,204,1,68,0.0,68.0,68.0,2,136,0.0,70.0,68.0
135130394.0,17,6,1146,6,1146,27026078.8,191.0,191.0,0,0,0.0,0.0,0.0
108073875.0,17,5,1005,5,1005,27018468.75,201.0,201.0,0,0,0.0,0.0,0.0
105428629.0,6,44,2904,22,1452,5020410.904761905,66.0,66.0,22,1452,5007298.19047619,66.0,66.0
206091.0,17,2,180,1,90,0.0,90.0,90.0,1,90,0.0,90.0,90.0
13609975.0,6,20,1607,10,975,1479120.5555555555,315.0,97.5,10,632,1479089.2222222222,78.0,63.2
120031235.0,17,28,13364,28,13364,4445601.296296297,501.0,477.2857142857143,0,0,0.0,0.0,0.0
2377.0,17,4,344,2,150,0.0,75.0,75.0,2,194,0.0,103.0,97.0
2051869.0,17,8,1640,4,312,683836.3333333333,78.0,78.0,4,1328,683817.3333333334,332.0,332.0
1187912.0,6,13,3010,8,2382,169701.7142857143,1514.0,297.75,5,628,228037.25,331.0,125.6
205793.0,17,2,180,1,90,0.0,90.0,90.0,1,90,0.0,90.0,90.0
61533.0,6,14,4740,7,653,10055.666666666666,249.0,93.28571428571428,7,4087,9298.0,1514.0,583.8571428571429
871876.0,6,10,1333,6,796,174375.2,458.0,132.66666666666666,4,537,198784.3333333333,331.0,134.25
120009772.0,17,29,13785,29,13785,4286063.285714285,501.0,475.3448275862069,0,0,0.0,0.0,0.0
98354966.0,6,34,2482,17,1288,6133694.4375,139.0,75.76470588235294,17,1194,6133695.75,123.0,70.23529411764706
103018.0,17,2,286,2,286,0.0,143.0,143.0,0,0,0.0,0.0,0.0
232402.0,6,3,373,2,238,0.0,172.0,119.0,1,135,0.0,135.0,135.0
36768.0,6,10,2032,5,524,8562.25,252.0,104.8,5,1508,8938.25,1236.0,301.6
101059064.0,6,189,21286,95,6492,1075096.425531915,140.0,68.33684210526316,94,14794,1075625.9892473118,284.0,157.38297872340425
24336.0,6,10,2032,5,524,5841.0,252.0,104.8,5,1508,5513.75,1236.0,301.6
120122052.0,6,15,2428,9,1204,15015256.5,188.0,133.77777777777777,6,1224,18074180.6,204.0,204.0
205551.0,17,2,180,1,90,0.0,90.0,90.0,1,90,0.0,90.0,90.0
29692384.0,6,26,7627,14,3735,189616.84615384616,1514.0,266.7857142857143,12,3892,2679734.0,1514.0,324.3333333333333
98066089.0,6,26,1762,13,922,8154189.25,139.0,70.92307692307692,13,840,8154192.083333333,123.0,64.61538461538461
108104666.0,17,5,1005,5,1005,27026166.5,201.0,201.0,0,0,0.0,0.0,0.0
0.0,6,1,54,0,0,0.0,0.0,0.0,1,54,0.0,54.0,54.0
23533.0,6,14,4740,7,653,3657.3333333333335,249.0,93.28571428571428,7,4087,2694.6666666666665,1514.0,583.8571428571429
111174.0,17,2,286,2,286,0.0,143.0,143.0,0,0,0.0,0.0,0.0
5633785.0,6,5,336,2,134,0.0,68.0,67.0,3,202,1528413.0,70.0,67.33333333333333
2477704.0,6,2,132,1,66,0.0,66.0,66.0,1,66,0.0,66.0,66.0
135128262.0,17,6,1206,6,1206,27025652.4,201.0,201.0,0,0,0.0,0.0,0.0
2495470.0,6,19,6869,10,1501,277274.44444444444,408.0,150.1,9,5368,264985.125,1514.0,596.4444444444445
153531.0,17,2,180,1,90,0.0,90.0,90.0,1,90,0.0,90.0,90.0
99396363.0,17,12,778,6,389,19801534.2,174.0,64.83333333333333,6,389,19800182.2,174.0,64.83333333333333
30864.0,6,14,4740,7,653,4525.833333333333,249.0,93.28571428571428,7,4087,4923.333333333333,1514.0,583.8571428571429
784.0,17,4,438,2,148,0.0,74.0,74.0,2,290,0.0,147.0,145.0
108086668.0,17,5,1005,5,1005,27021667.0,201.0,201.0,0,0,0.0,0.0,0.0
45477.0,6,10,2032,5,524,11045.5,252.0,104.8,5,1508,11097.25,1236.0,301.6
131756.0,17,4,1400,4,1400,43918.66666666666,350.0,350.0,0,0,0.0,0.0,0.0
135135457.0,17,6,1146,6,1146,27027091.4,191.0,191.0,0,0,0.0,0.0,0.0
216447.0,17,2,180,1,90,0.0,90.0,90.0,1,90,0.0,90.0,90.0
25372.0,6,14,4740,7,653,4029.0,249.0,93.28571428571428,7,4087,4071.0,1514.0,583.8571428571429
46866.0,6,14,4740,7,653,7617.333333333333,249.0,93.28571428571428,7,4087,7326.0,1514.0,583.8571428571429
119153582.0,17,16,1212,8,606,17000143.85714286,174.0,75.75,8,606,17003280.14285714,174.0,75.75
68722597.0,6,6,402,3,202,1521435.5,70.0,67.33333333333333,3,200,32991765.5,68.0,66.66666666666667
2594074.0,6,2,132,1,66,0.0,66.0,66.0,1,66,0.0,66.0,66.0
218477.0,6,3,426,2,280,0.0,214.0,140.0,1,146,0.0,146.0,146.0
304195.0,6,6,412,4,272,101398.33333333331,74.0,68.0,2,140,0.0,74.0,70.0
2405.0,17,4,344,2,150,0.0,75.0,75.0,2,194,0.0,103.0,97.0
20427.0,6,14,4740,7,653,3273.6666666666665,249.0,93.28571428571428,7,4087,3269.5,1514.0,583.8571428571429
120561.0,17,2,180,1,70,0.0,70.0,70.0,1,110,0.0,110.0,110.0
120129040.0,6,14,2224,9,1204,15016130.0,188.0,133.77777777777777,5,1020,22521226.0,204.0,204.0
7820078.0,17,8,1256,4,306,2606582.0,89.0,76.5,4,950,2605442.0,443.0,237.5
209541.0,17,2,180,1,90,0.0,90.0,90.0,1,90,0.0,90.0,90.0
119736271.0,17,35,16705,35,16705,3521655.029411765,501.0,477.2857142857143,0,0,0.0,0.0,0.0
10791.0,17,3,1026,3,1026,5395.5,342.0,342.0,0,0,0.0,0.0,0.0
90259752.0,6,12,1832,8,1016,12894250.285714284,188.0,127.0,4,816,30032309.0,204.0,204.0
108129009.0,17,5,955,5,955,27032252.25,191.0,191.0,0,0,0.0,0.0,0.0
3058441.0,6,3,1604,1,753,0.0,753.0,753.0,2,851,0.0,785.0,425.5
1739934.0,17,3,1026,3,1026,869967.0,342.0,342.0,0,0,0.0,0.0,0.0
45246.0,6,14,4740,7,653,7362.0,249.0,93.28571428571428,7,4087,7373.5,1514.0,583.8571428571429
107797968.0,6,211,23712,106,7292,1026647.3142857144,140.0,68.79245283018868,105,16420,1026601.1826923076,284.0,156.38095238095238
5284.0,17,2,180,1,90,0.0,90.0,90.0,1,90,0.0,90.0,90.0
355.0,17,2,267,1,83,0.0,83.0,83.0,1,184,0.0,184.0,184.0
24025237.0,17,3,1026,3,1026,12012618.5,342.0,342.0,0,0,0.0,0.0,0.0
24078613.0,17,3,1034,2,684,0.0,342.0,342.0,1,350,0.0,350.0,350.0
117402151.0,6,221,24834,111,7560,1067292.2818181815,140.0,68.10810810810811,110,17274,1068632.4403669725,284.0,157.03636363636363
837.0,17,4,438,2,148,0.0,74.0,74.0,2,290,0.0,147.0,145.0
1035804.0,6,11,1134,6,558,207160.8,220.0,93.0,5,576,257919.0,304.0,115.2
153517.0,17,2,180,1,90,0.0,90.0,90.0,1,90,0.0,90.0,90.0
108105148.0,17,5,1005,5,1005,27026287.0,201.0,201.0,0,0,0.0,0.0,0.0
3015915.0,6,11,2106,6,598,602853.0,252.0,99.66666666666669,5,1508,3693.5,1236.0,301.6
93486.0,6,14,4740,7,653,14984.333333333334,249.0,93.28571428571428,7,4087,15134.333333333334,1514.0,583.8571428571429
38718.0,6,14,4740,7,653,6276.0,249.0,93.28571428571428,7,4087,5532.666666666667,1514.0,583.8571428571429
34661.0,6,10,2032,5,524,8152.0,252.0,104.8,5,1508,8428.5,1236.0,301.6
120198688.0,6,606,75846,303,55626,397290.88410596026,390.0,183.5841584158416,303,20220,397292.26490066224,140.0,66.73267326732673
90355009.0,6,16,1192,8,596,12901766.857142856,95.0,74.5,8,596,12907334.0,95.0,74.5
1905073.0,17,6,1230,3,234,952350.5,78.0,78.0,3,996,952333.0,332.0,332.0
126012650.0,17,15,907,8,475,18001807.14285714,174.0,59.375,7,432,17666822.166666668,174.0,61.71428571428572
254882.0,6,12,1373,7,714,42480.333333333336,298.0,102.0,5,659,59385.5,379.0,131.8
29144.0,6,10,2032,5,524,6937.75,252.0,104.8,5,1508,6699.25,1236.0,301.6
2800645.0,6,2,132,1,66,0.0,66.0,66.0,1,66,0.0,66.0,66.0
105879.0,17,2,286,2,286,0.0,143.0,143.0,0,0,0.0,0.0,0.0
209629.0,17,2,180,1,90,0.0,90.0,90.0,1,90,0.0,90.0,90.0
313708.0,17,4,1400,4,1400,104569.33333333331,350.0,350.0,0,0,0.0,0.0,0.0
119976.0,17,2,180,1,70,0.0,70.0,70.0,1,110,0.0,110.0,110.0
220731.0,17,2,180,1,90,0.0,90.0,90.0,1,90,0.0,90.0,90.0
1176086.0,6,13,3020,8,2392,168012.2857142857,1514.0,299.0,5,628,224506.25,331.0,125.6
442129.0,17,2,363,1,79,0.0,79.0,79.0,1,284,0.0,284.0,284.0
90022218.0,17,28,13364,28,13364,3334156.222222222,501.0,477.2857142857143,0,0,0.0,0.0,0.0
103035869.0,6,191,21620,96,6558,1084588.0947368422,140.0,68.3125,95,15062,1091074.8404255318,284.0,158.54736842105262
2372.0,17,4,344,2,150,0.0,75.0,75.0,2,194,0.0,103.0,97.0
108093835.0,17,5,1005,5,1005,27023458.75,201.0,201.0,0,0,0.0,0.0,0.0
143898.0,17,2,180,1,90,0.0,90.0,90.0,1,90,0.0,90.0,90.0
196878.0,17,2,180,1,90,0.0,90.0,90.0,1,90,0.0,90.0,90.0
135106421.0,17,6,1146,6,1146,27021284.2,191.0,191.0,0,0,0.0,0.0,0.0
90045963.0,17,28,13364,28,13364,3335035.6666666665,501.0,477.2857142857143,0,0,0.0,0.0,0.0
199719.0,17,4,6056,4,6056,66573.0,1514.0,1514.0,0,0,0.0,0.0,0.0
206735.0,6,3,426,2,280,0.0,214.0,140.0,1,146,0.0,146.0,146.0
9022.0,17,2,582,1,83,0.0,83.0,83.0,1,499,0.0,499.0,499.0
119374033.0,17,35,16705,35,16705,3511000.970588235,501.0,477.2857142857143,0,0,0.0,0.0,0.0
113043341.0,6,16,2496,16,2496,7536222.733333333,156.0,156.0,0,0,0.0,0.0,0.0
132246.0,6,3,337,2,214,0.0,160.0,107.0,1,123,0.0,123.0,123.0
298974.0,6,6,412,4,272,99658.0,74.0,68.0,2,140,0.0,74.0,70.0
120126399.0,6,14,2240,6,1224,24025279.8,204.0,204.0,8,1016,17098699.0,188.0,127.0
29382.0,6,10,2032,5,524,7103.75,252.0,104.8,5,1508,7062.0,1236.0,301.6
204511.0,17,2,180,1,90,0.0,90.0,90.0,1,90,0.0,90.0,90.0
302298.0,6,6,412,4,272,100766.0,74.0,68.0,2,140,0.0,74.0,70.0
140996.0,6,2,132,1,66,0.0,66.0,66.0,1,66,0.0,66.0,66.0
146092.0,6,3,337,2,214,0.0,160.0,107.0,1,123,0.0,123.0,123.0
118295802.0,6,28,2127,13,989,9857983.5,95.0,76.07692307692308,15,1138,8434284.5,95.0,75.86666666666666
197057.0,17,2,180,1,90,0.0,90.0,90.0,1,90,0.0,90.0,90.0
119641204.0,6,294,33702,147,23704,817985.5753424658,300.0,161.2517006802721,147,9998,817985.6712328767,140.0,68.01360544217687
52596.0,6,14,4740,7,653,7990.166666666667,249.0,93.28571428571428,7,4087,8542.833333333334,1514.0,583.8571428571429
103583170.0,6,43,2838,22,1452,4932519.714285715,66.0,66.0,21,1386,5143842.3,66.0,66.0
28159.0,6,11,2098,6,590,5282.8,252.0,98.33333333333331,5,1508,6329.25,1236.0,301.6
120124972.0,6,16,2490,10,1392,13347219.111111112,188.0,139.2,6,1098,18102467.2,204.0,183.0
120340934.0,6,233,26372,117,18420,1037421.8448275862,284.0,157.43589743589743,116,7952,1037432.4,140.0,68.55172413793103
120024565.0,17,28,13364,28,13364,4445354.259259259,501.0,477.2857142857143,0,0,0.0,0.0,0.0
10488.0,17,4,823,2,163,0.0,89.0,81.5,2,660,0.0,443.0,330.0
146974.0,6,3,373,2,238,0.0,172.0,119.0,1,135,0.0,135.0,135.0
147218.0,6,3,373,2,238,0.0,172.0,119.0,1,135,0.0,135.0,135.0
10478150.0,6,7,478,4,272,3447374.333333333,74.0,68.0,3,206,5170958.0,74.0,68.66666666666667
92016253.0,6,38,2508,19,1254,5111997.166666667,66.0,66.0,19,1254,5111999.388888889,66.0,66.0
756.0,17,4,438,2,148,0.0,74.0,74.0,2,290,0.0,147.0,145.0
2799083.0,6,2,132,1,66,0.0,66.0,66.0,1,66,0.0,66.0,66.0
135133858.0,17,6,1146,6,1146,27026771.6,191.0,191.0,0,0,0.0,0.0,0.0
216899.0,6,3,426,2,280,0.0,214.0,140.0,1,146,0.0,146.0,146.0
218049.0,6,3,426,2,280,0.0,214.0,140.0,1,146,0.0,146.0,146.0
274145.0,6,10,1221,6,636,54829.0,298.0,106.0,4,585,85619.66666666667,379.0,146.25
254033.0,6,3,337,2,214,0.0,160.0,107.0,1,123,0.0,123.0,123.0
14157.0,6,12,1393,6,796,2698.4,271.0,132.66666666666666,6,597,2559.2,259.0,99.5
3914830.0,6,174,143021,99,133757,39947.24489795919,1510.0,1351.080808080808,75,9264,48717.58108108108,1510.0,123.52
53084.0,6,14,4740,7,653,7651.666666666667,249.0,93.28571428571428,7,4087,7323.333333333333,1514.0,583.8571428571429
218009.0,6,3,426,2,280,0.0,214.0,140.0,1,146,0.0,146.0,146.0
298093.0,6,6,412,4,272,99364.33333333331,74.0,68.0,2,140,0.0,74.0,70.0
157143.0,6,3,337,2,214,0.0,160.0,107.0,1,123,0.0,123.0,123.0
108109193.0,17,5,1005,5,1005,27027298.25,201.0,201.0,0,0,0.0,0.0,0.0
2804020.0,6,2,132,1,66,0.0,66.0,66.0,1,66,0.0,66.0,66.0
90294857.0,6,19,1436,10,745,10027339.222222222,95.0,74.5,9,691,11284686.875,95.0,76.77777777777777
135129376.0,17,6,1146,6,1146,27025875.2,191.0,191.0,0,0,0.0,0.0,0.0
0.0,6,1,172,1,172,0.0,172.0,172.0,0,0,0.0,0.0,0.0
10472524.0,6,7,478,4,272,3445320.6666666665,74.0,68.0,3,206,5167879.0,74.0,68.66666666666667
46595965.0,6,8,2113,3,960,21837024.5,826.0,320.0,5,1153,11005672.0,885.0,230.6
68069.0,6,14,4740,7,653,10256.333333333334,249.0,93.28571428571428,7,4087,6218.5,1514.0,583.8571428571429
2597442.0,6,2,132,1,66,0.0,66.0,66.0,1,66,0.0,66.0,66.0
1483415.0,17,16,1120,16,1120,98894.33333333331,70.0,70.0,0,0,0.0,0.0,0.0
51071.0,6,14,4740,7,653,7773.0,249.0,93.28571428571428,7,4087,5807.0,1514.0,583.8571428571429
108100731.0,17,5,1005,5,1005,27025182.75,201.0,201.0,0,0,0.0,0.0,0.0
590.0,17,5,550,5,550,147.5,110.0,110.0,0,0,0.0,0.0,0.0
1364900.0,6,4,276,2,128,0.0,74.0,64.0,2,148,0.0,74.0,74.0
414.0,17,2,410,1,78,0.0,78.0,78.0,1,332,0.0,332.0,332.0
4278.0,17,2,762,2,762,0.0,381.0,381.0,0,0,0.0,0.0,0.0
103375.0,17,2,286,2,286,0.0,143.0,143.0,0,0,0.0,0.0,0.0
57466.0,6,10,2032,5,524,13933.0,252.0,104.8,5,1508,11883.25,1236.0,301.6
108688886.0,6,32,2220,16,1149,7231537.733333333,123.0,71.8125,16,1071,7231530.333333333,123.0,66.9375
0.0,17,1,55,1,55,0.0,55.0,55.0,0,0,0.0,0.0,0.0
13502101.0,6,20,1607,10,975,1466182.888888889,315.0,97.5,10,632,1466152.4444444445,78.0,63.2
205782.0,17,2,180,1,90,0.0,90.0,90.0,1,90,0.0,90.0,90.0
144935.0,17,2,180,1,70,0.0,70.0,70.0,1,110,0.0,110.0,110.0
135123533.0,17,6,1146,6,1146,27024706.6,191.0,191.0,0,0,0.0,0.0,0.0
21527.0,6,14,4740,7,653,3392.1666666666665,249.0,93.28571428571428,7,4087,3446.6666666666665,1514.0,583.8571428571429
147940.0,17,2,180,1,90,0.0,90.0,90.0,1,90,0.0,90.0,90.0
4395874.0,6,19,1594,9,962,511570.25,315.0,106.88888888888889,10,632,454685.5555555556,78.0,63.2
113497061.0,6,48,3168,24,1584,4934654.826086956,66.0,66.0,24,1584,4925257.695652174,66.0,66.0
51400.0,6,14,4740,7,653,8442.166666666666,249.0,93.28571428571428,7,4087,6720.833333333333,1514.0,583.8571428571429
104000966.0,17,13,821,7,432,17333494.333333332,174.0,61.71428571428572,6,389,16801153.6,174.0,64.83333333333333
103001254.0,17,13,821,7,432,17166875.666666668,174.0,61.71428571428572,6,389,16574916.2,174.0,64.83333333333333
2321.0,17,4,344,2,150,0.0,75.0,75.0,2,194,0.0,103.0,97.0
307422.0,6,6,412,4,272,102474.0,74.0,68.0,2,140,0.0,74.0,70.0
302395.0,6,2,132,1,66,0.0,66.0,66.0,1,66,0.0,66.0,66.0
135129138.0,17,6,1206,6,1206,27025827.6,201.0,201.0,0,0,0.0,0.0,0.0
120410896.0,6,229,25928,115,18108,1056235.929824561,284.0,157.4608695652174,114,7820,1055926.8407079645,140.0,68.59649122807018
912.0,17,4,438,2,148,0.0,74.0,74.0,2,290,0.0,147.0,145.0
254919.0,6,3,337,2,214,0.0,160.0,107.0,1,123,0.0,123.0,123.0
193061.0,17,2,180,1,90,0.0,90.0,90.0,1,90,0.0,90.0,90.0
107801.0,17,2,286,2,286,0.0,143.0,143.0,0,0,0.0,0.0,0.0
146346.0,6,3,337,2,214,0.0,160.0,107.0,1,123,0.0,123.0,123.0
1159.0,17,2,762,2,762,0.0,381.0,381.0,0,0,0.0,0.0,0.0
27799.0,6,14,4740,7,653,4500.833333333333,249.0,93.28571428571428,7,4087,4473.333333333333,1514.0,583.8571428571429
321.0,17,2,166,1,75,0.0,75.0,75.0,1,91,0.0,91.0,91.0
90736900.0,6,19,1436,10,745,10078083.555555556,95.0,74.5,9,691,11340685.875,95.0,76.77777777777777
100621174.0,17,12,778,6,389,20124234.8,174.0,64.83333333333333,6,389,19936031.8,174.0,64.83333333333333
298298.0,6,6,412,4,272,99432.66666666669,74.0,68.0,2,140,0.0,74.0,70.0
120307859.0,6,223,25134,112,17512,1083854.5855855856,284.0,156.35714285714286,111,7622,1084287.2,140.0,68.66666666666667
108113490.0,17,5,955,5,955,27028372.5,191.0,191.0,0,0,0.0,0.0,0.0
10920538.0,6,8,544,4,272,3594572.333333333,74.0,68.0,4,272,3594491.6666666665,74.0,68.0
90360752.0,6,12,1848,7,828,15060125.333333334,188.0,118.28571428571428,5,1020,15083270.5,204.0,204.0
309946.0,6,6,412,4,272,103315.33333333331,74.0,68.0,2,140,0.0,74.0,70.0
120149463.0,6,14,2224,9,1204,15018682.875,188.0,133.77777777777777,5,1020,22590994.25,204.0,204.0
2761861.0,6,3,1604,2,851,0.0,785.0,425.5,1,753,0.0,753.0,753.0
26543.0,6,13,4515,6,512,5169.2,230.0,85.33333333333333,7,4003,3999.5,1514.0,571.8571428571429
153466.0,17,2,180,1,90,0.0,90.0,90.0,1,90,0.0,90.0,90.0
13615217.0,6,20,1607,10,975,1479268.2222222222,315.0,97.5,10,632,1479246.111111111,78.0,63.2
303652.0,6,2,132,1,66,0.0,66.0,66.0,1,66,0.0,66.0,66.0
120092123.0,6,17,2852,9,1836,15011515.375,204.0,204.0,8,1016,17094058.85714286,188.0,127.0
101679651.0,17,14,864,7,432,16920121.0,174.0,61.71428571428572,7,432,16846715.666666668,174.0,61.71428571428572
103541726.0,6,675,160394,333,22644,311809.4427710843,214.0,68.0,342,137750,301513.34017595305,1514.0,402.77777777777777
2336.0,17,4,344,2,150,0.0,75.0,75.0,2,194,0.0,103.0,97.0
2598227.0,6,2,132,1,66,0.0,66.0,66.0,1,66,0.0,66.0,66.0
201592.0,17,2,762,2,762,0.0,381.0,381.0,0,0,0.0,0.0,0.0
120119924.0,6,13,2020,9,1204,15014990.5,188.0,133.77777777777777,4,816,30029911.666666668,204.0,204.0
964.0,17,4,438,2,148,0.0,74.0,74.0,2,290,0.0,147.0,145.0
102784.0,17,2,286,2,286,0.0,143.0,143.0,0,0,0.0,0.0,0.0
37365.0,6,14,4740,7,653,6054.666666666667,249.0,93.28571428571428,7,4087,5353.5,1514.0,583.8571428571429
31658.0,6,14,4740,7,653,5155.0,249.0,93.28571428571428,7,4087,5135.833333333333,1514.0,583.8571428571429
629467.0,17,2,346,1,78,0.0,78.0,78.0,1,268,0.0,268.0,268.0
44889.0,6,10,2032,5,524,10989.0,252.0,104.8,5,1508,10178.75,1236.0,301.6
3183941.0,6,18,1495,9,921,358275.25,315.0,102.33333333333331,9,574,357696.875,78.0,63.77777777777778
32947.0,6,13,1386,7,789,4973.5,253.0,112.71428571428572,6,597,4851.2,259.0,99.5
2142.0,17,2,180,1,90,0.0,90.0,90.0,1,90,0.0,90.0,90.0
121356670.0,6,207,23486,104,16392,1178220.0970873786,284.0,157.6153846153846,103,7094,1135824.1274509805,140.0,68.87378640776699
96203877.0,17,12,778,6,389,19200170.4,174.0,64.83333333333333,6,389,19200979.4,174.0,64.83333333333333
29329.0,6,14,4740,7,653,4430.333333333333,249.0,93.28571428571428,7,4087,4261.166666666667,1514.0,583.8571428571429
135129146.0,17,6,1206,6,1206,27025829.2,201.0,201.0,0,0,0.0,0.0,0.0
147936.0,17,2,180,1,90,0.0,90.0,90.0,1,90,0.0,90.0,90.0
1307249.0,6,4,264,2,132,0.0,66.0,66.0,2,132,0.0,66.0,66.0
49896.0,6,14,4740,7,653,8189.0,249.0,93.28571428571428,7,4087,7191.0,1514.0,583.8571428571429
2442.0,17,4,344,2,150,0.0,75.0,75.0,2,194,0.0,103.0,97.0
36542.0,6,14,4740,7,653,5591.833333333333,249.0,93.28571428571428,7,4087,5200.0,1514.0,583.8571428571429
206010.0,17,2,180,1,90,0.0,90.0,90.0,1,90,0.0,90.0,90.0
120256445.0,6,256,29600,128,8670,940345.3937007874,140.0,67.734375,128,20930,940441.1732283464,284.0,163.515625
1815.0,17,2,180,1,90,0.0,90.0,90.0,1,90,0.0,90.0,90.0
2800767.0,6,2,132,1,66,0.0,66.0,66.0,1,66,0.0,66.0,66.0
100363293.0,17,12,778,6,389,20000879.4,174.0,64.83333333333333,6,389,20000159.6,174.0,64.83333333333333
305397.0,6,6,412,4,272,101799.0,74.0,68.0,2,140,0.0,74.0,70.0
204847.0,17,2,180,1,90,0.0,90.0,90.0,1,90,0.0,90.0,90.0
10521863.0,6,7,478,4,272,3461508.333333333,74.0,68.0,3,206,5192113.5,74.0,68.66666666666667
297144.0,6,6,412,4,272,99048.0,74.0,68.0,2,140,0.0,74.0,70.0
120130165.0,6,230,26190,115,7812,1046626.8245614036,140.0,67.9304347826087,115,18378,1037508.0263157894,336.0,159.80869565217392
27128.0,6,14,4740,7,653,4411.0,249.0,93.28571428571428,7,4087,2643.0,1514.0,583.8571428571429
293.0,17,2,164,1,82,0.0,82.0,82.0,1,82,0.0,82.0,82.0
3441193.0,6,171,138840,97,129654,35845.760416666664,1510.0,1336.639175257732,74,9186,42855.38356164384,1510.0,124.13513513513512
107325.0,17,2,286,2,286,0.0,143.0,143.0,0,0,0.0,0.0,0.0
122975242.0,6,48,3168,24,1584,5113735.652173913,66.0,66.0,24,1584,5153335.782608695,66.0,66.0
28562.0,6,10,2032,5,524,5834.25,252.0,104.8,5,1508,6882.25,1236.0,301.6
316344.0,17,4,1400,4,1400,105448.0,350.0,350.0,0,0,0.0,0.0,0.0
125386900.0,6,37,2656,19,1408,6965938.888888889,139.0,74.10526315789474,18,1248,6775600.176470588,123.0,69.33333333333333
99699.0,17,2,762,2,762,0.0,381.0,381.0,0,0,0.0,0.0,0.0
72353.0,6,14,4740,7,653,11477.0,249.0,93.28571428571428,7,4087,11916.666666666666,1514.0,583.8571428571429
51433.0,6,12,1320,6,723,8768.2,253.0,120.5,6,597,8186.2,259.0,99.5
90294124.0,6,16,1192,8,596,12892629.285714284,95.0,74.5,8,596,12897719.57142857,95.0,74.5
47134.0,6,14,4740,7,653,6649.166666666667,249.0,93.28571428571428,7,4087,6411.0,1514.0,583.8571428571429
103791.0,17,2,286,2,286,0.0,143.0,143.0,0,0,0.0,0.0,0.0
90475517.0,6,16,1233,8,596,12890883.285714284,95.0,74.5,8,637,12923597.0,95.0,79.625
135130475.0,17,6,1146,6,1146,27026095.0,191.0,191.0,0,0,0.0,0.0,0.0
90959146.0,6,21,1585,11,840,9095232.6,95.0,76.36363636363636,10,745,10103634.111111112,95.0,74.5
2363.0,17,4,344,2,150,0.0,75.0,75.0,2,194,0.0,103.0,97.0
107114.0,17,2,762,2,762,0.0,381.0,381.0,0,0,0.0,0.0,0.0
103501.0,17,2,286,2,286,0.0,143.0,143.0,0,0,0.0,0.0,0.0
90008201.0,17,28,13364,28,13364,3333637.074074074,501.0,477.2857142857143,0,0,0.0,0.0,0.0
116451.0,17,6,1230,3,234,58035.5,78.0,78.0,3,996,58021.5,332.0,332.0
209702.0,17,2,180,1,90,0.0,90.0,90.0,1,90,0.0,90.0,90.0
437716.0,6,11,1021,6,444,58768.0,162.0,74.0,5,577,73266.25,349.0,115.4
62687.99999999999,6,14,4740,7,653,10077.833333333334,249.0,93.28571428571428,7,4087,9657.833333333334,1514.0,583.8571428571429
40210.0,6,14,4740,7,653,6511.833333333333,249.0,93.28571428571428,7,4087,5139.666666666667,1514.0,583.8571428571429
897402.0,17,2,246,1,76,0.0,76.0,76.0,1,170,0.0,170.0,170.0
309543.0,17,4,1400,4,1400,103181.0,350.0,350.0,0,0,0.0,0.0,0.0
90031741.0,17,28,13364,28,13364,3334508.925925926,501.0,477.2857142857143,0,0,0.0,0.0,0.0
120121461.0,6,14,2240,8,1016,17136952.0,188.0,127.0,6,1224,18018827.2,204.0,204.0
110545.0,17,2,286,2,286,0.0,143.0,143.0,0,0,0.0,0.0,0.0
52298.0,17,2,180,1,90,0.0,90.0,90.0,1,90,0.0,90.0,90.0
107838551.0,6,28,1860,14,966,8278669.230769231,123.0,69.0,14,894,8278640.461538462,123.0,63.85714285714285
120018879.0,17,29,13785,29,13785,4286388.535714285,501.0,475.3448275862069,0,0,0.0,0.0,0.0
338.0,17,2,166,1,75,0.0,75.0,75.0,1,91,0.0,91.0,91.0
289478.0,6,10,1221,6,636,57895.6,298.0,106.0,4,585,77974.66666666667,379.0,146.25
90101964.0,6,11,1644,4,816,30033185.666666668,204.0,204.0,7,828,15016560.0,188.0,118.28571428571428
113687.0,6,14,4740,7,653,18824.166666666668,249.0,93.28571428571428,7,4087,18695.5,1514.0,583.8571428571429
120028312.0,17,29,13785,29,13785,4286725.428571428,501.0,475.3448275862069,0,0,0.0,0.0,0.0
298353.0,6,6,412,4,272,99451.0,74.0,68.0,2,140,0.0,74.0,70.0
91104815.0,6,174,19650,87,13686,1056842.7093023255,284.0,157.31034482758622,87,5964,1056841.8720930233,140.0,68.55172413793103
217893.0,6,3,426,2,280,0.0,214.0,140.0,1,146,0.0,146.0,146.0
90298168.0,6,21,1585,11,840,9025263.6,95.0,76.36363636363636,10,745,9950838.444444444,95.0,74.5
9198.0,17,2,582,1,83,0.0,83.0,83.0,1,499,0.0,499.0,499.0
135136010.0,17,6,1146,6,1146,27027202.0,191.0,191.0,0,0,0.0,0.0,0.0
1157067.0,6,13,3010,8,2382,165295.2857142857,1514.0,297.75,5,628,221119.0,331.0,125.6
153457.0,17,2,180,1,90,0.0,90.0,90.0,1,90,0.0,90.0,90.0
308.0,17,2,168,1,76,0.0,76.0,76.0,1,92,0.0,92.0,92.0
120097431.0,6,13,2036,5,1020,30024357.75,204.0,204.0,8,1016,17132151.285714287,188.0,127.0
10479223.0,6,7,478,4,272,3447629.0,74.0,68.0,3,206,5171355.5,74.0,68.66666666666667
35674.0,6,14,4740,7,653,5785.666666666667,249.0,93.28571428571428,7,4087,5550.0,1514.0,583.8571428571429
371.0,17,2,267,1,83,0.0,83.0,83.0,1,184,0.0,184.0,184.0
3102.0,17,4,344,2,150,0.0,75.0,75.0,2,194,0.0,103.0,97.0
108196.0,17,2,286,2,286,0.0,143.0,143.0,0,0,0.0,0.0,0.0
21840.0,6,14,4740,7,653,3516.1666666666665,249.0,93.28571428571428,7,4087,3192.6666666666665,1514.0,583.8571428571429
362.0,17,2,166,1,75,0.0,75.0,75.0,1,91,0.0,91.0,91.0
107494.0,17,2,286,2,286,0.0,143.0,143.0,0,0,0.0,0.0,0.0
209568.0,17,2,180,1,90,0.0,90.0,90.0,1,90,0.0,90.0,90.0
9393.0,17,2,582,1,83,0.0,83.0,83.0,1,499,0.0,499.0,499.0
308212.0,6,12,1373,7,714,51368.66666666666,298.0,102.0,5,659,72969.75,379.0,131.8
116226048.0,6,33,2412,17,1272,7264128.0,123.0,74.82352941176471,16,1140,7733969.266666667,123.0,71.25
96101133.0,6,408,49108,204,13686,473357.37438423646,140.0,67.08823529411765,204,35422,472804.630541872,406.0,173.63725490196077
570.0,17,2,508,2,508,0.0,257.0,254.0,0,0,0.0,0.0,0.0
1307167.0,6,4,264,2,132,0.0,66.0,66.0,2,132,0.0,66.0,66.0
15897.000000000002,6,14,4740,7,653,2440.5,249.0,93.28571428571428,7,4087,2515.5,1514.0,583.8571428571429
108109453.0,17,5,1005,5,1005,27027363.25,201.0,201.0,0,0,0.0,0.0,0.0
90092197.0,6,11,1644,4,816,30030257.0,204.0,204.0,7,828,15014980.333333334,188.0,118.28571428571428
4405554.0,6,26,5154,14,2630,338888.76923076925,580.0,187.8571428571429,12,2524,380704.1818181818,732.0,210.3333333333333
100288334.0,17,14,864,7,432,16666804.166666666,174.0,61.71428571428572,7,432,16667614.0,174.0,61.71428571428572
2779760.0,6,2,132,1,66,0.0,66.0,66.0,1,66,0.0,66.0,66.0
44451.0,6,14,4740,7,653,7094.333333333333,249.0,93.28571428571428,7,4087,6041.166666666667,1514.0,583.8571428571429
11754516.0,17,4,1368,4,1368,3918172.0,342.0,342.0,0,0,0.0,0.0,0.0
104429.0,17,2,286,2,286,0.0,143.0,143.0,0,0,0.0,0.0,0.0
135134713.0,17,6,1146,6,1146,27026942.6,191.0,191.0,0,0,0.0,0.0,0.0
306425.0,6,6,412,4,272,102141.66666666669,74.0,68.0,2,140,0.0,74.0,70.0
99668454.0,6,24,1569,12,786,9060768.545454543,123.0,65.5,12,783,9042139.454545457,123.0,65.25
207730.0,6,3,426,2,280,0.0,214.0,140.0,1,146,0.0,146.0,146.0
16046.000000000002,6,14,4740,7,653,2419.0,249.0,93.28571428571428,7,4087,2541.833333333333,1514.0,583.8571428571429
3186.0,17,2,359,1,75,0.0,75.0,75.0,1,284,0.0,284.0,284.0
9669.0,17,2,571,1,86,0.0,86.0,86.0,1,485,0.0,485.0,485.0
15162.0,17,2,582,1,83,0.0,83.0,83.0,1,499,0.0,499.0,499.0
110565983.0,6,324,37518,162,26604,685408.0621118012,390.0,164.22222222222223,162,10914,685408.0559006211,140.0,67.37037037037037
3127742.0,6,3,1604,2,851,0.0,785.0,425.5,1,753,0.0,753.0,753.0
94862191.0,6,30,2122,15,1105,6760460.571428572,139.0,73.66666666666667,15,1017,6760466.857142857,123.0,67.8
2583800.0,6,2,132,1,66,0.0,66.0,66.0,1,66,0.0,66.0,66.0
204380.0,17,2,762,2,762,0.0,381.0,381.0,0,0,0.0,0.0,0.0
26929058.0,17,5,1710,5,1710,6732264.5,342.0,342.0,0,0,0.0,0.0,0.0
2223.0,17,4,344,2,150,0.0,75.0,75.0,2,194,0.0,103.0,97.0
2569559.0,6,2,132,1,66,0.0,66.0,66.0,1,66,0.0,66.0,66.0
113618074.0,6,46,3036,23,1518,5150437.181818182,66.0,66.0,23,1518,5150442.2727272725,66.0,66.0
110050457.0,6,32,2236,16,1165,7322311.866666666,139.0,72.8125,16,1071,7322312.4,123.0,66.9375
120001592.0,6,511,93508,256,17414,470594.47843137255,214.0,68.0234375,255,76094,469270.9763779527,1514.0,298.40784313725493
105615.0,17,2,762,2,762,0.0,381.0,381.0,0,0,0.0,0.0,0.0
307288.0,6,6,412,4,272,102429.33333333331,74.0,68.0,2,140,0.0,74.0,70.0
9155.0,17,2,582,1,83,0.0,83.0,83.0,1,499,0.0,499.0,499.0
297264.0,6,6,412,4,272,99088.0,74.0,68.0,2,140,0.0,74.0,70.0
5830901.0,6,5,336,2,134,0.0,68.0,67.0,3,202,1528901.0,70.0,67.33333333333333
13453.0,6,14,4740,7,653,2131.1666666666665,249.0,93.28571428571428,7,4087,2104.333333333333,1514.0,583.8571428571429
196955.0,17,2,180,1,90,0.0,90.0,90.0,1,90,0.0,90.0,90.0
127783745.0,6,31,2034,16,1086,8518916.333333334,123.0,67.875,15,948,8398738.5,123.0,63.2
3024452.0,6,12,2172,7,664,503581.8333333333,252.0,94.85714285714286,5,1508,6851.0,1236.0,301.6
27182870.0,17,5,1710,5,1710,6795717.5,342.0,342.0,0,0,0.0,0.0,0.0
102619.0,17,2,286,2,286,0.0,143.0,143.0,0,0,0.0,0.0,0.0
147419.0,17,4,704,2,148,0.0,74.0,74.0,2,556,0.0,280.0,278.0
90036135.0,17,28,13364,28,13364,3334671.6666666665,501.0,477.2857142857143,0,0,0.0,0.0,0.0
130928.0,6,2,132,1,66,0.0,66.0,66.0,1,66,0.0,66.0,66.0
120066292.0,17,29,13785,29,13785,4288081.857142857,501.0,475.3448275862069,0,0,0.0,0.0,0.0
298323.0,6,6,412,4,272,99441.0,74.0,68.0,2,140,0.0,74.0,70.0
2478.0,17,4,344,2,150,0.0,75.0,75.0,2,194,0.0,103.0,97.0
107678.0,17,2,286,2,286,0.0,143.0,143.0,0,0,0.0,0.0,0.0
210841.0,17,2,414,1,88,0.0,88.0,88.0,1,326,0.0,326.0,326.0
32047.0,6,10,2032,5,524,7784.0,252.0,104.8,5,1508,7768.5,1236.0,301.6
121200.0,6,3,337,2,214,0.0,160.0,107.0,1,123,0.0,123.0,123.0
0.0,6,1,66,1,66,0.0,66.0,66.0,0,0,0.0,0.0,0.0
66397.0,6,10,2032,5,524,10146.5,252.0,104.8,5,1508,16342.25,1236.0,301.6
32227.0,6,10,2032,5,524,7831.5,252.0,104.8,5,1508,7516.25,1236.0,301.6
307217.0,6,6,412,4,272,102405.66666666669,74.0,68.0,2,140,0.0,74.0,70.0
207072.0,6,3,426,2,280,0.0,214.0,140.0,1,146,0.0,146.0,146.0
2632.0,17,4,344,2,150,0.0,75.0,75.0,2,194,0.0,103.0,97.0
27313588.0,17,5,1710,5,1710,6828397.0,342.0,342.0,0,0,0.0,0.0,0.0
90294060.0,6,20,1531,10,786,10026963.888888888,95.0,78.6,10,745,10001913.0,95.0,74.5
104862.0,17,2,700,2,700,0.0,350.0,350.0,0,0,0.0,0.0,0.0
254934.0,6,3,337,2,214,0.0,160.0,107.0,1,123,0.0,123.0,123.0
94448869.0,17,12,778,6,389,18800549.8,174.0,64.83333333333333,6,389,18800174.8,174.0,64.83333333333333
26515.0,6,10,2032,5,524,6424.25,252.0,104.8,5,1508,5797.0,1236.0,301.6
321432.0,6,6,412,4,272,107144.0,74.0,68.0,2,140,0.0,74.0,70.0
92795905.0,6,155,17496,78,5370,1205141.6233766233,140.0,68.84615384615384,77,12126,1207246.8684210526,284.0,157.4805194805195
2366.0,17,4,344,2,150,0.0,75.0,75.0,2,194,0.0,103.0,97.0
14337699.0,6,20,1607,10,975,1558947.7777777778,315.0,97.5,10,632,1559000.7777777778,78.0,63.2
118268204.0,6,34,2350,17,1225,7378283.125,139.0,72.05882352941177,17,1125,7378267.125,123.0,66.17647058823529
5976696.0,17,5,1710,5,1710,1494174.0,342.0,342.0,0,0,0.0,0.0,0.0
2429.0,17,4,344,2,150,0.0,75.0,75.0,2,194,0.0,103.0,97.0
19683.0,6,11,2098,6,590,3713.8,252.0,98.33333333333331,5,1508,4052.0,1236.0,301.6
90315932.0,6,20,1490,10,704,10028360.222222222,95.0,70.4,10,786,10032473.777777778,95.0,78.6
509659.0,6,5,336,2,134,0.0,68.0,67.0,3,202,191830.0,70.0,67.33333333333333
125828438.0,6,57,11766,28,5929,3560571.111111111,1514.0,211.75,29,5837,4486171.428571428,1514.0,201.27586206896552
534.0,17,2,508,2,508,0.0,257.0,254.0,0,0,0.0,0.0,0.0
101873.0,17,2,762,2,762,0.0,381.0,381.0,0,0,0.0,0.0,0.0
24208.0,6,10,2032,5,524,5810.0,252.0,104.8,5,1508,5032.75,1236.0,301.6
90530538.0,6,14,2240,8,1016,12932934.0,188.0,127.0,6,1224,18073869.2,204.0,204.0
43183.0,6,14,4740,7,653,7028.0,249.0,93.28571428571428,7,4087,5201.166666666667,1514.0,583.8571428571429
102810.0,17,2,286,2,286,0.0,143.0,143.0,0,0,0.0,0.0,0.0
103316.0,17,2,286,2,286,0.0,143.0,143.0,0,0,0.0,0.0,0.0
323.0,17,2,174,1,79,0.0,79.0,79.0,1,95,0.0,95.0,95.0
378.0,17,2,166,1,75,0.0,75.0,75.0,1,91,0.0,91.0,91.0
97901965.0,6,185,20932,93,6360,1064151.793478261,140.0,68.38709677419355,92,14572,1064415.0989010988,284.0,158.3913043478261
34111.0,6,14,4740,7,653,5563.833333333333,249.0,93.28571428571428,7,4087,5509.666666666667,1514.0,583.8571428571429
120198.0,17,2,180,1,70,0.0,70.0,70.0,1,110,0.0,110.0,110.0
90299171.0,6,21,1585,11,840,9025180.0,95.0,76.36363636363636,10,745,9998893.444444444,95.0,74.5
320953.0,17,4,1400,4,1400,106984.33333333331,350.0,350.0,0,0,0.0,0.0,0.0
23098277.0,17,3,1034,2,684,0.0,342.0,342.0,1,350,0.0,350.0,350.0
482177.0,6,5,336,2,134,0.0,68.0,67.0,3,202,191101.0,70.0,67.33333333333333
102013989.0,17,14,864,7,432,17000164.0,174.0,61.71428571428572,7,432,17001084.0,174.0,61.71428571428572
120077.0,17,2,180,1,70,0.0,70.0,70.0,1,110,0.0,110.0,110.0
146865.0,6,3,373,2,238,0.0,172.0,119.0,1,135,0.0,135.0,135.0
5005255.0,17,2,174,2,174,0.0,87.0,87.0,0,0,0.0,0.0,0.0
1484.0,17,2,762,2,762,0.0,381.0,381.0,0,0,0.0,0.0,0.0
2325.0,17,4,344,2,150,0.0,75.0,75.0,2,194,0.0,103.0,97.0
3399458.0,6,154,132292,96,124162,35783.768421052635,1510.0,1293.3541666666667,58,8130,54168.08771929824,1510.0,140.17241379310346
14311.0,6,14,4740,7,653,2123.5,249.0,93.28571428571428,7,4087,2247.0,1514.0,583.8571428571429
120174848.0,6,220,24772,110,7482,1085420.0550458715,140.0,68.01818181818182,110,17290,1094991.605504587,284.0,157.1818181818182
160271.0,6,2,128,1,74,0.0,74.0,74.0,1,54,0.0,54.0,54.0
442557.0,6,10,967,5,390,74521.5,162.0,78.0,5,577,74464.75,349.0,115.4
207560.0,6,3,426,2,280,0.0,214.0,140.0,1,146,0.0,146.0,146.0
277725.0,17,2,363,1,79,0.0,79.0,79.0,1,284,0.0,284.0,284.0
37707.0,6,14,4740,7,653,6156.833333333333,249.0,93.28571428571428,7,4087,5958.666666666667,1514.0,583.8571428571429
108103735.0,17,5,1005,5,1005,27025933.75,201.0,201.0,0,0,0.0,0.0,0.0
307585.0,6,6,412,4,272,102528.33333333331,74.0,68.0,2,140,0.0,74.0,70.0
3006582.0,6,12,2172,7,664,501097.0,252.0,94.85714285714286,5,1508,2233.25,1236.0,301.6
31777.0,6,10,2032,5,524,7721.5,252.0,104.8,5,1508,7699.0,1236.0,301.6
36315.0,6,14,4740,7,653,5625.166666666667,249.0,93.28571428571428,7,4087,5642.833333333333,1514.0,583.8571428571429
144189.0,17,2,180,1,90,0.0,90.0,90.0,1,90,0.0,90.0,90.0
120000023.0,6,28,2168,16,1274,8000001.533333333,95.0,79.625,12,894,8322027.181818182,95.0,74.5
113733636.0,6,46,3036,23,1518,5155437.636363637,66.0,66.0,23,1518,5155429.0,66.0,66.0
90977348.0,6,21,1585,11,840,9096542.7,95.0,76.36363636363636,10,745,10104520.0,95.0,74.5
90256595.0,6,14,2240,8,1016,12893799.285714284,188.0,127.0,6,1224,18018918.0,204.0,204.0
16776.0,6,11,2098,6,590,2662.4,252.0,98.33333333333331,5,1508,3937.75,1236.0,301.6
310021.0,17,4,1400,4,1400,103340.33333333331,350.0,350.0,0,0,0.0,0.0,0.0
309368.0,6,6,412,4,272,103122.66666666669,74.0,68.0,2,140,0.0,74.0,70.0
2082.0,17,4,344,2,150,0.0,75.0,75.0,2,194,0.0,103.0,97.0
40646.0,6,13,1394,7,797,6263.666666666667,253.0,113.85714285714286,6,597,6711.8,259.0,99.5
123839735.0,6,48,3168,24,1584,5027850.0869565215,66.0,66.0,24,1584,5269550.782608695,66.0,66.0
303047.0,6,6,412,4,272,101015.66666666669,74.0,68.0,2,140,0.0,74.0,70.0
1207286.0,17,5,961,3,234,603454.5,78.0,78.0,2,727,0.0,395.0,363.5
113496472.0,6,48,3168,24,1584,4934629.217391305,66.0,66.0,24,1584,4925233.260869565,66.0,66.0
37707.0,6,14,4740,7,653,5830.333333333333,249.0,93.28571428571428,7,4087,5729.833333333333,1514.0,583.8571428571429
206055.0,6,3,426,2,280,0.0,214.0,140.0,1,146,0.0,146.0,146.0
322.0,17,2,174,1,79,0.0,79.0,79.0,1,95,0.0,95.0,95.0
158011.0,17,4,1400,4,1400,52670.333333333336,350.0,350.0,0,0,0.0,0.0,0.0
113251924.0,6,46,3036,23,1518,5135440.0,66.0,66.0,23,1518,5135310.681818182,66.0,66.0
317.0,17,2,156,1,78,0.0,78.0,78.0,1,78,0.0,78.0,78.0
206863.0,6,3,426,2,280,0.0,214.0,140.0,1,146,0.0,146.0,146.0
118760384.0,6,212,23980,106,16688,1129002.4761904762,284.0,157.43396226415095,106,7292,1129003.0571428572,140.0,68.79245283018868
25501.0,6,14,4740,7,653,4123.5,249.0,93.28571428571428,7,4087,3968.0,1514.0,583.8571428571429
300369.0,6,6,412,4,272,100123.0,74.0,68.0,2,140,0.0,74.0,70.0
301533.0,6,6,412,4,272,100511.0,74.0,68.0,2,140,0.0,74.0,70.0
146064.0,6,3,337,2,214,0.0,160.0,107.0,1,123,0.0,123.0,123.0
319764.0,6,3,202,2,128,0.0,74.0,64.0,1,74,0.0,74.0,74.0
108098170.0,17,5,1005,5,1005,27024542.5,201.0,201.0,0,0,0.0,0.0,0.0
2437.0,17,4,344,2,150,0.0,75.0,75.0,2,194,0.0,103.0,97.0
90748946.0,6,19,1436,10,745,10078638.333333334,95.0,74.5,9,691,11342799.0,95.0,76.77777777777777
90068294.0,17,28,13364,28,13364,3335862.7407407407,501.0,477.2857142857143,0,0,0.0,0.0,0.0
3438.0,17,2,414,1,88,0.0,88.0,88.0,1,326,0.0,326.0,326.0
97732.0,6,14,4740,7,653,16013.833333333334,249.0,93.28571428571428,7,4087,15119.5,1514.0,583.8571428571429
100245696.0,6,180,20344,90,14170,1123896.6966292134,284.0,157.44444444444446,90,6174,1123934.8202247191,140.0,68.6
321996.0,17,4,1400,4,1400,107332.0,350.0,350.0,0,0,0.0,0.0,0.0
2420.0,17,4,344,2,150,0.0,75.0,75.0,2,194,0.0,103.0,97.0
260392.0,6,3,337,2,214,0.0,160.0,107.0,1,123,0.0,123.0,123.0
146909.0,6,3,373,2,238,0.0,172.0,119.0,1,135,0.0,135.0,135.0
31358.0,6,14,4740,7,653,5110.333333333333,249.0,93.28571428571428,7,4087,4819.0,1514.0,583.8571428571429
216771.0,6,3,426,2,280,0.0,214.0,140.0,1,146,0.0,146.0,146.0
106382404.0,6,31,2182,16,1165,7077769.933333334,139.0,72.8125,15,1017,7583326.071428572,123.0,67.8
2594213.0,6,2,132,1,66,0.0,66.0,66.0,1,66,0.0,66.0,66.0
128991422.0,6,35,2463,17,1194,7437908.5625,123.0,70.23529411764706,18,1269,7587705.0,123.0,70.5
35291.0,6,14,4740,7,653,5758.166666666667,249.0,93.28571428571428,7,4087,5263.166666666667,1514.0,583.8571428571429
114374828.0,6,218,24842,109,17426,1057034.037037037,336.0,159.87155963302752,109,7416,1057034.0277777778,140.0,68.03669724770643
228359.0,17,2,180,1,90,0.0,90.0,90.0,1,90,0.0,90.0,90.0
113107754.0,6,258,29266,129,20456,881970.578125,284.0,158.57364341085272,129,8810,882896.3828125,140.0,68.29457364341086
19749.0,17,2,539,1,86,0.0,86.0,86.0,1,453,0.0,453.0,453.0
123855.0,6,3,373,2,238,0.0,172.0,119.0,1,135,0.0,135.0,135.0
34142169.0,6,7,1874,3,887,17005388.0,753.0,295.6666666666667,4,987,11337613.333333334,785.0,246.75
241062.0,6,3,337,2,214,0.0,160.0,107.0,1,123,0.0,123.0,123.0
121163300.0,17,15,1038,8,606,17309042.85714286,174.0,75.75,7,432,17000158.666666668,174.0,61.71428571428572
135128937.0,17,6,1206,6,1206,27025787.4,201.0,201.0,0,0,0.0,0.0,0.0
196930.0,17,2,180,1,90,0.0,90.0,90.0,1,90,0.0,90.0,90.0
861190.0,6,9,1269,6,798,172238.0,460.0,133.0,3,471,292643.0,331.0,157.0
26998.0,6,14,4740,7,653,3563.333333333333,249.0,93.28571428571428,7,4087,4307.333333333333,1514.0,583.8571428571429
16039.000000000002,6,14,4740,7,653,2374.833333333333,249.0,93.28571428571428,7,4087,2537.0,1514.0,583.8571428571429
304505.0,17,2,180,1,90,0.0,90.0,90.0,1,90,0.0,90.0,90.0
32578.000000000004,6,10,2032,5,524,7735.75,252.0,104.8,5,1508,6484.5,1236.0,301.6
107933.0,17,2,286,2,286,0.0,143.0,143.0,0,0,0.0,0.0,0.0
256454.00000000003,6,3,337,2,214,0.0,160.0,107.0,1,123,0.0,123.0,123.0
1242596.0,17,7,490,7,490,207099.3333333333,70.0,70.0,0,0,0.0,0.0,0.0
394567.0,6,20,7606,11,978,39359.4,310.0,88.9090909090909,9,6628,48469.0,1514.0,736.4444444444445
205729.0,17,2,180,1,90,0.0,90.0,90.0,1,90,0.0,90.0,90.0
14235.0,6,13,1459,7,862,2178.1666666666665,271.0,123.14285714285714,6,597,2146.6,259.0,99.5
114157862.0,17,13,952,7,563,19026310.33333333,174.0,80.42857142857143,6,389,18859888.4,174.0,64.83333333333333
318290.0,17,4,1400,4,1400,106096.66666666669,350.0,350.0,0,0,0.0,0.0,0.0
12900.0,6,13,1459,7,862,2150.0,271.0,123.14285714285714,6,597,2035.6,259.0,99.5
13857.0,6,14,4740,7,653,2120.333333333333,249.0,93.28571428571428,7,4087,2174.1666666666665,1514.0,583.8571428571429
135139592.0,17,6,1146,6,1146,27027918.4,191.0,191.0,0,0,0.0,0.0,0.0
1300805.0,6,4,264,2,132,0.0,66.0,66.0,2,132,0.0,66.0,66.0
5004866.0,17,4,534,2,166,0.0,83.0,83.0,2,368,0.0,184.0,184.0
120000220.0,6,19,1436,9,691,15000027.5,95.0,76.77777777777777,10,745,13304629.888888888,95.0,74.5
125864571.0,6,62,12595,30,6557,3316000.413793104,1514.0,218.56666666666663,32,6038,4053179.677419354,1514.0,188.6875
213661.0,17,2,180,1,90,0.0,90.0,90.0,1,90,0.0,90.0,90.0
120124763.0,6,14,2224,9,1204,15015595.375,188.0,133.77777777777777,5,1020,22523014.0,204.0,204.0
104837565.0,6,32,2236,16,1165,6974789.266666667,139.0,72.8125,16,1071,6974791.933333334,123.0,66.9375
40799.0,6,14,4740,7,653,6532.5,249.0,93.28571428571428,7,4087,6668.833333333333,1514.0,583.8571428571429
1514.0,17,5,550,5,550,378.5,110.0,110.0,0,0,0.0,0.0,0.0
2314.0,17,4,344,2,150,0.0,75.0,75.0,2,194,0.0,103.0,97.0
207898.0,17,2,762,2,762,0.0,381.0,381.0,0,0,0.0,0.0,0.0
153462.0,17,2,180,1,90,0.0,90.0,90.0,1,90,0.0,90.0,90.0
301.0,17,2,168,1,76,0.0,76.0,76.0,1,92,0.0,92.0,92.0
206886.0,6,3,426,2,280,0.0,214.0,140.0,1,146,0.0,146.0,146.0
90261294.0,6,12,1832,8,1016,12894470.57142857,188.0,127.0,4,816,30032140.0,204.0,204.0
233562.0,6,3,337,2,214,0.0,160.0,107.0,1,123,0.0,123.0,123.0
733817.0,17,2,876,2,876,0.0,438.0,438.0,0,0,0.0,0.0,0.0
90900994.0,6,21,1585,11,840,9089759.2,95.0,76.36363636363636,10,745,10098905.888888888,95.0,74.5
90287629.0,6,16,1192,8,596,12891975.714285716,95.0,74.5,8,596,12897224.57142857,95.0,74.5
15413.0,6,13,1459,7,862,2390.0,271.0,123.14285714285714,6,597,2665.2,259.0,99.5
228101.0,17,2,180,1,90,0.0,90.0,90.0,1,90,0.0,90.0,90.0
33723.0,6,14,4740,7,653,5495.333333333333,249.0,93.28571428571428,7,4087,5194.166666666667,1514.0,583.8571428571429
14222.0,6,10,2032,5,524,2973.25,252.0,104.8,5,1508,3154.25,1236.0,301.6
5938289.0,6,4,270,2,134,0.0,68.0,67.0,2,136,0.0,70.0,68.0
90290027.0,6,16,1192,8,596,12892562.57142857,95.0,74.5,8,596,12897502.142857144,95.0,74.5
95600882.0,17,15,5138,14,4788,5731586.307692308,342.0,342.0,1,350,0.0,350.0,350.0
121197.0,6,3,337,2,214,0.0,160.0,107.0,1,123,0.0,123.0,123.0
2056.0,17,4,344,2,150,0.0,75.0,75.0,2,194,0.0,103.0,97.0
2049.0,17,4,344,2,150,0.0,75.0,75.0,2,194,0.0,103.0,97.0
222070.0,6,13,1386,7,789,37011.66666666666,253.0,112.71428571428572,6,597,43336.0,259.0,99.5
188259.0,17,2,180,1,90,0.0,90.0,90.0,1,90,0.0,90.0,90.0
3142974.0,6,3,1777,2,951,0.0,885.0,475.5,1,826,0.0,826.0,826.0
110848.0,17,2,286,2,286,0.0,143.0,143.0,0,0,0.0,0.0,0.0
1024764.0,6,11,1134,6,558,204952.8,220.0,93.0,5,576,254478.75,304.0,115.2
103848.0,17,2,286,2,286,0.0,143.0,143.0,0,0,0.0,0.0,0.0
30703.0,6,14,4740,7,653,4965.0,249.0,93.28571428571428,7,4087,4980.833333333333,1514.0,583.8571428571429
45298.0,6,14,4740,7,653,5891.833333333333,249.0,93.28571428571428,7,4087,7408.666666666667,1514.0,583.8571428571429
438334.0,6,10,967,5,390,73576.25,162.0,78.0,5,577,73502.75,349.0,115.4
1307448.0,17,7,490,7,490,217908.0,70.0,70.0,0,0,0.0,0.0,0.0
306978.0,6,6,412,4,272,102326.0,74.0,68.0,2,140,0.0,74.0,70.0
2440.0,17,4,344,2,150,0.0,75.0,75.0,2,194,0.0,103.0,97.0
73966.0,6,10,2032,5,524,17235.75,252.0,104.8,5,1508,17838.25,1236.0,301.6
31318.0,6,14,4740,7,653,5027.166666666667,249.0,93.28571428571428,7,4087,4220.833333333333,1514.0,583.8571428571429
92766387.0,6,28,2008,14,1045,7119256.230769231,139.0,74.64285714285714,14,963,7119267.076923077,123.0,68.78571428571429
207161.0,17,2,180,1,90,0.0,90.0,90.0,1,90,0.0,90.0,90.0
400488.0,6,3,204,1,68,0.0,68.0,68.0,2,136,0.0,70.0,68.0
213539.0,17,2,180,1,90,0.0,90.0,90.0,1,90,0.0,90.0,90.0
3004330.0,6,11,2106,6,598,600682.2,252.0,99.66666666666669,5,1508,1896.75,1236.0,301.6
91281.0,6,14,4740,7,653,14376.666666666666,249.0,93.28571428571428,7,4087,12465.166666666666,1514.0,583.8571428571429
108130206.0,6,28,1860,14,966,8301091.615384615,123.0,69.0,14,894,8301091.230769231,123.0,63.85714285714285
2011372.0,6,7,499,4,301,639353.0,103.0,75.25,3,198,921116.5,66.0,66.0
159133.0,6,2,128,1,74,0.0,74.0,74.0,1,54,0.0,54.0,54.0
120128086.0,6,229,25822,115,7886,1053755.1403508773,140.0,68.57391304347826,114,17936,1053897.725663717,284.0,157.33333333333334
90204790.0,6,17,1287,8,596,12852145.857142856,95.0,74.5,9,691,11250000.625,95.0,76.77777777777777
90009066.0,17,28,13364,28,13364,3333669.111111111,501.0,477.2857142857143,0,0,0.0,0.0,0.0
2352.0,17,2,939,1,590,0.0,590.0,590.0,1,349,0.0,349.0,349.0
217842.0,6,3,426,2,280,0.0,214.0,140.0,1,146,0.0,146.0,146.0
307483.0,6,6,412,4,272,102494.33333333331,74.0,68.0,2,140,0.0,74.0,70.0
112535413.0,6,46,3036,23,1518,5105437.727272728,66.0,66.0,23,1518,5105444.863636363,66.0,66.0
60472.0,6,14,4740,7,653,9920.0,249.0,93.28571428571428,7,4087,9324.833333333334,1514.0,583.8571428571429
80895.0,6,14,4740,7,653,13354.5,249.0,93.28571428571428,7,4087,12726.333333333334,1514.0,583.8571428571429
120369734.0,6,207,23502,104,16482,1168638.1941747572,284.0,158.48076923076923,103,7020,1160780.205882353,140.0,68.15533980582525
109429212.0,17,14,864,7,432,18166827.33333333,174.0,61.71428571428572,7,432,18167651.166666668,174.0,61.71428571428572
119306880.0,6,171,19474,86,13568,1403610.3529411764,284.0,157.7674418604651,85,5906,1409271.988095238,140.0,69.48235294117647
337.0,17,2,166,1,75,0.0,75.0,75.0,1,91,0.0,91.0,91.0
109097.0,17,2,286,2,286,0.0,143.0,143.0,0,0,0.0,0.0,0.0
35189.0,6,13,1479,7,882,5864.833333333333,291.0,126.0,6,597,6268.0,259.0,99.5
32329263.0,6,26,7627,14,3735,184983.6923076923,1514.0,266.7857142857143,12,3892,2919377.909090909,1514.0,324.3333333333333
234487.0,6,3,373,2,238,0.0,172.0,119.0,1,135,0.0,135.0,135.0
2797092.0,6,2,132,1,66,0.0,66.0,66.0,1,66,0.0,66.0,66.0
216717.0,17,2,180,1,90,0.0,90.0,90.0,1,90,0.0,90.0,90.0
129006710.0,17,15,907,8,475,18429530.0,174.0,59.375,7,432,18166860.666666668,174.0,61.71428571428572
203231.0,17,2,180,1,90,0.0,90.0,90.0,1,90,0.0,90.0,90.0
90286948.0,6,16,1192,8,596,12890977.0,95.0,74.5,8,596,12897550.714285716,95.0,74.5
14397.0,6,14,4740,7,653,2160.6666666666665,249.0,93.28571428571428,7,4087,2261.6666666666665,1514.0,583.8571428571429
108109078.0,17,5,1005,5,1005,27027269.5,201.0,201.0,0,0,0.0,0.0,0.0
54055.0,6,14,4740,7,653,7402.833333333333,249.0,93.28571428571428,7,4087,8641.666666666666,1514.0,583.8571428571429
117572373.0,6,219,24908,110,17492,1078645.623853211,284.0,159.01818181818183,109,7416,1078985.3333333333,140.0,68.03669724770643
318.0,17,2,174,1,79,0.0,79.0,79.0,1,95,0.0,95.0,95.0
241688.0,6,3,337,2,214,0.0,160.0,107.0,1,123,0.0,123.0,123.0
120165566.0,6,222,25122,111,7548,1085980.0636363635,140.0,68.0,111,17574,1086002.2727272727,284.0,158.32432432432432
120152019.0,6,222,24978,111,7548,1084946.3909090909,140.0,68.0,111,17430,1084887.7181818185,284.0,157.02702702702703
41630.0,6,14,4740,7,653,6209.166666666667,249.0,93.28571428571428,7,4087,6800.333333333333,1514.0,583.8571428571429
890122.0,6,10,1336,6,799,178024.4,461.0,133.16666666666666,4,537,205821.0,331.0,134.25
754.0,17,4,438,2,148,0.0,74.0,74.0,2,290,0.0,147.0,145.0
2586360.0,6,2,132,1,66,0.0,66.0,66.0,1,66,0.0,66.0,66.0
96146741.0,6,178,20290,89,14194,1090128.4659090908,374.0,159.48314606741573,89,6096,1090129.6590909092,140.0,68.49438202247191
135134885.0,17,6,1146,6,1146,27026977.0,191.0,191.0,0,0,0.0,0.0,0.0
2544.0,17,4,344,2,150,0.0,75.0,75.0,2,194,0.0,103.0,97.0
1307109.0,6,4,264,2,132,0.0,66.0,66.0,2,132,0.0,66.0,66.0
2921831.0,6,12,2172,7,664,486905.6666666667,252.0,94.85714285714286,5,1508,2202.25,1236.0,301.6
2057.0,17,4,344,2,150,0.0,75.0,75.0,2,194,0.0,103.0,97.0
242742.0,6,3,337,2,214,0.0,160.0,107.0,1,123,0.0,123.0,123.0
374.0,17,2,762,2,762,0.0,381.0,381.0,0,0,0.0,0.0,0.0
205833.0,6,3,426,2,280,0.0,214.0,140.0,1,146,0.0,146.0,146.0
287630.0,17,2,359,1,75,0.0,75.0,75.0,1,284,0.0,284.0,284.0
303719.0,6,6,412,4,272,101239.66666666669,74.0,68.0,2,140,0.0,74.0,70.0
153546.0,17,2,180,1,90,0.0,90.0,90.0,1,90,0.0,90.0,90.0
52480.0,6,14,4740,7,653,8543.666666666666,249.0,93.28571428571428,7,4087,6593.833333333333,1514.0,583.8571428571429
107683.0,17,2,286,2,286,0.0,143.0,143.0,0,0,0.0,0.0,0.0
18728.0,6,10,1066,5,490,3742.25,218.0,98.0,5,576,4241.25,304.0,115.2
30266.0,6,14,4740,7,653,4075.0,249.0,93.28571428571428,7,4087,4827.666666666667,1514.0,583.8571428571429
10911088.0,6,8,544,4,272,3591688.0,74.0,68.0,4,272,3591570.333333333,74.0,68.0
18410.0,6,20,7606,11,978,1841.0,310.0,88.9090909090909,9,6628,1762.125,1514.0,736.4444444444445
112424.0,17,4,1400,4,1400,37474.66666666666,350.0,350.0,0,0,0.0,0.0,0.0
322.0,17,2,166,1,75,0.0,75.0,75.0,1,91,0.0,91.0,91.0
153400.0,17,2,180,1,90,0.0,90.0,90.0,1,90,0.0,90.0,90.0
160158.0,17,2,180,1,90,0.0,90.0,90.0,1,90,0.0,90.0,90.0
309037.0,6,6,412,4,272,103012.33333333331,74.0,68.0,2,140,0.0,74.0,70.0
915.0,17,5,550,5,550,228.75,110.0,110.0,0,0,0.0,0.0,0.0
298193.0,6,6,412,4,272,99397.66666666669,74.0,68.0,2,140,0.0,74.0,70.0
80588.0,6,10,2032,5,524,19933.0,252.0,104.8,5,1508,19313.75,1236.0,301.6
119687495.0,6,19,1395,10,745,13271224.0,95.0,74.5,9,650,14929995.0,95.0,72.22222222222223
2800257.0,6,2,132,1,66,0.0,66.0,66.0,1,66,0.0,66.0,66.0
148717.0,17,2,414,1,88,0.0,88.0,88.0,1,326,0.0,326.0,326.0
746881.0,6,2,132,1,66,0.0,66.0,66.0,1,66,0.0,66.0,66.0
2409339.0,6,25,7573,14,3735,185333.7692307692,1514.0,266.7857142857143,11,3838,215577.2,1514.0,348.90909090909093
16352177.999999998,6,26,9149,14,2115,1257859.8461538462,408.0,151.07142857142858,12,7034,1111775.6363636365,1514.0,586.1666666666666
923314.0,6,5,336,2,134,0.0,68.0,67.0,3,202,196238.5,70.0,67.33333333333333
114955.0,17,4,1400,4,1400,38318.333333333336,350.0,350.0,0,0,0.0,0.0,0.0
1299975.0,17,7,490,7,490,216662.5,70.0,70.0,0,0,0.0,0.0,0.0
90206796.0,6,16,1192,8,596,12851856.285714284,95.0,74.5,8,596,12857293.142857144,95.0,74.5
213654.0,17,2,180,1,90,0.0,90.0,90.0,1,90,0.0,90.0,90.0
90457774.0,6,370,44016,185,12432,491523.16847826086,140.0,67.2,185,31584,491561.3695652174,374.0,170.72432432432433
5834306.0,6,5,336,2,134,0.0,68.0,67.0,3,202,1522291.5,70.0,67.33333333333333
2273.0,17,4,344,2,150,0.0,75.0,75.0,2,194,0.0,103.0,97.0
249827.0,6,3,337,2,214,0.0,160.0,107.0,1,123,0.0,123.0,123.0
1507073.0,6,2,132,1,66,0.0,66.0,66.0,1,66,0.0,66.0,66.0
843657.0,6,9,1096,6,625,168731.4,287.0,104.16666666666669,3,471,285404.5,331.0,157.0
127952033.0,6,33,2296,17,1225,7997002.0625,139.0,72.05882352941177,16,1071,7849924.4,123.0,66.9375
238002.0,6,3,373,2,238,0.0,172.0,119.0,1,135,0.0,135.0,135.0
110961.0,17,2,286,2,286,0.0,143.0,143.0,0,0,0.0,0.0,0.0
4405.0,17,2,582,1,83,0.0,83.0,83.0,1,499,0.0,499.0,499.0
232181.0,6,3,337,2,214,0.0,160.0,107.0,1,123,0.0,123.0,123.0
34301.0,6,2,145,2,145,0.0,91.0,72.5,0,0,0.0,0.0,0.0
228673.0,17,2,180,1,90,0.0,90.0,90.0,1,90,0.0,90.0,90.0
46730.0,6,14,4740,7,653,7361.666666666667,249.0,93.28571428571428,7,4087,6483.5,1514.0,583.8571428571429
103152.0,17,2,286,2,286,0.0,143.0,143.0,0,0,0.0,0.0,0.0
285219.0,17,2,363,1,79,0.0,79.0,79.0,1,284,0.0,284.0,284.0
310780.0,17,2,180,1,90,0.0,90.0,90.0,1,90,0.0,90.0,90.0
106887.0,17,2,286,2,286,0.0,143.0,143.0,0,0,0.0,0.0,0.0
90000995.0,17,11,735,6,389,18000199.0,174.0,64.83333333333333,5,346,17500609.25,174.0,69.2
120239363.0,6,18,1341,9,691,14999894.375,95.0,76.77777777777777,9,650,15000001.75,95.0,72.22222222222223
5007987.0,17,4,849,2,166,0.0,83.0,83.0,2,683,0.0,499.0,341.5
91207.0,17,2,286,2,286,0.0,143.0,143.0,0,0,0.0,0.0,0.0
15048469.0,17,6,2718,6,2718,3009693.8,453.0,453.0,0,0,0.0,0.0,0.0
308527.0,6,6,412,4,272,102842.33333333331,74.0,68.0,2,140,0.0,74.0,70.0
310641.0,17,4,622,4,622,103547.0,163.0,155.5,0,0,0.0,0.0,0.0
21923.0,6,14,4740,7,653,3493.0,249.0,93.28571428571428,7,4087,3518.333333333333,1514.0,583.8571428571429
213092.0,17,2,180,1,90,0.0,90.0,90.0,1,90,0.0,90.0,90.0
206054.0,6,3,426,2,280,0.0,214.0,140.0,1,146,0.0,146.0,146.0
120015302.0,6,25,2044,13,1191,9999999.083333334,256.0,91.6153846153846,12,853,10884979.727272728,95.0,71.08333333333333
274146.0,6,12,1373,7,714,45691.0,298.0,102.0,5,659,67527.75,379.0,131.8
90256685.0,6,13,2036,8,1016,12893812.142857144,188.0,127.0,5,1020,22522784.75,204.0,204.0
73163.0,6,12,1328,6,731,12434.2,253.0,121.83333333333331,6,597,13412.4,259.0,99.5
41853.0,6,10,2032,5,524,9844.0,252.0,104.8,5,1508,10188.25,1236.0,301.6
90745093.0,6,17,1287,9,691,11336884.875,95.0,76.77777777777777,8,596,12963112.42857143,95.0,74.5
103183.0,17,2,762,2,762,0.0,381.0,381.0,0,0,0.0,0.0,0.0
90223317.0,6,16,1192,8,596,12853333.142857144,95.0,74.5,8,596,12858188.857142856,95.0,74.5
98235873.0,17,11,735,6,389,19600159.0,174.0,64.83333333333333,5,346,19744593.0,174.0,69.2
309737.0,17,4,704,2,148,0.0,74.0,74.0,2,556,0.0,280.0,278.0
121190.0,6,3,337,2,214,0.0,160.0,107.0,1,123,0.0,123.0,123.0
32228.0,6,10,2032,5,524,7413.75,252.0,104.8,5,1508,7092.25,1236.0,301.6
15271.0,17,2,180,1,90,0.0,90.0,90.0,1,90,0.0,90.0,90.0
90052116.0,17,28,13364,28,13364,3335263.5555555555,501.0,477.2857142857143,0,0,0.0,0.0,0.0
2745698.0,17,2,876,2,876,0.0,438.0,438.0,0,0,0.0,0.0,0.0
2037.0,17,4,344,2,150,0.0,75.0,75.0,2,194,0.0,103.0,97.0
2248.0,17,4,344,2,150,0.0,75.0,75.0,2,194,0.0,103.0,97.0
3781696.0,6,5,336,2,134,0.0,68.0,67.0,3,202,1527995.5,70.0,67.33333333333333
90003493.0,6,15,1097,8,596,12857641.857142856,95.0,74.5,7,501,14951345.666666666,95.0,71.57142857142857
42777.0,6,14,4740,7,653,5065.5,249.0,93.28571428571428,7,4087,6668.0,1514.0,583.8571428571429
38279.0,6,14,4740,7,653,5079.833333333333,249.0,93.28571428571428,7,4087,6158.0,1514.0,583.8571428571429
10873201.0,6,8,544,4,272,3579307.0,74.0,68.0,4,272,3579224.6666666665,74.0,68.0
100180.0,17,2,762,2,762,0.0,381.0,381.0,0,0,0.0,0.0,0.0
199681.0,17,2,180,1,90,0.0,90.0,90.0,1,90,0.0,90.0,90.0
146247.0,6,3,337,2,214,0.0,160.0,107.0,1,123,0.0,123.0,123.0
65835.0,6,10,2032,5,524,16222.0,252.0,104.8,5,1508,15876.25,1236.0,301.6
179947.0,17,2,180,1,90,0.0,90.0,90.0,1,90,0.0,90.0,90.0
295589.0,17,2,180,1,90,0.0,90.0,90.0,1,90,0.0,90.0,90.0
16656.0,6,11,1133,6,602,3075.8,264.0,100.33333333333331,5,531,3460.75,259.0,106.2
1772271.0,6,2,132,1,66,0.0,66.0,66.0,1,66,0.0,66.0,66.0
0.0,6,1,66,1,66,0.0,66.0,66.0,0,0,0.0,0.0,0.0
104132567.0,6,44,2904,22,1452,4958693.666666667,66.0,66.0,22,1452,4945701.761904762,66.0,66.0
307760.0,6,6,412,4,272,102586.66666666669,74.0,68.0,2,140,0.0,74.0,70.0
147514.0,6,3,373,2,238,0.0,172.0,119.0,1,135,0.0,135.0,135.0
90044478.0,17,28,13364,28,13364,3334980.6666666665,501.0,477.2857142857143,0,0,0.0,0.0,0.0
206043.0,6,3,426,2,280,0.0,214.0,140.0,1,146,0.0,146.0,146.0
108791.0,17,2,286,2,286,0.0,143.0,143.0,0,0,0.0,0.0,0.0
327.0,17,2,191,1,73,0.0,73.0,73.0,1,118,0.0,118.0,118.0
211180.0,6,12,1373,7,714,35196.666666666664,298.0,102.0,5,659,51782.25,379.0,131.8
31667.0,6,13,4412,6,409,6186.0,127.0,68.16666666666667,7,4003,4890.0,1514.0,571.8571428571429
41713.0,6,10,2032,5,524,7001.0,252.0,104.8,5,1508,9994.5,1236.0,301.6
263913.0,6,10,1221,6,636,52782.6,298.0,106.0,4,585,82235.33333333333,379.0,146.25
147961.0,17,2,180,1,90,0.0,90.0,90.0,1,90,0.0,90.0,90.0
496.0,17,2,508,2,508,0.0,257.0,254.0,0,0,0.0,0.0,0.0
2407.0,17,4,344,2,150,0.0,75.0,75.0,2,194,0.0,103.0,97.0
61145810.0,6,6,674,4,428,20381936.666666668,160.0,107.0,2,246,0.0,123.0,123.0
108546.0,17,2,286,2,286,0.0,143.0,143.0,0,0,0.0,0.0,0.0
16203350.0,17,6,2052,6,2052,3240670.0,342.0,342.0,0,0,0.0,0.0,0.0
120122719.0,6,13,2020,9,1204,15015339.875,188.0,133.77777777777777,4,816,30031026.666666668,204.0,204.0
215277.0,17,2,180,1,90,0.0,90.0,90.0,1,90,0.0,90.0,90.0
122669249.0,17,14,1126,7,563,17269950.166666668,174.0,80.42857142857143,7,563,19039662.666666668,174.0,80.42857142857143
96511017.0,17,16,1474,8,737,13714941.714285716,174.0,92.125,8,737,13714402.857142856,174.0,92.125
113392323.0,6,46,3036,23,1518,5154184.409090909,66.0,66.0,23,1518,5154184.545454546,66.0,66.0
1153634.0,6,13,3008,8,2380,164804.85714285713,1514.0,297.5,5,628,220268.25,331.0,125.6
14543035.0,6,21,1661,9,921,1779059.125,315.0,102.33333333333331,12,740,1293842.181818182,78.0,61.66666666666666
205660.0,17,2,180,1,90,0.0,90.0,90.0,1,90,0.0,90.0,90.0
323.0,17,2,174,1,79,0.0,79.0,79.0,1,95,0.0,95.0,95.0
108109432.0,17,5,1005,5,1005,27027358.0,201.0,201.0,0,0,0.0,0.0,0.0
310156.0,17,4,1400,4,1400,103385.33333333331,350.0,350.0,0,0,0.0,0.0,0.0
135125080.0,17,6,1206,6,1206,27025016.0,201.0,201.0,0,0,0.0,0.0,0.0
108300633.0,6,190,21426,95,14934,1149845.3510638298,284.0,157.2,95,6492,1149841.7978723403,140.0,68.33684210526316
90046692.0,17,27,12943,27,12943,3463334.3076923075,501.0,479.3703703703704,0,0,0.0,0.0,0.0
5215377.0,6,5,336,2,134,0.0,68.0,67.0,3,202,1525182.5,70.0,67.33333333333333
5184.0,17,2,180,1,90,0.0,90.0,90.0,1,90,0.0,90.0,90.0
284839.0,17,2,363,1,79,0.0,79.0,79.0,1,284,0.0,284.0,284.0
155003.0,6,13,1394,7,797,25833.83333333333,253.0,113.85714285714286,6,597,27959.0,259.0,99.5
1852.0,17,2,691,1,349,0.0,349.0,349.0,1,342,0.0,342.0,342.0
5515877.0,6,5,336,2,134,0.0,68.0,67.0,3,202,1422865.0,70.0,67.33333333333333
3080653.0,6,4,270,2,134,0.0,68.0,67.0,2,136,0.0,70.0,68.0
90532319.0,6,15,2444,8,1016,12933188.42857143,188.0,127.0,7,1428,15060992.0,204.0,204.0
20579.0,6,10,2032,5,524,3974.0,252.0,104.8,5,1508,4796.75,1236.0,301.6
104473035.0,6,44,2904,22,1452,4974906.428571428,66.0,66.0,22,1452,4960211.761904762,66.0,66.0
118177561.0,6,48,3168,24,1584,5138154.826086956,66.0,66.0,24,1584,5124733.608695652,66.0,66.0
87990.0,6,14,4740,7,653,14525.0,249.0,93.28571428571428,7,4087,8049.333333333333,1514.0,583.8571428571429
296.0,17,2,164,1,82,0.0,82.0,82.0,1,82,0.0,82.0,82.0
82.0,17,2,762,2,762,0.0,381.0,381.0,0,0,0.0,0.0,0.0
90220249.0,6,16,1192,8,596,12853939.42857143,95.0,74.5,8,596,12859294.714285716,95.0,74.5
3333.0,17,2,315,1,75,0.0,75.0,75.0,1,240,0.0,240.0,240.0
108106621.0,17,5,955,5,955,27026655.25,191.0,191.0,0,0,0.0,0.0,0.0
90256357.0,6,13,2036,8,1016,12893765.285714284,188.0,127.0,5,1020,22522553.25,204.0,204.0
2463.0,17,4,344,2,150,0.0,75.0,75.0,2,194,0.0,103.0,97.0
238807.0,6,3,373,2,238,0.0,172.0,119.0,1,135,0.0,135.0,135.0
30952.0,6,14,4740,7,653,4103.833333333333,249.0,93.28571428571428,7,4087,4954.666666666667,1514.0,583.8571428571429
53804.0,6,14,4740,7,653,8806.0,249.0,93.28571428571428,7,4087,8835.333333333334,1514.0,583.8571428571429
135131354.0,17,6,1206,6,1206,27026270.8,201.0,201.0,0,0,0.0,0.0,0.0
298346.0,6,6,412,4,272,99448.66666666669,74.0,68.0,2,140,0.0,74.0,70.0
36502.0,6,10,2032,5,524,8330.25,252.0,104.8,5,1508,8878.75,1236.0,301.6
35997.0,6,14,4740,7,653,5659.5,249.0,93.28571428571428,7,4087,5629.333333333333,1514.0,583.8571428571429
729.0,17,4,438,2,148,0.0,74.0,74.0,2,290,0.0,147.0,145.0
120007631.0,17,15,1169,8,606,17143947.285714287,174.0,75.75,7,563,16500187.666666666,174.0,80.42857142857143
237916.0,6,3,337,2,214,0.0,160.0,107.0,1,123,0.0,123.0,123.0
50281.0,6,10,2032,5,524,11539.5,252.0,104.8,5,1508,11215.5,1236.0,301.6
323223.0,17,4,1400,4,1400,107741.0,350.0,350.0,0,0,0.0,0.0,0.0
507832.0,6,5,336,2,134,0.0,68.0,67.0,3,202,192898.0,70.0,67.33333333333333
15654.999999999998,6,11,1131,6,600,2944.8,262.0,100.0,5,531,3244.25,259.0,106.2
308240.0,6,6,412,4,272,102746.66666666669,74.0,68.0,2,140,0.0,74.0,70.0
46570.0,6,10,2032,5,524,11383.75,252.0,104.8,5,1508,11057.75,1236.0,301.6
236481.0,6,4,439,2,238,0.0,172.0,119.0,2,201,0.0,135.0,100.5
123840016.0,6,49,3234,25,1650,5160000.666666667,66.0,66.0,24,1584,5069561.565217392,66.0,66.0
3086.0,17,2,224,1,76,0.0,76.0,76.0,1,148,0.0,148.0,148.0
22563.0,6,10,2032,5,524,4678.75,252.0,104.8,5,1508,4534.75,1236.0,301.6
120435883.0,6,47,3102,23,1518,5155440.7727272725,66.0,66.0,24,1584,5222686.391304348,66.0,66.0
219525.0,17,2,180,1,90,0.0,90.0,90.0,1,90,0.0,90.0,90.0
34183.0,6,14,4740,7,653,5174.666666666667,249.0,93.28571428571428,7,4087,5222.5,1514.0,583.8571428571429
143917.0,17,2,180,1,90,0.0,90.0,90.0,1,90,0.0,90.0,90.0
135001482.0,17,15,907,8,475,19285926.0,174.0,59.375,7,432,19167491.166666668,174.0,61.71428571428572
36374.0,6,14,4740,7,653,5936.666666666667,249.0,93.28571428571428,7,4087,5929.0,1514.0,583.8571428571429
136738.0,6,10,1065,5,534,33947.75,262.0,106.8,5,531,2701.5,259.0,106.2
43395.0,6,14,4740,7,653,5851.666666666667,249.0,93.28571428571428,7,4087,7074.833333333333,1514.0,583.8571428571429
15955317.0,17,6,2052,6,2052,3191063.4,342.0,342.0,0,0,0.0,0.0,0.0
5005230.0,17,4,849,2,166,0.0,83.0,83.0,2,683,0.0,499.0,341.5
90238451.0,6,36,2376,18,1188,5308144.176470588,66.0,66.0,18,1188,5291928.411764706,66.0,66.0
15747.0,6,10,2032,5,524,3156.5,252.0,104.8,5,1508,3378.25,1236.0,301.6
4105.0,17,2,598,1,72,0.0,72.0,72.0,1,526,0.0,526.0,526.0
310256.0,6,6,412,4,272,103418.66666666669,74.0,68.0,2,140,0.0,74.0,70.0
5824658.0,6,4,270,2,134,0.0,68.0,67.0,2,136,0.0,70.0,68.0
250966.00000000003,6,3,354,2,288,0.0,222.0,144.0,1,66,0.0,66.0,66.0
2058.0,17,4,344,2,150,0.0,75.0,75.0,2,194,0.0,103.0,97.0
205630.0,17,2,180,1,90,0.0,90.0,90.0,1,90,0.0,90.0,90.0
0.0,6,1,172,1,172,0.0,172.0,172.0,0,0,0.0,0.0,0.0
24509.0,6,10,2032,5,524,5833.5,252.0,104.8,5,1508,5549.5,1236.0,301.6
17481.0,6,10,2032,5,524,4138.5,252.0,104.8,5,1508,3797.25,1236.0,301.6
46661.0,6,10,2032,5,524,11108.75,252.0,104.8,5,1508,10708.0,1236.0,301.6
100071805.0,6,184,20936,92,6368,1099690.1648351648,140.0,69.21739130434783,92,14568,1096285.8461538462,300.0,158.34782608695653
2051.0,17,4,344,2,150,0.0,75.0,75.0,2,194,0.0,103.0,97.0
3219.0,17,2,359,1,75,0.0,75.0,75.0,1,284,0.0,284.0,284.0
38307.0,6,10,2032,5,524,9126.5,252.0,104.8,5,1508,9304.25,1236.0,301.6
90362348.0,6,15,2180,8,1016,12908906.857142856,188.0,127.0,7,1164,10055763.333333334,204.0,166.28571428571428
92210.0,6,14,4740,7,653,14601.333333333334,249.0,93.28571428571428,7,4087,14543.166666666666,1514.0,583.8571428571429
583829.0,6,4,508,2,238,0.0,172.0,119.0,2,270,0.0,135.0,135.0
146334.0,6,3,337,2,214,0.0,160.0,107.0,1,123,0.0,123.0,123.0
108106430.0,17,5,1005,5,1005,27026607.5,201.0,201.0,0,0,0.0,0.0,0.0
29748.0,6,14,4740,7,653,4839.5,249.0,93.28571428571428,7,4087,4558.333333333333,1514.0,583.8571428571429
3057145.0,6,3,1604,2,851,0.0,785.0,425.5,1,753,0.0,753.0,753.0
216335.0,17,2,180,1,90,0.0,90.0,90.0,1,90,0.0,90.0,90.0
11130.0,17,2,571,1,86,0.0,86.0,86.0,1,485,0.0,485.0,485.0
45249.0,6,14,4740,7,653,7420.166666666667,249.0,93.28571428571428,7,4087,5577.666666666667,1514.0,583.8571428571429
120229043.0,6,226,25894,113,7754,1066597.455357143,140.0,68.61946902654867,113,18140,1066127.017857143,284.0,160.53097345132744
70060.0,17,2,604,1,75,0.0,75.0,75.0,1,529,0.0,529.0,529.0
0.0,17,1,72,1,72,0.0,72.0,72.0,0,0,0.0,0.0,0.0
8541.0,6,10,2032,5,524,1920.5,252.0,104.8,5,1508,1886.75,1236.0,301.6
24716.0,6,14,4740,7,653,2572.6666666666665,249.0,93.28571428571428,7,4087,3981.8333333333335,1514.0,583.8571428571429
120176425.0,17,13,821,7,432,20029404.166666668,174.0,61.71428571428572,6,389,20075202.0,174.0,64.83333333333333
110963856.0,6,30,2122,15,1017,7925989.714285715,123.0,67.8,15,1105,7197358.785714285,139.0,73.66666666666667
90029316.0,17,27,12943,27,12943,3462666.0,501.0,479.3703703703704,0,0,0.0,0.0,0.0
104803523.0,17,15,5130,15,5130,7485965.928571428,342.0,342.0,0,0,0.0,0.0,0.0
1245025.0,6,7,499,3,198,613578.5,66.0,66.0,4,301,392049.3333333333,103.0,75.25
144976.0,17,2,180,1,70,0.0,70.0,70.0,1,110,0.0,110.0,110.0
102577.0,17,2,286,2,286,0.0,143.0,143.0,0,0,0.0,0.0,0.0
94946948.0,6,185,20842,93,6360,1032032.0434782607,140.0,68.38709677419355,92,14482,1031934.3296703296,284.0,157.41304347826087
307907.0,6,6,412,4,272,102635.66666666669,74.0,68.0,2,140,0.0,74.0,70.0
209933.0,6,3,426,2,280,0.0,214.0,140.0,1,146,0.0,146.0,146.0
512409.0,6,3,204,2,136,0.0,70.0,68.0,1,68,0.0,68.0,68.0
90300012.0,6,16,1192,8,596,12893330.0,95.0,74.5,8,596,12899383.142857144,95.0,74.5
2594620.0,6,2,132,1,66,0.0,66.0,66.0,1,66,0.0,66.0,66.0
98307.0,17,2,762,2,762,0.0,381.0,381.0,0,0,0.0,0.0,0.0
310899.0,17,4,622,4,622,103633.0,163.0,155.5,0,0,0.0,0.0,0.0
103366.0,17,2,286,2,286,0.0,143.0,143.0,0,0,0.0,0.0,0.0
41707.0,6,12,1320,6,723,7706.4,253.0,120.5,6,597,6580.2,259.0,99.5
128788569.0,17,14,864,7,432,18167804.166666668,174.0,61.71428571428572,7,432,20015958.5,174.0,61.71428571428572
26500.0,6,14,4740,7,653,4032.8333333333335,249.0,93.28571428571428,7,4087,3793.5,1514.0,583.8571428571429
112979653.0,6,45,2970,23,1518,5135438.7727272725,66.0,66.0,22,1452,5186262.380952381,66.0,66.0
866987.0,6,10,1334,6,797,173397.4,459.0,132.83333333333334,4,537,198128.0,331.0,134.25
23746.0,6,14,4740,7,653,3078.6666666666665,249.0,93.28571428571428,7,4087,3664.8333333333335,1514.0,583.8571428571429
2355.0,17,4,344,2,150,0.0,75.0,75.0,2,194,0.0,103.0,97.0
32946.0,6,14,4740,7,653,5318.833333333333,249.0,93.28571428571428,7,4087,4581.5,1514.0,583.8571428571429
112018716.0,6,35,2526,18,1332,6589336.235294118,123.0,74.0,17,1194,6987642.625,123.0,70.23529411764706
21715.0,6,14,4740,7,653,3387.0,249.0,93.28571428571428,7,4087,3336.5,1514.0,583.8571428571429
0.0,6,1,54,1,54,0.0,54.0,54.0,0,0,0.0,0.0,0.0
103696.0,17,2,286,2,286,0.0,143.0,143.0,0,0,0.0,0.0,0.0
224025.0,6,3,426,2,280,0.0,214.0,140.0,1,146,0.0,146.0,146.0
0.0,17,1,72,1,72,0.0,72.0,72.0,0,0,0.0,0.0,0.0
179047.0,17,2,180,1,90,0.0,90.0,90.0,1,90,0.0,90.0,90.0
1102.0,17,2,508,2,508,0.0,257.0,254.0,0,0,0.0,0.0,0.0
108103883.0,17,5,955,5,955,27025970.75,191.0,191.0,0,0,0.0,0.0,0.0
315889.0,17,4,1400,4,1400,105296.33333333331,350.0,350.0,0,0,0.0,0.0,0.0
90059507.0,17,28,13364,28,13364,3335537.296296296,501.0,477.2857142857143,0,0,0.0,0.0,0.0
135136295.0,17,6,1146,6,1146,27027259.0,191.0,191.0,0,0,0.0,0.0,0.0
315243.0,17,4,1400,4,1400,105081.0,350.0,350.0,0,0,0.0,0.0,0.0
91004379.0,6,176,19872,88,13842,1043546.0804597702,284.0,157.29545454545453,88,6030,1043554.0689655172,140.0,68.52272727272727
37018.0,6,14,4740,7,653,6013.833333333333,249.0,93.28571428571428,7,4087,6027.666666666667,1514.0,583.8571428571429
97378680.0,6,40,2640,20,1320,5125193.684210527,66.0,66.0,20,1320,5108950.263157895,66.0,66.0
121472819.0,6,34,2350,17,1125,6968018.5625,123.0,66.17647058823529,17,1225,6968019.5,139.0,72.05882352941177
123305844.0,6,48,3168,24,1584,4941589.0,66.0,66.0,24,1584,5355170.695652174,66.0,66.0
107528845.0,6,28,1860,14,966,8254847.692307692,123.0,69.0,14,894,8254844.461538462,123.0,63.85714285714285
90036568.0,17,28,13364,28,13364,3334687.703703704,501.0,477.2857142857143,0,0,0.0,0.0,0.0
10096.0,6,10,1066,5,490,2284.5,218.0,98.0,5,576,2199.5,304.0,115.2
19918.0,17,2,582,1,83,0.0,83.0,83.0,1,499,0.0,499.0,499.0
108110072.0,17,5,955,5,955,27027518.0,191.0,191.0,0,0,0.0,0.0,0.0
2802408.0,6,2,132,1,66,0.0,66.0,66.0,1,66,0.0,66.0,66.0
97056246.0,17,24,10872,24,10872,4219836.782608695,453.0,453.0,0,0,0.0,0.0,0.0
108519382.0,6,44,2904,22,1452,5167589.619047619,66.0,66.0,22,1452,5151838.904761905,66.0,66.0
123455935.0,6,49,3234,25,1650,5143997.291666667,66.0,66.0,24,1584,5083588.260869565,66.0,66.0
2083.0,17,4,344,2,150,0.0,75.0,75.0,2,194,0.0,103.0,97.0
121317.0,6,3,337,2,214,0.0,160.0,107.0,1,123,0.0,123.0,123.0
298814.0,6,6,412,4,272,99604.66666666669,74.0,68.0,2,140,0.0,74.0,70.0
153435.0,17,2,180,1,90,0.0,90.0,90.0,1,90,0.0,90.0,90.0
2571196.0,6,3,202,1,66,0.0,66.0,66.0,2,136,0.0,70.0,68.0
108113238.0,17,5,955,5,955,27028309.5,191.0,191.0,0,0,0.0,0.0,0.0
90255237.0,6,13,2036,8,1016,12893605.285714284,188.0,127.0,5,1020,22522910.75,204.0,204.0
118724451.0,6,428,53822,214,39476,556381.4553990611,554.0,184.46728971962617,214,14346,556381.5164319249,140.0,67.03738317757009
1440.0,17,2,762,2,762,0.0,381.0,381.0,0,0,0.0,0.0,0.0
22560.0,6,14,4740,7,653,3405.833333333333,249.0,93.28571428571428,7,4087,3365.6666666666665,1514.0,583.8571428571429
3202.0,17,2,180,1,90,0.0,90.0,90.0,1,90,0.0,90.0,90.0
110092965.0,6,33,2428,17,1288,6880810.3125,139.0,75.76470588235294,16,1140,7325100.733333333,123.0,71.25
108114618.0,17,5,1005,5,1005,27028654.5,201.0,201.0,0,0,0.0,0.0,0.0
120378852.0,6,2459,2121438,1701,2071410,70811.08941176471,1514.0,1217.7601410934744,758,50028,158412.71202113607,66.0,66.0
34809.0,6,14,4740,7,653,5671.666666666667,249.0,93.28571428571428,7,4087,5653.833333333333,1514.0,583.8571428571429
228167.0,17,2,180,1,90,0.0,90.0,90.0,1,90,0.0,90.0,90.0
42722.0,6,14,4740,7,653,6552.166666666667,249.0,93.28571428571428,7,4087,6964.166666666667,1514.0,583.8571428571429
19541.0,6,10,2032,5,524,4673.0,252.0,104.8,5,1508,4631.0,1236.0,301.6
10517832.0,6,7,478,4,272,3460842.6666666665,74.0,68.0,3,206,5191142.5,74.0,68.66666666666667
122687968.0,6,49,3234,25,1650,5111998.666666667,66.0,66.0,24,1584,4901668.043478261,66.0,66.0
115101491.0,6,29,1920,15,1026,8221535.071428572,123.0,68.4,14,894,8069382.769230769,123.0,63.85714285714285
91772080.0,6,171,19362,86,13530,1079671.5294117648,284.0,157.32558139534885,85,5832,1080189.1904761903,140.0,68.61176470588235
153558.0,17,2,180,1,90,0.0,90.0,90.0,1,90,0.0,90.0,90.0
107382.0,17,2,286,2,286,0.0,143.0,143.0,0,0,0.0,0.0,0.0
2802739.0,6,2,132,1,66,0.0,66.0,66.0,1,66,0.0,66.0,66.0
1057224.0,6,3,1604,2,851,0.0,785.0,425.5,1,753,0.0,753.0,753.0
108116416.0,17,5,1005,5,1005,27029104.0,201.0,201.0,0,0,0.0,0.0,0.0
7374.0,17,4,823,2,163,0.0,89.0,81.5,2,660,0.0,443.0,330.0
20133.0,17,2,582,1,83,0.0,83.0,83.0,1,499,0.0,499.0,499.0
19512.0,17,2,762,2,762,0.0,381.0,381.0,0,0,0.0,0.0,0.0
36414.0,6,14,4740,7,653,5960.166666666667,249.0,93.28571428571428,7,4087,5949.666666666667,1514.0,583.8571428571429
54086.0,6,14,4740,7,653,8894.0,249.0,93.28571428571428,7,4087,8009.333333333333,1514.0,583.8571428571429
120124633.0,6,15,2428,9,1204,15015579.125,188.0,133.77777777777777,6,1224,18018039.0,204.0,204.0
120003322.0,6,18,1341,9,691,14999989.25,95.0,76.77777777777777,9,650,15000039.375,95.0,72.22222222222223
293.0,17,2,174,1,79,0.0,79.0,79.0,1,95,0.0,95.0,95.0
153539.0,17,2,180,1,90,0.0,90.0,90.0,1,90,0.0,90.0,90.0
143949.0,17,2,180,1,90,0.0,90.0,90.0,1,90,0.0,90.0,90.0
23611.0,6,14,4740,7,653,3423.6666666666665,249.0,93.28571428571428,7,4087,3800.5,1514.0,583.8571428571429
192989.0,17,2,180,1,90,0.0,90.0,90.0,1,90,0.0,90.0,90.0
2285.0,17,4,344,2,150,0.0,75.0,75.0,2,194,0.0,103.0,97.0
109133.0,17,2,700,2,700,0.0,350.0,350.0,0,0,0.0,0.0,0.0
41276.0,6,14,4740,7,653,6226.0,249.0,93.28571428571428,7,4087,6598.5,1514.0,583.8571428571429
2067.0,17,4,344,2,150,0.0,75.0,75.0,2,194,0.0,103.0,97.0
120121664.0,6,14,2224,9,1204,15015208.0,188.0,133.77777777777777,5,1020,22523545.75,204.0,204.0
55372.0,6,14,4740,7,653,9093.166666666666,249.0,93.28571428571428,7,4087,9010.833333333334,1514.0,583.8571428571429
157960.0,6,3,337,2,214,0.0,160.0,107.0,1,123,0.0,123.0,123.0
27148790.0,17,5,1710,5,1710,6787197.5,342.0,342.0,0,0,0.0,0.0,0.0
889326.0,6,9,1118,6,586,177865.2,248.0,97.66666666666669,3,532,300906.5,392.0,177.33333333333334
181320.0,17,2,180,1,90,0.0,90.0,90.0,1,90,0.0,90.0,90.0
335.0,17,2,166,1,75,0.0,75.0,75.0,1,91,0.0,91.0,91.0
84.0,17,2,762,2,762,0.0,381.0,381.0,0,0,0.0,0.0,0.0
197977.0,17,2,180,1,90,0.0,90.0,90.0,1,90,0.0,90.0,90.0
2770.0,17,4,344,2,150,0.0,75.0,75.0,2,194,0.0,103.0,97.0
121236.0,6,3,337,2,214,0.0,160.0,107.0,1,123,0.0,123.0,123.0
233563.0,6,3,337,2,214,0.0,160.0,107.0,1,123,0.0,123.0,123.0
119084462.0,6,18,1382,9,691,11163844.0,95.0,76.77777777777777,9,691,14854512.75,95.0,76.77777777777777
106586.0,17,2,286,2,286,0.0,143.0,143.0,0,0,0.0,0.0,0.0
252247.0,17,4,6056,4,6056,84082.33333333333,1514.0,1514.0,0,0,0.0,0.0,0.0
28226.0,6,10,2032,5,524,6821.5,252.0,104.8,5,1508,6499.25,1236.0,301.6
101005200.0,17,12,778,6,389,20157210.0,174.0,64.83333333333333,6,389,20169251.8,174.0,64.83333333333333
296.0,17,2,174,1,79,0.0,79.0,79.0,1,95,0.0,95.0,95.0
2396.0,17,4,344,2,150,0.0,75.0,75.0,2,194,0.0,103.0,97.0
24763.0,6,14,4740,7,653,3906.1666666666665,249.0,93.28571428571428,7,4087,3993.5,1514.0,583.8571428571429
3431.0,17,2,346,1,78,0.0,78.0,78.0,1,268,0.0,268.0,268.0
277284.0,17,2,363,1,79,0.0,79.0,79.0,1,284,0.0,284.0,284.0
201605.0,17,2,180,1,90,0.0,90.0,90.0,1,90,0.0,90.0,90.0
1302227.0,6,4,264,2,132,0.0,66.0,66.0,2,132,0.0,66.0,66.0
153533.0,17,2,180,1,90,0.0,90.0,90.0,1,90,0.0,90.0,90.0
28697.0,6,10,2032,5,524,5100.25,252.0,104.8,5,1508,6597.75,1236.0,301.6
2009641.0,17,4,525,2,150,0.0,75.0,75.0,2,375,0.0,284.0,187.5
551347.0,6,2,132,1,66,0.0,66.0,66.0,1,66,0.0,66.0,66.0
284454.0,17,2,363,1,79,0.0,79.0,79.0,1,284,0.0,284.0,284.0
299568.0,17,4,1400,4,1400,99856.0,350.0,350.0,0,0,0.0,0.0,0.0
120971372.0,6,33,2296,17,1225,7560710.75,139.0,72.05882352941177,16,1071,7384692.066666666,123.0,66.9375
42177.0,6,10,2032,5,524,9743.5,252.0,104.8,5,1508,8316.5,1236.0,301.6
235330.0,6,3,373,2,238,0.0,172.0,119.0,1,135,0.0,135.0,135.0
14371.0,6,14,4740,7,653,2272.5,249.0,93.28571428571428,7,4087,2257.833333333333,1514.0,583.8571428571429
347677.0,6,10,1221,6,636,69535.4,298.0,106.0,4,585,110436.66666666669,379.0,146.25
355360.0,6,10,1221,6,636,71072.0,298.0,106.0,4,585,117179.66666666669,379.0,146.25
307075.0,17,2,180,1,90,0.0,90.0,90.0,1,90,0.0,90.0,90.0
24915.0,17,4,823,2,163,0.0,89.0,81.5,2,660,0.0,443.0,330.0
48641.0,6,10,2032,5,524,11794.75,252.0,104.8,5,1508,11467.75,1236.0,301.6
24443.0,6,14,4740,7,653,3785.1666666666665,249.0,93.28571428571428,7,4087,3884.1666666666665,1514.0,583.8571428571429
60436.0,6,14,4740,7,653,8665.5,249.0,93.28571428571428,7,4087,9845.833333333334,1514.0,583.8571428571429
42656.0,6,14,4740,7,653,6919.0,249.0,93.28571428571428,7,4087,6786.166666666667,1514.0,583.8571428571429
124946588.0,6,31,2034,16,1086,8329772.533333333,123.0,67.875,15,948,8196055.785714285,123.0,63.2
858805.0,6,9,1270,6,799,171761.0,461.0,133.16666666666666,3,471,291595.5,331.0,157.0
229550.0,6,3,426,2,280,0.0,214.0,140.0,1,146,0.0,146.0,146.0
108109891.0,17,5,955,5,955,27027472.75,191.0,191.0,0,0,0.0,0.0,0.0
817.0,17,4,438,2,148,0.0,74.0,74.0,2,290,0.0,147.0,145.0
44074.0,6,13,1386,7,789,7309.333333333333,253.0,112.71428571428572,6,597,7874.0,259.0,99.5
92832267.0,6,38,2508,19,1254,5157333.722222222,66.0,66.0,19,1254,5157333.888888889,66.0,66.0
2014.0,17,4,344,2,150,0.0,75.0,75.0,2,194,0.0,103.0,97.0
32973.0,6,10,2032,5,524,8005.25,252.0,104.8,5,1508,7627.25,1236.0,301.6
24024788.0,17,3,1026,3,1026,12012394.0,342.0,342.0,0,0,0.0,0.0,0.0
51690.0,6,10,2032,5,524,12669.25,252.0,104.8,5,1508,11506.0,1236.0,301.6
47974.0,6,14,4740,7,653,7873.833333333333,249.0,93.28571428571428,7,4087,7821.166666666667,1514.0,583.8571428571429
233087.0,6,3,337,2,214,0.0,160.0,107.0,1,123,0.0,123.0,123.0
802.0,17,4,438,2,148,0.0,74.0,74.0,2,290,0.0,147.0,145.0
56253.0,6,12,1328,6,731,10693.2,253.0,121.83333333333331,6,597,8562.4,259.0,99.5
32653.0,6,14,4740,7,653,5329.5,249.0,93.28571428571428,7,4087,4104.833333333333,1514.0,583.8571428571429
1067.0,17,2,508,2,508,0.0,257.0,254.0,0,0,0.0,0.0,0.0
26706.0,6,10,2032,5,524,6454.25,252.0,104.8,5,1508,5627.0,1236.0,301.6
2010.0,17,4,344,2,150,0.0,75.0,75.0,2,194,0.0,103.0,97.0
306959.0,6,6,412,4,272,102319.66666666669,74.0,68.0,2,140,0.0,74.0,70.0
502609.0,6,5,336,2,134,0.0,68.0,67.0,3,202,192305.0,70.0,67.33333333333333
122500.0,6,11,2098,6,590,24317.2,252.0,98.33333333333331,5,1508,28854.0,1236.0,301.6
2020.0,17,4,344,2,150,0.0,75.0,75.0,2,194,0.0,103.0,97.0
36203.0,6,14,4740,7,653,5910.333333333333,249.0,93.28571428571428,7,4087,5860.0,1514.0,583.8571428571429
10477302.0,6,7,478,4,272,3446901.333333333,74.0,68.0,3,206,5170225.0,74.0,68.66666666666667
216951.0,6,3,426,2,280,0.0,214.0,140.0,1,146,0.0,146.0,146.0
22848.0,6,14,4740,7,653,3662.8333333333335,249.0,93.28571428571428,7,4087,3335.6666666666665,1514.0,583.8571428571429
91175489.0,6,27,1938,14,1029,6996828.153846154,123.0,73.5,13,909,7579982.166666667,123.0,69.92307692307692
3321096.0,6,193,165146,114,155630,29390.230088495577,1510.0,1365.1754385964912,79,9516,38449.61538461538,1510.0,120.45569620253164
120006177.0,6,18,1341,9,691,14999993.0,95.0,76.77777777777777,9,650,15000415.375,95.0,72.22222222222223
2080.0,17,4,344,2,150,0.0,75.0,75.0,2,194,0.0,103.0,97.0
100792771.0,6,29,2068,15,1105,7184855.928571428,139.0,73.66666666666667,14,963,7737558.384615385,123.0,68.78571428571429
74654945.0,6,9,842,9,842,9331868.125,97.0,93.55555555555556,0,0,0.0,0.0,0.0
100152.0,17,2,762,2,762,0.0,381.0,381.0,0,0,0.0,0.0,0.0
207088.0,17,2,180,1,90,0.0,90.0,90.0,1,90,0.0,90.0,90.0
127495.0,6,3,373,2,238,0.0,172.0,119.0,1,135,0.0,135.0,135.0
196973.0,17,2,180,1,90,0.0,90.0,90.0,1,90,0.0,90.0,90.0
120449826.0,6,18,1508,8,763,13534300.0,221.0,95.375,10,745,13356664.444444444,95.0,74.5
43445.0,6,14,4740,7,653,7118.166666666667,249.0,93.28571428571428,7,4087,6861.0,1514.0,583.8571428571429
196866.0,17,2,180,1,90,0.0,90.0,90.0,1,90,0.0,90.0,90.0
45147.0,6,14,4740,7,653,7381.0,249.0,93.28571428571428,7,4087,6358.333333333333,1514.0,583.8571428571429
309715.0,6,6,412,4,272,103238.33333333331,74.0,68.0,2,140,0.0,74.0,70.0
120124247.0,6,17,2836,9,1204,15015530.875,188.0,133.77777777777777,8,1632,12909311.142857144,204.0,204.0
7116.0,17,4,344,2,150,0.0,75.0,75.0,2,194,0.0,103.0,97.0
2419.0,17,4,344,2,150,0.0,75.0,75.0,2,194,0.0,103.0,97.0
113919793.0,6,32,2220,16,1149,7580272.666666667,123.0,71.8125,16,1071,7580272.666666667,123.0,66.9375
871527.0,6,12,2709,7,742,145254.5,338.0,106.0,5,1967,149731.75,1514.0,393.4
2512.0,17,4,344,2,150,0.0,75.0,75.0,2,194,0.0,103.0,97.0
135133580.0,17,6,1146,6,1146,27026716.0,191.0,191.0,0,0,0.0,0.0,0.0
1361212.0,6,7,499,3,198,613911.5,66.0,66.0,4,301,443023.0,103.0,75.25
118639360.0,6,216,24312,108,16888,1106768.3457943923,284.0,156.37037037037038,108,7424,1106768.2803738315,140.0,68.74074074074075
205845.0,17,2,180,1,90,0.0,90.0,90.0,1,90,0.0,90.0,90.0
312811.0,17,4,1400,4,1400,104270.33333333331,350.0,350.0,0,0,0.0,0.0,0.0
14569.0,6,13,1459,7,862,2428.1666666666665,271.0,123.14285714285714,6,597,2554.6,259.0,99.5
262892.0,6,10,1221,6,636,52578.4,298.0,106.0,4,585,81656.66666666667,379.0,146.25
6345.0,17,4,823,2,163,0.0,89.0,81.5,2,660,0.0,443.0,330.0
93147787.0,17,12,778,6,389,18600173.0,174.0,64.83333333333333,6,389,18602161.4,174.0,64.83333333333333
146107.0,6,3,337,2,214,0.0,160.0,107.0,1,123,0.0,123.0,123.0
51047.0,17,2,180,1,90,0.0,90.0,90.0,1,90,0.0,90.0,90.0
98994.0,6,2,132,1,66,0.0,66.0,66.0,1,66,0.0,66.0,66.0
281369.0,17,2,414,1,88,0.0,88.0,88.0,1,326,0.0,326.0,326.0
38737.0,6,14,4740,7,653,6331.166666666667,249.0,93.28571428571428,7,4087,5838.666666666667,1514.0,583.8571428571429
34815.0,6,10,2032,5,524,6250.25,252.0,104.8,5,1508,8212.5,1236.0,301.6
9591.0,17,2,571,1,86,0.0,86.0,86.0,1,485,0.0,485.0,485.0
44228582.0,6,7,1874,3,887,21740226.0,753.0,295.6666666666667,4,987,13886648.0,785.0,246.75
1309125.0,6,4,264,2,132,0.0,66.0,66.0,2,132,0.0,66.0,66.0
27467.0,6,14,4740,7,653,4134.666666666667,249.0,93.28571428571428,7,4087,3652.8333333333335,1514.0,583.8571428571429
1776317.0,6,2,132,1,66,0.0,66.0,66.0,1,66,0.0,66.0,66.0
216896.0,6,3,426,2,280,0.0,214.0,140.0,1,146,0.0,146.0,146.0
284756.0,17,2,180,1,90,0.0,90.0,90.0,1,90,0.0,90.0,90.0
166949.0,17,4,571,2,148,0.0,74.0,74.0,2,423,0.0,276.0,211.5
273001.0,6,12,1373,7,714,45500.16666666666,298.0,102.0,5,659,63931.25,379.0,131.8
66985.0,6,14,4740,7,653,10977.166666666666,249.0,93.28571428571428,7,4087,6987.5,1514.0,583.8571428571429
48013.0,17,3,1143,3,1143,24006.5,381.0,381.0,0,0,0.0,0.0,0.0
1975.0,17,4,344,2,150,0.0,75.0,75.0,2,194,0.0,103.0,97.0
107005.0,17,2,286,2,286,0.0,143.0,143.0,0,0,0.0,0.0,0.0
158507.0,6,3,337,2,214,0.0,160.0,107.0,1,123,0.0,123.0,123.0
16883.0,17,2,180,1,90,0.0,90.0,90.0,1,90,0.0,90.0,90.0
3007522.0,6,12,2172,7,664,500930.6666666667,252.0,94.85714285714286,5,1508,2679.25,1236.0,301.6
309794.0,17,4,1400,4,1400,103264.66666666669,350.0,350.0,0,0,0.0,0.0,0.0
10519285.0,6,6,412,3,206,5189824.0,74.0,68.66666666666667,3,206,5189737.5,74.0,68.66666666666667
97371733.0,6,26,1746,13,906,8096320.416666667,123.0,69.6923076923077,13,840,8096324.5,123.0,64.61538461538461
305026.0,6,6,412,4,272,101675.33333333331,74.0,68.0,2,140,0.0,74.0,70.0
412.0,17,2,174,1,79,0.0,79.0,79.0,1,95,0.0,95.0,95.0
120092089.0,17,13,690,7,432,19960682.166666668,174.0,61.71428571428572,6,258,20001001.6,43.0,43.0
77114.0,6,14,4740,7,653,12668.666666666666,249.0,93.28571428571428,7,4087,12660.166666666666,1514.0,583.8571428571429
90024395.0,17,28,13364,28,13364,3334236.851851852,501.0,477.2857142857143,0,0,0.0,0.0,0.0
2243.0,17,2,762,2,762,0.0,381.0,381.0,0,0,0.0,0.0,0.0
237327.0,17,2,180,1,90,0.0,90.0,90.0,1,90,0.0,90.0,90.0
97115288.0,6,184,20760,92,14466,1064835.7142857143,284.0,157.2391304347826,92,6294,1064836.076923077,140.0,68.41304347826087
29188.0,6,10,2032,5,524,6969.5,252.0,104.8,5,1508,6983.5,1236.0,301.6
210444.0,6,10,1221,6,636,42088.8,298.0,106.0,4,585,68566.0,379.0,146.25
118036854.0,6,32,2220,16,1149,7869123.6,123.0,71.8125,16,1071,7854709.533333333,123.0,66.9375
38704.0,6,10,2032,5,524,9407.0,252.0,104.8,5,1508,9314.25,1236.0,301.6
6717.0,17,4,823,2,163,0.0,89.0,81.5,2,660,0.0,443.0,330.0
25794.0,6,14,4740,7,653,3674.5,249.0,93.28571428571428,7,4087,4053.8333333333335,1514.0,583.8571428571429
21215.0,6,10,2032,5,524,4871.75,252.0,104.8,5,1508,4588.0,1236.0,301.6
54015.0,6,14,4740,7,653,8578.833333333334,249.0,93.28571428571428,7,4087,8276.166666666666,1514.0,583.8571428571429
153405.0,17,2,180,1,90,0.0,90.0,90.0,1,90,0.0,90.0,90.0
135133634.0,17,6,1146,6,1146,27026726.8,191.0,191.0,0,0,0.0,0.0,0.0
120125769.0,6,13,2036,5,1020,30031442.25,204.0,204.0,8,1016,17137194.14285714,188.0,127.0
90259270.0,6,12,1832,8,1016,12894181.42857143,188.0,127.0,4,816,30029969.33333333,204.0,204.0
2540.0,17,4,344,2,150,0.0,75.0,75.0,2,194,0.0,103.0,97.0
99210398.0,17,12,778,6,389,19842079.6,174.0,64.83333333333333,6,389,19690472.8,174.0,64.83333333333333
22776602.0,17,4,1376,3,1026,1397734.5,342.0,342.0,1,350,0.0,350.0,350.0
90261928.0,6,16,2368,9,1204,11282741.0,188.0,133.77777777777777,7,1164,15015645.0,204.0,166.28571428571428
171578.0,17,2,180,1,90,0.0,90.0,90.0,1,90,0.0,90.0,90.0
2016.0,17,4,344,2,150,0.0,75.0,75.0,2,194,0.0,103.0,97.0
53188.0,6,14,4740,7,653,8222.5,249.0,93.28571428571428,7,4087,7565.333333333333,1514.0,583.8571428571429
102963.0,17,2,286,2,286,0.0,143.0,143.0,0,0,0.0,0.0,0.0
197105.0,17,2,180,1,90,0.0,90.0,90.0,1,90,0.0,90.0,90.0
239379.0,17,2,180,1,90,0.0,90.0,90.0,1,90,0.0,90.0,90.0
90254848.0,6,16,2368,9,1204,11281856.0,188.0,133.77777777777777,7,1164,15015466.0,204.0,166.28571428571428
12292.0,17,4,823,2,163,0.0,89.0,81.5,2,660,0.0,443.0,330.0
95660795.0,17,14,4796,13,4446,6226145.0,342.0,342.0,1,350,0.0,350.0,350.0
216599.0,17,2,180,1,90,0.0,90.0,90.0,1,90,0.0,90.0,90.0
3176.0,17,2,762,2,762,0.0,381.0,381.0,0,0,0.0,0.0,0.0
504318.00000000006,6,5,336,2,134,0.0,68.0,67.0,3,202,192919.0,70.0,67.33333333333333
113618968.0,6,46,3036,23,1518,5150443.227272728,66.0,66.0,23,1518,5150441.5,66.0,66.0
104263.0,17,2,286,2,286,0.0,143.0,143.0,0,0,0.0,0.0,0.0
36043.0,6,14,4740,7,653,5798.5,249.0,93.28571428571428,7,4087,5209.166666666667,1514.0,583.8571428571429
2334.0,17,4,344,2,150,0.0,75.0,75.0,2,194,0.0,103.0,97.0
104537.0,17,2,286,2,286,0.0,143.0,143.0,0,0,0.0,0.0,0.0
16882.0,17,2,180,1,90,0.0,90.0,90.0,1,90,0.0,90.0,90.0
26879.0,6,14,4740,7,653,3951.6666666666665,249.0,93.28571428571428,7,4087,4326.0,1514.0,583.8571428571429
1321575.0,6,4,264,2,132,0.0,66.0,66.0,2,132,0.0,66.0,66.0
249694.0,6,3,337,2,214,0.0,160.0,107.0,1,123,0.0,123.0,123.0
307125.0,17,2,180,1,90,0.0,90.0,90.0,1,90,0.0,90.0,90.0
187485.0,17,4,1400,4,1400,62495.0,350.0,350.0,0,0,0.0,0.0,0.0
5619428.0,6,5,336,2,134,0.0,68.0,67.0,3,202,1527399.5,70.0,67.33333333333333
44454.0,6,14,4740,7,653,5740.833333333333,249.0,93.28571428571428,7,4087,7189.5,1514.0,583.8571428571429
205899.0,6,3,426,2,280,0.0,214.0,140.0,1,146,0.0,146.0,146.0
23323.0,6,14,4740,7,653,3663.5,249.0,93.28571428571428,7,4087,3695.8333333333335,1514.0,583.8571428571429
118947597.0,6,39,2902,20,1531,6260399.842105263,139.0,76.55,19,1371,6596155.277777778,123.0,72.15789473684211
110736320.0,6,217,24648,109,7416,1025336.2962962964,140.0,68.03669724770643,108,17232,1026731.1495327104,284.0,159.55555555555554
105991507.0,6,31,2182,16,1165,7051719.133333334,139.0,72.8125,15,1017,7555414.285714285,123.0,67.8
91409080.0,6,24,1829,13,989,7617070.416666667,95.0,76.07692307692308,11,840,9140724.5,95.0,76.36363636363636
139086.0,6,2,132,1,66,0.0,66.0,66.0,1,66,0.0,66.0,66.0
117841294.0,6,29,1914,15,948,8417235.285714285,123.0,63.2,14,966,8279892.538461538,123.0,69.0
111364898.0,6,188,21204,94,14778,1195151.8279569892,284.0,157.2127659574468,94,6426,1195158.7311827955,140.0,68.36170212765957
128935.0,6,13,1513,7,882,20988.5,291.0,126.0,6,631,25267.6,293.0,105.16666666666669
310551.0,6,6,412,4,272,103517.0,74.0,68.0,2,140,0.0,74.0,70.0
4965895.0,6,13,1386,7,789,827649.1666666666,253.0,112.71428571428572,6,597,989723.6,259.0,99.5
212614.0,17,2,626,1,72,0.0,72.0,72.0,1,554,0.0,554.0,554.0
90294961.0,6,14,1043,7,542,15049160.166666666,95.0,77.42857142857143,7,501,14999272.166666666,95.0,71.57142857142857
24420.0,6,10,2032,5,524,4921.75,252.0,104.8,5,1508,5784.5,1236.0,301.6
206054.0,6,3,426,2,280,0.0,214.0,140.0,1,146,0.0,146.0,146.0
153419.0,17,2,180,1,90,0.0,90.0,90.0,1,90,0.0,90.0,90.0
119366815.0,6,34,2350,17,1225,7446921.5625,139.0,72.05882352941177,17,1125,7446935.9375,123.0,66.17647058823529
5001856.0,17,2,150,2,150,0.0,75.0,75.0,0,0,0.0,0.0,0.0
90767677.0,6,19,1436,10,745,10080707.555555556,95.0,74.5,9,691,11345636.25,95.0,76.77777777777777
1204623.0,17,7,490,7,490,200770.5,70.0,70.0,0,0,0.0,0.0,0.0
332.0,17,2,160,1,80,0.0,80.0,80.0,1,80,0.0,80.0,80.0
118581155.0,17,80,33360,80,33360,1501027.278481013,453.0,417.0,0,0,0.0,0.0,0.0
1908.0,17,2,192,1,88,0.0,88.0,88.0,1,104,0.0,104.0,104.0
2431626.0,6,49,23728,25,19797,101317.75,1514.0,791.88,24,3931,95567.52173913045,1514.0,163.79166666666666
108105939.0,17,5,955,5,955,27026484.75,191.0,191.0,0,0,0.0,0.0,0.0
126009247.0,17,15,907,8,475,18001321.0,174.0,59.375,7,432,17666818.666666668,174.0,61.71428571428572
107100.0,17,2,286,2,286,0.0,143.0,143.0,0,0,0.0,0.0,0.0
135132480.0,17,6,1206,6,1206,27026496.0,201.0,201.0,0,0,0.0,0.0,0.0
300429.0,6,6,412,4,272,100143.0,74.0,68.0,2,140,0.0,74.0,70.0
77922.0,6,18,7491,10,823,8658.0,221.0,82.3,8,6668,9909.57142857143,1514.0,833.5
220782.0,6,3,426,2,280,0.0,214.0,140.0,1,146,0.0,146.0,146.0
1974.0,17,4,344,2,150,0.0,75.0,75.0,2,194,0.0,103.0,97.0
2001.0,17,4,344,2,150,0.0,75.0,75.0,2,194,0.0,103.0,97.0
299782.0,17,2,237,1,81,0.0,81.0,81.0,1,156,0.0,156.0,156.0
302408.0,6,6,412,4,272,100802.66666666669,74.0,68.0,2,140,0.0,74.0,70.0
340.0,17,2,166,1,75,0.0,75.0,75.0,1,91,0.0,91.0,91.0
313668.0,6,6,412,4,272,104556.0,74.0,68.0,2,140,0.0,74.0,70.0
143912.0,17,2,180,1,90,0.0,90.0,90.0,1,90,0.0,90.0,90.0
2803397.0,6,2,132,1,66,0.0,66.0,66.0,1,66,0.0,66.0,66.0
69230.0,6,14,4740,7,653,9893.333333333334,249.0,93.28571428571428,7,4087,10900.0,1514.0,583.8571428571429
307505.0,6,12,1373,7,714,51250.833333333336,298.0,102.0,5,659,72087.0,379.0,131.8
120966840.0,6,39,2770,20,1468,6366675.7894736845,139.0,73.4,19,1302,6153684.777777778,123.0,68.52631578947368
2638.0,17,4,344,2,150,0.0,75.0,75.0,2,194,0.0,103.0,97.0
1170996.0,6,13,3020,8,2392,167285.14285714287,1514.0,299.0,5,628,223853.5,331.0,125.6
90032193.0,17,27,12943,27,12943,3462776.653846154,501.0,479.3703703703704,0,0,0.0,0.0,0.0
90052475.0,17,27,12943,27,12943,3463556.730769231,501.0,479.3703703703704,0,0,0.0,0.0,0.0
48682.0,6,14,4740,7,653,7324.333333333333,249.0,93.28571428571428,7,4087,7902.5,1514.0,583.8571428571429
240858.0,6,3,337,2,214,0.0,160.0,107.0,1,123,0.0,123.0,123.0
98344117.0,17,12,778,6,389,19601373.2,174.0,64.83333333333333,6,389,19600169.6,174.0,64.83333333333333
311.0,17,2,174,1,79,0.0,79.0,79.0,1,95,0.0,95.0,95.0
302182.0,6,6,412,4,272,100727.33333333331,74.0,68.0,2,140,0.0,74.0,70.0
35642.0,6,14,4740,7,653,5104.5,249.0,93.28571428571428,7,4087,4836.666666666667,1514.0,583.8571428571429
34529.0,6,14,4740,7,653,5260.5,249.0,93.28571428571428,7,4087,5198.166666666667,1514.0,583.8571428571429
135128604.0,17,6,1206,6,1206,27025720.8,201.0,201.0,0,0,0.0,0.0,0.0
2799770.0,6,2,132,1,66,0.0,66.0,66.0,1,66,0.0,66.0,66.0
21430.0,6,14,4740,7,653,3462.6666666666665,249.0,93.28571428571428,7,4087,3401.833333333333,1514.0,583.8571428571429
211274.0,17,2,180,1,90,0.0,90.0,90.0,1,90,0.0,90.0,90.0
20343.0,17,2,582,1,83,0.0,83.0,83.0,1,499,0.0,499.0,499.0
302483.0,6,6,412,4,272,100827.66666666669,74.0,68.0,2,140,0.0,74.0,70.0
920015.0,6,12,2718,7,743,153335.83333333334,339.0,106.14285714285714,5,1975,161006.25,1514.0,395.0
367.0,17,2,267,1,83,0.0,83.0,83.0,1,184,0.0,184.0,184.0
19766.0,6,10,2032,5,524,4333.25,252.0,104.8,5,1508,3643.5,1236.0,301.6
207322.0,6,3,426,2,280,0.0,214.0,140.0,1,146,0.0,146.0,146.0
1508.0,17,4,820,2,156,0.0,78.0,78.0,2,664,0.0,332.0,332.0
113733926.0,6,46,3036,23,1518,5155443.590909091,66.0,66.0,23,1518,5155447.318181818,66.0,66.0
205866.0,17,2,180,1,90,0.0,90.0,90.0,1,90,0.0,90.0,90.0
90526895.0,6,15,2444,8,1016,12932413.57142857,188.0,127.0,7,1428,15060624.5,204.0,204.0
218258.0,6,3,426,2,280,0.0,214.0,140.0,1,146,0.0,146.0,146.0
243154.0,17,2,180,1,90,0.0,90.0,90.0,1,90,0.0,90.0,90.0
29604.0,6,14,4740,7,653,4535.833333333333,249.0,93.28571428571428,7,4087,4790.666666666667,1514.0,583.8571428571429
303634.0,6,2,132,1,66,0.0,66.0,66.0,1,66,0.0,66.0,66.0
112549.0,17,2,286,2,286,0.0,143.0,143.0,0,0,0.0,0.0,0.0
1678607.0,6,19,7533,10,1403,186511.88888888888,583.0,140.3,9,6130,178340.125,1484.0,681.1111111111111
90045514.0,17,28,13364,28,13364,3335019.037037037,501.0,477.2857142857143,0,0,0.0,0.0,0.0
215500.0,17,2,180,1,90,0.0,90.0,90.0,1,90,0.0,90.0,90.0
92275587.0,17,12,778,6,389,18401151.8,174.0,64.83333333333333,6,389,18400144.6,174.0,64.83333333333333
300472.0,6,6,412,4,272,100157.33333333331,74.0,68.0,2,140,0.0,74.0,70.0
837237.0,6,9,1118,6,586,167447.4,248.0,97.66666666666669,3,532,280845.0,392.0,177.33333333333334
120021173.0,17,28,13364,28,13364,4445228.62962963,501.0,477.2857142857143,0,0,0.0,0.0,0.0
107846966.0,6,28,1860,14,966,8295920.461538462,123.0,69.0,14,894,8279274.461538462,123.0,63.85714285714285
933341.0,6,12,1447,6,816,185482.8,291.0,136.0,6,631,185478.0,293.0,105.16666666666669
109216642.0,17,10,900,5,450,27248976.75,90.0,90.0,5,450,27249027.5,90.0,90.0
153441.0,17,2,180,1,90,0.0,90.0,90.0,1,90,0.0,90.0,90.0
120000064.0,6,20,1531,11,840,12000006.4,95.0,76.36363636363636,9,691,11286155.875,95.0,76.77777777777777
872536.0,6,10,1334,6,797,174507.2,459.0,132.83333333333334,4,537,199059.0,331.0,134.25
16935.0,6,20,7606,11,978,1693.5,310.0,88.9090909090909,9,6628,1865.75,1514.0,736.4444444444445
8736033.0,17,3,1034,2,684,0.0,342.0,342.0,1,350,0.0,350.0,350.0
90205570.0,6,21,1585,10,745,9996052.888888888,95.0,74.5,11,840,9000094.1,95.0,76.36363636363636
2490.0,17,4,344,2,150,0.0,75.0,75.0,2,194,0.0,103.0,97.0
2590440.0,6,2,132,1,66,0.0,66.0,66.0,1,66,0.0,66.0,66.0
107009.0,17,2,286,2,286,0.0,143.0,143.0,0,0,0.0,0.0,0.0
2436.0,17,2,762,2,762,0.0,381.0,381.0,0,0,0.0,0.0,0.0
13609927.0,6,20,1607,10,975,1478359.2222222222,315.0,97.5,10,632,1478340.111111111,78.0,63.2
3065273.0,6,12,2172,7,664,510610.0,252.0,94.85714285714286,5,1508,11635.5,1236.0,301.6
206082.0,17,2,180,1,90,0.0,90.0,90.0,1,90,0.0,90.0,90.0
305127.0,6,6,412,4,272,101709.0,74.0,68.0,2,140,0.0,74.0,70.0
120002512.0,17,29,13785,29,13785,4285804.0,501.0,475.3448275862069,0,0,0.0,0.0,0.0
216528.0,17,2,180,1,90,0.0,90.0,90.0,1,90,0.0,90.0,90.0
23884.0,6,10,2032,5,524,5675.25,252.0,104.8,5,1508,5297.75,1236.0,301.6
2483582.0,6,25,7573,14,3735,191044.7692307692,1514.0,266.7857142857143,11,3838,222055.6,1514.0,348.90909090909093
10833984.0,6,7,478,3,206,5348992.5,74.0,68.66666666666667,4,272,3565907.333333333,74.0,68.0
108101955.0,17,5,1005,5,1005,27025488.75,201.0,201.0,0,0,0.0,0.0,0.0
870126.0,6,12,1362,6,731,172443.0,253.0,121.83333333333331,6,631,173416.4,293.0,105.16666666666669
63253.00000000001,6,14,4740,7,653,8332.5,249.0,93.28571428571428,7,4087,9614.833333333334,1514.0,583.8571428571429
107687.0,17,2,286,2,286,0.0,143.0,143.0,0,0,0.0,0.0,0.0
90359433.0,6,13,2052,6,1224,18071401.2,204.0,204.0,7,828,15014114.166666666,188.0,118.28571428571428
37683.0,6,14,4740,7,653,6101.166666666667,249.0,93.28571428571428,7,4087,5743.833333333333,1514.0,583.8571428571429
233101.0,6,3,337,2,214,0.0,160.0,107.0,1,123,0.0,123.0,123.0
861.0,17,5,550,5,550,215.25,110.0,110.0,0,0,0.0,0.0,0.0
45847.0,6,14,4740,7,653,7475.666666666667,249.0,93.28571428571428,7,4087,6973.666666666667,1514.0,583.8571428571429
90315208.0,6,18,1501,9,851,11282802.0,255.0,94.55555555555556,9,650,11288225.375,95.0,72.22222222222223
135134148.0,17,6,1206,6,1206,27026829.6,201.0,201.0,0,0,0.0,0.0,0.0
359.0,17,2,160,1,80,0.0,80.0,80.0,1,80,0.0,80.0,80.0
135129063.0,17,6,1206,6,1206,27025812.6,201.0,201.0,0,0,0.0,0.0,0.0
1303018.0,6,4,264,2,132,0.0,66.0,66.0,2,132,0.0,66.0,66.0
98467488.0,6,31,2314,16,1228,6564499.2,139.0,76.75,15,1086,7017944.714285715,123.0,72.4
0.0,6,1,66,1,66,0.0,66.0,66.0,0,0,0.0,0.0,0.0
120123675.0,6,13,2036,8,1016,17137262.85714286,188.0,127.0,5,1020,22523682.0,204.0,204.0
8882.0,17,2,539,1,86,0.0,86.0,86.0,1,453,0.0,453.0,453.0
106075.0,17,2,700,2,700,0.0,350.0,350.0,0,0,0.0,0.0,0.0
1303.0,17,2,762,2,762,0.0,381.0,381.0,0,0,0.0,0.0,0.0
19878.0,6,10,1065,5,534,4705.0,262.0,106.8,5,531,4748.25,259.0,106.2
121124081.0,17,14,995,7,432,17500198.166666668,174.0,61.71428571428572,7,563,19487923.666666668,174.0,80.42857142857143
128533885.0,6,34,2356,18,1285,7560816.764705882,139.0,71.38888888888889,16,1071,7889403.8,123.0,66.9375
122536986.0,17,14,864,7,432,17166827.0,174.0,61.71428571428572,7,432,17168116.666666668,174.0,61.71428571428572
217680.0,6,3,426,2,280,0.0,214.0,140.0,1,146,0.0,146.0,146.0
4297.0,17,2,626,1,72,0.0,72.0,72.0,1,554,0.0,554.0,554.0
120449378.0,6,215,24358,108,17000,1125695.1214953272,284.0,157.40740740740742,107,7358,1126612.6981132077,140.0,68.76635514018692
0.0,17,1,55,1,55,0.0,55.0,55.0,0,0,0.0,0.0,0.0
135124160.0,17,6,1146,6,1146,27024832.0,191.0,191.0,0,0,0.0,0.0,0.0
124009062.0,17,15,1169,8,606,17715580.285714287,174.0,75.75,7,563,17333490.666666668,174.0,80.42857142857143
191251.0,17,2,180,1,90,0.0,90.0,90.0,1,90,0.0,90.0,90.0
2802138.0,6,2,132,1,66,0.0,66.0,66.0,1,66,0.0,66.0,66.0
90253525.0,6,21,1585,10,745,10028169.444444444,95.0,74.5,11,840,8998523.7,95.0,76.36363636363636
271188.0,6,10,1221,6,636,54237.6,298.0,106.0,4,585,84974.33333333333,379.0,146.25
240885.0,6,3,337,2,214,0.0,160.0,107.0,1,123,0.0,123.0,123.0
51643.0,6,14,4740,7,653,7114.666666666667,249.0,93.28571428571428,7,4087,8433.833333333334,1514.0,583.8571428571429
90532054.0,6,14,2240,8,1016,12933150.57142857,188.0,127.0,6,1224,18072039.0,204.0,204.0
2175027.0,6,20,6935,11,1567,217502.7,408.0,142.45454545454547,9,5368,229105.375,1514.0,596.4444444444445
90328045.0,6,14,2102,8,1016,12904006.42857143,188.0,127.0,6,1086,18032848.6,204.0,181.0
0.0,17,1,55,1,55,0.0,55.0,55.0,0,0,0.0,0.0,0.0
172318.0,17,4,1524,4,1524,57439.333333333336,381.0,381.0,0,0,0.0,0.0,0.0
28949.0,6,14,4740,7,653,4684.166666666667,249.0,93.28571428571428,7,4087,4119.5,1514.0,583.8571428571429
130434.0,17,2,582,1,83,0.0,83.0,83.0,1,499,0.0,499.0,499.0
322533.0,6,6,412,4,272,107511.0,74.0,68.0,2,140,0.0,74.0,70.0
349.0,17,2,267,1,83,0.0,83.0,83.0,1,184,0.0,184.0,184.0
2023297.0,17,4,525,2,150,0.0,75.0,75.0,2,375,0.0,284.0,187.5
123258.0,6,3,373,2,238,0.0,172.0,119.0,1,135,0.0,135.0,135.0
197104.0,17,2,180,1,90,0.0,90.0,90.0,1,90,0.0,90.0,90.0
206011.0,6,3,426,2,280,0.0,214.0,140.0,1,146,0.0,146.0,146.0
344.0,17,2,267,1,83,0.0,83.0,83.0,1,184,0.0,184.0,184.0
121375070.0,6,238,26844,119,8150,982707.0508474576,140.0,68.4873949579832,119,18694,1021613.9491525424,300.0,157.0924369747899
120201357.0,6,176,19946,88,6104,1372189.3103448276,140.0,69.36363636363636,88,13842,1372117.0689655172,284.0,157.29545454545453
19736.0,6,2,145,2,145,0.0,91.0,72.5,0,0,0.0,0.0,0.0
134068.0,6,2,132,1,66,0.0,66.0,66.0,1,66,0.0,66.0,66.0
19264.0,6,14,4740,7,653,3025.0,249.0,93.28571428571428,7,4087,3066.833333333333,1514.0,583.8571428571429
367.0,17,2,166,1,75,0.0,75.0,75.0,1,91,0.0,91.0,91.0
2720.0,17,4,344,2,150,0.0,75.0,75.0,2,194,0.0,103.0,97.0
115373.0,17,4,1400,4,1400,38457.66666666666,350.0,350.0,0,0,0.0,0.0,0.0
49982.0,6,14,4740,7,653,7820.333333333333,249.0,93.28571428571428,7,4087,6359.833333333333,1514.0,583.8571428571429
81032.0,6,14,4740,7,653,13266.5,249.0,93.28571428571428,7,4087,13356.333333333334,1514.0,583.8571428571429
180560.0,17,4,704,2,148,0.0,74.0,74.0,2,556,0.0,280.0,278.0
2691192.0,6,2,132,1,66,0.0,66.0,66.0,1,66,0.0,66.0,66.0
162323.0,17,2,180,1,90,0.0,90.0,90.0,1,90,0.0,90.0,90.0
881030.0,6,10,1334,6,797,176206.0,459.0,132.83333333333334,4,537,201830.66666666663,331.0,134.25
183741.0,6,10,1066,5,490,44608.0,218.0,98.0,5,576,45628.25,304.0,115.2
693.0,17,4,438,2,148,0.0,74.0,74.0,2,290,0.0,147.0,145.0
90663339.0,6,17,2572,9,1204,11332917.375,188.0,133.77777777777777,8,1368,12928911.285714284,204.0,171.0
249580.0,17,4,6056,4,6056,83193.33333333333,1514.0,1514.0,0,0,0.0,0.0,0.0
90266304.0,6,12,1832,8,1016,12895186.285714284,188.0,127.0,4,816,30029429.33333333,204.0,204.0
21004493.0,17,3,1034,2,684,0.0,342.0,342.0,1,350,0.0,350.0,350.0
55779.0,6,14,4740,7,653,8060.0,249.0,93.28571428571428,7,4087,8004.666666666667,1514.0,583.8571428571429
90019921.0,17,28,13364,28,13364,3334071.1481481483,501.0,477.2857142857143,0,0,0.0,0.0,0.0
40001.0,6,10,2032,5,524,9556.0,252.0,104.8,5,1508,8514.5,1236.0,301.6
1445685.0,6,7,499,4,301,468386.6666666667,103.0,75.25,3,198,716387.5,66.0,66.0
42430.0,6,14,4740,7,653,6545.0,249.0,93.28571428571428,7,4087,5971.0,1514.0,583.8571428571429
34602.0,6,14,4740,7,653,5594.833333333333,249.0,93.28571428571428,7,4087,4588.833333333333,1514.0,583.8571428571429
2846829.0,6,3,204,2,136,0.0,70.0,68.0,1,68,0.0,68.0,68.0
416.0,17,2,762,2,762,0.0,381.0,381.0,0,0,0.0,0.0,0.0
575535.0,6,4,508,2,238,0.0,172.0,119.0,2,270,0.0,135.0,135.0
322.0,17,2,174,1,79,0.0,79.0,79.0,1,95,0.0,95.0,95.0
128008260.0,17,15,907,8,475,18286894.285714287,174.0,59.375,7,432,18000179.5,174.0,61.71428571428572
58884884.0,17,9,3086,8,2736,5108436.857142857,342.0,342.0,1,350,0.0,350.0,350.0
2875850.0,6,3,1777,1,826,0.0,826.0,826.0,2,951,0.0,885.0,475.5
146176.0,6,3,337,2,214,0.0,160.0,107.0,1,123,0.0,123.0,123.0
28444.0,6,2,145,2,145,0.0,91.0,72.5,0,0,0.0,0.0,0.0
96132144.0,6,59,12411,28,6468,3560449.777777778,1514.0,231.0,31,5943,3195571.1666666665,1514.0,191.70967741935485
232843.0,6,3,337,2,214,0.0,160.0,107.0,1,123,0.0,123.0,123.0
312488.0,6,6,412,4,272,104162.66666666669,74.0,68.0,2,140,0.0,74.0,70.0
7157.0,17,2,582,1,83,0.0,83.0,83.0,1,499,0.0,499.0,499.0
115102488.0,6,212,24076,106,7218,1078061.9714285715,140.0,68.09433962264151,106,16858,1088223.123809524,300.0,159.03773584905662
2806003.0,6,2,132,1,66,0.0,66.0,66.0,1,66,0.0,66.0,66.0
107497.0,17,2,286,2,286,0.0,143.0,143.0,0,0,0.0,0.0,0.0
41745.0,6,10,2032,5,524,10213.5,252.0,104.8,5,1508,9433.25,1236.0,301.6
120123325.0,6,15,2428,9,1204,15015415.625,188.0,133.77777777777777,6,1224,18073624.6,204.0,204.0
206093.0,6,3,426,2,280,0.0,214.0,140.0,1,146,0.0,146.0,146.0
2302.0,17,4,344,2,150,0.0,75.0,75.0,2,194,0.0,103.0,97.0
90257319.0,6,13,2036,8,1016,12893902.714285716,188.0,127.0,5,1020,22523811.0,204.0,204.0
21295.0,6,2,145,2,145,0.0,91.0,72.5,0,0,0.0,0.0,0.0
8271.0,6,10,2032,5,524,1856.0,252.0,104.8,5,1508,1806.5,1236.0,301.6
1040730.0,6,11,1134,6,558,208146.0,220.0,93.0,5,576,258883.0,304.0,115.2
102841.0,17,2,286,2,286,0.0,143.0,143.0,0,0,0.0,0.0,0.0
90034721.0,17,28,13364,28,13364,3334619.296296296,501.0,477.2857142857143,0,0,0.0,0.0,0.0
122217.0,6,3,373,2,238,0.0,172.0,119.0,1,135,0.0,135.0,135.0
339.0,17,2,267,1,83,0.0,83.0,83.0,1,184,0.0,184.0,184.0
3004828.0,6,11,2106,6,598,600789.0,252.0,99.66666666666669,5,1508,1602.5,1236.0,301.6
1312040.0,17,7,490,7,490,218673.3333333333,70.0,70.0,0,0,0.0,0.0,0.0
9782.0,17,2,582,1,83,0.0,83.0,83.0,1,499,0.0,499.0,499.0
52218.0,6,10,2032,5,524,10833.5,252.0,104.8,5,1508,12627.75,1236.0,301.6
36456.0,6,14,4740,7,653,5955.0,249.0,93.28571428571428,7,4087,5937.666666666667,1514.0,583.8571428571429
17459.0,6,14,4740,7,653,2756.5,249.0,93.28571428571428,7,4087,2774.1666666666665,1514.0,583.8571428571429
13615700.0,6,20,1646,10,1014,1478686.111111111,315.0,101.4,10,632,1478989.7777777778,78.0,63.2
39431.0,6,14,4740,7,653,6461.833333333333,249.0,93.28571428571428,7,4087,5342.666666666667,1514.0,583.8571428571429
108117852.0,17,5,1005,5,1005,27029463.0,201.0,201.0,0,0,0.0,0.0,0.0
321735.0,17,2,180,1,90,0.0,90.0,90.0,1,90,0.0,90.0,90.0
37109.0,6,10,2032,5,524,9005.0,252.0,104.8,5,1508,8162.0,1236.0,301.6
35245.0,6,10,2032,5,524,8581.0,252.0,104.8,5,1508,7887.5,1236.0,301.6
108675.0,17,2,286,2,286,0.0,143.0,143.0,0,0,0.0,0.0,0.0
108105387.0,17,5,1005,5,1005,27026346.75,201.0,201.0,0,0,0.0,0.0,0.0
103005882.0,17,13,1083,7,563,17167647.0,174.0,80.42857142857143,6,520,17007014.6,174.0,86.66666666666667
121389.0,6,3,337,2,214,0.0,160.0,107.0,1,123,0.0,123.0,123.0
98058.0,17,2,762,2,762,0.0,381.0,381.0,0,0,0.0,0.0,0.0
2348.0,17,4,344,2,150,0.0,75.0,75.0,2,194,0.0,103.0,97.0
206983.0,17,2,762,2,762,0.0,381.0,381.0,0,0,0.0,0.0,0.0
121304.0,6,3,337,2,214,0.0,160.0,107.0,1,123,0.0,123.0,123.0
90251590.0,6,14,2240,8,1016,12893084.285714284,188.0,127.0,6,1224,18017898.0,204.0,204.0
38486.0,6,14,4740,7,653,5494.833333333333,249.0,93.28571428571428,7,4087,5322.5,1514.0,583.8571428571429
3105023.0,6,3,1604,2,851,0.0,785.0,425.5,1,753,0.0,753.0,753.0
120015961.0,17,28,13364,28,13364,4445035.592592592,501.0,477.2857142857143,0,0,0.0,0.0,0.0
2005.0,17,4,344,2,150,0.0,75.0,75.0,2,194,0.0,103.0,97.0
120177675.0,6,232,26072,116,7952,1028623.8086956522,140.0,68.55172413793103,116,18120,1037619.8695652174,284.0,156.20689655172413
21388.0,6,14,4740,7,653,3342.333333333333,249.0,93.28571428571428,7,4087,3316.833333333333,1514.0,583.8571428571429
262591.0,6,3,337,2,214,0.0,160.0,107.0,1,123,0.0,123.0,123.0
21159.0,6,14,4740,7,653,3091.1666666666665,249.0,93.28571428571428,7,4087,3119.1666666666665,1514.0,583.8571428571429
258976.0,6,10,1221,6,636,51795.2,298.0,106.0,4,585,80447.66666666667,379.0,146.25
139459.0,6,2,132,1,66,0.0,66.0,66.0,1,66,0.0,66.0,66.0
2432.0,17,4,344,2,150,0.0,75.0,75.0,2,194,0.0,103.0,97.0
2077.0,17,4,344,2,150,0.0,75.0,75.0,2,194,0.0,103.0,97.0
250045.00000000003,17,4,6056,4,6056,83348.33333333333,1514.0,1514.0,0,0,0.0,0.0,0.0
297887.0,6,6,412,4,272,99295.66666666669,74.0,68.0,2,140,0.0,74.0,70.0
20213.0,6,20,7606,11,978,2021.3,310.0,88.9090909090909,9,6628,2130.0,1514.0,736.4444444444445
299341.0,6,6,412,4,272,99780.33333333331,74.0,68.0,2,140,0.0,74.0,70.0
108109392.0,17,5,1005,5,1005,27027348.0,201.0,201.0,0,0,0.0,0.0,0.0
228230.0,17,2,180,1,90,0.0,90.0,90.0,1,90,0.0,90.0,90.0
147705.0,6,3,373,2,238,0.0,172.0,119.0,1,135,0.0,135.0,135.0
298836.0,6,6,412,4,272,99612.0,74.0,68.0,2,140,0.0,74.0,70.0
307223.0,6,6,412,4,272,102407.66666666669,74.0,68.0,2,140,0.0,74.0,70.0
90744803.0,6,19,1436,10,745,10077111.888888888,95.0,74.5,9,691,11342243.375,95.0,76.77777777777777
33705669.0,6,5,336,2,134,0.0,68.0,67.0,3,202,15564973.0,70.0,67.33333333333333
216589.0,17,2,180,1,90,0.0,90.0,90.0,1,90,0.0,90.0,90.0
190961.0,17,2,180,1,90,0.0,90.0,90.0,1,90,0.0,90.0,90.0
65454.0,6,14,4740,7,653,9846.666666666666,249.0,93.28571428571428,7,4087,10519.0,1514.0,583.8571428571429
108112990.0,17,5,1005,5,1005,27028247.5,201.0,201.0,0,0,0.0,0.0,0.0
2745.0,17,4,344,2,150,0.0,75.0,75.0,2,194,0.0,103.0,97.0
90257096.0,6,14,2240,8,1016,12893870.857142856,188.0,127.0,6,1224,18018800.4,204.0,204.0
307552.0,6,6,412,4,272,102517.33333333331,74.0,68.0,2,140,0.0,74.0,70.0
28436.0,6,14,4740,7,653,4572.666666666667,249.0,93.28571428571428,7,4087,4559.166666666667,1514.0,583.8571428571429
128825538.0,17,14,864,7,432,18166849.33333333,174.0,61.71428571428572,7,432,18167394.666666668,174.0,61.71428571428572
310.0,17,2,164,1,82,0.0,82.0,82.0,1,82,0.0,82.0,82.0
142125.0,17,4,704,2,148,0.0,74.0,74.0,2,556,0.0,280.0,278.0
307762.0,6,6,412,4,272,102587.33333333331,74.0,68.0,2,140,0.0,74.0,70.0
293069.0,17,2,180,1,90,0.0,90.0,90.0,1,90,0.0,90.0,90.0
33214.0,6,14,4740,7,653,5257.5,249.0,93.28571428571428,7,4087,5086.166666666667,1514.0,583.8571428571429
26853512.0,6,10,684,6,396,5370702.4,95.0,66.0,4,288,8881433.666666666,95.0,72.0
105878.0,17,2,700,2,700,0.0,350.0,350.0,0,0,0.0,0.0,0.0
4998059.0,17,2,168,2,168,0.0,84.0,84.0,0,0,0.0,0.0,0.0
153413.0,17,2,180,1,90,0.0,90.0,90.0,1,90,0.0,90.0,90.0
91159572.0,6,164,18412,82,12778,1122771.4197530863,284.0,155.82926829268294,82,5634,1122769.6790123456,140.0,68.70731707317073
2082752.0,6,25,7611,13,2516,173562.66666666666,1034.0,193.53846153846155,12,5095,162135.27272727274,1510.0,424.5833333333333
206240.0,6,3,426,2,280,0.0,214.0,140.0,1,146,0.0,146.0,146.0
120024714.0,17,29,13785,29,13785,4286596.928571428,501.0,475.3448275862069,0,0,0.0,0.0,0.0
103312504.0,6,42,2772,21,1386,5150441.9,66.0,66.0,21,1386,5150442.1,66.0,66.0
316482.0,17,2,604,1,75,0.0,75.0,75.0,1,529,0.0,529.0,529.0
2043.0,17,4,344,2,150,0.0,75.0,75.0,2,194,0.0,103.0,97.0
120151124.0,6,32,2220,16,1071,8010074.933333334,123.0,66.9375,16,1149,7329628.266666667,123.0,71.8125
121796.0,6,3,337,2,214,0.0,160.0,107.0,1,123,0.0,123.0,123.0
14783.0,6,10,2032,5,524,3462.5,252.0,104.8,5,1508,2977.25,1236.0,301.6
66431.0,6,10,2032,5,524,16017.25,252.0,104.8,5,1508,6010.0,1236.0,301.6
206165.0,6,3,426,2,280,0.0,214.0,140.0,1,146,0.0,146.0,146.0
120000227.0,6,18,1382,9,691,15000028.375,95.0,76.77777777777777,9,691,14968411.5,95.0,76.77777777777777
90040468.0,17,28,13364,28,13364,3334832.1481481483,501.0,477.2857142857143,0,0,0.0,0.0,0.0
3004353.0,6,11,2106,6,598,600662.6,252.0,99.66666666666669,5,1508,1683.5,1236.0,301.6
104791.0,17,2,286,2,286,0.0,143.0,143.0,0,0,0.0,0.0,0.0
258396.00000000003,6,10,1221,6,636,51679.2,298.0,106.0,4,585,80374.66666666667,379.0,146.25
122234.0,6,3,373,2,238,0.0,172.0,119.0,1,135,0.0,135.0,135.0
49049.0,6,10,2032,5,524,10685.5,252.0,104.8,5,1508,11328.75,1236.0,301.6
120000784.0,6,18,1382,10,786,13333420.444444444,95.0,78.6,8,596,12899008.142857144,95.0,74.5
20037.0,6,11,2098,6,590,3677.2,252.0,98.33333333333331,5,1508,4339.5,1236.0,301.6
3188607.0,17,3,1026,3,1026,1594303.5,342.0,342.0,0,0,0.0,0.0,0.0
1310288.0,6,4,264,2,132,0.0,66.0,66.0,2,132,0.0,66.0,66.0
303741.0,6,6,412,4,272,101247.0,74.0,68.0,2,140,0.0,74.0,70.0
4443.0,17,2,614,1,72,0.0,72.0,72.0,1,542,0.0,542.0,542.0
106577.0,17,2,700,2,700,0.0,350.0,350.0,0,0,0.0,0.0,0.0
107195555.0,6,44,2904,22,1452,5104550.238095238,66.0,66.0,22,1452,5088853.80952381,66.0,66.0
11537340.0,6,7,499,4,301,3575253.6666666665,103.0,75.25,3,198,4117644.0,66.0,66.0
237433.0,6,3,337,2,214,0.0,160.0,107.0,1,123,0.0,123.0,123.0
413.0,17,2,508,2,508,0.0,257.0,254.0,0,0,0.0,0.0,0.0
0.0,6,1,160,1,160,0.0,160.0,160.0,0,0,0.0,0.0,0.0
90057947.0,17,28,13364,28,13364,3335479.5185185187,501.0,477.2857142857143,0,0,0.0,0.0,0.0
232992.0,6,3,337,2,214,0.0,160.0,107.0,1,123,0.0,123.0,123.0
90251137.0,6,13,2174,7,950,15014725.0,188.0,135.71428571428572,6,1224,18017945.0,204.0,204.0
120122504.0,6,13,2020,9,1204,15015313.0,188.0,133.77777777777777,4,816,30031169.33333333,204.0,204.0
47607400.0,6,7,1874,3,887,22587268.0,753.0,295.6666666666667,4,987,14929150.666666666,785.0,246.75
21207.0,17,2,539,1,86,0.0,86.0,86.0,1,453,0.0,453.0,453.0
3291152.0,6,146,135007,95,127339,35012.255319148935,1510.0,1340.4105263157894,51,7668,59714.9,1510.0,150.35294117647058
245628.0,6,3,337,2,214,0.0,160.0,107.0,1,123,0.0,123.0,123.0
34298.0,6,14,4740,7,653,5591.5,249.0,93.28571428571428,7,4087,4815.833333333333,1514.0,583.8571428571429
886996.0,6,10,1334,6,797,177399.2,459.0,132.83333333333334,4,537,204775.3333333333,331.0,134.25
109813.0,17,2,286,2,286,0.0,143.0,143.0,0,0,0.0,0.0,0.0
2018146.0,17,4,525,2,150,0.0,75.0,75.0,2,375,0.0,284.0,187.5
315953.0,17,4,1400,4,1400,105317.66666666669,350.0,350.0,0,0,0.0,0.0,0.0
47056.0,6,14,4740,7,653,7219.333333333333,249.0,93.28571428571428,7,4087,7121.166666666667,1514.0,583.8571428571429
153429.0,17,2,180,1,90,0.0,90.0,90.0,1,90,0.0,90.0,90.0
2572751.0,6,2,132,1,66,0.0,66.0,66.0,1,66,0.0,66.0,66.0
98765.0,17,2,762,2,762,0.0,381.0,381.0,0,0,0.0,0.0,0.0
127001207.0,17,15,907,8,475,18143029.57142857,174.0,59.375,7,432,17834331.166666668,174.0,61.71428571428572
108102386.0,17,5,1005,5,1005,27025596.5,201.0,201.0,0,0,0.0,0.0,0.0
90096439.0,6,12,1848,5,1020,22523516.25,204.0,204.0,7,828,15015662.666666666,188.0,118.28571428571428
90776944.0,6,19,1436,10,745,10081458.777777778,95.0,74.5,9,691,11344584.75,95.0,76.77777777777777
108103419.0,17,5,955,5,955,27025854.75,191.0,191.0,0,0,0.0,0.0,0.0
57935.0,6,14,4740,7,653,9212.833333333334,249.0,93.28571428571428,7,4087,5367.333333333333,1514.0,583.8571428571429
113673946.0,6,48,3168,24,1584,4942345.478260869,66.0,66.0,24,1584,4935651.956521739,66.0,66.0
63526.0,6,14,4740,7,653,10036.833333333334,249.0,93.28571428571428,7,4087,9236.666666666666,1514.0,583.8571428571429
301892.0,6,6,412,4,272,100630.66666666669,74.0,68.0,2,140,0.0,74.0,70.0
210104.0,17,2,414,1,88,0.0,88.0,88.0,1,326,0.0,326.0,326.0
536640.0,17,6,2100,6,2100,107328.0,350.0,350.0,0,0,0.0,0.0,0.0
103993567.0,6,195,21936,98,6690,1072098.6288659794,140.0,68.26530612244898,97,15246,1072419.1458333333,284.0,157.17525773195877
108607431.0,6,39,3178,22,1777,5161501.238095238,139.0,80.77272727272727,17,1401,6774438.5625,123.0,82.41176470588235
329896.0,6,6,412,4,272,109965.33333333331,74.0,68.0,2,140,0.0,74.0,70.0
148902.0,17,2,414,1,88,0.0,88.0,88.0,1,326,0.0,326.0,326.0
327.0,17,2,166,1,75,0.0,75.0,75.0,1,91,0.0,91.0,91.0
205701.0,17,2,180,1,90,0.0,90.0,90.0,1,90,0.0,90.0,90.0
121307.0,6,3,337,2,214,0.0,160.0,107.0,1,123,0.0,123.0,123.0
861186.0,6,10,1262,6,725,172237.2,387.0,120.83333333333331,4,537,196195.0,331.0,134.25
234174.0,6,3,337,2,214,0.0,160.0,107.0,1,123,0.0,123.0,123.0
108252770.0,17,14,864,7,432,18001619.666666668,174.0,61.71428571428572,7,432,18000160.0,174.0,61.71428571428572
209823.0,6,3,426,2,280,0.0,214.0,140.0,1,146,0.0,146.0,146.0
57747.0,6,14,4740,7,653,9094.833333333334,249.0,93.28571428571428,7,4087,9481.833333333334,1514.0,583.8571428571429
369187.0,6,10,1221,6,636,73837.4,298.0,106.0,4,585,121798.66666666669,379.0,146.25
111801.0,17,2,286,2,286,0.0,143.0,143.0,0,0,0.0,0.0,0.0
1302552.0,6,4,264,2,132,0.0,66.0,66.0,2,132,0.0,66.0,66.0
412.0,17,2,762,2,762,0.0,381.0,381.0,0,0,0.0,0.0,0.0
10523377.0,6,7,478,4,272,3461094.333333333,74.0,68.0,3,206,5191545.0,74.0,68.66666666666667
136392.0,6,2,132,1,66,0.0,66.0,66.0,1,66,0.0,66.0,66.0
113015481.0,6,48,3168,24,1584,4913716.565217392,66.0,66.0,24,1584,4904318.608695652,66.0,66.0
118545747.0,6,34,2350,17,1225,7395617.125,139.0,72.05882352941177,17,1125,7395615.9375,123.0,66.17647058823529
120123067.0,6,15,2290,9,1204,15015383.375,188.0,133.77777777777777,6,1086,18019705.0,204.0,181.0
135131449.0,17,6,1146,6,1146,27026289.8,191.0,191.0,0,0,0.0,0.0,0.0
2442.0,17,4,344,2,150,0.0,75.0,75.0,2,194,0.0,103.0,97.0
143951.0,17,2,180,1,90,0.0,90.0,90.0,1,90,0.0,90.0,90.0
30129.0,6,14,4740,7,653,4636.0,249.0,93.28571428571428,7,4087,4882.5,1514.0,583.8571428571429
81867.0,6,13,1394,7,797,12682.0,253.0,113.85714285714286,6,597,13529.4,259.0,99.5
294838.0,6,20,7884,11,890,29483.8,222.0,80.9090909090909,9,6994,35758.5,1514.0,777.1111111111111
2291.0,17,4,344,2,150,0.0,75.0,75.0,2,194,0.0,103.0,97.0
96979428.0,6,31,2245,16,1140,6465295.2,123.0,71.25,15,1105,6911607.142857143,139.0,73.66666666666667
41474.0,6,13,1479,7,882,6912.333333333333,291.0,126.0,6,597,5641.2,259.0,99.5
102957070.0,6,193,21714,97,6624,1072469.4791666667,140.0,68.28865979381443,96,15090,1074016.2631578948,284.0,157.1875
120019287.0,17,28,13364,28,13364,4445158.777777778,501.0,477.2857142857143,0,0,0.0,0.0,0.0
233230.0,6,3,337,2,214,0.0,160.0,107.0,1,123,0.0,123.0,123.0
47603723.0,6,8,1940,3,887,22587009.0,753.0,295.6666666666667,5,1053,11258405.5,785.0,210.6
1207592.0,17,7,490,7,490,201265.3333333333,70.0,70.0,0,0,0.0,0.0,0.0
298.0,17,2,168,1,76,0.0,76.0,76.0,1,92,0.0,92.0,92.0
135132699.0,17,6,1146,6,1146,27026539.8,191.0,191.0,0,0,0.0,0.0,0.0
160177.0,17,2,180,1,90,0.0,90.0,90.0,1,90,0.0,90.0,90.0
222631.0,6,3,426,2,280,0.0,214.0,140.0,1,146,0.0,146.0,146.0
14617771.0,6,21,1823,11,1191,1431411.8,322.0,108.27272727272728,10,632,1590417.2222222222,78.0,63.2
14131942.0,17,6,2052,6,2052,2826388.4,342.0,342.0,0,0,0.0,0.0,0.0
106307.0,17,2,700,2,700,0.0,350.0,350.0,0,0,0.0,0.0,0.0
100980.0,17,2,700,2,700,0.0,350.0,350.0,0,0,0.0,0.0,0.0
120122487.0,6,14,2240,8,1016,17137433.285714287,188.0,127.0,6,1224,18018800.8,204.0,204.0
11354.0,6,10,1067,5,536,2613.5,264.0,107.2,5,531,2136.75,259.0,106.2
285340.0,17,4,571,2,148,0.0,74.0,74.0,2,423,0.0,276.0,211.5
16152885.999999998,17,6,2052,6,2052,3230577.2,342.0,342.0,0,0,0.0,0.0,0.0
90259184.0,6,13,2036,8,1016,12894169.142857144,188.0,127.0,5,1020,22523412.0,204.0,204.0
1668225.0,17,2,876,2,876,0.0,438.0,438.0,0,0,0.0,0.0,0.0
1315549.0,6,4,264,2,132,0.0,66.0,66.0,2,132,0.0,66.0,66.0
107138760.0,17,14,864,7,432,17668378.666666668,174.0,61.71428571428572,7,432,17833534.333333332,174.0,61.71428571428572
15135.0,6,14,4740,7,653,2286.333333333333,249.0,93.28571428571428,7,4087,2348.6666666666665,1514.0,583.8571428571429
95682557.0,6,47,4020,27,2250,3671800.4615384615,123.0,83.33333333333333,20,1770,5024571.47368421,123.0,88.5
201516.0,17,2,180,1,90,0.0,90.0,90.0,1,90,0.0,90.0,90.0
209537.0,17,2,180,1,90,0.0,90.0,90.0,1,90,0.0,90.0,90.0
107682.0,17,2,286,2,286,0.0,143.0,143.0,0,0,0.0,0.0,0.0
120017672.0,17,28,13364,28,13364,4445098.962962963,501.0,477.2857142857143,0,0,0.0,0.0,0.0
90220184.0,6,16,1192,8,596,12853589.714285716,95.0,74.5,8,596,12859220.142857144,95.0,74.5
119314943.0,6,245,27778,123,19430,977991.3360655736,284.0,157.96747967479675,122,8348,978490.4214876032,140.0,68.42622950819673
316857.0,17,4,1400,4,1400,105619.0,350.0,350.0,0,0,0.0,0.0,0.0
55226.0,6,10,2032,5,524,12756.5,252.0,104.8,5,1508,13449.0,1236.0,301.6
217914.0,6,4,492,2,280,0.0,214.0,140.0,2,212,0.0,146.0,106.0
217318.0,17,2,180,1,90,0.0,90.0,90.0,1,90,0.0,90.0,90.0
32061.0,6,10,2032,5,524,7727.25,252.0,104.8,5,1508,7736.0,1236.0,301.6
149923144.0,17,36,17126,36,17126,4283518.4,501.0,475.72222222222223,0,0,0.0,0.0,0.0
10529500.0,6,7,478,4,272,3464229.333333333,74.0,68.0,3,206,5196220.5,74.0,68.66666666666667
105793.0,6,13,1386,7,789,17632.166666666668,253.0,112.71428571428572,6,597,20297.4,259.0,99.5
108127272.0,17,5,955,5,955,27031818.0,191.0,191.0,0,0,0.0,0.0,0.0
337.0,17,2,166,1,75,0.0,75.0,75.0,1,91,0.0,91.0,91.0
42780.0,6,14,4740,7,653,7009.833333333333,249.0,93.28571428571428,7,4087,6418.5,1514.0,583.8571428571429
90033136.0,17,28,13364,28,13364,3334560.592592593,501.0,477.2857142857143,0,0,0.0,0.0,0.0
336.0,17,2,166,1,75,0.0,75.0,75.0,1,91,0.0,91.0,91.0
2595934.0,6,2,132,1,66,0.0,66.0,66.0,1,66,0.0,66.0,66.0
153494.0,17,2,180,1,90,0.0,90.0,90.0,1,90,0.0,90.0,90.0
311289.0,17,4,1400,4,1400,103763.0,350.0,350.0,0,0,0.0,0.0,0.0
76455955.0,17,14,4788,14,4788,5881227.307692308,342.0,342.0,0,0,0.0,0.0,0.0
108093992.0,17,5,1005,5,1005,27023498.0,201.0,201.0,0,0,0.0,0.0,0.0
108117929.0,17,5,955,5,955,27029482.25,191.0,191.0,0,0,0.0,0.0,0.0
3144139.0,6,3,204,2,136,0.0,70.0,68.0,1,68,0.0,68.0,68.0
134801.0,6,13,1386,7,789,22466.83333333333,253.0,112.71428571428572,6,597,24723.4,259.0,99.5
3004836.0,6,12,2172,7,664,500741.1666666667,252.0,94.85714285714286,5,1508,1630.5,1236.0,301.6
15023668.0,17,6,2052,6,2052,3004733.6,342.0,342.0,0,0,0.0,0.0,0.0
103156.0,17,2,286,2,286,0.0,143.0,143.0,0,0,0.0,0.0,0.0
1931821.0,6,2,132,1,66,0.0,66.0,66.0,1,66,0.0,66.0,66.0
5827569.0,6,5,336,2,134,0.0,68.0,67.0,3,202,1518305.5,70.0,67.33333333333333
2971846.0,6,3,204,2,136,0.0,70.0,68.0,1,68,0.0,68.0,68.0
99021961.0,6,199,22470,100,15714,1000221.8282828284,284.0,157.14,99,6756,1000003.3571428572,140.0,68.24242424242425
42177.0,6,14,4740,7,653,6047.333333333333,249.0,93.28571428571428,7,4087,6727.5,1514.0,583.8571428571429
34138.0,6,14,4740,7,653,5568.666666666667,249.0,93.28571428571428,7,4087,5155.166666666667,1514.0,583.8571428571429
39841.0,6,10,1066,5,490,9361.0,218.0,98.0,5,576,9502.0,304.0,115.2
122946.0,6,3,337,2,214,0.0,160.0,107.0,1,123,0.0,123.0,123.0
310136.0,17,4,1400,4,1400,103378.66666666669,350.0,350.0,0,0,0.0,0.0,0.0
13249.0,6,10,1067,5,536,3149.5,264.0,107.2,5,531,2811.75,259.0,106.2
106326261.0,17,14,864,7,432,17667149.833333332,174.0,61.71428571428572,7,432,17500159.166666668,174.0,61.71428571428572
285470.0,17,2,363,1,79,0.0,79.0,79.0,1,284,0.0,284.0,284.0
2423.0,17,4,344,2,150,0.0,75.0,75.0,2,194,0.0,103.0,97.0
203674.0,17,2,762,2,762,0.0,381.0,381.0,0,0,0.0,0.0,0.0
205447.0,17,2,180,1,90,0.0,90.0,90.0,1,90,0.0,90.0,90.0
306397.0,6,6,412,4,272,102132.33333333331,74.0,68.0,2,140,0.0,74.0,70.0
106529454.0,17,14,864,7,432,17728224.666666668,174.0,61.71428571428572,7,432,17565604.166666668,174.0,61.71428571428572
18318.0,6,14,4740,7,653,2944.6666666666665,249.0,93.28571428571428,7,4087,2913.1666666666665,1514.0,583.8571428571429
120052167.0,17,29,13785,29,13785,4287577.392857143,501.0,475.3448275862069,0,0,0.0,0.0,0.0
1270.0,17,2,762,2,762,0.0,381.0,381.0,0,0,0.0,0.0,0.0
313675.0,6,6,412,4,272,104558.33333333331,74.0,68.0,2,140,0.0,74.0,70.0
108097620.0,17,5,1005,5,1005,27024405.0,201.0,201.0,0,0,0.0,0.0,0.0
109449.0,17,2,286,2,286,0.0,143.0,143.0,0,0,0.0,0.0,0.0
10087.0,6,10,1067,5,536,2341.0,264.0,107.2,5,531,2245.5,259.0,106.2
48744.0,6,10,2032,5,524,10876.0,252.0,104.8,5,1508,11936.0,1236.0,301.6
3103815.0,6,156,123435,88,114645,35676.03448275862,1510.0,1302.784090909091,68,8790,41640.31343283582,1510.0,129.26470588235293
41278.0,6,12,1320,6,723,7479.8,253.0,120.5,6,597,6735.6,259.0,99.5
27548994.0,17,4,1376,3,1026,1361643.0,342.0,342.0,1,350,0.0,350.0,350.0
170.0,17,2,700,2,700,0.0,350.0,350.0,0,0,0.0,0.0,0.0
144622.0,17,2,180,1,70,0.0,70.0,70.0,1,110,0.0,110.0,110.0
233148.0,6,3,337,2,214,0.0,160.0,107.0,1,123,0.0,123.0,123.0
147923.0,17,2,180,1,90,0.0,90.0,90.0,1,90,0.0,90.0,90.0
21584.0,6,10,2032,5,524,5179.0,252.0,104.8,5,1508,5005.5,1236.0,301.6
316.0,17,2,174,1,79,0.0,79.0,79.0,1,95,0.0,95.0,95.0
2362.0,17,4,344,2,150,0.0,75.0,75.0,2,194,0.0,103.0,97.0
153451.0,17,2,180,1,90,0.0,90.0,90.0,1,90,0.0,90.0,90.0
421365.0,6,10,1221,6,636,84273.0,298.0,106.0,4,585,138567.33333333334,379.0,146.25
499765.0,6,5,336,2,134,0.0,68.0,67.0,3,202,196424.5,70.0,67.33333333333333
12014415.0,17,3,1026,3,1026,6007207.5,342.0,342.0,0,0,0.0,0.0,0.0
90318645.0,6,13,1898,8,1016,12902663.57142857,188.0,127.0,5,882,22537743.0,204.0,176.4
65040.0,6,14,4740,7,653,9155.5,249.0,93.28571428571428,7,4087,9932.0,1514.0,583.8571428571429
348.0,17,2,248,1,84,0.0,84.0,84.0,1,164,0.0,164.0,164.0
318.0,17,2,174,1,79,0.0,79.0,79.0,1,95,0.0,95.0,95.0
208657.0,6,12,1373,7,714,34776.166666666664,298.0,102.0,5,659,50740.5,379.0,131.8
296.0,17,2,156,1,78,0.0,78.0,78.0,1,78,0.0,78.0,78.0
305349.0,6,6,412,4,272,101783.0,74.0,68.0,2,140,0.0,74.0,70.0
108680.0,17,2,286,2,286,0.0,143.0,143.0,0,0,0.0,0.0,0.0
304564.0,6,6,412,4,272,101521.33333333331,74.0,68.0,2,140,0.0,74.0,70.0
2596663.0,6,2,132,1,66,0.0,66.0,66.0,1,66,0.0,66.0,66.0
68554.0,6,14,4740,7,653,10883.833333333334,249.0,93.28571428571428,7,4087,6479.5,1514.0,583.8571428571429
345.0,17,2,160,1,80,0.0,80.0,80.0,1,80,0.0,80.0,80.0
895975.0,6,12,2715,7,743,149329.16666666666,339.0,106.14285714285714,5,1972,155851.75,1514.0,394.4
240145.0,6,3,337,2,214,0.0,160.0,107.0,1,123,0.0,123.0,123.0
16648.0,6,20,7606,11,978,1664.8,310.0,88.9090909090909,9,6628,1890.375,1514.0,736.4444444444445
866240.0,6,10,1336,6,799,173248.0,461.0,133.16666666666666,4,537,197841.3333333333,331.0,134.25
890133.0,6,12,2710,7,743,148355.5,339.0,106.14285714285714,5,1967,153675.25,1514.0,393.4
104914957.0,17,15,5130,15,5130,7493925.5,342.0,342.0,0,0,0.0,0.0,0.0
1288404.0,17,7,490,7,490,214734.0,70.0,70.0,0,0,0.0,0.0,0.0
301.0,17,2,164,1,82,0.0,82.0,82.0,1,82,0.0,82.0,82.0
14661869.0,6,20,1689,10,1057,1592740.111111111,315.0,105.7,10,632,1592890.3333333333,78.0,63.2
11019.0,6,10,2032,5,524,2437.0,252.0,104.8,5,1508,2434.5,1236.0,301.6
840159.0,6,9,1118,6,586,168031.8,248.0,97.66666666666669,3,532,282235.5,392.0,177.33333333333334
382865.0,6,3,204,2,136,0.0,70.0,68.0,1,68,0.0,68.0,68.0
314322.0,17,4,1400,4,1400,104774.0,350.0,350.0,0,0,0.0,0.0,0.0
754935.0,6,2,132,1,66,0.0,66.0,66.0,1,66,0.0,66.0,66.0
298716.0,6,6,412,4,272,99572.0,74.0,68.0,2,140,0.0,74.0,70.0
207174.0,6,3,426,2,280,0.0,214.0,140.0,1,146,0.0,146.0,146.0
2963924.0,6,22,6440,11,1463,296392.4,357.0,133.0,11,4977,265123.2,1510.0,452.45454545454544
228299.0,17,2,180,1,90,0.0,90.0,90.0,1,90,0.0,90.0,90.0
362888.0,6,11,1021,6,444,48744.2,162.0,74.0,5,577,60769.0,349.0,115.4
3562.0,17,4,344,2,150,0.0,75.0,75.0,2,194,0.0,103.0,97.0
823.0,17,4,438,2,148,0.0,74.0,74.0,2,290,0.0,147.0,145.0
90047915.0,17,27,12943,27,12943,3463381.346153846,501.0,479.3703703703704,0,0,0.0,0.0,0.0
214658.0,6,11,1132,6,556,41850.2,218.0,92.66666666666669,5,576,53429.0,304.0,115.2
28050.0,6,11,2098,6,590,5019.0,252.0,98.33333333333331,5,1508,6734.25,1236.0,301.6
509713.0,6,5,336,2,134,0.0,68.0,67.0,3,202,190231.0,70.0,67.33333333333333
407.0,17,2,410,1,78,0.0,78.0,78.0,1,332,0.0,332.0,332.0
246054.0,6,3,337,2,214,0.0,160.0,107.0,1,123,0.0,123.0,123.0
135132468.0,17,6,1146,6,1146,27026493.6,191.0,191.0,0,0,0.0,0.0,0.0
217851.0,6,3,426,2,280,0.0,214.0,140.0,1,146,0.0,146.0,146.0
108719341.0,6,32,2220,16,1149,7247956.066666666,123.0,71.8125,16,1071,7233524.133333334,123.0,66.9375
282436.0,17,2,363,1,79,0.0,79.0,79.0,1,284,0.0,284.0,284.0
206667.0,17,2,180,1,90,0.0,90.0,90.0,1,90,0.0,90.0,90.0
4070.0,17,4,344,2,150,0.0,75.0,75.0,2,194,0.0,103.0,97.0
228557.0,17,2,180,1,90,0.0,90.0,90.0,1,90,0.0,90.0,90.0
335.0,17,2,160,1,80,0.0,80.0,80.0,1,80,0.0,80.0,80.0
346.0,17,2,160,1,80,0.0,80.0,80.0,1,80,0.0,80.0,80.0
102641.0,17,2,286,2,286,0.0,143.0,143.0,0,0,0.0,0.0,0.0
103572.0,17,2,286,2,286,0.0,143.0,143.0,0,0,0.0,0.0,0.0
143946.0,17,2,180,1,90,0.0,90.0,90.0,1,90,0.0,90.0,90.0
317877.0,17,4,1400,4,1400,105959.0,350.0,350.0,0,0,0.0,0.0,0.0
318254.0,17,4,1400,4,1400,106084.66666666669,350.0,350.0,0,0,0.0,0.0,0.0
122006357.0,17,15,907,8,475,17429479.57142857,174.0,59.375,7,432,17085765.0,174.0,61.71428571428572
46753.0,6,14,4740,7,653,7074.666666666667,249.0,93.28571428571428,7,4087,7308.166666666667,1514.0,583.8571428571429
108108169.0,17,5,955,5,955,27027042.25,191.0,191.0,0,0,0.0,0.0,0.0
303891.0,6,6,412,4,272,101297.0,74.0,68.0,2,140,0.0,74.0,70.0
307681.0,17,4,704,2,148,0.0,74.0,74.0,2,556,0.0,280.0,278.0
201567.0,17,4,6056,4,6056,67189.0,1514.0,1514.0,0,0,0.0,0.0,0.0
90252544.0,6,12,1832,8,1016,12893220.57142857,188.0,127.0,4,816,30029184.33333333,204.0,204.0
50289.0,6,14,4740,7,653,7764.0,249.0,93.28571428571428,7,4087,7724.833333333333,1514.0,583.8571428571429
5714500.0,6,5,336,2,134,0.0,68.0,67.0,3,202,1475301.0,70.0,67.33333333333333
149060.0,6,3,337,2,214,0.0,160.0,107.0,1,123,0.0,123.0,123.0
90070069.0,17,28,13364,28,13364,3335928.4814814813,501.0,477.2857142857143,0,0,0.0,0.0,0.0
135131216.0,17,6,1206,6,1206,27026243.2,201.0,201.0,0,0,0.0,0.0,0.0
316112.0,17,4,1400,4,1400,105370.66666666669,350.0,350.0,0,0,0.0,0.0,0.0
39028.0,6,14,4740,7,653,6257.833333333333,249.0,93.28571428571428,7,4087,6369.166666666667,1514.0,583.8571428571429
120124326.0,6,14,2224,9,1204,15015540.75,188.0,133.77777777777777,5,1020,22525207.0,204.0,204.0
51461.0,6,10,2032,5,524,11159.5,252.0,104.8,5,1508,12604.75,1236.0,301.6
62554.0,6,14,4740,7,653,9078.833333333334,249.0,93.28571428571428,7,4087,6957.833333333333,1514.0,583.8571428571429
135129202.0,17,6,1206,6,1206,27025840.4,201.0,201.0,0,0,0.0,0.0,0.0
294.0,17,2,156,1,78,0.0,78.0,78.0,1,78,0.0,78.0,78.0
90055749.0,17,27,12943,27,12943,3463682.653846154,501.0,479.3703703703704,0,0,0.0,0.0,0.0
212902.0,17,2,180,1,90,0.0,90.0,90.0,1,90,0.0,90.0,90.0
146082.0,6,3,337,2,214,0.0,160.0,107.0,1,123,0.0,123.0,123.0
895224.0,6,12,1427,6,796,178454.2,271.0,132.66666666666666,6,631,177762.4,293.0,105.16666666666669
320185.0,17,4,1400,4,1400,106728.33333333331,350.0,350.0,0,0,0.0,0.0,0.0
196918.0,17,2,180,1,90,0.0,90.0,90.0,1,90,0.0,90.0,90.0
147367.0,17,4,1400,4,1400,49122.333333333336,350.0,350.0,0,0,0.0,0.0,0.0
103749325.0,6,44,2904,22,1452,4940444.047619048,66.0,66.0,22,1452,4925742.380952381,66.0,66.0
33270.0,6,14,4740,7,653,5373.5,249.0,93.28571428571428,7,4087,4209.333333333333,1514.0,583.8571428571429
2592328.0,6,2,132,1,66,0.0,66.0,66.0,1,66,0.0,66.0,66.0
320214.0,6,6,412,4,272,106738.0,74.0,68.0,2,140,0.0,74.0,70.0
8799.0,17,4,344,2,150,0.0,75.0,75.0,2,194,0.0,103.0,97.0
104647256.0,6,44,2904,22,1452,4983202.666666667,66.0,66.0,22,1452,4967526.0,66.0,66.0
0.0,6,1,66,1,66,0.0,66.0,66.0,0,0,0.0,0.0,0.0
0.0,6,1,66,0,0,0.0,0.0,0.0,1,66,0.0,66.0,66.0
2436.0,17,4,344,2,150,0.0,75.0,75.0,2,194,0.0,103.0,97.0
216578.0,17,2,180,1,90,0.0,90.0,90.0,1,90,0.0,90.0,90.0
102043.0,17,2,762,2,762,0.0,381.0,381.0,0,0,0.0,0.0,0.0
46193.0,6,14,4740,7,653,7353.666666666667,249.0,93.28571428571428,7,4087,7066.333333333333,1514.0,583.8571428571429
8924.0,6,10,2032,5,524,2009.5,252.0,104.8,5,1508,2007.25,1236.0,301.6
108109467.0,17,5,955,5,955,27027366.75,191.0,191.0,0,0,0.0,0.0,0.0
107435.0,17,2,286,2,286,0.0,143.0,143.0,0,0,0.0,0.0,0.0
32699.0,6,14,4740,7,653,5155.833333333333,249.0,93.28571428571428,7,4087,5105.666666666667,1514.0,583.8571428571429
119550770.0,6,212,23852,106,16560,1136529.6285714286,284.0,156.2264150943396,106,7292,1136530.2761904765,140.0,68.79245283018868
4492.0,17,2,626,1,72,0.0,72.0,72.0,1,554,0.0,554.0,554.0
198885.0,17,2,180,1,90,0.0,90.0,90.0,1,90,0.0,90.0,90.0
60927.0,6,10,2032,5,524,11680.75,252.0,104.8,5,1508,14830.25,1236.0,301.6
27509594.0,17,5,1710,5,1710,6877398.5,342.0,342.0,0,0,0.0,0.0,0.0
90051835.0,17,28,13364,28,13364,3335253.1481481483,501.0,477.2857142857143,0,0,0.0,0.0,0.0
120085213.0,6,238,26754,119,8150,1010559.3644067796,140.0,68.4873949579832,119,18604,1011509.4830508474,284.0,156.3361344537815
24901.0,6,14,4740,7,653,3550.0,249.0,93.28571428571428,7,4087,4011.0,1514.0,583.8571428571429
288979.0,6,10,1221,6,636,57795.8,298.0,106.0,4,585,85894.33333333333,379.0,146.25
18889.0,6,14,4740,7,653,2821.833333333333,249.0,93.28571428571428,7,4087,2956.833333333333,1514.0,583.8571428571429
44945.0,6,14,4740,7,653,7317.0,249.0,93.28571428571428,7,4087,5757.666666666667,1514.0,583.8571428571429
116001347.0,17,13,821,7,432,19333557.83333333,174.0,61.71428571428572,6,389,19201039.8,174.0,64.83333333333333
30477.0,6,14,4740,7,653,4301.833333333333,249.0,93.28571428571428,7,4087,4823.5,1514.0,583.8571428571429
120054079.0,17,29,13785,29,13785,4287645.678571428,501.0,475.3448275862069,0,0,0.0,0.0,0.0
98439.0,6,14,4740,7,653,16048.333333333334,249.0,93.28571428571428,7,4087,16113.166666666666,1514.0,583.8571428571429
90009981.0,17,28,13364,28,13364,3333703.0,501.0,477.2857142857143,0,0,0.0,0.0,0.0
24011.0,6,14,4740,7,653,2737.833333333333,249.0,93.28571428571428,7,4087,3483.1666666666665,1514.0,583.8571428571429
56203.0,6,14,4740,7,653,8798.166666666666,249.0,93.28571428571428,7,4087,9142.0,1514.0,583.8571428571429
146191.0,6,3,337,2,214,0.0,160.0,107.0,1,123,0.0,123.0,123.0
108109225.0,17,5,955,5,955,27027306.25,191.0,191.0,0,0,0.0,0.0,0.0
153405.0,17,2,180,1,90,0.0,90.0,90.0,1,90,0.0,90.0,90.0
284649.0,6,12,1373,7,714,47441.5,298.0,102.0,5,659,66758.0,379.0,131.8
146063.0,6,3,337,2,214,0.0,160.0,107.0,1,123,0.0,123.0,123.0
143834.0,17,2,180,1,90,0.0,90.0,90.0,1,90,0.0,90.0,90.0
9007776.0,17,2,160,2,160,0.0,80.0,80.0,0,0,0.0,0.0,0.0
170751.0,6,14,4740,7,653,23507.666666666668,249.0,93.28571428571428,7,4087,28318.0,1514.0,583.8571428571429
146106.0,6,3,337,2,214,0.0,160.0,107.0,1,123,0.0,123.0,123.0
135131441.0,17,6,1206,6,1206,27026288.2,201.0,201.0,0,0,0.0,0.0,0.0
322746.0,6,6,412,4,272,107582.0,74.0,68.0,2,140,0.0,74.0,70.0
275662.0,17,2,238,1,74,0.0,74.0,74.0,1,164,0.0,164.0,164.0
1253023.0,6,14,3077,8,2383,179003.2857142857,1514.0,297.875,6,694,196100.0,331.0,115.66666666666669
22208.0,6,10,2032,5,524,5288.5,252.0,104.8,5,1508,5077.0,1236.0,301.6
120074305.0,17,14,995,7,563,20012384.166666668,174.0,80.42857142857143,7,432,19922979.0,174.0,61.71428571428572
216458.0,17,2,180,1,90,0.0,90.0,90.0,1,90,0.0,90.0,90.0
3515.0,17,4,407,2,144,0.0,72.0,72.0,2,263,0.0,136.0,131.5
154944.0,6,2,132,1,66,0.0,66.0,66.0,1,66,0.0,66.0,66.0
128025492.0,6,33,2296,17,1225,8001593.25,139.0,72.05882352941177,16,1071,7854978.466666667,123.0,66.9375
307531.0,6,6,412,4,272,102510.33333333331,74.0,68.0,2,140,0.0,74.0,70.0
752.0,17,4,438,2,148,0.0,74.0,74.0,2,290,0.0,147.0,145.0
49606.0,6,14,4740,7,653,8137.166666666667,249.0,93.28571428571428,7,4087,6806.333333333333,1514.0,583.8571428571429
120067442.0,17,29,13785,29,13785,4288122.928571428,501.0,475.3448275862069,0,0,0.0,0.0,0.0
99236.0,17,2,762,2,762,0.0,381.0,381.0,0,0,0.0,0.0,0.0
147993.0,17,2,180,1,90,0.0,90.0,90.0,1,90,0.0,90.0,90.0
108109375.0,17,5,955,5,955,27027343.75,191.0,191.0,0,0,0.0,0.0,0.0
44275.0,6,14,4740,7,653,6385.0,249.0,93.28571428571428,7,4087,6197.166666666667,1514.0,583.8571428571429
90256778.0,6,11,1766,7,950,15015538.5,188.0,135.71428571428572,4,816,30031103.33333333,204.0,204.0
113618817.0,6,46,3036,23,1518,5150438.181818182,66.0,66.0,23,1518,5150437.0,66.0,66.0
250653.00000000003,17,4,6056,4,6056,83551.0,1514.0,1514.0,0,0,0.0,0.0,0.0
120046777.0,17,28,13364,28,13364,4446176.925925926,501.0,477.2857142857143,0,0,0.0,0.0,0.0
26186.0,6,10,2032,5,524,6314.25,252.0,104.8,5,1508,6137.75,1236.0,301.6
262762.0,6,10,1221,6,636,52552.4,298.0,106.0,4,585,82231.33333333333,379.0,146.25
302215.0,6,6,412,4,272,100738.33333333331,74.0,68.0,2,140,0.0,74.0,70.0
3481.0,17,4,344,2,150,0.0,75.0,75.0,2,194,0.0,103.0,97.0
318.0,17,2,168,1,76,0.0,76.0,76.0,1,92,0.0,92.0,92.0
120122878.0,6,13,2020,9,1204,15015359.75,188.0,133.77777777777777,4,816,30029967.666666668,204.0,204.0
303555.0,6,6,412,4,272,101185.0,74.0,68.0,2,140,0.0,74.0,70.0
19973185.0,6,26,7627,14,3735,196491.92307692303,1514.0,266.7857142857143,12,3892,1797070.7272727273,1514.0,324.3333333333333
38915.0,6,14,4740,7,653,6258.833333333333,249.0,93.28571428571428,7,4087,5830.5,1514.0,583.8571428571429
538484.0,6,12,1365,7,702,89694.66666666667,298.0,100.28571428571428,5,663,130736.25,379.0,132.6
120342611.0,6,233,26356,117,18404,1037436.301724138,284.0,157.2991452991453,116,7952,1037389.4434782608,140.0,68.55172413793103
108133089.0,17,5,1005,5,1005,27033272.25,201.0,201.0,0,0,0.0,0.0,0.0
3007951.0,6,11,2106,6,598,601416.4,252.0,99.66666666666669,5,1508,1958.25,1236.0,301.6
228464.0,17,2,180,1,90,0.0,90.0,90.0,1,90,0.0,90.0,90.0
96078631.0,6,58,12223,29,6431,3431379.6785714286,1514.0,221.7586206896552,29,5792,3422438.035714286,1514.0,199.72413793103448
292310.0,17,2,230,1,79,0.0,79.0,79.0,1,151,0.0,151.0,151.0
105545.0,17,2,700,2,700,0.0,350.0,350.0,0,0,0.0,0.0,0.0
205736.0,17,2,180,1,90,0.0,90.0,90.0,1,90,0.0,90.0,90.0
104684491.0,6,74,14382,36,7479,2990985.4571428574,1514.0,207.75,38,6903,2823388.675675676,1514.0,181.6578947368421
102603.0,17,2,700,2,700,0.0,350.0,350.0,0,0,0.0,0.0,0.0
9538.0,6,10,1066,5,490,2090.25,218.0,98.0,5,576,2111.0,304.0,115.2
101150.0,17,2,762,2,762,0.0,381.0,381.0,0,0,0.0,0.0,0.0
318281.0,6,6,412,4,272,106093.66666666669,74.0,68.0,2,140,0.0,74.0,70.0
302435.0,6,6,412,4,272,100811.66666666669,74.0,68.0,2,140,0.0,74.0,70.0
228290.0,17,2,180,1,90,0.0,90.0,90.0,1,90,0.0,90.0,90.0
97329439.0,17,12,778,6,389,19401662.2,174.0,64.83333333333333,6,389,19400166.8,174.0,64.83333333333333
90004293.0,17,28,13364,28,13364,3333492.333333333,501.0,477.2857142857143,0,0,0.0,0.0,0.0
319.0,17,2,166,1,75,0.0,75.0,75.0,1,91,0.0,91.0,91.0
302.0,17,2,174,1,79,0.0,79.0,79.0,1,95,0.0,95.0,95.0
221359.0,6,3,426,2,280,0.0,214.0,140.0,1,146,0.0,146.0,146.0
28798.0,6,14,4740,7,653,4593.333333333333,249.0,93.28571428571428,7,4087,4473.5,1514.0,583.8571428571429
24957088.0,17,5,1718,4,1368,1018739.6666666666,342.0,342.0,1,350,0.0,350.0,350.0
164505.0,17,2,414,1,88,0.0,88.0,88.0,1,326,0.0,326.0,326.0
37824.0,6,14,4740,7,653,6183.833333333333,249.0,93.28571428571428,7,4087,6087.5,1514.0,583.8571428571429
119414863.0,17,14,864,7,432,19834281.166666668,174.0,61.71428571428572,7,432,19833556.33333333,174.0,61.71428571428572
20230.0,17,2,582,1,83,0.0,83.0,83.0,1,499,0.0,499.0,499.0
39044.0,6,12,1320,7,789,6507.333333333333,253.0,112.71428571428572,5,531,7420.5,259.0,106.2
510268.00000000006,6,5,336,2,134,0.0,68.0,67.0,3,202,194069.0,70.0,67.33333333333333
90100290.0,6,12,1848,5,1020,22524443.0,204.0,204.0,7,828,14970515.333333334,188.0,118.28571428571428
242114.0,6,3,337,2,214,0.0,160.0,107.0,1,123,0.0,123.0,123.0
37862.0,6,14,4740,7,653,6184.0,249.0,93.28571428571428,7,4087,5587.333333333333,1514.0,583.8571428571429
120024.0,17,2,180,1,70,0.0,70.0,70.0,1,110,0.0,110.0,110.0
4450.0,17,2,614,1,72,0.0,72.0,72.0,1,542,0.0,542.0,542.0
731793.0,17,4,1400,4,1400,243931.0,350.0,350.0,0,0,0.0,0.0,0.0
105235373.0,6,44,2904,22,1452,5011208.238095238,66.0,66.0,22,1452,4996239.428571428,66.0,66.0
90052298.0,17,28,13364,28,13364,3335270.296296296,501.0,477.2857142857143,0,0,0.0,0.0,0.0
90282478.0,6,15,1138,7,542,15047079.666666666,95.0,77.42857142857143,8,596,12854902.42857143,95.0,74.5
90013790.0,17,28,13364,28,13364,3333844.074074074,501.0,477.2857142857143,0,0,0.0,0.0,0.0
14824.0,6,11,1133,6,602,2154.4,264.0,100.33333333333331,5,531,3297.25,259.0,106.2
223255.0,17,2,180,1,90,0.0,90.0,90.0,1,90,0.0,90.0,90.0
96005296.0,17,12,778,6,389,19201059.2,174.0,64.83333333333333,6,389,19000207.2,174.0,64.83333333333333
2791936.0,6,2,132,1,66,0.0,66.0,66.0,1,66,0.0,66.0,66.0
5832108.0,6,5,336,2,134,0.0,68.0,67.0,3,202,1524948.0,70.0,67.33333333333333
153390.0,17,2,180,1,90,0.0,90.0,90.0,1,90,0.0,90.0,90.0
756939.0,6,14,4740,7,653,125154.16666666669,249.0,93.28571428571428,7,4087,125840.5,1514.0,583.8571428571429
101963238.0,6,28,1876,14,982,7826733.923076923,139.0,70.14285714285714,14,894,7826732.230769231,123.0,63.85714285714285
306.0,17,2,156,1,78,0.0,78.0,78.0,1,78,0.0,78.0,78.0
318.0,17,2,174,1,79,0.0,79.0,79.0,1,95,0.0,95.0,95.0
147296.0,6,12,1320,6,723,28276.2,253.0,120.5,6,597,26113.8,259.0,99.5
3875.0,17,4,344,2,150,0.0,75.0,75.0,2,194,0.0,103.0,97.0
2511580.0,6,3,1604,1,753,0.0,753.0,753.0,2,851,0.0,785.0,425.5
108105115.0,17,5,1005,5,1005,27026278.75,201.0,201.0,0,0,0.0,0.0,0.0
102934.0,17,2,286,2,286,0.0,143.0,143.0,0,0,0.0,0.0,0.0
44523.0,6,10,2032,5,524,10896.75,252.0,104.8,5,1508,10514.5,1236.0,301.6
90257677.0,6,14,2240,8,1016,12893953.857142856,188.0,127.0,6,1224,18018464.6,204.0,204.0
22280.0,17,2,180,1,90,0.0,90.0,90.0,1,90,0.0,90.0,90.0
301.0,17,2,168,1,76,0.0,76.0,76.0,1,92,0.0,92.0,92.0
29609.0,6,14,4740,7,653,4111.666666666667,249.0,93.28571428571428,7,4087,3866.0,1514.0,583.8571428571429
27547940.0,17,5,1710,5,1710,6886985.0,342.0,342.0,0,0,0.0,0.0,0.0
2429.0,17,4,344,2,150,0.0,75.0,75.0,2,194,0.0,103.0,97.0
3858.0,17,4,344,2,150,0.0,75.0,75.0,2,194,0.0,103.0,97.0
22363.0,6,10,2032,5,524,5308.5,252.0,104.8,5,1508,5238.25,1236.0,301.6
30157.0,6,14,4740,7,653,4830.333333333333,249.0,93.28571428571428,7,4087,4531.5,1514.0,583.8571428571429
120065848.0,17,29,13785,29,13785,4288066.0,501.0,475.3448275862069,0,0,0.0,0.0,0.0
206813.0,6,3,426,2,280,0.0,214.0,140.0,1,146,0.0,146.0,146.0
135129479.0,17,6,1206,6,1206,27025895.8,201.0,201.0,0,0,0.0,0.0,0.0
228235.0,17,2,180,1,90,0.0,90.0,90.0,1,90,0.0,90.0,90.0
85851.0,17,2,286,2,286,0.0,143.0,143.0,0,0,0.0,0.0,0.0
15091.0,6,11,1133,6,602,2803.4,264.0,100.33333333333331,5,531,3303.75,259.0,106.2
300876.0,6,6,412,4,272,100292.0,74.0,68.0,2,140,0.0,74.0,70.0
2938997.0,6,4,264,4,264,979665.6666666666,66.0,66.0,0,0,0.0,0.0,0.0
220594.0,6,3,426,2,280,0.0,214.0,140.0,1,146,0.0,146.0,146.0
3005124.0,6,12,2172,7,664,500697.0,252.0,94.85714285714286,5,1508,1772.0,1236.0,301.6
1869126.0,17,6,1230,3,234,934374.5,78.0,78.0,3,996,934358.0,332.0,332.0
90299167.0,6,16,1192,8,596,12893795.142857144,95.0,74.5,8,596,12898681.714285716,95.0,74.5
1198496.0,6,13,3010,8,2382,171213.7142857143,1514.0,297.75,5,628,230787.5,331.0,125.6
89101.0,17,4,1400,4,1400,29700.33333333333,350.0,350.0,0,0,0.0,0.0,0.0
3077917.0,6,3,204,2,134,0.0,68.0,67.0,1,70,0.0,70.0,70.0
316126.0,6,6,412,4,272,105375.33333333331,74.0,68.0,2,140,0.0,74.0,70.0
1306993.0,6,4,264,2,132,0.0,66.0,66.0,2,132,0.0,66.0,66.0
315594.0,17,4,1400,4,1400,105198.0,350.0,350.0,0,0,0.0,0.0,0.0
307957.0,6,6,412,4,272,102652.33333333331,74.0,68.0,2,140,0.0,74.0,70.0
65339.99999999999,6,14,4740,7,653,9905.333333333334,249.0,93.28571428571428,7,4087,10666.5,1514.0,583.8571428571429
51590.0,6,14,4740,7,653,8471.5,249.0,93.28571428571428,7,4087,8092.666666666667,1514.0,583.8571428571429
108099685.0,17,5,1005,5,1005,27024921.25,201.0,201.0,0,0,0.0,0.0,0.0
121001127.0,17,15,907,8,475,17285875.285714287,174.0,59.375,7,432,16834728.0,174.0,61.71428571428572
369.0,17,2,267,1,83,0.0,83.0,83.0,1,184,0.0,184.0,184.0
149223113.0,17,36,17126,36,17126,4263517.514285714,501.0,475.72222222222223,0,0,0.0,0.0,0.0
26015.0,6,10,2032,5,524,6276.5,252.0,104.8,5,1508,5930.25,1236.0,301.6
120076989.0,17,29,13785,29,13785,4288463.892857143,501.0,475.3448275862069,0,0,0.0,0.0,0.0
900848.0,6,12,2710,7,743,150141.33333333334,339.0,106.14285714285714,5,1967,156374.75,1514.0,393.4
120125154.0,6,13,2020,9,1204,15015644.25,188.0,133.77777777777777,4,816,30031239.666666668,204.0,204.0
40150.0,6,14,4740,7,653,6450.833333333333,249.0,93.28571428571428,7,4087,6532.666666666667,1514.0,583.8571428571429
120001110.0,6,17,1287,9,691,15000138.75,95.0,76.77777777777777,8,596,12858767.714285716,95.0,74.5
153437.0,17,2,180,1,90,0.0,90.0,90.0,1,90,0.0,90.0,90.0
103940003.0,6,32,2236,16,1165,6915683.6,139.0,72.8125,16,1071,6915685.8,123.0,66.9375
131124.0,6,2,132,1,66,0.0,66.0,66.0,1,66,0.0,66.0,66.0
114693137.0,17,15,1169,8,606,16384733.857142856,174.0,75.75,7,563,18505463.166666668,174.0,80.42857142857143
156841.0,6,3,337,2,214,0.0,160.0,107.0,1,123,0.0,123.0,123.0
98005687.0,6,34,2620,18,1411,5752353.176470588,139.0,78.38888888888889,16,1209,6519334.733333333,123.0,75.5625
2021.0,17,4,344,2,150,0.0,75.0,75.0,2,194,0.0,103.0,97.0
102138395.0,17,14,864,7,432,17000606.166666668,174.0,61.71428571428572,7,432,17000191.666666668,174.0,61.71428571428572
66231.0,6,14,4740,7,653,10907.666666666666,249.0,93.28571428571428,7,4087,9410.5,1514.0,583.8571428571429
59354.0,6,11,1132,6,556,10709.0,218.0,92.66666666666669,5,576,14502.25,304.0,115.2
43403.0,6,10,2032,5,524,9973.25,252.0,104.8,5,1508,9107.0,1236.0,301.6
242559.0,6,3,373,2,238,0.0,172.0,119.0,1,135,0.0,135.0,135.0
153401.0,17,2,180,1,90,0.0,90.0,90.0,1,90,0.0,90.0,90.0
307915.0,6,6,412,4,272,102638.33333333331,74.0,68.0,2,140,0.0,74.0,70.0
120033247.0,17,29,13785,29,13785,4286901.678571428,501.0,475.3448275862069,0,0,0.0,0.0,0.0
2020.0,17,4,344,2,150,0.0,75.0,75.0,2,194,0.0,103.0,97.0
36418.0,6,14,4740,7,653,5860.0,249.0,93.28571428571428,7,4087,5769.666666666667,1514.0,583.8571428571429
22085.0,6,14,4740,7,653,3494.1666666666665,249.0,93.28571428571428,7,4087,3543.833333333333,1514.0,583.8571428571429
168109.0,17,2,414,1,88,0.0,88.0,88.0,1,326,0.0,326.0,326.0
49514.0,6,14,4740,7,653,7557.0,249.0,93.28571428571428,7,4087,8123.666666666667,1514.0,583.8571428571429
111168.0,17,2,286,2,286,0.0,143.0,143.0,0,0,0.0,0.0,0.0
9716.0,17,2,539,1,86,0.0,86.0,86.0,1,453,0.0,453.0,453.0
123250458.0,6,49,3234,25,1650,5135435.75,66.0,66.0,24,1584,5011809.565217392,66.0,66.0
10435009.0,6,6,412,3,206,5149338.0,74.0,68.66666666666667,3,206,5149243.0,74.0,68.66666666666667
106732.0,17,2,762,2,762,0.0,381.0,381.0,0,0,0.0,0.0,0.0
120056987.0,17,28,13364,28,13364,4446555.074074074,501.0,477.2857142857143,0,0,0.0,0.0,0.0
94875874.0,6,173,19494,87,5964,1103207.8372093022,140.0,68.55172413793103,86,13530,1104060.129411765,284.0,157.32558139534885
90293859.0,6,21,1585,11,840,9024350.4,95.0,76.36363636363636,10,745,10001751.666666666,95.0,74.5
190421.0,17,2,180,1,90,0.0,90.0,90.0,1,90,0.0,90.0,90.0
282386.0,17,2,363,1,79,0.0,79.0,79.0,1,284,0.0,284.0,284.0
107148.0,17,2,286,2,286,0.0,143.0,143.0,0,0,0.0,0.0,0.0
228410.0,17,2,180,1,90,0.0,90.0,90.0,1,90,0.0,90.0,90.0
1303151.0,6,4,264,2,132,0.0,66.0,66.0,2,132,0.0,66.0,66.0
120125636.0,6,14,2240,6,1224,24025127.2,204.0,204.0,8,1016,17137139.42857143,188.0,127.0
263157.0,6,10,1221,6,636,52631.4,298.0,106.0,4,585,81838.33333333333,379.0,146.25
66901.0,6,11,2098,6,590,13310.8,252.0,98.33333333333331,5,1508,16545.5,1236.0,301.6
143922.0,17,2,180,1,90,0.0,90.0,90.0,1,90,0.0,90.0,90.0
311066.0,6,6,412,4,272,103688.66666666669,74.0,68.0,2,140,0.0,74.0,70.0
31601.0,6,10,2032,5,524,7588.0,252.0,104.8,5,1508,6876.25,1236.0,301.6
119476855.0,6,34,2334,17,1209,7467303.4375,123.0,71.11764705882354,17,1125,7453792.0,123.0,66.17647058823529
120675.0,6,3,337,2,214,0.0,160.0,107.0,1,123,0.0,123.0,123.0
108099095.0,17,5,1005,5,1005,27024773.75,201.0,201.0,0,0,0.0,0.0,0.0
299852.0,6,6,412,4,272,99950.66666666669,74.0,68.0,2,140,0.0,74.0,70.0
876913.0,6,12,1427,6,796,173963.4,271.0,132.66666666666666,6,631,174113.6,293.0,105.16666666666669
50654.0,6,14,4740,7,653,8264.0,249.0,93.28571428571428,7,4087,7651.333333333333,1514.0,583.8571428571429
111012631.0,6,34,2488,18,1348,6518098.705882353,139.0,74.88888888888889,16,1140,7387177.866666666,123.0,71.25
801.0,17,4,438,2,148,0.0,74.0,74.0,2,290,0.0,147.0,145.0
120212831.0,6,21,1585,10,786,13332964.444444444,95.0,78.6,11,799,11999671.2,95.0,72.63636363636364
100111.0,17,2,762,2,762,0.0,381.0,381.0,0,0,0.0,0.0,0.0
96855723.0,6,199,22756,100,6822,978340.6363636364,140.0,68.22,99,15934,978943.9285714284,284.0,160.94949494949495
1315808.0,6,4,264,2,132,0.0,66.0,66.0,2,132,0.0,66.0,66.0
235062.0,6,3,337,2,214,0.0,160.0,107.0,1,123,0.0,123.0,123.0
943.0,17,2,762,2,762,0.0,381.0,381.0,0,0,0.0,0.0,0.0
99394.0,6,14,4740,7,653,15545.0,249.0,93.28571428571428,7,4087,14256.166666666666,1514.0,583.8571428571429
2285.0,17,4,344,2,150,0.0,75.0,75.0,2,194,0.0,103.0,97.0
109651.0,17,2,700,2,700,0.0,350.0,350.0,0,0,0.0,0.0,0.0
34091.0,6,12,1320,6,723,6684.6,253.0,120.5,6,597,5476.0,259.0,99.5
2810614.0,6,2,132,1,66,0.0,66.0,66.0,1,66,0.0,66.0,66.0
903.0,17,4,438,2,148,0.0,74.0,74.0,2,290,0.0,147.0,145.0
209483.0,17,2,180,1,90,0.0,90.0,90.0,1,90,0.0,90.0,90.0
90213084.0,6,16,1192,8,596,12853207.142857144,95.0,74.5,8,596,12858349.285714284,95.0,74.5
108105632.0,17,5,1005,5,1005,27026408.0,201.0,201.0,0,0,0.0,0.0,0.0
200095.0,17,2,762,2,762,0.0,381.0,381.0,0,0,0.0,0.0,0.0
56418.0,6,10,2032,5,524,13822.75,252.0,104.8,5,1508,11960.25,1236.0,301.6
10526058.0,6,7,478,4,272,3462997.333333333,74.0,68.0,3,206,5194400.5,74.0,68.66666666666667
304708.0,6,6,412,4,272,101569.33333333331,74.0,68.0,2,140,0.0,74.0,70.0
603237.0,6,4,508,2,238,0.0,172.0,119.0,2,270,0.0,135.0,135.0
299557.0,6,6,412,4,272,99852.33333333331,74.0,68.0,2,140,0.0,74.0,70.0
232778.0,6,3,337,2,214,0.0,160.0,107.0,1,123,0.0,123.0,123.0
62442.0,6,14,4740,7,653,9733.833333333334,249.0,93.28571428571428,7,4087,10055.166666666666,1514.0,583.8571428571429
209181.0,6,3,426,2,280,0.0,214.0,140.0,1,146,0.0,146.0,146.0
199658.0,17,4,6056,4,6056,66552.66666666667,1514.0,1514.0,0,0,0.0,0.0,0.0
278579.0,17,2,180,1,90,0.0,90.0,90.0,1,90,0.0,90.0,90.0
269123.0,6,10,1221,6,636,53824.6,298.0,106.0,4,585,84329.66666666667,379.0,146.25
120528356.0,6,237,26672,119,18588,1021426.745762712,284.0,156.2016806722689,118,8084,1021379.6837606838,140.0,68.50847457627118
46302.0,6,14,4740,7,653,7596.833333333333,249.0,93.28571428571428,7,4087,6938.5,1514.0,583.8571428571429
109273.0,17,2,286,2,286,0.0,143.0,143.0,0,0,0.0,0.0,0.0
31679.0,6,14,4740,7,653,5022.166666666667,249.0,93.28571428571428,7,4087,4735.833333333333,1514.0,583.8571428571429
50784.0,17,2,180,1,90,0.0,90.0,90.0,1,90,0.0,90.0,90.0
120304492.0,6,280,32534,140,9536,859562.798561151,140.0,68.11428571428571,140,22998,859654.4028776978,284.0,164.27142857142857
51728586.0,6,8,2113,3,960,24537748.5,826.0,320.0,5,1153,12236938.25,885.0,230.6
206853.0,6,3,426,2,280,0.0,214.0,140.0,1,146,0.0,146.0,146.0
300537.0,6,6,412,4,272,100179.0,74.0,68.0,2,140,0.0,74.0,70.0
153425.0,17,2,180,1,90,0.0,90.0,90.0,1,90,0.0,90.0,90.0
3378.0,17,4,344,2,150,0.0,75.0,75.0,2,194,0.0,103.0,97.0
1646545.0,6,7,499,4,301,541182.6666666666,103.0,75.25,3,198,715998.5,66.0,66.0
2593019.0,6,25,7573,14,3735,199463.0,1514.0,266.7857142857143,11,3838,233712.1,1514.0,348.90909090909093
118517784.0,6,246,27786,123,19446,969693.8360655736,284.0,158.09756097560975,123,8340,969694.0901639344,140.0,67.8048780487805
153418.0,17,2,180,1,90,0.0,90.0,90.0,1,90,0.0,90.0,90.0
108067.0,6,10,2032,5,524,26598.5,252.0,104.8,5,1508,25764.5,1236.0,301.6
120007447.0,6,17,1287,9,691,15000930.875,95.0,76.77777777777777,8,596,12857654.142857144,95.0,74.5
212970.0,6,3,426,2,280,0.0,214.0,140.0,1,146,0.0,146.0,146.0
38803.0,6,10,2032,5,524,9272.0,252.0,104.8,5,1508,9074.25,1236.0,301.6
102989.0,17,4,1400,4,1400,34329.666666666664,350.0,350.0,0,0,0.0,0.0,0.0
90705859.0,6,23,1895,11,799,9070585.9,95.0,72.63636363636364,12,1096,8222466.454545454,256.0,91.33333333333331
654066.0,6,4,508,2,238,0.0,172.0,119.0,2,270,0.0,135.0,135.0
92868469.0,6,207,24184,104,17238,901635.6213592232,284.0,165.75,103,6946,901460.9901960784,140.0,67.4368932038835
96075692.0,6,40,2640,20,1320,5056615.368421053,66.0,66.0,20,1320,5045239.894736842,66.0,66.0
20494.0,6,10,2032,5,524,4420.5,252.0,104.8,5,1508,4794.0,1236.0,301.6
24532079.0,17,8,1141,4,306,8177186.666666667,89.0,76.5,4,835,8177254.0,443.0,208.75
320729.0,17,4,1400,4,1400,106909.66666666669,350.0,350.0,0,0,0.0,0.0,0.0
232932.0,6,3,337,2,214,0.0,160.0,107.0,1,123,0.0,123.0,123.0
11740.0,6,14,4740,7,653,1834.8333333333333,249.0,93.28571428571428,7,4087,1819.5,1514.0,583.8571428571429
104188664.0,6,28,1860,14,966,7997909.923076923,123.0,69.0,14,894,7997911.615384615,123.0,63.85714285714285
308871.0,6,6,412,4,272,102957.0,74.0,68.0,2,140,0.0,74.0,70.0
31902.0,6,14,4740,7,653,4516.5,249.0,93.28571428571428,7,4087,4848.666666666667,1514.0,583.8571428571429
197024.0,17,2,180,1,90,0.0,90.0,90.0,1,90,0.0,90.0,90.0
57892.0,6,14,4740,7,653,9527.333333333334,249.0,93.28571428571428,7,4087,9243.666666666666,1514.0,583.8571428571429
489537.0,6,5,336,2,134,0.0,68.0,67.0,3,202,192193.0,70.0,67.33333333333333
120005469.0,6,21,1585,11,840,11999996.9,95.0,76.36363636363636,10,745,13332580.444444444,95.0,74.5
232481.0,6,3,337,2,214,0.0,160.0,107.0,1,123,0.0,123.0,123.0
3292015.0,6,5,336,2,134,0.0,68.0,67.0,3,202,1535937.0,70.0,67.33333333333333
208252.0,6,3,426,2,280,0.0,214.0,140.0,1,146,0.0,146.0,146.0
114226579.0,6,48,3168,24,1584,4966373.0,66.0,66.0,24,1584,4952949.173913044,66.0,66.0
51973.0,6,14,4740,7,653,7642.166666666667,249.0,93.28571428571428,7,4087,8029.5,1514.0,583.8571428571429
120315353.0,6,223,25246,112,17624,1083922.0990990992,284.0,157.35714285714286,111,7622,1085450.6090909091,140.0,68.66666666666667
297265.0,6,6,412,4,272,99088.33333333331,74.0,68.0,2,140,0.0,74.0,70.0
729.0,17,4,438,2,148,0.0,74.0,74.0,2,290,0.0,147.0,145.0
90023614.0,17,28,13364,28,13364,3334207.925925926,501.0,477.2857142857143,0,0,0.0,0.0,0.0
129001380.0,17,15,907,8,475,18428768.57142857,174.0,59.375,7,432,18167442.666666668,174.0,61.71428571428572
304919.0,17,4,704,2,148,0.0,74.0,74.0,2,556,0.0,280.0,278.0
0.0,6,1,66,1,66,0.0,66.0,66.0,0,0,0.0,0.0,0.0
310202.0,17,4,1400,4,1400,103400.66666666669,350.0,350.0,0,0,0.0,0.0,0.0
40633.0,6,14,4740,7,653,5887.5,249.0,93.28571428571428,7,4087,6149.666666666667,1514.0,583.8571428571429
239293.0,17,2,180,1,90,0.0,90.0,90.0,1,90,0.0,90.0,90.0
327.0,17,2,174,1,79,0.0,79.0,79.0,1,95,0.0,95.0,95.0
213022.0,6,3,426,2,280,0.0,214.0,140.0,1,146,0.0,146.0,146.0
54319.0,6,10,2032,5,524,13318.5,252.0,104.8,5,1508,10958.25,1236.0,301.6
119545354.0,6,656,114168,331,92200,361635.2636363636,1514.0,278.5498489425982,325,21968,368332.1635802469,214.0,67.59384615384616
147454.0,6,3,373,2,238,0.0,172.0,119.0,1,135,0.0,135.0,135.0
0.0,17,1,90,1,90,0.0,90.0,90.0,0,0,0.0,0.0,0.0
305683.0,6,2,1538,1,753,0.0,753.0,753.0,1,785,0.0,785.0,785.0
143889.0,17,2,180,1,90,0.0,90.0,90.0,1,90,0.0,90.0,90.0
120001664.0,6,27,2916,14,1507,9230897.23076923,337.0,107.64285714285714,13,1409,9976475.583333334,425.0,108.3846153846154
14348.0,6,10,2032,5,524,3010.75,252.0,104.8,5,1508,3104.0,1236.0,301.6
90367307.0,6,14,1980,7,1152,15061029.666666666,204.0,164.57142857142858,7,828,15060830.166666666,188.0,118.28571428571428
153568.0,17,2,180,1,90,0.0,90.0,90.0,1,90,0.0,90.0,90.0
1308092.0,6,4,264,2,132,0.0,66.0,66.0,2,132,0.0,66.0,66.0
5632132.0,6,5,336,2,134,0.0,68.0,67.0,3,202,1426151.5,70.0,67.33333333333333
90284264.0,6,16,1192,8,596,12891373.57142857,95.0,74.5,8,596,12895997.857142856,95.0,74.5
93585152.0,6,166,18778,83,5700,1131386.487804878,140.0,68.67469879518072,83,13078,1132727.3048780488,284.0,157.56626506024097
31617.0,6,10,2032,5,524,7509.0,252.0,104.8,5,1508,7108.5,1236.0,301.6
103422.0,17,2,286,2,286,0.0,143.0,143.0,0,0,0.0,0.0,0.0
308188.0,6,6,412,4,272,102729.33333333331,74.0,68.0,2,140,0.0,74.0,70.0
292748.0,17,2,180,1,90,0.0,90.0,90.0,1,90,0.0,90.0,90.0
1229629.0,17,7,490,7,490,204938.16666666663,70.0,70.0,0,0,0.0,0.0,0.0
112008215.0,17,13,821,7,432,18668035.83333333,174.0,61.71428571428572,6,389,18400164.6,174.0,64.83333333333333
1032661.0,6,11,1134,6,558,206532.2,220.0,93.0,5,576,256171.25,304.0,115.2
108106974.0,17,5,955,5,955,27026743.5,191.0,191.0,0,0,0.0,0.0,0.0
52536.0,6,14,4740,7,653,6717.5,249.0,93.28571428571428,7,4087,8552.333333333334,1514.0,583.8571428571429
1775860.0,6,2,132,1,66,0.0,66.0,66.0,1,66,0.0,66.0,66.0
121003436.0,17,15,907,8,475,17286205.14285714,174.0,59.375,7,432,16833519.666666668,174.0,61.71428571428572
7509365.0,17,4,1376,3,1026,36318.0,342.0,342.0,1,350,0.0,350.0,350.0
135136011.0,17,6,1146,6,1146,27027202.2,191.0,191.0,0,0,0.0,0.0,0.0
242036.0,6,3,373,2,238,0.0,172.0,119.0,1,135,0.0,135.0,135.0
5818557.0,6,5,336,2,134,0.0,68.0,67.0,3,202,1525813.0,70.0,67.33333333333333
371.0,17,2,166,1,75,0.0,75.0,75.0,1,91,0.0,91.0,91.0
39717344.0,6,26,7627,14,3735,195764.6153846153,1514.0,266.7857142857143,12,3892,3591101.909090909,1514.0,324.3333333333333
3007240.0,6,145,121766,86,113570,35379.294117647056,1510.0,1320.5813953488373,59,8196,46587.25862068965,1510.0,138.91525423728814
120006376.0,6,26,2866,13,1457,10000531.333333334,361.0,112.07692307692308,13,1409,9977612.416666666,425.0,108.3846153846154
120263138.0,6,204,23108,102,6954,1182455.8316831684,140.0,68.17647058823529,102,16154,1182624.0693069308,284.0,158.37254901960785
108106670.0,17,5,955,5,955,27026667.5,191.0,191.0,0,0,0.0,0.0,0.0
147408.0,6,3,373,2,238,0.0,172.0,119.0,1,135,0.0,135.0,135.0
153407.0,17,2,180,1,90,0.0,90.0,90.0,1,90,0.0,90.0,90.0
209477.0,17,2,180,1,90,0.0,90.0,90.0,1,90,0.0,90.0,90.0
94012556.0,6,40,2640,20,1320,4948029.263157895,66.0,66.0,20,1320,4933505.52631579,66.0,66.0
504300.0,6,5,336,2,134,0.0,68.0,67.0,3,202,191723.5,70.0,67.33333333333333
1820.0,17,2,192,1,88,0.0,88.0,88.0,1,104,0.0,104.0,104.0
67079052.00000001,6,24,1727,12,884,6097613.454545454,95.0,73.66666666666667,12,843,6070994.181818182,95.0,70.25
6618.0,17,2,582,1,83,0.0,83.0,83.0,1,499,0.0,499.0,499.0
316902.0,17,4,1400,4,1400,105634.0,350.0,350.0,0,0,0.0,0.0,0.0
91815.0,6,10,2032,5,524,22733.75,252.0,104.8,5,1508,21256.0,1236.0,301.6
237162.0,17,2,180,1,90,0.0,90.0,90.0,1,90,0.0,90.0,90.0
100934.0,17,2,762,2,762,0.0,381.0,381.0,0,0,0.0,0.0,0.0
867224.0,6,9,1267,6,796,173444.8,458.0,132.66666666666666,3,471,295859.5,331.0,157.0
6902.0,17,4,823,2,163,0.0,89.0,81.5,2,660,0.0,443.0,330.0
135145071.0,17,6,1146,6,1146,27029014.2,191.0,191.0,0,0,0.0,0.0,0.0
228445.0,17,2,180,1,90,0.0,90.0,90.0,1,90,0.0,90.0,90.0
48507.0,6,10,2032,5,524,10263.0,252.0,104.8,5,1508,11852.75,1236.0,301.6
119609.0,17,2,762,2,762,0.0,381.0,381.0,0,0,0.0,0.0,0.0
35100.0,6,10,2032,5,524,8559.75,252.0,104.8,5,1508,6289.25,1236.0,301.6
14000.0,6,10,2032,5,524,3107.5,252.0,104.8,5,1508,3267.5,1236.0,301.6
135133315.0,17,6,1206,6,1206,27026663.0,201.0,201.0,0,0,0.0,0.0,0.0
90005171.0,17,28,13364,28,13364,3333524.851851852,501.0,477.2857142857143,0,0,0.0,0.0,0.0
27459.0,6,14,4740,7,653,4367.0,249.0,93.28571428571428,7,4087,4271.5,1514.0,583.8571428571429
36151.0,6,14,4740,7,653,5805.833333333333,249.0,93.28571428571428,7,4087,5803.333333333333,1514.0,583.8571428571429
989203.0,6,12,1447,6,816,197362.4,291.0,136.0,6,631,196898.6,293.0,105.16666666666669
1018741.0,6,11,1134,6,558,203748.2,220.0,93.0,5,576,253744.5,304.0,115.2
103849.0,17,2,286,2,286,0.0,143.0,143.0,0,0,0.0,0.0,0.0
4655.0,17,2,582,1,83,0.0,83.0,83.0,1,499,0.0,499.0,499.0
1774428.0,6,2,132,1,66,0.0,66.0,66.0,1,66,0.0,66.0,66.0
36940.0,6,14,4740,7,653,5905.666666666667,249.0,93.28571428571428,7,4087,5973.5,1514.0,583.8571428571429
108106433.0,17,5,1005,5,1005,27026608.25,201.0,201.0,0,0,0.0,0.0,0.0
228289.0,17,2,180,1,90,0.0,90.0,90.0,1,90,0.0,90.0,90.0
112025122.0,6,244,28284,122,8274,918860.4628099174,140.0,67.81967213114754,122,20010,919093.520661157,374.0,164.01639344262296
6016357.0,17,5,1710,5,1710,1504089.25,342.0,342.0,0,0,0.0,0.0,0.0
18409.0,6,10,2032,5,524,4387.75,252.0,104.8,5,1508,4240.75,1236.0,301.6
90524242.0,6,13,2036,8,1016,12932034.57142857,188.0,127.0,5,1020,22590579.5,204.0,204.0
2361.0,17,4,344,2,150,0.0,75.0,75.0,2,194,0.0,103.0,97.0
298086.0,6,6,412,4,272,99362.0,74.0,68.0,2,140,0.0,74.0,70.0
200802.0,17,4,6056,4,6056,66934.0,1514.0,1514.0,0,0,0.0,0.0,0.0
1304.0,17,4,438,2,148,0.0,74.0,74.0,2,290,0.0,147.0,145.0
297135.0,6,6,412,4,272,99045.0,74.0,68.0,2,140,0.0,74.0,70.0
206208.0,6,3,426,2,280,0.0,214.0,140.0,1,146,0.0,146.0,146.0
146194.0,6,3,337,2,214,0.0,160.0,107.0,1,123,0.0,123.0,123.0
196794.0,17,2,180,1,90,0.0,90.0,90.0,1,90,0.0,90.0,90.0
90943726.0,6,21,1585,11,840,9093593.3,95.0,76.36363636363636,10,745,10104144.444444444,95.0,74.5
2802584.0,6,2,132,1,66,0.0,66.0,66.0,1,66,0.0,66.0,66.0
135135229.0,17,6,1206,6,1206,27027045.8,201.0,201.0,0,0,0.0,0.0,0.0
90024888.0,6,14,1043,7,542,15004148.0,95.0,77.42857142857143,7,501,14955409.0,95.0,71.57142857142857
90045985.0,17,27,12943,27,12943,3463307.1153846155,501.0,479.3703703703704,0,0,0.0,0.0,0.0
31145.0,6,14,4740,7,653,4701.666666666667,249.0,93.28571428571428,7,4087,4896.333333333333,1514.0,583.8571428571429
767.0,17,4,438,2,148,0.0,74.0,74.0,2,290,0.0,147.0,145.0
144083.0,17,2,180,1,90,0.0,90.0,90.0,1,90,0.0,90.0,90.0
108107752.0,17,5,955,5,955,27026938.0,191.0,191.0,0,0,0.0,0.0,0.0
297917.0,6,6,412,4,272,99305.66666666669,74.0,68.0,2,140,0.0,74.0,70.0
311053.0,17,4,1400,4,1400,103684.33333333331,350.0,350.0,0,0,0.0,0.0,0.0
13426.0,6,14,4740,7,653,2018.3333333333333,249.0,93.28571428571428,7,4087,2102.5,1514.0,583.8571428571429
756.0,17,2,762,2,762,0.0,381.0,381.0,0,0,0.0,0.0,0.0
3078252.0,6,3,204,2,134,0.0,68.0,67.0,1,70,0.0,70.0,70.0
3894.0,17,4,704,2,148,0.0,74.0,74.0,2,556,0.0,280.0,278.0
374.0,17,2,267,1,83,0.0,83.0,83.0,1,184,0.0,184.0,184.0
1044018.0,6,13,1386,7,789,174003.0,253.0,112.71428571428572,6,597,207676.0,259.0,99.5
1990.0,17,4,344,2,150,0.0,75.0,75.0,2,194,0.0,103.0,97.0
216193.0,17,2,180,1,90,0.0,90.0,90.0,1,90,0.0,90.0,90.0
780.0,17,2,762,2,762,0.0,381.0,381.0,0,0,0.0,0.0,0.0
56211.0,6,14,4740,7,653,8780.0,249.0,93.28571428571428,7,4087,8954.833333333334,1514.0,583.8571428571429
314935.0,6,6,412,4,272,104978.33333333331,74.0,68.0,2,140,0.0,74.0,70.0
135132105.0,17,6,1206,6,1206,27026421.0,201.0,201.0,0,0,0.0,0.0,0.0
150942.0,6,3,337,2,214,0.0,160.0,107.0,1,123,0.0,123.0,123.0
309736.0,6,6,412,4,272,103245.33333333331,74.0,68.0,2,140,0.0,74.0,70.0
120007684.0,17,15,907,8,475,17143954.85714286,174.0,59.375,7,432,16745727.166666666,174.0,61.71428571428572
310214.0,17,4,1400,4,1400,103404.66666666669,350.0,350.0,0,0,0.0,0.0,0.0
10519644.0,6,6,412,3,206,5191552.5,74.0,68.66666666666667,3,206,5191547.0,74.0,68.66666666666667
0.0,6,1,54,0,0,0.0,0.0,0.0,1,54,0.0,54.0,54.0
50685383.0,6,9,2737,4,965,16229724.333333334,753.0,241.25,5,1772,11978036.5,785.0,354.4
48388.0,6,14,4740,7,653,7658.0,249.0,93.28571428571428,7,4087,7869.5,1514.0,583.8571428571429
90227652.0,6,16,1192,8,596,12853205.57142857,95.0,74.5,8,596,12858890.142857144,95.0,74.5
135130912.0,17,6,1206,6,1206,27026182.4,201.0,201.0,0,0,0.0,0.0,0.0
82922716.0,17,14,4796,13,4446,6228550.583333333,342.0,342.0,1,350,0.0,350.0,350.0
43872.0,6,14,4740,7,653,7184.333333333333,249.0,93.28571428571428,7,4087,7039.166666666667,1514.0,583.8571428571429
108101489.0,17,5,955,5,955,27025372.25,191.0,191.0,0,0,0.0,0.0,0.0
10109.0,17,4,823,2,163,0.0,89.0,81.5,2,660,0.0,443.0,330.0
317140.0,17,4,1400,4,1400,105713.33333333331,350.0,350.0,0,0,0.0,0.0,0.0
108101215.0,17,5,1005,5,1005,27025303.75,201.0,201.0,0,0,0.0,0.0,0.0
120127159.0,6,230,25994,115,7812,1046617.0263157894,140.0,67.9304347826087,115,18182,1038279.0701754388,284.0,158.10434782608695
2856004.0,6,4,270,3,202,1428002.0,70.0,67.33333333333333,1,68,0.0,68.0,68.0
102889.0,17,2,286,2,286,0.0,143.0,143.0,0,0,0.0,0.0,0.0
120363103.0,6,241,27206,121,18990,1003025.8583333332,284.0,156.94214876033058,120,8216,1002807.9663865546,140.0,68.46666666666667
3012360.0,6,12,2172,7,664,501428.1666666667,252.0,94.85714285714286,5,1508,2710.75,1236.0,301.6
107124247.0,6,29,2052,15,1089,7636304.428571428,123.0,72.6,14,963,8223689.307692308,123.0,68.78571428571429
3168646.0,6,18,1495,9,921,358416.25,315.0,102.33333333333331,9,574,358381.125,78.0,63.77777777777778
315862.0,17,4,1400,4,1400,105287.33333333331,350.0,350.0,0,0,0.0,0.0,0.0
80477.0,6,14,4740,7,653,12957.833333333334,249.0,93.28571428571428,7,4087,13104.5,1514.0,583.8571428571429
109709155.0,6,46,4098,27,2313,4219582.884615385,123.0,85.66666666666667,19,1785,6082936.333333333,123.0,93.94736842105264
105067509.0,6,30,2106,15,1089,7489384.928571428,123.0,72.6,15,1017,7489391.857142857,123.0,67.8
302979.0,6,7,478,4,272,100993.0,74.0,68.0,3,206,75094.5,74.0,68.66666666666667
0.0,17,1,55,1,55,0.0,55.0,55.0,0,0,0.0,0.0,0.0
108106906.0,17,5,955,5,955,27026726.5,191.0,191.0,0,0,0.0,0.0,0.0
135126972.0,17,6,1146,6,1146,27025394.4,191.0,191.0,0,0,0.0,0.0,0.0
217508.0,6,3,426,2,280,0.0,214.0,140.0,1,146,0.0,146.0,146.0
404.0,17,2,410,1,78,0.0,78.0,78.0,1,332,0.0,332.0,332.0
104520967.0,6,44,2904,22,1452,4977188.904761905,66.0,66.0,22,1452,4962837.19047619,66.0,66.0
53780.0,6,14,4740,7,653,8420.833333333334,249.0,93.28571428571428,7,4087,8567.333333333334,1514.0,583.8571428571429
90258459.0,6,13,2036,8,1016,12894065.57142857,188.0,127.0,5,1020,22523468.75,204.0,204.0
197111.0,17,2,180,1,90,0.0,90.0,90.0,1,90,0.0,90.0,90.0
1185724.0,6,13,3020,8,2392,169389.14285714287,1514.0,299.0,5,628,227505.25,331.0,125.6
5622897.0,6,5,336,2,134,0.0,68.0,67.0,3,202,1422370.5,70.0,67.33333333333333
43921.0,6,14,4740,7,653,7131.5,249.0,93.28571428571428,7,4087,6205.5,1514.0,583.8571428571429
2334443.0,6,28,9195,16,3843,155629.53333333333,1514.0,240.1875,12,5352,189155.2727272728,1514.0,446.0
68388.0,6,10,2032,5,524,12250.25,252.0,104.8,5,1508,11610.0,1236.0,301.6
90261839.0,6,12,1832,8,1016,12894548.42857143,188.0,127.0,4,816,30032723.0,204.0,204.0
153420.0,17,2,180,1,90,0.0,90.0,90.0,1,90,0.0,90.0,90.0
73774.0,6,14,4740,7,653,11573.833333333334,249.0,93.28571428571428,7,4087,12080.666666666666,1514.0,583.8571428571429
205771.0,17,2,180,1,90,0.0,90.0,90.0,1,90,0.0,90.0,90.0
237727.0,17,2,180,1,90,0.0,90.0,90.0,1,90,0.0,90.0,90.0
10891133.0,6,8,544,4,272,3584786.333333333,74.0,68.0,4,272,3584721.0,74.0,68.0
2403.0,17,4,344,2,150,0.0,75.0,75.0,2,194,0.0,103.0,97.0
29272.0,6,10,2032,5,524,5224.75,252.0,104.8,5,1508,6649.25,1236.0,301.6
1023510.0,6,11,1134,6,558,204702.00000000003,220.0,93.0,5,576,255316.75,304.0,115.2
203089.0,17,2,762,2,762,0.0,381.0,381.0,0,0,0.0,0.0,0.0
694.0,17,4,438,2,148,0.0,74.0,74.0,2,290,0.0,147.0,145.0
103255.0,17,2,286,2,286,0.0,143.0,143.0,0,0,0.0,0.0,0.0
2016.0,17,4,344,2,150,0.0,75.0,75.0,2,194,0.0,103.0,97.0
241890.0,6,3,337,2,214,0.0,160.0,107.0,1,123,0.0,123.0,123.0
111175321.0,6,34,2482,17,1194,6948457.5625,123.0,70.23529411764706,17,1288,6310261.4375,139.0,75.76470588235294
209676.0,17,2,180,1,90,0.0,90.0,90.0,1,90,0.0,90.0,90.0
99791.0,17,2,286,2,286,0.0,143.0,143.0,0,0,0.0,0.0,0.0
1304042.0,6,4,264,2,132,0.0,66.0,66.0,2,132,0.0,66.0,66.0
306009.0,6,3,202,2,128,0.0,74.0,64.0,1,74,0.0,74.0,74.0
147982.0,17,2,180,1,90,0.0,90.0,90.0,1,90,0.0,90.0,90.0
20373.0,17,2,582,1,83,0.0,83.0,83.0,1,499,0.0,499.0,499.0
30505.0,6,14,4740,7,653,4214.0,249.0,93.28571428571428,7,4087,4943.333333333333,1514.0,583.8571428571429
127011348.0,17,15,907,8,475,18144478.285714287,174.0,59.375,7,432,17833504.5,174.0,61.71428571428572
120068309.0,17,28,13364,28,13364,4446974.407407408,501.0,477.2857142857143,0,0,0.0,0.0,0.0
108103211.0,17,5,955,5,955,27025802.75,191.0,191.0,0,0,0.0,0.0,0.0
108106575.0,17,5,1005,5,1005,27026643.75,201.0,201.0,0,0,0.0,0.0,0.0
128638170.0,6,32,2220,16,1071,7910248.466666667,123.0,66.9375,16,1149,7959714.0,123.0,71.8125
262077.0,6,10,1221,6,636,52415.4,298.0,106.0,4,585,81783.0,379.0,146.25
113809062.0,6,48,3168,24,1584,4948220.0869565215,66.0,66.0,24,1584,4938821.782608695,66.0,66.0
1597361.0,6,7,499,4,301,474999.6666666667,103.0,75.25,3,198,716381.5,66.0,66.0
120330746.0,6,211,23798,106,16560,1146007.1047619048,284.0,156.2264150943396,105,7238,1148148.423076923,140.0,68.93333333333334
5831288.0,6,5,336,2,134,0.0,68.0,67.0,3,202,1527419.5,70.0,67.33333333333333
121001151.0,17,14,864,8,475,17285878.714285713,174.0,59.375,6,389,16401650.4,174.0,64.83333333333333
112464191.0,6,46,3036,23,1518,5111997.181818182,66.0,66.0,23,1518,5111989.318181818,66.0,66.0
121187930.0,6,310,38628,155,10452,774934.3766233766,140.0,67.43225806451613,155,28176,781660.4025974026,480.0,181.78064516129032
135141607.0,17,6,1206,6,1206,27028321.4,201.0,201.0,0,0,0.0,0.0,0.0
23914.0,6,14,4740,7,653,3862.5,249.0,93.28571428571428,7,4087,3533.1666666666665,1514.0,583.8571428571429
2382.0,17,4,344,2,150,0.0,75.0,75.0,2,194,0.0,103.0,97.0
301810.0,6,6,412,4,272,100603.33333333331,74.0,68.0,2,140,0.0,74.0,70.0
107944.0,17,2,286,2,286,0.0,143.0,143.0,0,0,0.0,0.0,0.0
531329.0,17,6,2100,6,2100,106265.8,350.0,350.0,0,0,0.0,0.0,0.0
120000023.0,6,20,1531,11,840,12000002.3,95.0,76.36363636363636,9,691,11339561.375,95.0,76.77777777777777
306884.0,6,6,412,4,272,102294.66666666669,74.0,68.0,2,140,0.0,74.0,70.0
216108.0,6,10,1221,6,636,43221.6,298.0,106.0,4,585,70705.33333333333,379.0,146.25
113712657.0,6,32,2220,16,1149,7566439.6,123.0,71.8125,16,1071,7566430.066666666,123.0,66.9375
2597381.0,6,2,132,1,66,0.0,66.0,66.0,1,66,0.0,66.0,66.0
219081.0,6,3,426,2,280,0.0,214.0,140.0,1,146,0.0,146.0,146.0
1768528.0,6,2,132,1,66,0.0,66.0,66.0,1,66,0.0,66.0,66.0
36233.0,6,14,4740,7,653,5916.333333333333,249.0,93.28571428571428,7,4087,5319.0,1514.0,583.8571428571429
90903101.0,6,182,20554,91,14400,1007641.7444444444,284.0,158.24175824175825,91,6154,1007641.3111111112,140.0,67.62637362637362
42329.0,6,10,2032,5,524,10326.75,252.0,104.8,5,1508,9777.25,1236.0,301.6
279949.0,17,4,704,2,148,0.0,74.0,74.0,2,556,0.0,280.0,278.0
90019868.0,17,28,13364,28,13364,3334069.185185185,501.0,477.2857142857143,0,0,0.0,0.0,0.0
205831.0,17,2,180,1,90,0.0,90.0,90.0,1,90,0.0,90.0,90.0
90290465.0,6,16,1192,8,596,12892698.142857144,95.0,74.5,8,596,12896749.57142857,95.0,74.5
121199.0,6,3,337,2,214,0.0,160.0,107.0,1,123,0.0,123.0,123.0
302359.0,6,6,412,4,272,100786.33333333331,74.0,68.0,2,140,0.0,74.0,70.0
147988.0,17,2,180,1,90,0.0,90.0,90.0,1,90,0.0,90.0,90.0
0.0,17,1,453,1,453,0.0,453.0,453.0,0,0,0.0,0.0,0.0
304670.0,6,6,412,4,272,101556.66666666669,74.0,68.0,2,140,0.0,74.0,70.0
90056665.0,17,28,13364,28,13364,3335432.037037037,501.0,477.2857142857143,0,0,0.0,0.0,0.0
348.0,17,2,267,1,83,0.0,83.0,83.0,1,184,0.0,184.0,184.0
2799857.0,6,2,132,1,66,0.0,66.0,66.0,1,66,0.0,66.0,66.0
90034042.0,17,28,13364,28,13364,3334594.1481481483,501.0,477.2857142857143,0,0,0.0,0.0,0.0
153576.0,17,2,180,1,90,0.0,90.0,90.0,1,90,0.0,90.0,90.0
90296348.0,6,16,1192,8,596,12892717.42857143,95.0,74.5,8,596,12898806.42857143,95.0,74.5
36738.0,6,14,4740,7,653,5839.833333333333,249.0,93.28571428571428,7,4087,4094.1666666666665,1514.0,583.8571428571429
2269.0,17,4,344,2,150,0.0,75.0,75.0,2,194,0.0,103.0,97.0
38345.0,6,14,4740,7,653,6137.333333333333,249.0,93.28571428571428,7,4087,6187.166666666667,1514.0,583.8571428571429
308217.0,6,6,412,4,272,102739.0,74.0,68.0,2,140,0.0,74.0,70.0
34236.0,6,14,4740,7,653,5568.5,249.0,93.28571428571428,7,4087,5565.666666666667,1514.0,583.8571428571429
27241446.0,17,5,1718,4,1368,1779721.3333333333,342.0,342.0,1,350,0.0,350.0,350.0
300889.0,6,6,412,4,272,100296.33333333331,74.0,68.0,2,140,0.0,74.0,70.0
135140322.0,17,6,1146,6,1146,27028064.4,191.0,191.0,0,0,0.0,0.0,0.0
143836.0,17,2,180,1,90,0.0,90.0,90.0,1,90,0.0,90.0,90.0
1682.0,17,4,438,2,148,0.0,74.0,74.0,2,290,0.0,147.0,145.0
120175264.0,6,236,26644,118,8084,1020146.641025641,140.0,68.50847457627118,118,18560,1020152.5982905984,284.0,157.28813559322035
135130513.0,17,6,1206,6,1206,27026102.6,201.0,201.0,0,0,0.0,0.0,0.0
341039.0,6,3,1604,2,851,0.0,785.0,425.5,1,753,0.0,753.0,753.0
102406.0,17,2,286,2,286,0.0,143.0,143.0,0,0,0.0,0.0,0.0
49172.0,6,14,4740,7,653,7842.0,249.0,93.28571428571428,7,4087,5070.333333333333,1514.0,583.8571428571429
106990.0,17,2,286,2,286,0.0,143.0,143.0,0,0,0.0,0.0,0.0
1302419.0,6,4,264,2,132,0.0,66.0,66.0,2,132,0.0,66.0,66.0
90362964.0,6,11,1644,7,828,15060494.0,188.0,118.28571428571428,4,816,20110639.666666668,204.0,204.0
111008659.0,6,30,1974,15,1026,7913771.571428572,123.0,68.4,15,948,7913773.428571428,123.0,63.2
34988.0,6,10,2032,5,524,7473.0,252.0,104.8,5,1508,8386.5,1236.0,301.6
2054.0,17,4,344,2,150,0.0,75.0,75.0,2,194,0.0,103.0,97.0
190823.0,17,4,1524,4,1524,63607.66666666666,381.0,381.0,0,0,0.0,0.0,0.0
26362.0,6,10,2032,5,524,5488.25,252.0,104.8,5,1508,5947.75,1236.0,301.6
108101566.0,17,5,955,5,955,27025391.5,191.0,191.0,0,0,0.0,0.0,0.0
48883.0,6,11,2098,6,590,9444.6,252.0,98.33333333333331,5,1508,11437.75,1236.0,301.6
90258600.0,6,12,1832,8,1016,12894085.714285716,188.0,127.0,4,816,30032160.0,204.0,204.0
1169031.0,6,13,3018,8,2390,167004.42857142858,1514.0,298.75,5,628,224139.25,331.0,125.6
242081.0,6,3,337,2,214,0.0,160.0,107.0,1,123,0.0,123.0,123.0
14657141.0,6,20,1607,10,975,1593113.5555555555,315.0,97.5,10,632,1592933.7777777778,78.0,63.2
321711.0,17,4,1400,4,1400,107237.0,350.0,350.0,0,0,0.0,0.0,0.0
208566.0,17,2,762,2,762,0.0,381.0,381.0,0,0,0.0,0.0,0.0
284354.0,17,2,363,1,79,0.0,79.0,79.0,1,284,0.0,284.0,284.0
108369315.0,6,41,3402,22,1824,5160443.571428572,123.0,82.9090909090909,19,1578,6008507.388888889,123.0,83.05263157894737
330.0,17,2,208,1,72,0.0,72.0,72.0,1,136,0.0,136.0,136.0
758.0,17,4,438,2,148,0.0,74.0,74.0,2,290,0.0,147.0,145.0
298444.0,6,6,412,4,272,99481.33333333331,74.0,68.0,2,140,0.0,74.0,70.0
298362.0,6,6,412,4,272,99454.0,74.0,68.0,2,140,0.0,74.0,70.0
107091.0,17,2,700,2,700,0.0,350.0,350.0,0,0,0.0,0.0,0.0
206138.0,6,3,426,2,280,0.0,214.0,140.0,1,146,0.0,146.0,146.0
450404.0,17,4,6056,4,6056,150134.66666666666,1514.0,1514.0,0,0,0.0,0.0,0.0
44995.0,6,14,4740,7,653,7275.5,249.0,93.28571428571428,7,4087,5319.666666666667,1514.0,583.8571428571429
120114576.0,6,16,2368,9,1204,14994349.0,188.0,133.77777777777777,7,1164,15016245.833333334,204.0,166.28571428571428
30239.0,6,10,2032,5,524,6397.75,252.0,104.8,5,1508,6684.5,1236.0,301.6
128282479.0,17,14,864,7,432,18333494.666666668,174.0,61.71428571428572,7,432,18334771.166666668,174.0,61.71428571428572
30130.0,6,14,4740,7,653,4244.166666666667,249.0,93.28571428571428,7,4087,4758.833333333333,1514.0,583.8571428571429
63429.0,6,10,2032,5,524,15568.75,252.0,104.8,5,1508,13895.25,1236.0,301.6
5627189.0,6,5,336,2,134,0.0,68.0,67.0,3,202,1420926.5,70.0,67.33333333333333
308372.0,6,6,412,4,272,102790.66666666669,74.0,68.0,2,140,0.0,74.0,70.0
427297.0,6,3,1604,2,851,0.0,785.0,425.5,1,753,0.0,753.0,753.0
92113709.0,6,38,2508,19,1254,5105436.388888889,66.0,66.0,19,1254,5105448.444444444,66.0,66.0
111179.0,17,4,1400,4,1400,37059.66666666666,350.0,350.0,0,0,0.0,0.0,0.0
3342.0,17,4,344,2,150,0.0,75.0,75.0,2,194,0.0,103.0,97.0
300925.0,6,6,412,4,272,100308.33333333331,74.0,68.0,2,140,0.0,74.0,70.0
320.0,17,2,174,1,79,0.0,79.0,79.0,1,95,0.0,95.0,95.0
241664.0,6,3,337,2,214,0.0,160.0,107.0,1,123,0.0,123.0,123.0
100178279.0,17,12,516,6,258,20000201.8,43.0,43.0,6,258,20001421.2,43.0,43.0
309025.0,6,6,412,4,272,103008.33333333331,74.0,68.0,2,140,0.0,74.0,70.0
206386.0,6,3,426,2,280,0.0,214.0,140.0,1,146,0.0,146.0,146.0
1024752.0,6,11,1134,6,558,204950.4,220.0,93.0,5,576,255455.0,304.0,115.2
1855.0,17,4,344,2,150,0.0,75.0,75.0,2,194,0.0,103.0,97.0
1863.0,17,4,344,2,150,0.0,75.0,75.0,2,194,0.0,103.0,97.0
90255743.0,6,12,1832,8,1016,12893677.57142857,188.0,127.0,4,816,30030357.33333333,204.0,204.0
56190.0,6,13,1386,7,789,9168.166666666666,253.0,112.71428571428572,6,597,10006.8,259.0,99.5
274186.0,6,10,1221,6,636,54837.2,298.0,106.0,4,585,85126.33333333333,379.0,146.25
270793.0,6,3,337,2,214,0.0,160.0,107.0,1,123,0.0,123.0,123.0
306501.0,6,6,412,4,272,102167.0,74.0,68.0,2,140,0.0,74.0,70.0
108106144.0,17,5,1005,5,1005,27026536.0,201.0,201.0,0,0,0.0,0.0,0.0
305648.0,6,6,412,4,272,101882.66666666669,74.0,68.0,2,140,0.0,74.0,70.0
90293161.0,6,16,1192,8,596,12892877.142857144,95.0,74.5,8,596,12898727.142857144,95.0,74.5
232541.0,6,3,337,2,214,0.0,160.0,107.0,1,123,0.0,123.0,123.0
58517.0,6,14,4740,7,653,9329.666666666666,249.0,93.28571428571428,7,4087,8367.833333333334,1514.0,583.8571428571429
2780086.0,6,2,132,1,66,0.0,66.0,66.0,1,66,0.0,66.0,66.0
17722.0,6,10,2032,5,524,4132.5,252.0,104.8,5,1508,3754.25,1236.0,301.6
63950.00000000001,6,14,4740,7,653,10328.5,249.0,93.28571428571428,7,4087,8293.0,1514.0,583.8571428571429
125557.0,6,14,4740,7,653,20805.0,249.0,93.28571428571428,7,4087,19894.0,1514.0,583.8571428571429
37362.0,6,14,4740,7,653,6107.166666666667,249.0,93.28571428571428,7,4087,6084.0,1514.0,583.8571428571429
90283774.0,6,14,2240,8,1016,12897682.0,188.0,127.0,6,1224,18024127.2,204.0,204.0
42436.0,6,14,4740,7,653,6920.5,249.0,93.28571428571428,7,4087,6837.666666666667,1514.0,583.8571428571429
2365.0,17,4,344,2,150,0.0,75.0,75.0,2,194,0.0,103.0,97.0
61048.0,6,10,2032,5,524,13296.5,252.0,104.8,5,1508,14394.75,1236.0,301.6
42219.0,6,14,4740,7,653,6911.5,249.0,93.28571428571428,7,4087,6896.333333333333,1514.0,583.8571428571429
190229.0,6,11,1132,6,556,37505.2,218.0,92.66666666666669,5,576,47080.0,304.0,115.2
103779.0,17,2,286,2,286,0.0,143.0,143.0,0,0,0.0,0.0,0.0
56568.0,6,14,4740,7,653,7798.5,249.0,93.28571428571428,7,4087,8566.166666666666,1514.0,583.8571428571429
437023.0,6,11,1021,6,444,58586.0,162.0,74.0,5,577,73158.25,349.0,115.4
165849.0,17,2,180,1,90,0.0,90.0,90.0,1,90,0.0,90.0,90.0
33659.0,6,10,2032,5,524,7514.75,252.0,104.8,5,1508,8155.0,1236.0,301.6
120029896.0,17,29,13785,29,13785,4286782.0,501.0,475.3448275862069,0,0,0.0,0.0,0.0
96101491.0,6,66,16034,34,6786,2912166.393939394,1514.0,199.58823529411765,32,9248,3091760.935483871,1514.0,289.0
2192798.0,6,18,6803,10,1501,243644.22222222225,408.0,150.1,8,5302,243159.2857142857,1514.0,662.75
2710.0,17,4,344,2,150,0.0,75.0,75.0,2,194,0.0,103.0,97.0
78925.0,6,14,4740,7,653,13030.0,249.0,93.28571428571428,7,4087,12828.833333333334,1514.0,583.8571428571429
304229.0,6,6,412,4,272,101409.66666666669,74.0,68.0,2,140,0.0,74.0,70.0
103846.0,17,2,286,2,286,0.0,143.0,143.0,0,0,0.0,0.0,0.0
120063318.0,6,222,24962,111,7622,1084031.7636363637,140.0,68.66666666666667,111,17340,1085070.7454545454,284.0,156.21621621621622
0.0,17,1,350,1,350,0.0,350.0,350.0,0,0,0.0,0.0,0.0
21711.0,6,14,4740,7,653,2382.0,249.0,93.28571428571428,7,4087,3481.833333333333,1514.0,583.8571428571429
209509.0,17,2,180,1,90,0.0,90.0,90.0,1,90,0.0,90.0,90.0
310.0,17,2,174,1,79,0.0,79.0,79.0,1,95,0.0,95.0,95.0
24351.0,6,10,2032,5,524,5853.0,252.0,104.8,5,1508,5617.75,1236.0,301.6
327605.0,17,2,876,2,876,0.0,438.0,438.0,0,0,0.0,0.0,0.0
233451.0,6,3,337,2,214,0.0,160.0,107.0,1,123,0.0,123.0,123.0
103000968.0,17,14,864,7,432,17166828.0,174.0,61.71428571428572,7,432,17001068.833333332,174.0,61.71428571428572
228421.0,17,2,180,1,90,0.0,90.0,90.0,1,90,0.0,90.0,90.0
21201.0,6,14,4740,7,653,3261.333333333333,249.0,93.28571428571428,7,4087,2867.5,1514.0,583.8571428571429
2888565.0,6,3,1604,1,753,0.0,753.0,753.0,2,851,0.0,785.0,425.5
25033.0,6,14,4740,7,653,3959.6666666666665,249.0,93.28571428571428,7,4087,3977.1666666666665,1514.0,583.8571428571429
1774962.0,17,6,1039,4,312,591526.0,78.0,78.0,2,727,0.0,395.0,363.5
7482093.0,6,5,1736,2,819,0.0,753.0,409.5,3,917,3676829.0,785.0,305.6666666666667
90296124.0,6,17,1287,9,691,11281272.375,95.0,76.77777777777777,8,596,12898222.142857144,95.0,74.5
386663.0,6,3,204,1,68,0.0,68.0,68.0,2,136,0.0,70.0,68.0
120285516.0,6,212,23958,106,7292,1140850.7238095235,140.0,68.79245283018868,106,16666,1137757.4095238096,284.0,157.2264150943396
106728.0,17,2,286,2,286,0.0,143.0,143.0,0,0,0.0,0.0,0.0
5005201.0,17,4,849,2,166,0.0,83.0,83.0,2,683,0.0,499.0,341.5
47878973.0,6,8,1307,8,1307,6839853.285714285,172.0,163.375,0,0,0.0,0.0,0.0
90008978.0,17,28,13364,28,13364,3333665.851851852,501.0,477.2857142857143,0,0,0.0,0.0,0.0
1314517.0,6,4,264,2,132,0.0,66.0,66.0,2,132,0.0,66.0,66.0
298733.0,17,2,180,1,90,0.0,90.0,90.0,1,90,0.0,90.0,90.0
2000703.0,6,24,6999,12,1981,181862.0909090909,575.0,165.08333333333334,12,5018,153500.0,1510.0,418.1666666666667
55502.0,6,14,4740,7,653,8984.833333333334,249.0,93.28571428571428,7,4087,8251.666666666666,1514.0,583.8571428571429
314708.0,17,4,1400,4,1400,104902.66666666669,350.0,350.0,0,0,0.0,0.0,0.0
228438.0,17,2,180,1,90,0.0,90.0,90.0,1,90,0.0,90.0,90.0
120448923.0,6,21,1585,11,840,9041588.8,95.0,76.36363636363636,10,745,13378229.777777778,95.0,74.5
1182445.0,6,13,3010,8,2382,168920.7142857143,1514.0,297.75,5,628,227455.5,331.0,125.6
47097.0,6,14,4740,7,653,7723.0,249.0,93.28571428571428,7,4087,6976.666666666667,1514.0,583.8571428571429
2291.0,17,4,344,2,150,0.0,75.0,75.0,2,194,0.0,103.0,97.0
52722.0,6,10,2032,5,524,12493.5,252.0,104.8,5,1508,12918.5,1236.0,301.6
216589.0,6,3,426,2,280,0.0,214.0,140.0,1,146,0.0,146.0,146.0
99758207.0,17,12,778,6,389,19951641.4,174.0,64.83333333333333,6,389,19875933.0,174.0,64.83333333333333
232908.0,17,2,180,1,90,0.0,90.0,90.0,1,90,0.0,90.0,90.0
120215788.0,6,226,25730,113,7754,1069049.767857143,140.0,68.61946902654867,113,17976,1066051.732142857,284.0,159.0796460176991
121906.0,6,3,373,2,238,0.0,172.0,119.0,1,135,0.0,135.0,135.0
135132426.0,17,6,1146,6,1146,27026485.2,191.0,191.0,0,0,0.0,0.0,0.0
320186.0,17,4,1400,4,1400,106728.66666666669,350.0,350.0,0,0,0.0,0.0,0.0
217010.0,6,3,426,2,280,0.0,214.0,140.0,1,146,0.0,146.0,146.0
95215284.0,17,12,778,6,389,19001123.4,174.0,64.83333333333333,6,389,19000165.4,174.0,64.83333333333333
135124951.0,17,6,1146,6,1146,27024990.2,191.0,191.0,0,0,0.0,0.0,0.0
1196783.0,6,13,3000,8,2372,170969.0,1514.0,296.5,5,628,231107.5,331.0,125.6
126012608.0,17,15,907,8,475,18001801.14285714,174.0,59.375,7,432,17666827.333333332,174.0,61.71428571428572
221778.0,6,10,1221,6,636,44355.6,298.0,106.0,4,585,73082.0,379.0,146.25
102747.0,17,2,286,2,286,0.0,143.0,143.0,0,0,0.0,0.0,0.0
306247.0,6,3,202,2,128,0.0,74.0,64.0,1,74,0.0,74.0,74.0
135127292.0,17,6,1146,6,1146,27025458.4,191.0,191.0,0,0,0.0,0.0,0.0
2800419.0,6,2,132,1,66,0.0,66.0,66.0,1,66,0.0,66.0,66.0
120009917.0,6,29,3439,15,1935,8571426.92857143,427.0,129.0,14,1504,9231206.0,336.0,107.42857142857144
108102364.0,17,5,1005,5,1005,27025591.0,201.0,201.0,0,0,0.0,0.0,0.0
149740.0,17,2,180,1,90,0.0,90.0,90.0,1,90,0.0,90.0,90.0
199211.0,17,4,6056,4,6056,66403.66666666667,1514.0,1514.0,0,0,0.0,0.0,0.0
104321195.0,6,43,2838,22,1452,4967664.0,66.0,66.0,21,1386,5159997.25,66.0,66.0
91377016.0,6,24,1829,13,989,7614573.5,95.0,76.07692307692308,11,840,9137081.4,95.0,76.36363636363636
214209.0,6,10,1221,6,636,42841.8,298.0,106.0,4,585,70491.33333333333,379.0,146.25
515.0,17,2,508,2,508,0.0,257.0,254.0,0,0,0.0,0.0,0.0
44937.0,6,14,4740,7,653,6590.833333333333,249.0,93.28571428571428,7,4087,5686.0,1514.0,583.8571428571429
209843.0,6,3,426,2,280,0.0,214.0,140.0,1,146,0.0,146.0,146.0
2591892.0,6,2,132,1,66,0.0,66.0,66.0,1,66,0.0,66.0,66.0
442917.0,6,10,1221,6,636,88583.4,298.0,106.0,4,585,142097.66666666666,379.0,146.25
3060833.0,6,3,204,2,136,0.0,70.0,68.0,1,68,0.0,68.0,68.0
4293.0,17,2,762,2,762,0.0,381.0,381.0,0,0,0.0,0.0,0.0
0.0,6,1,172,1,172,0.0,172.0,172.0,0,0,0.0,0.0,0.0
68942.0,17,2,620,1,75,0.0,75.0,75.0,1,545,0.0,545.0,545.0
143933.0,17,2,180,1,90,0.0,90.0,90.0,1,90,0.0,90.0,90.0
98966071.0,6,40,2640,20,1320,5208740.578947368,66.0,66.0,20,1320,5192540.105263158,66.0,66.0
14952.0,17,2,180,1,90,0.0,90.0,90.0,1,90,0.0,90.0,90.0
112366647.0,6,221,24950,111,7622,1021514.9727272728,140.0,68.66666666666667,110,17328,1021493.4128440368,284.0,157.52727272727273
2294.0,17,4,344,2,150,0.0,75.0,75.0,2,194,0.0,103.0,97.0
196923.0,17,2,180,1,90,0.0,90.0,90.0,1,90,0.0,90.0,90.0
1708429.0,6,23,6509,12,1529,155311.72727272726,357.0,127.41666666666669,11,4980,140496.2,1510.0,452.7272727272728
33105.0,6,14,4740,7,653,5392.333333333333,249.0,93.28571428571428,7,4087,5380.833333333333,1514.0,583.8571428571429
61812.0,6,10,2032,5,524,12415.25,252.0,104.8,5,1508,7103.25,1236.0,301.6
370392.0,6,10,1221,6,636,74078.4,298.0,106.0,4,585,122131.33333333331,379.0,146.25
170774.0,6,10,2032,5,524,42472.25,252.0,104.8,5,1508,34579.25,1236.0,301.6
3005616.0,6,11,2106,6,598,600951.6,252.0,99.66666666666669,5,1508,1717.25,1236.0,301.6
1306926.0,6,4,264,2,132,0.0,66.0,66.0,2,132,0.0,66.0,66.0
90299047.0,6,16,1192,8,596,12893723.142857144,95.0,74.5,8,596,12898410.42857143,95.0,74.5
196937.0,17,2,180,1,90,0.0,90.0,90.0,1,90,0.0,90.0,90.0
2510531.0,6,25,7573,14,3735,193117.7692307692,1514.0,266.7857142857143,11,3838,225500.7,1514.0,348.90909090909093
247261.0,17,2,180,1,90,0.0,90.0,90.0,1,90,0.0,90.0,90.0
30605.0,6,14,4740,7,653,4901.5,249.0,93.28571428571428,7,4087,4864.833333333333,1514.0,583.8571428571429
10520932.0,6,7,478,4,272,3461273.0,74.0,68.0,3,206,5191841.5,74.0,68.66666666666667
24729.0,6,10,1810,5,358,5926.25,130.0,71.6,5,1452,5894.75,1224.0,290.4
120028653.0,17,29,13785,29,13785,4286737.607142857,501.0,475.3448275862069,0,0,0.0,0.0,0.0
205677.0,17,2,180,1,90,0.0,90.0,90.0,1,90,0.0,90.0,90.0
280755.0,17,2,363,1,79,0.0,79.0,79.0,1,284,0.0,284.0,284.0
103190.0,17,2,286,2,286,0.0,143.0,143.0,0,0,0.0,0.0,0.0
228426.0,17,2,180,1,90,0.0,90.0,90.0,1,90,0.0,90.0,90.0
36090.0,6,14,4740,7,653,5618.666666666667,249.0,93.28571428571428,7,4087,5638.5,1514.0,583.8571428571429
1301740.0,6,4,264,2,132,0.0,66.0,66.0,2,132,0.0,66.0,66.0
18743.0,6,14,4740,7,653,2615.1666666666665,249.0,93.28571428571428,7,4087,2948.833333333333,1514.0,583.8571428571429
17578.0,6,2,145,2,145,0.0,91.0,72.5,0,0,0.0,0.0,0.0
335.0,17,2,208,1,72,0.0,72.0,72.0,1,136,0.0,136.0,136.0
183075.0,17,2,180,1,90,0.0,90.0,90.0,1,90,0.0,90.0,90.0
152717.0,6,11,1132,6,556,30079.6,218.0,92.66666666666669,5,576,37955.0,304.0,115.2
14247202.0,17,6,2052,6,2052,2849440.4,342.0,342.0,0,0,0.0,0.0,0.0
90065665.0,17,28,13364,28,13364,3335765.3703703703,501.0,477.2857142857143,0,0,0.0,0.0,0.0
3122608.0,6,3,204,2,136,0.0,70.0,68.0,1,68,0.0,68.0,68.0
5117.0,17,4,438,2,148,0.0,74.0,74.0,2,290,0.0,147.0,145.0
100374.0,17,2,762,2,762,0.0,381.0,381.0,0,0,0.0,0.0,0.0
1644494.0,6,8,602,5,404,386266.0,103.0,80.8,3,198,204774.5,66.0,66.0
122975012.0,6,48,3168,24,1584,4971856.782608695,66.0,66.0,24,1584,5295217.739130435,66.0,66.0
193417.0,17,2,180,1,90,0.0,90.0,90.0,1,90,0.0,90.0,90.0
90051262.0,17,28,13364,28,13364,3335231.925925926,501.0,477.2857142857143,0,0,0.0,0.0,0.0
135138134.0,17,6,1206,6,1206,27027626.8,201.0,201.0,0,0,0.0,0.0,0.0
298151.0,6,6,412,4,272,99383.66666666669,74.0,68.0,2,140,0.0,74.0,70.0
2880695.0,6,4,270,2,134,0.0,68.0,67.0,2,136,0.0,70.0,68.0
120237941.0,6,18,1341,9,691,14999467.875,95.0,76.77777777777777,9,650,15000000.875,95.0,72.22222222222223
113168120.0,6,45,2970,23,1518,5144005.454545454,66.0,66.0,22,1452,5318282.380952381,66.0,66.0
280589.0,17,4,1400,4,1400,93529.66666666669,350.0,350.0,0,0,0.0,0.0,0.0
120115717.0,6,14,2086,9,1204,15014464.625,188.0,133.77777777777777,5,882,22521188.25,204.0,176.4
216986.0,6,10,1221,6,636,43397.2,298.0,106.0,4,585,70819.33333333333,379.0,146.25
25734.0,17,2,180,1,90,0.0,90.0,90.0,1,90,0.0,90.0,90.0
20790.0,6,10,2032,5,524,4973.0,252.0,104.8,5,1508,4229.75,1236.0,301.6
44634.0,6,14,4740,7,653,7031.666666666667,249.0,93.28571428571428,7,4087,6692.833333333333,1514.0,583.8571428571429
19520.0,6,11,2098,6,590,3641.0,252.0,98.33333333333331,5,1508,3675.25,1236.0,301.6
135129472.0,17,6,1146,6,1146,27025894.4,191.0,191.0,0,0,0.0,0.0,0.0
241582.0,6,3,373,2,238,0.0,172.0,119.0,1,135,0.0,135.0,135.0
293924.0,17,2,246,1,76,0.0,76.0,76.0,1,170,0.0,170.0,170.0
111155312.0,17,14,1126,7,563,18499243.83333333,174.0,80.42857142857143,7,563,18499253.83333333,174.0,80.42857142857143
30324.0,6,10,2032,5,524,7351.5,252.0,104.8,5,1508,6714.5,1236.0,301.6
43802.0,6,10,2032,5,524,10683.5,252.0,104.8,5,1508,10284.0,1236.0,301.6
90040649.0,17,28,13364,28,13364,3334838.851851852,501.0,477.2857142857143,0,0,0.0,0.0,0.0
115482101.0,6,224,25200,112,17512,1038441.1351351351,284.0,156.35714285714286,112,7688,1038441.3063063064,140.0,68.64285714285714
71358.0,17,2,608,1,75,0.0,75.0,75.0,1,533,0.0,533.0,533.0
108108844.0,17,5,1005,5,1005,27027211.0,201.0,201.0,0,0,0.0,0.0,0.0
603011.0,6,4,508,2,238,0.0,172.0,119.0,2,270,0.0,135.0,135.0
90261361.0,6,12,1832,8,1016,12894480.142857144,188.0,127.0,4,816,30032004.666666668,204.0,204.0
117159394.0,6,30,1974,15,1026,8353875.071428572,123.0,68.4,15,948,8353851.214285715,123.0,63.2
120086349.0,6,14,2102,6,1086,24017269.8,204.0,181.0,8,1016,17132082.14285714,188.0,127.0
107953.0,17,2,700,2,700,0.0,350.0,350.0,0,0,0.0,0.0,0.0
108109522.0,17,5,955,5,955,27027380.5,191.0,191.0,0,0,0.0,0.0,0.0
301192.0,6,6,412,4,272,100397.33333333331,74.0,68.0,2,140,0.0,74.0,70.0
90025801.0,17,27,12943,27,12943,3462530.8076923075,501.0,479.3703703703704,0,0,0.0,0.0,0.0
26254.0,6,14,4740,7,653,3928.6666666666665,249.0,93.28571428571428,7,4087,4171.166666666667,1514.0,583.8571428571429
143927.0,17,2,180,1,90,0.0,90.0,90.0,1,90,0.0,90.0,90.0
2440.0,17,4,344,2,150,0.0,75.0,75.0,2,194,0.0,103.0,97.0
354.0,17,2,248,1,84,0.0,84.0,84.0,1,164,0.0,164.0,164.0
6642.0,17,4,823,2,163,0.0,89.0,81.5,2,660,0.0,443.0,330.0
213638.0,17,2,180,1,90,0.0,90.0,90.0,1,90,0.0,90.0,90.0
447.0,17,2,508,2,508,0.0,257.0,254.0,0,0,0.0,0.0,0.0
359.0,17,2,168,1,76,0.0,76.0,76.0,1,92,0.0,92.0,92.0
350829.0,6,4,508,2,238,0.0,172.0,119.0,2,270,0.0,135.0,135.0
103326.0,17,2,286,2,286,0.0,143.0,143.0,0,0,0.0,0.0,0.0
120051420.0,17,29,13785,29,13785,4287550.714285715,501.0,475.3448275862069,0,0,0.0,0.0,0.0
206290.0,6,3,426,2,280,0.0,214.0,140.0,1,146,0.0,146.0,146.0
91004646.0,17,13,1083,7,563,15167441.0,174.0,80.42857142857143,6,520,14200158.2,174.0,86.66666666666667
0.0,17,1,90,1,90,0.0,90.0,90.0,0,0,0.0,0.0,0.0
29357.0,6,14,4740,7,653,4767.0,249.0,93.28571428571428,7,4087,4693.0,1514.0,583.8571428571429
143861.0,17,2,180,1,90,0.0,90.0,90.0,1,90,0.0,90.0,90.0
208410.0,6,10,1221,6,636,41682.0,298.0,106.0,4,585,68509.33333333333,379.0,146.25
0.0,6,1,66,1,66,0.0,66.0,66.0,0,0,0.0,0.0,0.0
301759.0,6,6,412,4,272,100586.33333333331,74.0,68.0,2,140,0.0,74.0,70.0
44524.0,6,10,2032,5,524,10213.75,252.0,104.8,5,1508,10346.75,1236.0,301.6
245329.0,6,3,337,2,214,0.0,160.0,107.0,1,123,0.0,123.0,123.0
5625668.0,6,4,270,2,134,0.0,68.0,67.0,2,136,0.0,70.0,68.0
1919.0,17,2,691,1,349,0.0,349.0,349.0,1,342,0.0,342.0,342.0
32945.0,6,14,4740,7,653,4951.833333333333,249.0,93.28571428571428,7,4087,4784.666666666667,1514.0,583.8571428571429
120580363.0,6,301,34614,151,24492,803869.0866666667,300.0,162.19867549668874,150,10122,802346.6577181208,140.0,67.48
45858.0,6,14,4740,7,653,7520.5,249.0,93.28571428571428,7,4087,6387.5,1514.0,583.8571428571429
216356.0,6,3,426,2,280,0.0,214.0,140.0,1,146,0.0,146.0,146.0
90026716.0,17,27,12943,27,12943,3462566.0,501.0,479.3703703703704,0,0,0.0,0.0,0.0
42413.0,6,10,2032,5,524,10367.75,252.0,104.8,5,1508,9795.75,1236.0,301.6
309993.0,6,3,202,2,128,0.0,74.0,64.0,1,74,0.0,74.0,74.0
120130592.0,6,15,2428,9,1204,15016324.0,188.0,133.77777777777777,6,1224,18073452.2,204.0,204.0
9743893.0,6,5,1736,2,819,0.0,753.0,409.5,3,917,4802700.0,785.0,305.6666666666667
815.0,17,4,438,2,148,0.0,74.0,74.0,2,290,0.0,147.0,145.0
2368.0,17,4,344,2,150,0.0,75.0,75.0,2,194,0.0,103.0,97.0
486436.0,6,8,664,4,416,108516.0,210.0,104.0,4,248,108439.0,74.0,62.0
2329.0,17,4,344,2,150,0.0,75.0,75.0,2,194,0.0,103.0,97.0
2330.0,17,4,344,2,150,0.0,75.0,75.0,2,194,0.0,103.0,97.0
206470.0,6,3,426,2,280,0.0,214.0,140.0,1,146,0.0,146.0,146.0
798.0,17,4,438,2,148,0.0,74.0,74.0,2,290,0.0,147.0,145.0
303249.0,17,4,1400,4,1400,101083.0,350.0,350.0,0,0,0.0,0.0,0.0
311.0,17,2,174,1,79,0.0,79.0,79.0,1,95,0.0,95.0,95.0
1162310.0,6,13,3019,8,2391,166044.2857142857,1514.0,298.875,5,628,221655.0,331.0,125.6
196921.0,17,2,180,1,90,0.0,90.0,90.0,1,90,0.0,90.0,90.0
0.0,17,1,84,1,84,0.0,84.0,84.0,0,0,0.0,0.0,0.0
113617991.0,6,46,3036,23,1518,5150438.2727272725,66.0,66.0,23,1518,5150432.136363637,66.0,66.0
192893.0,17,2,180,1,90,0.0,90.0,90.0,1,90,0.0,90.0,90.0
2880907.0,6,11,2106,6,598,575928.8,252.0,99.66666666666669,5,1508,1767.25,1236.0,301.6
90258312.0,6,14,2240,8,1016,12894044.57142857,188.0,127.0,6,1224,18018704.6,204.0,204.0
246246.0,6,3,337,2,214,0.0,160.0,107.0,1,123,0.0,123.0,123.0
37238.0,6,14,4740,7,653,6049.5,249.0,93.28571428571428,7,4087,5083.166666666667,1514.0,583.8571428571429
102042070.0,17,14,1126,7,563,17000164.5,174.0,80.42857142857143,7,563,17000819.0,174.0,80.42857142857143
218000.0,6,3,426,2,280,0.0,214.0,140.0,1,146,0.0,146.0,146.0
16942.0,17,2,180,1,90,0.0,90.0,90.0,1,90,0.0,90.0,90.0
117529463.0,17,14,1126,7,563,19570713.0,174.0,80.42857142857143,7,563,19561754.5,174.0,80.42857142857143
25968.0,6,10,2032,5,524,6197.5,252.0,104.8,5,1508,6128.0,1236.0,301.6
116009077.0,17,15,1169,8,606,16572725.285714284,174.0,75.75,7,563,16000136.166666666,174.0,80.42857142857143
55190.0,6,14,4740,7,653,8764.166666666666,249.0,93.28571428571428,7,4087,8325.833333333334,1514.0,583.8571428571429
206154.0,6,3,426,2,280,0.0,214.0,140.0,1,146,0.0,146.0,146.0
1037343.0,6,11,1134,6,558,207468.6,220.0,93.0,5,576,256885.25,304.0,115.2
2245.0,17,4,344,2,150,0.0,75.0,75.0,2,194,0.0,103.0,97.0
699.0,17,4,438,2,148,0.0,74.0,74.0,2,290,0.0,147.0,145.0
21585.0,17,2,582,1,83,0.0,83.0,83.0,1,499,0.0,499.0,499.0
120084077.0,17,29,13785,29,13785,4288717.035714285,501.0,475.3448275862069,0,0,0.0,0.0,0.0
103317.0,17,2,286,2,286,0.0,143.0,143.0,0,0,0.0,0.0,0.0
20213.0,17,2,582,1,83,0.0,83.0,83.0,1,499,0.0,499.0,499.0
120204682.0,6,18,1341,9,691,14999874.875,95.0,76.77777777777777,9,650,14999869.875,95.0,72.22222222222223
143938.0,17,2,180,1,90,0.0,90.0,90.0,1,90,0.0,90.0,90.0
34361.0,6,14,4740,7,653,4904.333333333333,249.0,93.28571428571428,7,4087,5588.166666666667,1514.0,583.8571428571429
5630199.0,6,5,336,2,134,0.0,68.0,67.0,3,202,1425133.5,70.0,67.33333333333333
90266225.0,6,19,1436,10,745,10025095.333333334,95.0,74.5,9,691,11281652.5,95.0,76.77777777777777
2596782.0,6,2,132,1,66,0.0,66.0,66.0,1,66,0.0,66.0,66.0
102324533.0,6,42,2772,21,1386,5105432.0,66.0,66.0,21,1386,5105428.5,66.0,66.0
32567.0,6,14,4740,7,653,4674.0,249.0,93.28571428571428,7,4087,5291.833333333333,1514.0,583.8571428571429
3051420.0,6,3,204,1,68,0.0,68.0,68.0,2,136,0.0,70.0,68.0
118764.0,6,12,1354,6,723,22495.6,253.0,120.5,6,631,21952.4,293.0,105.16666666666669
119359452.0,6,223,25262,112,17714,1075310.3783783785,284.0,158.16071428571428,111,7548,1075612.190909091,140.0,68.0
90050302.0,17,28,13364,28,13364,3335196.3703703703,501.0,477.2857142857143,0,0,0.0,0.0,0.0
297427.0,6,6,412,4,272,99142.33333333331,74.0,68.0,2,140,0.0,74.0,70.0
90037290.0,17,28,13364,28,13364,3334714.4444444445,501.0,477.2857142857143,0,0,0.0,0.0,0.0
9675.0,17,2,582,1,83,0.0,83.0,83.0,1,499,0.0,499.0,499.0
1302036.0,6,4,264,2,132,0.0,66.0,66.0,2,132,0.0,66.0,66.0
318974.0,6,3,202,2,128,0.0,74.0,64.0,1,74,0.0,74.0,74.0
10467734.0,6,7,478,4,272,3443920.333333333,74.0,68.0,3,206,5165746.0,74.0,68.66666666666667
2386.0,17,4,344,2,150,0.0,75.0,75.0,2,194,0.0,103.0,97.0
206779.0,17,2,180,1,90,0.0,90.0,90.0,1,90,0.0,90.0,90.0
2004.0,17,4,344,2,150,0.0,75.0,75.0,2,194,0.0,103.0,97.0
2531090.0,6,25,7573,14,3735,194699.2307692308,1514.0,266.7857142857143,11,3838,227639.2,1514.0,348.90909090909093
209710.0,17,2,180,1,90,0.0,90.0,90.0,1,90,0.0,90.0,90.0
135132066.0,17,6,1146,6,1146,27026413.2,191.0,191.0,0,0,0.0,0.0,0.0
135131967.0,17,6,1146,6,1146,27026393.4,191.0,191.0,0,0,0.0,0.0,0.0
120879211.0,6,46,3907,26,2206,4835168.44,139.0,84.84615384615384,20,1701,5915170.052631579,123.0,85.05
1109.0,17,2,508,2,508,0.0,257.0,254.0,0,0,0.0,0.0,0.0
91822200.0,6,27,1954,14,1045,7046647.384615385,139.0,74.64285714285714,13,909,7633873.75,123.0,69.92307692307692
99001.0,17,2,286,2,286,0.0,143.0,143.0,0,0,0.0,0.0,0.0
153450.0,17,2,180,1,90,0.0,90.0,90.0,1,90,0.0,90.0,90.0
4283.0,17,2,614,1,72,0.0,72.0,72.0,1,542,0.0,542.0,542.0
22781.0,6,10,1065,5,534,5176.0,262.0,106.8,5,531,5136.75,259.0,106.2
2686716.0,6,2,132,1,66,0.0,66.0,66.0,1,66,0.0,66.0,66.0
14635644.0,6,23,1822,12,1132,1303422.0909090908,315.0,94.33333333333331,11,690,1433757.8,78.0,62.72727272727273
41127.0,6,10,2032,5,524,8814.25,252.0,104.8,5,1508,9362.0,1236.0,301.6
771.0,17,2,762,2,762,0.0,381.0,381.0,0,0,0.0,0.0,0.0
12477.0,6,12,1393,6,796,2082.0,271.0,132.66666666666666,6,597,2294.6,259.0,99.5
143869.0,17,2,180,1,90,0.0,90.0,90.0,1,90,0.0,90.0,90.0
16339.0,6,10,2032,5,524,3854.25,252.0,104.8,5,1508,3425.25,1236.0,301.6
3206141.0,6,18,1495,9,921,362774.25,315.0,102.33333333333331,9,574,362736.5,78.0,63.77777777777778
23434.0,6,13,1459,7,862,3643.3333333333335,271.0,123.14285714285714,6,597,4408.6,259.0,99.5
4211.0,17,2,598,1,72,0.0,72.0,72.0,1,526,0.0,526.0,526.0
42770.0,6,14,4740,7,653,6632.166666666667,249.0,93.28571428571428,7,4087,6988.5,1514.0,583.8571428571429
109185.0,17,2,286,2,286,0.0,143.0,143.0,0,0,0.0,0.0,0.0
450.0,17,2,508,2,508,0.0,257.0,254.0,0,0,0.0,0.0,0.0
14072.0,17,4,344,2,150,0.0,75.0,75.0,2,194,0.0,103.0,97.0
10517343.0,6,7,478,4,272,3460465.6666666665,74.0,68.0,3,206,5190625.0,74.0,68.66666666666667
107299.0,17,2,700,2,700,0.0,350.0,350.0,0,0,0.0,0.0,0.0
112495.0,6,14,4740,7,653,18112.5,249.0,93.28571428571428,7,4087,17303.166666666668,1514.0,583.8571428571429
1311876.0,6,4,264,2,132,0.0,66.0,66.0,2,132,0.0,66.0,66.0
5625473.0,6,5,336,2,134,0.0,68.0,67.0,3,202,1423500.5,70.0,67.33333333333333
97945516.0,6,197,22158,99,6756,999444.0408163264,140.0,68.24242424242425,98,15402,999058.8659793816,284.0,157.16326530612244
98483294.0,6,30,2106,15,1089,7034521.0,123.0,72.6,15,1017,7019063.714285715,123.0,67.8
83466.0,6,14,4740,7,653,13488.166666666666,249.0,93.28571428571428,7,4087,13213.0,1514.0,583.8571428571429
112214865.0,6,32,2236,16,1165,7466590.133333334,139.0,72.8125,16,1071,7466590.8,123.0,66.9375
302013.0,6,6,412,4,272,100671.0,74.0,68.0,2,140,0.0,74.0,70.0
2783663.0,6,2,132,1,66,0.0,66.0,66.0,1,66,0.0,66.0,66.0
120054057.0,6,414,48504,207,34620,581788.2378640777,284.0,167.2463768115942,207,13884,581788.0388349515,140.0,67.07246376811594
506750.00000000006,6,5,336,2,134,0.0,68.0,67.0,3,202,195964.5,70.0,67.33333333333333
20111.0,6,10,2032,5,524,4685.75,252.0,104.8,5,1508,4765.25,1236.0,301.6
236311.0,6,3,337,2,214,0.0,160.0,107.0,1,123,0.0,123.0,123.0
316303.0,17,4,1400,4,1400,105434.33333333331,350.0,350.0,0,0,0.0,0.0,0.0
150933.0,17,4,1524,4,1524,50311.0,381.0,381.0,0,0,0.0,0.0,0.0
121510.0,6,3,337,2,214,0.0,160.0,107.0,1,123,0.0,123.0,123.0
120015469.0,17,29,13785,29,13785,4286266.75,501.0,475.3448275862069,0,0,0.0,0.0,0.0
0.0,17,1,381,1,381,0.0,381.0,381.0,0,0,0.0,0.0,0.0
115572664.0,6,204,23120,102,16154,1142153.7524752475,284.0,158.37254901960785,102,6966,1142153.3366336634,140.0,68.29411764705883
11431.0,17,4,823,2,163,0.0,89.0,81.5,2,660,0.0,443.0,330.0
237273.0,17,2,180,1,90,0.0,90.0,90.0,1,90,0.0,90.0,90.0
4185.0,17,2,582,1,83,0.0,83.0,83.0,1,499,0.0,499.0,499.0
90208572.0,6,17,1287,8,596,12852916.714285716,95.0,74.5,9,691,11250355.125,95.0,76.77777777777777
39856.0,6,10,2032,5,524,7051.0,252.0,104.8,5,1508,9682.5,1236.0,301.6
120318679.0,6,210,23774,105,7152,1149017.2596153845,140.0,68.11428571428571,105,16622,1148943.9903846155,284.0,158.3047619047619
10459352.0,6,7,478,4,272,3439342.0,74.0,68.0,3,206,5158882.0,74.0,68.66666666666667
97963524.0,17,12,778,6,389,19397171.6,174.0,64.83333333333333,6,389,19400213.8,174.0,64.83333333333333
117661185.0,17,14,864,7,432,19500161.33333333,174.0,61.71428571428572,7,432,19501205.666666668,174.0,61.71428571428572
232974.0,6,3,337,2,214,0.0,160.0,107.0,1,123,0.0,123.0,123.0
90513483.0,6,14,2240,8,1016,12930497.57142857,188.0,127.0,6,1224,18070305.6,204.0,204.0
90291134.0,6,16,1192,8,596,12891739.714285716,95.0,74.5,8,596,12897736.42857143,95.0,74.5
113255062.0,6,46,3036,23,1518,5135440.954545454,66.0,66.0,23,1518,5135436.909090909,66.0,66.0
106581.0,17,2,286,2,286,0.0,143.0,143.0,0,0,0.0,0.0,0.0
147032.0,6,3,337,2,214,0.0,160.0,107.0,1,123,0.0,123.0,123.0
120122810.0,6,14,2224,9,1204,15015351.25,188.0,133.77777777777777,5,1020,22520899.5,204.0,204.0
47647.0,6,14,4740,7,653,7797.5,249.0,93.28571428571428,7,4087,7656.166666666667,1514.0,583.8571428571429
130445.0,6,2,132,1,66,0.0,66.0,66.0,1,66,0.0,66.0,66.0
47386.0,6,10,2032,5,524,9492.25,252.0,104.8,5,1508,10034.5,1236.0,301.6
120042683.0,6,19,1436,9,691,15005335.375,95.0,76.77777777777777,10,745,13305096.0,95.0,74.5
297717.0,17,2,246,1,76,0.0,76.0,76.0,1,170,0.0,170.0,170.0
96728495.0,6,40,2640,20,1320,5090973.421052632,66.0,66.0,20,1320,5076627.947368421,66.0,66.0
414.0,17,2,762,2,762,0.0,381.0,381.0,0,0,0.0,0.0,0.0
19215.0,6,10,2032,5,524,4152.25,252.0,104.8,5,1508,4545.75,1236.0,301.6
3006080.0,6,12,2172,7,664,500919.3333333333,252.0,94.85714285714286,5,1508,1895.5,1236.0,301.6
291589.0,17,2,246,1,76,0.0,76.0,76.0,1,170,0.0,170.0,170.0
20379.0,6,14,4740,7,653,3202.0,249.0,93.28571428571428,7,4087,3207.333333333333,1514.0,583.8571428571429
239970.0,6,3,337,2,214,0.0,160.0,107.0,1,123,0.0,123.0,123.0
24489568.0,6,5,1736,2,819,0.0,753.0,409.5,3,917,12173081.5,785.0,305.6666666666667
205866.0,17,2,180,1,90,0.0,90.0,90.0,1,90,0.0,90.0,90.0
320428.0,17,4,1400,4,1400,106809.33333333331,350.0,350.0,0,0,0.0,0.0,0.0
90752850.0,6,19,1436,10,745,10078931.0,95.0,74.5,9,691,11343131.75,95.0,76.77777777777777
90019214.0,17,28,13364,28,13364,3334044.962962963,501.0,477.2857142857143,0,0,0.0,0.0,0.0
112839505.0,6,997,229836,485,32824,233125.98140495867,214.0,67.67835051546392,512,197012,220773.5968688845,1514.0,384.7890625
30228.0,6,14,4740,7,653,4893.333333333333,249.0,93.28571428571428,7,4087,4660.166666666667,1514.0,583.8571428571429
206563.0,6,3,426,2,280,0.0,214.0,140.0,1,146,0.0,146.0,146.0
2498.0,17,4,344,2,150,0.0,75.0,75.0,2,194,0.0,103.0,97.0
771.0,17,4,438,2,148,0.0,74.0,74.0,2,290,0.0,147.0,145.0
90262755.0,6,12,1832,8,1016,12894679.285714284,188.0,127.0,4,816,30030571.33333333,204.0,204.0
2594728.0,6,2,132,1,66,0.0,66.0,66.0,1,66,0.0,66.0,66.0
876412.0,6,10,1333,6,796,175282.4,458.0,132.66666666666666,4,537,201234.66666666663,331.0,134.25
196961.0,17,2,180,1,90,0.0,90.0,90.0,1,90,0.0,90.0,90.0
247837.0,6,3,337,2,214,0.0,160.0,107.0,1,123,0.0,123.0,123.0
9081.0,17,4,823,2,163,0.0,89.0,81.5,2,660,0.0,443.0,330.0
166974.0,17,4,1400,4,1400,55658.0,350.0,350.0,0,0,0.0,0.0,0.0
509215.0,6,5,336,2,134,0.0,68.0,67.0,3,202,193608.0,70.0,67.33333333333333
173471.0,17,2,180,1,90,0.0,90.0,90.0,1,90,0.0,90.0,90.0
3052637.0,6,3,204,1,68,0.0,68.0,68.0,2,136,0.0,70.0,68.0
36200.0,6,14,4740,7,653,5275.0,249.0,93.28571428571428,7,4087,5671.333333333333,1514.0,583.8571428571429
107547.0,17,2,286,2,286,0.0,143.0,143.0,0,0,0.0,0.0,0.0
16650.0,6,10,2032,5,524,3598.0,252.0,104.8,5,1508,3909.75,1236.0,301.6
36267.0,6,13,1394,7,797,5887.833333333333,253.0,113.85714285714286,6,597,6544.0,259.0,99.5
9246.0,17,2,539,1,86,0.0,86.0,86.0,1,453,0.0,453.0,453.0
206174.0,6,3,426,2,280,0.0,214.0,140.0,1,146,0.0,146.0,146.0
3306.0,17,4,344,2,150,0.0,75.0,75.0,2,194,0.0,103.0,97.0
240159.0,17,4,1524,4,1524,80053.0,381.0,381.0,0,0,0.0,0.0,0.0
240750.0,6,3,337,2,214,0.0,160.0,107.0,1,123,0.0,123.0,123.0
226150.0,6,3,426,2,280,0.0,214.0,140.0,1,146,0.0,146.0,146.0
104707891.0,6,207,23396,104,7086,1016581.4660194176,140.0,68.13461538461539,103,16310,1016423.568627451,284.0,158.3495145631068
32486.0,6,10,2032,5,524,7910.75,252.0,104.8,5,1508,7809.5,1236.0,301.6
135131680.0,17,6,1206,6,1206,27026336.0,201.0,201.0,0,0,0.0,0.0,0.0
90091060.0,6,12,1572,7,828,15015176.666666666,188.0,118.28571428571428,5,744,15015088.25,204.0,148.8
280424.0,17,2,363,1,79,0.0,79.0,79.0,1,284,0.0,284.0,284.0
246298.0,6,3,337,2,214,0.0,160.0,107.0,1,123,0.0,123.0,123.0
98350.0,17,2,762,2,762,0.0,381.0,381.0,0,0,0.0,0.0,0.0
142550.0,6,2,132,1,66,0.0,66.0,66.0,1,66,0.0,66.0,66.0
74090.0,17,2,634,1,82,0.0,82.0,82.0,1,552,0.0,552.0,552.0
340.0,17,2,250,1,93,0.0,93.0,93.0,1,157,0.0,157.0,157.0
90252600.0,6,12,1832,8,1016,12893228.57142857,188.0,127.0,4,816,30027987.33333333,204.0,204.0
120140364.0,6,232,26216,116,7952,1037636.9826086956,140.0,68.55172413793103,116,18264,1037576.2434782608,284.0,157.44827586206895
108112689.0,17,5,1005,5,1005,27028172.25,201.0,201.0,0,0,0.0,0.0,0.0
143974.0,17,2,180,1,90,0.0,90.0,90.0,1,90,0.0,90.0,90.0
196889.0,17,2,180,1,90,0.0,90.0,90.0,1,90,0.0,90.0,90.0
315212.0,17,4,1400,4,1400,105070.66666666669,350.0,350.0,0,0,0.0,0.0,0.0
90310036.0,6,18,1502,9,852,11282071.25,256.0,94.66666666666669,9,650,11287312.5,95.0,72.22222222222223
108101804.0,17,5,955,5,955,27025451.0,191.0,191.0,0,0,0.0,0.0,0.0
94092347.0,17,12,778,6,389,18801173.8,174.0,64.83333333333333,6,389,18800162.8,174.0,64.83333333333333
103260.0,17,2,286,2,286,0.0,143.0,143.0,0,0,0.0,0.0,0.0
90529567.0,6,14,2240,8,1016,12932795.285714284,188.0,127.0,6,1224,18072195.2,204.0,204.0
103200202.0,6,42,2772,21,1386,5159996.65,66.0,66.0,21,1386,5159997.95,66.0,66.0
146218.0,6,3,337,2,214,0.0,160.0,107.0,1,123,0.0,123.0,123.0
25032.0,6,10,2032,5,524,5548.25,252.0,104.8,5,1508,5636.75,1236.0,301.6
37140.0,6,14,4740,7,653,5993.166666666667,249.0,93.28571428571428,7,4087,5768.0,1514.0,583.8571428571429
304501.0,6,6,412,4,272,101500.33333333331,74.0,68.0,2,140,0.0,74.0,70.0
236886.0,6,3,337,2,214,0.0,160.0,107.0,1,123,0.0,123.0,123.0
146276.0,6,3,337,2,214,0.0,160.0,107.0,1,123,0.0,123.0,123.0
110325567.0,6,31,2160,16,1071,7355037.8,123.0,66.9375,15,1089,7315716.214285715,123.0,72.6
116144846.0,6,48,3168,24,1584,5049775.913043479,66.0,66.0,24,1584,5036105.565217392,66.0,66.0
2805127.0,6,2,132,1,66,0.0,66.0,66.0,1,66,0.0,66.0,66.0
191085.0,17,2,180,1,90,0.0,90.0,90.0,1,90,0.0,90.0,90.0
34947.0,6,14,4740,7,653,5691.666666666667,249.0,93.28571428571428,7,4087,5226.166666666667,1514.0,583.8571428571429
37364.0,6,10,2032,5,524,9110.5,252.0,104.8,5,1508,8733.5,1236.0,301.6
13297.0,6,10,1067,5,536,3082.25,264.0,107.2,5,531,2541.5,259.0,106.2
206005.0,17,2,180,1,90,0.0,90.0,90.0,1,90,0.0,90.0,90.0
143945.0,17,2,180,1,90,0.0,90.0,90.0,1,90,0.0,90.0,90.0
146144.0,6,3,337,2,214,0.0,160.0,107.0,1,123,0.0,123.0,123.0
110103681.0,6,199,22598,100,15842,1112158.393939394,284.0,158.42,99,6756,1112937.551020408,140.0,68.24242424242425
284528.0,17,2,363,1,79,0.0,79.0,79.0,1,284,0.0,284.0,284.0
207045.0,6,10,1066,5,490,50694.0,218.0,98.0,5,576,51480.25,304.0,115.2
2422.0,17,4,344,2,150,0.0,75.0,75.0,2,194,0.0,103.0,97.0
283814.0,17,2,414,1,88,0.0,88.0,88.0,1,326,0.0,326.0,326.0
108106557.0,17,5,955,5,955,27026639.25,191.0,191.0,0,0,0.0,0.0,0.0
107008.0,17,2,286,2,286,0.0,143.0,143.0,0,0,0.0,0.0,0.0
371.0,17,2,267,1,83,0.0,83.0,83.0,1,184,0.0,184.0,184.0
0.0,6,1,66,1,66,0.0,66.0,66.0,0,0,0.0,0.0,0.0
2029.0,17,4,344,2,150,0.0,75.0,75.0,2,194,0.0,103.0,97.0
333777.0,6,12,1373,7,714,55629.5,298.0,102.0,5,659,77090.5,379.0,131.8
2073.0,17,4,344,2,150,0.0,75.0,75.0,2,194,0.0,103.0,97.0
33048.0,6,14,4740,7,653,4621.166666666667,249.0,93.28571428571428,7,4087,4954.166666666667,1514.0,583.8571428571429
204384.0,17,2,762,2,762,0.0,381.0,381.0,0,0,0.0,0.0,0.0
90025985.0,17,28,13364,28,13364,3334295.7407407407,501.0,477.2857142857143,0,0,0.0,0.0,0.0
219313.0,17,2,414,1,88,0.0,88.0,88.0,1,326,0.0,326.0,326.0
301484.0,6,6,412,4,272,100494.66666666669,74.0,68.0,2,140,0.0,74.0,70.0
151806.0,17,2,414,1,88,0.0,88.0,88.0,1,326,0.0,326.0,326.0
232473.0,6,3,337,2,214,0.0,160.0,107.0,1,123,0.0,123.0,123.0
10466615.0,6,7,478,4,272,3441988.6666666665,74.0,68.0,3,206,5162912.5,74.0,68.66666666666667
2455.0,17,4,344,2,150,0.0,75.0,75.0,2,194,0.0,103.0,97.0
126323490.0,6,60,5314,25,2316,4847376.291666667,123.0,92.64,35,2998,3471597.5588235296,139.0,85.65714285714286
320233.0,17,4,1400,4,1400,106744.33333333331,350.0,350.0,0,0,0.0,0.0,0.0
66985.0,6,14,4740,7,653,10979.166666666666,249.0,93.28571428571428,7,4087,10978.833333333334,1514.0,583.8571428571429
44774.0,6,14,4740,7,653,7157.666666666667,249.0,93.28571428571428,7,4087,6665.0,1514.0,583.8571428571429
108723192.0,6,34,2482,17,1288,6795199.5,139.0,75.76470588235294,17,1194,6782397.5625,123.0,70.23529411764706
31929.0,6,14,4740,7,653,5149.0,249.0,93.28571428571428,7,4087,5131.5,1514.0,583.8571428571429
2265.0,17,4,344,2,150,0.0,75.0,75.0,2,194,0.0,103.0,97.0
2365.0,17,4,344,2,150,0.0,75.0,75.0,2,194,0.0,103.0,97.0
216653.0,6,3,426,2,280,0.0,214.0,140.0,1,146,0.0,146.0,146.0
41407.0,6,14,4740,7,653,6776.333333333333,249.0,93.28571428571428,7,4087,6646.5,1514.0,583.8571428571429
120235323.0,6,21,1585,10,786,13332469.111111112,95.0,78.6,11,799,12000004.6,95.0,72.63636363636364
50564.0,6,14,4740,7,653,7271.666666666667,249.0,93.28571428571428,7,4087,8289.666666666666,1514.0,583.8571428571429
135135753.0,17,6,1146,6,1146,27027150.6,191.0,191.0,0,0,0.0,0.0,0.0
648084.0,6,4,508,2,238,0.0,172.0,119.0,2,270,0.0,135.0,135.0
35673.0,6,14,4740,7,653,5624.666666666667,249.0,93.28571428571428,7,4087,5599.333333333333,1514.0,583.8571428571429
135130564.0,17,6,1206,6,1206,27026112.8,201.0,201.0,0,0,0.0,0.0,0.0
97004406.0,17,11,735,6,389,19400881.2,174.0,64.83333333333333,5,346,19250163.0,174.0,69.2
464608.0,6,10,1221,6,636,92921.6,298.0,106.0,4,585,149053.0,379.0,146.25
108113256.0,17,5,1005,5,1005,27028314.0,201.0,201.0,0,0,0.0,0.0,0.0
105051263.0,17,14,1126,7,563,17508543.833333332,174.0,80.42857142857143,7,563,17411046.666666668,174.0,80.42857142857143
96001025.0,17,11,735,6,389,19200205.0,174.0,64.83333333333333,5,346,19001551.0,174.0,69.2
437017.0,6,11,1021,6,444,58674.2,162.0,74.0,5,577,73184.0,349.0,115.4
29900.0,6,10,2032,5,524,7027.25,252.0,104.8,5,1508,7225.0,1236.0,301.6
34091.0,6,14,4740,7,653,5380.0,249.0,93.28571428571428,7,4087,5420.833333333333,1514.0,583.8571428571429
207949.0,6,10,1221,6,636,41589.8,298.0,106.0,4,585,68259.66666666667,379.0,146.25
296189.0,17,2,246,1,76,0.0,76.0,76.0,1,170,0.0,170.0,170.0
5098.0,17,2,180,1,90,0.0,90.0,90.0,1,90,0.0,90.0,90.0
99574.0,17,2,762,2,762,0.0,381.0,381.0,0,0,0.0,0.0,0.0
328815.0,17,2,238,1,74,0.0,74.0,74.0,1,164,0.0,164.0,164.0
30056.0,6,10,2032,5,524,7302.25,252.0,104.8,5,1508,7166.75,1236.0,301.6
318473.0,17,4,1400,4,1400,106157.66666666669,350.0,350.0,0,0,0.0,0.0,0.0
2064350.0,6,19,6869,11,1567,206435.0,408.0,142.45454545454547,8,5302,231806.57142857145,1514.0,662.75
5607409.0,6,4,270,2,134,0.0,68.0,67.0,2,136,0.0,70.0,68.0
90735802.0,6,17,1287,9,691,11336715.0,95.0,76.77777777777777,8,596,12960893.0,95.0,74.5
10274.0,6,10,1067,5,536,2173.25,264.0,107.2,5,531,2244.0,259.0,106.2
10465365.0,6,7,478,4,272,3442826.0,74.0,68.0,3,206,5164124.5,74.0,68.66666666666667
135134993.0,17,6,1146,6,1146,27026998.6,191.0,191.0,0,0,0.0,0.0,0.0
102502.0,17,2,286,2,286,0.0,143.0,143.0,0,0,0.0,0.0,0.0
108587.0,17,2,286,2,286,0.0,143.0,143.0,0,0,0.0,0.0,0.0
143301.0,6,2,132,1,66,0.0,66.0,66.0,1,66,0.0,66.0,66.0
5827806.0,6,5,336,2,134,0.0,68.0,67.0,3,202,1524781.0,70.0,67.33333333333333
259578.0,17,4,1524,4,1524,86526.0,381.0,381.0,0,0,0.0,0.0,0.0
12997.0,6,11,1133,6,602,2220.6,264.0,100.33333333333331,5,531,3059.75,259.0,106.2
66781.0,6,14,4740,7,653,10419.666666666666,249.0,93.28571428571428,7,4087,10908.0,1514.0,583.8571428571429
2385.0,17,4,344,2,150,0.0,75.0,75.0,2,194,0.0,103.0,97.0
90785206.0,6,22,1680,12,894,8249173.818181818,95.0,74.5,10,786,10085809.555555556,95.0,78.6
1456.0,17,4,438,2,148,0.0,74.0,74.0,2,290,0.0,147.0,145.0
146308.0,6,3,337,2,214,0.0,160.0,107.0,1,123,0.0,123.0,123.0
216400.0,17,2,180,1,90,0.0,90.0,90.0,1,90,0.0,90.0,90.0
120120810.0,6,15,2290,9,1204,15015101.25,188.0,133.77777777777777,6,1086,18018634.6,204.0,181.0
299290.0,17,2,224,1,76,0.0,76.0,76.0,1,148,0.0,148.0,148.0
2089.0,17,4,344,2,150,0.0,75.0,75.0,2,194,0.0,103.0,97.0
284772.0,17,2,363,1,79,0.0,79.0,79.0,1,284,0.0,284.0,284.0
108656351.0,6,32,2236,16,1165,7229358.6,139.0,72.8125,16,1071,7229357.533333333,123.0,66.9375
25265.0,6,10,2032,5,524,6095.75,252.0,104.8,5,1508,5915.25,1236.0,301.6
304177.0,17,4,704,2,148,0.0,74.0,74.0,2,556,0.0,280.0,278.0
1790728.0,6,4,276,2,128,0.0,74.0,64.0,2,148,0.0,74.0,74.0
36138.0,17,4,823,2,163,0.0,89.0,81.5,2,660,0.0,443.0,330.0
108104324.0,17,5,1005,5,1005,27026081.0,201.0,201.0,0,0,0.0,0.0,0.0
0.0,17,1,90,1,90,0.0,90.0,90.0,0,0,0.0,0.0,0.0
299445.0,17,2,620,1,75,0.0,75.0,75.0,1,545,0.0,545.0,545.0
32185.0,6,14,4740,7,653,4498.5,249.0,93.28571428571428,7,4087,4802.666666666667,1514.0,583.8571428571429
103375098.0,6,527,103942,269,86470,384920.75746268657,1514.0,321.4498141263941,258,17472,401396.0,214.0,67.72093023255815
780.0,17,4,438,2,148,0.0,74.0,74.0,2,290,0.0,147.0,145.0
103200419.0,6,42,2772,21,1386,5160008.6,66.0,66.0,21,1386,5160006.65,66.0,66.0
43242.0,6,13,1386,7,789,6708.833333333333,253.0,112.71428571428572,6,597,8078.4,259.0,99.5
318448.0,6,6,412,4,272,106149.33333333331,74.0,68.0,2,140,0.0,74.0,70.0
135135618.0,17,6,1146,6,1146,27027123.6,191.0,191.0,0,0,0.0,0.0,0.0
16872.0,6,14,4740,7,653,2706.5,249.0,93.28571428571428,7,4087,2317.1666666666665,1514.0,583.8571428571429
1043213.0,6,11,1134,6,558,208642.60000000003,220.0,93.0,5,576,259229.0,304.0,115.2
135142953.0,17,6,1206,6,1206,27028590.6,201.0,201.0,0,0,0.0,0.0,0.0
2792867.0,6,2,132,1,66,0.0,66.0,66.0,1,66,0.0,66.0,66.0
120062852.0,17,29,13785,29,13785,4287959.0,501.0,475.3448275862069,0,0,0.0,0.0,0.0
113587989.0,6,31,2166,16,1149,7558144.266666667,123.0,71.8125,15,1017,8098011.285714285,123.0,67.8
10244.0,6,11,2098,6,590,1737.8,252.0,98.33333333333331,5,1508,2312.5,1236.0,301.6
136280.0,6,2,132,1,66,0.0,66.0,66.0,1,66,0.0,66.0,66.0
27834.0,6,14,4740,7,653,4516.5,249.0,93.28571428571428,7,4087,3985.1666666666665,1514.0,583.8571428571429
108106207.0,17,5,1005,5,1005,27026551.75,201.0,201.0,0,0,0.0,0.0,0.0
203616.0,17,2,762,2,762,0.0,381.0,381.0,0,0,0.0,0.0,0.0
108117318.0,17,5,1005,5,1005,27029329.5,201.0,201.0,0,0,0.0,0.0,0.0
10526514.0,6,7,478,4,272,3461670.0,74.0,68.0,3,206,5192398.5,74.0,68.66666666666667
322465.0,17,4,1400,4,1400,107488.33333333331,350.0,350.0,0,0,0.0,0.0,0.0
210315.0,6,10,1221,6,636,42063.0,298.0,106.0,4,585,68372.33333333333,379.0,146.25
90248381.0,6,14,2240,8,1016,12892625.857142856,188.0,127.0,6,1224,18017188.8,204.0,204.0
1302505.0,6,4,264,2,132,0.0,66.0,66.0,2,132,0.0,66.0,66.0
100414305.0,6,28,1860,14,966,7707589.153846154,123.0,69.0,14,894,7707583.769230769,123.0,63.85714285714285
90092859.0,6,13,2032,8,1138,12870408.42857143,188.0,142.25,5,894,15118383.25,204.0,178.8
214462.0,6,3,426,2,280,0.0,214.0,140.0,1,146,0.0,146.0,146.0
30137.0,6,14,4740,7,653,4915.666666666667,249.0,93.28571428571428,7,4087,4200.333333333333,1514.0,583.8571428571429
113733712.0,6,46,3036,23,1518,5155440.2727272725,66.0,66.0,23,1518,5155437.818181818,66.0,66.0
8315806.0,17,3,1034,2,684,0.0,342.0,342.0,1,350,0.0,350.0,350.0
206628.0,17,2,180,1,90,0.0,90.0,90.0,1,90,0.0,90.0,90.0
90096874.0,6,11,1644,4,816,30031492.33333333,204.0,204.0,7,828,15015757.0,188.0,118.28571428571428
135132015.0,17,6,1146,6,1146,27026403.0,191.0,191.0,0,0,0.0,0.0,0.0
108106138.0,17,5,1005,5,1005,27026534.5,201.0,201.0,0,0,0.0,0.0,0.0
368814.0,17,2,180,1,90,0.0,90.0,90.0,1,90,0.0,90.0,90.0
2393320.0,6,2,132,1,66,0.0,66.0,66.0,1,66,0.0,66.0,66.0
108102295.0,17,5,955,5,955,27025573.75,191.0,191.0,0,0,0.0,0.0,0.0
117622069.0,6,214,24324,107,17040,1107612.6698113207,374.0,159.25233644859813,107,7284,1107610.6037735848,140.0,68.07476635514018
105742430.0,6,44,2904,22,1452,5035353.80952381,66.0,66.0,22,1452,5020661.238095238,66.0,66.0
1964.0,17,4,344,2,150,0.0,75.0,75.0,2,194,0.0,103.0,97.0
324758.0,6,10,1221,6,636,64951.6,298.0,106.0,4,585,102846.0,379.0,146.25
53015696.0,6,15,1036,8,545,7573670.857142857,95.0,68.125,7,491,8798780.5,95.0,70.14285714285714
2364.0,17,4,344,2,150,0.0,75.0,75.0,2,194,0.0,103.0,97.0
160184.0,17,2,180,1,90,0.0,90.0,90.0,1,90,0.0,90.0,90.0
45662.0,6,14,4740,7,653,7246.166666666667,249.0,93.28571428571428,7,4087,6704.0,1514.0,583.8571428571429
90264726.0,6,12,1832,8,1016,12894960.857142856,188.0,127.0,4,816,30033192.666666668,204.0,204.0
108728.0,17,2,286,2,286,0.0,143.0,143.0,0,0,0.0,0.0,0.0
1066378.0,6,3,204,2,136,0.0,70.0,68.0,1,68,0.0,68.0,68.0
100300332.0,6,172,19556,86,13658,1177471.0705882353,284.0,158.8139534883721,86,5898,1177468.5529411766,140.0,68.5813953488372
38583.0,6,14,4740,7,653,6267.666666666667,249.0,93.28571428571428,7,4087,6066.666666666667,1514.0,583.8571428571429
252571.0,6,3,337,2,214,0.0,160.0,107.0,1,123,0.0,123.0,123.0
310626.0,17,4,1400,4,1400,103542.0,350.0,350.0,0,0,0.0,0.0,0.0
162354.0,17,2,180,1,90,0.0,90.0,90.0,1,90,0.0,90.0,90.0
17021.0,17,2,180,1,90,0.0,90.0,90.0,1,90,0.0,90.0,90.0
85318.0,6,10,2032,5,524,19428.25,252.0,104.8,5,1508,19847.5,1236.0,301.6
1763.0,17,4,344,2,150,0.0,75.0,75.0,2,194,0.0,103.0,97.0
149949943.0,17,35,16705,35,16705,4410292.44117647,501.0,477.2857142857143,0,0,0.0,0.0,0.0
90298269.0,6,16,1192,8,596,12892432.42857143,95.0,74.5,8,596,12899390.142857144,95.0,74.5
870017.0,6,9,1268,6,797,174003.4,459.0,132.83333333333334,3,471,297261.0,331.0,157.0
153390.0,17,2,180,1,90,0.0,90.0,90.0,1,90,0.0,90.0,90.0
0.0,6,1,172,1,172,0.0,172.0,172.0,0,0,0.0,0.0,0.0
26293.0,6,14,4740,7,653,3980.6666666666665,249.0,93.28571428571428,7,4087,4245.833333333333,1514.0,583.8571428571429
209534.0,6,10,1221,6,636,41906.8,298.0,106.0,4,585,69028.33333333333,379.0,146.25
216527.0,17,2,180,1,90,0.0,90.0,90.0,1,90,0.0,90.0,90.0
241973.0,6,3,337,2,214,0.0,160.0,107.0,1,123,0.0,123.0,123.0
103384.0,17,2,286,2,286,0.0,143.0,143.0,0,0,0.0,0.0,0.0
3283750.0,6,149,125301,88,116973,37744.252873563215,1510.0,1329.2386363636365,61,8328,49455.066666666666,1510.0,136.52459016393442
1932900.0,6,18,6803,10,1501,214766.66666666663,408.0,150.1,8,5302,214565.0,1514.0,662.75
3557052.0,6,5,350,2,128,0.0,74.0,64.0,3,222,1623150.0,74.0,74.0
27853.0,6,14,4740,7,653,4273.0,249.0,93.28571428571428,7,4087,4304.166666666667,1514.0,583.8571428571429
122975262.0,6,48,3168,24,1584,5194509.0869565215,66.0,66.0,24,1584,5072579.478260869,66.0,66.0
19186.0,6,14,4740,7,653,2902.1666666666665,249.0,93.28571428571428,7,4087,2878.1666666666665,1514.0,583.8571428571429
108107700.0,17,5,955,5,955,27026925.0,191.0,191.0,0,0,0.0,0.0,0.0
2801421.0,6,2,132,1,66,0.0,66.0,66.0,1,66,0.0,66.0,66.0
104637.0,17,2,286,2,286,0.0,143.0,143.0,0,0,0.0,0.0,0.0
31690.000000000004,6,10,2032,5,524,7697.25,252.0,104.8,5,1508,6945.25,1236.0,301.6
851135.0,6,9,1096,6,625,170227.0,287.0,104.16666666666669,3,471,288917.0,331.0,157.0
753.0,17,4,438,2,148,0.0,74.0,74.0,2,290,0.0,147.0,145.0
22165.0,6,10,2032,5,524,5213.25,252.0,104.8,5,1508,5281.5,1236.0,301.6
206168.0,6,3,426,2,280,0.0,214.0,140.0,1,146,0.0,146.0,146.0
35969.0,6,14,4740,7,653,5578.333333333333,249.0,93.28571428571428,7,4087,5470.833333333333,1514.0,583.8571428571429
196989.0,17,2,180,1,90,0.0,90.0,90.0,1,90,0.0,90.0,90.0
120641129.0,6,328,38078,164,11120,735891.6319018404,140.0,67.8048780487805,164,26958,739990.3312883435,374.0,164.3780487804878
153441.0,17,2,180,1,90,0.0,90.0,90.0,1,90,0.0,90.0,90.0
90008064.0,17,27,12943,27,12943,3461848.6153846155,501.0,479.3703703703704,0,0,0.0,0.0,0.0
10185.0,6,11,2098,6,590,1894.6,252.0,98.33333333333331,5,1508,1929.75,1236.0,301.6
832061.0,6,9,1118,6,586,166412.2,248.0,97.66666666666669,3,532,279781.0,392.0,177.33333333333334
121390.0,6,3,337,2,214,0.0,160.0,107.0,1,123,0.0,123.0,123.0
217872.0,6,3,426,2,280,0.0,214.0,140.0,1,146,0.0,146.0,146.0
122001200.0,17,15,907,8,475,17428742.85714286,174.0,59.375,7,432,17000710.0,174.0,61.71428571428572
51457.0,6,14,4740,7,653,7779.666666666667,249.0,93.28571428571428,7,4087,7945.0,1514.0,583.8571428571429
3217434.0,6,24,6503,14,2100,247494.92307692303,544.0,150.0,10,4403,330838.7777777777,1514.0,440.3
42482.0,6,14,4740,7,653,6961.333333333333,249.0,93.28571428571428,7,4087,6645.0,1514.0,583.8571428571429
121484.0,6,3,337,2,214,0.0,160.0,107.0,1,123,0.0,123.0,123.0
186055.0,17,2,180,1,90,0.0,90.0,90.0,1,90,0.0,90.0,90.0
108103326.0,17,5,1005,5,1005,27025831.5,201.0,201.0,0,0,0.0,0.0,0.0
307983.0,6,6,412,4,272,102661.0,74.0,68.0,2,140,0.0,74.0,70.0
112416323.0,6,37,2788,19,1471,6245351.277777778,139.0,77.42105263157895,18,1317,6599641.352941177,123.0,73.16666666666667
18874.0,6,14,4740,7,653,2932.1666666666665,249.0,93.28571428571428,7,4087,2507.333333333333,1514.0,583.8571428571429
108105541.0,17,5,1005,5,1005,27026385.25,201.0,201.0,0,0,0.0,0.0,0.0
103187019.0,17,16,1666,8,761,14572260.285714284,250.0,95.125,8,905,14714439.714285716,394.0,113.125
90025364.0,17,28,13364,28,13364,3334272.7407407407,501.0,477.2857142857143,0,0,0.0,0.0,0.0
283877.0,17,2,363,1,79,0.0,79.0,79.0,1,284,0.0,284.0,284.0
2054465.0,17,8,1640,4,312,684697.0000000001,78.0,78.0,4,1328,684666.3333333334,332.0,332.0
2320.0,17,4,344,2,150,0.0,75.0,75.0,2,194,0.0,103.0,97.0
338786.0,17,2,876,2,876,0.0,438.0,438.0,0,0,0.0,0.0,0.0
18425.0,6,10,2032,5,524,3981.5,252.0,104.8,5,1508,3541.0,1236.0,301.6
272223.0,6,3,337,2,214,0.0,160.0,107.0,1,123,0.0,123.0,123.0
115020885.0,6,48,3168,24,1584,5000908.043478261,66.0,66.0,24,1584,4987447.913043479,66.0,66.0
3332.0,17,2,398,1,88,0.0,88.0,88.0,1,310,0.0,310.0,310.0
58378.0,6,10,2032,5,524,14358.75,252.0,104.8,5,1508,11087.5,1236.0,301.6
249108.0,6,3,373,2,238,0.0,172.0,119.0,1,135,0.0,135.0,135.0
117484192.0,6,467,56560,234,15740,504224.0,140.0,67.26495726495726,233,40820,505391.7974137931,374.0,175.1931330472103
27273424.0,17,5,1710,5,1710,6818356.0,342.0,342.0,0,0,0.0,0.0,0.0
92019419.0,6,30,2106,15,1089,6557399.285714285,123.0,72.6,15,1017,6557350.214285715,123.0,67.8
90261192.0,6,12,1832,8,1016,12894456.0,188.0,127.0,4,816,30031789.666666668,204.0,204.0
21840.0,17,2,180,1,90,0.0,90.0,90.0,1,90,0.0,90.0,90.0
108102386.0,17,5,955,5,955,27025596.5,191.0,191.0,0,0,0.0,0.0,0.0
14197.0,6,10,1975,5,467,2829.75,195.0,93.4,5,1508,3264.75,1236.0,301.6
110006310.0,17,13,821,7,432,18334385.0,174.0,61.71428571428572,6,389,18000174.8,174.0,64.83333333333333
320014.0,17,4,1400,4,1400,106671.33333333331,350.0,350.0,0,0,0.0,0.0,0.0
206072.0,6,3,426,2,280,0.0,214.0,140.0,1,146,0.0,146.0,146.0
108108016.0,17,5,1005,5,1005,27027004.0,201.0,201.0,0,0,0.0,0.0,0.0
22702.0,6,14,4740,7,653,3425.6666666666665,249.0,93.28571428571428,7,4087,3277.1666666666665,1514.0,583.8571428571429
14163513.0,17,6,2052,6,2052,2832702.6,342.0,342.0,0,0,0.0,0.0,0.0
349.0,17,2,160,1,80,0.0,80.0,80.0,1,80,0.0,80.0,80.0
90260649.0,6,12,1832,8,1016,12894378.42857143,188.0,127.0,4,816,30031171.666666668,204.0,204.0
104564.0,17,2,700,2,700,0.0,350.0,350.0,0,0,0.0,0.0,0.0
107019.0,17,2,286,2,286,0.0,143.0,143.0,0,0,0.0,0.0,0.0
284604.0,17,2,363,1,79,0.0,79.0,79.0,1,284,0.0,284.0,284.0
124973944.0,6,37,2656,19,1408,6942996.888888889,139.0,74.10526315789474,18,1248,6751304.117647059,123.0,69.33333333333333
112496368.0,6,47,3102,24,1584,4891133.130434782,66.0,66.0,23,1518,5112001.090909091,66.0,66.0
90258397.0,6,12,1832,8,1016,12894056.714285716,188.0,127.0,4,816,30031582.33333333,204.0,204.0
2993327.0,6,11,2106,6,598,598496.6,252.0,99.66666666666669,5,1508,5351.75,1236.0,301.6
32446.000000000004,6,14,4740,7,653,4741.333333333333,249.0,93.28571428571428,7,4087,5090.166666666667,1514.0,583.8571428571429
2297060.0,6,3,1604,2,851,0.0,785.0,425.5,1,753,0.0,753.0,753.0
153484.0,17,2,180,1,90,0.0,90.0,90.0,1,90,0.0,90.0,90.0
1306987.0,6,4,264,2,132,0.0,66.0,66.0,2,132,0.0,66.0,66.0
24660.0,6,14,4740,7,653,3950.5,249.0,93.28571428571428,7,4087,3507.5,1514.0,583.8571428571429
207067.0,17,4,6056,4,6056,69022.33333333333,1514.0,1514.0,0,0,0.0,0.0,0.0
97706643.0,6,50,4204,28,2326,3618764.555555556,139.0,83.07142857142857,22,1878,4642385.571428572,123.0,85.36363636363636
206935.0,6,10,1221,6,636,41387.0,298.0,106.0,4,585,68049.66666666667,379.0,146.25
812.0,17,4,438,2,148,0.0,74.0,74.0,2,290,0.0,147.0,145.0
103981.0,17,2,286,2,286,0.0,143.0,143.0,0,0,0.0,0.0,0.0
1675720.0,17,18,1260,18,1260,98571.76470588236,70.0,70.0,0,0,0.0,0.0,0.0
4274390.0,6,11,1134,6,558,854878.0,220.0,93.0,5,576,1065624.25,304.0,115.2
125065907.0,6,36,2596,18,1248,6769441.94117647,123.0,69.33333333333333,18,1348,6769444.529411765,139.0,74.88888888888889
7102.0,17,2,582,1,83,0.0,83.0,83.0,1,499,0.0,499.0,499.0
24397.0,6,14,4740,7,653,3018.5,249.0,93.28571428571428,7,4087,3838.3333333333335,1514.0,583.8571428571429
0.0,6,1,172,1,172,0.0,172.0,172.0,0,0,0.0,0.0,0.0
113309663.0,6,45,2970,23,1518,5150439.227272728,66.0,66.0,22,1452,4958047.19047619,66.0,66.0
90691503.0,6,22,2566,11,1261,9069150.3,426.0,114.63636363636364,11,1305,9047702.9,360.0,118.63636363636364
49720.0,6,10,2032,5,524,11282.25,252.0,104.8,5,1508,12113.25,1236.0,301.6
144714.0,17,2,180,1,70,0.0,70.0,70.0,1,110,0.0,110.0,110.0
4461.0,17,2,602,1,72,0.0,72.0,72.0,1,530,0.0,530.0,530.0
108104772.0,17,5,1005,5,1005,27026193.0,201.0,201.0,0,0,0.0,0.0,0.0
22116.0,6,2,145,2,145,0.0,91.0,72.5,0,0,0.0,0.0,0.0
42970.0,6,14,4740,7,653,7041.666666666667,249.0,93.28571428571428,7,4087,6946.5,1514.0,583.8571428571429
314722.0,17,2,333,1,87,0.0,87.0,87.0,1,246,0.0,246.0,246.0
47958.0,6,14,4740,7,653,7866.5,249.0,93.28571428571428,7,4087,7597.0,1514.0,583.8571428571429
98527647.0,6,40,2640,20,1320,5185665.631578947,66.0,66.0,20,1320,5169802.47368421,66.0,66.0
1340241.0,6,4,276,2,128,0.0,74.0,64.0,2,148,0.0,74.0,74.0
108106014.0,17,5,955,5,955,27026503.5,191.0,191.0,0,0,0.0,0.0,0.0
246407.0,17,4,1524,4,1524,82135.66666666667,381.0,381.0,0,0,0.0,0.0,0.0
299380.0,6,6,412,4,272,99793.33333333331,74.0,68.0,2,140,0.0,74.0,70.0
97438.0,6,14,4740,7,653,16027.5,249.0,93.28571428571428,7,4087,14353.5,1514.0,583.8571428571429
90293887.0,6,22,1680,12,894,8204240.818181818,95.0,74.5,10,786,10031456.555555556,95.0,78.6
135135877.0,17,6,1206,6,1206,27027175.4,201.0,201.0,0,0,0.0,0.0,0.0
5550.0,17,2,180,1,90,0.0,90.0,90.0,1,90,0.0,90.0,90.0
2013.0,17,4,344,2,150,0.0,75.0,75.0,2,194,0.0,103.0,97.0
90776167.0,6,20,1531,11,840,9072672.2,95.0,76.36363636363636,9,691,11225843.5,95.0,76.77777777777777
363426.0,6,11,1021,6,444,48884.6,162.0,74.0,5,577,60930.0,349.0,115.4
120056169.0,17,28,13364,28,13364,4446524.777777778,501.0,477.2857142857143,0,0,0.0,0.0,0.0
1231862.0,17,7,490,7,490,205310.3333333333,70.0,70.0,0,0,0.0,0.0,0.0
939436.0,6,12,1447,6,816,186781.4,291.0,136.0,6,631,186657.0,293.0,105.16666666666669
404.0,17,2,762,2,762,0.0,381.0,381.0,0,0,0.0,0.0,0.0
13361.0,6,11,2098,6,590,2672.2,252.0,98.33333333333331,5,1508,2828.25,1236.0,301.6
102008831.0,17,14,1126,7,563,17001126.0,174.0,80.42857142857143,7,563,17000153.833333332,174.0,80.42857142857143
117952509.0,6,34,2334,17,1209,7358544.8125,123.0,71.11764705882354,17,1125,7358547.6875,123.0,66.17647058823529
311602.0,17,4,622,4,622,103867.33333333331,163.0,155.5,0,0,0.0,0.0,0.0
101731032.0,6,28,1860,14,966,7808860.769230769,123.0,69.0,14,894,7808865.461538462,123.0,63.85714285714285
90019923.0,17,28,13364,28,13364,3334071.222222222,501.0,477.2857142857143,0,0,0.0,0.0,0.0
281593.0,17,2,363,1,79,0.0,79.0,79.0,1,284,0.0,284.0,284.0
106425187.0,6,34,2482,17,1288,6651574.1875,139.0,75.76470588235294,17,1194,6638062.125,123.0,70.23529411764706
518.0,17,2,508,2,508,0.0,257.0,254.0,0,0,0.0,0.0,0.0
1051956.0,6,13,1386,7,789,175326.0,253.0,112.71428571428572,6,597,207910.0,259.0,99.5
421989.0,6,3,204,2,136,0.0,70.0,68.0,1,68,0.0,68.0,68.0
1191478.0,6,13,3020,8,2392,170211.14285714287,1514.0,299.0,5,628,228955.25,331.0,125.6
10536817.0,6,7,478,4,272,3465207.0,74.0,68.0,3,206,5197718.0,74.0,68.66666666666667
106445.0,17,2,286,2,286,0.0,143.0,143.0,0,0,0.0,0.0,0.0
3785212.0,6,5,336,2,134,0.0,68.0,67.0,3,202,1526111.0,70.0,67.33333333333333
10509430.0,6,7,478,4,272,3457717.0,74.0,68.0,3,206,5186470.5,74.0,68.66666666666667
318.0,17,2,174,1,79,0.0,79.0,79.0,1,95,0.0,95.0,95.0
149461711.0,17,36,17126,36,17126,4270334.6,501.0,475.72222222222223,0,0,0.0,0.0,0.0
312816.0,17,4,1400,4,1400,104272.0,350.0,350.0,0,0,0.0,0.0,0.0
34388.0,6,14,4740,7,653,4492.333333333333,249.0,93.28571428571428,7,4087,5593.666666666667,1514.0,583.8571428571429
300621.0,17,2,180,1,90,0.0,90.0,90.0,1,90,0.0,90.0,90.0
108107038.0,17,5,955,5,955,27026759.5,191.0,191.0,0,0,0.0,0.0,0.0
96949206.0,17,12,778,6,389,19201272.6,174.0,64.83333333333333,6,389,19200148.0,174.0,64.83333333333333
5015435.0,17,4,376,2,152,0.0,76.0,76.0,2,224,0.0,148.0,112.0
206231.0,6,3,426,2,280,0.0,214.0,140.0,1,146,0.0,146.0,146.0
287125.0,17,2,363,1,79,0.0,79.0,79.0,1,284,0.0,284.0,284.0
2730491.0,6,25,7573,14,3735,210037.7692307692,1514.0,266.7857142857143,11,3838,245608.1,1514.0,348.90909090909093
3125503.0,6,133,97751,71,89017,44650.04285714286,1510.0,1253.7605633802816,62,8734,46195.13114754098,1510.0,140.8709677419355
2309.0,17,4,344,2,150,0.0,75.0,75.0,2,194,0.0,103.0,97.0
116619.0,17,4,1400,4,1400,38873.0,350.0,350.0,0,0,0.0,0.0,0.0
16473.0,6,13,1459,7,862,2591.0,271.0,123.14285714285714,6,597,2959.2,259.0,99.5
108109188.0,17,5,1005,5,1005,27027297.0,201.0,201.0,0,0,0.0,0.0,0.0
9672.0,17,2,582,1,83,0.0,83.0,83.0,1,499,0.0,499.0,499.0
230334.0,6,12,1373,7,714,38389.0,298.0,102.0,5,659,56734.75,379.0,131.8
300872.0,17,2,586,1,81,0.0,81.0,81.0,1,505,0.0,505.0,505.0
10518985.0,6,7,478,4,272,3460577.0,74.0,68.0,3,206,5190715.0,74.0,68.66666666666667
101196.0,17,2,762,2,762,0.0,381.0,381.0,0,0,0.0,0.0,0.0
56790.0,6,10,2032,5,524,13178.5,252.0,104.8,5,1508,13636.25,1236.0,301.6
14056.0,6,14,4740,7,653,2116.833333333333,249.0,93.28571428571428,7,4087,2207.6666666666665,1514.0,583.8571428571429
3175585.0,6,18,1495,9,921,358340.75,315.0,102.33333333333331,9,574,358334.75,78.0,63.77777777777778
3181327.0,6,18,1495,9,921,358373.375,315.0,102.33333333333331,9,574,358614.125,78.0,63.77777777777778
99638614.0,6,40,2640,20,1320,5244137.578947368,66.0,66.0,20,1320,5232761.421052632,66.0,66.0
90254214.0,6,13,2036,8,1016,12893459.142857144,188.0,127.0,5,1020,22522877.75,204.0,204.0
19854.0,17,2,582,1,83,0.0,83.0,83.0,1,499,0.0,499.0,499.0
371730.0,17,2,363,1,75,0.0,75.0,75.0,1,288,0.0,288.0,288.0
121400.0,6,3,337,2,214,0.0,160.0,107.0,1,123,0.0,123.0,123.0
4359448.0,6,192,161806,112,152225,39274.30630630631,1510.0,1359.1517857142858,80,9581,51320.50632911392,1510.0,119.7625
135130759.0,17,6,1206,6,1206,27026151.8,201.0,201.0,0,0,0.0,0.0,0.0
33197.0,6,14,4740,7,653,5412.333333333333,249.0,93.28571428571428,7,4087,4480.166666666667,1514.0,583.8571428571429
124636952.0,17,14,864,7,432,17500173.0,174.0,61.71428571428572,7,432,17501242.833333332,174.0,61.71428571428572
3047225.0,6,3,204,1,68,0.0,68.0,68.0,2,136,0.0,70.0,68.0
46926.0,6,14,4740,7,653,7402.0,249.0,93.28571428571428,7,4087,6696.0,1514.0,583.8571428571429
106403923.0,6,28,1992,14,963,8184917.153846154,123.0,68.78571428571429,14,1029,7400222.923076923,123.0,73.5
284984.0,17,2,180,1,90,0.0,90.0,90.0,1,90,0.0,90.0,90.0
120167358.0,6,31,2119,15,1017,7870037.571428572,123.0,67.8,16,1102,8011127.4,139.0,68.875
119529298.0,17,35,16705,35,16705,3515567.588235294,501.0,477.2857142857143,0,0,0.0,0.0,0.0
153456.0,17,2,180,1,90,0.0,90.0,90.0,1,90,0.0,90.0,90.0
326.0,17,2,166,1,75,0.0,75.0,75.0,1,91,0.0,91.0,91.0
45765620.0,6,8,2113,3,960,21820412.5,826.0,320.0,5,1153,10745603.0,885.0,230.6
228359.0,17,2,180,1,90,0.0,90.0,90.0,1,90,0.0,90.0,90.0
146991.0,17,4,571,2,148,0.0,74.0,74.0,2,423,0.0,280.0,211.5
2370.0,17,4,344,2,150,0.0,75.0,75.0,2,194,0.0,103.0,97.0
90287745.0,6,17,1287,9,691,11279574.125,95.0,76.77777777777777,8,596,12897420.714285716,95.0,74.5
41333.0,6,10,2032,5,524,9273.0,252.0,104.8,5,1508,9383.0,1236.0,301.6
32305.0,6,14,4740,7,653,4526.666666666667,249.0,93.28571428571428,7,4087,5122.833333333333,1514.0,583.8571428571429
6786.0,17,2,582,1,83,0.0,83.0,83.0,1,499,0.0,499.0,499.0
20179.0,6,14,4740,7,653,2843.1666666666665,249.0,93.28571428571428,7,4087,2916.0,1514.0,583.8571428571429
120319545.0,6,226,25990,113,7692,1066925.3125,140.0,68.070796460177,113,18298,1066905.9285714286,284.0,161.92920353982302
215252.0,17,2,180,1,90,0.0,90.0,90.0,1,90,0.0,90.0,90.0
846.0,17,4,438,2,148,0.0,74.0,74.0,2,290,0.0,147.0,145.0
317976.0,6,6,412,4,272,105992.0,74.0,68.0,2,140,0.0,74.0,70.0
2419.0,17,4,344,2,150,0.0,75.0,75.0,2,194,0.0,103.0,97.0
12040718.0,17,5,2265,5,2265,3010179.5,453.0,453.0,0,0,0.0,0.0,0.0
115563302.0,6,48,3168,24,1584,5024491.391304348,66.0,66.0,24,1584,5011404.652173913,66.0,66.0
1283955.0,17,7,490,7,490,213992.5,70.0,70.0,0,0,0.0,0.0,0.0
0.0,6,1,54,0,0,0.0,0.0,0.0,1,54,0.0,54.0,54.0
82119.0,6,14,4740,7,653,13558.0,249.0,93.28571428571428,7,4087,13061.5,1514.0,583.8571428571429
217943.0,6,3,426,2,280,0.0,214.0,140.0,1,146,0.0,146.0,146.0
41826.0,6,14,4740,7,653,6517.5,249.0,93.28571428571428,7,4087,6121.833333333333,1514.0,583.8571428571429
2038.0,17,4,344,2,150,0.0,75.0,75.0,2,194,0.0,103.0,97.0
2041.0,17,4,344,2,150,0.0,75.0,75.0,2,194,0.0,103.0,97.0
2587091.0,6,20,6935,11,1567,258709.1,408.0,142.45454545454547,9,5368,275792.5,1514.0,596.4444444444445
102169644.0,17,14,864,7,432,17001006.0,174.0,61.71428571428572,7,432,17000163.0,174.0,61.71428571428572
51087.0,17,2,180,1,90,0.0,90.0,90.0,1,90,0.0,90.0,90.0
40762.0,6,14,4740,7,653,6598.333333333333,249.0,93.28571428571428,7,4087,6224.333333333333,1514.0,583.8571428571429
3201.0,17,2,333,1,87,0.0,87.0,87.0,1,246,0.0,246.0,246.0
1089353.0,6,13,1386,7,789,181558.8333333333,253.0,112.71428571428572,6,597,216906.4,259.0,99.5
135136404.0,17,6,1206,6,1206,27027280.8,201.0,201.0,0,0,0.0,0.0,0.0
2365.0,17,4,344,2,150,0.0,75.0,75.0,2,194,0.0,103.0,97.0
14679275.0,6,20,1607,10,975,1594130.2222222222,315.0,97.5,10,632,1594549.0,78.0,63.2
148139.0,17,2,180,1,90,0.0,90.0,90.0,1,90,0.0,90.0,90.0
90049217.0,17,28,13364,28,13364,3335156.185185185,501.0,477.2857142857143,0,0,0.0,0.0,0.0
90274787.0,6,17,1373,9,818,11284348.375,222.0,90.88888888888889,8,555,12854587.714285716,95.0,69.375
2241.0,17,4,344,2,150,0.0,75.0,75.0,2,194,0.0,103.0,97.0
108108942.0,17,5,1005,5,1005,27027235.5,201.0,201.0,0,0,0.0,0.0,0.0
108100457.0,17,5,955,5,955,27025114.25,191.0,191.0,0,0,0.0,0.0,0.0
216691.0,6,3,426,2,280,0.0,214.0,140.0,1,146,0.0,146.0,146.0
146099.0,6,3,337,2,214,0.0,160.0,107.0,1,123,0.0,123.0,123.0
40686.0,6,14,4740,7,653,6363.5,249.0,93.28571428571428,7,4087,6641.0,1514.0,583.8571428571429
1174304.0,6,13,3019,8,2391,167757.7142857143,1514.0,298.875,5,628,224664.75,331.0,125.6
209621.0,17,2,180,1,90,0.0,90.0,90.0,1,90,0.0,90.0,90.0
601029.0,6,4,508,2,238,0.0,172.0,119.0,2,270,0.0,135.0,135.0
45094.0,6,14,4740,7,653,7395.333333333333,249.0,93.28571428571428,7,4087,6223.0,1514.0,583.8571428571429
300270.0,6,6,412,4,272,100090.0,74.0,68.0,2,140,0.0,74.0,70.0
2791146.0,6,2,132,1,66,0.0,66.0,66.0,1,66,0.0,66.0,66.0
0.0,17,1,99,1,99,0.0,99.0,99.0,0,0,0.0,0.0,0.0
230239.0,6,3,426,2,280,0.0,214.0,140.0,1,146,0.0,146.0,146.0
155368.0,6,3,337,2,214,0.0,160.0,107.0,1,123,0.0,123.0,123.0
90210978.0,6,21,1585,10,745,9996605.222222222,95.0,74.5,11,840,9000637.8,95.0,76.36363636363636
4123.0,17,2,582,1,83,0.0,83.0,83.0,1,499,0.0,499.0,499.0
2592049.0,6,2,132,1,66,0.0,66.0,66.0,1,66,0.0,66.0,66.0
3407.0,17,2,414,1,88,0.0,88.0,88.0,1,326,0.0,326.0,326.0
708.0,17,4,438,2,148,0.0,74.0,74.0,2,290,0.0,147.0,145.0
764.0,17,4,438,2,148,0.0,74.0,74.0,2,290,0.0,147.0,145.0
682069.0,6,4,497,3,374,341034.5,160.0,124.66666666666669,1,123,0.0,123.0,123.0
143932.0,17,2,180,1,90,0.0,90.0,90.0,1,90,0.0,90.0,90.0
82.0,17,2,762,2,762,0.0,381.0,381.0,0,0,0.0,0.0,0.0
120355460.0,6,378,45428,189,12770,630152.5478723404,140.0,67.56613756613757,189,32658,635802.8882978724,284.0,172.79365079365078
47389.0,6,10,2032,5,524,11632.25,252.0,104.8,5,1508,11457.0,1236.0,301.6
738.0,17,4,438,2,148,0.0,74.0,74.0,2,290,0.0,147.0,145.0
108105133.0,17,5,955,5,955,27026283.25,191.0,191.0,0,0,0.0,0.0,0.0
121865.0,6,3,337,2,214,0.0,160.0,107.0,1,123,0.0,123.0,123.0
119297234.0,6,225,25500,113,7680,1065153.875,140.0,67.96460176991151,112,17820,1066534.2342342343,374.0,159.10714285714286
164818.0,17,2,414,1,88,0.0,88.0,88.0,1,326,0.0,326.0,326.0
90306407.0,6,24,1829,13,989,7521293.25,95.0,76.07692307692308,11,840,9003027.4,95.0,76.36363636363636
2334.0,17,4,344,2,150,0.0,75.0,75.0,2,194,0.0,103.0,97.0
130522.0,6,3,337,2,214,0.0,160.0,107.0,1,123,0.0,123.0,123.0
34426.0,6,14,4740,7,653,5455.333333333333,249.0,93.28571428571428,7,4087,5596.5,1514.0,583.8571428571429
33374.0,6,10,2032,5,524,8114.5,252.0,104.8,5,1508,7837.0,1236.0,301.6
318018.0,17,4,1400,4,1400,106006.0,350.0,350.0,0,0,0.0,0.0,0.0
118671858.0,6,33,2290,17,1125,7416991.125,123.0,66.17647058823529,16,1165,7368529.933333334,139.0,72.8125
121211504.0,6,282,32862,141,9528,856846.5642857143,140.0,67.57446808510639,141,23334,859894.05,284.0,165.48936170212767
15048.0,6,14,4740,7,653,2268.833333333333,249.0,93.28571428571428,7,4087,2370.5,1514.0,583.8571428571429
205348.0,17,2,762,2,762,0.0,381.0,381.0,0,0,0.0,0.0,0.0
100007364.0,17,13,821,7,432,16667894.0,174.0,61.71428571428572,6,389,19927407.6,174.0,64.83333333333333
101932.0,17,2,762,2,762,0.0,381.0,381.0,0,0,0.0,0.0,0.0
315738.0,17,4,1400,4,1400,105246.0,350.0,350.0,0,0,0.0,0.0,0.0
90029721.0,17,27,12943,27,12943,3462681.576923077,501.0,479.3703703703704,0,0,0.0,0.0,0.0
14641008.0,6,20,1646,10,1014,1592808.0,315.0,101.4,10,632,1592773.3333333333,78.0,63.2
16715.0,6,14,4740,7,653,2602.1666666666665,249.0,93.28571428571428,7,4087,2646.1666666666665,1514.0,583.8571428571429
90256226.0,6,13,2036,8,1016,12893746.57142857,188.0,127.0,5,1020,22523688.25,204.0,204.0
108101751.0,17,5,1005,5,1005,27025437.75,201.0,201.0,0,0,0.0,0.0,0.0
3317438.0,6,7,923,4,753,1033499.6666666666,571.0,188.25,3,170,1550551.5,62.0,56.66666666666666
106375.0,17,2,762,2,762,0.0,381.0,381.0,0,0,0.0,0.0,0.0
108103700.0,17,5,955,5,955,27025925.0,191.0,191.0,0,0,0.0,0.0,0.0
22053254.0,17,4,1376,3,1026,969279.5,342.0,342.0,1,350,0.0,350.0,350.0
121282401.0,6,32,2226,17,1209,7580150.0625,123.0,71.11764705882354,15,1017,7934434.571428572,123.0,67.8
755.0,17,4,438,2,148,0.0,74.0,74.0,2,290,0.0,147.0,145.0
0.0,17,1,55,1,55,0.0,55.0,55.0,0,0,0.0,0.0,0.0
341.0,17,2,160,1,80,0.0,80.0,80.0,1,80,0.0,80.0,80.0
34911.0,6,14,4740,7,653,5698.333333333333,249.0,93.28571428571428,7,4087,5310.333333333333,1514.0,583.8571428571429
120369604.0,6,403,49096,202,35534,598853.7512437811,336.0,175.9108910891089,201,13562,596677.685,140.0,67.4726368159204
96126382.0,6,58,12285,29,6491,3433085.071428572,1514.0,223.8275862068965,29,5794,3423945.6428571427,1514.0,199.79310344827587
46683.0,6,14,4740,7,653,7502.0,249.0,93.28571428571428,7,4087,7648.0,1514.0,583.8571428571429
213809.0,6,3,426,2,280,0.0,214.0,140.0,1,146,0.0,146.0,146.0
148107.0,17,2,180,1,90,0.0,90.0,90.0,1,90,0.0,90.0,90.0
882314.0,6,12,2709,7,743,147052.33333333334,339.0,106.14285714285714,5,1966,151749.5,1514.0,393.2
53153.0,6,14,4740,7,653,8730.833333333334,249.0,93.28571428571428,7,4087,8534.833333333334,1514.0,583.8571428571429
466.0,17,2,410,1,78,0.0,78.0,78.0,1,332,0.0,332.0,332.0
324.0,17,2,174,1,79,0.0,79.0,79.0,1,95,0.0,95.0,95.0
135127319.0,17,6,1146,6,1146,27025463.8,191.0,191.0,0,0,0.0,0.0,0.0
24183.0,6,14,4740,7,653,3916.0,249.0,93.28571428571428,7,4087,3681.8333333333335,1514.0,583.8571428571429
108105563.0,17,5,955,5,955,27026390.75,191.0,191.0,0,0,0.0,0.0,0.0
319522.0,6,6,412,4,272,106507.33333333331,74.0,68.0,2,140,0.0,74.0,70.0
1775737.0,6,2,132,1,66,0.0,66.0,66.0,1,66,0.0,66.0,66.0
146294.0,6,3,373,2,238,0.0,172.0,119.0,1,135,0.0,135.0,135.0
108105328.0,17,5,1005,5,1005,27026332.0,201.0,201.0,0,0,0.0,0.0,0.0
343.0,17,2,174,1,79,0.0,79.0,79.0,1,95,0.0,95.0,95.0
1602204.0,6,7,499,3,198,716501.5,66.0,66.0,4,301,484281.6666666667,103.0,75.25
3230.0,17,4,344,2,150,0.0,75.0,75.0,2,194,0.0,103.0,97.0
56174.0,6,14,4740,7,653,9224.833333333334,249.0,93.28571428571428,7,4087,8535.5,1514.0,583.8571428571429
441.0,17,2,166,1,75,0.0,75.0,75.0,1,91,0.0,91.0,91.0
218536.0,6,3,426,2,280,0.0,214.0,140.0,1,146,0.0,146.0,146.0
135132848.0,17,6,1206,6,1206,27026569.6,201.0,201.0,0,0,0.0,0.0,0.0
144706.0,17,2,180,1,70,0.0,70.0,70.0,1,110,0.0,110.0,110.0
206502.0,17,2,762,2,762,0.0,381.0,381.0,0,0,0.0,0.0,0.0
538355.0,17,6,2100,6,2100,107671.0,350.0,350.0,0,0,0.0,0.0,0.0
2811.0,17,2,224,1,76,0.0,76.0,76.0,1,148,0.0,148.0,148.0
90260441.0,6,12,1832,8,1016,12894348.714285716,188.0,127.0,4,816,30031676.666666668,204.0,204.0
2052.0,17,4,344,2,150,0.0,75.0,75.0,2,194,0.0,103.0,97.0
140609.0,6,2,132,1,66,0.0,66.0,66.0,1,66,0.0,66.0,66.0
16181058.0,17,6,2052,6,2052,3236211.6,342.0,342.0,0,0,0.0,0.0,0.0
105263604.0,6,196,22198,98,15508,1082973.3711340206,374.0,158.24489795918367,98,6690,1082973.4432989692,140.0,68.26530612244898
112519.0,17,2,286,2,286,0.0,143.0,143.0,0,0,0.0,0.0,0.0
108096956.0,17,5,1005,5,1005,27024239.0,201.0,201.0,0,0,0.0,0.0,0.0
328880.0,6,6,412,4,272,109626.66666666669,74.0,68.0,2,140,0.0,74.0,70.0
21144.0,6,10,1067,5,536,4005.0,264.0,107.2,5,531,5009.0,259.0,106.2
510875.0,6,5,336,2,134,0.0,68.0,67.0,3,202,193935.0,70.0,67.33333333333333
90308372.0,6,19,1436,10,745,10028136.444444444,95.0,74.5,9,691,11288006.5,95.0,76.77777777777777
2240.0,17,2,508,2,508,0.0,257.0,254.0,0,0,0.0,0.0,0.0
192598.0,17,2,762,2,762,0.0,381.0,381.0,0,0,0.0,0.0,0.0
121474.0,6,3,337,2,214,0.0,160.0,107.0,1,123,0.0,123.0,123.0
15328.0,6,14,4740,7,653,2237.1666666666665,249.0,93.28571428571428,7,4087,2321.0,1514.0,583.8571428571429
10447840.0,6,7,478,4,272,3437089.0,74.0,68.0,3,206,5155513.0,74.0,68.66666666666667
318929.0,6,6,412,4,272,106309.66666666669,74.0,68.0,2,140,0.0,74.0,70.0
118320536.0,6,229,25928,115,7886,1037899.4385964912,140.0,68.57391304347826,114,18042,1038029.221238938,284.0,158.26315789473685
217529.0,6,3,426,2,280,0.0,214.0,140.0,1,146,0.0,146.0,146.0
108698349.0,6,32,2220,16,1149,7246556.6,123.0,71.8125,16,1071,7232138.6,123.0,66.9375
102690.0,17,2,762,2,762,0.0,381.0,381.0,0,0,0.0,0.0,0.0
39984.0,6,14,4740,7,653,6001.666666666667,249.0,93.28571428571428,7,4087,6526.666666666667,1514.0,583.8571428571429
122185.0,6,11,1132,6,556,24437.0,218.0,92.66666666666669,5,576,30083.75,304.0,115.2
147955.0,17,2,180,1,90,0.0,90.0,90.0,1,90,0.0,90.0,90.0
9332.0,17,2,582,1,83,0.0,83.0,83.0,1,499,0.0,499.0,499.0
209742.0,17,2,180,1,90,0.0,90.0,90.0,1,90,0.0,90.0,90.0
90027227.0,17,28,13364,28,13364,3334341.7407407407,501.0,477.2857142857143,0,0,0.0,0.0,0.0
323763.0,17,4,1400,4,1400,107921.0,350.0,350.0,0,0,0.0,0.0,0.0
228258.0,17,2,180,1,90,0.0,90.0,90.0,1,90,0.0,90.0,90.0
301.0,17,2,156,1,78,0.0,78.0,78.0,1,78,0.0,78.0,78.0
146143.0,6,3,337,2,214,0.0,160.0,107.0,1,123,0.0,123.0,123.0
228189.0,17,2,180,1,90,0.0,90.0,90.0,1,90,0.0,90.0,90.0
108109203.0,17,5,955,5,955,27027300.75,191.0,191.0,0,0,0.0,0.0,0.0
39824.0,6,14,4740,7,653,6464.5,249.0,93.28571428571428,7,4087,6446.333333333333,1514.0,583.8571428571429
119978.0,17,2,180,1,70,0.0,70.0,70.0,1,110,0.0,110.0,110.0
0.0,6,1,66,1,66,0.0,66.0,66.0,0,0,0.0,0.0,0.0
203431.0,17,2,762,2,762,0.0,381.0,381.0,0,0,0.0,0.0,0.0
120392893.0,6,515,61634,258,44450,468454.83657587547,554.0,172.28682170542635,257,17184,466165.69921875,140.0,66.86381322957199
955366.0,6,12,1427,6,796,190443.6,271.0,132.66666666666666,6,631,189749.4,293.0,105.16666666666669
108103476.0,17,5,955,5,955,27025869.0,191.0,191.0,0,0,0.0,0.0,0.0
153754.0,6,3,337,2,214,0.0,160.0,107.0,1,123,0.0,123.0,123.0
216804.0,6,3,426,2,280,0.0,214.0,140.0,1,146,0.0,146.0,146.0
42591.0,6,13,1386,7,789,7098.5,253.0,112.71428571428572,6,597,4893.2,259.0,99.5
10519011.0,6,7,478,4,272,3460693.333333333,74.0,68.0,3,206,5190898.0,74.0,68.66666666666667
549007.0,17,2,346,1,78,0.0,78.0,78.0,1,268,0.0,268.0,268.0
22790.0,6,14,4740,7,653,3261.833333333333,249.0,93.28571428571428,7,4087,3570.1666666666665,1514.0,583.8571428571429
322655.0,17,4,1400,4,1400,107551.66666666669,350.0,350.0,0,0,0.0,0.0,0.0
116558775.0,6,302,37470,151,27282,775622.8266666667,336.0,180.67549668874173,151,10188,775621.88,140.0,67.47019867549669
90217365.0,6,19,1436,9,691,11246261.25,95.0,76.77777777777777,10,745,10000232.222222222,95.0,74.5
232274.0,6,3,337,2,214,0.0,160.0,107.0,1,123,0.0,123.0,123.0
308129.0,6,6,412,4,272,102709.66666666669,74.0,68.0,2,140,0.0,74.0,70.0
3285707.0,6,9,1031,5,807,767425.25,571.0,161.4,4,224,1023436.3333333334,62.0,56.0
108112676.0,17,5,1005,5,1005,27028169.0,201.0,201.0,0,0,0.0,0.0,0.0
113440314.0,6,46,3036,23,1518,5156362.090909091,66.0,66.0,23,1518,5156366.5,66.0,66.0
308.0,17,2,166,1,75,0.0,75.0,75.0,1,91,0.0,91.0,91.0
204845.0,17,2,180,1,90,0.0,90.0,90.0,1,90,0.0,90.0,90.0
249003.0,17,2,180,1,70,0.0,70.0,70.0,1,110,0.0,110.0,110.0
120081735.0,17,28,13364,28,13364,4447471.666666667,501.0,477.2857142857143,0,0,0.0,0.0,0.0
29989.0,6,10,2032,5,524,6043.75,252.0,104.8,5,1508,6680.5,1236.0,301.6
209410.0,6,10,1221,6,636,41882.0,298.0,106.0,4,585,68621.0,379.0,146.25
280313.0,17,2,363,1,79,0.0,79.0,79.0,1,284,0.0,284.0,284.0
90294082.0,6,16,1192,8,596,12892023.857142856,95.0,74.5,8,596,12897795.857142856,95.0,74.5
108101439.0,17,5,955,5,955,27025359.75,191.0,191.0,0,0,0.0,0.0,0.0
2594721.0,6,2,132,1,66,0.0,66.0,66.0,1,66,0.0,66.0,66.0
877083.0,6,10,1334,6,797,175416.6,459.0,132.83333333333334,4,537,200443.3333333333,331.0,134.25
91443777.0,6,21,1712,11,799,9139865.6,95.0,72.63636363636364,10,913,10160072.888888888,222.0,91.3
43495.0,6,10,2032,5,524,10634.25,252.0,104.8,5,1508,10720.75,1236.0,301.6
217409.0,6,3,426,2,280,0.0,214.0,140.0,1,146,0.0,146.0,146.0
91111048.0,6,380,49600,190,12762,481924.9523809524,140.0,67.16842105263157,190,36838,481913.05291005294,336.0,193.8842105263158
284408.0,17,2,363,1,79,0.0,79.0,79.0,1,284,0.0,284.0,284.0
16856.0,6,11,1133,6,602,3285.2,264.0,100.33333333333331,5,531,3495.25,259.0,106.2
11645.0,6,10,1066,5,490,2671.0,218.0,98.0,5,576,2315.25,304.0,115.2
867634.0,6,9,1267,6,796,173526.8,458.0,132.66666666666666,3,471,296049.5,331.0,157.0
146282.0,6,3,337,2,214,0.0,160.0,107.0,1,123,0.0,123.0,123.0
108107182.0,17,5,1005,5,1005,27026795.5,201.0,201.0,0,0,0.0,0.0,0.0
150316.0,6,10,1066,5,490,36581.25,218.0,98.0,5,576,37375.5,304.0,115.2
115610809.0,17,14,864,7,432,19167753.83333333,174.0,61.71428571428572,7,432,19166857.166666668,174.0,61.71428571428572
2494.0,17,4,344,2,150,0.0,75.0,75.0,2,194,0.0,103.0,97.0
90053761.0,17,27,12943,27,12943,3463606.1923076925,501.0,479.3703703703704,0,0,0.0,0.0,0.0
238198.0,6,3,337,2,214,0.0,160.0,107.0,1,123,0.0,123.0,123.0
54179088.0,6,8,1307,8,1307,7739869.714285715,172.0,163.375,0,0,0.0,0.0,0.0
0.0,17,1,381,1,381,0.0,381.0,381.0,0,0,0.0,0.0,0.0
41394.0,6,14,4740,7,653,6443.166666666667,249.0,93.28571428571428,7,4087,6692.5,1514.0,583.8571428571429
99228.0,17,2,762,2,762,0.0,381.0,381.0,0,0,0.0,0.0,0.0
146087.0,6,3,337,2,214,0.0,160.0,107.0,1,123,0.0,123.0,123.0
103472.0,17,2,286,2,286,0.0,143.0,143.0,0,0,0.0,0.0,0.0
151723.0,17,2,414,1,88,0.0,88.0,88.0,1,326,0.0,326.0,326.0
324481.0,17,4,1400,4,1400,108160.33333333331,350.0,350.0,0,0,0.0,0.0,0.0
22151324.0,6,5,1909,2,892,0.0,826.0,446.0,3,1017,9922073.5,885.0,339.0
2687793.0,6,3,1604,2,851,0.0,785.0,425.5,1,753,0.0,753.0,753.0
36064.0,6,14,4740,7,653,5853.0,249.0,93.28571428571428,7,4087,5814.833333333333,1514.0,583.8571428571429
232460.0,6,3,337,2,214,0.0,160.0,107.0,1,123,0.0,123.0,123.0
99994.0,17,2,762,2,762,0.0,381.0,381.0,0,0,0.0,0.0,0.0
391.0,17,2,208,1,72,0.0,72.0,72.0,1,136,0.0,136.0,136.0
2599446.0,6,2,132,1,66,0.0,66.0,66.0,1,66,0.0,66.0,66.0
355.0,17,2,166,1,75,0.0,75.0,75.0,1,91,0.0,91.0,91.0
112605928.0,6,30,1990,15,1042,8027875.5,139.0,69.46666666666667,15,948,8027875.571428572,123.0,63.2
120399199.0,6,217,24580,109,17156,1114807.398148148,284.0,157.39449541284404,108,7424,1115499.6728971964,140.0,68.74074074074075
114608870.0,6,36,2596,18,1348,6741698.235294118,139.0,74.88888888888889,18,1248,6728972.823529412,123.0,69.33333333333333
0.0,6,1,66,1,66,0.0,66.0,66.0,0,0,0.0,0.0,0.0
5623216.0,6,4,270,2,134,0.0,68.0,67.0,2,136,0.0,70.0,68.0
10433522.0,6,7,478,4,272,3431017.0,74.0,68.0,3,206,5146386.0,74.0,68.66666666666667
27970.0,6,13,4412,6,409,5425.8,127.0,68.16666666666667,7,4003,4419.666666666667,1514.0,571.8571428571429
287830.0,17,2,359,1,75,0.0,75.0,75.0,1,284,0.0,284.0,284.0
110897503.0,6,32,2236,16,1165,7393166.866666666,139.0,72.8125,16,1071,7378750.333333333,123.0,66.9375
115062587.0,6,262,30086,131,8942,878685.9692307692,140.0,68.25954198473282,131,21144,878762.0846153846,374.0,161.40458015267177
170645.0,17,2,245,1,85,0.0,85.0,85.0,1,160,0.0,160.0,160.0
307103.0,6,6,412,4,272,102367.66666666669,74.0,68.0,2,140,0.0,74.0,70.0
108104100.0,17,5,1005,5,1005,27026025.0,201.0,201.0,0,0,0.0,0.0,0.0
119927981.0,17,35,16705,35,16705,3527293.5588235296,501.0,477.2857142857143,0,0,0.0,0.0,0.0
28815365.0,6,31,9412,17,3897,169581.0,1514.0,229.23529411764707,14,5515,2200726.3076923075,1514.0,393.9285714285714
14127.0,6,10,2032,5,524,3263.5,252.0,104.8,5,1508,3190.25,1236.0,301.6
50425.0,6,10,2032,5,524,12354.0,252.0,104.8,5,1508,12105.75,1236.0,301.6
44962.0,6,14,4740,7,653,7331.0,249.0,93.28571428571428,7,4087,7272.333333333333,1514.0,583.8571428571429
22141.0,6,14,4740,7,653,3532.333333333333,249.0,93.28571428571428,7,4087,2492.5,1514.0,583.8571428571429
143974.0,17,2,180,1,90,0.0,90.0,90.0,1,90,0.0,90.0,90.0
90328114.0,6,36,2376,18,1188,5313418.470588235,66.0,66.0,18,1188,5295039.823529412,66.0,66.0
135132067.0,17,6,1206,6,1206,27026413.4,201.0,201.0,0,0,0.0,0.0,0.0
210002.0,6,3,426,2,280,0.0,214.0,140.0,1,146,0.0,146.0,146.0
119985394.0,17,35,16705,35,16705,3528982.1764705884,501.0,477.2857142857143,0,0,0.0,0.0,0.0
125799114.0,6,71,14627,34,7364,3404085.878787879,1514.0,216.58823529411765,37,7263,3488710.277777778,1514.0,196.2972972972973
102328.0,17,2,286,2,286,0.0,143.0,143.0,0,0,0.0,0.0,0.0
90091003.0,6,10,1440,7,828,15015167.166666666,188.0,118.28571428571428,3,612,30030772.5,204.0,204.0
349.0,17,2,267,1,83,0.0,83.0,83.0,1,184,0.0,184.0,184.0
31970.0,6,14,4740,7,653,4383.5,249.0,93.28571428571428,7,4087,5187.833333333333,1514.0,583.8571428571429
90052291.0,17,28,13364,28,13364,3335270.037037037,501.0,477.2857142857143,0,0,0.0,0.0,0.0
309251.0,6,6,412,4,272,103083.66666666669,74.0,68.0,2,140,0.0,74.0,70.0
146249.0,6,3,337,2,214,0.0,160.0,107.0,1,123,0.0,123.0,123.0
46064.0,6,10,2032,5,524,11264.0,252.0,104.8,5,1508,11062.5,1236.0,301.6
111023751.0,6,32,2236,16,1165,7387181.133333334,139.0,72.8125,16,1071,7387182.866666666,123.0,66.9375
1300748.0,6,4,264,2,132,0.0,66.0,66.0,2,132,0.0,66.0,66.0
232333.0,6,3,337,2,214,0.0,160.0,107.0,1,123,0.0,123.0,123.0
780.0,17,4,438,2,148,0.0,74.0,74.0,2,290,0.0,147.0,145.0
119973956.0,6,964,200532,473,31884,254148.64406779665,214.0,67.40803382663847,491,168648,244800.78163265303,1514.0,343.4786150712831
120002433.0,6,19,1615,10,704,13333603.666666666,95.0,70.4,9,911,14268122.625,218.0,101.22222222222224
90255518.0,6,13,2036,8,1016,12893645.42857143,188.0,127.0,5,1020,22523324.0,204.0,204.0
310652.0,6,12,1373,7,714,51775.333333333336,298.0,102.0,5,659,61718.75,379.0,131.8
119890784.0,17,35,16705,35,16705,3526199.529411765,501.0,477.2857142857143,0,0,0.0,0.0,0.0
743943.0,6,2,132,1,66,0.0,66.0,66.0,1,66,0.0,66.0,66.0
10454047.0,6,7,478,4,272,3439199.0,74.0,68.0,3,206,5158701.5,74.0,68.66666666666667
343038.0,6,2,132,1,66,0.0,66.0,66.0,1,66,0.0,66.0,66.0
116001162.0,17,13,821,7,432,19333527.0,174.0,61.71428571428572,6,389,19200956.4,174.0,64.83333333333333
135131968.0,17,6,1146,6,1146,27026393.6,191.0,191.0,0,0,0.0,0.0,0.0
205697.0,17,2,180,1,90,0.0,90.0,90.0,1,90,0.0,90.0,90.0
47803.0,6,14,4740,7,653,7562.166666666667,249.0,93.28571428571428,7,4087,7823.166666666667,1514.0,583.8571428571429
90033455.0,17,27,12943,27,12943,3462825.1923076925,501.0,479.3703703703704,0,0,0.0,0.0,0.0
245362.0,6,3,337,2,214,0.0,160.0,107.0,1,123,0.0,123.0,123.0
307305.0,6,6,412,4,272,102435.0,74.0,68.0,2,140,0.0,74.0,70.0
90716311.0,6,20,1531,11,840,9067883.5,95.0,76.36363636363636,9,691,11339156.125,95.0,76.77777777777777
321680.0,17,4,1400,4,1400,107226.66666666669,350.0,350.0,0,0,0.0,0.0,0.0
344.0,17,2,208,1,72,0.0,72.0,72.0,1,136,0.0,136.0,136.0
210599.0,17,4,6056,4,6056,70199.66666666667,1514.0,1514.0,0,0,0.0,0.0,0.0
143958.0,17,2,180,1,90,0.0,90.0,90.0,1,90,0.0,90.0,90.0
50961.0,17,2,180,1,90,0.0,90.0,90.0,1,90,0.0,90.0,90.0
143895.0,17,2,180,1,90,0.0,90.0,90.0,1,90,0.0,90.0,90.0
649.0,17,2,267,1,83,0.0,83.0,83.0,1,184,0.0,184.0,184.0
221190.0,6,3,426,2,280,0.0,214.0,140.0,1,146,0.0,146.0,146.0
108078100.0,17,5,955,5,955,27019525.0,191.0,191.0,0,0,0.0,0.0,0.0
135131573.0,17,6,1146,6,1146,27026314.6,191.0,191.0,0,0,0.0,0.0,0.0
725050.0,6,11,1021,6,444,97279.8,162.0,74.0,5,577,121417.25,349.0,115.4
657.0,17,2,762,2,762,0.0,381.0,381.0,0,0,0.0,0.0,0.0
302783.0,6,6,412,4,272,100927.66666666669,74.0,68.0,2,140,0.0,74.0,70.0
120337908.0,6,227,25732,114,18052,1064937.2389380531,390.0,158.35087719298247,113,7680,1065133.5535714286,140.0,67.96460176991151
34471.0,6,14,4740,7,653,5533.0,249.0,93.28571428571428,7,4087,5610.0,1514.0,583.8571428571429
280060.0,17,2,363,1,79,0.0,79.0,79.0,1,284,0.0,284.0,284.0
14247.0,6,13,1459,7,862,2225.6666666666665,271.0,123.14285714285714,6,597,2596.0,259.0,99.5
304912.0,6,6,412,4,272,101637.33333333331,74.0,68.0,2,140,0.0,74.0,70.0
2397.0,17,4,344,2,150,0.0,75.0,75.0,2,194,0.0,103.0,97.0
39704.0,6,13,1479,7,882,6358.0,291.0,126.0,6,597,7061.8,259.0,99.5
90256600.0,6,14,2240,8,1016,12893800.0,188.0,127.0,6,1224,18018316.0,204.0,204.0
90286508.0,6,21,1585,11,840,9023646.8,95.0,76.36363636363636,10,745,9999878.0,95.0,74.5
33075.0,6,11,1133,6,602,6375.4,264.0,100.33333333333331,5,531,7266.5,259.0,106.2
101616688.0,17,14,864,7,432,16834211.833333332,174.0,61.71428571428572,7,432,16833491.166666668,174.0,61.71428571428572
5011459.0,17,4,414,2,152,0.0,76.0,76.0,2,262,0.0,170.0,131.0
5617318.0,6,5,336,2,134,0.0,68.0,67.0,3,202,1418439.5,70.0,67.33333333333333
205923.0,17,2,180,1,90,0.0,90.0,90.0,1,90,0.0,90.0,90.0
388883.0,6,10,1221,6,636,77776.6,298.0,106.0,4,585,128394.0,379.0,146.25
135135773.0,17,6,1146,6,1146,27027154.6,191.0,191.0,0,0,0.0,0.0,0.0
107412338.0,6,28,1860,14,966,8245897.692307692,123.0,69.0,14,894,8245896.0,123.0,63.85714285714285
329.0,17,2,166,1,75,0.0,75.0,75.0,1,91,0.0,91.0,91.0
911965.0,6,10,1221,6,636,182393.0,298.0,106.0,4,585,298427.3333333333,379.0,146.25
135131357.0,17,6,1146,6,1146,27026271.4,191.0,191.0,0,0,0.0,0.0,0.0
120072883.0,17,28,13364,28,13364,4447143.814814814,501.0,477.2857142857143,0,0,0.0,0.0,0.0
29790.0,6,2,145,2,145,0.0,91.0,72.5,0,0,0.0,0.0,0.0
304621.0,6,6,412,4,272,101540.33333333331,74.0,68.0,2,140,0.0,74.0,70.0
243450.0,6,3,373,2,238,0.0,172.0,119.0,1,135,0.0,135.0,135.0
102852.0,17,2,286,2,286,0.0,143.0,143.0,0,0,0.0,0.0,0.0
96063612.0,6,186,21088,93,14728,1041830.2391304348,374.0,158.36559139784947,93,6360,1041830.4021739132,140.0,68.38709677419355
441473.0,6,10,1221,6,636,88294.6,298.0,106.0,4,585,140169.0,379.0,146.25
10522422.0,6,7,478,4,272,3461807.6666666665,74.0,68.0,3,206,5192588.5,74.0,68.66666666666667
297210.0,6,6,412,4,272,99070.0,74.0,68.0,2,140,0.0,74.0,70.0
228345.0,17,2,180,1,90,0.0,90.0,90.0,1,90,0.0,90.0,90.0
311495.0,17,4,704,2,148,0.0,74.0,74.0,2,556,0.0,280.0,278.0
90029919.0,17,28,13364,28,13364,3334441.4444444445,501.0,477.2857142857143,0,0,0.0,0.0,0.0
108101043.0,17,5,955,5,955,27025260.75,191.0,191.0,0,0,0.0,0.0,0.0
153509.0,17,2,180,1,90,0.0,90.0,90.0,1,90,0.0,90.0,90.0
211543.0,6,10,1221,6,636,42308.6,298.0,106.0,4,585,68938.66666666667,379.0,146.25
94229684.0,6,23,1852,11,958,9397158.6,213.0,87.0909090909091,12,894,8547273.909090908,95.0,74.5
141541.0,17,4,571,2,148,0.0,74.0,74.0,2,423,0.0,280.0,211.5
21323.0,17,2,507,1,86,0.0,86.0,86.0,1,421,0.0,421.0,421.0
2436797.0,6,3,1777,1,826,0.0,826.0,826.0,2,951,0.0,885.0,475.5
833.0,17,4,438,2,148,0.0,74.0,74.0,2,290,0.0,147.0,145.0
90302505.0,6,21,1585,11,840,9025868.4,95.0,76.36363636363636,10,745,9949715.111111112,95.0,74.5
95269506.0,6,408,54254,204,40568,468247.8325123153,480.0,198.86274509803923,204,13686,468247.9014778325,140.0,67.08823529411765
313272.0,6,3,202,2,128,0.0,74.0,64.0,1,74,0.0,74.0,74.0
736140.0,6,11,1021,6,444,98575.4,162.0,74.0,5,577,123031.75,349.0,115.4
307763.0,6,6,412,4,272,102587.66666666669,74.0,68.0,2,140,0.0,74.0,70.0
304055.0,6,3,202,2,128,0.0,74.0,64.0,1,74,0.0,74.0,74.0
327.0,17,2,208,1,72,0.0,72.0,72.0,1,136,0.0,136.0,136.0
347.0,17,2,166,1,75,0.0,75.0,75.0,1,91,0.0,91.0,91.0
90061849.0,17,28,13364,28,13364,3335624.037037037,501.0,477.2857142857143,0,0,0.0,0.0,0.0
113986052.0,6,234,26438,117,7944,975551.1293103448,140.0,67.8974358974359,117,18494,975661.0431034482,284.0,158.06837606837607
246263.0,6,3,337,2,214,0.0,160.0,107.0,1,123,0.0,123.0,123.0
20227.0,6,10,2032,5,524,4819.75,252.0,104.8,5,1508,4709.5,1236.0,301.6
317956.0,17,4,1400,4,1400,105985.33333333331,350.0,350.0,0,0,0.0,0.0,0.0
106410155.0,17,14,864,7,432,17668012.833333332,174.0,61.71428571428572,7,432,17666828.0,174.0,61.71428571428572
232999.0,6,3,337,2,214,0.0,160.0,107.0,1,123,0.0,123.0,123.0
108105410.0,17,5,1005,5,1005,27026352.5,201.0,201.0,0,0,0.0,0.0,0.0
2598609.0,6,2,132,1,66,0.0,66.0,66.0,1,66,0.0,66.0,66.0
5834894.0,6,5,336,2,134,0.0,68.0,67.0,3,202,1522293.0,70.0,67.33333333333333
313468.0,17,4,1400,4,1400,104489.33333333331,350.0,350.0,0,0,0.0,0.0,0.0
153482.0,17,2,180,1,90,0.0,90.0,90.0,1,90,0.0,90.0,90.0
1302409.0,6,4,264,2,132,0.0,66.0,66.0,2,132,0.0,66.0,66.0
303304.0,6,6,412,4,272,101101.33333333331,74.0,68.0,2,140,0.0,74.0,70.0
25775.0,6,14,4740,7,653,3694.8333333333335,249.0,93.28571428571428,7,4087,4105.333333333333,1514.0,583.8571428571429
120129386.0,6,230,25978,115,7886,1047130.7894736842,140.0,68.57391304347826,115,18092,1053555.0438596492,284.0,157.3217391304348
47136.0,6,14,4740,7,653,7060.833333333333,249.0,93.28571428571428,7,4087,7555.166666666667,1514.0,583.8571428571429
10469602.0,6,7,478,4,272,3444370.6666666665,74.0,68.0,3,206,5166443.0,74.0,68.66666666666667
125204559.0,6,31,2166,15,1017,8229960.214285715,123.0,67.8,16,1149,7681298.933333334,123.0,71.8125
204606.0,17,2,762,2,762,0.0,381.0,381.0,0,0,0.0,0.0,0.0
23498.0,6,10,1066,5,490,4941.5,218.0,98.0,5,576,4395.25,304.0,115.2
120250626.0,6,232,26232,116,7952,1038525.4,140.0,68.55172413793103,116,18280,1038625.2521739132,284.0,157.58620689655172
2052299.0,17,6,1230,3,234,1025968.0,78.0,78.0,3,996,1025942.5,332.0,332.0
334.0,17,2,248,1,84,0.0,84.0,84.0,1,164,0.0,164.0,164.0
2383.0,17,4,344,2,150,0.0,75.0,75.0,2,194,0.0,103.0,97.0
300012.0,6,6,412,4,272,100004.0,74.0,68.0,2,140,0.0,74.0,70.0
3272978.0,6,8,3364,4,1650,308768.3333333333,753.0,412.5,4,1714,1090992.6666666667,785.0,428.5
90949014.0,6,21,1585,11,840,9094171.3,95.0,76.36363636363636,10,745,10104676.333333334,95.0,74.5
45644.0,17,2,180,1,90,0.0,90.0,90.0,1,90,0.0,90.0,90.0
72711.0,6,14,4740,7,653,11748.666666666666,249.0,93.28571428571428,7,4087,11704.833333333334,1514.0,583.8571428571429
469.0,17,2,267,1,83,0.0,83.0,83.0,1,184,0.0,184.0,184.0
2272.0,17,4,344,2,150,0.0,75.0,75.0,2,194,0.0,103.0,97.0
873.0,17,4,438,2,148,0.0,74.0,74.0,2,290,0.0,147.0,145.0
100026945.0,17,12,778,6,389,20000160.2,174.0,64.83333333333333,6,389,20000967.4,174.0,64.83333333333333
103451.0,17,2,286,2,286,0.0,143.0,143.0,0,0,0.0,0.0,0.0
50683.0,6,10,2032,5,524,12432.0,252.0,104.8,5,1508,12276.5,1236.0,301.6
2189.0,17,2,180,1,90,0.0,90.0,90.0,1,90,0.0,90.0,90.0
510651.0,6,5,336,2,134,0.0,68.0,67.0,3,202,192600.0,70.0,67.33333333333333
268487.0,6,3,337,2,214,0.0,160.0,107.0,1,123,0.0,123.0,123.0
995841.0,17,5,961,3,234,497736.5,78.0,78.0,2,727,0.0,395.0,363.5
29622.0,6,14,4740,7,653,3980.6666666666665,249.0,93.28571428571428,7,4087,4353.166666666667,1514.0,583.8571428571429
109558.0,17,4,1400,4,1400,36519.333333333336,350.0,350.0,0,0,0.0,0.0,0.0
139913.0,6,2,132,1,66,0.0,66.0,66.0,1,66,0.0,66.0,66.0
334324.0,6,3,1604,2,851,0.0,785.0,425.5,1,753,0.0,753.0,753.0
30446.0,6,14,4740,7,653,4888.166666666667,249.0,93.28571428571428,7,4087,4942.0,1514.0,583.8571428571429
46155.0,6,14,4740,7,653,7565.333333333333,249.0,93.28571428571428,7,4087,7273.5,1514.0,583.8571428571429
23921710.0,6,449,419831,127,8553,189854.84126984127,205.0,67.34645669291339,322,411278,74511.507788162,1514.0,1277.2608695652175
233744.0,6,3,373,2,238,0.0,172.0,119.0,1,135,0.0,135.0,135.0
152285.0,6,2,132,1,66,0.0,66.0,66.0,1,66,0.0,66.0,66.0
94000913.0,17,11,735,6,389,18800182.6,174.0,64.83333333333333,5,346,18501715.75,174.0,69.2
304240.0,6,6,412,4,272,101413.33333333331,74.0,68.0,2,140,0.0,74.0,70.0
69286.0,17,2,616,1,75,0.0,75.0,75.0,1,541,0.0,541.0,541.0
90037050.0,17,28,13364,28,13364,3334705.5555555555,501.0,477.2857142857143,0,0,0.0,0.0,0.0
91382375.0,6,24,1829,13,989,7613990.833333333,95.0,76.07692307692308,11,840,9137490.1,95.0,76.36363636363636
121350.0,6,3,337,2,214,0.0,160.0,107.0,1,123,0.0,123.0,123.0
5125428.0,6,5,336,2,134,0.0,68.0,67.0,3,202,1177820.5,70.0,67.33333333333333
118707370.0,6,48,3168,24,1584,5161190.0,66.0,66.0,24,1584,5151802.521739131,66.0,66.0
116994201.0,17,16,1474,8,737,16676027.285714284,174.0,92.125,8,737,16690585.857142856,174.0,92.125
25583.0,6,14,4740,7,653,4013.1666666666665,249.0,93.28571428571428,7,4087,4128.5,1514.0,583.8571428571429
217854.0,6,3,426,2,280,0.0,214.0,140.0,1,146,0.0,146.0,146.0
1307128.0,6,4,264,2,132,0.0,66.0,66.0,2,132,0.0,66.0,66.0
135126620.0,17,6,1146,6,1146,27025324.0,191.0,191.0,0,0,0.0,0.0,0.0
30993.0,6,14,4740,7,653,5043.5,249.0,93.28571428571428,7,4087,5016.333333333333,1514.0,583.8571428571429
31872.0,6,10,2032,5,524,7041.5,252.0,104.8,5,1508,6251.75,1236.0,301.6
301778.0,6,6,412,4,272,100592.66666666669,74.0,68.0,2,140,0.0,74.0,70.0
146856.0,6,3,373,2,238,0.0,172.0,119.0,1,135,0.0,135.0,135.0
21777.0,6,14,4740,7,653,3508.5,249.0,93.28571428571428,7,4087,3449.0,1514.0,583.8571428571429
131295.0,17,4,1524,4,1524,43765.0,381.0,381.0,0,0,0.0,0.0,0.0
308075.0,6,6,412,4,272,102691.66666666669,74.0,68.0,2,140,0.0,74.0,70.0
196918.0,17,2,180,1,90,0.0,90.0,90.0,1,90,0.0,90.0,90.0
120180060.0,6,228,25644,114,7820,1056137.1238938053,140.0,68.59649122807018,114,17824,1047050.371681416,284.0,156.35087719298247
148031.0,17,2,180,1,90,0.0,90.0,90.0,1,90,0.0,90.0,90.0
11546.0,6,11,1132,6,556,2217.0,218.0,92.66666666666669,5,576,2685.25,304.0,115.2
90475674.0,6,20,1490,11,840,9043487.0,95.0,76.36363636363636,9,650,11302906.375,95.0,72.22222222222223
2380.0,17,4,344,2,150,0.0,75.0,75.0,2,194,0.0,103.0,97.0
120054185.0,6,36,2596,18,1348,7049166.882352941,139.0,74.88888888888889,18,1248,7049293.647058823,123.0,69.33333333333333
2347.0,17,4,344,2,150,0.0,75.0,75.0,2,194,0.0,103.0,97.0
308084.0,6,6,412,4,272,102694.66666666669,74.0,68.0,2,140,0.0,74.0,70.0
111165324.0,6,235,26594,118,8010,950130.9743589744,140.0,67.88135593220339,117,18584,949233.6724137932,284.0,158.83760683760684
16417.0,6,14,4740,7,653,2570.0,249.0,93.28571428571428,7,4087,2605.0,1514.0,583.8571428571429
53133.0,6,14,4740,7,653,8714.333333333334,249.0,93.28571428571428,7,4087,8035.166666666667,1514.0,583.8571428571429
31243.0,6,10,2032,5,524,6801.25,252.0,104.8,5,1508,7560.5,1236.0,301.6
120066924.0,6,220,24884,110,7482,1094011.1009174313,140.0,68.01818181818182,110,17402,1094110.0275229358,284.0,158.2
103335.0,17,2,286,2,286,0.0,143.0,143.0,0,0,0.0,0.0,0.0
3663157.0,6,5,336,2,134,0.0,68.0,67.0,3,202,1531181.5,70.0,67.33333333333333
48171.0,6,14,4740,7,653,7502.333333333333,249.0,93.28571428571428,7,4087,7751.333333333333,1514.0,583.8571428571429
103916386.0,6,29,1983,15,1017,7422565.214285715,123.0,67.8,14,966,7993351.615384615,123.0,69.0
204141.0,6,10,1221,6,636,40828.2,298.0,106.0,4,585,67070.0,379.0,146.25
0.0,17,1,453,1,453,0.0,453.0,453.0,0,0,0.0,0.0,0.0
107089.0,17,2,286,2,286,0.0,143.0,143.0,0,0,0.0,0.0,0.0
5628970.0,6,5,336,2,134,0.0,68.0,67.0,3,202,1424219.5,70.0,67.33333333333333
29467.0,6,10,2032,5,524,5797.5,252.0,104.8,5,1508,4890.0,1236.0,301.6
2096474.0,6,24,7544,12,2450,190588.54545454544,1034.0,204.16666666666663,12,5094,162539.54545454544,1510.0,424.5
135134246.0,17,6,1146,6,1146,27026849.2,191.0,191.0,0,0,0.0,0.0,0.0
2630614.0,6,3,1602,2,850,0.0,784.0,425.0,1,752,0.0,752.0,752.0
10523540.0,6,7,478,4,272,3462143.333333333,74.0,68.0,3,206,5193093.0,74.0,68.66666666666667
153493.0,17,2,180,1,90,0.0,90.0,90.0,1,90,0.0,90.0,90.0
228246.0,17,2,180,1,90,0.0,90.0,90.0,1,90,0.0,90.0,90.0
250682.00000000003,6,3,337,2,214,0.0,160.0,107.0,1,123,0.0,123.0,123.0
108090218.0,17,5,1005,5,1005,27022554.5,201.0,201.0,0,0,0.0,0.0,0.0
46782542.0,6,8,1940,3,887,21998058.5,753.0,295.6666666666667,5,1053,11001577.25,785.0,210.6
16125.0,17,4,823,2,163,0.0,89.0,81.5,2,660,0.0,443.0,330.0
441970.0,17,2,363,1,79,0.0,79.0,79.0,1,284,0.0,284.0,284.0
343.0,17,2,160,1,80,0.0,80.0,80.0,1,80,0.0,80.0,80.0
196888.0,17,2,180,1,90,0.0,90.0,90.0,1,90,0.0,90.0,90.0
3371.0,17,4,571,2,148,0.0,74.0,74.0,2,423,0.0,280.0,211.5
217814.0,6,3,426,2,280,0.0,214.0,140.0,1,146,0.0,146.0,146.0
153417.0,17,2,180,1,90,0.0,90.0,90.0,1,90,0.0,90.0,90.0
219.0,17,5,550,5,550,54.75,110.0,110.0,0,0,0.0,0.0,0.0
6733.0,17,4,344,2,150,0.0,75.0,75.0,2,194,0.0,103.0,97.0
841158.0,6,9,1118,6,586,168231.6,248.0,97.66666666666669,3,532,282650.0,392.0,177.33333333333334
2845088.0,6,3,204,1,68,0.0,68.0,68.0,2,136,0.0,70.0,68.0
14244249.0,17,6,2052,6,2052,2848849.8,342.0,342.0,0,0,0.0,0.0,0.0
206221.0,17,2,762,2,762,0.0,381.0,381.0,0,0,0.0,0.0,0.0
270070.0,6,10,1221,6,636,54014.0,298.0,106.0,4,585,83403.0,379.0,146.25
302210.0,6,6,412,4,272,100736.66666666669,74.0,68.0,2,140,0.0,74.0,70.0
120007099.0,17,29,13785,29,13785,4285967.821428572,501.0,475.3448275862069,0,0,0.0,0.0,0.0
2799281.0,6,2,132,1,66,0.0,66.0,66.0,1,66,0.0,66.0,66.0
119005447.0,17,13,821,7,432,19834241.166666668,174.0,61.71428571428572,6,389,19800167.2,174.0,64.83333333333333
33730.0,6,14,4740,7,653,5499.166666666667,249.0,93.28571428571428,7,4087,5486.833333333333,1514.0,583.8571428571429
46369.0,6,10,2032,5,524,9996.75,252.0,104.8,5,1508,10636.25,1236.0,301.6
1970.0,17,4,344,2,150,0.0,75.0,75.0,2,194,0.0,103.0,97.0
32682118.000000004,6,5,336,2,134,0.0,68.0,67.0,3,202,14949282.5,70.0,67.33333333333333
108103716.0,17,5,955,5,955,27025929.0,191.0,191.0,0,0,0.0,0.0,0.0
41885.0,6,10,2032,5,524,9884.0,252.0,104.8,5,1508,10056.75,1236.0,301.6
406.0,17,2,410,1,78,0.0,78.0,78.0,1,332,0.0,332.0,332.0
49918.0,6,14,4740,7,653,7978.166666666667,249.0,93.28571428571428,7,4087,7074.333333333333,1514.0,583.8571428571429
9820.0,17,2,582,1,83,0.0,83.0,83.0,1,499,0.0,499.0,499.0
120000046.0,6,26,2019,15,1179,8571431.857142856,95.0,78.6,11,840,9093926.8,95.0,76.36363636363636
1185023.0,6,13,3010,8,2382,169289.0,1514.0,297.75,5,628,228089.5,331.0,125.6
34222.0,6,10,2032,5,524,7811.25,252.0,104.8,5,1508,6892.5,1236.0,301.6
10188.0,17,4,344,2,150,0.0,75.0,75.0,2,194,0.0,103.0,97.0
237896.0,17,2,343,1,75,0.0,75.0,75.0,1,268,0.0,268.0,268.0
293.0,17,2,156,1,78,0.0,78.0,78.0,1,78,0.0,78.0,78.0
48676.0,6,14,4740,7,653,6877.666666666667,249.0,93.28571428571428,7,4087,7824.333333333333,1514.0,583.8571428571429
27418320.0,17,5,1710,5,1710,6854580.0,342.0,342.0,0,0,0.0,0.0,0.0
92167.0,6,10,2032,5,524,22777.75,252.0,104.8,5,1508,21884.0,1236.0,301.6
217864.0,6,3,426,2,280,0.0,214.0,140.0,1,146,0.0,146.0,146.0
2345.0,17,4,344,2,150,0.0,75.0,75.0,2,194,0.0,103.0,97.0
284855.0,17,2,363,1,79,0.0,79.0,79.0,1,284,0.0,284.0,284.0
120349651.0,6,217,24452,109,17028,1114348.6203703703,284.0,156.22018348623854,108,7424,1115064.2990654206,140.0,68.74074074074075
120003577.0,6,21,1585,11,840,11999953.8,95.0,76.36363636363636,10,745,13333406.111111112,95.0,74.5
49165.0,6,14,4740,7,653,8069.5,249.0,93.28571428571428,7,4087,7227.833333333333,1514.0,583.8571428571429
40184.0,6,14,4740,7,653,6435.5,249.0,93.28571428571428,7,4087,6484.666666666667,1514.0,583.8571428571429
5831401.0,6,5,336,2,134,0.0,68.0,67.0,3,202,1523195.5,70.0,67.33333333333333
1321232.0,6,4,264,2,132,0.0,66.0,66.0,2,132,0.0,66.0,66.0
1161886.0,6,11,1134,6,558,232377.2,220.0,93.0,5,576,289783.0,304.0,115.2
120001157.0,17,14,864,7,432,20000192.83333333,174.0,61.71428571428572,7,432,16666357.333333334,174.0,61.71428571428572
2735625.0,6,2,132,1,66,0.0,66.0,66.0,1,66,0.0,66.0,66.0
4370.0,17,4,344,2,150,0.0,75.0,75.0,2,194,0.0,103.0,97.0
6852.0,17,2,582,1,83,0.0,83.0,83.0,1,499,0.0,499.0,499.0
98181567.0,6,200,22552,100,15730,989559.4545454546,284.0,157.3,100,6822,989559.7575757576,140.0,68.22
90067602.0,17,27,12943,27,12943,3464138.5384615385,501.0,479.3703703703704,0,0,0.0,0.0,0.0
108104483.0,17,5,955,5,955,27026120.75,191.0,191.0,0,0,0.0,0.0,0.0
110568.0,17,4,1400,4,1400,36856.0,350.0,350.0,0,0,0.0,0.0,0.0
321462.0,17,4,1400,4,1400,107154.0,350.0,350.0,0,0,0.0,0.0,0.0
90063137.0,17,28,13364,28,13364,3335671.7407407407,501.0,477.2857142857143,0,0,0.0,0.0,0.0
204592.0,17,2,762,2,762,0.0,381.0,381.0,0,0,0.0,0.0,0.0
118339802.0,6,230,25994,115,18108,1036180.5789473684,284.0,157.4608695652174,115,7886,1036180.7105263158,140.0,68.57391304347826
101998936.0,6,28,1860,14,966,7829462.461538462,123.0,69.0,14,894,7829467.307692308,123.0,63.85714285714285
90944123.0,6,21,1585,11,840,9093835.3,95.0,76.36363636363636,10,745,10103759.666666666,95.0,74.5
108727767.0,6,33,2428,17,1288,6782710.0,139.0,75.76470588235294,16,1140,7234889.6,123.0,71.25
304342.0,6,6,412,4,272,101447.33333333331,74.0,68.0,2,140,0.0,74.0,70.0
305459.0,6,6,412,4,272,101819.66666666669,74.0,68.0,2,140,0.0,74.0,70.0
26963.0,6,14,4740,7,653,4280.5,249.0,93.28571428571428,7,4087,4355.833333333333,1514.0,583.8571428571429
26302.0,6,11,2098,6,590,5163.6,252.0,98.33333333333331,5,1508,5819.75,1236.0,301.6
191181.0,17,2,180,1,90,0.0,90.0,90.0,1,90,0.0,90.0,90.0
90507104.0,6,174,19666,87,5890,1042873.3255813952,140.0,67.70114942528735,87,13776,1042850.3139534884,284.0,158.3448275862069
512808.00000000006,17,2,363,1,79,0.0,79.0,79.0,1,284,0.0,284.0,284.0
15059701.0,17,6,2718,6,2718,3011940.2,453.0,453.0,0,0,0.0,0.0,0.0
120105762.0,6,232,26200,116,7952,1028635.1130434782,140.0,68.55172413793103,116,18248,1038262.3652173912,284.0,157.31034482758622
23289.0,17,2,582,1,83,0.0,83.0,83.0,1,499,0.0,499.0,499.0
39604.0,6,14,4740,7,653,6477.666666666667,249.0,93.28571428571428,7,4087,6387.5,1514.0,583.8571428571429
4297.0,17,2,598,1,72,0.0,72.0,72.0,1,526,0.0,526.0,526.0
118555305.0,6,228,25660,114,17914,1047257.0088495576,284.0,157.140350877193,114,7746,1047257.0619469028,140.0,67.94736842105263
153422.0,17,2,180,1,90,0.0,90.0,90.0,1,90,0.0,90.0,90.0
90014490.0,6,23,2056,11,799,9001449.0,95.0,72.63636363636364,12,1257,8161736.818181818,256.0,104.75
59214.0,6,14,4740,7,653,8799.166666666666,249.0,93.28571428571428,7,4087,9729.833333333334,1514.0,583.8571428571429
166688.0,17,2,180,1,90,0.0,90.0,90.0,1,90,0.0,90.0,90.0
24891.0,6,14,4740,7,653,3985.1666666666665,249.0,93.28571428571428,7,4087,3807.3333333333335,1514.0,583.8571428571429
110920740.0,6,35,2542,18,1348,6512632.588235294,139.0,74.88888888888889,17,1194,6919720.8125,123.0,70.23529411764706
108095763.0,17,5,955,5,955,27023940.75,191.0,191.0,0,0,0.0,0.0,0.0
38703627.0,17,14,10511,14,10511,2977202.076923077,761.0,750.7857142857143,0,0,0.0,0.0,0.0
108105059.0,17,5,955,5,955,27026264.75,191.0,191.0,0,0,0.0,0.0,0.0
120076283.0,17,28,13364,28,13364,4447269.740740741,501.0,477.2857142857143,0,0,0.0,0.0,0.0
865744.0,6,9,1268,6,797,173148.8,459.0,132.83333333333334,3,471,295058.5,331.0,157.0
299069.0,6,6,412,4,272,99689.66666666669,74.0,68.0,2,140,0.0,74.0,70.0
2069.0,17,4,344,2,150,0.0,75.0,75.0,2,194,0.0,103.0,97.0
221674.0,6,10,1221,6,636,44334.8,298.0,106.0,4,585,72595.0,379.0,146.25
47493.0,6,14,4740,7,653,7301.333333333333,249.0,93.28571428571428,7,4087,6960.333333333333,1514.0,583.8571428571429
48049.0,6,14,4740,7,653,7128.666666666667,249.0,93.28571428571428,7,4087,7871.333333333333,1514.0,583.8571428571429
205890.0,17,2,180,1,90,0.0,90.0,90.0,1,90,0.0,90.0,90.0
90274170.0,6,12,1832,8,1016,12896310.0,188.0,127.0,4,816,30037528.33333333,204.0,204.0
113614561.0,6,46,3036,23,1518,5150437.363636363,66.0,66.0,23,1518,5150443.545454546,66.0,66.0
40479.0,6,10,2032,5,524,9823.75,252.0,104.8,5,1508,9864.75,1236.0,301.6
19582.0,6,14,4740,7,653,2849.6666666666665,249.0,93.28571428571428,7,4087,3127.0,1514.0,583.8571428571429
159765.0,6,11,1132,6,556,31953.0,218.0,92.66666666666669,5,576,39500.75,304.0,115.2
470.0,17,2,762,2,762,0.0,381.0,381.0,0,0,0.0,0.0,0.0
40587.0,6,10,2032,5,524,9165.25,252.0,104.8,5,1508,9073.5,1236.0,301.6
31820.0,6,14,4740,7,653,5005.833333333333,249.0,93.28571428571428,7,4087,5105.166666666667,1514.0,583.8571428571429
48164.0,6,13,1479,7,882,7687.166666666667,291.0,126.0,6,597,8114.6,259.0,99.5
90531954.0,6,14,2240,8,1016,12933136.285714284,188.0,127.0,6,1224,18073780.6,204.0,204.0
147406.0,6,3,373,2,238,0.0,172.0,119.0,1,135,0.0,135.0,135.0
44892.0,6,14,4740,7,653,7355.166666666667,249.0,93.28571428571428,7,4087,7081.333333333333,1514.0,583.8571428571429
134274.0,6,3,337,2,214,0.0,160.0,107.0,1,123,0.0,123.0,123.0
53094.0,6,14,4740,7,653,7826.333333333333,249.0,93.28571428571428,7,4087,8615.166666666666,1514.0,583.8571428571429
350.0,17,2,166,1,75,0.0,75.0,75.0,1,91,0.0,91.0,91.0
301949.0,6,6,412,4,272,100649.66666666669,74.0,68.0,2,140,0.0,74.0,70.0
232155.0,6,3,337,2,214,0.0,160.0,107.0,1,123,0.0,123.0,123.0
162391.0,17,2,180,1,90,0.0,90.0,90.0,1,90,0.0,90.0,90.0
135135550.0,17,6,1206,6,1206,27027110.0,201.0,201.0,0,0,0.0,0.0,0.0
120135986.0,6,229,25710,115,7812,1053824.4385964912,140.0,67.9304347826087,114,17898,1056162.3628318585,284.0,157.0
21830.0,6,14,4740,7,653,3280.333333333333,249.0,93.28571428571428,7,4087,3504.5,1514.0,583.8571428571429
207301.0,6,3,426,2,280,0.0,214.0,140.0,1,146,0.0,146.0,146.0
210117.0,6,3,426,2,280,0.0,214.0,140.0,1,146,0.0,146.0,146.0
21987.0,17,2,180,1,90,0.0,90.0,90.0,1,90,0.0,90.0,90.0
3015010.0,6,11,2106,6,598,602822.2,252.0,99.66666666666669,5,1508,2799.5,1236.0,301.6
135129613.0,17,6,1146,6,1146,27025922.6,191.0,191.0,0,0,0.0,0.0,0.0
108107355.0,17,5,1005,5,1005,27026838.75,201.0,201.0,0,0,0.0,0.0,0.0
531277.0,6,5,367,2,132,0.0,66.0,66.0,3,235,265638.5,103.0,78.33333333333333
315.0,17,2,174,1,79,0.0,79.0,79.0,1,95,0.0,95.0,95.0
818.0,17,4,438,2,148,0.0,74.0,74.0,2,290,0.0,147.0,145.0
143969.0,17,2,180,1,90,0.0,90.0,90.0,1,90,0.0,90.0,90.0
164274.0,17,2,180,1,90,0.0,90.0,90.0,1,90,0.0,90.0,90.0
3384.0,17,2,414,1,88,0.0,88.0,88.0,1,326,0.0,326.0,326.0
157841.0,17,2,180,1,90,0.0,90.0,90.0,1,90,0.0,90.0,90.0
103001013.0,17,13,821,7,432,17166835.5,174.0,61.71428571428572,6,389,16600936.8,174.0,64.83333333333333
228349.0,17,2,180,1,90,0.0,90.0,90.0,1,90,0.0,90.0,90.0
91242224.0,17,14,1126,7,563,15166810.166666666,174.0,80.42857142857143,7,563,15167650.166666666,174.0,80.42857142857143
90033479.0,17,27,12943,27,12943,3462826.1153846155,501.0,479.3703703703704,0,0,0.0,0.0,0.0
90049974.0,17,28,13364,28,13364,3335184.222222222,501.0,477.2857142857143,0,0,0.0,0.0,0.0
127006316.0,17,15,907,8,475,18143759.42857143,174.0,59.375,7,432,17666841.333333332,174.0,61.71428571428572
31901.0,6,14,4740,7,653,4649.666666666667,249.0,93.28571428571428,7,4087,4918.0,1514.0,583.8571428571429
2801234.0,6,2,132,1,66,0.0,66.0,66.0,1,66,0.0,66.0,66.0
110648858.0,6,32,2220,16,1149,7362191.2,123.0,71.8125,16,1071,7362188.133333334,123.0,66.9375
113610296.0,6,46,3036,23,1518,5150437.045454546,66.0,66.0,23,1518,5150432.681818182,66.0,66.0
2306.0,17,4,344,2,150,0.0,75.0,75.0,2,194,0.0,103.0,97.0
108109474.0,17,5,955,5,955,27027368.5,191.0,191.0,0,0,0.0,0.0,0.0
289.0,17,2,174,1,79,0.0,79.0,79.0,1,95,0.0,95.0,95.0
866146.0,6,10,1336,6,799,173229.2,461.0,133.16666666666666,4,537,197899.3333333333,331.0,134.25
26535.0,17,2,180,1,90,0.0,90.0,90.0,1,90,0.0,90.0,90.0
135130311.0,17,6,1146,6,1146,27026062.2,191.0,191.0,0,0,0.0,0.0,0.0
3015312.0,6,11,2106,6,598,602874.4,252.0,99.66666666666669,5,1508,2731.25,1236.0,301.6
3086.0,17,2,224,1,76,0.0,76.0,76.0,1,148,0.0,148.0,148.0
3110925.0,6,3,1602,1,752,0.0,752.0,752.0,2,850,0.0,784.0,425.0
119185464.0,6,37,2650,19,1302,6621414.666666667,123.0,68.52631578947368,18,1348,6410863.470588235,139.0,74.88888888888889
837682.0,6,9,1118,6,586,167536.4,248.0,97.66666666666669,3,532,282526.5,392.0,177.33333333333334
115565978.0,6,48,3168,24,1584,5024607.739130435,66.0,66.0,24,1584,5010937.217391305,66.0,66.0
300042.0,6,6,412,4,272,100014.0,74.0,68.0,2,140,0.0,74.0,70.0
59810.0,6,12,1320,6,723,11471.4,253.0,120.5,6,597,11230.8,259.0,99.5
819.0,17,4,438,2,148,0.0,74.0,74.0,2,290,0.0,147.0,145.0
1303043.0,6,4,264,2,132,0.0,66.0,66.0,2,132,0.0,66.0,66.0
1161361.0,6,13,3010,8,2382,165908.7142857143,1514.0,297.75,5,628,222139.25,331.0,125.6
100632.0,17,2,762,2,762,0.0,381.0,381.0,0,0,0.0,0.0,0.0
3137639.0,6,3,204,2,136,0.0,70.0,68.0,1,68,0.0,68.0,68.0
303756.0,6,6,412,4,272,101252.0,74.0,68.0,2,140,0.0,74.0,70.0
25153001.0,17,5,1718,4,1368,1810921.6666666667,342.0,342.0,1,350,0.0,350.0,350.0
120065609.0,17,28,13364,28,13364,4446874.407407408,501.0,477.2857142857143,0,0,0.0,0.0,0.0
123840043.0,6,49,3234,25,1650,5160001.791666667,66.0,66.0,24,1584,4995229.0869565215,66.0,66.0
26468.0,6,10,2032,5,524,6326.75,252.0,104.8,5,1508,6344.25,1236.0,301.6
119872599.0,17,34,16284,34,16284,3632503.0,501.0,478.9411764705882,0,0,0.0,0.0,0.0
148120.0,6,3,337,2,214,0.0,160.0,107.0,1,123,0.0,123.0,123.0
65849.0,17,2,180,1,90,0.0,90.0,90.0,1,90,0.0,90.0,90.0
325901.0,6,6,412,4,272,108633.66666666669,74.0,68.0,2,140,0.0,74.0,70.0
234523.0,6,3,337,2,214,0.0,160.0,107.0,1,123,0.0,123.0,123.0
913102.0,6,12,2710,7,743,152183.66666666666,339.0,106.14285714285714,5,1967,159367.25,1514.0,393.4
35609.0,6,10,2032,5,524,7834.0,252.0,104.8,5,1508,8618.25,1236.0,301.6
56814.0,6,12,1320,7,789,9469.0,253.0,112.71428571428572,5,531,11772.5,259.0,106.2
153448.0,17,2,180,1,90,0.0,90.0,90.0,1,90,0.0,90.0,90.0
20467.0,6,2,145,2,145,0.0,91.0,72.5,0,0,0.0,0.0,0.0
372.0,17,2,267,1,83,0.0,83.0,83.0,1,184,0.0,184.0,184.0
2114.0,17,4,344,2,150,0.0,75.0,75.0,2,194,0.0,103.0,97.0
16862.0,17,2,180,1,90,0.0,90.0,90.0,1,90,0.0,90.0,90.0
2442.0,17,4,344,2,150,0.0,75.0,75.0,2,194,0.0,103.0,97.0
1563987.0,17,6,1230,3,234,781808.5,78.0,78.0,3,996,781790.5,332.0,332.0
90036938.0,17,28,13364,28,13364,3334701.407407407,501.0,477.2857142857143,0,0,0.0,0.0,0.0
120121787.0,6,14,2224,9,1204,15015223.375,188.0,133.77777777777777,5,1020,22522712.0,204.0,204.0
33182197.000000004,6,5,336,2,134,0.0,68.0,67.0,3,202,15290875.0,70.0,67.33333333333333
2351.0,17,4,344,2,150,0.0,75.0,75.0,2,194,0.0,103.0,97.0
214495.0,17,4,1524,4,1524,71498.33333333333,381.0,381.0,0,0,0.0,0.0,0.0
64754.00000000001,6,14,4740,7,653,9878.833333333334,249.0,93.28571428571428,7,4087,10646.666666666666,1514.0,583.8571428571429
209563.0,17,2,180,1,90,0.0,90.0,90.0,1,90,0.0,90.0,90.0
10472782.0,6,7,478,4,272,3445525.333333333,74.0,68.0,3,206,5168200.0,74.0,68.66666666666667
216332.0,17,2,180,1,90,0.0,90.0,90.0,1,90,0.0,90.0,90.0
114022638.0,6,31,2113,16,1071,7601509.2,123.0,66.9375,15,1042,8129707.071428572,139.0,69.46666666666667
0.0,17,1,55,1,55,0.0,55.0,55.0,0,0,0.0,0.0,0.0
2795973.0,6,2,132,1,66,0.0,66.0,66.0,1,66,0.0,66.0,66.0
145030.0,6,2,132,1,66,0.0,66.0,66.0,1,66,0.0,66.0,66.0
228327.0,17,2,180,1,90,0.0,90.0,90.0,1,90,0.0,90.0,90.0
135135298.0,17,6,1206,6,1206,27027059.6,201.0,201.0,0,0,0.0,0.0,0.0
157272.0,6,3,337,2,214,0.0,160.0,107.0,1,123,0.0,123.0,123.0
209693.0,17,2,180,1,90,0.0,90.0,90.0,1,90,0.0,90.0,90.0
24820.0,6,10,2032,5,524,5978.0,252.0,104.8,5,1508,5951.75,1236.0,301.6
245273.0,6,2,132,1,66,0.0,66.0,66.0,1,66,0.0,66.0,66.0
107933864.0,6,30,2106,15,1089,7694146.142857143,123.0,72.6,15,1017,7694145.714285715,123.0,67.8
9815.0,6,10,2032,5,524,1975.5,252.0,104.8,5,1508,2152.75,1236.0,301.6
31749.0,6,14,4740,7,653,4694.5,249.0,93.28571428571428,7,4087,4154.166666666667,1514.0,583.8571428571429
2348.0,17,4,344,2,150,0.0,75.0,75.0,2,194,0.0,103.0,97.0
103420966.0,6,29,1999,15,1105,7387211.857142857,139.0,73.66666666666667,14,894,7731190.615384615,123.0,63.85714285714285
205954.0,6,3,426,2,280,0.0,214.0,140.0,1,146,0.0,146.0,146.0
25193.0,6,14,4740,7,653,3870.5,249.0,93.28571428571428,7,4087,4046.0,1514.0,583.8571428571429
44680.0,6,14,4740,7,653,7321.666666666667,249.0,93.28571428571428,7,4087,7257.0,1514.0,583.8571428571429
294538.0,17,2,224,1,76,0.0,76.0,76.0,1,148,0.0,148.0,148.0
303960.0,6,7,478,4,272,101320.0,74.0,68.0,3,206,74712.5,74.0,68.66666666666667
41068.0,6,10,2032,5,524,7650.75,252.0,104.8,5,1508,9803.25,1236.0,301.6
16443869.0,17,6,2052,6,2052,3288773.8,342.0,342.0,0,0,0.0,0.0,0.0
190939.0,17,2,180,1,90,0.0,90.0,90.0,1,90,0.0,90.0,90.0
103739.0,17,2,286,2,286,0.0,143.0,143.0,0,0,0.0,0.0,0.0
97010792.0,6,179,20250,90,6162,1090008.8988764044,140.0,68.46666666666667,89,14088,1090594.6136363635,284.0,158.2921348314607
49899.0,6,14,4740,7,653,8123.5,249.0,93.28571428571428,7,4087,8164.666666666667,1514.0,583.8571428571429
134593.0,6,11,1132,6,556,26918.6,218.0,92.66666666666669,5,576,32741.75,304.0,115.2
233173.0,6,3,373,2,238,0.0,172.0,119.0,1,135,0.0,135.0,135.0
19574.0,6,10,2032,5,524,4652.5,252.0,104.8,5,1508,4167.25,1236.0,301.6
108714420.0,6,33,2428,17,1288,6794651.25,139.0,75.76470588235294,16,1140,7233206.133333334,123.0,71.25
108103091.0,17,5,955,5,955,27025772.75,191.0,191.0,0,0,0.0,0.0,0.0
90287748.0,6,19,1436,10,745,10026647.555555556,95.0,74.5,9,691,11284377.5,95.0,76.77777777777777
15012.0,17,2,180,1,90,0.0,90.0,90.0,1,90,0.0,90.0,90.0
9021759.0,17,4,1812,4,1812,3007253.0,453.0,453.0,0,0,0.0,0.0,0.0
122028567.0,6,31,2166,15,1017,8003098.214285715,123.0,67.8,16,1149,7469550.066666666,123.0,71.8125
90046434.0,17,28,13364,28,13364,3335053.111111111,501.0,477.2857142857143,0,0,0.0,0.0,0.0
2616924.0,6,25,7573,14,3735,201301.84615384616,1514.0,266.7857142857143,11,3838,235993.1,1514.0,348.90909090909093
102261599.0,6,310,35286,155,24834,662700.4025974026,284.0,160.21935483870968,155,10452,662700.6363636364,140.0,67.43225806451613
123790523.0,6,49,3234,25,1650,5157938.458333333,66.0,66.0,24,1584,5065631.695652174,66.0,66.0
125790856.0,6,59,12449,31,6590,3224679.466666667,1514.0,212.5806451612904,28,5859,4651299.222222222,1514.0,209.25
114527245.0,6,48,3168,24,1584,4979445.434782608,66.0,66.0,24,1584,4966064.0,66.0,66.0
5604559.0,17,4,692,2,156,0.0,78.0,78.0,2,536,0.0,268.0,268.0
233179.0,6,3,337,2,214,0.0,160.0,107.0,1,123,0.0,123.0,123.0
42296.0,6,14,4740,7,653,6664.166666666667,249.0,93.28571428571428,7,4087,6146.333333333333,1514.0,583.8571428571429
102879740.0,6,41,2706,21,1386,5143987.0,66.0,66.0,20,1320,5115694.210526316,66.0,66.0
76768606.0,17,14,4788,14,4788,5905277.384615385,342.0,342.0,0,0,0.0,0.0,0.0
110120960.0,6,28,1860,14,966,8454250.461538462,123.0,69.0,14,894,8454250.846153846,123.0,63.85714285714285
94065354.0,6,174,19650,87,13686,1091280.9302325582,284.0,157.31034482758622,87,5964,1091281.1976744186,140.0,68.55172413793103
212914.0,17,2,762,2,762,0.0,381.0,381.0,0,0,0.0,0.0,0.0
38730.0,6,14,4740,7,653,6328.166666666667,249.0,93.28571428571428,7,4087,6181.166666666667,1514.0,583.8571428571429
206218.0,6,3,426,2,280,0.0,214.0,140.0,1,146,0.0,146.0,146.0
130819.0,6,3,337,2,214,0.0,160.0,107.0,1,123,0.0,123.0,123.0
126907183.0,6,32,2167,16,1002,7947775.733333333,123.0,62.625,16,1165,7794776.066666666,139.0,72.8125
123016142.0,6,34,2482,17,1194,7064406.875,123.0,70.23529411764706,17,1288,7064410.625,139.0,75.76470588235294
135217.0,6,2,132,1,66,0.0,66.0,66.0,1,66,0.0,66.0,66.0
146681.0,6,3,337,2,214,0.0,160.0,107.0,1,123,0.0,123.0,123.0
47362.0,6,14,4740,7,653,7539.666666666667,249.0,93.28571428571428,7,4087,5929.166666666667,1514.0,583.8571428571429
0.0,17,1,179,1,179,0.0,179.0,179.0,0,0,0.0,0.0,0.0
34380.0,6,10,2032,5,524,7723.5,252.0,104.8,5,1508,7769.0,1236.0,301.6
6538.0,17,4,823,2,163,0.0,89.0,81.5,2,660,0.0,443.0,330.0
2183587.0,6,2,132,1,66,0.0,66.0,66.0,1,66,0.0,66.0,66.0
26655.0,6,10,2032,5,524,6168.0,252.0,104.8,5,1508,4748.75,1236.0,301.6
244885.0,6,3,337,2,214,0.0,160.0,107.0,1,123,0.0,123.0,123.0
93360916.0,6,40,2640,20,1320,4913732.421052632,66.0,66.0,20,1320,4897184.894736842,66.0,66.0
21207.0,6,11,1133,6,602,3708.8,264.0,100.33333333333331,5,531,4190.25,259.0,106.2
44020.0,6,14,4740,7,653,6530.5,249.0,93.28571428571428,7,4087,7201.833333333333,1514.0,583.8571428571429
857294.0,6,9,1268,6,797,171458.8,459.0,132.83333333333334,3,471,290877.5,331.0,157.0
26287.0,6,10,2032,5,524,6129.5,252.0,104.8,5,1508,5792.75,1236.0,301.6
86.0,17,2,762,2,762,0.0,381.0,381.0,0,0,0.0,0.0,0.0
6143734.0,6,37,19834,20,1898,323354.4210526316,369.0,94.9,17,17936,192448.4375,1514.0,1055.0588235294117
108319186.0,6,18,1400,9,750,13508373.875,154.0,83.33333333333333,9,650,13512965.0,95.0,72.22222222222223
16738.0,6,11,2098,6,590,2768.8,252.0,98.33333333333331,5,1508,3866.25,1236.0,301.6
112451388.0,6,32,2236,16,1165,7482376.0,139.0,72.8125,16,1071,7482373.533333333,123.0,66.9375
217015.0,17,2,180,1,90,0.0,90.0,90.0,1,90,0.0,90.0,90.0
2094.0,17,4,344,2,150,0.0,75.0,75.0,2,194,0.0,103.0,97.0
69951.0,6,14,4740,7,653,11239.5,249.0,93.28571428571428,7,4087,11179.0,1514.0,583.8571428571429
1236342.0,17,7,490,7,490,206057.0,70.0,70.0,0,0,0.0,0.0,0.0
316267.0,6,6,412,4,272,105422.33333333331,74.0,68.0,2,140,0.0,74.0,70.0
316114.0,17,4,1400,4,1400,105371.33333333331,350.0,350.0,0,0,0.0,0.0,0.0
109505.0,17,4,1400,4,1400,36501.66666666666,350.0,350.0,0,0,0.0,0.0,0.0
904.0,17,4,438,2,148,0.0,74.0,74.0,2,290,0.0,147.0,145.0
240081.0,6,3,373,2,238,0.0,172.0,119.0,1,135,0.0,135.0,135.0
73696.0,6,14,4740,7,653,12161.666666666666,249.0,93.28571428571428,7,4087,11773.166666666666,1514.0,583.8571428571429
419659.0,6,3,1604,2,851,0.0,785.0,425.5,1,753,0.0,753.0,753.0
108105618.0,17,5,955,5,955,27026404.5,191.0,191.0,0,0,0.0,0.0,0.0
10488223.0,6,7,478,4,272,3450485.333333333,74.0,68.0,3,206,5175594.5,74.0,68.66666666666667
118499877.0,6,35,2542,18,1348,6957879.05882353,139.0,74.88888888888889,17,1194,7392574.5625,123.0,70.23529411764706
111536.0,17,2,286,2,286,0.0,143.0,143.0,0,0,0.0,0.0,0.0
118940800.0,6,48,3168,24,1584,5171339.130434782,66.0,66.0,24,1584,5157755.956521739,66.0,66.0
58821.0,6,14,4740,7,653,9592.0,249.0,93.28571428571428,7,4087,8926.833333333334,1514.0,583.8571428571429
157397.0,6,3,337,2,214,0.0,160.0,107.0,1,123,0.0,123.0,123.0
12518.0,6,10,1065,5,534,2670.5,262.0,106.8,5,531,2767.5,259.0,106.2
44456.0,6,14,4740,7,653,6934.333333333333,249.0,93.28571428571428,7,4087,7089.333333333333,1514.0,583.8571428571429
105011235.0,17,14,864,7,432,17500180.0,174.0,61.71428571428572,7,432,17500854.333333332,174.0,61.71428571428572
2608343.0,6,2,132,1,66,0.0,66.0,66.0,1,66,0.0,66.0,66.0
70415.0,6,14,4740,7,653,11610.0,249.0,93.28571428571428,7,4087,11604.666666666666,1514.0,583.8571428571429
99.0,17,2,762,2,762,0.0,381.0,381.0,0,0,0.0,0.0,0.0
9243955.0,17,3,1034,2,684,0.0,342.0,342.0,1,350,0.0,350.0,350.0
90294631.0,6,16,1192,8,596,12893352.142857144,95.0,74.5,8,596,12898795.0,95.0,74.5
22220.0,17,2,582,1,83,0.0,83.0,83.0,1,499,0.0,499.0,499.0
511152.00000000006,6,5,336,2,134,0.0,68.0,67.0,3,202,193254.5,70.0,67.33333333333333
44877.0,6,20,7606,11,978,4487.7,310.0,88.9090909090909,9,6628,5428.125,1514.0,736.4444444444445
101699.0,6,2,132,1,66,0.0,66.0,66.0,1,66,0.0,66.0,66.0
2097.0,17,4,344,2,150,0.0,75.0,75.0,2,194,0.0,103.0,97.0
147831.0,17,2,180,1,90,0.0,90.0,90.0,1,90,0.0,90.0,90.0
141.0,17,2,700,2,700,0.0,350.0,350.0,0,0,0.0,0.0,0.0
3084.0,17,2,180,1,90,0.0,90.0,90.0,1,90,0.0,90.0,90.0
107835488.0,6,28,1860,14,966,8278440.076923077,123.0,69.0,14,894,8278437.461538462,123.0,63.85714285714285
116168082.0,6,48,3168,24,1584,5050786.173913044,66.0,66.0,24,1584,5038812.304347826,66.0,66.0
106854.0,17,2,286,2,286,0.0,143.0,143.0,0,0,0.0,0.0,0.0
152375.0,17,4,6056,4,6056,50791.66666666666,1514.0,1514.0,0,0,0.0,0.0,0.0
122510.0,6,3,373,2,238,0.0,172.0,119.0,1,135,0.0,135.0,135.0
14010.0,6,11,1131,6,600,2616.6,262.0,100.0,5,531,3177.25,259.0,106.2
90043504.0,17,27,12943,27,12943,3463211.6923076925,501.0,479.3703703703704,0,0,0.0,0.0,0.0
133660.0,6,2,132,1,66,0.0,66.0,66.0,1,66,0.0,66.0,66.0
218772.0,17,4,1400,4,1400,72924.0,350.0,350.0,0,0,0.0,0.0,0.0
144034.0,17,2,180,1,90,0.0,90.0,90.0,1,90,0.0,90.0,90.0
259994.0,6,10,1221,6,636,51998.8,298.0,106.0,4,585,81327.33333333333,379.0,146.25
101332.0,17,2,762,2,762,0.0,381.0,381.0,0,0,0.0,0.0,0.0
120361319.0,6,218,24518,109,7490,1087714.8796296297,140.0,68.71559633027523,109,17028,1106853.6851851852,284.0,156.22018348623854
41735.0,6,14,4740,7,653,6364.666666666667,249.0,93.28571428571428,7,4087,6350.333333333333,1514.0,583.8571428571429
209189.0,6,3,426,2,280,0.0,214.0,140.0,1,146,0.0,146.0,146.0
98268729.0,6,25,1686,13,840,8189060.75,123.0,64.61538461538461,12,846,8006125.454545454,123.0,70.5
1766553.0,6,2,132,1,66,0.0,66.0,66.0,1,66,0.0,66.0,66.0
205754.0,17,2,180,1,90,0.0,90.0,90.0,1,90,0.0,90.0,90.0
34478.0,6,14,4740,7,653,5429.333333333333,249.0,93.28571428571428,7,4087,5443.666666666667,1514.0,583.8571428571429
100603531.0,17,16,1474,8,737,14371933.0,174.0,92.125,8,737,14271199.57142857,174.0,92.125
123456080.0,6,49,3234,25,1650,5144003.333333333,66.0,66.0,24,1584,5127296.434782608,66.0,66.0
90294796.0,6,16,1192,8,596,12892326.142857144,95.0,74.5,8,596,12898330.42857143,95.0,74.5
14266577.0,17,6,2052,6,2052,2853315.4,342.0,342.0,0,0,0.0,0.0,0.0
2430794.0,6,28,9195,16,3843,162052.93333333332,1514.0,240.1875,12,5352,196479.2727272728,1514.0,446.0
146257.0,6,3,337,2,214,0.0,160.0,107.0,1,123,0.0,123.0,123.0
1808.0,17,4,344,2,150,0.0,75.0,75.0,2,194,0.0,103.0,97.0
1114432.0,6,12,1373,7,714,185738.66666666663,298.0,102.0,5,659,277853.25,379.0,131.8
5214.0,17,4,344,2,150,0.0,75.0,75.0,2,194,0.0,103.0,97.0
162183.0,17,2,180,1,90,0.0,90.0,90.0,1,90,0.0,90.0,90.0
99730024.0,6,30,2106,15,1089,7123573.142857143,123.0,72.6,15,1017,7108079.571428572,123.0,67.8
38595.0,6,14,4740,7,653,5767.5,249.0,93.28571428571428,7,4087,5922.5,1514.0,583.8571428571429
155681.0,6,3,337,2,214,0.0,160.0,107.0,1,123,0.0,123.0,123.0
516868.0,6,10,1221,6,636,103373.6,298.0,106.0,4,585,166925.0,379.0,146.25
111705063.0,6,30,1974,15,1026,7963529.857142857,123.0,68.4,15,948,7963528.571428572,123.0,63.2
1866554.0,17,3,1026,3,1026,933277.0,342.0,342.0,0,0,0.0,0.0,0.0
771.0,17,4,438,2,148,0.0,74.0,74.0,2,290,0.0,147.0,145.0
20105.0,6,2,145,2,145,0.0,91.0,72.5,0,0,0.0,0.0,0.0
108104841.0,17,5,955,5,955,27026210.25,191.0,191.0,0,0,0.0,0.0,0.0
39732.0,6,10,2032,5,524,8598.5,252.0,104.8,5,1508,9224.5,1236.0,301.6
3046282.0,6,4,270,3,202,1523141.0,70.0,67.33333333333333,1,68,0.0,68.0,68.0
90294365.0,6,16,1192,8,596,12893057.0,95.0,74.5,8,596,12898394.57142857,95.0,74.5
298422.0,6,6,412,4,272,99474.0,74.0,68.0,2,140,0.0,74.0,70.0
298525.0,6,6,412,4,272,99508.33333333331,74.0,68.0,2,140,0.0,74.0,70.0
767.0,17,5,550,5,550,191.75,110.0,110.0,0,0,0.0,0.0,0.0
90256771.0,6,12,1832,8,1016,12893824.42857143,188.0,127.0,4,816,30030638.33333333,204.0,204.0
11268.0,6,13,1459,7,862,1836.5,271.0,123.14285714285714,6,597,2082.4,259.0,99.5
1314453.0,6,4,264,2,132,0.0,66.0,66.0,2,132,0.0,66.0,66.0
232944.0,6,3,337,2,214,0.0,160.0,107.0,1,123,0.0,123.0,123.0
47880.0,6,14,4740,7,653,7858.333333333333,249.0,93.28571428571428,7,4087,7328.5,1514.0,583.8571428571429
20973.0,6,10,1066,5,490,4326.25,218.0,98.0,5,576,5042.5,304.0,115.2
114305.0,17,2,286,2,286,0.0,143.0,143.0,0,0,0.0,0.0,0.0
5615013.0,6,5,336,2,134,0.0,68.0,67.0,3,202,1370216.5,70.0,67.33333333333333
2337.0,17,4,344,2,150,0.0,75.0,75.0,2,194,0.0,103.0,97.0
108102964.0,17,5,955,5,955,27025741.0,191.0,191.0,0,0,0.0,0.0,0.0
108117874.0,17,5,1005,5,1005,27029468.5,201.0,201.0,0,0,0.0,0.0,0.0
138191.0,6,2,132,1,66,0.0,66.0,66.0,1,66,0.0,66.0,66.0
62799.99999999999,6,10,2032,5,524,15442.0,252.0,104.8,5,1508,15048.75,1236.0,301.6
12224.0,6,11,1133,6,602,2386.2,264.0,100.33333333333331,5,531,2440.5,259.0,106.2
375787.0,6,10,1221,6,636,75157.4,298.0,106.0,4,585,123807.33333333331,379.0,146.25
209192.0,6,10,1221,6,636,41838.4,298.0,106.0,4,585,68583.0,379.0,146.25
42336.0,6,14,4740,7,653,6942.333333333333,249.0,93.28571428571428,7,4087,4843.666666666667,1514.0,583.8571428571429
135132992.0,17,6,1206,6,1206,27026598.4,201.0,201.0,0,0,0.0,0.0,0.0
16011.000000000002,6,11,1131,6,600,2430.6,262.0,100.0,5,531,3659.5,259.0,106.2
2988207.0,6,12,2172,7,664,497864.1666666667,252.0,94.85714285714286,5,1508,3077.25,1236.0,301.6
90269167.0,6,12,1832,8,1016,12895595.285714284,188.0,127.0,4,816,30035232.0,204.0,204.0
3073432.0,6,3,204,2,136,0.0,70.0,68.0,1,68,0.0,68.0,68.0
108689108.0,6,39,3040,21,1654,5424226.15,139.0,78.76190476190476,18,1386,6381294.705882353,123.0,77.0
166856.0,17,2,180,1,90,0.0,90.0,90.0,1,90,0.0,90.0,90.0
397.0,17,2,174,1,79,0.0,79.0,79.0,1,95,0.0,95.0,95.0
109345.0,17,2,286,2,286,0.0,143.0,143.0,0,0,0.0,0.0,0.0
90028833.0,17,28,13364,28,13364,3334401.222222222,501.0,477.2857142857143,0,0,0.0,0.0,0.0
108104798.0,17,5,1005,5,1005,27026199.5,201.0,201.0,0,0,0.0,0.0,0.0
231308.0,6,3,426,2,280,0.0,214.0,140.0,1,146,0.0,146.0,146.0
275217.0,6,3,426,2,280,0.0,214.0,140.0,1,146,0.0,146.0,146.0
2352.0,17,4,344,2,150,0.0,75.0,75.0,2,194,0.0,103.0,97.0
120032098.0,17,28,13364,28,13364,4445633.259259259,501.0,477.2857142857143,0,0,0.0,0.0,0.0
103108775.0,6,41,2706,21,1386,5155438.75,66.0,66.0,20,1320,5263868.52631579,66.0,66.0
120154798.0,6,12,1832,8,1016,17142021.85714286,188.0,127.0,4,816,30040668.0,204.0,204.0
153459.0,17,2,180,1,90,0.0,90.0,90.0,1,90,0.0,90.0,90.0
310428.0,17,4,1400,4,1400,103476.0,350.0,350.0,0,0,0.0,0.0,0.0
256516.00000000003,17,4,6056,4,6056,85505.33333333333,1514.0,1514.0,0,0,0.0,0.0,0.0
90550429.0,6,15,2444,8,1016,12935775.57142857,188.0,127.0,7,1428,15064801.166666666,204.0,204.0
216483.0,17,2,180,1,90,0.0,90.0,90.0,1,90,0.0,90.0,90.0
1158.0,17,4,438,2,148,0.0,74.0,74.0,2,290,0.0,147.0,145.0
112038.0,17,2,700,2,700,0.0,350.0,350.0,0,0,0.0,0.0,0.0
249974.0,17,4,6056,4,6056,83324.66666666667,1514.0,1514.0,0,0,0.0,0.0,0.0
197096.0,17,2,180,1,90,0.0,90.0,90.0,1,90,0.0,90.0,90.0
116094202.0,17,14,864,7,432,19167674.33333333,174.0,61.71428571428572,7,432,19166833.83333333,174.0,61.71428571428572
57872.0,6,14,4740,7,653,9526.166666666666,249.0,93.28571428571428,7,4087,8176.0,1514.0,583.8571428571429
90032351.0,17,27,12943,27,12943,3462782.730769231,501.0,479.3703703703704,0,0,0.0,0.0,0.0
1244437.0,6,7,499,4,301,389778.0,103.0,75.25,3,198,614135.5,66.0,66.0
95888553.0,6,305,39160,153,10320,630845.7434210526,140.0,67.45098039215686,152,28840,628825.0662251656,336.0,189.73684210526315
146012.0,6,3,337,2,214,0.0,160.0,107.0,1,123,0.0,123.0,123.0
90093096.0,6,10,1440,7,828,15015516.0,188.0,118.28571428571428,3,612,30030993.5,204.0,204.0
241808.0,6,3,337,2,214,0.0,160.0,107.0,1,123,0.0,123.0,123.0
2444.0,17,4,344,2,150,0.0,75.0,75.0,2,194,0.0,103.0,97.0
152342.0,17,4,6056,4,6056,50780.66666666666,1514.0,1514.0,0,0,0.0,0.0,0.0
90041162.0,17,28,13364,28,13364,3334857.851851852,501.0,477.2857142857143,0,0,0.0,0.0,0.0
60240.0,6,14,4740,7,653,9916.166666666666,249.0,93.28571428571428,7,4087,9365.666666666666,1514.0,583.8571428571429
232929.0,6,3,337,2,214,0.0,160.0,107.0,1,123,0.0,123.0,123.0
2007918.0,17,4,525,2,150,0.0,75.0,75.0,2,375,0.0,284.0,187.5
115413748.0,6,220,24756,110,17200,1056868.4587155962,284.0,156.36363636363637,110,7556,1056868.1009174313,140.0,68.69090909090909
119519445.0,6,216,24424,108,17000,1115093.093457944,284.0,157.40740740740742,108,7424,1115092.5607476635,140.0,68.74074074074075
1170023.0,6,13,3010,8,2382,167146.14285714287,1514.0,297.75,5,628,223618.25,331.0,125.6
120158436.0,6,226,25550,113,7754,1065497.4732142857,140.0,68.61946902654867,113,17796,1065448.0625,284.0,157.4867256637168
160328.0,6,2,128,1,74,0.0,74.0,74.0,1,54,0.0,54.0,54.0
100031266.0,17,12,778,6,389,20000164.6,174.0,64.83333333333333,6,389,20001007.8,174.0,64.83333333333333
44158.0,6,10,2032,5,524,10035.5,252.0,104.8,5,1508,9206.5,1236.0,301.6
527594.0,6,6,758,3,410,254476.5,172.0,136.66666666666666,3,348,191440.5,135.0,116.0
836338.0,6,9,1118,6,586,167267.6,248.0,97.66666666666669,3,532,280214.5,392.0,177.33333333333334
299120.0,6,6,412,4,272,99706.66666666669,74.0,68.0,2,140,0.0,74.0,70.0
2903.0,17,4,344,2,150,0.0,75.0,75.0,2,194,0.0,103.0,97.0
114488720.0,6,32,2236,16,1165,7632581.333333333,139.0,72.8125,16,1071,7618170.266666667,123.0,66.9375
300050.0,6,6,412,4,272,100016.66666666669,74.0,68.0,2,140,0.0,74.0,70.0
284537.0,17,2,363,1,79,0.0,79.0,79.0,1,284,0.0,284.0,284.0
123610491.0,6,49,3234,25,1650,5150437.125,66.0,66.0,24,1584,4963558.304347826,66.0,66.0
1770095.0,6,2,132,1,66,0.0,66.0,66.0,1,66,0.0,66.0,66.0
45055015.0,6,23,7918,13,1426,3754584.5833333335,408.0,109.6923076923077,10,6492,4849440.555555556,1514.0,649.2
233041.0,6,3,337,2,214,0.0,160.0,107.0,1,123,0.0,123.0,123.0
2319.0,17,4,344,2,150,0.0,75.0,75.0,2,194,0.0,103.0,97.0
30367.0,6,14,4740,7,653,3045.333333333333,249.0,93.28571428571428,7,4087,4850.5,1514.0,583.8571428571429
2356.0,17,4,344,2,150,0.0,75.0,75.0,2,194,0.0,103.0,97.0
5621633.0,6,5,336,2,134,0.0,68.0,67.0,3,202,1523467.0,70.0,67.33333333333333
2356.0,17,4,344,2,150,0.0,75.0,75.0,2,194,0.0,103.0,97.0
146066.0,6,3,337,2,214,0.0,160.0,107.0,1,123,0.0,123.0,123.0
750137.0,17,4,344,2,150,0.0,75.0,75.0,2,194,0.0,103.0,97.0
153424.0,17,2,180,1,90,0.0,90.0,90.0,1,90,0.0,90.0,90.0
90256838.0,6,12,1832,8,1016,12893834.0,188.0,127.0,4,816,30031238.0,204.0,204.0
36661.0,6,13,1386,7,789,5732.833333333333,253.0,112.71428571428572,6,597,6508.0,259.0,99.5
102535.0,6,2,132,1,66,0.0,66.0,66.0,1,66,0.0,66.0,66.0
5838198.0,6,5,336,2,134,0.0,68.0,67.0,3,202,1525335.5,70.0,67.33333333333333
120113001.0,6,12,1832,8,1016,17135754.42857143,188.0,127.0,4,816,30026641.666666668,204.0,204.0
217522.0,6,3,426,2,280,0.0,214.0,140.0,1,146,0.0,146.0,146.0
124669957.0,17,14,864,7,432,17666830.666666668,174.0,61.71428571428572,7,432,17667575.833333332,174.0,61.71428571428572
42082.0,6,14,4740,7,653,6896.166666666667,249.0,93.28571428571428,7,4087,6603.833333333333,1514.0,583.8571428571429
14425.0,6,14,4740,7,653,2177.6666666666665,249.0,93.28571428571428,7,4087,2187.833333333333,1514.0,583.8571428571429
44779.0,6,14,4740,7,653,6994.333333333333,249.0,93.28571428571428,7,4087,7124.333333333333,1514.0,583.8571428571429
238044.0,6,3,337,2,214,0.0,160.0,107.0,1,123,0.0,123.0,123.0
1038971.0,6,11,1134,6,558,207794.2,220.0,93.0,5,576,255782.0,304.0,115.2
306983.0,6,6,412,4,272,102327.66666666669,74.0,68.0,2,140,0.0,74.0,70.0
120111176.0,6,232,26216,116,7952,1037386.9130434784,140.0,68.55172413793103,116,18264,1040955.504347826,284.0,157.44827586206895
44747.0,6,14,4740,7,653,6644.5,249.0,93.28571428571428,7,4087,6678.666666666667,1514.0,583.8571428571429
157773.0,17,2,180,1,90,0.0,90.0,90.0,1,90,0.0,90.0,90.0
313555.0,6,6,412,4,272,104518.33333333331,74.0,68.0,2,140,0.0,74.0,70.0
35233.0,6,11,2098,6,590,6597.4,252.0,98.33333333333331,5,1508,7990.25,1236.0,301.6
135130786.0,17,6,1146,6,1146,27026157.2,191.0,191.0,0,0,0.0,0.0,0.0
47217.0,6,14,4740,7,653,6808.0,249.0,93.28571428571428,7,4087,7733.166666666667,1514.0,583.8571428571429
91605646.0,6,267,43264,134,9140,688764.2556390978,214.0,68.2089552238806,133,34124,686103.2954545454,1514.0,256.57142857142856
205768.0,17,2,180,1,90,0.0,90.0,90.0,1,90,0.0,90.0,90.0
180149.0,17,4,1524,4,1524,60049.66666666666,381.0,381.0,0,0,0.0,0.0,0.0
178197.0,17,2,180,1,90,0.0,90.0,90.0,1,90,0.0,90.0,90.0
242809.0,6,3,337,2,214,0.0,160.0,107.0,1,123,0.0,123.0,123.0
1167.0,17,4,438,2,148,0.0,74.0,74.0,2,290,0.0,147.0,145.0
29542.0,6,14,4740,7,653,4808.833333333333,249.0,93.28571428571428,7,4087,4060.0,1514.0,583.8571428571429
1412084.0,17,7,490,7,490,235347.3333333333,70.0,70.0,0,0,0.0,0.0,0.0
40888.0,6,14,4740,7,653,6655.5,249.0,93.28571428571428,7,4087,6386.5,1514.0,583.8571428571429
234394.0,6,3,337,2,214,0.0,160.0,107.0,1,123,0.0,123.0,123.0
90060326.0,17,28,13364,28,13364,3335567.6296296297,501.0,477.2857142857143,0,0,0.0,0.0,0.0
218107.0,6,3,426,2,280,0.0,214.0,140.0,1,146,0.0,146.0,146.0
20078.0,6,14,4740,7,653,3216.6666666666665,249.0,93.28571428571428,7,4087,3215.1666666666665,1514.0,583.8571428571429
2062.0,17,4,344,2,150,0.0,75.0,75.0,2,194,0.0,103.0,97.0
103440.0,17,2,286,2,286,0.0,143.0,143.0,0,0,0.0,0.0,0.0
1110783.0,6,13,1386,7,789,185130.5,253.0,112.71428571428572,6,597,218918.2,259.0,99.5
20497.0,6,14,4740,7,653,3233.0,249.0,93.28571428571428,7,4087,3276.833333333333,1514.0,583.8571428571429
90262992.0,6,12,1832,8,1016,12894713.142857144,188.0,127.0,4,816,30032559.0,204.0,204.0
2316.0,17,4,344,2,150,0.0,75.0,75.0,2,194,0.0,103.0,97.0
297803.0,6,6,412,4,272,99267.66666666669,74.0,68.0,2,140,0.0,74.0,70.0
31225.0,6,10,2032,5,524,6967.25,252.0,104.8,5,1508,7565.25,1236.0,301.6
120123958.0,6,13,2020,9,1204,15015494.75,188.0,133.77777777777777,4,816,30025175.666666668,204.0,204.0
108099356.0,17,5,955,5,955,27024839.0,191.0,191.0,0,0,0.0,0.0,0.0
30548.0,6,14,4740,7,653,4970.333333333333,249.0,93.28571428571428,7,4087,4891.0,1514.0,583.8571428571429
108871952.0,17,14,864,7,432,18000816.833333332,174.0,61.71428571428572,7,432,18000154.833333332,174.0,61.71428571428572
2341.0,17,4,344,2,150,0.0,75.0,75.0,2,194,0.0,103.0,97.0
47735.0,6,14,3592,8,696,6819.285714285715,214.0,87.0,6,2896,7935.4,1514.0,482.6666666666667
135136777.0,17,6,1146,6,1146,27027355.4,191.0,191.0,0,0,0.0,0.0,0.0
3007125.0,6,11,2106,6,598,601155.4,252.0,99.66666666666669,5,1508,2227.25,1236.0,301.6
206015.0,6,3,426,2,280,0.0,214.0,140.0,1,146,0.0,146.0,146.0
502353.00000000006,6,5,336,2,134,0.0,68.0,67.0,3,202,192836.0,70.0,67.33333333333333
123456261.0,6,49,3234,25,1650,5144010.875,66.0,66.0,24,1584,5115442.173913044,66.0,66.0
153486.0,17,2,180,1,90,0.0,90.0,90.0,1,90,0.0,90.0,90.0
2596060.0,6,2,132,1,66,0.0,66.0,66.0,1,66,0.0,66.0,66.0
4305.0,17,2,598,1,72,0.0,72.0,72.0,1,526,0.0,526.0,526.0
81126.0,6,14,4740,7,653,13405.666666666666,249.0,93.28571428571428,7,4087,13340.666666666666,1514.0,583.8571428571429
119966858.0,6,25,1883,12,894,10884511.363636363,95.0,74.5,13,989,9982497.833333334,95.0,76.07692307692308
233236.0,6,3,337,2,214,0.0,160.0,107.0,1,123,0.0,123.0,123.0
864.0,17,5,550,5,550,216.0,110.0,110.0,0,0,0.0,0.0,0.0
20849.0,6,14,4740,7,653,3325.5,249.0,93.28571428571428,7,4087,3244.6666666666665,1514.0,583.8571428571429
1774.0,17,2,664,1,322,0.0,322.0,322.0,1,342,0.0,342.0,342.0
118237941.0,6,217,24378,109,7490,1094795.75,140.0,68.71559633027523,108,16888,1095210.4205607476,284.0,156.37037037037038
99026.0,17,2,286,2,286,0.0,143.0,143.0,0,0,0.0,0.0,0.0
2400.0,17,4,344,2,150,0.0,75.0,75.0,2,194,0.0,103.0,97.0
143879.0,17,2,180,1,90,0.0,90.0,90.0,1,90,0.0,90.0,90.0
39036.0,6,14,4740,7,653,6395.0,249.0,93.28571428571428,7,4087,6261.166666666667,1514.0,583.8571428571429
307097.0,6,6,412,4,272,102365.66666666669,74.0,68.0,2,140,0.0,74.0,70.0
116325277.0,6,329,38750,165,11198,709300.4695121951,140.0,67.86666666666666,164,27552,709340.6871165644,464.0,168.0
217129.0,6,3,426,2,280,0.0,214.0,140.0,1,146,0.0,146.0,146.0
2327.0,17,4,344,2,150,0.0,75.0,75.0,2,194,0.0,103.0,97.0
122200.0,6,3,373,2,238,0.0,172.0,119.0,1,135,0.0,135.0,135.0
108105383.0,17,5,1005,5,1005,27026345.75,201.0,201.0,0,0,0.0,0.0,0.0
32280.000000000004,6,10,2032,5,524,7696.75,252.0,104.8,5,1508,7524.75,1236.0,301.6
302335.0,6,2,132,1,66,0.0,66.0,66.0,1,66,0.0,66.0,66.0
104281.0,17,2,286,2,286,0.0,143.0,143.0,0,0,0.0,0.0,0.0
205414.0,6,3,426,2,280,0.0,214.0,140.0,1,146,0.0,146.0,146.0
31832.0,6,14,4740,7,653,3995.8333333333335,249.0,93.28571428571428,7,4087,5165.5,1514.0,583.8571428571429
108109949.0,17,5,1005,5,1005,27027487.25,201.0,201.0,0,0,0.0,0.0,0.0
116786.0,17,4,1400,4,1400,38928.66666666666,350.0,350.0,0,0,0.0,0.0,0.0
1037710.0,6,11,1134,6,558,207542.0,220.0,93.0,5,576,256872.25,304.0,115.2
3581.0,17,2,346,1,78,0.0,78.0,78.0,1,268,0.0,268.0,268.0
297429.0,6,6,412,4,272,99143.0,74.0,68.0,2,140,0.0,74.0,70.0
105052981.0,6,44,2904,22,1452,5002522.904761905,66.0,66.0,22,1452,4992227.285714285,66.0,66.0
3007080.0,6,12,2172,7,664,501024.8333333333,252.0,94.85714285714286,5,1508,1880.25,1236.0,301.6
1055146.0,6,13,1386,7,789,175857.66666666666,253.0,112.71428571428572,6,597,210424.6,259.0,99.5
874502.0,6,9,1268,6,797,174900.4,459.0,132.83333333333334,3,471,299484.0,331.0,157.0
20114.0,6,12,1413,7,882,3352.333333333333,291.0,126.0,5,531,4166.5,259.0,106.2
108118120.0,17,5,1005,5,1005,27029530.0,201.0,201.0,0,0,0.0,0.0,0.0
26259.0,6,11,1131,6,600,4893.6,262.0,100.0,5,531,4811.25,259.0,106.2
305004.0,6,6,412,4,272,101668.0,74.0,68.0,2,140,0.0,74.0,70.0
8999.0,17,2,582,1,83,0.0,83.0,83.0,1,499,0.0,499.0,499.0
36289.0,6,14,4740,7,653,5425.0,249.0,93.28571428571428,7,4087,5188.833333333333,1514.0,583.8571428571429
1674614.0,17,6,1293,3,234,837066.5,78.0,78.0,3,1059,527955.5,395.0,353.0
28187.0,6,14,4740,7,653,3598.5,249.0,93.28571428571428,7,4087,4494.166666666667,1514.0,583.8571428571429
307403.0,6,6,412,4,272,102467.66666666669,74.0,68.0,2,140,0.0,74.0,70.0
114414800.0,6,48,3168,24,1584,4974556.521739131,66.0,66.0,24,1584,4960889.347826087,66.0,66.0
944.0,17,4,438,2,148,0.0,74.0,74.0,2,290,0.0,147.0,145.0
4053.0,17,2,570,1,81,0.0,81.0,81.0,1,489,0.0,489.0,489.0
307383.0,6,6,412,4,272,102461.0,74.0,68.0,2,140,0.0,74.0,70.0
136194.0,6,13,1386,7,789,22699.0,253.0,112.71428571428572,6,597,23823.6,259.0,99.5
305160.0,17,4,704,2,148,0.0,74.0,74.0,2,556,0.0,280.0,278.0
90012649.0,17,28,13364,28,13364,3333801.814814815,501.0,477.2857142857143,0,0,0.0,0.0,0.0
611.0,17,2,508,2,508,0.0,257.0,254.0,0,0,0.0,0.0,0.0
715.0,17,4,438,2,148,0.0,74.0,74.0,2,290,0.0,147.0,145.0
50653.0,6,14,4740,7,653,8317.0,249.0,93.28571428571428,7,4087,8285.0,1514.0,583.8571428571429
0.0,17,1,179,1,179,0.0,179.0,179.0,0,0,0.0,0.0,0.0
216599.0,17,2,180,1,90,0.0,90.0,90.0,1,90,0.0,90.0,90.0
108103127.0,17,5,955,5,955,27025781.75,191.0,191.0,0,0,0.0,0.0,0.0
206204.0,17,2,762,2,762,0.0,381.0,381.0,0,0,0.0,0.0,0.0
6834.0,17,2,582,1,83,0.0,83.0,83.0,1,499,0.0,499.0,499.0
5622724.0,6,5,336,2,134,0.0,68.0,67.0,3,202,1524185.5,70.0,67.33333333333333
34422.0,6,14,4740,7,653,5628.333333333333,249.0,93.28571428571428,7,4087,5482.0,1514.0,583.8571428571429
144026.0,17,2,180,1,90,0.0,90.0,90.0,1,90,0.0,90.0,90.0
47168.0,6,14,4740,7,653,7739.0,249.0,93.28571428571428,7,4087,7394.0,1514.0,583.8571428571429
38934.0,6,10,2032,5,524,9494.75,252.0,104.8,5,1508,8563.25,1236.0,301.6
268522.0,6,12,1373,7,714,44753.66666666666,298.0,102.0,5,659,63043.25,379.0,131.8
108120451.0,17,5,955,5,955,27030112.75,191.0,191.0,0,0,0.0,0.0,0.0
123234903.0,6,35,2542,17,1194,7078119.9375,123.0,70.23529411764706,18,1348,6661762.352941177,139.0,74.88888888888889
59158.0,6,14,4740,7,653,9725.666666666666,249.0,93.28571428571428,7,4087,8362.666666666666,1514.0,583.8571428571429
347.0,17,2,166,1,75,0.0,75.0,75.0,1,91,0.0,91.0,91.0
107363.0,17,2,286,2,286,0.0,143.0,143.0,0,0,0.0,0.0,0.0
2794698.0,6,2,132,1,66,0.0,66.0,66.0,1,66,0.0,66.0,66.0
1171035.0,6,13,3018,8,2390,167290.7142857143,1514.0,298.75,5,628,223843.5,331.0,125.6
108107115.0,17,5,1005,5,1005,27026778.75,201.0,201.0,0,0,0.0,0.0,0.0
1321441.0,6,4,264,2,132,0.0,66.0,66.0,2,132,0.0,66.0,66.0
333.0,17,2,160,1,80,0.0,80.0,80.0,1,80,0.0,80.0,80.0
59206.0,6,14,4740,7,653,9422.333333333334,249.0,93.28571428571428,7,4087,9577.166666666666,1514.0,583.8571428571429
16740.0,6,14,4740,7,653,2607.1666666666665,249.0,93.28571428571428,7,4087,2567.6666666666665,1514.0,583.8571428571429
79.0,17,2,762,2,762,0.0,381.0,381.0,0,0,0.0,0.0,0.0
69147.0,6,14,4740,7,653,11402.333333333334,249.0,93.28571428571428,7,4087,10823.666666666666,1514.0,583.8571428571429
304148.0,6,6,412,4,272,101382.66666666669,74.0,68.0,2,140,0.0,74.0,70.0
36041.0,6,14,4740,7,653,5610.5,249.0,93.28571428571428,7,4087,5551.666666666667,1514.0,583.8571428571429
39831.0,6,14,4740,7,653,6256.0,249.0,93.28571428571428,7,4087,6499.0,1514.0,583.8571428571429
24353.0,6,10,2032,5,524,5844.0,252.0,104.8,5,1508,4900.5,1236.0,301.6
320.0,17,2,168,1,76,0.0,76.0,76.0,1,92,0.0,92.0,92.0
90258009.0,6,12,1832,8,1016,12894001.285714284,188.0,127.0,4,816,30025641.0,204.0,204.0
304.0,17,2,168,1,76,0.0,76.0,76.0,1,92,0.0,92.0,92.0
759.0,17,4,438,2,148,0.0,74.0,74.0,2,290,0.0,147.0,145.0
196892.0,17,2,180,1,90,0.0,90.0,90.0,1,90,0.0,90.0,90.0
16949.0,6,13,1459,7,862,2824.833333333333,271.0,123.14285714285714,6,597,2705.6,259.0,99.5
203757.0,17,4,1524,4,1524,67919.0,381.0,381.0,0,0,0.0,0.0,0.0
123481.0,6,3,337,2,214,0.0,160.0,107.0,1,123,0.0,123.0,123.0
120121604.0,6,15,2428,9,1204,15015200.5,188.0,133.77777777777777,6,1224,18072858.2,204.0,204.0
42750.0,6,14,4740,7,653,6956.666666666667,249.0,93.28571428571428,7,4087,6435.833333333333,1514.0,583.8571428571429
2117273.0,6,25,7611,13,2516,176439.41666666666,1034.0,193.53846153846155,12,5095,163613.0909090909,1510.0,424.5833333333333
108130233.0,17,5,1005,5,1005,27032558.25,201.0,201.0,0,0,0.0,0.0,0.0
135126339.0,17,6,1206,6,1206,27025267.8,201.0,201.0,0,0,0.0,0.0,0.0
108101921.0,17,5,1005,5,1005,27025480.25,201.0,201.0,0,0,0.0,0.0,0.0
108107661.0,17,5,1005,5,1005,27026915.25,201.0,201.0,0,0,0.0,0.0,0.0
24282.0,6,14,4740,7,653,3920.3333333333335,249.0,93.28571428571428,7,4087,3856.0,1514.0,583.8571428571429
220366.0,17,2,180,1,90,0.0,90.0,90.0,1,90,0.0,90.0,90.0
96995210.0,17,11,735,6,389,19367251.8,174.0,64.83333333333333,5,346,19368446.25,174.0,69.2
8278501.0,17,4,1376,3,1026,928677.5,342.0,342.0,1,350,0.0,350.0,350.0
316.0,17,2,168,1,76,0.0,76.0,76.0,1,92,0.0,92.0,92.0
306.0,17,2,168,1,76,0.0,76.0,76.0,1,92,0.0,92.0,92.0
310.0,17,2,174,1,79,0.0,79.0,79.0,1,95,0.0,95.0,95.0
90815391.0,6,19,1436,10,745,10079859.666666666,95.0,74.5,9,691,11351720.25,95.0,76.77777777777777
115610.0,6,12,1447,6,816,21623.6,291.0,136.0,6,631,21524.2,293.0,105.16666666666669
120215329.0,6,23,1734,11,840,11999896.3,95.0,76.36363636363636,12,894,10908990.454545457,95.0,74.5
533608.0,6,2,132,1,66,0.0,66.0,66.0,1,66,0.0,66.0,66.0
119695750.0,6,502,78230,251,16936,478694.576,214.0,67.47410358565737,251,61294,478702.784,1514.0,244.199203187251
91470.0,17,3,1050,3,1050,45735.0,350.0,350.0,0,0,0.0,0.0,0.0
120232617.0,6,18,1341,9,691,14999396.5,95.0,76.77777777777777,9,650,14998740.125,95.0,72.22222222222223
153440.0,17,2,180,1,90,0.0,90.0,90.0,1,90,0.0,90.0,90.0
0.0,6,1,54,0,0,0.0,0.0,0.0,1,54,0.0,54.0,54.0
53071.0,6,14,4740,7,653,8298.333333333334,249.0,93.28571428571428,7,4087,8513.333333333334,1514.0,583.8571428571429
147938.0,17,2,180,1,90,0.0,90.0,90.0,1,90,0.0,90.0,90.0
801.0,17,4,438,2,148,0.0,74.0,74.0,2,290,0.0,147.0,145.0
136011817.0,17,14,864,8,475,19430259.57142857,174.0,59.375,6,389,19400166.0,174.0,64.83333333333333
120154866.0,6,828,110530,414,27546,288935.6537530266,140.0,66.53623188405797,414,82984,290588.46246973367,464.0,200.44444444444449
341673.0,17,2,582,1,83,0.0,83.0,83.0,1,499,0.0,499.0,499.0
73453.0,6,14,4740,7,653,12126.333333333334,249.0,93.28571428571428,7,4087,12057.166666666666,1514.0,583.8571428571429
15068.0,6,14,4740,7,653,2401.6666666666665,249.0,93.28571428571428,7,4087,2323.333333333333,1514.0,583.8571428571429
2924680.0,6,3,1604,1,753,0.0,753.0,753.0,2,851,0.0,785.0,425.5
155169.0,6,3,337,2,214,0.0,160.0,107.0,1,123,0.0,123.0,123.0
99676865.0,6,23,1446,12,783,9061533.181818182,123.0,65.25,11,663,8947530.1,123.0,60.27272727272727
14702.0,6,10,2032,5,524,3441.5,252.0,104.8,5,1508,3468.25,1236.0,301.6
90135428.0,6,13,1914,6,1086,18026496.0,204.0,181.0,7,828,15022190.5,188.0,118.28571428571428
110463010.0,6,797,141106,393,26382,281793.39285714284,214.0,67.12977099236642,404,114724,273334.97518610425,1514.0,283.970297029703
145358.0,17,2,180,1,70,0.0,70.0,70.0,1,110,0.0,110.0,110.0
853.0,17,4,438,2,148,0.0,74.0,74.0,2,290,0.0,147.0,145.0
90529796.0,6,14,2240,8,1016,12932828.0,188.0,127.0,6,1224,18072828.8,204.0,204.0
100383117.0,17,13,821,7,432,16666816.0,174.0,61.71428571428572,6,389,20001332.0,174.0,64.83333333333333
236556.0,6,3,373,2,238,0.0,172.0,119.0,1,135,0.0,135.0,135.0
1650755.0,6,20,7599,11,1469,165075.5,583.0,133.54545454545453,9,6130,171844.875,1484.0,681.1111111111111
1177779.0,6,13,3010,8,2382,168254.14285714287,1514.0,297.75,5,628,226301.75,331.0,125.6
1046612.0,6,13,1386,7,789,174435.33333333334,253.0,112.71428571428572,6,597,207891.4,259.0,99.5
2349.0,17,4,344,2,150,0.0,75.0,75.0,2,194,0.0,103.0,97.0
216848.0,6,3,426,2,280,0.0,214.0,140.0,1,146,0.0,146.0,146.0
2794802.0,6,2,132,1,66,0.0,66.0,66.0,1,66,0.0,66.0,66.0
228192.0,17,2,180,1,90,0.0,90.0,90.0,1,90,0.0,90.0,90.0
114047533.0,17,14,864,7,432,19000732.666666668,174.0,61.71428571428572,7,432,19000192.166666668,174.0,61.71428571428572
46789095.0,6,8,2113,3,960,22042204.5,826.0,320.0,5,1153,11259167.5,885.0,230.6
610936.0,6,4,508,2,238,0.0,172.0,119.0,2,270,0.0,135.0,135.0
985.0,17,4,438,2,148,0.0,74.0,74.0,2,290,0.0,147.0,145.0
245209.0,6,3,373,2,238,0.0,172.0,119.0,1,135,0.0,135.0,135.0
20719.0,6,10,2032,5,524,4380.25,252.0,104.8,5,1508,4548.0,1236.0,301.6
254432.0,6,3,337,2,214,0.0,160.0,107.0,1,123,0.0,123.0,123.0
103765.0,17,2,286,2,286,0.0,143.0,143.0,0,0,0.0,0.0,0.0
204597.0,17,2,762,2,762,0.0,381.0,381.0,0,0,0.0,0.0,0.0
3271.0,17,2,343,1,75,0.0,75.0,75.0,1,268,0.0,268.0,268.0
102615.0,6,12,1320,6,723,18605.0,253.0,120.5,6,597,18633.2,259.0,99.5
112346539.0,6,855,162642,424,28502,265560.0827423168,214.0,67.22169811320755,431,134140,261251.9534883721,1514.0,311.22969837587004
104408763.0,6,191,21566,96,6632,1098365.7789473685,140.0,69.08333333333333,95,14934,1102121.6489361702,284.0,157.2
1019746.0,6,11,1134,6,558,203949.2,220.0,93.0,5,576,253994.0,304.0,115.2
19497.0,6,14,4740,7,653,3001.6666666666665,249.0,93.28571428571428,7,4087,3105.333333333333,1514.0,583.8571428571429
742.0,17,4,438,2,148,0.0,74.0,74.0,2,290,0.0,147.0,145.0
218227.0,6,3,426,2,280,0.0,214.0,140.0,1,146,0.0,146.0,146.0
98708335.0,17,16,5480,15,5130,5718597.5,342.0,342.0,1,350,0.0,350.0,350.0
121336.0,6,3,373,2,238,0.0,172.0,119.0,1,135,0.0,135.0,135.0
2697148.0,6,25,7573,14,3735,207472.92307692303,1514.0,266.7857142857143,11,3838,243466.2,1514.0,348.90909090909093
144707.0,17,2,180,1,70,0.0,70.0,70.0,1,110,0.0,110.0,110.0
26908.0,6,12,1320,6,723,4720.0,253.0,120.5,6,597,4517.4,259.0,99.5
15058.0,17,2,180,1,90,0.0,90.0,90.0,1,90,0.0,90.0,90.0
135094666.0,17,6,1146,6,1146,27018933.2,191.0,191.0,0,0,0.0,0.0,0.0
30975.0,6,11,2098,6,590,5657.2,252.0,98.33333333333331,5,1508,6846.0,1236.0,301.6
253213.00000000003,6,3,337,2,214,0.0,160.0,107.0,1,123,0.0,123.0,123.0
2058.0,17,4,344,2,150,0.0,75.0,75.0,2,194,0.0,103.0,97.0
147956.0,17,2,180,1,90,0.0,90.0,90.0,1,90,0.0,90.0,90.0
90296979.0,6,17,1287,9,691,11281648.0,95.0,76.77777777777777,8,596,12897870.714285716,95.0,74.5
295738.0,6,6,412,4,272,98579.33333333331,74.0,68.0,2,140,0.0,74.0,70.0
10490240.0,6,7,478,4,272,3450042.6666666665,74.0,68.0,3,206,5174951.5,74.0,68.66666666666667
57108.0,6,14,4740,7,653,8959.333333333334,249.0,93.28571428571428,7,4087,9138.5,1514.0,583.8571428571429
352.0,17,2,762,2,762,0.0,381.0,381.0,0,0,0.0,0.0,0.0
3566803.0,6,5,336,2,134,0.0,68.0,67.0,3,202,1422033.0,70.0,67.33333333333333
194634.0,17,2,180,1,90,0.0,90.0,90.0,1,90,0.0,90.0,90.0
123839669.0,6,48,3168,24,1584,5147218.173913044,66.0,66.0,24,1584,5150172.565217392,66.0,66.0
114704723.0,17,14,864,7,432,19090822.0,174.0,61.71428571428572,7,432,19093561.33333333,174.0,61.71428571428572
148003.0,17,2,180,1,90,0.0,90.0,90.0,1,90,0.0,90.0,90.0
313126.0,6,3,202,2,128,0.0,74.0,64.0,1,74,0.0,74.0,74.0
103555.0,17,2,286,2,286,0.0,143.0,143.0,0,0,0.0,0.0,0.0
210524.0,17,2,762,2,762,0.0,381.0,381.0,0,0,0.0,0.0,0.0
1381.0,17,2,762,2,762,0.0,381.0,381.0,0,0,0.0,0.0,0.0
946610.0,6,12,1354,6,723,188054.2,253.0,120.5,6,631,187925.4,293.0,105.16666666666669
135128051.0,17,6,1146,6,1146,27025610.2,191.0,191.0,0,0,0.0,0.0,0.0
407023.0,6,3,204,1,68,0.0,68.0,68.0,2,136,0.0,70.0,68.0
14185.0,17,4,344,2,150,0.0,75.0,75.0,2,194,0.0,103.0,97.0
32885734.0,6,5,336,2,134,0.0,68.0,67.0,3,202,15052421.5,70.0,67.33333333333333
163420.0,6,12,1447,6,816,31601.2,291.0,136.0,6,631,31964.8,293.0,105.16666666666669
0.0,6,1,172,1,172,0.0,172.0,172.0,0,0,0.0,0.0,0.0
891088.0,6,12,2711,7,743,148514.66666666666,339.0,106.14285714285714,5,1968,153840.75,1514.0,393.6
786.0,17,4,438,2,148,0.0,74.0,74.0,2,290,0.0,147.0,145.0
233074.0,6,3,337,2,214,0.0,160.0,107.0,1,123,0.0,123.0,123.0
14654579.0,6,20,1648,10,1016,1592766.4444444445,315.0,101.6,10,632,1592022.7777777778,78.0,63.2
579696.0,6,4,508,2,238,0.0,172.0,119.0,2,270,0.0,135.0,135.0
441996.0,17,2,363,1,79,0.0,79.0,79.0,1,284,0.0,284.0,284.0
342686.0,6,4,270,2,134,0.0,68.0,67.0,2,136,0.0,70.0,68.0
26611247.0,17,5,1718,4,1368,936769.3333333334,342.0,342.0,1,350,0.0,350.0,350.0
12832.0,6,11,1132,6,556,2217.2,218.0,92.66666666666669,5,576,2722.75,304.0,115.2
2002809.0,6,18,6803,10,1501,222534.3333333333,408.0,150.1,8,5302,223701.57142857145,1514.0,662.75
120000022.0,6,20,1531,11,840,12000002.2,95.0,76.36363636363636,9,691,11339313.125,95.0,76.77777777777777
117196617.0,6,203,22824,102,6954,1160362.5445544554,140.0,68.17647058823529,101,15870,1162826.4,284.0,157.12871287128712
2268429.0,6,8,602,5,404,542210.25,103.0,80.8,3,198,204917.5,66.0,66.0
135145204.0,17,6,1146,6,1146,27029040.8,191.0,191.0,0,0,0.0,0.0,0.0
54862.0,6,14,4740,7,653,8652.833333333334,249.0,93.28571428571428,7,4087,7881.666666666667,1514.0,583.8571428571429
203065.0,17,4,6056,4,6056,67688.33333333333,1514.0,1514.0,0,0,0.0,0.0,0.0
146246.0,6,3,337,2,214,0.0,160.0,107.0,1,123,0.0,123.0,123.0
301.0,17,2,156,1,78,0.0,78.0,78.0,1,78,0.0,78.0,78.0
6656.0,17,2,239,1,82,0.0,82.0,82.0,1,157,0.0,157.0,157.0
23051.0,6,10,2032,5,524,5523.5,252.0,104.8,5,1508,5233.5,1236.0,301.6
153338.0,17,2,180,1,90,0.0,90.0,90.0,1,90,0.0,90.0,90.0
28436.0,6,14,4740,7,653,4569.166666666667,249.0,93.28571428571428,7,4087,4600.5,1514.0,583.8571428571429
9926989.0,6,5,1736,2,819,0.0,753.0,409.5,3,917,4897909.5,785.0,305.6666666666667
18686.0,6,10,2032,5,524,4370.5,252.0,104.8,5,1508,4137.75,1236.0,301.6
43036286.0,6,4,1670,3,917,21518143.0,785.0,305.6666666666667,1,753,0.0,753.0,753.0
300574.0,6,6,412,4,272,100191.33333333331,74.0,68.0,2,140,0.0,74.0,70.0
103270.0,17,2,286,2,286,0.0,143.0,143.0,0,0,0.0,0.0,0.0
2117.0,17,4,344,2,150,0.0,75.0,75.0,2,194,0.0,103.0,97.0
55911.0,6,14,4740,7,653,8710.666666666666,249.0,93.28571428571428,7,4087,8833.0,1514.0,583.8571428571429
97167337.0,6,200,22552,100,15730,979422.1818181818,284.0,157.3,100,6822,979415.8686868688,140.0,68.22
115484304.0,6,47,3102,24,1584,5021045.434782608,66.0,66.0,23,1518,5143996.727272728,66.0,66.0
281310.0,17,2,363,1,79,0.0,79.0,79.0,1,284,0.0,284.0,284.0
207938.0,6,3,426,2,280,0.0,214.0,140.0,1,146,0.0,146.0,146.0
90871494.0,6,44,3852,26,2190,3634859.76,123.0,84.23076923076923,18,1662,5332591.823529412,123.0,92.33333333333331
120051752.0,17,29,13785,29,13785,4287562.571428572,501.0,475.3448275862069,0,0,0.0,0.0,0.0
117485112.0,6,250,29310,125,20838,945725.0967741936,374.0,166.704,125,8472,945724.75,140.0,67.776
108107784.0,17,5,1005,5,1005,27026946.0,201.0,201.0,0,0,0.0,0.0,0.0
108111820.0,17,5,1005,5,1005,27027955.0,201.0,201.0,0,0,0.0,0.0,0.0
151.0,17,2,158,2,158,0.0,79.0,79.0,0,0,0.0,0.0,0.0
120890697.0,17,17,1386,8,606,16574304.857142856,174.0,75.75,9,780,15079351.75,174.0,86.66666666666667
112445790.0,6,36,2596,18,1348,6602430.0,139.0,74.88888888888889,18,1248,6602430.411764706,123.0,69.33333333333333
304020.0,6,6,412,4,272,101340.0,74.0,68.0,2,140,0.0,74.0,70.0
320.0,17,2,174,1,79,0.0,79.0,79.0,1,95,0.0,95.0,95.0
120102709.0,6,238,27078,119,8076,1013996.8389830508,140.0,67.8655462184874,119,19002,1010839.406779661,374.0,159.68067226890756
142133.0,17,4,704,2,148,0.0,74.0,74.0,2,556,0.0,280.0,278.0
9507.0,17,2,571,1,86,0.0,86.0,86.0,1,485,0.0,485.0,485.0
31277.0,6,13,1479,7,882,5021.333333333333,291.0,126.0,6,597,5420.4,259.0,99.5
261507.0,6,12,1373,7,714,43584.5,298.0,102.0,5,659,61331.25,379.0,131.8
8701.0,17,2,602,1,72,0.0,72.0,72.0,1,530,0.0,530.0,530.0
410154.0,6,3,204,2,136,0.0,70.0,68.0,1,68,0.0,68.0,68.0
104236221.0,6,242,27378,121,19170,866840.8583333333,284.0,158.4297520661157,121,8208,866839.2333333333,140.0,67.83471074380165
108101669.0,17,5,1005,5,1005,27025417.25,201.0,201.0,0,0,0.0,0.0,0.0
2394.0,17,4,344,2,150,0.0,75.0,75.0,2,194,0.0,103.0,97.0
18112.0,6,10,2032,5,524,4279.5,252.0,104.8,5,1508,4224.0,1236.0,301.6
284152.0,17,2,363,1,79,0.0,79.0,79.0,1,284,0.0,284.0,284.0
120074475.0,6,47,3102,23,1518,5144003.863636363,66.0,66.0,24,1584,5220618.0,66.0,66.0
106711473.0,17,14,864,7,432,17668344.0,174.0,61.71428571428572,7,432,17666815.5,174.0,61.71428571428572
206986.0,6,3,426,2,280,0.0,214.0,140.0,1,146,0.0,146.0,146.0
2462910.0,6,49,23728,25,19797,102621.25,1514.0,791.88,24,3931,96931.0,1514.0,163.79166666666666
940237.0,6,5,1742,2,821,0.0,753.0,410.5,3,921,470118.5,785.0,307.0
2360.0,17,4,344,2,150,0.0,75.0,75.0,2,194,0.0,103.0,97.0
2585558.0,6,2,132,1,66,0.0,66.0,66.0,1,66,0.0,66.0,66.0
1467956.0,17,16,1120,16,1120,97863.73333333334,70.0,70.0,0,0,0.0,0.0,0.0
100541919.0,17,12,516,6,258,20000228.8,43.0,43.0,6,258,20000925.4,43.0,43.0
463519.0,6,4,508,2,238,0.0,172.0,119.0,2,270,0.0,135.0,135.0
298164.0,6,6,412,4,272,99388.0,74.0,68.0,2,140,0.0,74.0,70.0
2498346.0,6,3,1604,2,851,0.0,785.0,425.5,1,753,0.0,753.0,753.0
122803332.0,17,16,1343,9,780,15350416.5,174.0,86.66666666666667,7,563,18999178.0,174.0,80.42857142857143
103362713.0,17,14,864,7,432,17166834.0,174.0,61.71428571428572,7,432,17168072.666666668,174.0,61.71428571428572
190871.0,17,2,180,1,90,0.0,90.0,90.0,1,90,0.0,90.0,90.0
2872813.0,6,4,270,2,134,0.0,68.0,67.0,2,136,0.0,70.0,68.0
90214093.0,6,20,1855,9,650,11247241.25,95.0,72.22222222222223,11,1205,9000836.1,257.0,109.54545454545456
205890.0,17,2,180,1,90,0.0,90.0,90.0,1,90,0.0,90.0,90.0
90240822.0,6,14,1964,8,1016,12891546.0,188.0,127.0,6,948,18015783.6,204.0,158.0
102941.0,17,2,286,2,286,0.0,143.0,143.0,0,0,0.0,0.0,0.0
305.0,17,2,174,1,79,0.0,79.0,79.0,1,95,0.0,95.0,95.0
35224.0,6,14,4740,7,653,5025.333333333333,249.0,93.28571428571428,7,4087,5442.833333333333,1514.0,583.8571428571429
10904299.0,6,8,544,4,272,3589291.0,74.0,68.0,4,272,3589218.333333333,74.0,68.0
0.0,17,1,453,1,453,0.0,453.0,453.0,0,0,0.0,0.0,0.0
241143.0,6,3,373,2,238,0.0,172.0,119.0,1,135,0.0,135.0,135.0
80475.0,6,14,4740,7,653,6103.833333333333,249.0,93.28571428571428,7,4087,13271.166666666666,1514.0,583.8571428571429
311514.0,6,6,412,4,272,103838.0,74.0,68.0,2,140,0.0,74.0,70.0
37479.0,6,14,4740,7,653,6107.333333333333,249.0,93.28571428571428,7,4087,5691.666666666667,1514.0,583.8571428571429
135135472.0,17,6,1206,6,1206,27027094.4,201.0,201.0,0,0,0.0,0.0,0.0
216118.0,6,3,426,2,280,0.0,214.0,140.0,1,146,0.0,146.0,146.0
119783503.0,6,34,2334,17,1209,7472967.5625,123.0,71.11764705882354,17,1125,7472965.4375,123.0,66.17647058823529
1196865.0,6,13,3013,8,2385,170980.7142857143,1514.0,298.125,5,628,230276.75,331.0,125.6
120000090.0,6,17,1287,9,691,15000011.25,95.0,76.77777777777777,8,596,12898783.142857144,95.0,74.5
2838158.0,6,3,1777,2,951,0.0,885.0,475.5,1,826,0.0,826.0,826.0
1095579.0,17,2,246,1,76,0.0,76.0,76.0,1,170,0.0,170.0,170.0
144920.0,17,2,180,1,70,0.0,70.0,70.0,1,110,0.0,110.0,110.0
90066715.0,17,28,13364,28,13364,3335804.25925926,501.0,477.2857142857143,0,0,0.0,0.0,0.0
941.0,17,5,550,5,550,235.25,110.0,110.0,0,0,0.0,0.0,0.0
135135357.0,17,6,1146,6,1146,27027071.4,191.0,191.0,0,0,0.0,0.0,0.0
23026375.0,17,3,1034,2,684,0.0,342.0,342.0,1,350,0.0,350.0,350.0
24431.0,6,14,4740,7,653,3914.0,249.0,93.28571428571428,7,4087,3648.6666666666665,1514.0,583.8571428571429
61676.0,6,10,2032,5,524,14266.0,252.0,104.8,5,1508,15111.0,1236.0,301.6
232282.0,6,3,337,2,214,0.0,160.0,107.0,1,123,0.0,123.0,123.0
203199.0,17,4,1524,4,1524,67733.0,381.0,381.0,0,0,0.0,0.0,0.0
197417.0,17,2,180,1,90,0.0,90.0,90.0,1,90,0.0,90.0,90.0
62282.0,6,14,4740,7,653,10112.666666666666,249.0,93.28571428571428,7,4087,10199.0,1514.0,583.8571428571429
2062.0,17,4,344,2,150,0.0,75.0,75.0,2,194,0.0,103.0,97.0
111035815.0,6,30,1974,15,1026,7915004.714285715,123.0,68.4,15,948,7914842.142857143,123.0,63.2
312705.0,6,6,412,4,272,104235.0,74.0,68.0,2,140,0.0,74.0,70.0
61191.0,6,10,2032,5,524,12500.25,252.0,104.8,5,1508,14811.5,1236.0,301.6
207431.0,6,3,426,2,280,0.0,214.0,140.0,1,146,0.0,146.0,146.0
90032026.0,17,25,11975,25,11975,3751334.4166666665,501.0,479.0,0,0,0.0,0.0,0.0
204911.0,17,2,180,1,90,0.0,90.0,90.0,1,90,0.0,90.0,90.0
494353.0,6,3,1604,1,753,0.0,753.0,753.0,2,851,0.0,785.0,425.5
317056.0,6,6,412,4,272,105685.33333333331,74.0,68.0,2,140,0.0,74.0,70.0
18964.0,6,14,4740,7,653,2917.333333333333,249.0,93.28571428571428,7,4087,3024.1666666666665,1514.0,583.8571428571429
2781870.0,6,2,132,1,66,0.0,66.0,66.0,1,66,0.0,66.0,66.0
342.0,17,2,250,1,93,0.0,93.0,93.0,1,157,0.0,157.0,157.0
15298.0,6,13,1459,7,862,2549.6666666666665,271.0,123.14285714285714,6,597,2660.0,259.0,99.5
10110.0,17,4,823,2,163,0.0,89.0,81.5,2,660,0.0,443.0,330.0
52612.0,6,14,4740,7,653,8524.166666666666,249.0,93.28571428571428,7,4087,8189.333333333333,1514.0,583.8571428571429
144099.0,17,2,180,1,90,0.0,90.0,90.0,1,90,0.0,90.0,90.0
90038491.0,17,28,13364,28,13364,3334758.925925926,501.0,477.2857142857143,0,0,0.0,0.0,0.0
0.0,17,1,55,1,55,0.0,55.0,55.0,0,0,0.0,0.0,0.0
207457.0,6,3,426,2,280,0.0,214.0,140.0,1,146,0.0,146.0,146.0
108107532.0,17,5,955,5,955,27026883.0,191.0,191.0,0,0,0.0,0.0,0.0
973.0,17,2,250,1,93,0.0,93.0,93.0,1,157,0.0,157.0,157.0
206765.0,6,3,426,2,280,0.0,214.0,140.0,1,146,0.0,146.0,146.0
90049697.0,17,28,13364,28,13364,3335173.962962963,501.0,477.2857142857143,0,0,0.0,0.0,0.0
113619059.0,6,46,3036,23,1518,5150439.5,66.0,66.0,23,1518,5150443.0,66.0,66.0
4555.0,17,2,762,2,762,0.0,381.0,381.0,0,0,0.0,0.0,0.0
309955.0,6,6,412,4,272,103318.33333333331,74.0,68.0,2,140,0.0,74.0,70.0
98105.0,17,2,762,2,762,0.0,381.0,381.0,0,0,0.0,0.0,0.0
108245049.0,6,31,2182,16,1165,7202712.266666667,139.0,72.8125,15,1017,7717184.642857143,123.0,67.8
56386521.0,6,9,1479,9,1479,7048315.125,172.0,164.33333333333334,0,0,0.0,0.0,0.0
10534027.0,6,7,478,4,272,3464387.6666666665,74.0,68.0,3,206,5195854.0,74.0,68.66666666666667
220453.0,6,3,426,2,280,0.0,214.0,140.0,1,146,0.0,146.0,146.0
21527.0,6,20,7606,11,978,2152.7,310.0,88.9090909090909,9,6628,2407.625,1514.0,736.4444444444445
108350.0,17,2,286,2,286,0.0,143.0,143.0,0,0,0.0,0.0,0.0
310.0,17,2,174,1,79,0.0,79.0,79.0,1,95,0.0,95.0,95.0
8971.0,17,2,539,1,86,0.0,86.0,86.0,1,453,0.0,453.0,453.0
37507.0,6,14,4740,7,653,5756.0,249.0,93.28571428571428,7,4087,5071.5,1514.0,583.8571428571429
115925500.0,6,48,3168,24,1584,5040239.130434782,66.0,66.0,24,1584,5027155.173913044,66.0,66.0
49050.0,6,14,4740,7,653,8059.166666666667,249.0,93.28571428571428,7,4087,7874.666666666667,1514.0,583.8571428571429
42041.0,6,10,2032,5,524,9426.75,252.0,104.8,5,1508,9371.25,1236.0,301.6
284131.0,17,2,363,1,79,0.0,79.0,79.0,1,284,0.0,284.0,284.0
44602.0,6,14,4740,7,653,6309.666666666667,249.0,93.28571428571428,7,4087,6249.333333333333,1514.0,583.8571428571429
57550.0,6,14,4740,7,653,9463.0,249.0,93.28571428571428,7,4087,9175.833333333334,1514.0,583.8571428571429
205825.0,17,2,180,1,90,0.0,90.0,90.0,1,90,0.0,90.0,90.0
101998582.0,6,203,22836,102,7028,1009886.9504950496,140.0,68.90196078431373,101,15808,1010849.98,284.0,156.5148514851485
205967.0,17,2,180,1,90,0.0,90.0,90.0,1,90,0.0,90.0,90.0
90051970.0,17,28,13364,28,13364,3335258.1481481483,501.0,477.2857142857143,0,0,0.0,0.0,0.0
297632.0,6,6,412,4,272,99210.66666666669,74.0,68.0,2,140,0.0,74.0,70.0
246233.0,6,3,337,2,214,0.0,160.0,107.0,1,123,0.0,123.0,123.0
205744.0,17,2,180,1,90,0.0,90.0,90.0,1,90,0.0,90.0,90.0
108107709.0,17,5,955,5,955,27026927.25,191.0,191.0,0,0,0.0,0.0,0.0
90090455.0,6,11,1644,4,816,30029355.33333333,204.0,204.0,7,828,15014540.333333334,188.0,118.28571428571428
2112033.0,6,19,6869,11,1567,211203.3,408.0,142.45454545454547,8,5302,239063.57142857145,1514.0,662.75
48486.0,6,10,2032,5,524,11633.0,252.0,104.8,5,1508,10807.0,1236.0,301.6
153442.0,17,2,180,1,90,0.0,90.0,90.0,1,90,0.0,90.0,90.0
128551754.0,6,35,2394,18,1269,7561867.882352941,123.0,70.5,17,1125,7397572.375,123.0,66.17647058823529
213648.0,17,2,180,1,90,0.0,90.0,90.0,1,90,0.0,90.0,90.0
36380.0,6,14,4740,7,653,5860.5,249.0,93.28571428571428,7,4087,5241.833333333333,1514.0,583.8571428571429
90042249.0,17,28,13364,28,13364,3334898.111111111,501.0,477.2857142857143,0,0,0.0,0.0,0.0
283954.0,17,2,363,1,79,0.0,79.0,79.0,1,284,0.0,284.0,284.0
398.0,17,2,152,1,76,0.0,76.0,76.0,1,76,0.0,76.0,76.0
3006546.0,6,11,2106,6,598,601135.6,252.0,99.66666666666669,5,1508,2054.5,1236.0,301.6
108105342.0,17,5,1005,5,1005,27026335.5,201.0,201.0,0,0,0.0,0.0,0.0
120142862.0,6,14,2240,6,1224,24028572.4,204.0,204.0,8,1016,17098042.285714287,188.0,127.0
197968.0,17,2,180,1,90,0.0,90.0,90.0,1,90,0.0,90.0,90.0
241891.0,6,3,337,2,214,0.0,160.0,107.0,1,123,0.0,123.0,123.0
122978687.0,6,48,3168,24,1584,4960640.478260869,66.0,66.0,24,1584,5306444.0869565215,66.0,66.0
314366.0,17,4,1400,4,1400,104788.66666666669,350.0,350.0,0,0,0.0,0.0,0.0
109584592.0,6,47,3876,25,2067,4566024.666666667,123.0,82.68,22,1809,5208023.333333333,123.0,82.22727272727273
280064.0,17,2,363,1,79,0.0,79.0,79.0,1,284,0.0,284.0,284.0
108104216.0,17,5,955,5,955,27026054.0,191.0,191.0,0,0,0.0,0.0,0.0
0.0,6,1,172,1,172,0.0,172.0,172.0,0,0,0.0,0.0,0.0
45487.0,6,14,4740,7,653,6826.666666666667,249.0,93.28571428571428,7,4087,7355.5,1514.0,583.8571428571429
113520295.0,6,47,3102,24,1584,4935654.0869565215,66.0,66.0,23,1518,5160001.590909091,66.0,66.0
305211.0,17,4,704,2,148,0.0,74.0,74.0,2,556,0.0,280.0,278.0
135615.0,6,2,132,1,66,0.0,66.0,66.0,1,66,0.0,66.0,66.0
336.0,17,2,166,1,75,0.0,75.0,75.0,1,91,0.0,91.0,91.0
765.0,17,2,762,2,762,0.0,381.0,381.0,0,0,0.0,0.0,0.0
1981.0,17,4,344,2,150,0.0,75.0,75.0,2,194,0.0,103.0,97.0
122016.0,6,3,337,2,214,0.0,160.0,107.0,1,123,0.0,123.0,123.0
35041.0,6,14,4740,7,653,5497.333333333333,249.0,93.28571428571428,7,4087,5281.666666666667,1514.0,583.8571428571429
9091.0,17,2,614,1,72,0.0,72.0,72.0,1,542,0.0,542.0,542.0
285778.0,17,4,571,2,148,0.0,74.0,74.0,2,423,0.0,276.0,211.5
331.0,17,2,166,1,75,0.0,75.0,75.0,1,91,0.0,91.0,91.0
144037.0,17,2,180,1,90,0.0,90.0,90.0,1,90,0.0,90.0,90.0
47276.0,6,14,4740,7,653,7302.666666666667,249.0,93.28571428571428,7,4087,7137.333333333333,1514.0,583.8571428571429
18309.0,6,11,2098,6,590,3483.0,252.0,98.33333333333331,5,1508,4282.0,1236.0,301.6
4799654.0,6,5,336,2,134,0.0,68.0,67.0,3,202,1525739.5,70.0,67.33333333333333
0.0,17,1,55,1,55,0.0,55.0,55.0,0,0,0.0,0.0,0.0
0.0,17,1,44,1,44,0.0,44.0,44.0,0,0,0.0,0.0,0.0
119854699.0,6,13,1898,9,1082,14981837.375,188.0,120.22222222222224,4,816,30032967.33333333,204.0,204.0
90286864.0,6,21,1585,11,840,9024173.0,95.0,76.36363636363636,10,745,9952073.777777778,95.0,74.5
217893.0,6,3,426,2,280,0.0,214.0,140.0,1,146,0.0,146.0,146.0
2413.0,17,4,344,2,150,0.0,75.0,75.0,2,194,0.0,103.0,97.0
1579.0,17,2,762,2,762,0.0,381.0,381.0,0,0,0.0,0.0,0.0
120123937.0,6,18,2543,9,1284,15015492.125,204.0,142.66666666666666,9,1259,11281745.0,199.0,139.88888888888889
135138351.0,17,6,1146,6,1146,27027670.2,191.0,191.0,0,0,0.0,0.0,0.0
10011.0,6,10,2032,5,524,2237.25,252.0,104.8,5,1508,1687.25,1236.0,301.6
541691.0,17,6,2100,6,2100,108338.2,350.0,350.0,0,0,0.0,0.0,0.0
2050841.0,6,4,270,2,134,0.0,68.0,67.0,2,136,0.0,70.0,68.0
25398.0,6,14,4740,7,653,4125.333333333333,249.0,93.28571428571428,7,4087,4071.5,1514.0,583.8571428571429
26806.0,6,14,4740,7,653,3748.8333333333335,249.0,93.28571428571428,7,4087,4292.166666666667,1514.0,583.8571428571429
90538639.0,6,13,2036,8,1016,12934091.285714284,188.0,127.0,5,1020,22593469.0,204.0,204.0
29695570.0,6,25,8361,13,1707,2474630.833333333,408.0,131.30769230769232,12,6654,2399897.8181818184,1514.0,554.5
503692.0,6,5,336,2,134,0.0,68.0,67.0,3,202,192454.0,70.0,67.33333333333333
2591333.0,6,2,132,1,66,0.0,66.0,66.0,1,66,0.0,66.0,66.0
14628838.0,6,20,1607,10,975,1592634.6666666667,315.0,97.5,10,632,1592612.3333333333,78.0,63.2
90494336.0,6,16,2510,8,1016,12927762.285714284,188.0,127.0,8,1494,12904761.57142857,204.0,186.75
10421316.0,6,6,412,3,206,5142494.0,74.0,68.66666666666667,3,206,5142381.5,74.0,68.66666666666667
148074.0,17,2,180,1,90,0.0,90.0,90.0,1,90,0.0,90.0,90.0
500564.0,6,5,336,2,134,0.0,68.0,67.0,3,202,195830.0,70.0,67.33333333333333
298430.0,6,6,412,4,272,99476.66666666669,74.0,68.0,2,140,0.0,74.0,70.0
120120723.0,6,18,2760,10,1392,13346747.0,188.0,139.2,8,1368,12909129.857142856,204.0,171.0
15944.0,6,11,1133,6,602,2884.8,264.0,100.33333333333331,5,531,3743.25,259.0,106.2
617120.0,17,2,346,1,78,0.0,78.0,78.0,1,268,0.0,268.0,268.0
2471.0,17,4,344,2,150,0.0,75.0,75.0,2,194,0.0,103.0,97.0
300.0,17,2,168,1,76,0.0,76.0,76.0,1,92,0.0,92.0,92.0
47665.0,6,14,4740,7,653,7812.666666666667,249.0,93.28571428571428,7,4087,7681.0,1514.0,583.8571428571429
266276.0,17,2,180,1,90,0.0,90.0,90.0,1,90,0.0,90.0,90.0
79636.0,6,14,4740,7,653,12636.0,249.0,93.28571428571428,7,4087,12388.666666666666,1514.0,583.8571428571429
57565.0,6,14,4740,7,653,9289.666666666666,249.0,93.28571428571428,7,4087,4803.666666666667,1514.0,583.8571428571429
90255902.0,6,12,1832,8,1016,12893700.285714284,188.0,127.0,4,816,30030399.666666668,204.0,204.0
99383632.0,17,12,778,6,389,19800157.8,174.0,64.83333333333333,6,389,19801190.4,174.0,64.83333333333333
32241.0,6,14,4740,7,653,5049.5,249.0,93.28571428571428,7,4087,5121.333333333333,1514.0,583.8571428571429
1956.0,17,2,180,1,90,0.0,90.0,90.0,1,90,0.0,90.0,90.0
156020.0,6,3,337,2,214,0.0,160.0,107.0,1,123,0.0,123.0,123.0
338.0,17,2,160,1,80,0.0,80.0,80.0,1,80,0.0,80.0,80.0
22646.0,6,14,4740,7,653,3559.0,249.0,93.28571428571428,7,4087,3336.833333333333,1514.0,583.8571428571429
30126.0,6,14,4740,7,653,4310.666666666667,249.0,93.28571428571428,7,4087,4888.666666666667,1514.0,583.8571428571429
308470.0,6,6,412,4,272,102823.33333333331,74.0,68.0,2,140,0.0,74.0,70.0
218007.0,6,3,426,2,280,0.0,214.0,140.0,1,146,0.0,146.0,146.0
143880.0,17,2,180,1,90,0.0,90.0,90.0,1,90,0.0,90.0,90.0
38431.0,6,14,4740,7,653,5891.166666666667,249.0,93.28571428571428,7,4087,6265.333333333333,1514.0,583.8571428571429
2388441.0,6,3,1604,1,753,0.0,753.0,753.0,2,851,0.0,785.0,425.5
4413.0,17,2,626,1,72,0.0,72.0,72.0,1,554,0.0,554.0,554.0
353.0,17,2,166,1,75,0.0,75.0,75.0,1,91,0.0,91.0,91.0
303137.0,6,2,132,1,66,0.0,66.0,66.0,1,66,0.0,66.0,66.0
135150083.0,17,6,1206,6,1206,27030016.6,201.0,201.0,0,0,0.0,0.0,0.0
90292960.0,6,17,1287,9,691,11281419.375,95.0,76.77777777777777,8,596,12898342.857142856,95.0,74.5
76717707.0,17,14,4788,14,4788,5901362.076923077,342.0,342.0,0,0,0.0,0.0,0.0
2458.0,17,4,344,2,150,0.0,75.0,75.0,2,194,0.0,103.0,97.0
115817429.0,6,47,3102,23,1518,5167947.681818182,66.0,66.0,24,1584,5035528.913043479,66.0,66.0
26327.0,6,14,4740,7,653,4227.333333333333,249.0,93.28571428571428,7,4087,4123.833333333333,1514.0,583.8571428571429
90938110.0,6,21,1585,11,840,9092335.9,95.0,76.36363636363636,10,745,10100903.555555556,95.0,74.5
40114.0,6,10,2032,5,524,9726.0,252.0,104.8,5,1508,9453.25,1236.0,301.6
135136838.0,17,6,1206,6,1206,27027367.6,201.0,201.0,0,0,0.0,0.0,0.0
207026.0,6,3,426,2,280,0.0,214.0,140.0,1,146,0.0,146.0,146.0
135129490.0,17,6,1206,6,1206,27025898.0,201.0,201.0,0,0,0.0,0.0,0.0
29420.0,6,10,2032,5,524,5562.0,252.0,104.8,5,1508,6262.25,1236.0,301.6
6374.0,17,2,239,1,82,0.0,82.0,82.0,1,157,0.0,157.0,157.0
303103.0,6,2,132,1,66,0.0,66.0,66.0,1,66,0.0,66.0,66.0
273284.0,6,12,1373,7,714,45547.333333333336,298.0,102.0,5,659,63985.0,379.0,131.8
280580.0,17,2,180,1,90,0.0,90.0,90.0,1,90,0.0,90.0,90.0
297097.0,6,6,412,4,272,99032.33333333331,74.0,68.0,2,140,0.0,74.0,70.0
35660.0,6,10,2032,5,524,8686.5,252.0,104.8,5,1508,8479.5,1236.0,301.6
135136145.0,17,6,1146,6,1146,27027229.0,191.0,191.0,0,0,0.0,0.0,0.0
91425832.0,6,22,1680,12,935,8311170.181818182,95.0,77.91666666666667,10,745,10156948.555555556,95.0,74.5
129507305.0,6,31,2119,15,1017,8537300.857142856,123.0,67.8,16,1102,8633789.866666667,139.0,68.875
1166181.0,6,13,3004,8,2376,166597.2857142857,1514.0,297.0,5,628,222598.25,331.0,125.6
95996684.0,6,167,18828,84,5766,1156586.5542168675,140.0,68.64285714285714,83,13062,1158027.1829268292,284.0,157.3734939759036
135130081.0,17,6,1146,6,1146,27026016.2,191.0,191.0,0,0,0.0,0.0,0.0
118900634.0,6,39,2886,20,1515,6257928.105263158,123.0,75.75,19,1371,6593607.333333333,123.0,72.15789473684211
311207.0,17,4,1400,4,1400,103735.66666666669,350.0,350.0,0,0,0.0,0.0,0.0
106545.0,17,2,286,2,286,0.0,143.0,143.0,0,0,0.0,0.0,0.0
59486365.0,17,9,3086,8,2736,5212731.571428572,342.0,342.0,1,350,0.0,350.0,350.0
317438.0,17,4,1400,4,1400,105812.66666666669,350.0,350.0,0,0,0.0,0.0,0.0
27115.0,6,14,4740,7,653,4226.166666666667,249.0,93.28571428571428,7,4087,4377.166666666667,1514.0,583.8571428571429
143941.0,17,2,180,1,90,0.0,90.0,90.0,1,90,0.0,90.0,90.0
325747.0,17,4,1400,4,1400,108582.33333333331,350.0,350.0,0,0,0.0,0.0,0.0
204697.0,17,2,762,2,762,0.0,381.0,381.0,0,0,0.0,0.0,0.0
90210432.0,6,16,1192,8,596,12852373.57142857,95.0,74.5,8,596,12857959.42857143,95.0,74.5
28826.0,6,14,4740,7,653,4637.166666666667,249.0,93.28571428571428,7,4087,4190.666666666667,1514.0,583.8571428571429
228109.0,17,2,180,1,90,0.0,90.0,90.0,1,90,0.0,90.0,90.0
37349.0,6,14,4740,7,653,5928.5,249.0,93.28571428571428,7,4087,5625.5,1514.0,583.8571428571429
135119124.0,17,6,1146,6,1146,27023824.8,191.0,191.0,0,0,0.0,0.0,0.0
300.0,17,2,164,1,82,0.0,82.0,82.0,1,82,0.0,82.0,82.0
25621747.0,17,5,1718,4,1368,888747.6666666666,342.0,342.0,1,350,0.0,350.0,350.0
14663722.0,6,20,1607,10,975,1593177.5555555555,315.0,97.5,10,632,1592631.5555555555,78.0,63.2
310826.0,17,4,1400,4,1400,103608.66666666669,350.0,350.0,0,0,0.0,0.0,0.0
108107937.0,17,5,955,5,955,27026984.25,191.0,191.0,0,0,0.0,0.0,0.0
137468.0,6,2,132,1,66,0.0,66.0,66.0,1,66,0.0,66.0,66.0
135125063.0,17,6,1146,6,1146,27025012.6,191.0,191.0,0,0,0.0,0.0,0.0
108105011.0,17,5,955,5,955,27026252.75,191.0,191.0,0,0,0.0,0.0,0.0
308.0,17,2,174,1,79,0.0,79.0,79.0,1,95,0.0,95.0,95.0
103005.0,17,2,286,2,286,0.0,143.0,143.0,0,0,0.0,0.0,0.0
122930669.0,6,34,2350,17,1125,7059067.5,123.0,66.17647058823529,17,1225,7059086.0,139.0,72.05882352941177
36934.0,6,11,2098,6,590,7197.4,252.0,98.33333333333331,5,1508,7403.25,1236.0,301.6
108108808.0,17,5,1005,5,1005,27027202.0,201.0,201.0,0,0,0.0,0.0,0.0
90372715.0,6,16,1192,8,596,12904189.42857143,95.0,74.5,8,596,12908595.142857144,95.0,74.5
33977.0,6,14,4740,7,653,5508.0,249.0,93.28571428571428,7,4087,4848.166666666667,1514.0,583.8571428571429
387769.0,17,2,363,1,75,0.0,75.0,75.0,1,288,0.0,288.0,288.0
2890034.0,17,2,876,2,876,0.0,438.0,438.0,0,0,0.0,0.0,0.0
50811.0,6,14,4740,7,653,8156.5,249.0,93.28571428571428,7,4087,7859.5,1514.0,583.8571428571429
90254958.0,6,14,2240,8,1016,12893565.42857143,188.0,127.0,6,1224,18018763.4,204.0,204.0
171749.0,17,2,180,1,90,0.0,90.0,90.0,1,90,0.0,90.0,90.0
68189.0,6,14,4740,7,653,11083.666666666666,249.0,93.28571428571428,7,4087,10222.833333333334,1514.0,583.8571428571429
1313499.0,6,4,264,2,132,0.0,66.0,66.0,2,132,0.0,66.0,66.0
131087.0,6,3,337,2,214,0.0,160.0,107.0,1,123,0.0,123.0,123.0
205257.0,17,2,762,2,762,0.0,381.0,381.0,0,0,0.0,0.0,0.0
43386.0,6,14,4740,7,653,6544.666666666667,249.0,93.28571428571428,7,4087,6539.833333333333,1514.0,583.8571428571429
108102949.0,17,5,955,5,955,27025737.25,191.0,191.0,0,0,0.0,0.0,0.0
34559.0,6,10,2032,5,524,7803.75,252.0,104.8,5,1508,7882.25,1236.0,301.6
1314284.0,6,4,264,2,132,0.0,66.0,66.0,2,132,0.0,66.0,66.0
20030.0,6,10,2032,5,524,4674.75,252.0,104.8,5,1508,4778.75,1236.0,301.6
108097735.0,17,5,1005,5,1005,27024433.75,201.0,201.0,0,0,0.0,0.0,0.0
2095.0,17,4,344,2,150,0.0,75.0,75.0,2,194,0.0,103.0,97.0
2311.0,17,4,344,2,150,0.0,75.0,75.0,2,194,0.0,103.0,97.0
28231.0,6,14,4740,7,653,4560.833333333333,249.0,93.28571428571428,7,4087,4504.5,1514.0,583.8571428571429
6041.0,17,2,762,2,762,0.0,381.0,381.0,0,0,0.0,0.0,0.0
284820.0,17,4,704,2,148,0.0,74.0,74.0,2,556,0.0,280.0,278.0
4268.0,17,2,610,1,72,0.0,72.0,72.0,1,538,0.0,538.0,538.0
90026162.0,17,27,12943,27,12943,3462544.6923076925,501.0,479.3703703703704,0,0,0.0,0.0,0.0
135140912.0,17,6,1206,6,1206,27028182.4,201.0,201.0,0,0,0.0,0.0,0.0
156097.0,17,2,180,1,90,0.0,90.0,90.0,1,90,0.0,90.0,90.0
40707464.0,6,5,336,2,134,0.0,68.0,67.0,3,202,19057151.0,70.0,67.33333333333333
90533858.0,6,14,2240,8,1016,12933408.285714284,188.0,127.0,6,1224,18074058.8,204.0,204.0
626.0,17,2,762,2,762,0.0,381.0,381.0,0,0,0.0,0.0,0.0
90040159.0,17,28,13364,28,13364,3334820.703703704,501.0,477.2857142857143,0,0,0.0,0.0,0.0
285.0,17,2,164,1,82,0.0,82.0,82.0,1,82,0.0,82.0,82.0
2342.0,17,4,344,2,150,0.0,75.0,75.0,2,194,0.0,103.0,97.0
204315.0,17,2,762,2,762,0.0,381.0,381.0,0,0,0.0,0.0,0.0
144775.0,17,2,180,1,70,0.0,70.0,70.0,1,110,0.0,110.0,110.0
1315553.0,6,4,264,2,132,0.0,66.0,66.0,2,132,0.0,66.0,66.0
120429069.0,6,221,24896,111,17340,1094809.7181818185,284.0,156.21621621621622,110,7556,1096432.1009174313,140.0,68.69090909090909
1172202.0,6,13,3010,8,2382,167457.42857142858,1514.0,297.75,5,628,224262.5,331.0,125.6
527344.0,17,3,1026,3,1026,263672.0,342.0,342.0,0,0,0.0,0.0,0.0
109094943.0,6,32,2236,16,1165,7258618.866666666,139.0,72.8125,16,1071,7258616.733333333,123.0,66.9375
13852.0,6,12,2634,7,626,2308.6666666666665,222.0,89.42857142857143,5,2008,2615.0,1514.0,401.6
2808958.0,6,2,132,1,66,0.0,66.0,66.0,1,66,0.0,66.0,66.0
258027.0,17,2,180,1,70,0.0,70.0,70.0,1,110,0.0,110.0,110.0
115227633.0,6,47,3102,23,1518,5159999.0,66.0,66.0,24,1584,5009885.0869565215,66.0,66.0
90294503.0,6,16,1192,8,596,12892726.285714284,95.0,74.5,8,596,12897743.57142857,95.0,74.5
111516.0,17,2,286,2,286,0.0,143.0,143.0,0,0,0.0,0.0,0.0
90962175.0,6,21,1585,11,840,9094694.9,95.0,76.36363636363636,10,745,10104326.777777778,95.0,74.5
338.0,17,2,250,1,93,0.0,93.0,93.0,1,157,0.0,157.0,157.0
123839335.0,6,48,3168,24,1584,5013351.608695652,66.0,66.0,24,1584,5284899.565217392,66.0,66.0
108108749.0,17,5,955,5,955,27027187.25,191.0,191.0,0,0,0.0,0.0,0.0
90266395.0,6,12,1832,8,1016,12895199.285714284,188.0,127.0,4,816,30033389.0,204.0,204.0
313.0,17,2,174,1,79,0.0,79.0,79.0,1,95,0.0,95.0,95.0
204959.0,6,10,1221,6,636,40991.8,298.0,106.0,4,585,67275.33333333333,379.0,146.25
312081.0,6,6,412,4,272,104027.0,74.0,68.0,2,140,0.0,74.0,70.0
93004808.0,17,11,735,6,389,18600961.6,174.0,64.83333333333333,5,346,19857016.5,174.0,69.2
90294609.0,6,16,1192,8,596,12892417.57142857,95.0,74.5,8,596,12898810.714285716,95.0,74.5
4983.0,17,4,344,2,150,0.0,75.0,75.0,2,194,0.0,103.0,97.0
33994.0,6,14,4740,7,653,5289.0,249.0,93.28571428571428,7,4087,5174.5,1514.0,583.8571428571429
4207.0,17,2,602,1,72,0.0,72.0,72.0,1,530,0.0,530.0,530.0
106000976.0,17,13,821,7,432,17666829.333333332,174.0,61.71428571428572,6,389,17200845.0,174.0,64.83333333333333
90125016.0,6,164,18604,82,13044,1109996.827160494,300.0,159.0731707317073,82,5560,1109995.9259259258,140.0,67.8048780487805
301074.0,6,6,412,4,272,100358.0,74.0,68.0,2,140,0.0,74.0,70.0
93201.0,6,12,1427,6,796,17663.2,271.0,132.66666666666666,6,631,16645.2,293.0,105.16666666666669
34583.0,6,13,4412,6,409,6720.2,127.0,68.16666666666667,7,4003,5587.666666666667,1514.0,571.8571428571429
127011231.0,17,15,907,8,475,18144461.57142857,174.0,59.375,7,432,17833497.166666668,174.0,61.71428571428572
246786.0,17,4,1400,4,1400,82262.0,350.0,350.0,0,0,0.0,0.0,0.0
299348.0,6,6,412,4,272,99782.66666666669,74.0,68.0,2,140,0.0,74.0,70.0
571912.0,6,2,132,1,66,0.0,66.0,66.0,1,66,0.0,66.0,66.0
60140.0,6,14,4740,7,653,9418.666666666666,249.0,93.28571428571428,7,4087,8038.833333333333,1514.0,583.8571428571429
16352371.000000002,6,26,7627,14,3735,206654.15384615384,1514.0,266.7857142857143,12,3892,1467956.818181818,1514.0,324.3333333333333
326.0,17,2,166,1,75,0.0,75.0,75.0,1,91,0.0,91.0,91.0
108093097.0,17,5,955,5,955,27023274.25,191.0,191.0,0,0,0.0,0.0,0.0
107598.0,17,2,286,2,286,0.0,143.0,143.0,0,0,0.0,0.0,0.0
146.0,17,2,158,2,158,0.0,79.0,79.0,0,0,0.0,0.0,0.0
2850420.0,6,4,270,3,202,1425210.0,70.0,67.33333333333333,1,68,0.0,68.0,68.0
206906.0,17,2,180,1,90,0.0,90.0,90.0,1,90,0.0,90.0,90.0
252281.0,17,4,6056,4,6056,84093.66666666667,1514.0,1514.0,0,0,0.0,0.0,0.0
2108.0,17,4,344,2,150,0.0,75.0,75.0,2,194,0.0,103.0,97.0
206890.0,6,3,426,2,280,0.0,214.0,140.0,1,146,0.0,146.0,146.0
39400.0,6,14,4740,7,653,6457.333333333333,249.0,93.28571428571428,7,4087,5721.0,1514.0,583.8571428571429
1174002.0,6,13,3020,8,2392,167714.57142857142,1514.0,299.0,5,628,224553.0,331.0,125.6
505245.00000000006,6,5,336,2,134,0.0,68.0,67.0,3,202,193861.5,70.0,67.33333333333333
4387.0,17,2,610,1,72,0.0,72.0,72.0,1,538,0.0,538.0,538.0
228451.0,17,2,180,1,90,0.0,90.0,90.0,1,90,0.0,90.0,90.0
315387.0,6,6,412,4,272,105129.0,74.0,68.0,2,140,0.0,74.0,70.0
103958207.0,6,32,2236,16,1165,6916159.4,139.0,72.8125,16,1071,6916138.066666666,123.0,66.9375
139541.0,6,2,132,1,66,0.0,66.0,66.0,1,66,0.0,66.0,66.0
19187.0,6,10,2032,5,524,3428.25,252.0,104.8,5,1508,3988.75,1236.0,301.6
108113914.0,17,5,955,5,955,27028478.5,191.0,191.0,0,0,0.0,0.0,0.0
944.0,17,2,762,2,762,0.0,381.0,381.0,0,0,0.0,0.0,0.0
10367.0,17,2,582,1,83,0.0,83.0,83.0,1,499,0.0,499.0,499.0
143934.0,17,2,180,1,90,0.0,90.0,90.0,1,90,0.0,90.0,90.0
2806098.0,6,2,132,1,66,0.0,66.0,66.0,1,66,0.0,66.0,66.0
120059806.0,17,28,13364,28,13364,4446659.481481481,501.0,477.2857142857143,0,0,0.0,0.0,0.0
299049.0,6,6,412,4,272,99683.0,74.0,68.0,2,140,0.0,74.0,70.0
28442.0,6,14,4740,7,653,4389.666666666667,249.0,93.28571428571428,7,4087,4522.666666666667,1514.0,583.8571428571429
2370.0,17,4,344,2,150,0.0,75.0,75.0,2,194,0.0,103.0,97.0
103459.0,17,2,286,2,286,0.0,143.0,143.0,0,0,0.0,0.0,0.0
10863078.0,6,8,544,4,272,3575575.333333333,74.0,68.0,4,272,3575499.0,74.0,68.0
442455.0,6,10,967,5,390,74503.25,162.0,78.0,5,577,74415.75,349.0,115.4
160471.0,17,2,180,1,90,0.0,90.0,90.0,1,90,0.0,90.0,90.0
135130985.0,17,6,1206,6,1206,27026197.0,201.0,201.0,0,0,0.0,0.0,0.0
2801895.0,6,2,132,1,66,0.0,66.0,66.0,1,66,0.0,66.0,66.0
90307810.0,6,16,1192,8,596,12893938.142857144,95.0,74.5,8,596,12900115.142857144,95.0,74.5
108113091.0,17,5,955,5,955,27028272.75,191.0,191.0,0,0,0.0,0.0,0.0
197070.0,17,2,180,1,90,0.0,90.0,90.0,1,90,0.0,90.0,90.0
68521507.0,6,4,268,2,132,0.0,66.0,66.0,2,136,0.0,70.0,68.0
1317893.0,17,7,490,7,490,219648.8333333333,70.0,70.0,0,0,0.0,0.0,0.0
113157895.0,6,219,24616,110,7482,1038145.8256880734,140.0,68.01818181818182,109,17134,1038185.1203703705,284.0,157.19266055045873
128670300.0,6,32,2157,16,1071,7912350.266666667,123.0,66.9375,16,1086,8577891.666666666,123.0,67.875
310478.0,17,4,1400,4,1400,103492.66666666669,350.0,350.0,0,0,0.0,0.0,0.0
2356.0,17,4,344,2,150,0.0,75.0,75.0,2,194,0.0,103.0,97.0
69195.0,6,13,1394,7,797,10802.166666666666,253.0,113.85714285714286,6,597,13535.4,259.0,99.5
206173.0,6,3,426,2,280,0.0,214.0,140.0,1,146,0.0,146.0,146.0
145701.0,17,2,180,1,90,0.0,90.0,90.0,1,90,0.0,90.0,90.0
147282.0,6,3,373,2,238,0.0,172.0,119.0,1,135,0.0,135.0,135.0
308594.0,6,6,412,4,272,102864.66666666669,74.0,68.0,2,140,0.0,74.0,70.0
300589.0,6,6,412,4,272,100196.33333333331,74.0,68.0,2,140,0.0,74.0,70.0
31759.000000000004,6,14,4740,7,653,4392.333333333333,249.0,93.28571428571428,7,4087,5162.0,1514.0,583.8571428571429
96223828.0,17,14,1126,7,563,16001185.5,174.0,80.42857142857143,7,563,16000141.0,174.0,80.42857142857143
55972.0,6,14,4740,7,653,9205.833333333334,249.0,93.28571428571428,7,4087,9077.5,1514.0,583.8571428571429
103656.0,17,2,286,2,286,0.0,143.0,143.0,0,0,0.0,0.0,0.0
319343.0,6,6,412,4,272,106447.66666666669,74.0,68.0,2,140,0.0,74.0,70.0
99694083.0,17,12,778,6,389,19913021.2,174.0,64.83333333333333,6,389,19906622.8,174.0,64.83333333333333
2989.0,17,2,224,1,76,0.0,76.0,76.0,1,148,0.0,148.0,148.0
107842166.0,6,28,1860,14,966,8278930.923076923,123.0,69.0,14,894,8278932.923076923,123.0,63.85714285714285
23172.0,6,10,2032,5,524,5344.5,252.0,104.8,5,1508,5107.0,1236.0,301.6
111593104.0,17,14,864,7,432,18598850.666666668,174.0,61.71428571428572,7,432,18423391.33333333,174.0,61.71428571428572
12924.0,17,4,344,2,150,0.0,75.0,75.0,2,194,0.0,103.0,97.0
312878.0,17,4,1400,4,1400,104292.66666666669,350.0,350.0,0,0,0.0,0.0,0.0
10848168.0,6,7,478,3,206,5354035.5,74.0,68.66666666666667,4,272,3569271.6666666665,74.0,68.0
90050004.0,17,28,13364,28,13364,3335185.333333333,501.0,477.2857142857143,0,0,0.0,0.0,0.0
46499.0,6,10,2032,5,524,11274.25,252.0,104.8,5,1508,11103.25,1236.0,301.6
121958.0,6,3,373,2,238,0.0,172.0,119.0,1,135,0.0,135.0,135.0
162272.0,17,2,180,1,90,0.0,90.0,90.0,1,90,0.0,90.0,90.0
37789.0,6,10,2032,5,524,6097.0,252.0,104.8,5,1508,8432.75,1236.0,301.6
1221116.0,6,11,1134,6,558,244223.2,220.0,93.0,5,576,303965.25,304.0,115.2
108098907.0,17,5,1005,5,1005,27024726.75,201.0,201.0,0,0,0.0,0.0,0.0
204774.0,17,2,762,2,762,0.0,381.0,381.0,0,0,0.0,0.0,0.0
143935.0,17,2,180,1,90,0.0,90.0,90.0,1,90,0.0,90.0,90.0
108107780.0,17,5,1005,5,1005,27026945.0,201.0,201.0,0,0,0.0,0.0,0.0
51968.0,6,10,2032,5,524,12268.0,252.0,104.8,5,1508,12660.0,1236.0,301.6
2797553.0,6,2,132,1,66,0.0,66.0,66.0,1,66,0.0,66.0,66.0
162764.0,6,10,1066,5,490,38419.25,218.0,98.0,5,576,40331.5,304.0,115.2
6091.0,17,2,239,1,82,0.0,82.0,82.0,1,157,0.0,157.0,157.0
353.0,17,2,267,1,83,0.0,83.0,83.0,1,184,0.0,184.0,184.0
48540.0,6,13,1386,7,789,7758.333333333333,253.0,112.71428571428572,6,597,9308.2,259.0,99.5
90040236.0,17,28,13364,28,13364,3334823.5555555555,501.0,477.2857142857143,0,0,0.0,0.0,0.0
18131.0,6,10,1065,5,534,4287.75,262.0,106.8,5,531,3817.5,259.0,106.2
10544310.0,6,7,478,4,272,3467459.333333333,74.0,68.0,3,206,5201111.5,74.0,68.66666666666667
109277.0,17,4,1400,4,1400,36425.66666666666,350.0,350.0,0,0,0.0,0.0,0.0
98833993.0,17,12,778,6,389,19601642.8,174.0,64.83333333333333,6,389,19600166.2,174.0,64.83333333333333
113122453.0,6,37,2656,19,1408,6272588.944444444,139.0,74.10526315789474,18,1248,6641561.235294118,123.0,69.33333333333333
601160.0,17,2,473,1,78,0.0,78.0,78.0,1,395,0.0,395.0,395.0
303828.0,6,6,412,4,272,101276.0,74.0,68.0,2,140,0.0,74.0,70.0
108107948.0,17,5,955,5,955,27026987.0,191.0,191.0,0,0,0.0,0.0,0.0
103612.0,17,2,286,2,286,0.0,143.0,143.0,0,0,0.0,0.0,0.0
108106466.0,17,5,1005,5,1005,27026616.5,201.0,201.0,0,0,0.0,0.0,0.0
120179585.0,6,232,26290,116,7952,1037944.1652173912,140.0,68.55172413793103,116,18338,1036531.408695652,284.0,158.08620689655172
102526.0,17,2,286,2,286,0.0,143.0,143.0,0,0,0.0,0.0,0.0
5006768.0,17,4,849,2,166,0.0,83.0,83.0,2,683,0.0,499.0,341.5
108104763.0,17,5,1005,5,1005,27026190.75,201.0,201.0,0,0,0.0,0.0,0.0
1861.0,17,2,192,1,88,0.0,88.0,88.0,1,104,0.0,104.0,104.0
2355527.0,6,3,1604,2,851,0.0,785.0,425.5,1,753,0.0,753.0,753.0
5623276.0,6,5,336,2,134,0.0,68.0,67.0,3,202,1423586.0,70.0,67.33333333333333
13322.0,6,13,1459,7,862,2177.833333333333,271.0,123.14285714285714,6,597,2515.0,259.0,99.5
122194414.0,6,35,2473,18,1348,7187906.705882353,139.0,74.88888888888889,17,1125,7444883.125,123.0,66.17647058823529
108106889.0,17,5,955,5,955,27026722.25,191.0,191.0,0,0,0.0,0.0,0.0
27270.0,6,10,2032,5,524,6322.75,252.0,104.8,5,1508,6256.25,1236.0,301.6
96008868.0,6,187,21076,94,6438,1032353.4193548388,140.0,68.48936170212765,93,14638,1033463.9891304348,284.0,157.3978494623656
202347.0,17,4,6056,4,6056,67449.0,1514.0,1514.0,0,0,0.0,0.0,0.0
113359292.0,6,35,2526,18,1332,6655488.411764706,123.0,74.0,17,1194,7071456.5625,123.0,70.23529411764706
3234774.0,6,19,6869,10,1501,359419.3333333333,408.0,150.1,9,5368,345407.875,1514.0,596.4444444444445
34727.0,6,14,4740,7,653,5643.833333333333,249.0,93.28571428571428,7,4087,5507.0,1514.0,583.8571428571429
12239.0,6,11,1133,6,602,1992.4,264.0,100.33333333333331,5,531,2536.25,259.0,106.2
207524.0,17,2,180,1,90,0.0,90.0,90.0,1,90,0.0,90.0,90.0
1025374.0,6,11,1134,6,558,205074.8,220.0,93.0,5,576,255341.5,304.0,115.2
0.0,17,1,55,1,55,0.0,55.0,55.0,0,0,0.0,0.0,0.0
120455371.0,6,259,30518,130,21708,933762.5658914729,284.0,166.98461538461538,129,8810,933066.5859375,140.0,68.29457364341086
228252.0,17,2,180,1,90,0.0,90.0,90.0,1,90,0.0,90.0,90.0
58849506.0,17,9,3086,8,2736,5111141.714285715,342.0,342.0,1,350,0.0,350.0,350.0
40816.0,6,14,4740,7,653,6680.333333333333,249.0,93.28571428571428,7,4087,6478.666666666667,1514.0,583.8571428571429
128687538.0,17,14,864,7,432,18333498.33333333,174.0,61.71428571428572,7,432,18334964.0,174.0,61.71428571428572
90986624.0,6,21,1585,11,840,9094156.6,95.0,76.36363636363636,10,745,10108657.333333334,95.0,74.5
108108733.0,17,5,1005,5,1005,27027183.25,201.0,201.0,0,0,0.0,0.0,0.0
191006.0,17,2,180,1,90,0.0,90.0,90.0,1,90,0.0,90.0,90.0
38373.0,6,14,4740,7,653,6151.333333333333,249.0,93.28571428571428,7,4087,5905.0,1514.0,583.8571428571429
303.0,17,2,168,1,76,0.0,76.0,76.0,1,92,0.0,92.0,92.0
18542.0,6,14,4740,7,653,2729.333333333333,249.0,93.28571428571428,7,4087,2943.6666666666665,1514.0,583.8571428571429
121010890.0,17,15,907,8,475,17287270.0,174.0,59.375,7,432,16900458.166666668,174.0,61.71428571428572
265833.0,6,10,1221,6,636,53166.6,298.0,106.0,4,585,83214.66666666667,379.0,146.25
5620926.0,6,5,336,2,134,0.0,68.0,67.0,3,202,1420693.0,70.0,67.33333333333333
2394.0,17,4,344,2,150,0.0,75.0,75.0,2,194,0.0,103.0,97.0
207203.0,17,2,180,1,90,0.0,90.0,90.0,1,90,0.0,90.0,90.0
71983.0,6,14,4740,7,653,11387.333333333334,249.0,93.28571428571428,7,4087,11165.833333333334,1514.0,583.8571428571429
135137590.0,17,6,1146,6,1146,27027518.0,191.0,191.0,0,0,0.0,0.0,0.0
34750.0,6,10,2032,5,524,8439.0,252.0,104.8,5,1508,8117.0,1236.0,301.6
282060.0,6,10,1221,6,636,56412.0,298.0,106.0,4,585,92906.66666666669,379.0,146.25
120769131.0,6,226,25406,113,7754,1070983.142857143,140.0,68.61946902654867,113,17652,1074635.4017857143,284.0,156.21238938053096
19780.0,6,11,2098,6,590,3127.0,252.0,98.33333333333331,5,1508,4649.5,1236.0,301.6
112464302.0,6,46,3036,23,1518,5112001.909090909,66.0,66.0,23,1518,5112002.181818182,66.0,66.0
27351.0,6,14,4740,7,653,4153.833333333333,249.0,93.28571428571428,7,4087,4198.0,1514.0,583.8571428571429
1324691.0,6,4,264,2,132,0.0,66.0,66.0,2,132,0.0,66.0,66.0
19046800.0,6,4,1843,3,1017,9523400.0,885.0,339.0,1,826,0.0,826.0,826.0
30857.0,6,14,4740,7,653,3908.3333333333335,249.0,93.28571428571428,7,4087,4974.666666666667,1514.0,583.8571428571429
120232298.0,6,19,1395,10,745,13332879.0,95.0,74.5,9,650,14998756.75,95.0,72.22222222222223
217933.0,6,3,426,2,280,0.0,214.0,140.0,1,146,0.0,146.0,146.0
108108045.0,17,5,1005,5,1005,27027011.25,201.0,201.0,0,0,0.0,0.0,0.0
90757361.0,6,17,1287,9,691,11339219.875,95.0,76.77777777777777,8,596,12963648.42857143,95.0,74.5
237049.0,17,2,180,1,90,0.0,90.0,90.0,1,90,0.0,90.0,90.0
153481.0,17,2,180,1,90,0.0,90.0,90.0,1,90,0.0,90.0,90.0
2626.0,17,4,344,2,150,0.0,75.0,75.0,2,194,0.0,103.0,97.0
91161640.0,6,26,1746,13,906,7596803.333333333,123.0,69.6923076923077,13,840,7578771.333333333,123.0,64.61538461538461
111712576.0,6,32,2220,16,1149,7433119.866666666,123.0,71.8125,16,1071,7433115.466666667,123.0,66.9375
146053.0,6,3,337,2,214,0.0,160.0,107.0,1,123,0.0,123.0,123.0
48925.0,6,14,4740,7,653,7448.166666666667,249.0,93.28571428571428,7,4087,7833.0,1514.0,583.8571428571429
2586091.0,6,2,132,1,66,0.0,66.0,66.0,1,66,0.0,66.0,66.0
280909.0,17,2,363,1,79,0.0,79.0,79.0,1,284,0.0,284.0,284.0
849760.0,6,9,1118,6,586,169952.0,248.0,97.66666666666669,3,532,287134.0,392.0,177.33333333333334
43127.0,6,14,4740,7,653,6206.166666666667,249.0,93.28571428571428,7,4087,6750.333333333333,1514.0,583.8571428571429
108105231.0,17,5,955,5,955,27026307.75,191.0,191.0,0,0,0.0,0.0,0.0
232551.0,6,3,337,2,214,0.0,160.0,107.0,1,123,0.0,123.0,123.0
299621.0,6,6,412,4,272,99873.66666666669,74.0,68.0,2,140,0.0,74.0,70.0
108108445.0,17,5,1005,5,1005,27027111.25,201.0,201.0,0,0,0.0,0.0,0.0
108113130.0,17,5,1005,5,1005,27028282.5,201.0,201.0,0,0,0.0,0.0,0.0
5616868.0,6,5,336,2,134,0.0,68.0,67.0,3,202,1423129.5,70.0,67.33333333333333
55965.0,6,14,4740,7,653,9206.333333333334,249.0,93.28571428571428,7,4087,8209.666666666666,1514.0,583.8571428571429
114647937.0,6,48,3168,24,1584,4984692.913043479,66.0,66.0,24,1584,4975296.0,66.0,66.0
2589395.0,6,25,7573,14,3735,199184.2307692308,1514.0,266.7857142857143,11,3838,233539.1,1514.0,348.90909090909093
321583.0,6,6,412,4,272,107194.33333333331,74.0,68.0,2,140,0.0,74.0,70.0
2931.0,17,2,224,1,76,0.0,76.0,76.0,1,148,0.0,148.0,148.0
233214.0,6,3,337,2,214,0.0,160.0,107.0,1,123,0.0,123.0,123.0
146132.0,6,2,132,1,66,0.0,66.0,66.0,1,66,0.0,66.0,66.0
2249.0,17,4,344,2,150,0.0,75.0,75.0,2,194,0.0,103.0,97.0
234251.0,6,3,337,2,214,0.0,160.0,107.0,1,123,0.0,123.0,123.0
45055015.0,17,9,3086,8,2736,5107738.714285715,342.0,342.0,1,350,0.0,350.0,350.0
114263903.0,6,36,2580,18,1332,6721406.05882353,123.0,74.0,18,1248,6708670.823529412,123.0,69.33333333333333
216310.0,17,2,180,1,90,0.0,90.0,90.0,1,90,0.0,90.0,90.0
339.0,17,2,174,1,79,0.0,79.0,79.0,1,95,0.0,95.0,95.0
318490.0,17,4,1400,4,1400,106163.33333333331,350.0,350.0,0,0,0.0,0.0,0.0
135138001.0,17,6,1146,6,1146,27027600.2,191.0,191.0,0,0,0.0,0.0,0.0
249499.0,17,4,1524,4,1524,83166.33333333333,381.0,381.0,0,0,0.0,0.0,0.0
216594.0,6,3,426,2,280,0.0,214.0,140.0,1,146,0.0,146.0,146.0
2793390.0,6,2,132,1,66,0.0,66.0,66.0,1,66,0.0,66.0,66.0
25655.0,6,14,4740,7,653,3848.1666666666665,249.0,93.28571428571428,7,4087,3662.6666666666665,1514.0,583.8571428571429
90021015.0,17,28,13364,28,13364,3334111.6666666665,501.0,477.2857142857143,0,0,0.0,0.0,0.0
25518.0,6,10,2032,5,524,6088.0,252.0,104.8,5,1508,5905.0,1236.0,301.6
103328.0,17,2,286,2,286,0.0,143.0,143.0,0,0,0.0,0.0,0.0
841587.0,6,9,1096,6,625,168317.4,287.0,104.16666666666669,3,471,284486.5,331.0,157.0
102806166.0,6,32,2220,16,1149,6839353.4,123.0,71.8125,16,1071,6839326.0,123.0,66.9375
310357.0,17,4,1400,4,1400,103452.33333333331,350.0,350.0,0,0,0.0,0.0,0.0
108118954.0,17,5,1005,5,1005,27029738.5,201.0,201.0,0,0,0.0,0.0,0.0
26380.0,6,14,4740,7,653,4093.5,249.0,93.28571428571428,7,4087,4239.333333333333,1514.0,583.8571428571429
302.0,17,2,164,1,82,0.0,82.0,82.0,1,82,0.0,82.0,82.0
4419.0,17,4,344,2,150,0.0,75.0,75.0,2,194,0.0,103.0,97.0
107635.0,17,2,286,2,286,0.0,143.0,143.0,0,0,0.0,0.0,0.0
41795.0,6,14,4740,7,653,6837.666666666667,249.0,93.28571428571428,7,4087,6735.166666666667,1514.0,583.8571428571429
52344.0,6,14,4740,7,653,8602.833333333334,249.0,93.28571428571428,7,4087,8534.333333333334,1514.0,583.8571428571429
107840.0,17,2,286,2,286,0.0,143.0,143.0,0,0,0.0,0.0,0.0
316471.0,17,4,1400,4,1400,105490.33333333331,350.0,350.0,0,0,0.0,0.0,0.0
41557.0,6,14,4740,7,653,6754.833333333333,249.0,93.28571428571428,7,4087,6181.166666666667,1514.0,583.8571428571429
123610531.0,6,49,3234,25,1650,5150438.791666667,66.0,66.0,24,1584,4993353.0869565215,66.0,66.0
90040405.0,17,27,12943,27,12943,3463092.5,501.0,479.3703703703704,0,0,0.0,0.0,0.0
55690.0,6,14,4740,7,653,8754.166666666666,249.0,93.28571428571428,7,4087,8921.333333333334,1514.0,583.8571428571429
37015.0,6,10,2032,5,524,8896.75,252.0,104.8,5,1508,8974.0,1236.0,301.6
207605.0,6,3,426,2,280,0.0,214.0,140.0,1,146,0.0,146.0,146.0
246281.0,6,3,337,2,214,0.0,160.0,107.0,1,123,0.0,123.0,123.0
30320.0,17,2,582,1,83,0.0,83.0,83.0,1,499,0.0,499.0,499.0
355.0,17,2,267,1,83,0.0,83.0,83.0,1,184,0.0,184.0,184.0
168005.0,17,4,1524,4,1524,56001.66666666666,381.0,381.0,0,0,0.0,0.0,0.0
30928.0,6,10,2032,5,524,7514.25,252.0,104.8,5,1508,7273.25,1236.0,301.6
108119719.0,6,32,2236,16,1165,7207981.266666667,139.0,72.8125,16,1071,7193559.133333334,123.0,66.9375
296124.0,6,12,1373,7,714,49354.0,298.0,102.0,5,659,67213.0,379.0,131.8
90091047.0,17,28,13364,28,13364,3336705.4444444445,501.0,477.2857142857143,0,0,0.0,0.0,0.0
27129327.0,17,5,1710,5,1710,6782331.75,342.0,342.0,0,0,0.0,0.0,0.0
40306.0,6,14,4740,7,653,6289.333333333333,249.0,93.28571428571428,7,4087,6419.333333333333,1514.0,583.8571428571429
3269.0,17,2,414,1,88,0.0,88.0,88.0,1,326,0.0,326.0,326.0
35744.0,6,14,4740,7,653,5835.0,249.0,93.28571428571428,7,4087,4523.166666666667,1514.0,583.8571428571429
3194.0,17,2,224,1,76,0.0,76.0,76.0,1,148,0.0,148.0,148.0
1910.0,17,2,664,1,322,0.0,322.0,322.0,1,342,0.0,342.0,342.0
2365.0,17,4,344,2,150,0.0,75.0,75.0,2,194,0.0,103.0,97.0
196868.0,17,2,180,1,90,0.0,90.0,90.0,1,90,0.0,90.0,90.0
297.0,17,2,164,1,82,0.0,82.0,82.0,1,82,0.0,82.0,82.0
48131151.0,6,8,1307,8,1307,6875878.714285715,172.0,163.375,0,0,0.0,0.0,0.0
2795667.0,6,2,132,1,66,0.0,66.0,66.0,1,66,0.0,66.0,66.0
43697.0,6,10,2032,5,524,10712.75,252.0,104.8,5,1508,9460.25,1236.0,301.6
105023705.0,6,199,22364,100,6896,1060845.505050505,140.0,68.96,99,15468,1051367.6020408163,284.0,156.24242424242425
216575.0,17,2,180,1,90,0.0,90.0,90.0,1,90,0.0,90.0,90.0
25499.0,6,14,4740,7,653,3861.8333333333335,249.0,93.28571428571428,7,4087,3769.8333333333335,1514.0,583.8571428571429
0.0,17,1,381,1,381,0.0,381.0,381.0,0,0,0.0,0.0,0.0
14414.0,6,11,2098,6,590,2662.8,252.0,98.33333333333331,5,1508,3264.25,1236.0,301.6
32751.000000000004,6,14,4740,7,653,5338.5,249.0,93.28571428571428,7,4087,5321.166666666667,1514.0,583.8571428571429
246974.0,6,3,337,2,214,0.0,160.0,107.0,1,123,0.0,123.0,123.0
135133791.0,17,6,1146,6,1146,27026758.2,191.0,191.0,0,0,0.0,0.0,0.0
90092887.0,6,13,2052,6,1224,18018114.8,204.0,204.0,7,828,14969704.0,188.0,118.28571428571428
20813.0,6,14,4740,7,653,3191.333333333333,249.0,93.28571428571428,7,4087,3331.1666666666665,1514.0,583.8571428571429
23914.0,6,14,4740,7,653,3310.0,249.0,93.28571428571428,7,4087,3831.1666666666665,1514.0,583.8571428571429
1844051.0,6,22,6443,12,1529,167641.0,357.0,127.41666666666669,10,4914,169395.77777777778,1510.0,491.4
16814.0,17,2,180,1,90,0.0,90.0,90.0,1,90,0.0,90.0,90.0
16877.0,17,2,180,1,90,0.0,90.0,90.0,1,90,0.0,90.0,90.0
15992388.0,17,6,2052,6,2052,3198477.6,342.0,342.0,0,0,0.0,0.0,0.0
9197.0,6,10,2032,5,524,1982.5,252.0,104.8,5,1508,2013.75,1236.0,301.6
90293233.0,6,17,1408,9,650,11281296.625,95.0,72.22222222222223,8,758,12897532.42857143,216.0,94.75
1460.0,17,2,762,2,762,0.0,381.0,381.0,0,0,0.0,0.0,0.0
119000916.0,17,13,821,7,432,19833486.0,174.0,61.71428571428572,6,389,19801154.8,174.0,64.83333333333333
103274561.0,17,14,864,7,432,17167712.0,174.0,61.71428571428572,7,432,17166831.166666668,174.0,61.71428571428572
90257673.0,6,13,2036,8,1016,12893953.285714284,188.0,127.0,5,1020,22523846.0,204.0,204.0
151585.0,17,2,414,1,88,0.0,88.0,88.0,1,326,0.0,326.0,326.0
4433.0,17,4,344,2,150,0.0,75.0,75.0,2,194,0.0,103.0,97.0
59347.0,6,14,4740,7,653,9231.333333333334,249.0,93.28571428571428,7,4087,9487.333333333334,1514.0,583.8571428571429
315075.0,17,4,1400,4,1400,105025.0,350.0,350.0,0,0,0.0,0.0,0.0
90285614.0,6,16,1192,8,596,12891923.857142856,95.0,74.5,8,596,12895990.142857144,95.0,74.5
31814.000000000004,6,10,2032,5,524,7079.75,252.0,104.8,5,1508,6563.25,1236.0,301.6
112265.0,17,2,700,2,700,0.0,350.0,350.0,0,0,0.0,0.0,0.0
240259.0,6,3,373,2,238,0.0,172.0,119.0,1,135,0.0,135.0,135.0
90048764.0,17,28,13364,28,13364,3335139.407407407,501.0,477.2857142857143,0,0,0.0,0.0,0.0
0.0,17,1,85,1,85,0.0,85.0,85.0,0,0,0.0,0.0,0.0
28864.0,6,11,2098,6,590,4059.8,252.0,98.33333333333331,5,1508,6752.0,1236.0,301.6
218596.0,6,3,426,2,280,0.0,214.0,140.0,1,146,0.0,146.0,146.0
2781233.0,6,2,132,1,66,0.0,66.0,66.0,1,66,0.0,66.0,66.0
108151477.0,17,5,1005,5,1005,27037869.25,201.0,201.0,0,0,0.0,0.0,0.0
122975344.0,6,48,3168,24,1584,5136339.173913044,66.0,66.0,24,1584,5130756.043478261,66.0,66.0
15389.0,6,14,4740,7,653,2459.0,249.0,93.28571428571428,7,4087,2323.6666666666665,1514.0,583.8571428571429
220922.0,6,3,426,2,280,0.0,214.0,140.0,1,146,0.0,146.0,146.0
21512.0,6,10,2032,5,524,4719.5,252.0,104.8,5,1508,5005.0,1236.0,301.6
100292.0,17,2,286,2,286,0.0,143.0,143.0,0,0,0.0,0.0,0.0
47604250.0,6,8,1940,3,887,22592810.5,753.0,295.6666666666667,5,1053,11207798.5,785.0,210.6
235760.0,6,3,337,2,214,0.0,160.0,107.0,1,123,0.0,123.0,123.0
120215.0,17,2,180,1,70,0.0,70.0,70.0,1,110,0.0,110.0,110.0
108095626.0,17,5,955,5,955,27023906.5,191.0,191.0,0,0,0.0,0.0,0.0
2334.0,17,4,344,2,150,0.0,75.0,75.0,2,194,0.0,103.0,97.0
2319.0,17,4,344,2,150,0.0,75.0,75.0,2,194,0.0,103.0,97.0
318452.0,17,4,1400,4,1400,106150.66666666669,350.0,350.0,0,0,0.0,0.0,0.0
120052151.0,17,28,13364,28,13364,4446375.962962963,501.0,477.2857142857143,0,0,0.0,0.0,0.0
121013587.0,17,15,907,8,475,17287655.285714287,174.0,59.375,7,432,16833495.5,174.0,61.71428571428572
264668.0,17,4,1400,4,1400,88222.66666666667,350.0,350.0,0,0,0.0,0.0,0.0
43791.0,6,10,2032,5,524,10636.5,252.0,104.8,5,1508,10385.5,1236.0,301.6
119070843.0,6,33,2602,16,1233,7938056.2,95.0,77.0625,17,1369,7428260.6875,95.0,80.52941176470588
120000052.0,6,17,1287,9,691,15000006.5,95.0,76.77777777777777,8,596,12900616.42857143,95.0,74.5
95343964.0,17,12,778,6,389,19000149.0,174.0,64.83333333333333,6,389,19001017.0,174.0,64.83333333333333
125463878.0,6,30,2037,15,948,8412394.07142857,123.0,63.2,15,1089,8248506.0,123.0,72.6
144785.0,17,2,180,1,70,0.0,70.0,70.0,1,110,0.0,110.0,110.0
1307939.0,6,4,264,2,132,0.0,66.0,66.0,2,132,0.0,66.0,66.0
246467.0,6,3,337,2,214,0.0,160.0,107.0,1,123,0.0,123.0,123.0
2240.0,17,4,344,2,150,0.0,75.0,75.0,2,194,0.0,103.0,97.0
108110050.0,17,5,1005,5,1005,27027512.5,201.0,201.0,0,0,0.0,0.0,0.0
297533.0,6,6,412,4,272,99177.66666666669,74.0,68.0,2,140,0.0,74.0,70.0
108103939.0,17,5,955,5,955,27025984.75,191.0,191.0,0,0,0.0,0.0,0.0
311598.0,17,4,622,4,622,103866.0,163.0,155.5,0,0,0.0,0.0,0.0
233675.0,6,3,337,2,214,0.0,160.0,107.0,1,123,0.0,123.0,123.0
106891.0,17,2,286,2,286,0.0,143.0,143.0,0,0,0.0,0.0,0.0
108096312.0,17,5,1005,5,1005,27024078.0,201.0,201.0,0,0,0.0,0.0,0.0
90289672.0,6,16,1192,8,596,12892120.42857143,95.0,74.5,8,596,12898171.285714284,95.0,74.5
233930.0,6,3,337,2,214,0.0,160.0,107.0,1,123,0.0,123.0,123.0
58685.0,6,14,4740,7,653,9555.333333333334,249.0,93.28571428571428,7,4087,8885.5,1514.0,583.8571428571429
247255.0,6,3,373,2,238,0.0,172.0,119.0,1,135,0.0,135.0,135.0
232844.0,6,3,337,2,214,0.0,160.0,107.0,1,123,0.0,123.0,123.0
171616.0,17,2,180,1,90,0.0,90.0,90.0,1,90,0.0,90.0,90.0
108108315.0,17,5,955,5,955,27027078.75,191.0,191.0,0,0,0.0,0.0,0.0
2246.0,17,4,344,2,150,0.0,75.0,75.0,2,194,0.0,103.0,97.0
90027525.0,17,28,13364,28,13364,3334352.777777778,501.0,477.2857142857143,0,0,0.0,0.0,0.0
143113.0,17,4,1524,4,1524,47704.333333333336,381.0,381.0,0,0,0.0,0.0,0.0
46440.0,6,10,2032,5,524,11250.0,252.0,104.8,5,1508,10779.0,1236.0,301.6
20434.0,6,14,4740,7,653,3088.1666666666665,249.0,93.28571428571428,7,4087,3241.6666666666665,1514.0,583.8571428571429
166571.0,17,2,180,1,90,0.0,90.0,90.0,1,90,0.0,90.0,90.0
48139.0,6,14,4740,7,653,7674.166666666667,249.0,93.28571428571428,7,4087,7874.0,1514.0,583.8571428571429
90037189.0,17,28,13364,28,13364,3334710.703703704,501.0,477.2857142857143,0,0,0.0,0.0,0.0
2408067.0,6,3,1604,2,851,0.0,785.0,425.5,1,753,0.0,753.0,753.0
8700.0,6,10,2032,5,524,1889.5,252.0,104.8,5,1508,1936.25,1236.0,301.6
233076.0,6,3,337,2,214,0.0,160.0,107.0,1,123,0.0,123.0,123.0
0.0,17,1,342,1,342,0.0,342.0,342.0,0,0,0.0,0.0,0.0
90911791.0,6,21,1585,11,840,9090276.1,95.0,76.36363636363636,10,745,10099945.222222222,95.0,74.5
28177.0,6,14,4740,7,653,4493.166666666667,249.0,93.28571428571428,7,4087,4263.0,1514.0,583.8571428571429
315.0,17,2,208,1,72,0.0,72.0,72.0,1,136,0.0,136.0,136.0
96159707.0,6,58,12312,29,6518,3434275.25,1514.0,224.7586206896552,29,5794,3424657.6785714286,1514.0,199.79310344827587
141057.0,6,2,132,1,66,0.0,66.0,66.0,1,66,0.0,66.0,66.0
228264.0,17,2,180,1,90,0.0,90.0,90.0,1,90,0.0,90.0,90.0
72990.0,6,10,2032,5,524,17747.0,252.0,104.8,5,1508,17209.5,1236.0,301.6
346.0,17,2,267,1,83,0.0,83.0,83.0,1,184,0.0,184.0,184.0
1105318.0,6,13,1394,7,797,184219.66666666663,253.0,113.85714285714286,6,597,218796.0,259.0,99.5
61345.0,6,14,4740,7,653,10093.833333333334,249.0,93.28571428571428,7,4087,8453.0,1514.0,583.8571428571429
2111.0,17,4,344,2,150,0.0,75.0,75.0,2,194,0.0,103.0,97.0
3574728.0,6,5,336,2,134,0.0,68.0,67.0,3,202,1527007.5,70.0,67.33333333333333
102649.0,17,2,286,2,286,0.0,143.0,143.0,0,0,0.0,0.0,0.0
123639855.0,6,31,2113,16,1165,8242657.0,139.0,72.8125,15,948,8415136.857142856,123.0,63.2
92768293.0,6,38,2508,19,1254,5153780.444444444,66.0,66.0,19,1254,5153779.333333333,66.0,66.0
90300939.0,6,16,1192,8,596,12893599.57142857,95.0,74.5,8,596,12898930.285714284,95.0,74.5
107359.0,17,2,286,2,286,0.0,143.0,143.0,0,0,0.0,0.0,0.0
2262.0,17,4,344,2,150,0.0,75.0,75.0,2,194,0.0,103.0,97.0
35727.0,6,10,2032,5,524,8099.25,252.0,104.8,5,1508,8293.25,1236.0,301.6
2176.0,17,4,344,2,150,0.0,75.0,75.0,2,194,0.0,103.0,97.0
213656.0,17,2,180,1,90,0.0,90.0,90.0,1,90,0.0,90.0,90.0
171742.0,17,2,180,1,90,0.0,90.0,90.0,1,90,0.0,90.0,90.0
9448.0,17,2,498,1,80,0.0,80.0,80.0,1,418,0.0,418.0,418.0
1159026.0,6,13,3000,8,2372,165575.14285714287,1514.0,296.5,5,628,221579.5,331.0,125.6
2299.0,17,4,344,2,150,0.0,75.0,75.0,2,194,0.0,103.0,97.0
114081557.0,6,48,3168,24,1584,4960067.695652174,66.0,66.0,24,1584,4950668.521739131,66.0,66.0
10468484.0,6,7,478,4,272,3444033.0,74.0,68.0,3,206,5165930.0,74.0,68.66666666666667
103767.0,17,2,700,2,700,0.0,350.0,350.0,0,0,0.0,0.0,0.0
305082.0,6,3,202,2,128,0.0,74.0,64.0,1,74,0.0,74.0,74.0
50771.0,17,2,180,1,90,0.0,90.0,90.0,1,90,0.0,90.0,90.0
90016318.0,17,28,13364,28,13364,3333937.703703704,501.0,477.2857142857143,0,0,0.0,0.0,0.0
153384.0,17,2,180,1,90,0.0,90.0,90.0,1,90,0.0,90.0,90.0
780.0,17,4,438,2,148,0.0,74.0,74.0,2,290,0.0,147.0,145.0
52909.0,6,10,2032,5,524,12769.25,252.0,104.8,5,1508,12782.0,1236.0,301.6
148154.0,17,2,180,1,90,0.0,90.0,90.0,1,90,0.0,90.0,90.0
317385.0,17,4,1400,4,1400,105795.0,350.0,350.0,0,0,0.0,0.0,0.0
727.0,17,4,438,2,148,0.0,74.0,74.0,2,290,0.0,147.0,145.0
108104111.0,17,5,955,5,955,27026027.75,191.0,191.0,0,0,0.0,0.0,0.0
146251.0,6,3,337,2,214,0.0,160.0,107.0,1,123,0.0,123.0,123.0
507065.0,6,5,336,2,134,0.0,68.0,67.0,3,202,190426.0,70.0,67.33333333333333
78.0,17,2,762,2,762,0.0,381.0,381.0,0,0,0.0,0.0,0.0
33764.0,6,14,4740,7,653,5127.333333333333,249.0,93.28571428571428,7,4087,4565.333333333333,1514.0,583.8571428571429
40574.0,6,14,4428,8,690,5796.285714285715,220.0,86.25,6,3738,6344.2,1514.0,623.0
90751270.0,6,19,1436,10,745,10077983.222222222,95.0,74.5,9,691,11342203.875,95.0,76.77777777777777
2156.0,17,2,932,1,590,0.0,590.0,590.0,1,342,0.0,342.0,342.0
299702.0,17,2,246,1,76,0.0,76.0,76.0,1,170,0.0,170.0,170.0
891307.0,6,12,2710,7,743,148551.16666666666,339.0,106.14285714285714,5,1967,154712.75,1514.0,393.4
173400.0,6,10,1066,5,490,42042.0,218.0,98.0,5,576,43008.25,304.0,115.2
146342.0,6,3,337,2,214,0.0,160.0,107.0,1,123,0.0,123.0,123.0
149815506.0,17,36,17126,36,17126,4280443.028571429,501.0,475.72222222222223,0,0,0.0,0.0,0.0
120048431.0,17,28,13364,28,13364,4446238.185185186,501.0,477.2857142857143,0,0,0.0,0.0,0.0
1049319.0,6,13,1386,7,789,174886.5,253.0,112.71428571428572,6,597,208565.8,259.0,99.5
242393.0,6,3,373,2,238,0.0,172.0,119.0,1,135,0.0,135.0,135.0
318812.0,17,4,1400,4,1400,106270.66666666669,350.0,350.0,0,0,0.0,0.0,0.0
143902.0,17,2,180,1,90,0.0,90.0,90.0,1,90,0.0,90.0,90.0
216548.0,17,2,180,1,90,0.0,90.0,90.0,1,90,0.0,90.0,90.0
33415.0,6,14,4740,7,653,5442.833333333333,249.0,93.28571428571428,7,4087,4998.833333333333,1514.0,583.8571428571429
20968271.0,17,3,1034,2,684,0.0,342.0,342.0,1,350,0.0,350.0,350.0
197194.0,17,2,180,1,90,0.0,90.0,90.0,1,90,0.0,90.0,90.0
39396.0,6,10,2032,5,524,8837.25,252.0,104.8,5,1508,7469.5,1236.0,301.6
216318.0,17,2,180,1,90,0.0,90.0,90.0,1,90,0.0,90.0,90.0
122027.0,6,4,439,2,238,0.0,172.0,119.0,2,201,0.0,135.0,100.5
304032.0,6,6,412,4,272,101344.0,74.0,68.0,2,140,0.0,74.0,70.0
9359.0,6,10,2032,5,524,2108.5,252.0,104.8,5,1508,2072.25,1236.0,301.6
197482.0,17,2,180,1,90,0.0,90.0,90.0,1,90,0.0,90.0,90.0
59417.0,6,10,2032,5,524,14361.25,252.0,104.8,5,1508,14540.0,1236.0,301.6
90056271.0,17,28,13364,28,13364,3335417.4444444445,501.0,477.2857142857143,0,0,0.0,0.0,0.0
146928.0,6,2,132,1,66,0.0,66.0,66.0,1,66,0.0,66.0,66.0
27251437.0,17,5,1710,5,1710,6812859.25,342.0,342.0,0,0,0.0,0.0,0.0
69730.0,6,13,1386,7,789,11468.666666666666,253.0,112.71428571428572,6,597,12133.0,259.0,99.5
907552.0,6,12,1447,6,816,180513.6,291.0,136.0,6,631,180446.4,293.0,105.16666666666669
279176.0,6,12,1373,7,714,46529.333333333336,298.0,102.0,5,659,64960.25,379.0,131.8
45075383.0,17,9,3086,8,2736,5109447.142857143,342.0,342.0,1,350,0.0,350.0,350.0
2403.0,17,4,344,2,150,0.0,75.0,75.0,2,194,0.0,103.0,97.0
7475.0,17,4,344,2,150,0.0,75.0,75.0,2,194,0.0,103.0,97.0
90259898.0,6,12,1832,8,1016,12894271.142857144,188.0,127.0,4,816,30031174.0,204.0,204.0
90628740.0,6,164,18540,82,12906,1116217.2962962964,284.0,157.390243902439,82,5634,1116217.2716049382,140.0,68.70731707317073
309.0,17,2,164,1,82,0.0,82.0,82.0,1,82,0.0,82.0,82.0
98214.0,17,2,762,2,762,0.0,381.0,381.0,0,0,0.0,0.0,0.0
232179.0,6,3,337,2,214,0.0,160.0,107.0,1,123,0.0,123.0,123.0
40961214.0,6,4,1670,3,917,20480607.0,785.0,305.6666666666667,1,753,0.0,753.0,753.0
325486.0,6,10,1221,6,636,65097.2,298.0,106.0,4,585,103015.33333333331,379.0,146.25
22898.0,6,14,4740,7,653,3205.833333333333,249.0,93.28571428571428,7,4087,3681.0,1514.0,583.8571428571429
11669.0,6,11,1131,6,600,2174.4,262.0,100.0,5,531,2579.25,259.0,106.2
604841.0,17,2,335,1,88,0.0,88.0,88.0,1,247,0.0,247.0,247.0
111003705.0,6,37,2942,20,1610,5830938.842105263,139.0,80.5,17,1332,6924241.125,123.0,78.3529411764706
121258.0,6,3,337,2,214,0.0,160.0,107.0,1,123,0.0,123.0,123.0
6964.0,17,2,582,1,83,0.0,83.0,83.0,1,499,0.0,499.0,499.0
4924586.0,6,13,1394,7,797,820764.3333333334,253.0,113.85714285714286,6,597,982754.4,259.0,99.5
120009844.0,6,24,1829,13,1030,9999997.0,95.0,79.23076923076923,11,799,11999471.4,95.0,72.63636363636364
135144661.0,17,6,1146,6,1146,27028932.2,191.0,191.0,0,0,0.0,0.0,0.0
28670356.0,6,32,9877,18,2306,1686491.5294117648,408.0,128.11111111111111,14,7571,1878021.5384615385,1514.0,540.7857142857143
9396.0,17,2,461,1,86,0.0,86.0,86.0,1,375,0.0,375.0,375.0
0.0,6,1,54,0,0,0.0,0.0,0.0,1,54,0.0,54.0,54.0
90285174.0,6,16,1192,8,596,12891889.42857143,95.0,74.5,8,596,12896453.142857144,95.0,74.5
103919.0,17,2,286,2,286,0.0,143.0,143.0,0,0,0.0,0.0,0.0
121168.0,6,3,337,2,214,0.0,160.0,107.0,1,123,0.0,123.0,123.0
120002315.0,6,17,1287,9,691,15000289.375,95.0,76.77777777777777,8,596,12896877.857142856,95.0,74.5
90258233.0,6,13,2036,8,1016,12894033.285714284,188.0,127.0,5,1020,22523523.5,204.0,204.0
220903.0,6,3,426,2,280,0.0,214.0,140.0,1,146,0.0,146.0,146.0
108675.0,17,2,700,2,700,0.0,350.0,350.0,0,0,0.0,0.0,0.0
28816.0,6,14,4740,7,653,4685.166666666667,249.0,93.28571428571428,7,4087,4371.833333333333,1514.0,583.8571428571429
206173.0,6,3,426,2,280,0.0,214.0,140.0,1,146,0.0,146.0,146.0
297499.0,6,6,412,4,272,99166.33333333331,74.0,68.0,2,140,0.0,74.0,70.0
3964.0,17,2,582,1,83,0.0,83.0,83.0,1,499,0.0,499.0,499.0
334.0,17,2,166,1,75,0.0,75.0,75.0,1,91,0.0,91.0,91.0
531409.0,17,6,2100,6,2100,106281.8,350.0,350.0,0,0,0.0,0.0,0.0
332.0,17,2,166,1,75,0.0,75.0,75.0,1,91,0.0,91.0,91.0
130405.0,6,3,337,2,214,0.0,160.0,107.0,1,123,0.0,123.0,123.0
104026.0,17,2,286,2,286,0.0,143.0,143.0,0,0,0.0,0.0,0.0
235275.0,6,3,337,2,214,0.0,160.0,107.0,1,123,0.0,123.0,123.0
139787.0,17,4,1524,4,1524,46595.66666666666,381.0,381.0,0,0,0.0,0.0,0.0
3074169.0,6,3,1604,2,851,0.0,785.0,425.5,1,753,0.0,753.0,753.0
1034962.0,6,11,1134,6,558,206992.4,220.0,93.0,5,576,256399.5,304.0,115.2
153447.0,17,2,180,1,90,0.0,90.0,90.0,1,90,0.0,90.0,90.0
20230.0,6,14,4740,7,653,3019.6666666666665,249.0,93.28571428571428,7,4087,3161.5,1514.0,583.8571428571429
2588081.0,6,2,132,1,66,0.0,66.0,66.0,1,66,0.0,66.0,66.0
41984591.0,6,4,1670,3,917,20992295.5,785.0,305.6666666666667,1,753,0.0,753.0,753.0
14784.0,17,2,180,1,90,0.0,90.0,90.0,1,90,0.0,90.0,90.0
2020275.0,17,4,525,2,150,0.0,75.0,75.0,2,375,0.0,284.0,187.5
2022706.0,17,4,525,2,150,0.0,75.0,75.0,2,375,0.0,284.0,187.5
105688371.0,17,14,864,7,432,17500933.166666668,174.0,61.71428571428572,7,432,17500167.666666668,174.0,61.71428571428572
1310297.0,6,4,264,2,132,0.0,66.0,66.0,2,132,0.0,66.0,66.0
28123.0,6,10,2032,5,524,6425.75,252.0,104.8,5,1508,6608.0,1236.0,301.6
235619.0,6,3,337,2,214,0.0,160.0,107.0,1,123,0.0,123.0,123.0
119650603.0,6,230,26010,115,18198,1047678.9824561405,284.0,158.24347826086955,115,7812,1047318.754385965,140.0,67.9304347826087
127170498.0,6,32,2236,16,1071,7812382.866666666,123.0,66.9375,16,1165,7812371.4,139.0,72.8125
52222.0,6,14,4740,7,653,8320.666666666666,249.0,93.28571428571428,7,4087,7705.166666666667,1514.0,583.8571428571429
2797654.0,6,2,132,1,66,0.0,66.0,66.0,1,66,0.0,66.0,66.0
507825.0,6,4,270,2,134,0.0,68.0,67.0,2,136,0.0,70.0,68.0
246729.0,6,3,337,2,214,0.0,160.0,107.0,1,123,0.0,123.0,123.0
10845.0,6,10,1065,5,534,2426.25,262.0,106.8,5,531,2371.25,259.0,106.2
197159.0,17,2,180,1,90,0.0,90.0,90.0,1,90,0.0,90.0,90.0
127818.0,6,2,132,1,66,0.0,66.0,66.0,1,66,0.0,66.0,66.0
121134.0,6,3,337,2,214,0.0,160.0,107.0,1,123,0.0,123.0,123.0
341.0,17,2,267,1,83,0.0,83.0,83.0,1,184,0.0,184.0,184.0
26518.0,6,14,4740,7,653,3212.333333333333,249.0,93.28571428571428,7,4087,4226.333333333333,1514.0,583.8571428571429
23120201.0,17,3,1034,2,684,0.0,342.0,342.0,1,350,0.0,350.0,350.0
40360.0,6,10,2032,5,524,4326.5,252.0,104.8,5,1508,9181.25,1236.0,301.6
54263.0,6,14,4740,7,653,7879.166666666667,249.0,93.28571428571428,7,4087,8453.0,1514.0,583.8571428571429
407.0,17,2,174,1,79,0.0,79.0,79.0,1,95,0.0,95.0,95.0
10513472.0,6,7,478,4,272,3459044.333333333,74.0,68.0,3,206,5188424.0,74.0,68.66666666666667
43307.0,6,14,4740,7,653,7092.166666666667,249.0,93.28571428571428,7,4087,7079.333333333333,1514.0,583.8571428571429
108111992.0,17,5,955,5,955,27027998.0,191.0,191.0,0,0,0.0,0.0,0.0
120995057.0,6,31,2034,16,1086,8066337.133333334,123.0,67.875,15,948,7914694.785714285,123.0,63.2
96670.0,17,2,762,2,762,0.0,381.0,381.0,0,0,0.0,0.0,0.0
329.0,17,2,166,1,75,0.0,75.0,75.0,1,91,0.0,91.0,91.0
852435.0,6,9,1096,6,625,170487.0,287.0,104.16666666666669,3,471,288419.5,331.0,157.0
300696.0,6,6,412,4,272,100232.0,74.0,68.0,2,140,0.0,74.0,70.0
84.0,17,2,762,2,762,0.0,381.0,381.0,0,0,0.0,0.0,0.0
2223.0,17,4,344,2,150,0.0,75.0,75.0,2,194,0.0,103.0,97.0
298767.0,6,6,412,4,272,99589.0,74.0,68.0,2,140,0.0,74.0,70.0
23561.0,6,12,1413,7,882,3926.8333333333335,291.0,126.0,5,531,5097.0,259.0,106.2
136239.0,6,2,132,1,66,0.0,66.0,66.0,1,66,0.0,66.0,66.0
90281107.0,6,16,1192,8,596,12891435.857142856,95.0,74.5,8,596,12896562.714285716,95.0,74.5
2299.0,17,4,344,2,150,0.0,75.0,75.0,2,194,0.0,103.0,97.0
147982.0,17,2,180,1,90,0.0,90.0,90.0,1,90,0.0,90.0,90.0
15221.0,17,2,180,1,90,0.0,90.0,90.0,1,90,0.0,90.0,90.0
213358.0,6,10,1221,6,636,42671.6,298.0,106.0,4,585,69941.0,379.0,146.25
121349.0,6,3,337,2,214,0.0,160.0,107.0,1,123,0.0,123.0,123.0
90005179.0,6,25,2768,13,1411,7500431.583333333,427.0,108.53846153846152,12,1357,8155146.545454546,336.0,113.08333333333331
217926.0,6,3,426,2,280,0.0,214.0,140.0,1,146,0.0,146.0,146.0
22939.0,6,14,4740,7,653,3653.6666666666665,249.0,93.28571428571428,7,4087,3635.1666666666665,1514.0,583.8571428571429
119799193.0,6,23,1734,11,840,11979919.3,95.0,76.36363636363636,12,894,10868544.636363637,95.0,74.5
1553131.0,6,7,499,3,198,716892.0,66.0,66.0,4,301,501518.3333333333,103.0,75.25
108105682.0,17,5,955,5,955,27026420.5,191.0,191.0,0,0,0.0,0.0,0.0
247084.0,17,2,180,1,90,0.0,90.0,90.0,1,90,0.0,90.0,90.0
45873.0,6,14,4740,7,653,7135.5,249.0,93.28571428571428,7,4087,4505.0,1514.0,583.8571428571429
58697.0,6,14,4740,7,653,9659.666666666666,249.0,93.28571428571428,7,4087,9525.0,1514.0,583.8571428571429
2799812.0,6,2,132,1,66,0.0,66.0,66.0,1,66,0.0,66.0,66.0
874.0,17,4,438,2,148,0.0,74.0,74.0,2,290,0.0,147.0,145.0
159659.0,6,10,1066,5,490,39229.0,218.0,98.0,5,576,39033.25,304.0,115.2
40120.0,6,10,2032,5,524,9792.25,252.0,104.8,5,1508,9170.75,1236.0,301.6
332.0,17,2,166,1,75,0.0,75.0,75.0,1,91,0.0,91.0,91.0
80570.0,6,10,2032,5,524,19839.5,252.0,104.8,5,1508,19848.5,1236.0,301.6
219039.0,6,3,426,2,280,0.0,214.0,140.0,1,146,0.0,146.0,146.0
103039154.0,6,185,20916,93,14622,1119990.8043478262,284.0,157.2258064516129,92,6294,1109511.5824175824,140.0,68.41304347826087
300658.0,17,2,238,1,74,0.0,74.0,74.0,1,164,0.0,164.0,164.0
108110058.0,17,5,955,5,955,27027514.5,191.0,191.0,0,0,0.0,0.0,0.0
40943.0,6,14,4740,7,653,6671.5,249.0,93.28571428571428,7,4087,6118.833333333333,1514.0,583.8571428571429
2137844.0,17,4,1368,4,1368,712614.6666666666,342.0,342.0,0,0,0.0,0.0,0.0
2061.0,17,4,344,2,150,0.0,75.0,75.0,2,194,0.0,103.0,97.0
316541.0,17,4,622,4,622,105513.66666666669,163.0,155.5,0,0,0.0,0.0,0.0
113254942.0,6,46,3036,23,1518,5135438.454545454,66.0,66.0,23,1518,5135447.2727272725,66.0,66.0
135131411.0,17,6,1146,6,1146,27026282.2,191.0,191.0,0,0,0.0,0.0,0.0
42965.0,6,11,2098,6,590,7476.4,252.0,98.33333333333331,5,1508,9675.25,1236.0,301.6
10483911.0,6,7,478,4,272,3449042.0,74.0,68.0,3,206,5173476.5,74.0,68.66666666666667
0.0,17,1,381,1,381,0.0,381.0,381.0,0,0,0.0,0.0,0.0
108099155.0,17,5,955,5,955,27024788.75,191.0,191.0,0,0,0.0,0.0,0.0
7920.0,17,2,582,1,83,0.0,83.0,83.0,1,499,0.0,499.0,499.0
338477.0,6,2,132,1,66,0.0,66.0,66.0,1,66,0.0,66.0,66.0
251859.0,6,3,337,2,214,0.0,160.0,107.0,1,123,0.0,123.0,123.0
9003896.0,17,8,632,4,316,3000995.6666666665,79.0,79.0,4,316,3001150.333333333,79.0,79.0
502383.0,6,5,336,2,134,0.0,68.0,67.0,3,202,196810.5,70.0,67.33333333333333
1344061.0,17,16,1120,16,1120,89604.06666666667,70.0,70.0,0,0,0.0,0.0,0.0
51248.0,6,14,4740,7,653,7426.166666666667,249.0,93.28571428571428,7,4087,8409.333333333334,1514.0,583.8571428571429
2428.0,17,4,344,2,150,0.0,75.0,75.0,2,194,0.0,103.0,97.0
120037538.0,17,28,13364,28,13364,4445834.740740741,501.0,477.2857142857143,0,0,0.0,0.0,0.0
120125112.0,6,14,2224,9,1204,15015639.0,188.0,133.77777777777777,5,1020,22523278.75,204.0,204.0
2302.0,17,4,344,2,150,0.0,75.0,75.0,2,194,0.0,103.0,97.0
315558.0,17,4,1400,4,1400,105186.0,350.0,350.0,0,0,0.0,0.0,0.0
254699.0,6,3,337,2,214,0.0,160.0,107.0,1,123,0.0,123.0,123.0
1407799.0,17,16,1120,16,1120,93853.26666666666,70.0,70.0,0,0,0.0,0.0,0.0
44824.0,6,10,2032,5,524,10916.5,252.0,104.8,5,1508,10968.25,1236.0,301.6
496511.0,6,5,336,2,134,0.0,68.0,67.0,3,202,195658.0,70.0,67.33333333333333
120122899.0,6,13,2020,9,1204,15015362.375,188.0,133.77777777777777,4,816,30031172.0,204.0,204.0
699.0,17,4,438,2,148,0.0,74.0,74.0,2,290,0.0,147.0,145.0
43508.0,6,14,4740,7,653,7069.0,249.0,93.28571428571428,7,4087,7012.5,1514.0,583.8571428571429
144980.0,17,2,180,1,70,0.0,70.0,70.0,1,110,0.0,110.0,110.0
104244.0,17,2,286,2,286,0.0,143.0,143.0,0,0,0.0,0.0,0.0
216416.0,17,2,180,1,90,0.0,90.0,90.0,1,90,0.0,90.0,90.0
2341.0,17,4,344,2,150,0.0,75.0,75.0,2,194,0.0,103.0,97.0
29598.0,6,14,4740,7,653,4523.833333333333,249.0,93.28571428571428,7,4087,4794.5,1514.0,583.8571428571429
206178.0,6,3,426,2,280,0.0,214.0,140.0,1,146,0.0,146.0,146.0
111412265.0,17,14,864,7,432,18500157.666666668,174.0,61.71428571428572,7,432,18500759.83333333,174.0,61.71428571428572
232370.0,6,3,337,2,214,0.0,160.0,107.0,1,123,0.0,123.0,123.0
1302693.0,6,4,264,2,132,0.0,66.0,66.0,2,132,0.0,66.0,66.0
20175.0,6,10,2032,5,524,3732.0,252.0,104.8,5,1508,4576.5,1236.0,301.6
51750.0,6,14,4740,7,653,8464.166666666666,249.0,93.28571428571428,7,4087,8219.333333333334,1514.0,583.8571428571429
104999.0,17,2,700,2,700,0.0,350.0,350.0,0,0,0.0,0.0,0.0
158042.0,17,2,602,1,72,0.0,72.0,72.0,1,530,0.0,530.0,530.0
105851.0,17,2,700,2,700,0.0,350.0,350.0,0,0,0.0,0.0,0.0
134823.0,6,2,132,1,66,0.0,66.0,66.0,1,66,0.0,66.0,66.0
100265452.0,17,12,778,6,389,20053090.4,174.0,64.83333333333333,6,389,19855947.4,174.0,64.83333333333333
66179.0,6,14,4740,7,653,6969.0,249.0,93.28571428571428,7,4087,10758.833333333334,1514.0,583.8571428571429
292786.0,6,12,1373,7,714,48797.66666666666,298.0,102.0,5,659,68946.5,379.0,131.8
330.0,17,2,174,1,79,0.0,79.0,79.0,1,95,0.0,95.0,95.0
120128337.0,6,15,2428,9,1204,15016042.125,188.0,133.77777777777777,6,1224,18071954.8,204.0,204.0
107635593.0,6,27,1800,14,894,8279661.0,123.0,63.85714285714285,13,906,8119398.083333333,123.0,69.6923076923077
753702.0,6,2,132,1,66,0.0,66.0,66.0,1,66,0.0,66.0,66.0
90047133.0,17,28,13364,28,13364,3335079.0,501.0,477.2857142857143,0,0,0.0,0.0,0.0
4298.0,17,2,614,1,72,0.0,72.0,72.0,1,542,0.0,542.0,542.0
5622777.0,6,5,336,2,134,0.0,68.0,67.0,3,202,1525856.5,70.0,67.33333333333333
221597.0,6,3,426,2,280,0.0,214.0,140.0,1,146,0.0,146.0,146.0
318.0,17,2,174,1,79,0.0,79.0,79.0,1,95,0.0,95.0,95.0
48270.0,6,10,2032,5,524,11806.0,252.0,104.8,5,1508,8595.0,1236.0,301.6
146073.0,6,3,337,2,214,0.0,160.0,107.0,1,123,0.0,123.0,123.0
20981828.0,6,26,7643,14,3751,183838.84615384616,1514.0,267.92857142857144,12,3892,1888831.4545454544,1514.0,324.3333333333333
102472.0,17,2,286,2,286,0.0,143.0,143.0,0,0,0.0,0.0,0.0
10468640.0,6,7,478,4,272,3444129.0,74.0,68.0,3,206,5166121.5,74.0,68.66666666666667
226102.0,6,13,1386,7,789,37683.66666666666,253.0,112.71428571428572,6,597,43498.0,259.0,99.5
312254.0,6,6,412,4,272,104084.66666666669,74.0,68.0,2,140,0.0,74.0,70.0
177386.0,17,2,180,1,90,0.0,90.0,90.0,1,90,0.0,90.0,90.0
2402672.0,6,3,1604,2,851,0.0,785.0,425.5,1,753,0.0,753.0,753.0
0.0,17,1,342,1,342,0.0,342.0,342.0,0,0,0.0,0.0,0.0
146179.0,6,3,337,2,214,0.0,160.0,107.0,1,123,0.0,123.0,123.0
10449293.0,6,7,478,4,272,3437580.6666666665,74.0,68.0,3,206,5156247.5,74.0,68.66666666666667
997730.0,6,12,1354,6,723,197092.6,253.0,120.5,6,631,198981.8,293.0,105.16666666666669
1318169.0,6,4,264,2,132,0.0,66.0,66.0,2,132,0.0,66.0,66.0
122425147.0,17,14,864,7,432,17166861.833333332,174.0,61.71428571428572,7,432,17159110.5,174.0,61.71428571428572
24325.0,6,10,1949,5,441,5710.0,169.0,88.2,5,1508,5815.75,1236.0,301.6
57766.0,6,14,4740,7,653,7311.0,249.0,93.28571428571428,7,4087,9068.5,1514.0,583.8571428571429
320016.0,17,4,1400,4,1400,106672.0,350.0,350.0,0,0,0.0,0.0,0.0
1158783.0,6,13,3000,8,2372,165540.42857142858,1514.0,296.5,5,628,221528.0,331.0,125.6
332.0,17,2,168,1,76,0.0,76.0,76.0,1,92,0.0,92.0,92.0
108107953.0,17,5,955,5,955,27026988.25,191.0,191.0,0,0,0.0,0.0,0.0
305279.0,6,6,412,4,272,101759.66666666669,74.0,68.0,2,140,0.0,74.0,70.0
2362.0,17,4,344,2,150,0.0,75.0,75.0,2,194,0.0,103.0,97.0
90003726.0,17,27,12943,27,12943,3461681.769230769,501.0,479.3703703703704,0,0,0.0,0.0,0.0
46285.0,6,14,4740,7,653,7586.833333333333,249.0,93.28571428571428,7,4087,7470.5,1514.0,583.8571428571429
253092.0,6,3,337,2,214,0.0,160.0,107.0,1,123,0.0,123.0,123.0
9160.0,17,2,582,1,83,0.0,83.0,83.0,1,499,0.0,499.0,499.0
4331.0,17,2,614,1,72,0.0,72.0,72.0,1,542,0.0,542.0,542.0
54197.0,6,10,2032,5,524,13314.0,252.0,104.8,5,1508,12859.0,1236.0,301.6
2589656.0,6,2,132,1,66,0.0,66.0,66.0,1,66,0.0,66.0,66.0
2598252.0,6,2,132,1,66,0.0,66.0,66.0,1,66,0.0,66.0,66.0
18299.0,6,11,1449,6,572,3659.8,246.0,95.33333333333331,5,877,2713.25,605.0,175.4
141953.0,17,4,571,2,148,0.0,74.0,74.0,2,423,0.0,276.0,211.5
24958.0,6,10,2032,5,524,6019.25,252.0,104.8,5,1508,5542.25,1236.0,301.6
22520.0,6,10,2032,5,524,4217.0,252.0,104.8,5,1508,4527.5,1236.0,301.6
2387.0,17,4,344,2,150,0.0,75.0,75.0,2,194,0.0,103.0,97.0
48652.0,6,10,2032,5,524,11888.0,252.0,104.8,5,1508,11889.25,1236.0,301.6
232288.0,6,3,337,2,214,0.0,160.0,107.0,1,123,0.0,123.0,123.0
10509060.0,6,7,478,4,272,3455855.0,74.0,68.0,3,206,5183658.5,74.0,68.66666666666667
236488.0,6,3,337,2,214,0.0,160.0,107.0,1,123,0.0,123.0,123.0
104986513.0,6,183,20604,92,6294,1153697.945054945,140.0,68.41304347826087,91,14310,1144578.2222222222,284.0,157.25274725274724
303188.0,6,2,132,1,66,0.0,66.0,66.0,1,66,0.0,66.0,66.0
120142401.0,6,13,2036,8,1016,17137474.714285713,188.0,127.0,5,1020,22528175.5,204.0,204.0
248883.0,6,3,337,2,214,0.0,160.0,107.0,1,123,0.0,123.0,123.0
93882971.0,6,26,1746,13,906,7806485.666666667,123.0,69.6923076923077,13,840,7806481.416666667,123.0,64.61538461538461
188799.0,17,2,180,1,90,0.0,90.0,90.0,1,90,0.0,90.0,90.0
105570010.0,6,44,2904,22,1452,5027143.333333333,66.0,66.0,22,1452,5016851.0,66.0,66.0
3785420.0,6,5,336,2,134,0.0,68.0,67.0,3,202,1526218.0,70.0,67.33333333333333
130019.0,6,3,337,2,214,0.0,160.0,107.0,1,123,0.0,123.0,123.0
256267.00000000003,6,3,337,2,214,0.0,160.0,107.0,1,123,0.0,123.0,123.0
209644.0,17,2,180,1,90,0.0,90.0,90.0,1,90,0.0,90.0,90.0
1172336.0,6,13,3010,8,2382,167476.57142857142,1514.0,297.75,5,628,224060.5,331.0,125.6
14897.0,6,14,4740,7,653,2216.6666666666665,249.0,93.28571428571428,7,4087,2341.6666666666665,1514.0,583.8571428571429
2595740.0,6,2,132,1,66,0.0,66.0,66.0,1,66,0.0,66.0,66.0
301623.0,6,6,412,4,272,100541.0,74.0,68.0,2,140,0.0,74.0,70.0
900509.0,6,12,2711,7,743,150084.83333333334,339.0,106.14285714285714,5,1968,156243.5,1514.0,393.6
117382316.0,6,48,3168,24,1584,5103578.956521739,66.0,66.0,24,1584,5094182.434782608,66.0,66.0
135134678.0,17,6,1206,6,1206,27026935.6,201.0,201.0,0,0,0.0,0.0,0.0
313368.0,17,4,1400,4,1400,104456.0,350.0,350.0,0,0,0.0,0.0,0.0
263954.0,6,12,1373,7,714,43992.333333333336,298.0,102.0,5,659,61683.25,379.0,131.8
47455.0,6,14,4740,7,653,6245.166666666667,249.0,93.28571428571428,7,4087,7768.5,1514.0,583.8571428571429
108647811.0,6,32,2236,16,1165,7243187.4,139.0,72.8125,16,1071,7228770.4,123.0,66.9375
106587.0,17,2,286,2,286,0.0,143.0,143.0,0,0,0.0,0.0,0.0
217041.0,6,3,426,2,280,0.0,214.0,140.0,1,146,0.0,146.0,146.0
2327.0,17,4,344,2,150,0.0,75.0,75.0,2,194,0.0,103.0,97.0
4646.0,17,2,626,1,72,0.0,72.0,72.0,1,554,0.0,554.0,554.0
1065239.0,6,3,1604,2,851,0.0,785.0,425.5,1,753,0.0,753.0,753.0
255240.00000000003,6,3,337,2,214,0.0,160.0,107.0,1,123,0.0,123.0,123.0
319553.0,6,6,412,4,272,106517.66666666669,74.0,68.0,2,140,0.0,74.0,70.0
302467.0,6,2,132,1,66,0.0,66.0,66.0,1,66,0.0,66.0,66.0
110974413.0,6,61,12503,31,6656,3691075.7666666666,1514.0,214.70967741935485,30,5847,3819606.206896552,1514.0,194.9
103505.0,17,2,286,2,286,0.0,143.0,143.0,0,0,0.0,0.0,0.0
2010272.0,17,4,525,2,150,0.0,75.0,75.0,2,375,0.0,284.0,187.5
20023.0,17,2,582,1,83,0.0,83.0,83.0,1,499,0.0,499.0,499.0
760.0,17,4,438,2,148,0.0,74.0,74.0,2,290,0.0,147.0,145.0
322.0,17,2,174,1,79,0.0,79.0,79.0,1,95,0.0,95.0,95.0
120008032.0,6,24,1829,13,1030,9999990.916666666,95.0,79.23076923076923,11,799,11999663.1,95.0,72.63636363636364
312806.0,6,6,412,4,272,104268.66666666669,74.0,68.0,2,140,0.0,74.0,70.0
156719.0,6,3,337,2,214,0.0,160.0,107.0,1,123,0.0,123.0,123.0
47057.0,6,10,2032,5,524,9422.5,252.0,104.8,5,1508,11592.75,1236.0,301.6
10497392.0,6,7,478,4,272,3452494.333333333,74.0,68.0,3,206,5178634.0,74.0,68.66666666666667
35467.0,6,10,2032,5,524,8227.75,252.0,104.8,5,1508,7213.25,1236.0,301.6
50878.0,17,2,180,1,90,0.0,90.0,90.0,1,90,0.0,90.0,90.0
117204465.0,17,14,1126,7,563,19507395.0,174.0,80.42857142857143,7,563,19507395.33333333,174.0,80.42857142857143
2043.0,17,4,344,2,150,0.0,75.0,75.0,2,194,0.0,103.0,97.0
107326900.0,6,412,51696,206,37878,522495.6731707317,352.0,183.873786407767,206,13818,522496.09268292686,140.0,67.07766990291262
103007.0,17,2,286,2,286,0.0,143.0,143.0,0,0,0.0,0.0,0.0
108117705.0,17,5,955,5,955,27029426.25,191.0,191.0,0,0,0.0,0.0,0.0
19165.0,6,14,4740,7,653,3086.6666666666665,249.0,93.28571428571428,7,4087,2863.6666666666665,1514.0,583.8571428571429
36284.0,6,14,4740,7,653,4811.666666666667,249.0,93.28571428571428,7,4087,5862.5,1514.0,583.8571428571429
90920929.0,6,21,1585,11,840,9091281.6,95.0,76.36363636363636,10,745,10101518.0,95.0,74.5
235581.0,6,3,337,2,214,0.0,160.0,107.0,1,123,0.0,123.0,123.0
730.0,17,4,438,2,148,0.0,74.0,74.0,2,290,0.0,147.0,145.0
217751.0,6,3,426,2,280,0.0,214.0,140.0,1,146,0.0,146.0,146.0
322702.0,17,4,1400,4,1400,107567.33333333331,350.0,350.0,0,0,0.0,0.0,0.0
103288707.0,6,188,21434,94,14996,1108317.322580645,284.0,159.53191489361703,94,6438,1108317.688172043,140.0,68.48936170212765
523837.0,6,13,4515,6,512,104553.0,230.0,85.33333333333333,7,4003,87071.33333333333,1514.0,571.8571428571429
9859291.0,6,5,1736,2,819,0.0,753.0,409.5,3,917,4862557.5,785.0,305.6666666666667
108210828.0,6,195,22064,98,6690,1115575.5463917523,140.0,68.26530612244898,97,15374,1117843.25,284.0,158.49484536082474
207104.0,6,3,426,2,280,0.0,214.0,140.0,1,146,0.0,146.0,146.0
321156.0,17,4,1400,4,1400,107052.0,350.0,350.0,0,0,0.0,0.0,0.0
120130487.0,17,14,864,7,432,20021747.83333333,174.0,61.71428571428572,7,432,19954494.666666668,174.0,61.71428571428572
1612632.0,6,7,499,3,198,716524.5,66.0,66.0,4,301,505160.3333333333,103.0,75.25
128924383.0,6,39,2754,20,1452,6785493.842105263,123.0,72.6,19,1302,6595611.833333333,123.0,68.52631578947368
2333.0,17,4,344,2,150,0.0,75.0,75.0,2,194,0.0,103.0,97.0
20358.0,6,14,4740,7,653,2999.0,249.0,93.28571428571428,7,4087,3193.1666666666665,1514.0,583.8571428571429
120124127.0,6,14,2224,9,1204,15015515.875,188.0,133.77777777777777,5,1020,22588340.75,204.0,204.0
119779990.0,6,23,1693,12,894,10889090.0,95.0,74.5,11,799,11950472.2,95.0,72.63636363636364
310219.0,17,4,1400,4,1400,103406.33333333331,350.0,350.0,0,0,0.0,0.0,0.0
222123.0,17,2,180,1,90,0.0,90.0,90.0,1,90,0.0,90.0,90.0
299584.0,6,6,412,4,272,99861.33333333331,74.0,68.0,2,140,0.0,74.0,70.0
1653113.0,6,7,499,3,198,716368.0,66.0,66.0,4,301,530820.3333333334,103.0,75.25
112192275.0,6,303,34660,152,10254,742995.1986754967,140.0,67.46052631578948,151,24406,746391.7533333333,284.0,161.6291390728477
102644.0,17,2,286,2,286,0.0,143.0,143.0,0,0,0.0,0.0,0.0
108108851.0,17,5,1005,5,1005,27027212.75,201.0,201.0,0,0,0.0,0.0,0.0
3250885.0,6,7,923,4,753,1015208.0,571.0,188.25,3,170,1522852.0,62.0,56.66666666666666
2052427.0,17,6,1230,3,234,1026010.0,78.0,78.0,3,996,1026004.5,332.0,332.0
298519.0,6,6,412,4,272,99506.33333333331,74.0,68.0,2,140,0.0,74.0,70.0
867852.0,6,9,1267,6,796,173570.4,458.0,132.66666666666666,3,471,296115.5,331.0,157.0
312805.0,6,3,202,2,128,0.0,74.0,64.0,1,74,0.0,74.0,74.0
51143.0,17,2,180,1,90,0.0,90.0,90.0,1,90,0.0,90.0,90.0
143987.0,17,2,180,1,90,0.0,90.0,90.0,1,90,0.0,90.0,90.0
120233424.0,6,21,1585,10,786,13332830.777777778,95.0,78.6,11,799,11998996.8,95.0,72.63636363636364
2052379.0,6,25,7611,13,2516,171031.58333333334,1034.0,193.53846153846155,12,5095,159075.0,1510.0,424.5833333333333
135130158.0,17,6,1206,6,1206,27026031.6,201.0,201.0,0,0,0.0,0.0,0.0
35791.0,6,14,4740,7,653,5842.0,249.0,93.28571428571428,7,4087,5825.5,1514.0,583.8571428571429
205720.0,6,3,426,2,280,0.0,214.0,140.0,1,146,0.0,146.0,146.0
107478.0,17,2,286,2,286,0.0,143.0,143.0,0,0,0.0,0.0,0.0
28827.0,6,14,4740,7,653,4640.5,249.0,93.28571428571428,7,4087,4272.0,1514.0,583.8571428571429
201362.0,6,10,1221,6,636,40272.4,298.0,106.0,4,585,65866.0,379.0,146.25
1487.0,17,2,762,2,762,0.0,381.0,381.0,0,0,0.0,0.0,0.0
2336.0,17,4,344,2,150,0.0,75.0,75.0,2,194,0.0,103.0,97.0
116452997.0,6,30,1974,15,1026,8302664.714285715,123.0,68.4,15,948,8302663.428571428,123.0,63.2
124010578.0,17,15,907,8,475,17715796.85714286,174.0,59.375,7,432,17333490.833333332,174.0,61.71428571428572
123840000.0,6,49,3234,25,1650,5160000.0,66.0,66.0,24,1584,5091419.478260869,66.0,66.0
199580.0,17,2,180,1,90,0.0,90.0,90.0,1,90,0.0,90.0,90.0
17090.0,17,2,180,1,90,0.0,90.0,90.0,1,90,0.0,90.0,90.0
185968.0,17,2,180,1,90,0.0,90.0,90.0,1,90,0.0,90.0,90.0
1026517.0,6,12,2714,7,742,171086.16666666666,338.0,106.0,5,1972,187688.0,1514.0,394.4
297449.0,6,6,412,4,272,99149.66666666669,74.0,68.0,2,140,0.0,74.0,70.0
467.0,17,2,160,1,80,0.0,80.0,80.0,1,80,0.0,80.0,80.0
165920.0,17,2,180,1,90,0.0,90.0,90.0,1,90,0.0,90.0,90.0
90293903.0,6,21,1585,11,840,9024533.7,95.0,76.36363636363636,10,745,9948422.777777778,95.0,74.5
39811.0,6,14,4740,7,653,6150.666666666667,249.0,93.28571428571428,7,4087,6452.666666666667,1514.0,583.8571428571429
18537.0,6,14,4740,7,653,2981.1666666666665,249.0,93.28571428571428,7,4087,2949.833333333333,1514.0,583.8571428571429
2352.0,17,4,344,2,150,0.0,75.0,75.0,2,194,0.0,103.0,97.0
213583.0,17,2,180,1,90,0.0,90.0,90.0,1,90,0.0,90.0,90.0
1167308.0,6,13,3000,8,2372,166758.2857142857,1514.0,296.5,5,628,222849.5,331.0,125.6
162315.0,17,2,180,1,90,0.0,90.0,90.0,1,90,0.0,90.0,90.0
135133738.0,17,6,1206,6,1206,27026747.6,201.0,201.0,0,0,0.0,0.0,0.0
238885.0,6,3,373,2,238,0.0,172.0,119.0,1,135,0.0,135.0,135.0
234033.0,6,6,386,4,247,78011.0,85.0,61.75,2,139,0.0,85.0,69.5
108105773.0,17,5,1005,5,1005,27026443.25,201.0,201.0,0,0,0.0,0.0,0.0
22635.0,6,11,1132,6,556,3103.0,218.0,92.66666666666669,5,576,5457.25,304.0,115.2
1325105.0,6,4,264,2,132,0.0,66.0,66.0,2,132,0.0,66.0,66.0
181497.0,17,4,704,2,148,0.0,74.0,74.0,2,556,0.0,280.0,278.0
47780.0,6,14,4740,7,653,7609.0,249.0,93.28571428571428,7,4087,7807.666666666667,1514.0,583.8571428571429
135136522.0,17,6,1146,6,1146,27027304.4,191.0,191.0,0,0,0.0,0.0,0.0
322213.0,6,6,412,4,272,107404.33333333331,74.0,68.0,2,140,0.0,74.0,70.0
373433.0,6,11,1021,6,444,50794.0,162.0,74.0,5,577,63427.5,349.0,115.4
45969.0,6,14,4740,7,653,7390.5,249.0,93.28571428571428,7,4087,6202.166666666667,1514.0,583.8571428571429
146225.0,6,3,337,2,214,0.0,160.0,107.0,1,123,0.0,123.0,123.0
100330701.0,17,12,778,6,389,20026655.0,174.0,64.83333333333333,6,389,20034355.8,174.0,64.83333333333333
3265108.0,6,7,923,4,753,1019734.3333333334,571.0,188.25,3,170,1530238.0,62.0,56.66666666666666
93002252.0,17,11,735,6,389,18600450.4,174.0,64.83333333333333,5,346,19889008.5,174.0,69.2
120011149.0,17,15,1169,8,606,17144449.85714286,174.0,75.75,7,563,16666825.0,174.0,80.42857142857143
111940178.0,6,30,1990,15,1042,7979544.642857143,139.0,69.46666666666667,15,948,7979550.428571428,123.0,63.2
336496.0,6,12,1373,7,714,56082.66666666666,298.0,102.0,5,659,79806.25,379.0,131.8
502526.0,6,4,270,2,134,0.0,68.0,67.0,2,136,0.0,70.0,68.0
171602.0,17,2,180,1,90,0.0,90.0,90.0,1,90,0.0,90.0,90.0
68165.0,6,14,4740,7,653,11198.666666666666,249.0,93.28571428571428,7,4087,10486.0,1514.0,583.8571428571429
108108323.0,17,5,955,5,955,27027080.75,191.0,191.0,0,0,0.0,0.0,0.0
13032.0,6,3,332,1,54,0.0,54.0,54.0,2,278,0.0,187.0,139.0
51129.0,17,2,180,1,90,0.0,90.0,90.0,1,90,0.0,90.0,90.0
90529532.0,6,14,2240,8,1016,12932790.285714284,188.0,127.0,6,1224,18073635.8,204.0,204.0
103108.0,17,2,286,2,286,0.0,143.0,143.0,0,0,0.0,0.0,0.0
3005141.0,6,12,2172,7,664,500759.1666666667,252.0,94.85714285714286,5,1508,1601.0,1236.0,301.6
16887.0,6,10,1067,5,536,4057.25,264.0,107.2,5,531,3828.5,259.0,106.2
222142.0,17,2,180,1,90,0.0,90.0,90.0,1,90,0.0,90.0,90.0
39150.0,6,10,2032,5,524,8144.75,252.0,104.8,5,1508,9519.25,1236.0,301.6
2032.0,17,4,344,2,150,0.0,75.0,75.0,2,194,0.0,103.0,97.0
495749.0,6,5,336,2,134,0.0,68.0,67.0,3,202,192417.0,70.0,67.33333333333333
224965.0,17,2,180,1,90,0.0,90.0,90.0,1,90,0.0,90.0,90.0
153548.0,17,2,180,1,90,0.0,90.0,90.0,1,90,0.0,90.0,90.0
90563938.0,6,30,2106,15,1089,6453445.285714285,123.0,72.6,15,1017,6453444.785714285,123.0,67.8
135133640.0,17,6,1206,6,1206,27026728.0,201.0,201.0,0,0,0.0,0.0,0.0
1207171.0,6,13,3020,8,2392,172453.0,1514.0,299.0,5,628,227756.5,331.0,125.6
111373429.0,6,210,23790,105,16638,1068726.1634615385,284.0,158.45714285714286,105,7152,1068726.375,140.0,68.11428571428571
274088.0,17,4,823,2,163,0.0,89.0,81.5,2,660,0.0,443.0,330.0
153437.0,17,2,180,1,90,0.0,90.0,90.0,1,90,0.0,90.0,90.0
103643.0,17,2,286,2,286,0.0,143.0,143.0,0,0,0.0,0.0,0.0
38900.0,6,14,4740,7,653,5926.666666666667,249.0,93.28571428571428,7,4087,6190.5,1514.0,583.8571428571429
144135.0,17,2,180,1,90,0.0,90.0,90.0,1,90,0.0,90.0,90.0
98894383.0,6,19,1491,9,650,12361797.875,95.0,72.22222222222223,10,841,10964149.222222222,154.0,84.1
25740.0,6,10,2032,5,524,6201.25,252.0,104.8,5,1508,4757.25,1236.0,301.6
10891561.0,6,8,544,4,272,3585161.0,74.0,68.0,4,272,3585026.6666666665,74.0,68.0
321.0,17,2,174,1,79,0.0,79.0,79.0,1,95,0.0,95.0,95.0
1190115.0,6,13,3009,8,2381,170016.42857142858,1514.0,297.625,5,628,228603.5,331.0,125.6
308134.0,6,3,202,2,128,0.0,74.0,64.0,1,74,0.0,74.0,74.0
143998.0,17,2,180,1,90,0.0,90.0,90.0,1,90,0.0,90.0,90.0
209447.0,17,2,180,1,90,0.0,90.0,90.0,1,90,0.0,90.0,90.0
359895.0,6,3,204,2,136,0.0,70.0,68.0,1,68,0.0,68.0,68.0
95239459.0,17,12,778,6,389,19001311.0,174.0,64.83333333333333,6,389,19000168.4,174.0,64.83333333333333
135127576.0,17,6,1206,6,1206,27025515.2,201.0,201.0,0,0,0.0,0.0,0.0
302740.0,6,6,412,4,272,100913.33333333331,74.0,68.0,2,140,0.0,74.0,70.0
120001222.0,17,17,1709,9,948,15000152.75,394.0,105.33333333333331,8,761,16356662.714285716,250.0,95.125
259198.0,6,10,1221,6,636,51839.6,298.0,106.0,4,585,80442.66666666667,379.0,146.25
49209.0,6,10,2032,5,524,12064.5,252.0,104.8,5,1508,11697.5,1236.0,301.6
216722.0,6,3,426,2,280,0.0,214.0,140.0,1,146,0.0,146.0,146.0
24363034.0,17,5,1718,4,1368,819177.6666666666,342.0,342.0,1,350,0.0,350.0,350.0
197191.0,17,2,180,1,90,0.0,90.0,90.0,1,90,0.0,90.0,90.0
29617.0,6,14,4740,7,653,4515.166666666667,249.0,93.28571428571428,7,4087,4745.333333333333,1514.0,583.8571428571429
90029109.0,17,28,13364,28,13364,3334411.4444444445,501.0,477.2857142857143,0,0,0.0,0.0,0.0
3171773.0,6,18,1536,9,962,358261.75,315.0,106.88888888888889,9,574,358263.75,78.0,63.77777777777778
32675462.000000004,6,5,336,2,134,0.0,68.0,67.0,3,202,14950839.0,70.0,67.33333333333333
25044.0,6,10,2032,5,524,6006.0,252.0,104.8,5,1508,5673.25,1236.0,301.6
140119.0,6,2,132,1,66,0.0,66.0,66.0,1,66,0.0,66.0,66.0
200526.0,17,4,6056,4,6056,66842.0,1514.0,1514.0,0,0,0.0,0.0,0.0
93274052.0,17,12,778,6,389,18601577.2,174.0,64.83333333333333,6,389,18600158.6,174.0,64.83333333333333
101213143.0,17,14,864,7,432,16833497.666666668,174.0,61.71428571428572,7,432,16834368.166666668,174.0,61.71428571428572
45132.0,6,14,4740,7,653,6934.0,249.0,93.28571428571428,7,4087,7315.5,1514.0,583.8571428571429
116508567.0,6,226,25602,113,17922,1038333.6607142856,284.0,158.60176991150442,113,7680,1038288.9107142856,140.0,67.96460176991151
32133.000000000004,6,14,4740,7,653,5230.166666666667,249.0,93.28571428571428,7,4087,5157.333333333333,1514.0,583.8571428571429
43761.0,6,10,2032,5,524,10702.25,252.0,104.8,5,1508,10236.5,1236.0,301.6
1157861.0,6,13,3010,8,2382,165408.7142857143,1514.0,297.75,5,628,221322.75,331.0,125.6
16081513.999999998,17,6,2052,6,2052,3216302.8,342.0,342.0,0,0,0.0,0.0,0.0
120126512.0,6,15,2428,9,1204,15015814.0,188.0,133.77777777777777,6,1224,18075024.2,204.0,204.0
90027344.0,17,28,13364,28,13364,3334346.074074074,501.0,477.2857142857143,0,0,0.0,0.0,0.0
24025848.0,17,3,1026,3,1026,12012924.0,342.0,342.0,0,0,0.0,0.0,0.0
20292.0,6,11,1133,6,602,3940.8,264.0,100.33333333333331,5,531,4414.75,259.0,106.2
39931551.0,6,4,1670,3,917,19965775.5,785.0,305.6666666666667,1,753,0.0,753.0,753.0
748383.0,6,4,492,2,280,0.0,214.0,140.0,2,212,0.0,146.0,106.0
310.0,17,2,156,1,78,0.0,78.0,78.0,1,78,0.0,78.0,78.0
54126.0,6,14,4740,7,653,7327.5,249.0,93.28571428571428,7,4087,7952.333333333333,1514.0,583.8571428571429
90255740.0,6,13,2036,8,1016,12893677.142857144,188.0,127.0,5,1020,22523026.25,204.0,204.0
323.0,17,2,166,1,75,0.0,75.0,75.0,1,91,0.0,91.0,91.0
302941.0,6,6,412,4,272,100980.33333333331,74.0,68.0,2,140,0.0,74.0,70.0
46998.0,6,14,4740,7,653,7709.5,249.0,93.28571428571428,7,4087,7693.833333333333,1514.0,583.8571428571429
148702.0,17,2,414,1,88,0.0,88.0,88.0,1,326,0.0,326.0,326.0
220561.0,17,2,180,1,90,0.0,90.0,90.0,1,90,0.0,90.0,90.0
337.0,17,2,166,1,75,0.0,75.0,75.0,1,91,0.0,91.0,91.0
120123420.0,6,15,2444,7,1428,20020570.0,204.0,204.0,8,1016,17137266.285714287,188.0,127.0
108106204.0,17,5,955,5,955,27026551.0,191.0,191.0,0,0,0.0,0.0,0.0
109297.0,17,2,286,2,286,0.0,143.0,143.0,0,0,0.0,0.0,0.0
7719282.0,6,129,128538,37,2612,214424.5,216.0,70.5945945945946,92,125926,84788.15384615384,1514.0,1368.7608695652175
297419.0,6,6,412,4,272,99139.66666666669,74.0,68.0,2,140,0.0,74.0,70.0
317.0,17,2,174,1,79,0.0,79.0,79.0,1,95,0.0,95.0,95.0
208001.0,6,10,1221,6,636,41600.2,298.0,106.0,4,585,67971.0,379.0,146.25
298416.0,6,6,412,4,272,99472.0,74.0,68.0,2,140,0.0,74.0,70.0
3350162.0,6,13,3012,7,1906,508059.0,784.0,272.2857142857143,6,1106,609241.6,752.0,184.3333333333333
120139989.0,6,274,32318,137,9264,877242.0441176471,140.0,67.62043795620438,137,23054,877337.6544117647,284.0,168.27737226277372
120012927.0,6,22,1680,11,840,12001292.7,95.0,76.36363636363636,11,840,9001546.9,95.0,76.36363636363636
206425.0,17,2,180,1,90,0.0,90.0,90.0,1,90,0.0,90.0,90.0
162365.0,17,2,180,1,90,0.0,90.0,90.0,1,90,0.0,90.0,90.0
2595207.0,6,2,132,1,66,0.0,66.0,66.0,1,66,0.0,66.0,66.0
27058.0,6,14,4740,7,653,4320.333333333333,249.0,93.28571428571428,7,4087,4377.5,1514.0,583.8571428571429
120121581.0,6,14,1964,6,948,24024316.2,204.0,158.0,8,1016,17137066.714285713,188.0,127.0
127116105.0,6,32,2236,16,1071,7954914.2,123.0,66.9375,16,1165,8474262.6,139.0,72.8125
47606632.0,6,7,1874,3,887,22509816.0,753.0,295.6666666666667,4,987,15011982.666666666,785.0,246.75
221078.0,6,3,426,2,280,0.0,214.0,140.0,1,146,0.0,146.0,146.0
7132.0,17,2,582,1,83,0.0,83.0,83.0,1,499,0.0,499.0,499.0
123455722.0,6,48,3168,24,1584,5028279.739130435,66.0,66.0,24,1584,5239692.695652174,66.0,66.0
56281.0,6,14,4740,7,653,9181.5,249.0,93.28571428571428,7,4087,9000.333333333334,1514.0,583.8571428571429
303097.0,6,6,412,4,272,101032.33333333331,74.0,68.0,2,140,0.0,74.0,70.0
321.0,17,2,166,1,75,0.0,75.0,75.0,1,91,0.0,91.0,91.0
1975.0,17,2,176,1,80,0.0,80.0,80.0,1,96,0.0,96.0,96.0
313471.0,17,4,1400,4,1400,104490.33333333331,350.0,350.0,0,0,0.0,0.0,0.0
119807451.0,6,21,1585,10,745,13311939.0,95.0,74.5,11,840,11954678.3,95.0,76.36363636363636
1828.0,17,5,550,5,550,457.0,110.0,110.0,0,0,0.0,0.0,0.0
109343289.0,6,22,1578,10,735,12149112.0,95.0,73.5,12,843,9939872.636363637,95.0,70.25
47176.0,6,14,4740,7,653,6328.0,249.0,93.28571428571428,7,4087,6957.166666666667,1514.0,583.8571428571429
120092826.0,6,250,28266,125,8472,961814.379032258,140.0,67.776,125,19794,961921.5241935484,284.0,158.352
0.0,17,1,72,1,72,0.0,72.0,72.0,0,0,0.0,0.0,0.0
3088.0,17,2,224,1,76,0.0,76.0,76.0,1,148,0.0,148.0,148.0
135136339.0,17,6,1206,6,1206,27027267.8,201.0,201.0,0,0,0.0,0.0,0.0
216753.0,17,2,180,1,90,0.0,90.0,90.0,1,90,0.0,90.0,90.0
1660555.0,6,7,499,4,301,482147.6666666667,103.0,75.25,3,198,819310.0,66.0,66.0
30551.0,6,14,4740,7,653,3873.3333333333335,249.0,93.28571428571428,7,4087,4579.833333333333,1514.0,583.8571428571429
34487.0,6,11,2098,6,590,6699.2,252.0,98.33333333333331,5,1508,8371.0,1236.0,301.6
146078.0,6,3,337,2,214,0.0,160.0,107.0,1,123,0.0,123.0,123.0
90201802.0,6,16,1192,8,596,12851927.857142856,95.0,74.5,8,596,12856638.285714284,95.0,74.5
31078653.0,6,7,1874,3,887,15466826.0,753.0,295.6666666666667,4,987,10311967.666666666,785.0,246.75
114172659.0,17,14,864,7,432,19000164.666666668,174.0,61.71428571428572,7,432,19001205.0,174.0,61.71428571428572
48858.0,6,14,4740,7,653,7026.833333333333,249.0,93.28571428571428,7,4087,7598.833333333333,1514.0,583.8571428571429
2591919.0,6,2,132,1,66,0.0,66.0,66.0,1,66,0.0,66.0,66.0
217238.0,17,2,180,1,90,0.0,90.0,90.0,1,90,0.0,90.0,90.0
120011123.0,6,18,1341,9,691,14999993.75,95.0,76.77777777777777,9,650,15000374.0,95.0,72.22222222222223
90032618.0,17,28,13364,28,13364,3334541.407407407,501.0,477.2857142857143,0,0,0.0,0.0,0.0
27731.0,6,10,2032,5,524,6070.25,252.0,104.8,5,1508,6216.5,1236.0,301.6
3115373.0,6,3,1604,1,753,0.0,753.0,753.0,2,851,0.0,785.0,425.5
153494.0,17,2,180,1,90,0.0,90.0,90.0,1,90,0.0,90.0,90.0
105022580.0,17,14,864,7,432,17500156.166666668,174.0,61.71428571428572,7,432,17501256.666666668,174.0,61.71428571428572
299718.0,6,6,412,4,272,99906.0,74.0,68.0,2,140,0.0,74.0,70.0
232879.0,6,3,337,2,214,0.0,160.0,107.0,1,123,0.0,123.0,123.0
32213.0,6,10,2032,5,524,7792.0,252.0,104.8,5,1508,7401.75,1236.0,301.6
63225.0,6,14,4740,7,653,10391.333333333334,249.0,93.28571428571428,7,4087,9957.333333333334,1514.0,583.8571428571429
355.0,17,2,174,1,79,0.0,79.0,79.0,1,95,0.0,95.0,95.0
303611.0,6,2,132,1,66,0.0,66.0,66.0,1,66,0.0,66.0,66.0
114096956.0,6,48,3168,24,1584,4960737.217391305,66.0,66.0,24,1584,4948757.695652174,66.0,66.0
3028960.0,6,11,2106,6,598,605324.2,252.0,99.66666666666669,5,1508,7445.5,1236.0,301.6
891019.0,6,12,2710,7,743,148503.16666666666,339.0,106.14285714285714,5,1967,153772.5,1514.0,393.4
2054.0,17,4,344,2,150,0.0,75.0,75.0,2,194,0.0,103.0,97.0
284044.0,17,2,363,1,79,0.0,79.0,79.0,1,284,0.0,284.0,284.0
1774.0,17,4,344,2,150,0.0,75.0,75.0,2,194,0.0,103.0,97.0
135152906.0,17,6,1206,6,1206,27030581.2,201.0,201.0,0,0,0.0,0.0,0.0
120146248.0,6,280,33032,140,9536,851150.9064748201,140.0,68.11428571428571,140,23496,858503.9352517986,300.0,167.82857142857142
344.0,17,2,160,1,80,0.0,80.0,80.0,1,80,0.0,80.0,80.0
235506.0,6,3,426,2,280,0.0,214.0,140.0,1,146,0.0,146.0,146.0
125023442.0,17,15,907,8,475,17860491.714285713,174.0,59.375,7,432,17500163.166666668,174.0,61.71428571428572
270795.0,6,12,1373,7,714,45132.5,298.0,102.0,5,659,63596.75,379.0,131.8
306179.0,6,3,202,2,128,0.0,74.0,64.0,1,74,0.0,74.0,74.0
198295.0,6,13,1386,7,789,33049.166666666664,253.0,112.71428571428572,6,597,38789.6,259.0,99.5
143995.0,17,2,180,1,90,0.0,90.0,90.0,1,90,0.0,90.0,90.0
98420.0,17,2,762,2,762,0.0,381.0,381.0,0,0,0.0,0.0,0.0
125283624.0,6,30,2037,15,948,8416088.42857143,123.0,63.2,15,1089,8235573.0,123.0,72.6
201989.0,17,2,608,1,75,0.0,75.0,75.0,1,533,0.0,533.0,533.0
135132008.0,17,6,1206,6,1206,27026401.6,201.0,201.0,0,0,0.0,0.0,0.0
28431.0,6,10,2032,5,524,6875.5,252.0,104.8,5,1508,6570.75,1236.0,301.6
135100851.0,17,6,1146,6,1146,27020170.2,191.0,191.0,0,0,0.0,0.0,0.0
145479.0,6,3,337,2,214,0.0,160.0,107.0,1,123,0.0,123.0,123.0
101596.0,6,2,132,1,66,0.0,66.0,66.0,1,66,0.0,66.0,66.0
6661.0,17,2,582,1,83,0.0,83.0,83.0,1,499,0.0,499.0,499.0
105321336.0,17,15,5130,15,5130,7522952.571428572,342.0,342.0,0,0,0.0,0.0,0.0
4388.0,17,2,762,2,762,0.0,381.0,381.0,0,0,0.0,0.0,0.0
359.0,17,2,267,1,83,0.0,83.0,83.0,1,184,0.0,184.0,184.0
114851.0,6,14,4740,7,653,19022.0,249.0,93.28571428571428,7,4087,17644.333333333332,1514.0,583.8571428571429
90034726.0,17,28,13364,28,13364,3334619.4814814813,501.0,477.2857142857143,0,0,0.0,0.0,0.0
232965.0,6,3,337,2,214,0.0,160.0,107.0,1,123,0.0,123.0,123.0
1033142.0,6,11,1134,6,558,206628.4,220.0,93.0,5,576,255203.0,304.0,115.2
2016619.0,17,4,525,2,150,0.0,75.0,75.0,2,375,0.0,284.0,187.5
308266.0,6,6,412,4,272,102755.33333333331,74.0,68.0,2,140,0.0,74.0,70.0
1207.0,17,4,438,2,148,0.0,74.0,74.0,2,290,0.0,147.0,145.0
886.0,17,4,438,2,148,0.0,74.0,74.0,2,290,0.0,147.0,145.0
398788.0,6,12,1373,7,714,66464.66666666667,298.0,102.0,5,659,95641.5,379.0,131.8
90258265.0,6,13,2036,8,1016,12894037.857142856,188.0,127.0,5,1020,22516508.0,204.0,204.0
735.0,17,2,762,2,762,0.0,381.0,381.0,0,0,0.0,0.0,0.0
99006246.0,17,13,1083,7,563,16501041.0,174.0,80.42857142857143,6,520,15800131.4,174.0,86.66666666666667
90255015.0,6,14,2240,8,1016,12893573.57142857,188.0,127.0,6,1224,18018702.6,204.0,204.0
14647813.0,6,20,1607,10,975,1593662.2222222222,315.0,97.5,10,632,1593639.6666666667,78.0,63.2
1310637.0,6,4,264,2,132,0.0,66.0,66.0,2,132,0.0,66.0,66.0
104190178.0,6,32,2236,16,1165,6946011.866666666,139.0,72.8125,16,1071,6931591.866666666,123.0,66.9375
102345.0,17,4,1400,4,1400,34115.0,350.0,350.0,0,0,0.0,0.0,0.0
871383.0,6,9,1268,6,797,174276.6,459.0,132.83333333333334,3,471,297806.5,331.0,157.0
90300448.0,6,12,1832,8,1016,12900064.0,188.0,127.0,4,816,30028788.0,204.0,204.0
90071570.0,6,11,1644,4,816,30023435.0,204.0,204.0,7,828,15011688.166666666,188.0,118.28571428571428
10461811.0,6,7,478,4,272,3441779.333333333,74.0,68.0,3,206,5162578.0,74.0,68.66666666666667
135117198.0,17,6,1146,6,1146,27023439.6,191.0,191.0,0,0,0.0,0.0,0.0
95083819.0,17,12,778,6,389,19002607.2,174.0,64.83333333333333,6,389,19000153.4,174.0,64.83333333333333
5624174.0,6,5,336,2,134,0.0,68.0,67.0,3,202,1372506.5,70.0,67.33333333333333
225853.0,6,3,426,2,280,0.0,214.0,140.0,1,146,0.0,146.0,146.0
128006219.0,17,15,907,8,475,18286602.71428572,174.0,59.375,7,432,18000176.666666668,174.0,61.71428571428572
20105.0,6,10,1067,5,536,4701.0,264.0,107.2,5,531,4571.75,259.0,106.2
311175.0,17,4,1400,4,1400,103725.0,350.0,350.0,0,0,0.0,0.0,0.0
30711.0,6,10,2032,5,524,6977.75,252.0,104.8,5,1508,6220.5,1236.0,301.6
326.0,17,2,208,1,72,0.0,72.0,72.0,1,136,0.0,136.0,136.0
503881.0,6,5,336,2,134,0.0,68.0,67.0,3,202,192337.5,70.0,67.33333333333333
120203643.0,6,226,25656,113,7680,1065576.3839285714,140.0,67.96460176991151,113,17976,1065936.919642857,284.0,159.0796460176991
153425.0,17,2,180,1,90,0.0,90.0,90.0,1,90,0.0,90.0,90.0
312256.0,6,6,412,4,272,104085.33333333331,74.0,68.0,2,140,0.0,74.0,70.0
39732.0,6,14,4740,7,653,6500.666666666667,249.0,93.28571428571428,7,4087,6439.666666666667,1514.0,583.8571428571429
2363.0,17,4,344,2,150,0.0,75.0,75.0,2,194,0.0,103.0,97.0
90026148.0,17,28,13364,28,13364,3334301.777777778,501.0,477.2857142857143,0,0,0.0,0.0,0.0
1036327.0,6,10,1221,6,636,207265.4,298.0,106.0,4,585,340040.0,379.0,146.25
2051.0,17,4,344,2,150,0.0,75.0,75.0,2,194,0.0,103.0,97.0
90256572.0,6,12,1832,8,1016,12893796.0,188.0,127.0,4,816,30030863.33333333,204.0,204.0
127776485.0,6,34,2419,18,1348,7516263.823529412,139.0,74.88888888888889,16,1071,7908545.466666667,123.0,66.9375
17187.0,6,10,2032,5,524,3780.25,252.0,104.8,5,1508,3696.75,1236.0,301.6
100215611.0,6,266,30476,133,21402,757569.6742424242,374.0,160.91729323308272,133,9074,758681.1060606061,140.0,68.22556390977444
4379.0,17,2,602,1,72,0.0,72.0,72.0,1,530,0.0,530.0,530.0
302043.0,6,6,412,4,272,100681.0,74.0,68.0,2,140,0.0,74.0,70.0
123305622.0,6,48,3168,24,1584,4948992.304347826,66.0,66.0,24,1584,5347772.130434782,66.0,66.0
120058636.0,17,28,13364,28,13364,4446616.148148148,501.0,477.2857142857143,0,0,0.0,0.0,0.0
4332.0,17,2,598,1,72,0.0,72.0,72.0,1,526,0.0,526.0,526.0
209935.0,17,2,180,1,90,0.0,90.0,90.0,1,90,0.0,90.0,90.0
897307.0,6,10,1336,6,799,179461.4,461.0,133.16666666666666,4,537,207216.3333333333,331.0,134.25
872211.0,6,9,1269,6,798,174442.2,460.0,133.0,3,471,298095.0,331.0,157.0
108118908.0,17,5,955,5,955,27029727.0,191.0,191.0,0,0,0.0,0.0,0.0
859075.0,6,11,2644,7,743,143179.16666666666,339.0,106.14285714285714,4,1901,195488.0,1514.0,475.25
881.0,17,4,438,2,148,0.0,74.0,74.0,2,290,0.0,147.0,145.0
196935.0,17,2,180,1,90,0.0,90.0,90.0,1,90,0.0,90.0,90.0
84262.0,6,14,4740,7,653,13739.833333333334,249.0,93.28571428571428,7,4087,4919.5,1514.0,583.8571428571429
280862.0,17,4,6056,4,6056,93620.66666666669,1514.0,1514.0,0,0,0.0,0.0,0.0
43903046.0,6,8,745,8,745,6271863.714285715,97.0,93.125,0,0,0.0,0.0,0.0
64486.0,6,14,4740,7,653,7894.666666666667,249.0,93.28571428571428,7,4087,10475.666666666666,1514.0,583.8571428571429
243190.0,6,3,337,2,214,0.0,160.0,107.0,1,123,0.0,123.0,123.0
518948.0,6,2,145,2,145,0.0,91.0,72.5,0,0,0.0,0.0,0.0
90305197.0,6,19,1436,10,745,10028366.777777778,95.0,74.5,9,691,11286992.125,95.0,76.77777777777777
121001169.0,17,15,907,8,475,17285881.285714287,174.0,59.375,7,432,16834240.166666668,174.0,61.71428571428572
97000833.0,17,14,1126,7,563,16166805.5,174.0,80.42857142857143,7,563,16001366.833333334,174.0,80.42857142857143
3775571.0,6,5,336,2,134,0.0,68.0,67.0,3,202,1517102.5,70.0,67.33333333333333
28783.0,6,10,2032,5,524,6174.0,252.0,104.8,5,1508,6924.25,1236.0,301.6
0.0,17,1,381,1,381,0.0,381.0,381.0,0,0,0.0,0.0,0.0
345664.0,17,2,582,1,83,0.0,83.0,83.0,1,499,0.0,499.0,499.0
41778.0,6,10,2032,5,524,10156.25,252.0,104.8,5,1508,9768.25,1236.0,301.6
90052025.0,17,28,13364,28,13364,3335260.185185185,501.0,477.2857142857143,0,0,0.0,0.0,0.0
207075.0,6,3,426,2,280,0.0,214.0,140.0,1,146,0.0,146.0,146.0
1306273.0,6,4,264,2,132,0.0,66.0,66.0,2,132,0.0,66.0,66.0
120317882.0,6,338,39168,169,11376,711282.2738095238,140.0,67.31360946745562,169,27792,715402.494047619,284.0,164.44970414201185
111899520.0,6,30,1974,15,1026,7977404.0,123.0,68.4,15,948,7977402.428571428,123.0,63.2
1302364.0,6,4,264,2,132,0.0,66.0,66.0,2,132,0.0,66.0,66.0
95336500.0,6,26,1746,13,906,7926717.833333333,123.0,69.6923076923077,13,840,7926706.583333333,123.0,64.61538461538461
0.0,17,1,342,1,342,0.0,342.0,342.0,0,0,0.0,0.0,0.0
153855.0,17,2,180,1,90,0.0,90.0,90.0,1,90,0.0,90.0,90.0
53722.0,6,14,4740,7,653,8478.833333333334,249.0,93.28571428571428,7,4087,8762.666666666666,1514.0,583.8571428571429
27249.0,6,10,2032,5,524,6027.25,252.0,104.8,5,1508,5896.25,1236.0,301.6
731.0,17,4,438,2,148,0.0,74.0,74.0,2,290,0.0,147.0,145.0
2733763.0,6,20,6935,11,1567,273376.3,408.0,142.45454545454547,9,5368,272115.875,1514.0,596.4444444444445
30366.0,6,14,4740,7,653,4939.0,249.0,93.28571428571428,7,4087,4110.166666666667,1514.0,583.8571428571429
2069.0,17,4,344,2,150,0.0,75.0,75.0,2,194,0.0,103.0,97.0
144925.0,17,2,180,1,70,0.0,70.0,70.0,1,110,0.0,110.0,110.0
26426.0,6,10,2032,5,524,6355.25,252.0,104.8,5,1508,6031.75,1236.0,301.6
320817.0,17,4,1400,4,1400,106939.0,350.0,350.0,0,0,0.0,0.0,0.0
2041.0,17,4,344,2,150,0.0,75.0,75.0,2,194,0.0,103.0,97.0
16857.0,17,2,180,1,90,0.0,90.0,90.0,1,90,0.0,90.0,90.0
207543.0,6,3,426,2,280,0.0,214.0,140.0,1,146,0.0,146.0,146.0
1634686.0,6,20,6434,12,1921,148607.81818181818,620.0,160.08333333333334,8,4513,191006.14285714287,1514.0,564.125
318721.0,6,3,1604,2,851,0.0,785.0,425.5,1,753,0.0,753.0,753.0
135130905.0,17,6,1206,6,1206,27026181.0,201.0,201.0,0,0,0.0,0.0,0.0
102136027.0,17,14,864,7,432,17000168.0,174.0,61.71428571428572,7,432,17001498.5,174.0,61.71428571428572
16943.0,17,2,180,1,90,0.0,90.0,90.0,1,90,0.0,90.0,90.0
206448.0,6,3,426,2,280,0.0,214.0,140.0,1,146,0.0,146.0,146.0
2332.0,17,4,344,2,150,0.0,75.0,75.0,2,194,0.0,103.0,97.0
29823.0,6,10,2032,5,524,6623.75,252.0,104.8,5,1508,6806.5,1236.0,301.6
90029974.0,17,28,13364,28,13364,3334443.4814814813,501.0,477.2857142857143,0,0,0.0,0.0,0.0
143629.0,6,2,132,1,66,0.0,66.0,66.0,1,66,0.0,66.0,66.0
27431261.0,17,5,1710,5,1710,6857815.25,342.0,342.0,0,0,0.0,0.0,0.0
10428115.0,6,6,412,3,206,5145862.5,74.0,68.66666666666667,3,206,5145713.0,74.0,68.66666666666667
2318.0,17,4,344,2,150,0.0,75.0,75.0,2,194,0.0,103.0,97.0
153419.0,17,2,180,1,90,0.0,90.0,90.0,1,90,0.0,90.0,90.0
120313246.0,6,219,24834,110,17418,1103791.247706422,284.0,158.34545454545454,109,7416,1105457.8796296297,140.0,68.03669724770643
1838124.0,17,2,896,2,896,0.0,453.0,448.0,0,0,0.0,0.0,0.0
314.0,17,2,178,1,81,0.0,81.0,81.0,1,97,0.0,97.0,97.0
969992.0,6,10,1333,6,796,193998.4,458.0,132.66666666666666,4,537,231650.0,331.0,134.25
218173.0,6,3,426,2,280,0.0,214.0,140.0,1,146,0.0,146.0,146.0
229990.0,6,10,1221,6,636,45998.0,298.0,106.0,4,585,75349.0,379.0,146.25
135132011.0,17,6,1146,6,1146,27026402.2,191.0,191.0,0,0,0.0,0.0,0.0
19239.0,6,20,7606,11,978,1923.9,310.0,88.9090909090909,9,6628,1582.5,1514.0,736.4444444444445
156430.0,17,2,180,1,90,0.0,90.0,90.0,1,90,0.0,90.0,90.0
2359.0,17,4,344,2,150,0.0,75.0,75.0,2,194,0.0,103.0,97.0
35233.0,6,14,4740,7,653,5750.0,249.0,93.28571428571428,7,4087,5733.666666666667,1514.0,583.8571428571429
39598.0,6,14,4740,7,653,6441.666666666667,249.0,93.28571428571428,7,4087,6319.833333333333,1514.0,583.8571428571429
108106151.0,17,5,955,5,955,27026537.75,191.0,191.0,0,0,0.0,0.0,0.0
31048.0,6,14,4740,7,653,5052.666666666667,249.0,93.28571428571428,7,4087,4757.666666666667,1514.0,583.8571428571429
120000161.0,6,23,1775,13,1030,10000013.416666666,95.0,79.23076923076923,10,745,10157150.555555556,95.0,74.5
10406.0,17,2,582,1,83,0.0,83.0,83.0,1,499,0.0,499.0,499.0
399.0,17,2,508,2,508,0.0,257.0,254.0,0,0,0.0,0.0,0.0
50554.0,6,12,1413,7,882,8425.666666666666,291.0,126.0,5,531,10217.25,259.0,106.2
47726.0,6,14,4740,7,653,7829.333333333333,249.0,93.28571428571428,7,4087,6801.166666666667,1514.0,583.8571428571429
280846.0,17,2,363,1,79,0.0,79.0,79.0,1,284,0.0,284.0,284.0
90029076.0,17,28,13364,28,13364,3334410.222222222,501.0,477.2857142857143,0,0,0.0,0.0,0.0
40930591.0,6,26,7627,14,3735,190521.7692307692,1514.0,266.7857142857143,12,3892,3702307.727272727,1514.0,324.3333333333333
9880.0,6,11,1132,6,556,1834.8,218.0,92.66666666666669,5,576,2202.5,304.0,115.2
294.0,17,2,156,1,78,0.0,78.0,78.0,1,78,0.0,78.0,78.0
440576.0,6,3,1777,2,951,0.0,885.0,475.5,1,826,0.0,826.0,826.0
165887.0,17,2,180,1,90,0.0,90.0,90.0,1,90,0.0,90.0,90.0
207769.0,17,4,6056,4,6056,69256.33333333333,1514.0,1514.0,0,0,0.0,0.0,0.0
45545.0,6,10,2032,5,524,11031.25,252.0,104.8,5,1508,10662.25,1236.0,301.6
0.0,17,1,381,1,381,0.0,381.0,381.0,0,0,0.0,0.0,0.0
209552.0,17,2,180,1,90,0.0,90.0,90.0,1,90,0.0,90.0,90.0
245643.0,6,3,337,2,214,0.0,160.0,107.0,1,123,0.0,123.0,123.0
8615672.0,17,3,1034,2,684,0.0,342.0,342.0,1,350,0.0,350.0,350.0
233716.0,6,3,373,2,238,0.0,172.0,119.0,1,135,0.0,135.0,135.0
90301256.0,6,16,1192,8,596,12891845.285714284,95.0,74.5,8,596,12899489.42857143,95.0,74.5
90255099.0,6,12,1832,8,1016,12893585.57142857,188.0,127.0,4,816,30029757.33333333,204.0,204.0
43654.0,6,14,4740,7,653,6933.5,249.0,93.28571428571428,7,4087,6964.666666666667,1514.0,583.8571428571429
108092819.0,17,5,1005,5,1005,27023204.75,201.0,201.0,0,0,0.0,0.0,0.0
2680912.0,6,3,204,2,136,0.0,70.0,68.0,1,68,0.0,68.0,68.0
90296099.0,6,19,1436,10,745,10027824.777777778,95.0,74.5,9,691,11286553.125,95.0,76.77777777777777
32774.0,6,14,4740,7,653,5343.666666666667,249.0,93.28571428571428,7,4087,3746.3333333333335,1514.0,583.8571428571429
101121001.0,6,183,20710,92,6294,1111219.7912087913,140.0,68.41304347826087,91,14416,1100610.1555555556,374.0,158.41758241758242
41040.0,6,10,2032,5,524,8855.25,252.0,104.8,5,1508,9897.5,1236.0,301.6
49193.0,6,14,4740,7,653,7621.166666666667,249.0,93.28571428571428,7,4087,5002.333333333333,1514.0,583.8571428571429
67573.0,6,14,4740,7,653,10527.5,249.0,93.28571428571428,7,4087,10883.666666666666,1514.0,583.8571428571429
90020628.0,17,28,13364,28,13364,3334097.333333333,501.0,477.2857142857143,0,0,0.0,0.0,0.0
1305916.0,6,4,264,2,132,0.0,66.0,66.0,2,132,0.0,66.0,66.0
93161963.0,17,12,778,6,389,18600160.6,174.0,64.83333333333333,6,389,18600589.4,174.0,64.83333333333333
2651097.0,6,32,10926,18,3951,155946.88235294115,1514.0,219.5,14,6975,184728.84615384616,1514.0,498.2142857142857
809.0,17,4,438,2,148,0.0,74.0,74.0,2,290,0.0,147.0,145.0
2087496.0,6,2,132,1,66,0.0,66.0,66.0,1,66,0.0,66.0,66.0
125007450.0,17,15,1169,8,606,17858207.14285714,174.0,75.75,7,563,17333687.0,174.0,80.42857142857143
13835.0,17,2,180,1,90,0.0,90.0,90.0,1,90,0.0,90.0,90.0
308310.0,6,6,412,4,272,102770.0,74.0,68.0,2,140,0.0,74.0,70.0
408.0,17,2,410,1,78,0.0,78.0,78.0,1,332,0.0,332.0,332.0
10442424.0,6,7,478,4,272,3434301.0,74.0,68.0,3,206,5151296.0,74.0,68.66666666666667
2629.0,17,4,344,2,150,0.0,75.0,75.0,2,194,0.0,103.0,97.0
54018.0,6,11,2098,6,590,9268.0,252.0,98.33333333333331,5,1508,12932.75,1236.0,301.6
100902.0,17,2,762,2,762,0.0,381.0,381.0,0,0,0.0,0.0,0.0
2317.0,17,4,344,2,150,0.0,75.0,75.0,2,194,0.0,103.0,97.0
120000306.0,6,1137,286470,586,249068,205128.7282051282,1514.0,425.0307167235495,551,37402,217771.86,214.0,67.88021778584393
217849.0,6,3,426,2,280,0.0,214.0,140.0,1,146,0.0,146.0,146.0
27450.0,6,14,4740,7,653,4423.833333333333,249.0,93.28571428571428,7,4087,4346.5,1514.0,583.8571428571429
18876.0,6,10,2032,5,524,4495.5,252.0,104.8,5,1508,4091.75,1236.0,301.6
51884.0,6,14,4740,7,653,8380.5,249.0,93.28571428571428,7,4087,8471.5,1514.0,583.8571428571429
747315.0,6,2,132,1,66,0.0,66.0,66.0,1,66,0.0,66.0,66.0
2129.0,17,4,344,2,150,0.0,75.0,75.0,2,194,0.0,103.0,97.0
135123363.0,17,6,1206,6,1206,27024672.6,201.0,201.0,0,0,0.0,0.0,0.0
104591.0,17,2,286,2,286,0.0,143.0,143.0,0,0,0.0,0.0,0.0
303233.0,6,6,412,4,272,101077.66666666669,74.0,68.0,2,140,0.0,74.0,70.0
232902.0,6,3,337,2,214,0.0,160.0,107.0,1,123,0.0,123.0,123.0
27547.0,6,14,4740,7,653,4466.0,249.0,93.28571428571428,7,4087,4193.166666666667,1514.0,583.8571428571429
38616.0,6,10,2032,5,524,9273.0,252.0,104.8,5,1508,8536.5,1236.0,301.6
185927.0,17,2,180,1,90,0.0,90.0,90.0,1,90,0.0,90.0,90.0
10418715.0,6,7,478,4,272,3427287.0,74.0,68.0,3,206,5140808.0,74.0,68.66666666666667
33447.0,6,10,1065,5,534,4967.75,262.0,106.8,5,531,7641.75,259.0,106.2
35704.0,6,10,2032,5,524,7541.75,252.0,104.8,5,1508,8585.75,1236.0,301.6
118915821.0,6,36,2596,18,1348,6995048.294117647,139.0,74.88888888888889,18,1248,6982327.235294118,123.0,69.33333333333333
110795939.0,6,29,1914,15,948,7913995.642857143,123.0,63.2,14,966,7738034.923076923,123.0,69.0
104948564.0,6,20,1490,10,745,11660951.555555556,95.0,74.5,10,745,11632026.111111112,95.0,74.5
0.0,6,1,66,1,66,0.0,66.0,66.0,0,0,0.0,0.0,0.0
363853.0,6,11,1021,6,444,48953.0,162.0,74.0,5,577,61005.5,349.0,115.4
108109582.0,17,5,955,5,955,27027395.5,191.0,191.0,0,0,0.0,0.0,0.0
37066.0,6,14,4740,7,653,5742.166666666667,249.0,93.28571428571428,7,4087,5971.166666666667,1514.0,583.8571428571429
2004.0,17,4,344,2,150,0.0,75.0,75.0,2,194,0.0,103.0,97.0
102001279.0,17,13,821,7,432,17000213.166666668,174.0,61.71428571428572,6,389,16401100.8,174.0,64.83333333333333
0.0,17,1,74,1,74,0.0,74.0,74.0,0,0,0.0,0.0,0.0
2067.0,17,4,344,2,150,0.0,75.0,75.0,2,194,0.0,103.0,97.0
1521.0,17,2,176,1,80,0.0,80.0,80.0,1,96,0.0,96.0,96.0
232056.0,6,3,337,2,214,0.0,160.0,107.0,1,123,0.0,123.0,123.0
40688.0,6,14,4740,7,653,6161.0,249.0,93.28571428571428,7,4087,6635.5,1514.0,583.8571428571429
114927080.0,6,38,2710,19,1408,6384837.777777778,139.0,74.10526315789474,19,1302,6372829.722222222,123.0,68.52631578947368
228261.0,17,2,180,1,90,0.0,90.0,90.0,1,90,0.0,90.0,90.0
217908.0,6,3,426,2,280,0.0,214.0,140.0,1,146,0.0,146.0,146.0
511884.0,6,5,336,2,134,0.0,68.0,67.0,3,202,192652.5,70.0,67.33333333333333
6774.0,17,2,582,1,83,0.0,83.0,83.0,1,499,0.0,499.0,499.0
10512031.0,6,7,478,4,272,3457542.0,74.0,68.0,3,206,5186190.5,74.0,68.66666666666667
2035366.0,17,8,1640,4,312,678328.6666666666,78.0,78.0,4,1328,678312.6666666666,332.0,332.0
132652.0,6,3,337,2,214,0.0,160.0,107.0,1,123,0.0,123.0,123.0
11139.0,17,4,823,2,163,0.0,89.0,81.5,2,660,0.0,443.0,330.0
90311253.0,6,15,1097,8,596,12901607.57142857,95.0,74.5,7,501,15002693.833333334,95.0,71.57142857142857
115806134.0,6,48,3168,24,1584,5035049.304347826,66.0,66.0,24,1584,5021588.0869565215,66.0,66.0
10476016.0,6,7,478,4,272,3445188.333333333,74.0,68.0,3,206,5167659.5,74.0,68.66666666666667
58814.0,6,14,4740,7,653,9469.0,249.0,93.28571428571428,7,4087,9040.666666666666,1514.0,583.8571428571429
304331.0,6,6,412,4,272,101443.66666666669,74.0,68.0,2,140,0.0,74.0,70.0
90922364.0,6,21,1585,11,840,9091621.8,95.0,76.36363636363636,10,745,10098891.444444444,95.0,74.5
28202.0,6,14,4740,7,653,4170.666666666667,249.0,93.28571428571428,7,4087,4485.0,1514.0,583.8571428571429
113753516.0,6,48,3168,24,1584,4945805.043478261,66.0,66.0,24,1584,4936414.304347826,66.0,66.0
32680642.0,6,5,336,2,134,0.0,68.0,67.0,3,202,15052969.5,70.0,67.33333333333333
34991.0,6,14,4740,7,653,5609.0,249.0,93.28571428571428,7,4087,5672.5,1514.0,583.8571428571429
782.0,6,2,128,1,74,0.0,74.0,74.0,1,54,0.0,54.0,54.0
103402563.0,17,14,864,7,432,17207269.833333332,174.0,61.71428571428572,7,432,17209953.833333332,174.0,61.71428571428572
120135619.0,6,14,2240,6,1224,24027123.8,204.0,204.0,8,1016,17099043.14285714,188.0,127.0
5629484.0,6,5,336,2,134,0.0,68.0,67.0,3,202,1525081.5,70.0,67.33333333333333
36143.0,6,11,1132,6,556,4718.2,218.0,92.66666666666669,5,576,8830.25,304.0,115.2
67994.0,6,14,4740,7,653,10761.333333333334,249.0,93.28571428571428,7,4087,10677.5,1514.0,583.8571428571429
328.0,17,2,174,1,79,0.0,79.0,79.0,1,95,0.0,95.0,95.0
2458357.0,6,25,7573,14,3735,189104.38461538465,1514.0,266.7857142857143,11,3838,220962.7,1514.0,348.90909090909093
10487348.0,6,7,478,4,272,3450426.333333333,74.0,68.0,3,206,5175480.0,74.0,68.66666666666667
10459968.0,6,7,478,4,272,3440984.333333333,74.0,68.0,3,206,5161336.5,74.0,68.66666666666667
1776282.0,6,2,132,1,66,0.0,66.0,66.0,1,66,0.0,66.0,66.0
97202229.0,17,12,778,6,389,19401089.2,174.0,64.83333333333333,6,389,19400188.8,174.0,64.83333333333333
15564.0,6,11,1132,6,556,2799.6,218.0,92.66666666666669,5,576,3376.5,304.0,115.2
43816.0,6,10,2032,5,524,6599.5,252.0,104.8,5,1508,9795.5,1236.0,301.6
122024.0,6,3,373,2,238,0.0,172.0,119.0,1,135,0.0,135.0,135.0
162333.0,17,2,180,1,90,0.0,90.0,90.0,1,90,0.0,90.0,90.0
104814703.0,17,14,864,7,432,17334808.5,174.0,61.71428571428572,7,432,17333502.833333332,174.0,61.71428571428572
309958.0,17,4,1400,4,1400,103319.33333333331,350.0,350.0,0,0,0.0,0.0,0.0
149563.0,6,3,373,2,238,0.0,172.0,119.0,1,135,0.0,135.0,135.0
51865.0,6,10,2032,5,524,12755.5,252.0,104.8,5,1508,11016.5,1236.0,301.6
58696.0,6,14,4740,7,653,9289.833333333334,249.0,93.28571428571428,7,4087,9517.166666666666,1514.0,583.8571428571429
0.0,17,1,90,1,90,0.0,90.0,90.0,0,0,0.0,0.0,0.0
41609.0,6,14,4740,7,653,6809.166666666667,249.0,93.28571428571428,7,4087,6251.333333333333,1514.0,583.8571428571429
106055.0,17,2,286,2,286,0.0,143.0,143.0,0,0,0.0,0.0,0.0
2568490.0,6,3,1602,1,752,0.0,752.0,752.0,2,850,0.0,784.0,425.0
11016.0,6,11,1132,6,556,1973.6,218.0,92.66666666666669,5,576,2463.0,304.0,115.2
108099299.0,17,5,955,5,955,27024824.75,191.0,191.0,0,0,0.0,0.0,0.0
511721.0,6,5,336,2,134,0.0,68.0,67.0,3,202,193573.0,70.0,67.33333333333333
196829.0,17,2,180,1,90,0.0,90.0,90.0,1,90,0.0,90.0,90.0
106111108.0,6,573,101270,290,82284,367166.4636678201,1514.0,283.7379310344828,283,18986,372618.5177304965,214.0,67.08833922261483
90034814.0,17,28,13364,28,13364,3334622.7407407407,501.0,477.2857142857143,0,0,0.0,0.0,0.0
3257853.0,6,3,1604,1,753,0.0,753.0,753.0,2,851,0.0,785.0,425.5
110144829.0,6,27,1822,14,982,8456045.846153846,139.0,70.14285714285714,13,840,9160525.083333334,123.0,64.61538461538461
41977.0,6,14,4740,7,653,6869.833333333333,249.0,93.28571428571428,7,4087,6858.0,1514.0,583.8571428571429
34959.0,6,14,4740,7,653,5543.333333333333,249.0,93.28571428571428,7,4087,5294.666666666667,1514.0,583.8571428571429
103224.0,17,2,286,2,286,0.0,143.0,143.0,0,0,0.0,0.0,0.0
363186.0,6,11,1021,6,444,48835.2,162.0,74.0,5,577,60832.0,349.0,115.4
159066.0,6,3,337,2,214,0.0,160.0,107.0,1,123,0.0,123.0,123.0
90257558.0,6,13,2036,8,1016,12893936.857142856,188.0,127.0,5,1020,22522668.75,204.0,204.0
101005912.0,17,13,1083,7,563,16834318.666666668,174.0,80.42857142857143,6,520,16200155.6,174.0,86.66666666666667
5630270.0,6,5,336,2,134,0.0,68.0,67.0,3,202,1425163.0,70.0,67.33333333333333
127091133.0,6,32,2157,16,1071,7806936.933333334,123.0,66.9375,16,1086,8472533.066666666,123.0,67.875
121611.0,6,3,337,2,214,0.0,160.0,107.0,1,123,0.0,123.0,123.0
11874.0,6,10,1065,5,534,2735.75,262.0,106.8,5,531,2748.75,259.0,106.2
120259411.0,6,214,24202,107,7358,1077717.29245283,140.0,68.76635514018692,107,16844,1126711.2264150945,284.0,157.42056074766356
117640185.0,6,34,2334,17,1209,7338636.5,123.0,71.11764705882354,17,1125,7338636.75,123.0,66.17647058823529
447.0,17,2,164,1,82,0.0,82.0,82.0,1,82,0.0,82.0,82.0
316824.0,17,4,1400,4,1400,105608.0,350.0,350.0,0,0,0.0,0.0,0.0
209481.0,17,2,180,1,90,0.0,90.0,90.0,1,90,0.0,90.0,90.0
90265958.0,6,16,2368,9,1204,11283244.75,188.0,133.77777777777777,7,1164,15016926.5,204.0,166.28571428571428
52770.0,6,14,4740,7,653,8423.666666666666,249.0,93.28571428571428,7,4087,8606.166666666666,1514.0,583.8571428571429
3176367.0,6,18,1536,9,962,358336.375,315.0,106.88888888888889,9,574,358307.5,78.0,63.77777777777778
110942899.0,6,35,2542,18,1348,6513347.235294118,139.0,74.88888888888889,17,1194,6920430.125,123.0,70.23529411764706
108113067.0,17,5,955,5,955,27028266.75,191.0,191.0,0,0,0.0,0.0,0.0
2033.0,17,4,344,2,150,0.0,75.0,75.0,2,194,0.0,103.0,97.0
5890.0,17,6,1230,3,234,2611.0,78.0,78.0,3,996,2741.0,332.0,332.0
206966.0,17,2,762,2,762,0.0,381.0,381.0,0,0,0.0,0.0,0.0
70170.0,6,14,4740,7,653,11573.0,249.0,93.28571428571428,7,4087,10798.333333333334,1514.0,583.8571428571429
90304454.0,6,16,1192,8,596,12893748.857142856,95.0,74.5,8,596,12898869.285714284,95.0,74.5
135132558.0,17,6,1146,6,1146,27026511.6,191.0,191.0,0,0,0.0,0.0,0.0
6767.0,17,4,823,2,163,0.0,89.0,81.5,2,660,0.0,443.0,330.0
10505161.0,6,6,412,3,206,5184716.5,74.0,68.66666666666667,3,206,5184592.0,74.0,68.66666666666667
2372.0,17,4,344,2,150,0.0,75.0,75.0,2,194,0.0,103.0,97.0
87718.0,6,14,4740,7,653,14145.333333333334,249.0,93.28571428571428,7,4087,13718.666666666666,1514.0,583.8571428571429
13940806.0,6,18,1495,9,921,1702178.75,315.0,102.33333333333331,9,574,1702005.5,78.0,63.77777777777778
162298.0,17,2,180,1,90,0.0,90.0,90.0,1,90,0.0,90.0,90.0
323.0,17,2,174,1,79,0.0,79.0,79.0,1,95,0.0,95.0,95.0
135132100.0,17,6,1206,6,1206,27026420.0,201.0,201.0,0,0,0.0,0.0,0.0
114001109.0,17,13,821,7,432,19000184.83333333,174.0,61.71428571428572,6,389,18800932.2,174.0,64.83333333333333
99680520.0,6,31,2314,16,1228,6645368.0,139.0,76.75,15,1086,7104579.928571428,123.0,72.4
306948.0,6,2,132,1,66,0.0,66.0,66.0,1,66,0.0,66.0,66.0
218868.0,6,3,426,2,280,0.0,214.0,140.0,1,146,0.0,146.0,146.0
117959037.0,6,29,1914,15,948,8425645.5,123.0,63.2,14,966,8289125.153846154,123.0,69.0
121729.0,6,3,337,2,214,0.0,160.0,107.0,1,123,0.0,123.0,123.0
142038.0,17,4,704,2,148,0.0,74.0,74.0,2,556,0.0,280.0,278.0
15883.000000000002,6,14,4740,7,653,2538.5,249.0,93.28571428571428,7,4087,2433.6666666666665,1514.0,583.8571428571429
2526.0,17,4,344,2,150,0.0,75.0,75.0,2,194,0.0,103.0,97.0
145999.0,6,3,337,2,214,0.0,160.0,107.0,1,123,0.0,123.0,123.0
102988.0,17,2,286,2,286,0.0,143.0,143.0,0,0,0.0,0.0,0.0
2365.0,17,4,344,2,150,0.0,75.0,75.0,2,194,0.0,103.0,97.0
119737602.0,6,250,28552,125,20080,963889.8064516129,284.0,160.64,125,8472,963890.2258064516,140.0,67.776
65853.0,6,14,4740,7,653,10710.166666666666,249.0,93.28571428571428,7,4087,10571.166666666666,1514.0,583.8571428571429
2371.0,17,4,344,2,150,0.0,75.0,75.0,2,194,0.0,103.0,97.0
142059.0,6,13,1386,7,789,23676.5,253.0,112.71428571428572,6,597,27133.4,259.0,99.5
135125166.0,17,6,1146,6,1146,27025033.2,191.0,191.0,0,0,0.0,0.0,0.0
2999949.0,6,11,2106,6,598,599786.8,252.0,99.66666666666669,5,1508,2954.0,1236.0,301.6
4430.0,17,2,614,1,72,0.0,72.0,72.0,1,542,0.0,542.0,542.0
725.0,17,4,438,2,148,0.0,74.0,74.0,2,290,0.0,147.0,145.0
9713.0,17,2,571,1,86,0.0,86.0,86.0,1,485,0.0,485.0,485.0
8316215.0,6,35,9514,18,5234,489189.1176470588,1514.0,290.77777777777777,17,4280,456696.125,1514.0,251.76470588235293
315234.0,6,6,412,4,272,105078.0,74.0,68.0,2,140,0.0,74.0,70.0
90298994.0,6,16,1192,8,596,12892344.0,95.0,74.5,8,596,12899652.57142857,95.0,74.5
299.0,17,2,164,1,82,0.0,82.0,82.0,1,82,0.0,82.0,82.0
2843771.0,6,4,270,3,202,1421885.5,70.0,67.33333333333333,1,68,0.0,68.0,68.0
2008.0,17,4,344,2,150,0.0,75.0,75.0,2,194,0.0,103.0,97.0
40267.0,6,10,2032,5,524,9830.5,252.0,104.8,5,1508,9653.75,1236.0,301.6
90079508.0,6,178,20216,89,14194,1021185.0227272728,300.0,159.48314606741573,89,6022,1021185.0454545454,140.0,67.66292134831461
113524156.0,6,46,3036,23,1518,5160177.045454546,66.0,66.0,23,1518,5160173.590909091,66.0,66.0
163669.0,6,3,337,2,214,0.0,160.0,107.0,1,123,0.0,123.0,123.0
298540.0,6,6,412,4,272,99513.33333333331,74.0,68.0,2,140,0.0,74.0,70.0
74557149.0,6,9,842,9,842,9319643.625,97.0,93.55555555555556,0,0,0.0,0.0,0.0
233963.0,6,3,337,2,214,0.0,160.0,107.0,1,123,0.0,123.0,123.0
196863.0,17,2,180,1,90,0.0,90.0,90.0,1,90,0.0,90.0,90.0
281708.0,17,2,363,1,79,0.0,79.0,79.0,1,284,0.0,284.0,284.0
112598008.0,6,48,3168,24,1584,4895565.565217392,66.0,66.0,24,1584,4889736.521739131,66.0,66.0
3069162.0,17,3,1026,3,1026,1534581.0,342.0,342.0,0,0,0.0,0.0,0.0
136744.0,6,2,132,1,66,0.0,66.0,66.0,1,66,0.0,66.0,66.0
1313268.0,17,7,490,7,490,218878.0,70.0,70.0,0,0,0.0,0.0,0.0
120142629.0,6,222,25106,111,7622,1084825.2727272727,140.0,68.66666666666667,111,17484,1084678.2,284.0,157.51351351351352
2797198.0,6,2,132,1,66,0.0,66.0,66.0,1,66,0.0,66.0,66.0
2005.0,17,4,344,2,150,0.0,75.0,75.0,2,194,0.0,103.0,97.0
7212.0,17,2,582,1,83,0.0,83.0,83.0,1,499,0.0,499.0,499.0
266543.0,6,10,1221,6,636,53308.6,298.0,106.0,4,585,83469.66666666667,379.0,146.25
135131133.0,17,6,1146,6,1146,27026226.6,191.0,191.0,0,0,0.0,0.0,0.0
98838.0,17,2,700,2,700,0.0,350.0,350.0,0,0,0.0,0.0,0.0
284989.0,17,2,363,1,79,0.0,79.0,79.0,1,284,0.0,284.0,284.0
2799999.0,6,2,132,1,66,0.0,66.0,66.0,1,66,0.0,66.0,66.0
35301.0,6,14,4740,7,653,5772.833333333333,249.0,93.28571428571428,7,4087,4882.0,1514.0,583.8571428571429
2798004.0,6,2,132,1,66,0.0,66.0,66.0,1,66,0.0,66.0,66.0
325.0,17,2,174,1,79,0.0,79.0,79.0,1,95,0.0,95.0,95.0
108105466.0,17,5,1005,5,1005,27026366.5,201.0,201.0,0,0,0.0,0.0,0.0
3154989.0,6,3,1777,1,826,0.0,826.0,826.0,2,951,0.0,885.0,475.5
37782.0,6,10,2032,5,524,9213.25,252.0,104.8,5,1508,8624.75,1236.0,301.6
102998805.0,6,191,21508,96,6558,1084197.9473684211,140.0,68.3125,95,14950,1085893.1382978724,284.0,157.3684210526316
6548.0,17,4,823,2,163,0.0,89.0,81.5,2,660,0.0,443.0,330.0
17032.0,6,14,4740,7,653,2569.833333333333,249.0,93.28571428571428,7,4087,2660.0,1514.0,583.8571428571429
119383986.0,17,34,16284,34,16284,3617696.5454545454,501.0,478.9411764705882,0,0,0.0,0.0,0.0
73609.0,6,10,2032,5,524,18169.5,252.0,104.8,5,1508,14560.75,1236.0,301.6
43453.0,6,10,2032,5,524,10578.75,252.0,104.8,5,1508,10240.5,1236.0,301.6
31185.0,6,10,2032,5,524,6030.75,252.0,104.8,5,1508,6254.0,1236.0,301.6
110361.0,17,4,1400,4,1400,36787.0,350.0,350.0,0,0,0.0,0.0,0.0
136832.0,6,12,1354,6,723,26767.6,253.0,120.5,6,631,26195.8,293.0,105.16666666666669
987394.0,6,12,1354,6,723,193995.2,253.0,120.5,6,631,196825.2,293.0,105.16666666666669
49194.0,6,14,4740,7,653,8088.833333333333,249.0,93.28571428571428,7,4087,5891.166666666667,1514.0,583.8571428571429
113039220.0,6,35,2542,18,1348,6636671.117647059,139.0,74.88888888888889,17,1194,7051463.0625,123.0,70.23529411764706
1047550.0,6,11,1134,6,558,209510.0,220.0,93.0,5,576,255120.0,304.0,115.2
1590552.0,6,32,19485,17,1268,99409.5,204.0,74.58823529411765,15,18217,112791.57142857143,1514.0,1214.4666666666667
0.0,17,1,90,1,90,0.0,90.0,90.0,0,0,0.0,0.0,0.0
121341.0,6,3,337,2,214,0.0,160.0,107.0,1,123,0.0,123.0,123.0
13640346.0,6,20,1607,10,975,1479940.0,315.0,97.5,10,632,1479347.6666666667,78.0,63.2
25442217.0,17,5,1718,4,1368,1134442.6666666667,342.0,342.0,1,350,0.0,350.0,350.0
62379.0,6,14,4740,7,653,10134.0,249.0,93.28571428571428,7,4087,7724.166666666667,1514.0,583.8571428571429
3923060.0,6,25,7608,13,2516,326921.6666666667,1034.0,193.53846153846155,12,5092,329357.45454545453,1510.0,424.3333333333333
19144.0,6,10,1067,5,536,4510.0,264.0,107.2,5,531,3872.0,259.0,106.2
205643.0,17,2,180,1,90,0.0,90.0,90.0,1,90,0.0,90.0,90.0
1049.0,17,4,438,2,148,0.0,74.0,74.0,2,290,0.0,147.0,145.0
90255532.0,6,13,2036,8,1016,12893647.42857143,188.0,127.0,5,1020,22523147.75,204.0,204.0
318044.0,17,4,1400,4,1400,106014.66666666669,350.0,350.0,0,0,0.0,0.0,0.0
142216.0,6,2,132,1,66,0.0,66.0,66.0,1,66,0.0,66.0,66.0
92016221.0,6,38,2508,19,1254,5111997.555555556,66.0,66.0,19,1254,5111989.111111111,66.0,66.0
36792.0,6,14,4740,7,653,5971.333333333333,249.0,93.28571428571428,7,4087,4815.833333333333,1514.0,583.8571428571429
216635.0,6,3,426,2,280,0.0,214.0,140.0,1,146,0.0,146.0,146.0
119770069.0,6,23,1734,12,894,10888188.090909092,95.0,74.5,11,840,11951123.1,95.0,76.36363636363636
0.0,17,1,342,1,342,0.0,342.0,342.0,0,0,0.0,0.0,0.0
17588.0,6,10,2032,5,524,4061.25,252.0,104.8,5,1508,4135.0,1236.0,301.6
113619049.0,6,46,3036,23,1518,5150444.318181818,66.0,66.0,23,1518,5150443.590909091,66.0,66.0
146224.0,6,3,337,2,214,0.0,160.0,107.0,1,123,0.0,123.0,123.0
137489.0,6,2,132,1,66,0.0,66.0,66.0,1,66,0.0,66.0,66.0
1894958.0,6,18,6803,10,1501,210550.88888888888,408.0,150.1,8,5302,220133.2857142857,1514.0,662.75
412730.0,17,2,762,2,762,0.0,381.0,381.0,0,0,0.0,0.0,0.0
2424.0,17,4,344,2,150,0.0,75.0,75.0,2,194,0.0,103.0,97.0
309871.0,6,6,412,4,272,103290.33333333331,74.0,68.0,2,140,0.0,74.0,70.0
99352.0,17,2,762,2,762,0.0,381.0,381.0,0,0,0.0,0.0,0.0
14272743.0,17,6,2052,6,2052,2854548.6,342.0,342.0,0,0,0.0,0.0,0.0
122150.0,6,3,373,2,238,0.0,172.0,119.0,1,135,0.0,135.0,135.0
120437814.0,6,207,23342,104,16248,1169299.1650485436,284.0,156.23076923076923,103,7094,1170695.225490196,140.0,68.87378640776699
38927.0,6,10,2032,5,524,9268.5,252.0,104.8,5,1508,7622.25,1236.0,301.6
10053.0,6,10,2032,5,524,2287.25,252.0,104.8,5,1508,1937.0,1236.0,301.6
2485360.0,6,25,7573,14,3735,191181.53846153847,1514.0,266.7857142857143,11,3838,222683.4,1514.0,348.90909090909093
233690.0,6,3,337,2,214,0.0,160.0,107.0,1,123,0.0,123.0,123.0
307794.0,6,6,412,4,272,102598.0,74.0,68.0,2,140,0.0,74.0,70.0
232929.0,6,3,337,2,214,0.0,160.0,107.0,1,123,0.0,123.0,123.0
90040242.0,17,27,12943,27,12943,3463086.230769231,501.0,479.3703703703704,0,0,0.0,0.0,0.0
16846.0,17,2,180,1,90,0.0,90.0,90.0,1,90,0.0,90.0,90.0
348.0,17,2,267,1,83,0.0,83.0,83.0,1,184,0.0,184.0,184.0
16288409.999999998,17,6,2052,6,2052,3257682.0,342.0,342.0,0,0,0.0,0.0,0.0
119984247.0,17,35,16705,35,16705,3528948.4411764704,501.0,477.2857142857143,0,0,0.0,0.0,0.0
8165381.999999999,17,5,1710,5,1710,2041345.5,342.0,342.0,0,0,0.0,0.0,0.0
2404.0,17,4,344,2,150,0.0,75.0,75.0,2,194,0.0,103.0,97.0
16344.0,6,10,2032,5,524,3480.5,252.0,104.8,5,1508,3833.25,1236.0,301.6
522095.0,6,3,204,1,68,0.0,68.0,68.0,2,136,0.0,70.0,68.0
2935465.0,6,11,2106,6,598,586924.8,252.0,99.66666666666669,5,1508,1907.5,1236.0,301.6
16863.0,17,2,180,1,90,0.0,90.0,90.0,1,90,0.0,90.0,90.0
170514.0,17,2,180,1,90,0.0,90.0,90.0,1,90,0.0,90.0,90.0
205977.0,17,2,180,1,90,0.0,90.0,90.0,1,90,0.0,90.0,90.0
101006168.0,17,13,821,7,432,16834361.333333332,174.0,61.71428571428572,6,389,16200195.8,174.0,64.83333333333333
90527596.0,6,14,2240,8,1016,12932513.714285716,188.0,127.0,6,1224,18073195.2,204.0,204.0
152539.0,17,4,6056,4,6056,50846.333333333336,1514.0,1514.0,0,0,0.0,0.0,0.0
135137683.0,17,6,1146,6,1146,27027536.6,191.0,191.0,0,0,0.0,0.0,0.0
155268.0,17,2,414,1,88,0.0,88.0,88.0,1,326,0.0,326.0,326.0
21557.0,17,2,582,1,83,0.0,83.0,83.0,1,499,0.0,499.0,499.0
90293957.0,6,18,1503,9,853,11281067.0,257.0,94.77777777777776,9,650,11286382.875,95.0,72.22222222222223
102181.0,17,2,700,2,700,0.0,350.0,350.0,0,0,0.0,0.0,0.0
233040.0,6,3,337,2,214,0.0,160.0,107.0,1,123,0.0,123.0,123.0
145089.0,17,2,180,1,70,0.0,70.0,70.0,1,110,0.0,110.0,110.0
17261.0,6,14,4740,7,653,2373.6666666666665,249.0,93.28571428571428,7,4087,2740.5,1514.0,583.8571428571429
217814.0,6,3,426,2,280,0.0,214.0,140.0,1,146,0.0,146.0,146.0
119851080.0,6,15,2306,6,1224,23969759.8,204.0,204.0,9,1082,14981243.375,188.0,120.22222222222224
1699.0,17,4,438,2,148,0.0,74.0,74.0,2,290,0.0,147.0,145.0
92880232.0,6,38,2508,19,1254,5159999.5,66.0,66.0,19,1254,5159998.777777778,66.0,66.0
135142312.0,17,6,1206,6,1206,27028462.4,201.0,201.0,0,0,0.0,0.0,0.0
5725141.0,6,4,270,2,134,0.0,68.0,67.0,2,136,0.0,70.0,68.0
90036617.0,17,28,13364,28,13364,3334689.5185185187,501.0,477.2857142857143,0,0,0.0,0.0,0.0
1307890.0,6,4,264,2,132,0.0,66.0,66.0,2,132,0.0,66.0,66.0
9944.0,17,2,582,1,83,0.0,83.0,83.0,1,499,0.0,499.0,499.0
2380.0,17,4,344,2,150,0.0,75.0,75.0,2,194,0.0,103.0,97.0
319495.0,17,4,1400,4,1400,106498.33333333331,350.0,350.0,0,0,0.0,0.0,0.0
49383.0,6,14,4740,7,653,7958.5,249.0,93.28571428571428,7,4087,6842.166666666667,1514.0,583.8571428571429
286586.0,17,2,180,1,90,0.0,90.0,90.0,1,90,0.0,90.0,90.0
135131043.0,17,6,1206,6,1206,27026208.6,201.0,201.0,0,0,0.0,0.0,0.0
120139829.0,6,13,2036,5,1020,30034957.25,204.0,204.0,8,1016,17136940.42857143,188.0,127.0
1182848.0,6,13,3010,8,2382,168978.2857142857,1514.0,297.75,5,628,226938.75,331.0,125.6
36673.0,6,12,1413,7,882,6112.166666666667,291.0,126.0,5,531,8079.0,259.0,106.2
120074616.0,17,29,13785,29,13785,4288379.142857143,501.0,475.3448275862069,0,0,0.0,0.0,0.0
2291.0,17,4,344,2,150,0.0,75.0,75.0,2,194,0.0,103.0,97.0
206059.0,6,3,426,2,280,0.0,214.0,140.0,1,146,0.0,146.0,146.0
94854547.0,6,26,1746,13,906,7886558.916666667,123.0,69.6923076923077,13,840,7886560.916666667,123.0,64.61538461538461
301762.0,17,2,246,1,76,0.0,76.0,76.0,1,170,0.0,170.0,170.0
123458597.0,6,49,3234,25,1650,5144108.208333333,66.0,66.0,24,1584,5047675.869565218,66.0,66.0
6024.0,17,2,180,1,90,0.0,90.0,90.0,1,90,0.0,90.0,90.0
331.0,17,2,160,1,80,0.0,80.0,80.0,1,80,0.0,80.0,80.0
90044669.0,17,28,13364,28,13364,3334987.7407407407,501.0,477.2857142857143,0,0,0.0,0.0,0.0
2018385.0,17,4,525,2,150,0.0,75.0,75.0,2,375,0.0,284.0,187.5
57284.0,6,14,4740,7,653,9413.0,249.0,93.28571428571428,7,4087,9272.666666666666,1514.0,583.8571428571429
249075.0,6,3,337,2,214,0.0,160.0,107.0,1,123,0.0,123.0,123.0
32588.0,6,10,1066,5,490,7640.25,218.0,98.0,5,576,7939.75,304.0,115.2
2795143.0,6,2,132,1,66,0.0,66.0,66.0,1,66,0.0,66.0,66.0
25906.0,6,10,2032,5,524,5141.25,252.0,104.8,5,1508,6203.75,1236.0,301.6
50982.0,6,14,4740,7,653,7820.5,249.0,93.28571428571428,7,4087,6744.166666666667,1514.0,583.8571428571429
90045961.0,17,28,13364,28,13364,3335035.592592593,501.0,477.2857142857143,0,0,0.0,0.0,0.0
135131566.0,17,6,1206,6,1206,27026313.2,201.0,201.0,0,0,0.0,0.0,0.0
227211.0,6,10,1221,6,636,45442.2,298.0,106.0,4,585,73015.33333333333,379.0,146.25
35185.0,6,14,4740,7,653,5714.333333333333,249.0,93.28571428571428,7,4087,5732.5,1514.0,583.8571428571429
326.0,17,2,166,1,75,0.0,75.0,75.0,1,91,0.0,91.0,91.0
37902.0,6,14,4740,7,653,6157.833333333333,249.0,93.28571428571428,7,4087,5266.833333333333,1514.0,583.8571428571429
149800464.0,17,36,17126,36,17126,4280013.257142857,501.0,475.72222222222223,0,0,0.0,0.0,0.0
781.0,17,4,438,2,148,0.0,74.0,74.0,2,290,0.0,147.0,145.0
97389754.0,6,27,1971,13,979,8115236.083333333,95.0,75.3076923076923,14,992,7469785.692307692,95.0,70.85714285714286
107392.0,17,2,286,2,286,0.0,143.0,143.0,0,0,0.0,0.0,0.0
102999.0,17,2,286,2,286,0.0,143.0,143.0,0,0,0.0,0.0,0.0
2390.0,17,4,344,2,150,0.0,75.0,75.0,2,194,0.0,103.0,97.0
1854552.0,6,20,7599,11,1469,185455.2,583.0,133.54545454545453,9,6130,199241.125,1484.0,681.1111111111111
13325.0,6,10,2032,5,524,3004.5,252.0,104.8,5,1508,3049.0,1236.0,301.6
108099926.0,17,5,1005,5,1005,27024981.5,201.0,201.0,0,0,0.0,0.0,0.0
0.0,17,1,55,1,55,0.0,55.0,55.0,0,0,0.0,0.0,0.0
2318.0,17,4,344,2,150,0.0,75.0,75.0,2,194,0.0,103.0,97.0
120001159.0,6,17,1287,9,691,15000144.875,95.0,76.77777777777777,8,596,12898800.285714284,95.0,74.5
23582081.0,6,30,10135,16,2552,1572138.7333333334,408.0,159.5,14,7583,1632632.6153846155,1514.0,541.6428571428571
96179099.0,6,58,12255,29,6460,3434967.821428572,1514.0,222.7586206896552,29,5795,3425107.535714286,1514.0,199.8275862068965
98298.0,17,2,762,2,762,0.0,381.0,381.0,0,0,0.0,0.0,0.0
310727.0,6,6,412,4,272,103575.66666666669,74.0,68.0,2,140,0.0,74.0,70.0
120078170.0,17,29,13785,29,13785,4288506.071428572,501.0,475.3448275862069,0,0,0.0,0.0,0.0
2955232.0,6,3,204,2,136,0.0,70.0,68.0,1,68,0.0,68.0,68.0
209702.0,6,3,426,2,280,0.0,214.0,140.0,1,146,0.0,146.0,146.0
9004897.0,17,4,300,4,300,3001632.333333333,75.0,75.0,0,0,0.0,0.0,0.0
118886767.0,6,38,2710,19,1408,6604820.388888889,139.0,74.10526315789474,19,1302,6592798.888888889,123.0,68.52631578947368
279169.0,6,10,1221,6,636,55833.8,298.0,106.0,4,585,91993.33333333331,379.0,146.25
1408033.0,17,7,490,7,490,234672.16666666663,70.0,70.0,0,0,0.0,0.0,0.0
90215989.0,6,21,1585,10,745,9997124.444444444,95.0,74.5,11,840,9001058.2,95.0,76.36363636363636
323032.0,6,6,412,4,272,107677.33333333331,74.0,68.0,2,140,0.0,74.0,70.0
222494.0,6,10,1221,6,636,44498.8,298.0,106.0,4,585,72826.66666666667,379.0,146.25
232419.0,6,3,337,2,214,0.0,160.0,107.0,1,123,0.0,123.0,123.0
107202783.0,6,203,23058,102,6954,1061413.693069307,140.0,68.17647058823529,101,16104,1061701.55,300.0,159.44554455445544
93516307.0,6,40,2640,20,1320,4921910.894736842,66.0,66.0,20,1320,4905358.842105263,66.0,66.0
90015088.0,17,28,13364,28,13364,3333892.1481481483,501.0,477.2857142857143,0,0,0.0,0.0,0.0
262325.0,6,10,1221,6,636,52465.0,298.0,106.0,4,585,86402.0,379.0,146.25
108108939.0,17,5,1005,5,1005,27027234.75,201.0,201.0,0,0,0.0,0.0,0.0
146604.0,6,3,337,2,214,0.0,160.0,107.0,1,123,0.0,123.0,123.0
117491378.0,6,232,26216,116,18338,1019793.3304347828,284.0,158.08620689655172,116,7878,1019793.095652174,140.0,67.91379310344827
92888271.0,6,38,2508,19,1254,5160445.055555556,66.0,66.0,19,1254,5160441.166666667,66.0,66.0
23339.0,6,19,7540,11,978,2333.9,310.0,88.9090909090909,8,6562,2246.5714285714284,1514.0,820.25
248056.0,17,4,6056,4,6056,82685.33333333333,1514.0,1514.0,0,0,0.0,0.0,0.0
77398.0,6,14,4740,7,653,12407.0,249.0,93.28571428571428,7,4087,12093.166666666666,1514.0,583.8571428571429
10434046.0,6,6,412,3,206,5146194.0,74.0,68.66666666666667,3,206,5146080.5,74.0,68.66666666666667
3072.0,17,2,224,1,76,0.0,76.0,76.0,1,148,0.0,148.0,148.0
2600760.0,6,2,132,1,66,0.0,66.0,66.0,1,66,0.0,66.0,66.0
125877391.0,17,15,907,7,432,17667382.0,174.0,61.71428571428572,8,475,17857362.14285714,174.0,59.375
2020149.0,6,23,7478,12,2450,183649.9090909091,1034.0,204.16666666666663,11,5028,172021.8,1510.0,457.09090909090907
120167138.0,6,228,25862,114,7820,1047093.3805309734,140.0,68.59649122807018,114,18042,1056101.2389380531,374.0,158.26315789473685
2455.0,17,4,344,2,150,0.0,75.0,75.0,2,194,0.0,103.0,97.0
308050.0,6,6,412,4,272,102683.33333333331,74.0,68.0,2,140,0.0,74.0,70.0
33145.0,6,10,2032,5,524,8063.5,252.0,104.8,5,1508,7653.0,1236.0,301.6
206610.0,6,10,1221,6,636,41322.0,298.0,106.0,4,585,67619.66666666667,379.0,146.25
108097086.0,17,5,955,5,955,27024271.5,191.0,191.0,0,0,0.0,0.0,0.0
90766400.0,6,22,1680,12,894,8247085.909090909,95.0,74.5,10,786,10083766.111111112,95.0,78.6
111328.0,17,2,286,2,286,0.0,143.0,143.0,0,0,0.0,0.0,0.0
33127.0,6,14,4740,7,653,4593.0,249.0,93.28571428571428,7,4087,5286.0,1514.0,583.8571428571429
90256949.0,6,15,2444,8,1016,12893849.857142856,188.0,127.0,7,1428,15015284.5,204.0,204.0
2275.0,17,4,344,2,150,0.0,75.0,75.0,2,194,0.0,103.0,97.0
221353.0,6,12,1373,7,714,36892.16666666666,298.0,102.0,5,659,54531.0,379.0,131.8
90207606.0,6,17,1287,8,596,12852717.142857144,95.0,74.5,9,691,11250342.625,95.0,76.77777777777777
234366.0,6,3,373,2,238,0.0,172.0,119.0,1,135,0.0,135.0,135.0
40532.0,6,14,4740,7,653,6582.333333333333,249.0,93.28571428571428,7,4087,6198.333333333333,1514.0,583.8571428571429
13557.0,6,13,1459,7,862,2219.0,271.0,123.14285714285714,6,597,2230.0,259.0,99.5
79.0,17,2,762,2,762,0.0,381.0,381.0,0,0,0.0,0.0,0.0
53076.0,6,13,1386,7,789,8088.0,253.0,112.71428571428572,6,597,8515.2,259.0,99.5
2601344.0,6,25,7573,14,3735,200103.38461538465,1514.0,266.7857142857143,11,3838,234571.5,1514.0,348.90909090909093
788.0,17,2,762,2,762,0.0,381.0,381.0,0,0,0.0,0.0,0.0
37629.0,6,14,4740,7,653,6139.333333333333,249.0,93.28571428571428,7,4087,5728.666666666667,1514.0,583.8571428571429
622833.0,17,6,1230,3,234,311230.5,78.0,78.0,3,996,311213.0,332.0,332.0
232936.0,6,13,1386,7,789,38822.66666666666,253.0,112.71428571428572,6,597,44082.4,259.0,99.5
42071.0,6,14,4740,7,653,6166.333333333333,249.0,93.28571428571428,7,4087,6767.0,1514.0,583.8571428571429
90288718.0,6,15,1097,8,596,12898388.285714284,95.0,74.5,7,501,14999212.833333334,95.0,71.57142857142857
2388.0,17,4,344,2,150,0.0,75.0,75.0,2,194,0.0,103.0,97.0
2802273.0,6,2,132,1,66,0.0,66.0,66.0,1,66,0.0,66.0,66.0
99842357.0,6,1104,436982,505,34588,198082.7400793651,214.0,68.49108910891088,599,402394,166927.40635451506,1514.0,671.7762938230384
77802.0,6,10,2032,5,524,19163.0,252.0,104.8,5,1508,6119.25,1236.0,301.6
337.0,17,2,168,1,76,0.0,76.0,76.0,1,92,0.0,92.0,92.0
135135905.0,17,6,1146,6,1146,27027181.0,191.0,191.0,0,0,0.0,0.0,0.0
89229736.0,17,14,4788,14,4788,6863825.846153846,342.0,342.0,0,0,0.0,0.0,0.0
37695.0,6,14,4740,7,653,6155.333333333333,249.0,93.28571428571428,7,4087,5633.5,1514.0,583.8571428571429
372082.0,17,2,180,1,90,0.0,90.0,90.0,1,90,0.0,90.0,90.0
237942.0,6,3,337,2,214,0.0,160.0,107.0,1,123,0.0,123.0,123.0
209874.0,17,2,484,1,178,0.0,178.0,178.0,1,306,0.0,306.0,306.0
71330.0,6,14,4740,7,653,11213.5,249.0,93.28571428571428,7,4087,11589.666666666666,1514.0,583.8571428571429
22301.0,6,14,4740,7,653,3558.5,249.0,93.28571428571428,7,4087,3244.1666666666665,1514.0,583.8571428571429
31797.0,6,12,1413,7,882,5299.5,291.0,126.0,5,531,5430.5,259.0,106.2
984272.0,6,12,1362,6,731,195996.0,253.0,121.83333333333331,6,631,196391.4,293.0,105.16666666666669
23644152.0,17,1554,661348,963,614792,24578.12058212058,1434.0,638.4132917964694,591,46556,39853.39152542373,351.0,78.77495769881557
35514.0,6,14,4740,7,653,5809.0,249.0,93.28571428571428,7,4087,4749.166666666667,1514.0,583.8571428571429
122291861.0,6,32,2226,17,1209,7643241.3125,123.0,71.11764705882354,15,1017,8006391.0,123.0,67.8
2792760.0,6,2,132,1,66,0.0,66.0,66.0,1,66,0.0,66.0,66.0
506780.0,6,5,336,2,134,0.0,68.0,67.0,3,202,192675.0,70.0,67.33333333333333
242033.0,6,3,337,2,214,0.0,160.0,107.0,1,123,0.0,123.0,123.0
313683.0,17,4,1400,4,1400,104561.0,350.0,350.0,0,0,0.0,0.0,0.0
146191.0,6,3,337,2,214,0.0,160.0,107.0,1,123,0.0,123.0,123.0
147082.0,6,3,373,2,238,0.0,172.0,119.0,1,135,0.0,135.0,135.0
119608156.0,6,182,20554,91,14326,1326586.9666666666,284.0,157.42857142857142,91,6228,1326585.0,140.0,68.43956043956044
122188.0,6,3,373,2,238,0.0,172.0,119.0,1,135,0.0,135.0,135.0
95130370.0,6,40,2640,20,1320,5006861.578947368,66.0,66.0,20,1320,4990617.368421053,66.0,66.0
2005.0,17,4,344,2,150,0.0,75.0,75.0,2,194,0.0,103.0,97.0
186083.0,17,2,180,1,90,0.0,90.0,90.0,1,90,0.0,90.0,90.0
160524.0,6,3,337,2,214,0.0,160.0,107.0,1,123,0.0,123.0,123.0
83462789.0,17,14,4796,13,4446,6234677.083333333,342.0,342.0,1,350,0.0,350.0,350.0
82433.0,6,10,2032,5,524,20387.75,252.0,104.8,5,1508,19757.75,1236.0,301.6
107584.0,17,2,286,2,286,0.0,143.0,143.0,0,0,0.0,0.0,0.0
205962.0,6,3,426,2,280,0.0,214.0,140.0,1,146,0.0,146.0,146.0
15508.0,6,10,2032,5,524,3664.75,252.0,104.8,5,1508,3605.25,1236.0,301.6
117036.0,17,4,1400,4,1400,39012.0,350.0,350.0,0,0,0.0,0.0,0.0
92001315.0,17,16,5472,16,5472,6133421.0,342.0,342.0,0,0,0.0,0.0,0.0
95693.0,17,2,762,2,762,0.0,381.0,381.0,0,0,0.0,0.0,0.0
28906.0,6,14,4740,7,653,4439.5,249.0,93.28571428571428,7,4087,4663.5,1514.0,583.8571428571429
2593792.0,6,2,132,1,66,0.0,66.0,66.0,1,66,0.0,66.0,66.0
237366.0,6,3,337,2,214,0.0,160.0,107.0,1,123,0.0,123.0,123.0
2482.0,17,4,344,2,150,0.0,75.0,75.0,2,194,0.0,103.0,97.0
206172.0,6,3,426,2,280,0.0,214.0,140.0,1,146,0.0,146.0,146.0
44517.0,6,14,4740,7,653,7301.333333333333,249.0,93.28571428571428,7,4087,7153.833333333333,1514.0,583.8571428571429
64537.0,6,14,4740,7,653,10498.833333333334,249.0,93.28571428571428,7,4087,9638.333333333334,1514.0,583.8571428571429
1302495.0,6,4,264,2,132,0.0,66.0,66.0,2,132,0.0,66.0,66.0
330308.0,6,6,412,4,272,110102.66666666669,74.0,68.0,2,140,0.0,74.0,70.0
45283.0,6,10,2032,5,524,10750.75,252.0,104.8,5,1508,7235.75,1236.0,301.6
2198.0,17,2,664,1,322,0.0,322.0,322.0,1,342,0.0,342.0,342.0
397.0,17,2,174,1,79,0.0,79.0,79.0,1,95,0.0,95.0,95.0
1302586.0,6,4,264,2,132,0.0,66.0,66.0,2,132,0.0,66.0,66.0
90754539.0,6,22,1680,12,894,8246571.181818182,95.0,74.5,10,786,10083105.111111112,95.0,78.6
34968.0,6,12,1413,6,816,6210.6,291.0,136.0,6,597,5825.6,259.0,99.5
10515865.0,6,7,478,4,272,3457988.6666666665,74.0,68.0,3,206,5186950.0,74.0,68.66666666666667
108111309.0,17,5,1005,5,1005,27027827.25,201.0,201.0,0,0,0.0,0.0,0.0
90205698.0,6,17,1287,8,596,12852831.714285716,95.0,74.5,9,691,11250125.875,95.0,76.77777777777777
43334.0,6,13,1386,7,789,5900.666666666667,253.0,112.71428571428572,6,597,7847.2,259.0,99.5
46039.0,6,10,2032,5,524,11274.5,252.0,104.8,5,1508,9989.25,1236.0,301.6
143867.0,17,2,180,1,90,0.0,90.0,90.0,1,90,0.0,90.0,90.0
90251995.0,6,12,1832,8,1016,12893142.142857144,188.0,127.0,4,816,30028641.0,204.0,204.0
120708273.0,6,385,63222,195,50312,622207.5927835051,1514.0,258.01025641025643,190,12910,633166.4656084656,214.0,67.94736842105263
100816.0,17,2,762,2,762,0.0,381.0,381.0,0,0,0.0,0.0,0.0
308556.0,6,6,412,4,272,102852.0,74.0,68.0,2,140,0.0,74.0,70.0
120028917.0,17,29,13785,29,13785,4286747.035714285,501.0,475.3448275862069,0,0,0.0,0.0,0.0
40391166.0,6,26,7627,14,3735,185935.0769230769,1514.0,266.7857142857143,12,3892,3652277.272727273,1514.0,324.3333333333333
523345.0,6,5,336,2,134,0.0,68.0,67.0,3,202,179409.5,70.0,67.33333333333333
61470.0,6,14,4740,7,653,10080.833333333334,249.0,93.28571428571428,7,4087,9803.166666666666,1514.0,583.8571428571429
90013890.0,17,28,13364,28,13364,3333847.777777778,501.0,477.2857142857143,0,0,0.0,0.0,0.0
90477601.0,6,13,1910,8,1016,12907654.42857143,188.0,127.0,5,894,15114189.75,204.0,178.8
108106768.0,17,5,955,5,955,27026692.0,191.0,191.0,0,0,0.0,0.0,0.0
90008712.0,17,27,12943,27,12943,3461873.5384615385,501.0,479.3703703703704,0,0,0.0,0.0,0.0
604719.0,6,4,508,2,238,0.0,172.0,119.0,2,270,0.0,135.0,135.0
120012272.0,17,28,13364,28,13364,4444898.962962963,501.0,477.2857142857143,0,0,0.0,0.0,0.0
36351.0,6,14,4740,7,653,3949.6666666666665,249.0,93.28571428571428,7,4087,5924.166666666667,1514.0,583.8571428571429
307503.0,6,6,412,4,272,102501.0,74.0,68.0,2,140,0.0,74.0,70.0
2796305.0,6,2,132,1,66,0.0,66.0,66.0,1,66,0.0,66.0,66.0
313.0,17,2,166,1,75,0.0,75.0,75.0,1,91,0.0,91.0,91.0
386.0,17,2,508,2,508,0.0,257.0,254.0,0,0,0.0,0.0,0.0
108109217.0,17,5,955,5,955,27027304.25,191.0,191.0,0,0,0.0,0.0,0.0
0.0,17,1,342,1,342,0.0,342.0,342.0,0,0,0.0,0.0,0.0
90029876.0,17,28,13364,28,13364,3334439.851851852,501.0,477.2857142857143,0,0,0.0,0.0,0.0
908479.0,6,12,1427,6,796,179766.0,271.0,132.66666666666666,6,631,180365.8,293.0,105.16666666666669
1308541.0,6,4,264,2,132,0.0,66.0,66.0,2,132,0.0,66.0,66.0
2356.0,17,4,344,2,150,0.0,75.0,75.0,2,194,0.0,103.0,97.0
2526.0,17,4,344,2,150,0.0,75.0,75.0,2,194,0.0,103.0,97.0
228405.0,17,2,180,1,90,0.0,90.0,90.0,1,90,0.0,90.0,90.0
255069.0,6,3,337,2,214,0.0,160.0,107.0,1,123,0.0,123.0,123.0
206036.0,6,3,426,2,280,0.0,214.0,140.0,1,146,0.0,146.0,146.0
35370.0,6,14,4740,7,653,5310.833333333333,249.0,93.28571428571428,7,4087,5162.666666666667,1514.0,583.8571428571429
103566679.0,6,44,2904,22,1452,4931746.619047619,66.0,66.0,22,1452,4921848.571428572,66.0,66.0
2314.0,17,4,344,2,150,0.0,75.0,75.0,2,194,0.0,103.0,97.0
120714.0,17,2,180,1,70,0.0,70.0,70.0,1,110,0.0,110.0,110.0
155493.0,6,3,337,2,214,0.0,160.0,107.0,1,123,0.0,123.0,123.0
33113.0,6,14,4740,7,653,5398.666666666667,249.0,93.28571428571428,7,4087,5381.0,1514.0,583.8571428571429
108107569.0,17,5,955,5,955,27026892.25,191.0,191.0,0,0,0.0,0.0,0.0
144244.0,17,2,180,1,90,0.0,90.0,90.0,1,90,0.0,90.0,90.0
128028383.0,6,31,2034,16,1086,8535225.533333333,123.0,67.875,15,948,8416205.642857144,123.0,63.2
905491.0,6,12,2709,7,743,150915.16666666666,339.0,106.14285714285714,5,1966,157474.0,1514.0,393.2
429742.0,6,3,1604,1,753,0.0,753.0,753.0,2,851,0.0,785.0,425.5
95652.0,6,14,4740,7,653,14808.0,249.0,93.28571428571428,7,4087,15135.666666666666,1514.0,583.8571428571429
90775022.0,6,22,1680,12,935,8248424.818181818,95.0,77.91666666666667,10,745,10051183.333333334,95.0,74.5
204882.0,17,2,762,2,762,0.0,381.0,381.0,0,0,0.0,0.0,0.0
135134752.0,17,6,1146,6,1146,27026950.4,191.0,191.0,0,0,0.0,0.0,0.0
209434.0,17,2,180,1,90,0.0,90.0,90.0,1,90,0.0,90.0,90.0
56731.0,6,14,4740,7,653,9209.5,249.0,93.28571428571428,7,4087,9284.333333333334,1514.0,583.8571428571429
149.0,17,2,700,2,700,0.0,350.0,350.0,0,0,0.0,0.0,0.0
1315491.0,6,4,264,2,132,0.0,66.0,66.0,2,132,0.0,66.0,66.0
135124370.0,17,6,1206,6,1206,27024874.0,201.0,201.0,0,0,0.0,0.0,0.0
38743.0,6,14,4740,7,653,5914.5,249.0,93.28571428571428,7,4087,5191.166666666667,1514.0,583.8571428571429
928850.0,6,10,1221,6,636,185770.0,298.0,106.0,4,585,308772.3333333333,379.0,146.25
111379259.0,6,220,24740,110,17184,1019853.8165137614,284.0,156.21818181818182,110,7556,1019853.7798165138,140.0,68.69090909090909
205732.0,17,2,180,1,90,0.0,90.0,90.0,1,90,0.0,90.0,90.0
66958.0,6,10,2032,5,524,15770.25,252.0,104.8,5,1508,15732.5,1236.0,301.6
5627162.0,6,4,270,2,134,0.0,68.0,67.0,2,136,0.0,70.0,68.0
303608.0,6,2,132,1,66,0.0,66.0,66.0,1,66,0.0,66.0,66.0
81326.0,6,10,2032,5,524,19950.0,252.0,104.8,5,1508,18880.5,1236.0,301.6
5005644.0,17,4,849,2,166,0.0,83.0,83.0,2,683,0.0,499.0,341.5
108102540.0,17,5,955,5,955,27025635.0,191.0,191.0,0,0,0.0,0.0,0.0
31145.0,6,14,4740,7,653,5012.0,249.0,93.28571428571428,7,4087,5055.833333333333,1514.0,583.8571428571429
106203242.0,6,31,2182,16,1165,7065818.066666666,139.0,72.8125,15,1017,7570514.928571428,123.0,67.8
31577.0,6,13,1394,7,797,5262.833333333333,253.0,113.85714285714286,6,597,5613.8,259.0,99.5
108109846.0,17,5,955,5,955,27027461.5,191.0,191.0,0,0,0.0,0.0,0.0
36495.0,6,14,4740,7,653,5749.166666666667,249.0,93.28571428571428,7,4087,5516.333333333333,1514.0,583.8571428571429
90525652.0,6,13,2036,8,1016,12932236.0,188.0,127.0,5,1020,22590879.75,204.0,204.0
135149654.0,17,6,1146,6,1146,27029930.8,191.0,191.0,0,0,0.0,0.0,0.0
135127020.0,17,6,1206,6,1206,27025404.0,201.0,201.0,0,0,0.0,0.0,0.0
10093.0,17,2,582,1,83,0.0,83.0,83.0,1,499,0.0,499.0,499.0
108132356.0,17,5,1005,5,1005,27033089.0,201.0,201.0,0,0,0.0,0.0,0.0
8854432.0,17,3,1034,2,684,0.0,342.0,342.0,1,350,0.0,350.0,350.0
284262.0,17,2,363,1,79,0.0,79.0,79.0,1,284,0.0,284.0,284.0
216746.0,6,3,426,2,280,0.0,214.0,140.0,1,146,0.0,146.0,146.0
146851.0,6,3,373,2,238,0.0,172.0,119.0,1,135,0.0,135.0,135.0
208355.0,6,3,426,2,280,0.0,214.0,140.0,1,146,0.0,146.0,146.0
0.0,6,1,66,0,0,0.0,0.0,0.0,1,66,0.0,66.0,66.0
103309786.0,6,42,2772,21,1386,5150437.95,66.0,66.0,21,1386,5150410.3,66.0,66.0
94850473.0,6,40,2640,20,1320,4992130.157894737,66.0,66.0,20,1320,4980755.0,66.0,66.0
310832.0,6,6,412,4,272,103610.66666666669,74.0,68.0,2,140,0.0,74.0,70.0
144028.0,17,2,180,1,90,0.0,90.0,90.0,1,90,0.0,90.0,90.0
2055.0,17,4,344,2,150,0.0,75.0,75.0,2,194,0.0,103.0,97.0
120125554.0,6,13,2020,9,1204,15015694.25,188.0,133.77777777777777,4,816,30031291.0,204.0,204.0
222349.0,6,13,1394,7,797,37058.16666666666,253.0,113.85714285714286,6,597,43132.8,259.0,99.5
28575.0,6,10,2032,5,524,5852.25,252.0,104.8,5,1508,6563.75,1236.0,301.6
197317.0,17,2,180,1,90,0.0,90.0,90.0,1,90,0.0,90.0,90.0
13083.0,6,10,1065,5,534,2755.0,262.0,106.8,5,531,2946.25,259.0,106.2
218927.0,17,2,180,1,90,0.0,90.0,90.0,1,90,0.0,90.0,90.0
153702.0,17,2,180,1,90,0.0,90.0,90.0,1,90,0.0,90.0,90.0
498904.0,6,4,270,2,134,0.0,68.0,67.0,2,136,0.0,70.0,68.0
1502613.0,6,19,7533,10,1403,166957.0,583.0,140.3,9,6130,155605.625,1484.0,681.1111111111111
121317765.0,6,217,24608,109,17172,1123312.638888889,284.0,157.54128440366972,108,7436,1105605.4112149533,140.0,68.85185185185185
90061778.0,17,27,12943,27,12943,3463914.5384615385,501.0,479.3703703703704,0,0,0.0,0.0,0.0
90027980.0,17,28,13364,28,13364,3334369.6296296297,501.0,477.2857142857143,0,0,0.0,0.0,0.0
120020039.0,17,29,13785,29,13785,4286429.964285715,501.0,475.3448275862069,0,0,0.0,0.0,0.0
103206.0,17,2,286,2,286,0.0,143.0,143.0,0,0,0.0,0.0,0.0
228245.0,17,2,180,1,90,0.0,90.0,90.0,1,90,0.0,90.0,90.0
107753.0,17,2,286,2,286,0.0,143.0,143.0,0,0,0.0,0.0,0.0
1065663.0,6,4,270,3,202,532831.5,70.0,67.33333333333333,1,68,0.0,68.0,68.0
148029.0,17,2,180,1,90,0.0,90.0,90.0,1,90,0.0,90.0,90.0
48168.0,6,14,4740,7,653,7865.5,249.0,93.28571428571428,7,4087,7427.333333333333,1514.0,583.8571428571429
99529845.0,6,18,1503,9,853,12440578.0,257.0,94.77777777777776,9,650,12439607.5,95.0,72.22222222222223
107557.0,17,2,286,2,286,0.0,143.0,143.0,0,0,0.0,0.0,0.0
99554560.0,6,30,2122,15,1105,7095612.928571428,139.0,73.66666666666667,15,1017,7095626.0,123.0,67.8
47838.0,6,14,4740,7,653,7830.666666666667,249.0,93.28571428571428,7,4087,7682.166666666667,1514.0,583.8571428571429
148313.0,17,2,414,1,88,0.0,88.0,88.0,1,326,0.0,326.0,326.0
2369.0,17,4,344,2,150,0.0,75.0,75.0,2,194,0.0,103.0,97.0
120419169.0,6,245,27804,123,19456,987042.368852459,300.0,158.1788617886179,122,8348,989396.4132231404,140.0,68.42622950819673
120069565.0,17,28,13364,28,13364,4447020.925925926,501.0,477.2857142857143,0,0,0.0,0.0,0.0
245403.0,6,3,337,2,214,0.0,160.0,107.0,1,123,0.0,123.0,123.0
1169.0,17,5,550,5,550,292.25,110.0,110.0,0,0,0.0,0.0,0.0
590597.0,17,2,876,2,876,0.0,438.0,438.0,0,0,0.0,0.0,0.0
149857868.0,17,35,16705,35,16705,4407584.352941177,501.0,477.2857142857143,0,0,0.0,0.0,0.0
12208.0,17,2,582,1,83,0.0,83.0,83.0,1,499,0.0,499.0,499.0
54550.0,6,14,4740,7,653,8922.833333333334,249.0,93.28571428571428,7,4087,8560.166666666666,1514.0,583.8571428571429
19024725.0,6,6,1981,4,1087,6341575.0,885.0,271.75,2,894,0.0,826.0,447.0
111176622.0,6,32,2236,16,1165,7397373.733333333,139.0,72.8125,16,1071,7397374.0,123.0,66.9375
135122287.0,17,6,1146,6,1146,27024457.4,191.0,191.0,0,0,0.0,0.0,0.0
120004759.0,6,22,1639,11,799,12000475.9,95.0,72.63636363636364,11,840,11974781.4,95.0,76.36363636363636
20908.0,6,14,4740,7,653,3374.333333333333,249.0,93.28571428571428,7,4087,3086.5,1514.0,583.8571428571429
34177108.0,6,26,7627,14,3735,193144.3076923077,1514.0,266.7857142857143,12,3892,3087438.5454545454,1514.0,324.3333333333333
174449.0,6,18,6623,10,843,19383.222222222223,241.0,84.3,8,5780,23229.28571428572,1514.0,722.5
119089185.0,6,23,1734,11,840,11908918.5,95.0,76.36363636363636,12,894,10802636.090909092,95.0,74.5
307353.0,6,6,412,4,272,102451.0,74.0,68.0,2,140,0.0,74.0,70.0
228179.0,17,2,180,1,90,0.0,90.0,90.0,1,90,0.0,90.0,90.0
136327.0,6,2,132,1,66,0.0,66.0,66.0,1,66,0.0,66.0,66.0
108101274.0,17,5,955,5,955,27025318.5,191.0,191.0,0,0,0.0,0.0,0.0
291027.0,17,2,180,1,90,0.0,90.0,90.0,1,90,0.0,90.0,90.0
90322789.0,6,16,1192,8,596,12893034.0,95.0,74.5,8,596,12901441.42857143,95.0,74.5
787921.0,6,11,1131,6,600,156182.8,262.0,100.0,5,531,196653.5,259.0,106.2
1683434.0,6,23,6509,12,1529,153039.45454545456,357.0,127.41666666666669,11,4980,138202.9,1510.0,452.7272727272728
90018776.0,17,27,12943,27,12943,3462260.6153846155,501.0,479.3703703703704,0,0,0.0,0.0,0.0
207195.0,6,3,426,2,280,0.0,214.0,140.0,1,146,0.0,146.0,146.0
320501.0,17,2,620,1,75,0.0,75.0,75.0,1,545,0.0,545.0,545.0
17550.0,6,11,2098,6,590,2726.2,252.0,98.33333333333331,5,1508,4055.0,1236.0,301.6
30773.0,6,10,2032,5,524,7252.25,252.0,104.8,5,1508,6884.5,1236.0,301.6
48129.0,6,14,4740,7,653,7712.0,249.0,93.28571428571428,7,4087,7875.833333333333,1514.0,583.8571428571429
84906.0,6,12,1328,7,797,14151.0,253.0,113.85714285714286,5,531,16380.75,259.0,106.2
71002.0,6,14,4740,7,653,11641.666666666666,249.0,93.28571428571428,7,4087,11603.166666666666,1514.0,583.8571428571429
120120635.0,6,13,2036,8,1016,17136925.14285714,188.0,127.0,5,1020,22523214.0,204.0,204.0
233267.0,6,3,337,2,214,0.0,160.0,107.0,1,123,0.0,123.0,123.0
250026.00000000003,6,3,337,2,214,0.0,160.0,107.0,1,123,0.0,123.0,123.0
135130534.0,17,6,1146,6,1146,27026106.8,191.0,191.0,0,0,0.0,0.0,0.0
40053.0,6,14,4740,7,653,6550.5,249.0,93.28571428571428,7,4087,6277.666666666667,1514.0,583.8571428571429
107234.0,17,2,286,2,286,0.0,143.0,143.0,0,0,0.0,0.0,0.0
135132094.0,17,6,1146,6,1146,27026418.8,191.0,191.0,0,0,0.0,0.0,0.0
109116946.0,6,205,23046,103,7020,1069773.9803921569,140.0,68.15533980582525,102,16026,1071256.0297029703,284.0,157.11764705882354
5632566.0,6,5,336,2,134,0.0,68.0,67.0,3,202,1529931.0,70.0,67.33333333333333
51938.0,6,14,4740,7,653,8412.666666666666,249.0,93.28571428571428,7,4087,7513.5,1514.0,583.8571428571429
90296276.0,6,16,1192,8,596,12892422.857142856,95.0,74.5,8,596,12898281.57142857,95.0,74.5
103334.0,17,2,286,2,286,0.0,143.0,143.0,0,0,0.0,0.0,0.0
302483.0,6,2,132,1,66,0.0,66.0,66.0,1,66,0.0,66.0,66.0
27728358.0,17,5,1710,5,1710,6932089.5,342.0,342.0,0,0,0.0,0.0,0.0
301296.0,6,6,412,4,272,100432.0,74.0,68.0,2,140,0.0,74.0,70.0
216399.0,17,2,180,1,90,0.0,90.0,90.0,1,90,0.0,90.0,90.0
113309520.0,6,30,1974,15,1026,8078108.142857143,123.0,68.4,15,948,8078110.214285715,123.0,63.2
38540.0,6,14,4740,7,653,5445.666666666667,249.0,93.28571428571428,7,4087,5561.166666666667,1514.0,583.8571428571429
48110.0,6,14,4740,7,653,7837.166666666667,249.0,93.28571428571428,7,4087,7756.833333333333,1514.0,583.8571428571429
218010.0,6,3,426,2,280,0.0,214.0,140.0,1,146,0.0,146.0,146.0
267237.0,6,12,1373,7,714,44539.5,298.0,102.0,5,659,61805.5,379.0,131.8
693.0,17,4,438,2,148,0.0,74.0,74.0,2,290,0.0,147.0,145.0
2173729.0,6,19,6869,11,1567,217372.9,408.0,142.45454545454547,8,5302,248625.57142857145,1514.0,662.75
40970.0,6,14,4740,7,653,6658.5,249.0,93.28571428571428,7,4087,5632.666666666667,1514.0,583.8571428571429
10467494.0,6,6,412,3,206,5163334.5,74.0,68.66666666666667,3,206,5163245.5,74.0,68.66666666666667
224423.0,6,10,1221,6,636,44884.6,298.0,106.0,4,585,73469.66666666667,379.0,146.25
33636.0,6,14,4740,7,653,5374.833333333333,249.0,93.28571428571428,7,4087,4960.666666666667,1514.0,583.8571428571429
3214029.0,6,15,3750,8,928,459030.7142857143,252.0,116.0,7,2822,36247.66666666666,1236.0,403.1428571428572
280298.0,17,2,363,1,79,0.0,79.0,79.0,1,284,0.0,284.0,284.0
21065.0,6,13,1459,7,862,3287.833333333333,271.0,123.14285714285714,6,597,3951.4,259.0,99.5
118794104.0,6,252,28626,126,20014,948630.296,300.0,158.84126984126985,126,8612,948629.936,140.0,68.34920634920636
90026768.0,17,28,13364,28,13364,3334324.7407407407,501.0,477.2857142857143,0,0,0.0,0.0,0.0
143946.0,17,2,180,1,90,0.0,90.0,90.0,1,90,0.0,90.0,90.0
9269.0,17,2,539,1,86,0.0,86.0,86.0,1,453,0.0,453.0,453.0
746327.0,6,2,132,1,66,0.0,66.0,66.0,1,66,0.0,66.0,66.0
107507.0,17,2,286,2,286,0.0,143.0,143.0,0,0,0.0,0.0,0.0
330.0,17,2,166,1,75,0.0,75.0,75.0,1,91,0.0,91.0,91.0
120004911.0,6,27,3281,13,1447,10000409.25,333.0,111.3076923076923,14,1834,9210895.23076923,425.0,131.0
337051.0,6,6,412,4,272,112350.33333333331,74.0,68.0,2,140,0.0,74.0,70.0
215735.0,6,3,426,2,280,0.0,214.0,140.0,1,146,0.0,146.0,146.0
217523.0,6,3,426,2,280,0.0,214.0,140.0,1,146,0.0,146.0,146.0
111555.0,17,2,700,2,700,0.0,350.0,350.0,0,0,0.0,0.0,0.0
108108228.0,17,5,1005,5,1005,27027057.0,201.0,201.0,0,0,0.0,0.0,0.0
242475.0,6,3,373,2,238,0.0,172.0,119.0,1,135,0.0,135.0,135.0
14153720.0,17,6,2052,6,2052,2830744.0,342.0,342.0,0,0,0.0,0.0,0.0
3009988.0,6,12,2172,7,664,501222.8333333333,252.0,94.85714285714286,5,1508,2737.25,1236.0,301.6
38368.0,6,10,2032,5,524,9356.0,252.0,104.8,5,1508,9066.75,1236.0,301.6
322.0,17,2,174,1,79,0.0,79.0,79.0,1,95,0.0,95.0,95.0
155967.0,17,2,180,1,90,0.0,90.0,90.0,1,90,0.0,90.0,90.0
44825610.0,6,7,1874,5,1053,11206402.5,785.0,210.6,2,821,0.0,753.0,410.5
307135.0,6,6,412,4,272,102378.33333333331,74.0,68.0,2,140,0.0,74.0,70.0
68111.0,6,14,4740,7,653,11209.166666666666,249.0,93.28571428571428,7,4087,11060.166666666666,1514.0,583.8571428571429
148602.0,17,2,414,1,88,0.0,88.0,88.0,1,326,0.0,326.0,326.0
5625427.0,6,5,336,2,134,0.0,68.0,67.0,3,202,1526377.0,70.0,67.33333333333333
233771.0,6,3,373,2,238,0.0,172.0,119.0,1,135,0.0,135.0,135.0
138867387.0,17,14,864,7,432,19833504.5,174.0,61.71428571428572,7,432,20007929.33333333,174.0,61.71428571428572
342.0,17,2,160,1,80,0.0,80.0,80.0,1,80,0.0,80.0,80.0
208089.0,6,3,426,2,280,0.0,214.0,140.0,1,146,0.0,146.0,146.0
121319761.0,6,231,26240,116,18354,1054954.443478261,284.0,158.22413793103448,115,7886,1046167.745614035,140.0,68.57391304347826
35459.0,6,10,2032,5,524,6911.25,252.0,104.8,5,1508,8250.25,1236.0,301.6
90021789.0,17,28,13364,28,13364,3334140.333333333,501.0,477.2857142857143,0,0,0.0,0.0,0.0
3518300.0,6,7,923,4,753,1100723.0,571.0,188.25,3,170,1651118.5,62.0,56.66666666666666
155291.0,6,3,337,2,214,0.0,160.0,107.0,1,123,0.0,123.0,123.0
425347.0,6,2,145,2,145,0.0,91.0,72.5,0,0,0.0,0.0,0.0
218920.0,6,3,426,2,280,0.0,214.0,140.0,1,146,0.0,146.0,146.0
96034097.0,17,14,1126,7,563,16000175.5,174.0,80.42857142857143,7,563,16001379.0,174.0,80.42857142857143
67042.0,6,14,4740,7,653,9850.333333333334,249.0,93.28571428571428,7,4087,10768.5,1514.0,583.8571428571429
5618647.0,6,5,336,2,134,0.0,68.0,67.0,3,202,1527827.0,70.0,67.33333333333333
137328.0,6,2,132,1,66,0.0,66.0,66.0,1,66,0.0,66.0,66.0
13573.0,6,14,4740,7,653,2039.3333333333333,249.0,93.28571428571428,7,4087,2128.5,1514.0,583.8571428571429
2436521.0,6,25,7573,14,3735,187424.6923076923,1514.0,266.7857142857143,11,3838,215104.8,1514.0,348.90909090909093
206747.0,6,3,426,2,280,0.0,214.0,140.0,1,146,0.0,146.0,146.0
145996.0,6,3,337,2,214,0.0,160.0,107.0,1,123,0.0,123.0,123.0
302196.0,6,6,412,4,272,100732.0,74.0,68.0,2,140,0.0,74.0,70.0
119954591.0,6,11,1628,8,1016,17136370.14285714,188.0,127.0,3,612,30032177.5,204.0,204.0
245582.0,6,3,337,2,214,0.0,160.0,107.0,1,123,0.0,123.0,123.0
91838135.0,6,27,1954,14,1045,7047868.692307692,139.0,74.64285714285714,13,909,7635186.833333333,123.0,69.92307692307692
115120268.0,17,14,864,7,432,19167852.5,174.0,61.71428571428572,7,432,19166853.666666668,174.0,61.71428571428572
153455.0,17,2,180,1,90,0.0,90.0,90.0,1,90,0.0,90.0,90.0
100487.0,17,2,286,2,286,0.0,143.0,143.0,0,0,0.0,0.0,0.0
122530486.0,6,49,3234,25,1650,5105436.916666667,66.0,66.0,24,1584,5008403.652173913,66.0,66.0
90046111.0,17,28,13364,28,13364,3335041.1481481483,501.0,477.2857142857143,0,0,0.0,0.0,0.0
12153.0,17,2,582,1,83,0.0,83.0,83.0,1,499,0.0,499.0,499.0
24484.0,6,10,2032,5,524,5887.0,252.0,104.8,5,1508,5565.25,1236.0,301.6
121440.0,6,3,337,2,214,0.0,160.0,107.0,1,123,0.0,123.0,123.0
28218.0,6,10,2032,5,524,6289.0,252.0,104.8,5,1508,5174.0,1236.0,301.6
106360560.0,6,44,2904,22,1452,5064788.571428572,66.0,66.0,22,1452,5049820.0,66.0,66.0
108105612.0,17,5,1005,5,1005,27026403.0,201.0,201.0,0,0,0.0,0.0,0.0
42443.0,6,14,4740,7,653,6944.0,249.0,93.28571428571428,7,4087,5945.166666666667,1514.0,583.8571428571429
82388.0,6,14,4740,7,653,12542.5,249.0,93.28571428571428,7,4087,13220.666666666666,1514.0,583.8571428571429
841.0,17,4,438,2,148,0.0,74.0,74.0,2,290,0.0,147.0,145.0
10489.0,6,10,1067,5,536,2388.25,264.0,107.2,5,531,1929.0,259.0,106.2
860.0,17,4,438,2,148,0.0,74.0,74.0,2,290,0.0,147.0,145.0
120056604.0,17,29,13785,29,13785,4287735.857142857,501.0,475.3448275862069,0,0,0.0,0.0,0.0
99143695.0,6,23,1990,11,1137,9889377.6,223.0,103.36363636363636,12,853,8993462.0,95.0,71.08333333333333
196889.0,17,2,180,1,90,0.0,90.0,90.0,1,90,0.0,90.0,90.0
116629176.0,6,246,28628,123,20214,954203.4836065574,300.0,164.34146341463415,123,8414,954203.5163934426,140.0,68.40650406504065
90013929.0,17,27,12943,27,12943,3462074.1923076925,501.0,479.3703703703704,0,0,0.0,0.0,0.0
122821347.0,6,32,2305,17,1288,7676334.1875,139.0,75.76470588235294,15,1017,8208349.142857143,123.0,67.8
2077.0,17,4,344,2,150,0.0,75.0,75.0,2,194,0.0,103.0,97.0
349.0,17,2,267,1,83,0.0,83.0,83.0,1,184,0.0,184.0,184.0
108102027.0,17,5,1005,5,1005,27025506.75,201.0,201.0,0,0,0.0,0.0,0.0
793.0,17,4,438,2,148,0.0,74.0,74.0,2,290,0.0,147.0,145.0
53298.0,6,14,4740,7,653,8482.333333333334,249.0,93.28571428571428,7,4087,7611.166666666667,1514.0,583.8571428571429
123090800.0,17,14,864,7,432,17333498.833333332,174.0,61.71428571428572,7,432,19931238.0,174.0,61.71428571428572
116283977.0,6,211,23712,106,7218,1107466.4476190477,140.0,68.09433962264151,105,16494,1108281.8942307692,284.0,157.0857142857143
6509.0,17,2,762,2,762,0.0,381.0,381.0,0,0,0.0,0.0,0.0
261549.0,6,10,1221,6,636,52309.8,298.0,106.0,4,585,81049.66666666667,379.0,146.25
104282.0,17,2,286,2,286,0.0,143.0,143.0,0,0,0.0,0.0,0.0
64344.0,6,14,4740,7,653,10599.333333333334,249.0,93.28571428571428,7,4087,9817.666666666666,1514.0,583.8571428571429
3014692.0,6,12,2172,7,664,502396.8333333333,252.0,94.85714285714286,5,1508,3610.5,1236.0,301.6
116631469.0,6,48,3168,24,1584,5070933.434782608,66.0,66.0,24,1584,5058954.956521739,66.0,66.0
90401315.0,6,13,1898,8,1016,12914473.57142857,188.0,127.0,5,882,22557809.75,204.0,176.4
11933.0,6,10,2032,5,524,2535.75,252.0,104.8,5,1508,2695.75,1236.0,301.6
104481.0,17,2,286,2,286,0.0,143.0,143.0,0,0,0.0,0.0,0.0
90528999.0,6,14,2240,8,1016,12932714.142857144,188.0,127.0,6,1224,18072841.4,204.0,204.0
307.0,17,2,174,1,79,0.0,79.0,79.0,1,95,0.0,95.0,95.0
9008946.0,17,2,160,2,160,0.0,80.0,80.0,0,0,0.0,0.0,0.0
113023124.0,17,14,864,7,432,18834985.33333333,174.0,61.71428571428572,7,432,18833500.5,174.0,61.71428571428572
10470899.0,6,7,478,4,272,3443811.333333333,74.0,68.0,3,206,5165623.0,74.0,68.66666666666667
302279.0,6,6,412,4,272,100759.66666666669,74.0,68.0,2,140,0.0,74.0,70.0
35346.0,6,10,2032,5,524,7917.0,252.0,104.8,5,1508,8492.0,1236.0,301.6
103200291.0,6,42,2772,21,1386,5160002.0,66.0,66.0,21,1386,5159992.0,66.0,66.0
120095095.0,6,217,24608,109,7428,1111991.6203703703,140.0,68.14678899082568,108,17180,1103754.4112149533,284.0,159.07407407407408
337.0,17,2,166,1,75,0.0,75.0,75.0,1,91,0.0,91.0,91.0
44902.0,6,13,1394,7,797,7255.833333333333,253.0,113.85714285714286,6,597,7845.6,259.0,99.5
752.0,17,2,762,2,762,0.0,381.0,381.0,0,0,0.0,0.0,0.0
5473689.0,6,151,132235,94,124171,58856.87096774193,1510.0,1320.968085106383,57,8064,90671.0,1510.0,141.47368421052633
206232.0,6,3,426,2,280,0.0,214.0,140.0,1,146,0.0,146.0,146.0
1314624.0,6,4,264,2,132,0.0,66.0,66.0,2,132,0.0,66.0,66.0
90009375.0,17,28,13364,28,13364,3333680.5555555555,501.0,477.2857142857143,0,0,0.0,0.0,0.0
863.0,17,4,438,2,148,0.0,74.0,74.0,2,290,0.0,147.0,145.0
110017239.0,6,30,1990,15,1042,7842967.714285715,139.0,69.46666666666667,15,948,7842966.642857143,123.0,63.2
14626.0,17,4,823,2,163,0.0,89.0,81.5,2,660,0.0,443.0,330.0
120182092.0,6,238,26882,119,8150,1011489.5169491526,140.0,68.4873949579832,119,18732,1011606.2627118644,284.0,157.41176470588235
202015.0,6,10,1221,6,636,40403.0,298.0,106.0,4,585,66162.0,379.0,146.25
108106450.0,17,5,1005,5,1005,27026612.5,201.0,201.0,0,0,0.0,0.0,0.0
5001690.0,17,4,849,2,166,0.0,83.0,83.0,2,683,0.0,499.0,341.5
214751.0,6,12,1373,7,714,35791.833333333336,298.0,102.0,5,659,52701.25,379.0,131.8
90006473.0,17,28,13364,28,13364,3333573.074074074,501.0,477.2857142857143,0,0,0.0,0.0,0.0
125507.0,6,10,2032,5,524,31061.5,252.0,104.8,5,1508,15153.0,1236.0,301.6
814.0,17,4,438,2,148,0.0,74.0,74.0,2,290,0.0,147.0,145.0
216166.0,6,4,301,2,132,0.0,66.0,66.0,2,169,0.0,103.0,84.5
108917013.0,6,44,2904,22,1452,5186524.428571428,66.0,66.0,22,1452,5173389.19047619,66.0,66.0
119145395.0,6,234,26528,117,8018,1019997.3534482758,140.0,68.52991452991454,117,18510,1020119.6637931034,284.0,158.2051282051282
2428.0,17,4,344,2,150,0.0,75.0,75.0,2,194,0.0,103.0,97.0
43804.0,6,14,4740,7,653,7171.666666666667,249.0,93.28571428571428,7,4087,6568.833333333333,1514.0,583.8571428571429
280444.0,17,4,571,2,148,0.0,74.0,74.0,2,423,0.0,276.0,211.5
38173.0,6,14,4740,7,653,4990.833333333333,249.0,93.28571428571428,7,4087,6186.166666666667,1514.0,583.8571428571429
1310765.0,6,4,264,2,132,0.0,66.0,66.0,2,132,0.0,66.0,66.0
317922.0,6,6,412,4,272,105974.0,74.0,68.0,2,140,0.0,74.0,70.0
118426988.0,6,221,25056,111,17574,1076608.981818182,284.0,158.32432432432432,110,7482,1076923.0,140.0,68.01818181818182
228250.0,17,2,180,1,90,0.0,90.0,90.0,1,90,0.0,90.0,90.0
216603.0,6,3,426,2,280,0.0,214.0,140.0,1,146,0.0,146.0,146.0
207506.0,6,3,426,2,280,0.0,214.0,140.0,1,146,0.0,146.0,146.0
49178.0,6,14,4740,7,653,8013.333333333333,249.0,93.28571428571428,7,4087,6437.5,1514.0,583.8571428571429
90256312.0,6,14,2240,8,1016,12893758.857142856,188.0,127.0,6,1224,18017860.6,204.0,204.0
23426.0,6,10,2032,5,524,5235.0,252.0,104.8,5,1508,5603.0,1236.0,301.6
60136.0,6,14,4740,7,653,8378.833333333334,249.0,93.28571428571428,7,4087,9877.0,1514.0,583.8571428571429
137845.0,17,4,344,2,150,0.0,75.0,75.0,2,194,0.0,103.0,97.0
303634.0,6,2,132,1,66,0.0,66.0,66.0,1,66,0.0,66.0,66.0
19650.0,6,10,2032,5,524,4555.5,252.0,104.8,5,1508,3806.25,1236.0,301.6
15233.0,6,2,177,1,123,0.0,123.0,123.0,1,54,0.0,54.0,54.0
120045177.0,17,28,13364,28,13364,4446117.666666667,501.0,477.2857142857143,0,0,0.0,0.0,0.0
207214.0,6,3,426,2,280,0.0,214.0,140.0,1,146,0.0,146.0,146.0
90941823.0,6,21,1585,11,840,9093507.7,95.0,76.36363636363636,10,745,10102749.666666666,95.0,74.5
281383.0,17,2,363,1,79,0.0,79.0,79.0,1,284,0.0,284.0,284.0
208570.0,17,2,180,1,90,0.0,90.0,90.0,1,90,0.0,90.0,90.0
124954483.0,17,15,1169,8,606,17850640.42857143,174.0,75.75,7,563,17528404.666666668,174.0,80.42857142857143
204326.0,17,2,762,2,762,0.0,381.0,381.0,0,0,0.0,0.0,0.0
32218.0,6,13,1479,7,882,5369.666666666667,291.0,126.0,6,597,4943.0,259.0,99.5
90019682.0,17,27,12943,27,12943,3462295.461538461,501.0,479.3703703703704,0,0,0.0,0.0,0.0
26325.0,6,14,4740,7,653,3949.5,249.0,93.28571428571428,7,4087,3903.3333333333335,1514.0,583.8571428571429
2385.0,17,4,344,2,150,0.0,75.0,75.0,2,194,0.0,103.0,97.0
195910.0,6,2,132,1,66,0.0,66.0,66.0,1,66,0.0,66.0,66.0
2596563.0,6,2,132,1,66,0.0,66.0,66.0,1,66,0.0,66.0,66.0
24813.0,6,14,4740,7,653,3965.6666666666665,249.0,93.28571428571428,7,4087,3299.333333333333,1514.0,583.8571428571429
214178.0,6,12,1373,7,714,35696.333333333336,298.0,102.0,5,659,52664.75,379.0,131.8
315986.0,17,4,1400,4,1400,105328.66666666669,350.0,350.0,0,0,0.0,0.0,0.0
120092164.0,6,334,40614,167,11318,706790.0240963856,140.0,67.77245508982035,167,29296,718593.2228915662,570.0,175.4251497005988
119690925.0,6,698,92918,349,23330,343920.8448275862,140.0,66.84813753581662,349,69588,343900.6810344828,374.0,199.39255014326648
318504.0,17,4,1400,4,1400,106168.0,350.0,350.0,0,0,0.0,0.0,0.0
315507.0,17,4,704,2,148,0.0,74.0,74.0,2,556,0.0,280.0,278.0
45236.0,6,14,4740,7,653,7374.333333333333,249.0,93.28571428571428,7,4087,7125.833333333333,1514.0,583.8571428571429
34123.0,6,11,2098,6,590,5214.6,252.0,98.33333333333331,5,1508,8267.0,1236.0,301.6
4973.0,17,2,582,1,83,0.0,83.0,83.0,1,499,0.0,499.0,499.0
120126840.0,6,13,2036,5,1020,30031710.0,204.0,204.0,8,1016,17137294.42857143,188.0,127.0
125747697.0,6,32,2220,16,1071,7717501.666666667,123.0,66.9375,16,1149,7977615.466666667,123.0,71.8125
27163.0,6,11,2098,6,590,4681.4,252.0,98.33333333333331,5,1508,5667.25,1236.0,301.6
213979.0,17,2,180,1,90,0.0,90.0,90.0,1,90,0.0,90.0,90.0
8998302.0,17,4,300,4,300,2999434.0,75.0,75.0,0,0,0.0,0.0,0.0
4353.0,17,2,602,1,72,0.0,72.0,72.0,1,530,0.0,530.0,530.0
90310294.0,6,21,1585,11,840,9025126.4,95.0,76.36363636363636,10,745,10002950.555555556,95.0,74.5
108106130.0,17,5,955,5,955,27026532.5,191.0,191.0,0,0,0.0,0.0,0.0
45344.0,6,14,4740,7,653,7156.0,249.0,93.28571428571428,7,4087,7345.833333333333,1514.0,583.8571428571429
202172.0,6,11,1132,6,556,39786.6,218.0,92.66666666666669,5,576,49997.25,304.0,115.2
16424767.0,6,26,9161,14,2127,1263443.6153846155,408.0,151.92857142857142,12,7034,1118095.3636363635,1514.0,586.1666666666666
103435.0,17,2,286,2,286,0.0,143.0,143.0,0,0,0.0,0.0,0.0
1094511.0,6,13,1386,7,789,182418.5,253.0,112.71428571428572,6,597,218035.2,259.0,99.5
2180.0,17,4,344,2,150,0.0,75.0,75.0,2,194,0.0,103.0,97.0
108107129.0,17,5,1005,5,1005,27026782.25,201.0,201.0,0,0,0.0,0.0,0.0
27224128.0,17,5,1710,5,1710,6806032.0,342.0,342.0,0,0,0.0,0.0,0.0
23371.0,6,10,2032,5,524,5027.75,252.0,104.8,5,1508,5587.0,1236.0,301.6
1300117.0,6,4,264,2,132,0.0,66.0,66.0,2,132,0.0,66.0,66.0
108102136.0,17,5,955,5,955,27025534.0,191.0,191.0,0,0,0.0,0.0,0.0
247403.0,6,3,337,2,214,0.0,160.0,107.0,1,123,0.0,123.0,123.0
104629.0,17,2,286,2,286,0.0,143.0,143.0,0,0,0.0,0.0,0.0
10833.0,6,10,2032,5,524,2483.75,252.0,104.8,5,1508,2334.0,1236.0,301.6
207261.0,6,3,426,2,280,0.0,214.0,140.0,1,146,0.0,146.0,146.0
45179.0,6,14,4740,7,653,7364.833333333333,249.0,93.28571428571428,7,4087,6165.666666666667,1514.0,583.8571428571429
120130400.0,6,13,2020,9,1204,15016300.0,188.0,133.77777777777777,4,816,30032911.666666668,204.0,204.0
3479.0,17,2,414,1,88,0.0,88.0,88.0,1,326,0.0,326.0,326.0
135122999.0,17,6,1146,6,1146,27024599.8,191.0,191.0,0,0,0.0,0.0,0.0
204632.0,17,2,762,2,762,0.0,381.0,381.0,0,0,0.0,0.0,0.0
206936.0,6,3,426,2,280,0.0,214.0,140.0,1,146,0.0,146.0,146.0
120070207.0,17,28,13364,28,13364,4447044.703703703,501.0,477.2857142857143,0,0,0.0,0.0,0.0
2044.0,17,4,344,2,150,0.0,75.0,75.0,2,194,0.0,103.0,97.0
103283.0,17,2,286,2,286,0.0,143.0,143.0,0,0,0.0,0.0,0.0
837438.0,6,9,1118,6,586,167487.6,248.0,97.66666666666669,3,532,282388.0,392.0,177.33333333333334
3171850.0,6,18,1495,9,921,358790.75,315.0,102.33333333333331,9,574,358761.625,78.0,63.77777777777778
133950.0,6,2,132,1,66,0.0,66.0,66.0,1,66,0.0,66.0,66.0
2293.0,17,4,344,2,150,0.0,75.0,75.0,2,194,0.0,103.0,97.0
198148.0,17,4,6056,4,6056,66049.33333333333,1514.0,1514.0,0,0,0.0,0.0,0.0
996514.0,17,6,1230,3,234,498071.5,78.0,78.0,3,996,498051.5,332.0,332.0
509553.00000000006,6,5,336,2,134,0.0,68.0,67.0,3,202,193369.0,70.0,67.33333333333333
0.0,17,1,350,1,350,0.0,350.0,350.0,0,0,0.0,0.0,0.0
209489.0,17,2,180,1,90,0.0,90.0,90.0,1,90,0.0,90.0,90.0
299006.0,6,6,412,4,272,99668.66666666669,74.0,68.0,2,140,0.0,74.0,70.0
1796596.0,17,6,1230,3,234,898115.0,78.0,78.0,3,996,898092.0,332.0,332.0
1449.0,17,2,762,2,762,0.0,381.0,381.0,0,0,0.0,0.0,0.0
90737744.0,6,17,1287,9,691,11336135.25,95.0,76.77777777777777,8,596,12962054.57142857,95.0,74.5
150076.0,17,2,180,1,90,0.0,90.0,90.0,1,90,0.0,90.0,90.0
90016889.0,17,28,13364,28,13364,3333958.851851852,501.0,477.2857142857143,0,0,0.0,0.0,0.0
304761.0,17,4,704,2,148,0.0,74.0,74.0,2,556,0.0,280.0,278.0
318.0,17,2,174,1,79,0.0,79.0,79.0,1,95,0.0,95.0,95.0
90277237.0,6,16,1192,8,596,12890717.142857144,95.0,74.5,8,596,12895936.142857144,95.0,74.5
22797.0,6,14,4740,7,653,3675.8333333333335,249.0,93.28571428571428,7,4087,3662.8333333333335,1514.0,583.8571428571429
7745.0,6,10,2032,5,524,1718.25,252.0,104.8,5,1508,1679.0,1236.0,301.6
51774.0,6,11,2098,6,590,9511.2,252.0,98.33333333333331,5,1508,10635.0,1236.0,301.6
2114119.0,6,18,6803,10,1501,234902.11111111112,408.0,150.1,8,5302,238865.8571428572,1514.0,662.75
317591.0,17,4,1400,4,1400,105863.66666666669,350.0,350.0,0,0,0.0,0.0,0.0
296.0,17,2,156,1,78,0.0,78.0,78.0,1,78,0.0,78.0,78.0
5618055.0,6,4,270,2,134,0.0,68.0,67.0,2,136,0.0,70.0,68.0
94009507.0,6,39,2574,20,1320,4931332.578947368,66.0,66.0,19,1254,5155446.777777778,66.0,66.0
90094864.0,6,10,1440,7,828,15015810.666666666,188.0,118.28571428571428,3,612,30032396.5,204.0,204.0
30696.0,6,10,1066,5,490,5494.25,218.0,98.0,5,576,7465.5,304.0,115.2
121001079.0,17,15,907,8,475,17285868.42857143,174.0,59.375,7,432,16835014.5,174.0,61.71428571428572
2470.0,17,4,344,2,150,0.0,75.0,75.0,2,194,0.0,103.0,97.0
116021135.0,6,29,1914,15,948,8287223.928571428,123.0,63.2,14,966,8139890.461538462,123.0,69.0
1398046.0,17,16,1120,16,1120,93203.06666666668,70.0,70.0,0,0,0.0,0.0,0.0
3009496.0,6,11,2106,6,598,601654.8,252.0,99.66666666666669,5,1508,2263.25,1236.0,301.6
0.0,6,1,66,1,66,0.0,66.0,66.0,0,0,0.0,0.0,0.0
120124093.0,6,13,2020,9,1204,15015511.625,188.0,133.77777777777777,4,816,30030536.666666668,204.0,204.0
890526.0,6,9,1269,6,798,178105.2,460.0,133.0,3,471,307406.0,331.0,157.0
297965.0,6,6,412,4,272,99321.66666666669,74.0,68.0,2,140,0.0,74.0,70.0
232814.0,6,3,337,2,214,0.0,160.0,107.0,1,123,0.0,123.0,123.0
232918.0,6,3,337,2,214,0.0,160.0,107.0,1,123,0.0,123.0,123.0
27747135.0,17,5,1710,5,1710,6936783.75,342.0,342.0,0,0,0.0,0.0,0.0
114993199.0,17,13,952,7,563,19165533.166666668,174.0,80.42857142857143,6,389,18820006.0,174.0,64.83333333333333
29716.0,6,14,4740,7,653,4830.333333333333,249.0,93.28571428571428,7,4087,4294.333333333333,1514.0,583.8571428571429
324512.0,17,4,1400,4,1400,108170.66666666669,350.0,350.0,0,0,0.0,0.0,0.0
96984926.0,6,40,2640,20,1320,5104469.7894736845,66.0,66.0,20,1320,5090124.157894737,66.0,66.0
24479.0,6,10,2032,5,524,5904.5,252.0,104.8,5,1508,4194.0,1236.0,301.6
299987.0,6,6,412,4,272,99995.66666666669,74.0,68.0,2,140,0.0,74.0,70.0
237889.0,6,3,373,2,238,0.0,172.0,119.0,1,135,0.0,135.0,135.0
233066.0,6,3,337,2,214,0.0,160.0,107.0,1,123,0.0,123.0,123.0
1225654.0,6,11,1134,6,558,245130.8,220.0,93.0,5,576,305321.5,304.0,115.2
326.0,17,2,174,1,79,0.0,79.0,79.0,1,95,0.0,95.0,95.0
254740.00000000003,6,12,1373,7,714,42456.66666666666,298.0,102.0,5,659,59616.5,379.0,131.8
2798774.0,6,2,132,1,66,0.0,66.0,66.0,1,66,0.0,66.0,66.0
123839379.0,6,49,3234,25,1650,5159974.125,66.0,66.0,24,1584,5089498.260869565,66.0,66.0
141406.0,17,4,704,2,148,0.0,74.0,74.0,2,556,0.0,280.0,278.0
17315.0,6,10,2032,5,524,4049.75,252.0,104.8,5,1508,4023.0,1236.0,301.6
100598338.0,6,31,2176,16,1071,6706555.866666666,123.0,66.9375,15,1105,6456853.285714285,139.0,73.66666666666667
90040814.0,17,28,13364,28,13364,3334844.962962963,501.0,477.2857142857143,0,0,0.0,0.0,0.0
312.0,17,2,156,1,78,0.0,78.0,78.0,1,78,0.0,78.0,78.0
125001110.0,17,15,907,8,475,17857301.42857143,174.0,59.375,7,432,17501000.833333332,174.0,61.71428571428572
334.0,17,2,166,1,75,0.0,75.0,75.0,1,91,0.0,91.0,91.0
41915.0,6,10,2032,5,524,8700.5,252.0,104.8,5,1508,8825.75,1236.0,301.6
146899.0,6,2,132,1,66,0.0,66.0,66.0,1,66,0.0,66.0,66.0
17019.0,17,2,180,1,90,0.0,90.0,90.0,1,90,0.0,90.0,90.0
304357.0,6,6,412,4,272,101452.33333333331,74.0,68.0,2,140,0.0,74.0,70.0
50285.0,6,13,1479,7,882,8380.833333333334,291.0,126.0,6,597,7701.8,259.0,99.5
206992.0,6,3,426,2,280,0.0,214.0,140.0,1,146,0.0,146.0,146.0
405.0,17,2,762,2,762,0.0,381.0,381.0,0,0,0.0,0.0,0.0
10468093.0,6,7,478,4,272,3444087.333333333,74.0,68.0,3,206,5166047.0,74.0,68.66666666666667
148495.0,6,3,337,2,214,0.0,160.0,107.0,1,123,0.0,123.0,123.0
33408.0,6,14,4740,7,653,5451.666666666667,249.0,93.28571428571428,7,4087,5228.166666666667,1514.0,583.8571428571429
1747830.0,6,23,6509,12,1529,158893.63636363635,357.0,127.41666666666669,11,4980,143373.8,1510.0,452.7272727272728
100261570.0,17,12,778,6,389,19993006.8,174.0,64.83333333333333,6,389,20020526.0,174.0,64.83333333333333
10469456.0,6,7,478,4,272,3444370.333333333,74.0,68.0,3,206,5166479.0,74.0,68.66666666666667
108104816.0,17,5,955,5,955,27026204.0,191.0,191.0,0,0,0.0,0.0,0.0
10792.0,6,10,1065,5,534,2208.75,262.0,106.8,5,531,2352.0,259.0,106.2
153440.0,17,2,180,1,90,0.0,90.0,90.0,1,90,0.0,90.0,90.0
26783.0,6,10,2032,5,524,6069.75,252.0,104.8,5,1508,3259.75,1236.0,301.6
112535472.0,6,46,3036,23,1518,5105435.863636363,66.0,66.0,23,1518,5105435.0,66.0,66.0
120108664.0,6,14,2240,6,1224,24021732.8,204.0,204.0,8,1016,17135143.57142857,188.0,127.0
1313614.0,6,4,264,2,132,0.0,66.0,66.0,2,132,0.0,66.0,66.0
45037762.0,6,6,1808,4,987,15012587.333333334,785.0,246.75,2,821,0.0,753.0,410.5
118901703.0,6,35,2542,18,1348,6994217.823529412,139.0,74.88888888888889,17,1194,7417843.125,123.0,70.23529411764706
37301.0,6,10,2032,5,524,9026.75,252.0,104.8,5,1508,8525.75,1236.0,301.6
44039.0,6,14,4740,7,653,7139.333333333333,249.0,93.28571428571428,7,4087,6545.5,1514.0,583.8571428571429
36246.0,6,14,4740,7,653,5787.5,249.0,93.28571428571428,7,4087,5486.0,1514.0,583.8571428571429
135132869.0,17,6,1206,6,1206,27026573.8,201.0,201.0,0,0,0.0,0.0,0.0
108104254.0,17,5,1005,5,1005,27026063.5,201.0,201.0,0,0,0.0,0.0,0.0
113168320.0,6,46,3036,23,1518,5144002.681818182,66.0,66.0,23,1518,5144002.363636363,66.0,66.0
33704.0,6,10,2032,5,524,8173.0,252.0,104.8,5,1508,7368.25,1236.0,301.6
90759094.0,6,27,2073,15,1138,6479676.642857143,95.0,75.86666666666666,12,935,8181945.545454546,95.0,77.91666666666667
48627199.0,6,8,1940,3,887,22935869.5,753.0,295.6666666666667,5,1053,11463505.5,785.0,210.6
75742.0,6,10,2032,5,524,17361.5,252.0,104.8,5,1508,17298.75,1236.0,301.6
9256.0,17,2,582,1,83,0.0,83.0,83.0,1,499,0.0,499.0,499.0
53786.0,6,14,4740,7,653,8439.833333333334,249.0,93.28571428571428,7,4087,8833.166666666666,1514.0,583.8571428571429
99691766.0,17,12,778,6,389,19601557.8,174.0,64.83333333333333,6,389,19600160.0,174.0,64.83333333333333
1182756.0,6,11,1134,6,558,236551.2,220.0,93.0,5,576,293675.25,304.0,115.2
102980838.0,6,42,2772,21,1386,5135437.9,66.0,66.0,21,1386,5135443.15,66.0,66.0
405003.0,6,4,508,2,238,0.0,172.0,119.0,2,270,0.0,135.0,135.0
259461.0,6,10,1221,6,636,51892.2,298.0,106.0,4,585,80729.33333333333,379.0,146.25
104355.0,17,4,1400,4,1400,34785.0,350.0,350.0,0,0,0.0,0.0,0.0
19673.0,6,14,4740,7,653,3012.833333333333,249.0,93.28571428571428,7,4087,3094.5,1514.0,583.8571428571429
2594753.0,6,2,132,1,66,0.0,66.0,66.0,1,66,0.0,66.0,66.0
36688.0,6,14,4740,7,653,5989.0,249.0,93.28571428571428,7,4087,5022.833333333333,1514.0,583.8571428571429
90034517.0,17,28,13364,28,13364,3334611.7407407407,501.0,477.2857142857143,0,0,0.0,0.0,0.0
108104020.0,17,5,955,5,955,27026005.0,191.0,191.0,0,0,0.0,0.0,0.0
100788842.0,6,30,2122,15,1105,7183786.785714285,139.0,73.66666666666667,15,1017,7183782.571428572,123.0,67.8
248239.0,17,4,6056,4,6056,82746.33333333333,1514.0,1514.0,0,0,0.0,0.0,0.0
0.0,17,1,43,1,43,0.0,43.0,43.0,0,0,0.0,0.0,0.0
108119534.0,17,5,1005,5,1005,27029883.5,201.0,201.0,0,0,0.0,0.0,0.0
32842.0,6,14,4740,7,653,5364.0,249.0,93.28571428571428,7,4087,4688.0,1514.0,583.8571428571429
90052154.0,17,28,13364,28,13364,3335264.962962963,501.0,477.2857142857143,0,0,0.0,0.0,0.0
2028610.0,6,23,6933,11,1915,202861.0,575.0,174.0909090909091,12,5018,155112.0909090909,1510.0,418.1666666666667
6742.0,17,2,582,1,83,0.0,83.0,83.0,1,499,0.0,499.0,499.0
2358.0,17,4,344,2,150,0.0,75.0,75.0,2,194,0.0,103.0,97.0
2364.0,17,4,344,2,150,0.0,75.0,75.0,2,194,0.0,103.0,97.0
111333764.0,6,32,2236,16,1165,7407850.266666667,139.0,72.8125,16,1071,7407847.733333333,123.0,66.9375
73515.0,6,14,4740,7,653,8751.833333333334,249.0,93.28571428571428,7,4087,11784.666666666666,1514.0,583.8571428571429
27084.0,6,14,4740,7,653,4076.5,249.0,93.28571428571428,7,4087,3370.0,1514.0,583.8571428571429
209509.0,17,2,180,1,90,0.0,90.0,90.0,1,90,0.0,90.0,90.0
3064263.0,6,12,2172,7,664,509757.1666666667,252.0,94.85714285714286,5,1508,27432.25,1236.0,301.6
190826.0,17,2,180,1,90,0.0,90.0,90.0,1,90,0.0,90.0,90.0
511020.00000000006,6,5,336,2,134,0.0,68.0,67.0,3,202,181182.5,70.0,67.33333333333333
31391.000000000004,6,14,4740,7,653,5032.0,249.0,93.28571428571428,7,4087,5042.666666666667,1514.0,583.8571428571429
3806.0,17,2,762,2,762,0.0,381.0,381.0,0,0,0.0,0.0,0.0
332839.0,6,6,412,4,272,110946.33333333331,74.0,68.0,2,140,0.0,74.0,70.0
15002.0,6,11,2098,6,590,2731.2,252.0,98.33333333333331,5,1508,3232.5,1236.0,301.6
4062.0,17,2,762,2,762,0.0,381.0,381.0,0,0,0.0,0.0,0.0
108102911.0,17,5,955,5,955,27025727.75,191.0,191.0,0,0,0.0,0.0,0.0
2045308.0,17,6,1230,3,234,1022460.0,78.0,78.0,3,996,1022452.0,332.0,332.0
184836.0,17,2,180,1,90,0.0,90.0,90.0,1,90,0.0,90.0,90.0
2462.0,17,4,344,2,150,0.0,75.0,75.0,2,194,0.0,103.0,97.0
46842934.0,6,14,982,6,437,9367338.8,95.0,72.83333333333333,8,545,6691450.285714285,95.0,68.125
208581.0,6,3,426,2,280,0.0,214.0,140.0,1,146,0.0,146.0,146.0
102792.0,17,2,286,2,286,0.0,143.0,143.0,0,0,0.0,0.0,0.0
206183.0,6,3,426,2,280,0.0,214.0,140.0,1,146,0.0,146.0,146.0
120000146.0,6,17,1287,9,691,15000018.25,95.0,76.77777777777777,8,596,12898960.42857143,95.0,74.5
90048962.0,17,28,13364,28,13364,3335146.7407407407,501.0,477.2857142857143,0,0,0.0,0.0,0.0
2177.0,17,4,344,2,150,0.0,75.0,75.0,2,194,0.0,103.0,97.0
107494.0,17,2,604,1,75,0.0,75.0,75.0,1,529,0.0,529.0,529.0
199258.0,17,2,180,1,90,0.0,90.0,90.0,1,90,0.0,90.0,90.0
44346.0,6,14,4740,7,653,6795.833333333333,249.0,93.28571428571428,7,4087,6617.333333333333,1514.0,583.8571428571429
39503.0,6,12,1413,7,882,6583.833333333333,291.0,126.0,5,531,9024.75,259.0,106.2
216456.0,17,2,180,1,90,0.0,90.0,90.0,1,90,0.0,90.0,90.0
108099843.0,17,5,1005,5,1005,27024960.75,201.0,201.0,0,0,0.0,0.0,0.0
32591.000000000004,6,10,2032,5,524,7925.5,252.0,104.8,5,1508,7702.75,1236.0,301.6
143964.0,17,2,180,1,90,0.0,90.0,90.0,1,90,0.0,90.0,90.0
109275.0,17,2,762,2,762,0.0,381.0,381.0,0,0,0.0,0.0,0.0
135128488.0,17,6,1146,6,1146,27025697.6,191.0,191.0,0,0,0.0,0.0,0.0
102324721.0,6,42,2772,21,1386,5105444.65,66.0,66.0,21,1386,5105438.9,66.0,66.0
42597.0,6,14,4740,7,653,6968.166666666667,249.0,93.28571428571428,7,4087,6932.166666666667,1514.0,583.8571428571429
131849.0,6,11,1131,6,600,24753.0,262.0,100.0,5,531,25618.5,259.0,106.2
3018649.0,6,139,98130,71,89341,43123.55714285714,1510.0,1258.3239436619715,68,8789,40519.07462686567,1510.0,129.25
50946.0,17,2,180,1,90,0.0,90.0,90.0,1,90,0.0,90.0,90.0
2332.0,17,4,344,2,150,0.0,75.0,75.0,2,194,0.0,103.0,97.0
90039342.0,17,28,13364,28,13364,3334790.4444444445,501.0,477.2857142857143,0,0,0.0,0.0,0.0
216351.0,17,2,180,1,90,0.0,90.0,90.0,1,90,0.0,90.0,90.0
2438.0,17,4,344,2,150,0.0,75.0,75.0,2,194,0.0,103.0,97.0
108107714.0,17,5,1005,5,1005,27026928.5,201.0,201.0,0,0,0.0,0.0,0.0
51730705.0,6,8,2113,3,960,24542669.5,826.0,320.0,5,1153,12288875.0,885.0,230.6
108102631.0,17,5,1005,5,1005,27025657.75,201.0,201.0,0,0,0.0,0.0,0.0
27608800.0,17,5,1710,5,1710,6902200.0,342.0,342.0,0,0,0.0,0.0,0.0
333464.0,17,4,622,4,622,111154.66666666669,163.0,155.5,0,0,0.0,0.0,0.0
20474.0,6,14,4740,7,653,3231.333333333333,249.0,93.28571428571428,7,4087,3000.333333333333,1514.0,583.8571428571429
861338.0,6,9,1267,6,796,172267.6,458.0,132.66666666666666,3,471,294397.5,331.0,157.0
16706.0,6,14,4740,7,653,2675.833333333333,249.0,93.28571428571428,7,4087,2651.5,1514.0,583.8571428571429
200125.0,17,4,6056,4,6056,66708.33333333333,1514.0,1514.0,0,0,0.0,0.0,0.0
142987.0,6,2,132,1,66,0.0,66.0,66.0,1,66,0.0,66.0,66.0
38411.0,6,14,4740,7,653,6196.0,249.0,93.28571428571428,7,4087,5220.0,1514.0,583.8571428571429
128001484.0,17,15,907,8,475,18285926.285714287,174.0,59.375,7,432,18001158.0,174.0,61.71428571428572
108109637.0,17,5,1005,5,1005,27027409.25,201.0,201.0,0,0,0.0,0.0,0.0
365727.0,17,2,363,1,75,0.0,75.0,75.0,1,288,0.0,288.0,288.0
320962.0,17,4,1400,4,1400,106987.33333333331,350.0,350.0,0,0,0.0,0.0,0.0
239526.0,6,3,337,2,214,0.0,160.0,107.0,1,123,0.0,123.0,123.0
103008726.0,17,13,1083,7,563,17168121.0,174.0,80.42857142857143,6,520,16600160.6,174.0,86.66666666666667
90296091.0,6,16,1192,8,596,12892638.857142856,95.0,74.5,8,596,12897351.857142856,95.0,74.5
73649.0,6,14,4740,7,653,11836.5,249.0,93.28571428571428,7,4087,10698.166666666666,1514.0,583.8571428571429
127397.0,6,15,4806,8,719,16844.285714285714,249.0,89.875,7,4087,21094.166666666668,1514.0,583.8571428571429
1998.0,17,4,344,2,150,0.0,75.0,75.0,2,194,0.0,103.0,97.0
120003734.0,6,16,1192,8,596,17143390.57142857,95.0,74.5,8,596,17107231.714285713,95.0,74.5
2077.0,17,2,684,1,342,0.0,342.0,342.0,1,342,0.0,342.0,342.0
363847.0,6,12,1373,7,714,60641.16666666666,298.0,102.0,5,659,90285.5,379.0,131.8
31490.0,6,14,4740,7,653,4892.666666666667,249.0,93.28571428571428,7,4087,4482.0,1514.0,583.8571428571429
494097.0,6,5,336,2,134,0.0,68.0,67.0,3,202,191260.5,70.0,67.33333333333333
363.0,17,2,267,1,83,0.0,83.0,83.0,1,184,0.0,184.0,184.0
209475.0,17,2,180,1,90,0.0,90.0,90.0,1,90,0.0,90.0,90.0
57611.0,6,14,4740,7,653,9210.0,249.0,93.28571428571428,7,4087,8021.0,1514.0,583.8571428571429
122314642.0,6,48,3168,24,1584,5140879.652173913,66.0,66.0,24,1584,5066873.565217392,66.0,66.0
1775294.0,6,2,132,1,66,0.0,66.0,66.0,1,66,0.0,66.0,66.0
40506.0,6,14,4740,7,653,6296.833333333333,249.0,93.28571428571428,7,4087,6283.0,1514.0,583.8571428571429
5826127.0,6,4,270,2,134,0.0,68.0,67.0,2,136,0.0,70.0,68.0
214181.0,6,3,426,2,280,0.0,214.0,140.0,1,146,0.0,146.0,146.0
1591.0,17,2,192,1,88,0.0,88.0,88.0,1,104,0.0,104.0,104.0
1021.0,17,5,550,5,550,255.25,110.0,110.0,0,0,0.0,0.0,0.0
2411.0,17,4,344,2,150,0.0,75.0,75.0,2,194,0.0,103.0,97.0
232958.0,6,3,337,2,214,0.0,160.0,107.0,1,123,0.0,123.0,123.0
113510010.0,6,216,24452,108,17090,1058830.0280373832,284.0,158.24074074074073,108,7362,1058830.1775700934,140.0,68.16666666666667
120018136.0,17,28,13364,28,13364,4445116.148148148,501.0,477.2857142857143,0,0,0.0,0.0,0.0
98428.0,17,2,762,2,762,0.0,381.0,381.0,0,0,0.0,0.0,0.0
1479904.0,17,16,1120,16,1120,98660.26666666666,70.0,70.0,0,0,0.0,0.0,0.0
90050230.0,17,27,12943,27,12943,3463470.3846153845,501.0,479.3703703703704,0,0,0.0,0.0,0.0
90988552.0,6,20,1531,10,786,10104148.444444444,95.0,78.6,10,745,10109068.222222222,95.0,74.5
0.0,6,1,54,0,0,0.0,0.0,0.0,1,54,0.0,54.0,54.0
40160.0,6,2,132,1,66,0.0,66.0,66.0,1,66,0.0,66.0,66.0
90299553.0,6,16,1192,8,596,12893020.714285716,95.0,74.5,8,596,12899421.0,95.0,74.5
197806.0,17,2,180,1,90,0.0,90.0,90.0,1,90,0.0,90.0,90.0
305264.0,6,3,202,2,128,0.0,74.0,64.0,1,74,0.0,74.0,74.0
210925.0,17,2,180,1,90,0.0,90.0,90.0,1,90,0.0,90.0,90.0
108107100.0,17,5,955,5,955,27026775.0,191.0,191.0,0,0,0.0,0.0,0.0
119986.0,17,2,180,1,70,0.0,70.0,70.0,1,110,0.0,110.0,110.0
33362.0,6,10,2032,5,524,8107.75,252.0,104.8,5,1508,8079.75,1236.0,301.6
104945982.0,17,15,5130,15,5130,7496141.571428572,342.0,342.0,0,0,0.0,0.0,0.0
10501645.0,6,7,478,4,272,3453619.6666666665,74.0,68.0,3,206,5180300.5,74.0,68.66666666666667
185646.0,17,2,180,1,90,0.0,90.0,90.0,1,90,0.0,90.0,90.0
105219.0,17,2,286,2,286,0.0,143.0,143.0,0,0,0.0,0.0,0.0
52176.0,6,14,4740,7,653,7790.333333333333,249.0,93.28571428571428,7,4087,8504.0,1514.0,583.8571428571429
297809.0,6,6,412,4,272,99269.66666666669,74.0,68.0,2,140,0.0,74.0,70.0
258988.0,6,3,337,2,214,0.0,160.0,107.0,1,123,0.0,123.0,123.0
120010990.0,6,18,1341,9,691,14999988.75,95.0,76.77777777777777,9,650,15000952.125,95.0,72.22222222222223
17927.0,6,12,1393,6,796,3351.2,271.0,132.66666666666666,6,597,3404.6,259.0,99.5
17190.0,6,11,2098,6,590,2912.4,252.0,98.33333333333331,5,1508,3669.5,1236.0,301.6
221474.0,6,3,426,2,280,0.0,214.0,140.0,1,146,0.0,146.0,146.0
26672.0,6,14,4740,7,653,4339.666666666667,249.0,93.28571428571428,7,4087,3547.5,1514.0,583.8571428571429
2047073.0,17,6,1039,4,312,682233.0,78.0,78.0,2,727,0.0,395.0,363.5
351608.0,17,2,180,1,90,0.0,90.0,90.0,1,90,0.0,90.0,90.0
99881.0,17,2,286,2,286,0.0,143.0,143.0,0,0,0.0,0.0,0.0
317658.0,17,4,1400,4,1400,105886.0,350.0,350.0,0,0,0.0,0.0,0.0
2430.0,17,4,344,2,150,0.0,75.0,75.0,2,194,0.0,103.0,97.0
949969.0,6,12,1447,6,816,188578.4,291.0,136.0,6,631,187930.2,293.0,105.16666666666669
181303.0,17,2,180,1,90,0.0,90.0,90.0,1,90,0.0,90.0,90.0
90052316.0,17,27,12943,27,12943,3463550.6153846155,501.0,479.3703703703704,0,0,0.0,0.0,0.0
108526.0,17,2,286,2,286,0.0,143.0,143.0,0,0,0.0,0.0,0.0
42406.0,6,14,4740,7,653,6950.0,249.0,93.28571428571428,7,4087,6144.5,1514.0,583.8571428571429
90086481.0,6,11,1644,4,816,30028288.33333333,204.0,204.0,7,828,15014221.5,188.0,118.28571428571428
110065455.0,6,32,2236,16,1165,7323297.333333333,139.0,72.8125,16,1071,7323282.4,123.0,66.9375
367371.0,17,2,363,1,75,0.0,75.0,75.0,1,288,0.0,288.0,288.0
53232.0,6,14,4740,7,653,7943.666666666667,249.0,93.28571428571428,7,4087,7055.666666666667,1514.0,583.8571428571429
2594310.0,6,2,132,1,66,0.0,66.0,66.0,1,66,0.0,66.0,66.0
281747.0,17,2,582,1,83,0.0,83.0,83.0,1,499,0.0,499.0,499.0
97730938.0,6,26,1746,13,906,8126246.916666667,123.0,69.6923076923077,13,840,8126262.083333333,123.0,64.61538461538461
123839709.0,6,48,3168,24,1584,5041993.652173913,66.0,66.0,24,1584,5255397.956521739,66.0,66.0
108107091.0,17,5,955,5,955,27026772.75,191.0,191.0,0,0,0.0,0.0,0.0
90017636.0,17,28,13364,28,13364,3333986.5185185187,501.0,477.2857142857143,0,0,0.0,0.0,0.0
135133819.0,17,6,1206,6,1206,27026763.8,201.0,201.0,0,0,0.0,0.0,0.0
42555.0,6,14,4740,7,653,6866.833333333333,249.0,93.28571428571428,7,4087,5332.5,1514.0,583.8571428571429
1017025.0,6,11,1134,6,558,203405.0,220.0,93.0,5,576,253830.75,304.0,115.2
326913.0,6,6,412,4,272,108971.0,74.0,68.0,2,140,0.0,74.0,70.0
119989988.0,6,29,1930,15,948,8570713.42857143,123.0,63.2,14,982,8445335.0,139.0,70.14285714285714
120157476.0,6,224,25508,112,7688,1076011.3063063065,140.0,68.64285714285714,112,17820,1074913.6756756755,374.0,159.10714285714286
3172718.0,6,3,204,2,136,0.0,70.0,68.0,1,68,0.0,68.0,68.0
113503826.0,6,48,3168,24,1584,4934948.956521739,66.0,66.0,24,1584,4925548.304347826,66.0,66.0
33694.0,6,12,1320,7,789,5615.666666666667,253.0,112.71428571428572,5,531,6648.5,259.0,106.2
31772.0,6,14,4740,7,653,5051.666666666667,249.0,93.28571428571428,7,4087,4846.166666666667,1514.0,583.8571428571429
233066.0,6,3,337,2,214,0.0,160.0,107.0,1,123,0.0,123.0,123.0
90037974.0,17,28,13364,28,13364,3334739.777777778,501.0,477.2857142857143,0,0,0.0,0.0,0.0
26537562.0,6,5,1736,2,819,0.0,753.0,409.5,3,917,13198007.5,785.0,305.6666666666667
297422.0,6,6,412,4,272,99140.66666666669,74.0,68.0,2,140,0.0,74.0,70.0
90034995.0,17,28,13364,28,13364,3334629.4444444445,501.0,477.2857142857143,0,0,0.0,0.0,0.0
731.0,17,2,684,2,684,0.0,342.0,342.0,0,0,0.0,0.0,0.0
5824904.0,6,5,336,2,134,0.0,68.0,67.0,3,202,1473368.0,70.0,67.33333333333333
39088.0,6,10,2032,5,524,9544.75,252.0,104.8,5,1508,9264.0,1236.0,301.6
310861.0,17,4,1400,4,1400,103620.33333333331,350.0,350.0,0,0,0.0,0.0,0.0
162293.0,17,2,180,1,90,0.0,90.0,90.0,1,90,0.0,90.0,90.0
113668060.0,6,46,3036,23,1518,5166718.5,66.0,66.0,23,1518,5166713.909090909,66.0,66.0
140.0,17,2,700,2,700,0.0,350.0,350.0,0,0,0.0,0.0,0.0
108107445.0,17,5,1005,5,1005,27026861.25,201.0,201.0,0,0,0.0,0.0,0.0
47981.0,6,14,4740,7,653,7721.166666666667,249.0,93.28571428571428,7,4087,7501.666666666667,1514.0,583.8571428571429
9246.0,17,2,539,1,86,0.0,86.0,86.0,1,453,0.0,453.0,453.0
3170.0,17,4,344,2,150,0.0,75.0,75.0,2,194,0.0,103.0,97.0
105100229.0,6,583,109218,292,19642,361132.0378006873,214.0,67.26712328767124,291,89576,362350.5275862069,1514.0,307.8213058419244
28069.0,6,10,2032,5,524,6797.75,252.0,104.8,5,1508,6230.75,1236.0,301.6
111036455.0,6,31,2182,16,1165,7388029.133333334,139.0,72.8125,15,1017,7915743.571428572,123.0,67.8
207674.0,17,2,762,2,762,0.0,381.0,381.0,0,0,0.0,0.0,0.0
4513.0,17,2,614,1,72,0.0,72.0,72.0,1,542,0.0,542.0,542.0
120785980.0,6,34,2419,17,1194,6924998.4375,123.0,70.23529411764706,17,1225,7548980.5625,139.0,72.05882352941177
3169518.0,6,3,204,2,136,0.0,70.0,68.0,1,68,0.0,68.0,68.0
82925671.0,17,15,5138,14,4788,5902342.461538462,342.0,342.0,1,350,0.0,350.0,350.0
246993.0,6,3,373,2,238,0.0,172.0,119.0,1,135,0.0,135.0,135.0
219490.0,6,3,426,2,280,0.0,214.0,140.0,1,146,0.0,146.0,146.0
108112549.0,17,5,1005,5,1005,27028137.25,201.0,201.0,0,0,0.0,0.0,0.0
203620.0,17,2,762,2,762,0.0,381.0,381.0,0,0,0.0,0.0,0.0
10459792.0,6,7,478,4,272,3441396.0,74.0,68.0,3,206,5161946.5,74.0,68.66666666666667
1131312.0,6,20,6434,12,1921,102846.54545454546,620.0,160.08333333333334,8,4513,133839.14285714287,1514.0,564.125
109007721.0,17,14,864,7,432,18167953.5,174.0,61.71428571428572,7,432,18000161.833333332,174.0,61.71428571428572
90757951.0,17,27,12943,27,12943,3490690.423076923,501.0,479.3703703703704,0,0,0.0,0.0,0.0
135138810.0,17,6,1206,6,1206,27027762.0,201.0,201.0,0,0,0.0,0.0,0.0
1012066.0,6,6,482,2,144,0.0,78.0,72.0,4,338,336663.3333333333,103.0,84.5
2591784.0,6,2,132,1,66,0.0,66.0,66.0,1,66,0.0,66.0,66.0
317067.0,17,4,1400,4,1400,105689.0,350.0,350.0,0,0,0.0,0.0,0.0
140697.0,17,2,210,1,86,0.0,86.0,86.0,1,124,0.0,124.0,124.0
22979.0,6,14,4740,7,653,3711.3333333333335,249.0,93.28571428571428,7,4087,3547.833333333333,1514.0,583.8571428571429
3622008.0,6,153,118340,83,109418,44170.82926829269,1510.0,1318.289156626506,70,8922,48000.34782608696,1510.0,127.45714285714286
17259.0,6,14,4740,7,653,2441.5,249.0,93.28571428571428,7,4087,2738.833333333333,1514.0,583.8571428571429
135128185.0,17,6,1146,6,1146,27025637.0,191.0,191.0,0,0,0.0,0.0,0.0
38943.0,6,14,4740,7,653,6358.666666666667,249.0,93.28571428571428,7,4087,6315.833333333333,1514.0,583.8571428571429
2018.0,17,4,344,2,150,0.0,75.0,75.0,2,194,0.0,103.0,97.0
153435.0,17,2,180,1,90,0.0,90.0,90.0,1,90,0.0,90.0,90.0
314812.0,17,4,1400,4,1400,104937.33333333331,350.0,350.0,0,0,0.0,0.0,0.0
9733.0,17,2,539,1,86,0.0,86.0,86.0,1,453,0.0,453.0,453.0
1040178.0,6,13,1386,7,789,173363.0,253.0,112.71428571428572,6,597,205411.8,259.0,99.5
120183241.0,6,224,25312,112,7688,1074743.7657657657,140.0,68.64285714285714,112,17624,1076463.6846846847,284.0,157.35714285714286
90256663.0,6,13,2036,8,1016,12893809.0,188.0,127.0,5,1020,22522237.0,204.0,204.0
128963.0,6,2,132,1,66,0.0,66.0,66.0,1,66,0.0,66.0,66.0
206542.0,17,2,762,2,762,0.0,381.0,381.0,0,0,0.0,0.0,0.0
241888.0,6,3,337,2,214,0.0,160.0,107.0,1,123,0.0,123.0,123.0
250665.00000000003,6,3,337,2,214,0.0,160.0,107.0,1,123,0.0,123.0,123.0
503141.0,6,6,758,3,410,208340.0,172.0,136.66666666666666,3,348,179367.0,135.0,116.0
120124589.0,6,14,2224,9,1204,15015573.625,188.0,133.77777777777777,5,1020,22525189.5,204.0,204.0
792.0,17,4,438,2,148,0.0,74.0,74.0,2,290,0.0,147.0,145.0
209465.0,17,2,180,1,90,0.0,90.0,90.0,1,90,0.0,90.0,90.0
135136325.0,17,6,1206,6,1206,27027265.0,201.0,201.0,0,0,0.0,0.0,0.0
103437.0,17,2,286,2,286,0.0,143.0,143.0,0,0,0.0,0.0,0.0
320728.0,6,6,412,4,272,106909.33333333331,74.0,68.0,2,140,0.0,74.0,70.0
147300.0,6,3,373,2,238,0.0,172.0,119.0,1,135,0.0,135.0,135.0
10870702.0,6,8,544,4,272,3578231.6666666665,74.0,68.0,4,272,3578149.0,74.0,68.0
39124.0,6,10,2032,5,524,9472.0,252.0,104.8,5,1508,8911.75,1236.0,301.6
56946.0,6,14,4740,7,653,9158.833333333334,249.0,93.28571428571428,7,4087,9316.0,1514.0,583.8571428571429
33027.0,6,14,4740,7,653,5354.333333333333,249.0,93.28571428571428,7,4087,5137.5,1514.0,583.8571428571429
81.0,17,2,762,2,762,0.0,381.0,381.0,0,0,0.0,0.0,0.0
108110055.0,17,5,1005,5,1005,27027513.75,201.0,201.0,0,0,0.0,0.0,0.0
90053911.0,17,28,13364,28,13364,3335330.037037037,501.0,477.2857142857143,0,0,0.0,0.0,0.0
9263.0,17,2,507,1,86,0.0,86.0,86.0,1,421,0.0,421.0,421.0
318188.0,17,4,1400,4,1400,106062.66666666669,350.0,350.0,0,0,0.0,0.0,0.0
7675435.0,6,137,130208,43,2994,182748.4523809524,202.0,69.62790697674419,94,127214,82459.6129032258,1514.0,1353.340425531915
1780.0,17,2,176,1,80,0.0,80.0,80.0,1,96,0.0,96.0,96.0
149097.0,6,3,373,2,238,0.0,172.0,119.0,1,135,0.0,135.0,135.0
312976.0,17,4,1400,4,1400,104325.33333333331,350.0,350.0,0,0,0.0,0.0,0.0
135140925.0,17,6,1206,6,1206,27028185.0,201.0,201.0,0,0,0.0,0.0,0.0
123579.0,6,14,4740,7,653,20437.166666666668,249.0,93.28571428571428,7,4087,20193.166666666668,1514.0,583.8571428571429
90209506.0,6,16,1192,8,596,12852411.857142856,95.0,74.5,8,596,12857797.42857143,95.0,74.5
5720079.0,6,5,336,2,134,0.0,68.0,67.0,3,202,1572849.0,70.0,67.33333333333333
162395.0,17,2,180,1,90,0.0,90.0,90.0,1,90,0.0,90.0,90.0
35695.0,6,14,4740,7,653,5257.666666666667,249.0,93.28571428571428,7,4087,5638.5,1514.0,583.8571428571429
0.0,6,1,66,1,66,0.0,66.0,66.0,0,0,0.0,0.0,0.0
120378544.0,6,233,26356,117,18404,1037746.0689655172,284.0,157.2991452991453,116,7952,1037891.3565217392,140.0,68.55172413793103
18592.0,17,5,550,5,550,4648.0,110.0,110.0,0,0,0.0,0.0,0.0
100467.0,17,2,762,2,762,0.0,381.0,381.0,0,0,0.0,0.0,0.0
10494789.0,6,7,478,4,272,3452642.333333333,74.0,68.0,3,206,5178901.5,74.0,68.66666666666667
108100572.0,17,5,955,5,955,27025143.0,191.0,191.0,0,0,0.0,0.0,0.0
2300.0,17,4,344,2,150,0.0,75.0,75.0,2,194,0.0,103.0,97.0
107920.0,17,2,286,2,286,0.0,143.0,143.0,0,0,0.0,0.0,0.0
960163.0,6,12,1354,6,723,191230.6,253.0,120.5,6,631,191246.8,293.0,105.16666666666669
1990.0,17,4,344,2,150,0.0,75.0,75.0,2,194,0.0,103.0,97.0
116675181.0,6,32,2220,16,1149,7778345.4,123.0,71.8125,16,1071,7763926.066666666,123.0,66.9375
307798.0,6,6,412,4,272,102599.33333333331,74.0,68.0,2,140,0.0,74.0,70.0
26511946.0,17,8,1371,4,306,8837207.0,89.0,76.5,4,1065,8786491.0,443.0,266.25
21531.0,17,2,582,1,83,0.0,83.0,83.0,1,499,0.0,499.0,499.0
144006.0,6,2,132,1,66,0.0,66.0,66.0,1,66,0.0,66.0,66.0
99228.0,17,2,762,2,762,0.0,381.0,381.0,0,0,0.0,0.0,0.0
100887.0,17,2,762,2,762,0.0,381.0,381.0,0,0,0.0,0.0,0.0
827.0,17,5,550,5,550,206.75,110.0,110.0,0,0,0.0,0.0,0.0
103040325.0,6,42,2772,21,1386,5152003.65,66.0,66.0,21,1386,5152003.35,66.0,66.0
107368.0,17,2,286,2,286,0.0,143.0,143.0,0,0,0.0,0.0,0.0
90292877.0,6,36,2376,18,1188,5311345.705882353,66.0,66.0,18,1188,5293125.588235294,66.0,66.0
199683.0,17,4,6056,4,6056,66561.0,1514.0,1514.0,0,0,0.0,0.0,0.0
153351.0,17,2,180,1,90,0.0,90.0,90.0,1,90,0.0,90.0,90.0
5819631.0,6,5,336,2,134,0.0,68.0,67.0,3,202,1521044.0,70.0,67.33333333333333
90262057.0,6,12,1832,8,1016,12894579.57142857,188.0,127.0,4,816,30032350.33333333,204.0,204.0
5535.0,17,4,823,2,163,0.0,89.0,81.5,2,660,0.0,443.0,330.0
90044239.0,17,28,13364,28,13364,3334971.814814815,501.0,477.2857142857143,0,0,0.0,0.0,0.0
10480191.0,6,7,478,4,272,3448078.0,74.0,68.0,3,206,5172020.5,74.0,68.66666666666667
306068.0,6,6,412,4,272,102022.66666666669,74.0,68.0,2,140,0.0,74.0,70.0
197003.0,17,2,180,1,90,0.0,90.0,90.0,1,90,0.0,90.0,90.0
2303.0,17,4,344,2,150,0.0,75.0,75.0,2,194,0.0,103.0,97.0
27333.0,6,14,4740,7,653,4270.166666666667,249.0,93.28571428571428,7,4087,4417.333333333333,1514.0,583.8571428571429
304421.0,6,6,412,4,272,101473.66666666669,74.0,68.0,2,140,0.0,74.0,70.0
309457.0,17,4,1400,4,1400,103152.33333333331,350.0,350.0,0,0,0.0,0.0,0.0
347.0,17,2,216,1,84,0.0,84.0,84.0,1,132,0.0,132.0,132.0
102636608.0,17,14,864,7,432,16834069.333333332,174.0,61.71428571428572,7,432,16833499.5,174.0,61.71428571428572
113617979.0,6,46,3036,23,1518,5150437.454545454,66.0,66.0,23,1518,5150432.954545454,66.0,66.0
284192.0,17,2,363,1,79,0.0,79.0,79.0,1,284,0.0,284.0,284.0
13917226.0,17,6,2052,6,2052,2783445.2,342.0,342.0,0,0,0.0,0.0,0.0
108106643.0,17,5,1005,5,1005,27026660.75,201.0,201.0,0,0,0.0,0.0,0.0
3002800.0,6,11,2106,6,598,600364.6,252.0,99.66666666666669,5,1508,1764.5,1236.0,301.6
1306973.0,6,4,264,2,132,0.0,66.0,66.0,2,132,0.0,66.0,66.0
59289.0,6,14,4740,7,653,9271.166666666666,249.0,93.28571428571428,7,4087,6724.0,1514.0,583.8571428571429
239652.0,6,4,492,2,280,0.0,214.0,140.0,2,212,0.0,146.0,106.0
90025522.0,17,28,13364,28,13364,3334278.592592593,501.0,477.2857142857143,0,0,0.0,0.0,0.0
2288.0,17,4,344,2,150,0.0,75.0,75.0,2,194,0.0,103.0,97.0
118883175.0,6,39,2902,20,1531,6257009.210526316,139.0,76.55,19,1371,6588646.944444444,123.0,72.15789473684211
32961.0,6,14,4740,7,653,4393.5,249.0,93.28571428571428,7,4087,4995.833333333333,1514.0,583.8571428571429
116354424.0,6,48,3168,24,1584,5058888.0,66.0,66.0,24,1584,5045274.608695652,66.0,66.0
245463.0,6,3,337,2,214,0.0,160.0,107.0,1,123,0.0,123.0,123.0
120075782.0,6,227,25578,113,17758,1066261.8392857143,284.0,157.1504424778761,114,7820,1060713.1238938053,140.0,68.59649122807018
301462.0,6,6,412,4,272,100487.33333333331,74.0,68.0,2,140,0.0,74.0,70.0
113168006.0,6,46,3036,23,1518,5143989.318181818,66.0,66.0,23,1518,5143988.7727272725,66.0,66.0
90010444.0,17,28,13364,28,13364,3333720.1481481483,501.0,477.2857142857143,0,0,0.0,0.0,0.0
90035687.0,17,28,13364,28,13364,3334655.074074074,501.0,477.2857142857143,0,0,0.0,0.0,0.0
309924.0,6,6,412,4,272,103308.0,74.0,68.0,2,140,0.0,74.0,70.0
0.0,17,1,44,1,44,0.0,44.0,44.0,0,0,0.0,0.0,0.0
29233.0,6,10,2032,5,524,6558.75,252.0,104.8,5,1508,7028.25,1236.0,301.6
122912807.0,17,14,1126,7,563,17166815.833333332,174.0,80.42857142857143,7,563,17167874.333333332,174.0,80.42857142857143
10509133.0,6,7,478,4,272,3457858.333333333,74.0,68.0,3,206,5186662.0,74.0,68.66666666666667
146212.0,6,3,337,2,214,0.0,160.0,107.0,1,123,0.0,123.0,123.0
66085.0,17,2,180,1,90,0.0,90.0,90.0,1,90,0.0,90.0,90.0
3262702.0,6,3,1604,2,851,0.0,785.0,425.5,1,753,0.0,753.0,753.0
112779375.0,6,34,2482,17,1288,7035221.9375,139.0,75.76470588235294,17,1194,7035220.4375,123.0,70.23529411764706
153462.0,17,2,180,1,90,0.0,90.0,90.0,1,90,0.0,90.0,90.0
881542.0,6,12,2710,7,743,146923.66666666666,339.0,106.14285714285714,5,1967,151457.75,1514.0,393.4
829.0,17,4,438,2,148,0.0,74.0,74.0,2,290,0.0,147.0,145.0
36691.0,6,14,4740,7,653,5991.833333333333,249.0,93.28571428571428,7,4087,5723.666666666667,1514.0,583.8571428571429
33332.0,6,14,4740,7,653,4779.0,249.0,93.28571428571428,7,4087,5417.166666666667,1514.0,583.8571428571429
120056472.0,17,29,13785,29,13785,4287731.142857143,501.0,475.3448275862069,0,0,0.0,0.0,0.0
10857418.0,6,8,544,4,272,3573600.6666666665,74.0,68.0,4,272,3573546.6666666665,74.0,68.0
24576.0,6,14,4740,7,653,3674.8333333333335,249.0,93.28571428571428,7,4087,3779.6666666666665,1514.0,583.8571428571429
217753.0,6,3,426,2,280,0.0,214.0,140.0,1,146,0.0,146.0,146.0
49814.0,6,14,4740,7,653,7121.666666666667,249.0,93.28571428571428,7,4087,6367.666666666667,1514.0,583.8571428571429
39228.0,6,14,4740,7,653,6416.666666666667,249.0,93.28571428571428,7,4087,6348.0,1514.0,583.8571428571429
102748.0,17,2,286,2,286,0.0,143.0,143.0,0,0,0.0,0.0,0.0
2793672.0,6,2,132,1,66,0.0,66.0,66.0,1,66,0.0,66.0,66.0
135119968.0,17,6,1146,6,1146,27023993.6,191.0,191.0,0,0,0.0,0.0,0.0
90025531.0,17,27,12943,27,12943,3462520.423076923,501.0,479.3703703703704,0,0,0.0,0.0,0.0
10461501.0,6,7,478,4,272,3441986.0,74.0,68.0,3,206,5162897.0,74.0,68.66666666666667
244190.0,6,3,337,2,214,0.0,160.0,107.0,1,123,0.0,123.0,123.0
123730585.0,6,49,3234,25,1650,5155441.041666667,66.0,66.0,24,1584,5065821.173913044,66.0,66.0
105935.0,17,2,700,2,700,0.0,350.0,350.0,0,0,0.0,0.0,0.0
3087.0,17,2,224,1,76,0.0,76.0,76.0,1,148,0.0,148.0,148.0
2129.0,17,4,344,2,150,0.0,75.0,75.0,2,194,0.0,103.0,97.0
3598805.0,6,5,1909,2,892,0.0,826.0,446.0,3,1017,1453457.0,885.0,339.0
108112491.0,17,5,1005,5,1005,27028122.75,201.0,201.0,0,0,0.0,0.0,0.0
90272358.0,6,14,2240,8,1016,12896051.142857144,188.0,127.0,6,1224,18022065.8,204.0,204.0
5821665.0,6,5,336,2,134,0.0,68.0,67.0,3,202,1528282.5,70.0,67.33333333333333
135132482.0,17,6,1146,6,1146,27026496.4,191.0,191.0,0,0,0.0,0.0,0.0
120101756.0,6,14,2240,8,1016,17095440.14285714,188.0,127.0,6,1224,18072856.8,204.0,204.0
2149457.0,6,25,7610,13,2516,179121.41666666666,1034.0,193.53846153846155,12,5094,165688.72727272726,1510.0,424.5
2303.0,17,4,344,2,150,0.0,75.0,75.0,2,194,0.0,103.0,97.0
105445770.0,17,14,1126,7,563,17503472.166666668,174.0,80.42857142857143,7,563,17547805.5,174.0,80.42857142857143
108096674.0,17,5,955,5,955,27024168.5,191.0,191.0,0,0,0.0,0.0,0.0
28663.0,6,10,2032,5,524,5439.0,252.0,104.8,5,1508,6586.75,1236.0,301.6
408.0,17,2,410,1,78,0.0,78.0,78.0,1,332,0.0,332.0,332.0
90256378.0,6,13,2036,8,1016,12893768.285714284,188.0,127.0,5,1020,22522817.0,204.0,204.0
208852.0,6,3,426,2,280,0.0,214.0,140.0,1,146,0.0,146.0,146.0
220753.0,6,3,426,2,280,0.0,214.0,140.0,1,146,0.0,146.0,146.0
295775.0,17,4,6056,4,6056,98591.66666666669,1514.0,1514.0,0,0,0.0,0.0,0.0
6797.0,17,2,582,1,83,0.0,83.0,83.0,1,499,0.0,499.0,499.0
108105660.0,17,5,1005,5,1005,27026415.0,201.0,201.0,0,0,0.0,0.0,0.0
104172313.0,6,29,2052,15,1089,7425461.428571428,123.0,72.6,14,963,7996618.615384615,123.0,68.78571428571429
299216.0,6,6,412,4,272,99738.66666666669,74.0,68.0,2,140,0.0,74.0,70.0
25561.0,6,12,1320,6,723,4495.0,253.0,120.5,6,597,4134.2,259.0,99.5
108322181.0,6,32,2236,16,1165,7207032.666666667,139.0,72.8125,16,1071,7207081.466666667,123.0,66.9375
55423.0,6,14,4740,7,653,8623.0,249.0,93.28571428571428,7,4087,8936.666666666666,1514.0,583.8571428571429
205792.0,17,2,180,1,90,0.0,90.0,90.0,1,90,0.0,90.0,90.0
301.0,17,2,164,1,82,0.0,82.0,82.0,1,82,0.0,82.0,82.0
102820.0,17,2,286,2,286,0.0,143.0,143.0,0,0,0.0,0.0,0.0
45613.0,6,14,4740,7,653,6780.666666666667,249.0,93.28571428571428,7,4087,7409.833333333333,1514.0,583.8571428571429
90529655.0,6,13,2036,8,1016,12932807.857142856,188.0,127.0,5,1020,22591179.0,204.0,204.0
340.0,17,2,208,1,72,0.0,72.0,72.0,1,136,0.0,136.0,136.0
1733489.0,6,22,6443,12,1529,157589.9090909091,357.0,127.41666666666669,10,4914,158784.44444444444,1510.0,491.4
2033270.0,17,20,7472,20,7472,107014.2105263158,390.0,373.6,0,0,0.0,0.0,0.0
10518972.0,6,7,478,4,272,3460862.6666666665,74.0,68.0,3,206,5191217.0,74.0,68.66666666666667
107701724.0,6,43,2838,22,1452,5128641.095238095,66.0,66.0,21,1386,5159991.0,66.0,66.0
3325129.0,6,7,923,4,753,1036204.0,571.0,188.25,3,170,1554913.0,62.0,56.66666666666666
194041.0,17,4,1400,4,1400,64680.333333333336,350.0,350.0,0,0,0.0,0.0,0.0
116808208.0,6,48,3168,24,1584,5078617.739130435,66.0,66.0,24,1584,5064928.521739131,66.0,66.0
111203070.0,6,211,23728,106,7218,1059076.857142857,140.0,68.09433962264151,105,16510,1059330.5096153845,284.0,157.23809523809524
303611.0,6,2,132,1,66,0.0,66.0,66.0,1,66,0.0,66.0,66.0
21972.0,17,3,1026,3,1026,10986.0,342.0,342.0,0,0,0.0,0.0,0.0
153427.0,17,2,180,1,90,0.0,90.0,90.0,1,90,0.0,90.0,90.0
21442.0,6,14,4740,7,653,3464.1666666666665,249.0,93.28571428571428,7,4087,3144.1666666666665,1514.0,583.8571428571429
0.0,6,1,54,0,0,0.0,0.0,0.0,1,54,0.0,54.0,54.0
226005.0,6,10,1221,6,636,45201.0,298.0,106.0,4,585,73104.33333333333,379.0,146.25
26695.0,6,14,4740,7,653,4324.833333333333,249.0,93.28571428571428,7,4087,4200.5,1514.0,583.8571428571429
90018206.0,17,28,13364,28,13364,3334007.6296296297,501.0,477.2857142857143,0,0,0.0,0.0,0.0
235000.0,6,10,1221,6,636,47000.0,298.0,106.0,4,585,75410.0,379.0,146.25
105189557.0,17,15,1431,8,737,15004205.285714284,174.0,92.125,7,694,17504917.0,174.0,99.14285714285714
300891.0,6,6,412,4,272,100297.0,74.0,68.0,2,140,0.0,74.0,70.0
5622736.0,6,4,270,2,134,0.0,68.0,67.0,2,136,0.0,70.0,68.0
103206.0,17,2,286,2,286,0.0,143.0,143.0,0,0,0.0,0.0,0.0
315966.0,17,4,1400,4,1400,105322.0,350.0,350.0,0,0,0.0,0.0,0.0
308797.0,6,6,412,4,272,102932.33333333331,74.0,68.0,2,140,0.0,74.0,70.0
305573.0,6,6,412,4,272,101857.66666666669,74.0,68.0,2,140,0.0,74.0,70.0
541322.0,6,2,132,1,66,0.0,66.0,66.0,1,66,0.0,66.0,66.0
90098023.0,6,12,1848,7,828,15016337.166666666,188.0,118.28571428571428,5,1020,15016021.25,204.0,204.0
911640.0,6,10,1333,6,796,182328.0,458.0,132.66666666666666,4,537,211961.0,331.0,134.25
108103390.0,17,5,955,5,955,27025847.5,191.0,191.0,0,0,0.0,0.0,0.0
90257492.0,6,12,1832,8,1016,12893927.42857143,188.0,127.0,4,816,30031071.0,204.0,204.0
151908.0,17,2,414,1,88,0.0,88.0,88.0,1,326,0.0,326.0,326.0
49990.0,6,14,4740,7,653,8155.666666666667,249.0,93.28571428571428,7,4087,7755.5,1514.0,583.8571428571429
10138.0,17,4,820,2,156,0.0,78.0,78.0,2,664,0.0,332.0,332.0
103665.0,17,2,286,2,286,0.0,143.0,143.0,0,0,0.0,0.0,0.0
0.0,17,1,90,1,90,0.0,90.0,90.0,0,0,0.0,0.0,0.0
122977171.0,6,48,3168,24,1584,4951012.173913044,66.0,66.0,24,1584,5316156.260869565,66.0,66.0
24845.0,6,14,4740,7,653,4029.3333333333335,249.0,93.28571428571428,7,4087,4004.6666666666665,1514.0,583.8571428571429
11428623.0,6,7,499,4,301,3245280.6666666665,103.0,75.25,3,198,4107257.0,66.0,66.0
11923.0,17,2,582,1,83,0.0,83.0,83.0,1,499,0.0,499.0,499.0
44272.0,6,14,4740,7,653,6979.5,249.0,93.28571428571428,7,4087,7190.5,1514.0,583.8571428571429
104260660.0,6,256,29758,128,21088,819246.5433070866,390.0,164.75,128,8670,819246.7480314961,140.0,67.734375
303627.0,6,2,132,1,66,0.0,66.0,66.0,1,66,0.0,66.0,66.0
10444356.0,6,7,478,4,272,3434568.333333333,74.0,68.0,3,206,5151772.0,74.0,68.66666666666667
853885.0,6,9,1196,6,725,170777.0,387.0,120.83333333333331,3,471,289111.5,331.0,157.0
315887.0,6,6,412,4,272,105295.66666666669,74.0,68.0,2,140,0.0,74.0,70.0
46715.0,6,14,4740,7,653,7248.5,249.0,93.28571428571428,7,4087,6214.166666666667,1514.0,583.8571428571429
120185805.0,6,252,28886,126,8612,955914.472,140.0,68.34920634920636,126,20274,954959.232,284.0,160.9047619047619
2799841.0,6,2,132,1,66,0.0,66.0,66.0,1,66,0.0,66.0,66.0
228270.0,17,2,180,1,90,0.0,90.0,90.0,1,90,0.0,90.0,90.0
302420.0,6,2,132,1,66,0.0,66.0,66.0,1,66,0.0,66.0,66.0
99557.0,17,2,762,2,762,0.0,381.0,381.0,0,0,0.0,0.0,0.0
3013948.0,6,12,2172,7,664,502168.8333333333,252.0,94.85714285714286,5,1508,3914.0,1236.0,301.6
93772919.0,6,23,2657,11,1261,6395293.9,425.0,114.63636363636364,12,1396,8524286.0,333.0,116.33333333333331
99026398.0,17,12,778,6,389,19801296.8,174.0,64.83333333333333,6,389,19800154.6,174.0,64.83333333333333
2789469.0,6,2,132,1,66,0.0,66.0,66.0,1,66,0.0,66.0,66.0
144662.0,17,2,180,1,90,0.0,90.0,90.0,1,90,0.0,90.0,90.0
90039933.0,17,28,13364,28,13364,3334812.333333333,501.0,477.2857142857143,0,0,0.0,0.0,0.0
33379.0,6,14,4740,7,653,5432.0,249.0,93.28571428571428,7,4087,5425.0,1514.0,583.8571428571429
1597267.0,6,47,31301,24,1761,69446.39130434782,223.0,73.375,23,29540,72501.59090909091,1514.0,1284.3478260869565
321.0,17,2,208,1,72,0.0,72.0,72.0,1,136,0.0,136.0,136.0
52009.0,6,14,4740,7,653,8533.5,249.0,93.28571428571428,7,4087,8360.333333333334,1514.0,583.8571428571429
242646.0,6,3,337,2,214,0.0,160.0,107.0,1,123,0.0,123.0,123.0
107358.0,17,2,286,2,286,0.0,143.0,143.0,0,0,0.0,0.0,0.0
307072.0,6,6,412,4,272,102357.33333333331,74.0,68.0,2,140,0.0,74.0,70.0
26049.0,17,2,582,1,83,0.0,83.0,83.0,1,499,0.0,499.0,499.0
53070.0,6,14,4740,7,653,8679.166666666666,249.0,93.28571428571428,7,4087,7502.666666666667,1514.0,583.8571428571429
246934.0,6,3,337,2,214,0.0,160.0,107.0,1,123,0.0,123.0,123.0
120279614.0,6,33,2434,18,1348,7075271.411764706,139.0,74.88888888888889,15,1086,7863559.714285715,123.0,72.4
281337.0,17,2,414,1,88,0.0,88.0,88.0,1,326,0.0,326.0,326.0
25384178.0,6,26,7627,14,3735,197254.2307692308,1514.0,266.7857142857143,12,3892,2287982.5454545454,1514.0,324.3333333333333
100276.0,17,2,762,2,762,0.0,381.0,381.0,0,0,0.0,0.0,0.0
47038.0,6,14,4740,7,653,7072.5,249.0,93.28571428571428,7,4087,6205.666666666667,1514.0,583.8571428571429
301518.0,6,6,412,4,272,100506.0,74.0,68.0,2,140,0.0,74.0,70.0
65418.00000000001,6,14,4740,7,653,10530.333333333334,249.0,93.28571428571428,7,4087,9355.666666666666,1514.0,583.8571428571429
90034683.0,17,28,13364,28,13364,3334617.888888889,501.0,477.2857142857143,0,0,0.0,0.0,0.0
3924.000000000001,17,2,762,2,762,0.0,381.0,381.0,0,0,0.0,0.0,0.0
129011285.0,17,15,907,8,475,18430183.57142857,174.0,59.375,7,432,18166826.83333333,174.0,61.71428571428572
216329.0,17,2,180,1,90,0.0,90.0,90.0,1,90,0.0,90.0,90.0
105865011.0,6,809,174696,412,147828,257579.10218978103,1514.0,358.80582524271847,397,26868,266760.6111111111,214.0,67.67758186397985
3005692.0,6,12,2172,7,664,500893.8333333333,252.0,94.85714285714286,5,1508,1719.75,1236.0,301.6
27537.0,17,2,582,1,83,0.0,83.0,83.0,1,499,0.0,499.0,499.0
459006.0,6,5,367,2,132,0.0,66.0,66.0,3,235,229503.0,103.0,78.33333333333333
105000945.0,17,13,1083,7,563,17500157.5,174.0,80.42857142857143,6,520,17001121.6,174.0,86.66666666666667
457809.0,6,3,1604,2,851,0.0,785.0,425.5,1,753,0.0,753.0,753.0
2803716.0,6,2,132,1,66,0.0,66.0,66.0,1,66,0.0,66.0,66.0
43433.0,6,14,4740,7,653,6544.0,249.0,93.28571428571428,7,4087,6815.5,1514.0,583.8571428571429
101574.0,17,2,286,2,286,0.0,143.0,143.0,0,0,0.0,0.0,0.0
47602267.0,6,8,1938,3,886,22712617.0,752.0,295.3333333333333,5,1052,11206630.0,784.0,210.4
63485.0,6,14,4740,7,653,9712.333333333334,249.0,93.28571428571428,7,4087,10309.166666666666,1514.0,583.8571428571429
395.0,17,2,410,1,78,0.0,78.0,78.0,1,332,0.0,332.0,332.0
15303461.0,17,6,2052,6,2052,3060692.2,342.0,342.0,0,0,0.0,0.0,0.0
315922.0,17,4,704,2,148,0.0,74.0,74.0,2,556,0.0,280.0,278.0
38415.0,6,10,2032,5,524,9374.75,252.0,104.8,5,1508,9063.75,1236.0,301.6
90262969.0,6,14,2240,8,1016,12894709.857142856,188.0,127.0,6,1224,18020014.4,204.0,204.0
24666.0,6,14,4740,7,653,3663.1666666666665,249.0,93.28571428571428,7,4087,3758.6666666666665,1514.0,583.8571428571429
216917.0,6,3,426,2,280,0.0,214.0,140.0,1,146,0.0,146.0,146.0
215472.0,6,10,1221,6,636,43094.4,298.0,106.0,4,585,70560.66666666667,379.0,146.25
2514994.0,6,20,6935,11,1567,251499.4,408.0,142.45454545454547,9,5368,250109.375,1514.0,596.4444444444445
297.0,17,2,164,1,82,0.0,82.0,82.0,1,82,0.0,82.0,82.0
284779.0,17,2,363,1,79,0.0,79.0,79.0,1,284,0.0,284.0,284.0
3127178.0,6,7,923,4,753,973722.0,571.0,188.25,3,170,1457876.0,62.0,56.66666666666666
322631.0,17,4,1400,4,1400,107543.66666666669,350.0,350.0,0,0,0.0,0.0,0.0
117065403.0,6,34,2466,17,1194,7316587.6875,123.0,70.23529411764706,17,1272,6678401.9375,123.0,74.82352941176471
1162815.0,6,13,3020,8,2392,166116.42857142858,1514.0,299.0,5,628,221791.5,331.0,125.6
37460.0,6,14,4740,7,653,6118.166666666667,249.0,93.28571428571428,7,4087,5986.166666666667,1514.0,583.8571428571429
23551.0,6,10,2032,5,524,5643.5,252.0,104.8,5,1508,5656.75,1236.0,301.6
1112434.0,6,11,1134,6,558,222486.8,220.0,93.0,5,576,277565.0,304.0,115.2
224129.0,6,10,1221,6,636,44825.8,298.0,106.0,4,585,73043.0,379.0,146.25
274307.0,6,10,1221,6,636,54861.4,298.0,106.0,4,585,85662.33333333333,379.0,146.25
171771.0,17,2,180,1,90,0.0,90.0,90.0,1,90,0.0,90.0,90.0
23722.0,6,10,2032,5,524,5477.0,252.0,104.8,5,1508,5694.0,1236.0,301.6
100650711.0,17,13,821,7,432,16666803.5,174.0,61.71428571428572,6,389,20000903.0,174.0,64.83333333333333
37228051.0,6,7,1874,3,887,18539246.0,753.0,295.6666666666667,4,987,12362587.666666666,785.0,246.75
228389.0,17,2,180,1,90,0.0,90.0,90.0,1,90,0.0,90.0,90.0
18492.0,6,14,4740,7,653,2744.5,249.0,93.28571428571428,7,4087,2941.0,1514.0,583.8571428571429
1994146.0,6,19,6869,11,1567,199414.6,408.0,142.45454545454547,8,5302,223552.57142857145,1514.0,662.75
2898044.0,6,2,132,1,66,0.0,66.0,66.0,1,66,0.0,66.0,66.0
382.0,17,2,168,1,76,0.0,76.0,76.0,1,92,0.0,92.0,92.0
1307916.0,6,4,264,2,132,0.0,66.0,66.0,2,132,0.0,66.0,66.0
53976.0,6,10,1066,5,490,11338.75,218.0,98.0,5,576,13244.75,304.0,115.2
90042663.0,17,28,13364,28,13364,3334913.4444444445,501.0,477.2857142857143,0,0,0.0,0.0,0.0
232761.0,6,3,337,2,214,0.0,160.0,107.0,1,123,0.0,123.0,123.0
11784214.0,6,5,1736,2,819,0.0,753.0,409.5,3,917,5825225.0,785.0,305.6666666666667
320.0,17,2,174,1,79,0.0,79.0,79.0,1,95,0.0,95.0,95.0
110936.0,6,12,1447,6,816,21166.2,291.0,136.0,6,631,20426.2,293.0,105.16666666666669
113254744.0,6,46,3036,23,1518,5135435.227272728,66.0,66.0,23,1518,5135425.727272728,66.0,66.0
153387.0,17,2,180,1,90,0.0,90.0,90.0,1,90,0.0,90.0,90.0
5625305.0,6,4,270,2,134,0.0,68.0,67.0,2,136,0.0,70.0,68.0
10511114.0,6,6,412,3,206,5187646.5,74.0,68.66666666666667,3,206,5187536.5,74.0,68.66666666666667
509171.00000000006,6,5,336,2,134,0.0,68.0,67.0,3,202,195463.0,70.0,67.33333333333333
18544.0,6,2,145,2,145,0.0,91.0,72.5,0,0,0.0,0.0,0.0
51838.0,6,14,4740,7,653,8404.166666666666,249.0,93.28571428571428,7,4087,8473.333333333334,1514.0,583.8571428571429
45155.0,6,14,4740,7,653,6580.5,249.0,93.28571428571428,7,4087,7348.5,1514.0,583.8571428571429
310830.0,6,6,412,4,272,103610.0,74.0,68.0,2,140,0.0,74.0,70.0
111566216.0,6,30,2106,15,1017,7969015.428571428,123.0,67.8,15,1089,7612406.785714285,123.0,72.6
852550.0,6,9,1096,6,625,170510.0,287.0,104.16666666666669,3,471,288443.0,331.0,157.0
232657.0,17,4,1524,4,1524,77552.33333333333,381.0,381.0,0,0,0.0,0.0,0.0
120270272.0,6,220,24884,110,7556,1086238.110091743,140.0,68.69090909090909,110,17328,1086354.9724770642,284.0,157.52727272727273
120063722.0,17,29,13785,29,13785,4287990.071428572,501.0,475.3448275862069,0,0,0.0,0.0,0.0
4284335.0,6,26,5153,14,2631,329564.23076923075,581.0,187.92857142857144,12,2522,370557.6363636364,730.0,210.16666666666663
23603.0,6,14,4740,7,653,3645.3333333333335,249.0,93.28571428571428,7,4087,3593.5,1514.0,583.8571428571429
5623598.0,6,5,336,2,134,0.0,68.0,67.0,3,202,1523069.0,70.0,67.33333333333333
2426.0,17,4,344,2,150,0.0,75.0,75.0,2,194,0.0,103.0,97.0
305367.0,6,6,412,4,272,101789.0,74.0,68.0,2,140,0.0,74.0,70.0
2375.0,17,4,344,2,150,0.0,75.0,75.0,2,194,0.0,103.0,97.0
62907.00000000001,6,12,1320,7,789,10484.5,253.0,112.71428571428572,5,531,11902.25,259.0,106.2
112919642.0,6,32,2236,16,1165,7513574.266666667,139.0,72.8125,16,1071,7513573.866666666,123.0,66.9375
74795.0,6,14,4740,7,653,11519.666666666666,249.0,93.28571428571428,7,4087,11687.666666666666,1514.0,583.8571428571429
298165.0,17,4,1524,4,1524,99388.33333333331,381.0,381.0,0,0,0.0,0.0,0.0
52361.0,6,10,2032,5,524,12495.75,252.0,104.8,5,1508,11998.75,1236.0,301.6
108112902.0,17,5,955,5,955,27028225.5,191.0,191.0,0,0,0.0,0.0,0.0
2780833.0,6,2,132,1,66,0.0,66.0,66.0,1,66,0.0,66.0,66.0
110974855.0,6,31,2166,16,1149,7383226.933333334,123.0,71.8125,15,1017,7910601.428571428,123.0,67.8
50733.0,17,2,180,1,90,0.0,90.0,90.0,1,90,0.0,90.0,90.0
309941.0,6,6,412,4,272,103313.66666666669,74.0,68.0,2,140,0.0,74.0,70.0
217567.0,6,3,426,2,280,0.0,214.0,140.0,1,146,0.0,146.0,146.0
10458529.0,6,7,478,4,272,3440763.333333333,74.0,68.0,3,206,5161026.0,74.0,68.66666666666667
321264.0,17,4,1400,4,1400,107088.0,350.0,350.0,0,0,0.0,0.0,0.0
108099711.0,17,5,1005,5,1005,27024927.75,201.0,201.0,0,0,0.0,0.0,0.0
15047519.0,6,5,370,5,370,3761879.75,74.0,74.0,0,0,0.0,0.0,0.0
1833921.0,6,7,499,3,198,818911.5,66.0,66.0,4,301,604682.6666666666,103.0,75.25
184836.0,17,2,180,1,90,0.0,90.0,90.0,1,90,0.0,90.0,90.0
333.0,17,2,166,1,75,0.0,75.0,75.0,1,91,0.0,91.0,91.0
96937443.0,6,26,1746,13,906,8060120.583333333,123.0,69.6923076923077,13,840,8060127.0,123.0,64.61538461538461
118887252.0,6,34,2334,17,1209,7430453.25,123.0,71.11764705882354,17,1125,7416950.3125,123.0,66.17647058823529
52641.0,6,10,2032,5,524,12492.75,252.0,104.8,5,1508,12244.75,1236.0,301.6
1088706.0,6,13,1386,7,789,181451.0,253.0,112.71428571428572,6,597,214670.6,259.0,99.5
135130187.0,17,6,1206,6,1206,27026037.4,201.0,201.0,0,0,0.0,0.0,0.0
120144362.0,6,322,37090,161,10922,745979.9625,140.0,67.83850931677019,161,26168,745738.09375,284.0,162.53416149068323
2896.0,17,2,224,1,76,0.0,76.0,76.0,1,148,0.0,148.0,148.0
16898.0,17,2,180,1,90,0.0,90.0,90.0,1,90,0.0,90.0,90.0
107278797.0,17,14,864,7,432,17833505.5,174.0,61.71428571428572,7,432,17834493.5,174.0,61.71428571428572
148453.0,6,3,337,2,214,0.0,160.0,107.0,1,123,0.0,123.0,123.0
135125250.0,17,6,1206,6,1206,27025050.0,201.0,201.0,0,0,0.0,0.0,0.0
42595.0,6,14,4740,7,653,6094.5,249.0,93.28571428571428,7,4087,6800.333333333333,1514.0,583.8571428571429
103071042.0,17,14,864,7,432,17178507.0,174.0,61.71428571428572,7,432,17061071.5,174.0,61.71428571428572
107819094.0,6,28,1860,14,966,8277186.230769231,123.0,69.0,14,894,8277178.076923077,123.0,63.85714285714285
584626.0,6,4,508,2,238,0.0,172.0,119.0,2,270,0.0,135.0,135.0
24682.0,6,10,2032,5,524,5392.75,252.0,104.8,5,1508,5590.5,1236.0,301.6
206799.0,6,3,426,2,280,0.0,214.0,140.0,1,146,0.0,146.0,146.0
330022.0,17,2,180,1,90,0.0,90.0,90.0,1,90,0.0,90.0,90.0
109271.0,17,2,700,2,700,0.0,350.0,350.0,0,0,0.0,0.0,0.0
135136546.0,17,6,1146,6,1146,27027309.2,191.0,191.0,0,0,0.0,0.0,0.0
107543.0,17,2,286,2,286,0.0,143.0,143.0,0,0,0.0,0.0,0.0
26766476.0,17,5,1718,4,1368,998860.0,342.0,342.0,1,350,0.0,350.0,350.0
90363623.0,6,11,1644,7,828,15060603.833333334,188.0,118.28571428571428,4,816,20106898.33333333,204.0,204.0
90031256.0,17,28,13364,28,13364,3334490.962962963,501.0,477.2857142857143,0,0,0.0,0.0,0.0
144602.0,6,10,1913,5,461,28682.75,233.0,92.2,5,1452,34862.0,1224.0,290.4
217763.0,6,10,1221,6,636,43552.6,298.0,106.0,4,585,71554.66666666667,379.0,146.25
40150.0,6,13,1479,7,882,6626.833333333333,291.0,126.0,6,597,7474.4,259.0,99.5
91160858.0,6,27,2073,12,935,8287350.727272727,95.0,77.91666666666667,15,1138,6492981.857142857,95.0,75.86666666666666
103450310.0,6,44,2904,22,1452,4926205.238095238,66.0,66.0,22,1452,4915914.80952381,66.0,66.0
62907.00000000001,6,10,2032,5,524,15522.25,252.0,104.8,5,1508,14156.5,1236.0,301.6
107333673.0,17,18,1620,9,810,13389187.625,90.0,90.0,9,810,13389151.75,90.0,90.0
303885.0,6,6,412,4,272,101295.0,74.0,68.0,2,140,0.0,74.0,70.0
323.0,17,2,174,1,79,0.0,79.0,79.0,1,95,0.0,95.0,95.0
49461.0,6,14,4740,7,653,7530.666666666667,249.0,93.28571428571428,7,4087,7393.833333333333,1514.0,583.8571428571429
841802.0,6,9,1270,6,799,168360.4,461.0,133.16666666666666,3,471,284615.0,331.0,157.0
117246677.0,6,48,3168,24,1584,5097681.608695652,66.0,66.0,24,1584,5084259.0869565215,66.0,66.0
2190.0,17,4,344,2,150,0.0,75.0,75.0,2,194,0.0,103.0,97.0
100225070.0,6,295,34672,148,24748,681803.1972789116,336.0,167.21621621621622,147,9924,684963.4109589041,140.0,67.51020408163265
2983639.0,6,11,2106,6,598,596469.8,252.0,99.66666666666669,5,1508,3990.25,1236.0,301.6
90278245.0,6,19,1436,10,745,10025952.222222222,95.0,74.5,9,691,11284460.5,95.0,76.77777777777777
14148427.0,6,20,1607,10,975,1535580.7777777778,315.0,97.5,10,632,1535728.7777777778,78.0,63.2
108115522.0,17,5,1005,5,1005,27028880.5,201.0,201.0,0,0,0.0,0.0,0.0
2345.0,17,4,344,2,150,0.0,75.0,75.0,2,194,0.0,103.0,97.0
135140771.0,17,6,1146,6,1146,27028154.2,191.0,191.0,0,0,0.0,0.0,0.0
101366979.0,17,14,864,7,432,16834341.5,174.0,61.71428571428572,7,432,16833501.0,174.0,61.71428571428572
104914.0,17,2,700,2,700,0.0,350.0,350.0,0,0,0.0,0.0,0.0
2299.0,17,4,344,2,150,0.0,75.0,75.0,2,194,0.0,103.0,97.0
209423.0,6,10,1221,6,636,41884.6,298.0,106.0,4,585,68708.33333333333,379.0,146.25
108103700.0,17,5,955,5,955,27025925.0,191.0,191.0,0,0,0.0,0.0,0.0
155845.0,6,3,337,2,214,0.0,160.0,107.0,1,123,0.0,123.0,123.0
104223.0,17,2,286,2,286,0.0,143.0,143.0,0,0,0.0,0.0,0.0
104969.0,17,2,700,2,700,0.0,350.0,350.0,0,0,0.0,0.0,0.0
120226167.0,6,240,27258,120,8216,1003346.4453781513,140.0,68.46666666666667,120,19042,1003338.411764706,390.0,158.68333333333334
1163302.0,6,13,3020,8,2392,166186.0,1514.0,299.0,5,628,221928.5,331.0,125.6
538.0,17,2,508,2,508,0.0,257.0,254.0,0,0,0.0,0.0,0.0
207016.0,6,3,426,2,280,0.0,214.0,140.0,1,146,0.0,146.0,146.0
298347.0,6,6,412,4,272,99449.0,74.0,68.0,2,140,0.0,74.0,70.0
108109929.0,17,5,1005,5,1005,27027482.25,201.0,201.0,0,0,0.0,0.0,0.0
120046.0,17,2,180,1,70,0.0,70.0,70.0,1,110,0.0,110.0,110.0
34578.0,6,2,145,2,145,0.0,91.0,72.5,0,0,0.0,0.0,0.0
315363.0,17,4,1400,4,1400,105121.0,350.0,350.0,0,0,0.0,0.0,0.0
0.0,17,1,55,1,55,0.0,55.0,55.0,0,0,0.0,0.0,0.0
33187.0,6,14,4740,7,653,5290.0,249.0,93.28571428571428,7,4087,5086.833333333333,1514.0,583.8571428571429
108093508.0,17,5,955,5,955,27023377.0,191.0,191.0,0,0,0.0,0.0,0.0
154511.0,17,4,6056,4,6056,51503.66666666666,1514.0,1514.0,0,0,0.0,0.0,0.0
108109010.0,17,5,1005,5,1005,27027252.5,201.0,201.0,0,0,0.0,0.0,0.0
121291.0,6,3,337,2,214,0.0,160.0,107.0,1,123,0.0,123.0,123.0
2305.0,17,4,344,2,150,0.0,75.0,75.0,2,194,0.0,103.0,97.0
23864.0,6,10,2032,5,524,5549.5,252.0,104.8,5,1508,5705.25,1236.0,301.6
50731.0,6,14,4740,7,653,8310.5,249.0,93.28571428571428,7,4087,8034.0,1514.0,583.8571428571429
317834.0,17,4,1400,4,1400,105944.66666666669,350.0,350.0,0,0,0.0,0.0,0.0
234465.0,6,3,373,2,238,0.0,172.0,119.0,1,135,0.0,135.0,135.0
90028484.0,17,28,13364,28,13364,3334388.296296296,501.0,477.2857142857143,0,0,0.0,0.0,0.0
50341.0,6,12,1413,7,882,8390.166666666666,291.0,126.0,5,531,11803.75,259.0,106.2
15266.0,6,13,1459,7,862,1914.5,271.0,123.14285714285714,6,597,2846.4,259.0,99.5
33101.0,6,14,4740,7,653,4907.166666666667,249.0,93.28571428571428,7,4087,5022.666666666667,1514.0,583.8571428571429
106720.0,17,2,286,2,286,0.0,143.0,143.0,0,0,0.0,0.0,0.0
297977.0,6,6,412,4,272,99325.66666666669,74.0,68.0,2,140,0.0,74.0,70.0
75558.0,6,14,4740,7,653,11912.833333333334,249.0,93.28571428571428,7,4087,11099.0,1514.0,583.8571428571429
209497.0,6,10,1221,6,636,41899.4,298.0,106.0,4,585,68718.66666666667,379.0,146.25
121547.0,6,3,337,2,214,0.0,160.0,107.0,1,123,0.0,123.0,123.0
3006434.0,6,11,2106,6,598,601107.4,252.0,99.66666666666669,5,1508,1874.0,1236.0,301.6
2322.0,17,4,344,2,150,0.0,75.0,75.0,2,194,0.0,103.0,97.0
47067.0,6,14,4740,7,653,7725.333333333333,249.0,93.28571428571428,7,4087,6718.166666666667,1514.0,583.8571428571429
30080.0,6,14,4740,7,653,4614.0,249.0,93.28571428571428,7,4087,4877.166666666667,1514.0,583.8571428571429
2367444.0,6,49,23728,25,19797,98643.5,1514.0,791.88,24,3931,93150.17391304349,1514.0,163.79166666666666
6649.0,17,2,582,1,83,0.0,83.0,83.0,1,499,0.0,499.0,499.0
208000.0,6,3,426,2,280,0.0,214.0,140.0,1,146,0.0,146.0,146.0
97759055.0,6,29,2068,15,1105,6967381.428571428,139.0,73.66666666666667,14,963,7503336.384615385,123.0,68.78571428571429
18115.0,6,11,1132,6,556,3028.2,218.0,92.66666666666669,5,576,4077.75,304.0,115.2
10473426.0,6,7,478,4,272,3445590.333333333,74.0,68.0,3,206,5168309.5,74.0,68.66666666666667
234241.0,6,3,337,2,214,0.0,160.0,107.0,1,123,0.0,123.0,123.0
203441.0,17,2,762,2,762,0.0,381.0,381.0,0,0,0.0,0.0,0.0
305293.0,6,2,1538,1,753,0.0,753.0,753.0,1,785,0.0,785.0,785.0
310312.0,17,4,1400,4,1400,103437.33333333331,350.0,350.0,0,0,0.0,0.0,0.0
302409.0,6,2,132,1,66,0.0,66.0,66.0,1,66,0.0,66.0,66.0
6953.0,17,2,582,1,83,0.0,83.0,83.0,1,499,0.0,499.0,499.0
102115.0,17,2,286,2,286,0.0,143.0,143.0,0,0,0.0,0.0,0.0
47387.0,6,14,4740,7,653,7705.666666666667,249.0,93.28571428571428,7,4087,7717.166666666667,1514.0,583.8571428571429
2316.0,17,4,344,2,150,0.0,75.0,75.0,2,194,0.0,103.0,97.0
2367585.0,6,49,23728,25,19797,98649.375,1514.0,791.88,24,3931,93062.34782608696,1514.0,163.79166666666666
2323.0,17,4,344,2,150,0.0,75.0,75.0,2,194,0.0,103.0,97.0
124881336.0,6,36,2586,19,1392,6937852.0,123.0,73.26315789473684,17,1194,7167144.625,123.0,70.23529411764706
335315.0,17,2,180,1,90,0.0,90.0,90.0,1,90,0.0,90.0,90.0
214871.0,17,2,180,1,90,0.0,90.0,90.0,1,90,0.0,90.0,90.0
2317.0,17,4,344,2,150,0.0,75.0,75.0,2,194,0.0,103.0,97.0
237319.0,17,2,180,1,90,0.0,90.0,90.0,1,90,0.0,90.0,90.0
350.0,17,2,166,1,83,0.0,83.0,83.0,1,83,0.0,83.0,83.0
2448.0,17,4,344,2,150,0.0,75.0,75.0,2,194,0.0,103.0,97.0
1026495.0,6,13,1428,7,797,169740.0,253.0,113.85714285714286,6,631,204456.6,293.0,105.16666666666669
90253531.0,6,14,2240,8,1016,12893361.57142857,188.0,127.0,6,1224,18018254.6,204.0,204.0
208833.0,17,2,762,2,762,0.0,381.0,381.0,0,0,0.0,0.0,0.0
105061.0,17,2,700,2,700,0.0,350.0,350.0,0,0,0.0,0.0,0.0
100464.0,17,2,762,2,762,0.0,381.0,381.0,0,0,0.0,0.0,0.0
242284.0,6,3,337,2,214,0.0,160.0,107.0,1,123,0.0,123.0,123.0
1033973.0,6,11,1134,6,558,206794.6,220.0,93.0,5,576,256218.75,304.0,115.2
37270.0,6,14,4740,7,653,6006.833333333333,249.0,93.28571428571428,7,4087,5970.833333333333,1514.0,583.8571428571429
147970.0,17,2,180,1,90,0.0,90.0,90.0,1,90,0.0,90.0,90.0
104405.0,17,2,700,2,700,0.0,350.0,350.0,0,0,0.0,0.0,0.0
120270266.0,6,286,33608,143,9734,841050.690140845,140.0,68.06993006993007,143,23874,841200.2535211268,300.0,166.95104895104896
2052018.0,6,18,6803,10,1501,228002.0,408.0,150.1,8,5302,230729.57142857145,1514.0,662.75
310815.0,6,6,412,4,272,103605.0,74.0,68.0,2,140,0.0,74.0,70.0
31123.0,6,10,2032,5,524,7361.25,252.0,104.8,5,1508,6872.0,1236.0,301.6
219677.0,6,3,426,2,280,0.0,214.0,140.0,1,146,0.0,146.0,146.0
102047.0,17,2,286,2,286,0.0,143.0,143.0,0,0,0.0,0.0,0.0
108107762.0,17,5,955,5,955,27026940.5,191.0,191.0,0,0,0.0,0.0,0.0
433.0,17,2,508,2,508,0.0,257.0,254.0,0,0,0.0,0.0,0.0
108102132.0,17,5,1005,5,1005,27025533.0,201.0,201.0,0,0,0.0,0.0,0.0
90260258.0,6,12,1832,8,1016,12894322.57142857,188.0,127.0,4,816,30031552.666666668,204.0,204.0
90977825.0,6,168,19000,84,13308,1093522.8554216868,284.0,158.42857142857142,84,5692,1093526.0722891567,140.0,67.76190476190476
353210.0,6,10,1221,6,636,70642.0,298.0,106.0,4,585,116495.66666666669,379.0,146.25
32295.0,6,14,4740,7,653,5209.5,249.0,93.28571428571428,7,4087,5223.0,1514.0,583.8571428571429
108105528.0,17,5,1005,5,1005,27026382.0,201.0,201.0,0,0,0.0,0.0,0.0
135135599.0,17,6,1146,6,1146,27027119.8,191.0,191.0,0,0,0.0,0.0,0.0
90019712.0,17,28,13364,28,13364,3334063.407407407,501.0,477.2857142857143,0,0,0.0,0.0,0.0
206945.0,6,3,426,2,280,0.0,214.0,140.0,1,146,0.0,146.0,146.0
48698.0,6,14,4740,7,653,6207.833333333333,249.0,93.28571428571428,7,4087,7903.5,1514.0,583.8571428571429
120122834.0,6,17,2572,8,1368,17160404.85714286,204.0,171.0,9,1204,14994440.375,188.0,133.77777777777777
135137869.0,17,6,1146,6,1146,27027573.8,191.0,191.0,0,0,0.0,0.0,0.0
107259027.0,6,195,22350,98,6690,1105763.1649484537,140.0,68.26530612244898,97,15660,1114469.3541666667,374.0,161.44329896907217
49365.0,6,10,2032,5,524,12132.75,252.0,104.8,5,1508,11988.5,1236.0,301.6
5626615.0,6,4,270,2,134,0.0,68.0,67.0,2,136,0.0,70.0,68.0
307725.0,6,6,412,4,272,102575.0,74.0,68.0,2,140,0.0,74.0,70.0
104001.0,17,2,286,2,286,0.0,143.0,143.0,0,0,0.0,0.0,0.0
300465.0,6,6,412,4,272,100155.0,74.0,68.0,2,140,0.0,74.0,70.0
859616.0,6,9,1096,6,625,171923.2,287.0,104.16666666666669,3,471,291885.0,331.0,157.0
120171154.0,6,252,28600,126,8612,954760.552,140.0,68.34920634920636,126,19988,954727.736,284.0,158.63492063492063
128082.0,6,14,4740,7,653,21238.666666666668,249.0,93.28571428571428,7,4087,14733.333333333334,1514.0,583.8571428571429
108731074.0,6,33,2412,17,1272,6795692.125,123.0,74.82352941176471,16,1140,7234758.066666666,123.0,71.25
108103532.0,17,5,955,5,955,27025883.0,191.0,191.0,0,0,0.0,0.0,0.0
317825.0,17,4,1400,4,1400,105941.66666666669,350.0,350.0,0,0,0.0,0.0,0.0
301616.0,6,6,412,4,272,100538.66666666669,74.0,68.0,2,140,0.0,74.0,70.0
0.0,17,1,55,1,55,0.0,55.0,55.0,0,0,0.0,0.0,0.0
321928.0,17,4,1400,4,1400,107309.33333333331,350.0,350.0,0,0,0.0,0.0,0.0
90540842.0,6,15,2444,8,1016,12934406.0,188.0,127.0,7,1428,15062201.333333334,204.0,204.0
304168.0,6,6,412,4,272,101389.33333333331,74.0,68.0,2,140,0.0,74.0,70.0
108102495.0,17,5,1005,5,1005,27025623.75,201.0,201.0,0,0,0.0,0.0,0.0
118995744.0,6,48,3168,24,1584,5173728.0,66.0,66.0,24,1584,5161744.956521739,66.0,66.0
205592.0,17,2,180,1,90,0.0,90.0,90.0,1,90,0.0,90.0,90.0
268371.0,6,3,198,1,66,0.0,66.0,66.0,2,132,0.0,66.0,66.0
96406024.0,6,39,2574,20,1320,5057465.631578947,66.0,66.0,19,1254,5155419.277777778,66.0,66.0
22355.0,6,14,4740,7,653,3297.1666666666665,249.0,93.28571428571428,7,4087,3582.0,1514.0,583.8571428571429
232880.0,6,3,337,2,214,0.0,160.0,107.0,1,123,0.0,123.0,123.0
298399.0,6,6,412,4,272,99466.33333333331,74.0,68.0,2,140,0.0,74.0,70.0
2707.0,17,4,344,2,150,0.0,75.0,75.0,2,194,0.0,103.0,97.0
246315.0,6,3,373,2,238,0.0,172.0,119.0,1,135,0.0,135.0,135.0
90258278.0,6,13,2036,8,1016,12894039.714285716,188.0,127.0,5,1020,22523269.0,204.0,204.0
12624.0,6,10,1949,5,441,2944.25,169.0,88.2,5,1508,2730.75,1236.0,301.6
23960.0,6,14,4740,7,653,3872.3333333333335,249.0,93.28571428571428,7,4087,3018.833333333333,1514.0,583.8571428571429
90313184.0,6,16,1192,8,596,12894011.57142857,95.0,74.5,8,596,12901105.714285716,95.0,74.5
313280.0,17,4,1400,4,1400,104426.66666666669,350.0,350.0,0,0,0.0,0.0,0.0
96131177.0,6,52,11501,28,5976,3560413.962962963,1514.0,213.42857142857144,24,5525,4168424.304347826,1514.0,230.2083333333333
178112.0,17,2,180,1,90,0.0,90.0,90.0,1,90,0.0,90.0,90.0
121363.0,6,3,337,2,214,0.0,160.0,107.0,1,123,0.0,123.0,123.0
2461.0,17,4,344,2,150,0.0,75.0,75.0,2,194,0.0,103.0,97.0
1287732.0,17,7,490,7,490,214622.0,70.0,70.0,0,0,0.0,0.0,0.0
14922314.0,6,33,10980,18,3951,159875.35294117648,1514.0,219.5,15,7029,1050419.642857143,1514.0,468.6
160272.0,6,2,128,1,74,0.0,74.0,74.0,1,54,0.0,54.0,54.0
5828404.0,6,4,270,2,134,0.0,68.0,67.0,2,136,0.0,70.0,68.0
2806358.0,6,2,132,1,66,0.0,66.0,66.0,1,66,0.0,66.0,66.0
117696395.0,6,47,3102,24,1584,5105131.043478261,66.0,66.0,23,1518,5135573.318181818,66.0,66.0
98182265.0,6,170,19312,85,13480,1166274.488095238,374.0,158.58823529411765,85,5832,1166275.0833333333,140.0,68.61176470588235
37673.0,6,13,4515,6,512,6982.6,230.0,85.33333333333333,7,4003,5899.666666666667,1514.0,571.8571428571429
9517.0,17,2,571,1,86,0.0,86.0,86.0,1,485,0.0,485.0,485.0
29827.0,6,14,4740,7,653,4802.0,249.0,93.28571428571428,7,4087,4191.666666666667,1514.0,583.8571428571429
46015.0,6,14,4740,7,653,6253.0,249.0,93.28571428571428,7,4087,7313.333333333333,1514.0,583.8571428571429
40125.0,6,11,2098,6,590,7505.0,252.0,98.33333333333331,5,1508,7533.75,1236.0,301.6
56971.0,6,14,4740,7,653,9324.5,249.0,93.28571428571428,7,4087,9140.5,1514.0,583.8571428571429
0.0,17,1,381,1,381,0.0,381.0,381.0,0,0,0.0,0.0,0.0
18192598.0,6,344,324554,98,6632,187552.55670103093,210.0,67.6734693877551,246,317922,74210.2081632653,1514.0,1292.3658536585365
90091835.0,6,12,1848,5,1020,22522362.0,204.0,204.0,7,828,15014922.833333334,188.0,118.28571428571428
348158.0,17,6,1230,3,234,173901.0,78.0,78.0,3,996,173814.5,332.0,332.0
102724502.0,6,28,1860,14,966,7885288.615384615,123.0,69.0,14,894,7885287.692307692,123.0,63.85714285714285
90023576.0,17,27,12943,27,12943,3462445.230769231,501.0,479.3703703703704,0,0,0.0,0.0,0.0
315.0,17,2,174,1,79,0.0,79.0,79.0,1,95,0.0,95.0,95.0
135128465.0,17,6,1206,6,1206,27025693.0,201.0,201.0,0,0,0.0,0.0,0.0
227563.0,6,12,1373,7,714,37927.16666666666,298.0,102.0,5,659,56094.75,379.0,131.8
90257196.0,6,15,2444,8,1016,12893885.142857144,188.0,127.0,7,1428,15015446.833333334,204.0,204.0
121437.0,6,3,337,2,214,0.0,160.0,107.0,1,123,0.0,123.0,123.0
270394.0,6,10,1221,6,636,54078.8,298.0,106.0,4,585,84767.33333333333,379.0,146.25
135139067.0,17,6,1146,6,1146,27027813.4,191.0,191.0,0,0,0.0,0.0,0.0
21717.0,6,10,2032,5,524,4785.75,252.0,104.8,5,1508,4759.0,1236.0,301.6
108081871.0,17,5,1005,5,1005,27020467.75,201.0,201.0,0,0,0.0,0.0,0.0
54685.0,6,14,4740,7,653,8007.833333333333,249.0,93.28571428571428,7,4087,8158.0,1514.0,583.8571428571429
37698.0,6,14,4740,7,653,6153.5,249.0,93.28571428571428,7,4087,6091.5,1514.0,583.8571428571429
205829.0,17,2,180,1,90,0.0,90.0,90.0,1,90,0.0,90.0,90.0
90038408.0,17,28,13364,28,13364,3334755.851851852,501.0,477.2857142857143,0,0,0.0,0.0,0.0
108107139.0,17,5,1005,5,1005,27026784.75,201.0,201.0,0,0,0.0,0.0,0.0
10908345.0,6,8,544,4,272,3590650.333333333,74.0,68.0,4,272,3590590.6666666665,74.0,68.0
108112730.0,17,5,955,5,955,27028182.5,191.0,191.0,0,0,0.0,0.0,0.0
108133301.0,17,5,1005,5,1005,27033325.25,201.0,201.0,0,0,0.0,0.0,0.0
281397.0,17,2,363,1,79,0.0,79.0,79.0,1,284,0.0,284.0,284.0
90257645.0,6,14,2240,8,1016,12893949.285714284,188.0,127.0,6,1224,18018688.4,204.0,204.0
156425.0,6,3,337,2,214,0.0,160.0,107.0,1,123,0.0,123.0,123.0
108009077.0,17,13,821,7,432,18001512.833333332,174.0,61.71428571428572,6,389,19985886.0,174.0,64.83333333333333
317.0,17,2,174,1,79,0.0,79.0,79.0,1,95,0.0,95.0,95.0
115812.0,6,14,4740,7,653,14257.0,249.0,93.28571428571428,7,4087,17652.666666666668,1514.0,583.8571428571429
46618.0,6,14,4740,7,653,7649.333333333333,249.0,93.28571428571428,7,4087,7182.833333333333,1514.0,583.8571428571429
2360584.0,6,3,204,2,136,0.0,70.0,68.0,1,68,0.0,68.0,68.0
203097.0,17,4,6056,4,6056,67699.0,1514.0,1514.0,0,0,0.0,0.0,0.0
1307962.0,6,4,264,2,132,0.0,66.0,66.0,2,132,0.0,66.0,66.0
118417346.0,6,30,1974,15,1026,8442950.07142857,123.0,68.4,15,948,8442950.92857143,123.0,63.2
108979.0,17,2,286,2,286,0.0,143.0,143.0,0,0,0.0,0.0,0.0
742057.0,6,10,1065,5,534,185165.0,262.0,106.8,5,531,184778.5,259.0,106.2
9342.0,17,2,571,1,86,0.0,86.0,86.0,1,485,0.0,485.0,485.0
355.0,17,2,267,1,83,0.0,83.0,83.0,1,184,0.0,184.0,184.0
49794.0,6,14,4740,7,653,7766.333333333333,249.0,93.28571428571428,7,4087,8153.5,1514.0,583.8571428571429
917174.0,6,10,1162,6,625,183434.8,287.0,104.16666666666669,4,537,213865.0,331.0,134.25
302434.0,6,2,132,1,66,0.0,66.0,66.0,1,66,0.0,66.0,66.0
306815.0,6,6,412,4,272,102271.66666666669,74.0,68.0,2,140,0.0,74.0,70.0
95551932.0,17,15,5138,14,4788,5732744.076923077,342.0,342.0,1,350,0.0,350.0,350.0
121445.0,6,3,337,2,214,0.0,160.0,107.0,1,123,0.0,123.0,123.0
246961.0,6,3,337,2,214,0.0,160.0,107.0,1,123,0.0,123.0,123.0
213458.0,6,10,1221,6,636,42691.6,298.0,106.0,4,585,69920.66666666667,379.0,146.25
53851.0,6,14,4740,7,653,7021.5,249.0,93.28571428571428,7,4087,8839.833333333334,1514.0,583.8571428571429
120120724.0,6,228,25772,114,7746,1057852.8584070797,140.0,67.94736842105263,114,18026,1038328.6814159292,284.0,158.12280701754386
302725.0,6,6,412,4,272,100908.33333333331,74.0,68.0,2,140,0.0,74.0,70.0
97616.0,17,2,762,2,762,0.0,381.0,381.0,0,0,0.0,0.0,0.0
206095.0,6,3,426,2,280,0.0,214.0,140.0,1,146,0.0,146.0,146.0
117657430.0,17,13,821,7,432,19500991.166666668,174.0,61.71428571428572,6,389,19600177.4,174.0,64.83333333333333
247515.0,6,3,337,2,214,0.0,160.0,107.0,1,123,0.0,123.0,123.0
5623060.0,6,4,270,2,134,0.0,68.0,67.0,2,136,0.0,70.0,68.0
322339.0,17,4,1400,4,1400,107446.33333333331,350.0,350.0,0,0,0.0,0.0,0.0
109881.0,17,2,286,2,286,0.0,143.0,143.0,0,0,0.0,0.0,0.0
394934.0,17,2,176,1,80,0.0,80.0,80.0,1,96,0.0,96.0,96.0
108108779.0,17,5,955,5,955,27027194.75,191.0,191.0,0,0,0.0,0.0,0.0
324.0,17,2,174,1,79,0.0,79.0,79.0,1,95,0.0,95.0,95.0
56056.0,6,14,4740,7,653,9181.833333333334,249.0,93.28571428571428,7,4087,8663.166666666666,1514.0,583.8571428571429
1858.0,17,2,176,1,80,0.0,80.0,80.0,1,96,0.0,96.0,96.0
34495.0,6,10,2032,5,524,7266.5,252.0,104.8,5,1508,7791.75,1236.0,301.6
121316.0,6,3,337,2,214,0.0,160.0,107.0,1,123,0.0,123.0,123.0
204410.0,17,2,762,2,762,0.0,381.0,381.0,0,0,0.0,0.0,0.0
135132957.0,17,6,1146,6,1146,27026591.4,191.0,191.0,0,0,0.0,0.0,0.0
243013.0,6,3,337,2,214,0.0,160.0,107.0,1,123,0.0,123.0,123.0
86446.0,6,10,1065,5,534,20267.75,262.0,106.8,5,531,20241.5,259.0,106.2
115600007.0,6,48,3168,24,1584,5026087.260869565,66.0,66.0,24,1584,5012661.869565218,66.0,66.0
165842.0,17,2,414,1,88,0.0,88.0,88.0,1,326,0.0,326.0,326.0
90117295.0,6,10,1440,7,828,15019549.166666666,188.0,118.28571428571428,3,612,30032183.0,204.0,204.0
119789497.0,6,23,1693,12,894,10889954.272727272,95.0,74.5,11,799,11953985.8,95.0,72.63636363636364
5566.0,17,2,180,1,90,0.0,90.0,90.0,1,90,0.0,90.0,90.0
44540.0,6,10,2032,5,524,10137.0,252.0,104.8,5,1508,8258.75,1236.0,301.6
106005182.0,17,13,821,7,432,17667530.333333332,174.0,61.71428571428572,6,389,17200202.8,174.0,64.83333333333333
276323.0,17,2,363,1,79,0.0,79.0,79.0,1,284,0.0,284.0,284.0
313293.0,17,4,1400,4,1400,104431.0,350.0,350.0,0,0,0.0,0.0,0.0
233050.0,6,3,337,2,214,0.0,160.0,107.0,1,123,0.0,123.0,123.0
35994.0,6,10,2032,5,524,8520.25,252.0,104.8,5,1508,8613.0,1236.0,301.6
114556.0,17,2,762,2,762,0.0,381.0,381.0,0,0,0.0,0.0,0.0
117001047.0,17,15,1169,8,606,16714435.285714284,174.0,75.75,7,563,16167554.833333334,174.0,80.42857142857143
35473.0,6,10,2032,5,524,8254.0,252.0,104.8,5,1508,7244.25,1236.0,301.6
44840.0,6,10,2032,5,524,10972.5,252.0,104.8,5,1508,9075.0,1236.0,301.6
28468.0,6,11,1132,6,556,5532.6,218.0,92.66666666666669,5,576,6290.5,304.0,115.2
93840465.0,6,26,1746,13,906,7820038.75,123.0,69.6923076923077,13,840,7802031.25,123.0,64.61538461538461
12271.0,6,10,1067,5,536,2424.5,264.0,107.2,5,531,2706.5,259.0,106.2
114096252.0,6,47,3102,23,1518,5186193.2727272725,66.0,66.0,24,1584,4947303.913043479,66.0,66.0
2798119.0,6,2,132,1,66,0.0,66.0,66.0,1,66,0.0,66.0,66.0
301119.0,6,6,412,4,272,100373.0,74.0,68.0,2,140,0.0,74.0,70.0
47615.0,6,14,4740,7,653,6704.333333333333,249.0,93.28571428571428,7,4087,7688.166666666667,1514.0,583.8571428571429
33415.0,6,14,4740,7,653,5459.833333333333,249.0,93.28571428571428,7,4087,3286.0,1514.0,583.8571428571429
36850.0,6,14,4740,7,653,5993.666666666667,249.0,93.28571428571428,7,4087,5710.333333333333,1514.0,583.8571428571429
9532.0,17,2,539,1,86,0.0,86.0,86.0,1,453,0.0,453.0,453.0
156321.0,17,2,180,1,90,0.0,90.0,90.0,1,90,0.0,90.0,90.0
235065.0,6,3,373,2,238,0.0,172.0,119.0,1,135,0.0,135.0,135.0
30760663.0,6,26,7627,14,3735,200977.6923076923,1514.0,266.7857142857143,12,3892,2777761.636363636,1514.0,324.3333333333333
26361830.0,17,5,1718,4,1368,764360.3333333334,342.0,342.0,1,350,0.0,350.0,350.0
135128902.0,17,6,1206,6,1206,27025780.4,201.0,201.0,0,0,0.0,0.0,0.0
147956.0,17,2,180,1,90,0.0,90.0,90.0,1,90,0.0,90.0,90.0
103026.0,17,2,286,2,286,0.0,143.0,143.0,0,0,0.0,0.0,0.0
120125673.0,6,13,2020,9,1204,15015709.125,188.0,133.77777777777777,4,816,30030581.666666668,204.0,204.0
235087.0,6,3,337,2,214,0.0,160.0,107.0,1,123,0.0,123.0,123.0
414.0,17,2,508,2,508,0.0,257.0,254.0,0,0,0.0,0.0,0.0
0.0,17,1,55,1,55,0.0,55.0,55.0,0,0,0.0,0.0,0.0
123250538.0,6,49,3234,25,1650,5135439.083333333,66.0,66.0,24,1584,5153555.0,66.0,66.0
91891943.0,6,24,1632,12,846,8334190.636363637,123.0,70.5,12,786,8334191.090909091,123.0,65.5
1279865.0,17,7,490,7,490,213310.8333333333,70.0,70.0,0,0,0.0,0.0,0.0
3056192.0,6,4,270,3,202,1528096.0,70.0,67.33333333333333,1,68,0.0,68.0,68.0
300779.0,6,6,412,4,272,100259.66666666669,74.0,68.0,2,140,0.0,74.0,70.0
147938.0,17,2,180,1,90,0.0,90.0,90.0,1,90,0.0,90.0,90.0
108121.0,17,2,286,2,286,0.0,143.0,143.0,0,0,0.0,0.0,0.0
32341.0,6,14,4740,7,653,4628.0,249.0,93.28571428571428,7,4087,5249.333333333333,1514.0,583.8571428571429
178361.0,17,2,180,1,90,0.0,90.0,90.0,1,90,0.0,90.0,90.0
313899.0,17,4,1400,4,1400,104633.0,350.0,350.0,0,0,0.0,0.0,0.0
108109769.0,17,5,955,5,955,27027442.25,191.0,191.0,0,0,0.0,0.0,0.0
20489.0,6,14,4740,7,653,3104.1666666666665,249.0,93.28571428571428,7,4087,3206.0,1514.0,583.8571428571429
146704.0,6,3,337,2,214,0.0,160.0,107.0,1,123,0.0,123.0,123.0
30039.0,6,10,2032,5,524,5866.75,252.0,104.8,5,1508,6866.25,1236.0,301.6
319999.0,17,4,1400,4,1400,106666.33333333331,350.0,350.0,0,0,0.0,0.0,0.0
15067227.0,17,6,2718,6,2718,3013445.4,453.0,453.0,0,0,0.0,0.0,0.0
245581.0,6,3,337,2,214,0.0,160.0,107.0,1,123,0.0,123.0,123.0
298313.0,6,6,412,4,272,99437.66666666669,74.0,68.0,2,140,0.0,74.0,70.0
111775.0,17,2,286,2,286,0.0,143.0,143.0,0,0,0.0,0.0,0.0
299090.0,6,6,412,4,272,99696.66666666669,74.0,68.0,2,140,0.0,74.0,70.0
129001152.0,17,15,907,8,475,18428736.0,174.0,59.375,7,432,18167634.0,174.0,61.71428571428572
144770.0,17,2,180,1,70,0.0,70.0,70.0,1,110,0.0,110.0,110.0
1657039.0,6,4,276,2,128,0.0,74.0,64.0,2,148,0.0,74.0,74.0
897436.0,6,10,1335,6,798,179487.2,460.0,133.0,4,537,207121.0,331.0,134.25
319.0,17,2,174,1,79,0.0,79.0,79.0,1,95,0.0,95.0,95.0
1081306.0,6,11,1134,6,558,216261.2,220.0,93.0,5,576,264256.5,304.0,115.2
90054577.0,17,27,12943,27,12943,3463637.576923077,501.0,479.3703703703704,0,0,0.0,0.0,0.0
2354.0,17,4,344,2,150,0.0,75.0,75.0,2,194,0.0,103.0,97.0
318.0,17,2,174,1,79,0.0,79.0,79.0,1,95,0.0,95.0,95.0
259597.00000000003,6,10,1221,6,636,51919.4,298.0,106.0,4,585,79940.66666666667,379.0,146.25
499923.0,6,5,336,2,134,0.0,68.0,67.0,3,202,193248.5,70.0,67.33333333333333
1166759.0,6,13,3020,8,2392,166679.85714285713,1514.0,299.0,5,628,222816.25,331.0,125.6
323.0,17,2,174,1,79,0.0,79.0,79.0,1,95,0.0,95.0,95.0
90286455.0,6,16,1192,8,596,12891539.285714284,95.0,74.5,8,596,12896592.285714284,95.0,74.5
5622248.0,6,5,336,2,134,0.0,68.0,67.0,3,202,1421831.5,70.0,67.33333333333333
153369.0,17,2,180,1,90,0.0,90.0,90.0,1,90,0.0,90.0,90.0
500799.0,6,5,336,2,134,0.0,68.0,67.0,3,202,193485.5,70.0,67.33333333333333
108108034.0,17,5,955,5,955,27027008.5,191.0,191.0,0,0,0.0,0.0,0.0
51595.0,6,14,4740,7,653,8433.666666666666,249.0,93.28571428571428,7,4087,8257.833333333334,1514.0,583.8571428571429
40874.0,6,14,4740,7,653,6424.833333333333,249.0,93.28571428571428,7,4087,6442.0,1514.0,583.8571428571429
341.0,17,2,267,1,83,0.0,83.0,83.0,1,184,0.0,184.0,184.0
308337.0,6,6,412,4,272,102779.0,74.0,68.0,2,140,0.0,74.0,70.0
1036839.0,6,11,1134,6,558,207367.8,220.0,93.0,5,576,258079.75,304.0,115.2
102708785.0,6,41,2706,21,1386,5135439.25,66.0,66.0,20,1320,5034597.631578947,66.0,66.0
99812306.0,17,12,778,6,389,19877184.0,174.0,64.83333333333333,6,389,19930516.4,174.0,64.83333333333333
13639.0,17,2,582,1,83,0.0,83.0,83.0,1,499,0.0,499.0,499.0
90297171.0,6,16,1192,8,596,12892622.0,95.0,74.5,8,596,12898212.857142856,95.0,74.5
216802.0,6,3,426,2,280,0.0,214.0,140.0,1,146,0.0,146.0,146.0
90018593.0,17,28,13364,28,13364,3334021.962962963,501.0,477.2857142857143,0,0,0.0,0.0,0.0
37550.0,6,14,4740,7,653,6132.0,249.0,93.28571428571428,7,4087,5943.166666666667,1514.0,583.8571428571429
1468033.0,17,16,1120,16,1120,97868.86666666668,70.0,70.0,0,0,0.0,0.0,0.0
10434898.0,6,7,478,4,272,3431993.0,74.0,68.0,3,206,5147831.0,74.0,68.66666666666667
15065385.0,17,6,2718,6,2718,3013077.0,453.0,453.0,0,0,0.0,0.0,0.0
19591.0,17,4,823,2,163,0.0,89.0,81.5,2,660,0.0,443.0,330.0
2881471.0,6,11,2106,6,598,576063.8,252.0,99.66666666666669,5,1508,1757.25,1236.0,301.6
24859345.0,17,5,1718,4,1368,914096.6666666666,342.0,342.0,1,350,0.0,350.0,350.0
555112.0,17,2,618,1,72,0.0,72.0,72.0,1,546,0.0,546.0,546.0
108108199.0,17,5,955,5,955,27027049.75,191.0,191.0,0,0,0.0,0.0,0.0
135135448.0,17,6,1206,6,1206,27027089.6,201.0,201.0,0,0,0.0,0.0,0.0
90019618.0,17,28,13364,28,13364,3334059.925925926,501.0,477.2857142857143,0,0,0.0,0.0,0.0
243387.0,6,3,337,2,214,0.0,160.0,107.0,1,123,0.0,123.0,123.0
2766150.0,6,3,1602,1,752,0.0,752.0,752.0,2,850,0.0,784.0,425.0
143890.0,17,2,180,1,90,0.0,90.0,90.0,1,90,0.0,90.0,90.0
249955.0,6,3,337,2,214,0.0,160.0,107.0,1,123,0.0,123.0,123.0
2381.0,17,4,344,2,150,0.0,75.0,75.0,2,194,0.0,103.0,97.0
50948.0,17,2,180,1,90,0.0,90.0,90.0,1,90,0.0,90.0,90.0
146204.0,6,3,337,2,214,0.0,160.0,107.0,1,123,0.0,123.0,123.0
90733989.0,6,22,1680,12,894,8244361.818181818,95.0,74.5,10,786,10081135.111111112,95.0,78.6
1798.0,17,6,1230,3,234,601.0,78.0,78.0,3,996,698.5,332.0,332.0
105136162.0,17,14,1126,7,563,17496013.0,174.0,80.42857142857143,7,563,17496007.333333332,174.0,80.42857142857143
32908.0,6,14,4740,7,653,5328.333333333333,249.0,93.28571428571428,7,4087,5247.5,1514.0,583.8571428571429
323637.0,17,4,1400,4,1400,107879.0,350.0,350.0,0,0,0.0,0.0,0.0
90306202.0,6,17,1287,9,691,11282179.75,95.0,76.77777777777777,8,596,12900460.0,95.0,74.5
215464.0,6,3,426,2,280,0.0,214.0,140.0,1,146,0.0,146.0,146.0
113506814.0,6,48,3168,24,1584,4935078.869565218,66.0,66.0,24,1584,4923231.043478261,66.0,66.0
103200225.0,6,42,2772,21,1386,5159998.15,66.0,66.0,21,1386,5159998.35,66.0,66.0
280386.0,6,10,1221,6,636,56077.2,298.0,106.0,4,585,87986.0,379.0,146.25
298793.0,6,2,138,1,68,0.0,68.0,68.0,1,70,0.0,70.0,70.0
2803685.0,6,2,132,1,66,0.0,66.0,66.0,1,66,0.0,66.0,66.0
1172862.0,6,13,3000,8,2372,167551.7142857143,1514.0,296.5,5,628,224297.25,331.0,125.6
94766957.0,17,14,4796,13,4446,6230462.75,342.0,342.0,1,350,0.0,350.0,350.0
302426.0,6,2,132,1,66,0.0,66.0,66.0,1,66,0.0,66.0,66.0
273991.0,6,10,1221,6,636,54798.2,298.0,106.0,4,585,84325.0,379.0,146.25
22105.0,6,11,1133,6,602,3103.0,264.0,100.33333333333331,5,531,4469.25,259.0,106.2
118032258.0,6,30,1974,15,1026,8415469.714285715,123.0,68.4,15,948,8415469.5,123.0,63.2
91184.0,6,2,132,1,66,0.0,66.0,66.0,1,66,0.0,66.0,66.0
146102.0,6,3,337,2,214,0.0,160.0,107.0,1,123,0.0,123.0,123.0
27423.0,6,10,1066,5,490,5549.75,218.0,98.0,5,576,6651.0,304.0,115.2
125.0,17,2,762,2,762,0.0,381.0,381.0,0,0,0.0,0.0,0.0
110976393.0,6,34,2482,17,1288,6922570.3125,139.0,75.76470588235294,17,1194,6922571.1875,123.0,70.23529411764706
153528.0,17,2,180,1,90,0.0,90.0,90.0,1,90,0.0,90.0,90.0
2317.0,17,4,344,2,150,0.0,75.0,75.0,2,194,0.0,103.0,97.0
108111204.0,17,5,955,5,955,27027801.0,191.0,191.0,0,0,0.0,0.0,0.0
284971.0,17,2,363,1,79,0.0,79.0,79.0,1,284,0.0,284.0,284.0
2282.0,17,4,344,2,150,0.0,75.0,75.0,2,194,0.0,103.0,97.0
93409976.0,17,12,778,6,389,18650204.0,174.0,64.83333333333333,6,389,18455111.8,174.0,64.83333333333333
112412718.0,6,292,35836,146,9858,769559.2620689655,140.0,67.52054794520548,146,25978,774378.2413793104,390.0,177.93150684931507
54274.0,6,14,4740,7,653,8877.5,249.0,93.28571428571428,7,4087,8867.666666666666,1514.0,583.8571428571429
13083.0,6,13,1459,7,862,1999.0,271.0,123.14285714285714,6,597,2406.2,259.0,99.5
97452260.0,17,12,778,6,389,19400682.8,174.0,64.83333333333333,6,389,19400168.2,174.0,64.83333333333333
31286657.0,6,7,1874,3,887,15568533.0,753.0,295.6666666666667,4,987,10382800.333333334,785.0,246.75
349.0,17,2,174,1,79,0.0,79.0,79.0,1,95,0.0,95.0,95.0
39793.0,6,14,4740,7,653,6473.833333333333,249.0,93.28571428571428,7,4087,6459.333333333333,1514.0,583.8571428571429
3380884.0,17,3,1026,3,1026,1690442.0,342.0,342.0,0,0,0.0,0.0,0.0
318967.0,17,4,1400,4,1400,106322.33333333331,350.0,350.0,0,0,0.0,0.0,0.0
35474.0,6,14,4740,7,653,5685.333333333333,249.0,93.28571428571428,7,4087,5426.333333333333,1514.0,583.8571428571429
118366355.0,6,34,2334,17,1209,7384394.4375,123.0,71.11764705882354,17,1125,7384395.9375,123.0,66.17647058823529
4998769.0,17,4,849,2,166,0.0,83.0,83.0,2,683,0.0,499.0,341.5
143322.0,6,2,132,1,66,0.0,66.0,66.0,1,66,0.0,66.0,66.0
29983.0,6,14,4740,7,653,4838.0,249.0,93.28571428571428,7,4087,4859.333333333333,1514.0,583.8571428571429
332404.0,6,10,1221,6,636,66480.8,298.0,106.0,4,585,105371.33333333331,379.0,146.25
92842592.0,6,177,19900,89,13870,1055029.4545454546,284.0,155.8426966292135,88,6030,1055415.8505747127,140.0,68.52272727272727
114690749.0,6,211,23786,106,7292,1092292.8476190476,140.0,68.79245283018868,105,16494,1100307.826923077,284.0,157.0857142857143
90539476.0,6,15,2444,8,1016,12934210.857142856,188.0,127.0,7,1428,15062601.666666666,204.0,204.0
120311260.0,6,208,23552,104,7086,1160061.786407767,140.0,68.13461538461539,104,16466,1160190.2718446602,284.0,158.32692307692307
327.0,17,2,208,1,72,0.0,72.0,72.0,1,136,0.0,136.0,136.0
612261.0,17,3,551,2,156,0.0,78.0,78.0,1,395,0.0,395.0,395.0
284792.0,17,2,363,1,79,0.0,79.0,79.0,1,284,0.0,284.0,284.0
3051409.0,6,3,204,2,136,0.0,70.0,68.0,1,68,0.0,68.0,68.0
208418.0,6,3,426,2,280,0.0,214.0,140.0,1,146,0.0,146.0,146.0
135129235.0,17,6,1146,6,1146,27025847.0,191.0,191.0,0,0,0.0,0.0,0.0
232860.0,6,3,337,2,214,0.0,160.0,107.0,1,123,0.0,123.0,123.0
315702.0,17,4,1400,4,1400,105234.0,350.0,350.0,0,0,0.0,0.0,0.0
232162.0,6,3,337,2,214,0.0,160.0,107.0,1,123,0.0,123.0,123.0
136197.0,6,2,132,1,66,0.0,66.0,66.0,1,66,0.0,66.0,66.0
12565.0,17,2,539,1,86,0.0,86.0,86.0,1,453,0.0,453.0,453.0
307689.0,6,6,412,4,272,102563.0,74.0,68.0,2,140,0.0,74.0,70.0
121402.0,6,3,337,2,214,0.0,160.0,107.0,1,123,0.0,123.0,123.0
873892.0,6,9,1268,6,797,174778.4,459.0,132.83333333333334,3,471,299101.0,331.0,157.0
299055.0,6,6,412,4,272,99685.0,74.0,68.0,2,140,0.0,74.0,70.0
818.0,17,4,438,2,148,0.0,74.0,74.0,2,290,0.0,147.0,145.0
1041854.0,6,13,1394,7,797,173642.33333333334,253.0,113.85714285714286,6,597,205726.6,259.0,99.5
14945.0,6,14,4740,7,653,2372.333333333333,249.0,93.28571428571428,7,4087,2353.0,1514.0,583.8571428571429
7648.0,17,2,582,1,83,0.0,83.0,83.0,1,499,0.0,499.0,499.0
119991.0,17,2,180,1,70,0.0,70.0,70.0,1,110,0.0,110.0,110.0
109310242.0,6,28,1860,14,966,8391864.0,123.0,69.0,14,894,8391861.76923077,123.0,63.85714285714285
90030482.0,17,28,13364,28,13364,3334462.296296296,501.0,477.2857142857143,0,0,0.0,0.0,0.0
108105120.0,17,5,1005,5,1005,27026280.0,201.0,201.0,0,0,0.0,0.0,0.0
153341.0,17,2,180,1,90,0.0,90.0,90.0,1,90,0.0,90.0,90.0
147938.0,17,2,180,1,90,0.0,90.0,90.0,1,90,0.0,90.0,90.0
1166252.0,6,13,3002,8,2374,166607.42857142858,1514.0,296.75,5,628,223417.5,331.0,125.6
232889.0,6,3,337,2,214,0.0,160.0,107.0,1,123,0.0,123.0,123.0
225858.0,6,3,426,2,280,0.0,214.0,140.0,1,146,0.0,146.0,146.0
120217939.0,6,282,32072,141,9602,852833.7642857142,140.0,68.09929078014184,141,22470,854101.5714285715,284.0,159.36170212765958
108105012.0,17,5,955,5,955,27026253.0,191.0,191.0,0,0,0.0,0.0,0.0
1850.0,17,4,344,2,150,0.0,75.0,75.0,2,194,0.0,103.0,97.0
196791.0,17,2,180,1,90,0.0,90.0,90.0,1,90,0.0,90.0,90.0
2594251.0,6,3,1777,1,826,0.0,826.0,826.0,2,951,0.0,885.0,475.5
0.0,17,1,44,1,44,0.0,44.0,44.0,0,0,0.0,0.0,0.0
404.0,17,2,410,1,78,0.0,78.0,78.0,1,332,0.0,332.0,332.0
7925.0,6,10,2032,5,524,1690.75,252.0,104.8,5,1508,1665.5,1236.0,301.6
285859.0,17,4,1524,4,1524,95286.33333333331,381.0,381.0,0,0,0.0,0.0,0.0
117844629.0,6,29,1914,15,948,8417473.5,123.0,63.2,14,966,8280138.307692308,123.0,69.0
90259258.0,6,12,1832,8,1016,12894179.714285716,188.0,127.0,4,816,30031387.33333333,204.0,204.0
206084.0,17,2,180,1,90,0.0,90.0,90.0,1,90,0.0,90.0,90.0
2809011.0,6,2,132,1,66,0.0,66.0,66.0,1,66,0.0,66.0,66.0
294853.0,6,10,1221,6,636,58970.6,298.0,106.0,4,585,92500.66666666669,379.0,146.25
167505.0,17,2,180,1,90,0.0,90.0,90.0,1,90,0.0,90.0,90.0
92359272.0,17,12,778,6,389,18440069.8,174.0,64.83333333333333,6,389,18434651.2,174.0,64.83333333333333
812.0,17,4,438,2,148,0.0,74.0,74.0,2,290,0.0,147.0,145.0
123455631.0,6,48,3168,24,1584,5099981.652173913,66.0,66.0,24,1584,5167855.652173913,66.0,66.0
120071921.0,6,210,23954,105,7226,1148665.0,140.0,68.81904761904762,105,16728,1146622.9038461538,374.0,159.31428571428572
302985.0,6,6,412,4,272,100995.0,74.0,68.0,2,140,0.0,74.0,70.0
2279.0,17,4,344,2,150,0.0,75.0,75.0,2,194,0.0,103.0,97.0
205146.0,17,2,180,1,90,0.0,90.0,90.0,1,90,0.0,90.0,90.0
2590640.0,6,2,132,1,66,0.0,66.0,66.0,1,66,0.0,66.0,66.0
123839970.0,6,49,3234,25,1650,5159998.75,66.0,66.0,24,1584,5107842.434782608,66.0,66.0
60292.0,6,14,4740,7,653,9310.166666666666,249.0,93.28571428571428,7,4087,9838.833333333334,1514.0,583.8571428571429
135127992.0,17,6,1146,6,1146,27025598.4,191.0,191.0,0,0,0.0,0.0,0.0
2472.0,17,4,344,2,150,0.0,75.0,75.0,2,194,0.0,103.0,97.0
24145.0,6,14,4740,7,653,3867.3333333333335,249.0,93.28571428571428,7,4087,3844.6666666666665,1514.0,583.8571428571429
35208.0,6,14,4740,7,653,5677.166666666667,249.0,93.28571428571428,7,4087,5722.166666666667,1514.0,583.8571428571429
2012.0,17,4,344,2,150,0.0,75.0,75.0,2,194,0.0,103.0,97.0
90099237.0,6,12,1848,5,1020,22522859.0,204.0,204.0,7,828,15015457.166666666,188.0,118.28571428571428
40417.0,6,14,4740,7,653,5915.666666666667,249.0,93.28571428571428,7,4087,6339.666666666667,1514.0,583.8571428571429
2565125.0,6,25,7573,14,3735,197317.3076923077,1514.0,266.7857142857143,11,3838,230573.5,1514.0,348.90909090909093
128547.0,6,2,132,1,66,0.0,66.0,66.0,1,66,0.0,66.0,66.0
90301125.0,6,16,1192,8,596,12894220.857142856,95.0,74.5,8,596,12898377.285714284,95.0,74.5
4230.0,17,4,344,2,150,0.0,75.0,75.0,2,194,0.0,103.0,97.0
120126083.0,6,14,2224,9,1204,15015760.375,188.0,133.77777777777777,5,1020,22592148.0,204.0,204.0
9148.0,17,2,539,1,86,0.0,86.0,86.0,1,453,0.0,453.0,453.0
216268.0,17,2,180,1,90,0.0,90.0,90.0,1,90,0.0,90.0,90.0
153505.0,17,2,180,1,90,0.0,90.0,90.0,1,90,0.0,90.0,90.0
120284962.0,6,220,24756,110,7556,1095802.3394495412,140.0,68.69090909090909,110,17200,1097089.256880734,284.0,156.36363636363637
206214.0,6,3,426,2,280,0.0,214.0,140.0,1,146,0.0,146.0,146.0
5969.0,17,2,415,1,84,0.0,84.0,84.0,1,331,0.0,331.0,331.0
3008851.0,6,11,2106,6,598,601554.8,252.0,99.66666666666669,5,1508,1956.5,1236.0,301.6
90289285.0,6,16,1192,8,596,12891650.714285716,95.0,74.5,8,596,12898010.42857143,95.0,74.5
108117825.0,17,5,1005,5,1005,27029456.25,201.0,201.0,0,0,0.0,0.0,0.0
109639.0,6,2,132,1,66,0.0,66.0,66.0,1,66,0.0,66.0,66.0
299823.0,6,6,412,4,272,99941.0,74.0,68.0,2,140,0.0,74.0,70.0
65433.00000000001,6,14,4740,7,653,10674.333333333334,249.0,93.28571428571428,7,4087,10771.5,1514.0,583.8571428571429
108101253.0,17,5,1005,5,1005,27025313.25,201.0,201.0,0,0,0.0,0.0,0.0
4602497.0,6,5,336,2,134,0.0,68.0,67.0,3,202,1523903.0,70.0,67.33333333333333
1338.0,17,5,550,5,550,334.5,110.0,110.0,0,0,0.0,0.0,0.0
90064095.0,17,28,13364,28,13364,3335707.222222222,501.0,477.2857142857143,0,0,0.0,0.0,0.0
4230.0,17,2,762,2,762,0.0,381.0,381.0,0,0,0.0,0.0,0.0
205106.0,17,2,762,2,762,0.0,381.0,381.0,0,0,0.0,0.0,0.0
121160461.0,6,230,26174,115,7886,1037491.754385965,140.0,68.57391304347826,115,18288,1055601.1315789474,284.0,159.02608695652174
103106.0,17,2,286,2,286,0.0,143.0,143.0,0,0,0.0,0.0,0.0
91424835.0,6,22,1680,12,935,8310684.909090909,95.0,77.91666666666667,10,745,10157633.0,95.0,74.5
135129372.0,17,6,1146,6,1146,27025874.4,191.0,191.0,0,0,0.0,0.0,0.0
120122010.0,6,14,2008,6,928,24024402.0,199.0,154.66666666666666,8,1080,17136971.57142857,204.0,135.0
24433.0,6,14,4740,7,653,3962.3333333333335,249.0,93.28571428571428,7,4087,3759.1666666666665,1514.0,583.8571428571429
178308.0,17,4,1400,4,1400,59436.0,350.0,350.0,0,0,0.0,0.0,0.0
1239828.0,17,7,490,7,490,206638.0,70.0,70.0,0,0,0.0,0.0,0.0
90251984.0,6,12,1832,8,1016,12893140.57142857,188.0,127.0,4,816,30030293.33333333,204.0,204.0
53253.0,6,13,1386,7,789,8223.833333333334,253.0,112.71428571428572,6,597,8280.0,259.0,99.5
90075697.0,17,28,13364,28,13364,3336136.925925926,501.0,477.2857142857143,0,0,0.0,0.0,0.0
250630.00000000003,6,3,373,2,238,0.0,172.0,119.0,1,135,0.0,135.0,135.0
338055.0,17,2,498,1,80,0.0,80.0,80.0,1,418,0.0,418.0,418.0
21007.0,6,14,4740,7,653,3378.833333333333,249.0,93.28571428571428,7,4087,3328.833333333333,1514.0,583.8571428571429
120024773.0,6,26,1978,14,1084,9230762.076923076,95.0,77.42857142857143,12,894,10910248.0,95.0,74.5
153513.0,17,2,180,1,90,0.0,90.0,90.0,1,90,0.0,90.0,90.0
14996.0,6,2,145,2,145,0.0,91.0,72.5,0,0,0.0,0.0,0.0
871533.0,6,9,1269,6,798,174306.6,460.0,133.0,3,471,297895.5,331.0,157.0
108104872.0,17,5,1005,5,1005,27026218.0,201.0,201.0,0,0,0.0,0.0,0.0
90259394.0,6,12,1832,8,1016,12894199.142857144,188.0,127.0,4,816,30031271.33333333,204.0,204.0
108395678.0,6,32,2220,16,1149,7226378.533333333,123.0,71.8125,16,1071,7211933.2,123.0,66.9375
135138223.0,17,6,1146,6,1146,27027644.6,191.0,191.0,0,0,0.0,0.0,0.0
150874.0,6,13,1394,7,797,25145.666666666668,253.0,113.85714285714286,6,597,28913.4,259.0,99.5
2313.0,17,4,344,2,150,0.0,75.0,75.0,2,194,0.0,103.0,97.0
110982582.0,6,34,2482,17,1288,6923630.0,139.0,75.76470588235294,17,1194,6923505.5625,123.0,70.23529411764706
71722.0,6,14,4740,7,653,11520.333333333334,249.0,93.28571428571428,7,4087,11716.5,1514.0,583.8571428571429
216462.0,6,12,1373,7,714,36077.0,298.0,102.0,5,659,52624.75,379.0,131.8
90026953.0,17,28,13364,28,13364,3334331.592592593,501.0,477.2857142857143,0,0,0.0,0.0,0.0
5005785.0,17,4,849,2,166,0.0,83.0,83.0,2,683,0.0,499.0,341.5
302385.0,6,6,412,4,272,100795.0,74.0,68.0,2,140,0.0,74.0,70.0
128339594.0,6,31,2034,16,1086,8555972.933333334,123.0,67.875,15,948,8438381.142857144,123.0,63.2
127702386.0,6,35,2410,18,1285,7511905.05882353,139.0,71.38888888888889,17,1125,7343700.6875,123.0,66.17647058823529
48658.0,6,14,4740,7,653,7983.0,249.0,93.28571428571428,7,4087,7610.0,1514.0,583.8571428571429
96237489.0,6,210,23960,105,16796,923291.7019230768,284.0,159.96190476190475,105,7164,923291.528846154,140.0,68.22857142857143
228397.0,17,2,180,1,90,0.0,90.0,90.0,1,90,0.0,90.0,90.0
46726.0,6,14,4740,7,653,7535.666666666667,249.0,93.28571428571428,7,4087,7167.833333333333,1514.0,583.8571428571429
108249523.0,6,28,1876,14,982,8310268.692307692,139.0,70.14285714285714,14,894,8310270.846153846,123.0,63.85714285714285
365422.0,6,11,1021,6,444,49309.8,162.0,74.0,5,577,61467.5,349.0,115.4
848789.0,6,9,1096,6,625,169757.8,287.0,104.16666666666669,3,471,286614.5,331.0,157.0
11798.0,17,4,823,2,163,0.0,89.0,81.5,2,660,0.0,443.0,330.0
143831.0,17,2,180,1,90,0.0,90.0,90.0,1,90,0.0,90.0,90.0
105234869.0,6,43,2838,22,1452,5011172.619047619,66.0,66.0,21,1386,5159990.95,66.0,66.0
108112019.0,17,5,955,5,955,27028004.75,191.0,191.0,0,0,0.0,0.0,0.0
302311.0,6,6,412,4,272,100770.33333333331,74.0,68.0,2,140,0.0,74.0,70.0
119836.0,17,2,180,1,70,0.0,70.0,70.0,1,110,0.0,110.0,110.0
2994878.0,17,2,906,2,906,0.0,453.0,453.0,0,0,0.0,0.0,0.0
750.0,17,4,438,2,148,0.0,74.0,74.0,2,290,0.0,147.0,145.0
146313.0,6,3,337,2,214,0.0,160.0,107.0,1,123,0.0,123.0,123.0
3209446.0,6,3,1604,1,753,0.0,753.0,753.0,2,851,0.0,785.0,425.5
16812.0,6,11,2098,6,590,3133.8,252.0,98.33333333333331,5,1508,3434.75,1236.0,301.6
0.0,17,1,342,1,342,0.0,342.0,342.0,0,0,0.0,0.0,0.0
345.0,17,2,267,1,83,0.0,83.0,83.0,1,184,0.0,184.0,184.0
130437.0,6,3,337,2,214,0.0,160.0,107.0,1,123,0.0,123.0,123.0
18188.0,6,2,145,2,145,0.0,91.0,72.5,0,0,0.0,0.0,0.0
120674074.0,6,230,25850,115,7886,1042572.1403508772,140.0,68.57391304347826,115,17964,1056162.0438596492,284.0,156.2086956521739
96956176.0,17,14,1126,7,563,16159362.666666666,174.0,80.42857142857143,7,563,16086513.833333334,174.0,80.42857142857143
304387.0,6,6,412,4,272,101462.33333333331,74.0,68.0,2,140,0.0,74.0,70.0
112815.0,17,2,286,2,286,0.0,143.0,143.0,0,0,0.0,0.0,0.0
31700.0,6,10,2032,5,524,7693.0,252.0,104.8,5,1508,7685.25,1236.0,301.6
120058739.0,17,28,13364,28,13364,4446619.962962963,501.0,477.2857142857143,0,0,0.0,0.0,0.0
90533941.0,6,15,2444,8,1016,12933420.142857144,188.0,127.0,7,1428,15059840.5,204.0,204.0
2803618.0,6,2,132,1,66,0.0,66.0,66.0,1,66,0.0,66.0,66.0
46279.0,6,13,1394,7,797,7198.0,253.0,113.85714285714286,6,597,7943.6,259.0,99.5
310361.0,17,4,1400,4,1400,103453.66666666669,350.0,350.0,0,0,0.0,0.0,0.0
303636.0,6,2,132,1,66,0.0,66.0,66.0,1,66,0.0,66.0,66.0
52970.0,6,14,4740,7,653,8709.5,249.0,93.28571428571428,7,4087,8338.0,1514.0,583.8571428571429
101000953.0,17,13,821,7,432,16833492.166666668,174.0,61.71428571428572,6,389,16200930.2,174.0,64.83333333333333
90051307.0,17,27,12943,27,12943,3463511.8076923075,501.0,479.3703703703704,0,0,0.0,0.0,0.0
312103.0,17,4,622,4,622,104034.33333333331,163.0,155.5,0,0,0.0,0.0,0.0
2030.0,17,4,344,2,150,0.0,75.0,75.0,2,194,0.0,103.0,97.0
2463.0,17,4,344,2,150,0.0,75.0,75.0,2,194,0.0,103.0,97.0
305710.0,6,6,412,4,272,101903.33333333331,74.0,68.0,2,140,0.0,74.0,70.0
10476905.0,6,6,412,3,206,5170391.5,74.0,68.66666666666667,3,206,5170225.0,74.0,68.66666666666667
308.0,17,2,174,1,79,0.0,79.0,79.0,1,95,0.0,95.0,95.0
241964.0,6,3,337,2,214,0.0,160.0,107.0,1,123,0.0,123.0,123.0
301.0,17,2,174,1,79,0.0,79.0,79.0,1,95,0.0,95.0,95.0
38201164.0,6,26,7627,14,3735,211140.2307692308,1514.0,266.7857142857143,12,3892,3453134.8181818184,1514.0,324.3333333333333
135125838.0,17,6,1146,6,1146,27025167.6,191.0,191.0,0,0,0.0,0.0,0.0
310974.0,17,4,1400,4,1400,103658.0,350.0,350.0,0,0,0.0,0.0,0.0
155483.0,6,3,337,2,214,0.0,160.0,107.0,1,123,0.0,123.0,123.0
233300.0,6,3,337,2,214,0.0,160.0,107.0,1,123,0.0,123.0,123.0
121714.0,17,4,1524,4,1524,40571.333333333336,381.0,381.0,0,0,0.0,0.0,0.0
2798826.0,6,2,132,1,66,0.0,66.0,66.0,1,66,0.0,66.0,66.0
53291.0,6,14,4740,7,653,8725.0,249.0,93.28571428571428,7,4087,8729.5,1514.0,583.8571428571429
43934.0,6,14,4740,7,653,6639.0,249.0,93.28571428571428,7,4087,6862.0,1514.0,583.8571428571429
153843.0,17,2,180,1,90,0.0,90.0,90.0,1,90,0.0,90.0,90.0
298094.0,6,6,412,4,272,99364.66666666669,74.0,68.0,2,140,0.0,74.0,70.0
34337.0,6,14,4740,7,653,5482.666666666667,249.0,93.28571428571428,7,4087,5052.333333333333,1514.0,583.8571428571429
36809.0,6,14,4740,7,653,5951.333333333333,249.0,93.28571428571428,7,4087,5614.0,1514.0,583.8571428571429
2274.0,17,4,344,2,150,0.0,75.0,75.0,2,194,0.0,103.0,97.0
82206360.0,17,10,3428,9,3078,7514900.5,342.0,342.0,1,350,0.0,350.0,350.0
86898.0,6,14,4740,7,653,14271.833333333334,249.0,93.28571428571428,7,4087,14173.5,1514.0,583.8571428571429
334.0,17,2,166,1,75,0.0,75.0,75.0,1,91,0.0,91.0,91.0
120084413.0,17,29,13785,29,13785,4288729.035714285,501.0,475.3448275862069,0,0,0.0,0.0,0.0
228082.0,17,2,180,1,90,0.0,90.0,90.0,1,90,0.0,90.0,90.0
52498.0,6,10,2032,5,524,11548.75,252.0,104.8,5,1508,12582.75,1236.0,301.6
16354.0,6,14,4740,7,653,2601.0,249.0,93.28571428571428,7,4087,2590.1666666666665,1514.0,583.8571428571429
327.0,17,2,174,1,79,0.0,79.0,79.0,1,95,0.0,95.0,95.0
323.0,17,2,174,1,79,0.0,79.0,79.0,1,95,0.0,95.0,95.0
44388.0,6,14,4740,7,653,7268.333333333333,249.0,93.28571428571428,7,4087,7258.0,1514.0,583.8571428571429
319239.0,6,6,412,4,272,106413.0,74.0,68.0,2,140,0.0,74.0,70.0
103793.0,17,2,286,2,286,0.0,143.0,143.0,0,0,0.0,0.0,0.0
135128846.0,17,6,1146,6,1146,27025769.2,191.0,191.0,0,0,0.0,0.0,0.0
10514730.0,6,7,478,4,272,3459561.333333333,74.0,68.0,3,206,5189212.5,74.0,68.66666666666667
90062391.0,17,28,13364,28,13364,3335644.111111111,501.0,477.2857142857143,0,0,0.0,0.0,0.0
119169166.0,6,234,26528,117,18510,1025465.4137931034,284.0,158.2051282051282,117,8018,1025465.75,140.0,68.52991452991454
2493680.0,6,3,204,2,136,0.0,70.0,68.0,1,68,0.0,68.0,68.0
10465848.0,6,7,478,4,272,3441561.333333333,74.0,68.0,3,206,5162250.0,74.0,68.66666666666667
15737.999999999998,17,4,344,2,150,0.0,75.0,75.0,2,194,0.0,103.0,97.0
5627392.0,6,4,270,2,134,0.0,68.0,67.0,2,136,0.0,70.0,68.0
153467.0,17,2,180,1,90,0.0,90.0,90.0,1,90,0.0,90.0,90.0
120020936.0,6,21,1585,11,840,11999987.0,95.0,76.36363636363636,10,745,13335385.333333334,95.0,74.5
5005504.0,17,4,849,2,166,0.0,83.0,83.0,2,683,0.0,499.0,341.5
90526331.0,6,14,2240,8,1016,12932333.0,188.0,127.0,6,1224,18072376.8,204.0,204.0
298406.0,6,6,412,4,272,99468.66666666669,74.0,68.0,2,140,0.0,74.0,70.0
28854.0,6,14,4740,7,653,4687.833333333333,249.0,93.28571428571428,7,4087,4454.666666666667,1514.0,583.8571428571429
39109.0,6,14,4740,7,653,6333.833333333333,249.0,93.28571428571428,7,4087,6378.333333333333,1514.0,583.8571428571429
10470726.0,6,6,412,3,206,5167768.0,74.0,68.66666666666667,3,206,5167669.0,74.0,68.66666666666667
10501694.0,6,6,412,3,206,5182669.5,74.0,68.66666666666667,3,206,5182535.0,74.0,68.66666666666667
108108712.0,17,5,955,5,955,27027178.0,191.0,191.0,0,0,0.0,0.0,0.0
102897684.0,6,30,2106,15,1089,7334415.428571428,123.0,72.6,15,1017,7334392.642857143,123.0,67.8
28068.0,6,10,1065,5,534,6648.75,262.0,106.8,5,531,6713.0,259.0,106.2
145767.0,6,3,373,2,238,0.0,172.0,119.0,1,135,0.0,135.0,135.0
108099464.0,17,5,955,5,955,27024866.0,191.0,191.0,0,0,0.0,0.0,0.0
3047141.0,6,3,204,2,136,0.0,70.0,68.0,1,68,0.0,68.0,68.0
307924.0,6,6,412,4,272,102641.33333333331,74.0,68.0,2,140,0.0,74.0,70.0
144057.0,17,2,180,1,90,0.0,90.0,90.0,1,90,0.0,90.0,90.0
232350.0,6,3,373,2,238,0.0,172.0,119.0,1,135,0.0,135.0,135.0
44119.0,6,10,2032,5,524,8755.25,252.0,104.8,5,1508,10300.5,1236.0,301.6
90661803.0,6,16,2368,9,1204,11316985.125,188.0,133.77777777777777,7,1164,15083669.833333334,204.0,166.28571428571428
127847.0,6,12,1328,7,797,21307.83333333333,253.0,113.85714285714286,5,531,27263.75,259.0,106.2
303679.0,6,2,132,1,66,0.0,66.0,66.0,1,66,0.0,66.0,66.0
335.0,17,2,166,1,75,0.0,75.0,75.0,1,91,0.0,91.0,91.0
90261876.0,6,12,1832,8,1016,12894553.714285716,188.0,127.0,4,816,30031116.33333333,204.0,204.0
209803.0,6,3,426,2,280,0.0,214.0,140.0,1,146,0.0,146.0,146.0
107625488.0,17,14,864,7,432,17834257.5,174.0,61.71428571428572,7,432,17833501.333333332,174.0,61.71428571428572
1064938.0,6,3,204,2,136,0.0,70.0,68.0,1,68,0.0,68.0,68.0
102703.0,17,2,762,2,762,0.0,381.0,381.0,0,0,0.0,0.0,0.0
216752.0,6,3,426,2,280,0.0,214.0,140.0,1,146,0.0,146.0,146.0
135135489.0,17,6,1146,6,1146,27027097.8,191.0,191.0,0,0,0.0,0.0,0.0
207151.0,6,3,426,2,280,0.0,214.0,140.0,1,146,0.0,146.0,146.0
120080156.0,17,29,13785,29,13785,4288577.0,501.0,475.3448275862069,0,0,0.0,0.0,0.0
29793.0,6,14,4740,7,653,4784.333333333333,249.0,93.28571428571428,7,4087,4779.333333333333,1514.0,583.8571428571429
120170505.0,6,242,28248,121,8220,998369.725,140.0,67.93388429752066,121,20028,994530.5666666668,390.0,165.5206611570248
108104551.0,17,5,1005,5,1005,27026137.75,201.0,201.0,0,0,0.0,0.0,0.0
467830.0,17,2,363,1,75,0.0,75.0,75.0,1,288,0.0,288.0,288.0
216521.0,17,2,180,1,90,0.0,90.0,90.0,1,90,0.0,90.0,90.0
243510.0,6,3,337,2,214,0.0,160.0,107.0,1,123,0.0,123.0,123.0
50543.0,6,14,4740,7,653,8298.833333333334,249.0,93.28571428571428,7,4087,8247.0,1514.0,583.8571428571429
366.0,17,2,267,1,83,0.0,83.0,83.0,1,184,0.0,184.0,184.0
9839.0,17,2,571,1,86,0.0,86.0,86.0,1,485,0.0,485.0,485.0
230635.0,6,13,1394,7,797,38439.16666666666,253.0,113.85714285714286,6,597,42189.0,259.0,99.5
43079.0,6,10,2032,5,524,10499.75,252.0,104.8,5,1508,9397.25,1236.0,301.6
331132.0,6,6,412,4,272,110377.33333333331,74.0,68.0,2,140,0.0,74.0,70.0
325662.0,6,5,367,3,235,162831.0,103.0,78.33333333333333,2,132,0.0,66.0,66.0
228403.0,17,2,180,1,90,0.0,90.0,90.0,1,90,0.0,90.0,90.0
90744157.0,6,17,1287,8,637,12963451.0,95.0,79.625,9,650,11306197.875,95.0,72.22222222222223
105323459.0,6,28,1860,14,966,8085187.846153846,123.0,69.0,14,894,8085183.615384615,123.0,63.85714285714285
5821846.0,6,5,336,2,134,0.0,68.0,67.0,3,202,1524433.0,70.0,67.33333333333333
10778.0,6,10,2032,5,524,2464.25,252.0,104.8,5,1508,2418.5,1236.0,301.6
613898.0,17,2,346,1,78,0.0,78.0,78.0,1,268,0.0,268.0,268.0
90024363.0,17,28,13364,28,13364,3334235.6666666665,501.0,477.2857142857143,0,0,0.0,0.0,0.0
4364.0,17,2,614,1,72,0.0,72.0,72.0,1,542,0.0,542.0,542.0
64256.99999999999,6,14,4740,7,653,10585.5,249.0,93.28571428571428,7,4087,10548.333333333334,1514.0,583.8571428571429
155777.0,6,3,337,2,214,0.0,160.0,107.0,1,123,0.0,123.0,123.0
90062228.0,17,27,12943,27,12943,3463931.846153846,501.0,479.3703703703704,0,0,0.0,0.0,0.0
120024494.0,6,528,81096,264,63302,455548.3117870722,1514.0,239.78030303030303,264,17794,455543.2851711027,214.0,67.40151515151516
69038.0,6,14,4740,7,653,11350.5,249.0,93.28571428571428,7,4087,10387.166666666666,1514.0,583.8571428571429
9121.0,6,10,2032,5,524,2007.5,252.0,104.8,5,1508,2046.25,1236.0,301.6
128737516.0,6,34,2350,17,1125,7421817.375,123.0,66.17647058823529,17,1225,7421813.5,139.0,72.05882352941177
2442.0,17,4,344,2,150,0.0,75.0,75.0,2,194,0.0,103.0,97.0
321500.0,17,4,1400,4,1400,107166.66666666669,350.0,350.0,0,0,0.0,0.0,0.0
298799.0,6,6,412,4,272,99599.66666666669,74.0,68.0,2,140,0.0,74.0,70.0
10469912.0,6,7,478,4,272,3444653.333333333,74.0,68.0,3,206,5166857.0,74.0,68.66666666666667
43083.0,6,10,2032,5,524,9866.25,252.0,104.8,5,1508,10160.25,1236.0,301.6
103705.0,17,2,762,2,762,0.0,381.0,381.0,0,0,0.0,0.0,0.0
1797345.0,6,2,132,1,66,0.0,66.0,66.0,1,66,0.0,66.0,66.0
2599978.0,6,2,132,1,66,0.0,66.0,66.0,1,66,0.0,66.0,66.0
121936333.0,17,14,995,7,563,17002889.0,174.0,80.42857142857143,7,432,17001106.333333332,174.0,61.71428571428572
312548.0,17,4,1400,4,1400,104182.66666666669,350.0,350.0,0,0,0.0,0.0,0.0
207391.0,6,3,426,2,280,0.0,214.0,140.0,1,146,0.0,146.0,146.0
153356.0,17,2,180,1,90,0.0,90.0,90.0,1,90,0.0,90.0,90.0
120059.0,17,2,180,1,70,0.0,70.0,70.0,1,110,0.0,110.0,110.0
28330.0,6,14,4740,7,653,4600.666666666667,249.0,93.28571428571428,7,4087,4551.666666666667,1514.0,583.8571428571429
348.0,17,2,267,1,83,0.0,83.0,83.0,1,184,0.0,184.0,184.0
0.0,6,1,54,1,54,0.0,54.0,54.0,0,0,0.0,0.0,0.0
393.0,17,2,166,1,75,0.0,75.0,75.0,1,91,0.0,91.0,91.0
2100137.0,6,24,7545,12,2450,190921.54545454544,1034.0,204.16666666666663,12,5095,163188.18181818182,1510.0,424.5833333333333
209623.0,17,2,180,1,90,0.0,90.0,90.0,1,90,0.0,90.0,90.0
46723.0,6,10,2032,5,524,9960.25,252.0,104.8,5,1508,11476.5,1236.0,301.6
135137487.0,17,6,1146,6,1146,27027497.4,191.0,191.0,0,0,0.0,0.0,0.0
1033342.0,6,11,1134,6,558,206668.4,220.0,93.0,5,576,255956.0,304.0,115.2
8901.0,17,2,498,1,80,0.0,80.0,80.0,1,418,0.0,418.0,418.0
17590.0,6,14,4740,7,653,2338.6666666666665,249.0,93.28571428571428,7,4087,2794.1666666666665,1514.0,583.8571428571429
99271.0,17,2,762,2,762,0.0,381.0,381.0,0,0,0.0,0.0,0.0
103476.0,17,2,286,2,286,0.0,143.0,143.0,0,0,0.0,0.0,0.0
32604.0,6,14,4740,7,653,5324.833333333333,249.0,93.28571428571428,7,4087,5300.0,1514.0,583.8571428571429
43480.0,6,2,132,1,66,0.0,66.0,66.0,1,66,0.0,66.0,66.0
135134043.0,17,6,1206,6,1206,27026808.6,201.0,201.0,0,0,0.0,0.0,0.0
2906975.0,6,12,2172,7,664,483943.0,252.0,94.85714285714286,5,1508,3859.25,1236.0,301.6
9613.0,17,2,571,1,86,0.0,86.0,86.0,1,485,0.0,485.0,485.0
238123.0,6,3,373,2,238,0.0,172.0,119.0,1,135,0.0,135.0,135.0
103182587.0,6,44,2904,22,1452,4913456.523809524,66.0,66.0,22,1452,4903161.333333333,66.0,66.0
207088.0,6,3,426,2,280,0.0,214.0,140.0,1,146,0.0,146.0,146.0
2793219.0,6,3,1777,2,951,0.0,885.0,475.5,1,826,0.0,826.0,826.0
90526432.0,6,13,2036,8,1016,12932347.42857143,188.0,127.0,5,1020,22591352.0,204.0,204.0
43178.0,6,14,4740,7,653,7082.166666666667,249.0,93.28571428571428,7,4087,6392.666666666667,1514.0,583.8571428571429
90370735.0,6,14,2256,7,1428,15060969.0,204.0,204.0,7,828,15061363.0,188.0,118.28571428571428
108104904.0,17,5,955,5,955,27026226.0,191.0,191.0,0,0,0.0,0.0,0.0
338.0,17,2,174,1,79,0.0,79.0,79.0,1,95,0.0,95.0,95.0
306793.0,6,6,412,4,272,102264.33333333331,74.0,68.0,2,140,0.0,74.0,70.0
135132275.0,17,6,1206,6,1206,27026455.0,201.0,201.0,0,0,0.0,0.0,0.0
90075555.0,17,28,13364,28,13364,3336131.6666666665,501.0,477.2857142857143,0,0,0.0,0.0,0.0
135127941.0,17,6,1206,6,1206,27025588.2,201.0,201.0,0,0,0.0,0.0,0.0
885797.0,6,12,2715,7,743,147632.83333333334,339.0,106.14285714285714,5,1972,152571.0,1514.0,394.4
3275112.0,6,148,125886,89,117691,37217.181818181816,1510.0,1322.370786516854,59,8195,51076.55172413793,1510.0,138.89830508474577
321314.0,17,4,1400,4,1400,107104.66666666669,350.0,350.0,0,0,0.0,0.0,0.0
90052093.0,17,28,13364,28,13364,3335262.703703704,501.0,477.2857142857143,0,0,0.0,0.0,0.0
313555.0,17,4,1400,4,1400,104518.33333333331,350.0,350.0,0,0,0.0,0.0,0.0
120252795.0,6,214,24202,107,7358,1127846.8773584906,140.0,68.76635514018692,107,16844,1126656.1132075472,284.0,157.42056074766356
24311.0,6,11,2098,6,590,4170.8,252.0,98.33333333333331,5,1508,5817.75,1236.0,301.6
857332.0,6,9,1096,6,625,171466.4,287.0,104.16666666666669,3,471,292296.0,331.0,157.0
93017152.0,6,38,2508,19,1254,5150437.666666667,66.0,66.0,19,1254,5150438.666666667,66.0,66.0
705.0,17,4,438,2,148,0.0,74.0,74.0,2,290,0.0,147.0,145.0
90067286.0,17,28,13364,28,13364,3335825.407407407,501.0,477.2857142857143,0,0,0.0,0.0,0.0
135133460.0,17,6,1146,6,1146,27026692.0,191.0,191.0,0,0,0.0,0.0,0.0
90022800.0,17,28,13364,28,13364,3334177.777777778,501.0,477.2857142857143,0,0,0.0,0.0,0.0
37063.0,6,10,1065,5,534,8353.5,262.0,106.8,5,531,8859.25,259.0,106.2
17828.0,6,14,4740,7,653,2720.333333333333,249.0,93.28571428571428,7,4087,2829.0,1514.0,583.8571428571429
36624.0,6,10,1065,5,534,8350.25,262.0,106.8,5,531,8421.5,259.0,106.2
196852.0,17,2,180,1,90,0.0,90.0,90.0,1,90,0.0,90.0,90.0
108108185.0,17,5,955,5,955,27027046.25,191.0,191.0,0,0,0.0,0.0,0.0
108105923.0,17,5,955,5,955,27026480.75,191.0,191.0,0,0,0.0,0.0,0.0
94672785.0,6,40,2640,20,1320,4982778.157894737,66.0,66.0,20,1320,4966918.0,66.0,66.0
108113075.0,17,5,955,5,955,27028268.75,191.0,191.0,0,0,0.0,0.0,0.0
21025.0,17,2,582,1,83,0.0,83.0,83.0,1,499,0.0,499.0,499.0
0.0,6,1,66,1,66,0.0,66.0,66.0,0,0,0.0,0.0,0.0
123416377.0,6,48,3168,24,1584,5014482.652173913,66.0,66.0,24,1584,5287082.695652174,66.0,66.0
304388.0,6,6,412,4,272,101462.66666666669,74.0,68.0,2,140,0.0,74.0,70.0
208402.0,6,3,426,2,280,0.0,214.0,140.0,1,146,0.0,146.0,146.0
35966.0,6,10,2032,5,524,8636.75,252.0,104.8,5,1508,8072.5,1236.0,301.6
108253449.0,6,193,21730,97,6624,1127640.09375,140.0,68.28865979381443,96,15106,1128539.031578947,284.0,157.35416666666666
305050.0,6,6,412,4,272,101683.33333333331,74.0,68.0,2,140,0.0,74.0,70.0
20562.0,6,10,2032,5,524,4910.25,252.0,104.8,5,1508,4909.0,1236.0,301.6
128686783.0,6,35,2743,16,1209,7922078.2,123.0,75.5625,19,1534,6594542.555555556,139.0,80.73684210526316
144022.0,17,2,180,1,90,0.0,90.0,90.0,1,90,0.0,90.0,90.0
108010531.0,17,13,821,7,432,18001755.166666668,174.0,61.71428571428572,6,389,17600164.0,174.0,64.83333333333333
36945.0,6,13,1386,7,789,5506.166666666667,253.0,112.71428571428572,6,597,7013.0,259.0,99.5
108107774.0,17,5,1005,5,1005,27026943.5,201.0,201.0,0,0,0.0,0.0,0.0
116458501.0,6,269,31538,135,9132,869093.2910447761,140.0,67.64444444444445,134,22406,867900.0601503759,374.0,167.2089552238806
919.0,17,4,438,2,148,0.0,74.0,74.0,2,290,0.0,147.0,145.0
53730.0,6,14,4740,7,653,7417.333333333333,249.0,93.28571428571428,7,4087,8049.166666666667,1514.0,583.8571428571429
460871.0,6,6,758,3,410,206547.0,172.0,136.66666666666666,3,348,170675.0,135.0,116.0
150316.0,17,4,6056,4,6056,50105.333333333336,1514.0,1514.0,0,0,0.0,0.0,0.0
320.0,17,2,174,1,79,0.0,79.0,79.0,1,95,0.0,95.0,95.0
166612.0,17,2,180,1,90,0.0,90.0,90.0,1,90,0.0,90.0,90.0
301898.0,6,6,412,4,272,100632.66666666669,74.0,68.0,2,140,0.0,74.0,70.0
119903.0,17,2,180,1,70,0.0,70.0,70.0,1,110,0.0,110.0,110.0
135131584.0,17,6,1206,6,1206,27026316.8,201.0,201.0,0,0,0.0,0.0,0.0
30249.0,6,14,4740,7,653,4886.166666666667,249.0,93.28571428571428,7,4087,4380.333333333333,1514.0,583.8571428571429
2093.0,17,4,344,2,150,0.0,75.0,75.0,2,194,0.0,103.0,97.0
314263.0,17,4,1400,4,1400,104754.33333333331,350.0,350.0,0,0,0.0,0.0,0.0
303651.0,6,2,132,1,66,0.0,66.0,66.0,1,66,0.0,66.0,66.0
301842.0,6,6,412,4,272,100614.0,74.0,68.0,2,140,0.0,74.0,70.0
90092348.0,6,11,1644,7,828,15015391.333333334,188.0,118.28571428571428,4,816,20022379.0,204.0,204.0
282036.0,6,10,1221,6,636,56407.2,298.0,106.0,4,585,87777.66666666667,379.0,146.25
29850.0,6,14,4740,7,653,4747.333333333333,249.0,93.28571428571428,7,4087,4837.333333333333,1514.0,583.8571428571429
114125837.0,6,48,3168,24,1584,4961992.913043479,66.0,66.0,24,1584,4948732.260869565,66.0,66.0
135136590.0,17,6,1206,6,1206,27027318.0,201.0,201.0,0,0,0.0,0.0,0.0
108103564.0,17,5,955,5,955,27025891.0,191.0,191.0,0,0,0.0,0.0,0.0
120086306.0,6,268,30858,134,9140,897561.7067669173,140.0,68.2089552238806,134,21718,889057.8571428572,570.0,162.07462686567163
104651.0,17,2,286,2,286,0.0,143.0,143.0,0,0,0.0,0.0,0.0
351568.0,6,3,1604,2,851,0.0,785.0,425.5,1,753,0.0,753.0,753.0
232862.0,6,3,337,2,214,0.0,160.0,107.0,1,123,0.0,123.0,123.0
120140415.0,6,13,2036,8,1016,17136657.714285713,188.0,127.0,5,1020,22528429.25,204.0,204.0
10483916.0,6,7,478,4,272,3449037.333333333,74.0,68.0,3,206,5173452.5,74.0,68.66666666666667
104281111.0,6,492,68316,246,51858,424758.2897959184,480.0,210.8048780487805,246,16458,424758.4,140.0,66.90243902439025
22633.0,6,10,1065,5,534,4206.0,262.0,106.8,5,531,5312.25,259.0,106.2
153426.0,17,2,180,1,90,0.0,90.0,90.0,1,90,0.0,90.0,90.0
108078040.0,6,195,21936,98,6764,1114206.5979381443,140.0,69.0204081632653,97,15172,1104359.6875,284.0,156.41237113402062
318.0,17,2,174,1,79,0.0,79.0,79.0,1,95,0.0,95.0,95.0
207963.0,6,3,426,2,280,0.0,214.0,140.0,1,146,0.0,146.0,146.0
135524.0,6,2,132,1,66,0.0,66.0,66.0,1,66,0.0,66.0,66.0
3692845.0,17,3,1026,3,1026,1846422.5,342.0,342.0,0,0,0.0,0.0,0.0
311298.0,17,4,622,4,622,103766.0,163.0,155.5,0,0,0.0,0.0,0.0
895845.0,6,10,1334,6,797,179169.0,459.0,132.83333333333334,4,537,207692.3333333333,331.0,134.25
2002.0,17,4,344,2,150,0.0,75.0,75.0,2,194,0.0,103.0,97.0
146062.0,6,3,337,2,214,0.0,160.0,107.0,1,123,0.0,123.0,123.0
104010.0,17,2,286,2,286,0.0,143.0,143.0,0,0,0.0,0.0,0.0
9604.0,6,10,2032,5,524,2145.0,252.0,104.8,5,1508,2071.25,1236.0,301.6
121449.0,6,3,337,2,214,0.0,160.0,107.0,1,123,0.0,123.0,123.0
3050863.0,6,3,204,2,136,0.0,70.0,68.0,1,68,0.0,68.0,68.0
121249.0,6,3,337,2,214,0.0,160.0,107.0,1,123,0.0,123.0,123.0
40245.0,6,14,4740,7,653,6529.0,249.0,93.28571428571428,7,4087,6479.0,1514.0,583.8571428571429
51524.0,6,14,4740,7,653,8153.166666666667,249.0,93.28571428571428,7,4087,7150.5,1514.0,583.8571428571429
90023197.0,17,27,12943,27,12943,3462430.653846154,501.0,479.3703703703704,0,0,0.0,0.0,0.0
41748.0,6,11,2098,6,590,8072.6,252.0,98.33333333333331,5,1508,9690.75,1236.0,301.6
2305.0,17,4,344,2,150,0.0,75.0,75.0,2,194,0.0,103.0,97.0
114806297.0,6,37,2788,19,1471,6366092.888888889,139.0,77.42105263157895,18,1317,6740622.764705882,123.0,73.16666666666667
57460.0,6,14,4740,7,653,9096.0,249.0,93.28571428571428,7,4087,9081.5,1514.0,583.8571428571429
119460675.0,6,233,26166,117,7956,1029833.4051724138,140.0,68.0,116,18210,1029668.2434782608,284.0,156.98275862068965
101506204.0,6,27,1806,14,966,7791515.461538462,123.0,69.0,13,840,8440840.416666666,123.0,64.61538461538461
304662.0,6,6,412,4,272,101554.0,74.0,68.0,2,140,0.0,74.0,70.0
12639.0,6,2,145,2,145,0.0,91.0,72.5,0,0,0.0,0.0,0.0
277709.0,6,10,1221,6,636,55541.8,298.0,106.0,4,585,87094.66666666667,379.0,146.25
48962.0,6,14,4740,7,653,7607.333333333333,249.0,93.28571428571428,7,4087,6845.833333333333,1514.0,583.8571428571429
120001160.0,17,14,864,7,432,20000193.33333333,174.0,61.71428571428572,7,432,19834199.666666668,174.0,61.71428571428572
294.0,17,2,156,1,78,0.0,78.0,78.0,1,78,0.0,78.0,78.0
65186.99999999999,6,14,4740,7,653,10670.5,249.0,93.28571428571428,7,4087,9228.333333333334,1514.0,583.8571428571429
204475.0,17,2,762,2,762,0.0,381.0,381.0,0,0,0.0,0.0,0.0
143841.0,17,2,180,1,90,0.0,90.0,90.0,1,90,0.0,90.0,90.0
108099131.0,17,5,955,5,955,27024782.75,191.0,191.0,0,0,0.0,0.0,0.0
135140747.0,17,6,1206,6,1206,27028149.4,201.0,201.0,0,0,0.0,0.0,0.0
303992.0,6,6,412,4,272,101330.66666666669,74.0,68.0,2,140,0.0,74.0,70.0
2833.0,17,4,344,2,150,0.0,75.0,75.0,2,194,0.0,103.0,97.0
10462258.0,6,7,478,4,272,3440329.0,74.0,68.0,3,206,5160418.0,74.0,68.66666666666667
37925.0,6,10,2032,5,524,6849.75,252.0,104.8,5,1508,8651.5,1236.0,301.6
196840.0,17,2,180,1,90,0.0,90.0,90.0,1,90,0.0,90.0,90.0
119855894.0,17,35,16705,35,16705,3525173.3529411764,501.0,477.2857142857143,0,0,0.0,0.0,0.0
1954.0,17,2,192,1,88,0.0,88.0,88.0,1,104,0.0,104.0,104.0
29021.0,6,10,2032,5,524,2979.0,252.0,104.8,5,1508,6504.25,1236.0,301.6
722.0,17,4,438,2,148,0.0,74.0,74.0,2,290,0.0,147.0,145.0
1159544.0,6,13,3009,8,2381,165649.14285714287,1514.0,297.625,5,628,221613.0,331.0,125.6
120000019.0,6,21,1626,12,935,10909092.636363637,95.0,77.91666666666667,9,691,11345791.0,95.0,76.77777777777777
32369.000000000004,6,14,4740,7,653,4411.166666666667,249.0,93.28571428571428,7,4087,4822.166666666667,1514.0,583.8571428571429
317184.0,6,3,202,2,128,0.0,74.0,64.0,1,74,0.0,74.0,74.0
108108626.0,17,5,955,5,955,27027156.5,191.0,191.0,0,0,0.0,0.0,0.0
2036.0,17,4,344,2,150,0.0,75.0,75.0,2,194,0.0,103.0,97.0
390.0,17,2,410,1,78,0.0,78.0,78.0,1,332,0.0,332.0,332.0
297956.0,6,6,412,4,272,99318.66666666669,74.0,68.0,2,140,0.0,74.0,70.0
19830.0,6,14,4740,7,653,2859.1666666666665,249.0,93.28571428571428,7,4087,3159.1666666666665,1514.0,583.8571428571429
142718.0,6,2,132,1,66,0.0,66.0,66.0,1,66,0.0,66.0,66.0
10911902.0,6,8,544,4,272,3591879.0,74.0,68.0,4,272,3591798.333333333,74.0,68.0
100195161.0,17,16,1474,8,737,14290887.285714284,174.0,92.125,8,737,14169158.714285716,174.0,92.125
145849.0,6,3,337,2,214,0.0,160.0,107.0,1,123,0.0,123.0,123.0
240777.0,6,3,337,2,214,0.0,160.0,107.0,1,123,0.0,123.0,123.0
108103798.0,17,5,955,5,955,27025949.5,191.0,191.0,0,0,0.0,0.0,0.0
42203.0,6,14,4740,7,653,6845.0,249.0,93.28571428571428,7,4087,6129.0,1514.0,583.8571428571429
209620.0,17,2,180,1,90,0.0,90.0,90.0,1,90,0.0,90.0,90.0
2027.0,17,4,344,2,150,0.0,75.0,75.0,2,194,0.0,103.0,97.0
4426.0,17,2,582,1,83,0.0,83.0,83.0,1,499,0.0,499.0,499.0
232890.0,6,3,337,2,214,0.0,160.0,107.0,1,123,0.0,123.0,123.0
1046417.0,6,11,1134,6,558,209283.4,220.0,93.0,5,576,259627.0,304.0,115.2
237239.0,6,3,337,2,214,0.0,160.0,107.0,1,123,0.0,123.0,123.0
108099405.0,17,5,1005,5,1005,27024851.25,201.0,201.0,0,0,0.0,0.0,0.0
90047389.0,17,28,13364,28,13364,3335088.4814814813,501.0,477.2857142857143,0,0,0.0,0.0,0.0
66148.0,6,14,4740,7,653,10914.5,249.0,93.28571428571428,7,4087,8366.0,1514.0,583.8571428571429
50953.0,17,2,180,1,90,0.0,90.0,90.0,1,90,0.0,90.0,90.0
228477.0,17,2,180,1,90,0.0,90.0,90.0,1,90,0.0,90.0,90.0
259231.0,6,3,337,2,214,0.0,160.0,107.0,1,123,0.0,123.0,123.0
0.0,6,1,66,1,66,0.0,66.0,66.0,0,0,0.0,0.0,0.0
120000310.0,6,24,1829,11,840,12000031.0,95.0,76.36363636363636,13,989,9978025.25,95.0,76.07692307692308
1162466.0,6,13,3011,8,2383,166066.57142857142,1514.0,297.875,5,628,221818.5,331.0,125.6
135146967.0,17,6,1146,6,1146,27029393.4,191.0,191.0,0,0,0.0,0.0,0.0
104000925.0,17,13,821,7,432,17333487.5,174.0,61.71428571428572,6,389,16801357.0,174.0,64.83333333333333
302468.0,17,4,1400,4,1400,100822.66666666669,350.0,350.0,0,0,0.0,0.0,0.0
197024.0,17,2,180,1,90,0.0,90.0,90.0,1,90,0.0,90.0,90.0
123730593.0,6,49,3234,25,1650,5155441.375,66.0,66.0,24,1584,5138562.434782608,66.0,66.0
123850805.0,17,14,1126,7,563,17503175.5,174.0,80.42857142857143,7,563,19833928.5,174.0,80.42857142857143
14236.0,6,10,2032,5,524,3166.0,252.0,104.8,5,1508,3068.75,1236.0,301.6
135118020.0,17,6,1206,6,1206,27023604.0,201.0,201.0,0,0,0.0,0.0,0.0
207106.0,6,3,426,2,280,0.0,214.0,140.0,1,146,0.0,146.0,146.0
37485.0,6,10,2032,5,524,8985.25,252.0,104.8,5,1508,8220.0,1236.0,301.6
36888.0,6,14,4740,7,653,5949.833333333333,249.0,93.28571428571428,7,4087,5634.0,1514.0,583.8571428571429
209798.0,17,2,180,1,90,0.0,90.0,90.0,1,90,0.0,90.0,90.0
2014.0,17,4,344,2,150,0.0,75.0,75.0,2,194,0.0,103.0,97.0
27092825.0,17,5,1710,5,1710,6773206.25,342.0,342.0,0,0,0.0,0.0,0.0
29245.0,6,14,4740,7,653,4741.166666666667,249.0,93.28571428571428,7,4087,4741.0,1514.0,583.8571428571429
38773.0,6,13,1394,7,797,6462.166666666667,253.0,113.85714285714286,6,597,6828.0,259.0,99.5
90029256.0,17,28,13364,28,13364,3334416.888888889,501.0,477.2857142857143,0,0,0.0,0.0,0.0
2419.0,17,4,344,2,150,0.0,75.0,75.0,2,194,0.0,103.0,97.0
16929.0,17,2,180,1,90,0.0,90.0,90.0,1,90,0.0,90.0,90.0
120426943.0,6,231,26224,116,18338,1047190.8086956522,284.0,158.08620689655172,115,7886,1047361.245614035,140.0,68.57391304347826
55851.0,6,14,4740,7,653,7386.833333333333,249.0,93.28571428571428,7,4087,8856.0,1514.0,583.8571428571429
439464.0,6,11,1021,6,444,59049.6,162.0,74.0,5,577,73677.0,349.0,115.4
110889178.0,6,32,2220,16,1149,7378981.666666667,123.0,71.8125,16,1071,7378979.533333333,123.0,66.9375
30851.0,6,14,4740,7,653,4773.166666666667,249.0,93.28571428571428,7,4087,4662.0,1514.0,583.8571428571429
120243140.0,6,218,24518,109,7490,1105211.851851852,140.0,68.71559633027523,109,17028,1105752.0185185184,284.0,156.22018348623854
858865.0,6,9,1118,6,586,171773.0,248.0,97.66666666666669,3,532,291696.5,392.0,177.33333333333334
27385.0,6,14,4740,7,653,4453.0,249.0,93.28571428571428,7,4087,3959.5,1514.0,583.8571428571429
38889.0,6,14,4740,7,653,5702.333333333333,249.0,93.28571428571428,7,4087,6098.833333333333,1514.0,583.8571428571429
2401.0,17,4,344,2,150,0.0,75.0,75.0,2,194,0.0,103.0,97.0
2589677.0,6,2,132,1,66,0.0,66.0,66.0,1,66,0.0,66.0,66.0
286824.0,17,2,180,1,90,0.0,90.0,90.0,1,90,0.0,90.0,90.0
3008283.0,6,12,2172,7,664,501053.5,252.0,94.85714285714286,5,1508,2666.5,1236.0,301.6
105445710.0,17,14,1126,7,563,17500188.333333332,174.0,80.42857142857143,7,563,17502629.833333332,174.0,80.42857142857143
207122.0,6,3,426,2,280,0.0,214.0,140.0,1,146,0.0,146.0,146.0
117458402.0,6,207,23396,104,7086,1140372.8349514564,140.0,68.13461538461539,103,16310,1131157.843137255,284.0,158.3495145631068
108102237.0,17,5,1005,5,1005,27025559.25,201.0,201.0,0,0,0.0,0.0,0.0
171927.0,17,2,180,1,90,0.0,90.0,90.0,1,90,0.0,90.0,90.0
0.0,17,1,90,1,90,0.0,90.0,90.0,0,0,0.0,0.0,0.0
90051380.0,17,28,13364,28,13364,3335236.296296296,501.0,477.2857142857143,0,0,0.0,0.0,0.0
90364564.0,6,14,2256,7,1428,15060554.166666666,204.0,204.0,7,828,15014632.0,188.0,118.28571428571428
74586965.0,6,9,842,9,842,9323370.625,97.0,93.55555555555556,0,0,0.0,0.0,0.0
90395077.0,6,11,1644,7,828,15065846.166666666,188.0,118.28571428571428,4,816,20112284.33333333,204.0,204.0
37487.0,6,14,4740,7,653,6124.666666666667,249.0,93.28571428571428,7,4087,5888.666666666667,1514.0,583.8571428571429
116697570.0,6,48,3168,24,1584,5073807.391304348,66.0,66.0,24,1584,5061822.043478261,66.0,66.0
217593.0,17,4,1524,4,1524,72531.0,381.0,381.0,0,0,0.0,0.0,0.0
121202.0,6,3,337,2,214,0.0,160.0,107.0,1,123,0.0,123.0,123.0
206851.0,17,2,762,2,762,0.0,381.0,381.0,0,0,0.0,0.0,0.0
54409.0,6,12,1320,6,723,9058.0,253.0,120.5,6,597,8744.8,259.0,99.5
246190.0,6,3,373,2,238,0.0,172.0,119.0,1,135,0.0,135.0,135.0
108109782.0,17,5,1005,5,1005,27027445.5,201.0,201.0,0,0,0.0,0.0,0.0
143972.0,17,2,180,1,90,0.0,90.0,90.0,1,90,0.0,90.0,90.0
63767.00000000001,6,14,4740,7,653,10084.166666666666,249.0,93.28571428571428,7,4087,10363.5,1514.0,583.8571428571429
37214.0,6,14,4740,7,653,5146.166666666667,249.0,93.28571428571428,7,4087,6044.0,1514.0,583.8571428571429
309258.0,6,6,412,4,272,103086.0,74.0,68.0,2,140,0.0,74.0,70.0
316204.0,17,4,1400,4,1400,105401.33333333331,350.0,350.0,0,0,0.0,0.0,0.0
90252621.0,6,12,1832,8,1016,12893231.57142857,188.0,127.0,4,816,30029352.0,204.0,204.0
2783972.0,6,2,132,1,66,0.0,66.0,66.0,1,66,0.0,66.0,66.0
1510678.0,6,20,6434,12,1921,137334.36363636365,620.0,160.08333333333334,8,4513,176612.14285714287,1514.0,564.125
108103440.0,17,5,955,5,955,27025860.0,191.0,191.0,0,0,0.0,0.0,0.0
90029785.0,17,28,13364,28,13364,3334436.4814814813,501.0,477.2857142857143,0,0,0.0,0.0,0.0
362.0,17,2,160,1,80,0.0,80.0,80.0,1,80,0.0,80.0,80.0
102104.0,17,6,1230,3,234,50858.5,78.0,78.0,3,996,50831.0,332.0,332.0
1471898.0,17,16,1120,16,1120,98126.53333333334,70.0,70.0,0,0,0.0,0.0,0.0
839.0,17,4,438,2,148,0.0,74.0,74.0,2,290,0.0,147.0,145.0
90018935.0,17,28,13364,28,13364,3334034.6296296297,501.0,477.2857142857143,0,0,0.0,0.0,0.0
123459043.0,6,48,3168,24,1584,5038021.739130435,66.0,66.0,24,1584,5229955.565217392,66.0,66.0
97000793.0,17,13,1083,7,563,16166798.833333334,174.0,80.42857142857143,6,520,17000573.8,174.0,86.66666666666667
302395.0,6,2,132,1,66,0.0,66.0,66.0,1,66,0.0,66.0,66.0
103199865.0,6,41,2706,21,1386,5159993.25,66.0,66.0,20,1320,5352862.631578947,66.0,66.0
130461.0,6,2,132,1,66,0.0,66.0,66.0,1,66,0.0,66.0,66.0
120276263.0,6,350,41728,175,11846,687173.1034482758,140.0,67.69142857142857,175,29882,686526.2528735632,464.0,170.75428571428571
3726.0,17,4,344,2,150,0.0,75.0,75.0,2,194,0.0,103.0,97.0
112464280.0,6,46,3036,23,1518,5112001.090909091,66.0,66.0,23,1518,5112000.7727272725,66.0,66.0
135150727.0,17,6,1146,6,1146,27030145.4,191.0,191.0,0,0,0.0,0.0,0.0
90294652.0,6,22,1680,12,935,8204408.181818182,95.0,77.91666666666667,10,745,10000191.111111112,95.0,74.5
841350.0,6,9,1196,6,725,168270.0,387.0,120.83333333333331,3,471,284363.0,331.0,157.0
122012009.0,17,15,907,8,475,17430287.0,174.0,59.375,7,432,17000175.5,174.0,61.71428571428572
119514745.0,17,34,16284,34,16284,3621658.93939394,501.0,478.9411764705882,0,0,0.0,0.0,0.0
104079184.0,6,28,1876,14,982,7989471.692307692,139.0,70.14285714285714,14,894,7989471.846153846,123.0,63.85714285714285
0.0,17,1,86,1,86,0.0,86.0,86.0,0,0,0.0,0.0,0.0
887199.0,6,2,132,1,66,0.0,66.0,66.0,1,66,0.0,66.0,66.0
11793008.0,6,5,1736,2,819,0.0,753.0,409.5,3,917,5824903.0,785.0,305.6666666666667
5731238.0,6,5,336,2,134,0.0,68.0,67.0,3,202,1526069.5,70.0,67.33333333333333
293989.0,17,2,876,2,876,0.0,438.0,438.0,0,0,0.0,0.0,0.0
120068807.0,17,28,13364,28,13364,4446992.851851852,501.0,477.2857142857143,0,0,0.0,0.0,0.0
3001016.0,6,2,132,1,66,0.0,66.0,66.0,1,66,0.0,66.0,66.0
2427.0,17,4,344,2,150,0.0,75.0,75.0,2,194,0.0,103.0,97.0
197051.0,17,2,180,1,90,0.0,90.0,90.0,1,90,0.0,90.0,90.0
103216160.0,6,42,2772,21,1386,5160795.35,66.0,66.0,21,1386,5160795.0,66.0,66.0
16934.0,17,2,180,1,90,0.0,90.0,90.0,1,90,0.0,90.0,90.0
165088.0,17,2,414,1,88,0.0,88.0,88.0,1,326,0.0,326.0,326.0
3171488.0,6,18,1495,9,921,358373.25,315.0,102.33333333333331,9,574,358341.75,78.0,63.77777777777778
2217.0,17,4,344,2,150,0.0,75.0,75.0,2,194,0.0,103.0,97.0
246141.0,6,3,337,2,214,0.0,160.0,107.0,1,123,0.0,123.0,123.0
153492.0,17,2,180,1,90,0.0,90.0,90.0,1,90,0.0,90.0,90.0
153401.0,17,2,180,1,90,0.0,90.0,90.0,1,90,0.0,90.0,90.0
247087.0,6,3,337,2,214,0.0,160.0,107.0,1,123,0.0,123.0,123.0
9002000.0,17,4,316,4,316,3000666.6666666665,79.0,79.0,0,0,0.0,0.0,0.0
120001175.0,17,16,1212,8,606,17143025.0,174.0,75.75,8,606,17000736.57142857,174.0,75.75
40884.0,6,14,4740,7,653,6593.833333333333,249.0,93.28571428571428,7,4087,6601.333333333333,1514.0,583.8571428571429
60931.0,6,14,4740,7,653,8118.166666666667,249.0,93.28571428571428,7,4087,9914.5,1514.0,583.8571428571429
219178.0,6,3,426,2,280,0.0,214.0,140.0,1,146,0.0,146.0,146.0
123839.0,6,13,1386,7,789,20639.83333333333,253.0,112.71428571428572,6,597,22849.4,259.0,99.5
63797.00000000001,6,14,4740,7,653,9799.0,249.0,93.28571428571428,7,4087,9529.166666666666,1514.0,583.8571428571429
108112983.0,17,5,1005,5,1005,27028245.75,201.0,201.0,0,0,0.0,0.0,0.0
405168.0,6,3,1604,2,851,0.0,785.0,425.5,1,753,0.0,753.0,753.0
144006.0,17,2,180,1,90,0.0,90.0,90.0,1,90,0.0,90.0,90.0
215024.0,6,13,1394,7,797,35837.333333333336,253.0,113.85714285714286,6,597,42001.2,259.0,99.5
307150.0,6,6,412,4,272,102383.33333333331,74.0,68.0,2,140,0.0,74.0,70.0
48431.0,6,10,2032,5,524,11887.75,252.0,104.8,5,1508,8624.25,1236.0,301.6
146787.0,6,3,337,2,214,0.0,160.0,107.0,1,123,0.0,123.0,123.0
873064.0,6,9,1268,6,797,174612.8,459.0,132.83333333333334,3,471,298799.5,331.0,157.0
120000270.0,6,20,1531,11,840,12000027.0,95.0,76.36363636363636,9,691,11287580.75,95.0,76.77777777777777
153399.0,17,2,180,1,90,0.0,90.0,90.0,1,90,0.0,90.0,90.0
146216.0,6,3,337,2,214,0.0,160.0,107.0,1,123,0.0,123.0,123.0
0.0,6,1,54,1,54,0.0,54.0,54.0,0,0,0.0,0.0,0.0
90261237.0,6,13,2036,8,1016,12894462.42857143,188.0,127.0,5,1020,22524152.0,204.0,204.0
54413.0,6,14,4740,7,653,8773.833333333334,249.0,93.28571428571428,7,4087,6777.333333333333,1514.0,583.8571428571429
298408.0,6,7,478,4,272,99469.33333333331,74.0,68.0,3,206,73155.0,74.0,68.66666666666667
10460323.0,6,7,478,4,272,3441549.0,74.0,68.0,3,206,5162223.5,74.0,68.66666666666667
0.0,17,1,72,1,72,0.0,72.0,72.0,0,0,0.0,0.0,0.0
302369.0,6,2,132,1,66,0.0,66.0,66.0,1,66,0.0,66.0,66.0
2540.0,17,2,762,2,762,0.0,381.0,381.0,0,0,0.0,0.0,0.0
39721.0,6,14,4740,7,653,6498.666666666667,249.0,93.28571428571428,7,4087,6130.166666666667,1514.0,583.8571428571429
108753584.0,6,33,2428,17,1288,6797099.0,139.0,75.76470588235294,16,1140,7235796.333333333,123.0,71.25
218070.0,6,3,426,2,280,0.0,214.0,140.0,1,146,0.0,146.0,146.0
244541.0,6,3,337,2,214,0.0,160.0,107.0,1,123,0.0,123.0,123.0
129006937.0,17,15,907,8,475,18429562.42857143,174.0,59.375,7,432,18166824.666666668,174.0,61.71428571428572
135133108.0,17,6,1146,6,1146,27026621.6,191.0,191.0,0,0,0.0,0.0,0.0
120064036.0,17,29,13785,29,13785,4288001.285714285,501.0,475.3448275862069,0,0,0.0,0.0,0.0
771348.0,6,10,1065,5,534,192572.5,262.0,106.8,5,531,191992.5,259.0,106.2
43656.0,6,10,2032,5,524,9570.75,252.0,104.8,5,1508,8215.75,1236.0,301.6
206169.0,17,2,180,1,90,0.0,90.0,90.0,1,90,0.0,90.0,90.0
218050.0,6,3,426,2,280,0.0,214.0,140.0,1,146,0.0,146.0,146.0
102238155.0,17,14,864,7,432,17000160.166666668,174.0,61.71428571428572,7,432,17002165.5,174.0,61.71428571428572
47087.0,6,10,2032,5,524,10862.75,252.0,104.8,5,1508,10531.25,1236.0,301.6
43487.0,6,14,4740,7,653,7122.166666666667,249.0,93.28571428571428,7,4087,6693.333333333333,1514.0,583.8571428571429
543.0,17,2,762,2,762,0.0,381.0,381.0,0,0,0.0,0.0,0.0
123766145.0,6,66,5995,40,3487,3173490.897435897,139.0,87.175,26,2508,4567653.32,123.0,96.46153846153848
10464334.0,6,7,478,4,272,3442280.6666666665,74.0,68.0,3,206,5163338.5,74.0,68.66666666666667
257595.00000000003,6,10,1221,6,636,51519.0,298.0,106.0,4,585,80475.66666666667,379.0,146.25
108633490.0,6,32,2236,16,1165,7242232.666666667,139.0,72.8125,16,1071,7227812.666666667,123.0,66.9375
286078.0,6,10,1221,6,636,57215.6,298.0,106.0,4,585,94418.33333333331,379.0,146.25
205375.0,17,2,180,1,90,0.0,90.0,90.0,1,90,0.0,90.0,90.0
117463361.0,6,207,23470,104,16376,1140420.9805825243,284.0,157.46153846153845,103,7094,1141575.843137255,140.0,68.87378640776699
206950.0,6,3,426,2,280,0.0,214.0,140.0,1,146,0.0,146.0,146.0
0.0,17,1,72,1,72,0.0,72.0,72.0,0,0,0.0,0.0,0.0
206143.0,6,3,426,2,280,0.0,214.0,140.0,1,146,0.0,146.0,146.0
270357.0,6,10,1221,6,636,54071.4,298.0,106.0,4,585,84373.66666666667,379.0,146.25
108104652.0,17,5,1005,5,1005,27026163.0,201.0,201.0,0,0,0.0,0.0,0.0
6875.0,17,2,582,1,83,0.0,83.0,83.0,1,499,0.0,499.0,499.0
112593815.0,17,16,1474,8,737,16061835.714285716,174.0,92.125,8,737,16083058.714285716,174.0,92.125
85127.0,6,14,4740,7,653,14069.166666666666,249.0,93.28571428571428,7,4087,13800.166666666666,1514.0,583.8571428571429
90367958.0,6,12,1848,5,1020,22591272.25,204.0,204.0,7,828,15060582.0,188.0,118.28571428571428
307169.0,6,6,412,4,272,102389.66666666669,74.0,68.0,2,140,0.0,74.0,70.0
33078980.0,6,26,8427,14,1773,2544536.923076923,408.0,126.64285714285714,12,6654,2636656.363636364,1514.0,554.5
5623953.0,6,5,336,2,134,0.0,68.0,67.0,3,202,1526746.0,70.0,67.33333333333333
0.0,6,1,66,1,66,0.0,66.0,66.0,0,0,0.0,0.0,0.0
206501.0,6,3,426,2,280,0.0,214.0,140.0,1,146,0.0,146.0,146.0
10873848.0,6,8,544,4,272,3578890.0,74.0,68.0,4,272,3578800.0,74.0,68.0
316392.0,6,6,412,4,272,105464.0,74.0,68.0,2,140,0.0,74.0,70.0
90052876.0,17,28,13364,28,13364,3335291.703703704,501.0,477.2857142857143,0,0,0.0,0.0,0.0
17541.0,6,10,2032,5,524,3927.25,252.0,104.8,5,1508,4035.0,1236.0,301.6
104785.0,17,2,286,2,286,0.0,143.0,143.0,0,0,0.0,0.0,0.0
391014.0,6,3,1604,1,753,0.0,753.0,753.0,2,851,0.0,785.0,425.5
34479.0,6,10,2032,5,524,6732.5,252.0,104.8,5,1508,7840.75,1236.0,301.6
111647201.0,6,40,3216,22,1761,5316533.380952381,123.0,80.04545454545455,18,1455,6554752.705882353,123.0,80.83333333333333
205845.0,17,2,180,1,90,0.0,90.0,90.0,1,90,0.0,90.0,90.0
216762.0,17,2,180,1,90,0.0,90.0,90.0,1,90,0.0,90.0,90.0
10478109.0,6,7,478,4,272,3447281.0,74.0,68.0,3,206,5170763.0,74.0,68.66666666666667
101487844.0,17,14,864,7,432,16834531.0,174.0,61.71428571428572,7,432,16833496.333333332,174.0,61.71428571428572
306353.0,6,6,412,4,272,102117.66666666669,74.0,68.0,2,140,0.0,74.0,70.0
135128523.0,17,6,1206,6,1206,27025704.6,201.0,201.0,0,0,0.0,0.0,0.0
90762848.0,6,18,1382,10,786,10080007.666666666,95.0,78.6,8,596,12965311.142857144,95.0,74.5
299.0,17,2,156,1,78,0.0,78.0,78.0,1,78,0.0,78.0,78.0
254168.0,17,4,6056,4,6056,84722.66666666667,1514.0,1514.0,0,0,0.0,0.0,0.0
114067751.0,17,14,864,7,432,19000166.83333333,174.0,61.71428571428572,7,432,19001083.0,174.0,61.71428571428572
0.0,6,1,66,1,66,0.0,66.0,66.0,0,0,0.0,0.0,0.0
310986.0,17,4,1400,4,1400,103662.0,350.0,350.0,0,0,0.0,0.0,0.0
135134497.0,17,6,1206,6,1206,27026899.4,201.0,201.0,0,0,0.0,0.0,0.0
58402.0,6,14,4740,7,653,9613.0,249.0,93.28571428571428,7,4087,4611.166666666667,1514.0,583.8571428571429
108109528.0,17,5,1005,5,1005,27027382.0,201.0,201.0,0,0,0.0,0.0,0.0
45881.0,6,10,2032,5,524,10340.75,252.0,104.8,5,1508,8647.75,1236.0,301.6
2506.0,17,2,664,1,322,0.0,322.0,322.0,1,342,0.0,342.0,342.0
120000023.0,6,22,1680,12,935,10909093.0,95.0,77.91666666666667,10,745,10103919.444444444,95.0,74.5
196792.0,17,2,180,1,90,0.0,90.0,90.0,1,90,0.0,90.0,90.0
45511.0,6,14,4740,7,653,7129.0,249.0,93.28571428571428,7,4087,7148.5,1514.0,583.8571428571429
17922.0,6,2,145,2,145,0.0,91.0,72.5,0,0,0.0,0.0,0.0
17519.0,6,10,2032,5,524,4060.0,252.0,104.8,5,1508,4079.0,1236.0,301.6
10474271.0,6,7,478,4,272,3446131.333333333,74.0,68.0,3,206,5169108.0,74.0,68.66666666666667
120059379.0,6,229,25912,114,7820,1055157.0796460176,140.0,68.59649122807018,115,18092,1053055.3684210526,284.0,157.3217391304348
16277.0,6,10,2032,5,524,3836.75,252.0,104.8,5,1508,3912.25,1236.0,301.6
117699346.0,6,42,3208,22,1714,5604730.761904762,139.0,77.9090909090909,20,1494,6183918.105263158,123.0,74.7
321753.0,17,4,1400,4,1400,107251.0,350.0,350.0,0,0,0.0,0.0,0.0
100628927.0,6,34,2551,17,1263,6289307.9375,123.0,74.29411764705883,17,1288,6275678.1875,139.0,75.76470588235294
2016.0,17,4,344,2,150,0.0,75.0,75.0,2,194,0.0,103.0,97.0
1096933.0,6,13,1386,7,789,182822.16666666663,253.0,112.71428571428572,6,597,216646.4,259.0,99.5
212272.0,6,10,1221,6,636,42454.4,298.0,106.0,4,585,69471.0,379.0,146.25
295933.0,17,2,246,1,76,0.0,76.0,76.0,1,170,0.0,170.0,170.0
228278.0,17,2,180,1,90,0.0,90.0,90.0,1,90,0.0,90.0,90.0
90000820.0,17,11,735,6,389,18000164.0,174.0,64.83333333333333,5,346,17501591.25,174.0,69.2
120262922.0,6,188,21220,94,6426,1284453.1182795698,140.0,68.36170212765957,94,14794,1273298.9892473118,284.0,157.38297872340425
27215778.0,17,5,1710,5,1710,6803944.5,342.0,342.0,0,0,0.0,0.0,0.0
207322.0,6,3,426,2,280,0.0,214.0,140.0,1,146,0.0,146.0,146.0
117527996.0,6,34,2488,18,1348,6900704.94117647,139.0,74.88888888888889,16,1140,7820672.6,123.0,71.25
2403.0,17,4,344,2,150,0.0,75.0,75.0,2,194,0.0,103.0,97.0
90048776.0,17,27,12943,27,12943,3463414.461538461,501.0,479.3703703703704,0,0,0.0,0.0,0.0
105008199.0,17,14,864,7,432,17501366.5,174.0,61.71428571428572,7,432,17500144.333333332,174.0,61.71428571428572
108106505.0,17,5,955,5,955,27026626.25,191.0,191.0,0,0,0.0,0.0,0.0
115760217.0,17,14,864,7,432,19167537.166666668,174.0,61.71428571428572,7,432,19166862.83333333,174.0,61.71428571428572
1088135.0,6,13,1386,7,789,181355.8333333333,253.0,112.71428571428572,6,597,215768.4,259.0,99.5
113255018.0,6,46,3036,23,1518,5135439.5,66.0,66.0,23,1518,5135451.227272728,66.0,66.0
57759.0,6,14,4740,7,653,9485.666666666666,249.0,93.28571428571428,7,4087,8453.666666666666,1514.0,583.8571428571429
376.0,17,2,267,1,83,0.0,83.0,83.0,1,184,0.0,184.0,184.0
46155.0,6,14,4740,7,653,3358.6666666666665,249.0,93.28571428571428,7,4087,7064.5,1514.0,583.8571428571429
90098472.0,6,12,1710,5,882,22524039.0,204.0,176.4,7,828,15015859.333333334,188.0,118.28571428571428
4028250.0,17,2,180,1,90,0.0,90.0,90.0,1,90,0.0,90.0,90.0
91974115.0,6,259,31470,130,8802,712977.6356589147,140.0,67.70769230769231,129,22668,710387.828125,464.0,175.72093023255815
120007349.0,6,22,1680,11,840,12000734.9,95.0,76.36363636363636,11,840,9001012.7,95.0,76.36363636363636
2597496.0,6,2,132,1,66,0.0,66.0,66.0,1,66,0.0,66.0,66.0
101139969.0,6,16,1353,8,596,14448567.0,95.0,74.5,8,757,14413075.857142856,256.0,94.625
95092671.0,6,188,21204,94,14778,1020188.6451612904,284.0,157.2127659574468,94,6426,1020188.5591397848,140.0,68.36170212765957
90308961.0,6,19,1436,10,745,10028787.0,95.0,74.5,9,691,11287085.75,95.0,76.77777777777777
121637953.0,6,31,2119,15,1017,7975235.571428572,123.0,67.8,16,1102,8109165.933333334,139.0,68.875
3055963.0,6,15,4814,8,727,435969.28571428574,249.0,90.875,7,4087,5004.833333333333,1514.0,583.8571428571429
135134689.0,17,6,1206,6,1206,27026937.8,201.0,201.0,0,0,0.0,0.0,0.0
108098935.0,6,209,23596,105,7152,1039412.8365384616,140.0,68.11428571428571,104,16444,1039425.718446602,284.0,158.1153846153846
108105916.0,17,5,955,5,955,27026479.0,191.0,191.0,0,0,0.0,0.0,0.0
1307200.0,17,7,490,7,490,217866.66666666663,70.0,70.0,0,0,0.0,0.0,0.0
31730.0,6,14,4740,7,653,4967.666666666667,249.0,93.28571428571428,7,4087,5094.666666666667,1514.0,583.8571428571429
9502.0,17,2,598,1,72,0.0,72.0,72.0,1,526,0.0,526.0,526.0
36130.0,6,14,4740,7,653,5902.833333333333,249.0,93.28571428571428,7,4087,5431.666666666667,1514.0,583.8571428571429
118709262.0,6,33,2296,17,1225,7419328.875,139.0,72.05882352941177,16,1071,7233780.933333334,123.0,66.9375
101299.0,17,2,286,2,286,0.0,143.0,143.0,0,0,0.0,0.0,0.0
1086117.0,6,13,1386,7,789,181019.5,253.0,112.71428571428572,6,597,212162.4,259.0,99.5
90254781.0,6,14,2102,8,1016,12893540.142857144,188.0,127.0,6,1086,18018678.4,204.0,181.0
93397718.0,6,40,2640,20,1320,4915669.368421053,66.0,66.0,20,1320,4899668.7894736845,66.0,66.0
209392.0,17,2,180,1,90,0.0,90.0,90.0,1,90,0.0,90.0,90.0
108107081.0,17,5,955,5,955,27026770.25,191.0,191.0,0,0,0.0,0.0,0.0
129571648.0,6,35,2394,18,1269,7621861.647058823,123.0,70.5,17,1125,7460591.3125,123.0,66.17647058823529
90046793.0,17,28,13364,28,13364,3335066.407407407,501.0,477.2857142857143,0,0,0.0,0.0,0.0
19749.0,17,4,823,2,163,0.0,89.0,81.5,2,660,0.0,443.0,330.0
122966024.0,6,32,2283,16,1071,7781429.0,123.0,66.9375,16,1212,7532025.066666666,123.0,75.75
25045.0,6,10,2032,5,524,5402.0,252.0,104.8,5,1508,5779.0,1236.0,301.6
644642.0,6,2,132,1,66,0.0,66.0,66.0,1,66,0.0,66.0,66.0
16821.0,17,2,180,1,90,0.0,90.0,90.0,1,90,0.0,90.0,90.0
120144795.0,6,290,34772,145,9792,828683.7291666666,140.0,67.53103448275863,145,24980,828686.8611111111,390.0,172.27586206896552
162295.0,17,2,180,1,90,0.0,90.0,90.0,1,90,0.0,90.0,90.0
167289.0,6,3,337,2,214,0.0,160.0,107.0,1,123,0.0,123.0,123.0
58829856.0,17,9,3086,8,2736,5107785.142857143,342.0,342.0,1,350,0.0,350.0,350.0
14157.0,6,10,2032,5,524,3252.25,252.0,104.8,5,1508,2858.5,1236.0,301.6
106072820.0,6,44,2904,22,1452,5051086.666666667,66.0,66.0,22,1452,5040792.19047619,66.0,66.0
164849.0,17,2,414,1,88,0.0,88.0,88.0,1,326,0.0,326.0,326.0
122687662.0,6,48,3168,24,1584,4954128.521739131,66.0,66.0,24,1584,5254195.869565218,66.0,66.0
228290.0,17,2,180,1,90,0.0,90.0,90.0,1,90,0.0,90.0,90.0
17300.0,6,10,2032,5,524,3983.75,252.0,104.8,5,1508,3971.25,1236.0,301.6
311335.0,17,4,1400,4,1400,103778.33333333331,350.0,350.0,0,0,0.0,0.0,0.0
153496.0,17,2,180,1,90,0.0,90.0,90.0,1,90,0.0,90.0,90.0
407088.0,6,4,508,2,238,0.0,172.0,119.0,2,270,0.0,135.0,135.0
5626412.0,6,5,336,2,134,0.0,68.0,67.0,3,202,1422420.5,70.0,67.33333333333333
302311.0,6,6,412,4,272,100770.33333333331,74.0,68.0,2,140,0.0,74.0,70.0
207446.0,6,3,426,2,280,0.0,214.0,140.0,1,146,0.0,146.0,146.0
48203.0,6,14,4740,7,653,7924.666666666667,249.0,93.28571428571428,7,4087,7469.5,1514.0,583.8571428571429
0.0,17,1,55,1,55,0.0,55.0,55.0,0,0,0.0,0.0,0.0
99053.0,6,10,2032,5,524,24518.25,252.0,104.8,5,1508,21562.25,1236.0,301.6
34033.0,6,14,4740,7,653,5546.166666666667,249.0,93.28571428571428,7,4087,5131.666666666667,1514.0,583.8571428571429
108101911.0,17,5,955,5,955,27025477.75,191.0,191.0,0,0,0.0,0.0,0.0
233985.0,6,3,373,2,238,0.0,172.0,119.0,1,135,0.0,135.0,135.0
20215.0,17,2,582,1,83,0.0,83.0,83.0,1,499,0.0,499.0,499.0
216512.0,6,13,1394,7,797,36085.333333333336,253.0,113.85714285714286,6,597,41827.6,259.0,99.5
108108697.0,17,5,955,5,955,27027174.25,191.0,191.0,0,0,0.0,0.0,0.0
126753565.0,6,35,2548,19,1408,7041864.722222222,139.0,74.10526315789474,16,1140,7770994.4,123.0,71.25
90362355.0,17,12,778,6,389,18000442.6,174.0,64.83333333333333,6,389,18000154.6,174.0,64.83333333333333
123840013.0,6,49,3234,25,1650,5160000.541666667,66.0,66.0,24,1584,4984387.173913044,66.0,66.0
146879.0,6,4,439,2,238,0.0,172.0,119.0,2,201,0.0,135.0,100.5
144007.0,17,2,180,1,90,0.0,90.0,90.0,1,90,0.0,90.0,90.0
96144852.0,17,12,778,6,389,19197018.6,174.0,64.83333333333333,6,389,18922152.0,174.0,64.83333333333333
232137.0,6,3,337,2,214,0.0,160.0,107.0,1,123,0.0,123.0,123.0
78784.0,6,14,4740,7,653,12826.833333333334,249.0,93.28571428571428,7,4087,12759.166666666666,1514.0,583.8571428571429
91418296.0,6,24,1829,13,989,7617468.833333333,95.0,76.07692307692308,11,840,9141218.0,95.0,76.36363636363636
1318633.0,6,4,264,2,132,0.0,66.0,66.0,2,132,0.0,66.0,66.0
118781405.0,6,48,3168,24,1584,5164408.913043479,66.0,66.0,24,1584,5152414.956521739,66.0,66.0
146168.0,6,3,337,2,214,0.0,160.0,107.0,1,123,0.0,123.0,123.0
90526640.0,6,14,2240,8,1016,12932377.142857144,188.0,127.0,6,1224,18072882.0,204.0,204.0
2373.0,17,4,344,2,150,0.0,75.0,75.0,2,194,0.0,103.0,97.0
110171316.0,6,211,23840,106,7218,1049250.6285714286,140.0,68.09433962264151,105,16622,1049360.125,284.0,158.3047619047619
116132.0,6,2,132,1,66,0.0,66.0,66.0,1,66,0.0,66.0,66.0
144591.0,6,2,132,1,66,0.0,66.0,66.0,1,66,0.0,66.0,66.0
223871.0,6,12,1354,6,723,43897.0,253.0,120.5,6,631,43812.0,293.0,105.16666666666669
268073.0,6,3,337,2,214,0.0,160.0,107.0,1,123,0.0,123.0,123.0
3029380.0,6,148,124489,88,116227,34820.45977011494,1510.0,1320.7613636363635,60,8262,46162.69491525424,1510.0,137.7
93342925.0,6,40,2640,20,1320,4912785.52631579,66.0,66.0,20,1320,4896238.631578947,66.0,66.0
301402.0,6,6,412,4,272,100467.33333333331,74.0,68.0,2,140,0.0,74.0,70.0
802444.0,17,6,1230,3,234,401037.0,78.0,78.0,3,996,401019.5,332.0,332.0
135128732.0,17,6,1206,6,1206,27025746.4,201.0,201.0,0,0,0.0,0.0,0.0
126001422.0,17,15,907,8,475,18000203.14285714,174.0,59.375,7,432,17668110.166666668,174.0,61.71428571428572
107044.0,17,2,286,2,286,0.0,143.0,143.0,0,0,0.0,0.0,0.0
135135653.0,17,6,1206,6,1206,27027130.6,201.0,201.0,0,0,0.0,0.0,0.0
228466.0,17,2,180,1,90,0.0,90.0,90.0,1,90,0.0,90.0,90.0
108160.0,17,2,286,2,286,0.0,143.0,143.0,0,0,0.0,0.0,0.0
123730501.0,6,49,3234,25,1650,5155437.541666667,66.0,66.0,24,1584,5101190.217391305,66.0,66.0
815119.0,6,12,1354,6,723,162424.8,253.0,120.5,6,631,161745.6,293.0,105.16666666666669
243205.0,6,3,337,2,214,0.0,160.0,107.0,1,123,0.0,123.0,123.0
154711.0,6,2,132,1,66,0.0,66.0,66.0,1,66,0.0,66.0,66.0
83.0,17,2,762,2,762,0.0,381.0,381.0,0,0,0.0,0.0,0.0
337.0,17,2,166,1,75,0.0,75.0,75.0,1,91,0.0,91.0,91.0
2589212.0,6,2,132,1,66,0.0,66.0,66.0,1,66,0.0,66.0,66.0
51570685.0,6,12,884,6,437,10314137.0,95.0,72.83333333333333,6,447,10268747.8,95.0,74.5
108105449.0,17,5,955,5,955,27026362.25,191.0,191.0,0,0,0.0,0.0,0.0
1090072.0,6,13,1386,7,789,181678.66666666663,253.0,112.71428571428572,6,597,217246.2,259.0,99.5
323469.0,6,6,412,4,272,107823.0,74.0,68.0,2,140,0.0,74.0,70.0
238461.0,6,3,373,2,238,0.0,172.0,119.0,1,135,0.0,135.0,135.0
228219.0,17,2,180,1,90,0.0,90.0,90.0,1,90,0.0,90.0,90.0
204021.0,17,2,762,2,762,0.0,381.0,381.0,0,0,0.0,0.0,0.0
604652.0,6,4,508,2,238,0.0,172.0,119.0,2,270,0.0,135.0,135.0
320968.0,17,4,1400,4,1400,106989.33333333331,350.0,350.0,0,0,0.0,0.0,0.0
135124360.0,17,6,1146,6,1146,27024872.0,191.0,191.0,0,0,0.0,0.0,0.0
314614.0,17,4,1400,4,1400,104871.33333333331,350.0,350.0,0,0,0.0,0.0,0.0
107140.0,17,2,286,2,286,0.0,143.0,143.0,0,0,0.0,0.0,0.0
12849.0,17,4,823,2,163,0.0,89.0,81.5,2,660,0.0,443.0,330.0
320572.0,17,4,1400,4,1400,106857.33333333331,350.0,350.0,0,0,0.0,0.0,0.0
61836.0,6,10,2032,5,524,15198.5,252.0,104.8,5,1508,14900.5,1236.0,301.6
2934.0,17,2,762,2,762,0.0,381.0,381.0,0,0,0.0,0.0,0.0
100704407.0,17,13,821,7,432,16757576.0,174.0,61.71428571428572,6,389,19949470.6,174.0,64.83333333333333
232827.0,6,3,337,2,214,0.0,160.0,107.0,1,123,0.0,123.0,123.0
3175488.0,6,18,1495,9,921,358377.25,315.0,102.33333333333331,9,574,357957.75,78.0,63.77777777777778
120032144.0,17,29,13785,29,13785,4286862.285714285,501.0,475.3448275862069,0,0,0.0,0.0,0.0
91.0,17,2,762,2,762,0.0,381.0,381.0,0,0,0.0,0.0,0.0
170001.0,17,2,180,1,90,0.0,90.0,90.0,1,90,0.0,90.0,90.0
90253777.0,6,12,1832,8,1016,12893396.714285716,188.0,127.0,4,816,30029467.0,204.0,204.0
103843813.0,6,38,2842,19,1471,5769100.722222222,139.0,77.42105263157895,19,1371,5757087.055555556,123.0,72.15789473684211
90018614.0,17,28,13364,28,13364,3334022.7407407407,501.0,477.2857142857143,0,0,0.0,0.0,0.0
117471709.0,6,201,22708,101,15886,1174717.09,284.0,157.2871287128713,100,6822,1176180.2121212122,140.0,68.22
318044.0,17,4,1400,4,1400,106014.66666666669,350.0,350.0,0,0,0.0,0.0,0.0
1033802.0,6,11,1134,6,558,206760.4,220.0,93.0,5,576,256749.75,304.0,115.2
250119.0,17,4,1524,4,1524,83373.0,381.0,381.0,0,0,0.0,0.0,0.0
209545.0,17,2,180,1,90,0.0,90.0,90.0,1,90,0.0,90.0,90.0
90764387.0,6,27,2073,15,1138,6479875.785714285,95.0,75.86666666666666,12,935,8225489.454545454,95.0,77.91666666666667
2107.0,17,4,344,2,150,0.0,75.0,75.0,2,194,0.0,103.0,97.0
505333.00000000006,6,5,336,2,134,0.0,68.0,67.0,3,202,192822.0,70.0,67.33333333333333
299630.0,6,6,412,4,272,99876.66666666669,74.0,68.0,2,140,0.0,74.0,70.0
203889.0,17,4,6056,4,6056,67963.0,1514.0,1514.0,0,0,0.0,0.0,0.0
90258485.0,6,12,1832,8,1016,12894069.285714284,188.0,127.0,4,816,30031095.666666668,204.0,204.0
2597344.0,6,2,132,1,66,0.0,66.0,66.0,1,66,0.0,66.0,66.0
1054317.0,6,3,204,1,68,0.0,68.0,68.0,2,136,0.0,70.0,68.0
36956.0,6,14,4740,7,653,5251.5,249.0,93.28571428571428,7,4087,6021.333333333333,1514.0,583.8571428571429
34809.0,6,14,4740,7,653,4087.8333333333335,249.0,93.28571428571428,7,4087,5632.0,1514.0,583.8571428571429
49846.0,6,14,4740,7,653,7317.333333333333,249.0,93.28571428571428,7,4087,7511.166666666667,1514.0,583.8571428571429
216345.0,17,2,180,1,90,0.0,90.0,90.0,1,90,0.0,90.0,90.0
153378.0,17,2,180,1,90,0.0,90.0,90.0,1,90,0.0,90.0,90.0
1012855.0,6,12,1354,6,723,201039.0,253.0,120.5,6,631,202092.0,293.0,105.16666666666669
120031115.0,17,29,13785,29,13785,4286825.535714285,501.0,475.3448275862069,0,0,0.0,0.0,0.0
1000590.0,6,12,1354,6,723,197995.2,253.0,120.5,6,631,198886.2,293.0,105.16666666666669
36648.0,6,14,4740,7,653,5397.166666666667,249.0,93.28571428571428,7,4087,5432.0,1514.0,583.8571428571429
27731.0,6,14,4740,7,653,4364.166666666667,249.0,93.28571428571428,7,4087,4326.5,1514.0,583.8571428571429
228440.0,17,2,180,1,90,0.0,90.0,90.0,1,90,0.0,90.0,90.0
37611.0,6,14,4740,7,653,6146.0,249.0,93.28571428571428,7,4087,5317.5,1514.0,583.8571428571429
26590.0,6,10,2032,5,524,6412.5,252.0,104.8,5,1508,6399.75,1236.0,301.6
105045014.0,17,14,4788,14,4788,8080385.692307692,342.0,342.0,0,0,0.0,0.0,0.0
468242.0,6,3,204,1,68,0.0,68.0,68.0,2,136,0.0,70.0,68.0
10470934.0,6,7,478,4,272,3443412.0,74.0,68.0,3,206,5165012.0,74.0,68.66666666666667
135134487.0,17,6,1206,6,1206,27026897.4,201.0,201.0,0,0,0.0,0.0,0.0
71.0,17,2,762,2,762,0.0,381.0,381.0,0,0,0.0,0.0,0.0
108107358.0,17,5,1005,5,1005,27026839.5,201.0,201.0,0,0,0.0,0.0,0.0
318724.0,17,4,1400,4,1400,106241.33333333331,350.0,350.0,0,0,0.0,0.0,0.0
37353.0,6,14,4740,7,653,6053.833333333333,249.0,93.28571428571428,7,4087,6086.833333333333,1514.0,583.8571428571429
3007346.0,6,12,2172,7,664,501169.6666666667,252.0,94.85714285714286,5,1508,2438.75,1236.0,301.6
68856.0,6,14,4740,7,653,10070.833333333334,249.0,93.28571428571428,7,4087,10546.833333333334,1514.0,583.8571428571429
19270.0,6,10,2032,5,524,4603.75,252.0,104.8,5,1508,4573.5,1236.0,301.6
216685.0,6,3,426,2,280,0.0,214.0,140.0,1,146,0.0,146.0,146.0
209446.0,17,2,180,1,90,0.0,90.0,90.0,1,90,0.0,90.0,90.0
297407.0,6,6,412,4,272,99135.66666666669,74.0,68.0,2,140,0.0,74.0,70.0
120378622.0,6,213,24008,107,16716,1135647.3773584906,284.0,156.22429906542055,106,7292,1136616.6285714286,140.0,68.79245283018868
1506232.0,6,4,276,2,128,0.0,74.0,64.0,2,148,0.0,74.0,74.0
1500827.0,17,16,1120,16,1120,100055.13333333332,70.0,70.0,0,0,0.0,0.0,0.0
119680807.0,17,34,16284,34,16284,3626691.121212121,501.0,478.9411764705882,0,0,0.0,0.0,0.0
46787872.0,6,8,1940,3,887,22240801.5,753.0,295.6666666666667,5,1053,11003872.0,785.0,210.6
2077.0,17,4,344,2,150,0.0,75.0,75.0,2,194,0.0,103.0,97.0
120001300.0,6,17,1246,9,650,15000162.5,95.0,72.22222222222223,8,596,17104743.57142857,95.0,74.5
16895.0,6,14,4740,7,653,2688.833333333333,249.0,93.28571428571428,7,4087,2464.0,1514.0,583.8571428571429
202108.0,17,4,6056,4,6056,67369.33333333333,1514.0,1514.0,0,0,0.0,0.0,0.0
3529191.0,6,11,738,5,342,880817.75,95.0,68.4,6,396,703867.4,95.0,66.0
178175.0,17,2,180,1,90,0.0,90.0,90.0,1,90,0.0,90.0,90.0
91143240.0,17,12,778,6,389,18201107.4,174.0,64.83333333333333,6,389,18200163.2,174.0,64.83333333333333
120805983.0,17,14,1126,7,563,16833734.333333332,174.0,80.42857142857143,7,563,17536939.166666668,174.0,80.42857142857143
50513.0,6,14,4740,7,653,7866.666666666667,249.0,93.28571428571428,7,4087,6436.833333333333,1514.0,583.8571428571429
399981.0,17,4,6056,4,6056,133327.0,1514.0,1514.0,0,0,0.0,0.0,0.0
6172118.0,17,5,1710,5,1710,1543029.5,342.0,342.0,0,0,0.0,0.0,0.0
90982374.0,6,154,17458,77,12216,1194305.4473684211,284.0,158.64935064935065,77,5242,1194305.4210526317,140.0,68.07792207792208
1244050.0,17,7,490,7,490,207341.66666666663,70.0,70.0,0,0,0.0,0.0,0.0
1188210.0,6,13,3010,8,2382,169744.2857142857,1514.0,297.75,5,628,228191.5,331.0,125.6
223790.0,6,12,1373,7,714,37298.333333333336,298.0,102.0,5,659,54949.25,379.0,131.8
122822.0,6,3,373,2,238,0.0,172.0,119.0,1,135,0.0,135.0,135.0
199939.0,17,2,180,1,90,0.0,90.0,90.0,1,90,0.0,90.0,90.0
90050994.0,17,27,12943,27,12943,3463499.769230769,501.0,479.3703703703704,0,0,0.0,0.0,0.0
103568550.0,17,14,864,7,432,17168066.666666668,174.0,61.71428571428572,7,432,17166837.666666668,174.0,61.71428571428572
350.0,17,2,267,1,83,0.0,83.0,83.0,1,184,0.0,184.0,184.0
51066.0,6,14,4740,7,653,8241.833333333334,249.0,93.28571428571428,7,4087,8181.166666666667,1514.0,583.8571428571429
55383.0,6,14,4740,7,653,8941.166666666666,249.0,93.28571428571428,7,4087,8497.833333333334,1514.0,583.8571428571429
39542.0,6,10,2032,5,524,9652.25,252.0,104.8,5,1508,9558.5,1236.0,301.6
315898.0,6,6,412,4,272,105299.33333333331,74.0,68.0,2,140,0.0,74.0,70.0
5006600.0,17,4,1164,2,166,0.0,83.0,83.0,2,998,0.0,499.0,499.0
135136392.0,17,6,1206,6,1206,27027278.4,201.0,201.0,0,0,0.0,0.0,0.0
27122502.0,17,3,1034,2,684,0.0,342.0,342.0,1,350,0.0,350.0,350.0
338.0,17,2,267,1,83,0.0,83.0,83.0,1,184,0.0,184.0,184.0
143844.0,17,2,180,1,90,0.0,90.0,90.0,1,90,0.0,90.0,90.0
228126.0,17,2,180,1,90,0.0,90.0,90.0,1,90,0.0,90.0,90.0
27612.0,6,11,2098,6,590,5522.4,252.0,98.33333333333331,5,1508,5688.0,1236.0,301.6
76283.0,6,10,2032,5,524,17885.25,252.0,104.8,5,1508,18688.25,1236.0,301.6
20396.0,17,2,582,1,83,0.0,83.0,83.0,1,499,0.0,499.0,499.0
135135573.0,17,6,1146,6,1146,27027114.6,191.0,191.0,0,0,0.0,0.0,0.0
108102731.0,17,5,1005,5,1005,27025682.75,201.0,201.0,0,0,0.0,0.0,0.0
310390.0,6,3,202,2,128,0.0,74.0,64.0,1,74,0.0,74.0,74.0
3179420.0,6,18,1495,9,921,358385.875,315.0,102.33333333333331,9,574,358358.0,78.0,63.77777777777778
102390.0,17,2,762,2,762,0.0,381.0,381.0,0,0,0.0,0.0,0.0
108112296.0,17,5,1005,5,1005,27028074.0,201.0,201.0,0,0,0.0,0.0,0.0
109402962.0,6,32,2236,16,1165,7293530.8,139.0,72.8125,16,1071,7279109.133333334,123.0,66.9375
102945.0,17,2,286,2,286,0.0,143.0,143.0,0,0,0.0,0.0,0.0
256850.00000000003,6,10,1221,6,636,51370.0,298.0,106.0,4,585,80240.66666666667,379.0,146.25
217511.0,17,2,180,1,90,0.0,90.0,90.0,1,90,0.0,90.0,90.0
135143924.0,17,6,1206,6,1206,27028784.8,201.0,201.0,0,0,0.0,0.0,0.0
302841.0,6,6,412,4,272,100947.0,74.0,68.0,2,140,0.0,74.0,70.0
42403.0,6,14,4740,7,653,6840.833333333333,249.0,93.28571428571428,7,4087,6626.5,1514.0,583.8571428571429
311938.0,17,4,1400,4,1400,103979.33333333331,350.0,350.0,0,0,0.0,0.0,0.0
90035593.0,17,28,13364,28,13364,3334651.592592593,501.0,477.2857142857143,0,0,0.0,0.0,0.0
120030164.0,6,25,2042,13,1189,9999997.083333334,254.0,91.46153846153848,12,853,10910835.454545457,95.0,71.08333333333333
281467.0,17,2,363,1,79,0.0,79.0,79.0,1,284,0.0,284.0,284.0
144058.0,17,2,180,1,90,0.0,90.0,90.0,1,90,0.0,90.0,90.0
356.0,17,2,762,2,762,0.0,381.0,381.0,0,0,0.0,0.0,0.0
108109467.0,17,5,1005,5,1005,27027366.75,201.0,201.0,0,0,0.0,0.0,0.0
2365.0,17,4,344,2,150,0.0,75.0,75.0,2,194,0.0,103.0,97.0
26796.0,6,11,1131,6,600,5129.8,262.0,100.0,5,531,6298.25,259.0,106.2
295.0,17,2,164,1,82,0.0,82.0,82.0,1,82,0.0,82.0,82.0
252959.0,6,3,337,2,214,0.0,160.0,107.0,1,123,0.0,123.0,123.0
170278.0,17,2,414,1,88,0.0,88.0,88.0,1,326,0.0,326.0,326.0
298416.0,6,6,412,4,272,99472.0,74.0,68.0,2,140,0.0,74.0,70.0
403390.0,6,4,508,2,238,0.0,172.0,119.0,2,270,0.0,135.0,135.0
116381285.0,6,47,3102,24,1584,5060043.826086956,66.0,66.0,23,1518,5168185.090909091,66.0,66.0
57707203.0,6,8,1307,8,1307,8243886.142857143,172.0,163.375,0,0,0.0,0.0,0.0
108091173.0,17,5,1005,5,1005,27022793.25,201.0,201.0,0,0,0.0,0.0,0.0
665929.0,17,2,604,1,75,0.0,75.0,75.0,1,529,0.0,529.0,529.0
33012.0,6,13,1386,7,789,5185.666666666667,253.0,112.71428571428572,6,597,5811.6,259.0,99.5
2084.0,17,4,344,2,150,0.0,75.0,75.0,2,194,0.0,103.0,97.0
10417465.0,6,6,412,3,206,5140105.5,74.0,68.66666666666667,3,206,5139989.0,74.0,68.66666666666667
224517.0,6,10,1221,6,636,44903.4,298.0,106.0,4,585,73656.33333333333,379.0,146.25
312298.0,17,4,1400,4,1400,104099.33333333331,350.0,350.0,0,0,0.0,0.0,0.0
50981.0,6,14,4740,7,653,6813.0,249.0,93.28571428571428,7,4087,7971.0,1514.0,583.8571428571429
155910.0,17,2,180,1,90,0.0,90.0,90.0,1,90,0.0,90.0,90.0
96925229.0,6,175,19732,88,5956,1114083.0919540229,140.0,67.68181818181819,87,13776,1115020.5697674418,284.0,158.3448275862069
90299222.0,6,21,1585,11,840,9024909.2,95.0,76.36363636363636,10,745,10000791.555555556,95.0,74.5
143946.0,17,2,180,1,90,0.0,90.0,90.0,1,90,0.0,90.0,90.0
312821.0,17,4,1400,4,1400,104273.66666666669,350.0,350.0,0,0,0.0,0.0,0.0
109475905.0,17,13,821,7,432,18245984.166666668,174.0,61.71428571428572,6,389,17869246.8,174.0,64.83333333333333
108219486.0,17,14,864,7,432,18001580.5,174.0,61.71428571428572,7,432,18000165.333333332,174.0,61.71428571428572
3033.0,17,2,224,1,76,0.0,76.0,76.0,1,148,0.0,148.0,148.0
298632.0,6,2,132,1,66,0.0,66.0,66.0,1,66,0.0,66.0,66.0
209637.0,17,2,180,1,90,0.0,90.0,90.0,1,90,0.0,90.0,90.0
64902.0,6,14,4740,7,653,10687.333333333334,249.0,93.28571428571428,7,4087,9565.5,1514.0,583.8571428571429
106513.0,17,2,700,2,700,0.0,350.0,350.0,0,0,0.0,0.0,0.0
216359.0,17,2,180,1,90,0.0,90.0,90.0,1,90,0.0,90.0,90.0
92356600.0,17,16,5472,16,5472,6157106.666666667,342.0,342.0,0,0,0.0,0.0,0.0
90031650.0,17,28,13364,28,13364,3334505.5555555555,501.0,477.2857142857143,0,0,0.0,0.0,0.0
315.0,17,2,174,1,79,0.0,79.0,79.0,1,95,0.0,95.0,95.0
218473.0,6,3,426,2,280,0.0,214.0,140.0,1,146,0.0,146.0,146.0
90251082.0,6,13,2036,8,1016,12893011.714285716,188.0,127.0,5,1020,22522190.75,204.0,204.0
247648.0,6,3,337,2,214,0.0,160.0,107.0,1,123,0.0,123.0,123.0
108103082.0,17,5,1005,5,1005,27025770.5,201.0,201.0,0,0,0.0,0.0,0.0
10485273.0,6,7,478,4,272,3448559.0,74.0,68.0,3,206,5172736.5,74.0,68.66666666666667
26131.0,6,10,2032,5,524,5673.75,252.0,104.8,5,1508,5390.25,1236.0,301.6
1169472.0,6,13,2975,8,2347,167067.42857142858,1514.0,293.375,5,628,223451.5,331.0,125.6
301642.0,6,6,412,4,272,100547.33333333331,74.0,68.0,2,140,0.0,74.0,70.0
784.0,17,4,438,2,148,0.0,74.0,74.0,2,290,0.0,147.0,145.0
2000.0,17,2,939,1,590,0.0,590.0,590.0,1,349,0.0,349.0,349.0
21664.0,6,14,4740,7,653,2973.5,249.0,93.28571428571428,7,4087,3474.833333333333,1514.0,583.8571428571429
173464.0,6,10,1066,5,490,42192.0,218.0,98.0,5,576,43153.75,304.0,115.2
101422.0,17,2,286,2,286,0.0,143.0,143.0,0,0,0.0,0.0,0.0
317836.0,6,6,412,4,272,105945.33333333331,74.0,68.0,2,140,0.0,74.0,70.0
25635.0,6,14,4740,7,653,3830.3333333333335,249.0,93.28571428571428,7,4087,3867.8333333333335,1514.0,583.8571428571429
10439177.0,6,7,478,4,272,3434417.333333333,74.0,68.0,3,206,5151534.5,74.0,68.66666666666667
113520240.0,6,46,3036,23,1518,5159999.181818182,66.0,66.0,23,1518,5159999.136363637,66.0,66.0
54547.0,6,10,2032,5,524,12469.75,252.0,104.8,5,1508,11350.0,1236.0,301.6
270323.0,6,10,1221,6,636,54064.6,298.0,106.0,4,585,84606.0,379.0,146.25
9774.0,17,2,582,1,83,0.0,83.0,83.0,1,499,0.0,499.0,499.0
63145.99999999999,6,14,4740,7,653,10194.5,249.0,93.28571428571428,7,4087,10116.5,1514.0,583.8571428571429
143365.0,6,2,132,1,66,0.0,66.0,66.0,1,66,0.0,66.0,66.0
90258290.0,6,14,2240,8,1016,12894041.42857143,188.0,127.0,6,1224,18018835.6,204.0,204.0
272884.0,17,4,6056,4,6056,90961.33333333331,1514.0,1514.0,0,0,0.0,0.0,0.0
217901.0,6,3,426,2,280,0.0,214.0,140.0,1,146,0.0,146.0,146.0
108102393.0,17,5,1005,5,1005,27025598.25,201.0,201.0,0,0,0.0,0.0,0.0
121395.0,6,3,337,2,214,0.0,160.0,107.0,1,123,0.0,123.0,123.0
2793373.0,6,2,132,1,66,0.0,66.0,66.0,1,66,0.0,66.0,66.0
120123482.0,6,13,2036,5,1020,30030870.5,204.0,204.0,8,1016,17136917.57142857,188.0,127.0
101896.0,17,2,700,2,700,0.0,350.0,350.0,0,0,0.0,0.0,0.0
146294.0,6,3,337,2,214,0.0,160.0,107.0,1,123,0.0,123.0,123.0
207638.0,6,3,426,2,280,0.0,214.0,140.0,1,146,0.0,146.0,146.0
304079.0,17,4,1524,4,1524,101359.66666666669,381.0,381.0,0,0,0.0,0.0,0.0
120052136.0,17,28,13364,28,13364,4446375.407407408,501.0,477.2857142857143,0,0,0.0,0.0,0.0
148076.0,17,4,1524,4,1524,49358.66666666666,381.0,381.0,0,0,0.0,0.0,0.0
206003.0,6,3,426,2,280,0.0,214.0,140.0,1,146,0.0,146.0,146.0
196924.0,17,2,180,1,90,0.0,90.0,90.0,1,90,0.0,90.0,90.0
101535.0,17,2,286,2,286,0.0,143.0,143.0,0,0,0.0,0.0,0.0
153491.0,17,2,180,1,90,0.0,90.0,90.0,1,90,0.0,90.0,90.0
131679.0,6,2,132,1,66,0.0,66.0,66.0,1,66,0.0,66.0,66.0
301619.0,6,6,412,4,272,100539.66666666669,74.0,68.0,2,140,0.0,74.0,70.0
104276.0,17,2,286,2,286,0.0,143.0,143.0,0,0,0.0,0.0,0.0
101292503.0,17,14,864,7,432,16835113.0,174.0,61.71428571428572,7,432,16833528.666666668,174.0,61.71428571428572
314410.0,17,4,1400,4,1400,104803.33333333331,350.0,350.0,0,0,0.0,0.0,0.0
161209.0,17,2,180,1,90,0.0,90.0,90.0,1,90,0.0,90.0,90.0
1321449.0,6,4,264,2,132,0.0,66.0,66.0,2,132,0.0,66.0,66.0
108096172.0,17,5,955,5,955,27024043.0,191.0,191.0,0,0,0.0,0.0,0.0
16839.0,17,2,180,1,90,0.0,90.0,90.0,1,90,0.0,90.0,90.0
64665.0,6,14,4740,7,653,8781.166666666666,249.0,93.28571428571428,7,4087,10626.0,1514.0,583.8571428571429
2398.0,17,4,344,2,150,0.0,75.0,75.0,2,194,0.0,103.0,97.0
153450.0,17,2,180,1,90,0.0,90.0,90.0,1,90,0.0,90.0,90.0
27525.0,6,14,4740,7,653,4477.666666666667,249.0,93.28571428571428,7,4087,4112.666666666667,1514.0,583.8571428571429
242013.0,6,3,337,2,214,0.0,160.0,107.0,1,123,0.0,123.0,123.0
866676.0,6,9,1267,6,796,173335.2,458.0,132.66666666666666,3,471,295472.5,331.0,157.0
2074.0,17,4,344,2,150,0.0,75.0,75.0,2,194,0.0,103.0,97.0
31823.0,6,10,2032,5,524,7225.75,252.0,104.8,5,1508,7123.5,1236.0,301.6
233724.0,6,12,1373,7,714,38954.0,298.0,102.0,5,659,56546.25,379.0,131.8
39041.0,6,14,4740,7,653,6342.333333333333,249.0,93.28571428571428,7,4087,5967.833333333333,1514.0,583.8571428571429
2590528.0,6,2,132,1,66,0.0,66.0,66.0,1,66,0.0,66.0,66.0
1316214.0,6,4,264,2,132,0.0,66.0,66.0,2,132,0.0,66.0,66.0
10441197.0,6,7,478,4,272,3435060.333333333,74.0,68.0,3,206,5152460.0,74.0,68.66666666666667
59877.0,6,14,4740,7,653,9856.833333333334,249.0,93.28571428571428,7,4087,9033.333333333334,1514.0,583.8571428571429
0.0,6,1,60,1,60,0.0,60.0,60.0,0,0,0.0,0.0,0.0
241148.0,6,3,337,2,214,0.0,160.0,107.0,1,123,0.0,123.0,123.0
97060.0,17,2,762,2,762,0.0,381.0,381.0,0,0,0.0,0.0,0.0
228472.0,17,2,180,1,90,0.0,90.0,90.0,1,90,0.0,90.0,90.0
121051.0,6,3,373,2,238,0.0,172.0,119.0,1,135,0.0,135.0,135.0
9242.0,17,2,498,1,80,0.0,80.0,80.0,1,418,0.0,418.0,418.0
115969781.0,6,48,3168,24,1584,5042164.391304348,66.0,66.0,24,1584,5028893.521739131,66.0,66.0
2049.0,17,4,344,2,150,0.0,75.0,75.0,2,194,0.0,103.0,97.0
305358.0,6,6,412,4,272,101786.0,74.0,68.0,2,140,0.0,74.0,70.0
70288.0,6,14,4740,7,653,10770.666666666666,249.0,93.28571428571428,7,4087,11480.5,1514.0,583.8571428571429
99751145.0,6,214,24318,107,7284,933258.9905660376,140.0,68.07476635514018,107,17034,933301.6037735848,300.0,159.19626168224298
143881.0,17,2,180,1,90,0.0,90.0,90.0,1,90,0.0,90.0,90.0
9006395.0,17,4,300,4,300,3002131.6666666665,75.0,75.0,0,0,0.0,0.0,0.0
319919.0,6,6,412,4,272,106639.66666666669,74.0,68.0,2,140,0.0,74.0,70.0
16247.999999999998,6,14,4740,7,653,2521.333333333333,249.0,93.28571428571428,7,4087,2570.5,1514.0,583.8571428571429
318396.0,6,6,412,4,272,106132.0,74.0,68.0,2,140,0.0,74.0,70.0
20682.0,6,14,4740,7,653,3149.833333333333,249.0,93.28571428571428,7,4087,3111.5,1514.0,583.8571428571429
11160.0,6,11,2098,6,590,2138.0,252.0,98.33333333333331,5,1508,2487.5,1236.0,301.6
31211.0,6,14,4740,7,653,4976.0,249.0,93.28571428571428,7,4087,5065.666666666667,1514.0,583.8571428571429
17135.0,6,14,4740,7,653,2543.0,249.0,93.28571428571428,7,4087,2712.1666666666665,1514.0,583.8571428571429
108087216.0,17,5,955,5,955,27021804.0,191.0,191.0,0,0,0.0,0.0,0.0
844452.0,6,9,1096,6,625,168890.4,287.0,104.16666666666669,3,471,285935.0,331.0,157.0
135132303.0,17,6,1206,6,1206,27026460.6,201.0,201.0,0,0,0.0,0.0,0.0
108105805.0,17,5,955,5,955,27026451.25,191.0,191.0,0,0,0.0,0.0,0.0
0.0,6,1,66,1,66,0.0,66.0,66.0,0,0,0.0,0.0,0.0
108098367.0,17,5,1005,5,1005,27024591.75,201.0,201.0,0,0,0.0,0.0,0.0
20152.0,17,2,582,1,83,0.0,83.0,83.0,1,499,0.0,499.0,499.0
4982.0,17,2,582,1,83,0.0,83.0,83.0,1,499,0.0,499.0,499.0
207276.0,6,3,426,2,280,0.0,214.0,140.0,1,146,0.0,146.0,146.0
90098130.0,6,11,1644,4,816,30031931.33333333,204.0,204.0,7,828,15015960.333333334,188.0,118.28571428571428
232951.0,6,3,373,2,238,0.0,172.0,119.0,1,135,0.0,135.0,135.0
10532425.0,6,7,478,4,272,3465251.0,74.0,68.0,3,206,5197770.0,74.0,68.66666666666667
90018944.0,17,27,12943,27,12943,3462267.076923077,501.0,479.3703703703704,0,0,0.0,0.0,0.0
833436.0,6,9,1118,6,586,166687.2,248.0,97.66666666666669,3,532,280379.5,392.0,177.33333333333334
1044906.0,6,3,1604,2,851,0.0,785.0,425.5,1,753,0.0,753.0,753.0
120694516.0,6,23,1775,11,840,12069451.6,95.0,76.36363636363636,12,935,8221824.272727272,95.0,77.91666666666667
984995.0,17,6,1230,3,234,492305.5,78.0,78.0,3,996,492297.0,332.0,332.0
26445.0,6,10,2032,5,524,5165.0,252.0,104.8,5,1508,4578.0,1236.0,301.6
1419888.0,17,16,1120,16,1120,94659.2,70.0,70.0,0,0,0.0,0.0,0.0
16850.0,6,14,4740,7,653,2187.5,249.0,93.28571428571428,7,4087,2675.0,1514.0,583.8571428571429
115408222.0,6,213,24046,107,7358,1088756.8113207547,140.0,68.76635514018692,106,16688,1091778.8476190476,284.0,157.43396226415095
513389.0,6,2,145,2,145,0.0,91.0,72.5,0,0,0.0,0.0,0.0
14354.0,6,11,2098,6,590,2369.0,252.0,98.33333333333331,5,1508,2768.25,1236.0,301.6
120037175.0,17,28,13364,28,13364,4445821.296296297,501.0,477.2857142857143,0,0,0.0,0.0,0.0
59083.0,6,14,4740,7,653,9491.0,249.0,93.28571428571428,7,4087,7767.5,1514.0,583.8571428571429
30545.0,6,14,4740,7,653,4499.166666666667,249.0,93.28571428571428,7,4087,4149.5,1514.0,583.8571428571429
101972.0,17,2,762,2,762,0.0,381.0,381.0,0,0,0.0,0.0,0.0
279321.0,6,12,1373,7,714,46553.5,298.0,102.0,5,659,65461.0,379.0,131.8
2412.0,17,4,344,2,150,0.0,75.0,75.0,2,194,0.0,103.0,97.0
90041603.0,17,27,12943,27,12943,3463138.576923077,501.0,479.3703703703704,0,0,0.0,0.0,0.0
99976.0,17,2,286,2,286,0.0,143.0,143.0,0,0,0.0,0.0,0.0
15033094.0,17,6,2718,6,2718,3006618.8,453.0,453.0,0,0,0.0,0.0,0.0
44581.0,6,11,2098,6,590,8054.4,252.0,98.33333333333331,5,1508,8100.5,1236.0,301.6
60062120.0,6,7,982,5,574,15015530.0,188.0,114.8,2,408,0.0,204.0,204.0
338.0,17,2,191,1,73,0.0,73.0,73.0,1,118,0.0,118.0,118.0
39827.0,6,14,4740,7,653,5663.833333333333,249.0,93.28571428571428,7,4087,5814.666666666667,1514.0,583.8571428571429
217832.0,6,3,426,2,280,0.0,214.0,140.0,1,146,0.0,146.0,146.0
9292.0,17,2,582,1,83,0.0,83.0,83.0,1,499,0.0,499.0,499.0
108110331.0,17,5,1005,5,1005,27027582.75,201.0,201.0,0,0,0.0,0.0,0.0
10438279.0,6,7,478,4,272,3433841.333333333,74.0,68.0,3,206,5150564.0,74.0,68.66666666666667
215309.0,6,10,1221,6,636,43061.8,298.0,106.0,4,585,70806.33333333333,379.0,146.25
36149.0,6,14,4740,7,653,4504.333333333333,249.0,93.28571428571428,7,4087,5761.5,1514.0,583.8571428571429
309739.0,17,4,1400,4,1400,103246.33333333331,350.0,350.0,0,0,0.0,0.0,0.0
2353.0,17,4,344,2,150,0.0,75.0,75.0,2,194,0.0,103.0,97.0
11924.0,6,10,1949,5,441,2778.75,169.0,88.2,5,1508,2225.75,1236.0,301.6
96390.0,17,2,762,2,762,0.0,381.0,381.0,0,0,0.0,0.0,0.0
108104232.0,17,5,1005,5,1005,27026058.0,201.0,201.0,0,0,0.0,0.0,0.0
232182.0,6,3,337,2,214,0.0,160.0,107.0,1,123,0.0,123.0,123.0
817.0,17,2,762,2,762,0.0,381.0,381.0,0,0,0.0,0.0,0.0
804.0,17,4,438,2,148,0.0,74.0,74.0,2,290,0.0,147.0,145.0
14981.0,17,2,180,1,90,0.0,90.0,90.0,1,90,0.0,90.0,90.0
977505.0,6,12,1362,6,731,193998.2,253.0,121.83333333333331,6,631,195226.0,293.0,105.16666666666669
1735730.0,6,23,6508,12,1529,157793.63636363635,357.0,127.41666666666669,11,4979,142150.1,1510.0,452.6363636363636
27465259.0,17,5,1710,5,1710,6866314.75,342.0,342.0,0,0,0.0,0.0,0.0
101491.0,17,2,286,2,286,0.0,143.0,143.0,0,0,0.0,0.0,0.0
153451.0,17,2,180,1,90,0.0,90.0,90.0,1,90,0.0,90.0,90.0
10442074.0,6,7,478,4,272,3433753.6666666665,74.0,68.0,3,206,5150503.0,74.0,68.66666666666667
120601.0,6,3,337,2,214,0.0,160.0,107.0,1,123,0.0,123.0,123.0
119361509.0,6,23,1734,13,989,9943412.25,95.0,76.07692307692308,10,745,13261313.111111112,95.0,74.5
1431771.0,17,16,1120,16,1120,95451.4,70.0,70.0,0,0,0.0,0.0,0.0
100783.0,17,2,762,2,762,0.0,381.0,381.0,0,0,0.0,0.0,0.0
96995.0,6,12,1320,7,789,16165.833333333334,253.0,112.71428571428572,5,531,19026.5,259.0,106.2
282021.0,17,4,1400,4,1400,94007.0,350.0,350.0,0,0,0.0,0.0,0.0
146544.0,6,3,337,2,214,0.0,160.0,107.0,1,123,0.0,123.0,123.0
208916.0,6,3,426,2,280,0.0,214.0,140.0,1,146,0.0,146.0,146.0
31895.0,6,14,4740,7,653,4723.666666666667,249.0,93.28571428571428,7,4087,5140.5,1514.0,583.8571428571429
206845.0,6,3,426,2,280,0.0,214.0,140.0,1,146,0.0,146.0,146.0
2802933.0,6,2,132,1,66,0.0,66.0,66.0,1,66,0.0,66.0,66.0
121868.0,6,3,373,2,238,0.0,172.0,119.0,1,135,0.0,135.0,135.0
204823.0,17,4,1524,4,1524,68274.33333333333,381.0,381.0,0,0,0.0,0.0,0.0
120000595.0,6,22,1680,11,840,12000059.5,95.0,76.36363636363636,11,840,9000787.0,95.0,76.36363636363636
810.0,17,5,550,5,550,202.5,110.0,110.0,0,0,0.0,0.0,0.0
107378.0,17,2,286,2,286,0.0,143.0,143.0,0,0,0.0,0.0,0.0
867994.0,6,9,1268,6,797,173598.8,459.0,132.83333333333334,3,471,297509.5,331.0,157.0
108095961.0,17,5,1005,5,1005,27023990.25,201.0,201.0,0,0,0.0,0.0,0.0
50685.0,17,2,180,1,90,0.0,90.0,90.0,1,90,0.0,90.0,90.0
135132839.0,17,6,1146,6,1146,27026567.8,191.0,191.0,0,0,0.0,0.0,0.0
2093.0,17,4,344,2,150,0.0,75.0,75.0,2,194,0.0,103.0,97.0
4528.0,17,2,614,1,72,0.0,72.0,72.0,1,542,0.0,542.0,542.0
291794.0,17,2,363,1,79,0.0,79.0,79.0,1,284,0.0,284.0,284.0
199047.0,17,4,6056,4,6056,66349.0,1514.0,1514.0,0,0,0.0,0.0,0.0
120000051.0,6,17,1287,9,691,15000006.375,95.0,76.77777777777777,8,596,12894137.285714284,95.0,74.5
215399.0,17,2,180,1,90,0.0,90.0,90.0,1,90,0.0,90.0,90.0
161467.0,6,3,337,2,214,0.0,160.0,107.0,1,123,0.0,123.0,123.0
4571.0,17,2,626,1,72,0.0,72.0,72.0,1,554,0.0,554.0,554.0
45644.0,6,14,4740,7,653,7261.5,249.0,93.28571428571428,7,4087,6919.5,1514.0,583.8571428571429
2807710.0,6,2,132,1,66,0.0,66.0,66.0,1,66,0.0,66.0,66.0
104571.0,17,2,700,2,700,0.0,350.0,350.0,0,0,0.0,0.0,0.0
402545.0,6,4,508,2,238,0.0,172.0,119.0,2,270,0.0,135.0,135.0
300165.0,6,6,412,4,272,100055.0,74.0,68.0,2,140,0.0,74.0,70.0
120381445.0,6,235,26684,118,18666,1028901.2393162394,284.0,158.1864406779661,117,8018,1029119.1379310344,140.0,68.52991452991454
410.0,17,2,508,2,508,0.0,257.0,254.0,0,0,0.0,0.0,0.0
503.0,17,2,508,2,508,0.0,257.0,254.0,0,0,0.0,0.0,0.0
287086.0,17,2,359,1,75,0.0,75.0,75.0,1,284,0.0,284.0,284.0
53628850.0,17,4,360,2,180,0.0,90.0,90.0,2,180,0.0,90.0,90.0
236176.0,6,3,337,2,214,0.0,160.0,107.0,1,123,0.0,123.0,123.0
17957758.0,6,31,9412,17,3897,153739.6875,1514.0,229.23529411764707,14,5515,1365625.0,1514.0,393.9285714285714
82621.0,6,12,1328,7,797,13770.166666666666,253.0,113.85714285714286,5,531,15940.0,259.0,106.2
93397917.0,6,40,2640,20,1320,4915679.842105263,66.0,66.0,20,1320,4904297.894736842,66.0,66.0
318951.0,17,4,1400,4,1400,106317.0,350.0,350.0,0,0,0.0,0.0,0.0
104550455.0,6,44,2904,22,1452,4978593.095238095,66.0,66.0,22,1452,4965618.428571428,66.0,66.0
17429.0,6,11,2098,6,590,3385.2,252.0,98.33333333333331,5,1508,4095.75,1236.0,301.6
90295740.0,6,14,1043,7,542,15049290.0,95.0,77.42857142857143,7,501,15002054.833333334,95.0,71.57142857142857
10480437.0,6,7,478,4,272,3447798.6666666665,74.0,68.0,3,206,5171572.0,74.0,68.66666666666667
113428233.0,6,231,26060,116,7878,986332.4608695653,140.0,67.91379310344827,115,18182,985886.201754386,284.0,158.10434782608695
2100299.0,6,24,6999,13,2047,175024.91666666666,575.0,157.46153846153845,11,4952,178120.9,1510.0,450.1818181818182
100598808.0,17,12,778,6,389,19914876.6,174.0,64.83333333333333,6,389,20087980.6,174.0,64.83333333333333
217124.0,17,2,180,1,90,0.0,90.0,90.0,1,90,0.0,90.0,90.0
10890926.0,6,8,544,4,272,3584849.6666666665,74.0,68.0,4,272,3584791.333333333,74.0,68.0
34343.0,6,10,2032,5,524,8289.25,252.0,104.8,5,1508,6708.75,1236.0,301.6
135128932.0,17,6,1206,6,1206,27025786.4,201.0,201.0,0,0,0.0,0.0,0.0
247317.0,6,3,337,2,214,0.0,160.0,107.0,1,123,0.0,123.0,123.0
144883.0,17,2,180,1,70,0.0,70.0,70.0,1,110,0.0,110.0,110.0
37769.0,6,14,4740,7,653,6038.0,249.0,93.28571428571428,7,4087,6094.0,1514.0,583.8571428571429
208226.0,6,3,426,2,280,0.0,214.0,140.0,1,146,0.0,146.0,146.0
301583.0,6,6,412,4,272,100527.66666666669,74.0,68.0,2,140,0.0,74.0,70.0
90295776.0,6,17,1287,8,637,12899396.57142857,95.0,79.625,9,650,11254963.5,95.0,72.22222222222223
103225.0,17,2,762,2,762,0.0,381.0,381.0,0,0,0.0,0.0,0.0
120123062.0,6,15,2428,9,1204,15015382.75,188.0,133.77777777777777,6,1224,18072003.2,204.0,204.0
50898.0,17,2,180,1,90,0.0,90.0,90.0,1,90,0.0,90.0,90.0
118473689.0,6,45,3762,21,1755,5923662.15,123.0,83.57142857142857,24,2007,4716876.826086956,123.0,83.625
118294229.0,6,48,3168,24,1584,5143227.347826087,66.0,66.0,24,1584,5129803.608695652,66.0,66.0
120222974.0,6,232,26306,116,7878,1038249.9565217393,140.0,67.91379310344827,116,18428,1038285.591304348,284.0,158.86206896551724
3130773.0,6,3,1604,2,851,0.0,785.0,425.5,1,753,0.0,753.0,753.0
1841.0,17,4,344,2,150,0.0,75.0,75.0,2,194,0.0,103.0,97.0
90296137.0,6,19,1436,10,745,10027523.111111112,95.0,74.5,9,691,11285633.25,95.0,76.77777777777777
193232.0,17,2,180,1,90,0.0,90.0,90.0,1,90,0.0,90.0,90.0
57191.0,6,14,4740,7,653,9183.666666666666,249.0,93.28571428571428,7,4087,8547.166666666666,1514.0,583.8571428571429
54307.0,6,14,4740,7,653,8922.833333333334,249.0,93.28571428571428,7,4087,8882.833333333334,1514.0,583.8571428571429
103160.0,17,2,286,2,286,0.0,143.0,143.0,0,0,0.0,0.0,0.0
27427.0,6,10,2032,5,524,6514.75,252.0,104.8,5,1508,6514.5,1236.0,301.6
100998.0,17,2,286,2,286,0.0,143.0,143.0,0,0,0.0,0.0,0.0
90040206.0,17,28,13364,28,13364,3334822.4444444445,501.0,477.2857142857143,0,0,0.0,0.0,0.0
228252.0,17,2,180,1,90,0.0,90.0,90.0,1,90,0.0,90.0,90.0
324.0,17,2,166,1,75,0.0,75.0,75.0,1,91,0.0,91.0,91.0
135129494.0,17,6,1206,6,1206,27025898.8,201.0,201.0,0,0,0.0,0.0,0.0
9565.0,17,2,498,1,80,0.0,80.0,80.0,1,418,0.0,418.0,418.0
146234.0,6,3,337,2,214,0.0,160.0,107.0,1,123,0.0,123.0,123.0
41950.0,6,14,4740,7,653,6756.666666666667,249.0,93.28571428571428,7,4087,5831.166666666667,1514.0,583.8571428571429
302351.0,6,6,412,4,272,100783.66666666669,74.0,68.0,2,140,0.0,74.0,70.0
143965.0,17,2,180,1,90,0.0,90.0,90.0,1,90,0.0,90.0,90.0
90662263.0,6,15,2302,9,1204,11316439.875,188.0,133.77777777777777,6,1098,18099969.4,204.0,183.0
90304336.0,6,16,1192,8,596,12893555.285714284,95.0,74.5,8,596,12898458.0,95.0,74.5
33317.0,6,14,4740,7,653,4797.333333333333,249.0,93.28571428571428,7,4087,5408.333333333333,1514.0,583.8571428571429
124580923.0,17,15,1169,7,563,17500968.0,174.0,80.42857142857143,8,606,17714474.714285713,174.0,75.75
20430.0,6,14,4740,7,653,3254.1666666666665,249.0,93.28571428571428,7,4087,3255.5,1514.0,583.8571428571429
108098167.0,17,5,1005,5,1005,27024541.75,201.0,201.0,0,0,0.0,0.0,0.0
108103514.0,17,5,1005,5,1005,27025878.5,201.0,201.0,0,0,0.0,0.0,0.0
3004599.0,6,11,2106,6,598,600726.6,252.0,99.66666666666669,5,1508,2018.75,1236.0,301.6
5673.0,17,4,704,2,148,0.0,74.0,74.0,2,556,0.0,280.0,278.0
512200.0,6,5,336,2,134,0.0,68.0,67.0,3,202,189763.5,70.0,67.33333333333333
205120.0,17,2,762,2,762,0.0,381.0,381.0,0,0,0.0,0.0,0.0
321349.0,17,4,704,2,148,0.0,74.0,74.0,2,556,0.0,280.0,278.0
108108432.0,17,5,955,5,955,27027108.0,191.0,191.0,0,0,0.0,0.0,0.0
213624.0,17,2,414,1,88,0.0,88.0,88.0,1,326,0.0,326.0,326.0
108111004.0,17,5,955,5,955,27027751.0,191.0,191.0,0,0,0.0,0.0,0.0
2199.0,17,4,344,2,150,0.0,75.0,75.0,2,194,0.0,103.0,97.0
903.0,17,5,550,5,550,225.75,110.0,110.0,0,0,0.0,0.0,0.0
1942.0,17,2,180,1,90,0.0,90.0,90.0,1,90,0.0,90.0,90.0
214739.0,17,2,180,1,90,0.0,90.0,90.0,1,90,0.0,90.0,90.0
130287.0,6,3,337,2,214,0.0,160.0,107.0,1,123,0.0,123.0,123.0
90291649.0,6,28,3385,15,1932,6446079.071428572,426.0,128.8,13,1453,7523313.666666667,361.0,111.76923076923076
10902617.0,6,8,544,4,272,3588708.333333333,74.0,68.0,4,272,3588631.6666666665,74.0,68.0
51016.0,6,14,4740,7,653,8339.0,249.0,93.28571428571428,7,4087,8282.166666666666,1514.0,583.8571428571429
90255871.0,6,12,1832,8,1016,12893695.857142856,188.0,127.0,4,816,30031258.0,204.0,204.0
502310.00000000006,6,5,336,2,134,0.0,68.0,67.0,3,202,192571.5,70.0,67.33333333333333
262264.0,6,3,337,2,214,0.0,160.0,107.0,1,123,0.0,123.0,123.0
233832.0,6,3,337,2,214,0.0,160.0,107.0,1,123,0.0,123.0,123.0
212443.0,6,3,426,2,280,0.0,214.0,140.0,1,146,0.0,146.0,146.0
135136235.0,17,6,1146,6,1146,27027247.0,191.0,191.0,0,0,0.0,0.0,0.0
234349.0,6,3,337,2,214,0.0,160.0,107.0,1,123,0.0,123.0,123.0
7307876.0,6,34,8816,17,4822,456742.25,1514.0,283.6470588235294,17,3994,390786.8125,1514.0,234.94117647058823
121410.0,6,3,337,2,214,0.0,160.0,107.0,1,123,0.0,123.0,123.0
243634.0,17,4,1400,4,1400,81211.33333333333,350.0,350.0,0,0,0.0,0.0,0.0
120676596.0,6,22,1680,11,840,12067659.6,95.0,76.36363636363636,11,840,9043761.5,95.0,76.36363636363636
34843.0,6,14,4740,7,653,5580.5,249.0,93.28571428571428,7,4087,5279.5,1514.0,583.8571428571429
0.0,17,1,453,1,453,0.0,453.0,453.0,0,0,0.0,0.0,0.0
145915.0,6,2,132,1,66,0.0,66.0,66.0,1,66,0.0,66.0,66.0
4452.0,17,2,180,1,90,0.0,90.0,90.0,1,90,0.0,90.0,90.0
120003914.0,6,26,1978,14,1084,9230768.846153846,95.0,77.42857142857143,12,894,10908653.545454543,95.0,74.5
90279848.0,6,20,1490,10,704,10026227.777777778,95.0,70.4,10,786,10029874.666666666,95.0,78.6
90036085.0,17,28,13364,28,13364,3334669.814814815,501.0,477.2857142857143,0,0,0.0,0.0,0.0
216211.0,17,2,180,1,90,0.0,90.0,90.0,1,90,0.0,90.0,90.0
202506.0,6,10,1221,6,636,40501.2,298.0,106.0,4,585,66663.66666666667,379.0,146.25
305.0,17,2,174,1,79,0.0,79.0,79.0,1,95,0.0,95.0,95.0
306123.0,6,6,412,4,272,102041.0,74.0,68.0,2,140,0.0,74.0,70.0
0.0,17,1,44,1,44,0.0,44.0,44.0,0,0,0.0,0.0,0.0
317.0,17,2,174,1,79,0.0,79.0,79.0,1,95,0.0,95.0,95.0
2009.0,17,4,344,2,150,0.0,75.0,75.0,2,194,0.0,103.0,97.0
149717167.0,6,14,2086,10,1270,16635240.777777778,188.0,127.0,4,816,30031385.0,204.0,204.0
120031705.0,6,220,24868,111,7622,1091197.318181818,140.0,68.66666666666667,109,17246,1097425.2777777778,284.0,158.22018348623854
117806377.0,6,29,1920,15,1026,8414741.214285715,123.0,68.4,14,894,8278270.076923077,123.0,63.85714285714285
2041.0,17,4,344,2,150,0.0,75.0,75.0,2,194,0.0,103.0,97.0
153434.0,17,2,180,1,90,0.0,90.0,90.0,1,90,0.0,90.0,90.0
2044474.0,6,25,7609,13,2516,170372.83333333334,1034.0,193.53846153846155,12,5093,158466.63636363635,1510.0,424.4166666666667
24988.0,6,10,2032,5,524,4159.75,252.0,104.8,5,1508,5861.75,1236.0,301.6
153515.0,17,2,180,1,90,0.0,90.0,90.0,1,90,0.0,90.0,90.0
39645933.0,6,5,336,2,134,0.0,68.0,67.0,3,202,19752802.5,70.0,67.33333333333333
315108.0,17,4,1400,4,1400,105036.0,350.0,350.0,0,0,0.0,0.0,0.0
323.0,17,2,160,1,80,0.0,80.0,80.0,1,80,0.0,80.0,80.0
100124.0,17,2,762,2,762,0.0,381.0,381.0,0,0,0.0,0.0,0.0
205941.0,17,2,180,1,90,0.0,90.0,90.0,1,90,0.0,90.0,90.0
3976.000000000001,17,4,704,2,148,0.0,74.0,74.0,2,556,0.0,280.0,278.0
5618654.0,6,5,336,2,134,0.0,68.0,67.0,3,202,1422391.5,70.0,67.33333333333333
60738.0,6,14,4740,7,653,9348.833333333334,249.0,93.28571428571428,7,4087,9820.833333333334,1514.0,583.8571428571429
76611.0,6,14,4740,7,653,12269.166666666666,249.0,93.28571428571428,7,4087,12274.333333333334,1514.0,583.8571428571429
20889.0,6,14,4740,7,653,2940.333333333333,249.0,93.28571428571428,7,4087,3343.333333333333,1514.0,583.8571428571429
120001029.0,17,13,559,7,301,20000171.5,43.0,43.0,6,258,20003060.4,43.0,43.0
16060.000000000002,6,10,2032,5,524,3830.0,252.0,104.8,5,1508,3741.25,1236.0,301.6
90931067.0,6,21,1585,11,840,9092549.9,95.0,76.36363636363636,10,745,10102444.333333334,95.0,74.5
2846.0,17,4,6056,4,6056,948.6666666666666,1514.0,1514.0,0,0,0.0,0.0,0.0
146233.0,6,3,337,2,214,0.0,160.0,107.0,1,123,0.0,123.0,123.0
132102.0,6,2,132,1,66,0.0,66.0,66.0,1,66,0.0,66.0,66.0
106341096.0,17,14,864,7,432,17667782.833333332,174.0,61.71428571428572,7,432,17666831.333333332,174.0,61.71428571428572
9058990.0,17,4,1812,4,1812,3019663.333333333,453.0,453.0,0,0,0.0,0.0,0.0
1093724.0,6,13,1386,7,789,182287.3333333333,253.0,112.71428571428572,6,597,213780.8,259.0,99.5
284562.0,17,2,363,1,79,0.0,79.0,79.0,1,284,0.0,284.0,284.0
421221.0,6,3,204,1,68,0.0,68.0,68.0,2,136,0.0,70.0,68.0
364033.0,6,3,1604,1,753,0.0,753.0,753.0,2,851,0.0,785.0,425.5
103326.0,17,2,286,2,286,0.0,143.0,143.0,0,0,0.0,0.0,0.0
6148646.0,6,9,1059,5,827,1483135.25,571.0,165.4,4,232,1977718.3333333333,62.0,58.0
224283.0,17,2,414,1,88,0.0,88.0,88.0,1,326,0.0,326.0,326.0
115150027.0,6,34,2350,17,1225,7183397.125,139.0,72.05882352941177,17,1125,7183393.6875,123.0,66.17647058823529
9996.0,17,2,582,1,83,0.0,83.0,83.0,1,499,0.0,499.0,499.0
114004250.0,17,13,821,7,432,19000708.33333333,174.0,61.71428571428572,6,389,18800134.4,174.0,64.83333333333333
267068.0,6,3,337,2,214,0.0,160.0,107.0,1,123,0.0,123.0,123.0
146085.0,6,3,337,2,214,0.0,160.0,107.0,1,123,0.0,123.0,123.0
73828.0,6,14,4740,7,653,11249.333333333334,249.0,93.28571428571428,7,4087,11859.0,1514.0,583.8571428571429
4191.0,17,2,598,1,72,0.0,72.0,72.0,1,526,0.0,526.0,526.0
1022346.0,6,11,1134,6,558,204469.2,220.0,93.0,5,576,254990.75,304.0,115.2
1302978.0,6,4,264,2,132,0.0,66.0,66.0,2,132,0.0,66.0,66.0
105250381.0,17,14,864,7,432,17501758.833333332,174.0,61.71428571428572,7,432,17500150.166666668,174.0,61.71428571428572
115569534.0,6,210,23630,105,16404,1109173.9038461538,284.0,156.22857142857143,105,7226,1109175.625,140.0,68.81904761904762
2445.0,17,4,344,2,150,0.0,75.0,75.0,2,194,0.0,103.0,97.0
7761.0,17,2,180,1,90,0.0,90.0,90.0,1,90,0.0,90.0,90.0
300286.0,6,6,412,4,272,100095.33333333331,74.0,68.0,2,140,0.0,74.0,70.0
64726.00000000001,6,14,4740,7,653,10036.0,249.0,93.28571428571428,7,4087,9719.166666666666,1514.0,583.8571428571429
90095909.0,6,12,1848,5,1020,22523406.25,204.0,204.0,7,828,15015602.5,188.0,118.28571428571428
90102463.0,6,11,1644,4,816,30033674.666666668,204.0,204.0,7,828,15016695.5,188.0,118.28571428571428
207002.0,17,2,180,1,90,0.0,90.0,90.0,1,90,0.0,90.0,90.0
46586633.0,6,8,1940,3,887,21916108.5,753.0,295.6666666666667,5,1053,11002846.25,785.0,210.6
90216270.0,6,19,1436,9,691,11245198.5,95.0,76.77777777777777,10,745,10000107.555555556,95.0,74.5
306929.0,6,6,412,4,272,102309.66666666669,74.0,68.0,2,140,0.0,74.0,70.0
100670029.0,17,12,516,6,258,20000891.8,43.0,43.0,6,258,20000156.8,43.0,43.0
313776.0,17,4,1400,4,1400,104592.0,350.0,350.0,0,0,0.0,0.0,0.0
45228.0,6,13,1479,7,882,7538.0,291.0,126.0,6,597,6237.2,259.0,99.5
319469.0,6,6,412,4,272,106489.66666666669,74.0,68.0,2,140,0.0,74.0,70.0
42804.0,6,14,4740,7,653,6769.0,249.0,93.28571428571428,7,4087,6650.5,1514.0,583.8571428571429
90284906.0,6,12,1832,8,1016,12897843.714285716,188.0,127.0,4,816,30040190.666666668,204.0,204.0
80700.0,6,10,2032,5,524,19360.25,252.0,104.8,5,1508,19044.0,1236.0,301.6
106915.0,17,2,286,2,286,0.0,143.0,143.0,0,0,0.0,0.0,0.0
41511.0,6,14,4740,7,653,6679.166666666667,249.0,93.28571428571428,7,4087,6139.5,1514.0,583.8571428571429
27441.0,6,14,4740,7,653,4150.333333333333,249.0,93.28571428571428,7,4087,4441.166666666667,1514.0,583.8571428571429
57698.0,6,14,4740,7,653,9484.5,249.0,93.28571428571428,7,4087,9377.5,1514.0,583.8571428571429
24758.0,6,14,4740,7,653,3896.0,249.0,93.28571428571428,7,4087,3978.1666666666665,1514.0,583.8571428571429
108605.0,17,2,286,2,286,0.0,143.0,143.0,0,0,0.0,0.0,0.0
205961.0,17,2,180,1,90,0.0,90.0,90.0,1,90,0.0,90.0,90.0
192372.0,17,2,180,1,90,0.0,90.0,90.0,1,90,0.0,90.0,90.0
298379.0,6,6,412,4,272,99459.66666666669,74.0,68.0,2,140,0.0,74.0,70.0
115355.0,17,4,1524,4,1524,38451.66666666666,381.0,381.0,0,0,0.0,0.0,0.0
50298.0,6,14,4740,7,653,7930.333333333333,249.0,93.28571428571428,7,4087,7846.5,1514.0,583.8571428571429
2399.0,17,4,344,2,150,0.0,75.0,75.0,2,194,0.0,103.0,97.0
103417.0,17,2,762,2,762,0.0,381.0,381.0,0,0,0.0,0.0,0.0
135114020.0,17,6,1146,6,1146,27022804.0,191.0,191.0,0,0,0.0,0.0,0.0
2494782.0,6,32,10926,18,3951,146751.88235294115,1514.0,219.5,14,6975,172967.84615384616,1514.0,498.2142857142857
139731.0,6,3,337,2,214,0.0,160.0,107.0,1,123,0.0,123.0,123.0
144099.0,17,2,180,1,90,0.0,90.0,90.0,1,90,0.0,90.0,90.0
121458.0,6,3,337,2,214,0.0,160.0,107.0,1,123,0.0,123.0,123.0
13986.0,17,2,174,1,79,0.0,79.0,79.0,1,95,0.0,95.0,95.0
40753.0,6,10,2032,5,524,9429.25,252.0,104.8,5,1508,9862.25,1236.0,301.6
216470.0,17,2,180,1,90,0.0,90.0,90.0,1,90,0.0,90.0,90.0
1057049.0,6,13,1394,7,797,176174.83333333334,253.0,113.85714285714286,6,597,210609.0,259.0,99.5
129742991.0,6,38,2716,20,1468,6828578.47368421,139.0,73.4,18,1248,7031902.823529412,123.0,69.33333333333333
25610.0,6,11,2098,6,590,3903.6,252.0,98.33333333333331,5,1508,6094.0,1236.0,301.6
1080692.0,6,12,1354,6,723,215438.6,253.0,120.5,6,631,215857.4,293.0,105.16666666666669
105843.0,17,2,286,2,286,0.0,143.0,143.0,0,0,0.0,0.0,0.0
39174.0,6,10,2032,5,524,9458.25,252.0,104.8,5,1508,8572.25,1236.0,301.6
90296185.0,6,16,1192,8,596,12893558.0,95.0,74.5,8,596,12898284.142857144,95.0,74.5
105534.0,17,2,700,2,700,0.0,350.0,350.0,0,0,0.0,0.0,0.0
234484.0,6,3,337,2,214,0.0,160.0,107.0,1,123,0.0,123.0,123.0
33341.0,6,10,2032,5,524,8112.0,252.0,104.8,5,1508,8001.5,1236.0,301.6
16368.0,6,14,4740,7,653,2240.333333333333,249.0,93.28571428571428,7,4087,2539.5,1514.0,583.8571428571429
330.0,17,2,166,1,75,0.0,75.0,75.0,1,91,0.0,91.0,91.0
92807692.0,17,11,735,6,389,18529518.2,174.0,64.83333333333333,5,346,18359328.25,174.0,69.2
466.0,17,2,508,2,508,0.0,257.0,254.0,0,0,0.0,0.0,0.0
218691.0,6,3,426,2,280,0.0,214.0,140.0,1,146,0.0,146.0,146.0
135126834.0,17,6,1146,6,1146,27025366.8,191.0,191.0,0,0,0.0,0.0,0.0
120922425.0,6,31,2097,16,1149,8061495.0,123.0,71.8125,15,948,8072667.0,123.0,63.2
48948.0,6,14,4740,7,653,8033.5,249.0,93.28571428571428,7,4087,7916.333333333333,1514.0,583.8571428571429
1187715.0,6,13,3010,8,2382,169673.57142857142,1514.0,297.75,5,628,228147.75,331.0,125.6
114328214.0,6,47,3102,24,1584,4970780.695652174,66.0,66.0,23,1518,5159994.545454546,66.0,66.0
2320.0,17,4,344,2,150,0.0,75.0,75.0,2,194,0.0,103.0,97.0
311431.0,17,4,1400,4,1400,103810.33333333331,350.0,350.0,0,0,0.0,0.0,0.0
90529436.0,6,14,2240,8,1016,12932776.57142857,188.0,127.0,6,1224,18073483.2,204.0,204.0
14066.0,6,13,1459,7,862,2344.333333333333,271.0,123.14285714285714,6,597,2270.4,259.0,99.5
9863049.0,6,179,171453,53,3655,189674.0192307692,203.0,68.9622641509434,126,167798,78824.048,1514.0,1331.7301587301588
4520.0,17,2,180,1,90,0.0,90.0,90.0,1,90,0.0,90.0,90.0
1168641.0,6,13,3000,8,2372,166948.7142857143,1514.0,296.5,5,628,224042.5,331.0,125.6
205825.0,17,2,180,1,90,0.0,90.0,90.0,1,90,0.0,90.0,90.0
305330.0,17,4,704,2,148,0.0,74.0,74.0,2,556,0.0,280.0,278.0
96745781.0,6,60,12583,31,6708,3224859.3666666667,1514.0,216.3870967741936,29,5875,3445804.964285714,1514.0,202.5862068965517
26684820.0,17,5,1710,5,1710,6671205.0,342.0,342.0,0,0,0.0,0.0,0.0
153510.0,17,2,180,1,90,0.0,90.0,90.0,1,90,0.0,90.0,90.0
122978166.0,6,48,3168,24,1584,5003283.869565218,66.0,66.0,24,1584,5263924.347826087,66.0,66.0
22107.0,6,12,1393,6,796,4291.4,271.0,132.66666666666666,6,597,4150.0,259.0,99.5
90041183.0,17,28,13364,28,13364,3334858.6296296297,501.0,477.2857142857143,0,0,0.0,0.0,0.0
108104775.0,17,5,1005,5,1005,27026193.75,201.0,201.0,0,0,0.0,0.0,0.0
190892.0,17,2,180,1,90,0.0,90.0,90.0,1,90,0.0,90.0,90.0
2379.0,17,4,344,2,150,0.0,75.0,75.0,2,194,0.0,103.0,97.0
300200.0,6,6,412,4,272,100066.66666666669,74.0,68.0,2,140,0.0,74.0,70.0
109052327.0,17,14,864,7,432,18166871.5,174.0,61.71428571428572,7,432,18167554.83333333,174.0,61.71428571428572
119548706.0,17,35,16705,35,16705,3516138.411764706,501.0,477.2857142857143,0,0,0.0,0.0,0.0
90035516.0,17,28,13364,28,13364,3334648.7407407407,501.0,477.2857142857143,0,0,0.0,0.0,0.0
108103449.0,17,5,955,5,955,27025862.25,191.0,191.0,0,0,0.0,0.0,0.0
90256632.0,6,13,2036,8,1016,12893804.57142857,188.0,127.0,5,1020,22523004.5,204.0,204.0
65167.0,6,14,4740,7,653,10137.833333333334,249.0,93.28571428571428,7,4087,10619.666666666666,1514.0,583.8571428571429
153833.0,17,2,180,1,90,0.0,90.0,90.0,1,90,0.0,90.0,90.0
107343.0,17,2,286,2,286,0.0,143.0,143.0,0,0,0.0,0.0,0.0
297444.0,6,6,412,4,272,99148.0,74.0,68.0,2,140,0.0,74.0,70.0
104316.0,17,2,762,2,762,0.0,381.0,381.0,0,0,0.0,0.0,0.0
503.0,17,2,508,2,508,0.0,257.0,254.0,0,0,0.0,0.0,0.0
331.0,17,2,208,1,72,0.0,72.0,72.0,1,136,0.0,136.0,136.0
108098225.0,17,5,955,5,955,27024556.25,191.0,191.0,0,0,0.0,0.0,0.0
2027.0,17,4,344,2,150,0.0,75.0,75.0,2,194,0.0,103.0,97.0
1634447.0,6,20,6434,12,1921,148586.0909090909,620.0,160.08333333333334,8,4513,189540.14285714287,1514.0,564.125
49405.0,6,14,4740,7,653,8052.166666666667,249.0,93.28571428571428,7,4087,8035.5,1514.0,583.8571428571429
24490.0,6,14,4740,7,653,3879.3333333333335,249.0,93.28571428571428,7,4087,3935.6666666666665,1514.0,583.8571428571429
321680.0,6,6,412,4,272,107226.66666666669,74.0,68.0,2,140,0.0,74.0,70.0
120454746.0,6,211,23930,106,16704,1147188.0571428572,284.0,157.58490566037736,105,7226,1149361.3173076925,140.0,68.81904761904762
146239.0,6,3,337,2,214,0.0,160.0,107.0,1,123,0.0,123.0,123.0
5824970.0,6,5,336,2,134,0.0,68.0,67.0,3,202,1522982.0,70.0,67.33333333333333
466370.0,6,3,1604,2,851,0.0,785.0,425.5,1,753,0.0,753.0,753.0
40300.0,6,14,4740,7,653,4110.833333333333,249.0,93.28571428571428,7,4087,6525.333333333333,1514.0,583.8571428571429
242318.0,6,3,337,2,214,0.0,160.0,107.0,1,123,0.0,123.0,123.0
298.0,17,2,164,1,82,0.0,82.0,82.0,1,82,0.0,82.0,82.0
21051.0,6,14,4740,7,653,3182.6666666666665,249.0,93.28571428571428,7,4087,3370.833333333333,1514.0,583.8571428571429
504783.0,6,5,336,2,134,0.0,68.0,67.0,3,202,192463.5,70.0,67.33333333333333
304334.0,6,6,412,4,272,101444.66666666669,74.0,68.0,2,140,0.0,74.0,70.0
307559.0,6,6,412,4,272,102519.66666666669,74.0,68.0,2,140,0.0,74.0,70.0
5619348.0,6,5,336,2,134,0.0,68.0,67.0,3,202,1417778.0,70.0,67.33333333333333
120083810.0,6,14,2240,6,1224,24016762.0,204.0,204.0,8,1016,17131361.285714287,188.0,127.0
108108301.0,17,5,955,5,955,27027075.25,191.0,191.0,0,0,0.0,0.0,0.0
90034135.0,17,28,13364,28,13364,3334597.592592593,501.0,477.2857142857143,0,0,0.0,0.0,0.0
90257113.0,6,12,1832,8,1016,12893873.285714284,188.0,127.0,4,816,30030685.666666668,204.0,204.0
112081.0,17,2,286,2,286,0.0,143.0,143.0,0,0,0.0,0.0,0.0
37696.0,6,14,4740,7,653,6076.0,249.0,93.28571428571428,7,4087,6036.333333333333,1514.0,583.8571428571429
9005498.0,17,4,300,4,300,3001832.6666666665,75.0,75.0,0,0,0.0,0.0,0.0
72497.0,6,14,4740,7,653,11627.166666666666,249.0,93.28571428571428,7,4087,11246.833333333334,1514.0,583.8571428571429
506571.0,6,5,336,2,134,0.0,68.0,67.0,3,202,194309.5,70.0,67.33333333333333
312141.0,17,4,1400,4,1400,104047.0,350.0,350.0,0,0,0.0,0.0,0.0
510.00000000000006,17,2,508,2,508,0.0,257.0,254.0,0,0,0.0,0.0,0.0
4393.0,17,2,602,1,72,0.0,72.0,72.0,1,530,0.0,530.0,530.0
213527.0,17,2,414,1,88,0.0,88.0,88.0,1,326,0.0,326.0,326.0
204507.0,17,2,762,2,762,0.0,381.0,381.0,0,0,0.0,0.0,0.0
0.0,6,1,66,1,66,0.0,66.0,66.0,0,0,0.0,0.0,0.0
312070.0,6,6,412,4,272,104023.33333333331,74.0,68.0,2,140,0.0,74.0,70.0
6938.0,17,2,582,1,83,0.0,83.0,83.0,1,499,0.0,499.0,499.0
24466.0,6,10,2032,5,524,5717.75,252.0,104.8,5,1508,3812.25,1236.0,301.6
437309.0,6,10,967,5,390,73249.0,162.0,78.0,5,577,73186.75,349.0,115.4
1304064.0,6,4,264,2,132,0.0,66.0,66.0,2,132,0.0,66.0,66.0
120125735.0,6,13,2036,8,1016,17137334.0,188.0,127.0,5,1020,22523248.75,204.0,204.0
14135579.0,6,19,1594,9,962,1727902.875,315.0,106.88888888888889,10,632,1535889.2222222222,78.0,63.2
32946267.0,6,4,270,3,202,16473133.5,70.0,67.33333333333333,1,68,0.0,68.0,68.0
224791.0,6,3,426,2,280,0.0,214.0,140.0,1,146,0.0,146.0,146.0
232879.0,6,3,337,2,214,0.0,160.0,107.0,1,123,0.0,123.0,123.0
2090.0,17,4,344,2,150,0.0,75.0,75.0,2,194,0.0,103.0,97.0
12766.0,6,14,4740,7,653,1972.5,249.0,93.28571428571428,7,4087,1990.3333333333333,1514.0,583.8571428571429
307275.0,6,6,412,4,272,102425.0,74.0,68.0,2,140,0.0,74.0,70.0
65017.00000000001,6,14,4740,7,653,10137.166666666666,249.0,93.28571428571428,7,4087,9492.666666666666,1514.0,583.8571428571429
129025239.0,6,6,402,2,136,0.0,70.0,68.0,4,266,43008413.0,68.0,66.5
245454.0,6,4,439,2,238,0.0,172.0,119.0,2,201,0.0,135.0,100.5
196845.0,17,2,180,1,90,0.0,90.0,90.0,1,90,0.0,90.0,90.0
143851.0,17,2,180,1,90,0.0,90.0,90.0,1,90,0.0,90.0,90.0
135133537.0,17,6,1206,6,1206,27026707.4,201.0,201.0,0,0,0.0,0.0,0.0
4766.0,17,4,344,2,150,0.0,75.0,75.0,2,194,0.0,103.0,97.0
2395.0,17,4,344,2,150,0.0,75.0,75.0,2,194,0.0,103.0,97.0
107809712.0,17,14,864,7,432,17823162.833333332,174.0,61.71428571428572,7,432,17833486.333333332,174.0,61.71428571428572
235961.0,6,3,373,2,238,0.0,172.0,119.0,1,135,0.0,135.0,135.0
11979.0,17,2,498,1,80,0.0,80.0,80.0,1,418,0.0,418.0,418.0
120124059.0,6,14,2240,6,1224,24024811.8,204.0,204.0,8,1016,17098879.42857143,188.0,127.0
121837.0,6,3,337,2,214,0.0,160.0,107.0,1,123,0.0,123.0,123.0
14740990.0,6,20,1607,10,975,1604464.888888889,315.0,97.5,10,632,1604481.6666666667,78.0,63.2
302482.0,6,2,132,1,66,0.0,66.0,66.0,1,66,0.0,66.0,66.0
37791.0,6,14,4740,7,653,6123.166666666667,249.0,93.28571428571428,7,4087,5200.833333333333,1514.0,583.8571428571429
120014163.0,6,25,1924,14,1125,9230743.76923077,95.0,80.35714285714286,11,799,12000087.9,95.0,72.63636363636364
160173.0,17,2,180,1,90,0.0,90.0,90.0,1,90,0.0,90.0,90.0
60648.0,6,14,4740,7,653,9982.166666666666,249.0,93.28571428571428,7,4087,7975.166666666667,1514.0,583.8571428571429
0.0,6,1,172,1,172,0.0,172.0,172.0,0,0,0.0,0.0,0.0
118886204.0,6,35,2526,18,1332,6980444.0,123.0,74.0,17,1194,7416897.5,123.0,70.23529411764706
239205.0,17,2,180,1,90,0.0,90.0,90.0,1,90,0.0,90.0,90.0
438513.0,6,3,1777,1,826,0.0,826.0,826.0,2,951,0.0,885.0,475.5
92743682.0,6,25,1686,13,840,7728603.75,123.0,64.61538461538461,12,846,7523405.454545454,123.0,70.5
1782.0,17,2,762,2,762,0.0,381.0,381.0,0,0,0.0,0.0,0.0
64459.0,6,14,4740,7,653,10246.0,249.0,93.28571428571428,7,4087,10552.833333333334,1514.0,583.8571428571429
107361.0,17,2,286,2,286,0.0,143.0,143.0,0,0,0.0,0.0,0.0
55428.0,6,14,4740,7,653,9053.166666666666,249.0,93.28571428571428,7,4087,8626.833333333334,1514.0,583.8571428571429
90047712.0,17,28,13364,28,13364,3335100.4444444445,501.0,477.2857142857143,0,0,0.0,0.0,0.0
302636.0,6,3,202,2,128,0.0,74.0,64.0,1,74,0.0,74.0,74.0
302285.0,6,6,412,4,272,100761.66666666669,74.0,68.0,2,140,0.0,74.0,70.0
119792940.0,17,35,16705,35,16705,3523321.7647058824,501.0,477.2857142857143,0,0,0.0,0.0,0.0
52387.0,6,14,4740,7,653,7342.0,249.0,93.28571428571428,7,4087,7189.833333333333,1514.0,583.8571428571429
11989.0,6,2,145,2,145,0.0,91.0,72.5,0,0,0.0,0.0,0.0
104327230.0,17,14,1126,7,563,17334452.0,174.0,80.42857142857143,7,563,17333492.5,174.0,80.42857142857143
310943.0,17,4,1400,4,1400,103647.66666666669,350.0,350.0,0,0,0.0,0.0,0.0
116866409.0,6,32,2236,16,1165,7776691.933333334,139.0,72.8125,16,1071,7776692.2,123.0,66.9375
101008572.0,17,13,1083,7,563,16834762.0,174.0,80.42857142857143,6,520,16200153.6,174.0,86.66666666666667
10916419.0,6,8,544,4,272,3593372.6666666665,74.0,68.0,4,272,3593294.0,74.0,68.0
23296.0,6,14,4740,7,653,3760.6666666666665,249.0,93.28571428571428,7,4087,3349.333333333333,1514.0,583.8571428571429
240518.0,6,3,373,2,238,0.0,172.0,119.0,1,135,0.0,135.0,135.0
305170.0,6,6,412,4,272,101723.33333333331,74.0,68.0,2,140,0.0,74.0,70.0
552.0,17,2,174,1,79,0.0,79.0,79.0,1,95,0.0,95.0,95.0
143864.0,17,2,180,1,90,0.0,90.0,90.0,1,90,0.0,90.0,90.0
28817.0,6,10,2032,5,524,6995.25,252.0,104.8,5,1508,6858.75,1236.0,301.6
10417655.0,6,6,412,3,206,5140678.5,74.0,68.66666666666667,3,206,5140580.0,74.0,68.66666666666667
28881.0,6,10,2032,5,524,6983.5,252.0,104.8,5,1508,6774.5,1236.0,301.6
51934.0,6,12,1320,6,723,9472.8,253.0,120.5,6,597,7844.4,259.0,99.5
103954072.0,6,47,4227,19,1854,5775226.222222222,123.0,97.57894736842104,28,2373,3842139.407407407,123.0,84.75
90252964.0,6,12,1832,8,1016,12893280.57142857,188.0,127.0,4,816,30029141.0,204.0,204.0
155148.0,6,3,337,2,214,0.0,160.0,107.0,1,123,0.0,123.0,123.0
153509.0,17,2,180,1,90,0.0,90.0,90.0,1,90,0.0,90.0,90.0
116531310.0,6,220,24884,110,17402,1067120.9266055045,284.0,158.2,110,7482,1067121.119266055,140.0,68.01818181818182
107726.0,17,4,1400,4,1400,35908.666666666664,350.0,350.0,0,0,0.0,0.0,0.0
323474.0,17,2,180,1,90,0.0,90.0,90.0,1,90,0.0,90.0,90.0
16793070.0,6,20,1611,9,921,2060375.5,315.0,102.33333333333331,11,690,1648276.4,78.0,62.72727272727273
21307.0,6,11,1133,6,602,3948.0,264.0,100.33333333333331,5,531,4634.75,259.0,106.2
309693.0,6,6,412,4,272,103231.0,74.0,68.0,2,140,0.0,74.0,70.0
2392.0,17,4,344,2,150,0.0,75.0,75.0,2,194,0.0,103.0,97.0
9308.0,17,2,539,1,86,0.0,86.0,86.0,1,453,0.0,453.0,453.0
2095.0,17,4,344,2,150,0.0,75.0,75.0,2,194,0.0,103.0,97.0
311361.0,17,4,1400,4,1400,103787.0,350.0,350.0,0,0,0.0,0.0,0.0
138125.0,6,2,132,1,66,0.0,66.0,66.0,1,66,0.0,66.0,66.0
9952.0,6,11,2098,6,590,1690.8,252.0,98.33333333333331,5,1508,2243.5,1236.0,301.6
14640877.0,6,20,1607,10,975,1593407.2222222222,315.0,97.5,10,632,1593379.3333333333,78.0,63.2
507961.0,6,5,336,2,134,0.0,68.0,67.0,3,202,191554.0,70.0,67.33333333333333
209365.0,17,2,180,1,90,0.0,90.0,90.0,1,90,0.0,90.0,90.0
105763399.0,6,44,2904,22,1452,5036352.333333333,66.0,66.0,22,1452,5021825.476190476,66.0,66.0
112176126.0,6,30,2122,15,1017,8012547.285714285,123.0,67.8,15,1105,7299103.785714285,139.0,73.66666666666667
216199.0,6,10,1221,6,636,43239.8,298.0,106.0,4,585,69745.66666666667,379.0,146.25
90084336.0,17,28,13364,28,13364,3336456.888888889,501.0,477.2857142857143,0,0,0.0,0.0,0.0
11159.0,6,10,2032,5,524,2502.25,252.0,104.8,5,1508,2417.75,1236.0,301.6
122314492.0,6,48,3168,24,1584,4966251.869565218,66.0,66.0,24,1584,5242196.608695652,66.0,66.0
159990.0,6,2,128,1,74,0.0,74.0,74.0,1,54,0.0,54.0,54.0
135130164.0,17,6,1146,6,1146,27026032.8,191.0,191.0,0,0,0.0,0.0,0.0
310141.0,17,4,1400,4,1400,103380.33333333331,350.0,350.0,0,0,0.0,0.0,0.0
299045.0,6,6,412,4,272,99681.66666666669,74.0,68.0,2,140,0.0,74.0,70.0
135150307.0,17,6,1206,6,1206,27030061.4,201.0,201.0,0,0,0.0,0.0,0.0
13001.0,6,14,4740,7,653,2006.3333333333333,249.0,93.28571428571428,7,4087,2025.5,1514.0,583.8571428571429
1566986.0,6,2,132,1,66,0.0,66.0,66.0,1,66,0.0,66.0,66.0
306976.0,6,6,412,4,272,102325.33333333331,74.0,68.0,2,140,0.0,74.0,70.0
297800.0,6,6,412,4,272,99266.66666666669,74.0,68.0,2,140,0.0,74.0,70.0
113485.0,17,2,620,1,75,0.0,75.0,75.0,1,545,0.0,545.0,545.0
218000.0,6,3,426,2,280,0.0,214.0,140.0,1,146,0.0,146.0,146.0
2011771.0,17,4,525,2,150,0.0,75.0,75.0,2,375,0.0,284.0,187.5
4437.0,17,2,626,1,72,0.0,72.0,72.0,1,554,0.0,554.0,554.0
120596.0,6,3,337,2,214,0.0,160.0,107.0,1,123,0.0,123.0,123.0
37755.0,6,10,2032,5,524,8937.0,252.0,104.8,5,1508,8878.25,1236.0,301.6
110977205.0,6,33,2428,17,1288,6922596.25,139.0,75.76470588235294,16,1140,7384102.266666667,123.0,71.25
16560.0,6,2,145,2,145,0.0,91.0,72.5,0,0,0.0,0.0,0.0
102090.0,17,2,286,2,286,0.0,143.0,143.0,0,0,0.0,0.0,0.0
108697376.0,6,34,2482,17,1288,6793586.0,139.0,75.76470588235294,17,1194,6780078.9375,123.0,70.23529411764706
1022615.0,6,11,1134,6,558,204523.0,220.0,93.0,5,576,254333.0,304.0,115.2
102007726.0,17,14,864,7,432,17001287.666666668,174.0,61.71428571428572,7,432,16833494.666666668,174.0,61.71428571428572
90259728.0,6,12,1832,8,1016,12894246.857142856,188.0,127.0,4,816,30031568.0,204.0,204.0
150703.0,17,2,762,2,762,0.0,381.0,381.0,0,0,0.0,0.0,0.0
243633.0,6,3,337,2,214,0.0,160.0,107.0,1,123,0.0,123.0,123.0
8999482.0,17,3,1034,2,684,0.0,342.0,342.0,1,350,0.0,350.0,350.0
61191.0,6,14,4740,7,653,8733.0,249.0,93.28571428571428,7,4087,9548.166666666666,1514.0,583.8571428571429
17015.0,17,2,180,1,90,0.0,90.0,90.0,1,90,0.0,90.0,90.0
100198538.0,17,12,778,6,389,19999606.0,174.0,64.83333333333333,6,389,20007517.4,174.0,64.83333333333333
135117358.0,17,6,1206,6,1206,27023471.6,201.0,201.0,0,0,0.0,0.0,0.0
19860.0,6,13,1459,7,862,3310.0,271.0,123.14285714285714,6,597,3497.8,259.0,99.5
34747.0,6,14,4740,7,653,5666.166666666667,249.0,93.28571428571428,7,4087,5654.5,1514.0,583.8571428571429
21856.0,17,2,582,1,83,0.0,83.0,83.0,1,499,0.0,499.0,499.0
247870.0,6,3,426,2,280,0.0,214.0,140.0,1,146,0.0,146.0,146.0
120309704.0,6,231,26134,116,18248,1046171.3391304348,284.0,157.31034482758622,115,7886,1038178.1666666666,140.0,68.57391304347826
135136605.0,17,6,1206,6,1206,27027321.0,201.0,201.0,0,0,0.0,0.0,0.0
1167219.0,6,13,3010,8,2382,166745.57142857142,1514.0,297.75,5,628,222853.5,331.0,125.6
23637.0,6,10,2032,5,524,5298.5,252.0,104.8,5,1508,5562.75,1236.0,301.6
235434.0,6,3,337,2,214,0.0,160.0,107.0,1,123,0.0,123.0,123.0
91165807.0,6,25,1924,11,840,9091450.9,95.0,76.36363636363636,14,1084,6996193.538461538,95.0,77.42857142857143
228299.0,17,2,180,1,90,0.0,90.0,90.0,1,90,0.0,90.0,90.0
114433404.0,6,302,35426,151,25238,761453.9733333334,284.0,167.13907284768212,151,10188,761453.94,140.0,67.47019867549669
326.0,17,2,208,1,72,0.0,72.0,72.0,1,136,0.0,136.0,136.0
146801.0,6,3,337,2,214,0.0,160.0,107.0,1,123,0.0,123.0,123.0
102057513.0,17,14,864,7,432,17000571.666666668,174.0,61.71428571428572,7,432,17000151.333333332,174.0,61.71428571428572
32707.0,6,14,4740,7,653,5264.666666666667,249.0,93.28571428571428,7,4087,5268.666666666667,1514.0,583.8571428571429
120209986.0,6,216,24402,108,7424,1115501.785046729,140.0,68.74074074074075,108,16978,1116865.046728972,390.0,157.2037037037037
2295.0,17,4,344,2,150,0.0,75.0,75.0,2,194,0.0,103.0,97.0
123455736.0,6,48,3168,24,1584,4933785.347826087,66.0,66.0,24,1584,5334178.956521739,66.0,66.0
37326.0,6,10,2032,5,524,9043.0,252.0,104.8,5,1508,8507.75,1236.0,301.6
302423.0,6,2,132,1,66,0.0,66.0,66.0,1,66,0.0,66.0,66.0
108105789.0,17,5,955,5,955,27026447.25,191.0,191.0,0,0,0.0,0.0,0.0
50497.0,6,14,4740,7,653,7732.5,249.0,93.28571428571428,7,4087,7624.333333333333,1514.0,583.8571428571429
25954.0,6,14,4740,7,653,3359.6666666666665,249.0,93.28571428571428,7,4087,4013.0,1514.0,583.8571428571429
135127064.0,17,6,1206,6,1206,27025412.8,201.0,201.0,0,0,0.0,0.0,0.0
2364.0,17,4,344,2,150,0.0,75.0,75.0,2,194,0.0,103.0,97.0
55123.0,6,14,4740,7,653,9017.0,249.0,93.28571428571428,7,4087,8261.5,1514.0,583.8571428571429
107282.0,17,2,286,2,286,0.0,143.0,143.0,0,0,0.0,0.0,0.0
46714.0,6,14,4740,7,653,6195.5,249.0,93.28571428571428,7,4087,7559.5,1514.0,583.8571428571429
105070230.0,6,219,24728,110,7482,963947.0642201836,140.0,68.01818181818182,109,17246,970843.7037037036,284.0,158.22018348623854
91273.0,6,14,4740,7,653,14654.666666666666,249.0,93.28571428571428,7,4087,14307.333333333334,1514.0,583.8571428571429
36690.0,6,12,1413,6,816,7104.8,291.0,136.0,6,597,6392.0,259.0,99.5
94438.0,17,2,762,2,762,0.0,381.0,381.0,0,0,0.0,0.0,0.0
264871.0,6,10,1221,6,636,52974.2,298.0,106.0,4,585,82883.33333333333,379.0,146.25
709833.0,6,6,758,3,410,316477.5,172.0,136.66666666666666,3,348,232599.5,135.0,116.0
305776.0,6,2,1538,1,753,0.0,753.0,753.0,1,785,0.0,785.0,785.0
49433.0,6,14,4740,7,653,8062.666666666667,249.0,93.28571428571428,7,4087,7469.833333333333,1514.0,583.8571428571429
5627438.0,6,5,336,2,134,0.0,68.0,67.0,3,202,1535602.0,70.0,67.33333333333333
110397.0,17,4,1400,4,1400,36799.0,350.0,350.0,0,0,0.0,0.0,0.0
40448.0,6,13,1386,7,789,6741.333333333333,253.0,112.71428571428572,6,597,7423.8,259.0,99.5
300466.0,6,6,412,4,272,100155.33333333331,74.0,68.0,2,140,0.0,74.0,70.0
315.0,17,2,174,1,79,0.0,79.0,79.0,1,95,0.0,95.0,95.0
120125526.0,6,15,2428,9,1204,15015690.75,188.0,133.77777777777777,6,1224,18082101.8,204.0,204.0
1508421.0,6,20,6434,12,1921,137129.18181818182,620.0,160.08333333333334,8,4513,176073.2857142857,1514.0,564.125
34018.0,6,10,2032,5,524,7819.5,252.0,104.8,5,1508,6709.0,1236.0,301.6
110095559.0,6,35,2542,18,1348,6476209.352941177,139.0,74.88888888888889,17,1194,6867444.0,123.0,70.23529411764706
27025075.0,17,5,1718,4,1368,800534.6666666666,342.0,342.0,1,350,0.0,350.0,350.0
15675.000000000002,6,10,2032,5,524,3587.25,252.0,104.8,5,1508,3748.0,1236.0,301.6
111020087.0,6,30,1974,15,1026,7914577.214285715,123.0,68.4,15,948,7914576.285714285,123.0,63.2
43862.0,6,14,4740,7,653,7022.0,249.0,93.28571428571428,7,4087,7041.833333333333,1514.0,583.8571428571429
121676.0,6,3,337,2,214,0.0,160.0,107.0,1,123,0.0,123.0,123.0
922743.0,6,5,1742,2,821,0.0,753.0,410.5,3,921,461371.5,785.0,307.0
109516.0,17,2,286,2,286,0.0,143.0,143.0,0,0,0.0,0.0,0.0
95868223.0,6,39,2574,20,1320,5045677.736842105,66.0,66.0,19,1254,5160004.888888889,66.0,66.0
52592.0,6,10,2032,5,524,12925.25,252.0,104.8,5,1508,12426.5,1236.0,301.6
108104500.0,17,5,955,5,955,27026125.0,191.0,191.0,0,0,0.0,0.0,0.0
147134.0,6,3,373,2,238,0.0,172.0,119.0,1,135,0.0,135.0,135.0
356.0,17,2,248,1,84,0.0,84.0,84.0,1,164,0.0,164.0,164.0
248116.0,17,2,180,1,70,0.0,70.0,70.0,1,110,0.0,110.0,110.0
90032393.0,17,27,12943,27,12943,3462784.346153846,501.0,479.3703703703704,0,0,0.0,0.0,0.0
232974.0,6,3,337,2,214,0.0,160.0,107.0,1,123,0.0,123.0,123.0
120069024.0,6,226,25550,113,7680,1065620.1160714286,140.0,67.96460176991151,113,17870,1065761.5267857143,284.0,158.141592920354
261979.00000000003,6,10,1221,6,636,52395.8,298.0,106.0,4,585,86417.0,379.0,146.25
232196.0,6,3,337,2,214,0.0,160.0,107.0,1,123,0.0,123.0,123.0
306549.0,6,6,412,4,272,102183.0,74.0,68.0,2,140,0.0,74.0,70.0
202442.0,6,12,1362,6,731,39090.8,253.0,121.83333333333331,6,631,39864.4,293.0,105.16666666666669
1295618.0,6,4,264,2,132,0.0,66.0,66.0,2,132,0.0,66.0,66.0
69.0,17,2,762,2,762,0.0,381.0,381.0,0,0,0.0,0.0,0.0
67088.0,6,10,2032,5,524,14690.5,252.0,104.8,5,1508,16212.0,1236.0,301.6
90255563.0,6,12,1832,8,1016,12893651.857142856,188.0,127.0,4,816,30030400.666666668,204.0,204.0
310514.0,6,6,412,4,272,103504.66666666669,74.0,68.0,2,140,0.0,74.0,70.0
306898.0,6,6,412,4,272,102299.33333333331,74.0,68.0,2,140,0.0,74.0,70.0
130936.0,6,2,132,1,66,0.0,66.0,66.0,1,66,0.0,66.0,66.0
90210515.0,6,20,1531,9,691,11246442.375,95.0,76.77777777777777,11,840,9000462.5,95.0,76.36363636363636
116712362.0,6,48,3168,24,1584,5074450.521739131,66.0,66.0,24,1584,5061229.869565218,66.0,66.0
30062.0,6,10,1067,5,536,7347.5,264.0,107.2,5,531,6576.5,259.0,106.2
50394.0,6,2,132,1,66,0.0,66.0,66.0,1,66,0.0,66.0,66.0
704.0,17,4,438,2,148,0.0,74.0,74.0,2,290,0.0,147.0,145.0
90257521.0,6,13,2036,8,1016,12893931.57142857,188.0,127.0,5,1020,22518930.75,204.0,204.0
90767878.0,6,18,1382,10,786,10079823.555555556,95.0,78.6,8,596,12966351.0,95.0,74.5
18198.0,6,10,1065,5,534,4056.0,262.0,106.8,5,531,3818.5,259.0,106.2
3244086.0,6,7,923,4,753,1009081.0,571.0,188.25,3,170,1513851.0,62.0,56.66666666666666
310031.0,17,4,1400,4,1400,103343.66666666669,350.0,350.0,0,0,0.0,0.0,0.0
108106598.0,17,5,955,5,955,27026649.5,191.0,191.0,0,0,0.0,0.0,0.0
2070.0,17,4,344,2,150,0.0,75.0,75.0,2,194,0.0,103.0,97.0
306850.0,6,3,202,2,128,0.0,74.0,64.0,1,74,0.0,74.0,74.0
115804752.0,6,48,3168,24,1584,5034989.217391305,66.0,66.0,24,1584,5021531.434782608,66.0,66.0
113796423.0,6,36,2580,18,1332,6681208.352941177,123.0,74.0,18,1248,6681209.529411765,123.0,69.33333333333333
39337.0,6,10,2032,5,524,9093.5,252.0,104.8,5,1508,8256.25,1236.0,301.6
45926.0,6,14,4740,7,653,7480.333333333333,249.0,93.28571428571428,7,4087,7477.833333333333,1514.0,583.8571428571429
76093690.0,6,9,842,9,842,9511711.25,97.0,93.55555555555556,0,0,0.0,0.0,0.0
299064.0,6,6,412,4,272,99688.0,74.0,68.0,2,140,0.0,74.0,70.0
10430218.0,6,7,478,4,272,3431181.0,74.0,68.0,3,206,5146639.0,74.0,68.66666666666667
834.0,17,5,550,5,550,208.5,110.0,110.0,0,0,0.0,0.0,0.0
34153.0,6,14,4740,7,653,4739.0,249.0,93.28571428571428,7,4087,5048.666666666667,1514.0,583.8571428571429
124083135.0,17,15,1169,7,563,17500166.0,174.0,80.42857142857143,8,606,15001066.0,174.0,75.75
90696056.0,6,21,1585,10,745,10077339.555555556,95.0,74.5,11,840,9043521.1,95.0,76.36363636363636
2293.0,17,4,344,2,150,0.0,75.0,75.0,2,194,0.0,103.0,97.0
90951559.0,6,20,1490,10,745,10105728.777777778,95.0,74.5,10,745,10076717.555555556,95.0,74.5
105269035.0,17,14,864,7,432,17500168.333333332,174.0,61.71428571428572,7,432,17500890.833333332,174.0,61.71428571428572
35970.0,6,14,4740,7,653,5836.333333333333,249.0,93.28571428571428,7,4087,5804.333333333333,1514.0,583.8571428571429
119559371.0,6,33,2280,17,1209,7472460.6875,123.0,71.11764705882354,16,1071,7290552.133333334,123.0,66.9375
47784.0,6,14,4740,7,653,7368.5,249.0,93.28571428571428,7,4087,6518.0,1514.0,583.8571428571429
207125.0,6,3,426,2,280,0.0,214.0,140.0,1,146,0.0,146.0,146.0
302066.0,6,6,412,4,272,100688.66666666669,74.0,68.0,2,140,0.0,74.0,70.0
218364.0,6,3,426,2,280,0.0,214.0,140.0,1,146,0.0,146.0,146.0
41467.0,6,14,4740,7,653,6781.0,249.0,93.28571428571428,7,4087,6604.0,1514.0,583.8571428571429
120234412.0,6,219,24706,110,17290,1103068.0,284.0,157.1818181818182,109,7416,1104639.9722222222,140.0,68.03669724770643
105517744.0,6,44,2904,22,1452,5024654.476190476,66.0,66.0,22,1452,5011533.571428572,66.0,66.0
171594.0,17,2,180,1,90,0.0,90.0,90.0,1,90,0.0,90.0,90.0
42977.0,6,14,4740,7,653,6976.666666666667,249.0,93.28571428571428,7,4087,5967.833333333333,1514.0,583.8571428571429
27387.0,6,10,2032,5,524,6629.5,252.0,104.8,5,1508,6612.75,1236.0,301.6
10882795.0,6,8,544,4,272,3580762.6666666665,74.0,68.0,4,272,3580690.6666666665,74.0,68.0
123737679.0,6,35,2410,18,1285,7278687.0,139.0,71.38888888888889,17,1125,7096756.4375,123.0,66.17647058823529
121580.0,6,3,337,2,214,0.0,160.0,107.0,1,123,0.0,123.0,123.0
116171079.0,6,768,100938,384,25566,303240.3002610966,140.0,66.578125,384,75372,303244.0391644909,374.0,196.28125
118061973.0,6,48,3168,24,1584,5133129.260869565,66.0,66.0,24,1584,5121149.739130435,66.0,66.0
106862496.0,6,33,2343,17,1194,6678879.3125,123.0,70.23529411764706,16,1149,7124068.0,123.0,71.8125
101707733.0,17,14,864,7,432,16834156.666666668,174.0,61.71428571428572,7,432,16833539.666666668,174.0,61.71428571428572
38590794.0,6,26,7627,14,3735,184120.15384615384,1514.0,266.7857142857143,12,3892,3489642.363636364,1514.0,324.3333333333333
108101229.0,17,5,1005,5,1005,27025307.25,201.0,201.0,0,0,0.0,0.0,0.0
207059.0,17,2,762,2,762,0.0,381.0,381.0,0,0,0.0,0.0,0.0
2380005.0,6,49,23728,25,19797,99166.875,1514.0,791.88,24,3931,93384.21739130437,1514.0,163.79166666666666
92113750.0,6,38,2508,19,1254,5105435.888888889,66.0,66.0,19,1254,5105437.333333333,66.0,66.0
2798863.0,6,2,132,1,66,0.0,66.0,66.0,1,66,0.0,66.0,66.0
18172.0,6,10,2032,5,524,4222.0,252.0,104.8,5,1508,4231.5,1236.0,301.6
90032054.0,17,28,13364,28,13364,3334520.5185185187,501.0,477.2857142857143,0,0,0.0,0.0,0.0
108096238.0,17,5,1005,5,1005,27024059.5,201.0,201.0,0,0,0.0,0.0,0.0
4102.0,17,2,180,1,90,0.0,90.0,90.0,1,90,0.0,90.0,90.0
207808.0,6,3,426,2,280,0.0,214.0,140.0,1,146,0.0,146.0,146.0
20331.0,6,2,145,2,145,0.0,91.0,72.5,0,0,0.0,0.0,0.0
146215.0,6,3,337,2,214,0.0,160.0,107.0,1,123,0.0,123.0,123.0
108110403.0,17,5,1005,5,1005,27027600.75,201.0,201.0,0,0,0.0,0.0,0.0
132761.0,6,15,4806,8,719,18300.14285714286,249.0,89.875,7,4087,21821.0,1514.0,583.8571428571429
413.0,17,2,176,1,88,0.0,88.0,88.0,1,88,0.0,88.0,88.0
120382985.0,6,231,26150,116,18264,1046808.5652173914,284.0,157.44827586206895,115,7886,1046965.5175438595,140.0,68.57391304347826
90257913.0,6,12,1832,8,1016,12893987.57142857,188.0,127.0,4,816,30031095.33333333,204.0,204.0
14425210.0,17,6,2052,6,2052,2885042.0,342.0,342.0,0,0,0.0,0.0,0.0
123839707.0,6,48,3168,24,1584,5059359.434782608,66.0,66.0,24,1584,5238035.043478261,66.0,66.0
887501.0,6,12,2710,7,743,147916.83333333334,339.0,106.14285714285714,5,1967,153725.75,1514.0,393.4
135129610.0,17,6,1146,6,1146,27025922.0,191.0,191.0,0,0,0.0,0.0,0.0
2781002.0,6,2,132,1,66,0.0,66.0,66.0,1,66,0.0,66.0,66.0
108105603.0,17,5,955,5,955,27026400.75,191.0,191.0,0,0,0.0,0.0,0.0
217675.0,6,3,426,2,280,0.0,214.0,140.0,1,146,0.0,146.0,146.0
93389253.0,17,11,735,6,389,18646067.6,174.0,64.83333333333333,5,346,18473472.0,174.0,69.2
483.0,17,2,508,2,508,0.0,257.0,254.0,0,0,0.0,0.0,0.0
281164.0,17,2,363,1,79,0.0,79.0,79.0,1,284,0.0,284.0,284.0
148042.0,17,2,180,1,90,0.0,90.0,90.0,1,90,0.0,90.0,90.0
119673891.0,6,224,25328,112,17640,1076204.7567567567,284.0,157.5,112,7688,1076204.9189189188,140.0,68.64285714285714
3134413.0,6,7,923,4,753,976099.0,571.0,188.25,3,170,1464486.5,62.0,56.66666666666666
120124423.0,6,12,1832,8,1016,17137382.714285713,188.0,127.0,4,816,30028883.33333333,204.0,204.0
119781378.0,17,35,16705,35,16705,3522981.705882353,501.0,477.2857142857143,0,0,0.0,0.0,0.0
276178.0,6,10,1221,6,636,55235.6,298.0,106.0,4,585,86198.33333333333,379.0,146.25
2179036.0,6,18,6803,10,1501,242115.11111111112,408.0,150.1,8,5302,249340.14285714287,1514.0,662.75
135138246.0,17,6,1206,6,1206,27027649.2,201.0,201.0,0,0,0.0,0.0,0.0
21393.0,17,2,582,1,83,0.0,83.0,83.0,1,499,0.0,499.0,499.0
108113358.0,17,5,1005,5,1005,27028339.5,201.0,201.0,0,0,0.0,0.0,0.0
133571628.0,17,14,864,7,432,19001392.166666668,174.0,61.71428571428572,7,432,19000183.166666668,174.0,61.71428571428572
41839.0,6,14,4740,7,653,5797.0,249.0,93.28571428571428,7,4087,6391.666666666667,1514.0,583.8571428571429
1648880.0,6,20,6434,12,1921,149898.18181818182,620.0,160.08333333333334,8,4513,191998.0,1514.0,564.125
2045.0,17,4,344,2,150,0.0,75.0,75.0,2,194,0.0,103.0,97.0
12749500.0,6,5,1736,2,819,0.0,753.0,409.5,3,917,6301821.0,785.0,305.6666666666667
195200.0,17,4,1400,4,1400,65066.66666666666,350.0,350.0,0,0,0.0,0.0,0.0
1022096.0,6,11,1134,6,558,204419.2,220.0,93.0,5,576,255117.25,304.0,115.2
2098538.0,6,25,7610,13,2516,174878.16666666666,1034.0,193.53846153846155,12,5094,163007.18181818182,1510.0,424.5
44642.0,6,14,4740,7,653,7322.5,249.0,93.28571428571428,7,4087,7306.333333333333,1514.0,583.8571428571429
57695.0,6,14,4740,7,653,8366.5,249.0,93.28571428571428,7,4087,8815.0,1514.0,583.8571428571429
90006269.0,17,28,13364,28,13364,3333565.5185185187,501.0,477.2857142857143,0,0,0.0,0.0,0.0
58373.0,6,14,4740,7,653,9028.333333333334,249.0,93.28571428571428,7,4087,9174.5,1514.0,583.8571428571429
217764.0,6,3,426,2,280,0.0,214.0,140.0,1,146,0.0,146.0,146.0
251691.0,17,4,6056,4,6056,83897.0,1514.0,1514.0,0,0,0.0,0.0,0.0
60035.0,6,10,2032,5,524,14519.0,252.0,104.8,5,1508,10979.0,1236.0,301.6
135138170.0,17,6,1146,6,1146,27027634.0,191.0,191.0,0,0,0.0,0.0,0.0
171589.0,17,2,180,1,90,0.0,90.0,90.0,1,90,0.0,90.0,90.0
2375.0,17,4,344,2,150,0.0,75.0,75.0,2,194,0.0,103.0,97.0
311249.0,6,7,478,4,272,103749.66666666669,74.0,68.0,3,206,78178.5,74.0,68.66666666666667
10367.0,6,10,2032,5,524,1917.5,252.0,104.8,5,1508,2255.0,1236.0,301.6
2281947.0,6,50,23782,26,19851,91277.88,1514.0,763.5,24,3931,89853.82608695653,1514.0,163.79166666666666
36257.0,6,14,4740,7,653,5916.333333333333,249.0,93.28571428571428,7,4087,5361.666666666667,1514.0,583.8571428571429
62163938.0,17,8,2744,7,2394,6000257.166666667,342.0,342.0,1,350,0.0,350.0,350.0
219757.0,6,3,426,2,280,0.0,214.0,140.0,1,146,0.0,146.0,146.0
2798079.0,6,2,132,1,66,0.0,66.0,66.0,1,66,0.0,66.0,66.0
153542.0,17,2,180,1,90,0.0,90.0,90.0,1,90,0.0,90.0,90.0
209437.0,17,2,180,1,90,0.0,90.0,90.0,1,90,0.0,90.0,90.0
100778423.0,6,28,1876,14,982,7735595.769230769,139.0,70.14285714285714,14,894,7735591.153846154,123.0,63.85714285714285
56791.0,6,14,4740,7,653,9334.666666666666,249.0,93.28571428571428,7,4087,8679.166666666666,1514.0,583.8571428571429
155274.0,6,3,337,2,214,0.0,160.0,107.0,1,123,0.0,123.0,123.0
20018604.0,17,3,1034,2,684,0.0,342.0,342.0,1,350,0.0,350.0,350.0
1630470.0,6,7,499,4,301,495028.6666666667,103.0,75.25,3,198,715951.5,66.0,66.0
204693.0,17,2,762,2,762,0.0,381.0,381.0,0,0,0.0,0.0,0.0
43713.0,6,14,4740,7,653,6167.833333333333,249.0,93.28571428571428,7,4087,6701.5,1514.0,583.8571428571429
2787209.0,6,2,132,1,66,0.0,66.0,66.0,1,66,0.0,66.0,66.0
100000971.0,17,13,1083,7,563,16666828.5,174.0,80.42857142857143,6,520,17132178.0,174.0,86.66666666666667
297849.0,6,3,202,2,128,0.0,74.0,64.0,1,74,0.0,74.0,74.0
135128471.0,17,6,1206,6,1206,27025694.2,201.0,201.0,0,0,0.0,0.0,0.0
200413.0,17,2,762,2,762,0.0,381.0,381.0,0,0,0.0,0.0,0.0
307470.0,17,4,1400,4,1400,102490.0,350.0,350.0,0,0,0.0,0.0,0.0
109678.0,17,2,286,2,286,0.0,143.0,143.0,0,0,0.0,0.0,0.0
1411980.0,17,7,490,7,490,235330.0,70.0,70.0,0,0,0.0,0.0,0.0
120146747.0,6,46,3036,24,1584,5223771.608695652,66.0,66.0,22,1452,5065437.142857143,66.0,66.0
47119.0,6,13,1479,7,882,7533.166666666667,291.0,126.0,6,597,6511.0,259.0,99.5
699198.0,6,10,1124,6,608,139839.6,222.0,101.33333333333331,4,516,147299.33333333334,206.0,129.0
1416490.0,17,16,1120,16,1120,94432.66666666669,70.0,70.0,0,0,0.0,0.0,0.0
783.0,17,4,438,2,148,0.0,74.0,74.0,2,290,0.0,147.0,145.0
218789.0,6,3,426,2,280,0.0,214.0,140.0,1,146,0.0,146.0,146.0
108109509.0,17,5,955,5,955,27027377.25,191.0,191.0,0,0,0.0,0.0,0.0
52918.0,6,14,4740,7,653,8294.666666666666,249.0,93.28571428571428,7,4087,8625.833333333334,1514.0,583.8571428571429
1444821.0,6,19,7533,10,1403,160535.66666666666,583.0,140.3,9,6130,149156.875,1484.0,681.1111111111111
305009.0,6,6,412,4,272,101669.66666666669,74.0,68.0,2,140,0.0,74.0,70.0
324.0,17,2,156,1,78,0.0,78.0,78.0,1,78,0.0,78.0,78.0
102406595.0,17,14,864,7,432,17001318.666666668,174.0,61.71428571428572,7,432,17000172.5,174.0,61.71428571428572
146368.0,6,3,337,1,123,0.0,123.0,123.0,2,214,0.0,160.0,107.0
298771.0,6,6,412,4,272,99590.33333333331,74.0,68.0,2,140,0.0,74.0,70.0
4324.0,17,2,614,1,72,0.0,72.0,72.0,1,542,0.0,542.0,542.0
330.0,17,2,160,1,80,0.0,80.0,80.0,1,80,0.0,80.0,80.0
303604.0,6,2,132,1,66,0.0,66.0,66.0,1,66,0.0,66.0,66.0
4405.0,17,2,614,1,72,0.0,72.0,72.0,1,542,0.0,542.0,542.0
122161872.0,6,31,2166,15,1017,8012519.5,123.0,67.8,16,1149,7478380.133333334,123.0,71.8125
108672668.0,6,34,2482,17,1288,6778539.875,139.0,75.76470588235294,17,1194,6778540.75,123.0,70.23529411764706
102117195.0,6,175,20500,88,14536,1173760.8620689656,390.0,165.1818181818182,87,5964,1175330.023255814,140.0,68.55172413793103
42186.0,6,10,1065,5,534,9314.25,262.0,106.8,5,531,8529.0,259.0,106.2
3862163.0,6,34,10339,17,6284,241385.1875,1514.0,369.6470588235294,17,4055,205029.8125,1514.0,238.52941176470588
108108056.0,17,5,1005,5,1005,27027014.0,201.0,201.0,0,0,0.0,0.0,0.0
719.0,17,4,438,2,148,0.0,74.0,74.0,2,290,0.0,147.0,145.0
256274.0,6,3,337,2,214,0.0,160.0,107.0,1,123,0.0,123.0,123.0
90039490.0,17,28,13364,28,13364,3334795.925925926,501.0,477.2857142857143,0,0,0.0,0.0,0.0
0.0,6,1,66,1,66,0.0,66.0,66.0,0,0,0.0,0.0,0.0
108109146.0,17,5,1005,5,1005,27027286.5,201.0,201.0,0,0,0.0,0.0,0.0
300.0,17,2,156,1,78,0.0,78.0,78.0,1,78,0.0,78.0,78.0
107417.0,17,2,286,2,286,0.0,143.0,143.0,0,0,0.0,0.0,0.0
1376869.0,6,4,276,2,128,0.0,74.0,64.0,2,148,0.0,74.0,74.0
120293767.0,6,400,47690,200,13496,600558.0201005025,140.0,67.48,200,34194,604393.9346733668,336.0,170.97
90033522.0,17,28,13364,28,13364,3334574.888888889,501.0,477.2857142857143,0,0,0.0,0.0,0.0
106431.0,17,2,286,2,286,0.0,143.0,143.0,0,0,0.0,0.0,0.0
106025139.0,17,14,864,7,432,17667647.5,174.0,61.71428571428572,7,432,17666817.166666668,174.0,61.71428571428572
112185.0,17,2,700,2,700,0.0,350.0,350.0,0,0,0.0,0.0,0.0
305078.0,6,6,412,4,272,101692.66666666669,74.0,68.0,2,140,0.0,74.0,70.0
30913.0,6,10,2032,5,524,6534.5,252.0,104.8,5,1508,7348.25,1236.0,301.6
220353.0,6,3,426,2,280,0.0,214.0,140.0,1,146,0.0,146.0,146.0
2415.0,17,4,344,2,150,0.0,75.0,75.0,2,194,0.0,103.0,97.0
95876.0,6,11,2098,6,590,19055.2,252.0,98.33333333333331,5,1508,22373.5,1236.0,301.6
19821.0,6,10,2032,5,524,3590.25,252.0,104.8,5,1508,4637.75,1236.0,301.6
2406.0,17,4,344,2,150,0.0,75.0,75.0,2,194,0.0,103.0,97.0
113614326.0,6,46,3036,23,1518,5150435.863636363,66.0,66.0,23,1518,5150433.454545454,66.0,66.0
875533.0,6,11,2643,7,743,145922.16666666666,339.0,106.14285714285714,4,1900,199940.0,1514.0,475.0
120012426.0,6,18,1341,9,691,14999989.375,95.0,76.77777777777777,9,650,15001209.75,95.0,72.22222222222223
106696720.0,17,14,864,7,432,17756294.5,174.0,61.71428571428572,7,432,17636682.666666668,174.0,61.71428571428572
155389.0,17,4,1524,4,1524,51796.333333333336,381.0,381.0,0,0,0.0,0.0,0.0
148207.0,6,2,132,1,66,0.0,66.0,66.0,1,66,0.0,66.0,66.0
209587.0,17,2,180,1,90,0.0,90.0,90.0,1,90,0.0,90.0,90.0
90303080.0,6,16,1192,8,596,12893245.857142856,95.0,74.5,8,596,12899086.142857144,95.0,74.5
10523259.0,6,7,478,4,272,3462370.0,74.0,68.0,3,206,5193467.5,74.0,68.66666666666667
501541.0,6,2,132,1,66,0.0,66.0,66.0,1,66,0.0,66.0,66.0
355.0,17,2,267,1,83,0.0,83.0,83.0,1,184,0.0,184.0,184.0
120294750.0,6,18,1382,9,691,14999987.25,95.0,76.77777777777777,9,691,15035147.125,95.0,76.77777777777777
113610632.0,6,48,3168,24,1584,4934000.0,66.0,66.0,24,1584,4933606.739130435,66.0,66.0
23830.0,6,14,4740,7,653,3555.333333333333,249.0,93.28571428571428,7,4087,3832.8333333333335,1514.0,583.8571428571429
32513.0,6,14,4740,7,653,4721.666666666667,249.0,93.28571428571428,7,4087,4976.0,1514.0,583.8571428571429
122530588.0,6,49,3234,25,1650,5105441.166666667,66.0,66.0,24,1584,4968329.739130435,66.0,66.0
266648.0,6,3,337,2,214,0.0,160.0,107.0,1,123,0.0,123.0,123.0
44570.0,6,14,4740,7,653,6467.333333333333,249.0,93.28571428571428,7,4087,6834.333333333333,1514.0,583.8571428571429
135517.0,6,2,132,1,66,0.0,66.0,66.0,1,66,0.0,66.0,66.0
24605.0,6,14,4740,7,653,3938.0,249.0,93.28571428571428,7,4087,3360.5,1514.0,583.8571428571429
117296843.0,17,14,864,7,432,19522794.666666668,174.0,61.71428571428572,7,432,19460930.0,174.0,61.71428571428572
119640591.0,6,234,26400,117,18382,1029529.025862069,284.0,157.11111111111111,117,8018,1030452.2672413794,140.0,68.52991452991454
27206540.0,17,5,1710,5,1710,6801635.0,342.0,342.0,0,0,0.0,0.0,0.0
113168327.0,6,46,3036,23,1518,5143999.954545454,66.0,66.0,23,1518,5144002.681818182,66.0,66.0
20900.0,6,14,4740,7,653,3293.0,249.0,93.28571428571428,7,4087,3346.5,1514.0,583.8571428571429
44811.0,6,14,4740,7,653,6598.833333333333,249.0,93.28571428571428,7,4087,6872.666666666667,1514.0,583.8571428571429
147542.0,6,3,337,2,214,0.0,160.0,107.0,1,123,0.0,123.0,123.0
108104716.0,17,5,955,5,955,27026179.0,191.0,191.0,0,0,0.0,0.0,0.0
105065808.0,17,13,952,7,563,17437375.666666668,174.0,80.42857142857143,6,389,20037957.8,174.0,64.83333333333333
92333971.0,17,14,1126,7,563,15388995.166666666,174.0,80.42857142857143,7,563,15302170.5,174.0,80.42857142857143
307093.0,6,6,412,4,272,102364.33333333331,74.0,68.0,2,140,0.0,74.0,70.0
2044.0,17,4,344,2,150,0.0,75.0,75.0,2,194,0.0,103.0,97.0
1168209.0,6,13,3010,8,2382,166887.0,1514.0,297.75,5,628,223903.5,331.0,125.6
303003.0,6,6,412,4,272,101001.0,74.0,68.0,2,140,0.0,74.0,70.0
114020944.0,6,48,3168,24,1584,4957432.347826087,66.0,66.0,24,1584,4944016.217391305,66.0,66.0
419.0,17,2,762,2,762,0.0,381.0,381.0,0,0,0.0,0.0,0.0
25014.0,6,10,2032,5,524,5972.25,252.0,104.8,5,1508,4947.0,1236.0,301.6
15040.0,17,2,180,1,90,0.0,90.0,90.0,1,90,0.0,90.0,90.0
103804.0,17,2,286,2,286,0.0,143.0,143.0,0,0,0.0,0.0,0.0
143856.0,17,2,180,1,90,0.0,90.0,90.0,1,90,0.0,90.0,90.0
119851751.0,6,15,2306,6,1224,23970058.2,204.0,204.0,9,1082,14981318.5,188.0,120.22222222222224
237511.0,6,3,373,2,238,0.0,172.0,119.0,1,135,0.0,135.0,135.0
120056142.0,6,228,25788,114,7746,1055174.7168141592,140.0,67.94736842105263,114,18042,1055373.8053097343,284.0,158.26315789473685
325.0,17,2,166,1,75,0.0,75.0,75.0,1,91,0.0,91.0,91.0
439944.0,6,11,1021,6,444,59241.6,162.0,74.0,5,577,73934.5,349.0,115.4
41340.0,6,11,2098,6,590,7667.6,252.0,98.33333333333331,5,1508,10050.5,1236.0,301.6
90373886.0,6,17,1287,9,691,11291542.75,95.0,76.77777777777777,8,596,12843712.142857144,95.0,74.5
28334.0,6,14,4740,7,653,3657.8333333333335,249.0,93.28571428571428,7,4087,4582.5,1514.0,583.8571428571429
0.0,17,1,55,1,55,0.0,55.0,55.0,0,0,0.0,0.0,0.0
1167218.0,6,13,3010,8,2382,166745.42857142858,1514.0,297.75,5,628,222922.0,331.0,125.6
3168450.0,6,18,1495,9,921,358384.875,315.0,102.33333333333331,9,574,358364.25,78.0,63.77777777777778
47607958.0,6,8,1940,3,887,22754253.0,753.0,295.6666666666667,5,1053,11208225.75,785.0,210.6
91437376.0,6,24,1829,13,989,7616842.25,95.0,76.07692307692308,11,840,9141916.8,95.0,76.36363636363636
90020797.0,17,27,12943,27,12943,3462338.346153846,501.0,479.3703703703704,0,0,0.0,0.0,0.0
120123773.0,6,14,2224,9,1204,15015471.625,188.0,133.77777777777777,5,1020,22524352.75,204.0,204.0
250976.0,6,3,373,2,238,0.0,172.0,119.0,1,135,0.0,135.0,135.0
2286.0,17,4,344,2,150,0.0,75.0,75.0,2,194,0.0,103.0,97.0
52937.0,6,14,4740,7,653,7957.5,249.0,93.28571428571428,7,4087,5708.0,1514.0,583.8571428571429
135133502.0,17,6,1146,6,1146,27026700.4,191.0,191.0,0,0,0.0,0.0,0.0
309567.0,6,6,412,4,272,103189.0,74.0,68.0,2,140,0.0,74.0,70.0
35015.0,6,14,4740,7,653,5726.5,249.0,93.28571428571428,7,4087,5077.0,1514.0,583.8571428571429
90019220.0,17,28,13364,28,13364,3334045.185185185,501.0,477.2857142857143,0,0,0.0,0.0,0.0
106692.0,17,2,286,2,286,0.0,143.0,143.0,0,0,0.0,0.0,0.0
26231961.0,17,5,1718,4,1368,1794177.6666666667,342.0,342.0,1,350,0.0,350.0,350.0
198675.0,17,2,180,1,90,0.0,90.0,90.0,1,90,0.0,90.0,90.0
145960.0,17,2,180,1,90,0.0,90.0,90.0,1,90,0.0,90.0,90.0
259205.00000000003,6,10,1221,6,636,51841.0,298.0,106.0,4,585,80617.33333333333,379.0,146.25
120124300.0,6,14,2224,9,1204,15015537.5,188.0,133.77777777777777,5,1020,22595497.25,204.0,204.0
114886170.0,6,33,2280,17,1209,7166883.9375,123.0,71.11764705882354,16,1071,7644674.933333334,123.0,66.9375
110416309.0,6,218,24534,109,17044,1020380.5925925926,284.0,156.36697247706422,109,7490,1020380.5925925926,140.0,68.71559633027523
113117788.0,6,32,2220,16,1149,7541185.866666666,123.0,71.8125,16,1071,7526063.466666667,123.0,66.9375
2128.0,17,4,344,2,150,0.0,75.0,75.0,2,194,0.0,103.0,97.0
9252.0,17,4,823,2,163,0.0,89.0,81.5,2,660,0.0,443.0,330.0
9687.0,17,2,582,1,83,0.0,83.0,83.0,1,499,0.0,499.0,499.0
36510.0,6,14,4740,7,653,5922.0,249.0,93.28571428571428,7,4087,5762.166666666667,1514.0,583.8571428571429
108104376.0,17,5,1005,5,1005,27026094.0,201.0,201.0,0,0,0.0,0.0,0.0
108112238.0,6,189,21758,95,6492,1150130.1914893617,140.0,68.33684210526316,94,15266,1140209.688172043,284.0,162.40425531914894
16306.999999999998,6,14,4740,7,653,2545.333333333333,249.0,93.28571428571428,7,4087,2583.0,1514.0,583.8571428571429
1033918.0,6,11,1134,6,558,206783.6,220.0,93.0,5,576,258082.25,304.0,115.2
2370.0,17,2,664,1,322,0.0,322.0,322.0,1,342,0.0,342.0,342.0
1480.0,17,2,762,2,762,0.0,381.0,381.0,0,0,0.0,0.0,0.0
123455818.0,6,48,3168,24,1584,4944106.130434782,66.0,66.0,24,1584,5323873.608695652,66.0,66.0
207243.0,6,3,426,2,280,0.0,214.0,140.0,1,146,0.0,146.0,146.0
523770.0,6,3,198,1,66,0.0,66.0,66.0,2,132,0.0,66.0,66.0
286804.0,17,2,363,1,79,0.0,79.0,79.0,1,284,0.0,284.0,284.0
216928.0,6,3,426,2,280,0.0,214.0,140.0,1,146,0.0,146.0,146.0
899055.0,6,10,1333,6,796,179811.0,458.0,132.66666666666666,4,537,207963.0,331.0,134.25
33312.0,6,14,4740,7,653,5125.666666666667,249.0,93.28571428571428,7,4087,5411.5,1514.0,583.8571428571429
87547.0,6,19,7540,11,978,8754.7,310.0,88.9090909090909,8,6562,5555.142857142857,1514.0,820.25
153419.0,17,2,180,1,90,0.0,90.0,90.0,1,90,0.0,90.0,90.0
1194044.0,6,13,3010,8,2382,170577.7142857143,1514.0,297.75,5,628,229560.25,331.0,125.6
32175.000000000004,6,14,4740,7,653,4604.0,249.0,93.28571428571428,7,4087,4741.0,1514.0,583.8571428571429
216359.0,17,2,180,1,90,0.0,90.0,90.0,1,90,0.0,90.0,90.0
90011590.0,17,28,13364,28,13364,3333762.592592593,501.0,477.2857142857143,0,0,0.0,0.0,0.0
307912.0,6,6,412,4,272,102637.33333333331,74.0,68.0,2,140,0.0,74.0,70.0
3171381.0,6,6,876,2,292,0.0,214.0,146.0,4,584,984431.3333333334,146.0,146.0
206139.0,6,3,426,2,280,0.0,214.0,140.0,1,146,0.0,146.0,146.0
284616.0,17,4,571,2,148,0.0,74.0,74.0,2,423,0.0,280.0,211.5
456.0,17,2,267,1,83,0.0,83.0,83.0,1,184,0.0,184.0,184.0
196935.0,17,2,180,1,90,0.0,90.0,90.0,1,90,0.0,90.0,90.0
143947.0,17,2,180,1,90,0.0,90.0,90.0,1,90,0.0,90.0,90.0
217827.0,6,3,426,2,280,0.0,214.0,140.0,1,146,0.0,146.0,146.0
209073.0,6,3,426,2,280,0.0,214.0,140.0,1,146,0.0,146.0,146.0
215085.0,6,3,426,2,280,0.0,214.0,140.0,1,146,0.0,146.0,146.0
307847.0,6,6,412,4,272,102615.66666666669,74.0,68.0,2,140,0.0,74.0,70.0
51750.0,6,12,1413,7,882,8625.0,291.0,126.0,5,531,10840.75,259.0,106.2
2097473.0,6,19,6869,11,1567,209747.3,408.0,142.45454545454547,8,5302,237773.0,1514.0,662.75
2748213.0,6,3,1604,1,753,0.0,753.0,753.0,2,851,0.0,785.0,425.5
66388.0,6,14,4740,7,653,10778.0,249.0,93.28571428571428,7,4087,9732.0,1514.0,583.8571428571429
206418.0,17,2,180,1,90,0.0,90.0,90.0,1,90,0.0,90.0,90.0
155896.0,17,2,180,1,90,0.0,90.0,90.0,1,90,0.0,90.0,90.0
113522910.0,6,48,3168,24,1584,4935778.695652174,66.0,66.0,24,1584,4923785.130434782,66.0,66.0
120001005.0,17,15,907,8,475,17143000.714285713,174.0,59.375,7,432,16667454.5,174.0,61.71428571428572
217610.0,6,3,426,2,280,0.0,214.0,140.0,1,146,0.0,146.0,146.0
106290.0,17,2,700,2,700,0.0,350.0,350.0,0,0,0.0,0.0,0.0
104022057.0,6,528,64254,264,17646,395515.36121673,140.0,66.8409090909091,264,46608,394539.4866920152,374.0,176.54545454545453
314568.0,17,4,1400,4,1400,104856.0,350.0,350.0,0,0,0.0,0.0,0.0
891726.0,6,10,1335,6,798,178345.2,460.0,133.0,4,537,205275.3333333333,331.0,134.25
204741.0,17,2,762,2,762,0.0,381.0,381.0,0,0,0.0,0.0,0.0
322984.0,17,4,1400,4,1400,107661.33333333331,350.0,350.0,0,0,0.0,0.0,0.0
213379.0,17,2,180,1,90,0.0,90.0,90.0,1,90,0.0,90.0,90.0
1283950.0,17,7,490,7,490,213991.66666666663,70.0,70.0,0,0,0.0,0.0,0.0
119717419.0,6,346,40886,173,29172,694780.2151162791,374.0,168.6242774566474,173,11714,694780.5058139535,140.0,67.71098265895954
135125671.0,17,6,1146,6,1146,27025134.2,191.0,191.0,0,0,0.0,0.0,0.0
239452.0,17,2,180,1,90,0.0,90.0,90.0,1,90,0.0,90.0,90.0
72168549.0,6,9,842,9,842,9021068.625,97.0,93.55555555555556,0,0,0.0,0.0,0.0
146252.0,6,3,337,2,214,0.0,160.0,107.0,1,123,0.0,123.0,123.0
143933.0,17,2,180,1,90,0.0,90.0,90.0,1,90,0.0,90.0,90.0
151500.0,17,2,414,1,88,0.0,88.0,88.0,1,326,0.0,326.0,326.0
297310.0,6,6,412,4,272,99103.33333333331,74.0,68.0,2,140,0.0,74.0,70.0
33274.0,6,10,2032,5,524,7022.75,252.0,104.8,5,1508,7812.25,1236.0,301.6
209181.0,6,10,1221,6,636,41836.2,298.0,106.0,4,585,67840.33333333333,379.0,146.25
64549.99999999999,6,12,1328,7,797,10758.333333333334,253.0,113.85714285714286,5,531,13945.75,259.0,106.2
183.0,17,2,3028,2,3028,0.0,1514.0,1514.0,0,0,0.0,0.0,0.0
100160280.0,6,191,21508,96,6558,1054318.7368421052,140.0,68.3125,95,14950,1054602.2872340423,284.0,157.3684210526316
95000768.0,17,11,735,6,389,19000153.6,174.0,64.83333333333333,5,346,20071025.75,174.0,69.2
118632366.0,6,33,2290,17,1125,7414522.875,123.0,66.17647058823529,16,1165,7381613.8,139.0,72.8125
90535588.0,6,14,2240,8,1016,12933655.42857143,188.0,127.0,6,1224,18074432.0,204.0,204.0
10838134.0,6,8,544,4,272,3567377.6666666665,74.0,68.0,4,272,3567301.333333333,74.0,68.0
209668.0,17,2,180,1,90,0.0,90.0,90.0,1,90,0.0,90.0,90.0
124001104.0,17,15,907,8,475,17714443.42857143,174.0,59.375,7,432,17334508.5,174.0,61.71428571428572
111449462.0,17,12,1080,6,540,22259280.4,90.0,90.0,6,540,22259211.8,90.0,90.0
507717.0,6,4,270,2,134,0.0,68.0,67.0,2,136,0.0,70.0,68.0
2359.0,17,4,344,2,150,0.0,75.0,75.0,2,194,0.0,103.0,97.0
90213315.0,6,25,2815,13,1456,7496968.833333333,361.0,112.0,12,1359,8181993.909090909,429.0,113.25
1419855.0,17,16,1120,16,1120,94657.0,70.0,70.0,0,0,0.0,0.0,0.0
296878.0,6,6,412,4,272,98959.33333333331,74.0,68.0,2,140,0.0,74.0,70.0
108111086.0,17,5,1005,5,1005,27027771.5,201.0,201.0,0,0,0.0,0.0,0.0
19513.0,6,14,4740,7,653,2980.0,249.0,93.28571428571428,7,4087,2726.1666666666665,1514.0,583.8571428571429
142413.0,6,2,132,1,66,0.0,66.0,66.0,1,66,0.0,66.0,66.0
93817525.0,6,183,20620,92,6294,1030961.8131868131,140.0,68.41304347826087,91,14326,1030862.2666666668,284.0,157.42857142857142
243365.0,6,3,337,2,214,0.0,160.0,107.0,1,123,0.0,123.0,123.0
145734.0,6,3,373,2,238,0.0,172.0,119.0,1,135,0.0,135.0,135.0
3059.0,17,2,224,1,76,0.0,76.0,76.0,1,148,0.0,148.0,148.0
112331091.0,6,32,2220,16,1149,7474353.933333334,123.0,71.8125,16,1071,7474352.733333333,123.0,66.9375
314.0,17,2,160,1,80,0.0,80.0,80.0,1,80,0.0,80.0,80.0
1114903.0,6,20,6434,12,1921,101354.81818181818,620.0,160.08333333333334,8,4513,132969.57142857142,1514.0,564.125
90256639.0,6,13,2036,8,1016,12893805.57142857,188.0,127.0,5,1020,22522708.5,204.0,204.0
2137.0,17,2,664,1,322,0.0,322.0,322.0,1,342,0.0,342.0,342.0
302247.0,17,2,346,1,78,0.0,78.0,78.0,1,268,0.0,268.0,268.0
44639.0,6,14,4740,7,653,7321.0,249.0,93.28571428571428,7,4087,7127.333333333333,1514.0,583.8571428571429
108105190.0,17,5,955,5,955,27026297.5,191.0,191.0,0,0,0.0,0.0,0.0
103737044.0,6,31,2182,16,1165,6901401.0,139.0,72.8125,15,1017,7394360.0,123.0,67.8
206349.0,17,2,180,1,90,0.0,90.0,90.0,1,90,0.0,90.0,90.0
104804.0,17,2,762,2,762,0.0,381.0,381.0,0,0,0.0,0.0,0.0
90016136.0,17,28,13364,28,13364,3333930.962962963,501.0,477.2857142857143,0,0,0.0,0.0,0.0
90259992.0,6,13,2036,8,1016,12894284.57142857,188.0,127.0,5,1020,22523528.0,204.0,204.0
90256019.0,6,13,2036,8,1016,12893717.0,188.0,127.0,5,1020,22523118.75,204.0,204.0
246484.0,6,3,337,2,214,0.0,160.0,107.0,1,123,0.0,123.0,123.0
1023655.0,6,11,1134,6,558,204731.00000000003,220.0,93.0,5,576,254702.75,304.0,115.2
302258.0,6,6,412,4,272,100752.66666666669,74.0,68.0,2,140,0.0,74.0,70.0
358.0,17,2,267,1,83,0.0,83.0,83.0,1,184,0.0,184.0,184.0
120040951.0,17,28,13364,28,13364,4445961.148148148,501.0,477.2857142857143,0,0,0.0,0.0,0.0
27060.0,6,10,2032,5,524,5688.5,252.0,104.8,5,1508,6197.5,1236.0,301.6
44214.0,6,10,2032,5,524,10818.5,252.0,104.8,5,1508,10697.5,1236.0,301.6
0.0,17,1,342,1,342,0.0,342.0,342.0,0,0,0.0,0.0,0.0
103729.0,17,2,286,2,286,0.0,143.0,143.0,0,0,0.0,0.0,0.0
1431841.0,17,16,1120,16,1120,95456.06666666668,70.0,70.0,0,0,0.0,0.0,0.0
372592.0,6,11,1021,6,444,50689.4,162.0,74.0,5,577,63270.75,349.0,115.4
108103801.0,17,5,1005,5,1005,27025950.25,201.0,201.0,0,0,0.0,0.0,0.0
146398.0,6,3,337,2,214,0.0,160.0,107.0,1,123,0.0,123.0,123.0
108101158.0,17,5,955,5,955,27025289.5,191.0,191.0,0,0,0.0,0.0,0.0
196781.0,17,2,180,1,90,0.0,90.0,90.0,1,90,0.0,90.0,90.0
24448203.0,6,26,7627,14,3735,212249.84615384616,1514.0,266.7857142857143,12,3892,2202982.0,1514.0,324.3333333333333
2047867.0,17,6,1230,3,234,1023713.0,78.0,78.0,3,996,1023712.0,332.0,332.0
9061566.0,17,4,1812,4,1812,3020522.0,453.0,453.0,0,0,0.0,0.0,0.0
143847.0,17,2,180,1,90,0.0,90.0,90.0,1,90,0.0,90.0,90.0
0.0,6,1,66,1,66,0.0,66.0,66.0,0,0,0.0,0.0,0.0
1794453.0,17,6,1230,3,234,897042.5,78.0,78.0,3,996,897016.5,332.0,332.0
6868.0,17,2,582,1,83,0.0,83.0,83.0,1,499,0.0,499.0,499.0
2302.0,17,4,344,2,150,0.0,75.0,75.0,2,194,0.0,103.0,97.0
316035.0,17,4,1400,4,1400,105345.0,350.0,350.0,0,0,0.0,0.0,0.0
5722.0,17,2,180,1,90,0.0,90.0,90.0,1,90,0.0,90.0,90.0
793.0,17,2,684,2,684,0.0,342.0,342.0,0,0,0.0,0.0,0.0
217720.0,6,12,1373,7,714,36286.66666666666,298.0,102.0,5,659,53483.75,379.0,131.8
41716.0,6,14,4740,7,653,6274.833333333333,249.0,93.28571428571428,7,4087,6763.0,1514.0,583.8571428571429
14245.0,17,2,582,1,83,0.0,83.0,83.0,1,499,0.0,499.0,499.0
71137958.0,6,9,842,9,842,8892244.75,97.0,93.55555555555556,0,0,0.0,0.0,0.0
0.0,6,1,66,1,66,0.0,66.0,66.0,0,0,0.0,0.0,0.0
232354.0,6,3,337,2,214,0.0,160.0,107.0,1,123,0.0,123.0,123.0
300622.0,6,6,412,4,272,100207.33333333331,74.0,68.0,2,140,0.0,74.0,70.0
90056120.0,17,28,13364,28,13364,3335411.851851852,501.0,477.2857142857143,0,0,0.0,0.0,0.0
196897.0,17,2,180,1,90,0.0,90.0,90.0,1,90,0.0,90.0,90.0
1952.0,17,2,192,1,88,0.0,88.0,88.0,1,104,0.0,104.0,104.0
438.0,17,2,250,1,93,0.0,93.0,93.0,1,157,0.0,157.0,157.0
521.0,17,2,508,2,508,0.0,257.0,254.0,0,0,0.0,0.0,0.0
106827.0,17,2,286,2,286,0.0,143.0,143.0,0,0,0.0,0.0,0.0
127958136.0,6,31,2034,16,1086,8530542.4,123.0,67.875,15,948,8411210.214285715,123.0,63.2
90297575.0,6,16,1192,8,596,12893014.857142856,95.0,74.5,8,596,12898905.0,95.0,74.5
102654.0,17,2,286,2,286,0.0,143.0,143.0,0,0,0.0,0.0,0.0
2458.0,17,4,344,2,150,0.0,75.0,75.0,2,194,0.0,103.0,97.0
112464228.0,6,46,3036,23,1518,5111999.363636363,66.0,66.0,23,1518,5111998.818181818,66.0,66.0
10455827.0,6,7,478,4,272,3439932.333333333,74.0,68.0,3,206,5159810.5,74.0,68.66666666666667
233770.0,6,3,373,2,238,0.0,172.0,119.0,1,135,0.0,135.0,135.0
104057405.0,6,43,2838,22,1452,4955102.476190476,66.0,66.0,21,1386,5154395.3,66.0,66.0
108111071.0,17,5,955,5,955,27027767.75,191.0,191.0,0,0,0.0,0.0,0.0
166587.0,17,2,180,1,90,0.0,90.0,90.0,1,90,0.0,90.0,90.0
2377.0,17,4,344,2,150,0.0,75.0,75.0,2,194,0.0,103.0,97.0
349560.0,6,10,1221,6,636,69912.0,298.0,106.0,4,585,106428.0,379.0,146.25
217503.0,6,3,426,2,280,0.0,214.0,140.0,1,146,0.0,146.0,146.0
97913351.0,6,26,1746,13,906,8159445.916666667,123.0,69.6923076923077,13,840,8141424.083333333,123.0,64.61538461538461
1300178.0,6,4,264,2,132,0.0,66.0,66.0,2,132,0.0,66.0,66.0
111906.0,17,4,1400,4,1400,37302.0,350.0,350.0,0,0,0.0,0.0,0.0
120551619.0,6,436,52354,218,14684,552799.6543778802,140.0,67.35779816513761,218,37670,555188.3732718894,284.0,172.7981651376147
110989627.0,6,32,2236,16,1165,7384926.6,139.0,72.8125,16,1071,7384923.666666667,123.0,66.9375
3043.0,17,2,224,1,76,0.0,76.0,76.0,1,148,0.0,148.0,148.0
33550.0,6,10,1066,5,490,7314.25,218.0,98.0,5,576,6612.0,304.0,115.2
147985.0,17,2,180,1,90,0.0,90.0,90.0,1,90,0.0,90.0,90.0
38643.0,6,10,2032,5,524,9410.5,252.0,104.8,5,1508,8891.0,1236.0,301.6
52455.0,6,13,1386,7,789,6103.166666666667,253.0,112.71428571428572,6,597,9460.6,259.0,99.5
310120.0,6,6,412,4,272,103373.33333333331,74.0,68.0,2,140,0.0,74.0,70.0
90256222.0,6,12,1832,8,1016,12893746.0,188.0,127.0,4,816,30030605.666666668,204.0,204.0
330.0,17,2,166,1,75,0.0,75.0,75.0,1,91,0.0,91.0,91.0
10425029.0,6,7,478,4,272,3429498.6666666665,74.0,68.0,3,206,5144097.0,74.0,68.66666666666667
103081103.0,6,41,2706,21,1386,5154055.15,66.0,66.0,20,1320,5199773.7894736845,66.0,66.0
216603.0,17,2,180,1,90,0.0,90.0,90.0,1,90,0.0,90.0,90.0
135132002.0,17,6,1146,6,1146,27026400.4,191.0,191.0,0,0,0.0,0.0,0.0
106832.0,17,2,700,2,700,0.0,350.0,350.0,0,0,0.0,0.0,0.0
1168977.0,6,13,3010,8,2382,166996.7142857143,1514.0,297.75,5,628,223442.0,331.0,125.6
38597.0,6,13,1479,7,882,6432.833333333333,291.0,126.0,6,597,6668.2,259.0,99.5
242322.0,17,2,180,1,90,0.0,90.0,90.0,1,90,0.0,90.0,90.0
159990.0,6,2,128,1,74,0.0,74.0,74.0,1,54,0.0,54.0,54.0
135121608.0,17,6,1146,6,1146,27024321.6,191.0,191.0,0,0,0.0,0.0,0.0
127391.0,6,2,132,1,66,0.0,66.0,66.0,1,66,0.0,66.0,66.0
156559.0,6,3,337,2,214,0.0,160.0,107.0,1,123,0.0,123.0,123.0
821298.0,6,10,1221,6,636,164259.6,298.0,106.0,4,585,272928.6666666667,379.0,146.25
9059.0,17,2,582,1,83,0.0,83.0,83.0,1,499,0.0,499.0,499.0
108109407.0,17,5,1005,5,1005,27027351.75,201.0,201.0,0,0,0.0,0.0,0.0
209533.0,17,2,180,1,90,0.0,90.0,90.0,1,90,0.0,90.0,90.0
38618.0,6,10,2032,5,524,9021.25,252.0,104.8,5,1508,8686.75,1236.0,301.6
137007983.0,17,15,907,8,475,19572569.0,174.0,59.375,7,432,19500188.166666668,174.0,61.71428571428572
37065.0,6,14,4740,7,653,6043.166666666667,249.0,93.28571428571428,7,4087,5859.833333333333,1514.0,583.8571428571429
120049254.0,17,28,13364,28,13364,4446268.666666667,501.0,477.2857142857143,0,0,0.0,0.0,0.0
119510573.0,6,293,35298,147,9924,818565.5684931506,140.0,67.51020408163265,146,25374,817101.2965517241,284.0,173.7945205479452
16696.0,6,14,4740,7,653,2313.1666666666665,249.0,93.28571428571428,7,4087,2645.1666666666665,1514.0,583.8571428571429
197026.0,17,2,180,1,90,0.0,90.0,90.0,1,90,0.0,90.0,90.0
41799.0,6,14,4740,7,653,6511.166666666667,249.0,93.28571428571428,7,4087,6506.0,1514.0,583.8571428571429
325.0,17,2,160,1,80,0.0,80.0,80.0,1,80,0.0,80.0,80.0
130661.0,6,3,337,2,214,0.0,160.0,107.0,1,123,0.0,123.0,123.0
40056.0,6,14,4740,7,653,6552.5,249.0,93.28571428571428,7,4087,6256.666666666667,1514.0,583.8571428571429
33785.0,6,14,4740,7,653,5476.166666666667,249.0,93.28571428571428,7,4087,5233.833333333333,1514.0,583.8571428571429
812.0,17,4,438,2,148,0.0,74.0,74.0,2,290,0.0,147.0,145.0
29476.0,6,14,4740,7,653,4791.833333333333,249.0,93.28571428571428,7,4087,4551.5,1514.0,583.8571428571429
14638324.0,6,19,1553,9,921,1792165.125,315.0,102.33333333333331,10,632,1592059.888888889,78.0,63.2
34763.0,6,10,2032,5,524,8464.75,252.0,104.8,5,1508,7843.5,1236.0,301.6
123005853.0,17,15,907,8,475,17572264.714285713,174.0,59.375,7,432,17166881.0,174.0,61.71428571428572
24918955.0,6,13,928,7,491,4153159.1666666665,95.0,70.14285714285714,6,437,4941761.4,95.0,72.83333333333333
58659.0,6,14,4740,7,653,9317.333333333334,249.0,93.28571428571428,7,4087,7687.0,1514.0,583.8571428571429
196988.0,17,2,180,1,90,0.0,90.0,90.0,1,90,0.0,90.0,90.0
330.0,17,2,166,1,75,0.0,75.0,75.0,1,91,0.0,91.0,91.0
2364.0,17,4,344,2,150,0.0,75.0,75.0,2,194,0.0,103.0,97.0
120046788.0,17,29,13785,29,13785,4287385.285714285,501.0,475.3448275862069,0,0,0.0,0.0,0.0
120057894.0,17,28,13364,28,13364,4446588.666666667,501.0,477.2857142857143,0,0,0.0,0.0,0.0
120413755.0,6,231,26166,116,18354,1047076.1304347826,284.0,158.22413793103448,115,7812,1047214.596491228,140.0,67.9304347826087
0.0,6,1,54,0,0,0.0,0.0,0.0,1,54,0.0,54.0,54.0
8671246.0,17,3,1034,2,684,0.0,342.0,342.0,1,350,0.0,350.0,350.0
230183.0,17,2,180,1,90,0.0,90.0,90.0,1,90,0.0,90.0,90.0
220637.0,6,10,1221,6,636,44127.4,298.0,106.0,4,585,72710.66666666667,379.0,146.25
5624629.0,6,5,336,2,134,0.0,68.0,67.0,3,202,1420664.5,70.0,67.33333333333333
280930.0,17,2,414,1,88,0.0,88.0,88.0,1,326,0.0,326.0,326.0
29890.0,6,12,1320,6,723,5765.8,253.0,120.5,6,597,5440.8,259.0,99.5
2235.0,17,2,691,1,349,0.0,349.0,349.0,1,342,0.0,342.0,342.0
30138.0,6,14,4740,7,653,4870.666666666667,249.0,93.28571428571428,7,4087,4860.0,1514.0,583.8571428571429
2284.0,17,4,344,2,150,0.0,75.0,75.0,2,194,0.0,103.0,97.0
135127848.0,17,6,1206,6,1206,27025569.6,201.0,201.0,0,0,0.0,0.0,0.0
90047832.0,17,28,13364,28,13364,3335104.888888889,501.0,477.2857142857143,0,0,0.0,0.0,0.0
57132.0,6,10,2032,5,524,13683.5,252.0,104.8,5,1508,13692.0,1236.0,301.6
47605190.0,6,8,2113,3,960,22616921.5,826.0,320.0,5,1153,11205708.0,885.0,230.6
35057.0,6,14,4740,7,653,5325.0,249.0,93.28571428571428,7,4087,5701.5,1514.0,583.8571428571429
2026.0,17,4,344,2,150,0.0,75.0,75.0,2,194,0.0,103.0,97.0
30684.0,6,14,4740,7,653,4895.166666666667,249.0,93.28571428571428,7,4087,4838.333333333333,1514.0,583.8571428571429
108106703.0,17,5,955,5,955,27026675.75,191.0,191.0,0,0,0.0,0.0,0.0
39020.0,6,10,2032,5,524,9161.75,252.0,104.8,5,1508,7515.25,1236.0,301.6
2471.0,17,4,344,2,150,0.0,75.0,75.0,2,194,0.0,103.0,97.0
60692.0,6,14,4740,7,653,10006.5,249.0,93.28571428571428,7,4087,9233.0,1514.0,583.8571428571429
135125472.0,17,6,1206,6,1206,27025094.4,201.0,201.0,0,0,0.0,0.0,0.0
59119.0,6,14,4740,7,653,8869.833333333334,249.0,93.28571428571428,7,4087,8639.333333333334,1514.0,583.8571428571429
120128887.0,6,12,1832,8,1016,17137788.85714286,188.0,127.0,4,816,30033508.0,204.0,204.0
37150.0,6,2,145,2,145,0.0,91.0,72.5,0,0,0.0,0.0,0.0
112089445.0,6,36,2596,18,1348,6580798.705882353,139.0,74.88888888888889,18,1248,6580796.882352941,123.0,69.33333333333333
120574547.0,6,204,22980,102,6954,1185707.2475247525,140.0,68.17647058823529,102,16026,1185815.2673267326,284.0,157.11764705882354
236694.0,6,3,337,2,214,0.0,160.0,107.0,1,123,0.0,123.0,123.0
52588.0,6,14,4740,7,653,8490.333333333334,249.0,93.28571428571428,7,4087,7877.0,1514.0,583.8571428571429
90019260.0,17,28,13364,28,13364,3334046.6666666665,501.0,477.2857142857143,0,0,0.0,0.0,0.0
872529.0,6,10,1335,6,798,174505.8,460.0,133.0,4,537,198998.3333333333,331.0,134.25
958737.0,6,4,492,2,280,0.0,214.0,140.0,2,212,0.0,146.0,106.0
108103618.0,17,5,1005,5,1005,27025904.5,201.0,201.0,0,0,0.0,0.0,0.0
3577222.0,6,5,336,2,134,0.0,68.0,67.0,3,202,1423941.0,70.0,67.33333333333333
3028580.0,6,11,1979,6,527,605013.8,233.0,87.83333333333333,5,1452,4972.25,1224.0,290.4
122304.0,6,3,373,2,238,0.0,172.0,119.0,1,135,0.0,135.0,135.0
304897.0,6,6,412,4,272,101632.33333333331,74.0,68.0,2,140,0.0,74.0,70.0
90256286.0,6,12,1832,8,1016,12893755.142857144,188.0,127.0,4,816,30030598.0,204.0,204.0
90289626.0,6,16,1192,8,596,12892586.857142856,95.0,74.5,8,596,12897190.285714284,95.0,74.5
108100887.0,17,5,955,5,955,27025221.75,191.0,191.0,0,0,0.0,0.0,0.0
367.0,17,2,204,1,88,0.0,88.0,88.0,1,116,0.0,116.0,116.0
31587.0,6,10,2032,5,524,6070.0,252.0,104.8,5,1508,7641.25,1236.0,301.6
153584.0,17,2,180,1,90,0.0,90.0,90.0,1,90,0.0,90.0,90.0
16829.0,6,10,2032,5,524,3989.75,252.0,104.8,5,1508,3965.0,1236.0,301.6
146823.0,17,4,704,2,148,0.0,74.0,74.0,2,556,0.0,280.0,278.0
97000768.0,17,12,778,6,389,19400153.6,174.0,64.83333333333333,6,389,19201283.4,174.0,64.83333333333333
498400.0,6,5,336,2,134,0.0,68.0,67.0,3,202,184615.5,70.0,67.33333333333333
20981933.0,17,3,1034,2,684,0.0,342.0,342.0,1,350,0.0,350.0,350.0
2400.0,17,4,344,2,150,0.0,75.0,75.0,2,194,0.0,103.0,97.0
135135105.0,17,6,1206,6,1206,27027021.0,201.0,201.0,0,0,0.0,0.0,0.0
90027880.0,17,28,13364,28,13364,3334365.925925926,501.0,477.2857142857143,0,0,0.0,0.0,0.0
14630618.0,6,19,1635,9,1003,1791316.875,315.0,111.44444444444444,10,632,1592250.5555555555,78.0,63.2
49447.0,6,10,2032,5,524,12134.0,252.0,104.8,5,1508,11712.0,1236.0,301.6
90285796.0,6,19,1436,10,745,10026252.888888888,95.0,74.5,9,691,11285014.375,95.0,76.77777777777777
36593.0,6,14,4740,7,653,5794.5,249.0,93.28571428571428,7,4087,5953.166666666667,1514.0,583.8571428571429
153463.0,17,2,180,1,90,0.0,90.0,90.0,1,90,0.0,90.0,90.0
98132150.0,6,172,19428,86,13530,1151964.1411764706,284.0,157.32558139534885,86,5898,1151963.870588235,140.0,68.5813953488372
90529919.0,6,13,2036,8,1016,12932845.57142857,188.0,127.0,5,1020,22587616.75,204.0,204.0
24992.0,6,14,4740,7,653,3249.5,249.0,93.28571428571428,7,4087,4029.6666666666665,1514.0,583.8571428571429
106773.0,17,2,700,2,700,0.0,350.0,350.0,0,0,0.0,0.0,0.0
249738.0,17,4,6056,4,6056,83246.0,1514.0,1514.0,0,0,0.0,0.0,0.0
5005539.0,17,4,534,2,166,0.0,83.0,83.0,2,368,0.0,184.0,184.0
302415.0,6,2,132,1,66,0.0,66.0,66.0,1,66,0.0,66.0,66.0
1983.0,17,4,344,2,150,0.0,75.0,75.0,2,194,0.0,103.0,97.0
238128.0,6,3,373,2,238,0.0,172.0,119.0,1,135,0.0,135.0,135.0
246599.0,6,3,373,2,238,0.0,172.0,119.0,1,135,0.0,135.0,135.0
29781.0,6,10,2032,5,524,7120.25,252.0,104.8,5,1508,6734.25,1236.0,301.6
108104586.0,17,5,955,5,955,27026146.5,191.0,191.0,0,0,0.0,0.0,0.0
0.0,17,1,350,1,350,0.0,350.0,350.0,0,0,0.0,0.0,0.0
147784.0,6,2,132,1,66,0.0,66.0,66.0,1,66,0.0,66.0,66.0
307893.0,6,6,412,4,272,102631.0,74.0,68.0,2,140,0.0,74.0,70.0
905.0,17,4,438,2,148,0.0,74.0,74.0,2,290,0.0,147.0,145.0
108107306.0,17,5,1005,5,1005,27026826.5,201.0,201.0,0,0,0.0,0.0,0.0
49695.0,6,14,4740,7,653,8134.333333333333,249.0,93.28571428571428,7,4087,7787.833333333333,1514.0,583.8571428571429
102383053.0,6,31,2298,16,1212,6811134.733333333,123.0,75.75,15,1086,7297646.357142857,123.0,72.4
108102083.0,17,5,1005,5,1005,27025520.75,201.0,201.0,0,0,0.0,0.0,0.0
120128530.0,6,32,2242,17,1225,7508033.125,139.0,72.05882352941177,15,1017,7851923.785714285,123.0,67.8
146219.0,6,3,337,2,214,0.0,160.0,107.0,1,123,0.0,123.0,123.0
90256208.0,6,12,1832,8,1016,12893744.0,188.0,127.0,4,816,30031202.33333333,204.0,204.0
505029.0,6,5,336,2,134,0.0,68.0,67.0,3,202,195025.0,70.0,67.33333333333333
37636.0,6,12,1320,6,723,6662.8,253.0,120.5,6,597,7338.6,259.0,99.5
33283.0,6,10,2032,5,524,7989.0,252.0,104.8,5,1508,8057.25,1236.0,301.6
5832398.0,6,5,336,2,134,0.0,68.0,67.0,3,202,1526752.5,70.0,67.33333333333333
120332026.0,6,233,26244,117,18366,1037345.051724138,284.0,156.97435897435898,116,7878,1037295.9217391304,140.0,67.91379310344827
37741.0,6,14,4740,7,653,6089.166666666667,249.0,93.28571428571428,7,4087,6101.166666666667,1514.0,583.8571428571429
17252.0,6,11,1132,6,556,2810.8,218.0,92.66666666666669,5,576,3758.75,304.0,115.2
90257937.0,6,12,1832,8,1016,12893991.0,188.0,127.0,4,816,30030547.33333333,204.0,204.0
90289033.0,6,18,1461,9,650,11280124.625,95.0,72.22222222222223,9,811,11284977.375,215.0,90.11111111111111
2149733.0,6,37,15535,19,10912,119429.61111111112,1514.0,574.3157894736842,18,4623,113072.29411764706,1514.0,256.8333333333333
40016.0,6,14,4740,7,653,5246.166666666667,249.0,93.28571428571428,7,4087,6419.666666666667,1514.0,583.8571428571429
2490.0,17,4,344,2,150,0.0,75.0,75.0,2,194,0.0,103.0,97.0
22193.0,6,10,2032,5,524,4945.0,252.0,104.8,5,1508,4409.25,1236.0,301.6
323059.0,17,4,1400,4,1400,107686.33333333331,350.0,350.0,0,0,0.0,0.0,0.0
2054.0,17,4,344,2,150,0.0,75.0,75.0,2,194,0.0,103.0,97.0
144408.0,17,4,704,2,148,0.0,74.0,74.0,2,556,0.0,280.0,278.0
233968.0,6,3,337,2,214,0.0,160.0,107.0,1,123,0.0,123.0,123.0
103564.0,17,2,286,2,286,0.0,143.0,143.0,0,0,0.0,0.0,0.0
125033850.0,6,31,2034,16,1086,8335590.0,123.0,67.875,15,948,8202260.928571428,123.0,63.2
115697185.0,6,48,3168,24,1584,5030312.391304348,66.0,66.0,24,1584,5017045.478260869,66.0,66.0
90776378.0,6,18,1382,10,786,10081498.222222222,95.0,78.6,8,596,12900509.42857143,95.0,74.5
39820.0,6,14,4740,7,653,5690.0,249.0,93.28571428571428,7,4087,5661.5,1514.0,583.8571428571429
16049.999999999998,6,10,1067,5,536,3000.0,264.0,107.2,5,531,3131.25,259.0,106.2
91877.0,6,12,1328,7,797,15312.833333333334,253.0,113.85714285714286,5,531,20142.25,259.0,106.2
550.0,17,2,508,2,508,0.0,257.0,254.0,0,0,0.0,0.0,0.0
42333.0,6,14,4740,7,653,5658.5,249.0,93.28571428571428,7,4087,6556.5,1514.0,583.8571428571429
19553.0,6,2,145,2,145,0.0,91.0,72.5,0,0,0.0,0.0,0.0
10432388.0,6,7,478,4,272,3431913.333333333,74.0,68.0,3,206,5147776.0,74.0,68.66666666666667
108102049.0,17,5,955,5,955,27025512.25,191.0,191.0,0,0,0.0,0.0,0.0
95683620.0,6,178,20094,89,6096,1077982.5,140.0,68.49438202247191,89,13998,1066315.3977272727,284.0,157.2808988764045
10921759.0,6,8,544,4,272,3594228.333333333,74.0,68.0,4,272,3594127.333333333,74.0,68.0
103454.0,17,2,286,2,286,0.0,143.0,143.0,0,0,0.0,0.0,0.0
120010079.0,6,16,1192,8,596,17144297.0,95.0,74.5,8,596,17104834.714285713,95.0,74.5
135927.0,6,2,132,1,66,0.0,66.0,66.0,1,66,0.0,66.0,66.0
2801954.0,6,2,132,1,66,0.0,66.0,66.0,1,66,0.0,66.0,66.0
158367.0,6,3,337,2,214,0.0,160.0,107.0,1,123,0.0,123.0,123.0
798334.0,6,6,758,3,410,390935.0,172.0,136.66666666666666,3,348,276659.5,135.0,116.0
92435.0,17,2,762,2,762,0.0,381.0,381.0,0,0,0.0,0.0,0.0
102632635.0,17,14,1126,7,563,17000160.666666668,174.0,80.42857142857143,7,563,17000775.333333332,174.0,80.42857142857143
1455983.0,6,20,7599,11,1469,145598.3,583.0,133.54545454545453,9,6130,149897.0,1484.0,681.1111111111111
16906.0,17,2,180,1,90,0.0,90.0,90.0,1,90,0.0,90.0,90.0
103009426.0,17,13,821,7,432,17168237.666666668,174.0,61.71428571428572,6,389,16600158.2,174.0,64.83333333333333
243887.0,6,3,426,2,280,0.0,214.0,140.0,1,146,0.0,146.0,146.0
79495.0,6,14,4740,7,653,12161.833333333334,249.0,93.28571428571428,7,4087,12485.5,1514.0,583.8571428571429
25179.0,6,14,4740,7,653,3964.0,249.0,93.28571428571428,7,4087,3862.1666666666665,1514.0,583.8571428571429
146200.0,6,3,337,2,214,0.0,160.0,107.0,1,123,0.0,123.0,123.0
347.0,17,2,174,1,79,0.0,79.0,79.0,1,95,0.0,95.0,95.0
1302456.0,6,4,264,2,132,0.0,66.0,66.0,2,132,0.0,66.0,66.0
47773.0,6,14,4740,7,653,7594.166666666667,249.0,93.28571428571428,7,4087,7505.0,1514.0,583.8571428571429
119386960.0,6,47,3102,24,1584,5177079.565217392,66.0,66.0,23,1518,5155439.818181818,66.0,66.0
275644.0,6,12,1373,7,714,45940.66666666666,298.0,102.0,5,659,68025.0,379.0,131.8
108081.0,17,4,1400,4,1400,36027.0,350.0,350.0,0,0,0.0,0.0,0.0
50753.0,17,2,180,1,90,0.0,90.0,90.0,1,90,0.0,90.0,90.0
12926302.0,6,20,1607,10,975,1399460.111111111,315.0,97.5,10,632,1399975.2222222222,78.0,63.2
46229.0,6,14,4740,7,653,7253.5,249.0,93.28571428571428,7,4087,6311.666666666667,1514.0,583.8571428571429
86812.0,6,2,134,1,68,0.0,68.0,68.0,1,66,0.0,66.0,66.0
241136.0,6,3,337,2,214,0.0,160.0,107.0,1,123,0.0,123.0,123.0
92754999.0,6,39,2574,20,1320,4881828.7894736845,66.0,66.0,19,1254,5112000.555555556,66.0,66.0
218090.0,6,3,426,2,280,0.0,214.0,140.0,1,146,0.0,146.0,146.0
90256056.0,6,12,1832,8,1016,12893722.285714284,188.0,127.0,4,816,30031111.33333333,204.0,204.0
104850.0,17,2,286,2,286,0.0,143.0,143.0,0,0,0.0,0.0,0.0
90048392.0,17,28,13364,28,13364,3335125.6296296297,501.0,477.2857142857143,0,0,0.0,0.0,0.0
45955.0,6,10,2032,5,524,7839.5,252.0,104.8,5,1508,11141.5,1236.0,301.6
27822.0,6,14,4740,7,653,4157.333333333333,249.0,93.28571428571428,7,4087,4075.1666666666665,1514.0,583.8571428571429
35488.0,6,14,4740,7,653,5795.333333333333,249.0,93.28571428571428,7,4087,4872.833333333333,1514.0,583.8571428571429
50892.0,6,2,132,1,66,0.0,66.0,66.0,1,66,0.0,66.0,66.0
52883.0,6,14,4740,7,653,8513.5,249.0,93.28571428571428,7,4087,8349.5,1514.0,583.8571428571429
14981.0,17,2,180,1,90,0.0,90.0,90.0,1,90,0.0,90.0,90.0
59186.0,6,10,2032,5,524,14546.25,252.0,104.8,5,1508,14102.0,1236.0,301.6
10314014.0,6,5,330,3,198,5157007.0,66.0,66.0,2,132,0.0,66.0,66.0
15878.0,6,11,2098,6,590,3098.0,252.0,98.33333333333331,5,1508,3651.75,1236.0,301.6
135131762.0,17,6,1206,6,1206,27026352.4,201.0,201.0,0,0,0.0,0.0,0.0
22431868.0,6,5,1736,2,819,0.0,753.0,409.5,3,917,11152578.0,785.0,305.6666666666667
151.0,17,2,3028,2,3028,0.0,1514.0,1514.0,0,0,0.0,0.0,0.0
2079941.0,6,18,6803,10,1501,231104.5555555556,408.0,150.1,8,5302,235265.2857142857,1514.0,662.75
363.0,17,2,267,1,83,0.0,83.0,83.0,1,184,0.0,184.0,184.0
103000904.0,17,13,1083,7,563,17166817.333333332,174.0,80.42857142857143,6,520,16600581.4,174.0,86.66666666666667
233897.0,6,3,337,2,214,0.0,160.0,107.0,1,123,0.0,123.0,123.0
211529.0,6,10,1221,6,636,42305.8,298.0,106.0,4,585,69504.66666666667,379.0,146.25
1310087.0,6,4,264,2,132,0.0,66.0,66.0,2,132,0.0,66.0,66.0
2072.0,17,4,344,2,150,0.0,75.0,75.0,2,194,0.0,103.0,97.0
25163.0,6,10,2032,5,524,4917.5,252.0,104.8,5,1508,5702.5,1236.0,301.6
90773924.0,6,19,1436,10,745,10080733.111111112,95.0,74.5,9,691,11345590.625,95.0,76.77777777777777
299436.0,6,6,412,4,272,99812.0,74.0,68.0,2,140,0.0,74.0,70.0
146224.0,6,2,132,1,66,0.0,66.0,66.0,1,66,0.0,66.0,66.0
205831.0,17,2,180,1,90,0.0,90.0,90.0,1,90,0.0,90.0,90.0
57579.0,6,10,2032,5,524,14016.25,252.0,104.8,5,1508,11759.0,1236.0,301.6
13635408.0,6,5,1736,2,819,0.0,753.0,409.5,3,917,6749552.5,785.0,305.6666666666667
128030478.0,6,33,2280,17,1209,8001904.875,123.0,71.11764705882354,16,1071,7855250.133333334,123.0,66.9375
153376.0,17,2,180,1,90,0.0,90.0,90.0,1,90,0.0,90.0,90.0
185583.0,17,2,180,1,90,0.0,90.0,90.0,1,90,0.0,90.0,90.0
2005.0,17,4,344,2,150,0.0,75.0,75.0,2,194,0.0,103.0,97.0
216815.0,6,3,426,2,280,0.0,214.0,140.0,1,146,0.0,146.0,146.0
123610503.0,6,49,3234,25,1650,5150437.625,66.0,66.0,24,1584,5023439.956521739,66.0,66.0
22181.0,6,10,2032,5,524,4369.0,252.0,104.8,5,1508,4990.25,1236.0,301.6
22143.0,6,14,4740,7,653,3205.333333333333,249.0,93.28571428571428,7,4087,3501.333333333333,1514.0,583.8571428571429
159975.0,6,2,128,1,74,0.0,74.0,74.0,1,54,0.0,54.0,54.0
309824.0,17,4,1400,4,1400,103274.66666666669,350.0,350.0,0,0,0.0,0.0,0.0
2576975.0,6,2,132,1,66,0.0,66.0,66.0,1,66,0.0,66.0,66.0
108106794.0,17,5,955,5,955,27026698.5,191.0,191.0,0,0,0.0,0.0,0.0
90258697.0,6,14,2102,8,1016,12894099.57142857,188.0,127.0,6,1086,18019317.0,204.0,181.0
218678.0,6,10,1221,6,636,43735.6,298.0,106.0,4,585,71553.0,379.0,146.25
90057969.0,17,28,13364,28,13364,3335480.333333333,501.0,477.2857142857143,0,0,0.0,0.0,0.0
5626863.0,6,5,336,2,134,0.0,68.0,67.0,3,202,1523861.0,70.0,67.33333333333333
120239181.0,6,248,28516,124,8480,970848.1463414634,140.0,68.38709677419355,124,20036,970999.699186992,284.0,161.5806451612903
111986348.0,6,30,1990,15,1042,7983596.0,139.0,69.46666666666667,15,948,7983578.214285715,123.0,63.2
90020829.0,17,28,13364,28,13364,3334104.777777778,501.0,477.2857142857143,0,0,0.0,0.0,0.0
135134403.0,17,6,1146,6,1146,27026880.6,191.0,191.0,0,0,0.0,0.0,0.0
2119282.0,6,22,7413,11,2384,211928.2,1034.0,216.72727272727272,11,5029,180826.5,1510.0,457.1818181818182
239365.0,6,3,337,2,214,0.0,160.0,107.0,1,123,0.0,123.0,123.0
26014.0,6,10,2032,5,524,5878.5,252.0,104.8,5,1508,6153.5,1236.0,301.6
141937.0,17,4,820,2,156,0.0,78.0,78.0,2,664,0.0,332.0,332.0
105619818.0,6,43,2838,21,1386,5159996.55,66.0,66.0,22,1452,5029493.761904762,66.0,66.0
8262.0,6,11,2098,6,590,1588.0,252.0,98.33333333333331,5,1508,1749.25,1236.0,301.6
102308.0,17,2,286,2,286,0.0,143.0,143.0,0,0,0.0,0.0,0.0
153486.0,17,2,180,1,90,0.0,90.0,90.0,1,90,0.0,90.0,90.0
0.0,17,1,55,1,55,0.0,55.0,55.0,0,0,0.0,0.0,0.0
147551.0,6,3,337,2,214,0.0,160.0,107.0,1,123,0.0,123.0,123.0
319684.0,6,6,412,4,272,106561.33333333331,74.0,68.0,2,140,0.0,74.0,70.0
90303921.0,6,19,1436,10,745,10028434.333333334,95.0,74.5,9,691,11286834.125,95.0,76.77777777777777
120244771.0,6,18,1341,9,691,14999398.375,95.0,76.77777777777777,9,650,14998753.75,95.0,72.22222222222223
366186.0,6,3,204,2,136,0.0,70.0,68.0,1,68,0.0,68.0,68.0
108104742.0,17,5,955,5,955,27026185.5,191.0,191.0,0,0,0.0,0.0,0.0
114140566.0,17,14,864,7,432,19000810.666666668,174.0,61.71428571428572,7,432,19000110.5,174.0,61.71428571428572
143997.0,17,2,180,1,90,0.0,90.0,90.0,1,90,0.0,90.0,90.0
90289508.0,6,19,1436,10,745,10026809.222222222,95.0,74.5,9,691,11285645.375,95.0,76.77777777777777
220190.0,6,3,426,2,280,0.0,214.0,140.0,1,146,0.0,146.0,146.0
43561.0,6,14,4740,7,653,6795.5,249.0,93.28571428571428,7,4087,6110.666666666667,1514.0,583.8571428571429
80784.0,6,14,4740,7,653,11331.833333333334,249.0,93.28571428571428,7,4087,12511.666666666666,1514.0,583.8571428571429
312494.0,17,4,1400,4,1400,104164.66666666669,350.0,350.0,0,0,0.0,0.0,0.0
102717634.0,17,14,1126,7,563,17001438.833333332,174.0,80.42857142857143,7,563,17000159.333333332,174.0,80.42857142857143
70518.0,6,14,4740,7,653,11216.833333333334,249.0,93.28571428571428,7,4087,11426.333333333334,1514.0,583.8571428571429
0.0,17,1,55,1,55,0.0,55.0,55.0,0,0,0.0,0.0,0.0
103435.0,17,2,286,2,286,0.0,143.0,143.0,0,0,0.0,0.0,0.0
236057.0,17,2,180,1,90,0.0,90.0,90.0,1,90,0.0,90.0,90.0
108095249.0,17,5,1005,5,1005,27023812.25,201.0,201.0,0,0,0.0,0.0,0.0
30899.0,6,14,4740,7,653,4946.166666666667,249.0,93.28571428571428,7,4087,5009.0,1514.0,583.8571428571429
105387.0,17,2,700,2,700,0.0,350.0,350.0,0,0,0.0,0.0,0.0
52389.0,6,14,4740,7,653,8511.333333333334,249.0,93.28571428571428,7,4087,8513.0,1514.0,583.8571428571429
47052.0,6,12,1328,7,797,7842.0,253.0,113.85714285714286,5,531,9629.0,259.0,106.2
232882.0,6,3,337,2,214,0.0,160.0,107.0,1,123,0.0,123.0,123.0
57937.0,6,20,7606,11,978,5793.7,310.0,88.9090909090909,9,6628,6774.0,1514.0,736.4444444444445
56116.0,6,14,4740,7,653,8287.0,249.0,93.28571428571428,7,4087,9094.666666666666,1514.0,583.8571428571429
120088737.0,6,12,1832,8,1016,17132730.714285713,188.0,127.0,4,816,30031153.33333333,204.0,204.0
241728.0,6,3,337,2,214,0.0,160.0,107.0,1,123,0.0,123.0,123.0
232994.0,6,3,337,2,214,0.0,160.0,107.0,1,123,0.0,123.0,123.0
32013.0,6,10,2032,5,524,7738.5,252.0,104.8,5,1508,6462.5,1236.0,301.6
10859862.0,6,8,544,4,272,3574786.6666666665,74.0,68.0,4,272,3574706.0,74.0,68.0
326800.0,6,6,412,4,272,108933.33333333331,74.0,68.0,2,140,0.0,74.0,70.0
2591670.0,6,2,132,1,66,0.0,66.0,66.0,1,66,0.0,66.0,66.0
232983.0,6,3,337,2,214,0.0,160.0,107.0,1,123,0.0,123.0,123.0
119781001.0,6,216,24440,108,17016,1117436.476635514,284.0,157.55555555555554,108,7424,1117437.906542056,140.0,68.74074074074075
133528930.0,17,15,1169,8,606,19075561.42857143,174.0,75.75,7,563,19016644.0,174.0,80.42857142857143
90013848.0,17,28,13364,28,13364,3333846.222222222,501.0,477.2857142857143,0,0,0.0,0.0,0.0
153470.0,17,2,180,1,90,0.0,90.0,90.0,1,90,0.0,90.0,90.0
99739567.0,6,24,1638,13,906,8311630.583333333,123.0,69.6923076923077,11,732,8953041.8,123.0,66.54545454545455
15467.0,6,14,4740,7,653,2260.1666666666665,249.0,93.28571428571428,7,4087,2355.1666666666665,1514.0,583.8571428571429
2019.0,17,4,344,2,150,0.0,75.0,75.0,2,194,0.0,103.0,97.0
205759.0,17,2,180,1,90,0.0,90.0,90.0,1,90,0.0,90.0,90.0
37121.0,6,10,2032,5,524,9048.5,252.0,104.8,5,1508,8673.75,1236.0,301.6
35979.0,6,14,4740,7,653,5748.333333333333,249.0,93.28571428571428,7,4087,4608.833333333333,1514.0,583.8571428571429
26285261.0,17,3,1034,2,684,0.0,342.0,342.0,1,350,0.0,350.0,350.0
1299758.0,6,4,264,2,132,0.0,66.0,66.0,2,132,0.0,66.0,66.0
7064.0,17,4,823,2,163,0.0,89.0,81.5,2,660,0.0,443.0,330.0
107456.0,17,2,286,2,286,0.0,143.0,143.0,0,0,0.0,0.0,0.0
0.0,17,1,179,1,179,0.0,179.0,179.0,0,0,0.0,0.0,0.0
90999.0,6,12,1328,7,797,15166.5,253.0,113.85714285714286,5,531,19967.25,259.0,106.2
93153335.0,6,176,19932,88,13890,1068255.3563218392,300.0,157.8409090909091,88,6042,1068255.3218390804,140.0,68.6590909090909
312499.0,17,4,704,2,148,0.0,74.0,74.0,2,556,0.0,280.0,278.0
120311605.0,6,216,24424,108,7424,1116782.429906542,140.0,68.74074074074075,108,17000,1116848.9719626168,284.0,157.40740740740742
2297.0,17,4,344,2,150,0.0,75.0,75.0,2,194,0.0,103.0,97.0
115726154.0,17,16,1212,8,606,16429384.857142856,174.0,75.75,8,606,16428713.0,174.0,75.75
201818.0,17,2,180,1,90,0.0,90.0,90.0,1,90,0.0,90.0,90.0
43678.0,6,10,2032,5,524,10703.75,252.0,104.8,5,1508,10171.75,1236.0,301.6
115036009.0,17,14,864,7,432,19168490.33333333,174.0,61.71428571428572,7,432,19166828.33333333,174.0,61.71428571428572
284667.0,17,2,363,1,79,0.0,79.0,79.0,1,284,0.0,284.0,284.0
113255597.0,6,46,3036,23,1518,5135439.090909091,66.0,66.0,23,1518,5135469.636363637,66.0,66.0
58707.0,6,10,2032,5,524,11856.5,252.0,104.8,5,1508,10840.25,1236.0,301.6
14208.0,6,11,1133,6,602,2514.4,264.0,100.33333333333331,5,531,2911.5,259.0,106.2
44024.0,6,10,2032,5,524,10784.0,252.0,104.8,5,1508,9075.5,1236.0,301.6
307304.0,6,6,412,4,272,102434.66666666669,74.0,68.0,2,140,0.0,74.0,70.0
1163133.0,6,13,3011,8,2383,166161.85714285713,1514.0,297.875,5,628,222632.0,331.0,125.6
70521.0,17,2,634,1,82,0.0,82.0,82.0,1,552,0.0,552.0,552.0
43379.0,6,10,2032,5,524,10532.0,252.0,104.8,5,1508,7845.0,1236.0,301.6
171580.0,17,2,180,1,90,0.0,90.0,90.0,1,90,0.0,90.0,90.0
2264.0,17,4,344,2,150,0.0,75.0,75.0,2,194,0.0,103.0,97.0
90522521.0,6,14,2240,8,1016,12931788.714285716,188.0,127.0,6,1224,18071574.6,204.0,204.0
135128365.0,17,6,1146,6,1146,27025673.0,191.0,191.0,0,0,0.0,0.0,0.0
108112421.0,17,5,955,5,955,27028105.25,191.0,191.0,0,0,0.0,0.0,0.0
106582646.0,6,43,2838,22,1452,5075351.857142857,66.0,66.0,21,1386,5151998.45,66.0,66.0
90289937.0,6,16,1192,8,596,12892351.285714284,95.0,74.5,8,596,12896191.857142856,95.0,74.5
64448.00000000001,6,14,4740,7,653,10281.333333333334,249.0,93.28571428571428,7,4087,10587.0,1514.0,583.8571428571429
870183.0,6,9,1270,6,799,174036.6,461.0,133.16666666666666,3,471,297262.0,331.0,157.0
25871.0,6,11,1132,6,556,5174.2,218.0,92.66666666666669,5,576,4871.0,304.0,115.2
43426.0,6,12,1413,7,882,7237.666666666667,291.0,126.0,5,531,8761.5,259.0,106.2
17086.0,17,2,180,1,90,0.0,90.0,90.0,1,90,0.0,90.0,90.0
16529.0,6,11,2098,6,590,2905.6,252.0,98.33333333333331,5,1508,3680.75,1236.0,301.6
92647138.0,6,30,2122,15,1105,6602238.5,139.0,73.66666666666667,15,1017,6602245.857142857,123.0,67.8
3291.0,17,2,224,1,76,0.0,76.0,76.0,1,148,0.0,148.0,148.0
108103910.0,17,5,1005,5,1005,27025977.5,201.0,201.0,0,0,0.0,0.0,0.0
39549.0,6,14,4740,7,653,6473.0,249.0,93.28571428571428,7,4087,6286.833333333333,1514.0,583.8571428571429
23064.0,6,14,4740,7,653,3453.1666666666665,249.0,93.28571428571428,7,4087,3436.5,1514.0,583.8571428571429
149511439.0,17,36,17126,36,17126,4271755.4,501.0,475.72222222222223,0,0,0.0,0.0,0.0
124795121.0,6,35,2410,18,1285,7340889.470588235,139.0,71.38888888888889,17,1125,7159997.25,123.0,66.17647058823529
90308615.0,6,21,1585,11,840,9026271.3,95.0,76.36363636363636,10,745,10002044.555555556,95.0,74.5
94586105.0,17,12,778,6,389,18917221.0,174.0,64.83333333333333,6,389,18835531.6,174.0,64.83333333333333
90300241.0,6,15,1097,8,596,12900034.42857143,95.0,74.5,7,501,15001489.5,95.0,71.57142857142857
311810.0,17,4,1400,4,1400,103936.66666666669,350.0,350.0,0,0,0.0,0.0,0.0
107362.0,17,2,286,2,286,0.0,143.0,143.0,0,0,0.0,0.0,0.0
169863.0,6,36,21262,19,1419,9436.833333333334,223.0,74.6842105263158,17,19843,10230.0625,1514.0,1167.235294117647
119962565.0,6,24,1788,12,894,10883663.636363637,95.0,74.5,12,894,10889996.272727272,95.0,74.5
112994695.0,6,30,1974,15,1026,8055627.5,123.0,68.4,15,948,8055629.285714285,123.0,63.2
90451074.0,6,17,1287,9,691,11300123.75,95.0,76.77777777777777,8,596,12786172.57142857,95.0,74.5
321099.0,17,4,1400,4,1400,107033.0,350.0,350.0,0,0,0.0,0.0,0.0
162528.0,17,4,1400,4,1400,54176.0,350.0,350.0,0,0,0.0,0.0,0.0
1576876.0,6,4,276,2,128,0.0,74.0,64.0,2,148,0.0,74.0,74.0
99483902.0,6,30,2106,15,1089,7105993.0,123.0,72.6,15,1017,7090553.928571428,123.0,67.8
0.0,17,1,438,1,438,0.0,438.0,438.0,0,0,0.0,0.0,0.0
226529.0,6,3,426,2,280,0.0,214.0,140.0,1,146,0.0,146.0,146.0
397130.0,17,2,180,1,90,0.0,90.0,90.0,1,90,0.0,90.0,90.0
65653901.00000001,17,12,8029,12,8029,5968536.454545454,892.0,669.0833333333334,0,0,0.0,0.0,0.0
146578.0,6,3,337,2,214,0.0,160.0,107.0,1,123,0.0,123.0,123.0
241938.0,6,3,373,2,238,0.0,172.0,119.0,1,135,0.0,135.0,135.0
108105141.0,17,5,1005,5,1005,27026285.25,201.0,201.0,0,0,0.0,0.0,0.0
21765.0,6,14,4740,7,653,3421.333333333333,249.0,93.28571428571428,7,4087,3484.333333333333,1514.0,583.8571428571429
19236.0,6,14,4740,7,653,2997.6666666666665,249.0,93.28571428571428,7,4087,2655.1666666666665,1514.0,583.8571428571429
269285.0,6,10,1221,6,636,53857.0,298.0,106.0,4,585,84367.66666666667,379.0,146.25
90915442.0,6,26,1978,15,1138,6490093.428571428,95.0,75.86666666666666,11,840,9067793.2,95.0,76.36363636363636
31243.0,6,20,7606,11,978,3124.3,310.0,88.9090909090909,9,6628,3372.375,1514.0,736.4444444444445
2942822.0,6,12,2172,7,664,490357.3333333333,252.0,94.85714285714286,5,1508,2309.0,1236.0,301.6
12167.0,6,11,1133,6,602,2433.4,264.0,100.33333333333331,5,531,2381.5,259.0,106.2
3177140.0,6,18,1536,9,962,358359.0,315.0,106.88888888888889,9,574,358335.75,78.0,63.77777777777778
590716.0,17,4,820,2,156,0.0,78.0,78.0,2,664,0.0,332.0,332.0
308282.0,6,6,412,4,272,102760.66666666669,74.0,68.0,2,140,0.0,74.0,70.0
20259.0,6,2,145,2,145,0.0,91.0,72.5,0,0,0.0,0.0,0.0
1166152.0,6,13,3000,8,2372,166593.14285714287,1514.0,296.5,5,628,222610.5,331.0,125.6
16900.0,17,2,180,1,90,0.0,90.0,90.0,1,90,0.0,90.0,90.0
434.0,17,2,508,2,508,0.0,257.0,254.0,0,0,0.0,0.0,0.0
115764880.0,6,34,2350,17,1225,7221785.4375,139.0,72.05882352941177,17,1125,7221780.0625,123.0,66.17647058823529
51085.0,6,14,4740,7,653,8352.166666666666,249.0,93.28571428571428,7,4087,8186.5,1514.0,583.8571428571429
124007400.0,17,15,907,8,475,17715342.85714286,174.0,59.375,7,432,17333527.5,174.0,61.71428571428572
667606.0,6,4,508,2,238,0.0,172.0,119.0,2,270,0.0,135.0,135.0
108109036.0,17,5,1005,5,1005,27027259.0,201.0,201.0,0,0,0.0,0.0,0.0
98987.0,17,2,762,2,762,0.0,381.0,381.0,0,0,0.0,0.0,0.0
249906.0,17,4,6056,4,6056,83302.0,1514.0,1514.0,0,0,0.0,0.0,0.0
43795.0,6,14,4740,7,653,6443.333333333333,249.0,93.28571428571428,7,4087,6918.333333333333,1514.0,583.8571428571429
107397.0,17,2,700,2,700,0.0,350.0,350.0,0,0,0.0,0.0,0.0
101434534.0,6,29,2062,15,1017,7245323.857142857,123.0,67.8,14,1045,7018026.153846154,139.0,74.64285714285714
127448936.0,6,22,1841,10,745,13186159.0,95.0,74.5,12,1096,11567645.909090908,256.0,91.33333333333331
2693918.0,6,2,132,1,66,0.0,66.0,66.0,1,66,0.0,66.0,66.0
47195.0,6,14,4740,7,653,7741.5,249.0,93.28571428571428,7,4087,7377.666666666667,1514.0,583.8571428571429
120000105.0,6,18,1341,10,745,13333345.0,95.0,74.5,8,596,17107190.57142857,95.0,74.5
158008.0,6,3,337,2,214,0.0,160.0,107.0,1,123,0.0,123.0,123.0
34949.0,6,14,4740,7,653,5477.5,249.0,93.28571428571428,7,4087,5317.333333333333,1514.0,583.8571428571429
120121481.0,6,14,2086,9,1204,15015185.125,188.0,133.77777777777777,5,882,22531351.0,204.0,176.4
2802218.0,6,2,132,1,66,0.0,66.0,66.0,1,66,0.0,66.0,66.0
36181.0,6,2,132,1,66,0.0,66.0,66.0,1,66,0.0,66.0,66.0
27608960.0,17,5,1710,5,1710,6902240.0,342.0,342.0,0,0,0.0,0.0,0.0
137941.0,6,2,132,1,66,0.0,66.0,66.0,1,66,0.0,66.0,66.0
114721.0,17,4,1400,4,1400,38240.333333333336,350.0,350.0,0,0,0.0,0.0,0.0
90285652.0,6,21,1585,11,840,9024260.2,95.0,76.36363636363636,10,745,10000382.222222222,95.0,74.5
226370.0,6,10,1221,6,636,45274.0,298.0,106.0,4,585,71022.0,379.0,146.25
303711.0,6,2,132,1,66,0.0,66.0,66.0,1,66,0.0,66.0,66.0
308393.0,6,6,412,4,272,102797.66666666669,74.0,68.0,2,140,0.0,74.0,70.0
122298365.0,6,33,2280,17,1209,7643647.8125,123.0,71.11764705882354,16,1071,7473152.733333333,123.0,66.9375
10486405.0,6,7,478,4,272,3450173.333333333,74.0,68.0,3,206,5175149.0,74.0,68.66666666666667
120404552.0,6,221,24986,111,17430,1094586.8363636364,284.0,157.02702702702703,110,7556,1096217.8440366972,140.0,68.69090909090909
14660328.0,6,20,1689,10,1057,1592923.111111111,315.0,105.7,10,632,1593212.5555555555,78.0,63.2
34796.0,6,14,4740,7,653,5670.5,249.0,93.28571428571428,7,4087,5499.833333333333,1514.0,583.8571428571429
117358487.0,6,41,3148,20,1494,6176762.47368421,123.0,74.7,21,1654,5357903.9,139.0,78.76190476190476
201762.0,17,2,180,1,90,0.0,90.0,90.0,1,90,0.0,90.0,90.0
107872.0,17,2,286,2,286,0.0,143.0,143.0,0,0,0.0,0.0,0.0
92811387.0,6,173,19668,87,13770,1079202.1744186047,374.0,158.27586206896552,86,5898,1079716.0235294118,140.0,68.5813953488372
2070.0,17,4,344,2,150,0.0,75.0,75.0,2,194,0.0,103.0,97.0
10461287.0,6,7,478,4,272,3441924.0,74.0,68.0,3,206,5162769.5,74.0,68.66666666666667
155961.0,6,3,337,2,214,0.0,160.0,107.0,1,123,0.0,123.0,123.0
301666.0,6,6,412,4,272,100555.33333333331,74.0,68.0,2,140,0.0,74.0,70.0
208584.0,6,3,426,2,280,0.0,214.0,140.0,1,146,0.0,146.0,146.0
24110.0,6,14,4740,7,653,3765.3333333333335,249.0,93.28571428571428,7,4087,3881.3333333333335,1514.0,583.8571428571429
318080.0,6,6,412,4,272,106026.66666666669,74.0,68.0,2,140,0.0,74.0,70.0
27115.0,6,10,2032,5,524,6543.5,252.0,104.8,5,1508,6525.0,1236.0,301.6
120256071.0,6,217,24612,109,17262,1113482.138888889,284.0,158.36697247706422,108,7350,1105719.401869159,140.0,68.05555555555556
59100774.0,17,9,3086,8,2736,5145478.714285715,342.0,342.0,1,350,0.0,350.0,350.0
120063588.0,17,29,13785,29,13785,4287985.285714285,501.0,475.3448275862069,0,0,0.0,0.0,0.0
910099.0,6,12,1354,6,723,180343.8,253.0,120.5,6,631,181544.4,293.0,105.16666666666669
105262415.0,6,43,2838,22,1452,5002216.952380952,66.0,66.0,21,1386,5105452.45,66.0,66.0
858609.0,6,11,2643,7,742,143101.5,338.0,106.0,4,1901,195303.66666666663,1514.0,475.25
144759.0,17,4,704,2,148,0.0,74.0,74.0,2,556,0.0,280.0,278.0
208251.0,6,10,1221,6,636,41650.2,298.0,106.0,4,585,68181.66666666667,379.0,146.25
2310.0,17,4,344,2,150,0.0,75.0,75.0,2,194,0.0,103.0,97.0
90259005.0,6,14,2240,8,1016,12894143.57142857,188.0,127.0,6,1224,18018771.2,204.0,204.0
3410429.0,6,7,923,4,753,1068346.0,571.0,188.25,3,170,1602386.5,62.0,56.66666666666666
506493.0,6,5,336,2,134,0.0,68.0,67.0,3,202,194575.0,70.0,67.33333333333333
35138.0,6,14,4740,7,653,5732.833333333333,249.0,93.28571428571428,7,4087,5464.0,1514.0,583.8571428571429
90085603.0,17,28,13364,28,13364,3336503.814814815,501.0,477.2857142857143,0,0,0.0,0.0,0.0
112535534.0,6,46,3036,23,1518,5105440.363636363,66.0,66.0,23,1518,5105443.045454546,66.0,66.0
122001218.0,17,15,907,8,475,17428745.42857143,174.0,59.375,7,432,16932980.333333332,174.0,61.71428571428572
31541.0,6,14,4740,7,653,5134.666666666667,249.0,93.28571428571428,7,4087,5113.166666666667,1514.0,583.8571428571429
90297516.0,6,16,1192,8,596,12892662.42857143,95.0,74.5,8,596,12898466.42857143,95.0,74.5
3022316.0,6,11,2106,6,598,603800.2,252.0,99.66666666666669,5,1508,5643.75,1236.0,301.6
96310504.0,17,12,778,6,389,19200222.2,174.0,64.83333333333333,6,389,19201058.8,174.0,64.83333333333333
0.0,17,1,179,1,179,0.0,179.0,179.0,0,0,0.0,0.0,0.0
166829.0,6,14,4740,7,653,26566.166666666668,249.0,93.28571428571428,7,4087,26574.5,1514.0,583.8571428571429
11759.0,6,10,1065,5,534,2653.0,262.0,106.8,5,531,2723.5,259.0,106.2
5467.0,17,2,180,1,90,0.0,90.0,90.0,1,90,0.0,90.0,90.0
53535.0,6,14,4740,7,653,8579.0,249.0,93.28571428571428,7,4087,8773.166666666666,1514.0,583.8571428571429
54876.0,6,14,4740,7,653,7912.0,249.0,93.28571428571428,7,4087,8856.666666666666,1514.0,583.8571428571429
122689688.0,17,15,907,7,432,17167654.333333332,174.0,61.71428571428572,8,475,17428729.714285713,174.0,59.375
121508.0,6,3,337,2,214,0.0,160.0,107.0,1,123,0.0,123.0,123.0
120002330.0,6,17,1246,9,650,15000291.25,95.0,72.22222222222223,8,596,17106519.85714286,95.0,74.5
5621465.0,6,5,336,2,134,0.0,68.0,67.0,3,202,1522486.5,70.0,67.33333333333333
47555.0,6,14,4740,7,653,7795.666666666667,249.0,93.28571428571428,7,4087,7646.166666666667,1514.0,583.8571428571429
1047775.0,6,11,1134,6,558,209555.0,220.0,93.0,5,576,257118.0,304.0,115.2
131407185.0,17,17,1517,9,780,16425898.125,174.0,86.66666666666667,8,737,15859506.714285716,174.0,92.125
278070.0,6,4,492,2,280,0.0,214.0,140.0,2,212,0.0,146.0,106.0
143902.0,17,2,180,1,90,0.0,90.0,90.0,1,90,0.0,90.0,90.0
30007.0,6,14,4740,7,653,4570.0,249.0,93.28571428571428,7,4087,4864.666666666667,1514.0,583.8571428571429
2780061.0,6,2,132,1,66,0.0,66.0,66.0,1,66,0.0,66.0,66.0
2115.0,17,4,344,2,150,0.0,75.0,75.0,2,194,0.0,103.0,97.0
41103.0,6,14,4740,7,653,6696.833333333333,249.0,93.28571428571428,7,4087,6510.5,1514.0,583.8571428571429
37525.0,6,14,4740,7,653,5138.666666666667,249.0,93.28571428571428,7,4087,6001.666666666667,1514.0,583.8571428571429
213651.0,17,2,180,1,90,0.0,90.0,90.0,1,90,0.0,90.0,90.0
90289715.0,6,16,1192,8,596,12891888.0,95.0,74.5,8,596,12896921.57142857,95.0,74.5
322926.0,17,4,1400,4,1400,107642.0,350.0,350.0,0,0,0.0,0.0,0.0
313210.0,17,4,1400,4,1400,104403.33333333331,350.0,350.0,0,0,0.0,0.0,0.0
120070743.0,6,214,24090,107,7284,1126044.8396226414,140.0,68.07476635514018,107,16806,1124920.3207547169,284.0,157.06542056074767
120007796.0,6,26,1978,14,1084,9230745.846153846,95.0,77.42857142857143,12,894,10883071.0,95.0,74.5
671112.0,6,2,132,1,66,0.0,66.0,66.0,1,66,0.0,66.0,66.0
255640.0,6,3,337,2,214,0.0,160.0,107.0,1,123,0.0,123.0,123.0
119333037.0,6,241,27276,121,19134,994441.975,284.0,158.13223140495867,120,8142,998220.3529411764,140.0,67.85
116897608.0,6,48,3168,24,1584,5082504.695652174,66.0,66.0,24,1584,5070511.956521739,66.0,66.0
207201.0,6,3,426,2,280,0.0,214.0,140.0,1,146,0.0,146.0,146.0
4610.0,17,2,626,1,72,0.0,72.0,72.0,1,554,0.0,554.0,554.0
90313245.0,6,16,1192,8,596,12895014.42857143,95.0,74.5,8,596,12900588.285714284,95.0,74.5
120000153.0,6,17,1287,9,691,15000019.125,95.0,76.77777777777777,8,596,12901449.142857144,95.0,74.5
102779514.0,6,43,2838,22,1452,4894250.714285715,66.0,66.0,21,1386,5112000.9,66.0,66.0
2356.0,17,4,344,2,150,0.0,75.0,75.0,2,194,0.0,103.0,97.0
3439188.0,6,172,142039,100,132985,34739.27272727273,1510.0,1329.85,72,9054,43947.18309859155,1510.0,125.75
90254146.0,6,12,1832,8,1016,12893449.42857143,188.0,127.0,4,816,30030639.666666668,204.0,204.0
245286.0,6,3,337,2,214,0.0,160.0,107.0,1,123,0.0,123.0,123.0
109658311.0,6,32,2220,16,1149,7296167.666666667,123.0,71.8125,16,1071,7296168.2,123.0,66.9375
208772.0,6,3,426,2,280,0.0,214.0,140.0,1,146,0.0,146.0,146.0
90036763.0,17,28,13364,28,13364,3334694.925925926,501.0,477.2857142857143,0,0,0.0,0.0,0.0
138083.0,17,2,176,1,80,0.0,80.0,80.0,1,96,0.0,96.0,96.0
0.0,17,1,381,1,381,0.0,381.0,381.0,0,0,0.0,0.0,0.0
47714711.0,6,8,1940,3,887,22538131.5,753.0,295.6666666666667,5,1053,11260373.0,785.0,210.6
2591695.0,6,2,132,1,66,0.0,66.0,66.0,1,66,0.0,66.0,66.0
216415.0,17,2,180,1,90,0.0,90.0,90.0,1,90,0.0,90.0,90.0
2432.0,17,4,344,2,150,0.0,75.0,75.0,2,194,0.0,103.0,97.0
102211.0,17,2,286,2,286,0.0,143.0,143.0,0,0,0.0,0.0,0.0
82755.0,6,14,4740,7,653,13458.0,249.0,93.28571428571428,7,4087,13488.5,1514.0,583.8571428571429
10284.0,6,10,1067,5,536,2272.75,264.0,107.2,5,531,1928.0,259.0,106.2
409.0,17,2,410,1,78,0.0,78.0,78.0,1,332,0.0,332.0,332.0
50019.0,6,14,4740,7,653,8041.166666666667,249.0,93.28571428571428,7,4087,7325.166666666667,1514.0,583.8571428571429
33603478.0,6,5,336,2,134,0.0,68.0,67.0,3,202,15511993.0,70.0,67.33333333333333
216859.0,6,3,426,2,280,0.0,214.0,140.0,1,146,0.0,146.0,146.0
146307.0,6,3,337,2,214,0.0,160.0,107.0,1,123,0.0,123.0,123.0
108110490.0,17,5,1005,5,1005,27027622.5,201.0,201.0,0,0,0.0,0.0,0.0
32993.0,6,14,4740,7,653,5305.5,249.0,93.28571428571428,7,4087,4872.333333333333,1514.0,583.8571428571429
924.0,17,4,438,2,148,0.0,74.0,74.0,2,290,0.0,147.0,145.0
82985174.0,17,14,4796,13,4446,6227589.25,342.0,342.0,1,350,0.0,350.0,350.0
133001124.0,17,15,907,8,475,19000160.57142857,174.0,59.375,7,432,18833779.5,174.0,61.71428571428572
2420.0,17,4,344,2,150,0.0,75.0,75.0,2,194,0.0,103.0,97.0
82914550.0,17,14,4796,13,4446,6228620.333333333,342.0,342.0,1,350,0.0,350.0,350.0
307067.0,6,6,412,4,272,102355.66666666669,74.0,68.0,2,140,0.0,74.0,70.0
135132436.0,17,6,1206,6,1206,27026487.2,201.0,201.0,0,0,0.0,0.0,0.0
492465.0,6,5,336,2,134,0.0,68.0,67.0,3,202,196668.5,70.0,67.33333333333333
202584.0,17,4,6056,4,6056,67528.0,1514.0,1514.0,0,0,0.0,0.0,0.0
308748.0,6,6,412,4,272,102916.0,74.0,68.0,2,140,0.0,74.0,70.0
122321.0,6,3,373,2,238,0.0,172.0,119.0,1,135,0.0,135.0,135.0
5004773.0,17,4,849,2,166,0.0,83.0,83.0,2,683,0.0,499.0,341.5
2362572.0,6,25,7573,14,3735,181736.3076923077,1514.0,266.7857142857143,11,3838,210170.8,1514.0,348.90909090909093
15027.0,6,14,4740,7,653,2296.333333333333,249.0,93.28571428571428,7,4087,2372.6666666666665,1514.0,583.8571428571429
2183525.0,6,24,7544,12,2450,198502.2727272728,1034.0,204.16666666666663,12,5094,170003.45454545456,1510.0,424.5
307509.0,17,4,1400,4,1400,102503.0,350.0,350.0,0,0,0.0,0.0,0.0
353.0,17,2,267,1,83,0.0,83.0,83.0,1,184,0.0,184.0,184.0
309751.0,6,6,412,4,272,103250.33333333331,74.0,68.0,2,140,0.0,74.0,70.0
84.0,17,2,762,2,762,0.0,381.0,381.0,0,0,0.0,0.0,0.0
311415.0,17,4,704,2,148,0.0,74.0,74.0,2,556,0.0,280.0,278.0
228400.0,17,2,180,1,90,0.0,90.0,90.0,1,90,0.0,90.0,90.0
71876.0,6,14,4740,7,653,11181.5,249.0,93.28571428571428,7,4087,10210.0,1514.0,583.8571428571429
119309111.0,6,362,56316,181,44000,661633.3666666667,1514.0,243.0939226519337,181,12316,661633.3555555556,214.0,68.04419889502762
171644.0,17,2,180,1,90,0.0,90.0,90.0,1,90,0.0,90.0,90.0
281284.0,17,4,1524,4,1524,93761.33333333331,381.0,381.0,0,0,0.0,0.0,0.0
37803.0,6,14,4740,7,653,6034.666666666667,249.0,93.28571428571428,7,4087,6143.333333333333,1514.0,583.8571428571429
151893.0,17,2,414,1,88,0.0,88.0,88.0,1,326,0.0,326.0,326.0
322.0,17,2,174,1,79,0.0,79.0,79.0,1,95,0.0,95.0,95.0
90021126.0,17,28,13364,28,13364,3334115.777777778,501.0,477.2857142857143,0,0,0.0,0.0,0.0
313.0,17,2,164,1,82,0.0,82.0,82.0,1,82,0.0,82.0,82.0
135127250.0,17,6,1206,6,1206,27025450.0,201.0,201.0,0,0,0.0,0.0,0.0
98683456.0,17,12,778,6,389,19601019.0,174.0,64.83333333333333,6,389,19600168.4,174.0,64.83333333333333
234514.0,6,3,426,2,280,0.0,214.0,140.0,1,146,0.0,146.0,146.0
49684.0,6,10,2032,5,524,12170.75,252.0,104.8,5,1508,11304.75,1236.0,301.6
1186021.0,6,13,3015,8,2387,169431.57142857142,1514.0,298.375,5,628,227568.25,331.0,125.6
93016292.0,6,38,2508,19,1254,5150437.055555556,66.0,66.0,19,1254,5150440.388888889,66.0,66.0
2433284.0,6,3,1604,1,753,0.0,753.0,753.0,2,851,0.0,785.0,425.5
7696633.0,6,5,1736,3,917,3777756.5,785.0,305.6666666666667,2,819,0.0,753.0,409.5
218133.0,6,3,426,2,280,0.0,214.0,140.0,1,146,0.0,146.0,146.0
90036644.0,17,28,13364,28,13364,3334690.5185185187,501.0,477.2857142857143,0,0,0.0,0.0,0.0
1273533.0,6,14,3086,8,2392,181933.2857142857,1514.0,299.0,6,694,200215.2,331.0,115.66666666666669
282125.0,17,2,180,1,90,0.0,90.0,90.0,1,90,0.0,90.0,90.0
51322.0,6,14,4740,7,653,8293.5,249.0,93.28571428571428,7,4087,7193.5,1514.0,583.8571428571429
90257580.0,6,14,2240,8,1016,12893940.0,188.0,127.0,6,1224,18018311.0,204.0,204.0
2306.0,17,4,344,2,150,0.0,75.0,75.0,2,194,0.0,103.0,97.0
1239127.0,17,7,490,7,490,206521.16666666663,70.0,70.0,0,0,0.0,0.0,0.0
305782.0,6,6,412,4,272,101927.33333333331,74.0,68.0,2,140,0.0,74.0,70.0
7292.0,17,2,582,1,83,0.0,83.0,83.0,1,499,0.0,499.0,499.0
9537.0,17,2,582,1,83,0.0,83.0,83.0,1,499,0.0,499.0,499.0
68334.0,6,13,1394,7,797,11389.0,253.0,113.85714285714286,6,597,10877.4,259.0,99.5
108110581.0,17,5,1005,5,1005,27027645.25,201.0,201.0,0,0,0.0,0.0,0.0
216537.0,17,2,180,1,90,0.0,90.0,90.0,1,90,0.0,90.0,90.0
228345.0,17,2,180,1,90,0.0,90.0,90.0,1,90,0.0,90.0,90.0
9427.0,17,2,614,1,72,0.0,72.0,72.0,1,542,0.0,542.0,542.0
113254831.0,6,46,3036,23,1518,5135438.863636363,66.0,66.0,23,1518,5135431.818181818,66.0,66.0
1325665.0,6,4,264,2,132,0.0,66.0,66.0,2,132,0.0,66.0,66.0
228297.0,17,2,180,1,90,0.0,90.0,90.0,1,90,0.0,90.0,90.0
362511.0,6,11,1021,6,444,48765.2,162.0,74.0,5,577,60708.75,349.0,115.4
121990507.0,17,14,1126,7,563,17001126.166666668,174.0,80.42857142857143,7,563,17000151.166666668,174.0,80.42857142857143
2141.0,17,4,344,2,150,0.0,75.0,75.0,2,194,0.0,103.0,97.0
99435848.0,17,14,1126,7,563,16546012.833333334,174.0,80.42857142857143,7,563,16476809.333333334,174.0,80.42857142857143
90203936.0,6,16,1192,8,596,12852319.714285716,95.0,74.5,8,596,12857034.714285716,95.0,74.5
11930.0,6,10,1949,5,441,2683.75,169.0,88.2,5,1508,2531.5,1236.0,301.6
28918.0,6,10,1066,5,490,6421.75,218.0,98.0,5,576,6785.25,304.0,115.2
2606328.0,6,25,7573,14,3735,200486.7692307692,1514.0,266.7857142857143,11,3838,235567.6,1514.0,348.90909090909093
298952.0,6,6,412,4,272,99650.66666666669,74.0,68.0,2,140,0.0,74.0,70.0
137611.0,6,2,132,1,66,0.0,66.0,66.0,1,66,0.0,66.0,66.0
52354.0,6,14,4740,7,653,8331.5,249.0,93.28571428571428,7,4087,6899.833333333333,1514.0,583.8571428571429
116897046.0,6,48,3168,24,1584,5082480.260869565,66.0,66.0,24,1584,5070496.739130435,66.0,66.0
108104145.0,17,5,955,5,955,27026036.25,191.0,191.0,0,0,0.0,0.0,0.0
2394.0,17,4,344,2,150,0.0,75.0,75.0,2,194,0.0,103.0,97.0
1029668.0,6,11,2049,6,541,204152.4,195.0,90.16666666666669,5,1508,4566.75,1236.0,301.6
16218751.999999998,17,6,2052,6,2052,3243750.4,342.0,342.0,0,0,0.0,0.0,0.0
33508.0,6,10,2032,5,524,8052.5,252.0,104.8,5,1508,7842.0,1236.0,301.6
2297.0,17,4,344,2,150,0.0,75.0,75.0,2,194,0.0,103.0,97.0
104254.0,17,2,286,2,286,0.0,143.0,143.0,0,0,0.0,0.0,0.0
153367.0,17,2,180,1,90,0.0,90.0,90.0,1,90,0.0,90.0,90.0
5621000.0,6,5,336,2,134,0.0,68.0,67.0,3,202,1526899.0,70.0,67.33333333333333
97863899.0,6,28,1992,14,1029,7511305.076923077,123.0,73.5,14,963,7510967.923076923,123.0,68.78571428571429
207389.0,6,3,426,2,280,0.0,214.0,140.0,1,146,0.0,146.0,146.0
108098963.0,17,5,1005,5,1005,27024740.75,201.0,201.0,0,0,0.0,0.0,0.0
112000994.0,17,15,1169,8,606,16000142.0,174.0,75.75,7,563,15334396.5,174.0,80.42857142857143
53189.0,6,14,4740,7,653,7237.833333333333,249.0,93.28571428571428,7,4087,8687.833333333334,1514.0,583.8571428571429
13882728.0,17,6,2052,6,2052,2776545.6,342.0,342.0,0,0,0.0,0.0,0.0
327.0,17,2,208,1,72,0.0,72.0,72.0,1,136,0.0,136.0,136.0
39968.0,6,14,4740,7,653,6452.166666666667,249.0,93.28571428571428,7,4087,5002.0,1514.0,583.8571428571429
50351.0,6,10,2032,5,524,8445.0,252.0,104.8,5,1508,11968.25,1236.0,301.6
3155.0,17,4,344,2,150,0.0,75.0,75.0,2,194,0.0,103.0,97.0
42021.0,6,14,4740,7,653,6814.166666666667,249.0,93.28571428571428,7,4087,6520.0,1514.0,583.8571428571429
101693.0,17,2,762,2,762,0.0,381.0,381.0,0,0,0.0,0.0,0.0
37388.0,6,14,4740,7,653,5896.5,249.0,93.28571428571428,7,4087,5832.666666666667,1514.0,583.8571428571429
285964.0,6,10,1221,6,636,57192.8,298.0,106.0,4,585,94169.0,379.0,146.25
9946.0,17,4,823,2,163,0.0,89.0,81.5,2,660,0.0,443.0,330.0
300388.0,6,6,412,4,272,100129.33333333331,74.0,68.0,2,140,0.0,74.0,70.0
9865.0,17,2,582,1,83,0.0,83.0,83.0,1,499,0.0,499.0,499.0
148233.0,17,2,414,1,88,0.0,88.0,88.0,1,326,0.0,326.0,326.0
53724.0,6,14,4740,7,653,8790.166666666666,249.0,93.28571428571428,7,4087,8716.0,1514.0,583.8571428571429
90276593.0,6,15,1097,8,596,12896656.142857144,95.0,74.5,7,501,14998926.5,95.0,71.57142857142857
102006333.0,17,13,821,7,432,17001055.5,174.0,61.71428571428572,6,389,16400183.6,174.0,64.83333333333333
112051136.0,17,14,864,7,432,18667661.666666668,174.0,61.71428571428572,7,432,18666836.166666668,174.0,61.71428571428572
405235.0,6,4,508,2,238,0.0,172.0,119.0,2,270,0.0,135.0,135.0
514.0,17,2,508,2,508,0.0,257.0,254.0,0,0,0.0,0.0,0.0
141609.0,17,2,176,1,80,0.0,80.0,80.0,1,96,0.0,96.0,96.0
4726.0,17,7,3341,7,3341,787.6666666666666,501.0,477.2857142857143,0,0,0.0,0.0,0.0
90254959.0,6,12,1832,8,1016,12893565.57142857,188.0,127.0,4,816,30030867.0,204.0,204.0
108108101.0,17,5,955,5,955,27027025.25,191.0,191.0,0,0,0.0,0.0,0.0
118027745.0,6,32,2220,16,1149,7868516.333333333,123.0,71.8125,16,1071,7854107.733333333,123.0,66.9375
14637925.0,6,20,1607,10,975,1591350.3333333333,315.0,97.5,10,632,1591294.7777777778,78.0,63.2
116424972.0,6,48,3168,24,1584,5061955.304347826,66.0,66.0,24,1584,5050107.043478261,66.0,66.0
108108275.0,17,5,955,5,955,27027068.75,191.0,191.0,0,0,0.0,0.0,0.0
2026.0,17,4,344,2,150,0.0,75.0,75.0,2,194,0.0,103.0,97.0
111287.0,17,4,1400,4,1400,37095.66666666666,350.0,350.0,0,0,0.0,0.0,0.0
2456.0,17,4,344,2,150,0.0,75.0,75.0,2,194,0.0,103.0,97.0
8825.0,17,2,498,1,80,0.0,80.0,80.0,1,418,0.0,418.0,418.0
100000821.0,17,11,473,6,258,20000164.2,43.0,43.0,5,215,20000708.0,43.0,43.0
108105178.0,17,5,955,5,955,27026294.5,191.0,191.0,0,0,0.0,0.0,0.0
764.0,17,4,438,2,148,0.0,74.0,74.0,2,290,0.0,147.0,145.0
50935.0,17,2,180,1,90,0.0,90.0,90.0,1,90,0.0,90.0,90.0
5629256.0,6,4,270,2,134,0.0,68.0,67.0,2,136,0.0,70.0,68.0
2358.0,17,4,344,2,150,0.0,75.0,75.0,2,194,0.0,103.0,97.0
102885.0,17,2,286,2,286,0.0,143.0,143.0,0,0,0.0,0.0,0.0
2337.0,17,4,344,2,150,0.0,75.0,75.0,2,194,0.0,103.0,97.0
2408.0,17,4,344,2,150,0.0,75.0,75.0,2,194,0.0,103.0,97.0
307626.0,6,6,412,4,272,102542.0,74.0,68.0,2,140,0.0,74.0,70.0
836.0,17,4,438,2,148,0.0,74.0,74.0,2,290,0.0,147.0,145.0
160493.0,17,2,180,1,90,0.0,90.0,90.0,1,90,0.0,90.0,90.0
317080.0,6,3,202,2,128,0.0,74.0,64.0,1,74,0.0,74.0,74.0
120380510.0,6,241,27272,121,19118,1003170.9166666666,284.0,158.0,120,8154,1002871.4285714284,140.0,67.95
216885.0,6,3,426,2,280,0.0,214.0,140.0,1,146,0.0,146.0,146.0
302145.0,6,6,412,4,272,100715.0,74.0,68.0,2,140,0.0,74.0,70.0
43046.0,6,14,4740,7,653,7051.833333333333,249.0,93.28571428571428,7,4087,6326.0,1514.0,583.8571428571429
5621869.0,6,5,336,2,134,0.0,68.0,67.0,3,202,1522748.0,70.0,67.33333333333333
2092.0,17,4,344,2,150,0.0,75.0,75.0,2,194,0.0,103.0,97.0
124070.0,6,12,1362,6,731,24500.4,253.0,121.83333333333331,6,631,24368.4,293.0,105.16666666666669
460352.0,17,6,2100,6,2100,92070.4,350.0,350.0,0,0,0.0,0.0,0.0
98275045.0,6,238,27024,119,18948,831048.1271186441,284.0,159.2268907563025,119,8076,831048.2033898305,140.0,67.8655462184874
14515.0,6,10,1065,5,534,3339.5,262.0,106.8,5,531,3286.25,259.0,106.2
5829533.0,6,5,336,2,134,0.0,68.0,67.0,3,202,1525091.0,70.0,67.33333333333333
28429.0,6,10,2032,5,524,6890.5,252.0,104.8,5,1508,6851.0,1236.0,301.6
107199.0,17,2,286,2,286,0.0,143.0,143.0,0,0,0.0,0.0,0.0
154.0,17,2,3028,2,3028,0.0,1514.0,1514.0,0,0,0.0,0.0,0.0
10515864.0,6,7,478,4,272,3459814.333333333,74.0,68.0,3,206,5189623.5,74.0,68.66666666666667
321248.0,17,4,704,2,148,0.0,74.0,74.0,2,556,0.0,280.0,278.0
114894415.0,6,48,3168,24,1584,4995409.347826087,66.0,66.0,24,1584,4981951.565217392,66.0,66.0
11427.0,6,10,1065,5,534,2575.0,262.0,106.8,5,531,2526.5,259.0,106.2
59957.0,6,14,4740,7,653,9317.833333333334,249.0,93.28571428571428,7,4087,8795.166666666666,1514.0,583.8571428571429
108112175.0,17,5,955,5,955,27028043.75,191.0,191.0,0,0,0.0,0.0,0.0
102636.0,17,2,762,2,762,0.0,381.0,381.0,0,0,0.0,0.0,0.0
328.0,17,2,208,1,72,0.0,72.0,72.0,1,136,0.0,136.0,136.0
90287758.0,6,16,1192,8,596,12891952.714285716,95.0,74.5,8,596,12897814.285714284,95.0,74.5
216837.0,17,2,180,1,90,0.0,90.0,90.0,1,90,0.0,90.0,90.0
2324.0,17,4,344,2,150,0.0,75.0,75.0,2,194,0.0,103.0,97.0
0.0,17,1,342,1,342,0.0,342.0,342.0,0,0,0.0,0.0,0.0
114636445.0,6,48,3168,24,1584,4984193.260869565,66.0,66.0,24,1584,4970768.130434782,66.0,66.0
308101.0,6,6,412,4,272,102700.33333333331,74.0,68.0,2,140,0.0,74.0,70.0
90261453.0,6,12,1832,8,1016,12894493.285714284,188.0,127.0,4,816,30030892.666666668,204.0,204.0
4455.0,17,2,614,1,72,0.0,72.0,72.0,1,542,0.0,542.0,542.0
51627.0,6,10,2032,5,524,12651.5,252.0,104.8,5,1508,11995.75,1236.0,301.6
2589943.0,6,2,132,1,66,0.0,66.0,66.0,1,66,0.0,66.0,66.0
135139261.0,17,6,1146,6,1146,27027852.2,191.0,191.0,0,0,0.0,0.0,0.0
206092.0,6,3,426,2,280,0.0,214.0,140.0,1,146,0.0,146.0,146.0
108111079.0,17,5,1005,5,1005,27027769.75,201.0,201.0,0,0,0.0,0.0,0.0
46951.0,6,14,4740,7,653,6406.166666666667,249.0,93.28571428571428,7,4087,7670.5,1514.0,583.8571428571429
2386.0,17,4,344,2,150,0.0,75.0,75.0,2,194,0.0,103.0,97.0
119319.0,6,2,132,1,66,0.0,66.0,66.0,1,66,0.0,66.0,66.0
40561.0,6,10,2032,5,524,9907.25,252.0,104.8,5,1508,9517.25,1236.0,301.6
350.0,17,2,160,1,80,0.0,80.0,80.0,1,80,0.0,80.0,80.0
317.0,17,2,174,1,79,0.0,79.0,79.0,1,95,0.0,95.0,95.0
108111968.0,17,5,1005,5,1005,27027992.0,201.0,201.0,0,0,0.0,0.0,0.0
284628.0,17,2,363,1,79,0.0,79.0,79.0,1,284,0.0,284.0,284.0
957921.0,6,12,1447,6,816,190252.8,291.0,136.0,6,631,190433.4,293.0,105.16666666666669
102377.0,17,2,286,2,286,0.0,143.0,143.0,0,0,0.0,0.0,0.0
36586.0,6,14,4740,7,653,5648.833333333333,249.0,93.28571428571428,7,4087,5568.166666666667,1514.0,583.8571428571429
29650.0,6,10,2032,5,524,6886.25,252.0,104.8,5,1508,7170.25,1236.0,301.6
23945.0,6,14,4740,7,653,3348.333333333333,249.0,93.28571428571428,7,4087,3854.5,1514.0,583.8571428571429
110456408.0,6,32,2236,16,1165,7349357.466666667,139.0,72.8125,16,1071,7349357.2,123.0,66.9375
15169.0,17,2,180,1,90,0.0,90.0,90.0,1,90,0.0,90.0,90.0
288507.0,17,2,180,1,90,0.0,90.0,90.0,1,90,0.0,90.0,90.0
122077.0,6,3,337,2,214,0.0,160.0,107.0,1,123,0.0,123.0,123.0
34365.0,6,14,4740,7,653,5616.666666666667,249.0,93.28571428571428,7,4087,5055.666666666667,1514.0,583.8571428571429
2355.0,17,4,344,2,150,0.0,75.0,75.0,2,194,0.0,103.0,97.0
112137353.0,6,988,220484,503,187722,223381.1812749004,1514.0,373.20477137176937,485,32762,231193.5020661157,214.0,67.55051546391752
63559.00000000001,6,14,4740,7,653,9492.333333333334,249.0,93.28571428571428,7,4087,10204.666666666666,1514.0,583.8571428571429
234147.0,6,3,337,2,214,0.0,160.0,107.0,1,123,0.0,123.0,123.0
32144.0,6,14,4740,7,653,4666.333333333333,249.0,93.28571428571428,7,4087,5214.5,1514.0,583.8571428571429
300847.0,6,6,412,4,272,100282.33333333331,74.0,68.0,2,140,0.0,74.0,70.0
2716224.0,6,155,121587,84,113056,28976.060240963856,1510.0,1345.904761904762,71,8531,34356.25714285715,1510.0,120.15492957746478
0.0,6,1,160,1,160,0.0,160.0,160.0,0,0,0.0,0.0,0.0
97118044.0,6,188,21310,94,14884,1041966.9032258064,374.0,158.3404255319149,94,6426,1041967.1720430108,140.0,68.36170212765957
168470.0,17,4,704,2,148,0.0,74.0,74.0,2,556,0.0,280.0,278.0
263566.0,6,10,1221,6,636,52713.2,298.0,106.0,4,585,82454.33333333333,379.0,146.25
18608.0,6,14,4740,7,653,2816.1666666666665,249.0,93.28571428571428,7,4087,2878.1666666666665,1514.0,583.8571428571429
12015.0,6,13,1459,7,862,2002.5,271.0,123.14285714285714,6,597,2141.8,259.0,99.5
42514.0,6,14,4740,7,653,6675.833333333333,249.0,93.28571428571428,7,4087,5687.166666666667,1514.0,583.8571428571429
322743.0,17,4,1400,4,1400,107581.0,350.0,350.0,0,0,0.0,0.0,0.0
101417.0,17,2,762,2,762,0.0,381.0,381.0,0,0,0.0,0.0,0.0
393568.0,6,10,967,5,390,68546.25,162.0,78.0,5,577,68479.5,349.0,115.4
90222553.0,6,19,1436,9,691,11246213.0,95.0,76.77777777777777,10,745,10000782.0,95.0,74.5
155193.0,6,3,337,2,214,0.0,160.0,107.0,1,123,0.0,123.0,123.0
322897.0,17,4,1400,4,1400,107632.33333333331,350.0,350.0,0,0,0.0,0.0,0.0
5627471.0,6,5,336,2,134,0.0,68.0,67.0,3,202,1518800.5,70.0,67.33333333333333
314654.0,17,4,1400,4,1400,104884.66666666669,350.0,350.0,0,0,0.0,0.0,0.0
132527.0,6,2,132,1,66,0.0,66.0,66.0,1,66,0.0,66.0,66.0
212583.0,6,10,1221,6,636,42516.6,298.0,106.0,4,585,69678.66666666667,379.0,146.25
310026.0,6,6,412,4,272,103342.0,74.0,68.0,2,140,0.0,74.0,70.0
200742.0,17,2,762,2,762,0.0,381.0,381.0,0,0,0.0,0.0,0.0
4983.0,17,2,180,1,90,0.0,90.0,90.0,1,90,0.0,90.0,90.0
101092144.0,17,14,1126,7,563,16834312.5,174.0,80.42857142857143,7,563,16833487.666666668,174.0,80.42857142857143
120203028.0,6,235,26578,118,8084,1027376.3076923076,140.0,68.50847457627118,117,18494,1027214.5,284.0,158.06837606837607
90002604.0,17,27,12943,27,12943,3461638.6153846155,501.0,479.3703703703704,0,0,0.0,0.0,0.0
228141.0,17,2,180,1,90,0.0,90.0,90.0,1,90,0.0,90.0,90.0
130012455.0,17,15,907,8,475,18573207.85714286,174.0,59.375,7,432,18333492.33333333,174.0,61.71428571428572
108526569.0,17,14,864,7,432,18087761.5,174.0,61.71428571428572,7,432,18003762.166666668,174.0,61.71428571428572
128010598.0,17,15,907,8,475,18287228.285714287,174.0,59.375,7,432,18000163.666666668,174.0,61.71428571428572
68724.0,6,14,4740,7,653,11280.5,249.0,93.28571428571428,7,4087,10251.833333333334,1514.0,583.8571428571429
309657.0,6,6,412,4,272,103219.0,74.0,68.0,2,140,0.0,74.0,70.0
24206.0,6,14,4740,7,653,3913.1666666666665,249.0,93.28571428571428,7,4087,3897.8333333333335,1514.0,583.8571428571429
153278.0,17,4,1524,4,1524,51092.66666666666,381.0,381.0,0,0,0.0,0.0,0.0
8002.0,17,4,344,2,150,0.0,75.0,75.0,2,194,0.0,103.0,97.0
107788.0,17,2,762,2,762,0.0,381.0,381.0,0,0,0.0,0.0,0.0
96084871.0,6,56,11691,28,5953,3558698.925925926,1514.0,212.6071428571429,28,5738,3549433.3703703703,1514.0,204.92857142857144
2530.0,17,4,344,2,150,0.0,75.0,75.0,2,194,0.0,103.0,97.0
228291.0,17,2,180,1,90,0.0,90.0,90.0,1,90,0.0,90.0,90.0
2800338.0,6,2,132,1,66,0.0,66.0,66.0,1,66,0.0,66.0,66.0
227209.0,17,2,180,1,90,0.0,90.0,90.0,1,90,0.0,90.0,90.0
4279.0,17,2,626,1,72,0.0,72.0,72.0,1,554,0.0,554.0,554.0
108107248.0,17,5,955,5,955,27026812.0,191.0,191.0,0,0,0.0,0.0,0.0
120007376.0,17,28,13364,28,13364,4444717.62962963,501.0,477.2857142857143,0,0,0.0,0.0,0.0
29448.0,6,14,4740,7,653,4453.0,249.0,93.28571428571428,7,4087,4730.666666666667,1514.0,583.8571428571429
212296.0,17,2,180,1,90,0.0,90.0,90.0,1,90,0.0,90.0,90.0
310175.0,6,3,202,2,128,0.0,74.0,64.0,1,74,0.0,74.0,74.0
148026.0,6,3,373,2,238,0.0,172.0,119.0,1,135,0.0,135.0,135.0
298981.0,6,2,132,1,66,0.0,66.0,66.0,1,66,0.0,66.0,66.0
2610634.0,6,25,7573,14,3735,200818.0,1514.0,266.7857142857143,11,3838,233999.5,1514.0,348.90909090909093
2446.0,17,4,344,2,150,0.0,75.0,75.0,2,194,0.0,103.0,97.0
1232045.0,17,7,490,7,490,205340.8333333333,70.0,70.0,0,0,0.0,0.0,0.0
90048608.0,17,28,13364,28,13364,3335133.6296296297,501.0,477.2857142857143,0,0,0.0,0.0,0.0
142376.0,6,2,132,1,66,0.0,66.0,66.0,1,66,0.0,66.0,66.0
10478192.0,6,7,478,4,272,3447509.333333333,74.0,68.0,3,206,5171117.0,74.0,68.66666666666667
135130523.0,17,6,1146,6,1146,27026104.6,191.0,191.0,0,0,0.0,0.0,0.0
10461879.0,6,7,478,4,272,3441976.6666666665,74.0,68.0,3,206,5162856.0,74.0,68.66666666666667
99198952.0,6,184,20776,92,14482,1087732.8131868131,284.0,157.41304347826087,92,6294,1087732.2417582418,140.0,68.41304347826087
20616.0,6,2,145,2,145,0.0,91.0,72.5,0,0,0.0,0.0,0.0
135130467.0,17,6,1206,6,1206,27026093.4,201.0,201.0,0,0,0.0,0.0,0.0
217923.0,6,3,426,2,280,0.0,214.0,140.0,1,146,0.0,146.0,146.0
156855.0,6,3,337,2,214,0.0,160.0,107.0,1,123,0.0,123.0,123.0
338.0,17,2,267,1,83,0.0,83.0,83.0,1,184,0.0,184.0,184.0
51068.0,17,2,180,1,90,0.0,90.0,90.0,1,90,0.0,90.0,90.0
102932.0,17,2,286,2,286,0.0,143.0,143.0,0,0,0.0,0.0,0.0
92230663.0,6,30,2122,15,1105,6572470.0,139.0,73.66666666666667,15,1017,6572473.571428572,123.0,67.8
7919852.0,17,7,1743,4,351,2633407.6666666665,103.0,87.75,3,1392,3944689.5,545.0,464.0
478602.0,6,5,336,2,134,0.0,68.0,67.0,3,202,184475.5,70.0,67.33333333333333
1306037.0,6,4,264,2,132,0.0,66.0,66.0,2,132,0.0,66.0,66.0
1057287.0,6,11,1134,6,558,211457.4,220.0,93.0,5,576,259293.0,304.0,115.2
155292.0,6,3,337,2,214,0.0,160.0,107.0,1,123,0.0,123.0,123.0
147964.0,17,2,180,1,90,0.0,90.0,90.0,1,90,0.0,90.0,90.0
108103532.0,17,5,955,5,955,27025883.0,191.0,191.0,0,0,0.0,0.0,0.0
218166.0,6,3,426,2,280,0.0,214.0,140.0,1,146,0.0,146.0,146.0
299330.0,6,6,412,4,272,99776.66666666669,74.0,68.0,2,140,0.0,74.0,70.0
2335.0,17,4,344,2,150,0.0,75.0,75.0,2,194,0.0,103.0,97.0
108971.0,17,2,286,2,286,0.0,143.0,143.0,0,0,0.0,0.0,0.0
143850.0,17,2,180,1,90,0.0,90.0,90.0,1,90,0.0,90.0,90.0
207414.0,6,3,426,2,280,0.0,214.0,140.0,1,146,0.0,146.0,146.0
337609.0,17,4,704,2,148,0.0,74.0,74.0,2,556,0.0,280.0,278.0
167178.0,17,4,704,2,148,0.0,74.0,74.0,2,556,0.0,280.0,278.0
35198.0,6,14,4740,7,653,4400.333333333333,249.0,93.28571428571428,7,4087,5678.5,1514.0,583.8571428571429
128653957.0,6,32,2236,16,1071,7911317.2,123.0,66.9375,16,1165,8060072.866666666,139.0,72.8125
121535.0,6,3,337,2,214,0.0,160.0,107.0,1,123,0.0,123.0,123.0
4520.0,17,4,813,2,144,0.0,72.0,72.0,2,669,0.0,542.0,334.5
312737.0,6,3,202,2,128,0.0,74.0,64.0,1,74,0.0,74.0,74.0
26440.0,6,14,4740,7,653,4236.333333333333,249.0,93.28571428571428,7,4087,4260.666666666667,1514.0,583.8571428571429
102296.0,17,2,762,2,762,0.0,381.0,381.0,0,0,0.0,0.0,0.0
0.0,6,1,66,1,66,0.0,66.0,66.0,0,0,0.0,0.0,0.0
310832.0,17,4,1400,4,1400,103610.66666666669,350.0,350.0,0,0,0.0,0.0,0.0
2633730.0,6,3,1604,2,851,0.0,785.0,425.5,1,753,0.0,753.0,753.0
326.0,17,2,208,1,72,0.0,72.0,72.0,1,136,0.0,136.0,136.0
1000500.0,17,4,820,2,156,0.0,78.0,78.0,2,664,0.0,332.0,332.0
120283298.0,6,355,41248,178,29270,679566.6553672317,284.0,164.438202247191,177,11978,677600.2784090909,140.0,67.67231638418079
3187538.0,6,3,204,1,68,0.0,68.0,68.0,2,136,0.0,70.0,68.0
216911.0,6,3,426,2,280,0.0,214.0,140.0,1,146,0.0,146.0,146.0
1316.0,17,4,438,2,148,0.0,74.0,74.0,2,290,0.0,147.0,145.0
207043.0,6,3,426,2,280,0.0,214.0,140.0,1,146,0.0,146.0,146.0
16997447.0,17,5,1905,5,1905,4249361.75,381.0,381.0,0,0,0.0,0.0,0.0
90063250.0,17,27,12943,27,12943,3463971.153846154,501.0,479.3703703703704,0,0,0.0,0.0,0.0
15784.0,6,11,1131,6,600,3050.0,262.0,100.0,5,531,3603.5,259.0,106.2
1306217.0,6,4,264,2,132,0.0,66.0,66.0,2,132,0.0,66.0,66.0
574626.0,6,4,508,2,238,0.0,172.0,119.0,2,270,0.0,135.0,135.0
90299380.0,6,21,1585,11,840,9025434.4,95.0,76.36363636363636,10,745,10001233.666666666,95.0,74.5
0.0,6,1,66,1,66,0.0,66.0,66.0,0,0,0.0,0.0,0.0
233018.0,6,3,337,2,214,0.0,160.0,107.0,1,123,0.0,123.0,123.0
146139.0,6,3,337,2,214,0.0,160.0,107.0,1,123,0.0,123.0,123.0
9309.0,17,2,498,1,80,0.0,80.0,80.0,1,418,0.0,418.0,418.0
9777.0,17,2,582,1,83,0.0,83.0,83.0,1,499,0.0,499.0,499.0
229709.0,17,2,359,1,75,0.0,75.0,75.0,1,284,0.0,284.0,284.0
839900.0,6,9,1096,6,625,167980.0,287.0,104.16666666666669,3,471,282305.5,331.0,157.0
25902.0,6,10,2032,5,524,5534.25,252.0,104.8,5,1508,5648.5,1236.0,301.6
2588462.0,6,2,132,1,66,0.0,66.0,66.0,1,66,0.0,66.0,66.0
100477626.0,17,12,516,6,258,20000160.4,43.0,43.0,6,258,20001336.0,43.0,43.0
3602857.0,6,5,367,3,235,1801428.5,103.0,78.33333333333333,2,132,0.0,66.0,66.0
295.0,17,2,156,1,78,0.0,78.0,78.0,1,78,0.0,78.0,78.0
90035533.0,6,12,894,7,542,15005922.166666666,95.0,77.42857142857143,5,352,15002511.75,95.0,70.4
99244.0,17,2,762,2,762,0.0,381.0,381.0,0,0,0.0,0.0,0.0
153414.0,17,2,180,1,90,0.0,90.0,90.0,1,90,0.0,90.0,90.0
34580.0,6,14,4740,7,653,4880.833333333333,249.0,93.28571428571428,7,4087,5280.166666666667,1514.0,583.8571428571429
2662376.0,6,25,7573,14,3735,204798.15384615384,1514.0,266.7857142857143,11,3838,237617.9,1514.0,348.90909090909093
204638.0,17,3,1143,3,1143,102319.0,381.0,381.0,0,0,0.0,0.0,0.0
228298.0,17,2,180,1,90,0.0,90.0,90.0,1,90,0.0,90.0,90.0
144005.0,17,2,180,1,90,0.0,90.0,90.0,1,90,0.0,90.0,90.0
31593.000000000004,6,10,2032,5,524,7645.0,252.0,104.8,5,1508,7363.0,1236.0,301.6
55087.0,6,14,4740,7,653,8158.666666666667,249.0,93.28571428571428,7,4087,7829.0,1514.0,583.8571428571429
183711.0,17,4,1400,4,1400,61237.0,350.0,350.0,0,0,0.0,0.0,0.0
1978197.0,6,2,132,1,66,0.0,66.0,66.0,1,66,0.0,66.0,66.0
206645.0,17,2,180,1,90,0.0,90.0,90.0,1,90,0.0,90.0,90.0
7110.0,17,2,582,1,83,0.0,83.0,83.0,1,499,0.0,499.0,499.0
39427.0,6,14,4740,7,653,6413.0,249.0,93.28571428571428,7,4087,6431.5,1514.0,583.8571428571429
169384.0,17,2,414,1,88,0.0,88.0,88.0,1,326,0.0,326.0,326.0
233182.0,6,3,337,2,214,0.0,160.0,107.0,1,123,0.0,123.0,123.0
122279.0,6,3,373,2,238,0.0,172.0,119.0,1,135,0.0,135.0,135.0
1297187.0,6,4,264,2,132,0.0,66.0,66.0,2,132,0.0,66.0,66.0
15369.0,6,14,4740,7,653,2189.0,249.0,93.28571428571428,7,4087,2335.5,1514.0,583.8571428571429
320450.0,6,6,412,4,272,106816.66666666669,74.0,68.0,2,140,0.0,74.0,70.0
97005052.0,17,11,735,6,389,19401010.4,174.0,64.83333333333333,5,346,19250158.5,174.0,69.2
43361.0,6,14,4740,7,653,7095.833333333333,249.0,93.28571428571428,7,4087,6989.333333333333,1514.0,583.8571428571429
1182.0,17,2,762,2,762,0.0,381.0,381.0,0,0,0.0,0.0,0.0
107842786.0,6,28,1860,14,966,8279004.538461538,123.0,69.0,14,894,8279010.769230769,123.0,63.85714285714285
105110.0,17,2,762,2,762,0.0,381.0,381.0,0,0,0.0,0.0,0.0
19320.0,6,20,7606,11,978,1932.0,310.0,88.9090909090909,9,6628,2107.5,1514.0,736.4444444444445
145640.0,6,3,337,2,214,0.0,160.0,107.0,1,123,0.0,123.0,123.0
92920751.0,6,389,49066,195,13092,478972.94329896907,140.0,67.13846153846154,194,35974,476040.7409326425,374.0,185.43298969072168
106734.0,17,4,1400,4,1400,35578.0,350.0,350.0,0,0,0.0,0.0,0.0
112979646.0,6,45,2970,23,1518,5135438.454545454,66.0,66.0,22,1452,5000381.571428572,66.0,66.0
241591.0,6,3,337,2,214,0.0,160.0,107.0,1,123,0.0,123.0,123.0
200933.0,17,3,1143,3,1143,100466.5,381.0,381.0,0,0,0.0,0.0,0.0
90305868.0,6,16,1192,8,596,12893590.142857144,95.0,74.5,8,596,12899369.714285716,95.0,74.5
2417871.0,6,26,7962,14,2958,185990.0769230769,1039.0,211.28571428571428,12,5004,192437.0,1510.0,417.0
42584.0,6,14,4740,7,653,6247.666666666667,249.0,93.28571428571428,7,4087,6765.0,1514.0,583.8571428571429
299123.0,6,6,412,4,272,99707.66666666669,74.0,68.0,2,140,0.0,74.0,70.0
13953.0,6,2,145,2,145,0.0,91.0,72.5,0,0,0.0,0.0,0.0
2598476.0,6,2,132,1,66,0.0,66.0,66.0,1,66,0.0,66.0,66.0
2605.0,17,2,762,2,762,0.0,381.0,381.0,0,0,0.0,0.0,0.0
10515312.0,6,7,478,4,272,3457750.0,74.0,68.0,3,206,5186554.0,74.0,68.66666666666667
3567513.0,6,5,336,2,134,0.0,68.0,67.0,3,202,530793.5,70.0,67.33333333333333
90304106.0,6,20,1531,10,786,10028113.888888888,95.0,78.6,10,745,10002165.555555556,95.0,74.5
303126.0,6,2,132,1,66,0.0,66.0,66.0,1,66,0.0,66.0,66.0
299948.0,6,6,412,4,272,99982.66666666669,74.0,68.0,2,140,0.0,74.0,70.0
43368.0,6,12,1320,6,723,7949.8,253.0,120.5,6,597,7833.2,259.0,99.5
108108744.0,17,5,955,5,955,27027186.0,191.0,191.0,0,0,0.0,0.0,0.0
5398.0,17,4,344,2,150,0.0,75.0,75.0,2,194,0.0,103.0,97.0
3299478.0,6,7,923,4,753,1027825.0,571.0,188.25,3,170,1542049.0,62.0,56.66666666666666
303088.0,6,2,132,1,66,0.0,66.0,66.0,1,66,0.0,66.0,66.0
2319.0,17,4,344,2,150,0.0,75.0,75.0,2,194,0.0,103.0,97.0
16856.0,6,13,1459,7,862,2669.1666666666665,271.0,123.14285714285714,6,597,2884.4,259.0,99.5
301351.0,6,6,412,4,272,100450.33333333331,74.0,68.0,2,140,0.0,74.0,70.0
100189260.0,17,12,778,6,389,20037852.0,174.0,64.83333333333333,6,389,19903131.8,174.0,64.83333333333333
18269.0,6,11,1132,6,556,3282.6,218.0,92.66666666666669,5,576,4071.0,304.0,115.2
1032618.0,6,11,1134,6,558,206523.60000000003,220.0,93.0,5,576,257517.5,304.0,115.2
3009945.0,6,12,2172,7,664,501492.8333333333,252.0,94.85714285714286,5,1508,2315.25,1236.0,301.6
109138.0,17,2,286,2,286,0.0,143.0,143.0,0,0,0.0,0.0,0.0
205178.0,17,3,1143,3,1143,102589.0,381.0,381.0,0,0,0.0,0.0,0.0
209764.0,6,3,426,2,280,0.0,214.0,140.0,1,146,0.0,146.0,146.0
108107824.0,17,5,1005,5,1005,27026956.0,201.0,201.0,0,0,0.0,0.0,0.0
2279.0,17,2,691,1,349,0.0,349.0,349.0,1,342,0.0,342.0,342.0
183858.0,6,12,1254,6,648,36522.4,298.0,108.0,6,606,36477.8,260.0,101.0
228380.0,17,2,180,1,90,0.0,90.0,90.0,1,90,0.0,90.0,90.0
322435.0,17,4,1400,4,1400,107478.33333333331,350.0,350.0,0,0,0.0,0.0,0.0
108140919.0,17,5,1005,5,1005,27035229.75,201.0,201.0,0,0,0.0,0.0,0.0
308941.0,6,6,412,4,272,102980.33333333331,74.0,68.0,2,140,0.0,74.0,70.0
164991.0,17,2,414,1,88,0.0,88.0,88.0,1,326,0.0,326.0,326.0
1562476.0,6,2,132,1,66,0.0,66.0,66.0,1,66,0.0,66.0,66.0
135137935.0,17,6,1146,6,1146,27027587.0,191.0,191.0,0,0,0.0,0.0,0.0
813.0,17,4,438,2,148,0.0,74.0,74.0,2,290,0.0,147.0,145.0
49696.0,6,14,4740,7,653,7025.666666666667,249.0,93.28571428571428,7,4087,7214.5,1514.0,583.8571428571429
90761993.0,6,22,1680,12,935,8247235.909090909,95.0,77.91666666666667,10,745,10052362.333333334,95.0,74.5
307932.0,6,6,412,4,272,102644.0,74.0,68.0,2,140,0.0,74.0,70.0
46074.0,6,14,4740,7,653,6182.166666666667,249.0,93.28571428571428,7,4087,7456.833333333333,1514.0,583.8571428571429
213840.0,6,3,426,2,280,0.0,214.0,140.0,1,146,0.0,146.0,146.0
90047361.0,17,27,12943,27,12943,3463360.0384615385,501.0,479.3703703703704,0,0,0.0,0.0,0.0
2991539.0,6,2,132,1,66,0.0,66.0,66.0,1,66,0.0,66.0,66.0
35550.0,6,14,4740,7,653,5798.333333333333,249.0,93.28571428571428,7,4087,5694.666666666667,1514.0,583.8571428571429
146116.0,6,3,337,2,214,0.0,160.0,107.0,1,123,0.0,123.0,123.0
4322.0,17,2,602,1,72,0.0,72.0,72.0,1,530,0.0,530.0,530.0
104200050.0,6,191,21726,96,15234,1096842.6315789474,284.0,158.6875,95,6492,1102369.0638297873,140.0,68.33684210526316
4517.0,17,2,180,1,90,0.0,90.0,90.0,1,90,0.0,90.0,90.0
11525.0,6,10,2032,5,524,2446.75,252.0,104.8,5,1508,2421.0,1236.0,301.6
29057.0,6,14,4740,7,653,3959.5,249.0,93.28571428571428,7,4087,4657.666666666667,1514.0,583.8571428571429
285214.0,17,2,363,1,79,0.0,79.0,79.0,1,284,0.0,284.0,284.0
214696.0,6,10,1221,6,636,42939.2,298.0,106.0,4,585,70451.66666666667,379.0,146.25
312651.0,17,4,1400,4,1400,104217.0,350.0,350.0,0,0,0.0,0.0,0.0
2809926.0,6,2,132,1,66,0.0,66.0,66.0,1,66,0.0,66.0,66.0
102895.0,17,2,286,2,286,0.0,143.0,143.0,0,0,0.0,0.0,0.0
3045136.0,6,4,270,3,202,1522568.0,70.0,67.33333333333333,1,68,0.0,68.0,68.0
117959116.0,6,48,3168,24,1584,5128657.217391305,66.0,66.0,24,1584,5115237.565217392,66.0,66.0
16305.0,6,10,2032,5,524,3862.0,252.0,104.8,5,1508,3567.25,1236.0,301.6
90055206.0,17,28,13364,28,13364,3335378.0,501.0,477.2857142857143,0,0,0.0,0.0,0.0
1314551.0,6,4,264,2,132,0.0,66.0,66.0,2,132,0.0,66.0,66.0
2337.0,17,4,344,2,150,0.0,75.0,75.0,2,194,0.0,103.0,97.0
375.0,17,2,248,1,84,0.0,84.0,84.0,1,164,0.0,164.0,164.0
107392.0,17,2,286,2,286,0.0,143.0,143.0,0,0,0.0,0.0,0.0
38482.0,6,14,4740,7,653,6284.0,249.0,93.28571428571428,7,4087,5928.166666666667,1514.0,583.8571428571429
26489.0,6,10,2032,5,524,6400.5,252.0,104.8,5,1508,6044.75,1236.0,301.6
120000978.0,17,15,1169,8,606,17142996.85714286,174.0,75.75,7,563,17346935.333333332,174.0,80.42857142857143
0.0,6,1,66,1,66,0.0,66.0,66.0,0,0,0.0,0.0,0.0
847135.0,6,9,1196,6,725,169427.0,387.0,120.83333333333331,3,471,287309.0,331.0,157.0
2407.0,17,2,691,1,349,0.0,349.0,349.0,1,342,0.0,342.0,342.0
113163215.0,17,15,1431,7,694,18834044.83333333,174.0,99.14285714285714,8,737,16143471.0,174.0,92.125
10242.0,17,4,823,2,163,0.0,89.0,81.5,2,660,0.0,443.0,330.0
96127273.0,6,56,12199,30,6526,3314733.5517241377,1514.0,217.53333333333333,26,5673,3834491.84,1514.0,218.19230769230768
1432350.0,17,16,1120,16,1120,95490.0,70.0,70.0,0,0,0.0,0.0,0.0
410.0,17,2,166,1,75,0.0,75.0,75.0,1,91,0.0,91.0,91.0
2220.0,17,2,684,1,342,0.0,342.0,342.0,1,342,0.0,342.0,342.0
43952.0,6,14,4740,7,653,6960.5,249.0,93.28571428571428,7,4087,5171.166666666667,1514.0,583.8571428571429
72894.0,6,14,4740,7,653,11902.333333333334,249.0,93.28571428571428,7,4087,11836.666666666666,1514.0,583.8571428571429
27714.0,6,14,4740,7,653,3782.8333333333335,249.0,93.28571428571428,7,4087,4228.666666666667,1514.0,583.8571428571429
5619743.0,6,5,336,2,134,0.0,68.0,67.0,3,202,1521413.5,70.0,67.33333333333333
298390.0,6,11,1287,6,636,59678.0,298.0,106.0,5,651,73977.75,379.0,130.2
51832.0,6,10,2032,5,524,12737.75,252.0,104.8,5,1508,12449.0,1236.0,301.6
2287.0,17,4,344,2,150,0.0,75.0,75.0,2,194,0.0,103.0,97.0
3006898.0,6,11,2106,6,598,601188.2,252.0,99.66666666666669,5,1508,1647.5,1236.0,301.6
90916230.0,6,21,1585,11,840,9090484.8,95.0,76.36363636363636,10,745,10101456.222222222,95.0,74.5
121493288.0,6,229,25912,115,18092,1065730.596491228,284.0,157.3217391304348,114,7820,1056946.5309734512,140.0,68.59649122807018
125008877.0,17,15,907,8,475,17858411.0,174.0,59.375,7,432,17500189.666666668,174.0,61.71428571428572
1165825.0,6,13,3004,8,2376,166546.42857142858,1514.0,297.0,5,628,222544.25,331.0,125.6
120314349.0,6,301,35916,151,25794,802095.66,336.0,170.82119205298014,150,10122,802780.9463087248,140.0,67.48
20104.0,6,10,2032,5,524,4514.75,252.0,104.8,5,1508,3740.5,1236.0,301.6
49521.0,6,14,4740,7,653,7601.5,249.0,93.28571428571428,7,4087,8080.0,1514.0,583.8571428571429
30678.0,6,14,4740,7,653,4924.833333333333,249.0,93.28571428571428,7,4087,4530.166666666667,1514.0,583.8571428571429
90305425.0,6,17,1287,9,691,11280999.25,95.0,76.77777777777777,8,596,12899368.714285716,95.0,74.5
120000112.0,6,23,1775,13,1030,10000009.333333334,95.0,79.23076923076923,10,745,10159686.444444444,95.0,74.5
210872.0,6,10,1221,6,636,42174.4,298.0,106.0,4,585,69093.33333333333,379.0,146.25
2335.0,17,4,344,2,150,0.0,75.0,75.0,2,194,0.0,103.0,97.0
50070.0,6,10,2032,5,524,10469.75,252.0,104.8,5,1508,12225.75,1236.0,301.6
118326.0,17,4,1400,4,1400,39442.0,350.0,350.0,0,0,0.0,0.0,0.0
2796619.0,6,2,132,1,66,0.0,66.0,66.0,1,66,0.0,66.0,66.0
105004985.0,17,13,821,7,432,17500830.833333332,174.0,61.71428571428572,6,389,17000169.0,174.0,64.83333333333333
24316.0,6,10,1913,5,461,5814.25,233.0,92.2,5,1452,4813.25,1224.0,290.4
110934597.0,6,33,2428,17,1288,6919923.75,139.0,75.76470588235294,16,1140,7381249.733333333,123.0,71.25
112784.0,17,2,286,2,286,0.0,143.0,143.0,0,0,0.0,0.0,0.0
90278741.0,6,19,1436,10,745,10026136.555555556,95.0,74.5,9,691,11282776.0,95.0,76.77777777777777
150904.0,6,2,132,1,66,0.0,66.0,66.0,1,66,0.0,66.0,66.0
1491036.0,6,19,7533,10,1403,165670.66666666666,583.0,140.3,9,6130,154802.5,1484.0,681.1111111111111
113168267.0,6,46,3036,23,1518,5144000.727272728,66.0,66.0,23,1518,5143999.954545454,66.0,66.0
249975.0,17,4,6056,4,6056,83325.0,1514.0,1514.0,0,0,0.0,0.0,0.0
308343.0,6,6,412,4,272,102781.0,74.0,68.0,2,140,0.0,74.0,70.0
96571792.0,17,14,1126,7,563,16068614.0,174.0,80.42857142857143,7,563,16078725.0,174.0,80.42857142857143
1168022.0,6,13,3010,8,2382,166860.2857142857,1514.0,297.75,5,628,222872.25,331.0,125.6
12218.0,6,10,1065,5,534,2747.75,262.0,106.8,5,531,2720.25,259.0,106.2
16428.0,6,14,4740,7,653,2448.5,249.0,93.28571428571428,7,4087,2519.833333333333,1514.0,583.8571428571429
37268.0,6,14,4740,7,653,6084.0,249.0,93.28571428571428,7,4087,5749.666666666667,1514.0,583.8571428571429
322471.0,17,4,1400,4,1400,107490.33333333331,350.0,350.0,0,0,0.0,0.0,0.0
108751.0,17,2,286,2,286,0.0,143.0,143.0,0,0,0.0,0.0,0.0
301.0,17,2,164,1,82,0.0,82.0,82.0,1,82,0.0,82.0,82.0
120125862.0,6,14,2240,6,1224,24025172.4,204.0,204.0,8,1016,17136847.0,188.0,127.0
31624.0,6,14,4740,7,653,4249.833333333333,249.0,93.28571428571428,7,4087,5115.5,1514.0,583.8571428571429
207054.0,6,10,1221,6,636,41410.8,298.0,106.0,4,585,67550.66666666667,379.0,146.25
303680.0,6,2,132,1,66,0.0,66.0,66.0,1,66,0.0,66.0,66.0
18212.0,6,14,4740,7,653,2831.1666666666665,249.0,93.28571428571428,7,4087,2436.333333333333,1514.0,583.8571428571429
2046.0,17,4,344,2,150,0.0,75.0,75.0,2,194,0.0,103.0,97.0
90012580.0,17,28,13364,28,13364,3333799.25925926,501.0,477.2857142857143,0,0,0.0,0.0,0.0
10506035.0,6,7,478,4,272,3456650.333333333,74.0,68.0,3,206,5184853.0,74.0,68.66666666666667
42741.0,6,14,4740,7,653,6758.333333333333,249.0,93.28571428571428,7,4087,6985.833333333333,1514.0,583.8571428571429
56440.0,6,10,2032,5,524,13798.75,252.0,104.8,5,1508,13320.25,1236.0,301.6
322083.0,17,4,1400,4,1400,107361.0,350.0,350.0,0,0,0.0,0.0,0.0
3006021.0,6,12,2172,7,664,500862.3333333333,252.0,94.85714285714286,5,1508,2338.75,1236.0,301.6
2320.0,17,4,344,2,150,0.0,75.0,75.0,2,194,0.0,103.0,97.0
21175.0,6,10,2032,5,524,5027.25,252.0,104.8,5,1508,4560.75,1236.0,301.6
34230.0,6,10,2032,5,524,7121.0,252.0,104.8,5,1508,7096.75,1236.0,301.6
143897.0,17,2,180,1,90,0.0,90.0,90.0,1,90,0.0,90.0,90.0
104718.0,17,2,700,2,700,0.0,350.0,350.0,0,0,0.0,0.0,0.0
146307.0,6,3,337,2,214,0.0,160.0,107.0,1,123,0.0,123.0,123.0
10517387.0,6,7,478,4,272,3460622.333333333,74.0,68.0,3,206,5190815.5,74.0,68.66666666666667
120377054.0,6,217,24596,109,17246,1114602.351851852,284.0,158.22018348623854,108,7350,1114179.6074766356,140.0,68.05555555555556
135125437.0,17,6,1206,6,1206,27025087.4,201.0,201.0,0,0,0.0,0.0,0.0
299882.0,6,6,412,4,272,99960.66666666669,74.0,68.0,2,140,0.0,74.0,70.0
509832.0,17,2,192,1,88,0.0,88.0,88.0,1,104,0.0,104.0,104.0
4614.0,17,2,614,1,72,0.0,72.0,72.0,1,542,0.0,542.0,542.0
112904242.0,6,34,2350,17,1225,7043023.3125,139.0,72.05882352941177,17,1125,7043025.1875,123.0,66.17647058823529
2388.0,17,4,344,2,150,0.0,75.0,75.0,2,194,0.0,103.0,97.0
33840.0,6,10,2032,5,524,8249.0,252.0,104.8,5,1508,7819.25,1236.0,301.6
122863.0,6,3,373,2,238,0.0,172.0,119.0,1,135,0.0,135.0,135.0
113456257.0,6,46,3036,23,1518,5157086.681818182,66.0,66.0,23,1518,5157089.727272728,66.0,66.0
837.0,17,4,438,2,148,0.0,74.0,74.0,2,290,0.0,147.0,145.0
0.0,17,1,438,1,438,0.0,438.0,438.0,0,0,0.0,0.0,0.0
3008006.0,6,11,2106,6,598,601370.6,252.0,99.66666666666669,5,1508,1865.0,1236.0,301.6
120241395.0,6,284,33014,142,9668,846930.8794326241,140.0,68.08450704225352,142,23346,847537.7021276596,554.0,164.40845070422534
106419318.0,6,31,2314,15,1086,7601379.857142857,123.0,72.4,16,1228,6414545.0,139.0,76.75
54414.0,6,14,4740,7,653,8952.5,249.0,93.28571428571428,7,4087,8644.833333333334,1514.0,583.8571428571429
317241.0,6,6,412,4,272,105747.0,74.0,68.0,2,140,0.0,74.0,70.0
54703.0,6,14,4740,7,653,8134.0,249.0,93.28571428571428,7,4087,8514.666666666666,1514.0,583.8571428571429
90412951.0,6,13,1898,8,1016,12916135.857142856,188.0,127.0,5,882,22562280.0,204.0,176.4
290440.0,17,2,180,1,90,0.0,90.0,90.0,1,90,0.0,90.0,90.0
120022927.0,17,29,13785,29,13785,4286533.107142857,501.0,475.3448275862069,0,0,0.0,0.0,0.0
156012.0,17,2,414,1,88,0.0,88.0,88.0,1,326,0.0,326.0,326.0
100142831.0,17,11,604,6,389,20028566.2,174.0,64.83333333333333,5,215,20000875.0,43.0,43.0
309054.0,6,6,412,4,272,103018.0,74.0,68.0,2,140,0.0,74.0,70.0
347.0,17,2,160,1,80,0.0,80.0,80.0,1,80,0.0,80.0,80.0
302.0,17,2,164,1,82,0.0,82.0,82.0,1,82,0.0,82.0,82.0
206193.0,6,3,426,2,280,0.0,214.0,140.0,1,146,0.0,146.0,146.0
90050019.0,17,28,13364,28,13364,3335185.888888889,501.0,477.2857142857143,0,0,0.0,0.0,0.0
135122476.0,17,6,1146,6,1146,27024495.2,191.0,191.0,0,0,0.0,0.0,0.0
102858.0,17,2,286,2,286,0.0,143.0,143.0,0,0,0.0,0.0,0.0
108105423.0,17,5,1005,5,1005,27026355.75,201.0,201.0,0,0,0.0,0.0,0.0
90260743.0,6,12,1832,8,1016,12894391.857142856,188.0,127.0,4,816,30032174.666666668,204.0,204.0
2685927.0,6,3,1604,1,753,0.0,753.0,753.0,2,851,0.0,785.0,425.5
68065.0,6,14,4740,7,653,10866.166666666666,249.0,93.28571428571428,7,4087,10701.166666666666,1514.0,583.8571428571429
883693.0,6,10,1334,6,797,176738.6,459.0,132.83333333333334,4,537,202721.3333333333,331.0,134.25
108109475.0,17,5,955,5,955,27027368.75,191.0,191.0,0,0,0.0,0.0,0.0
143936.0,17,2,180,1,90,0.0,90.0,90.0,1,90,0.0,90.0,90.0
213357.0,17,2,180,1,90,0.0,90.0,90.0,1,90,0.0,90.0,90.0
160629.0,17,4,1400,4,1400,53543.0,350.0,350.0,0,0,0.0,0.0,0.0
309514.0,17,4,1400,4,1400,103171.33333333331,350.0,350.0,0,0,0.0,0.0,0.0
311633.0,6,3,202,2,128,0.0,74.0,64.0,1,74,0.0,74.0,74.0
35702.0,6,14,4740,7,653,5831.5,249.0,93.28571428571428,7,4087,5547.333333333333,1514.0,583.8571428571429
736.0,17,4,438,2,148,0.0,74.0,74.0,2,290,0.0,147.0,145.0
110961.0,17,2,762,2,762,0.0,381.0,381.0,0,0,0.0,0.0,0.0
200587.0,6,10,1221,6,636,40117.4,298.0,106.0,4,585,65662.66666666667,379.0,146.25
13707.0,6,14,4740,7,653,2094.6666666666665,249.0,93.28571428571428,7,4087,2143.833333333333,1514.0,583.8571428571429
404.0,17,2,410,1,78,0.0,78.0,78.0,1,332,0.0,332.0,332.0
115535624.0,6,34,2356,18,1285,6796213.176470588,139.0,71.38888888888889,16,1071,7022348.933333334,123.0,66.9375
110977705.0,6,35,2542,18,1348,6515392.352941177,139.0,74.88888888888889,17,1194,6922602.9375,123.0,70.23529411764706
135166888.0,17,6,1206,6,1206,27033377.6,201.0,201.0,0,0,0.0,0.0,0.0
218566.0,6,3,426,2,280,0.0,214.0,140.0,1,146,0.0,146.0,146.0
103233368.0,17,14,864,7,432,17167545.333333332,174.0,61.71428571428572,7,432,17166832.666666668,174.0,61.71428571428572
107858048.0,6,28,1860,14,966,8279336.307692308,123.0,69.0,14,894,8280143.0,123.0,63.85714285714285
90025607.0,17,27,12943,27,12943,3462523.346153846,501.0,479.3703703703704,0,0,0.0,0.0,0.0
196821.0,17,2,180,1,90,0.0,90.0,90.0,1,90,0.0,90.0,90.0
90294313.0,6,16,1192,8,596,12892619.714285716,95.0,74.5,8,596,12897754.42857143,95.0,74.5
1561.0,17,2,192,1,88,0.0,88.0,88.0,1,104,0.0,104.0,104.0
197846.0,17,2,180,1,90,0.0,90.0,90.0,1,90,0.0,90.0,90.0
90053069.0,17,28,13364,28,13364,3335298.851851852,501.0,477.2857142857143,0,0,0.0,0.0,0.0
116208078.0,17,14,864,7,432,19333487.166666668,174.0,61.71428571428572,7,432,19334342.83333333,174.0,61.71428571428572
108098104.0,17,5,1005,5,1005,27024526.0,201.0,201.0,0,0,0.0,0.0,0.0
135127941.0,17,6,1206,6,1206,27025588.2,201.0,201.0,0,0,0.0,0.0,0.0
323749.0,17,4,1400,4,1400,107916.33333333331,350.0,350.0,0,0,0.0,0.0,0.0
261566.00000000003,6,3,337,2,214,0.0,160.0,107.0,1,123,0.0,123.0,123.0
44523116.0,6,5,1738,2,821,0.0,753.0,410.5,3,917,20992262.0,785.0,305.6666666666667
308371.0,6,3,202,2,128,0.0,74.0,64.0,1,74,0.0,74.0,74.0
4582.0,17,2,180,1,90,0.0,90.0,90.0,1,90,0.0,90.0,90.0
108110225.0,17,5,955,5,955,27027556.25,191.0,191.0,0,0,0.0,0.0,0.0
298933.0,6,6,412,4,272,99644.33333333331,74.0,68.0,2,140,0.0,74.0,70.0
120153965.0,6,236,26644,118,8084,1019859.8717948718,140.0,68.50847457627118,118,18560,1019889.2991452992,284.0,157.28813559322035
319639.0,17,4,1400,4,1400,106546.33333333331,350.0,350.0,0,0,0.0,0.0,0.0
90309448.0,6,21,1585,11,840,9026010.3,95.0,76.36363636363636,10,745,9950693.888888888,95.0,74.5
170136.0,17,2,602,1,72,0.0,72.0,72.0,1,530,0.0,530.0,530.0
120700.0,17,2,180,1,70,0.0,70.0,70.0,1,110,0.0,110.0,110.0
113472217.0,6,46,3036,23,1518,5157816.318181818,66.0,66.0,23,1518,5157810.454545454,66.0,66.0
102514.0,17,2,286,2,286,0.0,143.0,143.0,0,0,0.0,0.0,0.0
211644.0,6,3,426,2,280,0.0,214.0,140.0,1,146,0.0,146.0,146.0
3373249.0,6,5,336,2,134,0.0,68.0,67.0,3,202,1423914.0,70.0,67.33333333333333
10523998.0,6,7,478,4,272,3460743.6666666665,74.0,68.0,3,206,5191008.0,74.0,68.66666666666667
338669.0,17,2,620,1,75,0.0,75.0,75.0,1,545,0.0,545.0,545.0
302229.0,6,6,412,4,272,100743.0,74.0,68.0,2,140,0.0,74.0,70.0
307333.0,6,6,412,4,272,102444.33333333331,74.0,68.0,2,140,0.0,74.0,70.0
120127826.0,6,15,2152,9,1204,15015978.25,188.0,133.77777777777777,6,948,18018914.2,204.0,158.0
90256101.0,6,12,1832,8,1016,12893728.714285716,188.0,127.0,4,816,30019380.666666668,204.0,204.0
2406.0,17,2,762,2,762,0.0,381.0,381.0,0,0,0.0,0.0,0.0
301163.0,6,6,412,4,272,100387.66666666669,74.0,68.0,2,140,0.0,74.0,70.0
110203659.0,6,199,22396,100,6822,1113168.2727272727,140.0,68.22,99,15574,1113976.704081633,284.0,157.31313131313132
108102851.0,17,5,955,5,955,27025712.75,191.0,191.0,0,0,0.0,0.0,0.0
2358.0,17,2,762,2,762,0.0,381.0,381.0,0,0,0.0,0.0,0.0
2574108.0,6,2,132,1,66,0.0,66.0,66.0,1,66,0.0,66.0,66.0
90302603.0,6,21,1585,11,840,9026192.1,95.0,76.36363636363636,10,745,10001968.333333334,95.0,74.5
108107708.0,17,5,955,5,955,27026927.0,191.0,191.0,0,0,0.0,0.0,0.0
306891.0,6,6,412,4,272,102297.0,74.0,68.0,2,140,0.0,74.0,70.0
20784.0,17,2,582,1,83,0.0,83.0,83.0,1,499,0.0,499.0,499.0
2510.0,17,4,344,2,150,0.0,75.0,75.0,2,194,0.0,103.0,97.0
198338.0,17,2,180,1,90,0.0,90.0,90.0,1,90,0.0,90.0,90.0
1427513.0,17,16,1120,16,1120,95167.53333333334,70.0,70.0,0,0,0.0,0.0,0.0
207225.0,6,3,426,2,280,0.0,214.0,140.0,1,146,0.0,146.0,146.0
120006873.0,6,1005,229010,490,33302,245412.8282208589,214.0,67.96326530612245,515,195708,233334.8171206225,1514.0,380.0155339805825
107314.0,17,2,700,2,700,0.0,350.0,350.0,0,0,0.0,0.0,0.0
282.0,17,2,174,1,79,0.0,79.0,79.0,1,95,0.0,95.0,95.0
1908.0,17,2,192,1,88,0.0,88.0,88.0,1,104,0.0,104.0,104.0
90255410.0,6,15,2444,8,1016,12893630.0,188.0,127.0,7,1428,15015067.166666666,204.0,204.0
229792.0,17,2,180,1,90,0.0,90.0,90.0,1,90,0.0,90.0,90.0
105239468.0,17,14,1126,7,563,17484176.833333332,174.0,80.42857142857143,7,563,17513225.166666668,174.0,80.42857142857143
4239.0,17,2,762,2,762,0.0,381.0,381.0,0,0,0.0,0.0,0.0
1108518.0,6,22,6566,12,1921,100774.36363636365,620.0,160.08333333333334,10,4645,102367.77777777778,1514.0,464.5
17883.0,6,11,1133,6,602,3351.2,264.0,100.33333333333331,5,531,3669.5,259.0,106.2
26997625.0,17,5,1718,4,1368,944431.3333333334,342.0,342.0,1,350,0.0,350.0,350.0
50083.0,6,14,4740,7,653,8208.333333333334,249.0,93.28571428571428,7,4087,6739.0,1514.0,583.8571428571429
6971.0,17,2,582,1,83,0.0,83.0,83.0,1,499,0.0,499.0,499.0
153375.0,17,2,180,1,90,0.0,90.0,90.0,1,90,0.0,90.0,90.0
12982.0,6,11,2098,6,590,2214.0,252.0,98.33333333333331,5,1508,2960.0,1236.0,301.6
72549.0,17,2,286,2,286,0.0,143.0,143.0,0,0,0.0,0.0,0.0
10520871.0,6,7,478,4,272,3461619.6666666665,74.0,68.0,3,206,5192318.5,74.0,68.66666666666667
143917.0,17,2,180,1,90,0.0,90.0,90.0,1,90,0.0,90.0,90.0
52539.0,6,14,4740,7,653,8437.833333333334,249.0,93.28571428571428,7,4087,8113.833333333333,1514.0,583.8571428571429
241827.0,6,3,337,2,214,0.0,160.0,107.0,1,123,0.0,123.0,123.0
90529676.0,6,13,2036,8,1016,12932810.857142856,188.0,127.0,5,1020,22591657.75,204.0,204.0
25998.0,6,14,4740,7,653,4212.333333333333,249.0,93.28571428571428,7,4087,4086.6666666666665,1514.0,583.8571428571429
108101756.0,17,5,1005,5,1005,27025439.0,201.0,201.0,0,0,0.0,0.0,0.0
0.0,17,1,453,1,453,0.0,453.0,453.0,0,0,0.0,0.0,0.0
135132115.0,17,6,1146,6,1146,27026423.0,191.0,191.0,0,0,0.0,0.0,0.0
99677594.0,17,14,1126,7,563,16586298.166666666,174.0,80.42857142857143,7,563,16590731.333333334,174.0,80.42857142857143
14209960.0,6,20,1648,10,1016,1546209.3333333333,315.0,101.6,10,632,1546183.2222222222,78.0,63.2
307732.0,6,6,412,4,272,102577.33333333331,74.0,68.0,2,140,0.0,74.0,70.0
32523.000000000004,6,10,2032,5,524,7911.0,252.0,104.8,5,1508,7832.25,1236.0,301.6
232037.0,6,10,1221,6,636,46407.4,298.0,106.0,4,585,75972.33333333333,379.0,146.25
302474.0,6,2,132,1,66,0.0,66.0,66.0,1,66,0.0,66.0,66.0
384.0,17,2,267,1,83,0.0,83.0,83.0,1,184,0.0,184.0,184.0
105074.0,6,13,1394,7,797,17512.333333333332,253.0,113.85714285714286,6,597,18727.6,259.0,99.5
47031.0,6,14,4740,7,653,7437.0,249.0,93.28571428571428,7,4087,7324.5,1514.0,583.8571428571429
12298.0,17,2,582,1,83,0.0,83.0,83.0,1,499,0.0,499.0,499.0
300.0,17,2,174,1,79,0.0,79.0,79.0,1,95,0.0,95.0,95.0
1171557.0,6,13,3020,8,2392,167365.2857142857,1514.0,299.0,5,628,223962.5,331.0,125.6
14644425.0,6,20,1607,10,975,1592158.4444444445,315.0,97.5,10,632,1592123.888888889,78.0,63.2
2125555.0,6,23,7479,12,2450,193232.2727272728,1034.0,204.16666666666663,11,5029,180894.8,1510.0,457.1818181818182
19489.0,17,2,539,1,86,0.0,86.0,86.0,1,453,0.0,453.0,453.0
90276397.0,6,15,1138,7,542,15046066.166666666,95.0,77.42857142857143,8,596,12855758.857142856,95.0,74.5
256857.0,6,10,1221,6,636,51371.4,298.0,106.0,4,585,79729.0,379.0,146.25
341.0,17,2,174,1,79,0.0,79.0,79.0,1,95,0.0,95.0,95.0
1041748.0,6,11,1134,6,558,208349.6,220.0,93.0,5,576,258376.75,304.0,115.2
113251772.0,6,46,3036,23,1518,5135436.7727272725,66.0,66.0,23,1518,5135302.545454546,66.0,66.0
3644.0,17,2,352,1,72,0.0,72.0,72.0,1,280,0.0,280.0,280.0
108105578.0,17,5,1005,5,1005,27026394.5,201.0,201.0,0,0,0.0,0.0,0.0
90010833.0,17,28,13364,28,13364,3333734.5555555555,501.0,477.2857142857143,0,0,0.0,0.0,0.0
106173.0,17,2,286,2,286,0.0,143.0,143.0,0,0,0.0,0.0,0.0
107451312.0,6,31,2166,16,1149,7149035.733333333,123.0,71.8125,15,1017,7659636.142857143,123.0,67.8
30974.0,6,14,4740,7,653,4772.833333333333,249.0,93.28571428571428,7,4087,4950.666666666667,1514.0,583.8571428571429
2357.0,17,4,344,2,150,0.0,75.0,75.0,2,194,0.0,103.0,97.0
32056.0,6,14,4740,7,653,5192.333333333333,249.0,93.28571428571428,7,4087,4272.5,1514.0,583.8571428571429
3366605.0,17,3,1026,3,1026,1683302.5,342.0,342.0,0,0,0.0,0.0,0.0
341.0,17,2,267,1,83,0.0,83.0,83.0,1,184,0.0,184.0,184.0
2126.0,17,4,344,2,150,0.0,75.0,75.0,2,194,0.0,103.0,97.0
50433.0,6,14,4740,7,653,7134.166666666667,249.0,93.28571428571428,7,4087,7487.833333333333,1514.0,583.8571428571429
106393905.0,6,32,2236,16,1165,7078526.066666666,139.0,72.8125,16,1071,7078524.4,123.0,66.9375
18468.0,6,14,4740,7,653,2677.0,249.0,93.28571428571428,7,4087,2905.0,1514.0,583.8571428571429
38853.0,6,2,145,2,145,0.0,91.0,72.5,0,0,0.0,0.0,0.0
972497.0,6,12,1362,6,731,192844.6,253.0,121.83333333333331,6,631,192841.6,293.0,105.16666666666669
45894.0,6,10,2032,5,524,11215.75,252.0,104.8,5,1508,10187.0,1236.0,301.6
105781.0,17,2,286,2,286,0.0,143.0,143.0,0,0,0.0,0.0,0.0
316013.0,17,4,1400,4,1400,105337.66666666669,350.0,350.0,0,0,0.0,0.0,0.0
50735.0,6,10,2032,5,524,12236.5,252.0,104.8,5,1508,10971.25,1236.0,301.6
114441075.0,6,47,3102,23,1518,5112001.7727272725,66.0,66.0,24,1584,4975688.043478261,66.0,66.0
234532.0,17,2,180,1,70,0.0,70.0,70.0,1,110,0.0,110.0,110.0
230390.0,6,13,1386,7,789,38398.333333333336,253.0,112.71428571428572,6,597,44163.4,259.0,99.5
100182650.0,17,14,1126,7,563,16667727.666666666,174.0,80.42857142857143,7,563,16666824.833333334,174.0,80.42857142857143
86172.0,6,12,1328,7,797,14362.0,253.0,113.85714285714286,5,531,19424.75,259.0,106.2
162506.0,17,2,180,1,90,0.0,90.0,90.0,1,90,0.0,90.0,90.0
90262713.0,6,16,2368,9,1204,11282839.125,188.0,133.77777777777777,7,1164,15015892.0,204.0,166.28571428571428
108150382.0,6,207,23576,104,16556,1050003.7087378642,284.0,159.19230769230768,103,7020,1050160.5196078431,140.0,68.15533980582525
1055391.0,6,11,1134,6,558,211078.2,220.0,93.0,5,576,262567.25,304.0,115.2
90006563.0,17,11,735,6,389,18001312.6,174.0,64.83333333333333,5,346,17500208.25,174.0,69.2
382.0,17,2,508,2,508,0.0,257.0,254.0,0,0,0.0,0.0,0.0
139123.0,17,4,344,2,150,0.0,75.0,75.0,2,194,0.0,103.0,97.0
590705.0,6,4,508,2,238,0.0,172.0,119.0,2,270,0.0,135.0,135.0
357.0,17,2,267,1,83,0.0,83.0,83.0,1,184,0.0,184.0,184.0
97298187.0,6,40,2640,20,1320,5120957.210526316,66.0,66.0,20,1320,5106463.842105263,66.0,66.0
316.0,17,2,174,1,79,0.0,79.0,79.0,1,95,0.0,95.0,95.0
343.0,17,2,174,1,79,0.0,79.0,79.0,1,95,0.0,95.0,95.0
2304.0,17,4,344,2,150,0.0,75.0,75.0,2,194,0.0,103.0,97.0
891982.0,6,12,2715,7,743,148663.66666666666,339.0,106.14285714285714,5,1972,154873.5,1514.0,394.4
9763.0,17,2,571,1,86,0.0,86.0,86.0,1,485,0.0,485.0,485.0
248981.0,6,3,337,2,214,0.0,160.0,107.0,1,123,0.0,123.0,123.0
2051413.0,17,6,1230,3,234,1025517.5,78.0,78.0,3,996,1025499.5,332.0,332.0
90288512.0,6,17,1287,8,637,12898358.857142856,95.0,79.625,9,650,11248818.625,95.0,72.22222222222223
135123716.0,17,6,1146,6,1146,27024743.2,191.0,191.0,0,0,0.0,0.0,0.0
216325.0,6,10,1221,6,636,43265.0,298.0,106.0,4,585,71074.66666666667,379.0,146.25
3001701.0,6,11,2106,6,598,600159.4,252.0,99.66666666666669,5,1508,1581.5,1236.0,301.6
41078.0,6,2,132,1,66,0.0,66.0,66.0,1,66,0.0,66.0,66.0
313739.0,17,4,1400,4,1400,104579.66666666669,350.0,350.0,0,0,0.0,0.0,0.0
408369.0,6,4,508,2,238,0.0,172.0,119.0,2,270,0.0,135.0,135.0
56457.0,6,10,2032,5,524,13897.0,252.0,104.8,5,1508,13853.25,1236.0,301.6
15042.0,6,13,1459,7,862,1913.6666666666667,271.0,123.14285714285714,6,597,2552.0,259.0,99.5
120289169.0,6,16,1233,8,637,17184167.0,95.0,79.625,8,596,17107638.285714287,95.0,74.5
3004368.0,6,11,2106,6,598,600707.4,252.0,99.66666666666669,5,1508,1728.0,1236.0,301.6
246960.0,6,3,373,2,238,0.0,172.0,119.0,1,135,0.0,135.0,135.0
103291.0,17,2,286,2,286,0.0,143.0,143.0,0,0,0.0,0.0,0.0
196984.0,17,2,180,1,90,0.0,90.0,90.0,1,90,0.0,90.0,90.0
160958.0,17,2,180,1,90,0.0,90.0,90.0,1,90,0.0,90.0,90.0
2439.0,17,4,344,2,150,0.0,75.0,75.0,2,194,0.0,103.0,97.0
263408.0,6,10,1221,6,636,52681.6,298.0,106.0,4,585,82411.0,379.0,146.25
9093.0,17,2,498,1,80,0.0,80.0,80.0,1,418,0.0,418.0,418.0
121972466.0,6,33,2434,18,1348,7174850.94117647,139.0,74.88888888888889,15,1086,7983613.214285715,123.0,72.4
2792941.0,6,2,132,1,66,0.0,66.0,66.0,1,66,0.0,66.0,66.0
1162595.0,6,13,3010,8,2382,166085.0,1514.0,297.75,5,628,222466.0,331.0,125.6
90322101.0,6,16,1192,8,596,12893105.42857143,95.0,74.5,8,596,12902279.42857143,95.0,74.5
0.0,17,1,453,1,453,0.0,453.0,453.0,0,0,0.0,0.0,0.0
485138.0,6,13,1386,7,789,80856.33333333333,253.0,112.71428571428572,6,597,94757.4,259.0,99.5
330.0,17,2,174,1,79,0.0,79.0,79.0,1,95,0.0,95.0,95.0
135134943.0,17,6,1206,6,1206,27026988.6,201.0,201.0,0,0,0.0,0.0,0.0
458.0,17,2,160,1,80,0.0,80.0,80.0,1,80,0.0,80.0,80.0
90071891.0,17,28,13364,28,13364,3335995.962962963,501.0,477.2857142857143,0,0,0.0,0.0,0.0
127817557.0,6,30,1974,15,948,8416625.57142857,123.0,63.2,15,1026,8416635.785714285,123.0,68.4
1314865.0,6,4,264,2,132,0.0,66.0,66.0,2,132,0.0,66.0,66.0
0.0,17,1,179,1,179,0.0,179.0,179.0,0,0,0.0,0.0,0.0
90259983.0,6,13,2036,8,1016,12894283.285714284,188.0,127.0,5,1020,22523395.0,204.0,204.0
2293.0,17,4,344,2,150,0.0,75.0,75.0,2,194,0.0,103.0,97.0
26162.0,17,2,582,1,83,0.0,83.0,83.0,1,499,0.0,499.0,499.0
4183.0,17,4,344,2,150,0.0,75.0,75.0,2,194,0.0,103.0,97.0
135142467.0,17,6,1206,6,1206,27028493.4,201.0,201.0,0,0,0.0,0.0,0.0
102915.0,17,2,286,2,286,0.0,143.0,143.0,0,0,0.0,0.0,0.0
90007506.0,17,28,13364,28,13364,3333611.333333333,501.0,477.2857142857143,0,0,0.0,0.0,0.0
120122128.0,6,13,2036,8,1016,17137167.0,188.0,127.0,5,1020,22522832.25,204.0,204.0
120303154.0,6,215,24358,108,17000,1124328.5420560748,284.0,157.40740740740742,107,7358,1126336.5,140.0,68.76635514018692
156835.0,6,3,337,2,214,0.0,160.0,107.0,1,123,0.0,123.0,123.0
108111715.0,17,5,955,5,955,27027928.75,191.0,191.0,0,0,0.0,0.0,0.0
135124937.0,17,6,1146,6,1146,27024987.4,191.0,191.0,0,0,0.0,0.0,0.0
108116550.0,17,5,1005,5,1005,27029137.5,201.0,201.0,0,0,0.0,0.0,0.0
117832155.0,6,37,2788,19,1471,6546230.833333333,139.0,77.42105263157895,18,1317,6918571.176470588,123.0,73.16666666666667
121202067.0,6,222,25106,111,7548,1087078.6,140.0,68.0,111,17558,1094500.8818181818,284.0,158.18018018018017
163585.0,6,3,337,2,214,0.0,160.0,107.0,1,123,0.0,123.0,123.0
40076.0,6,14,4740,7,653,6489.666666666667,249.0,93.28571428571428,7,4087,6269.5,1514.0,583.8571428571429
75736.0,6,11,2098,6,590,15019.4,252.0,98.33333333333331,5,1508,17432.0,1236.0,301.6
218352.0,17,2,180,1,90,0.0,90.0,90.0,1,90,0.0,90.0,90.0
69023.0,6,14,4740,7,653,10541.166666666666,249.0,93.28571428571428,7,4087,11322.5,1514.0,583.8571428571429
248592.0,6,3,426,2,280,0.0,214.0,140.0,1,146,0.0,146.0,146.0
214597.0,6,12,1373,7,714,35766.166666666664,298.0,102.0,5,659,52679.5,379.0,131.8
90092626.0,6,10,1440,7,828,15015437.666666666,188.0,118.28571428571428,3,612,30029991.0,204.0,204.0
302363.0,6,2,132,1,66,0.0,66.0,66.0,1,66,0.0,66.0,66.0
196893.0,17,2,180,1,90,0.0,90.0,90.0,1,90,0.0,90.0,90.0
34883.0,6,14,4740,7,653,4348.0,249.0,93.28571428571428,7,4087,5361.166666666667,1514.0,583.8571428571429
90259105.0,6,13,2036,8,1016,12894157.857142856,188.0,127.0,5,1020,22521321.5,204.0,204.0
90527777.0,6,17,2572,9,1204,11315972.125,188.0,133.77777777777777,8,1368,12908889.857142856,204.0,171.0
3994065.0,17,4,1368,4,1368,1331355.0,342.0,342.0,0,0,0.0,0.0,0.0
305.0,17,2,174,1,79,0.0,79.0,79.0,1,95,0.0,95.0,95.0
24983.0,6,14,4740,7,653,3580.0,249.0,93.28571428571428,7,4087,3881.5,1514.0,583.8571428571429
1793.0,17,2,176,1,80,0.0,80.0,80.0,1,96,0.0,96.0,96.0
32868.0,6,10,2032,5,524,6156.5,252.0,104.8,5,1508,7963.5,1236.0,301.6
362.0,17,2,204,1,88,0.0,88.0,88.0,1,116,0.0,116.0,116.0
90064418.0,17,28,13364,28,13364,3335719.185185185,501.0,477.2857142857143,0,0,0.0,0.0,0.0
146.0,17,2,700,2,700,0.0,350.0,350.0,0,0,0.0,0.0,0.0
100860739.0,6,27,1816,14,894,7758518.384615385,123.0,63.85714285714285,13,922,7789976.083333333,139.0,70.92307692307692
0.0,17,1,161,1,161,0.0,161.0,161.0,0,0,0.0,0.0,0.0
108506557.0,6,32,2220,16,1149,7219369.133333334,123.0,71.8125,16,1071,7219367.466666667,123.0,66.9375
316.0,17,2,174,1,79,0.0,79.0,79.0,1,95,0.0,95.0,95.0
217760.0,6,3,426,2,280,0.0,214.0,140.0,1,146,0.0,146.0,146.0
117804.0,6,14,4740,7,653,19385.0,249.0,93.28571428571428,7,4087,18255.83333333333,1514.0,583.8571428571429
323302.0,17,4,1400,4,1400,107767.33333333331,350.0,350.0,0,0,0.0,0.0,0.0
103739.0,17,2,286,2,286,0.0,143.0,143.0,0,0,0.0,0.0,0.0
14315.0,6,10,2032,5,524,3331.25,252.0,104.8,5,1508,3221.5,1236.0,301.6
120130212.0,6,14,2224,9,1204,15016276.5,188.0,133.77777777777777,5,1020,22526310.5,204.0,204.0
978695.0,6,12,1354,6,723,194464.4,253.0,120.5,6,631,194771.0,293.0,105.16666666666669
16381.0,6,14,4740,7,653,2482.833333333333,249.0,93.28571428571428,7,4087,2595.833333333333,1514.0,583.8571428571429
118902384.0,6,34,2350,17,1225,7431399.0,139.0,72.05882352941177,17,1125,7417495.6875,123.0,66.17647058823529
1642417.0,17,2,876,2,876,0.0,438.0,438.0,0,0,0.0,0.0,0.0
318807.0,17,4,1400,4,1400,106269.0,350.0,350.0,0,0,0.0,0.0,0.0
1956.0,17,2,932,1,590,0.0,590.0,590.0,1,342,0.0,342.0,342.0
5833980.0,6,5,336,2,134,0.0,68.0,67.0,3,202,1520774.0,70.0,67.33333333333333
90298208.0,6,16,1192,8,596,12892708.714285716,95.0,74.5,8,596,12898822.0,95.0,74.5
10898888.0,6,8,544,4,272,3585731.333333333,74.0,68.0,4,272,3585653.6666666665,74.0,68.0
207455.0,6,3,426,2,280,0.0,214.0,140.0,1,146,0.0,146.0,146.0
90299215.0,6,18,1341,9,691,11287401.875,95.0,76.77777777777777,9,650,11249567.625,95.0,72.22222222222223
107011.0,17,2,286,2,286,0.0,143.0,143.0,0,0,0.0,0.0,0.0
153436.0,17,2,180,1,90,0.0,90.0,90.0,1,90,0.0,90.0,90.0
3046815.0,6,4,270,3,202,1523407.5,70.0,67.33333333333333,1,68,0.0,68.0,68.0
148009.0,17,2,180,1,90,0.0,90.0,90.0,1,90,0.0,90.0,90.0
2346.0,17,4,344,2,150,0.0,75.0,75.0,2,194,0.0,103.0,97.0
57907.0,6,10,2032,5,524,14224.75,252.0,104.8,5,1508,13906.75,1236.0,301.6
117578519.0,6,210,23658,105,16494,1128493.5,284.0,157.0857142857143,105,7164,1128492.9423076925,140.0,68.22857142857143
135126055.0,17,6,1146,6,1146,27025211.0,191.0,191.0,0,0,0.0,0.0,0.0
3005151.0,6,2,132,1,66,0.0,66.0,66.0,1,66,0.0,66.0,66.0
5624383.0,6,5,336,2,134,0.0,68.0,67.0,3,202,1423615.0,70.0,67.33333333333333
116380762.0,6,48,3168,24,1584,5060033.130434782,66.0,66.0,24,1584,5046574.304347826,66.0,66.0
35628.0,6,14,4740,7,653,5769.666666666667,249.0,93.28571428571428,7,4087,5790.5,1514.0,583.8571428571429
2893.0,17,2,224,1,76,0.0,76.0,76.0,1,148,0.0,148.0,148.0
208044.0,6,3,426,2,280,0.0,214.0,140.0,1,146,0.0,146.0,146.0
0.0,17,1,44,1,44,0.0,44.0,44.0,0,0,0.0,0.0,0.0
206035.0,17,2,180,1,90,0.0,90.0,90.0,1,90,0.0,90.0,90.0
196925.0,17,2,180,1,90,0.0,90.0,90.0,1,90,0.0,90.0,90.0
0.0,17,1,381,1,381,0.0,381.0,381.0,0,0,0.0,0.0,0.0
108121221.0,17,5,1005,5,1005,27030305.25,201.0,201.0,0,0,0.0,0.0,0.0
90281360.0,6,16,1192,8,596,12891645.142857144,95.0,74.5,8,596,12895651.285714284,95.0,74.5
82911467.0,17,15,5138,14,4788,5883215.076923077,342.0,342.0,1,350,0.0,350.0,350.0
2797507.0,6,2,132,1,66,0.0,66.0,66.0,1,66,0.0,66.0,66.0
31228765.0,6,26,7627,14,3735,187446.92307692303,1514.0,266.7857142857143,12,3892,2820269.727272727,1514.0,324.3333333333333
108130305.0,17,5,1005,5,1005,27032576.25,201.0,201.0,0,0,0.0,0.0,0.0
3343.0,17,2,382,1,88,0.0,88.0,88.0,1,294,0.0,294.0,294.0
2032.0,17,4,344,2,150,0.0,75.0,75.0,2,194,0.0,103.0,97.0
317636.0,17,4,1400,4,1400,105878.66666666669,350.0,350.0,0,0,0.0,0.0,0.0
312476.0,6,6,412,4,272,104158.66666666669,74.0,68.0,2,140,0.0,74.0,70.0
98225.0,17,2,286,2,286,0.0,143.0,143.0,0,0,0.0,0.0,0.0
120166205.0,6,204,23362,102,7028,1181499.8514851483,140.0,68.90196078431373,102,16334,1181984.524752475,284.0,160.13725490196077
10922.0,6,10,2032,5,524,2451.5,252.0,104.8,5,1508,1927.0,1236.0,301.6
8951.0,17,2,582,1,83,0.0,83.0,83.0,1,499,0.0,499.0,499.0
2743.0,17,4,344,2,150,0.0,75.0,75.0,2,194,0.0,103.0,97.0
10460051.0,6,7,478,4,272,3441265.6666666665,74.0,68.0,3,206,5161777.0,74.0,68.66666666666667
243470.0,6,3,337,2,214,0.0,160.0,107.0,1,123,0.0,123.0,123.0
2007.0,17,4,344,2,150,0.0,75.0,75.0,2,194,0.0,103.0,97.0
2543.0,17,2,180,1,90,0.0,90.0,90.0,1,90,0.0,90.0,90.0
2482595.0,6,28,12477,15,4556,177328.2142857143,1510.0,303.7333333333333,13,7921,174250.0,1510.0,609.3076923076923
323402.0,6,6,544,3,350,81697.0,210.0,116.66666666666669,3,194,81706.0,74.0,64.66666666666667
90038493.0,17,28,13364,28,13364,3334759.0,501.0,477.2857142857143,0,0,0.0,0.0,0.0
105796516.0,6,194,21870,97,6624,1093490.875,140.0,68.28865979381443,97,15246,1093495.3854166667,284.0,157.17525773195877
93947469.0,6,26,1762,13,922,7810958.833333333,139.0,70.92307692307692,13,840,7810966.833333333,123.0,64.61538461538461
716.0,17,4,438,2,148,0.0,74.0,74.0,2,290,0.0,147.0,145.0
146122.0,6,3,337,2,214,0.0,160.0,107.0,1,123,0.0,123.0,123.0
308925.0,6,7,478,4,272,102975.0,74.0,68.0,3,206,78341.5,74.0,68.66666666666667
284169.0,17,2,363,1,79,0.0,79.0,79.0,1,284,0.0,284.0,284.0
90058631.0,17,28,13364,28,13364,3335504.851851852,501.0,477.2857142857143,0,0,0.0,0.0,0.0
13645769.0,6,20,1648,10,1016,1479126.7777777778,315.0,101.6,10,632,1479071.4444444445,78.0,63.2
146161.0,6,3,337,2,214,0.0,160.0,107.0,1,123,0.0,123.0,123.0
13179.0,17,2,180,1,90,0.0,90.0,90.0,1,90,0.0,90.0,90.0
2321.0,17,4,344,2,150,0.0,75.0,75.0,2,194,0.0,103.0,97.0
63119.99999999999,6,14,4740,7,653,10325.5,249.0,93.28571428571428,7,4087,10318.166666666666,1514.0,583.8571428571429
44008175.0,6,7,2047,5,1153,11002043.75,885.0,230.6,2,894,0.0,826.0,447.0
100337928.0,17,12,778,6,389,19983503.0,174.0,64.83333333333333,6,389,20035805.6,174.0,64.83333333333333
103081.0,17,2,286,2,286,0.0,143.0,143.0,0,0,0.0,0.0,0.0
34848.0,17,2,582,1,83,0.0,83.0,83.0,1,499,0.0,499.0,499.0
232586.0,6,3,337,2,214,0.0,160.0,107.0,1,123,0.0,123.0,123.0
4113.0,17,2,582,1,83,0.0,83.0,83.0,1,499,0.0,499.0,499.0
120034880.0,6,22,1693,11,799,11999443.5,95.0,72.63636363636364,11,894,11998870.1,153.0,81.27272727272727
1307196.0,17,2,363,1,79,0.0,79.0,79.0,1,284,0.0,284.0,284.0
233354.0,6,11,1131,6,600,46375.8,262.0,100.0,5,531,3219.25,259.0,106.2
108960.0,17,2,286,2,286,0.0,143.0,143.0,0,0,0.0,0.0,0.0
103006233.0,17,13,821,7,432,17167705.5,174.0,61.71428571428572,6,389,16600161.6,174.0,64.83333333333333
9368556.0,17,3,1034,2,684,0.0,342.0,342.0,1,350,0.0,350.0,350.0
901625.0,6,10,1335,6,798,180325.0,460.0,133.0,4,537,208616.0,331.0,134.25
13251.0,6,13,1459,7,862,1999.8333333333333,271.0,123.14285714285714,6,597,2489.8,259.0,99.5
304570.0,6,6,412,4,272,101523.33333333331,74.0,68.0,2,140,0.0,74.0,70.0
1400352.0,17,16,1120,16,1120,93356.8,70.0,70.0,0,0,0.0,0.0,0.0
0.0,17,1,72,1,72,0.0,72.0,72.0,0,0,0.0,0.0,0.0
119911646.0,17,18,8154,18,8154,7053626.235294118,453.0,453.0,0,0,0.0,0.0,0.0
104992577.0,6,962,205362,486,173206,216035.54845360824,1514.0,356.3909465020576,476,32156,220583.6168421053,214.0,67.5546218487395
116771887.0,6,48,3168,24,1584,5077038.565217392,66.0,66.0,24,1584,5065193.608695652,66.0,66.0
218355.0,6,3,426,2,280,0.0,214.0,140.0,1,146,0.0,146.0,146.0
26411.0,6,10,1065,5,534,6190.5,262.0,106.8,5,531,6019.25,259.0,106.2
3581927.0,6,5,336,2,134,0.0,68.0,67.0,3,202,1526072.5,70.0,67.33333333333333
213816.0,6,3,426,2,280,0.0,214.0,140.0,1,146,0.0,146.0,146.0
26432.0,6,10,2032,5,524,6171.5,252.0,104.8,5,1508,5982.5,1236.0,301.6
0.0,17,1,55,1,55,0.0,55.0,55.0,0,0,0.0,0.0,0.0
116487285.0,6,201,22820,101,15998,1164872.85,284.0,158.3960396039604,100,6822,1157303.535353535,140.0,68.22
22909.0,6,11,2098,6,590,4211.0,252.0,98.33333333333331,5,1508,4980.25,1236.0,301.6
70170.0,6,14,4740,7,653,4503.5,249.0,93.28571428571428,7,4087,11517.333333333334,1514.0,583.8571428571429
209210.0,6,3,426,2,280,0.0,214.0,140.0,1,146,0.0,146.0,146.0
108118794.0,17,5,955,5,955,27029698.5,191.0,191.0,0,0,0.0,0.0,0.0
209660.0,6,3,426,2,280,0.0,214.0,140.0,1,146,0.0,146.0,146.0
166959.0,17,4,704,2,148,0.0,74.0,74.0,2,556,0.0,280.0,278.0
130411.0,6,2,132,1,66,0.0,66.0,66.0,1,66,0.0,66.0,66.0
105007086.0,17,13,821,7,432,17501181.0,174.0,61.71428571428572,6,389,17000161.2,174.0,64.83333333333333
65011.0,6,14,4740,7,653,10177.333333333334,249.0,93.28571428571428,7,4087,10365.166666666666,1514.0,583.8571428571429
1305997.0,17,7,490,7,490,217666.16666666663,70.0,70.0,0,0,0.0,0.0,0.0
205129.0,17,2,762,2,762,0.0,381.0,381.0,0,0,0.0,0.0,0.0
871103.0,17,2,620,1,75,0.0,75.0,75.0,1,545,0.0,545.0,545.0
0.0,17,1,381,1,381,0.0,381.0,381.0,0,0,0.0,0.0,0.0
3282180.0,6,3,1604,2,851,0.0,785.0,425.5,1,753,0.0,753.0,753.0
742.0,17,4,438,2,148,0.0,74.0,74.0,2,290,0.0,147.0,145.0
308.0,17,2,160,1,80,0.0,80.0,80.0,1,80,0.0,80.0,80.0
350.0,17,2,160,1,80,0.0,80.0,80.0,1,80,0.0,80.0,80.0
102055624.0,6,223,25134,112,7614,919420.036036036,140.0,67.98214285714286,111,17520,918344.1545454544,284.0,157.83783783783784
2381.0,17,4,344,2,150,0.0,75.0,75.0,2,194,0.0,103.0,97.0
36381.0,6,14,4740,7,653,5905.666666666667,249.0,93.28571428571428,7,4087,5844.5,1514.0,583.8571428571429
90743333.0,6,19,1436,10,745,10077916.222222222,95.0,74.5,9,691,11341254.0,95.0,76.77777777777777
307629.0,6,6,412,4,272,102543.0,74.0,68.0,2,140,0.0,74.0,70.0
119347386.0,6,249,28222,125,19742,962478.9193548388,284.0,157.936,124,8480,962195.5040650406,140.0,68.38709677419355
52600.0,6,14,4740,7,653,8206.833333333334,249.0,93.28571428571428,7,4087,5610.0,1514.0,583.8571428571429
207738.0,6,3,426,2,280,0.0,214.0,140.0,1,146,0.0,146.0,146.0
1248064.0,6,7,499,4,301,390245.3333333333,103.0,75.25,3,198,613983.5,66.0,66.0
0.0,17,1,381,1,381,0.0,381.0,381.0,0,0,0.0,0.0,0.0
27361296.0,17,5,1710,5,1710,6840324.0,342.0,342.0,0,0,0.0,0.0,0.0
90045529.0,17,28,13364,28,13364,3335019.592592593,501.0,477.2857142857143,0,0,0.0,0.0,0.0
8796.0,17,6,1230,3,234,4213.0,78.0,78.0,3,996,4164.0,332.0,332.0
34632.0,6,14,4740,7,653,4892.333333333333,249.0,93.28571428571428,7,4087,5586.333333333333,1514.0,583.8571428571429
14638.0,6,11,2098,6,590,2394.4,252.0,98.33333333333331,5,1508,3373.75,1236.0,301.6
38621.0,6,14,4740,7,653,5017.833333333333,249.0,93.28571428571428,7,4087,6150.666666666667,1514.0,583.8571428571429
4322.0,17,2,626,1,72,0.0,72.0,72.0,1,554,0.0,554.0,554.0
289065.0,17,2,180,1,90,0.0,90.0,90.0,1,90,0.0,90.0,90.0
15095.0,17,2,180,1,90,0.0,90.0,90.0,1,90,0.0,90.0,90.0
828250.0,6,9,1118,6,586,165650.0,248.0,97.66666666666669,3,532,277754.5,392.0,177.33333333333334
14465.0,6,10,2032,5,524,2597.0,252.0,104.8,5,1508,3219.25,1236.0,301.6
32381.0,6,14,4740,7,653,5277.333333333333,249.0,93.28571428571428,7,4087,5212.5,1514.0,583.8571428571429
2440.0,17,4,344,2,150,0.0,75.0,75.0,2,194,0.0,103.0,97.0
41221.0,6,14,4740,7,653,6710.666666666667,249.0,93.28571428571428,7,4087,5702.166666666667,1514.0,583.8571428571429
98068210.0,6,171,19362,86,13530,1153743.6470588236,284.0,157.32558139534885,85,5832,1155120.880952381,140.0,68.61176470588235
242419.0,6,3,337,2,214,0.0,160.0,107.0,1,123,0.0,123.0,123.0
5623995.0,6,5,336,2,134,0.0,68.0,67.0,3,202,1424804.5,70.0,67.33333333333333
2599616.0,6,2,132,1,66,0.0,66.0,66.0,1,66,0.0,66.0,66.0
326.0,17,2,166,1,75,0.0,75.0,75.0,1,91,0.0,91.0,91.0
120016643.0,17,15,907,8,475,17145234.714285713,174.0,59.375,7,432,19945612.5,174.0,61.71428571428572
1856181.0,6,7,499,3,198,920755.0,66.0,66.0,4,301,558056.0,103.0,75.25
3175574.0,6,17,1441,8,867,409556.28571428574,315.0,108.375,9,574,358364.625,78.0,63.77777777777778
1027334.0,6,11,1134,6,558,205466.8,220.0,93.0,5,576,254366.25,304.0,115.2
197750.0,17,2,180,1,90,0.0,90.0,90.0,1,90,0.0,90.0,90.0
135128565.0,17,6,1146,6,1146,27025713.0,191.0,191.0,0,0,0.0,0.0,0.0
2519809.0,6,25,7573,14,3735,193831.4615384616,1514.0,266.7857142857143,11,3838,226984.6,1514.0,348.90909090909093
90045943.0,17,27,12943,27,12943,3463305.5,501.0,479.3703703703704,0,0,0.0,0.0,0.0
119524242.0,6,224,25200,112,17512,1074941.189189189,284.0,156.35714285714286,112,7688,1074946.8288288289,140.0,68.64285714285714
100148179.0,17,12,778,6,389,20029635.8,174.0,64.83333333333333,6,389,19947523.2,174.0,64.83333333333333
2348.0,17,4,344,2,150,0.0,75.0,75.0,2,194,0.0,103.0,97.0
0.0,6,1,172,1,172,0.0,172.0,172.0,0,0,0.0,0.0,0.0
0.0,17,1,80,1,80,0.0,80.0,80.0,0,0,0.0,0.0,0.0
2860018.0,6,12,2172,7,664,476566.5,252.0,94.85714285714286,5,1508,1945.5,1236.0,301.6
1044517.0,6,13,1394,7,797,174086.16666666666,253.0,113.85714285714286,6,597,207079.8,259.0,99.5
1988.0,17,4,344,2,150,0.0,75.0,75.0,2,194,0.0,103.0,97.0
193666.0,17,4,1524,4,1524,64555.333333333336,381.0,381.0,0,0,0.0,0.0,0.0
235971.0,17,2,359,1,75,0.0,75.0,75.0,1,284,0.0,284.0,284.0
120260710.0,6,206,23202,103,7094,1160812.4019607843,140.0,68.87378640776699,103,16108,1170992.2843137255,284.0,156.38834951456312
310669.0,17,4,1400,4,1400,103556.33333333331,350.0,350.0,0,0,0.0,0.0,0.0
833.0,17,4,438,2,148,0.0,74.0,74.0,2,290,0.0,147.0,145.0
302.0,17,2,156,1,78,0.0,78.0,78.0,1,78,0.0,78.0,78.0
90257407.0,6,12,1832,8,1016,12893915.285714284,188.0,127.0,4,816,30030962.33333333,204.0,204.0
41241.0,6,10,2032,5,524,7676.25,252.0,104.8,5,1508,9690.75,1236.0,301.6
295221.0,6,10,1221,6,636,59044.2,298.0,106.0,4,585,92959.33333333331,379.0,146.25
27390.0,6,14,4740,7,653,4083.0,249.0,93.28571428571428,7,4087,4409.666666666667,1514.0,583.8571428571429
108717874.0,6,32,2220,16,1149,7247858.266666667,123.0,71.8125,16,1071,7234190.066666666,123.0,66.9375
197677.0,17,2,180,1,90,0.0,90.0,90.0,1,90,0.0,90.0,90.0
241779.0,6,3,337,2,214,0.0,160.0,107.0,1,123,0.0,123.0,123.0
115972191.0,6,48,3168,24,1584,5042269.173913044,66.0,66.0,24,1584,5032871.434782608,66.0,66.0
2304.0,17,2,762,2,762,0.0,381.0,381.0,0,0,0.0,0.0,0.0
0.0,6,1,54,0,0,0.0,0.0,0.0,1,54,0.0,54.0,54.0
90260224.0,6,13,2036,8,1016,12894317.714285716,188.0,127.0,5,1020,22522772.0,204.0,204.0
90622122.0,6,26,1746,13,906,7533854.583333333,123.0,69.6923076923077,13,840,7533837.083333333,123.0,64.61538461538461
301937.0,6,6,412,4,272,100645.66666666669,74.0,68.0,2,140,0.0,74.0,70.0
1176892.0,6,13,3020,8,2392,168127.42857142858,1514.0,299.0,5,628,225276.5,331.0,125.6
108112951.0,17,5,1005,5,1005,27028237.75,201.0,201.0,0,0,0.0,0.0,0.0
209569.0,17,2,180,1,90,0.0,90.0,90.0,1,90,0.0,90.0,90.0
216435.0,6,3,426,2,280,0.0,214.0,140.0,1,146,0.0,146.0,146.0
48110.0,6,14,4740,7,653,7896.833333333333,249.0,93.28571428571428,7,4087,6244.166666666667,1514.0,583.8571428571429
361087.0,6,11,1021,6,444,48516.0,162.0,74.0,5,577,60442.5,349.0,115.4
317050.0,17,4,1400,4,1400,105683.33333333331,350.0,350.0,0,0,0.0,0.0,0.0
119846937.0,6,15,2306,6,1224,23968920.0,204.0,204.0,9,1082,14980708.0,188.0,120.22222222222224
50512.0,6,14,4740,7,653,8249.5,249.0,93.28571428571428,7,4087,8262.166666666666,1514.0,583.8571428571429
93377763.0,6,18,1499,9,849,11671915.625,253.0,94.33333333333331,9,650,11670762.5,95.0,72.22222222222223
2597914.0,6,2,132,1,66,0.0,66.0,66.0,1,66,0.0,66.0,66.0
146106.0,6,3,337,2,214,0.0,160.0,107.0,1,123,0.0,123.0,123.0
108108999.0,17,5,1005,5,1005,27027249.75,201.0,201.0,0,0,0.0,0.0,0.0
13163.0,6,11,1133,6,602,2251.4,264.0,100.33333333333331,5,531,2566.25,259.0,106.2
57563.0,6,10,2032,5,524,11614.5,252.0,104.8,5,1508,13261.0,1236.0,301.6
306852.0,6,6,412,4,272,102284.0,74.0,68.0,2,140,0.0,74.0,70.0
103121.0,17,2,286,2,286,0.0,143.0,143.0,0,0,0.0,0.0,0.0
10487442.0,6,7,478,4,272,3450605.333333333,74.0,68.0,3,206,5175819.5,74.0,68.66666666666667
206187.0,6,3,426,2,280,0.0,214.0,140.0,1,146,0.0,146.0,146.0
118236154.0,6,37,2656,19,1408,6557316.111111111,139.0,74.10526315789474,18,1248,6943040.411764706,123.0,69.33333333333333
90292724.0,6,19,1436,10,745,10027221.666666666,95.0,74.5,9,691,11285056.0,95.0,76.77777777777777
108102165.0,17,5,955,5,955,27025541.25,191.0,191.0,0,0,0.0,0.0,0.0
109318571.0,6,214,24090,107,16732,1029378.1226415094,284.0,156.37383177570092,107,7358,1029375.2547169812,140.0,68.76635514018692
147212.0,6,3,373,2,238,0.0,172.0,119.0,1,135,0.0,135.0,135.0
56123.0,6,10,2032,5,524,13716.25,252.0,104.8,5,1508,12956.25,1236.0,301.6
100030446.0,17,14,864,7,432,16666808.5,174.0,61.71428571428572,7,432,16667382.833333334,174.0,61.71428571428572
298535.0,6,6,412,4,272,99511.66666666669,74.0,68.0,2,140,0.0,74.0,70.0
120067124.0,17,29,13785,29,13785,4288111.571428572,501.0,475.3448275862069,0,0,0.0,0.0,0.0
908278.0,6,12,2711,7,743,151379.66666666666,339.0,106.14285714285714,5,1968,158156.0,1514.0,393.6
48063.0,6,14,4740,7,653,6558.0,249.0,93.28571428571428,7,4087,6951.333333333333,1514.0,583.8571428571429
108103697.0,17,5,955,5,955,27025924.25,191.0,191.0,0,0,0.0,0.0,0.0
2777508.0,6,2,132,1,66,0.0,66.0,66.0,1,66,0.0,66.0,66.0
90025065.0,17,28,13364,28,13364,3334261.6666666665,501.0,477.2857142857143,0,0,0.0,0.0,0.0
120027538.0,17,13,952,7,563,20004589.666666668,174.0,80.42857142857143,6,389,20145035.8,174.0,64.83333333333333
90204700.0,6,16,1192,8,596,12852193.714285716,95.0,74.5,8,596,12857140.285714284,95.0,74.5
1303875.0,6,4,264,2,132,0.0,66.0,66.0,2,132,0.0,66.0,66.0
825.0,17,4,438,2,148,0.0,74.0,74.0,2,290,0.0,147.0,145.0
269761.0,6,10,1221,6,636,53952.2,298.0,106.0,4,585,88838.0,379.0,146.25
1952.0,17,2,664,1,322,0.0,322.0,322.0,1,342,0.0,342.0,342.0
30855.0,6,14,4740,7,653,4992.166666666667,249.0,93.28571428571428,7,4087,4537.333333333333,1514.0,583.8571428571429
128001115.0,17,15,907,8,475,18285873.57142857,174.0,59.375,7,432,18001315.5,174.0,61.71428571428572
316772.0,17,4,1400,4,1400,105590.66666666669,350.0,350.0,0,0,0.0,0.0,0.0
122134898.0,6,224,25184,112,7688,1074195.207207207,140.0,68.64285714285714,112,17496,1093853.3333333333,284.0,156.21428571428572
0.0,6,1,66,1,66,0.0,66.0,66.0,0,0,0.0,0.0,0.0
14531.0,6,14,4740,7,653,2190.333333333333,249.0,93.28571428571428,7,4087,2284.1666666666665,1514.0,583.8571428571429
10465524.0,6,7,478,4,272,3441266.333333333,74.0,68.0,3,206,5161762.5,74.0,68.66666666666667
12057792.0,17,5,2265,5,2265,3014448.0,453.0,453.0,0,0,0.0,0.0,0.0
301693.0,6,6,412,4,272,100564.33333333331,74.0,68.0,2,140,0.0,74.0,70.0
16802.0,17,2,180,1,90,0.0,90.0,90.0,1,90,0.0,90.0,90.0
18881.0,6,10,2032,5,524,4153.25,252.0,104.8,5,1508,4089.75,1236.0,301.6
315178.0,17,4,1400,4,1400,105059.33333333331,350.0,350.0,0,0,0.0,0.0,0.0
36822.0,17,2,582,1,83,0.0,83.0,83.0,1,499,0.0,499.0,499.0
2460670.0,6,2,132,1,66,0.0,66.0,66.0,1,66,0.0,66.0,66.0
218253.0,6,13,1386,7,789,36375.5,253.0,112.71428571428572,6,597,41864.8,259.0,99.5
155834.0,6,3,337,2,214,0.0,160.0,107.0,1,123,0.0,123.0,123.0
146200.0,6,2,132,1,66,0.0,66.0,66.0,1,66,0.0,66.0,66.0
153530.0,17,2,180,1,90,0.0,90.0,90.0,1,90,0.0,90.0,90.0
19309.0,6,14,4740,7,653,2912.0,249.0,93.28571428571428,7,4087,2889.333333333333,1514.0,583.8571428571429
216447.0,17,2,180,1,90,0.0,90.0,90.0,1,90,0.0,90.0,90.0
5827330.0,6,5,336,2,134,0.0,68.0,67.0,3,202,1525334.5,70.0,67.33333333333333
293836.0,17,4,1524,4,1524,97945.33333333331,381.0,381.0,0,0,0.0,0.0,0.0
2456.0,17,4,344,2,150,0.0,75.0,75.0,2,194,0.0,103.0,97.0
143855.0,17,2,180,1,90,0.0,90.0,90.0,1,90,0.0,90.0,90.0
153378.0,17,2,180,1,90,0.0,90.0,90.0,1,90,0.0,90.0,90.0
209402.0,17,2,180,1,90,0.0,90.0,90.0,1,90,0.0,90.0,90.0
49746.0,6,14,4740,7,653,8129.0,249.0,93.28571428571428,7,4087,7935.166666666667,1514.0,583.8571428571429
393.0,17,2,267,1,83,0.0,83.0,83.0,1,184,0.0,184.0,184.0
54859.0,6,14,4740,7,653,8941.0,249.0,93.28571428571428,7,4087,5983.5,1514.0,583.8571428571429
144339.0,17,4,704,2,148,0.0,74.0,74.0,2,556,0.0,280.0,278.0
45332.0,6,14,4740,7,653,7429.833333333333,249.0,93.28571428571428,7,4087,7181.0,1514.0,583.8571428571429
9844.0,17,2,598,1,72,0.0,72.0,72.0,1,526,0.0,526.0,526.0
298256.0,6,6,412,4,272,99418.66666666669,74.0,68.0,2,140,0.0,74.0,70.0
109461581.0,17,14,864,7,432,18243596.83333333,174.0,61.71428571428572,7,432,18160904.0,174.0,61.71428571428572
239444.0,6,3,337,2,214,0.0,160.0,107.0,1,123,0.0,123.0,123.0
145443.0,6,3,337,2,214,0.0,160.0,107.0,1,123,0.0,123.0,123.0
90949203.0,6,21,1585,11,840,9094128.4,95.0,76.36363636363636,10,745,10104509.0,95.0,74.5
312.0,17,2,168,1,76,0.0,76.0,76.0,1,92,0.0,92.0,92.0
438.0,17,2,166,1,75,0.0,75.0,75.0,1,91,0.0,91.0,91.0
49735.0,6,14,4740,7,653,8055.333333333333,249.0,93.28571428571428,7,4087,7450.333333333333,1514.0,583.8571428571429
120179952.0,6,242,27670,121,8282,994709.2666666668,140.0,68.44628099173553,121,19388,986139.3583333332,284.0,160.23140495867767
18414.0,6,10,2032,5,524,4339.25,252.0,104.8,5,1508,2956.75,1236.0,301.6
90520358.0,6,14,2240,8,1016,12931479.714285716,188.0,127.0,6,1224,18071674.6,204.0,204.0
220305.0,6,3,426,2,280,0.0,214.0,140.0,1,146,0.0,146.0,146.0
7200.0,17,2,582,1,83,0.0,83.0,83.0,1,499,0.0,499.0,499.0
93271305.0,17,15,5130,15,5130,6662236.071428572,342.0,342.0,0,0,0.0,0.0,0.0
1154649.0,6,13,3010,8,2382,164949.85714285713,1514.0,297.75,5,628,220522.75,331.0,125.6
101048036.0,17,14,864,7,432,16814853.5,174.0,61.71428571428572,7,432,16769794.0,174.0,61.71428571428572
866.0,17,4,438,2,148,0.0,74.0,74.0,2,290,0.0,147.0,145.0
205572.0,6,3,426,2,280,0.0,214.0,140.0,1,146,0.0,146.0,146.0
128048263.0,6,33,2280,17,1209,8003016.4375,123.0,71.11764705882354,16,1071,7857040.466666667,123.0,66.9375
39163.0,6,14,4740,7,653,6402.166666666667,249.0,93.28571428571428,7,4087,5767.666666666667,1514.0,583.8571428571429
137748.0,6,3,337,2,214,0.0,160.0,107.0,1,123,0.0,123.0,123.0
234188.0,6,3,426,2,280,0.0,214.0,140.0,1,146,0.0,146.0,146.0
319734.0,6,6,412,4,272,106578.0,74.0,68.0,2,140,0.0,74.0,70.0
36501.0,6,14,4740,7,653,5899.0,249.0,93.28571428571428,7,4087,5057.333333333333,1514.0,583.8571428571429
2664584.0,6,3,204,2,136,0.0,70.0,68.0,1,68,0.0,68.0,68.0
7697014.0,6,5,1736,2,819,0.0,753.0,409.5,3,917,3775707.5,785.0,305.6666666666667
67916.0,6,14,4740,7,653,10103.833333333334,249.0,93.28571428571428,7,4087,10867.333333333334,1514.0,583.8571428571429
108124161.0,17,5,1005,5,1005,27031040.25,201.0,201.0,0,0,0.0,0.0,0.0
135137705.0,17,6,1146,6,1146,27027541.0,191.0,191.0,0,0,0.0,0.0,0.0
311100.0,6,6,412,4,272,103700.0,74.0,68.0,2,140,0.0,74.0,70.0
216451.0,17,2,180,1,90,0.0,90.0,90.0,1,90,0.0,90.0,90.0
90046989.0,17,28,13364,28,13364,3335073.6666666665,501.0,477.2857142857143,0,0,0.0,0.0,0.0
40424.0,6,14,4740,7,653,5503.0,249.0,93.28571428571428,7,4087,6395.5,1514.0,583.8571428571429
165375.0,17,4,1524,4,1524,55125.0,381.0,381.0,0,0,0.0,0.0,0.0
90296803.0,6,16,1192,8,596,12890924.714285716,95.0,74.5,8,596,12897817.42857143,95.0,74.5
234242.0,6,3,337,2,214,0.0,160.0,107.0,1,123,0.0,123.0,123.0
2414.0,17,4,344,2,150,0.0,75.0,75.0,2,194,0.0,103.0,97.0
162913.0,17,2,180,1,90,0.0,90.0,90.0,1,90,0.0,90.0,90.0
95860316.0,6,181,20472,91,14310,1065114.6222222222,284.0,157.25274725274724,90,6162,1065328.4943820224,140.0,68.46666666666667
945.0,17,4,438,2,148,0.0,74.0,74.0,2,290,0.0,147.0,145.0
90531296.0,6,15,2168,8,1016,12933042.285714284,188.0,127.0,7,1152,15055336.666666666,204.0,164.57142857142858
0.0,6,1,66,1,66,0.0,66.0,66.0,0,0,0.0,0.0,0.0
95487554.0,6,28,1992,14,963,7345162.307692308,123.0,68.78571428571429,14,1029,6576980.769230769,123.0,73.5
100174675.0,17,12,778,6,389,20000864.6,174.0,64.83333333333333,6,389,20000152.4,174.0,64.83333333333333
219883.0,6,3,426,2,280,0.0,214.0,140.0,1,146,0.0,146.0,146.0
858828.0,6,9,1268,6,797,171765.6,459.0,132.83333333333334,3,471,291580.0,331.0,157.0
20813272.0,6,22,1767,11,1081,2048200.2,315.0,98.27272727272728,11,686,2048414.9,78.0,62.36363636363637
10522214.0,6,7,478,4,272,3461865.0,74.0,68.0,3,206,5192704.5,74.0,68.66666666666667
108103666.0,17,5,1005,5,1005,27025916.5,201.0,201.0,0,0,0.0,0.0,0.0
310893.0,6,4,492,2,280,0.0,214.0,140.0,2,212,0.0,146.0,106.0
30341.0,6,10,2032,5,524,7273.5,252.0,104.8,5,1508,6749.5,1236.0,301.6
311613.0,17,4,704,2,148,0.0,74.0,74.0,2,556,0.0,280.0,278.0
307514.0,6,6,412,4,272,102504.66666666669,74.0,68.0,2,140,0.0,74.0,70.0
757.0,17,2,684,2,684,0.0,342.0,342.0,0,0,0.0,0.0,0.0
25237.0,6,14,4740,7,653,3715.0,249.0,93.28571428571428,7,4087,4067.1666666666665,1514.0,583.8571428571429
1311668.0,6,4,264,2,132,0.0,66.0,66.0,2,132,0.0,66.0,66.0
0.0,17,1,72,1,72,0.0,72.0,72.0,0,0,0.0,0.0,0.0
15841.999999999998,6,11,2098,6,590,2643.0,252.0,98.33333333333331,5,1508,3602.75,1236.0,301.6
1153499.0,6,2,132,1,66,0.0,66.0,66.0,1,66,0.0,66.0,66.0
51589.0,6,10,2032,5,524,12678.25,252.0,104.8,5,1508,12160.0,1236.0,301.6
345.0,17,2,160,1,80,0.0,80.0,80.0,1,80,0.0,80.0,80.0
158675.0,6,3,337,2,214,0.0,160.0,107.0,1,123,0.0,123.0,123.0
2037735.0,6,25,7610,13,2516,169811.25,1034.0,193.53846153846155,12,5094,158304.63636363635,1510.0,424.5
10459697.0,6,7,478,4,272,3441202.333333333,74.0,68.0,3,206,5161715.5,74.0,68.66666666666667
97580787.0,17,14,4796,13,4446,6226932.083333333,342.0,342.0,1,350,0.0,350.0,350.0
361438.0,6,10,967,5,390,60590.75,162.0,78.0,5,577,60501.0,349.0,115.4
115083765.0,6,48,3168,24,1584,5003641.956521739,66.0,66.0,24,1584,4991662.043478261,66.0,66.0
2411.0,17,4,344,2,150,0.0,75.0,75.0,2,194,0.0,103.0,97.0
300986.0,6,6,412,4,272,100328.66666666669,74.0,68.0,2,140,0.0,74.0,70.0
308073.0,6,6,412,4,272,102691.0,74.0,68.0,2,140,0.0,74.0,70.0
298968.0,6,6,412,4,272,99656.0,74.0,68.0,2,140,0.0,74.0,70.0
1164341.0,6,13,3012,8,2384,166334.42857142858,1514.0,298.0,5,628,222916.0,331.0,125.6
243100.0,6,3,337,2,214,0.0,160.0,107.0,1,123,0.0,123.0,123.0
108435.0,17,2,286,2,286,0.0,143.0,143.0,0,0,0.0,0.0,0.0
433.0,17,2,508,2,508,0.0,257.0,254.0,0,0,0.0,0.0,0.0
2432.0,17,4,344,2,150,0.0,75.0,75.0,2,194,0.0,103.0,97.0
786.0,17,4,438,2,148,0.0,74.0,74.0,2,290,0.0,147.0,145.0
2303185.0,6,3,1777,2,951,0.0,885.0,475.5,1,826,0.0,826.0,826.0
50844.0,6,12,1320,7,789,8474.0,253.0,112.71428571428572,5,531,10636.0,259.0,106.2
120123328.0,6,13,2036,5,1020,30030832.0,204.0,204.0,8,1016,17137320.57142857,188.0,127.0
57352.0,6,14,4740,7,653,9397.833333333334,249.0,93.28571428571428,7,4087,7339.5,1514.0,583.8571428571429
119853381.0,6,15,2306,6,1224,23970187.4,204.0,204.0,9,1082,14981412.25,188.0,120.22222222222224
3010870.0,6,12,2172,7,664,501576.6666666667,252.0,94.85714285714286,5,1508,2842.5,1236.0,301.6
102240214.0,6,42,2772,21,1386,5111998.4,66.0,66.0,21,1386,5111996.8,66.0,66.0
85941.0,6,14,4740,7,653,9700.666666666666,249.0,93.28571428571428,7,4087,13715.5,1514.0,583.8571428571429
120711.0,6,3,337,2,214,0.0,160.0,107.0,1,123,0.0,123.0,123.0
109414889.0,6,192,21648,96,15016,1149470.1894736842,284.0,156.41666666666666,96,6632,1149470.1894736842,140.0,69.08333333333333
197928.0,17,4,6056,4,6056,65976.0,1514.0,1514.0,0,0,0.0,0.0,0.0
47952.0,6,14,4740,7,653,7128.666666666667,249.0,93.28571428571428,7,4087,6506.5,1514.0,583.8571428571429
42111.0,6,10,2032,5,524,9703.25,252.0,104.8,5,1508,9808.75,1236.0,301.6
26537303.0,6,5,1736,2,819,0.0,753.0,409.5,3,917,13200246.0,785.0,305.6666666666667
2455.0,17,4,344,2,150,0.0,75.0,75.0,2,194,0.0,103.0,97.0
338407.0,17,2,180,1,90,0.0,90.0,90.0,1,90,0.0,90.0,90.0
894.0,17,5,550,5,550,223.5,110.0,110.0,0,0,0.0,0.0,0.0
151610.0,17,2,414,1,88,0.0,88.0,88.0,1,326,0.0,326.0,326.0
38912066.0,17,23,10419,23,10419,1768730.2727272727,453.0,453.0,0,0,0.0,0.0,0.0
139683.0,6,2,132,1,66,0.0,66.0,66.0,1,66,0.0,66.0,66.0
4232.0,17,2,602,1,72,0.0,72.0,72.0,1,530,0.0,530.0,530.0
104425666.0,17,15,5130,15,5130,7458976.142857143,342.0,342.0,0,0,0.0,0.0,0.0
418818.0,17,3,1026,3,1026,209409.0,342.0,342.0,0,0,0.0,0.0,0.0
921.0,17,4,438,2,148,0.0,74.0,74.0,2,290,0.0,147.0,145.0
441014.0,6,11,1021,6,444,59455.2,162.0,74.0,5,577,74161.5,349.0,115.4
217126.0,17,2,180,1,90,0.0,90.0,90.0,1,90,0.0,90.0,90.0
774.0,17,4,438,2,148,0.0,74.0,74.0,2,290,0.0,147.0,145.0
254196.0,6,10,1221,6,636,50839.2,298.0,106.0,4,585,79373.0,379.0,146.25
48168.0,6,14,4740,7,653,7819.166666666667,249.0,93.28571428571428,7,4087,7823.666666666667,1514.0,583.8571428571429
108107885.0,17,5,955,5,955,27026971.25,191.0,191.0,0,0,0.0,0.0,0.0
116111604.0,6,272,31502,136,9272,853911.0296296297,140.0,68.17647058823529,136,22230,855300.8740740741,284.0,163.4558823529412
297510.0,6,6,412,4,272,99170.0,74.0,68.0,2,140,0.0,74.0,70.0
107000199.0,6,205,23046,103,7020,1049021.5588235294,140.0,68.15533980582525,102,16026,1049699.9504950496,284.0,157.11764705882354
331.0,17,2,160,1,80,0.0,80.0,80.0,1,80,0.0,80.0,80.0
286533.0,6,10,1221,6,636,57306.6,298.0,106.0,4,585,88467.66666666667,379.0,146.25
108145581.0,17,14,1126,7,563,17997629.833333332,174.0,80.42857142857143,7,563,17997635.666666668,174.0,80.42857142857143
17909429.0,6,26,7627,14,3735,198490.84615384616,1514.0,266.7857142857143,12,3892,1608455.0909090908,1514.0,324.3333333333333
146296.0,6,3,337,2,214,0.0,160.0,107.0,1,123,0.0,123.0,123.0
35687.0,6,10,2032,5,524,8466.75,252.0,104.8,5,1508,8345.25,1236.0,301.6
221922.0,17,2,180,1,90,0.0,90.0,90.0,1,90,0.0,90.0,90.0
5620665.0,6,4,270,2,134,0.0,68.0,67.0,2,136,0.0,70.0,68.0
90256375.0,6,12,1832,8,1016,12893767.857142856,188.0,127.0,4,816,30030653.0,204.0,204.0
5828331.0,6,4,270,2,134,0.0,68.0,67.0,2,136,0.0,70.0,68.0
309624.0,6,6,412,4,272,103208.0,74.0,68.0,2,140,0.0,74.0,70.0
25254.0,6,10,2032,5,524,5515.0,252.0,104.8,5,1508,6119.25,1236.0,301.6
118056941.0,6,229,25838,115,7812,1035587.201754386,140.0,67.9304347826087,114,18026,1035696.1769911504,284.0,158.12280701754386
241403.0,6,3,337,2,214,0.0,160.0,107.0,1,123,0.0,123.0,123.0
45337.0,6,14,4740,7,653,6449.5,249.0,93.28571428571428,7,4087,7240.666666666667,1514.0,583.8571428571429
37709.0,6,14,4740,7,653,4601.166666666667,249.0,93.28571428571428,7,4087,5979.333333333333,1514.0,583.8571428571429
0.0,17,1,44,1,44,0.0,44.0,44.0,0,0,0.0,0.0,0.0
2099.0,17,4,344,2,150,0.0,75.0,75.0,2,194,0.0,103.0,97.0
5006258.0,17,4,849,2,166,0.0,83.0,83.0,2,683,0.0,499.0,341.5
34356.0,6,2,145,2,145,0.0,91.0,72.5,0,0,0.0,0.0,0.0
99496123.0,6,39,3241,18,1524,5852713.117647059,123.0,84.66666666666667,21,1717,4963838.55,139.0,81.76190476190476
45036919.0,6,7,1874,5,1053,11259229.75,785.0,210.6,2,821,0.0,753.0,410.5
317241.0,17,4,1400,4,1400,105747.0,350.0,350.0,0,0,0.0,0.0,0.0
93266822.0,17,16,5472,16,5472,6217788.133333334,342.0,342.0,0,0,0.0,0.0,0.0
242515.0,6,3,337,2,214,0.0,160.0,107.0,1,123,0.0,123.0,123.0
252816.0,6,3,337,2,214,0.0,160.0,107.0,1,123,0.0,123.0,123.0
4545.0,17,2,614,1,72,0.0,72.0,72.0,1,542,0.0,542.0,542.0
313.0,17,2,174,1,79,0.0,79.0,79.0,1,95,0.0,95.0,95.0
24123.0,6,14,4740,7,653,3734.6666666666665,249.0,93.28571428571428,7,4087,3781.6666666666665,1514.0,583.8571428571429
248917.0,6,3,337,2,214,0.0,160.0,107.0,1,123,0.0,123.0,123.0
26689482.0,17,5,1710,5,1710,6672370.5,342.0,342.0,0,0,0.0,0.0,0.0
102795.0,17,2,762,2,762,0.0,381.0,381.0,0,0,0.0,0.0,0.0
4978049.0,17,4,849,2,166,0.0,83.0,83.0,2,683,0.0,499.0,341.5
65303.0,6,14,4740,7,653,9304.5,249.0,93.28571428571428,7,4087,10211.666666666666,1514.0,583.8571428571429
32373.0,6,14,4740,7,653,5212.5,249.0,93.28571428571428,7,4087,4791.833333333333,1514.0,583.8571428571429
186074.0,17,2,180,1,90,0.0,90.0,90.0,1,90,0.0,90.0,90.0
4862.0,17,2,180,1,90,0.0,90.0,90.0,1,90,0.0,90.0,90.0
135129888.0,17,6,1206,6,1206,27025977.6,201.0,201.0,0,0,0.0,0.0,0.0
115550677.0,6,204,22980,102,16026,1141935.2475247525,284.0,157.11764705882354,102,6954,1141934.8811881188,140.0,68.17647058823529
15084.0,6,14,4740,7,653,2222.333333333333,249.0,93.28571428571428,7,4087,2380.6666666666665,1514.0,583.8571428571429
135130896.0,17,6,1206,6,1206,27026179.2,201.0,201.0,0,0,0.0,0.0,0.0
17488.0,17,2,582,1,83,0.0,83.0,83.0,1,499,0.0,499.0,499.0
107941.0,17,2,286,2,286,0.0,143.0,143.0,0,0,0.0,0.0,0.0
600503.0,17,2,346,1,78,0.0,78.0,78.0,1,268,0.0,268.0,268.0
18950.0,6,11,2098,6,590,2597.4,252.0,98.33333333333331,5,1508,4283.0,1236.0,301.6
14116919.0,6,20,1648,10,1016,1535790.0,315.0,101.6,10,632,1535757.3333333333,78.0,63.2
292.0,17,2,156,1,78,0.0,78.0,78.0,1,78,0.0,78.0,78.0
135124685.0,17,6,1146,6,1146,27024937.0,191.0,191.0,0,0,0.0,0.0,0.0
121000523.0,17,15,907,8,475,17285789.0,174.0,59.375,7,432,16773767.666666666,174.0,61.71428571428572
10489961.0,6,7,478,4,272,3451122.0,74.0,68.0,3,206,5176577.5,74.0,68.66666666666667
90033917.0,17,28,13364,28,13364,3334589.5185185187,501.0,477.2857142857143,0,0,0.0,0.0,0.0
765.0,17,4,438,2,148,0.0,74.0,74.0,2,290,0.0,147.0,145.0
313119.0,6,6,412,4,272,104373.0,74.0,68.0,2,140,0.0,74.0,70.0
366.0,17,2,174,1,79,0.0,79.0,79.0,1,95,0.0,95.0,95.0
41977.0,6,14,4740,7,653,6510.0,249.0,93.28571428571428,7,4087,6726.833333333333,1514.0,583.8571428571429
17041.0,6,11,2098,6,590,3408.2,252.0,98.33333333333331,5,1508,3568.75,1236.0,301.6
107440318.0,6,33,2412,17,1272,6715019.875,123.0,74.82352941176471,16,1140,7148263.666666667,123.0,71.25
104878601.0,6,44,2904,22,1452,4994219.095238095,66.0,66.0,22,1452,4983928.0,66.0,66.0
32361.0,6,10,2032,5,524,6623.5,252.0,104.8,5,1508,7534.5,1236.0,301.6
4393.0,17,2,180,1,90,0.0,90.0,90.0,1,90,0.0,90.0,90.0
5785.0,17,2,237,1,81,0.0,81.0,81.0,1,156,0.0,156.0,156.0
739.0,17,4,438,2,148,0.0,74.0,74.0,2,290,0.0,147.0,145.0
2397.0,17,4,344,2,150,0.0,75.0,75.0,2,194,0.0,103.0,97.0
120228670.0,6,26,1978,12,935,10908205.454545457,95.0,77.91666666666667,14,1043,9230000.307692308,95.0,74.5
93508953.0,6,40,2640,20,1320,4921523.842105263,66.0,66.0,20,1320,4910153.0,66.0,66.0
22375.0,6,13,4515,6,512,4330.8,230.0,85.33333333333333,7,4003,3490.833333333333,1514.0,571.8571428571429
29361.0,6,14,4740,7,653,4300.5,249.0,93.28571428571428,7,4087,4099.5,1514.0,583.8571428571429
103869342.0,17,14,1126,7,563,17168040.0,174.0,80.42857142857143,7,563,17166830.666666668,174.0,80.42857142857143
41035.0,6,10,2032,5,524,9265.25,252.0,104.8,5,1508,9395.0,1236.0,301.6
2812896.0,6,2,132,1,66,0.0,66.0,66.0,1,66,0.0,66.0,66.0
120424323.0,6,223,25118,112,17496,1084903.810810811,284.0,156.21428571428572,111,7622,1086441.4363636365,140.0,68.66666666666667
319.0,17,2,174,1,79,0.0,79.0,79.0,1,95,0.0,95.0,95.0
216794.0,6,3,426,2,280,0.0,214.0,140.0,1,146,0.0,146.0,146.0
120122397.0,6,13,2020,9,1204,15015299.625,188.0,133.77777777777777,4,816,30030633.666666668,204.0,204.0
313562.0,17,4,1400,4,1400,104520.66666666669,350.0,350.0,0,0,0.0,0.0,0.0
2156.0,17,4,344,2,150,0.0,75.0,75.0,2,194,0.0,103.0,97.0
2799483.0,6,2,132,1,66,0.0,66.0,66.0,1,66,0.0,66.0,66.0
249263.0,17,2,180,1,90,0.0,90.0,90.0,1,90,0.0,90.0,90.0
44245.0,6,14,4740,7,653,7251.666666666667,249.0,93.28571428571428,7,4087,6998.833333333333,1514.0,583.8571428571429
91443750.0,6,24,1829,13,989,7619841.0,95.0,76.07692307692308,11,840,9143954.5,95.0,76.36363636363636
282584.0,17,2,363,1,79,0.0,79.0,79.0,1,284,0.0,284.0,284.0
110062851.0,6,27,1806,14,966,8450649.23076923,123.0,69.0,13,840,9154186.916666666,123.0,64.61538461538461
1194546.0,6,13,3010,8,2382,170649.42857142858,1514.0,297.75,5,628,229735.25,331.0,125.6
9348.0,17,2,582,1,83,0.0,83.0,83.0,1,499,0.0,499.0,499.0
148410.0,17,2,414,1,88,0.0,88.0,88.0,1,326,0.0,326.0,326.0
14638481.0,6,20,1607,10,975,1592875.7777777778,315.0,97.5,10,632,1592845.3333333333,78.0,63.2
234874.0,6,3,337,2,214,0.0,160.0,107.0,1,123,0.0,123.0,123.0
2536592.0,6,3,1604,1,753,0.0,753.0,753.0,2,851,0.0,785.0,425.5
58896.0,6,10,2032,5,524,14495.75,252.0,104.8,5,1508,13449.75,1236.0,301.6
103332039.0,17,14,864,7,432,17167535.333333332,174.0,61.71428571428572,7,432,17166843.166666668,174.0,61.71428571428572
91171478.0,6,1885,1634430,582,38424,156921.64888123923,78.0,66.02061855670104,1303,1596006,70022.18817204301,1514.0,1224.8702993092863
22934163.0,6,26,7627,14,3735,188760.6923076923,1514.0,266.7857142857143,12,3892,2065329.9090909087,1514.0,324.3333333333333
218037.0,17,2,180,1,90,0.0,90.0,90.0,1,90,0.0,90.0,90.0
228357.0,17,2,180,1,90,0.0,90.0,90.0,1,90,0.0,90.0,90.0
1212021.0,17,7,490,7,490,202003.5,70.0,70.0,0,0,0.0,0.0,0.0
95428719.0,17,12,778,6,389,19053964.6,174.0,64.83333333333333,6,389,18984063.4,174.0,64.83333333333333
343.0,17,2,160,1,80,0.0,80.0,80.0,1,80,0.0,80.0,80.0
1302388.0,6,4,264,2,132,0.0,66.0,66.0,2,132,0.0,66.0,66.0
365.0,17,2,202,1,87,0.0,87.0,87.0,1,115,0.0,115.0,115.0
41951.0,6,14,4740,7,653,6561.333333333333,249.0,93.28571428571428,7,4087,6863.5,1514.0,583.8571428571429
160016.0,6,2,128,1,74,0.0,74.0,74.0,1,54,0.0,54.0,54.0
87791.0,6,14,4740,7,653,13659.0,249.0,93.28571428571428,7,4087,14439.333333333334,1514.0,583.8571428571429
26752.0,6,14,4740,7,653,4177.666666666667,249.0,93.28571428571428,7,4087,4221.833333333333,1514.0,583.8571428571429
99947964.0,6,32,2236,16,1165,6649535.6,139.0,72.8125,16,1071,6649537.666666667,123.0,66.9375
311008.0,17,4,1400,4,1400,103669.33333333331,350.0,350.0,0,0,0.0,0.0,0.0
102240321.0,6,42,2772,21,1386,5112003.95,66.0,66.0,21,1386,5112003.05,66.0,66.0
147901.0,6,3,337,2,214,0.0,160.0,107.0,1,123,0.0,123.0,123.0
53448.0,6,14,4740,7,653,8449.166666666666,249.0,93.28571428571428,7,4087,8768.0,1514.0,583.8571428571429
259121.0,6,3,337,2,214,0.0,160.0,107.0,1,123,0.0,123.0,123.0
112234954.0,6,36,2596,18,1348,6589366.0,139.0,74.88888888888889,18,1248,6589363.529411765,123.0,69.33333333333333
107840362.0,6,28,1860,14,966,8295412.461538462,123.0,69.0,14,894,8279556.538461538,123.0,63.85714285714285
4359.0,17,2,614,1,72,0.0,72.0,72.0,1,542,0.0,542.0,542.0
2359.0,17,4,344,2,150,0.0,75.0,75.0,2,194,0.0,103.0,97.0
32999.0,6,14,4740,7,653,5330.333333333333,249.0,93.28571428571428,7,4087,4972.666666666667,1514.0,583.8571428571429
3022584.0,6,12,2172,7,664,502989.8333333333,252.0,94.85714285714286,5,1508,3165.0,1236.0,301.6
392.0,17,2,762,2,762,0.0,381.0,381.0,0,0,0.0,0.0,0.0
138775.0,6,13,1386,7,789,23129.166666666668,253.0,112.71428571428572,6,597,24956.8,259.0,99.5
145637.0,6,3,373,2,238,0.0,172.0,119.0,1,135,0.0,135.0,135.0
120059359.0,17,29,13785,29,13785,4287834.25,501.0,475.3448275862069,0,0,0.0,0.0,0.0
135131455.0,17,6,1206,6,1206,27026291.0,201.0,201.0,0,0,0.0,0.0,0.0
90050728.0,17,28,13364,28,13364,3335212.1481481483,501.0,477.2857142857143,0,0,0.0,0.0,0.0
48731.0,6,14,4740,7,653,7892.666666666667,249.0,93.28571428571428,7,4087,7964.833333333333,1514.0,583.8571428571429
108109123.0,17,5,1005,5,1005,27027280.75,201.0,201.0,0,0,0.0,0.0,0.0
60633.0,6,10,2032,5,524,14918.0,252.0,104.8,5,1508,14926.25,1236.0,301.6
158188.0,6,3,337,2,214,0.0,160.0,107.0,1,123,0.0,123.0,123.0
90039926.0,17,28,13364,28,13364,3334812.074074074,501.0,477.2857142857143,0,0,0.0,0.0,0.0
114844344.0,6,48,3168,24,1584,4993232.347826087,66.0,66.0,24,1584,4978906.173913044,66.0,66.0
1315626.0,6,4,264,2,132,0.0,66.0,66.0,2,132,0.0,66.0,66.0
228354.0,17,2,180,1,90,0.0,90.0,90.0,1,90,0.0,90.0,90.0
796326.0,17,2,346,1,78,0.0,78.0,78.0,1,268,0.0,268.0,268.0
320854.0,17,4,1400,4,1400,106951.33333333331,350.0,350.0,0,0,0.0,0.0,0.0
217243.0,6,10,1221,6,636,43448.6,298.0,106.0,4,585,71065.0,379.0,146.25
2444.0,17,4,344,2,150,0.0,75.0,75.0,2,194,0.0,103.0,97.0
51123.0,6,14,4740,7,653,8060.5,249.0,93.28571428571428,7,4087,8308.833333333334,1514.0,583.8571428571429
45855.0,6,14,4740,7,653,7522.0,249.0,93.28571428571428,7,4087,6806.666666666667,1514.0,583.8571428571429
297612.0,6,6,412,4,272,99204.0,74.0,68.0,2,140,0.0,74.0,70.0
208522.0,6,10,1221,6,636,41704.4,298.0,106.0,4,585,68284.33333333333,379.0,146.25
314917.0,17,4,1400,4,1400,104972.33333333331,350.0,350.0,0,0,0.0,0.0,0.0
51728438.0,6,8,2113,3,960,24537142.0,826.0,320.0,5,1153,12236946.0,885.0,230.6
111473062.0,6,198,22442,99,15686,1135285.1530612244,284.0,158.44444444444446,99,6756,1135284.4285714286,140.0,68.24242424242425
2282932.0,6,4,492,2,280,0.0,214.0,140.0,2,212,0.0,146.0,106.0
38169.0,6,14,4740,7,653,5847.166666666667,249.0,93.28571428571428,7,4087,5524.5,1514.0,583.8571428571429
1310669.0,6,4,264,2,132,0.0,66.0,66.0,2,132,0.0,66.0,66.0
37162.0,6,14,4740,7,653,6065.666666666667,249.0,93.28571428571428,7,4087,6057.5,1514.0,583.8571428571429
213812.0,6,3,426,2,280,0.0,214.0,140.0,1,146,0.0,146.0,146.0
2446.0,17,4,344,2,150,0.0,75.0,75.0,2,194,0.0,103.0,97.0
302619.0,6,6,412,4,272,100873.0,74.0,68.0,2,140,0.0,74.0,70.0
120000982.0,17,13,559,7,301,20000163.666666668,43.0,43.0,6,258,20004364.8,43.0,43.0
120193778.0,6,502,63916,251,47128,479913.528,300.0,187.7609561752988,251,16788,479912.996,140.0,66.88446215139442
157112.0,6,3,337,2,214,0.0,160.0,107.0,1,123,0.0,123.0,123.0
10201.0,6,10,2032,5,524,2342.5,252.0,104.8,5,1508,2124.75,1236.0,301.6
116522478.0,6,276,31062,138,21658,848958.4306569343,284.0,156.94202898550725,138,9404,848950.1678832116,140.0,68.14492753623189
42369.0,6,10,2032,5,524,10346.25,252.0,104.8,5,1508,10291.75,1236.0,301.6
53140.0,6,14,4740,7,653,8679.666666666666,249.0,93.28571428571428,7,4087,8569.666666666666,1514.0,583.8571428571429
9569.0,17,2,582,1,83,0.0,83.0,83.0,1,499,0.0,499.0,499.0
35599.0,6,14,4740,7,653,5544.166666666667,249.0,93.28571428571428,7,4087,5527.666666666667,1514.0,583.8571428571429
2953.0,17,2,224,1,76,0.0,76.0,76.0,1,148,0.0,148.0,148.0
113168255.0,6,46,3036,23,1518,5144000.0,66.0,66.0,23,1518,5143999.0,66.0,66.0
32320.0,6,14,4740,7,653,4672.833333333333,249.0,93.28571428571428,7,4087,5250.666666666667,1514.0,583.8571428571429
103099.0,17,2,286,2,286,0.0,143.0,143.0,0,0,0.0,0.0,0.0
113254932.0,6,46,3036,23,1518,5135434.045454546,66.0,66.0,23,1518,5135444.045454546,66.0,66.0
90073550.0,17,27,12943,27,12943,3464367.3076923075,501.0,479.3703703703704,0,0,0.0,0.0,0.0
90044621.0,17,28,13364,28,13364,3334985.962962963,501.0,477.2857142857143,0,0,0.0,0.0,0.0
50743.0,17,2,180,1,90,0.0,90.0,90.0,1,90,0.0,90.0,90.0
298128.0,6,6,412,4,272,99376.0,74.0,68.0,2,140,0.0,74.0,70.0
108107746.0,17,5,1005,5,1005,27026936.5,201.0,201.0,0,0,0.0,0.0,0.0
2258.0,17,4,344,2,150,0.0,75.0,75.0,2,194,0.0,103.0,97.0
117895936.0,6,244,27638,122,19364,972567.0165289256,284.0,158.72131147540983,122,8274,972557.826446281,140.0,67.81967213114754
1029973.0,6,11,1134,6,558,205994.6,220.0,93.0,5,576,256419.25,304.0,115.2
26538.0,6,14,4740,7,653,4244.666666666667,249.0,93.28571428571428,7,4087,4239.833333333333,1514.0,583.8571428571429
116485811.0,6,45,3768,25,2067,4853575.458333333,123.0,82.68,20,1701,6119445.052631579,123.0,85.05
90026456.0,17,28,13364,28,13364,3334313.185185185,501.0,477.2857142857143,0,0,0.0,0.0,0.0
100311178.0,17,12,516,6,258,20001719.4,43.0,43.0,6,258,20000187.2,43.0,43.0
90026692.0,17,28,13364,28,13364,3334321.925925926,501.0,477.2857142857143,0,0,0.0,0.0,0.0
43230.0,6,10,2032,5,524,10576.75,252.0,104.8,5,1508,9323.25,1236.0,301.6
128547.0,6,13,1394,7,797,21424.5,253.0,113.85714285714286,6,597,23487.6,259.0,99.5
37082.0,6,14,4740,7,653,5543.5,249.0,93.28571428571428,7,4087,6039.666666666667,1514.0,583.8571428571429
9558.0,17,4,823,2,163,0.0,89.0,81.5,2,660,0.0,443.0,330.0
108675887.0,6,32,2220,16,1149,7245059.133333334,123.0,71.8125,16,1071,7230636.4,123.0,66.9375
100596972.0,17,12,778,6,389,20001092.2,174.0,64.83333333333333,6,389,20000159.2,174.0,64.83333333333333
56672.0,6,12,1320,6,723,10699.8,253.0,120.5,6,597,9735.6,259.0,99.5
217038.0,6,3,426,2,280,0.0,214.0,140.0,1,146,0.0,146.0,146.0
26981.0,6,11,2098,6,590,5156.4,252.0,98.33333333333331,5,1508,4341.0,1236.0,301.6
37603.0,6,14,4740,7,653,5991.0,249.0,93.28571428571428,7,4087,5216.666666666667,1514.0,583.8571428571429
2381.0,17,4,344,2,150,0.0,75.0,75.0,2,194,0.0,103.0,97.0
2384.0,17,4,344,2,150,0.0,75.0,75.0,2,194,0.0,103.0,97.0
49252.0,6,10,2032,5,524,11122.0,252.0,104.8,5,1508,11584.25,1236.0,301.6
2959503.0,6,3,1604,2,851,0.0,785.0,425.5,1,753,0.0,753.0,753.0
4394.0,17,2,614,1,72,0.0,72.0,72.0,1,542,0.0,542.0,542.0
146554.0,6,3,337,2,214,0.0,160.0,107.0,1,123,0.0,123.0,123.0
157204.0,6,3,337,2,214,0.0,160.0,107.0,1,123,0.0,123.0,123.0
205855.0,17,2,180,1,90,0.0,90.0,90.0,1,90,0.0,90.0,90.0
0.0,6,1,66,1,66,0.0,66.0,66.0,0,0,0.0,0.0,0.0
120132087.0,6,236,26930,118,8084,1019758.1452991453,140.0,68.50847457627118,118,18846,1019790.435897436,464.0,159.71186440677965
68550.0,6,14,4740,7,653,11165.5,249.0,93.28571428571428,7,4087,10686.333333333334,1514.0,583.8571428571429
209361.0,6,3,426,2,280,0.0,214.0,140.0,1,146,0.0,146.0,146.0
160255.0,17,2,180,1,90,0.0,90.0,90.0,1,90,0.0,90.0,90.0
308697.0,6,6,412,4,272,102899.0,74.0,68.0,2,140,0.0,74.0,70.0
309775.0,6,6,412,4,272,103258.33333333331,74.0,68.0,2,140,0.0,74.0,70.0
56275.0,6,12,1320,6,723,9945.0,253.0,120.5,6,597,6626.0,259.0,99.5
107702.0,17,2,286,2,286,0.0,143.0,143.0,0,0,0.0,0.0,0.0
221853.0,6,3,426,2,280,0.0,214.0,140.0,1,146,0.0,146.0,146.0
197666.0,17,2,180,1,90,0.0,90.0,90.0,1,90,0.0,90.0,90.0
46509.0,6,14,4740,7,653,7110.0,249.0,93.28571428571428,7,4087,7357.333333333333,1514.0,583.8571428571429
435.0,17,2,166,1,75,0.0,75.0,75.0,1,91,0.0,91.0,91.0
1544194.0,6,4,276,2,128,0.0,74.0,64.0,2,148,0.0,74.0,74.0
135134165.0,17,6,1146,6,1146,27026833.0,191.0,191.0,0,0,0.0,0.0,0.0
90389344.0,6,26,1878,13,969,7514289.5,123.0,74.53846153846153,13,909,7514301.333333333,123.0,69.92307692307692
90053366.0,17,28,13364,28,13364,3335309.851851852,501.0,477.2857142857143,0,0,0.0,0.0,0.0
110962533.0,6,210,23662,105,7152,1050150.5576923075,140.0,68.11428571428571,105,16510,1049036.9711538462,284.0,157.23809523809524
7033.0,17,2,180,1,90,0.0,90.0,90.0,1,90,0.0,90.0,90.0
108109014.0,17,5,955,5,955,27027253.5,191.0,191.0,0,0,0.0,0.0,0.0
233144.0,6,3,337,2,214,0.0,160.0,107.0,1,123,0.0,123.0,123.0
128063091.0,6,31,2034,16,1086,8537539.4,123.0,67.875,15,948,8418381.357142856,123.0,63.2
92383.0,6,14,4740,7,653,14918.5,249.0,93.28571428571428,7,4087,13867.0,1514.0,583.8571428571429
216359.0,17,2,180,1,90,0.0,90.0,90.0,1,90,0.0,90.0,90.0
237815.0,17,2,359,1,75,0.0,75.0,75.0,1,284,0.0,284.0,284.0
272813.0,6,10,1221,6,636,54562.6,298.0,106.0,4,585,85573.0,379.0,146.25
28953.0,6,10,2032,5,524,6995.25,252.0,104.8,5,1508,6424.25,1236.0,301.6
80768.0,6,14,4740,7,653,12968.333333333334,249.0,93.28571428571428,7,4087,13282.5,1514.0,583.8571428571429
44746.0,6,14,4740,7,653,6901.833333333333,249.0,93.28571428571428,7,4087,6756.833333333333,1514.0,583.8571428571429
2345.0,17,4,344,2,150,0.0,75.0,75.0,2,194,0.0,103.0,97.0
217714.0,6,3,426,2,280,0.0,214.0,140.0,1,146,0.0,146.0,146.0
47568.0,6,14,4740,7,653,7803.666666666667,249.0,93.28571428571428,7,4087,7771.833333333333,1514.0,583.8571428571429
108803.0,17,2,286,2,286,0.0,143.0,143.0,0,0,0.0,0.0,0.0
213552.0,17,2,180,1,90,0.0,90.0,90.0,1,90,0.0,90.0,90.0
90257876.0,6,13,2036,8,1016,12893982.285714284,188.0,127.0,5,1020,22523577.25,204.0,204.0
109287498.0,17,14,864,7,432,18167949.666666668,174.0,61.71428571428572,7,432,18166832.33333333,174.0,61.71428571428572
299993.0,6,6,412,4,272,99997.66666666669,74.0,68.0,2,140,0.0,74.0,70.0
90031926.0,17,28,13364,28,13364,3334515.777777778,501.0,477.2857142857143,0,0,0.0,0.0,0.0
18101.0,6,10,2032,5,524,4314.25,252.0,104.8,5,1508,3914.75,1236.0,301.6
1325663.0,6,4,264,2,132,0.0,66.0,66.0,2,132,0.0,66.0,66.0
192899.0,17,2,180,1,90,0.0,90.0,90.0,1,90,0.0,90.0,90.0
15288.0,6,14,4740,7,653,2250.833333333333,249.0,93.28571428571428,7,4087,2407.833333333333,1514.0,583.8571428571429
90033731.0,17,27,12943,27,12943,3462835.8076923075,501.0,479.3703703703704,0,0,0.0,0.0,0.0
15264.0,17,4,823,2,163,0.0,89.0,81.5,2,660,0.0,443.0,330.0
90253866.0,6,12,1832,8,1016,12893409.42857143,188.0,127.0,4,816,30029803.0,204.0,204.0
113614504.0,6,46,3036,23,1518,5150438.681818182,66.0,66.0,23,1518,5150438.954545454,66.0,66.0
108108136.0,17,5,955,5,955,27027034.0,191.0,191.0,0,0,0.0,0.0,0.0
118641111.0,6,34,2488,18,1348,6978888.882352941,139.0,74.88888888888889,16,1140,7894885.533333333,123.0,71.25
40022.0,6,10,2032,5,524,9495.5,252.0,104.8,5,1508,9358.25,1236.0,301.6
149723591.0,6,16,2494,6,1224,23970512.2,204.0,204.0,10,1270,16635828.333333334,188.0,127.0
72465.0,6,14,4740,7,653,11665.166666666666,249.0,93.28571428571428,7,4087,11939.333333333334,1514.0,583.8571428571429
301471.0,6,6,412,4,272,100490.33333333331,74.0,68.0,2,140,0.0,74.0,70.0
149663532.0,17,35,16705,35,16705,4401868.588235294,501.0,477.2857142857143,0,0,0.0,0.0,0.0
125777529.0,6,65,15470,33,6181,3002293.0625,1514.0,187.3030303030303,32,9289,4050713.129032258,1514.0,290.28125
317.0,17,2,208,1,72,0.0,72.0,72.0,1,136,0.0,136.0,136.0
120037.0,17,2,180,1,70,0.0,70.0,70.0,1,110,0.0,110.0,110.0
228188.0,17,2,180,1,90,0.0,90.0,90.0,1,90,0.0,90.0,90.0
782812.0,6,14,4740,7,653,130118.33333333331,249.0,93.28571428571428,7,4087,130290.66666666669,1514.0,583.8571428571429
120001135.0,17,15,1169,8,606,17143019.285714287,174.0,75.75,7,563,16667633.5,174.0,80.42857142857143
12660.0,6,10,2032,5,524,2880.75,252.0,104.8,5,1508,2909.5,1236.0,301.6
12935964.0,17,20,7552,20,7552,680840.2105263158,394.0,377.6,0,0,0.0,0.0,0.0
298572.0,6,6,412,4,272,99524.0,74.0,68.0,2,140,0.0,74.0,70.0
119721.0,17,2,180,1,70,0.0,70.0,70.0,1,110,0.0,110.0,110.0
120062436.0,6,222,25106,111,7548,1085102.7272727273,140.0,68.0,111,17558,1075540.1363636365,284.0,158.18018018018017
8402045.0,17,3,1034,2,684,0.0,342.0,342.0,1,350,0.0,350.0,350.0
42614.0,6,2,132,1,66,0.0,66.0,66.0,1,66,0.0,66.0,66.0
305464.0,6,6,412,4,272,101821.33333333331,74.0,68.0,2,140,0.0,74.0,70.0
90257376.0,6,13,2036,8,1016,12893910.857142856,188.0,127.0,5,1020,22523384.0,204.0,204.0
126011181.0,17,15,907,8,475,18001597.285714287,174.0,59.375,7,432,17666814.666666668,174.0,61.71428571428572
143941.0,17,2,180,1,90,0.0,90.0,90.0,1,90,0.0,90.0,90.0
90094801.0,6,12,1848,5,1020,22523110.5,204.0,204.0,7,828,15015380.666666666,188.0,118.28571428571428
196989.0,17,2,180,1,90,0.0,90.0,90.0,1,90,0.0,90.0,90.0
847.0,17,4,438,2,148,0.0,74.0,74.0,2,290,0.0,147.0,145.0
100187279.0,17,14,864,7,432,16667228.166666666,174.0,61.71428571428572,7,432,16666796.333333334,174.0,61.71428571428572
126132.0,6,14,4740,7,653,20913.33333333333,249.0,93.28571428571428,7,4087,19430.0,1514.0,583.8571428571429
270441.0,6,10,1221,6,636,54088.2,298.0,106.0,4,585,84515.66666666667,379.0,146.25
797.0,17,4,438,2,148,0.0,74.0,74.0,2,290,0.0,147.0,145.0
143919.0,17,2,180,1,90,0.0,90.0,90.0,1,90,0.0,90.0,90.0
312.0,17,2,174,1,79,0.0,79.0,79.0,1,95,0.0,95.0,95.0
302717.0,6,6,412,4,272,100905.66666666669,74.0,68.0,2,140,0.0,74.0,70.0
233325.0,6,3,337,2,214,0.0,160.0,107.0,1,123,0.0,123.0,123.0
216628.0,6,3,426,2,280,0.0,214.0,140.0,1,146,0.0,146.0,146.0
37878.0,6,10,2032,5,524,9125.0,252.0,104.8,5,1508,9085.75,1236.0,301.6
117574.0,17,2,286,2,286,0.0,143.0,143.0,0,0,0.0,0.0,0.0
90260135.0,6,12,1832,8,1016,12894305.0,188.0,127.0,4,816,30030721.0,204.0,204.0
31648.000000000004,6,14,4740,7,653,5143.833333333333,249.0,93.28571428571428,7,4087,5134.0,1514.0,583.8571428571429
120120738.0,6,14,2224,9,1204,15015092.25,188.0,133.77777777777777,5,1020,22528739.0,204.0,204.0
321.0,17,2,174,1,79,0.0,79.0,79.0,1,95,0.0,95.0,95.0
17742843.0,6,26,7627,14,3735,195956.4615384616,1514.0,266.7857142857143,12,3892,1593296.0,1514.0,324.3333333333333
217437.0,6,3,426,2,280,0.0,214.0,140.0,1,146,0.0,146.0,146.0
103350816.0,17,14,864,7,432,17166828.166666668,174.0,61.71428571428572,7,432,17168191.0,174.0,61.71428571428572
315267.0,17,4,1400,4,1400,105089.0,350.0,350.0,0,0,0.0,0.0,0.0
1196812.0,6,13,3000,8,2372,170973.14285714287,1514.0,296.5,5,628,230295.0,331.0,125.6
323.0,17,2,174,1,79,0.0,79.0,79.0,1,95,0.0,95.0,95.0
110981049.0,6,30,1990,15,1042,7911796.214285715,139.0,69.46666666666667,15,948,7911796.071428572,123.0,63.2
3588.0,17,4,344,2,150,0.0,75.0,75.0,2,194,0.0,103.0,97.0
311232.0,6,5,337,3,174,155616.0,66.0,58.0,2,163,0.0,97.0,81.5
113141422.0,6,31,2166,16,1149,7528377.133333334,123.0,71.8125,15,1017,8066116.357142857,123.0,67.8
318.0,17,2,174,1,79,0.0,79.0,79.0,1,95,0.0,95.0,95.0
135124264.0,17,6,1206,6,1206,27024852.8,201.0,201.0,0,0,0.0,0.0,0.0
256901.0,6,3,337,2,214,0.0,160.0,107.0,1,123,0.0,123.0,123.0
90252420.0,6,16,1192,8,596,12852614.857142856,95.0,74.5,8,596,12862385.714285716,95.0,74.5
217974.0,6,3,426,2,280,0.0,214.0,140.0,1,146,0.0,146.0,146.0
33689.0,6,14,4740,7,653,5489.666666666667,249.0,93.28571428571428,7,4087,5049.0,1514.0,583.8571428571429
2034.0,17,4,344,2,150,0.0,75.0,75.0,2,194,0.0,103.0,97.0
116747762.0,17,13,821,7,432,19334238.83333333,174.0,61.71428571428572,6,389,20098509.2,174.0,64.83333333333333
3007902.0,6,12,2172,7,664,501127.3333333333,252.0,94.85714285714286,5,1508,2016.25,1236.0,301.6
126096012.0,6,32,2242,17,1225,7881000.75,139.0,72.05882352941177,15,1017,8278050.785714285,123.0,67.8
108214646.0,6,44,2904,22,1452,5153078.380952381,66.0,66.0,22,1452,5138345.476190476,66.0,66.0
320.0,17,2,166,1,75,0.0,75.0,75.0,1,91,0.0,91.0,91.0
2012.0,17,4,344,2,150,0.0,75.0,75.0,2,194,0.0,103.0,97.0
90018980.0,17,28,13364,28,13364,3334036.296296296,501.0,477.2857142857143,0,0,0.0,0.0,0.0
2446.0,17,4,344,2,150,0.0,75.0,75.0,2,194,0.0,103.0,97.0
90033742.0,17,28,13364,28,13364,3334583.037037037,501.0,477.2857142857143,0,0,0.0,0.0,0.0
50960.0,17,2,180,1,90,0.0,90.0,90.0,1,90,0.0,90.0,90.0
116001170.0,17,13,821,7,432,19333528.33333333,174.0,61.71428571428572,6,389,20048980.2,174.0,64.83333333333333
1481.0,17,2,762,2,762,0.0,381.0,381.0,0,0,0.0,0.0,0.0
228633.0,17,2,180,1,90,0.0,90.0,90.0,1,90,0.0,90.0,90.0
209523.0,17,2,180,1,90,0.0,90.0,90.0,1,90,0.0,90.0,90.0
315199.0,6,6,412,4,272,105066.33333333331,74.0,68.0,2,140,0.0,74.0,70.0
217650.0,6,3,426,2,280,0.0,214.0,140.0,1,146,0.0,146.0,146.0
21913252.0,6,6,1981,4,1087,7304417.333333333,885.0,271.75,2,894,0.0,826.0,447.0
120000046.0,6,17,1287,9,691,15000005.75,95.0,76.77777777777777,8,596,12897229.285714284,95.0,74.5
20554.0,6,2,145,2,145,0.0,91.0,72.5,0,0,0.0,0.0,0.0
2376.0,17,4,344,2,150,0.0,75.0,75.0,2,194,0.0,103.0,97.0
124001375.0,17,15,907,8,475,17714482.14285714,174.0,59.375,7,432,17334353.833333332,174.0,61.71428571428572
965586.0,6,12,1447,6,816,192190.0,291.0,136.0,6,631,192894.2,293.0,105.16666666666669
108109885.0,17,5,955,5,955,27027471.25,191.0,191.0,0,0,0.0,0.0,0.0
2626.0,17,2,762,2,762,0.0,381.0,381.0,0,0,0.0,0.0,0.0
2014476.0,17,6,1230,3,234,1007041.0,78.0,78.0,3,996,1007026.5,332.0,332.0
104006516.0,17,13,821,7,432,17334419.333333332,174.0,61.71428571428572,6,389,16800158.6,174.0,64.83333333333333
108109414.0,17,5,955,5,955,27027353.5,191.0,191.0,0,0,0.0,0.0,0.0
192652.0,17,2,180,1,90,0.0,90.0,90.0,1,90,0.0,90.0,90.0
205918.0,6,3,426,2,280,0.0,214.0,140.0,1,146,0.0,146.0,146.0
144757.0,17,2,180,1,70,0.0,70.0,70.0,1,110,0.0,110.0,110.0
120113426.0,6,14,2240,8,1016,17136018.57142857,188.0,127.0,6,1224,18018583.6,204.0,204.0
49842.0,17,4,6056,4,6056,16614.0,1514.0,1514.0,0,0,0.0,0.0,0.0
10454521.0,6,7,478,4,272,3439604.333333333,74.0,68.0,3,206,5159306.0,74.0,68.66666666666667
120213569.0,6,226,25534,113,7754,1066365.9107142857,140.0,68.61946902654867,113,17780,1065956.669642857,284.0,157.34513274336285
10241.0,6,10,1066,5,490,2391.75,218.0,98.0,5,576,1872.5,304.0,115.2
323357.0,6,10,1221,6,636,64671.4,298.0,106.0,4,585,102301.33333333331,379.0,146.25
109543637.0,6,30,2122,15,1105,7809129.428571428,139.0,73.66666666666667,15,1017,7809125.714285715,123.0,67.8
2572.0,17,4,344,2,150,0.0,75.0,75.0,2,194,0.0,103.0,97.0
51049.0,6,14,4740,7,653,8379.5,249.0,93.28571428571428,7,4087,7885.166666666667,1514.0,583.8571428571429
117365.0,6,11,2098,6,590,23137.0,252.0,98.33333333333331,5,1508,27914.25,1236.0,301.6
242391.0,6,3,426,2,280,0.0,214.0,140.0,1,146,0.0,146.0,146.0
317700.0,6,6,412,4,272,105900.0,74.0,68.0,2,140,0.0,74.0,70.0
120515302.0,6,199,22598,100,15768,1217326.2828282828,284.0,157.68,99,6830,1219107.7448979593,140.0,68.98989898989899
5010166.0,17,4,376,2,152,0.0,76.0,76.0,2,224,0.0,148.0,112.0
2605.0,17,4,344,2,150,0.0,75.0,75.0,2,194,0.0,103.0,97.0
103770463.0,6,29,2052,15,1089,7396764.357142857,123.0,72.6,14,963,7965753.923076923,123.0,68.78571428571429
121447.0,6,3,337,2,214,0.0,160.0,107.0,1,123,0.0,123.0,123.0
315700.0,17,4,1400,4,1400,105233.33333333331,350.0,350.0,0,0,0.0,0.0,0.0
2329.0,17,4,344,2,150,0.0,75.0,75.0,2,194,0.0,103.0,97.0
40524.0,6,19,7540,11,978,4052.4,310.0,88.9090909090909,8,6562,4344.0,1514.0,820.25
1188844.0,6,13,3011,8,2383,169834.85714285713,1514.0,297.875,5,628,228317.75,331.0,125.6
309336.0,17,4,1400,4,1400,103112.0,350.0,350.0,0,0,0.0,0.0,0.0
309303.0,6,6,412,4,272,103101.0,74.0,68.0,2,140,0.0,74.0,70.0
119477527.0,6,232,26216,116,18264,1037063.5391304347,284.0,157.44827586206895,116,7952,1037064.0869565216,140.0,68.55172413793103
2603548.0,6,2,132,1,66,0.0,66.0,66.0,1,66,0.0,66.0,66.0
25931.0,6,10,2032,5,524,4935.25,252.0,104.8,5,1508,6214.25,1236.0,301.6
57403134.0,6,9,1479,9,1479,7175391.75,172.0,164.33333333333334,0,0,0.0,0.0,0.0
143854.0,17,2,180,1,90,0.0,90.0,90.0,1,90,0.0,90.0,90.0
99949301.0,6,24,1500,12,783,9066676.090909092,123.0,65.25,12,717,9066680.727272728,123.0,59.75
233953.0,6,3,373,2,238,0.0,172.0,119.0,1,135,0.0,135.0,135.0
36461.0,6,14,4740,7,653,5901.166666666667,249.0,93.28571428571428,7,4087,4971.0,1514.0,583.8571428571429
76731.0,6,14,4740,7,653,12660.166666666666,249.0,93.28571428571428,7,4087,12422.5,1514.0,583.8571428571429
45805.0,6,14,4740,7,653,7263.5,249.0,93.28571428571428,7,4087,7462.0,1514.0,583.8571428571429
300036.0,6,6,412,4,272,100012.0,74.0,68.0,2,140,0.0,74.0,70.0
112221.0,17,4,1400,4,1400,37407.0,350.0,350.0,0,0,0.0,0.0,0.0
135133013.0,17,6,1206,6,1206,27026602.6,201.0,201.0,0,0,0.0,0.0,0.0
146166.0,6,3,337,2,214,0.0,160.0,107.0,1,123,0.0,123.0,123.0
4808.0,17,4,344,2,150,0.0,75.0,75.0,2,194,0.0,103.0,97.0
25733.0,6,14,4740,7,653,4121.166666666667,249.0,93.28571428571428,7,4087,4038.8333333333335,1514.0,583.8571428571429
10458426.0,6,7,478,4,272,3440895.6666666665,74.0,68.0,3,206,5161244.5,74.0,68.66666666666667
15682.000000000002,6,10,1067,5,536,3489.75,264.0,107.2,5,531,2967.75,259.0,106.2
241897.0,6,3,337,2,214,0.0,160.0,107.0,1,123,0.0,123.0,123.0
109149204.0,6,44,2904,22,1452,5197581.142857143,66.0,66.0,22,1452,5182841.047619048,66.0,66.0
107239.0,17,2,286,2,286,0.0,143.0,143.0,0,0,0.0,0.0,0.0
53150.0,6,14,4740,7,653,7940.666666666667,249.0,93.28571428571428,7,4087,8446.5,1514.0,583.8571428571429
300247.0,6,6,412,4,272,100082.33333333331,74.0,68.0,2,140,0.0,74.0,70.0
10214.0,17,4,823,2,163,0.0,89.0,81.5,2,660,0.0,443.0,330.0
301493.0,6,6,412,4,272,100497.66666666669,74.0,68.0,2,140,0.0,74.0,70.0
865982.0,6,9,1267,6,796,173196.4,458.0,132.66666666666666,3,471,296673.5,331.0,157.0
36591.0,6,14,4740,7,653,5924.666666666667,249.0,93.28571428571428,7,4087,5657.333333333333,1514.0,583.8571428571429
219464.0,6,3,426,2,280,0.0,214.0,140.0,1,146,0.0,146.0,146.0
307378.0,6,6,412,4,272,102459.33333333331,74.0,68.0,2,140,0.0,74.0,70.0
14441.0,6,12,1393,6,796,2646.8,271.0,132.66666666666666,6,597,2716.2,259.0,99.5
2118774.0,6,4,492,2,280,0.0,214.0,140.0,2,212,0.0,146.0,106.0
303671.0,6,2,132,1,66,0.0,66.0,66.0,1,66,0.0,66.0,66.0
55859.0,6,10,2032,5,524,13273.75,252.0,104.8,5,1508,11286.0,1236.0,301.6
120012550.0,6,24,1829,13,1030,9999907.166666666,95.0,79.23076923076923,11,799,11928793.4,95.0,72.63636363636364
313102.0,6,6,412,4,272,104367.33333333331,74.0,68.0,2,140,0.0,74.0,70.0
1652631.0,17,6,1230,3,234,826126.5,78.0,78.0,3,996,826113.5,332.0,332.0
90365155.0,6,11,1644,7,828,15060859.166666666,188.0,118.28571428571428,4,816,20111762.0,204.0,204.0
38760.0,6,14,4740,7,653,6198.666666666667,249.0,93.28571428571428,7,4087,6249.5,1514.0,583.8571428571429
27306.0,6,2,145,2,145,0.0,91.0,72.5,0,0,0.0,0.0,0.0
123610501.0,6,49,3234,25,1650,5150437.541666667,66.0,66.0,24,1584,5119238.478260869,66.0,66.0
38679.0,6,14,4740,7,653,6173.166666666667,249.0,93.28571428571428,7,4087,6125.5,1514.0,583.8571428571429
1027707.0,6,11,1134,6,558,205541.4,220.0,93.0,5,576,255706.25,304.0,115.2
120251332.0,6,230,25990,115,7898,1047524.9385964912,140.0,68.67826086956522,115,18092,1047606.394736842,284.0,157.3217391304348
108111350.0,17,5,1005,5,1005,27027837.5,201.0,201.0,0,0,0.0,0.0,0.0
106917288.0,6,224,26572,112,7688,960900.5765765766,140.0,68.64285714285714,112,18884,961027.3243243244,284.0,168.60714285714286
14631130.0,6,20,1648,10,1016,1592472.111111111,315.0,101.6,10,632,1592450.7777777778,78.0,63.2
103373.0,17,2,762,2,762,0.0,381.0,381.0,0,0,0.0,0.0,0.0
96522840.0,6,24,1638,13,906,8043570.0,123.0,69.6923076923077,11,732,8630356.7,123.0,66.54545454545455
0.0,17,1,350,1,350,0.0,350.0,350.0,0,0,0.0,0.0,0.0
179734.0,17,2,180,1,90,0.0,90.0,90.0,1,90,0.0,90.0,90.0
27556141.0,17,5,1710,5,1710,6889035.25,342.0,342.0,0,0,0.0,0.0,0.0
217202.0,6,3,426,2,280,0.0,214.0,140.0,1,146,0.0,146.0,146.0
0.0,6,1,66,1,66,0.0,66.0,66.0,0,0,0.0,0.0,0.0
61785.0,6,14,4740,7,653,9591.0,249.0,93.28571428571428,7,4087,9091.166666666666,1514.0,583.8571428571429
135133939.0,17,6,1206,6,1206,27026787.8,201.0,201.0,0,0,0.0,0.0,0.0
233548.0,6,10,1221,6,636,46709.6,298.0,106.0,4,585,71743.33333333333,379.0,146.25
90259573.0,6,12,1832,8,1016,12894224.714285716,188.0,127.0,4,816,30031063.0,204.0,204.0
82.0,17,2,762,2,762,0.0,381.0,381.0,0,0,0.0,0.0,0.0
122103.0,6,3,337,2,214,0.0,160.0,107.0,1,123,0.0,123.0,123.0
253627.0,6,3,337,2,214,0.0,160.0,107.0,1,123,0.0,123.0,123.0
279441.0,17,2,180,1,90,0.0,90.0,90.0,1,90,0.0,90.0,90.0
1750211.0,6,20,7599,11,1469,175021.1,583.0,133.54545454545453,9,6130,183944.375,1484.0,681.1111111111111
1028973.0,6,11,1134,6,558,205794.6,220.0,93.0,5,576,256026.25,304.0,115.2
120123974.0,6,13,2036,5,1020,30030993.5,204.0,204.0,8,1016,17136768.85714286,188.0,127.0
202529.0,17,4,6056,4,6056,67509.66666666667,1514.0,1514.0,0,0,0.0,0.0,0.0
25583.0,6,14,4740,7,653,4142.0,249.0,93.28571428571428,7,4087,4124.333333333333,1514.0,583.8571428571429
1308905.0,6,4,264,2,132,0.0,66.0,66.0,2,132,0.0,66.0,66.0
16086.0,6,11,1132,6,556,3051.4,218.0,92.66666666666669,5,576,3154.0,304.0,115.2
33180.0,6,14,4740,7,653,5403.5,249.0,93.28571428571428,7,4087,4714.0,1514.0,583.8571428571429
90724353.0,6,18,1382,10,786,10076021.0,95.0,78.6,8,596,12959615.42857143,95.0,74.5
3174994.0,6,5,336,2,134,0.0,68.0,67.0,3,202,195127.5,70.0,67.33333333333333
20046.0,6,10,2032,5,524,4804.75,252.0,104.8,5,1508,4348.0,1236.0,301.6
120125180.0,6,227,25690,113,17870,1065334.6875,284.0,158.141592920354,114,7820,1061150.07079646,140.0,68.59649122807018
40614.0,6,14,4740,7,653,6514.5,249.0,93.28571428571428,7,4087,5554.166666666667,1514.0,583.8571428571429
43474.0,6,14,4740,7,653,6418.0,249.0,93.28571428571428,7,4087,7054.666666666667,1514.0,583.8571428571429
128871474.0,6,38,2716,20,1468,6782709.157894737,139.0,73.4,18,1248,6980617.705882353,123.0,69.33333333333333
382116.0,6,10,1221,6,636,76423.2,298.0,106.0,4,585,121987.66666666669,379.0,146.25
236592.0,6,3,426,2,280,0.0,214.0,140.0,1,146,0.0,146.0,146.0
298741.0,17,2,238,1,74,0.0,74.0,74.0,1,164,0.0,164.0,164.0
216938.0,6,3,426,2,280,0.0,214.0,140.0,1,146,0.0,146.0,146.0
249599.0,17,8,12112,8,12112,35657.0,1514.0,1514.0,0,0,0.0,0.0,0.0
102532.0,17,2,762,2,762,0.0,381.0,381.0,0,0,0.0,0.0,0.0
60296.0,6,10,1065,5,534,14912.25,262.0,106.8,5,531,10286.25,259.0,106.2
123001040.0,17,15,1169,8,606,17571577.14285714,174.0,75.75,7,563,17167845.0,174.0,80.42857142857143
120255.0,17,2,180,1,70,0.0,70.0,70.0,1,110,0.0,110.0,110.0
138071.0,6,2,132,1,66,0.0,66.0,66.0,1,66,0.0,66.0,66.0
37635.0,6,14,4740,7,653,6150.5,249.0,93.28571428571428,7,4087,5583.0,1514.0,583.8571428571429
146198.0,6,3,337,2,214,0.0,160.0,107.0,1,123,0.0,123.0,123.0
299233.0,17,2,224,1,76,0.0,76.0,76.0,1,148,0.0,148.0,148.0
111941.0,17,4,1400,4,1400,37313.66666666666,350.0,350.0,0,0,0.0,0.0,0.0
303973.0,6,6,412,4,272,101324.33333333331,74.0,68.0,2,140,0.0,74.0,70.0
301785.0,6,6,412,4,272,100595.0,74.0,68.0,2,140,0.0,74.0,70.0
254189.0,6,10,1221,6,636,50837.8,298.0,106.0,4,585,78589.0,379.0,146.25
135132892.0,17,6,1206,6,1206,27026578.4,201.0,201.0,0,0,0.0,0.0,0.0
228172.0,17,2,180,1,90,0.0,90.0,90.0,1,90,0.0,90.0,90.0
107849018.0,6,28,1860,14,966,8296078.307692308,123.0,69.0,14,894,8279439.769230769,123.0,63.85714285714285
31023.0,6,10,2032,5,524,7421.5,252.0,104.8,5,1508,7335.75,1236.0,301.6
28810.0,6,14,4740,7,653,4647.333333333333,249.0,93.28571428571428,7,4087,4072.5,1514.0,583.8571428571429
51162.0,6,14,4740,7,653,8400.333333333334,249.0,93.28571428571428,7,4087,8011.833333333333,1514.0,583.8571428571429
57835.0,6,14,4740,7,653,8768.666666666666,249.0,93.28571428571428,7,4087,9349.833333333334,1514.0,583.8571428571429
108108769.0,17,5,1005,5,1005,27027192.25,201.0,201.0,0,0,0.0,0.0,0.0
2332.0,17,4,344,2,150,0.0,75.0,75.0,2,194,0.0,103.0,97.0
41084.0,6,14,4740,7,653,6725.833333333333,249.0,93.28571428571428,7,4087,6605.333333333333,1514.0,583.8571428571429
126935806.0,6,32,2157,16,1071,7796711.933333334,123.0,66.9375,16,1086,8462218.333333334,123.0,67.875
104055958.0,17,14,864,7,432,17334179.5,174.0,61.71428571428572,7,432,17333517.666666668,174.0,61.71428571428572
42947.0,6,14,4740,7,653,7027.5,249.0,93.28571428571428,7,4087,6990.5,1514.0,583.8571428571429
907.0,17,5,550,5,550,226.75,110.0,110.0,0,0,0.0,0.0,0.0
121204.0,6,3,337,2,214,0.0,160.0,107.0,1,123,0.0,123.0,123.0
2304.0,17,4,344,2,150,0.0,75.0,75.0,2,194,0.0,103.0,97.0
298700.0,6,6,412,4,272,99566.66666666669,74.0,68.0,2,140,0.0,74.0,70.0
108106710.0,17,5,1005,5,1005,27026677.5,201.0,201.0,0,0,0.0,0.0,0.0
107557144.0,6,44,2904,22,1452,5121768.761904762,66.0,66.0,22,1452,5105935.428571428,66.0,66.0
801.0,17,4,438,2,148,0.0,74.0,74.0,2,290,0.0,147.0,145.0
1296400.0,6,4,264,2,132,0.0,66.0,66.0,2,132,0.0,66.0,66.0
4310.0,17,2,626,1,72,0.0,72.0,72.0,1,554,0.0,554.0,554.0
108100744.0,17,5,955,5,955,27025186.0,191.0,191.0,0,0,0.0,0.0,0.0
81251.0,6,10,2032,5,524,18944.0,252.0,104.8,5,1508,17651.25,1236.0,301.6
67563126.0,6,9,1479,9,1479,8445390.75,172.0,164.33333333333334,0,0,0.0,0.0,0.0
99335178.0,6,67,6096,39,3411,2614083.6315789474,123.0,87.46153846153847,28,2685,3671062.0,123.0,95.89285714285714
107088751.0,6,243,27482,122,8348,885031.0,140.0,68.42622950819673,121,19134,883732.9083333333,284.0,158.13223140495867
119690770.0,6,47,3102,23,1518,5159984.7727272725,66.0,66.0,24,1584,5203933.391304348,66.0,66.0
14395.0,6,10,2032,5,524,3317.75,252.0,104.8,5,1508,3304.75,1236.0,301.6
336.0,17,2,166,1,75,0.0,75.0,75.0,1,91,0.0,91.0,91.0
38090.0,6,10,1065,5,534,9339.5,262.0,106.8,5,531,7814.75,259.0,106.2
2019135.0,17,4,525,2,150,0.0,75.0,75.0,2,375,0.0,284.0,187.5
112430.0,17,2,286,2,286,0.0,143.0,143.0,0,0,0.0,0.0,0.0
281735.0,6,10,1221,6,636,56347.0,298.0,106.0,4,585,92867.66666666669,379.0,146.25
165590.0,17,2,414,1,88,0.0,88.0,88.0,1,326,0.0,326.0,326.0
147842.0,17,2,180,1,90,0.0,90.0,90.0,1,90,0.0,90.0,90.0
111683690.0,6,32,2220,16,1149,7431199.533333333,123.0,71.8125,16,1071,7431196.666666667,123.0,66.9375
120119929.0,6,14,2240,6,1224,24023985.8,204.0,204.0,8,1016,17136392.57142857,188.0,127.0
9099.0,17,2,539,1,86,0.0,86.0,86.0,1,453,0.0,453.0,453.0
1317813.0,6,4,264,2,132,0.0,66.0,66.0,2,132,0.0,66.0,66.0
284640.0,17,2,363,1,79,0.0,79.0,79.0,1,284,0.0,284.0,284.0
299614.0,6,6,412,4,272,99871.33333333331,74.0,68.0,2,140,0.0,74.0,70.0
2514784.0,6,3,1604,1,753,0.0,753.0,753.0,2,851,0.0,785.0,425.5
33705761.0,6,5,336,2,134,0.0,68.0,67.0,3,202,15565132.0,70.0,67.33333333333333
10079.0,6,10,1975,5,467,2288.0,195.0,93.4,5,1508,2202.75,1236.0,301.6
73559.0,6,10,2032,5,524,17124.75,252.0,104.8,5,1508,17211.25,1236.0,301.6
90977002.0,6,21,1585,11,840,9095353.9,95.0,76.36363636363636,10,745,10107132.444444444,95.0,74.5
108528.0,17,2,286,2,286,0.0,143.0,143.0,0,0,0.0,0.0,0.0
1313413.0,6,4,264,2,132,0.0,66.0,66.0,2,132,0.0,66.0,66.0
2840336.0,6,3,1604,2,851,0.0,785.0,425.5,1,753,0.0,753.0,753.0
103746.0,17,2,286,2,286,0.0,143.0,143.0,0,0,0.0,0.0,0.0
467.0,17,2,508,2,508,0.0,257.0,254.0,0,0,0.0,0.0,0.0
114054911.0,6,48,3168,24,1584,4958909.173913044,66.0,66.0,24,1584,4945490.652173913,66.0,66.0
90536989.0,6,14,2240,8,1016,12933855.57142857,188.0,127.0,6,1224,18074863.6,204.0,204.0
327.0,17,2,174,1,79,0.0,79.0,79.0,1,95,0.0,95.0,95.0
90476680.0,6,288,33474,144,23748,631226.3566433566,284.0,164.91666666666666,144,9726,631226.2517482517,140.0,67.54166666666667
201609.0,17,2,359,1,75,0.0,75.0,75.0,1,284,0.0,284.0,284.0
87992.0,6,10,2032,5,524,21753.25,252.0,104.8,5,1508,20771.0,1236.0,301.6
106191.0,17,2,286,2,286,0.0,143.0,143.0,0,0,0.0,0.0,0.0
21410.0,17,2,582,1,83,0.0,83.0,83.0,1,499,0.0,499.0,499.0
104037.0,17,2,286,2,286,0.0,143.0,143.0,0,0,0.0,0.0,0.0
1573666.0,6,18,6507,10,1598,174851.77777777778,505.0,159.8,8,4909,179666.14285714287,1510.0,613.625
90315321.0,6,16,1192,8,596,12895171.285714284,95.0,74.5,8,596,12901084.714285716,95.0,74.5
113191119.0,17,16,1474,8,737,16147456.142857144,174.0,92.125,8,737,16147456.142857144,174.0,92.125
44235.0,6,10,2032,5,524,9196.25,252.0,104.8,5,1508,9150.75,1236.0,301.6
33910245.0,6,5,336,2,134,0.0,68.0,67.0,3,202,16887478.0,70.0,67.33333333333333
53323.0,6,14,4740,7,653,8686.333333333334,249.0,93.28571428571428,7,4087,8661.833333333334,1514.0,583.8571428571429
2293.0,17,4,344,2,150,0.0,75.0,75.0,2,194,0.0,103.0,97.0
151905.0,17,2,414,1,88,0.0,88.0,88.0,1,326,0.0,326.0,326.0
1723794.0,6,6,420,4,284,574598.0,78.0,71.0,2,136,0.0,68.0,68.0
16908.0,17,2,180,1,90,0.0,90.0,90.0,1,90,0.0,90.0,90.0
90046991.0,17,28,13364,28,13364,3335073.7407407407,501.0,477.2857142857143,0,0,0.0,0.0,0.0
246373.0,6,3,373,2,238,0.0,172.0,119.0,1,135,0.0,135.0,135.0
3633.0,17,2,352,1,72,0.0,72.0,72.0,1,280,0.0,280.0,280.0
108508212.0,6,31,2176,16,1071,7233853.266666667,123.0,66.9375,15,1105,7347111.214285715,139.0,73.66666666666667
5632521.0,6,4,270,2,134,0.0,68.0,67.0,2,136,0.0,70.0,68.0
1026081.0,6,11,1134,6,558,205216.2,220.0,93.0,5,576,255285.0,304.0,115.2
135136816.0,17,6,1146,6,1146,27027363.2,191.0,191.0,0,0,0.0,0.0,0.0
233290.0,6,3,337,2,214,0.0,160.0,107.0,1,123,0.0,123.0,123.0
209701.0,17,2,180,1,90,0.0,90.0,90.0,1,90,0.0,90.0,90.0
1052481.0,6,13,1386,7,789,175413.5,253.0,112.71428571428572,6,597,208767.6,259.0,99.5
120120508.0,6,13,2020,9,1204,15015063.5,188.0,133.77777777777777,4,816,30030113.33333333,204.0,204.0
2800426.0,6,2,132,1,66,0.0,66.0,66.0,1,66,0.0,66.0,66.0
2874389.0,6,4,270,2,134,0.0,68.0,67.0,2,136,0.0,70.0,68.0
120052719.0,17,29,13785,29,13785,4287597.107142857,501.0,475.3448275862069,0,0,0.0,0.0,0.0
115214520.0,6,37,2656,19,1408,6400806.666666667,139.0,74.10526315789474,18,1248,6764638.647058823,123.0,69.33333333333333
2971249.0,6,119,97550,72,90146,41846.22535211268,1510.0,1252.0277777777778,47,7404,57877.47826086957,1510.0,157.53191489361703
205402.0,17,2,762,2,762,0.0,381.0,381.0,0,0,0.0,0.0,0.0
36807.0,6,14,4740,7,653,6008.5,249.0,93.28571428571428,7,4087,5799.5,1514.0,583.8571428571429
335.0,17,2,166,1,75,0.0,75.0,75.0,1,91,0.0,91.0,91.0
274684.0,17,4,1524,4,1524,91561.33333333331,381.0,381.0,0,0,0.0,0.0,0.0
122687954.0,6,49,3234,25,1650,5111998.083333333,66.0,66.0,24,1584,5101824.043478261,66.0,66.0
37599.0,6,14,4740,7,653,4919.166666666667,249.0,93.28571428571428,7,4087,6038.666666666667,1514.0,583.8571428571429
29134957.0,17,5,1718,4,1368,1760542.0,342.0,342.0,1,350,0.0,350.0,350.0
25979.0,6,14,4740,7,653,4211.166666666667,249.0,93.28571428571428,7,4087,3783.5,1514.0,583.8571428571429
206063.0,17,2,180,1,90,0.0,90.0,90.0,1,90,0.0,90.0,90.0
120025456.0,17,28,13364,28,13364,4445387.259259259,501.0,477.2857142857143,0,0,0.0,0.0,0.0
107120639.0,6,651,86428,326,64756,329601.9661538462,554.0,198.638036809816,325,21672,327409.0555555556,140.0,66.68307692307692
172320.0,17,2,414,1,88,0.0,88.0,88.0,1,326,0.0,326.0,326.0
88862.0,6,12,1328,7,797,14810.333333333334,253.0,113.85714285714286,5,531,20585.0,259.0,106.2
228243.0,17,2,180,1,90,0.0,90.0,90.0,1,90,0.0,90.0,90.0
120124294.0,6,15,2428,9,1204,15015536.75,188.0,133.77777777777777,6,1224,18018534.6,204.0,204.0
216752.0,6,3,426,2,280,0.0,214.0,140.0,1,146,0.0,146.0,146.0
231886.0,6,10,1221,6,636,46377.2,298.0,106.0,4,585,75878.33333333333,379.0,146.25
120000048.0,6,17,1287,9,691,15000006.0,95.0,76.77777777777777,8,596,12897273.0,95.0,74.5
1893.0,17,4,438,2,148,0.0,74.0,74.0,2,290,0.0,147.0,145.0
153485.0,17,2,180,1,90,0.0,90.0,90.0,1,90,0.0,90.0,90.0
1995.0,17,4,344,2,150,0.0,75.0,75.0,2,194,0.0,103.0,97.0
306904.0,6,6,412,4,272,102301.33333333331,74.0,68.0,2,140,0.0,74.0,70.0
118396864.0,17,14,864,7,432,19668428.5,174.0,61.71428571428572,7,432,19666829.33333333,174.0,61.71428571428572
109205.0,17,2,286,2,286,0.0,143.0,143.0,0,0,0.0,0.0,0.0
2996047.0,6,3,1777,1,826,0.0,826.0,826.0,2,951,0.0,885.0,475.5
150032.0,17,4,6056,4,6056,50010.66666666666,1514.0,1514.0,0,0,0.0,0.0,0.0
322669.0,17,4,1400,4,1400,107556.33333333331,350.0,350.0,0,0,0.0,0.0,0.0
147991.0,17,2,180,1,90,0.0,90.0,90.0,1,90,0.0,90.0,90.0
303107.0,6,2,132,1,66,0.0,66.0,66.0,1,66,0.0,66.0,66.0
39523.0,6,14,4740,7,653,6366.666666666667,249.0,93.28571428571428,7,4087,5761.0,1514.0,583.8571428571429
356473.0,6,4,492,2,280,0.0,214.0,140.0,2,212,0.0,146.0,106.0
33340.0,6,14,4740,7,653,4936.833333333333,249.0,93.28571428571428,7,4087,4484.166666666667,1514.0,583.8571428571429
120143634.0,6,228,25772,114,7820,1046866.8761061948,140.0,68.59649122807018,114,17952,1055829.7787610618,284.0,157.47368421052633
90052420.0,17,28,13364,28,13364,3335274.814814815,501.0,477.2857142857143,0,0,0.0,0.0,0.0
5006969.0,17,4,534,2,166,0.0,83.0,83.0,2,368,0.0,184.0,184.0
120502699.0,6,215,24390,108,17106,1126193.4485981308,284.0,158.38888888888889,107,7284,1126973.1603773586,140.0,68.07476635514018
316.0,17,2,166,1,75,0.0,75.0,75.0,1,91,0.0,91.0,91.0
103545.0,17,2,286,2,286,0.0,143.0,143.0,0,0,0.0,0.0,0.0
0.0,6,1,66,1,66,0.0,66.0,66.0,0,0,0.0,0.0,0.0
146337.0,6,3,337,2,214,0.0,160.0,107.0,1,123,0.0,123.0,123.0
82098.0,6,12,1328,7,797,13683.0,253.0,113.85714285714286,5,531,18939.75,259.0,106.2
235435.0,6,3,337,2,214,0.0,160.0,107.0,1,123,0.0,123.0,123.0
28748.0,6,14,4740,7,653,4676.666666666667,249.0,93.28571428571428,7,4087,4466.666666666667,1514.0,583.8571428571429
119882.0,17,2,180,1,70,0.0,70.0,70.0,1,110,0.0,110.0,110.0
842255.0,6,9,1118,6,586,168451.0,248.0,97.66666666666669,3,532,283331.5,392.0,177.33333333333334
108099859.0,17,5,1005,5,1005,27024964.75,201.0,201.0,0,0,0.0,0.0,0.0
306207.0,6,6,412,4,272,102069.0,74.0,68.0,2,140,0.0,74.0,70.0
149538232.0,17,36,17126,36,17126,4272520.914285715,501.0,475.72222222222223,0,0,0.0,0.0,0.0
436830.0,6,11,1021,6,444,58544.6,162.0,74.0,5,577,73082.25,349.0,115.4
110400347.0,6,32,2220,16,1149,7345646.666666667,123.0,71.8125,16,1071,7345644.6,123.0,66.9375
232483.0,6,3,337,2,214,0.0,160.0,107.0,1,123,0.0,123.0,123.0
3251.0,17,2,224,1,76,0.0,76.0,76.0,1,148,0.0,148.0,148.0
11203.0,6,11,2098,6,590,2004.8,252.0,98.33333333333331,5,1508,2226.75,1236.0,301.6
45535.0,6,2,132,1,66,0.0,66.0,66.0,1,66,0.0,66.0,66.0
39199.0,6,14,4740,7,653,6340.333333333333,249.0,93.28571428571428,7,4087,6133.5,1514.0,583.8571428571429
90256699.0,6,14,2240,8,1016,12893814.142857144,188.0,127.0,6,1224,18018661.4,204.0,204.0
90027732.0,17,27,12943,27,12943,3462605.076923077,501.0,479.3703703703704,0,0,0.0,0.0,0.0
135133805.0,17,6,1146,6,1146,27026761.0,191.0,191.0,0,0,0.0,0.0,0.0
207394.0,6,3,426,2,280,0.0,214.0,140.0,1,146,0.0,146.0,146.0
60379.0,6,2,132,1,66,0.0,66.0,66.0,1,66,0.0,66.0,66.0
253000.0,6,3,337,2,214,0.0,160.0,107.0,1,123,0.0,123.0,123.0
71399.0,6,14,4740,7,653,11775.166666666666,249.0,93.28571428571428,7,4087,10988.666666666666,1514.0,583.8571428571429
1306198.0,6,4,264,2,132,0.0,66.0,66.0,2,132,0.0,66.0,66.0
58906.0,6,11,1132,6,556,11781.2,218.0,92.66666666666669,5,576,14398.25,304.0,115.2
90027099.0,17,28,13364,28,13364,3334337.0,501.0,477.2857142857143,0,0,0.0,0.0,0.0
120005126.0,6,21,1585,11,840,11999999.9,95.0,76.36363636363636,10,745,13333408.0,95.0,74.5
7034.0,17,2,582,1,83,0.0,83.0,83.0,1,499,0.0,499.0,499.0
121191.0,6,3,337,2,214,0.0,160.0,107.0,1,123,0.0,123.0,123.0
232143.0,6,3,337,2,214,0.0,160.0,107.0,1,123,0.0,123.0,123.0
3193558.0,6,171,133286,94,123902,34339.333333333336,1510.0,1318.106382978723,77,9384,37311.01315789474,1510.0,121.87012987012989
109488870.0,6,202,22886,101,15998,1092737.0,284.0,158.3960396039604,101,6888,1092736.82,140.0,68.1980198019802
3310.0,17,4,344,2,150,0.0,75.0,75.0,2,194,0.0,103.0,97.0
102812.0,17,2,286,2,286,0.0,143.0,143.0,0,0,0.0,0.0,0.0
153663.0,17,2,180,1,90,0.0,90.0,90.0,1,90,0.0,90.0,90.0
60151.0,6,14,4740,7,653,9900.166666666666,249.0,93.28571428571428,7,4087,8179.833333333333,1514.0,583.8571428571429
56298.0,6,12,1320,7,789,9383.0,253.0,112.71428571428572,5,531,12131.5,259.0,106.2
120122886.0,6,15,2152,9,1204,15015360.75,188.0,133.77777777777777,6,948,18011547.2,204.0,158.0
50001.0,6,14,4740,7,653,8167.0,249.0,93.28571428571428,7,4087,8185.5,1514.0,583.8571428571429
30783.0,6,10,2032,5,524,5715.25,252.0,104.8,5,1508,7428.75,1236.0,301.6
148014.0,17,2,180,1,90,0.0,90.0,90.0,1,90,0.0,90.0,90.0
100287104.0,6,184,20776,92,14482,1099673.923076923,284.0,157.41304347826087,92,6294,1099676.989010989,140.0,68.41304347826087
109289514.0,17,14,864,7,432,18167627.33333333,174.0,61.71428571428572,7,432,18166828.0,174.0,61.71428571428572
103483.0,17,2,286,2,286,0.0,143.0,143.0,0,0,0.0,0.0,0.0
30379828.0,6,26,7627,14,3735,191952.0,1514.0,266.7857142857143,12,3892,2741233.090909091,1514.0,324.3333333333333
205971.0,17,2,762,2,762,0.0,381.0,381.0,0,0,0.0,0.0,0.0
46984.0,6,14,4740,7,653,6329.0,249.0,93.28571428571428,7,4087,6893.166666666667,1514.0,583.8571428571429
14498.0,6,11,1131,6,600,2632.4,262.0,100.0,5,531,3306.75,259.0,106.2
90030298.0,17,28,13364,28,13364,3334455.4814814813,501.0,477.2857142857143,0,0,0.0,0.0,0.0
2605.0,17,2,762,2,762,0.0,381.0,381.0,0,0,0.0,0.0,0.0
120354588.0,6,241,27244,121,19028,1002954.9,284.0,157.25619834710744,120,8216,1002863.151260504,140.0,68.46666666666667
120212173.0,6,18,1341,9,691,14999492.375,95.0,76.77777777777777,9,650,14999487.875,95.0,72.22222222222223
103102.0,17,2,286,2,286,0.0,143.0,143.0,0,0,0.0,0.0,0.0
888245.0,6,10,1332,6,795,177649.0,457.0,132.5,4,537,204387.66666666663,331.0,134.25
103073.0,17,2,286,2,286,0.0,143.0,143.0,0,0,0.0,0.0,0.0
266291.0,6,3,337,2,214,0.0,160.0,107.0,1,123,0.0,123.0,123.0
228065.0,17,2,180,1,90,0.0,90.0,90.0,1,90,0.0,90.0,90.0
206039.0,6,3,426,2,280,0.0,214.0,140.0,1,146,0.0,146.0,146.0
116526367.0,6,301,37166,151,26970,776842.4466666667,384.0,178.60927152317882,150,10196,780543.2147651006,140.0,67.97333333333333
591400.0,6,4,508,2,238,0.0,172.0,119.0,2,270,0.0,135.0,135.0
90210523.0,6,16,1192,8,596,12852890.857142856,95.0,74.5,8,596,12857997.42857143,95.0,74.5
208126.0,6,3,426,2,280,0.0,214.0,140.0,1,146,0.0,146.0,146.0
108102803.0,17,5,1005,5,1005,27025700.75,201.0,201.0,0,0,0.0,0.0,0.0
3176145.0,6,18,1495,9,921,358397.25,315.0,102.33333333333331,9,574,358351.875,78.0,63.77777777777778
115080278.0,6,47,3102,23,1518,5144003.363636363,66.0,66.0,24,1584,5003473.608695652,66.0,66.0
1311838.0,6,4,264,2,132,0.0,66.0,66.0,2,132,0.0,66.0,66.0
3117.0,17,2,224,1,76,0.0,76.0,76.0,1,148,0.0,148.0,148.0
90309864.0,6,16,1192,8,596,12894116.857142856,95.0,74.5,8,596,12900562.42857143,95.0,74.5
39398.0,6,14,4740,7,653,6305.833333333333,249.0,93.28571428571428,7,4087,6428.166666666667,1514.0,583.8571428571429
246331.0,6,3,337,2,214,0.0,160.0,107.0,1,123,0.0,123.0,123.0
93551139.0,6,27,1869,14,963,7196241.461538462,123.0,68.78571428571429,13,906,7773707.666666667,123.0,69.6923076923077
10480428.0,6,7,478,4,272,3447847.0,74.0,68.0,3,206,5171678.0,74.0,68.66666666666667
309821.0,6,6,412,4,272,103273.66666666669,74.0,68.0,2,140,0.0,74.0,70.0
4500773.0,6,5,336,2,134,0.0,68.0,67.0,3,202,1528543.0,70.0,67.33333333333333
144256.0,17,4,1524,4,1524,48085.333333333336,381.0,381.0,0,0,0.0,0.0,0.0
927.0,17,4,438,2,148,0.0,74.0,74.0,2,290,0.0,147.0,145.0
142384.0,17,4,704,2,148,0.0,74.0,74.0,2,556,0.0,280.0,278.0
47718.0,6,10,2032,5,524,10733.25,252.0,104.8,5,1508,10362.75,1236.0,301.6
120474315.0,6,237,27086,119,19002,1020968.7711864408,284.0,159.68067226890756,118,8084,1020798.435897436,140.0,68.50847457627118
525.0,17,2,508,2,508,0.0,257.0,254.0,0,0,0.0,0.0,0.0
109001140.0,17,13,821,7,432,18166856.666666668,174.0,61.71428571428572,6,389,17801482.4,174.0,64.83333333333333
34084.0,6,14,4740,7,653,5184.5,249.0,93.28571428571428,7,4087,5448.166666666667,1514.0,583.8571428571429
90203896.0,6,22,1680,10,745,9996414.555555556,95.0,74.5,12,935,8181750.272727272,95.0,77.91666666666667
2353.0,17,4,344,2,150,0.0,75.0,75.0,2,194,0.0,103.0,97.0
212461.0,17,2,180,1,90,0.0,90.0,90.0,1,90,0.0,90.0,90.0
16993.0,6,14,4740,7,653,2448.0,249.0,93.28571428571428,7,4087,2700.6666666666665,1514.0,583.8571428571429
237520.0,17,2,180,1,90,0.0,90.0,90.0,1,90,0.0,90.0,90.0
255189.0,6,3,337,2,214,0.0,160.0,107.0,1,123,0.0,123.0,123.0
97525024.0,17,12,778,6,389,19505004.8,174.0,64.83333333333333,6,389,19366677.4,174.0,64.83333333333333
113609997.0,6,46,3036,23,1518,5150441.045454546,66.0,66.0,23,1518,5150460.090909091,66.0,66.0
145488.0,6,3,337,2,214,0.0,160.0,107.0,1,123,0.0,123.0,123.0
42446.0,6,14,4740,7,653,4873.333333333333,249.0,93.28571428571428,7,4087,6615.666666666667,1514.0,583.8571428571429
119715.0,17,2,180,1,70,0.0,70.0,70.0,1,110,0.0,110.0,110.0
117667774.0,6,274,31148,137,21884,863622.2426470588,374.0,159.73722627737226,137,9264,863622.5147058824,140.0,67.62043795620438
14632467.0,6,20,1648,10,1016,1592600.4444444445,315.0,101.6,10,632,1592572.7777777778,78.0,63.2
90241358.0,6,20,1531,9,691,11248581.0,95.0,76.77777777777777,11,840,9002492.4,95.0,76.36363636363636
120090155.0,6,232,26280,116,7878,1019165.4608695653,140.0,67.91379310344827,116,18402,1037301.4347826086,300.0,158.63793103448276
108106210.0,17,5,955,5,955,27026552.5,191.0,191.0,0,0,0.0,0.0,0.0
36233.0,6,14,4740,7,653,5454.666666666667,249.0,93.28571428571428,7,4087,5893.833333333333,1514.0,583.8571428571429
119406942.0,6,29,1914,15,948,8529067.285714285,123.0,63.2,14,966,8399578.0,123.0,69.0
111000142.0,6,30,1974,15,1026,7913152.0,123.0,68.4,15,948,7913150.785714285,123.0,63.2
123418615.0,6,48,3168,24,1584,5103830.869565218,66.0,66.0,24,1584,5197836.565217392,66.0,66.0
109930111.0,6,27,1737,14,894,8456162.384615384,123.0,63.85714285714285,13,843,9143031.916666666,123.0,64.84615384615384
197284.0,17,2,180,1,90,0.0,90.0,90.0,1,90,0.0,90.0,90.0
1338084.0,17,6,1230,3,234,668856.5,78.0,78.0,3,996,668838.0,332.0,332.0
869089.0,6,9,1270,6,799,173817.8,461.0,133.16666666666666,3,471,296653.0,331.0,157.0
2797781.0,6,2,132,1,66,0.0,66.0,66.0,1,66,0.0,66.0,66.0
105029223.0,17,15,5130,15,5130,7502087.357142857,342.0,342.0,0,0,0.0,0.0,0.0
135131981.0,17,6,1146,6,1146,27026396.2,191.0,191.0,0,0,0.0,0.0,0.0
50677.0,6,12,1413,7,882,8446.166666666666,291.0,126.0,5,531,9378.25,259.0,106.2
113168418.0,6,46,3036,23,1518,5143996.454545454,66.0,66.0,23,1518,5144007.818181818,66.0,66.0
1314451.0,6,4,264,2,132,0.0,66.0,66.0,2,132,0.0,66.0,66.0
106198991.0,6,44,2904,22,1452,5057094.80952381,66.0,66.0,22,1452,5042559.285714285,66.0,66.0
1320898.0,6,4,264,2,132,0.0,66.0,66.0,2,132,0.0,66.0,66.0
96957.0,17,2,762,2,762,0.0,381.0,381.0,0,0,0.0,0.0,0.0
1533176.0,17,2,876,2,876,0.0,438.0,438.0,0,0,0.0,0.0,0.0
111662.0,17,4,1400,4,1400,37220.66666666666,350.0,350.0,0,0,0.0,0.0,0.0
297438.0,6,6,412,4,272,99146.0,74.0,68.0,2,140,0.0,74.0,70.0
51862.0,6,14,4740,7,653,8253.166666666666,249.0,93.28571428571428,7,4087,8504.333333333334,1514.0,583.8571428571429
323374.0,17,4,1400,4,1400,107791.33333333331,350.0,350.0,0,0,0.0,0.0,0.0
349.0,17,2,214,1,75,0.0,75.0,75.0,1,139,0.0,139.0,139.0
5000668.0,17,4,376,2,152,0.0,76.0,76.0,2,224,0.0,148.0,112.0
171480.0,17,2,180,1,90,0.0,90.0,90.0,1,90,0.0,90.0,90.0
2560157.0,6,3,1777,2,951,0.0,885.0,475.5,1,826,0.0,826.0,826.0
35745804.0,6,5,336,2,134,0.0,68.0,67.0,3,202,17805088.5,70.0,67.33333333333333
143962.0,17,2,180,1,90,0.0,90.0,90.0,1,90,0.0,90.0,90.0
3943.000000000001,17,4,704,2,148,0.0,74.0,74.0,2,556,0.0,280.0,278.0
10523150.0,6,7,478,4,272,3460694.6666666665,74.0,68.0,3,206,5190932.5,74.0,68.66666666666667
37712.0,6,14,4740,7,653,6074.666666666667,249.0,93.28571428571428,7,4087,5652.666666666667,1514.0,583.8571428571429
10479386.0,6,7,478,4,272,3447388.6666666665,74.0,68.0,3,206,5170995.5,74.0,68.66666666666667
54643.0,6,14,4740,7,653,8750.833333333334,249.0,93.28571428571428,7,4087,8449.0,1514.0,583.8571428571429
284868.0,17,2,414,1,88,0.0,88.0,88.0,1,326,0.0,326.0,326.0
39161.0,6,10,2032,5,524,9333.5,252.0,104.8,5,1508,8935.0,1236.0,301.6
153162.0,17,2,414,1,88,0.0,88.0,88.0,1,326,0.0,326.0,326.0
129069.0,6,2,132,1,66,0.0,66.0,66.0,1,66,0.0,66.0,66.0
302168.0,6,6,412,4,272,100722.66666666669,74.0,68.0,2,140,0.0,74.0,70.0
2024.0,17,4,344,2,150,0.0,75.0,75.0,2,194,0.0,103.0,97.0
135145502.0,17,6,1206,6,1206,27029100.4,201.0,201.0,0,0,0.0,0.0,0.0
15629236.0,17,6,2052,6,2052,3125847.2,342.0,342.0,0,0,0.0,0.0,0.0
5150055.0,6,5,336,2,134,0.0,68.0,67.0,3,202,1428181.0,70.0,67.33333333333333
55652.0,6,10,2032,5,524,13663.0,252.0,104.8,5,1508,11374.5,1236.0,301.6
114745323.0,17,14,864,7,432,19000196.166666668,174.0,61.71428571428572,7,432,19000962.5,174.0,61.71428571428572
255956.00000000003,6,10,1221,6,636,51191.2,298.0,106.0,4,585,79517.66666666667,379.0,146.25
135145263.0,17,6,1146,6,1146,27029052.6,191.0,191.0,0,0,0.0,0.0,0.0
207769.0,6,4,504,3,358,103884.5,214.0,119.33333333333331,1,146,0.0,146.0,146.0
114710.0,17,4,1400,4,1400,38236.66666666666,350.0,350.0,0,0,0.0,0.0,0.0
153560.0,6,11,2098,6,590,30396.6,252.0,98.33333333333331,5,1508,37909.5,1236.0,301.6
38095.0,6,14,4740,7,653,6110.666666666667,249.0,93.28571428571428,7,4087,6208.5,1514.0,583.8571428571429
228332.0,17,2,180,1,90,0.0,90.0,90.0,1,90,0.0,90.0,90.0
288410.0,6,10,1221,6,636,57682.0,298.0,106.0,4,585,90728.33333333331,379.0,146.25
135129217.0,17,6,1146,6,1146,27025843.4,191.0,191.0,0,0,0.0,0.0,0.0
503627.00000000006,6,5,336,2,134,0.0,68.0,67.0,3,202,194444.5,70.0,67.33333333333333
305003.0,6,6,412,4,272,101667.66666666669,74.0,68.0,2,140,0.0,74.0,70.0
128119.0,6,13,1394,7,797,21353.166666666668,253.0,113.85714285714286,6,597,24768.0,259.0,99.5
290290.0,17,2,180,1,90,0.0,90.0,90.0,1,90,0.0,90.0,90.0
10455295.0,6,7,478,4,272,3439327.333333333,74.0,68.0,3,206,5158918.5,74.0,68.66666666666667
20994.0,6,10,2032,5,524,4958.5,252.0,104.8,5,1508,4257.75,1236.0,301.6
305574.0,6,6,412,4,272,101858.0,74.0,68.0,2,140,0.0,74.0,70.0
159307.0,6,3,337,2,214,0.0,160.0,107.0,1,123,0.0,123.0,123.0
125071.0,17,4,1400,4,1400,41690.333333333336,350.0,350.0,0,0,0.0,0.0,0.0
3165940.0,6,18,1495,9,921,358146.75,315.0,102.33333333333331,9,574,358113.5,78.0,63.77777777777778
184826.0,17,2,180,1,90,0.0,90.0,90.0,1,90,0.0,90.0,90.0
204163.0,17,2,762,2,762,0.0,381.0,381.0,0,0,0.0,0.0,0.0
50742.0,17,2,180,1,90,0.0,90.0,90.0,1,90,0.0,90.0,90.0
323486.0,17,4,1400,4,1400,107828.66666666669,350.0,350.0,0,0,0.0,0.0,0.0
101166644.0,6,32,2374,17,1288,6309408.625,139.0,75.76470588235294,15,1086,7210768.571428572,123.0,72.4
875792.0,6,10,1333,6,796,175158.4,458.0,132.66666666666666,4,537,199947.0,331.0,134.25
1503.0,17,5,550,5,550,375.75,110.0,110.0,0,0,0.0,0.0,0.0
44573.0,6,13,1479,7,882,7161.166666666667,291.0,126.0,6,597,7649.4,259.0,99.5
90094700.0,6,11,1644,4,816,30030777.0,204.0,204.0,7,828,15015576.5,188.0,118.28571428571428
123348929.0,6,230,25994,115,7886,1035422.9824561405,140.0,68.57391304347826,115,18108,1074753.5,284.0,157.4608695652174
245274.0,6,3,337,2,214,0.0,160.0,107.0,1,123,0.0,123.0,123.0
171560.0,17,2,180,1,90,0.0,90.0,90.0,1,90,0.0,90.0,90.0
320.0,17,2,174,1,79,0.0,79.0,79.0,1,95,0.0,95.0,95.0
5623705.0,6,4,270,2,134,0.0,68.0,67.0,2,136,0.0,70.0,68.0
2175.0,17,4,344,2,150,0.0,75.0,75.0,2,194,0.0,103.0,97.0
13633.0,6,10,2032,5,524,2407.5,252.0,104.8,5,1508,3160.25,1236.0,301.6
109193060.0,17,14,864,7,432,18166878.5,174.0,61.71428571428572,7,432,18167588.666666668,174.0,61.71428571428572
284861.0,17,4,571,2,148,0.0,74.0,74.0,2,423,0.0,280.0,211.5
108100978.0,17,5,1005,5,1005,27025244.5,201.0,201.0,0,0,0.0,0.0,0.0
135132435.0,17,6,1146,6,1146,27026487.0,191.0,191.0,0,0,0.0,0.0,0.0
3006855.0,6,11,2106,6,598,601190.4,252.0,99.66666666666669,5,1508,1689.25,1236.0,301.6
2359.0,17,4,344,2,150,0.0,75.0,75.0,2,194,0.0,103.0,97.0
120128684.0,6,13,2036,5,1020,30032171.0,204.0,204.0,8,1016,17137673.14285714,188.0,127.0
20707.0,6,14,4740,7,653,3232.5,249.0,93.28571428571428,7,4087,3313.5,1514.0,583.8571428571429
29777.0,6,14,4740,7,653,4853.833333333333,249.0,93.28571428571428,7,4087,4715.166666666667,1514.0,583.8571428571429
90289354.0,6,16,1192,8,596,12890887.142857144,95.0,74.5,8,596,12897291.42857143,95.0,74.5
114594093.0,6,48,3168,24,1584,4982351.869565218,66.0,66.0,24,1584,4968673.043478261,66.0,66.0
251149.0,6,3,337,2,214,0.0,160.0,107.0,1,123,0.0,123.0,123.0
9934.0,17,2,458,1,85,0.0,85.0,85.0,1,373,0.0,373.0,373.0
1154141.0,6,13,3020,8,2392,164877.2857142857,1514.0,299.0,5,628,220305.25,331.0,125.6
226309.0,6,13,1386,7,789,37718.16666666666,253.0,112.71428571428572,6,597,43684.0,259.0,99.5
307160.0,6,6,412,4,272,102386.66666666669,74.0,68.0,2,140,0.0,74.0,70.0
146125.0,6,3,337,2,214,0.0,160.0,107.0,1,123,0.0,123.0,123.0
40566.0,6,13,1479,7,882,6761.0,291.0,126.0,6,597,7321.4,259.0,99.5
24515.0,17,2,582,1,83,0.0,83.0,83.0,1,499,0.0,499.0,499.0
2020720.0,17,4,525,2,150,0.0,75.0,75.0,2,375,0.0,284.0,187.5
211463.0,17,2,180,1,90,0.0,90.0,90.0,1,90,0.0,90.0,90.0
1242712.0,6,7,499,4,301,408493.6666666667,103.0,75.25,3,198,612322.5,66.0,66.0
361.0,17,2,267,1,83,0.0,83.0,83.0,1,184,0.0,184.0,184.0
135128685.0,17,6,1146,6,1146,27025737.0,191.0,191.0,0,0,0.0,0.0,0.0
107336.0,17,2,700,2,700,0.0,350.0,350.0,0,0,0.0,0.0,0.0
336626.0,6,3,204,1,68,0.0,68.0,68.0,2,136,0.0,70.0,68.0
122975304.0,6,48,3168,24,1584,5029960.304347826,66.0,66.0,24,1584,5237122.826086956,66.0,66.0
297.0,17,2,156,1,78,0.0,78.0,78.0,1,78,0.0,78.0,78.0
90256343.0,6,13,2036,8,1016,12893763.285714284,188.0,127.0,5,1020,22522779.5,204.0,204.0
135137452.0,17,6,1206,6,1206,27027490.4,201.0,201.0,0,0,0.0,0.0,0.0
32664329.000000004,6,5,336,2,134,0.0,68.0,67.0,3,202,15052706.0,70.0,67.33333333333333
104699.0,17,2,286,2,286,0.0,143.0,143.0,0,0,0.0,0.0,0.0
100364.0,17,2,762,2,762,0.0,381.0,381.0,0,0,0.0,0.0,0.0
3003.0,17,4,344,2,150,0.0,75.0,75.0,2,194,0.0,103.0,97.0
119264915.0,17,16,1212,8,606,16858545.14285714,174.0,75.75,8,606,17000140.42857143,174.0,75.75
50888.0,17,2,180,1,90,0.0,90.0,90.0,1,90,0.0,90.0,90.0
108109052.0,17,5,1005,5,1005,27027263.0,201.0,201.0,0,0,0.0,0.0,0.0
20938.0,6,14,4740,7,653,3345.0,249.0,93.28571428571428,7,4087,3304.1666666666665,1514.0,583.8571428571429
120035414.0,17,28,13364,28,13364,4445756.074074074,501.0,477.2857142857143,0,0,0.0,0.0,0.0
415153.0,6,4,508,2,238,0.0,172.0,119.0,2,270,0.0,135.0,135.0
1553691.0,6,19,7533,10,1403,172632.33333333334,583.0,140.3,9,6130,162245.0,1484.0,681.1111111111111
318.0,17,2,160,1,80,0.0,80.0,80.0,1,80,0.0,80.0,80.0
389803.0,6,3,1604,1,753,0.0,753.0,753.0,2,851,0.0,785.0,425.5
10467065.0,6,7,478,4,272,3443524.333333333,74.0,68.0,3,206,5165153.5,74.0,68.66666666666667
2881502.0,6,4,270,2,134,0.0,68.0,67.0,2,136,0.0,70.0,68.0
4387935.0,6,5,336,2,134,0.0,68.0,67.0,3,202,1421591.5,70.0,67.33333333333333
12693.0,6,11,1132,6,556,2538.6,218.0,92.66666666666669,5,576,2291.5,304.0,115.2
243272.0,6,3,337,2,214,0.0,160.0,107.0,1,123,0.0,123.0,123.0
121297974.0,6,219,24802,110,17312,1112825.4495412845,284.0,157.38181818181818,109,7490,1105142.8703703703,140.0,68.71559633027523
202790.0,17,4,6056,4,6056,67596.66666666667,1514.0,1514.0,0,0,0.0,0.0,0.0
1175241.0,6,13,3000,8,2372,167891.57142857142,1514.0,296.5,5,628,224899.75,331.0,125.6
2424.0,17,4,344,2,150,0.0,75.0,75.0,2,194,0.0,103.0,97.0
122623316.0,6,34,2419,18,1348,7213136.235294118,139.0,74.88888888888889,16,1071,7604595.066666666,123.0,66.9375
298953.0,6,6,412,4,272,99651.0,74.0,68.0,2,140,0.0,74.0,70.0
276536.0,17,2,346,1,78,0.0,78.0,78.0,1,268,0.0,268.0,268.0
323381.0,6,20,8594,11,880,32338.1,212.0,80.0,9,7714,38729.375,1514.0,857.1111111111111
322.0,17,2,160,1,80,0.0,80.0,80.0,1,80,0.0,80.0,80.0
17081.0,17,2,582,1,83,0.0,83.0,83.0,1,499,0.0,499.0,499.0
108428754.0,6,31,2182,16,1165,7214202.733333333,139.0,72.8125,15,1017,7729503.428571428,123.0,67.8
312151.0,17,4,1400,4,1400,104050.33333333331,350.0,350.0,0,0,0.0,0.0,0.0
124006140.0,17,15,907,8,475,17715162.85714286,174.0,59.375,7,432,17333554.0,174.0,61.71428571428572
108108568.0,17,5,1005,5,1005,27027142.0,201.0,201.0,0,0,0.0,0.0,0.0
34771.0,6,10,2032,5,524,7678.5,252.0,104.8,5,1508,8259.0,1236.0,301.6
2802212.0,6,2,132,1,66,0.0,66.0,66.0,1,66,0.0,66.0,66.0
373972.0,6,3,204,1,68,0.0,68.0,68.0,2,136,0.0,70.0,68.0
410.0,17,2,410,1,78,0.0,78.0,78.0,1,332,0.0,332.0,332.0
216046.0,17,4,6056,4,6056,72015.33333333333,1514.0,1514.0,0,0,0.0,0.0,0.0
33743.0,6,14,4740,7,653,5445.166666666667,249.0,93.28571428571428,7,4087,5485.5,1514.0,583.8571428571429
118927195.0,6,38,2848,20,1531,6259326.052631579,139.0,76.55,18,1317,6982984.823529412,123.0,73.16666666666667
90049124.0,17,28,13364,28,13364,3335152.7407407407,501.0,477.2857142857143,0,0,0.0,0.0,0.0
143862.0,17,2,180,1,90,0.0,90.0,90.0,1,90,0.0,90.0,90.0
90254549.0,6,14,2240,8,1016,12893507.0,188.0,127.0,6,1224,18017904.8,204.0,204.0
112372425.0,6,32,2220,16,1149,7491495.0,123.0,71.8125,16,1071,7477063.266666667,123.0,66.9375
48044.0,6,10,2032,5,524,10771.5,252.0,104.8,5,1508,10784.25,1236.0,301.6
317005.0,17,4,1400,4,1400,105668.33333333331,350.0,350.0,0,0,0.0,0.0,0.0
46824.0,6,10,2032,5,524,11479.5,252.0,104.8,5,1508,11465.75,1236.0,301.6
200028.0,17,4,6056,4,6056,66676.0,1514.0,1514.0,0,0,0.0,0.0,0.0
5624453.0,6,4,270,2,134,0.0,68.0,67.0,2,136,0.0,70.0,68.0
60726.0,6,14,4740,7,653,10000.5,249.0,93.28571428571428,7,4087,8274.166666666666,1514.0,583.8571428571429
28702.0,6,14,4740,7,653,4180.166666666667,249.0,93.28571428571428,7,4087,4642.833333333333,1514.0,583.8571428571429
2040.0,17,4,344,2,150,0.0,75.0,75.0,2,194,0.0,103.0,97.0
39417.0,6,12,1320,7,789,6569.5,253.0,112.71428571428572,5,531,6197.25,259.0,106.2
306644.0,6,6,412,4,272,102214.66666666669,74.0,68.0,2,140,0.0,74.0,70.0
443218.0,6,11,1021,6,444,60001.8,162.0,74.0,5,577,74694.5,349.0,115.4
1088113.0,6,13,1386,7,789,181352.16666666663,253.0,112.71428571428572,6,597,213187.0,259.0,99.5
18029.0,6,10,1913,5,461,4300.75,233.0,92.2,5,1452,3977.25,1224.0,290.4
60916.0,6,10,2032,5,524,14445.0,252.0,104.8,5,1508,13969.0,1236.0,301.6
40922.0,6,14,4740,7,653,6467.166666666667,249.0,93.28571428571428,7,4087,6261.666666666667,1514.0,583.8571428571429
60210.0,6,14,4740,7,653,8175.166666666667,249.0,93.28571428571428,7,4087,9378.5,1514.0,583.8571428571429
2893726.0,6,12,2172,7,664,481998.3333333333,252.0,94.85714285714286,5,1508,2259.5,1236.0,301.6
2594972.0,6,2,132,1,66,0.0,66.0,66.0,1,66,0.0,66.0,66.0
0.0,17,1,55,1,55,0.0,55.0,55.0,0,0,0.0,0.0,0.0
122001458.0,17,15,907,8,475,17428779.714285713,174.0,59.375,7,432,17001175.333333332,174.0,61.71428571428572
307898.0,6,6,412,4,272,102632.66666666669,74.0,68.0,2,140,0.0,74.0,70.0
219247.0,17,2,180,1,90,0.0,90.0,90.0,1,90,0.0,90.0,90.0
2466.0,17,4,344,2,150,0.0,75.0,75.0,2,194,0.0,103.0,97.0
143951.0,17,2,180,1,90,0.0,90.0,90.0,1,90,0.0,90.0,90.0
229420.0,17,2,180,1,90,0.0,90.0,90.0,1,90,0.0,90.0,90.0
734709.0,6,11,1021,6,444,98370.6,162.0,74.0,5,577,122765.25,349.0,115.4
362272.0,6,11,1021,6,444,48635.8,162.0,74.0,5,577,60662.0,349.0,115.4
112138304.0,6,43,3654,19,1647,6229905.777777778,123.0,86.6842105263158,24,2007,4432073.565217392,123.0,83.625
874801.0,6,10,1162,6,625,174960.2,287.0,104.16666666666669,4,537,199712.66666666663,331.0,134.25
903.0,17,5,550,5,550,225.75,110.0,110.0,0,0,0.0,0.0,0.0
47924.0,6,14,4740,7,653,7305.166666666667,249.0,93.28571428571428,7,4087,7675.166666666667,1514.0,583.8571428571429
206596.0,6,3,426,2,280,0.0,214.0,140.0,1,146,0.0,146.0,146.0
16801.0,17,2,180,1,90,0.0,90.0,90.0,1,90,0.0,90.0,90.0
28749.0,6,14,4740,7,653,3938.5,249.0,93.28571428571428,7,4087,4243.833333333333,1514.0,583.8571428571429
7699.0,17,2,582,1,83,0.0,83.0,83.0,1,499,0.0,499.0,499.0
101153.0,17,2,286,2,286,0.0,143.0,143.0,0,0,0.0,0.0,0.0
217478.0,6,3,426,2,280,0.0,214.0,140.0,1,146,0.0,146.0,146.0
91916771.0,6,172,19444,86,13620,1078841.870588235,284.0,158.3720930232558,86,5824,1078841.8588235294,140.0,67.72093023255815
90039562.0,17,28,13364,28,13364,3334798.592592593,501.0,477.2857142857143,0,0,0.0,0.0,0.0
156861.0,6,3,337,2,214,0.0,160.0,107.0,1,123,0.0,123.0,123.0
105693179.0,6,28,1876,14,982,8113639.846153846,139.0,70.14285714285714,14,894,8113637.692307692,123.0,63.85714285714285
247088.0,6,3,373,2,238,0.0,172.0,119.0,1,135,0.0,135.0,135.0
39186.0,6,14,4740,7,653,5653.5,249.0,93.28571428571428,7,4087,5882.666666666667,1514.0,583.8571428571429
90045675.0,17,27,12943,27,12943,3463295.1923076925,501.0,479.3703703703704,0,0,0.0,0.0,0.0
216678.0,6,3,426,2,280,0.0,214.0,140.0,1,146,0.0,146.0,146.0
285449.0,17,4,704,2,148,0.0,74.0,74.0,2,556,0.0,280.0,278.0
111248546.0,6,209,23634,105,7152,1069697.5576923075,140.0,68.11428571428571,104,16482,1070151.4660194174,284.0,158.48076923076923
16875.0,6,20,7606,11,978,1687.5,310.0,88.9090909090909,9,6628,1644.75,1514.0,736.4444444444445
106763.0,17,2,286,2,286,0.0,143.0,143.0,0,0,0.0,0.0,0.0
90038444.0,17,28,13364,28,13364,3334757.185185185,501.0,477.2857142857143,0,0,0.0,0.0,0.0
90041067.0,17,27,12943,27,12943,3463117.961538461,501.0,479.3703703703704,0,0,0.0,0.0,0.0
293656.0,17,4,1400,4,1400,97885.33333333331,350.0,350.0,0,0,0.0,0.0,0.0
228264.0,6,3,426,2,280,0.0,214.0,140.0,1,146,0.0,146.0,146.0
99350814.0,6,29,1999,15,1017,7096486.714285715,123.0,67.8,14,982,7625654.846153846,139.0,70.14285714285714
0.0,17,1,350,1,350,0.0,350.0,350.0,0,0,0.0,0.0,0.0
142721.0,6,10,2032,5,524,35435.0,252.0,104.8,5,1508,35078.5,1236.0,301.6
310189.0,6,3,202,2,128,0.0,74.0,64.0,1,74,0.0,74.0,74.0
153389.0,17,2,180,1,90,0.0,90.0,90.0,1,90,0.0,90.0,90.0
302384.0,6,2,132,1,66,0.0,66.0,66.0,1,66,0.0,66.0,66.0
17998.0,6,20,7606,11,978,1799.8,310.0,88.9090909090909,9,6628,1924.0,1514.0,736.4444444444445
1995.0,17,4,344,2,150,0.0,75.0,75.0,2,194,0.0,103.0,97.0
100838512.0,6,30,2106,15,1089,7187320.071428572,123.0,72.6,15,1017,7187321.571428572,123.0,67.8
6245.0,17,2,180,1,90,0.0,90.0,90.0,1,90,0.0,90.0,90.0
32552058.000000004,6,4,264,2,132,0.0,66.0,66.0,2,132,0.0,66.0,66.0
219081.0,6,3,426,2,280,0.0,214.0,140.0,1,146,0.0,146.0,146.0
93505075.0,17,14,1126,7,563,15584179.166666666,174.0,80.42857142857143,7,563,15521176.333333334,174.0,80.42857142857143
110707378.0,17,14,864,7,432,18333497.0,174.0,61.71428571428572,7,432,18334330.33333333,174.0,61.71428571428572
24509.0,6,10,2032,5,524,5792.75,252.0,104.8,5,1508,5867.0,1236.0,301.6
2008075.0,17,4,525,2,150,0.0,75.0,75.0,2,375,0.0,284.0,187.5
38950.0,6,14,4740,7,653,6369.333333333333,249.0,93.28571428571428,7,4087,5821.0,1514.0,583.8571428571429
473.0,17,2,508,2,508,0.0,257.0,254.0,0,0,0.0,0.0,0.0
337.0,17,2,160,1,80,0.0,80.0,80.0,1,80,0.0,80.0,80.0
1047984.0,6,2,132,1,66,0.0,66.0,66.0,1,66,0.0,66.0,66.0
118921408.0,6,34,2334,17,1209,7419809.5625,123.0,71.11764705882354,17,1125,7419810.75,123.0,66.17647058823529
209407.0,17,2,180,1,90,0.0,90.0,90.0,1,90,0.0,90.0,90.0
108101870.0,17,5,955,5,955,27025467.5,191.0,191.0,0,0,0.0,0.0,0.0
144814.0,17,2,180,1,70,0.0,70.0,70.0,1,110,0.0,110.0,110.0
15327.0,6,10,2032,5,524,3622.5,252.0,104.8,5,1508,3541.75,1236.0,301.6
90298848.0,6,16,1192,8,596,12893702.714285716,95.0,74.5,8,596,12898372.285714284,95.0,74.5
299255.0,6,6,412,4,272,99751.66666666669,74.0,68.0,2,140,0.0,74.0,70.0
221901.0,6,3,426,2,280,0.0,214.0,140.0,1,146,0.0,146.0,146.0
45132.0,6,11,2098,6,590,8094.6,252.0,98.33333333333331,5,1508,9781.25,1236.0,301.6
29941.0,6,10,2032,5,524,6324.75,252.0,104.8,5,1508,7239.0,1236.0,301.6
120010214.0,6,16,1192,8,596,17144316.285714287,95.0,74.5,8,596,17108470.285714287,95.0,74.5
245353.0,6,3,337,2,214,0.0,160.0,107.0,1,123,0.0,123.0,123.0
25064585.0,17,3,1034,2,684,0.0,342.0,342.0,1,350,0.0,350.0,350.0
59632.0,6,10,2032,5,524,12338.25,252.0,104.8,5,1508,12427.0,1236.0,301.6
90257059.0,6,15,2168,8,1016,12893865.57142857,188.0,127.0,7,1152,15009485.333333334,204.0,164.57142857142858
144833.0,17,2,180,1,70,0.0,70.0,70.0,1,110,0.0,110.0,110.0
106552762.0,6,33,2428,17,1288,6646044.5,139.0,75.76470588235294,16,1140,7088836.8,123.0,71.25
346433.0,17,2,180,1,90,0.0,90.0,90.0,1,90,0.0,90.0,90.0
169838.0,17,2,180,1,90,0.0,90.0,90.0,1,90,0.0,90.0,90.0
135127423.0,17,6,1146,6,1146,27025484.6,191.0,191.0,0,0,0.0,0.0,0.0
148040.0,17,2,180,1,90,0.0,90.0,90.0,1,90,0.0,90.0,90.0
1032714.0,6,11,1134,6,558,206542.8,220.0,93.0,5,576,255711.25,304.0,115.2
959600.0,6,13,1394,7,797,159933.33333333334,253.0,113.85714285714286,6,597,190584.6,259.0,99.5
90235828.0,6,21,1585,10,745,9996741.111111112,95.0,74.5,11,840,9000897.3,95.0,76.36363636363636
99292.0,17,2,762,2,762,0.0,381.0,381.0,0,0,0.0,0.0,0.0
1339880.0,17,16,1120,16,1120,89325.33333333333,70.0,70.0,0,0,0.0,0.0,0.0
2349.0,17,4,344,2,150,0.0,75.0,75.0,2,194,0.0,103.0,97.0
318631.0,17,4,1400,4,1400,106210.33333333331,350.0,350.0,0,0,0.0,0.0,0.0
77525.0,6,14,4740,7,653,10612.5,249.0,93.28571428571428,7,4087,12721.166666666666,1514.0,583.8571428571429
103948.0,17,2,286,2,286,0.0,143.0,143.0,0,0,0.0,0.0,0.0
755.0,17,4,438,2,148,0.0,74.0,74.0,2,290,0.0,147.0,145.0
232659.0,17,2,762,2,762,0.0,381.0,381.0,0,0,0.0,0.0,0.0
79113.0,6,14,4740,7,653,13043.333333333334,249.0,93.28571428571428,7,4087,13037.833333333334,1514.0,583.8571428571429
143941.0,17,2,180,1,90,0.0,90.0,90.0,1,90,0.0,90.0,90.0
37307.0,6,14,4740,7,653,5592.166666666667,249.0,93.28571428571428,7,4087,5836.5,1514.0,583.8571428571429
9304.0,17,2,507,1,86,0.0,86.0,86.0,1,421,0.0,421.0,421.0
16843.0,6,14,4740,7,653,2465.5,249.0,93.28571428571428,7,4087,2298.0,1514.0,583.8571428571429
386189.0,6,3,1604,1,753,0.0,753.0,753.0,2,851,0.0,785.0,425.5
108099737.0,17,5,1005,5,1005,27024934.25,201.0,201.0,0,0,0.0,0.0,0.0
2591036.0,6,2,132,1,66,0.0,66.0,66.0,1,66,0.0,66.0,66.0
301632.0,6,6,412,4,272,100544.0,74.0,68.0,2,140,0.0,74.0,70.0
850.0,17,4,438,2,148,0.0,74.0,74.0,2,290,0.0,147.0,145.0
90254624.0,6,14,2240,8,1016,12893517.714285716,188.0,127.0,6,1224,18017957.0,204.0,204.0
120199792.0,6,26,1978,12,935,10908561.363636363,95.0,77.91666666666667,14,1043,9230324.076923076,95.0,74.5
1029844.0,6,11,1134,6,558,205968.8,220.0,93.0,5,576,255327.0,304.0,115.2
318090.0,17,4,1400,4,1400,106030.0,350.0,350.0,0,0,0.0,0.0,0.0
66779.0,6,14,4740,7,653,10952.666666666666,249.0,93.28571428571428,7,4087,10671.833333333334,1514.0,583.8571428571429
306354.0,6,6,412,4,272,102118.0,74.0,68.0,2,140,0.0,74.0,70.0
2801692.0,6,2,132,1,66,0.0,66.0,66.0,1,66,0.0,66.0,66.0
19919.0,17,2,582,1,83,0.0,83.0,83.0,1,499,0.0,499.0,499.0
9002156.0,17,2,160,2,160,0.0,80.0,80.0,0,0,0.0,0.0,0.0
90278137.0,6,15,2444,8,1016,12896876.714285716,188.0,127.0,7,1428,15016211.0,204.0,204.0
58323.0,6,10,2032,5,524,14166.5,252.0,104.8,5,1508,13521.25,1236.0,301.6
291853.0,17,2,246,1,76,0.0,76.0,76.0,1,170,0.0,170.0,170.0
419213.0,17,2,363,1,75,0.0,75.0,75.0,1,288,0.0,288.0,288.0
4304.0,17,2,598,1,72,0.0,72.0,72.0,1,526,0.0,526.0,526.0
197746.0,17,2,180,1,90,0.0,90.0,90.0,1,90,0.0,90.0,90.0
312.0,17,2,156,1,78,0.0,78.0,78.0,1,78,0.0,78.0,78.0
133226766.0,17,15,1038,8,606,19032395.14285714,174.0,75.75,7,432,19166808.0,174.0,61.71428571428572
120124761.0,6,13,2020,9,1204,15015595.125,188.0,133.77777777777777,4,816,30031251.33333333,204.0,204.0
228215.0,17,2,180,1,90,0.0,90.0,90.0,1,90,0.0,90.0,90.0
24329.0,6,10,2032,5,524,5763.0,252.0,104.8,5,1508,5563.25,1236.0,301.6
284469.0,17,2,363,1,79,0.0,79.0,79.0,1,284,0.0,284.0,284.0
108105858.0,17,5,1005,5,1005,27026464.5,201.0,201.0,0,0,0.0,0.0,0.0
102324448.0,6,42,2772,21,1386,5105430.65,66.0,66.0,21,1386,5105428.45,66.0,66.0
116285.0,6,13,1386,7,789,19380.83333333333,253.0,112.71428571428572,6,597,21909.2,259.0,99.5
37489.0,6,10,2032,5,524,9055.25,252.0,104.8,5,1508,8560.25,1236.0,301.6
127519096.0,17,14,864,7,432,17910626.333333332,174.0,61.71428571428572,7,432,18001421.166666668,174.0,61.71428571428572
2609335.0,6,25,7573,14,3735,200718.0769230769,1514.0,266.7857142857143,11,3838,235462.1,1514.0,348.90909090909093
40443.0,6,10,2032,5,524,9324.75,252.0,104.8,5,1508,8343.5,1236.0,301.6
1307852.0,6,4,264,2,132,0.0,66.0,66.0,2,132,0.0,66.0,66.0
303686.0,6,2,132,1,66,0.0,66.0,66.0,1,66,0.0,66.0,66.0
153460.0,17,2,180,1,90,0.0,90.0,90.0,1,90,0.0,90.0,90.0
113184432.0,6,34,2482,17,1288,7060527.125,139.0,75.76470588235294,17,1194,7060526.5,123.0,70.23529411764706
31058.0,6,10,2032,5,524,7459.25,252.0,104.8,5,1508,7525.5,1236.0,301.6
45844.0,6,11,2098,6,590,8346.6,252.0,98.33333333333331,5,1508,6170.75,1236.0,301.6
37508471.0,6,33,10980,18,3951,140083.9411764706,1514.0,219.5,15,7029,2664488.214285714,1514.0,468.6
2470669.0,6,3,1777,2,951,0.0,885.0,475.5,1,826,0.0,826.0,826.0
2363.0,17,4,344,2,150,0.0,75.0,75.0,2,194,0.0,103.0,97.0
5616809.0,6,5,336,2,134,0.0,68.0,67.0,3,202,1526100.0,70.0,67.33333333333333
217314.0,6,3,426,2,280,0.0,214.0,140.0,1,146,0.0,146.0,146.0
120301194.0,6,225,25558,113,17870,1074117.8035714286,284.0,158.141592920354,112,7688,1074399.0,140.0,68.64285714285714
5293.0,17,2,180,1,90,0.0,90.0,90.0,1,90,0.0,90.0,90.0
2352.0,17,4,344,2,150,0.0,75.0,75.0,2,194,0.0,103.0,97.0
117254675.0,6,51,4120,27,2203,4501493.153846154,139.0,81.5925925925926,24,1917,5088644.347826087,123.0,79.875
120129321.0,6,14,2224,9,1204,15016165.125,188.0,133.77777777777777,5,1020,22520205.5,204.0,204.0
120488204.0,6,22,1805,11,840,9043442.2,95.0,76.36363636363636,11,965,12043412.9,220.0,87.72727272727273
396.0,17,2,410,1,78,0.0,78.0,78.0,1,332,0.0,332.0,332.0
119691099.0,17,34,16284,34,16284,3627003.0,501.0,478.9411764705882,0,0,0.0,0.0,0.0
311835.0,6,6,412,4,272,103945.0,74.0,68.0,2,140,0.0,74.0,70.0
100180334.0,17,12,516,6,258,20001903.0,43.0,43.0,6,258,20000199.8,43.0,43.0
59370.0,6,10,2032,5,524,13919.25,252.0,104.8,5,1508,13995.5,1236.0,301.6
29304.0,6,14,4740,7,653,4775.0,249.0,93.28571428571428,7,4087,4420.333333333333,1514.0,583.8571428571429
157769.0,17,2,180,1,90,0.0,90.0,90.0,1,90,0.0,90.0,90.0
90363140.0,6,12,1848,7,828,15060523.333333334,188.0,118.28571428571428,5,1020,15081907.5,204.0,204.0
2062.0,17,4,344,2,150,0.0,75.0,75.0,2,194,0.0,103.0,97.0
307148.0,6,6,412,4,272,102382.66666666669,74.0,68.0,2,140,0.0,74.0,70.0
33814.0,6,14,4740,7,653,5353.5,249.0,93.28571428571428,7,4087,4971.333333333333,1514.0,583.8571428571429
14663434.0,6,20,1607,10,975,1592845.4444444445,315.0,97.5,10,632,1592289.7777777778,78.0,63.2
101764.0,17,2,762,2,762,0.0,381.0,381.0,0,0,0.0,0.0,0.0
1787.0,17,2,691,1,349,0.0,349.0,349.0,1,342,0.0,342.0,342.0
25038.0,6,11,2098,6,590,4853.8,252.0,98.33333333333331,5,1508,5720.75,1236.0,301.6
160664.0,6,3,337,2,214,0.0,160.0,107.0,1,123,0.0,123.0,123.0
44368.0,6,14,4740,7,653,6879.833333333333,249.0,93.28571428571428,7,4087,6823.666666666667,1514.0,583.8571428571429
299371.0,6,6,412,4,272,99790.33333333331,74.0,68.0,2,140,0.0,74.0,70.0
10426442.0,6,7,478,4,272,3429768.333333333,74.0,68.0,3,206,5144550.0,74.0,68.66666666666667
37808.0,6,10,2032,5,524,9079.25,252.0,104.8,5,1508,9194.75,1236.0,301.6
90297380.0,6,16,1192,8,596,12893565.857142856,95.0,74.5,8,596,12898730.714285716,95.0,74.5
216445.0,17,2,180,1,90,0.0,90.0,90.0,1,90,0.0,90.0,90.0
19843.0,6,14,4740,7,653,3070.333333333333,249.0,93.28571428571428,7,4087,3167.833333333333,1514.0,583.8571428571429
160125.0,17,2,180,1,90,0.0,90.0,90.0,1,90,0.0,90.0,90.0
266613.0,6,3,337,2,214,0.0,160.0,107.0,1,123,0.0,123.0,123.0
9858.0,17,2,539,1,86,0.0,86.0,86.0,1,453,0.0,453.0,453.0
94383129.0,17,12,778,6,389,18802427.6,174.0,64.83333333333333,6,389,18800163.8,174.0,64.83333333333333
107394.0,17,2,286,2,286,0.0,143.0,143.0,0,0,0.0,0.0,0.0
1840.0,17,2,180,1,90,0.0,90.0,90.0,1,90,0.0,90.0,90.0
1308001.0,6,4,264,2,132,0.0,66.0,66.0,2,132,0.0,66.0,66.0
108109457.0,17,5,1005,5,1005,27027364.25,201.0,201.0,0,0,0.0,0.0,0.0
13613419.0,6,20,1607,10,975,1479009.6666666667,315.0,97.5,10,632,1478982.4444444445,78.0,63.2
6947.0,17,2,239,1,82,0.0,82.0,82.0,1,157,0.0,157.0,157.0
0.0,17,1,44,1,44,0.0,44.0,44.0,0,0,0.0,0.0,0.0
698045.0,6,10,1124,6,608,139609.0,222.0,101.33333333333331,4,516,148179.0,206.0,129.0
508388.0,6,4,270,2,134,0.0,68.0,67.0,2,136,0.0,70.0,68.0
0.0,6,1,172,1,172,0.0,172.0,172.0,0,0,0.0,0.0,0.0
303017.0,6,6,412,4,272,101005.66666666669,74.0,68.0,2,140,0.0,74.0,70.0
284894.0,17,2,365,1,80,0.0,80.0,80.0,1,285,0.0,285.0,285.0
713.0,17,4,438,2,148,0.0,74.0,74.0,2,290,0.0,147.0,145.0
242478.0,6,3,337,2,214,0.0,160.0,107.0,1,123,0.0,123.0,123.0
12972369.0,17,20,7552,20,7552,682756.2631578947,394.0,377.6,0,0,0.0,0.0,0.0
123748299.0,6,49,3234,25,1650,5156179.125,66.0,66.0,24,1584,5061264.0869565215,66.0,66.0
840489.0,6,9,1096,6,625,168097.8,287.0,104.16666666666669,3,471,283754.5,331.0,157.0
5618331.0,6,5,336,2,134,0.0,68.0,67.0,3,202,1423904.0,70.0,67.33333333333333
38756.0,6,10,2032,5,524,8363.25,252.0,104.8,5,1508,9052.0,1236.0,301.6
73464.0,6,14,4740,7,653,12024.5,249.0,93.28571428571428,7,4087,10153.0,1514.0,583.8571428571429
40967.0,6,14,4740,7,653,6629.666666666667,249.0,93.28571428571428,7,4087,6066.5,1514.0,583.8571428571429
228220.0,17,2,180,1,90,0.0,90.0,90.0,1,90,0.0,90.0,90.0
120623829.0,6,230,25850,115,7886,1050923.9122807018,140.0,68.57391304347826,115,17964,1056198.350877193,284.0,156.2086956521739
1157984.0,6,13,3010,8,2382,165426.2857142857,1514.0,297.75,5,628,220627.25,331.0,125.6
223858.0,17,2,180,1,90,0.0,90.0,90.0,1,90,0.0,90.0,90.0
146.0,17,2,700,2,700,0.0,350.0,350.0,0,0,0.0,0.0,0.0
30564.0,6,13,1479,7,882,4519.666666666667,291.0,126.0,6,597,5250.4,259.0,99.5
90043656.0,17,28,13364,28,13364,3334950.222222222,501.0,477.2857142857143,0,0,0.0,0.0,0.0
1313547.0,6,4,264,2,132,0.0,66.0,66.0,2,132,0.0,66.0,66.0
115938242.0,6,32,2236,16,1165,7714834.733333333,139.0,72.8125,16,1071,7714833.666666667,123.0,66.9375
3450.0,17,2,414,1,88,0.0,88.0,88.0,1,326,0.0,326.0,326.0
311651.0,17,4,622,4,622,103883.66666666669,163.0,155.5,0,0,0.0,0.0,0.0
186472.0,17,2,180,1,90,0.0,90.0,90.0,1,90,0.0,90.0,90.0
90049323.0,17,28,13364,28,13364,3335160.111111111,501.0,477.2857142857143,0,0,0.0,0.0,0.0
108695720.0,6,33,2428,17,1288,6793482.5,139.0,75.76470588235294,16,1140,7231969.2,123.0,71.25
504853.0,6,5,336,2,134,0.0,68.0,67.0,3,202,194176.0,70.0,67.33333333333333
2403.0,17,2,762,2,762,0.0,381.0,381.0,0,0,0.0,0.0,0.0
93305565.0,6,20,1544,10,704,10361810.555555556,95.0,70.4,10,840,10366335.888888888,153.0,84.0
9106.0,17,2,582,1,83,0.0,83.0,83.0,1,499,0.0,499.0,499.0
7091.0,17,2,582,1,83,0.0,83.0,83.0,1,499,0.0,499.0,499.0
96113950.0,17,12,778,6,389,19201491.8,174.0,64.83333333333333,6,389,19200175.6,174.0,64.83333333333333
125822892.0,6,60,12026,29,6045,3432772.8928571427,1514.0,208.44827586206893,31,5981,4186886.033333333,1514.0,192.9354838709677
120015757.0,17,28,13364,28,13364,4445028.037037037,501.0,477.2857142857143,0,0,0.0,0.0,0.0
102052145.0,6,28,1860,14,966,7833452.230769231,123.0,69.0,14,894,7833574.230769231,123.0,63.85714285714285
103624.0,17,2,286,2,286,0.0,143.0,143.0,0,0,0.0,0.0,0.0
197640.0,17,2,180,1,90,0.0,90.0,90.0,1,90,0.0,90.0,90.0
145939.0,6,3,337,2,214,0.0,160.0,107.0,1,123,0.0,123.0,123.0
109255387.0,6,45,3922,26,2206,4361588.76,139.0,84.84615384615384,19,1716,6057679.277777778,123.0,90.3157894736842
1609.0,17,4,438,2,148,0.0,74.0,74.0,2,290,0.0,147.0,145.0
93667921.0,6,40,2640,20,1320,4929890.578947368,66.0,66.0,20,1320,4913336.263157895,66.0,66.0
135121222.0,17,6,1206,6,1206,27024244.4,201.0,201.0,0,0,0.0,0.0,0.0
5638648.0,6,5,336,2,134,0.0,68.0,67.0,3,202,1430563.5,70.0,67.33333333333333
153456.0,17,2,180,1,90,0.0,90.0,90.0,1,90,0.0,90.0,90.0
108111632.0,17,5,1005,5,1005,27027908.0,201.0,201.0,0,0,0.0,0.0,0.0
863.0,17,5,550,5,550,215.75,110.0,110.0,0,0,0.0,0.0,0.0
233954.0,6,3,373,2,238,0.0,172.0,119.0,1,135,0.0,135.0,135.0
109684765.0,6,31,2182,16,1165,7297927.933333334,139.0,72.8125,15,1017,7819200.071428572,123.0,67.8
149722157.0,6,16,2494,6,1224,23970362.4,204.0,204.0,10,1270,16635523.666666666,188.0,127.0
220976.0,6,3,426,2,280,0.0,214.0,140.0,1,146,0.0,146.0,146.0
37464.0,6,14,4740,7,653,5067.833333333333,249.0,93.28571428571428,7,4087,6097.0,1514.0,583.8571428571429
122530537.0,6,49,3234,25,1650,5105439.041666667,66.0,66.0,24,1584,4895332.434782608,66.0,66.0
4510.0,17,2,602,1,72,0.0,72.0,72.0,1,530,0.0,530.0,530.0
98213901.0,6,196,22120,98,15418,1010292.0103092784,284.0,157.3265306122449,98,6702,1010294.4226804124,140.0,68.38775510204081
0.0,17,1,350,1,350,0.0,350.0,350.0,0,0,0.0,0.0,0.0
812.0,17,4,438,2,148,0.0,74.0,74.0,2,290,0.0,147.0,145.0
34002.0,6,10,2032,5,524,7919.75,252.0,104.8,5,1508,7697.25,1236.0,301.6
39992.0,6,10,2032,5,524,9456.25,252.0,104.8,5,1508,9085.5,1236.0,301.6
90259808.0,6,12,1832,8,1016,12894258.285714284,188.0,127.0,4,816,30031584.666666668,204.0,204.0
120117046.0,6,13,2036,8,1016,17136767.714285713,188.0,127.0,5,1020,22522069.5,204.0,204.0
43177.0,6,14,4740,7,653,6996.333333333333,249.0,93.28571428571428,7,4087,6779.166666666667,1514.0,583.8571428571429
468.0,17,2,267,1,83,0.0,83.0,83.0,1,184,0.0,184.0,184.0
747522.0,6,2,132,1,66,0.0,66.0,66.0,1,66,0.0,66.0,66.0
90036387.0,17,28,13364,28,13364,3334681.0,501.0,477.2857142857143,0,0,0.0,0.0,0.0
790.0,17,4,438,2,148,0.0,74.0,74.0,2,290,0.0,147.0,145.0
108102180.0,17,5,1005,5,1005,27025545.0,201.0,201.0,0,0,0.0,0.0,0.0
782.0,17,4,438,2,148,0.0,74.0,74.0,2,290,0.0,147.0,145.0
754408.0,6,11,1021,6,444,102112.8,162.0,74.0,5,577,126542.5,349.0,115.4
27983.0,6,10,2032,5,524,5916.0,252.0,104.8,5,1508,5675.0,1236.0,301.6
234490.0,6,3,426,2,280,0.0,214.0,140.0,1,146,0.0,146.0,146.0
170839.0,6,3,337,2,214,0.0,160.0,107.0,1,123,0.0,123.0,123.0
120634971.0,17,15,907,7,432,16833496.5,174.0,61.71428571428572,8,475,17143788.42857143,174.0,59.375
115950.0,17,4,1400,4,1400,38650.0,350.0,350.0,0,0,0.0,0.0,0.0
104059924.0,6,28,1929,14,963,8004609.538461538,123.0,68.78571428571429,14,966,7987857.307692308,123.0,69.0
207046.0,6,3,426,2,280,0.0,214.0,140.0,1,146,0.0,146.0,146.0
23130237.0,17,3,1034,2,684,0.0,342.0,342.0,1,350,0.0,350.0,350.0
97077384.0,6,178,20094,89,13998,1100706.7954545454,284.0,157.2808988764045,89,6096,1100706.9659090908,140.0,68.49438202247191
303109.0,6,2,132,1,66,0.0,66.0,66.0,1,66,0.0,66.0,66.0
112790676.0,6,31,2182,16,1165,7504956.733333333,139.0,72.8125,15,1017,8041024.5,123.0,67.8
323372.0,17,4,1400,4,1400,107790.66666666669,350.0,350.0,0,0,0.0,0.0,0.0
217799.0,6,3,426,2,280,0.0,214.0,140.0,1,146,0.0,146.0,146.0
10907.0,17,2,571,1,86,0.0,86.0,86.0,1,485,0.0,485.0,485.0
205816.0,17,2,180,1,90,0.0,90.0,90.0,1,90,0.0,90.0,90.0
37722.0,6,13,1386,7,789,5922.0,253.0,112.71428571428572,6,597,6545.2,259.0,99.5
0.0,6,1,172,1,172,0.0,172.0,172.0,0,0,0.0,0.0,0.0
11306936.0,17,4,1368,4,1368,3768978.6666666665,342.0,342.0,0,0,0.0,0.0,0.0
201651.0,17,4,6056,4,6056,67217.0,1514.0,1514.0,0,0,0.0,0.0,0.0
307477.0,17,4,1400,4,1400,102492.33333333331,350.0,350.0,0,0,0.0,0.0,0.0
120023724.0,6,919,146694,457,30544,263209.9210526316,214.0,66.83588621444201,462,116150,259855.7570498916,1514.0,251.4069264069264
108100640.0,17,5,955,5,955,27025160.0,191.0,191.0,0,0,0.0,0.0,0.0
330379.0,6,6,412,4,272,110126.33333333331,74.0,68.0,2,140,0.0,74.0,70.0
5615171.0,6,4,270,2,134,0.0,68.0,67.0,2,136,0.0,70.0,68.0
306021.0,6,6,412,4,272,102007.0,74.0,68.0,2,140,0.0,74.0,70.0
308648.0,6,6,412,4,272,102882.66666666669,74.0,68.0,2,140,0.0,74.0,70.0
131326600.0,17,17,1386,8,606,16143020.57142857,174.0,75.75,9,780,16343311.0,174.0,86.66666666666667
2041484.0,6,4,492,2,280,0.0,214.0,140.0,2,212,0.0,146.0,106.0
146148.0,6,3,337,2,214,0.0,160.0,107.0,1,123,0.0,123.0,123.0
2037.0,17,4,344,2,150,0.0,75.0,75.0,2,194,0.0,103.0,97.0
38534.0,6,10,2032,5,524,8924.0,252.0,104.8,5,1508,9408.5,1236.0,301.6
216422.0,17,2,180,1,90,0.0,90.0,90.0,1,90,0.0,90.0,90.0
2690930.0,6,3,1604,2,851,0.0,785.0,425.5,1,753,0.0,753.0,753.0
3040.0,17,2,180,1,90,0.0,90.0,90.0,1,90,0.0,90.0,90.0
90303769.0,6,21,1585,11,840,9025487.3,95.0,76.36363636363636,10,745,10002015.444444444,95.0,74.5
0.0,17,1,381,1,381,0.0,381.0,381.0,0,0,0.0,0.0,0.0
147292.0,6,3,373,2,238,0.0,172.0,119.0,1,135,0.0,135.0,135.0
90292811.0,6,16,1192,8,596,12892693.0,95.0,74.5,8,596,12897066.57142857,95.0,74.5
206637.0,6,3,426,2,280,0.0,214.0,140.0,1,146,0.0,146.0,146.0
106117483.0,17,14,864,7,432,17667498.0,174.0,61.71428571428572,7,432,17666838.666666668,174.0,61.71428571428572
135138017.0,17,6,1146,6,1146,27027603.4,191.0,191.0,0,0,0.0,0.0,0.0
218974.0,6,3,426,2,280,0.0,214.0,140.0,1,146,0.0,146.0,146.0
143889.0,17,2,180,1,90,0.0,90.0,90.0,1,90,0.0,90.0,90.0
321009.0,6,3,202,2,128,0.0,74.0,64.0,1,74,0.0,74.0,74.0
320.0,17,2,174,1,79,0.0,79.0,79.0,1,95,0.0,95.0,95.0
157528.0,6,3,337,2,214,0.0,160.0,107.0,1,123,0.0,123.0,123.0
10521697.0,6,7,478,4,272,3461660.0,74.0,68.0,3,206,5192362.5,74.0,68.66666666666667
120000033.0,6,23,1775,13,1030,10000002.75,95.0,79.23076923076923,10,745,10053147.888888888,95.0,74.5
4265.0,17,2,598,1,72,0.0,72.0,72.0,1,526,0.0,526.0,526.0
20465.0,17,2,582,1,83,0.0,83.0,83.0,1,499,0.0,499.0,499.0
32689434.0,6,5,336,2,134,0.0,68.0,67.0,3,202,14955816.0,70.0,67.33333333333333
135132255.0,17,6,1206,6,1206,27026451.0,201.0,201.0,0,0,0.0,0.0,0.0
221988.0,6,3,426,2,280,0.0,214.0,140.0,1,146,0.0,146.0,146.0
135119146.0,17,6,1206,6,1206,27023829.2,201.0,201.0,0,0,0.0,0.0,0.0
102129125.0,17,14,864,7,432,17000174.166666668,174.0,61.71428571428572,7,432,17001277.166666668,174.0,61.71428571428572
219189.0,6,3,426,2,280,0.0,214.0,140.0,1,146,0.0,146.0,146.0
75909.0,6,12,1320,7,789,12651.5,253.0,112.71428571428572,5,531,16237.0,259.0,106.2
726.0,17,4,438,2,148,0.0,74.0,74.0,2,290,0.0,147.0,145.0
91048904.0,17,12,778,6,389,18201045.4,174.0,64.83333333333333,6,389,18200163.0,174.0,64.83333333333333
5008447.0,17,4,849,2,166,0.0,83.0,83.0,2,683,0.0,499.0,341.5
41131.0,6,13,1386,7,789,6855.166666666667,253.0,112.71428571428572,6,597,7401.2,259.0,99.5
108104815.0,17,5,1005,5,1005,27026203.75,201.0,201.0,0,0,0.0,0.0,0.0
27301189.0,17,5,1710,5,1710,6825297.25,342.0,342.0,0,0,0.0,0.0,0.0
9282.0,17,2,539,1,86,0.0,86.0,86.0,1,453,0.0,453.0,453.0
2089.0,17,4,344,2,150,0.0,75.0,75.0,2,194,0.0,103.0,97.0
852617.0,6,9,1268,6,797,170523.4,459.0,132.83333333333334,3,471,289958.5,331.0,157.0
3239791.0,6,25,6655,13,1603,269982.5833333333,357.0,123.3076923076923,12,5052,263729.36363636365,1510.0,421.0
3902840.0,6,5,1736,2,819,0.0,753.0,409.5,3,917,1885006.0,785.0,305.6666666666667
120399178.0,6,517,63852,259,46602,466663.4806201551,554.0,179.93050193050192,258,17250,464491.68093385216,140.0,66.86046511627907
42712.0,6,14,4740,7,653,6086.166666666667,249.0,93.28571428571428,7,4087,6904.333333333333,1514.0,583.8571428571429
120150918.0,6,234,26400,117,7944,1028772.724137931,140.0,67.8974358974359,117,18456,1028692.25,284.0,157.74358974358975
228438.0,17,2,180,1,90,0.0,90.0,90.0,1,90,0.0,90.0,90.0
22599.0,6,14,4740,7,653,3655.0,249.0,93.28571428571428,7,4087,3630.1666666666665,1514.0,583.8571428571429
143949.0,17,2,180,1,90,0.0,90.0,90.0,1,90,0.0,90.0,90.0
90255611.0,6,12,1832,8,1016,12893658.714285716,188.0,127.0,4,816,30028084.0,204.0,204.0
18507.0,17,3,1026,3,1026,9253.5,342.0,342.0,0,0,0.0,0.0,0.0
122009379.0,17,15,1169,8,606,17429911.285714287,174.0,75.75,7,563,17000182.333333332,174.0,80.42857142857143
2319.0,17,4,344,2,150,0.0,75.0,75.0,2,194,0.0,103.0,97.0
284507.0,17,2,363,1,79,0.0,79.0,79.0,1,284,0.0,284.0,284.0
4260115.0,6,168,133582,95,124454,45320.37234042553,1510.0,1310.042105263158,73,9128,54715.55555555556,1510.0,125.04109589041096
108098434.0,17,5,955,5,955,27024608.5,191.0,191.0,0,0,0.0,0.0,0.0
149844514.0,17,36,17126,36,17126,4281271.828571429,501.0,475.72222222222223,0,0,0.0,0.0,0.0
106588282.0,17,14,864,7,432,17666824.333333332,174.0,61.71428571428572,7,432,17667998.666666668,174.0,61.71428571428572
99922659.0,6,158,17890,79,5436,1270726.3717948718,140.0,68.81012658227849,79,12454,1270657.4487179487,284.0,157.64556962025316
516764.0,6,3,204,1,68,0.0,68.0,68.0,2,136,0.0,70.0,68.0
1164795.0,6,13,3010,8,2382,166399.2857142857,1514.0,297.75,5,628,222192.0,331.0,125.6
61053.0,6,10,2032,5,524,14988.0,252.0,104.8,5,1508,11344.75,1236.0,301.6
1696.0,17,2,664,1,322,0.0,322.0,322.0,1,342,0.0,342.0,342.0
153561.0,17,2,180,1,90,0.0,90.0,90.0,1,90,0.0,90.0,90.0
46839.0,6,10,2032,5,524,10324.75,252.0,104.8,5,1508,9966.25,1236.0,301.6
206387.0,6,3,426,2,280,0.0,214.0,140.0,1,146,0.0,146.0,146.0
90053525.0,17,27,12943,27,12943,3463597.1153846155,501.0,479.3703703703704,0,0,0.0,0.0,0.0
2164971.0,6,27,7742,15,2648,154640.7857142857,1034.0,176.53333333333333,12,5094,169282.63636363635,1510.0,424.5
865510.0,6,9,1267,6,796,173102.0,458.0,132.66666666666666,3,471,295184.5,331.0,157.0
108097526.0,17,5,955,5,955,27024381.5,191.0,191.0,0,0,0.0,0.0,0.0
309639.0,6,6,412,4,272,103213.0,74.0,68.0,2,140,0.0,74.0,70.0
217837.0,6,3,426,2,280,0.0,214.0,140.0,1,146,0.0,146.0,146.0
35776.0,6,14,4740,7,653,5525.833333333333,249.0,93.28571428571428,7,4087,4620.5,1514.0,583.8571428571429
27590764.0,17,5,1710,5,1710,6897691.0,342.0,342.0,0,0,0.0,0.0,0.0
303702.0,6,6,412,4,272,101234.0,74.0,68.0,2,140,0.0,74.0,70.0
90047675.0,17,27,12943,27,12943,3463372.1153846155,501.0,479.3703703703704,0,0,0.0,0.0,0.0
206277.0,17,2,180,1,90,0.0,90.0,90.0,1,90,0.0,90.0,90.0
318.0,17,2,174,1,79,0.0,79.0,79.0,1,95,0.0,95.0,95.0
138263569.0,17,14,864,7,432,19833537.33333333,174.0,61.71428571428572,7,432,19918771.166666668,174.0,61.71428571428572
113262163.0,6,32,2220,16,1149,7550810.866666666,123.0,71.8125,16,1071,7536390.266666667,123.0,66.9375
16251.000000000002,6,14,4740,7,653,2157.333333333333,249.0,93.28571428571428,7,4087,2572.0,1514.0,583.8571428571429
1297784.0,6,4,264,2,132,0.0,66.0,66.0,2,132,0.0,66.0,66.0
53511.0,6,14,4740,7,653,8701.666666666666,249.0,93.28571428571428,7,4087,8120.5,1514.0,583.8571428571429
304.0,17,2,174,1,79,0.0,79.0,79.0,1,95,0.0,95.0,95.0
104779175.0,17,15,5130,15,5130,7484226.785714285,342.0,342.0,0,0,0.0,0.0,0.0
38967.0,6,14,4740,7,653,6208.5,249.0,93.28571428571428,7,4087,6186.333333333333,1514.0,583.8571428571429
209833.0,17,2,762,2,762,0.0,381.0,381.0,0,0,0.0,0.0,0.0
243151.0,17,4,1524,4,1524,81050.33333333333,381.0,381.0,0,0,0.0,0.0,0.0
3005064.0,6,11,2106,6,598,600778.0,252.0,99.66666666666669,5,1508,1713.0,1236.0,301.6
149744.0,6,11,1131,6,600,29763.8,262.0,100.0,5,531,4613.5,259.0,106.2
29547.0,6,10,1065,5,534,6751.25,262.0,106.8,5,531,7120.25,259.0,106.2
14706.0,6,14,4740,7,653,2347.1666666666665,249.0,93.28571428571428,7,4087,2232.6666666666665,1514.0,583.8571428571429
90053462.0,17,28,13364,28,13364,3335313.407407407,501.0,477.2857142857143,0,0,0.0,0.0,0.0
143643.0,6,2,132,1,66,0.0,66.0,66.0,1,66,0.0,66.0,66.0
22576.0,6,10,2032,5,524,5417.75,252.0,104.8,5,1508,5189.5,1236.0,301.6
105467519.0,17,14,1126,7,563,17447199.333333332,174.0,80.42857142857143,7,563,17551090.5,174.0,80.42857142857143
90011726.0,17,28,13364,28,13364,3333767.6296296297,501.0,477.2857142857143,0,0,0.0,0.0,0.0
326.0,17,2,208,1,72,0.0,72.0,72.0,1,136,0.0,136.0,136.0
257084.0,6,10,1221,6,636,51416.8,298.0,106.0,4,585,80291.66666666667,379.0,146.25
13617422.0,6,20,1689,10,1057,1478679.6666666667,315.0,105.7,10,632,1478650.0,78.0,63.2
419886.0,17,2,363,1,75,0.0,75.0,75.0,1,288,0.0,288.0,288.0
3120178.0,6,157,122820,86,113832,36699.67058823529,1510.0,1323.6279069767445,71,8988,40093.328571428574,1510.0,126.59154929577464
36491.0,6,14,4740,7,653,5482.0,249.0,93.28571428571428,7,4087,5877.333333333333,1514.0,583.8571428571429
114795282.0,6,47,3102,24,1584,4991084.652173913,66.0,66.0,23,1518,5151999.318181818,66.0,66.0
3120.0,17,2,224,1,76,0.0,76.0,76.0,1,148,0.0,148.0,148.0
99000853.0,6,193,21842,97,6624,1031258.8854166666,140.0,68.28865979381443,96,15218,1036453.947368421,284.0,158.52083333333334
207069.0,6,3,426,2,280,0.0,214.0,140.0,1,146,0.0,146.0,146.0
303355.0,6,6,412,4,272,101118.33333333331,74.0,68.0,2,140,0.0,74.0,70.0
46139.0,6,14,4740,7,653,7575.833333333333,249.0,93.28571428571428,7,4087,7010.833333333333,1514.0,583.8571428571429
5348.0,17,2,180,1,90,0.0,90.0,90.0,1,90,0.0,90.0,90.0
105382659.0,17,14,864,7,432,17537289.166666668,174.0,61.71428571428572,7,432,17368579.0,174.0,61.71428571428572
2070.0,17,4,344,2,150,0.0,75.0,75.0,2,194,0.0,103.0,97.0
40432.0,6,10,2032,5,524,9697.0,252.0,104.8,5,1508,9857.25,1236.0,301.6
135132372.0,17,6,1146,6,1146,27026474.4,191.0,191.0,0,0,0.0,0.0,0.0
14876.0,6,10,2032,5,524,3423.0,252.0,104.8,5,1508,2526.0,1236.0,301.6
153463.0,17,2,180,1,90,0.0,90.0,90.0,1,90,0.0,90.0,90.0
65203.0,6,14,4740,7,653,10279.166666666666,249.0,93.28571428571428,7,4087,10731.666666666666,1514.0,583.8571428571429
342.0,17,2,160,1,80,0.0,80.0,80.0,1,80,0.0,80.0,80.0
52066.0,6,11,2098,6,590,10216.6,252.0,98.33333333333331,5,1508,9299.0,1236.0,301.6
5390131.0,6,15,1905,9,775,673766.375,267.0,86.11111111111111,6,1130,807666.8,425.0,188.3333333333333
104836737.0,6,29,2046,15,1017,7488307.0,123.0,67.8,14,1029,7296289.076923077,123.0,73.5
2347.0,17,4,344,2,150,0.0,75.0,75.0,2,194,0.0,103.0,97.0
19271.0,6,10,2032,5,524,3919.25,252.0,104.8,5,1508,4203.25,1236.0,301.6
135118754.0,17,6,1206,6,1206,27023750.8,201.0,201.0,0,0,0.0,0.0,0.0
90045186.0,17,27,12943,27,12943,3463276.3846153845,501.0,479.3703703703704,0,0,0.0,0.0,0.0
149659.0,17,2,180,1,90,0.0,90.0,90.0,1,90,0.0,90.0,90.0
120123897.0,6,13,2020,9,1204,15015487.125,188.0,133.77777777777777,4,816,30023764.666666668,204.0,204.0
16898.0,6,14,4740,7,653,2591.833333333333,249.0,93.28571428571428,7,4087,2264.6666666666665,1514.0,583.8571428571429
15410.0,6,13,1459,7,862,2439.5,271.0,123.14285714285714,6,597,2855.0,259.0,99.5
3012654.0,6,12,2172,7,664,501801.5,252.0,94.85714285714286,5,1508,3552.25,1236.0,301.6
206029.0,6,10,1221,6,636,41205.8,298.0,106.0,4,585,67341.33333333333,379.0,146.25
32345.0,6,10,2032,5,524,7200.75,252.0,104.8,5,1508,7495.75,1236.0,301.6
9462.0,17,2,582,1,83,0.0,83.0,83.0,1,499,0.0,499.0,499.0
19593.0,6,10,2032,5,524,4474.75,252.0,104.8,5,1508,4630.75,1236.0,301.6
207697.0,6,3,426,2,280,0.0,214.0,140.0,1,146,0.0,146.0,146.0
9521.0,17,2,571,1,86,0.0,86.0,86.0,1,485,0.0,485.0,485.0
287674.0,17,2,363,1,79,0.0,79.0,79.0,1,284,0.0,284.0,284.0
32633.000000000004,6,14,4740,7,653,5096.333333333333,249.0,93.28571428571428,7,4087,5307.166666666667,1514.0,583.8571428571429
103629.0,17,2,286,2,286,0.0,143.0,143.0,0,0,0.0,0.0,0.0
2430256.0,6,3,1604,2,851,0.0,785.0,425.5,1,753,0.0,753.0,753.0
1307962.0,17,7,490,7,490,217993.66666666663,70.0,70.0,0,0,0.0,0.0,0.0
118010009.0,17,13,821,7,432,19668334.83333333,174.0,61.71428571428572,6,389,19600206.6,174.0,64.83333333333333
120124527.0,6,17,2556,10,1392,13347169.666666666,188.0,139.2,7,1164,15015369.333333334,204.0,166.28571428571428
115440967.0,6,33,2428,17,1288,7201568.8125,139.0,75.76470588235294,16,1140,7681666.533333333,123.0,71.25
14336996.0,6,20,1607,10,975,1559509.7777777778,315.0,97.5,10,632,1559476.3333333333,78.0,63.2
34379.0,6,14,4740,7,653,5619.333333333333,249.0,93.28571428571428,7,4087,5567.666666666667,1514.0,583.8571428571429
1167044.0,6,13,3010,8,2382,166720.57142857142,1514.0,297.75,5,628,222895.0,331.0,125.6
135144598.0,17,6,1146,6,1146,27028919.6,191.0,191.0,0,0,0.0,0.0,0.0
45349.0,6,14,4740,7,653,7401.833333333333,249.0,93.28571428571428,7,4087,5883.666666666667,1514.0,583.8571428571429
55299.0,6,10,1065,5,534,13651.5,262.0,106.8,5,531,11879.0,259.0,106.2
319493.0,17,4,1400,4,1400,106497.66666666669,350.0,350.0,0,0,0.0,0.0,0.0
22755.0,17,4,344,2,150,0.0,75.0,75.0,2,194,0.0,103.0,97.0
108817.0,17,2,286,2,286,0.0,143.0,143.0,0,0,0.0,0.0,0.0
108111618.0,17,5,1005,5,1005,27027904.5,201.0,201.0,0,0,0.0,0.0,0.0
1321036.0,6,4,264,2,132,0.0,66.0,66.0,2,132,0.0,66.0,66.0
143892.0,17,2,180,1,90,0.0,90.0,90.0,1,90,0.0,90.0,90.0
88224.0,6,14,4740,7,653,14499.666666666666,249.0,93.28571428571428,7,4087,13862.833333333334,1514.0,583.8571428571429
309080.0,17,2,346,1,78,0.0,78.0,78.0,1,268,0.0,268.0,268.0
11391.0,6,10,2032,5,524,2630.0,252.0,104.8,5,1508,2185.0,1236.0,301.6
279588.0,17,2,180,1,90,0.0,90.0,90.0,1,90,0.0,90.0,90.0
104108.0,17,2,286,2,286,0.0,143.0,143.0,0,0,0.0,0.0,0.0
1427269.0,6,8,602,5,404,330391.75,103.0,80.8,3,198,203319.0,66.0,66.0
31829.000000000004,6,14,4740,7,653,5188.166666666667,249.0,93.28571428571428,7,4087,5128.0,1514.0,583.8571428571429
41768.0,6,10,1065,5,534,9770.0,262.0,106.8,5,531,8361.75,259.0,106.2
2723291.0,6,25,7573,14,3735,209483.92307692303,1514.0,266.7857142857143,11,3838,246218.1,1514.0,348.90909090909093
114257601.0,6,32,2236,16,1071,7617173.4,123.0,66.9375,16,1165,6937695.266666667,139.0,72.8125
100303894.0,17,13,821,7,432,16690825.833333334,174.0,61.71428571428572,6,389,16134277.0,174.0,64.83333333333333
2369.0,17,4,344,2,150,0.0,75.0,75.0,2,194,0.0,103.0,97.0
23105222.0,17,3,1034,2,684,0.0,342.0,342.0,1,350,0.0,350.0,350.0
115386484.0,6,48,3168,24,1584,5016803.652173913,66.0,66.0,24,1584,5003385.130434782,66.0,66.0
36993.0,6,10,2032,5,524,6137.75,252.0,104.8,5,1508,8883.5,1236.0,301.6
84763.0,6,14,4740,7,653,8739.333333333334,249.0,93.28571428571428,7,4087,12609.666666666666,1514.0,583.8571428571429
307109.0,6,6,412,4,272,102369.66666666669,74.0,68.0,2,140,0.0,74.0,70.0
9520.0,17,2,539,1,86,0.0,86.0,86.0,1,453,0.0,453.0,453.0
326.0,17,2,160,1,80,0.0,80.0,80.0,1,80,0.0,80.0,80.0
93175196.0,6,178,20110,89,14014,1056360.7840909092,284.0,157.46067415730337,89,6096,1056360.8636363635,140.0,68.49438202247191
7226.0,17,4,823,2,163,0.0,89.0,81.5,2,660,0.0,443.0,330.0
232375.0,6,3,337,2,214,0.0,160.0,107.0,1,123,0.0,123.0,123.0
108105291.0,17,5,955,5,955,27026322.75,191.0,191.0,0,0,0.0,0.0,0.0
302359.0,6,2,132,1,66,0.0,66.0,66.0,1,66,0.0,66.0,66.0
318278.0,17,4,1400,4,1400,106092.66666666669,350.0,350.0,0,0,0.0,0.0,0.0
90940147.0,6,19,1436,9,691,11367518.375,95.0,76.77777777777777,10,745,10076161.666666666,95.0,74.5
36808.0,6,14,4740,7,653,6016.666666666667,249.0,93.28571428571428,7,4087,4752.5,1514.0,583.8571428571429
57749.0,6,14,4740,7,653,9495.333333333334,249.0,93.28571428571428,7,4087,8009.5,1514.0,583.8571428571429
135135586.0,17,6,1146,6,1146,27027117.2,191.0,191.0,0,0,0.0,0.0,0.0
312757.0,17,4,1400,4,1400,104252.33333333331,350.0,350.0,0,0,0.0,0.0,0.0
14636837.0,6,20,1607,10,975,1592621.7777777778,315.0,97.5,10,632,1592604.111111111,78.0,63.2
135120813.0,17,6,1206,6,1206,27024162.6,201.0,201.0,0,0,0.0,0.0,0.0
90960340.0,6,21,1585,11,840,9093517.0,95.0,76.36363636363636,10,745,10102770.0,95.0,74.5
120007917.0,6,21,1585,11,840,11999999.1,95.0,76.36363636363636,10,745,13332463.222222222,95.0,74.5
218041.0,6,3,426,2,280,0.0,214.0,140.0,1,146,0.0,146.0,146.0
130112.0,6,2,132,1,66,0.0,66.0,66.0,1,66,0.0,66.0,66.0
3388.0,17,2,762,2,762,0.0,381.0,381.0,0,0,0.0,0.0,0.0
13296.0,17,4,823,2,163,0.0,89.0,81.5,2,660,0.0,443.0,330.0
228190.0,17,2,180,1,90,0.0,90.0,90.0,1,90,0.0,90.0,90.0
29142.0,6,13,1479,7,882,4732.666666666667,291.0,126.0,6,597,5293.0,259.0,99.5
120223.0,17,2,180,1,70,0.0,70.0,70.0,1,110,0.0,110.0,110.0
113931908.0,6,48,3168,24,1584,4953561.217391305,66.0,66.0,24,1584,4941582.347826087,66.0,66.0
35161.0,6,14,4740,7,653,5664.166666666667,249.0,93.28571428571428,7,4087,5574.5,1514.0,583.8571428571429
304753.0,17,2,180,1,90,0.0,90.0,90.0,1,90,0.0,90.0,90.0
196951.0,17,2,180,1,90,0.0,90.0,90.0,1,90,0.0,90.0,90.0
40609.0,6,10,2032,5,524,8592.75,252.0,104.8,5,1508,8999.75,1236.0,301.6
39817.0,6,10,2032,5,524,9622.0,252.0,104.8,5,1508,9447.5,1236.0,301.6
2311.0,17,4,344,2,150,0.0,75.0,75.0,2,194,0.0,103.0,97.0
207025.0,17,2,180,1,90,0.0,90.0,90.0,1,90,0.0,90.0,90.0
219199.0,6,3,426,2,280,0.0,214.0,140.0,1,146,0.0,146.0,146.0
412.0,17,2,267,1,83,0.0,83.0,83.0,1,184,0.0,184.0,184.0
168847.0,17,2,414,1,88,0.0,88.0,88.0,1,326,0.0,326.0,326.0
49076.0,6,14,4740,7,653,7937.5,249.0,93.28571428571428,7,4087,6397.0,1514.0,583.8571428571429
112590829.0,6,35,2536,18,1248,6622963.764705882,123.0,69.33333333333333,17,1288,6412818.8125,139.0,75.76470588235294
302661.0,6,6,412,4,272,100887.0,74.0,68.0,2,140,0.0,74.0,70.0
145587.0,6,3,337,2,214,0.0,160.0,107.0,1,123,0.0,123.0,123.0
242461.0,6,3,426,2,280,0.0,214.0,140.0,1,146,0.0,146.0,146.0
108117700.0,17,5,1005,5,1005,27029425.0,201.0,201.0,0,0,0.0,0.0,0.0
42112.0,6,14,4740,7,653,6895.333333333333,249.0,93.28571428571428,7,4087,6884.0,1514.0,583.8571428571429
90525096.0,6,13,2036,8,1016,12932156.57142857,188.0,127.0,5,1020,22591059.0,204.0,204.0
26148.0,6,14,4740,7,653,3900.0,249.0,93.28571428571428,7,4087,4216.666666666667,1514.0,583.8571428571429
135129053.0,17,6,1206,6,1206,27025810.6,201.0,201.0,0,0,0.0,0.0,0.0
90044810.0,17,28,13364,28,13364,3334992.962962963,501.0,477.2857142857143,0,0,0.0,0.0,0.0
90022235.0,17,28,13364,28,13364,3334156.851851852,501.0,477.2857142857143,0,0,0.0,0.0,0.0
153509.0,17,2,180,1,90,0.0,90.0,90.0,1,90,0.0,90.0,90.0
54093.0,6,10,2032,5,524,13325.5,252.0,104.8,5,1508,12160.25,1236.0,301.6
9162.0,17,2,539,1,86,0.0,86.0,86.0,1,453,0.0,453.0,453.0
212553.0,6,10,1221,6,636,42510.6,298.0,106.0,4,585,69262.33333333333,379.0,146.25
50027552.0,17,8,2736,8,2736,7146793.142857143,342.0,342.0,0,0,0.0,0.0,0.0
2050371.0,17,20,7568,20,7568,107914.26315789472,394.0,378.4,0,0,0.0,0.0,0.0
33361.0,6,14,4740,7,653,4926.0,249.0,93.28571428571428,7,4087,5363.5,1514.0,583.8571428571429
130810.0,6,2,132,1,66,0.0,66.0,66.0,1,66,0.0,66.0,66.0
312.0,17,2,166,1,75,0.0,75.0,75.0,1,91,0.0,91.0,91.0
314221.0,6,10,1221,6,636,62844.2,298.0,106.0,4,585,99221.0,379.0,146.25
34143865.0,6,7,1874,3,887,17002435.0,753.0,295.6666666666667,4,987,11335984.333333334,785.0,246.75
44264.0,6,10,1066,5,490,8771.25,218.0,98.0,5,576,9392.75,304.0,115.2
41129.0,6,14,4740,7,653,6685.666666666667,249.0,93.28571428571428,7,4087,6690.166666666667,1514.0,583.8571428571429
44493.0,17,2,180,1,90,0.0,90.0,90.0,1,90,0.0,90.0,90.0
355.0,17,2,160,1,80,0.0,80.0,80.0,1,80,0.0,80.0,80.0
92113896.0,6,38,2508,19,1254,5106882.444444444,66.0,66.0,19,1254,5105447.5,66.0,66.0
599586.0,17,2,346,1,78,0.0,78.0,78.0,1,268,0.0,268.0,268.0
20781.0,6,10,2032,5,524,4947.0,252.0,104.8,5,1508,4562.5,1236.0,301.6
90257134.0,6,12,1832,8,1016,12893876.285714284,188.0,127.0,4,816,30031147.0,204.0,204.0
21767.0,6,10,2032,5,524,5204.0,252.0,104.8,5,1508,5162.75,1236.0,301.6
153578.0,17,2,180,1,90,0.0,90.0,90.0,1,90,0.0,90.0,90.0
317420.0,6,6,412,4,272,105806.66666666669,74.0,68.0,2,140,0.0,74.0,70.0
5634568.0,6,5,336,2,134,0.0,68.0,67.0,3,202,1528078.5,70.0,67.33333333333333
146183.0,6,3,337,2,214,0.0,160.0,107.0,1,123,0.0,123.0,123.0
3439873.0,17,2,110,2,110,0.0,55.0,55.0,0,0,0.0,0.0,0.0
0.0,17,1,350,1,350,0.0,350.0,350.0,0,0,0.0,0.0,0.0
123305163.0,6,48,3168,24,1584,5043275.260869565,66.0,66.0,24,1584,5253471.304347826,66.0,66.0
216906.0,6,3,426,2,280,0.0,214.0,140.0,1,146,0.0,146.0,146.0
225972.0,6,12,1373,7,714,37662.0,298.0,102.0,5,659,53669.25,379.0,131.8
45316.0,6,10,2032,5,524,10600.25,252.0,104.8,5,1508,8826.75,1236.0,301.6
186314.0,17,2,598,1,72,0.0,72.0,72.0,1,526,0.0,526.0,526.0
105356577.0,17,14,864,7,432,17500159.5,174.0,61.71428571428572,7,432,17501149.666666668,174.0,61.71428571428572
90220534.0,6,16,1192,8,596,12853399.285714284,95.0,74.5,8,596,12857878.285714284,95.0,74.5
2207.0,17,2,180,1,90,0.0,90.0,90.0,1,90,0.0,90.0,90.0
202728.0,17,2,180,1,90,0.0,90.0,90.0,1,90,0.0,90.0,90.0
120015635.0,6,23,1862,11,968,12001563.5,223.0,88.0,12,894,10885055.727272728,95.0,74.5
90062143.0,17,28,13364,28,13364,3335634.925925926,501.0,477.2857142857143,0,0,0.0,0.0,0.0
228819.0,17,2,180,1,90,0.0,90.0,90.0,1,90,0.0,90.0,90.0
120345333.0,6,224,25418,112,7688,1077015.054054054,140.0,68.64285714285714,112,17730,1076844.5405405406,284.0,158.30357142857142
102991.0,17,2,286,2,286,0.0,143.0,143.0,0,0,0.0,0.0,0.0
44185.0,6,14,4740,7,653,6799.166666666667,249.0,93.28571428571428,7,4087,6676.5,1514.0,583.8571428571429
15822.0,6,13,1459,7,862,2637.0,271.0,123.14285714285714,6,597,2738.0,259.0,99.5
4166.0,17,2,598,1,72,0.0,72.0,72.0,1,526,0.0,526.0,526.0
2616513.0,6,3,204,2,136,0.0,70.0,68.0,1,68,0.0,68.0,68.0
104757.0,17,2,700,2,700,0.0,350.0,350.0,0,0,0.0,0.0,0.0
54670.0,6,14,4740,7,653,8745.833333333334,249.0,93.28571428571428,7,4087,8628.5,1514.0,583.8571428571429
206208.0,17,3,1143,3,1143,103104.0,381.0,381.0,0,0,0.0,0.0,0.0
143979.0,17,2,180,1,90,0.0,90.0,90.0,1,90,0.0,90.0,90.0
197010.0,17,2,180,1,90,0.0,90.0,90.0,1,90,0.0,90.0,90.0
103281.0,17,2,286,2,286,0.0,143.0,143.0,0,0,0.0,0.0,0.0
3172132.0,6,19,1549,9,921,358374.0,315.0,102.33333333333331,10,628,318523.6666666667,78.0,62.8
135127704.0,17,6,1146,6,1146,27025540.8,191.0,191.0,0,0,0.0,0.0,0.0
370720.0,6,10,1221,6,636,74144.0,298.0,106.0,4,585,117878.66666666669,379.0,146.25
90299439.0,6,21,1585,11,840,9024823.8,95.0,76.36363636363636,10,745,10001123.666666666,95.0,74.5
47810331.0,6,7,1872,3,886,22422069.0,752.0,295.3333333333333,4,986,15012931.666666666,784.0,246.5
5828199.0,6,5,336,2,134,0.0,68.0,67.0,3,202,1474160.5,70.0,67.33333333333333
54972.0,6,14,4740,7,653,9036.833333333334,249.0,93.28571428571428,7,4087,7999.333333333333,1514.0,583.8571428571429
2300.0,17,4,344,2,150,0.0,75.0,75.0,2,194,0.0,103.0,97.0
47438.0,6,14,4740,7,653,7449.0,249.0,93.28571428571428,7,4087,6957.5,1514.0,583.8571428571429
35010.0,6,14,4740,7,653,5304.5,249.0,93.28571428571428,7,4087,4663.0,1514.0,583.8571428571429
310106.0,17,4,1400,4,1400,103368.66666666669,350.0,350.0,0,0,0.0,0.0,0.0
3008568.0,6,2,132,1,66,0.0,66.0,66.0,1,66,0.0,66.0,66.0
297338.0,6,6,412,4,272,99112.66666666669,74.0,68.0,2,140,0.0,74.0,70.0
45704.0,6,14,4740,7,653,7409.666666666667,249.0,93.28571428571428,7,4087,7403.666666666667,1514.0,583.8571428571429
228450.0,17,2,180,1,90,0.0,90.0,90.0,1,90,0.0,90.0,90.0
2592530.0,6,23,7202,13,3681,216044.16666666663,1514.0,283.15384615384613,10,3521,259238.5555555556,1514.0,352.1
307219.0,6,6,412,4,272,102406.33333333331,74.0,68.0,2,140,0.0,74.0,70.0
829326.0,6,9,1118,6,586,165865.2,248.0,97.66666666666669,3,532,278407.5,392.0,177.33333333333334
108104162.0,17,5,1005,5,1005,27026040.5,201.0,201.0,0,0,0.0,0.0,0.0
1311664.0,17,7,490,7,490,218610.66666666663,70.0,70.0,0,0,0.0,0.0,0.0
166037.0,6,2,132,1,66,0.0,66.0,66.0,1,66,0.0,66.0,66.0
598819.0,17,2,473,1,78,0.0,78.0,78.0,1,395,0.0,395.0,395.0
284248.0,17,2,363,1,79,0.0,79.0,79.0,1,284,0.0,284.0,284.0
207487.0,6,3,426,2,280,0.0,214.0,140.0,1,146,0.0,146.0,146.0
108112753.0,17,5,955,5,955,27028188.25,191.0,191.0,0,0,0.0,0.0,0.0
2997.0,17,2,224,1,76,0.0,76.0,76.0,1,148,0.0,148.0,148.0
119114060.0,6,34,2334,17,1209,7431134.625,123.0,71.11764705882354,17,1125,7431136.125,123.0,66.17647058823529
120210342.0,6,214,24202,107,7358,1126228.7264150945,140.0,68.76635514018692,107,16844,1126366.29245283,284.0,157.42056074766356
119009042.0,17,15,1169,8,606,17001291.714285713,174.0,75.75,7,563,16500136.833333334,174.0,80.42857142857143
90051970.0,17,28,13364,28,13364,3335258.1481481483,501.0,477.2857142857143,0,0,0.0,0.0,0.0
10471854.0,6,7,478,4,272,3445112.6666666665,74.0,68.0,3,206,5167595.0,74.0,68.66666666666667
141803.0,6,2,132,1,66,0.0,66.0,66.0,1,66,0.0,66.0,66.0
99017668.0,6,403,64994,202,13702,492625.2139303483,214.0,67.83168316831683,201,51292,489858.49,1514.0,255.18407960199005
90257664.0,6,14,2240,8,1016,12893952.0,188.0,127.0,6,1224,18018737.4,204.0,204.0
115311964.0,6,191,21504,96,6570,1213810.147368421,140.0,68.4375,95,14934,1215690.2872340423,284.0,157.2
207275.0,6,3,426,2,280,0.0,214.0,140.0,1,146,0.0,146.0,146.0
119444361.0,6,215,24284,108,7350,1116302.4392523365,140.0,68.05555555555556,107,16934,1117042.2264150945,284.0,158.26168224299064
10475706.0,6,7,478,4,272,3446144.0,74.0,68.0,3,206,5169136.0,74.0,68.66666666666667
60003.0,6,14,4740,7,653,9808.333333333334,249.0,93.28571428571428,7,4087,9784.333333333334,1514.0,583.8571428571429
103774970.0,6,44,2904,22,1452,4941665.238095238,66.0,66.0,22,1452,4927369.571428572,66.0,66.0
20697.0,6,10,1067,5,536,4989.75,264.0,107.2,5,531,3641.75,259.0,106.2
18229.0,6,11,2098,6,590,3151.4,252.0,98.33333333333331,5,1508,3732.0,1236.0,301.6
23729.0,6,14,4740,7,653,3833.1666666666665,249.0,93.28571428571428,7,4087,3453.5,1514.0,583.8571428571429
15697164.0,6,20,1611,9,921,1919508.5,315.0,102.33333333333331,11,690,1535714.3,78.0,62.72727272727273
309.0,17,2,168,1,76,0.0,76.0,76.0,1,92,0.0,92.0,92.0
67325.0,6,14,4740,7,653,11012.833333333334,249.0,93.28571428571428,7,4087,9762.5,1514.0,583.8571428571429
4456.0,17,2,626,1,72,0.0,72.0,72.0,1,554,0.0,554.0,554.0
95659316.0,6,29,2052,15,1089,6832808.285714285,123.0,72.6,14,963,7341760.692307692,123.0,68.78571428571429
2009.0,17,4,344,2,150,0.0,75.0,75.0,2,194,0.0,103.0,97.0
34555.0,6,10,2032,5,524,8364.25,252.0,104.8,5,1508,7958.5,1236.0,301.6
114815713.0,6,48,3168,24,1584,4991987.521739131,66.0,66.0,24,1584,4978526.695652174,66.0,66.0
138869263.0,17,14,864,7,432,19835169.33333333,174.0,61.71428571428572,7,432,19833486.33333333,174.0,61.71428571428572
216404.0,17,2,180,1,90,0.0,90.0,90.0,1,90,0.0,90.0,90.0
44603152.0,6,8,1307,8,1307,6371878.857142857,172.0,163.375,0,0,0.0,0.0,0.0
105135598.0,6,197,22248,99,15558,1072812.224489796,284.0,157.15151515151516,98,6690,1073221.8350515463,140.0,68.26530612244898
302016.0,6,6,412,4,272,100672.0,74.0,68.0,2,140,0.0,74.0,70.0
90031775.0,17,28,13364,28,13364,3334510.185185185,501.0,477.2857142857143,0,0,0.0,0.0,0.0
90050914.0,17,27,12943,27,12943,3463496.6923076925,501.0,479.3703703703704,0,0,0.0,0.0,0.0
318182.0,17,4,1400,4,1400,106060.66666666669,350.0,350.0,0,0,0.0,0.0,0.0
5624973.0,6,5,336,2,134,0.0,68.0,67.0,3,202,1526274.0,70.0,67.33333333333333
307157.0,6,6,412,4,272,102385.66666666669,74.0,68.0,2,140,0.0,74.0,70.0
42010.0,6,14,4740,7,653,6719.5,249.0,93.28571428571428,7,4087,6792.666666666667,1514.0,583.8571428571429
89620.0,6,14,4740,7,653,14754.166666666666,249.0,93.28571428571428,7,4087,14341.833333333334,1514.0,583.8571428571429
72960.0,6,14,4740,7,653,10978.666666666666,249.0,93.28571428571428,7,4087,11203.666666666666,1514.0,583.8571428571429
115197748.0,17,14,864,7,432,19199624.666666668,174.0,61.71428571428572,7,432,19155121.83333333,174.0,61.71428571428572
49856.0,6,13,1386,7,789,8309.333333333334,253.0,112.71428571428572,6,597,7358.0,259.0,99.5
110720081.0,6,30,2122,15,1017,7908577.214285715,123.0,67.8,15,1105,7362270.0,139.0,73.66666666666667
4940654.0,6,9,630,4,280,923853.0,78.0,70.0,5,350,765485.25,78.0,70.0
107842824.0,6,28,1860,14,966,8295601.846153846,123.0,69.0,14,894,8278977.230769231,123.0,63.85714285714285
147958.0,17,2,180,1,90,0.0,90.0,90.0,1,90,0.0,90.0,90.0
90954553.0,6,21,1585,11,840,9094881.7,95.0,76.36363636363636,10,745,10105805.222222222,95.0,74.5
139008823.0,17,17,1255,9,649,17376102.875,174.0,72.11111111111111,8,606,16962072.714285713,174.0,75.75
281370.0,17,2,363,1,79,0.0,79.0,79.0,1,284,0.0,284.0,284.0
212385.0,6,3,426,2,280,0.0,214.0,140.0,1,146,0.0,146.0,146.0
0.0,6,1,66,1,66,0.0,66.0,66.0,0,0,0.0,0.0,0.0
6814.0,17,2,582,1,83,0.0,83.0,83.0,1,499,0.0,499.0,499.0
746958.0,6,2,132,1,66,0.0,66.0,66.0,1,66,0.0,66.0,66.0
36280.0,6,14,4740,7,653,5877.0,249.0,93.28571428571428,7,4087,5766.833333333333,1514.0,583.8571428571429
417.0,17,2,762,2,762,0.0,381.0,381.0,0,0,0.0,0.0,0.0
295.0,17,2,156,1,78,0.0,78.0,78.0,1,78,0.0,78.0,78.0
36271.0,6,10,2032,5,524,8295.5,252.0,104.8,5,1508,7730.25,1236.0,301.6
250275.00000000003,6,3,373,2,238,0.0,172.0,119.0,1,135,0.0,135.0,135.0
45248.0,6,10,2032,5,524,11063.25,252.0,104.8,5,1508,10754.75,1236.0,301.6
109892.0,17,2,286,2,286,0.0,143.0,143.0,0,0,0.0,0.0,0.0
317609.0,17,4,1400,4,1400,105869.66666666669,350.0,350.0,0,0,0.0,0.0,0.0
174736.0,6,11,1132,6,556,34329.8,218.0,92.66666666666669,5,576,43486.0,304.0,115.2
135125362.0,17,6,1146,6,1146,27025072.4,191.0,191.0,0,0,0.0,0.0,0.0
227780.0,17,2,180,1,90,0.0,90.0,90.0,1,90,0.0,90.0,90.0
100625.0,17,2,762,2,762,0.0,381.0,381.0,0,0,0.0,0.0,0.0
115736881.0,6,38,2710,19,1408,6417836.277777778,139.0,74.10526315789474,19,1302,6417834.944444444,123.0,68.52631578947368
116492050.0,6,46,3684,24,1944,5064871.739130435,123.0,81.0,22,1740,5536930.857142857,123.0,79.0909090909091
50415.0,6,14,4740,7,653,8140.333333333333,249.0,93.28571428571428,7,4087,8204.5,1514.0,583.8571428571429
246390.0,6,3,337,2,214,0.0,160.0,107.0,1,123,0.0,123.0,123.0
143881.0,17,2,180,1,90,0.0,90.0,90.0,1,90,0.0,90.0,90.0
32213.0,6,14,4740,7,653,5202.666666666667,249.0,93.28571428571428,7,4087,5123.666666666667,1514.0,583.8571428571429
146687.0,6,3,337,2,214,0.0,160.0,107.0,1,123,0.0,123.0,123.0
135129279.0,17,6,1146,6,1146,27025855.8,191.0,191.0,0,0,0.0,0.0,0.0
5628256.0,6,5,336,2,134,0.0,68.0,67.0,3,202,1423469.0,70.0,67.33333333333333
2599679.0,6,2,132,1,66,0.0,66.0,66.0,1,66,0.0,66.0,66.0
759.0,17,4,438,2,148,0.0,74.0,74.0,2,290,0.0,147.0,145.0
100664582.0,17,12,516,6,258,20000929.6,43.0,43.0,6,258,20000192.0,43.0,43.0
135126368.0,17,6,1206,6,1206,27025273.6,201.0,201.0,0,0,0.0,0.0,0.0
143947.0,17,2,180,1,90,0.0,90.0,90.0,1,90,0.0,90.0,90.0
883.0,17,4,438,2,148,0.0,74.0,74.0,2,290,0.0,147.0,145.0
23955476.0,17,5,1718,4,1368,997168.0,342.0,342.0,1,350,0.0,350.0,350.0
143.0,17,3,1143,3,1143,71.5,381.0,381.0,0,0,0.0,0.0,0.0
693693.0,6,6,758,3,410,305703.5,172.0,136.66666666666666,3,348,231169.0,135.0,116.0
19987.0,6,10,2032,5,524,4752.75,252.0,104.8,5,1508,4353.75,1236.0,301.6
426.0,17,2,168,1,76,0.0,76.0,76.0,1,92,0.0,92.0,92.0
38015.0,6,14,4740,7,653,5918.166666666667,249.0,93.28571428571428,7,4087,6113.333333333333,1514.0,583.8571428571429
95965897.0,6,175,19806,88,13842,1103056.287356322,284.0,157.29545454545453,87,5964,1105323.476744186,140.0,68.55172413793103
15699.999999999998,17,2,762,2,762,0.0,381.0,381.0,0,0,0.0,0.0,0.0
2300.0,17,4,344,2,150,0.0,75.0,75.0,2,194,0.0,103.0,97.0
34306.0,6,14,4740,7,653,3971.5,249.0,93.28571428571428,7,4087,4840.666666666667,1514.0,583.8571428571429
45120.0,6,14,4740,7,653,7411.166666666667,249.0,93.28571428571428,7,4087,6303.666666666667,1514.0,583.8571428571429
1161676.0,6,13,3000,8,2372,165953.7142857143,1514.0,296.5,5,628,222272.75,331.0,125.6
19998.0,17,2,582,1,83,0.0,83.0,83.0,1,499,0.0,499.0,499.0
43850.0,6,13,1386,7,789,7308.333333333333,253.0,112.71428571428572,6,597,7725.8,259.0,99.5
70900.0,6,14,4740,7,653,11575.833333333334,249.0,93.28571428571428,7,4087,10508.833333333334,1514.0,583.8571428571429
511425.0,6,5,336,2,134,0.0,68.0,67.0,3,202,195332.0,70.0,67.33333333333333
12056043.0,17,5,2265,5,2265,3014010.75,453.0,453.0,0,0,0.0,0.0,0.0
120344538.0,6,221,25024,111,17468,1094041.2545454546,284.0,157.36936936936937,110,7556,1094510.4311926605,140.0,68.69090909090909
102104547.0,6,197,22158,99,6756,1041883.1326530612,140.0,68.24242424242425,98,15402,1031090.2886597938,284.0,157.16326530612244
101393.0,17,2,762,2,762,0.0,381.0,381.0,0,0,0.0,0.0,0.0
315035.0,17,4,622,4,622,105011.66666666669,163.0,155.5,0,0,0.0,0.0,0.0
2033.0,17,4,344,2,150,0.0,75.0,75.0,2,194,0.0,103.0,97.0
5829418.0,6,5,336,2,134,0.0,68.0,67.0,3,202,1525170.5,70.0,67.33333333333333
119747.0,17,2,180,1,70,0.0,70.0,70.0,1,110,0.0,110.0,110.0
108101953.0,17,5,1005,5,1005,27025488.25,201.0,201.0,0,0,0.0,0.0,0.0
143883.0,17,2,180,1,90,0.0,90.0,90.0,1,90,0.0,90.0,90.0
307687.0,17,4,1400,4,1400,102562.33333333331,350.0,350.0,0,0,0.0,0.0,0.0
114920.0,17,2,286,2,286,0.0,143.0,143.0,0,0,0.0,0.0,0.0
196909.0,17,2,180,1,90,0.0,90.0,90.0,1,90,0.0,90.0,90.0
90028560.0,17,28,13364,28,13364,3334391.111111111,501.0,477.2857142857143,0,0,0.0,0.0,0.0
90055110.0,17,28,13364,28,13364,3335374.4444444445,501.0,477.2857142857143,0,0,0.0,0.0,0.0
0.0,6,1,66,1,66,0.0,66.0,66.0,0,0,0.0,0.0,0.0
113520167.0,6,46,3036,23,1518,5159996.409090909,66.0,66.0,23,1518,5159996.136363637,66.0,66.0
241288.0,6,3,337,2,214,0.0,160.0,107.0,1,123,0.0,123.0,123.0
317.0,17,2,174,1,79,0.0,79.0,79.0,1,95,0.0,95.0,95.0
90032557.0,17,28,13364,28,13364,3334539.1481481483,501.0,477.2857142857143,0,0,0.0,0.0,0.0
2593980.0,6,2,132,1,66,0.0,66.0,66.0,1,66,0.0,66.0,66.0
59618186.0,17,9,3086,8,2736,5214432.142857143,342.0,342.0,1,350,0.0,350.0,350.0
304204.0,6,3,202,2,128,0.0,74.0,64.0,1,74,0.0,74.0,74.0
217753.0,6,10,1221,6,636,43550.6,298.0,106.0,4,585,71193.66666666667,379.0,146.25
153506.0,17,2,180,1,90,0.0,90.0,90.0,1,90,0.0,90.0,90.0
33410.0,6,14,4740,7,653,4856.5,249.0,93.28571428571428,7,4087,5212.833333333333,1514.0,583.8571428571429
108103929.0,17,5,1005,5,1005,27025982.25,201.0,201.0,0,0,0.0,0.0,0.0
299998.0,6,6,412,4,272,99999.33333333331,74.0,68.0,2,140,0.0,74.0,70.0
2354.0,17,4,344,2,150,0.0,75.0,75.0,2,194,0.0,103.0,97.0
302.0,17,2,156,1,78,0.0,78.0,78.0,1,78,0.0,78.0,78.0
108123034.0,17,5,955,5,955,27030758.5,191.0,191.0,0,0,0.0,0.0,0.0
3005879.0,6,11,2106,6,598,600950.4,252.0,99.66666666666669,5,1508,1792.25,1236.0,301.6
208238.0,6,3,426,2,280,0.0,214.0,140.0,1,146,0.0,146.0,146.0
90272278.0,6,13,2036,8,1016,12896039.714285716,188.0,127.0,5,1020,22526985.0,204.0,204.0
36827.0,6,10,2032,5,524,8713.0,252.0,104.8,5,1508,8551.25,1236.0,301.6
31371.000000000004,6,10,2032,5,524,7563.25,252.0,104.8,5,1508,5916.0,1236.0,301.6
197319.0,17,2,180,1,90,0.0,90.0,90.0,1,90,0.0,90.0,90.0
144004.0,17,2,180,1,90,0.0,90.0,90.0,1,90,0.0,90.0,90.0
344.0,17,2,267,1,83,0.0,83.0,83.0,1,184,0.0,184.0,184.0
206798.0,6,3,426,2,280,0.0,214.0,140.0,1,146,0.0,146.0,146.0
120107895.0,6,13,2020,9,1204,15013486.875,188.0,133.77777777777777,4,816,30025259.666666668,204.0,204.0
1982.0,17,4,344,2,150,0.0,75.0,75.0,2,194,0.0,103.0,97.0
27529779.0,17,5,1710,5,1710,6882444.75,342.0,342.0,0,0,0.0,0.0,0.0
1300993.0,6,4,264,2,132,0.0,66.0,66.0,2,132,0.0,66.0,66.0
42352.0,6,14,4740,7,653,6698.0,249.0,93.28571428571428,7,4087,6120.166666666667,1514.0,583.8571428571429
108108214.0,17,5,955,5,955,27027053.5,191.0,191.0,0,0,0.0,0.0,0.0
106733586.0,6,32,2374,17,1288,6657349.3125,139.0,75.76470588235294,15,1086,7608404.0,123.0,72.4
301.0,17,2,174,1,79,0.0,79.0,79.0,1,95,0.0,95.0,95.0
47221.0,6,13,1479,7,882,5800.666666666667,291.0,126.0,6,597,8712.2,259.0,99.5
299160.0,6,6,412,4,272,99720.0,74.0,68.0,2,140,0.0,74.0,70.0
108107520.0,17,5,955,5,955,27026880.0,191.0,191.0,0,0,0.0,0.0,0.0
119991409.0,17,34,16284,34,16284,3636103.303030303,501.0,478.9411764705882,0,0,0.0,0.0,0.0
90254736.0,6,12,1832,8,1016,12893533.714285716,188.0,127.0,4,816,30030637.0,204.0,204.0
45122.0,6,14,4740,7,653,7395.833333333333,249.0,93.28571428571428,7,4087,7041.333333333333,1514.0,583.8571428571429
135135025.0,17,6,1206,6,1206,27027005.0,201.0,201.0,0,0,0.0,0.0,0.0
312796.0,17,4,1400,4,1400,104265.33333333331,350.0,350.0,0,0,0.0,0.0,0.0
103308.0,17,2,286,2,286,0.0,143.0,143.0,0,0,0.0,0.0,0.0
28021277.0,6,29,10238,16,3843,179369.4,1514.0,240.1875,13,6395,2317159.583333333,1514.0,491.9230769230769
300052.0,6,6,412,4,272,100017.33333333331,74.0,68.0,2,140,0.0,74.0,70.0
3199198.0,6,17,1441,8,867,409203.28571428574,315.0,108.375,9,574,358823.875,78.0,63.77777777777778
206009.0,6,3,426,2,280,0.0,214.0,140.0,1,146,0.0,146.0,146.0
2594610.0,6,2,132,1,66,0.0,66.0,66.0,1,66,0.0,66.0,66.0
1070.0,17,4,438,2,148,0.0,74.0,74.0,2,290,0.0,147.0,145.0
297455.0,6,10,1221,6,636,59491.0,298.0,106.0,4,585,93756.0,379.0,146.25
218075.0,6,3,426,2,280,0.0,214.0,140.0,1,146,0.0,146.0,146.0
36401.0,6,10,2032,5,524,8822.75,252.0,104.8,5,1508,7707.25,1236.0,301.6
83030.0,6,14,4740,7,653,12921.666666666666,249.0,93.28571428571428,7,4087,11468.166666666666,1514.0,583.8571428571429
0.0,17,1,80,1,80,0.0,80.0,80.0,0,0,0.0,0.0,0.0
103189.0,17,2,286,2,286,0.0,143.0,143.0,0,0,0.0,0.0,0.0
322258.0,17,4,1400,4,1400,107419.33333333331,350.0,350.0,0,0,0.0,0.0,0.0
2156349.0,6,2,132,1,66,0.0,66.0,66.0,1,66,0.0,66.0,66.0
41557.0,6,14,4740,7,653,6812.0,249.0,93.28571428571428,7,4087,6509.166666666667,1514.0,583.8571428571429
51161.0,17,2,180,1,90,0.0,90.0,90.0,1,90,0.0,90.0,90.0
835539.0,6,9,1118,6,586,167107.8,248.0,97.66666666666669,3,532,280069.5,392.0,177.33333333333334
14981.0,6,12,1393,6,796,2845.2,271.0,132.66666666666666,6,597,2842.4,259.0,99.5
119639687.0,17,35,16705,35,16705,3518814.323529412,501.0,477.2857142857143,0,0,0.0,0.0,0.0
4223.0,17,2,610,1,72,0.0,72.0,72.0,1,538,0.0,538.0,538.0
135126900.0,17,6,1206,6,1206,27025380.0,201.0,201.0,0,0,0.0,0.0,0.0
90306704.0,6,16,1192,8,596,12894024.142857144,95.0,74.5,8,596,12899451.857142856,95.0,74.5
207186.0,6,3,426,2,280,0.0,214.0,140.0,1,146,0.0,146.0,146.0
1487346.0,6,20,7599,11,1469,148734.6,583.0,133.54545454545453,9,6130,154168.375,1484.0,681.1111111111111
323344.0,17,4,1400,4,1400,107781.33333333331,350.0,350.0,0,0,0.0,0.0,0.0
2795058.0,6,2,132,1,66,0.0,66.0,66.0,1,66,0.0,66.0,66.0
1048258.0,6,11,1134,6,558,209651.60000000003,220.0,93.0,5,576,259520.25,304.0,115.2
89173.0,6,14,4740,7,653,14732.333333333334,249.0,93.28571428571428,7,4087,13491.333333333334,1514.0,583.8571428571429
120065763.0,17,29,13785,29,13785,4288062.964285715,501.0,475.3448275862069,0,0,0.0,0.0,0.0
147769.0,6,3,373,2,238,0.0,172.0,119.0,1,135,0.0,135.0,135.0
6072.0,17,2,231,1,78,0.0,78.0,78.0,1,153,0.0,153.0,153.0
10682.0,17,2,582,1,83,0.0,83.0,83.0,1,499,0.0,499.0,499.0
108135112.0,17,5,1005,5,1005,27033778.0,201.0,201.0,0,0,0.0,0.0,0.0
2929207.0,6,11,2106,6,598,585476.0,252.0,99.66666666666669,5,1508,2056.5,1236.0,301.6
120013318.0,6,14,2102,6,1086,18018922.2,204.0,181.0,8,1016,17144050.714285713,188.0,127.0
15851.0,6,10,2032,5,524,3162.0,252.0,104.8,5,1508,3682.75,1236.0,301.6
90227299.0,6,16,1192,8,596,12852827.857142856,95.0,74.5,8,596,12858705.142857144,95.0,74.5
119431170.0,6,48,3168,24,1584,5192659.565217392,66.0,66.0,24,1584,5179238.782608695,66.0,66.0
242263.0,6,3,337,2,214,0.0,160.0,107.0,1,123,0.0,123.0,123.0
27326.0,6,10,2032,5,524,6607.25,252.0,104.8,5,1508,5330.0,1236.0,301.6
42796.0,6,10,2032,5,524,10418.25,252.0,104.8,5,1508,10525.25,1236.0,301.6
2488.0,17,4,344,2,150,0.0,75.0,75.0,2,194,0.0,103.0,97.0
55215.0,6,14,4740,7,653,8777.0,249.0,93.28571428571428,7,4087,8912.833333333334,1514.0,583.8571428571429
35525.0,6,14,4740,7,653,5424.0,249.0,93.28571428571428,7,4087,5713.5,1514.0,583.8571428571429
2361.0,17,4,344,2,150,0.0,75.0,75.0,2,194,0.0,103.0,97.0
3178793.0,6,18,1495,9,921,358546.375,315.0,102.33333333333331,9,574,358524.75,78.0,63.77777777777778
316066.0,6,10,1221,6,636,63213.2,298.0,106.0,4,585,99853.33333333331,379.0,146.25
97935169.0,17,12,778,6,389,19555251.4,174.0,64.83333333333333,6,389,19366950.8,174.0,64.83333333333333
153499.0,17,2,180,1,90,0.0,90.0,90.0,1,90,0.0,90.0,90.0
118496832.0,6,248,28674,124,20194,961637.3170731708,374.0,162.8548387096774,124,8480,961638.406504065,140.0,68.38709677419355
147079.0,6,4,439,2,238,0.0,172.0,119.0,2,201,0.0,135.0,100.5
27534.0,6,10,2032,5,524,6495.5,252.0,104.8,5,1508,6578.75,1236.0,301.6
36982211.0,6,5,336,2,134,0.0,68.0,67.0,3,202,18417337.5,70.0,67.33333333333333
302186.0,6,6,412,4,272,100728.66666666669,74.0,68.0,2,140,0.0,74.0,70.0
5622917.0,6,4,270,2,134,0.0,68.0,67.0,2,136,0.0,70.0,68.0
3994.0,17,2,762,2,762,0.0,381.0,381.0,0,0,0.0,0.0,0.0
342.0,17,2,160,1,80,0.0,80.0,80.0,1,80,0.0,80.0,80.0
110684.0,17,4,1400,4,1400,36894.66666666666,350.0,350.0,0,0,0.0,0.0,0.0
16751.0,17,2,461,1,86,0.0,86.0,86.0,1,375,0.0,375.0,375.0
90286135.0,6,16,1192,8,596,12891591.0,95.0,74.5,8,596,12897817.857142856,95.0,74.5
45133895.0,17,8,2744,7,2394,5974738.0,342.0,342.0,1,350,0.0,350.0,350.0
108109072.0,17,5,955,5,955,27027268.0,191.0,191.0,0,0,0.0,0.0,0.0
135131293.0,17,6,1206,6,1206,27026258.6,201.0,201.0,0,0,0.0,0.0,0.0
54198.0,6,13,1386,7,789,8431.166666666666,253.0,112.71428571428572,6,597,9468.8,259.0,99.5
50577.0,6,14,4740,7,653,8171.333333333333,249.0,93.28571428571428,7,4087,5736.166666666667,1514.0,583.8571428571429
2311.0,17,4,344,2,150,0.0,75.0,75.0,2,194,0.0,103.0,97.0
90053274.0,17,27,12943,27,12943,3463587.461538461,501.0,479.3703703703704,0,0,0.0,0.0,0.0
302446.0,6,2,132,1,66,0.0,66.0,66.0,1,66,0.0,66.0,66.0
107751.0,17,2,286,2,286,0.0,143.0,143.0,0,0,0.0,0.0,0.0
90982.0,6,14,4740,7,653,14768.833333333334,249.0,93.28571428571428,7,4087,6630.666666666667,1514.0,583.8571428571429
332.0,17,2,250,1,93,0.0,93.0,93.0,1,157,0.0,157.0,157.0
67951.0,6,10,2032,5,524,16763.75,252.0,104.8,5,1508,16690.5,1236.0,301.6
164733.0,17,2,414,1,88,0.0,88.0,88.0,1,326,0.0,326.0,326.0
90759561.0,6,19,1436,10,745,10079352.777777778,95.0,74.5,9,691,11344247.25,95.0,76.77777777777777
38513.0,6,10,2032,5,524,9396.25,252.0,104.8,5,1508,8765.0,1236.0,301.6
58712.0,6,10,1066,5,490,13996.25,218.0,98.0,5,576,14131.5,304.0,115.2
46577.0,6,10,2032,5,524,9132.5,252.0,104.8,5,1508,9090.75,1236.0,301.6
29561.0,6,10,2032,5,524,6197.25,252.0,104.8,5,1508,7139.0,1236.0,301.6
40277.0,6,10,2032,5,524,9774.0,252.0,104.8,5,1508,9655.25,1236.0,301.6
2799959.0,6,2,132,1,66,0.0,66.0,66.0,1,66,0.0,66.0,66.0
13295.0,6,11,1131,6,600,2434.0,262.0,100.0,5,531,3004.5,259.0,106.2
197392.0,17,2,180,1,90,0.0,90.0,90.0,1,90,0.0,90.0,90.0
105555646.0,6,28,1860,14,966,8103050.538461538,123.0,69.0,14,894,8102253.461538462,123.0,63.85714285714285
14859666.0,6,5,1736,2,819,0.0,753.0,409.5,3,917,6030382.0,785.0,305.6666666666667
2086.0,17,4,344,2,150,0.0,75.0,75.0,2,194,0.0,103.0,97.0
300906.0,6,6,412,4,272,100302.0,74.0,68.0,2,140,0.0,74.0,70.0
217780.0,6,3,426,2,280,0.0,214.0,140.0,1,146,0.0,146.0,146.0
2696.0,17,4,344,2,150,0.0,75.0,75.0,2,194,0.0,103.0,97.0
216540.0,17,2,180,1,90,0.0,90.0,90.0,1,90,0.0,90.0,90.0
91833034.0,17,16,5472,16,5472,6122202.266666667,342.0,342.0,0,0,0.0,0.0,0.0
302567.0,6,6,412,4,272,100855.66666666669,74.0,68.0,2,140,0.0,74.0,70.0
146848.0,6,3,337,2,214,0.0,160.0,107.0,1,123,0.0,123.0,123.0
121202885.0,6,278,33032,139,9396,864866.6884057971,140.0,67.59712230215827,139,23636,872057.2391304348,284.0,170.0431654676259
23155596.0,17,3,1034,2,684,0.0,342.0,342.0,1,350,0.0,350.0,350.0
156293.0,6,3,337,2,214,0.0,160.0,107.0,1,123,0.0,123.0,123.0
30762.0,6,14,4740,7,653,3895.3333333333335,249.0,93.28571428571428,7,4087,4430.833333333333,1514.0,583.8571428571429
311.0,17,2,166,1,75,0.0,75.0,75.0,1,91,0.0,91.0,91.0
90044001.0,17,28,13364,28,13364,3334963.0,501.0,477.2857142857143,0,0,0.0,0.0,0.0
103999002.0,6,189,21360,95,14934,1106372.3617021276,284.0,157.2,94,6426,1107129.6666666667,140.0,68.36170212765957
314810.0,17,4,1400,4,1400,104936.66666666669,350.0,350.0,0,0,0.0,0.0,0.0
120493378.0,6,221,25056,111,17574,1095394.3454545457,284.0,158.32432432432432,110,7482,1095921.247706422,140.0,68.01818181818182
16594.0,6,10,2032,5,524,3941.25,252.0,104.8,5,1508,3719.25,1236.0,301.6
90011379.0,17,28,13364,28,13364,3333754.777777778,501.0,477.2857142857143,0,0,0.0,0.0,0.0
2805576.0,6,2,132,1,66,0.0,66.0,66.0,1,66,0.0,66.0,66.0
102092.0,17,2,286,2,286,0.0,143.0,143.0,0,0,0.0,0.0,0.0
217881.0,6,3,426,2,280,0.0,214.0,140.0,1,146,0.0,146.0,146.0
135129344.0,17,6,1206,6,1206,27025868.8,201.0,201.0,0,0,0.0,0.0,0.0
103303.0,17,2,286,2,286,0.0,143.0,143.0,0,0,0.0,0.0,0.0
299815.0,6,3,202,2,128,0.0,74.0,64.0,1,74,0.0,74.0,74.0
2242495.0,6,23,7478,12,2450,203863.18181818185,1034.0,204.16666666666663,11,5028,193626.6,1510.0,457.09090909090907
41101.0,6,14,4740,7,653,6231.0,249.0,93.28571428571428,7,4087,6249.166666666667,1514.0,583.8571428571429
298632.0,6,6,412,4,272,99544.0,74.0,68.0,2,140,0.0,74.0,70.0
336.0,17,2,166,1,75,0.0,75.0,75.0,1,91,0.0,91.0,91.0
135144889.0,17,6,1206,6,1206,27028977.8,201.0,201.0,0,0,0.0,0.0,0.0
90024851.0,17,28,13364,28,13364,3334253.7407407407,501.0,477.2857142857143,0,0,0.0,0.0,0.0
149826602.0,17,36,17126,36,17126,4280760.057142857,501.0,475.72222222222223,0,0,0.0,0.0,0.0
22263.0,6,14,4740,7,653,3454.6666666666665,249.0,93.28571428571428,7,4087,3245.5,1514.0,583.8571428571429
99096.0,17,2,286,2,286,0.0,143.0,143.0,0,0,0.0,0.0,0.0
232331.0,6,3,337,2,214,0.0,160.0,107.0,1,123,0.0,123.0,123.0
14751.0,6,10,2032,5,524,3024.0,252.0,104.8,5,1508,3335.25,1236.0,301.6
90023265.0,17,28,13364,28,13364,3334195.0,501.0,477.2857142857143,0,0,0.0,0.0,0.0
72625.0,6,12,1328,7,797,12104.166666666666,253.0,113.85714285714286,5,531,15240.0,259.0,106.2
5624180.0,6,5,336,2,134,0.0,68.0,67.0,3,202,1523217.5,70.0,67.33333333333333
2558550.0,6,3,1777,1,826,0.0,826.0,826.0,2,951,0.0,885.0,475.5
246215.0,6,3,337,2,214,0.0,160.0,107.0,1,123,0.0,123.0,123.0
100092.0,17,2,762,2,762,0.0,381.0,381.0,0,0,0.0,0.0,0.0
103134108.0,6,28,1860,14,966,7916731.769230769,123.0,69.0,14,894,7916739.538461538,123.0,63.85714285714285
108120441.0,17,5,1005,5,1005,27030110.25,201.0,201.0,0,0,0.0,0.0,0.0
120300058.0,6,263,30580,132,21638,918321.0534351146,352.0,163.92424242424244,131,8942,918280.1923076924,140.0,68.25954198473282
67961.0,6,14,4740,7,653,11148.5,249.0,93.28571428571428,7,4087,10338.666666666666,1514.0,583.8571428571429
317242.0,17,4,1400,4,1400,105747.33333333331,350.0,350.0,0,0,0.0,0.0,0.0
2331314.0,6,59,46957,25,1810,97138.08333333331,206.0,72.4,34,45147,70399.90909090909,1514.0,1327.8529411764705
26276.0,6,10,1065,5,534,4168.25,262.0,106.8,5,531,5898.25,259.0,106.2
58941.0,6,14,4740,7,653,9708.833333333334,249.0,93.28571428571428,7,4087,8506.833333333334,1514.0,583.8571428571429
10511343.0,6,7,478,4,272,3458531.0,74.0,68.0,3,206,5187697.5,74.0,68.66666666666667
64284.99999999999,6,14,4740,7,653,6262.0,249.0,93.28571428571428,7,4087,10163.333333333334,1514.0,583.8571428571429
13490.0,6,14,4740,7,653,2129.833333333333,249.0,93.28571428571428,7,4087,2109.833333333333,1514.0,583.8571428571429
171715.0,17,2,180,1,90,0.0,90.0,90.0,1,90,0.0,90.0,90.0
0.0,6,1,66,1,66,0.0,66.0,66.0,0,0,0.0,0.0,0.0
90027221.0,17,28,13364,28,13364,3334341.5185185187,501.0,477.2857142857143,0,0,0.0,0.0,0.0
52523.0,6,10,2032,5,524,12056.5,252.0,104.8,5,1508,11536.5,1236.0,301.6
21503.0,17,2,582,1,83,0.0,83.0,83.0,1,499,0.0,499.0,499.0
300188.0,6,6,412,4,272,100062.66666666669,74.0,68.0,2,140,0.0,74.0,70.0
108564.0,17,2,286,2,286,0.0,143.0,143.0,0,0,0.0,0.0,0.0
143981.0,17,2,180,1,90,0.0,90.0,90.0,1,90,0.0,90.0,90.0
205971.0,17,2,180,1,90,0.0,90.0,90.0,1,90,0.0,90.0,90.0
3214.0,17,4,416,2,144,0.0,72.0,72.0,2,272,0.0,136.0,136.0
0.0,6,1,66,1,66,0.0,66.0,66.0,0,0,0.0,0.0,0.0
135131241.0,17,6,1146,6,1146,27026248.2,191.0,191.0,0,0,0.0,0.0,0.0
305921.0,6,6,412,4,272,101973.66666666669,74.0,68.0,2,140,0.0,74.0,70.0
153434.0,17,2,180,1,90,0.0,90.0,90.0,1,90,0.0,90.0,90.0
128900458.0,6,35,2394,18,1269,7582379.882352941,123.0,70.5,17,1125,7418673.875,123.0,66.17647058823529
32108788.0,6,7,1874,3,887,15978586.5,753.0,295.6666666666667,4,987,10655641.0,785.0,246.75
93556471.0,6,26,1746,13,906,7778371.333333333,123.0,69.6923076923077,13,840,7778373.333333333,123.0,64.61538461538461
90527778.0,6,14,2240,8,1016,12932539.714285716,188.0,127.0,6,1224,18072901.6,204.0,204.0
144937.0,17,2,180,1,70,0.0,70.0,70.0,1,110,0.0,110.0,110.0
47142.0,6,14,4740,7,653,7012.666666666667,249.0,93.28571428571428,7,4087,7490.666666666667,1514.0,583.8571428571429
25000478.0,17,5,1718,4,1368,1035665.0,342.0,342.0,1,350,0.0,350.0,350.0
90530853.0,6,14,2240,8,1016,12932979.0,188.0,127.0,6,1224,18073403.4,204.0,204.0
1301058.0,6,4,264,2,132,0.0,66.0,66.0,2,132,0.0,66.0,66.0
52665.0,6,14,4740,7,653,7975.666666666667,249.0,93.28571428571428,7,4087,8613.833333333334,1514.0,583.8571428571429
5005074.0,17,4,849,2,166,0.0,83.0,83.0,2,683,0.0,499.0,341.5
90009865.0,17,28,13364,28,13364,3333698.703703704,501.0,477.2857142857143,0,0,0.0,0.0,0.0
118795686.0,6,47,3102,23,1518,5143998.727272728,66.0,66.0,24,1584,5165018.739130435,66.0,66.0
153470.0,17,2,180,1,90,0.0,90.0,90.0,1,90,0.0,90.0,90.0
228334.0,17,2,180,1,90,0.0,90.0,90.0,1,90,0.0,90.0,90.0
312.0,17,2,174,1,79,0.0,79.0,79.0,1,95,0.0,95.0,95.0
15552.0,6,14,4740,7,653,2395.5,249.0,93.28571428571428,7,4087,2419.0,1514.0,583.8571428571429
48733.0,6,14,4740,7,653,8000.5,249.0,93.28571428571428,7,4087,7562.333333333333,1514.0,583.8571428571429
90032024.0,17,28,13364,28,13364,3334519.407407407,501.0,477.2857142857143,0,0,0.0,0.0,0.0
1306878.0,6,4,264,2,132,0.0,66.0,66.0,2,132,0.0,66.0,66.0
90281790.0,6,17,1287,9,691,11279910.125,95.0,76.77777777777777,8,596,12896168.57142857,95.0,74.5
20819.0,6,10,2032,5,524,4976.75,252.0,104.8,5,1508,4947.0,1236.0,301.6
90370668.0,6,13,2052,6,1224,18073862.6,204.0,204.0,7,828,15015961.166666666,188.0,118.28571428571428
14446.0,6,14,4740,7,653,2254.833333333333,249.0,93.28571428571428,7,4087,2263.6666666666665,1514.0,583.8571428571429
20640.0,6,14,4740,7,653,3256.5,249.0,93.28571428571428,7,4087,3304.6666666666665,1514.0,583.8571428571429
7329633.0,17,4,1376,3,1026,56283.0,342.0,342.0,1,350,0.0,350.0,350.0
310218.0,17,4,1400,4,1400,103406.0,350.0,350.0,0,0,0.0,0.0,0.0
108714.0,17,2,700,2,700,0.0,350.0,350.0,0,0,0.0,0.0,0.0
3009075.0,6,12,2172,7,664,501415.0,252.0,94.85714285714286,5,1508,2554.0,1236.0,301.6
322.0,17,2,174,1,79,0.0,79.0,79.0,1,95,0.0,95.0,95.0
135128758.0,17,6,1146,6,1146,27025751.6,191.0,191.0,0,0,0.0,0.0,0.0
108097883.0,17,5,1005,5,1005,27024470.75,201.0,201.0,0,0,0.0,0.0,0.0
255958.00000000003,6,10,1221,6,636,51191.6,298.0,106.0,4,585,81661.66666666667,379.0,146.25
125006655.0,17,15,907,8,475,17858093.57142857,174.0,59.375,7,432,17500179.833333332,174.0,61.71428571428572
204549.0,17,2,180,1,90,0.0,90.0,90.0,1,90,0.0,90.0,90.0
2683697.0,6,3,1604,1,753,0.0,753.0,753.0,2,851,0.0,785.0,425.5
505487.0,6,5,336,2,134,0.0,68.0,67.0,3,202,191953.0,70.0,67.33333333333333
324381.0,6,6,412,4,272,108127.0,74.0,68.0,2,140,0.0,74.0,70.0
3211844.0,6,149,126558,89,118296,36498.22727272727,1510.0,1329.1685393258426,60,8262,49301.28813559322,1510.0,137.7
339.0,17,2,166,1,75,0.0,75.0,75.0,1,91,0.0,91.0,91.0
153357.0,17,2,180,1,90,0.0,90.0,90.0,1,90,0.0,90.0,90.0
14630866.0,6,18,1499,8,867,2047548.2857142857,315.0,108.375,10,632,1592457.888888889,78.0,63.2
206568.0,17,2,180,1,90,0.0,90.0,90.0,1,90,0.0,90.0,90.0
40886.0,6,14,4740,7,653,6694.0,249.0,93.28571428571428,7,4087,6422.666666666667,1514.0,583.8571428571429
3377.0,17,2,414,1,88,0.0,88.0,88.0,1,326,0.0,326.0,326.0
420.0,17,2,762,2,762,0.0,381.0,381.0,0,0,0.0,0.0,0.0
107254.0,17,2,286,2,286,0.0,143.0,143.0,0,0,0.0,0.0,0.0
190854.0,17,2,180,1,90,0.0,90.0,90.0,1,90,0.0,90.0,90.0
114420798.0,6,217,24490,109,7490,1059451.8333333333,140.0,68.71559633027523,108,17000,1059902.5327102805,284.0,157.40740740740742
3339876.0,6,183,135208,95,125099,35525.03191489362,1510.0,1316.8315789473684,88,10109,34846.597701149425,1510.0,114.875
8609980.0,17,3,1034,2,684,0.0,342.0,342.0,1,350,0.0,350.0,350.0
32951.0,6,10,2032,5,524,6861.5,252.0,104.8,5,1508,7609.75,1236.0,301.6
1304655.0,6,4,264,2,132,0.0,66.0,66.0,2,132,0.0,66.0,66.0
154053.0,17,2,180,1,90,0.0,90.0,90.0,1,90,0.0,90.0,90.0
43635.0,6,13,1459,7,862,6966.666666666667,271.0,123.14285714285714,6,597,2792.6,259.0,99.5
135131405.0,17,6,1206,6,1206,27026281.0,201.0,201.0,0,0,0.0,0.0,0.0
217457.0,6,3,426,2,280,0.0,214.0,140.0,1,146,0.0,146.0,146.0
90055828.0,17,28,13364,28,13364,3335401.037037037,501.0,477.2857142857143,0,0,0.0,0.0,0.0
2589225.0,6,2,132,1,66,0.0,66.0,66.0,1,66,0.0,66.0,66.0
299585.0,17,2,346,1,78,0.0,78.0,78.0,1,268,0.0,268.0,268.0
2288696.0,6,3,1604,2,851,0.0,785.0,425.5,1,753,0.0,753.0,753.0
90048967.0,17,27,12943,27,12943,3463421.8076923075,501.0,479.3703703703704,0,0,0.0,0.0,0.0
10409.0,17,2,582,1,83,0.0,83.0,83.0,1,499,0.0,499.0,499.0
79285.0,6,12,1328,7,797,13214.166666666666,253.0,113.85714285714286,5,531,16556.0,259.0,106.2
197822.0,17,2,180,1,90,0.0,90.0,90.0,1,90,0.0,90.0,90.0
2125271.0,6,19,6869,11,1567,212527.1,408.0,142.45454545454547,8,5302,241918.8571428572,1514.0,662.75
298893.0,6,6,412,4,272,99631.0,74.0,68.0,2,140,0.0,74.0,70.0
39154.0,6,14,4740,7,653,4303.166666666667,249.0,93.28571428571428,7,4087,6331.166666666667,1514.0,583.8571428571429
15570.0,6,13,1459,7,862,2444.833333333333,271.0,123.14285714285714,6,597,2532.0,259.0,99.5
50909.0,17,2,180,1,90,0.0,90.0,90.0,1,90,0.0,90.0,90.0
360.0,17,2,267,1,83,0.0,83.0,83.0,1,184,0.0,184.0,184.0
90525079.0,6,14,2240,8,1016,12932154.142857144,188.0,127.0,6,1224,18072336.8,204.0,204.0
108226.0,17,2,286,2,286,0.0,143.0,143.0,0,0,0.0,0.0,0.0
90261420.0,6,13,2036,8,1016,12894488.57142857,188.0,127.0,5,1020,22524022.75,204.0,204.0
197840.0,17,4,6056,4,6056,65946.66666666667,1514.0,1514.0,0,0,0.0,0.0,0.0
302447.0,6,2,132,1,66,0.0,66.0,66.0,1,66,0.0,66.0,66.0
113363940.0,6,48,3168,24,1584,4928866.956521739,66.0,66.0,24,1584,4919467.826086956,66.0,66.0
2069492.0,6,20,7599,11,1469,206949.2,583.0,133.54545454545453,9,6130,225447.5,1484.0,681.1111111111111
114718086.0,6,35,2542,18,1348,6735423.94117647,139.0,74.88888888888889,17,1194,7156388.875,123.0,70.23529411764706
101261871.0,6,28,1860,14,966,7772778.307692308,123.0,69.0,14,894,7772782.692307692,123.0,63.85714285714285
20590.0,6,10,2032,5,524,4906.75,252.0,104.8,5,1508,4851.0,1236.0,301.6
108103695.0,17,5,1005,5,1005,27025923.75,201.0,201.0,0,0,0.0,0.0,0.0
2038.0,17,4,344,2,150,0.0,75.0,75.0,2,194,0.0,103.0,97.0
90031606.0,17,28,13364,28,13364,3334503.925925926,501.0,477.2857142857143,0,0,0.0,0.0,0.0
26960.0,6,12,1320,6,723,4600.2,253.0,120.5,6,597,4651.4,259.0,99.5
90032001.0,17,28,13364,28,13364,3334518.5555555555,501.0,477.2857142857143,0,0,0.0,0.0,0.0
406996.0,6,3,1604,1,753,0.0,753.0,753.0,2,851,0.0,785.0,425.5
280007.0,17,4,704,2,148,0.0,74.0,74.0,2,556,0.0,280.0,278.0
108107043.0,17,5,1005,5,1005,27026760.75,201.0,201.0,0,0,0.0,0.0,0.0
108104616.0,17,5,955,5,955,27026154.0,191.0,191.0,0,0,0.0,0.0,0.0
212874.0,17,2,180,1,90,0.0,90.0,90.0,1,90,0.0,90.0,90.0
213074.0,6,3,426,2,280,0.0,214.0,140.0,1,146,0.0,146.0,146.0
8872313.0,17,3,1034,2,684,0.0,342.0,342.0,1,350,0.0,350.0,350.0
110555865.0,6,32,2220,16,1149,7356011.866666666,123.0,71.8125,16,1071,7355996.4,123.0,66.9375
430545.0,6,10,1221,6,636,86109.0,298.0,106.0,4,585,142299.66666666666,379.0,146.25
107512.0,17,2,286,2,286,0.0,143.0,143.0,0,0,0.0,0.0,0.0
298134.0,6,6,412,4,272,99378.0,74.0,68.0,2,140,0.0,74.0,70.0
362749.0,6,11,1021,6,444,48730.6,162.0,74.0,5,577,60799.0,349.0,115.4
90258082.0,6,12,1832,8,1016,12894011.714285716,188.0,127.0,4,816,30031461.666666668,204.0,204.0
168537.0,6,11,1132,6,556,33081.6,218.0,92.66666666666669,5,576,41929.75,304.0,115.2
108118709.0,17,5,955,5,955,27029677.25,191.0,191.0,0,0,0.0,0.0,0.0
330.0,17,2,208,1,72,0.0,72.0,72.0,1,136,0.0,136.0,136.0
5827157.0,6,5,336,2,134,0.0,68.0,67.0,3,202,1526442.0,70.0,67.33333333333333
39035.0,6,14,4740,7,653,6275.833333333333,249.0,93.28571428571428,7,4087,6020.0,1514.0,583.8571428571429
206428.0,6,10,1221,6,636,41285.6,298.0,106.0,4,585,67514.33333333333,379.0,146.25
40070.0,6,14,4740,7,653,6465.333333333333,249.0,93.28571428571428,7,4087,5565.5,1514.0,583.8571428571429
90257559.0,6,13,2036,8,1016,12893937.0,188.0,127.0,5,1020,22523048.25,204.0,204.0
298050.0,6,6,412,4,272,99350.0,74.0,68.0,2,140,0.0,74.0,70.0
90255136.0,6,12,1832,8,1016,12893590.857142856,188.0,127.0,4,816,30027051.33333333,204.0,204.0
2401.0,17,4,344,2,150,0.0,75.0,75.0,2,194,0.0,103.0,97.0
814.0,17,4,438,2,148,0.0,74.0,74.0,2,290,0.0,147.0,145.0
204068.0,17,2,762,2,762,0.0,381.0,381.0,0,0,0.0,0.0,0.0
311902.0,17,4,1400,4,1400,103967.33333333331,350.0,350.0,0,0,0.0,0.0,0.0
319008.0,17,4,1400,4,1400,106336.0,350.0,350.0,0,0,0.0,0.0,0.0
228271.0,17,2,180,1,90,0.0,90.0,90.0,1,90,0.0,90.0,90.0
8054.0,17,2,166,1,75,0.0,75.0,75.0,1,91,0.0,91.0,91.0
135127933.0,17,6,1146,6,1146,27025586.6,191.0,191.0,0,0,0.0,0.0,0.0
300.0,17,2,164,1,82,0.0,82.0,82.0,1,82,0.0,82.0,82.0
284143.0,17,2,363,1,79,0.0,79.0,79.0,1,284,0.0,284.0,284.0
135137762.0,17,6,1206,6,1206,27027552.4,201.0,201.0,0,0,0.0,0.0,0.0
2021503.0,17,4,525,2,150,0.0,75.0,75.0,2,375,0.0,284.0,187.5
102290.0,17,2,286,2,286,0.0,143.0,143.0,0,0,0.0,0.0,0.0
131356.0,6,3,337,2,214,0.0,160.0,107.0,1,123,0.0,123.0,123.0
50526.0,6,14,4740,7,653,6363.666666666667,249.0,93.28571428571428,7,4087,8277.833333333334,1514.0,583.8571428571429
143918.0,17,2,180,1,90,0.0,90.0,90.0,1,90,0.0,90.0,90.0
243358.0,6,3,337,2,214,0.0,160.0,107.0,1,123,0.0,123.0,123.0
213777.0,17,2,180,1,90,0.0,90.0,90.0,1,90,0.0,90.0,90.0
133521.0,6,2,132,1,66,0.0,66.0,66.0,1,66,0.0,66.0,66.0
254880.0,6,3,354,2,288,0.0,222.0,144.0,1,66,0.0,66.0,66.0
1302500.0,6,4,264,2,132,0.0,66.0,66.0,2,132,0.0,66.0,66.0
99870910.0,17,12,778,6,389,19800159.4,174.0,64.83333333333333,6,389,19800806.0,174.0,64.83333333333333
3022665.0,6,148,115750,82,107092,37316.851851851854,1510.0,1306.0,66,8658,41785.2,1510.0,131.1818181818182
153448.0,17,2,180,1,90,0.0,90.0,90.0,1,90,0.0,90.0,90.0
90010322.0,17,28,13364,28,13364,3333715.6296296297,501.0,477.2857142857143,0,0,0.0,0.0,0.0
318993.0,17,4,1400,4,1400,106331.0,350.0,350.0,0,0,0.0,0.0,0.0
201908.0,6,7,744,4,455,67302.66666666667,249.0,113.75,3,289,85026.5,149.0,96.33333333333331
2526.0,17,4,344,2,150,0.0,75.0,75.0,2,194,0.0,103.0,97.0
144044.0,17,2,180,1,90,0.0,90.0,90.0,1,90,0.0,90.0,90.0
5794.0,17,2,180,1,90,0.0,90.0,90.0,1,90,0.0,90.0,90.0
115916000.0,6,34,2334,17,1209,7231269.0625,123.0,71.11764705882354,17,1125,7231269.3125,123.0,66.17647058823529
126616494.0,6,33,2227,17,1225,7913530.875,139.0,72.05882352941177,16,1002,7914036.933333334,123.0,62.625
2262.0,17,4,344,2,150,0.0,75.0,75.0,2,194,0.0,103.0,97.0
27068698.0,17,5,1710,5,1710,6767174.5,342.0,342.0,0,0,0.0,0.0,0.0
81427.0,6,10,1065,5,534,20081.25,262.0,106.8,5,531,17710.75,259.0,106.2
10521185.0,6,7,478,4,272,3461658.333333333,74.0,68.0,3,206,5192368.5,74.0,68.66666666666667
98240.0,17,2,762,2,762,0.0,381.0,381.0,0,0,0.0,0.0,0.0
2596978.0,6,2,132,1,66,0.0,66.0,66.0,1,66,0.0,66.0,66.0
1311502.0,6,4,264,2,132,0.0,66.0,66.0,2,132,0.0,66.0,66.0
1042716.0,6,13,1386,7,789,173785.99999999997,253.0,112.71428571428572,6,597,206922.6,259.0,99.5
120220827.0,6,216,24440,108,7350,1106106.6448598132,140.0,68.05555555555556,108,17090,1115848.5140186916,284.0,158.24074074074073
2406.0,17,4,344,2,150,0.0,75.0,75.0,2,194,0.0,103.0,97.0
208064.0,6,3,426,2,280,0.0,214.0,140.0,1,146,0.0,146.0,146.0
287175.0,6,10,1221,6,636,57435.0,298.0,106.0,4,585,87257.0,379.0,146.25
19445093.0,6,5,1909,2,892,0.0,826.0,446.0,3,1017,8999857.5,885.0,339.0
40583.0,6,10,2032,5,524,8526.5,252.0,104.8,5,1508,9770.75,1236.0,301.6
244103.0,6,3,426,2,280,0.0,214.0,140.0,1,146,0.0,146.0,146.0
90263710.0,6,12,1832,8,1016,12894815.714285716,188.0,127.0,4,816,30032768.0,204.0,204.0
10066.0,17,2,582,1,83,0.0,83.0,83.0,1,499,0.0,499.0,499.0
90527675.0,6,13,2036,8,1016,12932525.0,188.0,127.0,5,1020,22591299.75,204.0,204.0
135130790.0,17,6,1206,6,1206,27026158.0,201.0,201.0,0,0,0.0,0.0,0.0
110969724.0,6,32,2220,16,1149,7383595.133333334,123.0,71.8125,16,1071,7383577.733333333,123.0,66.9375
317860.0,17,4,1400,4,1400,105953.33333333331,350.0,350.0,0,0,0.0,0.0,0.0
107392.0,17,2,286,2,286,0.0,143.0,143.0,0,0,0.0,0.0,0.0
122530629.0,6,49,3234,25,1650,5105442.875,66.0,66.0,24,1584,4956974.739130435,66.0,66.0
120017113.0,17,28,13364,28,13364,4445078.259259259,501.0,477.2857142857143,0,0,0.0,0.0,0.0
90524504.0,6,14,2240,8,1016,12932072.0,188.0,127.0,6,1224,18072159.6,204.0,204.0
731.0,17,4,438,2,148,0.0,74.0,74.0,2,290,0.0,147.0,145.0
103667.0,17,2,286,2,286,0.0,143.0,143.0,0,0,0.0,0.0,0.0
144691.0,17,2,180,1,70,0.0,70.0,70.0,1,110,0.0,110.0,110.0
10136.0,17,4,823,2,163,0.0,89.0,81.5,2,660,0.0,443.0,330.0
26259.0,6,10,2032,5,524,6228.75,252.0,104.8,5,1508,6320.0,1236.0,301.6
2806250.0,6,2,132,1,66,0.0,66.0,66.0,1,66,0.0,66.0,66.0
90308701.0,6,21,1741,11,996,9024481.4,251.0,90.54545454545456,10,745,10032703.555555556,95.0,74.5
84862541.0,6,17,1185,9,640,10607817.625,95.0,71.11111111111111,8,545,12086610.714285716,95.0,68.125
229571.0,17,2,359,1,75,0.0,75.0,75.0,1,284,0.0,284.0,284.0
17428965.0,6,21,7017,12,1641,1584451.3636363635,408.0,136.75,9,5376,1663780.0,1514.0,597.3333333333334
285191.0,17,2,363,1,79,0.0,79.0,79.0,1,284,0.0,284.0,284.0
59637.0,6,13,1386,7,789,9939.5,253.0,112.71428571428572,6,597,9445.0,259.0,99.5
9319930.0,17,3,1034,2,684,0.0,342.0,342.0,1,350,0.0,350.0,350.0
43710.0,6,14,4740,7,653,6926.0,249.0,93.28571428571428,7,4087,7060.333333333333,1514.0,583.8571428571429
2418.0,17,4,344,2,150,0.0,75.0,75.0,2,194,0.0,103.0,97.0
309775.0,17,4,1400,4,1400,103258.33333333331,350.0,350.0,0,0,0.0,0.0,0.0
10472953.0,6,7,478,4,272,3445357.6666666665,74.0,68.0,3,206,5167936.0,74.0,68.66666666666667
6648.0,17,4,823,2,163,0.0,89.0,81.5,2,660,0.0,443.0,330.0
14988.0,17,2,180,1,90,0.0,90.0,90.0,1,90,0.0,90.0,90.0
454915.0,6,3,1604,2,851,0.0,785.0,425.5,1,753,0.0,753.0,753.0
103454.0,17,2,286,2,286,0.0,143.0,143.0,0,0,0.0,0.0,0.0
7450.0,17,4,344,2,150,0.0,75.0,75.0,2,194,0.0,103.0,97.0
9760.0,17,2,582,1,83,0.0,83.0,83.0,1,499,0.0,499.0,499.0
100800004.0,6,32,2352,16,1212,6705606.8,123.0,75.75,16,1140,6705611.0,123.0,71.25
147679.0,6,3,337,2,214,0.0,160.0,107.0,1,123,0.0,123.0,123.0
1562547.0,17,6,1230,3,234,781084.0,78.0,78.0,3,996,781061.0,332.0,332.0
98722.0,17,2,762,2,762,0.0,381.0,381.0,0,0,0.0,0.0,0.0
114403284.0,6,48,3168,24,1584,4974055.826086956,66.0,66.0,24,1584,4964659.521739131,66.0,66.0
145014.0,17,2,180,1,70,0.0,70.0,70.0,1,110,0.0,110.0,110.0
30290.0,6,10,2032,5,524,7327.0,252.0,104.8,5,1508,7222.0,1236.0,301.6
3229536.0,6,3,1602,2,850,0.0,784.0,425.0,1,752,0.0,752.0,752.0
196146.0,17,4,6056,4,6056,65382.0,1514.0,1514.0,0,0,0.0,0.0,0.0
2607401.0,6,2,132,1,66,0.0,66.0,66.0,1,66,0.0,66.0,66.0
0.0,6,1,66,1,66,0.0,66.0,66.0,0,0,0.0,0.0,0.0
115000945.0,17,15,1169,8,606,16428706.42857143,174.0,75.75,7,563,15834358.333333334,174.0,80.42857142857143
153447.0,17,2,180,1,90,0.0,90.0,90.0,1,90,0.0,90.0,90.0
108107454.0,17,5,1005,5,1005,27026863.5,201.0,201.0,0,0,0.0,0.0,0.0
6360.0,17,4,823,2,163,0.0,89.0,81.5,2,660,0.0,443.0,330.0
90254592.0,6,13,2036,8,1016,12893513.142857144,188.0,127.0,5,1020,22522534.5,204.0,204.0
118565528.0,6,216,24424,108,17000,1105975.570093458,284.0,157.40740740740742,108,7424,1106076.1308411215,140.0,68.74074074074075
2507.0,17,4,344,2,150,0.0,75.0,75.0,2,194,0.0,103.0,97.0
99308.0,17,2,762,2,762,0.0,381.0,381.0,0,0,0.0,0.0,0.0
24637.0,6,10,2032,5,524,5769.0,252.0,104.8,5,1508,5909.5,1236.0,301.6
120252433.0,6,224,25328,112,7614,1076093.0720720722,140.0,67.98214285714286,112,17714,1075955.9099099098,284.0,158.16071428571428
0.0,6,1,66,1,66,0.0,66.0,66.0,0,0,0.0,0.0,0.0
15115269.0,17,6,2052,6,2052,3023053.8,342.0,342.0,0,0,0.0,0.0,0.0
90258458.0,6,12,1832,8,1016,12894065.42857143,188.0,127.0,4,816,30031766.33333333,204.0,204.0
1572749.0,6,2,132,1,66,0.0,66.0,66.0,1,66,0.0,66.0,66.0
107168594.0,6,201,22602,101,6888,1071685.94,140.0,68.1980198019802,100,15714,1072190.121212121,284.0,157.14
49666.0,6,14,4740,7,653,8096.333333333333,249.0,93.28571428571428,7,4087,6263.166666666667,1514.0,583.8571428571429
146285.0,6,3,337,2,214,0.0,160.0,107.0,1,123,0.0,123.0,123.0
210919.0,6,10,1221,6,636,42183.8,298.0,106.0,4,585,68893.33333333333,379.0,146.25
148003.0,17,2,180,1,90,0.0,90.0,90.0,1,90,0.0,90.0,90.0
206317.0,6,3,426,2,280,0.0,214.0,140.0,1,146,0.0,146.0,146.0
119915347.0,17,35,16705,35,16705,3526921.970588235,501.0,477.2857142857143,0,0,0.0,0.0,0.0
90293626.0,6,16,1192,8,596,12891680.142857144,95.0,74.5,8,596,12896530.57142857,95.0,74.5
140393.0,6,14,4740,7,653,21705.83333333333,249.0,93.28571428571428,7,4087,17403.666666666668,1514.0,583.8571428571429
102116996.0,6,28,1860,14,966,7838562.615384615,123.0,69.0,14,894,7838564.0,123.0,63.85714285714285
321536.0,17,4,1400,4,1400,107178.66666666669,350.0,350.0,0,0,0.0,0.0,0.0
383196.0,6,3,204,2,136,0.0,70.0,68.0,1,68,0.0,68.0,68.0
306911.0,6,6,412,4,272,102303.66666666669,74.0,68.0,2,140,0.0,74.0,70.0
232630.0,6,3,337,2,214,0.0,160.0,107.0,1,123,0.0,123.0,123.0
299351.0,6,6,412,4,272,99783.66666666669,74.0,68.0,2,140,0.0,74.0,70.0
107255136.0,17,14,864,7,432,17833498.333333332,174.0,61.71428571428572,7,432,17834382.333333332,174.0,61.71428571428572
3080040.0,6,3,204,2,134,0.0,68.0,67.0,1,70,0.0,70.0,70.0
1608.0,17,2,762,2,762,0.0,381.0,381.0,0,0,0.0,0.0,0.0
3595900.0,6,19,1549,10,975,363846.1111111111,315.0,97.5,9,574,409674.25,78.0,63.77777777777778
90772112.0,6,14,2240,8,1016,12967444.57142857,188.0,127.0,6,1224,18121659.6,204.0,204.0
148538.0,17,2,414,1,88,0.0,88.0,88.0,1,326,0.0,326.0,326.0
147983.0,17,2,180,1,90,0.0,90.0,90.0,1,90,0.0,90.0,90.0
147078.0,6,3,373,2,238,0.0,172.0,119.0,1,135,0.0,135.0,135.0
67229.0,6,12,1328,7,797,11204.833333333334,253.0,113.85714285714286,5,531,14092.25,259.0,106.2
90260173.0,6,12,1832,8,1016,12894310.42857143,188.0,127.0,4,816,30032460.666666668,204.0,204.0
1306990.0,6,4,264,2,132,0.0,66.0,66.0,2,132,0.0,66.0,66.0
16189286.0,17,6,2052,6,2052,3237857.2,342.0,342.0,0,0,0.0,0.0,0.0
108084817.0,17,5,955,5,955,27021204.25,191.0,191.0,0,0,0.0,0.0,0.0
108108994.0,17,5,1005,5,1005,27027248.5,201.0,201.0,0,0,0.0,0.0,0.0
1311806.0,6,4,264,2,132,0.0,66.0,66.0,2,132,0.0,66.0,66.0
90746484.0,6,19,1436,10,745,10078099.222222222,95.0,74.5,9,691,11342395.125,95.0,76.77777777777777
2499200.0,6,25,7573,14,3735,192246.15384615384,1514.0,266.7857142857143,11,3838,224542.0,1514.0,348.90909090909093
9521.0,17,2,571,1,86,0.0,86.0,86.0,1,485,0.0,485.0,485.0
1875362.0,6,4,276,2,128,0.0,74.0,64.0,2,148,0.0,74.0,74.0
107353781.0,6,29,2052,15,1089,7668127.214285715,123.0,72.6,14,963,8241346.692307692,123.0,68.78571428571429
90211492.0,6,16,1192,8,596,12853634.285714284,95.0,74.5,8,596,12857999.57142857,95.0,74.5
344.0,17,2,267,1,83,0.0,83.0,83.0,1,184,0.0,184.0,184.0
2337.0,17,4,344,2,150,0.0,75.0,75.0,2,194,0.0,103.0,97.0
136008815.0,17,15,907,8,475,19429830.71428572,174.0,59.375,7,432,19333533.83333333,174.0,61.71428571428572
2871075.0,6,3,1604,2,851,0.0,785.0,425.5,1,753,0.0,753.0,753.0
331.0,17,2,166,1,75,0.0,75.0,75.0,1,91,0.0,91.0,91.0
120004329.0,6,906,159266,459,129246,261546.4454148472,1514.0,281.58169934640523,447,30020,268585.1457399103,214.0,67.15883668903803
6380873.0,17,5,1710,5,1710,1595218.25,342.0,342.0,0,0,0.0,0.0,0.0
117715119.0,17,12,778,6,389,19600156.6,174.0,64.83333333333333,6,389,20104332.4,174.0,64.83333333333333
36218.0,6,14,4740,7,653,5924.833333333333,249.0,93.28571428571428,7,4087,4746.833333333333,1514.0,583.8571428571429
146173.0,6,3,337,2,214,0.0,160.0,107.0,1,123,0.0,123.0,123.0
9714.0,17,2,571,1,86,0.0,86.0,86.0,1,485,0.0,485.0,485.0
137926.0,6,2,132,1,66,0.0,66.0,66.0,1,66,0.0,66.0,66.0
215613.0,17,2,180,1,90,0.0,90.0,90.0,1,90,0.0,90.0,90.0
3177152.0,6,18,1536,9,962,358358.5,315.0,106.88888888888889,9,574,358322.625,78.0,63.77777777777778
10486722.0,6,7,478,4,272,3449627.0,74.0,68.0,3,206,5174368.5,74.0,68.66666666666667
87861.0,6,14,4740,7,653,14512.666666666666,249.0,93.28571428571428,7,4087,14376.0,1514.0,583.8571428571429
117610499.0,6,212,23996,106,16704,1118049.3523809523,300.0,157.58490566037736,106,7292,1118049.3904761905,140.0,68.79245283018868
2289.0,17,4,344,2,150,0.0,75.0,75.0,2,194,0.0,103.0,97.0
108104755.0,17,5,1005,5,1005,27026188.75,201.0,201.0,0,0,0.0,0.0,0.0
120055648.0,6,228,25660,114,7746,1056116.1946902657,140.0,67.94736842105263,114,17914,1056062.203539823,284.0,157.140350877193
511273.0,6,5,336,2,134,0.0,68.0,67.0,3,202,195267.0,70.0,67.33333333333333
108498212.0,17,14,864,7,432,18056348.666666668,174.0,61.71428571428572,7,432,18050874.5,174.0,61.71428571428572
43666.0,6,10,2032,5,524,10702.25,252.0,104.8,5,1508,10675.5,1236.0,301.6
107835.0,17,2,286,2,286,0.0,143.0,143.0,0,0,0.0,0.0,0.0
118714745.0,6,34,2482,17,1194,7419643.0625,123.0,70.23529411764706,17,1288,6795623.75,139.0,75.76470588235294
207261.0,6,3,426,2,280,0.0,214.0,140.0,1,146,0.0,146.0,146.0
215668.0,17,4,1400,4,1400,71889.33333333333,350.0,350.0,0,0,0.0,0.0,0.0
120019983.0,17,28,13364,28,13364,4445184.555555556,501.0,477.2857142857143,0,0,0.0,0.0,0.0
233566.0,6,3,337,2,214,0.0,160.0,107.0,1,123,0.0,123.0,123.0
388.0,17,2,174,1,79,0.0,79.0,79.0,1,95,0.0,95.0,95.0
1096.0,17,4,316,2,158,0.0,79.0,79.0,2,158,0.0,79.0,79.0
311045.0,6,3,202,2,128,0.0,74.0,64.0,1,74,0.0,74.0,74.0
110418282.0,17,14,864,7,432,18334976.5,174.0,61.71428571428572,7,432,18333494.0,174.0,61.71428571428572
90277672.0,6,16,1192,8,596,12890649.285714284,95.0,74.5,8,596,12894970.57142857,95.0,74.5
108241469.0,6,44,2904,22,1452,5154355.666666667,66.0,66.0,22,1452,5139653.0,66.0,66.0
92859445.0,6,713,157324,350,23778,266072.9083094556,214.0,67.93714285714286,363,133546,255900.0773480663,1514.0,367.8953168044077
48291.0,6,2,132,1,66,0.0,66.0,66.0,1,66,0.0,66.0,66.0
284528.0,6,10,1221,6,636,56905.6,298.0,106.0,4,585,89295.0,379.0,146.25
56409.0,6,14,4740,7,653,9265.333333333334,249.0,93.28571428571428,7,4087,9262.166666666666,1514.0,583.8571428571429
9385.0,6,11,2098,6,590,1725.6,252.0,98.33333333333331,5,1508,2060.5,1236.0,301.6
3014730.0,6,12,2172,7,664,502342.8333333333,252.0,94.85714285714286,5,1508,3165.25,1236.0,301.6
113360799.0,6,214,24202,107,16844,1067408.3867924528,284.0,157.42056074766356,107,7358,1067410.2452830188,140.0,68.76635514018692
17246.0,6,14,4740,7,653,2758.333333333333,249.0,93.28571428571428,7,4087,2728.1666666666665,1514.0,583.8571428571429
120047684.0,17,29,13785,29,13785,4287417.285714285,501.0,475.3448275862069,0,0,0.0,0.0,0.0
5010520.0,17,4,833,2,166,0.0,83.0,83.0,2,667,0.0,483.0,333.5
204540.0,17,2,762,2,762,0.0,381.0,381.0,0,0,0.0,0.0,0.0
10522558.0,6,7,478,4,272,3461869.0,74.0,68.0,3,206,5192699.0,74.0,68.66666666666667
233130.0,6,3,373,2,238,0.0,172.0,119.0,1,135,0.0,135.0,135.0
50886.0,17,2,180,1,90,0.0,90.0,90.0,1,90,0.0,90.0,90.0
2035245.0,6,28,12051,15,4361,145374.64285714287,1510.0,290.7333333333333,13,7690,144461.75,1510.0,591.5384615384615
118074180.0,17,22,9966,22,9966,5622580.0,453.0,453.0,0,0,0.0,0.0,0.0
201722.0,17,4,6056,4,6056,67240.66666666667,1514.0,1514.0,0,0,0.0,0.0,0.0
22092.0,6,14,4740,7,653,3540.833333333333,249.0,93.28571428571428,7,4087,3019.6666666666665,1514.0,583.8571428571429
90218298.0,6,16,1192,8,596,12853888.142857144,95.0,74.5,8,596,12859075.857142856,95.0,74.5
213344.0,6,10,1221,6,636,42668.8,298.0,106.0,4,585,69689.33333333333,379.0,146.25
100004004.0,17,14,1126,7,563,16667334.0,174.0,80.42857142857143,7,563,16500134.833333334,174.0,80.42857142857143
135139432.0,17,6,1206,6,1206,27027886.4,201.0,201.0,0,0,0.0,0.0,0.0
120000038.0,6,17,1287,9,691,15000004.75,95.0,76.77777777777777,8,596,12896102.714285716,95.0,74.5
90052514.0,17,27,12943,27,12943,3463558.230769231,501.0,479.3703703703704,0,0,0.0,0.0,0.0
155133.0,6,3,337,2,214,0.0,160.0,107.0,1,123,0.0,123.0,123.0
106030.0,17,2,700,2,700,0.0,350.0,350.0,0,0,0.0,0.0,0.0
877901.0,6,12,2715,7,743,146316.83333333334,339.0,106.14285714285714,5,1972,151301.75,1514.0,394.4
141349.0,6,2,132,1,66,0.0,66.0,66.0,1,66,0.0,66.0,66.0
284801.0,17,2,363,1,79,0.0,79.0,79.0,1,284,0.0,284.0,284.0
2334361.0,6,3,1777,2,951,0.0,885.0,475.5,1,826,0.0,826.0,826.0
792.0,17,5,550,5,550,198.0,110.0,110.0,0,0,0.0,0.0,0.0
297993.0,6,6,412,4,272,99331.0,74.0,68.0,2,140,0.0,74.0,70.0
9929.0,6,10,2032,5,524,1788.5,252.0,104.8,5,1508,2251.0,1236.0,301.6
120364975.0,6,255,28810,128,20120,947755.7086614174,284.0,157.1875,127,8690,947138.7777777778,140.0,68.4251968503937
995977.0,6,13,1428,7,797,164064.83333333334,253.0,113.85714285714286,6,631,198420.6,293.0,105.16666666666669
73893.0,6,14,4740,7,653,12139.666666666666,249.0,93.28571428571428,7,4087,8706.5,1514.0,583.8571428571429
29887.0,6,14,4740,7,653,3348.6666666666665,249.0,93.28571428571428,7,4087,4809.5,1514.0,583.8571428571429
2454.0,17,4,344,2,150,0.0,75.0,75.0,2,194,0.0,103.0,97.0
55654.0,6,14,4740,7,653,9122.0,249.0,93.28571428571428,7,4087,8316.666666666666,1514.0,583.8571428571429
15697.0,6,11,2098,6,590,2868.4,252.0,98.33333333333331,5,1508,3689.5,1236.0,301.6
2593161.0,6,2,132,1,66,0.0,66.0,66.0,1,66,0.0,66.0,66.0
82.0,17,2,762,2,762,0.0,381.0,381.0,0,0,0.0,0.0,0.0
120056570.0,17,29,13785,29,13785,4287734.642857143,501.0,475.3448275862069,0,0,0.0,0.0,0.0
108099587.0,17,5,1005,5,1005,27024896.75,201.0,201.0,0,0,0.0,0.0,0.0
16894.0,6,14,4740,7,653,2459.6666666666665,249.0,93.28571428571428,7,4087,2681.6666666666665,1514.0,583.8571428571429
47160.0,6,14,4740,7,653,7736.833333333333,249.0,93.28571428571428,7,4087,7655.166666666667,1514.0,583.8571428571429
232183.0,6,3,337,2,214,0.0,160.0,107.0,1,123,0.0,123.0,123.0
113000029.0,6,38,3102,21,1701,5639214.7,123.0,81.0,17,1401,7048912.375,123.0,82.41176470588235
105012493.0,17,13,1083,7,563,17502082.166666668,174.0,80.42857142857143,6,520,17000191.2,174.0,86.66666666666667
4614.0,17,2,180,1,90,0.0,90.0,90.0,1,90,0.0,90.0,90.0
135133190.0,17,6,1146,6,1146,27026638.0,191.0,191.0,0,0,0.0,0.0,0.0
162274.0,17,2,180,1,90,0.0,90.0,90.0,1,90,0.0,90.0,90.0
298200.0,17,2,180,1,90,0.0,90.0,90.0,1,90,0.0,90.0,90.0
105608252.0,17,13,821,7,432,17601375.333333332,174.0,61.71428571428572,6,389,17189816.6,174.0,64.83333333333333
5622301.0,6,5,336,2,134,0.0,68.0,67.0,3,202,1524563.0,70.0,67.33333333333333
114199887.0,6,225,25468,113,7754,1019641.8482142856,140.0,68.61946902654867,112,17714,1023353.5045045044,284.0,158.16071428571428
108627.0,17,2,286,2,286,0.0,143.0,143.0,0,0,0.0,0.0,0.0
105636.0,17,2,700,2,700,0.0,350.0,350.0,0,0,0.0,0.0,0.0
302382.0,6,2,132,1,66,0.0,66.0,66.0,1,66,0.0,66.0,66.0
112101797.0,17,16,1474,8,737,15991672.285714284,174.0,92.125,8,737,15991668.285714284,174.0,92.125
121976.0,6,3,373,2,238,0.0,172.0,119.0,1,135,0.0,135.0,135.0
167638.0,17,4,704,2,148,0.0,74.0,74.0,2,556,0.0,280.0,278.0
108124767.0,17,5,1005,5,1005,27031191.75,201.0,201.0,0,0,0.0,0.0,0.0
84.0,17,2,762,2,762,0.0,381.0,381.0,0,0,0.0,0.0,0.0
35299.0,6,14,4740,7,653,5699.5,249.0,93.28571428571428,7,4087,5344.666666666667,1514.0,583.8571428571429
1020697.0,6,11,1134,6,558,204139.4,220.0,93.0,5,576,254774.25,304.0,115.2
302178.0,6,6,412,4,272,100726.0,74.0,68.0,2,140,0.0,74.0,70.0
298182.0,6,6,412,4,272,99394.0,74.0,68.0,2,140,0.0,74.0,70.0
296357.0,17,2,180,1,90,0.0,90.0,90.0,1,90,0.0,90.0,90.0
146210.0,17,2,180,1,90,0.0,90.0,90.0,1,90,0.0,90.0,90.0
505646.00000000006,6,5,336,2,134,0.0,68.0,67.0,3,202,193876.5,70.0,67.33333333333333
108104530.0,17,5,1005,5,1005,27026132.5,201.0,201.0,0,0,0.0,0.0,0.0
90307747.0,6,16,1192,8,596,12893825.714285716,95.0,74.5,8,596,12899931.42857143,95.0,74.5
17386.0,6,11,1133,6,602,3345.6,264.0,100.33333333333331,5,531,3443.0,259.0,106.2
242630.0,6,3,337,2,214,0.0,160.0,107.0,1,123,0.0,123.0,123.0
153326.0,17,2,180,1,90,0.0,90.0,90.0,1,90,0.0,90.0,90.0
306013.0,6,6,412,4,272,102004.33333333331,74.0,68.0,2,140,0.0,74.0,70.0
228245.0,17,2,180,1,90,0.0,90.0,90.0,1,90,0.0,90.0,90.0
322187.0,17,4,1400,4,1400,107395.66666666669,350.0,350.0,0,0,0.0,0.0,0.0
108107478.0,17,5,955,5,955,27026869.5,191.0,191.0,0,0,0.0,0.0,0.0
71206.0,6,10,2032,5,524,17467.0,252.0,104.8,5,1508,16157.25,1236.0,301.6
22004.0,6,10,2032,5,524,5267.0,252.0,104.8,5,1508,4528.0,1236.0,301.6
2439977.0,6,26,7627,14,3735,187690.53846153847,1514.0,266.7857142857143,12,3892,196844.54545454544,1514.0,324.3333333333333
746.0,17,4,438,2,148,0.0,74.0,74.0,2,290,0.0,147.0,145.0
120004450.0,6,20,1531,9,691,15000556.25,95.0,76.77777777777777,11,840,11974554.3,95.0,76.36363636363636
120000567.0,6,17,1246,9,650,15000070.875,95.0,72.22222222222223,8,596,17108145.285714287,95.0,74.5
4388.0,17,2,626,1,72,0.0,72.0,72.0,1,554,0.0,554.0,554.0
12729.0,6,10,2032,5,524,2832.75,252.0,104.8,5,1508,2950.75,1236.0,301.6
232708.0,6,3,337,2,214,0.0,160.0,107.0,1,123,0.0,123.0,123.0
196884.0,17,2,180,1,90,0.0,90.0,90.0,1,90,0.0,90.0,90.0
90304379.0,6,16,1192,8,596,12894077.857142856,95.0,74.5,8,596,12899053.42857143,95.0,74.5
214726.0,6,12,1373,7,714,35787.666666666664,298.0,102.0,5,659,52615.5,379.0,131.8
108115730.0,17,5,955,5,955,27028932.5,191.0,191.0,0,0,0.0,0.0,0.0
218109.0,6,3,426,2,280,0.0,214.0,140.0,1,146,0.0,146.0,146.0
90227302.0,6,16,1192,8,596,12853710.285714284,95.0,74.5,8,596,12858739.142857144,95.0,74.5
51316.0,6,14,4740,7,653,7498.333333333333,249.0,93.28571428571428,7,4087,8413.666666666666,1514.0,583.8571428571429
25835.0,6,11,2098,6,590,5089.2,252.0,98.33333333333331,5,1508,4776.0,1236.0,301.6
143794.0,17,2,180,1,90,0.0,90.0,90.0,1,90,0.0,90.0,90.0
3779.0,17,4,344,2,150,0.0,75.0,75.0,2,194,0.0,103.0,97.0
2591547.0,6,2,132,1,66,0.0,66.0,66.0,1,66,0.0,66.0,66.0
18178.0,6,10,2032,5,524,4255.75,252.0,104.8,5,1508,3959.0,1236.0,301.6
206614.0,6,3,426,2,280,0.0,214.0,140.0,1,146,0.0,146.0,146.0
90274451.0,6,14,2240,8,1016,12896350.142857144,188.0,127.0,6,1224,18022178.4,204.0,204.0
106115950.0,6,28,1876,14,982,8146150.0,139.0,70.14285714285714,14,894,8146159.384615385,123.0,63.85714285714285
209516.0,17,2,180,1,90,0.0,90.0,90.0,1,90,0.0,90.0,90.0
7924371.0,17,4,1376,3,1026,46260.5,342.0,342.0,1,350,0.0,350.0,350.0
90047887.0,17,27,12943,27,12943,3463380.269230769,501.0,479.3703703703704,0,0,0.0,0.0,0.0
90261280.0,6,14,2240,8,1016,12894468.57142857,188.0,127.0,6,1224,18018808.0,204.0,204.0
304077.0,6,6,412,4,272,101359.0,74.0,68.0,2,140,0.0,74.0,70.0
318.0,17,2,174,1,79,0.0,79.0,79.0,1,95,0.0,95.0,95.0
5008017.0,17,4,534,2,166,0.0,83.0,83.0,2,368,0.0,184.0,184.0
147517.0,6,3,373,2,238,0.0,172.0,119.0,1,135,0.0,135.0,135.0
119760040.0,17,35,16705,35,16705,3522354.117647059,501.0,477.2857142857143,0,0,0.0,0.0,0.0
390994.0,17,2,363,1,75,0.0,75.0,75.0,1,288,0.0,288.0,288.0
217154.0,17,2,180,1,90,0.0,90.0,90.0,1,90,0.0,90.0,90.0
353901.0,6,3,1604,2,851,0.0,785.0,425.5,1,753,0.0,753.0,753.0
37297.0,6,14,4740,7,653,5629.833333333333,249.0,93.28571428571428,7,4087,5748.0,1514.0,583.8571428571429
39600.0,6,2,145,2,145,0.0,91.0,72.5,0,0,0.0,0.0,0.0
301839.0,6,6,412,4,272,100613.0,74.0,68.0,2,140,0.0,74.0,70.0
107831.0,17,2,286,2,286,0.0,143.0,143.0,0,0,0.0,0.0,0.0
1176489.0,6,13,3010,8,2382,168069.85714285713,1514.0,297.75,5,628,225207.25,331.0,125.6
40025.0,6,14,4740,7,653,6299.166666666667,249.0,93.28571428571428,7,4087,6021.666666666667,1514.0,583.8571428571429
2418.0,17,2,762,2,762,0.0,381.0,381.0,0,0,0.0,0.0,0.0
32229.0,6,14,4740,7,653,5259.5,249.0,93.28571428571428,7,4087,4866.5,1514.0,583.8571428571429
19558.0,6,14,4740,7,653,2933.5,249.0,93.28571428571428,7,4087,2896.333333333333,1514.0,583.8571428571429
4616.0,17,2,614,1,72,0.0,72.0,72.0,1,542,0.0,542.0,542.0
135126734.0,17,6,1206,6,1206,27025346.8,201.0,201.0,0,0,0.0,0.0,0.0
307.0,17,2,174,1,79,0.0,79.0,79.0,1,95,0.0,95.0,95.0
90257714.0,6,12,1832,8,1016,12893959.142857144,188.0,127.0,4,816,30031528.666666668,204.0,204.0
67874.0,6,10,2032,5,524,16731.5,252.0,104.8,5,1508,16628.5,1236.0,301.6
48817.0,6,14,4740,7,653,8011.166666666667,249.0,93.28571428571428,7,4087,7139.5,1514.0,583.8571428571429
37665.0,6,14,4740,7,653,5986.333333333333,249.0,93.28571428571428,7,4087,6052.833333333333,1514.0,583.8571428571429
114413575.0,6,48,3168,24,1584,4974503.260869565,66.0,66.0,24,1584,4960833.652173913,66.0,66.0
90257222.0,6,13,2036,8,1016,12893888.857142856,188.0,127.0,5,1020,22522672.0,204.0,204.0
17490.0,6,14,4740,7,653,2625.833333333333,249.0,93.28571428571428,7,4087,2625.833333333333,1514.0,583.8571428571429
377774.0,17,2,363,1,75,0.0,75.0,75.0,1,288,0.0,288.0,288.0
2449.0,17,4,344,2,150,0.0,75.0,75.0,2,194,0.0,103.0,97.0
267056.0,6,10,1221,6,636,53411.2,298.0,106.0,4,585,80930.0,379.0,146.25
120006144.0,6,16,1192,8,596,17143734.85714286,95.0,74.5,8,596,17106599.85714286,95.0,74.5
377290.0,6,12,1373,7,714,62881.66666666666,298.0,102.0,5,659,93373.25,379.0,131.8
41813.0,6,14,4740,7,653,6471.333333333333,249.0,93.28571428571428,7,4087,6611.333333333333,1514.0,583.8571428571429
1315961.0,6,4,264,2,132,0.0,66.0,66.0,2,132,0.0,66.0,66.0
217449.0,6,3,426,2,280,0.0,214.0,140.0,1,146,0.0,146.0,146.0
60805.0,6,14,4740,7,653,9860.166666666666,249.0,93.28571428571428,7,4087,9900.0,1514.0,583.8571428571429
210299.0,6,3,426,2,280,0.0,214.0,140.0,1,146,0.0,146.0,146.0
3716.0,17,6,1230,3,234,1478.5,78.0,78.0,3,996,1652.5,332.0,332.0
17355.0,6,10,2032,5,524,4125.0,252.0,104.8,5,1508,3980.0,1236.0,301.6
228189.0,17,2,180,1,90,0.0,90.0,90.0,1,90,0.0,90.0,90.0
550022.0,6,14,4105,8,540,78574.57142857143,150.0,67.5,6,3565,63228.0,1514.0,594.1666666666666
137518.0,6,2,132,1,66,0.0,66.0,66.0,1,66,0.0,66.0,66.0
20988.0,6,10,2032,5,524,4812.5,252.0,104.8,5,1508,4992.0,1236.0,301.6
44706.0,6,14,4740,7,653,7328.166666666667,249.0,93.28571428571428,7,4087,7094.5,1514.0,583.8571428571429
284456.0,17,2,363,1,79,0.0,79.0,79.0,1,284,0.0,284.0,284.0
1099163.0,6,13,1386,7,789,183193.8333333333,253.0,112.71428571428572,6,597,219043.8,259.0,99.5
324125.0,17,4,1400,4,1400,108041.66666666669,350.0,350.0,0,0,0.0,0.0,0.0
120004125.0,6,17,1246,9,650,15000515.625,95.0,72.22222222222223,8,596,17106795.57142857,95.0,74.5
248214.0,17,4,6056,4,6056,82738.0,1514.0,1514.0,0,0,0.0,0.0,0.0
321950.0,17,4,1400,4,1400,107316.66666666669,350.0,350.0,0,0,0.0,0.0,0.0
206863.0,6,3,426,2,280,0.0,214.0,140.0,1,146,0.0,146.0,146.0
50628.0,6,14,4740,7,653,8277.5,249.0,93.28571428571428,7,4087,6375.666666666667,1514.0,583.8571428571429
2418.0,17,4,344,2,150,0.0,75.0,75.0,2,194,0.0,103.0,97.0
29743.0,6,14,4740,7,653,4240.5,249.0,93.28571428571428,7,4087,4524.833333333333,1514.0,583.8571428571429
114263434.0,6,48,3168,24,1584,4967975.391304348,66.0,66.0,24,1584,4954515.521739131,66.0,66.0
90012834.0,17,28,13364,28,13364,3333808.6666666665,501.0,477.2857142857143,0,0,0.0,0.0,0.0
2388.0,17,4,344,2,150,0.0,75.0,75.0,2,194,0.0,103.0,97.0
5610073.0,6,5,336,2,134,0.0,68.0,67.0,3,202,1423577.5,70.0,67.33333333333333
33824.0,6,10,2032,5,524,7920.5,252.0,104.8,5,1508,8033.75,1236.0,301.6
96273931.0,17,14,1126,7,563,16000152.166666666,174.0,80.42857142857143,7,563,16000672.833333334,174.0,80.42857142857143
36736.0,6,14,4740,7,653,5852.666666666667,249.0,93.28571428571428,7,4087,5413.0,1514.0,583.8571428571429
46961.0,6,14,4740,7,653,7254.0,249.0,93.28571428571428,7,4087,6882.166666666667,1514.0,583.8571428571429
148050.0,17,2,180,1,90,0.0,90.0,90.0,1,90,0.0,90.0,90.0
108108256.0,17,5,955,5,955,27027064.0,191.0,191.0,0,0,0.0,0.0,0.0
2307.0,17,4,344,2,150,0.0,75.0,75.0,2,194,0.0,103.0,97.0
18840.0,17,2,447,1,84,0.0,84.0,84.0,1,363,0.0,363.0,363.0
104088.0,17,2,286,2,286,0.0,143.0,143.0,0,0,0.0,0.0,0.0
26725.0,6,14,4740,7,653,3923.0,249.0,93.28571428571428,7,4087,4317.166666666667,1514.0,583.8571428571429
1305223.0,6,4,264,2,132,0.0,66.0,66.0,2,132,0.0,66.0,66.0
153463.0,17,2,180,1,90,0.0,90.0,90.0,1,90,0.0,90.0,90.0
14327.0,17,2,180,1,90,0.0,90.0,90.0,1,90,0.0,90.0,90.0
4205.0,17,2,598,1,72,0.0,72.0,72.0,1,526,0.0,526.0,526.0
335824.0,6,6,412,4,272,111941.33333333331,74.0,68.0,2,140,0.0,74.0,70.0
41433.0,6,14,4740,7,653,6726.333333333333,249.0,93.28571428571428,7,4087,5808.5,1514.0,583.8571428571429
90253805.0,6,12,1832,8,1016,12893400.714285716,188.0,127.0,4,816,30026017.666666668,204.0,204.0
143964.0,17,2,180,1,90,0.0,90.0,90.0,1,90,0.0,90.0,90.0
90427820.0,6,57,5416,35,3124,2659641.7647058824,139.0,89.25714285714285,22,2292,4295786.666666667,123.0,104.1818181818182
90528325.0,6,13,2036,8,1016,12932617.857142856,188.0,127.0,5,1020,22590857.0,204.0,204.0
39778.0,6,14,4740,7,653,6408.5,249.0,93.28571428571428,7,4087,6475.166666666667,1514.0,583.8571428571429
372.0,17,2,160,1,80,0.0,80.0,80.0,1,80,0.0,80.0,80.0
147920.0,17,2,180,1,90,0.0,90.0,90.0,1,90,0.0,90.0,90.0
2798496.0,6,2,132,1,66,0.0,66.0,66.0,1,66,0.0,66.0,66.0
112109020.0,6,32,2236,16,1165,7473934.666666667,139.0,72.8125,16,1071,7459554.333333333,123.0,66.9375
2310.0,17,4,344,2,150,0.0,75.0,75.0,2,194,0.0,103.0,97.0
55864.0,17,2,239,1,82,0.0,82.0,82.0,1,157,0.0,157.0,157.0
90531283.0,6,17,2572,9,1204,11316410.375,188.0,133.77777777777777,8,1368,12909526.57142857,204.0,171.0
108116515.0,17,5,1005,5,1005,27029128.75,201.0,201.0,0,0,0.0,0.0,0.0
13767.0,17,2,180,1,90,0.0,90.0,90.0,1,90,0.0,90.0,90.0
272644.0,6,3,337,2,214,0.0,160.0,107.0,1,123,0.0,123.0,123.0
4501.0,17,2,626,1,72,0.0,72.0,72.0,1,554,0.0,554.0,554.0
115846713.0,6,35,2658,18,1395,6814512.529411765,123.0,77.5,17,1263,7226911.375,123.0,74.29411764705883
216841.0,6,3,426,2,280,0.0,214.0,140.0,1,146,0.0,146.0,146.0
122292163.0,6,38,2848,20,1531,6436429.631578947,139.0,76.55,18,1317,6593519.352941177,123.0,73.16666666666667
5623683.0,6,4,270,2,134,0.0,68.0,67.0,2,136,0.0,70.0,68.0
2301.0,17,4,344,2,150,0.0,75.0,75.0,2,194,0.0,103.0,97.0
136216.0,6,3,337,2,214,0.0,160.0,107.0,1,123,0.0,123.0,123.0
281798.0,6,12,1373,7,714,46966.333333333336,298.0,102.0,5,659,66324.0,379.0,131.8
120013505.0,6,33,2290,17,1125,7500844.0625,123.0,66.17647058823529,16,1165,7941575.266666667,139.0,72.8125
133544.0,6,12,1328,7,797,22257.33333333333,253.0,113.85714285714286,5,531,27270.25,259.0,106.2
41421.0,6,10,2032,5,524,9727.0,252.0,104.8,5,1508,6680.75,1236.0,301.6
252407.0,6,10,1221,6,636,50481.4,298.0,106.0,4,585,78593.66666666667,379.0,146.25
233279.0,6,3,373,2,238,0.0,172.0,119.0,1,135,0.0,135.0,135.0
34460.0,6,14,4740,7,653,5606.666666666667,249.0,93.28571428571428,7,4087,5449.166666666667,1514.0,583.8571428571429
146077.0,6,3,337,2,214,0.0,160.0,107.0,1,123,0.0,123.0,123.0
205987.0,17,2,180,1,90,0.0,90.0,90.0,1,90,0.0,90.0,90.0
2844457.0,6,3,204,2,136,0.0,70.0,68.0,1,68,0.0,68.0,68.0
36961.0,6,14,4740,7,653,5629.0,249.0,93.28571428571428,7,4087,5808.833333333333,1514.0,583.8571428571429
32781.0,6,14,4740,7,653,5307.333333333333,249.0,93.28571428571428,7,4087,5281.833333333333,1514.0,583.8571428571429
11418.0,6,11,2098,6,590,2081.4,252.0,98.33333333333331,5,1508,2600.0,1236.0,301.6
300396.0,6,6,412,4,272,100132.0,74.0,68.0,2,140,0.0,74.0,70.0
108105292.0,17,5,955,5,955,27026323.0,191.0,191.0,0,0,0.0,0.0,0.0
90035584.0,17,27,12943,27,12943,3462907.076923077,501.0,479.3703703703704,0,0,0.0,0.0,0.0
135136763.0,17,6,1206,6,1206,27027352.6,201.0,201.0,0,0,0.0,0.0,0.0
206372.0,6,3,426,2,280,0.0,214.0,140.0,1,146,0.0,146.0,146.0
98073.0,17,2,762,2,762,0.0,381.0,381.0,0,0,0.0,0.0,0.0
2285.0,17,4,344,2,150,0.0,75.0,75.0,2,194,0.0,103.0,97.0
7348.0,17,2,582,1,83,0.0,83.0,83.0,1,499,0.0,499.0,499.0
120099333.0,6,216,24296,108,7424,1114763.598130841,140.0,68.74074074074075,108,16872,1114799.4485981308,284.0,156.22222222222223
207285.0,6,4,492,2,280,0.0,214.0,140.0,2,212,0.0,146.0,106.0
119435036.0,6,48,3168,24,1584,5192827.652173913,66.0,66.0,24,1584,5179442.0,66.0,66.0
146376.0,6,3,337,2,214,0.0,160.0,107.0,1,123,0.0,123.0,123.0
1709901.0,6,19,7533,10,1403,189989.0,583.0,140.3,9,6130,181639.75,1484.0,681.1111111111111
5625402.0,6,5,336,2,134,0.0,68.0,67.0,3,202,1524370.0,70.0,67.33333333333333
2021.0,17,4,344,2,150,0.0,75.0,75.0,2,194,0.0,103.0,97.0
143983.0,17,2,180,1,90,0.0,90.0,90.0,1,90,0.0,90.0,90.0
318312.0,6,6,412,4,272,106104.0,74.0,68.0,2,140,0.0,74.0,70.0
95208363.0,17,12,1040,6,520,19009485.8,174.0,86.66666666666667,6,520,19009473.2,174.0,86.66666666666667
108133038.0,17,5,1005,5,1005,27033259.5,201.0,201.0,0,0,0.0,0.0,0.0
53239.0,6,14,4740,7,653,8162.0,249.0,93.28571428571428,7,4087,8414.5,1514.0,583.8571428571429
108932980.0,6,318,37022,159,26306,688086.9240506329,284.0,165.44654088050314,159,10716,688086.5759493671,140.0,67.39622641509433
118910324.0,6,37,2656,19,1408,6594145.166666667,139.0,74.10526315789474,18,1248,6982037.294117647,123.0,69.33333333333333
8100.0,6,11,2041,6,533,1323.6,195.0,88.83333333333333,5,1508,1790.75,1236.0,301.6
33374.0,6,14,4740,7,653,4918.833333333333,249.0,93.28571428571428,7,4087,4898.5,1514.0,583.8571428571429
120112774.0,6,13,2036,5,1020,30028193.5,204.0,204.0,8,1016,17135434.57142857,188.0,127.0
92801.0,6,14,4740,7,653,13590.5,249.0,93.28571428571428,7,4087,14488.666666666666,1514.0,583.8571428571429
1303519.0,6,4,264,2,132,0.0,66.0,66.0,2,132,0.0,66.0,66.0
501134.0,6,5,336,2,134,0.0,68.0,67.0,3,202,190583.5,70.0,67.33333333333333
146215.0,6,3,337,2,214,0.0,160.0,107.0,1,123,0.0,123.0,123.0
11275.0,6,11,2098,6,590,2080.0,252.0,98.33333333333331,5,1508,2583.25,1236.0,301.6
103347013.0,6,43,2838,22,1452,4921274.333333333,66.0,66.0,21,1386,5143993.5,66.0,66.0
2581176.0,6,25,7573,14,3735,198552.0,1514.0,266.7857142857143,11,3838,231714.7,1514.0,348.90909090909093
205900.0,17,2,762,2,762,0.0,381.0,381.0,0,0,0.0,0.0,0.0
237032.0,17,2,180,1,90,0.0,90.0,90.0,1,90,0.0,90.0,90.0
121122609.0,6,240,27120,120,8142,1002329.5210084034,140.0,67.85,120,18978,1011837.386554622,284.0,158.15
311372.0,17,4,1400,4,1400,103790.66666666669,350.0,350.0,0,0,0.0,0.0,0.0
59281.0,6,14,4740,7,653,9594.0,249.0,93.28571428571428,7,4087,8941.0,1514.0,583.8571428571429
2413.0,17,4,344,2,150,0.0,75.0,75.0,2,194,0.0,103.0,97.0
272179.0,17,4,1400,4,1400,90726.33333333331,350.0,350.0,0,0,0.0,0.0,0.0
272627.0,6,10,1221,6,636,54525.4,298.0,106.0,4,585,82318.66666666667,379.0,146.25
135126357.0,17,6,1146,6,1146,27025271.4,191.0,191.0,0,0,0.0,0.0,0.0
308469.0,6,6,412,4,272,102823.0,74.0,68.0,2,140,0.0,74.0,70.0
2286416.0,6,49,23728,25,19797,95267.33333333331,1514.0,791.88,24,3931,89742.73913043478,1514.0,163.79166666666666
34391.0,6,14,4740,7,653,4967.5,249.0,93.28571428571428,7,4087,4604.166666666667,1514.0,583.8571428571429
135127550.0,17,6,1206,6,1206,27025510.0,201.0,201.0,0,0,0.0,0.0,0.0
41409.0,6,14,4740,7,653,6745.166666666667,249.0,93.28571428571428,7,4087,6087.666666666667,1514.0,583.8571428571429
121911.0,6,3,337,2,214,0.0,160.0,107.0,1,123,0.0,123.0,123.0
27216574.0,17,5,1718,4,1368,1714181.3333333333,342.0,342.0,1,350,0.0,350.0,350.0
27120.0,6,14,4740,7,653,4322.833333333333,249.0,93.28571428571428,7,4087,4146.833333333333,1514.0,583.8571428571429
9133.0,17,2,582,1,83,0.0,83.0,83.0,1,499,0.0,499.0,499.0
131844.0,6,3,337,2,214,0.0,160.0,107.0,1,123,0.0,123.0,123.0
40212.0,6,14,4740,7,653,6482.166666666667,249.0,93.28571428571428,7,4087,6560.833333333333,1514.0,583.8571428571429
2257.0,17,4,344,2,150,0.0,75.0,75.0,2,194,0.0,103.0,97.0
58302.0,6,14,4740,7,653,9536.333333333334,249.0,93.28571428571428,7,4087,9220.666666666666,1514.0,583.8571428571429
38431.0,6,14,4740,7,653,6239.166666666667,249.0,93.28571428571428,7,4087,5878.333333333333,1514.0,583.8571428571429
209529.0,17,2,180,1,90,0.0,90.0,90.0,1,90,0.0,90.0,90.0
128866914.0,6,36,2602,19,1408,7159273.0,139.0,74.10526315789474,17,1194,7417268.0625,123.0,70.23529411764706
311541.0,17,4,1400,4,1400,103847.0,350.0,350.0,0,0,0.0,0.0,0.0
209159.0,6,12,1373,7,714,34859.833333333336,298.0,102.0,5,659,51456.5,379.0,131.8
217623.0,6,3,426,2,280,0.0,214.0,140.0,1,146,0.0,146.0,146.0
155397.0,6,3,337,2,214,0.0,160.0,107.0,1,123,0.0,123.0,123.0
302429.0,6,2,132,1,66,0.0,66.0,66.0,1,66,0.0,66.0,66.0
194993.0,17,4,820,2,156,0.0,78.0,78.0,2,664,0.0,332.0,332.0
107355.0,17,2,286,2,286,0.0,143.0,143.0,0,0,0.0,0.0,0.0
144050.0,17,2,180,1,90,0.0,90.0,90.0,1,90,0.0,90.0,90.0
65930.0,6,10,2032,5,524,16201.5,252.0,104.8,5,1508,15336.25,1236.0,301.6
321838.0,17,4,1400,4,1400,107279.33333333331,350.0,350.0,0,0,0.0,0.0,0.0
220052.0,6,3,426,2,280,0.0,214.0,140.0,1,146,0.0,146.0,146.0
90052584.0,17,28,13364,28,13364,3335280.888888889,501.0,477.2857142857143,0,0,0.0,0.0,0.0
300793.0,6,10,1221,6,636,60158.6,298.0,106.0,4,585,94775.33333333331,379.0,146.25
1250643.0,6,13,3000,8,2372,178663.2857142857,1514.0,296.5,5,628,243712.25,331.0,125.6
289356.0,6,10,1221,6,636,57871.2,298.0,106.0,4,585,90635.33333333331,379.0,146.25
1553080.0,6,2,132,1,66,0.0,66.0,66.0,1,66,0.0,66.0,66.0
10867.0,6,11,1132,6,556,2032.2,218.0,92.66666666666669,5,576,2479.5,304.0,115.2
43963.0,6,10,2032,5,524,10741.0,252.0,104.8,5,1508,10413.5,1236.0,301.6
108111891.0,17,5,1005,5,1005,27027972.75,201.0,201.0,0,0,0.0,0.0,0.0
90228555.0,6,22,1680,10,786,9997954.333333334,95.0,78.6,12,894,8182966.090909091,95.0,74.5
309508.0,17,4,704,2,148,0.0,74.0,74.0,2,556,0.0,280.0,278.0
1303097.0,6,4,264,2,132,0.0,66.0,66.0,2,132,0.0,66.0,66.0
216444.0,17,2,180,1,90,0.0,90.0,90.0,1,90,0.0,90.0,90.0
12257.0,6,14,4740,7,653,1931.5,249.0,93.28571428571428,7,4087,1906.3333333333333,1514.0,583.8571428571429
237984.0,6,3,337,2,214,0.0,160.0,107.0,1,123,0.0,123.0,123.0
107843925.0,6,28,1860,14,966,8279095.846153846,123.0,69.0,14,894,8279095.923076923,123.0,63.85714285714285
108107396.0,17,5,1005,5,1005,27026849.0,201.0,201.0,0,0,0.0,0.0,0.0
101976.0,17,2,286,2,286,0.0,143.0,143.0,0,0,0.0,0.0,0.0
102235.0,17,2,762,2,762,0.0,381.0,381.0,0,0,0.0,0.0,0.0
123455783.0,6,48,3168,24,1584,4933953.869565218,66.0,66.0,24,1584,5333874.782608695,66.0,66.0
850300.0,6,9,1096,6,625,170060.0,287.0,104.16666666666669,3,471,287325.0,331.0,157.0
26076.0,6,14,4740,7,653,4216.833333333333,249.0,93.28571428571428,7,4087,4208.666666666667,1514.0,583.8571428571429
1958.0,17,4,344,2,150,0.0,75.0,75.0,2,194,0.0,103.0,97.0
4588.0,17,2,614,1,72,0.0,72.0,72.0,1,542,0.0,542.0,542.0
196910.0,17,2,180,1,90,0.0,90.0,90.0,1,90,0.0,90.0,90.0
20098.0,6,10,2032,5,524,4793.75,252.0,104.8,5,1508,4767.75,1236.0,301.6
102310.0,17,2,286,2,286,0.0,143.0,143.0,0,0,0.0,0.0,0.0
4294.0,17,2,614,1,72,0.0,72.0,72.0,1,542,0.0,542.0,542.0
44592.0,6,12,1320,7,789,7432.0,253.0,112.71428571428572,5,531,10199.0,259.0,106.2
199569.0,17,4,6056,4,6056,66523.0,1514.0,1514.0,0,0,0.0,0.0,0.0
0.0,6,1,66,1,66,0.0,66.0,66.0,0,0,0.0,0.0,0.0
44090.0,6,11,2098,6,590,8566.2,252.0,98.33333333333331,5,1508,9562.5,1236.0,301.6
120067488.0,6,232,26306,116,7878,1037607.2608695652,140.0,67.91379310344827,116,18428,1029003.8434782608,374.0,158.86206896551724
122975069.0,6,48,3168,24,1584,5024549.695652174,66.0,66.0,24,1584,5242535.782608695,66.0,66.0
242204.0,6,3,373,2,238,0.0,172.0,119.0,1,135,0.0,135.0,135.0
242739.0,6,3,337,2,214,0.0,160.0,107.0,1,123,0.0,123.0,123.0
420730.0,6,3,204,2,136,0.0,70.0,68.0,1,68,0.0,68.0,68.0
230820.0,17,2,180,1,90,0.0,90.0,90.0,1,90,0.0,90.0,90.0
120236725.0,6,234,26294,117,8018,1029421.974137931,140.0,68.52991452991454,117,18276,1029488.75,284.0,156.2051282051282
1048.0,17,4,438,2,148,0.0,74.0,74.0,2,290,0.0,147.0,145.0
191254.0,17,2,180,1,90,0.0,90.0,90.0,1,90,0.0,90.0,90.0
208558.0,6,3,426,2,280,0.0,214.0,140.0,1,146,0.0,146.0,146.0
106499.0,17,2,286,2,286,0.0,143.0,143.0,0,0,0.0,0.0,0.0
135133001.0,17,6,1146,6,1146,27026600.2,191.0,191.0,0,0,0.0,0.0,0.0
146235.0,6,3,337,2,214,0.0,160.0,107.0,1,123,0.0,123.0,123.0
90028444.0,17,28,13364,28,13364,3334386.814814815,501.0,477.2857142857143,0,0,0.0,0.0,0.0
103470.0,17,2,286,2,286,0.0,143.0,143.0,0,0,0.0,0.0,0.0
148672.0,17,2,414,1,88,0.0,88.0,88.0,1,326,0.0,326.0,326.0
50731.0,6,14,4740,7,653,8291.5,249.0,93.28571428571428,7,4087,7573.333333333333,1514.0,583.8571428571429
120103630.0,6,13,2036,5,1020,30025907.5,204.0,204.0,8,1016,17133574.85714286,188.0,127.0
328.0,17,2,166,1,75,0.0,75.0,75.0,1,91,0.0,91.0,91.0
229824.0,6,13,1394,7,797,38304.0,253.0,113.85714285714286,6,597,44126.8,259.0,99.5
90215007.0,6,16,1192,8,596,12853256.142857144,95.0,74.5,8,596,12858612.142857144,95.0,74.5
37390.0,6,14,4740,7,653,5993.5,249.0,93.28571428571428,7,4087,6062.0,1514.0,583.8571428571429
0.0,6,1,66,1,66,0.0,66.0,66.0,0,0,0.0,0.0,0.0
135141208.0,17,6,1206,6,1206,27028241.6,201.0,201.0,0,0,0.0,0.0,0.0
311010.0,6,6,412,4,272,103670.0,74.0,68.0,2,140,0.0,74.0,70.0
121281.0,6,3,337,2,214,0.0,160.0,107.0,1,123,0.0,123.0,123.0
2096240.0,6,23,7479,12,2450,190567.2727272728,1034.0,204.16666666666663,11,5029,179113.4,1510.0,457.1818181818182
321146.0,17,4,1400,4,1400,107048.66666666669,350.0,350.0,0,0,0.0,0.0,0.0
114539.0,17,4,1400,4,1400,38179.66666666666,350.0,350.0,0,0,0.0,0.0,0.0
2017.0,17,4,344,2,150,0.0,75.0,75.0,2,194,0.0,103.0,97.0
215907.0,6,10,1221,6,636,43181.4,298.0,106.0,4,585,70460.0,379.0,146.25
138534.0,6,2,132,1,66,0.0,66.0,66.0,1,66,0.0,66.0,66.0
95111342.0,6,39,2574,20,1320,4989323.052631579,66.0,66.0,19,1254,5155458.611111111,66.0,66.0
120223161.0,6,262,30138,131,8942,919265.4307692308,140.0,68.25954198473282,131,21196,918782.1923076924,284.0,161.80152671755727
503474.0,6,5,336,2,134,0.0,68.0,67.0,3,202,193415.5,70.0,67.33333333333333
135130251.0,17,6,1146,6,1146,27026050.2,191.0,191.0,0,0,0.0,0.0,0.0
90037640.0,17,28,13364,28,13364,3334727.407407407,501.0,477.2857142857143,0,0,0.0,0.0,0.0
207450.0,6,3,426,2,280,0.0,214.0,140.0,1,146,0.0,146.0,146.0
152006.0,17,2,414,1,88,0.0,88.0,88.0,1,326,0.0,326.0,326.0
3202624.0,6,18,1495,9,921,361387.125,315.0,102.33333333333331,9,574,361368.875,78.0,63.77777777777778
2457.0,17,4,344,2,150,0.0,75.0,75.0,2,194,0.0,103.0,97.0
374.0,17,2,267,1,83,0.0,83.0,83.0,1,184,0.0,184.0,184.0
219138.0,17,2,180,1,90,0.0,90.0,90.0,1,90,0.0,90.0,90.0
1017456.0,6,12,1354,6,723,200935.2,253.0,120.5,6,631,203066.4,293.0,105.16666666666669
206855.0,17,2,180,1,90,0.0,90.0,90.0,1,90,0.0,90.0,90.0
158657.0,6,3,337,2,214,0.0,160.0,107.0,1,123,0.0,123.0,123.0
363818.0,6,11,1021,6,444,49843.6,162.0,74.0,5,577,61076.75,349.0,115.4
90398342.0,6,28,1992,14,963,6953718.615384615,123.0,68.78571428571429,14,1029,6168895.384615385,123.0,73.5
135128237.0,17,6,1146,6,1146,27025647.4,191.0,191.0,0,0,0.0,0.0,0.0
130213.0,6,3,337,2,214,0.0,160.0,107.0,1,123,0.0,123.0,123.0
90047703.0,17,28,13364,28,13364,3335100.111111111,501.0,477.2857142857143,0,0,0.0,0.0,0.0
81.0,17,2,762,2,762,0.0,381.0,381.0,0,0,0.0,0.0,0.0
90300861.0,6,16,1192,8,596,12893498.57142857,95.0,74.5,8,596,12899747.57142857,95.0,74.5
29704082.0,6,27,9531,15,2100,2121720.1428571427,408.0,140.0,12,7431,2338740.1818181816,1514.0,619.25
5005499.0,17,4,849,2,166,0.0,83.0,83.0,2,683,0.0,499.0,341.5
307795.0,17,4,1400,4,1400,102598.33333333331,350.0,350.0,0,0,0.0,0.0,0.0
2041.0,17,4,344,2,150,0.0,75.0,75.0,2,194,0.0,103.0,97.0
71504.0,17,2,762,2,762,0.0,381.0,381.0,0,0,0.0,0.0,0.0
322.0,17,2,174,1,79,0.0,79.0,79.0,1,95,0.0,95.0,95.0
208181.0,6,3,426,2,280,0.0,214.0,140.0,1,146,0.0,146.0,146.0
91901836.0,6,24,1829,13,989,7657507.583333333,95.0,76.07692307692308,11,840,9189876.5,95.0,76.36363636363636
300029.0,6,6,412,4,272,100009.66666666669,74.0,68.0,2,140,0.0,74.0,70.0
153441.0,17,2,180,1,90,0.0,90.0,90.0,1,90,0.0,90.0,90.0
120299379.0,17,14,864,7,432,16835813.166666668,174.0,61.71428571428572,7,432,16833546.666666668,174.0,61.71428571428572
23582794.0,6,24,8690,13,1719,1965232.8333333333,408.0,132.23076923076923,11,6971,1946230.1,1514.0,633.7272727272727
301811.0,6,6,412,4,272,100603.66666666669,74.0,68.0,2,140,0.0,74.0,70.0
123457216.0,6,49,3234,25,1650,5144050.666666667,66.0,66.0,24,1584,4931394.0869565215,66.0,66.0
1030891.0,6,11,1134,6,558,206178.2,220.0,93.0,5,576,256356.5,304.0,115.2
106547.0,6,14,4740,7,653,16154.666666666666,249.0,93.28571428571428,7,4087,17072.833333333332,1514.0,583.8571428571429
90050627.0,17,28,13364,28,13364,3335208.407407407,501.0,477.2857142857143,0,0,0.0,0.0,0.0
1314913.0,6,4,264,2,132,0.0,66.0,66.0,2,132,0.0,66.0,66.0
62121.0,6,10,2032,5,524,15103.5,252.0,104.8,5,1508,15248.0,1236.0,301.6
0.0,6,1,172,1,172,0.0,172.0,172.0,0,0,0.0,0.0,0.0
118409995.0,6,48,3168,24,1584,5148260.652173913,66.0,66.0,24,1584,5135212.956521739,66.0,66.0
6609.0,17,4,823,2,163,0.0,89.0,81.5,2,660,0.0,443.0,330.0
330861.0,6,6,412,4,272,110287.0,74.0,68.0,2,140,0.0,74.0,70.0
35665.0,6,14,4740,7,653,5375.333333333333,249.0,93.28571428571428,7,4087,5283.0,1514.0,583.8571428571429
109979242.0,6,214,24164,107,7358,1029657.7358490566,140.0,68.76635514018692,107,16806,1029763.5943396228,284.0,157.06542056074767
281360.0,17,2,363,1,79,0.0,79.0,79.0,1,284,0.0,284.0,284.0
90258451.0,6,13,2036,8,1016,12894064.42857143,188.0,127.0,5,1020,22523499.75,204.0,204.0
539921.0,17,6,2100,6,2100,107984.2,350.0,350.0,0,0,0.0,0.0,0.0
1026356.0,6,11,1134,6,558,205271.2,220.0,93.0,5,576,255243.75,304.0,115.2
142964.0,17,4,704,2,148,0.0,74.0,74.0,2,556,0.0,280.0,278.0
834055.0,6,9,1118,6,586,166811.0,248.0,97.66666666666669,3,532,280743.5,392.0,177.33333333333334
53192.0,6,14,4740,7,653,8167.0,249.0,93.28571428571428,7,4087,8221.0,1514.0,583.8571428571429
38918.0,6,14,4740,7,653,6321.5,249.0,93.28571428571428,7,4087,6349.333333333333,1514.0,583.8571428571429
3685325.0,6,20,6935,11,1567,368532.5,408.0,142.45454545454547,9,5368,403382.75,1514.0,596.4444444444445
317548.0,17,4,1400,4,1400,105849.33333333331,350.0,350.0,0,0,0.0,0.0,0.0
53000.0,6,14,4740,7,653,8094.5,249.0,93.28571428571428,7,4087,6713.333333333333,1514.0,583.8571428571429
247107.0,6,3,373,2,238,0.0,172.0,119.0,1,135,0.0,135.0,135.0
209629.0,17,2,180,1,90,0.0,90.0,90.0,1,90,0.0,90.0,90.0
36609.0,6,14,4740,7,653,5940.0,249.0,93.28571428571428,7,4087,5464.5,1514.0,583.8571428571429
135136753.0,17,6,1146,6,1146,27027350.6,191.0,191.0,0,0,0.0,0.0,0.0
913.0,17,4,438,2,148,0.0,74.0,74.0,2,290,0.0,147.0,145.0
38337.0,6,14,4740,7,653,5735.333333333333,249.0,93.28571428571428,7,4087,6157.666666666667,1514.0,583.8571428571429
105262601.0,17,14,864,7,432,17500165.166666668,174.0,61.71428571428572,7,432,17500740.166666668,174.0,61.71428571428572
1059670.0,6,3,204,1,68,0.0,68.0,68.0,2,136,0.0,70.0,68.0
331801.0,6,6,412,4,272,110600.33333333331,74.0,68.0,2,140,0.0,74.0,70.0
118251068.0,6,37,2926,17,1332,7390691.75,123.0,78.3529411764706,20,1594,5686836.105263158,139.0,79.7
120015524.0,17,29,13785,29,13785,4286268.714285715,501.0,475.3448275862069,0,0,0.0,0.0,0.0
202514.0,17,2,762,2,762,0.0,381.0,381.0,0,0,0.0,0.0,0.0
135131400.0,17,6,1146,6,1146,27026280.0,191.0,191.0,0,0,0.0,0.0,0.0
160855.0,17,4,1400,4,1400,53618.333333333336,350.0,350.0,0,0,0.0,0.0,0.0
101957113.0,6,187,21154,94,14794,1096313.0430107526,284.0,157.38297872340425,93,6360,1096765.9456521738,140.0,68.38709677419355
299430.0,6,6,412,4,272,99810.0,74.0,68.0,2,140,0.0,74.0,70.0
22566.0,6,10,1810,5,358,5096.75,130.0,71.6,5,1452,5069.25,1224.0,290.4
30723.0,6,14,4740,7,653,4783.833333333333,249.0,93.28571428571428,7,4087,4934.0,1514.0,583.8571428571429
209546.0,17,2,180,1,90,0.0,90.0,90.0,1,90,0.0,90.0,90.0
206049.0,6,3,426,2,280,0.0,214.0,140.0,1,146,0.0,146.0,146.0
953242.0,17,2,346,1,78,0.0,78.0,78.0,1,268,0.0,268.0,268.0
354.0,17,2,156,1,78,0.0,78.0,78.0,1,78,0.0,78.0,78.0
1317013.0,6,4,264,2,132,0.0,66.0,66.0,2,132,0.0,66.0,66.0
90057320.0,17,28,13364,28,13364,3335456.296296296,501.0,477.2857142857143,0,0,0.0,0.0,0.0
136903227.0,17,19,1865,9,911,14622131.875,174.0,101.22222222222224,10,954,15193723.111111112,174.0,95.4
876973.0,6,12,2711,7,743,146162.16666666666,339.0,106.14285714285714,5,1968,150443.75,1514.0,393.6
191071.0,17,2,180,1,90,0.0,90.0,90.0,1,90,0.0,90.0,90.0
2328.0,17,4,344,2,150,0.0,75.0,75.0,2,194,0.0,103.0,97.0
101972036.0,17,13,821,7,432,16968517.333333332,174.0,61.71428571428572,6,389,16458600.2,174.0,64.83333333333333
45333.0,6,14,4740,7,653,7392.333333333333,249.0,93.28571428571428,7,4087,7254.0,1514.0,583.8571428571429
119577412.0,6,220,24846,110,17290,1095156.4678899082,284.0,157.1818181818182,110,7556,1095164.770642202,140.0,68.69090909090909
135133750.0,17,6,1146,6,1146,27026750.0,191.0,191.0,0,0,0.0,0.0,0.0
784.0,17,5,550,5,550,196.0,110.0,110.0,0,0,0.0,0.0,0.0
51641.0,6,14,4740,7,653,7683.166666666667,249.0,93.28571428571428,7,4087,8302.0,1514.0,583.8571428571429
203408.0,17,2,762,2,762,0.0,381.0,381.0,0,0,0.0,0.0,0.0
216738.0,6,3,426,2,280,0.0,214.0,140.0,1,146,0.0,146.0,146.0
10425618.0,6,6,412,3,206,5144719.5,74.0,68.66666666666667,3,206,5144614.0,74.0,68.66666666666667
43925.0,6,14,4740,7,653,6479.666666666667,249.0,93.28571428571428,7,4087,6365.666666666667,1514.0,583.8571428571429
108111017.0,17,5,955,5,955,27027754.25,191.0,191.0,0,0,0.0,0.0,0.0
100279250.0,6,212,25144,106,17926,952980.3047619048,300.0,169.11320754716982,106,7218,952980.0571428572,140.0,68.09433962264151
16790.0,17,2,180,1,90,0.0,90.0,90.0,1,90,0.0,90.0,90.0
123149395.0,17,15,1300,8,737,17592770.714285713,174.0,92.125,7,563,17457920.333333332,174.0,80.42857142857143
45395.0,6,14,4740,7,653,7242.666666666667,249.0,93.28571428571428,7,4087,5629.666666666667,1514.0,583.8571428571429
43303.0,6,14,4740,7,653,6683.333333333333,249.0,93.28571428571428,7,4087,6849.333333333333,1514.0,583.8571428571429
10538635.0,6,6,412,3,206,5198409.5,74.0,68.66666666666667,3,206,5198299.0,74.0,68.66666666666667
3166.0,17,4,344,2,150,0.0,75.0,75.0,2,194,0.0,103.0,97.0
15511.0,6,10,2032,5,524,3065.25,252.0,104.8,5,1508,3598.5,1236.0,301.6
113613308.0,6,46,3036,23,1518,5150441.409090909,66.0,66.0,23,1518,5150438.181818182,66.0,66.0
217586.0,6,3,426,2,280,0.0,214.0,140.0,1,146,0.0,146.0,146.0
55675.0,6,12,1413,6,816,10923.6,291.0,136.0,6,597,8747.8,259.0,99.5
147945.0,17,2,180,1,90,0.0,90.0,90.0,1,90,0.0,90.0,90.0
297507.0,6,6,412,4,272,99169.0,74.0,68.0,2,140,0.0,74.0,70.0
9453.0,17,2,582,1,83,0.0,83.0,83.0,1,499,0.0,499.0,499.0
128022656.0,6,31,2034,16,1086,8534843.733333332,123.0,67.875,15,948,8415798.357142856,123.0,63.2
90293520.0,6,19,1436,10,745,10027686.555555556,95.0,74.5,9,691,11285601.5,95.0,76.77777777777777
69677.0,17,2,604,1,75,0.0,75.0,75.0,1,529,0.0,529.0,529.0
34590.0,6,14,4740,7,653,5617.833333333333,249.0,93.28571428571428,7,4087,5289.166666666667,1514.0,583.8571428571429
0.0,17,1,350,1,350,0.0,350.0,350.0,0,0,0.0,0.0,0.0
31569.0,6,10,2032,5,524,7598.25,252.0,104.8,5,1508,7600.25,1236.0,301.6
170279.0,17,2,1500,1,994,0.0,994.0,994.0,1,506,0.0,506.0,506.0
99423373.0,17,12,778,6,389,19884674.6,174.0,64.83333333333333,6,389,19835333.0,174.0,64.83333333333333
3011563.0,6,11,2106,6,598,601421.6,252.0,99.66666666666669,5,1508,2529.25,1236.0,301.6
303672.0,6,2,132,1,66,0.0,66.0,66.0,1,66,0.0,66.0,66.0
30157.0,6,14,4740,7,653,4902.333333333333,249.0,93.28571428571428,7,4087,4675.5,1514.0,583.8571428571429
304013.0,6,6,412,4,272,101337.66666666669,74.0,68.0,2,140,0.0,74.0,70.0
94061402.0,6,375,45008,188,32518,503002.14973262034,374.0,172.96808510638297,187,12490,501378.6666666667,140.0,66.79144385026738
356.0,17,2,267,1,83,0.0,83.0,83.0,1,184,0.0,184.0,184.0
34832.0,6,14,4740,7,653,5256.5,249.0,93.28571428571428,7,4087,5657.666666666667,1514.0,583.8571428571429
228545.0,17,2,180,1,90,0.0,90.0,90.0,1,90,0.0,90.0,90.0
1307010.0,6,4,264,2,132,0.0,66.0,66.0,2,132,0.0,66.0,66.0
90029634.0,17,28,13364,28,13364,3334430.888888889,501.0,477.2857142857143,0,0,0.0,0.0,0.0
4168.0,17,4,344,2,150,0.0,75.0,75.0,2,194,0.0,103.0,97.0
41443.0,6,10,2032,5,524,9867.75,252.0,104.8,5,1508,10099.25,1236.0,301.6
346971.0,6,3,204,2,136,0.0,70.0,68.0,1,68,0.0,68.0,68.0
2976942.0,6,164,129458,92,120404,32713.64835164836,1510.0,1308.7391304347825,72,9054,37569.0,1510.0,125.75
90284332.0,6,16,1192,8,596,12891418.142857144,95.0,74.5,8,596,12896459.42857143,95.0,74.5
112617.0,17,2,286,2,286,0.0,143.0,143.0,0,0,0.0,0.0,0.0
118164651.0,6,33,2274,17,1125,7385290.6875,123.0,66.17647058823529,16,1149,7198375.0,123.0,71.8125
284042.0,6,10,1221,6,636,56808.4,298.0,106.0,4,585,88168.66666666667,379.0,146.25
60404.0,6,14,4740,7,653,9909.833333333334,249.0,93.28571428571428,7,4087,9682.5,1514.0,583.8571428571429
228164.0,17,2,180,1,90,0.0,90.0,90.0,1,90,0.0,90.0,90.0
218859.0,6,3,426,2,280,0.0,214.0,140.0,1,146,0.0,146.0,146.0
205646.0,6,3,426,2,280,0.0,214.0,140.0,1,146,0.0,146.0,146.0
306641.0,6,6,412,4,272,102213.66666666669,74.0,68.0,2,140,0.0,74.0,70.0
90286434.0,6,16,1192,8,596,12890816.42857143,95.0,74.5,8,596,12897525.714285716,95.0,74.5
108112944.0,17,5,1005,5,1005,27028236.0,201.0,201.0,0,0,0.0,0.0,0.0
2969477.0,6,11,2106,6,598,593704.4,252.0,99.66666666666669,5,1508,2251.75,1236.0,301.6
31740.0,6,10,2032,5,524,7707.75,252.0,104.8,5,1508,7193.25,1236.0,301.6
10469209.0,6,7,478,4,272,3444311.6666666665,74.0,68.0,3,206,5166371.0,74.0,68.66666666666667
108105398.0,17,5,955,5,955,27026349.5,191.0,191.0,0,0,0.0,0.0,0.0
44559.0,6,10,2032,5,524,10828.5,252.0,104.8,5,1508,10007.25,1236.0,301.6
166671.0,17,2,180,1,90,0.0,90.0,90.0,1,90,0.0,90.0,90.0
21001.0,6,10,1067,5,536,4983.5,264.0,107.2,5,531,3661.5,259.0,106.2
10874136.0,6,8,544,4,272,3577663.6666666665,74.0,68.0,4,272,3577583.0,74.0,68.0
98608.0,17,3,1050,3,1050,49304.0,350.0,350.0,0,0,0.0,0.0,0.0
16096.0,6,14,4740,7,653,2564.333333333333,249.0,93.28571428571428,7,4087,2548.833333333333,1514.0,583.8571428571429
120045429.0,17,29,13785,29,13785,4287336.75,501.0,475.3448275862069,0,0,0.0,0.0,0.0
250227.0,6,10,1221,6,636,50045.4,298.0,106.0,4,585,82233.33333333333,379.0,146.25
2024.0,17,4,344,2,150,0.0,75.0,75.0,2,194,0.0,103.0,97.0
100000956.0,17,6,258,6,258,20000191.2,43.0,43.0,0,0,0.0,0.0,0.0
41188.0,6,14,4740,7,653,6739.666666666667,249.0,93.28571428571428,7,4087,6291.166666666667,1514.0,583.8571428571429
0.0,17,1,90,1,90,0.0,90.0,90.0,0,0,0.0,0.0,0.0
297882.0,6,6,412,4,272,99294.0,74.0,68.0,2,140,0.0,74.0,70.0
47100.0,6,14,4740,7,653,6668.166666666667,249.0,93.28571428571428,7,4087,7559.5,1514.0,583.8571428571429
27445849.0,17,5,1710,5,1710,6861462.25,342.0,342.0,0,0,0.0,0.0,0.0
206538.0,6,3,426,2,280,0.0,214.0,140.0,1,146,0.0,146.0,146.0
90740965.0,6,19,1436,10,745,10078512.888888888,95.0,74.5,9,691,11341257.125,95.0,76.77777777777777
2353012.0,6,3,1777,2,951,0.0,885.0,475.5,1,826,0.0,826.0,826.0
305326.0,6,6,412,4,272,101775.33333333331,74.0,68.0,2,140,0.0,74.0,70.0
67482.0,6,10,2032,5,524,14997.0,252.0,104.8,5,1508,13415.75,1236.0,301.6
124052.0,17,4,1400,4,1400,41350.66666666666,350.0,350.0,0,0,0.0,0.0,0.0
484204.0,17,2,374,1,73,0.0,73.0,73.0,1,301,0.0,301.0,301.0
90227888.0,6,13,2036,8,1016,12889698.285714284,188.0,127.0,5,1020,22516443.0,204.0,204.0
826.0,17,5,550,5,550,206.5,110.0,110.0,0,0,0.0,0.0,0.0
10483241.0,6,7,478,4,272,3449321.0,74.0,68.0,3,206,5173861.5,74.0,68.66666666666667
209582.0,17,2,180,1,90,0.0,90.0,90.0,1,90,0.0,90.0,90.0
305593.0,6,6,412,4,272,101864.33333333331,74.0,68.0,2,140,0.0,74.0,70.0
9237.0,17,2,507,1,86,0.0,86.0,86.0,1,421,0.0,421.0,421.0
233142.0,6,3,337,2,214,0.0,160.0,107.0,1,123,0.0,123.0,123.0
281618.0,17,2,363,1,79,0.0,79.0,79.0,1,284,0.0,284.0,284.0
300082.0,6,6,412,4,272,100027.33333333331,74.0,68.0,2,140,0.0,74.0,70.0
27693.0,6,14,4740,7,653,4489.5,249.0,93.28571428571428,7,4087,4476.166666666667,1514.0,583.8571428571429
121306.0,6,3,337,2,214,0.0,160.0,107.0,1,123,0.0,123.0,123.0
26439.0,6,14,4740,7,653,3942.1666666666665,249.0,93.28571428571428,7,4087,4229.333333333333,1514.0,583.8571428571429
90094704.0,6,11,1644,4,816,30031153.0,204.0,204.0,7,828,15015405.833333334,188.0,118.28571428571428
120125245.0,6,14,2224,9,1204,15015655.625,188.0,133.77777777777777,5,1020,22522960.5,204.0,204.0
29458.0,6,14,4740,7,653,4784.5,249.0,93.28571428571428,7,4087,4772.0,1514.0,583.8571428571429
331523.0,6,6,412,4,272,110507.66666666669,74.0,68.0,2,140,0.0,74.0,70.0
318.0,17,2,174,1,79,0.0,79.0,79.0,1,95,0.0,95.0,95.0
93115221.0,6,177,20256,89,14226,1058127.5113636365,300.0,159.8426966292135,88,6030,1058526.3793103448,140.0,68.52272727272727
153534.0,17,2,180,1,90,0.0,90.0,90.0,1,90,0.0,90.0,90.0
3581142.0,6,5,336,2,134,0.0,68.0,67.0,3,202,1512356.0,70.0,67.33333333333333
9007283.0,6,11,2106,6,598,1801211.0,252.0,99.66666666666669,5,1508,1838.5,1236.0,301.6
123456050.0,6,49,3234,25,1650,5144002.083333333,66.0,66.0,24,1584,5198588.173913044,66.0,66.0
120010695.0,17,29,13785,29,13785,4286096.25,501.0,475.3448275862069,0,0,0.0,0.0,0.0
233473.0,6,3,337,2,214,0.0,160.0,107.0,1,123,0.0,123.0,123.0
416219.0,6,3,1604,1,753,0.0,753.0,753.0,2,851,0.0,785.0,425.5
90036675.0,17,28,13364,28,13364,3334691.6666666665,501.0,477.2857142857143,0,0,0.0,0.0,0.0
113610865.0,6,46,3036,23,1518,5150436.2727272725,66.0,66.0,23,1518,5150440.590909091,66.0,66.0
36939.0,6,14,4740,7,653,6031.166666666667,249.0,93.28571428571428,7,4087,5894.0,1514.0,583.8571428571429
117392977.0,6,48,3168,24,1584,5104042.478260869,66.0,66.0,24,1584,5090794.0,66.0,66.0
162966.0,17,4,1400,4,1400,54322.0,350.0,350.0,0,0,0.0,0.0,0.0
109232301.0,17,14,864,7,432,18168040.33333333,174.0,61.71428571428572,7,432,18166830.0,174.0,61.71428571428572
206370.0,6,3,426,2,280,0.0,214.0,140.0,1,146,0.0,146.0,146.0
241205.0,6,3,373,2,238,0.0,172.0,119.0,1,135,0.0,135.0,135.0
108104954.0,17,5,1005,5,1005,27026238.5,201.0,201.0,0,0,0.0,0.0,0.0
310295.0,6,6,412,4,272,103431.66666666669,74.0,68.0,2,140,0.0,74.0,70.0
1302256.0,6,4,264,2,132,0.0,66.0,66.0,2,132,0.0,66.0,66.0
17197.0,6,10,2032,5,524,3201.0,252.0,104.8,5,1508,3801.0,1236.0,301.6
1157335.0,6,13,3020,8,2392,165333.57142857142,1514.0,299.0,5,628,220386.5,331.0,125.6
228213.0,17,2,180,1,90,0.0,90.0,90.0,1,90,0.0,90.0,90.0
13611135.0,6,19,1635,9,1003,1663588.625,315.0,111.44444444444444,10,632,1478657.6666666667,78.0,63.2
34721125.0,6,5,336,2,134,0.0,68.0,67.0,3,202,17293051.0,70.0,67.33333333333333
302505.0,17,2,246,1,76,0.0,76.0,76.0,1,170,0.0,170.0,170.0
1302543.0,6,4,264,2,132,0.0,66.0,66.0,2,132,0.0,66.0,66.0
314278.0,17,4,1400,4,1400,104759.33333333331,350.0,350.0,0,0,0.0,0.0,0.0
2296.0,17,4,344,2,150,0.0,75.0,75.0,2,194,0.0,103.0,97.0
157785.0,6,3,337,2,214,0.0,160.0,107.0,1,123,0.0,123.0,123.0
104564784.0,6,44,2904,22,1452,4979275.428571428,66.0,66.0,22,1452,4966143.904761905,66.0,66.0
38275.0,6,14,4740,7,653,5726.166666666667,249.0,93.28571428571428,7,4087,6193.833333333333,1514.0,583.8571428571429
10473204.0,6,7,478,4,272,3445725.333333333,74.0,68.0,3,206,5168451.0,74.0,68.66666666666667
90235619.0,6,13,2036,8,1016,12890802.714285716,188.0,127.0,5,1020,22518302.25,204.0,204.0
143937.0,17,2,180,1,90,0.0,90.0,90.0,1,90,0.0,90.0,90.0
207149.0,6,3,426,2,280,0.0,214.0,140.0,1,146,0.0,146.0,146.0
302106.0,17,2,246,1,76,0.0,76.0,76.0,1,170,0.0,170.0,170.0
90774021.0,6,19,1436,10,745,10080820.888888888,95.0,74.5,9,691,11346144.25,95.0,76.77777777777777
1683941.0,17,18,1260,18,1260,99055.35294117648,70.0,70.0,0,0,0.0,0.0,0.0
72135.0,6,14,4740,7,653,10469.166666666666,249.0,93.28571428571428,7,4087,11107.833333333334,1514.0,583.8571428571429
313362.0,6,3,202,2,128,0.0,74.0,64.0,1,74,0.0,74.0,74.0
38744.0,6,14,4740,7,653,6330.5,249.0,93.28571428571428,7,4087,6164.333333333333,1514.0,583.8571428571429
444655.0,6,10,1221,6,636,88931.0,298.0,106.0,4,585,142681.33333333334,379.0,146.25
46832.0,6,14,4740,7,653,6787.333333333333,249.0,93.28571428571428,7,4087,7589.333333333333,1514.0,583.8571428571429
6990.0,17,2,582,1,83,0.0,83.0,83.0,1,499,0.0,499.0,499.0
281354.0,17,2,363,1,79,0.0,79.0,79.0,1,284,0.0,284.0,284.0
138046.0,6,2,132,1,66,0.0,66.0,66.0,1,66,0.0,66.0,66.0
276062.0,17,2,346,1,78,0.0,78.0,78.0,1,268,0.0,268.0,268.0
146941.0,6,3,373,2,238,0.0,172.0,119.0,1,135,0.0,135.0,135.0
3275.0,17,2,359,1,75,0.0,75.0,75.0,1,284,0.0,284.0,284.0
2437046.0,6,3,1604,2,851,0.0,785.0,425.5,1,753,0.0,753.0,753.0
141814.0,6,10,1066,5,490,35087.25,218.0,98.0,5,576,35095.25,304.0,115.2
22985004.0,6,26,7807,14,1971,1768077.2307692308,408.0,140.78571428571428,12,5836,1776014.7272727273,1514.0,486.3333333333333
90829685.0,6,164,18540,82,12906,1118820.5555555555,284.0,157.390243902439,82,5634,1118820.7037037036,140.0,68.70731707317073
103288752.0,6,196,22092,98,15402,1062718.618556701,284.0,157.16326530612244,98,6690,1062724.3711340206,140.0,68.26530612244898
0.0,6,1,66,1,66,0.0,66.0,66.0,0,0,0.0,0.0,0.0
106755.0,17,2,286,2,286,0.0,143.0,143.0,0,0,0.0,0.0,0.0
246256.0,6,3,337,2,214,0.0,160.0,107.0,1,123,0.0,123.0,123.0
204901.0,17,2,762,2,762,0.0,381.0,381.0,0,0,0.0,0.0,0.0
2129.0,17,4,344,2,150,0.0,75.0,75.0,2,194,0.0,103.0,97.0
204131.0,17,2,180,1,90,0.0,90.0,90.0,1,90,0.0,90.0,90.0
100681765.0,6,29,1983,15,1017,7191554.642857143,123.0,67.8,14,966,7727988.076923077,123.0,69.0
177393.0,17,2,180,1,90,0.0,90.0,90.0,1,90,0.0,90.0,90.0
98106.0,6,11,2098,6,590,19501.2,252.0,98.33333333333331,5,1508,17845.0,1236.0,301.6
216452.0,17,2,180,1,90,0.0,90.0,90.0,1,90,0.0,90.0,90.0
120673669.0,6,22,1680,11,840,12067366.9,95.0,76.36363636363636,11,840,9043307.1,95.0,76.36363636363636
143853.0,17,2,180,1,90,0.0,90.0,90.0,1,90,0.0,90.0,90.0
120046774.0,17,28,13364,28,13364,4446176.814814814,501.0,477.2857142857143,0,0,0.0,0.0,0.0
536063.0,6,5,367,2,132,0.0,66.0,66.0,3,235,268031.5,103.0,78.33333333333333
113286683.0,6,48,3168,24,1584,4925507.956521739,66.0,66.0,24,1584,4916109.913043479,66.0,66.0
274863.0,6,12,1373,7,714,45810.5,298.0,102.0,5,659,64409.0,379.0,131.8
1342254.0,6,7,499,4,301,420281.0,103.0,75.25,3,198,613848.0,66.0,66.0
123839844.0,6,48,3168,24,1584,5102408.434782608,66.0,66.0,24,1584,5199564.521739131,66.0,66.0
116207823.0,6,47,3102,24,1584,5052502.695652174,66.0,66.0,23,1518,5143986.090909091,66.0,66.0
121313.0,6,3,337,2,214,0.0,160.0,107.0,1,123,0.0,123.0,123.0
297786.0,6,6,412,4,272,99262.0,74.0,68.0,2,140,0.0,74.0,70.0
128628666.0,6,34,2413,17,1125,7421048.3125,123.0,66.17647058823529,17,1288,7862541.1875,139.0,75.76470588235294
103254.0,6,14,4740,7,653,17079.666666666668,249.0,93.28571428571428,7,4087,14922.833333333334,1514.0,583.8571428571429
319.0,17,2,174,1,79,0.0,79.0,79.0,1,95,0.0,95.0,95.0
64215.99999999999,6,14,4740,7,653,10563.0,249.0,93.28571428571428,7,4087,10293.833333333334,1514.0,583.8571428571429
2594318.0,6,2,132,1,66,0.0,66.0,66.0,1,66,0.0,66.0,66.0
90221396.0,6,19,1436,9,691,11246668.375,95.0,76.77777777777777,10,745,10000590.444444444,95.0,74.5
160141.0,17,2,180,1,90,0.0,90.0,90.0,1,90,0.0,90.0,90.0
206161.0,6,3,426,2,280,0.0,214.0,140.0,1,146,0.0,146.0,146.0
105174203.0,17,14,1126,7,563,17529033.833333332,174.0,80.42857142857143,7,563,17494512.666666668,174.0,80.42857142857143
49313.0,6,10,2032,5,524,11745.75,252.0,104.8,5,1508,11909.25,1236.0,301.6
21979.0,6,19,7540,11,978,2197.9,310.0,88.9090909090909,8,6562,2449.285714285714,1514.0,820.25
45752.0,6,14,4740,7,653,6280.666666666667,249.0,93.28571428571428,7,4087,7197.166666666667,1514.0,583.8571428571429
90648360.0,6,15,2302,9,1204,11316806.25,188.0,133.77777777777777,6,1098,18097079.0,204.0,183.0
419432.0,17,2,363,1,75,0.0,75.0,75.0,1,288,0.0,288.0,288.0
1030989.0,6,11,1134,6,558,206197.8,220.0,93.0,5,576,256617.5,304.0,115.2
15068.0,6,10,2032,5,524,3224.75,252.0,104.8,5,1508,3381.5,1236.0,301.6
186076.0,17,2,180,1,90,0.0,90.0,90.0,1,90,0.0,90.0,90.0
224632.0,6,10,1221,6,636,44926.4,298.0,106.0,4,585,73980.33333333333,379.0,146.25
434.0,17,2,508,2,508,0.0,257.0,254.0,0,0,0.0,0.0,0.0
1319958.0,6,4,264,2,132,0.0,66.0,66.0,2,132,0.0,66.0,66.0
32679506.000000004,6,5,336,2,134,0.0,68.0,67.0,3,202,14951755.0,70.0,67.33333333333333
90260012.0,6,12,1832,8,1016,12894287.42857143,188.0,127.0,4,816,30031500.0,204.0,204.0
27139855.0,17,5,1710,5,1710,6784963.75,342.0,342.0,0,0,0.0,0.0,0.0
248106.0,6,3,337,2,214,0.0,160.0,107.0,1,123,0.0,123.0,123.0
135128085.0,17,6,1206,6,1206,27025617.0,201.0,201.0,0,0,0.0,0.0,0.0
36961.0,6,14,4740,7,653,5939.666666666667,249.0,93.28571428571428,7,4087,5906.833333333333,1514.0,583.8571428571429
217893.0,6,3,426,2,280,0.0,214.0,140.0,1,146,0.0,146.0,146.0
829.0,17,4,438,2,148,0.0,74.0,74.0,2,290,0.0,147.0,145.0
144706.0,6,2,132,1,66,0.0,66.0,66.0,1,66,0.0,66.0,66.0
243189.0,6,3,337,2,214,0.0,160.0,107.0,1,123,0.0,123.0,123.0
125229849.0,6,33,2296,17,1225,7826865.5625,139.0,72.05882352941177,16,1071,7668648.6,123.0,66.9375
105258.0,17,2,286,2,286,0.0,143.0,143.0,0,0,0.0,0.0,0.0
441020.0,6,11,1021,6,444,59398.6,162.0,74.0,5,577,74131.75,349.0,115.4
135137223.0,17,6,1206,6,1206,27027444.6,201.0,201.0,0,0,0.0,0.0,0.0
2339.0,17,4,344,2,150,0.0,75.0,75.0,2,194,0.0,103.0,97.0
314.0,17,2,174,1,79,0.0,79.0,79.0,1,95,0.0,95.0,95.0
283313.0,6,10,1221,6,636,56662.6,298.0,106.0,4,585,88698.0,379.0,146.25
44947.0,6,14,4740,7,653,7183.666666666667,249.0,93.28571428571428,7,4087,6996.5,1514.0,583.8571428571429
108105601.0,17,5,955,5,955,27026400.25,191.0,191.0,0,0,0.0,0.0,0.0
296.0,17,2,174,1,79,0.0,79.0,79.0,1,95,0.0,95.0,95.0
67606.0,6,14,4740,7,653,11131.0,249.0,93.28571428571428,7,4087,10659.5,1514.0,583.8571428571429
1315467.0,6,4,264,2,132,0.0,66.0,66.0,2,132,0.0,66.0,66.0
100154295.0,17,14,864,7,432,16668053.5,174.0,61.71428571428572,7,432,16666798.833333334,174.0,61.71428571428572
37140.0,6,14,4740,7,653,5603.333333333333,249.0,93.28571428571428,7,4087,5638.833333333333,1514.0,583.8571428571429
119780118.0,17,34,16284,34,16284,3629700.5454545454,501.0,478.9411764705882,0,0,0.0,0.0,0.0
143938.0,17,2,180,1,90,0.0,90.0,90.0,1,90,0.0,90.0,90.0
334239.0,6,12,1373,7,714,55706.5,298.0,102.0,5,659,79499.5,379.0,131.8
130005228.0,17,15,907,8,475,18572175.42857143,174.0,59.375,7,432,18333498.0,174.0,61.71428571428572
134197.0,6,2,132,1,66,0.0,66.0,66.0,1,66,0.0,66.0,66.0
41837.0,6,14,4740,7,653,6356.666666666667,249.0,93.28571428571428,7,4087,6503.5,1514.0,583.8571428571429
78751.0,6,14,4740,7,653,12684.166666666666,249.0,93.28571428571428,7,4087,12500.5,1514.0,583.8571428571429
1435851.0,17,16,1120,16,1120,95723.4,70.0,70.0,0,0,0.0,0.0,0.0
90019657.0,17,28,13364,28,13364,3334061.3703703703,501.0,477.2857142857143,0,0,0.0,0.0,0.0
209518.0,17,2,180,1,90,0.0,90.0,90.0,1,90,0.0,90.0,90.0
16564.0,6,14,4740,7,653,2483.0,249.0,93.28571428571428,7,4087,2567.5,1514.0,583.8571428571429
5011944.0,17,4,849,2,166,0.0,83.0,83.0,2,683,0.0,499.0,341.5
108102189.0,17,5,955,5,955,27025547.25,191.0,191.0,0,0,0.0,0.0,0.0
95188792.0,6,40,2640,20,1320,5009936.421052632,66.0,66.0,20,1320,4995441.47368421,66.0,66.0
47774.0,6,14,4740,7,653,7812.5,249.0,93.28571428571428,7,4087,7823.0,1514.0,583.8571428571429
0.0,17,1,44,1,44,0.0,44.0,44.0,0,0,0.0,0.0,0.0
156414.0,6,3,337,2,214,0.0,160.0,107.0,1,123,0.0,123.0,123.0
299891.0,17,2,246,1,76,0.0,76.0,76.0,1,170,0.0,170.0,170.0
216898.0,6,3,426,2,280,0.0,214.0,140.0,1,146,0.0,146.0,146.0
1203499.0,17,7,490,7,490,200583.16666666663,70.0,70.0,0,0,0.0,0.0,0.0
146261.0,6,3,337,2,214,0.0,160.0,107.0,1,123,0.0,123.0,123.0
310978.0,17,4,1400,4,1400,103659.33333333331,350.0,350.0,0,0,0.0,0.0,0.0
97999654.0,6,30,2106,15,1089,6984557.642857143,123.0,72.6,15,1017,6984561.428571428,123.0,67.8
90039401.0,17,28,13364,28,13364,3334792.6296296297,501.0,477.2857142857143,0,0,0.0,0.0,0.0
33736.0,6,10,2032,5,524,7512.25,252.0,104.8,5,1508,7295.5,1236.0,301.6
113520188.0,6,46,3036,23,1518,5159995.7727272725,66.0,66.0,23,1518,5159997.181818182,66.0,66.0
5625246.0,6,5,336,2,134,0.0,68.0,67.0,3,202,1522148.0,70.0,67.33333333333333
427.0,17,2,166,1,75,0.0,75.0,75.0,1,91,0.0,91.0,91.0
108113149.0,17,5,1005,5,1005,27028287.25,201.0,201.0,0,0,0.0,0.0,0.0
149938228.0,17,35,16705,35,16705,4409947.882352941,501.0,477.2857142857143,0,0,0.0,0.0,0.0
21549.0,17,2,566,1,83,0.0,83.0,83.0,1,483,0.0,483.0,483.0
146981.0,17,4,704,2,148,0.0,74.0,74.0,2,556,0.0,280.0,278.0
440.0,17,2,508,2,508,0.0,257.0,254.0,0,0,0.0,0.0,0.0
39560.0,6,14,4740,7,653,5679.5,249.0,93.28571428571428,7,4087,6070.0,1514.0,583.8571428571429
148574.0,17,2,414,1,88,0.0,88.0,88.0,1,326,0.0,326.0,326.0
113168275.0,6,46,3036,23,1518,5143999.363636363,66.0,66.0,23,1518,5144001.2727272725,66.0,66.0
114326275.0,6,223,25220,112,7614,1029966.4414414414,140.0,67.98214285714286,111,17606,1029937.781818182,300.0,158.61261261261262
102971.0,17,2,700,2,700,0.0,350.0,350.0,0,0,0.0,0.0,0.0
120041932.0,17,29,13785,29,13785,4287211.857142857,501.0,475.3448275862069,0,0,0.0,0.0,0.0
2137726.0,6,27,7742,13,2516,178143.83333333334,1034.0,193.53846153846155,14,5226,140964.38461538462,1510.0,373.2857142857143
28349.0,6,10,2032,5,524,6216.25,252.0,104.8,5,1508,6735.75,1236.0,301.6
0.0,17,1,55,1,55,0.0,55.0,55.0,0,0,0.0,0.0,0.0
258485.00000000003,6,3,337,2,214,0.0,160.0,107.0,1,123,0.0,123.0,123.0
120000067.0,6,35,3637,19,1940,6666670.388888889,426.0,102.10526315789474,16,1697,7456814.066666666,336.0,106.0625
113677977.0,6,47,3102,24,1584,4942520.739130435,66.0,66.0,23,1518,5159990.0,66.0,66.0
196972.0,17,2,180,1,90,0.0,90.0,90.0,1,90,0.0,90.0,90.0
147975.0,17,2,180,1,90,0.0,90.0,90.0,1,90,0.0,90.0,90.0
205900.0,17,2,180,1,90,0.0,90.0,90.0,1,90,0.0,90.0,90.0
38616918.0,6,5,336,2,134,0.0,68.0,67.0,3,202,18422502.5,70.0,67.33333333333333
138919.0,6,2,132,1,66,0.0,66.0,66.0,1,66,0.0,66.0,66.0
298495.0,6,6,412,4,272,99498.33333333331,74.0,68.0,2,140,0.0,74.0,70.0
26830.0,6,14,4740,7,653,3898.3333333333335,249.0,93.28571428571428,7,4087,4326.333333333333,1514.0,583.8571428571429
89938.0,17,2,286,2,286,0.0,143.0,143.0,0,0,0.0,0.0,0.0
277717.0,6,10,1221,6,636,55543.4,298.0,106.0,4,585,86573.66666666667,379.0,146.25
111034.0,17,2,286,2,286,0.0,143.0,143.0,0,0,0.0,0.0,0.0
40790.0,6,10,2032,5,524,9961.5,252.0,104.8,5,1508,9413.25,1236.0,301.6
216922.0,6,3,426,2,280,0.0,214.0,140.0,1,146,0.0,146.0,146.0
302.0,17,2,156,1,78,0.0,78.0,78.0,1,78,0.0,78.0,78.0
212407.0,6,10,1221,6,636,42481.4,298.0,106.0,4,585,69497.0,379.0,146.25
1774077.0,6,2,132,1,66,0.0,66.0,66.0,1,66,0.0,66.0,66.0
120140300.0,6,242,27310,121,8282,994361.9833333332,140.0,68.44628099173553,121,19028,994430.125,284.0,157.25619834710744
143994.0,17,2,180,1,90,0.0,90.0,90.0,1,90,0.0,90.0,90.0
107004825.0,6,31,2176,16,1071,7133625.266666667,123.0,66.9375,15,1105,6929938.285714285,139.0,73.66666666666667
302.0,17,2,156,1,78,0.0,78.0,78.0,1,78,0.0,78.0,78.0
2795540.0,6,2,132,1,66,0.0,66.0,66.0,1,66,0.0,66.0,66.0
2536857.0,6,25,7573,14,3735,195142.84615384616,1514.0,266.7857142857143,11,3838,227300.8,1514.0,348.90909090909093
52400.0,6,10,2032,5,524,12279.75,252.0,104.8,5,1508,11083.25,1236.0,301.6
12532.0,6,11,1131,6,600,2341.6,262.0,100.0,5,531,2913.5,259.0,106.2
115263743.0,6,363,45318,182,33150,636816.2596685083,390.0,182.1428571428572,181,12168,639103.0,140.0,67.22651933701657
42643.0,6,10,1066,5,490,9887.5,218.0,98.0,5,576,10449.25,304.0,115.2
112480211.0,6,46,3036,23,1518,5112725.181818182,66.0,66.0,23,1518,5112720.818181818,66.0,66.0
26207.0,17,4,823,2,163,0.0,89.0,81.5,2,660,0.0,443.0,330.0
206188.0,6,3,426,2,280,0.0,214.0,140.0,1,146,0.0,146.0,146.0
121454.0,6,3,337,2,214,0.0,160.0,107.0,1,123,0.0,123.0,123.0
106541.0,6,14,4740,7,653,17632.0,249.0,93.28571428571428,7,4087,16283.5,1514.0,583.8571428571429
348099.0,6,3,1604,2,851,0.0,785.0,425.5,1,753,0.0,753.0,753.0
50867.0,6,12,1320,7,789,8477.833333333334,253.0,112.71428571428572,5,531,10622.75,259.0,106.2
114990112.0,17,13,821,7,432,19165018.666666668,174.0,61.71428571428572,6,389,19000166.2,174.0,64.83333333333333
338.0,17,2,174,1,79,0.0,79.0,79.0,1,95,0.0,95.0,95.0
2802777.0,6,2,132,1,66,0.0,66.0,66.0,1,66,0.0,66.0,66.0
128824137.0,6,34,2334,17,1125,7427429.0,123.0,66.17647058823529,17,1209,7427419.0,123.0,71.11764705882354
300669.0,6,6,412,4,272,100223.0,74.0,68.0,2,140,0.0,74.0,70.0
3023197.0,6,3,1604,2,851,0.0,785.0,425.5,1,753,0.0,753.0,753.0
118107629.0,6,230,25978,115,7886,1028800.8333333334,140.0,68.57391304347826,115,18092,1011474.903508772,284.0,157.3217391304348
10458082.0,6,6,412,3,206,5160312.5,74.0,68.66666666666667,3,206,5160284.5,74.0,68.66666666666667
45835.0,6,14,4740,7,653,7330.166666666667,249.0,93.28571428571428,7,4087,5800.666666666667,1514.0,583.8571428571429
248556.0,6,3,337,2,214,0.0,160.0,107.0,1,123,0.0,123.0,123.0
234654.0,6,10,1221,6,636,46930.8,298.0,106.0,4,585,77343.33333333333,379.0,146.25
209513.0,17,2,180,1,90,0.0,90.0,90.0,1,90,0.0,90.0,90.0
65295.00000000001,6,12,1320,7,789,10882.5,253.0,112.71428571428572,5,531,13703.5,259.0,106.2
315937.0,17,4,1400,4,1400,105312.33333333331,350.0,350.0,0,0,0.0,0.0,0.0
228160.0,17,2,180,1,90,0.0,90.0,90.0,1,90,0.0,90.0,90.0
253869.0,6,10,1221,6,636,50773.8,298.0,106.0,4,585,79245.0,379.0,146.25
30892.0,6,14,4740,7,653,5025.5,249.0,93.28571428571428,7,4087,5014.0,1514.0,583.8571428571429
181645.0,17,4,571,2,148,0.0,74.0,74.0,2,423,0.0,280.0,211.5
860872.0,6,9,1196,6,725,172174.4,387.0,120.83333333333331,3,471,292598.5,331.0,157.0
120196427.0,6,21,1585,10,786,13332394.111111112,95.0,78.6,11,799,11999084.7,95.0,72.63636363636364
131970.0,6,2,132,1,66,0.0,66.0,66.0,1,66,0.0,66.0,66.0
759475.0,6,11,1131,6,600,151147.8,262.0,100.0,5,531,189587.25,259.0,106.2
251099.00000000003,6,13,1386,7,789,41849.833333333336,253.0,112.71428571428572,6,597,48070.4,259.0,99.5
177670.0,17,2,180,1,90,0.0,90.0,90.0,1,90,0.0,90.0,90.0
973013.0,6,10,1162,6,625,194602.6,287.0,104.16666666666669,4,537,232450.0,331.0,134.25
2799932.0,6,2,132,1,66,0.0,66.0,66.0,1,66,0.0,66.0,66.0
321689.0,6,6,412,4,272,107229.66666666669,74.0,68.0,2,140,0.0,74.0,70.0
17273.0,17,4,571,2,148,0.0,74.0,74.0,2,423,0.0,280.0,211.5
141491.0,6,2,132,1,66,0.0,66.0,66.0,1,66,0.0,66.0,66.0
48385.0,6,13,1386,7,789,7874.833333333333,253.0,112.71428571428572,6,597,8997.8,259.0,99.5
103961.0,17,2,286,2,286,0.0,143.0,143.0,0,0,0.0,0.0,0.0
19002.0,6,2,145,2,145,0.0,91.0,72.5,0,0,0.0,0.0,0.0
135135571.0,17,6,1146,6,1146,27027114.2,191.0,191.0,0,0,0.0,0.0,0.0
3066.0,17,2,224,1,76,0.0,76.0,76.0,1,148,0.0,148.0,148.0
311087.0,6,3,202,2,128,0.0,74.0,64.0,1,74,0.0,74.0,74.0
218489.0,6,3,426,2,280,0.0,214.0,140.0,1,146,0.0,146.0,146.0
61348.0,6,10,2032,5,524,12558.25,252.0,104.8,5,1508,12945.75,1236.0,301.6
135136267.0,17,6,1206,6,1206,27027253.4,201.0,201.0,0,0,0.0,0.0,0.0
5002192.0,17,4,629,2,156,0.0,78.0,78.0,2,473,0.0,268.0,236.5
146228.0,6,3,337,2,214,0.0,160.0,107.0,1,123,0.0,123.0,123.0
241925.0,6,3,337,2,214,0.0,160.0,107.0,1,123,0.0,123.0,123.0
112587617.0,6,30,1974,15,1026,8026537.642857143,123.0,68.4,15,948,8026541.928571428,123.0,63.2
90045049.0,17,28,13364,28,13364,3335001.814814815,501.0,477.2857142857143,0,0,0.0,0.0,0.0
43121.0,6,14,4740,7,653,6979.0,249.0,93.28571428571428,7,4087,6496.833333333333,1514.0,583.8571428571429
10460586.0,6,7,478,4,272,3441204.0,74.0,68.0,3,206,5161678.0,74.0,68.66666666666667
6442.0,17,4,823,2,163,0.0,89.0,81.5,2,660,0.0,443.0,330.0
90036356.0,17,28,13364,28,13364,3334679.851851852,501.0,477.2857142857143,0,0,0.0,0.0,0.0
135138447.0,17,6,1146,6,1146,27027689.4,191.0,191.0,0,0,0.0,0.0,0.0
12578.0,6,10,2032,5,524,2777.0,252.0,104.8,5,1508,2566.25,1236.0,301.6
206907.0,17,2,180,1,90,0.0,90.0,90.0,1,90,0.0,90.0,90.0
106565927.0,6,29,2052,15,1089,7596421.785714285,123.0,72.6,14,963,8180743.846153846,123.0,68.78571428571429
101000023.0,17,13,821,7,432,16833337.166666668,174.0,61.71428571428572,6,389,16201516.6,174.0,64.83333333333333
335596.0,17,2,180,1,90,0.0,90.0,90.0,1,90,0.0,90.0,90.0
344.0,17,2,267,1,83,0.0,83.0,83.0,1,184,0.0,184.0,184.0
135138735.0,17,6,1146,6,1146,27027747.0,191.0,191.0,0,0,0.0,0.0,0.0
295.0,17,2,156,1,78,0.0,78.0,78.0,1,78,0.0,78.0,78.0
311491.0,17,4,1400,4,1400,103830.33333333331,350.0,350.0,0,0,0.0,0.0,0.0
107632.0,17,2,286,2,286,0.0,143.0,143.0,0,0,0.0,0.0,0.0
0.0,17,1,55,1,55,0.0,55.0,55.0,0,0,0.0,0.0,0.0
3581484.0,6,5,336,2,134,0.0,68.0,67.0,3,202,1424045.0,70.0,67.33333333333333
505262.0,6,4,270,2,134,0.0,68.0,67.0,2,136,0.0,70.0,68.0
90531204.0,6,13,2036,8,1016,12933029.142857144,188.0,127.0,5,1020,22591787.25,204.0,204.0
117590139.0,6,47,3102,24,1584,5112603.391304348,66.0,66.0,23,1518,5112001.545454546,66.0,66.0
105002036.0,6,44,2904,22,1452,5000096.952380952,66.0,66.0,22,1452,4985222.952380952,66.0,66.0
90020147.0,17,28,13364,28,13364,3334079.5185185187,501.0,477.2857142857143,0,0,0.0,0.0,0.0
2317.0,17,4,344,2,150,0.0,75.0,75.0,2,194,0.0,103.0,97.0
23410.0,6,14,4740,7,653,3626.6666666666665,249.0,93.28571428571428,7,4087,3769.3333333333335,1514.0,583.8571428571429
45585.0,6,13,1479,7,882,7597.5,291.0,126.0,6,597,8534.0,259.0,99.5
200906.0,17,2,762,2,762,0.0,381.0,381.0,0,0,0.0,0.0,0.0
100272025.0,6,174,19650,87,13686,1163452.4186046512,284.0,157.31034482758622,87,5964,1163453.1511627906,140.0,68.55172413793103
24903.0,6,10,2032,5,524,5992.0,252.0,104.8,5,1508,5837.75,1236.0,301.6
19712.0,6,14,4740,7,653,2812.1666666666665,249.0,93.28571428571428,7,4087,3119.833333333333,1514.0,583.8571428571429
90257003.0,6,14,2102,8,1016,12893857.57142857,188.0,127.0,6,1086,18018978.0,204.0,181.0
121010322.0,17,15,907,8,475,17287188.85714286,174.0,59.375,7,432,16833499.166666668,174.0,61.71428571428572
265649.0,6,10,1221,6,636,53129.8,298.0,106.0,4,585,81539.66666666667,379.0,146.25
117968.0,17,2,286,2,286,0.0,143.0,143.0,0,0,0.0,0.0,0.0
64775.0,6,14,4740,7,653,10322.333333333334,249.0,93.28571428571428,7,4087,6849.166666666667,1514.0,583.8571428571429
318.0,17,2,174,1,79,0.0,79.0,79.0,1,95,0.0,95.0,95.0
17063.0,6,20,7606,11,978,1706.3,310.0,88.9090909090909,9,6628,1845.875,1514.0,736.4444444444445
115668297.0,6,32,2220,16,1149,7696816.8,123.0,71.8125,16,1071,7696826.733333333,123.0,66.9375
247275.0,6,3,337,2,214,0.0,160.0,107.0,1,123,0.0,123.0,123.0
90065835.0,17,27,12943,27,12943,3464070.576923077,501.0,479.3703703703704,0,0,0.0,0.0,0.0
90056818.0,17,28,13364,28,13364,3335437.703703704,501.0,477.2857142857143,0,0,0.0,0.0,0.0
115098857.0,6,48,3168,24,1584,5004298.130434782,66.0,66.0,24,1584,4992324.304347826,66.0,66.0
68752.0,6,14,4740,7,653,11338.5,249.0,93.28571428571428,7,4087,9922.5,1514.0,583.8571428571429
0.0,17,1,44,1,44,0.0,44.0,44.0,0,0,0.0,0.0,0.0
34115.0,6,14,4740,7,653,5301.833333333333,249.0,93.28571428571428,7,4087,4370.0,1514.0,583.8571428571429
2012.0,17,4,344,2,150,0.0,75.0,75.0,2,194,0.0,103.0,97.0
6421.0,17,2,582,1,83,0.0,83.0,83.0,1,499,0.0,499.0,499.0
85.0,17,2,762,2,762,0.0,381.0,381.0,0,0,0.0,0.0,0.0
1023645.0,6,20,6434,12,1921,93058.63636363635,620.0,160.08333333333334,8,4513,118215.42857142857,1514.0,564.125
2797984.0,6,2,132,1,66,0.0,66.0,66.0,1,66,0.0,66.0,66.0
526969.0,6,6,758,3,410,244453.5,172.0,136.66666666666666,3,348,191375.0,135.0,116.0
10519053.0,6,7,478,4,272,3460886.0,74.0,68.0,3,206,5191244.0,74.0,68.66666666666667
781803.0,6,14,4740,7,653,129813.83333333331,249.0,93.28571428571428,7,4087,130039.66666666669,1514.0,583.8571428571429
2489.0,17,4,344,2,150,0.0,75.0,75.0,2,194,0.0,103.0,97.0
68394.0,6,14,4740,7,653,10859.166666666666,249.0,93.28571428571428,7,4087,8616.166666666666,1514.0,583.8571428571429
314642.0,17,4,1400,4,1400,104880.66666666669,350.0,350.0,0,0,0.0,0.0,0.0
363056.0,6,11,1021,6,444,48829.6,162.0,74.0,5,577,60841.25,349.0,115.4
3333887.0,6,7,923,4,753,1039110.6666666666,571.0,188.25,3,170,1559268.0,62.0,56.66666666666666
200528.0,17,4,1524,4,1524,66842.66666666667,381.0,381.0,0,0,0.0,0.0,0.0
120123636.0,6,16,2490,10,1392,13347070.666666666,188.0,139.2,6,1098,18102782.0,204.0,183.0
153088.0,6,3,337,2,214,0.0,160.0,107.0,1,123,0.0,123.0,123.0
107394.0,17,2,286,2,286,0.0,143.0,143.0,0,0,0.0,0.0,0.0
310468.0,6,3,202,2,128,0.0,74.0,64.0,1,74,0.0,74.0,74.0
303628.0,6,2,132,1,66,0.0,66.0,66.0,1,66,0.0,66.0,66.0
30887.0,6,14,4740,7,653,4906.333333333333,249.0,93.28571428571428,7,4087,3577.333333333333,1514.0,583.8571428571429
206091.0,17,2,180,1,90,0.0,90.0,90.0,1,90,0.0,90.0,90.0
308736.0,6,6,412,4,272,102912.0,74.0,68.0,2,140,0.0,74.0,70.0
259218.0,6,3,337,2,214,0.0,160.0,107.0,1,123,0.0,123.0,123.0
90031366.0,17,28,13364,28,13364,3334495.037037037,501.0,477.2857142857143,0,0,0.0,0.0,0.0
120450387.0,6,223,25258,112,17624,1085138.6216216215,284.0,157.35714285714286,111,7634,1085566.6090909091,140.0,68.77477477477477
113570763.0,6,218,24534,109,17118,1049588.6296296297,284.0,157.045871559633,109,7416,1049589.4444444445,140.0,68.03669724770643
216301.0,17,2,180,1,90,0.0,90.0,90.0,1,90,0.0,90.0,90.0
330.0,17,2,166,1,75,0.0,75.0,75.0,1,91,0.0,91.0,91.0
2314.0,17,4,344,2,150,0.0,75.0,75.0,2,194,0.0,103.0,97.0
120122023.0,6,16,2632,9,1204,15015252.875,188.0,133.77777777777777,7,1428,15060711.833333334,204.0,204.0
4438.0,17,2,614,1,72,0.0,72.0,72.0,1,542,0.0,542.0,542.0
6749.0,17,2,582,1,83,0.0,83.0,83.0,1,499,0.0,499.0,499.0
69125.0,6,14,4740,7,653,9502.166666666666,249.0,93.28571428571428,7,4087,9982.833333333334,1514.0,583.8571428571429
244334.0,17,2,180,1,90,0.0,90.0,90.0,1,90,0.0,90.0,90.0
884485.0,6,9,1268,6,797,176897.0,459.0,132.83333333333334,3,471,304304.0,331.0,157.0
306768.0,6,6,412,4,272,102256.0,74.0,68.0,2,140,0.0,74.0,70.0
14493.0,6,11,1131,6,600,2650.2,262.0,100.0,5,531,3264.25,259.0,106.2
2000.0,17,4,344,2,150,0.0,75.0,75.0,2,194,0.0,103.0,97.0
135137301.0,17,6,1206,6,1206,27027460.2,201.0,201.0,0,0,0.0,0.0,0.0
100200306.0,17,12,778,6,389,20000159.6,174.0,64.83333333333333,6,389,20000997.2,174.0,64.83333333333333
316172.0,6,6,412,4,272,105390.66666666669,74.0,68.0,2,140,0.0,74.0,70.0
114271.0,17,4,1400,4,1400,38090.333333333336,350.0,350.0,0,0,0.0,0.0,0.0
197981.0,17,4,1524,4,1524,65993.66666666667,381.0,381.0,0,0,0.0,0.0,0.0
135132770.0,17,6,1206,6,1206,27026554.0,201.0,201.0,0,0,0.0,0.0,0.0
113173046.0,6,46,3036,23,1518,5144217.909090909,66.0,66.0,23,1518,5144217.636363637,66.0,66.0
108107281.0,17,5,955,5,955,27026820.25,191.0,191.0,0,0,0.0,0.0,0.0
27425796.0,17,5,1710,5,1710,6856449.0,342.0,342.0,0,0,0.0,0.0,0.0
317883.0,17,4,1400,4,1400,105961.0,350.0,350.0,0,0,0.0,0.0,0.0
8248239.999999999,6,6,433,2,132,0.0,66.0,66.0,4,301,2749413.333333333,103.0,75.25
120122894.0,6,13,2036,5,1020,30030723.5,204.0,204.0,8,1016,17136844.42857143,188.0,127.0
11828.0,6,10,1067,5,536,2776.0,264.0,107.2,5,531,2707.25,259.0,106.2
217553.0,6,10,1221,6,636,43510.6,298.0,106.0,4,585,71199.33333333333,379.0,146.25
4449.0,17,2,614,1,72,0.0,72.0,72.0,1,542,0.0,542.0,542.0
90259236.0,6,13,2036,8,1016,12894176.57142857,188.0,127.0,5,1020,22520420.75,204.0,204.0
101062909.0,17,14,864,7,432,16833510.5,174.0,61.71428571428572,7,432,16834988.5,174.0,61.71428571428572
4238.0,17,2,614,1,72,0.0,72.0,72.0,1,542,0.0,542.0,542.0
153392.0,17,2,180,1,90,0.0,90.0,90.0,1,90,0.0,90.0,90.0
2567834.0,6,2,132,1,66,0.0,66.0,66.0,1,66,0.0,66.0,66.0
41982.0,6,14,4740,7,653,6579.333333333333,249.0,93.28571428571428,7,4087,6858.333333333333,1514.0,583.8571428571429
122530509.0,6,49,3234,25,1650,5105437.875,66.0,66.0,24,1584,5181880.043478261,66.0,66.0
298801.0,6,6,412,4,272,99600.33333333331,74.0,68.0,2,140,0.0,74.0,70.0
120040015.0,17,12,647,6,389,20087942.8,174.0,64.83333333333333,6,258,20001213.6,43.0,43.0
135135217.0,17,6,1146,6,1146,27027043.4,191.0,191.0,0,0,0.0,0.0,0.0
11474.0,6,10,1949,5,441,2635.25,169.0,88.2,5,1508,2598.0,1236.0,301.6
294801.0,17,4,6056,4,6056,98267.0,1514.0,1514.0,0,0,0.0,0.0,0.0
122687997.0,6,49,3234,25,1650,5111999.875,66.0,66.0,24,1584,5121250.478260869,66.0,66.0
732409.0,17,8,2800,8,2800,104629.85714285714,350.0,350.0,0,0,0.0,0.0,0.0
159568.0,6,3,337,2,214,0.0,160.0,107.0,1,123,0.0,123.0,123.0
5025174.0,17,4,376,2,152,0.0,76.0,76.0,2,224,0.0,148.0,112.0
26870.0,6,14,4740,7,653,4320.0,249.0,93.28571428571428,7,4087,3986.0,1514.0,583.8571428571429
233401.0,6,3,337,2,214,0.0,160.0,107.0,1,123,0.0,123.0,123.0
303508.0,6,6,412,4,272,101169.33333333331,74.0,68.0,2,140,0.0,74.0,70.0
1778220.0,6,2,132,1,66,0.0,66.0,66.0,1,66,0.0,66.0,66.0
2040.0,17,4,344,2,150,0.0,75.0,75.0,2,194,0.0,103.0,97.0
2015.0,17,4,344,2,150,0.0,75.0,75.0,2,194,0.0,103.0,97.0
226043.0,17,2,180,1,90,0.0,90.0,90.0,1,90,0.0,90.0,90.0
313170.0,6,6,412,4,272,104390.0,74.0,68.0,2,140,0.0,74.0,70.0
1723509.0,6,23,6507,12,1529,156682.63636363635,357.0,127.41666666666669,11,4978,141058.2,1510.0,452.54545454545456
247206.0,6,3,373,2,238,0.0,172.0,119.0,1,135,0.0,135.0,135.0
5818303.0,6,4,270,2,134,0.0,68.0,67.0,2,136,0.0,70.0,68.0
120000011.0,6,26,2019,15,1179,8571429.357142856,95.0,78.6,11,840,9183494.4,95.0,76.36363636363636
90045544.0,6,158,17762,79,12400,1151671.7948717948,284.0,156.9620253164557,79,5362,1151671.923076923,140.0,67.87341772151899
791.0,17,4,438,2,148,0.0,74.0,74.0,2,290,0.0,147.0,145.0
90258098.0,6,13,2036,8,1016,12894014.0,188.0,127.0,5,1020,22523343.25,204.0,204.0
143897.0,17,2,180,1,90,0.0,90.0,90.0,1,90,0.0,90.0,90.0
1464854.0,6,7,499,4,301,423875.0,103.0,75.25,3,198,716298.0,66.0,66.0
3668028.0,17,4,1368,4,1368,1222676.0,342.0,342.0,0,0,0.0,0.0,0.0
208104.0,6,3,426,2,280,0.0,214.0,140.0,1,146,0.0,146.0,146.0
209511.0,17,2,180,1,90,0.0,90.0,90.0,1,90,0.0,90.0,90.0
49405.0,6,14,4740,7,653,7110.166666666667,249.0,93.28571428571428,7,4087,7886.166666666667,1514.0,583.8571428571429
265349.0,6,10,1221,6,636,53069.8,298.0,106.0,4,585,82703.0,379.0,146.25
161140.0,6,2,128,1,74,0.0,74.0,74.0,1,54,0.0,54.0,54.0
115521285.0,6,48,3168,24,1584,5022664.565217392,66.0,66.0,24,1584,5008994.913043479,66.0,66.0
300639.0,6,6,412,4,272,100213.0,74.0,68.0,2,140,0.0,74.0,70.0
775.0,17,4,438,2,148,0.0,74.0,74.0,2,290,0.0,147.0,145.0
301564.0,6,6,412,4,272,100521.33333333331,74.0,68.0,2,140,0.0,74.0,70.0
102785.0,17,2,286,2,286,0.0,143.0,143.0,0,0,0.0,0.0,0.0
250499.00000000003,17,4,6056,4,6056,83499.66666666667,1514.0,1514.0,0,0,0.0,0.0,0.0
118509075.0,6,232,26200,116,18248,1028628.8869565218,284.0,157.31034482758622,116,7952,1028633.3478260868,140.0,68.55172413793103
307043.0,6,6,412,4,272,102347.66666666669,74.0,68.0,2,140,0.0,74.0,70.0
326152.0,6,3,1604,2,851,0.0,785.0,425.5,1,753,0.0,753.0,753.0
4595287.0,6,5,336,2,134,0.0,68.0,67.0,3,202,1526887.5,70.0,67.33333333333333
16688415.0,6,20,1611,9,921,2047449.375,315.0,102.33333333333331,11,690,1637932.1,78.0,62.72727272727273
306923.0,6,2,132,1,66,0.0,66.0,66.0,1,66,0.0,66.0,66.0
306508.0,6,3,202,2,128,0.0,74.0,64.0,1,74,0.0,74.0,74.0
120122819.0,6,12,1832,8,1016,17137225.42857143,188.0,127.0,4,816,30028953.0,204.0,204.0
135134728.0,17,6,1146,6,1146,27026945.6,191.0,191.0,0,0,0.0,0.0,0.0
119678334.0,6,220,24868,110,17312,1095992.0825688073,284.0,157.38181818181818,110,7556,1095992.889908257,140.0,68.69090909090909
31739.000000000004,6,14,4740,7,653,5021.5,249.0,93.28571428571428,7,4087,4138.833333333333,1514.0,583.8571428571429
31744.0,6,14,4740,7,653,5118.5,249.0,93.28571428571428,7,4087,5075.0,1514.0,583.8571428571429
14679.0,6,10,1067,5,536,3173.25,264.0,107.2,5,531,3012.0,259.0,106.2
2357.0,17,4,344,2,150,0.0,75.0,75.0,2,194,0.0,103.0,97.0
232100.0,6,3,337,2,214,0.0,160.0,107.0,1,123,0.0,123.0,123.0
92788.0,6,14,4740,7,653,14247.666666666666,249.0,93.28571428571428,7,4087,9406.333333333334,1514.0,583.8571428571429
146175.0,6,4,439,2,238,0.0,172.0,119.0,2,201,0.0,135.0,100.5
2418.0,17,4,344,2,150,0.0,75.0,75.0,2,194,0.0,103.0,97.0
229350.0,17,2,359,1,75,0.0,75.0,75.0,1,284,0.0,284.0,284.0
299.0,17,2,164,1,82,0.0,82.0,82.0,1,82,0.0,82.0,82.0
92226.0,6,12,1328,7,797,15371.0,253.0,113.85714285714286,5,531,18827.5,259.0,106.2
151486.0,17,4,6056,4,6056,50495.333333333336,1514.0,1514.0,0,0,0.0,0.0,0.0
121255.0,6,3,337,2,214,0.0,160.0,107.0,1,123,0.0,123.0,123.0
120315303.0,6,219,24802,110,17312,1103810.119266055,284.0,157.38181818181818,109,7490,1104420.25,140.0,68.71559633027523
363219.0,6,11,1021,6,444,48858.4,162.0,74.0,5,577,60881.0,349.0,115.4
35464.0,6,10,2032,5,524,8395.0,252.0,104.8,5,1508,8239.25,1236.0,301.6
305488.0,6,6,412,4,272,101829.33333333331,74.0,68.0,2,140,0.0,74.0,70.0
36646.0,6,14,4740,7,653,5571.333333333333,249.0,93.28571428571428,7,4087,5958.833333333333,1514.0,583.8571428571429
44656.0,6,10,2032,5,524,8845.5,252.0,104.8,5,1508,10766.25,1236.0,301.6
135132796.0,17,6,1206,6,1206,27026559.2,201.0,201.0,0,0,0.0,0.0,0.0
120860.0,6,3,337,2,214,0.0,160.0,107.0,1,123,0.0,123.0,123.0
90255638.0,6,13,2036,8,1016,12893662.57142857,188.0,127.0,5,1020,22523627.0,204.0,204.0
207299.0,6,3,426,2,280,0.0,214.0,140.0,1,146,0.0,146.0,146.0
26658.0,6,14,4740,7,653,4327.333333333333,249.0,93.28571428571428,7,4087,3986.1666666666665,1514.0,583.8571428571429
102762.0,17,2,762,2,762,0.0,381.0,381.0,0,0,0.0,0.0,0.0
90959579.0,6,21,1585,11,840,9094769.6,95.0,76.36363636363636,10,745,10106361.555555556,95.0,74.5
120019.0,17,2,180,1,70,0.0,70.0,70.0,1,110,0.0,110.0,110.0
221877.0,17,2,359,1,75,0.0,75.0,75.0,1,284,0.0,284.0,284.0
99942825.0,6,24,1500,12,783,9066050.636363637,123.0,65.25,12,717,9066028.545454543,123.0,59.75
303689.0,6,2,132,1,66,0.0,66.0,66.0,1,66,0.0,66.0,66.0
98989.0,17,2,762,2,762,0.0,381.0,381.0,0,0,0.0,0.0,0.0
123001151.0,17,15,907,8,475,17571593.0,174.0,59.375,7,432,17168064.166666668,174.0,61.71428571428572
1043519.0,6,12,2711,7,743,173919.83333333334,339.0,106.14285714285714,5,1968,191895.5,1514.0,393.6
14629871.0,6,20,1607,10,975,1592015.2222222222,315.0,97.5,10,632,1591984.6666666667,78.0,63.2
90312441.0,6,19,1436,10,745,10029219.222222222,95.0,74.5,9,691,11287644.625,95.0,76.77777777777777
0.0,17,1,55,1,55,0.0,55.0,55.0,0,0,0.0,0.0,0.0
120017979.0,6,21,1585,11,840,12001797.9,95.0,76.36363636363636,10,745,13307350.888888888,95.0,74.5
402855.0,6,10,1221,6,636,80571.0,298.0,106.0,4,585,128485.33333333331,379.0,146.25
254375.00000000003,17,4,1524,4,1524,84791.66666666667,381.0,381.0,0,0,0.0,0.0,0.0
309945.0,17,4,704,2,148,0.0,74.0,74.0,2,556,0.0,280.0,278.0
135126404.0,17,6,1146,6,1146,27025280.8,191.0,191.0,0,0,0.0,0.0,0.0
362537.0,6,11,1021,6,444,48848.6,162.0,74.0,5,577,60799.0,349.0,115.4
113442602.0,6,47,3102,24,1584,4932275.739130435,66.0,66.0,23,1518,5155639.681818182,66.0,66.0
448.0,17,2,166,1,75,0.0,75.0,75.0,1,91,0.0,91.0,91.0
28523.0,6,14,4740,7,653,3953.1666666666665,249.0,93.28571428571428,7,4087,4579.333333333333,1514.0,583.8571428571429
311.0,17,2,208,1,72,0.0,72.0,72.0,1,136,0.0,136.0,136.0
303509.0,6,6,412,4,272,101169.66666666669,74.0,68.0,2,140,0.0,74.0,70.0
160756.0,17,4,1400,4,1400,53585.333333333336,350.0,350.0,0,0,0.0,0.0,0.0
1175200.0,6,13,3010,8,2382,167885.7142857143,1514.0,297.75,5,628,224846.75,331.0,125.6
20467.0,6,2,145,2,145,0.0,91.0,72.5,0,0,0.0,0.0,0.0
330.0,17,2,160,1,80,0.0,80.0,80.0,1,80,0.0,80.0,80.0
302000.0,6,6,412,4,272,100666.66666666669,74.0,68.0,2,140,0.0,74.0,70.0
205822.0,17,2,180,1,90,0.0,90.0,90.0,1,90,0.0,90.0,90.0
304404.0,17,4,571,2,148,0.0,74.0,74.0,2,423,0.0,280.0,211.5
36392.0,6,14,4740,7,653,5893.0,249.0,93.28571428571428,7,4087,5810.333333333333,1514.0,583.8571428571429
27130.0,6,13,1386,7,789,4112.833333333333,253.0,112.71428571428572,6,597,4743.2,259.0,99.5
0.0,6,1,66,1,66,0.0,66.0,66.0,0,0,0.0,0.0,0.0
108104814.0,17,5,955,5,955,27026203.5,191.0,191.0,0,0,0.0,0.0,0.0
179320.0,17,2,598,1,72,0.0,72.0,72.0,1,526,0.0,526.0,526.0
755001.0,6,2,132,1,66,0.0,66.0,66.0,1,66,0.0,66.0,66.0
123701.0,17,4,1524,4,1524,41233.66666666666,381.0,381.0,0,0,0.0,0.0,0.0
0.0,6,1,172,1,172,0.0,172.0,172.0,0,0,0.0,0.0,0.0
108100934.0,17,5,955,5,955,27025233.5,191.0,191.0,0,0,0.0,0.0,0.0
274661.0,6,10,1221,6,636,54932.2,298.0,106.0,4,585,86150.66666666667,379.0,146.25
48055.0,6,12,1320,7,789,8009.166666666667,253.0,112.71428571428572,5,531,10152.75,259.0,106.2
19458.0,6,10,2032,5,524,4654.0,252.0,104.8,5,1508,4195.0,1236.0,301.6
127363756.0,17,16,1212,8,606,15372068.714285716,174.0,75.75,8,606,17654307.57142857,174.0,75.75
144003.0,17,2,180,1,90,0.0,90.0,90.0,1,90,0.0,90.0,90.0
35210.0,6,10,2032,5,524,8258.5,252.0,104.8,5,1508,8531.5,1236.0,301.6
39861.0,6,10,2032,5,524,8122.25,252.0,104.8,5,1508,9597.75,1236.0,301.6
103072189.0,6,42,2772,21,1386,5153595.7,66.0,66.0,21,1386,5153593.55,66.0,66.0
90254311.0,6,12,1832,8,1016,12893473.0,188.0,127.0,4,816,30030485.666666668,204.0,204.0
22735.0,6,14,4740,7,653,3665.6666666666665,249.0,93.28571428571428,7,4087,3577.6666666666665,1514.0,583.8571428571429
110083398.0,6,31,2166,16,1149,7324543.933333334,123.0,71.8125,15,1017,7847724.5,123.0,67.8
101560334.0,17,14,864,7,432,16834756.666666668,174.0,61.71428571428572,7,432,16833494.833333332,174.0,61.71428571428572
314.0,17,2,164,1,74,0.0,74.0,74.0,1,90,0.0,90.0,90.0
135131870.0,17,6,1206,6,1206,27026374.0,201.0,201.0,0,0,0.0,0.0,0.0
92113650.0,6,168,19000,84,13234,1107210.3975903615,300.0,157.54761904761904,84,5766,1107209.1807228916,140.0,68.64285714285714
105046285.0,6,30,2106,15,1089,7503306.071428572,123.0,72.6,15,1017,7487853.0,123.0,67.8
1855.0,17,4,344,2,150,0.0,75.0,75.0,2,194,0.0,103.0,97.0
109300.0,17,2,286,2,286,0.0,143.0,143.0,0,0,0.0,0.0,0.0
15908819.0,17,6,2052,6,2052,3181763.8,342.0,342.0,0,0,0.0,0.0,0.0
1166161.0,6,13,3010,8,2382,166594.42857142858,1514.0,297.75,5,628,222611.25,331.0,125.6
245563.0,6,3,337,2,214,0.0,160.0,107.0,1,123,0.0,123.0,123.0
120068616.0,17,28,13364,28,13364,4446985.777777778,501.0,477.2857142857143,0,0,0.0,0.0,0.0
74663296.0,6,9,842,9,842,9332912.0,97.0,93.55555555555556,0,0,0.0,0.0,0.0
299.0,17,2,156,1,78,0.0,78.0,78.0,1,78,0.0,78.0,78.0
44276.0,6,14,4740,7,653,7095.166666666667,249.0,93.28571428571428,7,4087,6972.666666666667,1514.0,583.8571428571429
104306035.0,17,14,864,7,432,17333516.666666668,174.0,61.71428571428572,7,432,17334942.5,174.0,61.71428571428572
1415.0,17,4,438,2,148,0.0,74.0,74.0,2,290,0.0,147.0,145.0
10509687.0,6,6,412,3,206,5186406.5,74.0,68.66666666666667,3,206,5186309.5,74.0,68.66666666666667
72634.0,6,10,2032,5,524,16247.0,252.0,104.8,5,1508,15911.25,1236.0,301.6
297701.0,6,6,412,4,272,99233.66666666669,74.0,68.0,2,140,0.0,74.0,70.0
32730.000000000004,6,10,2032,5,524,7975.0,252.0,104.8,5,1508,7930.0,1236.0,301.6
4266.0,17,2,602,1,72,0.0,72.0,72.0,1,530,0.0,530.0,530.0
114612856.0,6,36,2596,18,1348,6729224.823529412,139.0,74.88888888888889,18,1248,6729223.647058823,123.0,69.33333333333333
2958.0,17,2,224,1,76,0.0,76.0,76.0,1,148,0.0,148.0,148.0
247050.0,6,3,337,2,214,0.0,160.0,107.0,1,123,0.0,123.0,123.0
2473.0,17,4,344,2,150,0.0,75.0,75.0,2,194,0.0,103.0,97.0
52479.0,17,2,684,2,684,0.0,342.0,342.0,0,0,0.0,0.0,0.0
323241.0,17,4,1400,4,1400,107747.0,350.0,350.0,0,0,0.0,0.0,0.0
2020155.0,17,4,525,2,150,0.0,75.0,75.0,2,375,0.0,284.0,187.5
104564655.0,17,14,864,7,432,17334192.5,174.0,61.71428571428572,7,432,17166831.5,174.0,61.71428571428572
3063.0,17,2,224,1,76,0.0,76.0,76.0,1,148,0.0,148.0,148.0
305188.0,6,6,412,4,272,101729.33333333331,74.0,68.0,2,140,0.0,74.0,70.0
305.0,17,2,156,1,78,0.0,78.0,78.0,1,78,0.0,78.0,78.0
90097148.0,6,12,1848,5,1020,22523510.5,204.0,204.0,7,828,14971255.0,188.0,118.28571428571428
45381.0,6,14,4740,7,653,7398.833333333333,249.0,93.28571428571428,7,4087,6867.333333333333,1514.0,583.8571428571429
147902.0,17,2,180,1,90,0.0,90.0,90.0,1,90,0.0,90.0,90.0
135126067.0,17,6,1146,6,1146,27025213.4,191.0,191.0,0,0,0.0,0.0,0.0
143991.0,17,2,180,1,90,0.0,90.0,90.0,1,90,0.0,90.0,90.0
146203.0,6,3,337,2,214,0.0,160.0,107.0,1,123,0.0,123.0,123.0
2316.0,17,4,344,2,150,0.0,75.0,75.0,2,194,0.0,103.0,97.0
358.0,17,2,267,1,83,0.0,83.0,83.0,1,184,0.0,184.0,184.0
4224.0,17,2,614,1,72,0.0,72.0,72.0,1,542,0.0,542.0,542.0
120048500.0,17,29,13785,29,13785,4287446.428571428,501.0,475.3448275862069,0,0,0.0,0.0,0.0
38350.0,6,14,4740,7,653,6239.333333333333,249.0,93.28571428571428,7,4087,6128.666666666667,1514.0,583.8571428571429
328.0,17,2,166,1,75,0.0,75.0,75.0,1,91,0.0,91.0,91.0
112733759.0,6,32,2220,16,1149,7501206.333333333,123.0,71.8125,16,1071,7501189.2,123.0,66.9375
108106462.0,17,5,955,5,955,27026615.5,191.0,191.0,0,0,0.0,0.0,0.0
206899.0,6,3,426,2,280,0.0,214.0,140.0,1,146,0.0,146.0,146.0
45929.0,6,14,4740,7,653,7028.833333333333,249.0,93.28571428571428,7,4087,7426.666666666667,1514.0,583.8571428571429
146289.0,6,3,373,2,238,0.0,172.0,119.0,1,135,0.0,135.0,135.0
241125.0,6,3,373,2,238,0.0,172.0,119.0,1,135,0.0,135.0,135.0
10458663.0,6,7,478,4,272,3439813.333333333,74.0,68.0,3,206,5159583.5,74.0,68.66666666666667
90098304.0,6,11,1644,4,816,30032004.33333333,204.0,204.0,7,828,15015952.0,188.0,118.28571428571428
2474.0,17,4,344,2,150,0.0,75.0,75.0,2,194,0.0,103.0,97.0
320269.0,17,4,1400,4,1400,106756.33333333331,350.0,350.0,0,0,0.0,0.0,0.0
108109866.0,17,5,1005,5,1005,27027466.5,201.0,201.0,0,0,0.0,0.0,0.0
58771012.0,17,9,3086,8,2736,5107952.142857143,342.0,342.0,1,350,0.0,350.0,350.0
1173727.0,6,13,3011,8,2383,167675.2857142857,1514.0,297.875,5,628,225285.0,331.0,125.6
156694.0,6,3,337,2,214,0.0,160.0,107.0,1,123,0.0,123.0,123.0
31619.0,6,10,2032,5,524,7347.0,252.0,104.8,5,1508,7623.0,1236.0,301.6
217622.0,6,3,426,2,280,0.0,214.0,140.0,1,146,0.0,146.0,146.0
0.0,6,1,66,1,66,0.0,66.0,66.0,0,0,0.0,0.0,0.0
119570811.0,6,23,1734,11,840,11957081.1,95.0,76.36363636363636,12,894,10848181.363636363,95.0,74.5
216592.0,6,3,426,2,280,0.0,214.0,140.0,1,146,0.0,146.0,146.0
752471.0,6,2,132,1,66,0.0,66.0,66.0,1,66,0.0,66.0,66.0
90034697.0,17,28,13364,28,13364,3334618.407407407,501.0,477.2857142857143,0,0,0.0,0.0,0.0
53846.0,6,13,1386,7,789,8761.0,253.0,112.71428571428572,6,597,9295.4,259.0,99.5
682.0,17,2,762,2,762,0.0,381.0,381.0,0,0,0.0,0.0,0.0
422.0,17,2,410,1,78,0.0,78.0,78.0,1,332,0.0,332.0,332.0
90324550.0,6,202,22848,101,6888,897382.51,140.0,68.1980198019802,101,15960,895167.86,284.0,158.01980198019805
101113100.0,17,14,864,7,432,16834547.0,174.0,61.71428571428572,7,432,16833489.666666668,174.0,61.71428571428572
17842.0,6,14,4740,7,653,2826.1666666666665,249.0,93.28571428571428,7,4087,2836.333333333333,1514.0,583.8571428571429
108111753.0,17,5,1005,5,1005,27027938.25,201.0,201.0,0,0,0.0,0.0,0.0
70266.0,6,14,4740,7,653,11486.166666666666,249.0,93.28571428571428,7,4087,11552.833333333334,1514.0,583.8571428571429
299146.0,6,6,412,4,272,99715.33333333331,74.0,68.0,2,140,0.0,74.0,70.0
9721.0,17,2,582,1,83,0.0,83.0,83.0,1,499,0.0,499.0,499.0
43454.0,6,10,2032,5,524,10386.75,252.0,104.8,5,1508,10580.0,1236.0,301.6
50251.0,6,14,4740,7,653,8186.5,249.0,93.28571428571428,7,4087,8064.5,1514.0,583.8571428571429
311.0,17,2,208,1,72,0.0,72.0,72.0,1,136,0.0,136.0,136.0
108103766.0,17,5,1005,5,1005,27025941.5,201.0,201.0,0,0,0.0,0.0,0.0
112536880.0,6,30,1974,15,1026,8022911.5,123.0,68.4,15,948,8022917.0,123.0,63.2
120878414.0,6,33,2280,17,1209,7554900.875,123.0,71.11764705882354,16,1071,7378495.066666666,123.0,66.9375
323515.0,17,4,1400,4,1400,107838.33333333331,350.0,350.0,0,0,0.0,0.0,0.0
37036.0,6,14,4740,7,653,5080.5,249.0,93.28571428571428,7,4087,5616.333333333333,1514.0,583.8571428571429
204751.0,17,2,762,2,762,0.0,381.0,381.0,0,0,0.0,0.0,0.0
228150.0,17,2,180,1,90,0.0,90.0,90.0,1,90,0.0,90.0,90.0
148050.0,17,2,180,1,90,0.0,90.0,90.0,1,90,0.0,90.0,90.0
120213895.0,6,282,33746,141,9528,852848.8214285715,140.0,67.57446808510639,141,24218,852850.3785714286,336.0,171.75886524822695
73229.0,6,12,1328,6,731,13821.6,253.0,121.83333333333331,6,597,11086.6,259.0,99.5
108103411.0,17,5,1005,5,1005,27025852.75,201.0,201.0,0,0,0.0,0.0,0.0
9006791.0,17,4,300,4,300,3002263.6666666665,75.0,75.0,0,0,0.0,0.0,0.0
324.0,17,2,174,1,79,0.0,79.0,79.0,1,95,0.0,95.0,95.0
104130285.0,6,167,18828,84,5766,1254581.746987952,140.0,68.64285714285714,83,13062,1244825.048780488,284.0,157.3734939759036
99060.0,17,2,762,2,762,0.0,381.0,381.0,0,0,0.0,0.0,0.0
23956.0,6,14,4740,7,653,3874.3333333333335,249.0,93.28571428571428,7,4087,3811.8333333333335,1514.0,583.8571428571429
349.0,17,2,267,1,83,0.0,83.0,83.0,1,184,0.0,184.0,184.0
93063.0,6,13,1386,7,789,15510.5,253.0,112.71428571428572,6,597,18068.2,259.0,99.5
0.0,17,1,90,1,90,0.0,90.0,90.0,0,0,0.0,0.0,0.0
5614483.0,6,4,270,2,134,0.0,68.0,67.0,2,136,0.0,70.0,68.0
98549.0,17,2,762,2,762,0.0,381.0,381.0,0,0,0.0,0.0,0.0
90740682.0,6,170,19206,85,13374,1077684.119047619,284.0,157.34117647058824,85,5832,1077681.2738095238,140.0,68.61176470588235
107823.0,17,2,286,2,286,0.0,143.0,143.0,0,0,0.0,0.0,0.0
2015896.0,17,2,876,2,876,0.0,438.0,438.0,0,0,0.0,0.0,0.0
30621.0,6,14,4740,7,653,4897.0,249.0,93.28571428571428,7,4087,4816.833333333333,1514.0,583.8571428571429
2380.0,17,4,344,2,150,0.0,75.0,75.0,2,194,0.0,103.0,97.0
90255991.0,6,12,1832,8,1016,12893713.0,188.0,127.0,4,816,30030298.666666668,204.0,204.0
123250513.0,6,49,3234,25,1650,5135438.041666667,66.0,66.0,24,1584,5174780.695652174,66.0,66.0
17913.0,6,14,4740,7,653,2423.833333333333,249.0,93.28571428571428,7,4087,2846.333333333333,1514.0,583.8571428571429
42644.0,6,13,1386,7,789,7053.0,253.0,112.71428571428572,6,597,6561.2,259.0,99.5
232314.0,6,3,337,2,214,0.0,160.0,107.0,1,123,0.0,123.0,123.0
217803.0,17,2,180,1,90,0.0,90.0,90.0,1,90,0.0,90.0,90.0
10438739.0,6,7,478,4,272,3434051.333333333,74.0,68.0,3,206,5150949.5,74.0,68.66666666666667
90009204.0,17,27,12943,27,12943,3461892.461538461,501.0,479.3703703703704,0,0,0.0,0.0,0.0
194649.0,17,2,180,1,90,0.0,90.0,90.0,1,90,0.0,90.0,90.0
196974.0,17,2,180,1,90,0.0,90.0,90.0,1,90,0.0,90.0,90.0
205767.0,17,2,180,1,90,0.0,90.0,90.0,1,90,0.0,90.0,90.0
111315.0,17,2,286,2,286,0.0,143.0,143.0,0,0,0.0,0.0,0.0
351.0,17,2,267,1,83,0.0,83.0,83.0,1,184,0.0,184.0,184.0
32432.000000000004,6,14,4740,7,653,5036.666666666667,249.0,93.28571428571428,7,4087,4601.666666666667,1514.0,583.8571428571429
14125.0,6,10,1067,5,536,3237.5,264.0,107.2,5,531,3071.0,259.0,106.2
149477.0,6,3,337,2,214,0.0,160.0,107.0,1,123,0.0,123.0,123.0
303.0,17,2,156,1,78,0.0,78.0,78.0,1,78,0.0,78.0,78.0
120158686.0,6,212,23980,106,7292,1128310.5333333334,140.0,68.79245283018868,106,16688,1136498.1523809524,284.0,157.43396226415095
211193.0,17,2,180,1,90,0.0,90.0,90.0,1,90,0.0,90.0,90.0
9696.0,17,2,582,1,83,0.0,83.0,83.0,1,499,0.0,499.0,499.0
127968.0,6,2,132,1,66,0.0,66.0,66.0,1,66,0.0,66.0,66.0
9743.0,17,2,539,1,86,0.0,86.0,86.0,1,453,0.0,453.0,453.0
2365925.0,6,25,7573,14,3735,181994.2307692308,1514.0,266.7857142857143,11,3838,210901.2,1514.0,348.90909090909093
242831.0,17,2,180,1,90,0.0,90.0,90.0,1,90,0.0,90.0,90.0
227808.0,17,2,180,1,90,0.0,90.0,90.0,1,90,0.0,90.0,90.0
268176.0,6,3,337,2,214,0.0,160.0,107.0,1,123,0.0,123.0,123.0
37584.0,6,10,2032,5,524,8986.0,252.0,104.8,5,1508,9124.0,1236.0,301.6
45524.0,6,14,4740,7,653,7194.166666666667,249.0,93.28571428571428,7,4087,7156.666666666667,1514.0,583.8571428571429
2518.0,17,4,344,2,150,0.0,75.0,75.0,2,194,0.0,103.0,97.0
6148.0,6,5,578,3,438,1850.5,298.0,146.0,2,140,0.0,74.0,70.0
1306914.0,6,4,264,2,132,0.0,66.0,66.0,2,132,0.0,66.0,66.0
313.0,17,2,174,1,79,0.0,79.0,79.0,1,95,0.0,95.0,95.0
2107171.0,6,24,7544,12,2450,191561.0,1034.0,204.16666666666663,12,5094,163417.81818181818,1510.0,424.5
160016.0,6,2,128,1,74,0.0,74.0,74.0,1,54,0.0,54.0,54.0
281245.0,17,2,363,1,79,0.0,79.0,79.0,1,284,0.0,284.0,284.0
103640.0,17,2,286,2,286,0.0,143.0,143.0,0,0,0.0,0.0,0.0
90300554.0,6,17,1287,9,691,11281434.0,95.0,76.77777777777777,8,596,12898863.0,95.0,74.5
36002.0,6,12,1413,7,882,6000.333333333333,291.0,126.0,5,531,7284.25,259.0,106.2
213602.0,6,4,492,2,280,0.0,214.0,140.0,2,212,0.0,146.0,106.0
90227620.0,6,22,1680,10,786,9996843.888888888,95.0,78.6,12,894,8182870.0,95.0,74.5
135129606.0,17,6,1146,6,1146,27025921.2,191.0,191.0,0,0,0.0,0.0,0.0
308727.0,6,6,412,4,272,102909.0,74.0,68.0,2,140,0.0,74.0,70.0
37669.0,6,14,4740,7,653,5518.666666666667,249.0,93.28571428571428,7,4087,6046.0,1514.0,583.8571428571429
46327.0,6,2,132,1,66,0.0,66.0,66.0,1,66,0.0,66.0,66.0
145369.0,6,3,337,2,214,0.0,160.0,107.0,1,123,0.0,123.0,123.0
1189752.0,6,13,3010,8,2382,169964.57142857142,1514.0,297.75,5,628,228563.25,331.0,125.6
228255.0,17,2,180,1,90,0.0,90.0,90.0,1,90,0.0,90.0,90.0
282308.0,17,2,180,1,90,0.0,90.0,90.0,1,90,0.0,90.0,90.0
826.0,17,4,438,2,148,0.0,74.0,74.0,2,290,0.0,147.0,145.0
436408.0,6,11,1021,6,444,58559.0,162.0,74.0,5,577,73030.75,349.0,115.4
25807.0,6,10,2032,5,524,6218.75,252.0,104.8,5,1508,6185.25,1236.0,301.6
119351146.0,6,23,1693,12,894,10850104.181818182,95.0,74.5,11,799,11909494.6,95.0,72.63636363636364
300339.0,6,6,412,4,272,100113.0,74.0,68.0,2,140,0.0,74.0,70.0
302537.0,6,6,412,4,272,100845.66666666669,74.0,68.0,2,140,0.0,74.0,70.0
319534.0,6,6,412,4,272,106511.33333333331,74.0,68.0,2,140,0.0,74.0,70.0
108727269.0,6,36,2596,18,1348,6383023.647058823,139.0,74.88888888888889,18,1248,6383022.529411765,123.0,69.33333333333333
90091799.0,6,12,1848,5,1020,22522365.0,204.0,204.0,7,828,15014838.5,188.0,118.28571428571428
120145243.0,6,224,25312,112,7688,1075102.972972973,140.0,68.64285714285714,112,17624,1081165.9279279278,284.0,157.35714285714286
232703.0,6,3,373,2,238,0.0,172.0,119.0,1,135,0.0,135.0,135.0
14911.0,17,2,180,1,90,0.0,90.0,90.0,1,90,0.0,90.0,90.0
61736.0,6,13,1386,7,789,9554.5,253.0,112.71428571428572,6,597,11470.2,259.0,99.5
90033699.0,17,28,13364,28,13364,3334581.4444444445,501.0,477.2857142857143,0,0,0.0,0.0,0.0
93585883.0,17,12,778,6,389,18597330.0,174.0,64.83333333333333,6,389,18600157.4,174.0,64.83333333333333
3448.0,17,2,359,1,75,0.0,75.0,75.0,1,284,0.0,284.0,284.0
4348.0,17,2,582,1,83,0.0,83.0,83.0,1,499,0.0,499.0,499.0
120115221.0,6,13,2036,8,1016,17135283.57142857,188.0,127.0,5,1020,22524456.5,204.0,204.0
18551.0,6,14,4740,7,653,2884.6666666666665,249.0,93.28571428571428,7,4087,2539.333333333333,1514.0,583.8571428571429
35721.0,6,14,4740,7,653,5740.666666666667,249.0,93.28571428571428,7,4087,5471.166666666667,1514.0,583.8571428571429
94230491.0,17,12,778,6,389,18801600.2,174.0,64.83333333333333,6,389,18800152.2,174.0,64.83333333333333
114978716.0,6,37,2788,19,1471,6387706.444444444,139.0,77.42105263157895,18,1317,6750740.882352941,123.0,73.16666666666667
90021038.0,17,28,13364,28,13364,3334112.5185185187,501.0,477.2857142857143,0,0,0.0,0.0,0.0
1416120.0,17,16,1120,16,1120,94408.0,70.0,70.0,0,0,0.0,0.0,0.0
196996.0,17,2,180,1,90,0.0,90.0,90.0,1,90,0.0,90.0,90.0
100173085.0,6,28,1876,14,982,7689020.076923077,139.0,70.14285714285714,14,894,7689022.846153846,123.0,63.85714285714285
117153.0,17,4,1400,4,1400,39051.0,350.0,350.0,0,0,0.0,0.0,0.0
107080.0,17,2,286,2,286,0.0,143.0,143.0,0,0,0.0,0.0,0.0
346.0,17,2,250,1,93,0.0,93.0,93.0,1,157,0.0,157.0,157.0
1174180.0,6,13,3020,8,2392,167740.0,1514.0,299.0,5,628,225396.25,331.0,125.6
25499.0,6,10,1065,5,534,6210.0,262.0,106.8,5,531,5664.75,259.0,106.2
5832997.0,6,5,336,2,134,0.0,68.0,67.0,3,202,1528637.0,70.0,67.33333333333333
16267.0,6,14,4740,7,653,2239.0,249.0,93.28571428571428,7,4087,2577.6666666666665,1514.0,583.8571428571429
40447.0,6,11,2098,6,590,8013.0,252.0,98.33333333333331,5,1508,9375.25,1236.0,301.6
14896.0,17,2,180,1,90,0.0,90.0,90.0,1,90,0.0,90.0,90.0
108630010.0,6,45,2970,23,1518,4922696.818181818,66.0,66.0,22,1452,5157003.095238095,66.0,66.0
51489.0,6,14,4740,7,653,8457.833333333334,249.0,93.28571428571428,7,4087,8438.333333333334,1514.0,583.8571428571429
135126907.0,17,6,1146,6,1146,27025381.4,191.0,191.0,0,0,0.0,0.0,0.0
29382.0,6,13,1386,7,789,4379.833333333333,253.0,112.71428571428572,6,597,4668.2,259.0,99.5
82953.0,6,10,1065,5,534,20312.5,262.0,106.8,5,531,18434.75,259.0,106.2
31960.000000000004,6,11,2098,6,590,6392.0,252.0,98.33333333333331,5,1508,7221.75,1236.0,301.6
229102.0,17,2,180,1,90,0.0,90.0,90.0,1,90,0.0,90.0,90.0
135145424.0,17,6,1146,6,1146,27029084.8,191.0,191.0,0,0,0.0,0.0,0.0
2451597.0,6,25,7573,14,3735,188584.38461538465,1514.0,266.7857142857143,11,3838,218308.5,1514.0,348.90909090909093
108110274.0,17,5,955,5,955,27027568.5,191.0,191.0,0,0,0.0,0.0,0.0
54204.0,6,14,4740,7,653,8302.666666666666,249.0,93.28571428571428,7,4087,6408.666666666667,1514.0,583.8571428571429
118660635.0,6,33,2274,17,1125,7416264.5,123.0,66.17647058823529,16,1149,7244961.4,123.0,71.8125
300564.0,6,6,412,4,272,100188.0,74.0,68.0,2,140,0.0,74.0,70.0
97072340.0,17,14,1126,7,563,16167348.0,174.0,80.42857142857143,7,563,16166799.833333334,174.0,80.42857142857143
510733.0,6,5,336,2,134,0.0,68.0,67.0,3,202,197969.5,70.0,67.33333333333333
103541.0,17,2,286,2,286,0.0,143.0,143.0,0,0,0.0,0.0,0.0
330443.0,6,6,412,4,272,110147.66666666669,74.0,68.0,2,140,0.0,74.0,70.0
28183.0,6,14,4740,7,653,4578.166666666667,249.0,93.28571428571428,7,4087,4563.333333333333,1514.0,583.8571428571429
35716.0,6,10,2032,5,524,8712.25,252.0,104.8,5,1508,8364.75,1236.0,301.6
2381991.0,6,25,7573,14,3735,183230.0769230769,1514.0,266.7857142857143,11,3838,211727.3,1514.0,348.90909090909093
207519.0,6,3,426,2,280,0.0,214.0,140.0,1,146,0.0,146.0,146.0
1032637.0,6,11,1134,6,558,206527.4,220.0,93.0,5,576,257101.5,304.0,115.2
437.0,17,2,267,1,83,0.0,83.0,83.0,1,184,0.0,184.0,184.0
97207987.0,17,12,778,6,389,19409811.4,174.0,64.83333333333333,6,389,19186228.6,174.0,64.83333333333333
38244.0,6,14,4740,7,653,6238.166666666667,249.0,93.28571428571428,7,4087,5699.333333333333,1514.0,583.8571428571429
119068610.0,6,48,3168,24,1584,5176896.0869565215,66.0,66.0,24,1584,5163224.173913044,66.0,66.0
108109035.0,17,5,1005,5,1005,27027258.75,201.0,201.0,0,0,0.0,0.0,0.0
148101.0,6,3,337,2,214,0.0,160.0,107.0,1,123,0.0,123.0,123.0
143969.0,17,2,180,1,90,0.0,90.0,90.0,1,90,0.0,90.0,90.0
3101489.0,6,167,128665,91,119347,34460.98888888889,1510.0,1311.5054945054944,76,9318,37144.64,1510.0,122.60526315789474
2085.0,17,4,344,2,150,0.0,75.0,75.0,2,194,0.0,103.0,97.0
2402.0,17,2,762,2,762,0.0,381.0,381.0,0,0,0.0,0.0,0.0
0.0,6,1,66,1,66,0.0,66.0,66.0,0,0,0.0,0.0,0.0
112506066.0,6,36,2734,19,1471,6250337.0,139.0,77.42105263157895,17,1263,7016962.125,123.0,74.29411764705883
311191.0,17,4,1400,4,1400,103730.33333333331,350.0,350.0,0,0,0.0,0.0,0.0
2842.0,17,4,438,2,148,0.0,74.0,74.0,2,290,0.0,147.0,145.0
38703.0,6,10,2032,5,524,9220.5,252.0,104.8,5,1508,8607.75,1236.0,301.6
90259721.0,6,12,1832,8,1016,12894245.857142856,188.0,127.0,4,816,30031553.666666668,204.0,204.0
15716.0,6,10,1067,5,536,3765.25,264.0,107.2,5,531,3207.5,259.0,106.2
205872.0,6,3,426,2,280,0.0,214.0,140.0,1,146,0.0,146.0,146.0
1295773.0,6,4,264,2,132,0.0,66.0,66.0,2,132,0.0,66.0,66.0
75652.0,6,14,4740,7,653,12075.666666666666,249.0,93.28571428571428,7,4087,12365.666666666666,1514.0,583.8571428571429
147073.0,6,3,373,2,238,0.0,172.0,119.0,1,135,0.0,135.0,135.0
9112.0,17,2,582,1,83,0.0,83.0,83.0,1,499,0.0,499.0,499.0
1321481.0,6,4,264,2,132,0.0,66.0,66.0,2,132,0.0,66.0,66.0
237362.0,17,2,762,2,762,0.0,381.0,381.0,0,0,0.0,0.0,0.0
338429.0,6,10,1221,6,636,67685.8,298.0,106.0,4,585,106772.0,379.0,146.25
10469866.0,6,7,478,4,272,3444616.333333333,74.0,68.0,3,206,5166820.5,74.0,68.66666666666667
262207.0,6,3,337,2,214,0.0,160.0,107.0,1,123,0.0,123.0,123.0
43981.0,6,12,1320,7,789,7330.166666666667,253.0,112.71428571428572,5,531,9029.0,259.0,106.2
108114175.0,17,5,1005,5,1005,27028543.75,201.0,201.0,0,0,0.0,0.0,0.0
153472.0,17,2,180,1,90,0.0,90.0,90.0,1,90,0.0,90.0,90.0
2322.0,17,4,344,2,150,0.0,75.0,75.0,2,194,0.0,103.0,97.0
10483836.0,6,7,478,4,272,3448875.0,74.0,68.0,3,206,5173221.0,74.0,68.66666666666667
2358591.0,6,25,7573,14,3735,181430.0769230769,1514.0,266.7857142857143,11,3838,209004.0,1514.0,348.90909090909093
211926.0,6,3,426,2,280,0.0,214.0,140.0,1,146,0.0,146.0,146.0
124001131.0,17,15,907,8,475,17714447.285714287,174.0,59.375,7,432,17334288.333333332,174.0,61.71428571428572
9906.0,17,2,582,1,83,0.0,83.0,83.0,1,499,0.0,499.0,499.0
228483.0,17,2,180,1,90,0.0,90.0,90.0,1,90,0.0,90.0,90.0
1043.0,17,2,762,2,762,0.0,381.0,381.0,0,0,0.0,0.0,0.0
117384291.0,6,231,26006,116,18120,1020732.9652173911,284.0,156.20689655172413,115,7886,1022665.701754386,140.0,68.57391304347826
228444.0,17,2,180,1,90,0.0,90.0,90.0,1,90,0.0,90.0,90.0
108105576.0,17,5,1005,5,1005,27026394.0,201.0,201.0,0,0,0.0,0.0,0.0
97831.0,17,2,762,2,762,0.0,381.0,381.0,0,0,0.0,0.0,0.0
49518.0,6,14,4740,7,653,8080.666666666667,249.0,93.28571428571428,7,4087,7532.5,1514.0,583.8571428571429
90257631.0,6,14,2240,8,1016,12893947.285714284,188.0,127.0,6,1224,18018611.8,204.0,204.0
298744.0,6,6,412,4,272,99581.33333333331,74.0,68.0,2,140,0.0,74.0,70.0
2056.0,17,4,344,2,150,0.0,75.0,75.0,2,194,0.0,103.0,97.0
2418.0,17,4,344,2,150,0.0,75.0,75.0,2,194,0.0,103.0,97.0
335028.0,17,2,180,1,90,0.0,90.0,90.0,1,90,0.0,90.0,90.0
2412.0,17,4,344,2,150,0.0,75.0,75.0,2,194,0.0,103.0,97.0
122671.0,6,3,337,2,214,0.0,160.0,107.0,1,123,0.0,123.0,123.0
23037.0,6,14,4740,7,653,3570.6666666666665,249.0,93.28571428571428,7,4087,3662.0,1514.0,583.8571428571429
120117688.0,6,13,2036,8,1016,17136443.0,188.0,127.0,5,1020,22517550.25,204.0,204.0
36059.0,6,14,4740,7,653,5861.5,249.0,93.28571428571428,7,4087,5795.833333333333,1514.0,583.8571428571429
31115.0,6,14,4740,7,653,4164.5,249.0,93.28571428571428,7,4087,5051.0,1514.0,583.8571428571429
209373.0,17,2,180,1,90,0.0,90.0,90.0,1,90,0.0,90.0,90.0
20932199.0,17,3,1034,2,684,0.0,342.0,342.0,1,350,0.0,350.0,350.0
11440.0,6,10,1949,5,441,2638.5,169.0,88.2,5,1508,2572.5,1236.0,301.6
3177.0,17,2,224,1,76,0.0,76.0,76.0,1,148,0.0,148.0,148.0
506849.0,6,5,336,2,134,0.0,68.0,67.0,3,202,190792.0,70.0,67.33333333333333
90264029.0,6,12,1832,8,1016,12894861.285714284,188.0,127.0,4,816,30031624.0,204.0,204.0
316125.0,17,4,1400,4,1400,105375.0,350.0,350.0,0,0,0.0,0.0,0.0
10434149.0,6,7,478,4,272,3432391.0,74.0,68.0,3,206,5148470.5,74.0,68.66666666666667
118616249.0,6,208,23568,104,16482,1149523.6213592233,284.0,158.48076923076923,104,7086,1149523.650485437,140.0,68.13461538461539
228028.0,6,3,426,2,280,0.0,214.0,140.0,1,146,0.0,146.0,146.0
246779.0,6,3,337,2,214,0.0,160.0,107.0,1,123,0.0,123.0,123.0
624356.0,6,12,1354,6,723,123993.4,253.0,120.5,6,631,123868.0,293.0,105.16666666666669
122169.0,6,3,373,2,238,0.0,172.0,119.0,1,135,0.0,135.0,135.0
26830.0,6,14,4740,7,653,4318.333333333333,249.0,93.28571428571428,7,4087,4260.5,1514.0,583.8571428571429
57102.0,6,14,4740,7,653,9354.0,249.0,93.28571428571428,7,4087,9359.166666666666,1514.0,583.8571428571429
1207668.0,17,7,490,7,490,201278.0,70.0,70.0,0,0,0.0,0.0,0.0
206264.0,6,3,426,2,280,0.0,214.0,140.0,1,146,0.0,146.0,146.0
116729038.0,6,48,3168,24,1584,5075175.565217392,66.0,66.0,24,1584,5061909.913043479,66.0,66.0
92172449.0,6,168,19000,84,13234,1107918.156626506,284.0,157.54761904761904,84,5766,1107918.3855421687,140.0,68.64285714285714
120117663.0,6,14,2224,9,1204,15014707.875,188.0,133.77777777777777,5,1020,22522447.75,204.0,204.0
2767170.0,6,2,132,1,66,0.0,66.0,66.0,1,66,0.0,66.0,66.0
90314342.0,6,14,2102,8,1016,12902048.857142856,188.0,127.0,6,1086,18029680.2,204.0,181.0
228331.0,17,2,180,1,90,0.0,90.0,90.0,1,90,0.0,90.0,90.0
9379.0,17,2,582,1,83,0.0,83.0,83.0,1,499,0.0,499.0,499.0
209678.0,6,3,426,2,280,0.0,214.0,140.0,1,146,0.0,146.0,146.0
14630384.0,6,20,1607,10,975,1592119.0,315.0,97.5,10,632,1592091.7777777778,78.0,63.2
2962.0,17,2,224,1,76,0.0,76.0,76.0,1,148,0.0,148.0,148.0
216665.0,6,3,426,2,280,0.0,214.0,140.0,1,146,0.0,146.0,146.0
2401.0,17,4,344,2,150,0.0,75.0,75.0,2,194,0.0,103.0,97.0
166113.0,17,4,571,2,148,0.0,74.0,74.0,2,423,0.0,280.0,211.5
302336.0,6,6,412,4,272,100778.66666666669,74.0,68.0,2,140,0.0,74.0,70.0
93130211.0,17,12,778,6,389,18600157.8,174.0,64.83333333333333,6,389,18600587.6,174.0,64.83333333333333
108161.0,17,2,286,2,286,0.0,143.0,143.0,0,0,0.0,0.0,0.0
105797855.0,6,28,1876,14,982,8121693.538461538,139.0,70.14285714285714,14,894,8121693.076923077,123.0,63.85714285714285
2336.0,17,4,344,2,150,0.0,75.0,75.0,2,194,0.0,103.0,97.0
313.0,17,2,174,1,79,0.0,79.0,79.0,1,95,0.0,95.0,95.0
121360.0,6,3,337,2,214,0.0,160.0,107.0,1,123,0.0,123.0,123.0
108106642.0,17,5,955,5,955,27026660.5,191.0,191.0,0,0,0.0,0.0,0.0
2407.0,17,4,344,2,150,0.0,75.0,75.0,2,194,0.0,103.0,97.0
6975.0,17,4,823,2,163,0.0,89.0,81.5,2,660,0.0,443.0,330.0
108303409.0,6,30,2106,15,1089,7720525.714285715,123.0,72.6,15,1017,7720519.0,123.0,67.8
302386.0,6,2,132,1,66,0.0,66.0,66.0,1,66,0.0,66.0,66.0
171640.0,17,2,180,1,90,0.0,90.0,90.0,1,90,0.0,90.0,90.0
29330.0,6,14,4740,7,653,4704.166666666667,249.0,93.28571428571428,7,4087,4332.833333333333,1514.0,583.8571428571429
119539272.0,6,211,23946,106,16794,1138469.2571428572,284.0,158.43396226415095,105,7152,1139523.0,140.0,68.11428571428571
219571.0,6,3,426,2,280,0.0,214.0,140.0,1,146,0.0,146.0,146.0
90020776.0,17,28,13364,28,13364,3334102.814814815,501.0,477.2857142857143,0,0,0.0,0.0,0.0
2793518.0,6,2,132,1,66,0.0,66.0,66.0,1,66,0.0,66.0,66.0
90070877.0,17,28,13364,28,13364,3335958.407407407,501.0,477.2857142857143,0,0,0.0,0.0,0.0
236365.0,6,3,337,2,214,0.0,160.0,107.0,1,123,0.0,123.0,123.0
504739.00000000006,6,4,270,2,134,0.0,68.0,67.0,2,136,0.0,70.0,68.0
108114320.0,17,5,1005,5,1005,27028580.0,201.0,201.0,0,0,0.0,0.0,0.0
99593.0,17,2,762,2,762,0.0,381.0,381.0,0,0,0.0,0.0,0.0
120152072.0,6,2455,2126310,1697,2076282,70844.3820754717,1514.0,1223.5014731879787,758,50028,158407.56803170408,66.0,66.0
14048.0,6,11,2098,6,590,2699.4,252.0,98.33333333333331,5,1508,2879.0,1236.0,301.6
121817612.0,6,31,2166,15,1017,7987997.714285715,123.0,67.8,16,1149,7455462.533333333,123.0,71.8125
90536002.0,6,14,2240,8,1016,12933714.57142857,188.0,127.0,6,1224,18074199.6,204.0,204.0
206586.0,17,2,180,1,90,0.0,90.0,90.0,1,90,0.0,90.0,90.0
111006921.0,17,15,1169,8,606,15858131.57142857,174.0,75.75,7,563,15166824.5,174.0,80.42857142857143
233099.0,6,3,373,2,238,0.0,172.0,119.0,1,135,0.0,135.0,135.0
171634.0,17,2,180,1,90,0.0,90.0,90.0,1,90,0.0,90.0,90.0
18707.0,6,2,145,2,145,0.0,91.0,72.5,0,0,0.0,0.0,0.0
108102573.0,17,5,1005,5,1005,27025643.25,201.0,201.0,0,0,0.0,0.0,0.0
4856.0,17,4,344,2,150,0.0,75.0,75.0,2,194,0.0,103.0,97.0
259565.0,6,3,337,2,214,0.0,160.0,107.0,1,123,0.0,123.0,123.0
128001353.0,17,15,907,8,475,18285907.57142857,174.0,59.375,7,432,18000951.166666668,174.0,61.71428571428572
218182.0,17,2,359,1,75,0.0,75.0,75.0,1,284,0.0,284.0,284.0
206183.0,17,2,180,1,90,0.0,90.0,90.0,1,90,0.0,90.0,90.0
82.0,17,2,762,2,762,0.0,381.0,381.0,0,0,0.0,0.0,0.0
14204.0,6,14,4740,7,653,2060.6666666666665,249.0,93.28571428571428,7,4087,2225.5,1514.0,583.8571428571429
120122215.0,6,14,2224,9,1204,15015276.875,188.0,133.77777777777777,5,1020,22522691.0,204.0,204.0
205791.0,17,2,180,1,90,0.0,90.0,90.0,1,90,0.0,90.0,90.0
13614515.0,17,6,2052,6,2052,2722903.0,342.0,342.0,0,0,0.0,0.0,0.0
39030.0,6,14,4740,7,653,6392.833333333333,249.0,93.28571428571428,7,4087,6266.0,1514.0,583.8571428571429
1312357.0,17,7,490,7,490,218726.16666666663,70.0,70.0,0,0,0.0,0.0,0.0
342.0,17,2,214,1,75,0.0,75.0,75.0,1,139,0.0,139.0,139.0
141746.0,6,2,132,1,66,0.0,66.0,66.0,1,66,0.0,66.0,66.0
402385.0,6,4,508,2,238,0.0,172.0,119.0,2,270,0.0,135.0,135.0
27337.0,6,14,4740,7,653,4015.0,249.0,93.28571428571428,7,4087,4221.333333333333,1514.0,583.8571428571429
135130979.0,17,6,1206,6,1206,27026195.8,201.0,201.0,0,0,0.0,0.0,0.0
2338.0,17,4,344,2,150,0.0,75.0,75.0,2,194,0.0,103.0,97.0
145746.0,6,3,337,2,214,0.0,160.0,107.0,1,123,0.0,123.0,123.0
123250446.0,6,49,3234,25,1650,5135435.25,66.0,66.0,24,1584,5100409.478260869,66.0,66.0
192895.0,17,2,180,1,90,0.0,90.0,90.0,1,90,0.0,90.0,90.0
104940290.0,6,44,2904,22,1452,4997156.666666667,66.0,66.0,22,1452,4982231.19047619,66.0,66.0
90296003.0,6,16,1192,8,596,12893036.714285716,95.0,74.5,8,596,12897757.142857144,95.0,74.5
10461203.0,6,7,478,4,272,3441572.333333333,74.0,68.0,3,206,5162254.0,74.0,68.66666666666667
363.0,17,2,267,1,83,0.0,83.0,83.0,1,184,0.0,184.0,184.0
316077.0,17,4,1400,4,1400,105359.0,350.0,350.0,0,0,0.0,0.0,0.0
2597408.0,6,2,132,1,66,0.0,66.0,66.0,1,66,0.0,66.0,66.0
320361.0,17,4,1400,4,1400,106787.0,350.0,350.0,0,0,0.0,0.0,0.0
794.0,17,5,550,5,550,198.5,110.0,110.0,0,0,0.0,0.0,0.0
33281.0,6,14,4740,7,653,5371.666666666667,249.0,93.28571428571428,7,4087,5279.333333333333,1514.0,583.8571428571429
9190.0,17,2,498,1,80,0.0,80.0,80.0,1,418,0.0,418.0,418.0
291232.0,17,2,246,1,76,0.0,76.0,76.0,1,170,0.0,170.0,170.0
233003.0,6,3,337,2,214,0.0,160.0,107.0,1,123,0.0,123.0,123.0
10503691.0,6,7,478,4,272,3455531.333333333,74.0,68.0,3,206,5183175.0,74.0,68.66666666666667
4336725.0,6,11,1134,6,558,867345.0,220.0,93.0,5,576,1082678.75,304.0,115.2
18946.0,17,2,582,1,83,0.0,83.0,83.0,1,499,0.0,499.0,499.0
540578.0,17,6,2100,6,2100,108115.6,350.0,350.0,0,0,0.0,0.0,0.0
410.0,17,2,508,2,508,0.0,257.0,254.0,0,0,0.0,0.0,0.0
66029.0,6,10,2032,5,524,13843.0,252.0,104.8,5,1508,14202.75,1236.0,301.6
90534604.0,6,14,2240,8,1016,12933514.857142856,188.0,127.0,6,1224,18074715.2,204.0,204.0
16725.0,17,2,180,1,90,0.0,90.0,90.0,1,90,0.0,90.0,90.0
216846.0,6,3,426,2,280,0.0,214.0,140.0,1,146,0.0,146.0,146.0
14642521.0,6,20,1607,10,975,1593804.2222222222,315.0,97.5,10,632,1593776.3333333333,78.0,63.2
37998.0,6,10,2032,5,524,9256.75,252.0,104.8,5,1508,9059.25,1236.0,301.6
109661.0,17,2,286,2,286,0.0,143.0,143.0,0,0,0.0,0.0,0.0
281630.0,17,2,180,1,90,0.0,90.0,90.0,1,90,0.0,90.0,90.0
316039.0,17,4,1400,4,1400,105346.33333333331,350.0,350.0,0,0,0.0,0.0,0.0
27754.0,6,14,4740,7,653,4515.833333333333,249.0,93.28571428571428,7,4087,4340.333333333333,1514.0,583.8571428571429
347.0,17,2,174,1,79,0.0,79.0,79.0,1,95,0.0,95.0,95.0
6911.0,17,2,582,1,83,0.0,83.0,83.0,1,499,0.0,499.0,499.0
326.0,17,2,160,1,80,0.0,80.0,80.0,1,80,0.0,80.0,80.0
135126271.0,17,6,1206,6,1206,27025254.2,201.0,201.0,0,0,0.0,0.0,0.0
317065.0,17,2,238,1,74,0.0,74.0,74.0,1,164,0.0,164.0,164.0
39075.0,6,10,2032,5,524,8662.5,252.0,104.8,5,1508,9473.5,1236.0,301.6
218368.0,6,3,426,2,280,0.0,214.0,140.0,1,146,0.0,146.0,146.0
512047.00000000006,6,5,336,2,134,0.0,68.0,67.0,3,202,192751.0,70.0,67.33333333333333
87224.0,17,2,762,2,762,0.0,381.0,381.0,0,0,0.0,0.0,0.0
324483.0,17,4,1400,4,1400,108161.0,350.0,350.0,0,0,0.0,0.0,0.0
48431.0,6,14,4740,7,653,7941.833333333333,249.0,93.28571428571428,7,4087,7891.833333333333,1514.0,583.8571428571429
3018220.0,6,3,204,2,136,0.0,70.0,68.0,1,68,0.0,68.0,68.0
0.0,17,1,161,1,161,0.0,161.0,161.0,0,0,0.0,0.0,0.0
48905.0,6,10,2032,5,524,11989.5,252.0,104.8,5,1508,11777.5,1236.0,301.6
135141933.0,17,6,1146,6,1146,27028386.6,191.0,191.0,0,0,0.0,0.0,0.0
185956.0,6,24,11197,13,1027,15496.333333333334,227.0,79.0,11,10170,17677.4,1514.0,924.5454545454544
90258731.0,6,12,1832,8,1016,12894104.42857143,188.0,127.0,4,816,30031503.33333333,204.0,204.0
108095030.0,17,5,1005,5,1005,27023757.5,201.0,201.0,0,0,0.0,0.0,0.0
5827872.0,6,5,336,2,134,0.0,68.0,67.0,3,202,1528323.5,70.0,67.33333333333333
232466.0,6,3,373,2,238,0.0,172.0,119.0,1,135,0.0,135.0,135.0
14983.0,17,2,180,1,90,0.0,90.0,90.0,1,90,0.0,90.0,90.0
90745507.0,6,17,1287,9,691,11337536.25,95.0,76.77777777777777,8,596,12962058.142857144,95.0,74.5
103334.0,17,2,286,2,286,0.0,143.0,143.0,0,0,0.0,0.0,0.0
108188443.0,6,44,2904,22,1452,5151830.619047619,66.0,66.0,22,1452,5137134.857142857,66.0,66.0
90046705.0,17,28,13364,28,13364,3335063.1481481483,501.0,477.2857142857143,0,0,0.0,0.0,0.0
90096042.0,6,11,1644,7,828,15016007.0,188.0,118.28571428571428,4,816,20021729.33333333,204.0,204.0
115376917.0,6,34,2350,17,1225,7197566.5,139.0,72.05882352941177,17,1125,7197564.9375,123.0,66.17647058823529
10437994.0,6,6,412,3,206,5150713.5,74.0,68.66666666666667,3,206,5150597.5,74.0,68.66666666666667
108103473.0,17,5,1005,5,1005,27025868.25,201.0,201.0,0,0,0.0,0.0,0.0
120809545.0,6,31,2182,15,1017,7916079.571428572,123.0,67.8,16,1165,7388328.933333334,139.0,72.8125
109758212.0,6,28,1876,14,982,8426331.076923076,139.0,70.14285714285714,14,894,8426340.307692308,123.0,63.85714285714285
153384.0,17,2,180,1,90,0.0,90.0,90.0,1,90,0.0,90.0,90.0
120398597.0,17,13,821,7,432,20066432.83333333,174.0,61.71428571428572,6,389,20050780.6,174.0,64.83333333333333
54596.0,6,10,2032,5,524,12896.0,252.0,104.8,5,1508,10666.75,1236.0,301.6
9672.0,17,4,823,2,163,0.0,89.0,81.5,2,660,0.0,443.0,330.0
4646.0,17,2,626,1,72,0.0,72.0,72.0,1,554,0.0,554.0,554.0
2118653.0,6,18,6803,10,1501,235405.88888888888,408.0,150.1,8,5302,239996.8571428572,1514.0,662.75
90526028.0,6,13,2036,8,1016,12932289.714285716,188.0,127.0,5,1020,22590693.5,204.0,204.0
148098.0,17,2,180,1,90,0.0,90.0,90.0,1,90,0.0,90.0,90.0
297646.0,6,6,412,4,272,99215.33333333331,74.0,68.0,2,140,0.0,74.0,70.0
317630.0,17,4,1400,4,1400,105876.66666666669,350.0,350.0,0,0,0.0,0.0,0.0
238006.0,17,4,1400,4,1400,79335.33333333333,350.0,350.0,0,0,0.0,0.0,0.0
2101.0,17,4,344,2,150,0.0,75.0,75.0,2,194,0.0,103.0,97.0
103442.0,17,2,286,2,286,0.0,143.0,143.0,0,0,0.0,0.0,0.0
3086.0,17,4,344,2,150,0.0,75.0,75.0,2,194,0.0,103.0,97.0
17029.0,6,10,2032,5,524,4016.75,252.0,104.8,5,1508,3985.0,1236.0,301.6
45912.0,6,13,4416,6,409,8972.2,127.0,68.16666666666667,7,4007,7236.333333333333,1514.0,572.4285714285714
113260319.0,6,207,23444,104,7160,1099614.7475728155,140.0,68.84615384615384,103,16284,1101272.274509804,284.0,158.09708737864077
333459.0,6,6,412,4,272,111153.0,74.0,68.0,2,140,0.0,74.0,70.0
2005103.0,17,4,525,2,150,0.0,75.0,75.0,2,375,0.0,284.0,187.5
1313508.0,6,4,264,2,132,0.0,66.0,66.0,2,132,0.0,66.0,66.0
27584379.0,17,5,1710,5,1710,6896094.75,342.0,342.0,0,0,0.0,0.0,0.0
14643659.0,6,20,1607,10,975,1592665.111111111,315.0,97.5,10,632,1592559.3333333333,78.0,63.2
3052590.0,6,3,204,2,136,0.0,70.0,68.0,1,68,0.0,68.0,68.0
7311.0,17,2,582,1,83,0.0,83.0,83.0,1,499,0.0,499.0,499.0
94610629.0,6,26,1762,13,922,7866242.666666667,139.0,70.92307692307692,13,840,7866245.083333333,123.0,64.61538461538461
1416996.0,6,109,75301,54,3748,26735.77358490566,222.0,69.4074074074074,55,71553,25489.277777777777,1514.0,1300.9636363636364
74883.0,6,14,4740,7,653,10971.666666666666,249.0,93.28571428571428,7,4087,12200.833333333334,1514.0,583.8571428571429
120026471.0,17,29,13785,29,13785,4286659.678571428,501.0,475.3448275862069,0,0,0.0,0.0,0.0
237074.0,6,3,373,2,238,0.0,172.0,119.0,1,135,0.0,135.0,135.0
239646.0,6,10,1221,6,636,47929.2,298.0,106.0,4,585,78795.0,379.0,146.25
48980.0,6,14,4740,7,653,8039.333333333333,249.0,93.28571428571428,7,4087,7761.333333333333,1514.0,583.8571428571429
113344253.0,6,46,3036,23,1518,5152000.363636363,66.0,66.0,23,1518,5151999.909090909,66.0,66.0
124009766.0,17,15,907,8,475,17715680.85714286,174.0,59.375,7,432,17333492.833333332,174.0,61.71428571428572
123443493.0,6,48,3168,24,1584,4935650.869565218,66.0,66.0,24,1584,5367096.347826087,66.0,66.0
102315128.0,6,28,1860,14,966,7853792.307692308,123.0,69.0,14,894,7853789.0,123.0,63.85714285714285
135137467.0,17,6,1206,6,1206,27027493.4,201.0,201.0,0,0,0.0,0.0,0.0
105596.0,17,2,700,2,700,0.0,350.0,350.0,0,0,0.0,0.0,0.0
90257432.0,6,12,1832,8,1016,12893918.857142856,188.0,127.0,4,816,30031157.666666668,204.0,204.0
226639.0,6,14,4740,7,653,22572.33333333333,249.0,93.28571428571428,7,4087,36467.16666666666,1514.0,583.8571428571429
112876.0,6,14,4740,7,653,18694.33333333333,249.0,93.28571428571428,7,4087,16822.5,1514.0,583.8571428571429
4441.0,17,2,180,1,90,0.0,90.0,90.0,1,90,0.0,90.0,90.0
90051894.0,17,28,13364,28,13364,3335255.333333333,501.0,477.2857142857143,0,0,0.0,0.0,0.0
415837.0,17,2,762,2,762,0.0,381.0,381.0,0,0,0.0,0.0,0.0
47801.0,6,14,4740,7,653,7769.5,249.0,93.28571428571428,7,4087,7537.166666666667,1514.0,583.8571428571429
45011141.0,17,9,3086,8,2736,5108898.142857143,342.0,342.0,1,350,0.0,350.0,350.0
249452.0,6,10,1221,6,636,49890.4,298.0,106.0,4,585,81878.33333333333,379.0,146.25
206163.0,6,3,426,2,280,0.0,214.0,140.0,1,146,0.0,146.0,146.0
206455.0,17,2,762,2,762,0.0,381.0,381.0,0,0,0.0,0.0,0.0
146893.0,6,3,337,2,214,0.0,160.0,107.0,1,123,0.0,123.0,123.0
105132635.0,6,207,23396,104,7086,1020705.1941747572,140.0,68.13461538461539,103,16310,1020533.8823529412,284.0,158.3495145631068
120565944.0,6,33,2428,16,1140,7372005.266666667,123.0,71.25,17,1288,6911269.3125,139.0,75.76470588235294
1321066.0,6,4,264,2,132,0.0,66.0,66.0,2,132,0.0,66.0,66.0
241070.0,6,3,337,2,214,0.0,160.0,107.0,1,123,0.0,123.0,123.0
120119616.0,6,12,1832,8,1016,17136870.42857143,188.0,127.0,4,816,30031230.0,204.0,204.0
11282.0,6,10,1065,5,534,2345.75,262.0,106.8,5,531,2517.75,259.0,106.2
360.0,17,2,248,1,84,0.0,84.0,84.0,1,164,0.0,164.0,164.0
503255.0,6,5,336,2,134,0.0,68.0,67.0,3,202,193702.0,70.0,67.33333333333333
322554.0,17,4,1400,4,1400,107518.0,350.0,350.0,0,0,0.0,0.0,0.0
2333.0,17,4,344,2,150,0.0,75.0,75.0,2,194,0.0,103.0,97.0
146105.0,6,3,337,2,214,0.0,160.0,107.0,1,123,0.0,123.0,123.0
178207.0,17,2,180,1,90,0.0,90.0,90.0,1,90,0.0,90.0,90.0
60957.0,6,13,1386,7,789,9413.0,253.0,112.71428571428572,6,597,5290.8,259.0,99.5
2258.0,17,4,344,2,150,0.0,75.0,75.0,2,194,0.0,103.0,97.0
90256110.0,6,14,2240,8,1016,12893730.0,188.0,127.0,6,1224,18014913.0,204.0,204.0
90022110.0,17,28,13364,28,13364,3334152.222222222,501.0,477.2857142857143,0,0,0.0,0.0,0.0
103035.0,17,2,286,2,286,0.0,143.0,143.0,0,0,0.0,0.0,0.0
2419.0,17,4,344,2,150,0.0,75.0,75.0,2,194,0.0,103.0,97.0
841.0,17,4,438,2,148,0.0,74.0,74.0,2,290,0.0,147.0,145.0
90046626.0,17,28,13364,28,13364,3335060.222222222,501.0,477.2857142857143,0,0,0.0,0.0,0.0
153460.0,17,2,180,1,90,0.0,90.0,90.0,1,90,0.0,90.0,90.0
10884208.0,6,7,478,3,206,5371968.5,74.0,68.66666666666667,4,272,3581232.6666666665,74.0,68.0
295948.0,6,6,412,4,272,98649.33333333331,74.0,68.0,2,140,0.0,74.0,70.0
95366804.0,6,39,2574,20,1320,5019291.52631579,66.0,66.0,19,1254,5160008.333333333,66.0,66.0
56048.0,6,14,4740,7,653,8649.166666666666,249.0,93.28571428571428,7,4087,8217.5,1514.0,583.8571428571429
16891.0,17,2,180,1,90,0.0,90.0,90.0,1,90,0.0,90.0,90.0
306359.0,6,6,412,4,272,102119.66666666669,74.0,68.0,2,140,0.0,74.0,70.0
90275815.0,6,14,1043,7,542,15045969.166666666,95.0,77.42857142857143,7,501,14998291.833333334,95.0,71.57142857142857
12662.0,6,12,1393,6,796,2269.0,271.0,132.66666666666666,6,597,2364.8,259.0,99.5
96949.0,17,2,762,2,762,0.0,381.0,381.0,0,0,0.0,0.0,0.0
2360.0,17,4,344,2,150,0.0,75.0,75.0,2,194,0.0,103.0,97.0
108459745.0,6,31,2160,16,1071,7230649.666666667,123.0,66.9375,15,1089,7018338.071428572,123.0,72.6
39706.0,6,14,4740,7,653,6090.833333333333,249.0,93.28571428571428,7,4087,6327.333333333333,1514.0,583.8571428571429
143887.0,6,2,132,1,66,0.0,66.0,66.0,1,66,0.0,66.0,66.0
90289487.0,6,16,1192,8,596,12891295.57142857,95.0,74.5,8,596,12897790.142857144,95.0,74.5
281435.0,17,2,363,1,79,0.0,79.0,79.0,1,284,0.0,284.0,284.0
2914395.0,6,11,2106,6,598,582702.8,252.0,99.66666666666669,5,1508,1685.25,1236.0,301.6
5245478.0,6,5,336,2,134,0.0,68.0,67.0,3,202,1526814.5,70.0,67.33333333333333
109599135.0,17,14,864,7,432,18167474.666666668,174.0,61.71428571428572,7,432,18166846.666666668,174.0,61.71428571428572
115494932.0,6,224,25312,112,17624,1038556.3333333334,284.0,157.35714285714286,112,7688,1038556.3243243244,140.0,68.64285714285714
297906.0,17,4,407,2,144,0.0,72.0,72.0,2,263,0.0,136.0,131.5
4386.0,17,2,614,1,72,0.0,72.0,72.0,1,542,0.0,542.0,542.0
298232.0,6,6,412,4,272,99410.66666666669,74.0,68.0,2,140,0.0,74.0,70.0
34977.0,6,10,2032,5,524,8520.25,252.0,104.8,5,1508,7345.25,1236.0,301.6
47820711.0,6,8,2113,3,960,22789972.0,826.0,320.0,5,1153,11259810.25,885.0,230.6
111816.0,6,10,2032,5,524,13726.5,252.0,104.8,5,1508,25106.0,1236.0,301.6
831812.0,6,9,1118,6,586,166362.4,248.0,97.66666666666669,3,532,279671.0,392.0,177.33333333333334
128630737.0,17,14,864,7,432,18167619.33333333,174.0,61.71428571428572,7,432,18166817.33333333,174.0,61.71428571428572
0.0,17,1,381,1,381,0.0,381.0,381.0,0,0,0.0,0.0,0.0
59906.0,6,14,4740,7,653,9855.5,249.0,93.28571428571428,7,4087,9530.833333333334,1514.0,583.8571428571429
17149.0,17,4,344,2,150,0.0,75.0,75.0,2,194,0.0,103.0,97.0
2353.0,17,4,344,2,150,0.0,75.0,75.0,2,194,0.0,103.0,97.0
90250917.0,6,12,1832,8,1016,12892988.142857144,188.0,127.0,4,816,30029659.33333333,204.0,204.0
498.0,17,2,508,2,508,0.0,257.0,254.0,0,0,0.0,0.0,0.0
252665.0,17,4,6056,4,6056,84221.66666666667,1514.0,1514.0,0,0,0.0,0.0,0.0
108109286.0,17,5,1005,5,1005,27027321.5,201.0,201.0,0,0,0.0,0.0,0.0
15048.0,17,2,180,1,90,0.0,90.0,90.0,1,90,0.0,90.0,90.0
119787679.0,6,23,1734,11,840,11978767.9,95.0,76.36363636363636,12,894,10866237.818181818,95.0,74.5
21641.0,17,2,582,1,83,0.0,83.0,83.0,1,499,0.0,499.0,499.0
120042264.0,17,28,13364,28,13364,4446009.777777778,501.0,477.2857142857143,0,0,0.0,0.0,0.0
119308883.0,17,35,16705,35,16705,3509084.794117647,501.0,477.2857142857143,0,0,0.0,0.0,0.0
216688.0,6,3,426,2,280,0.0,214.0,140.0,1,146,0.0,146.0,146.0
2356.0,17,4,344,2,150,0.0,75.0,75.0,2,194,0.0,103.0,97.0
113168494.0,6,46,3036,23,1518,5144011.318181818,66.0,66.0,23,1518,5144010.727272728,66.0,66.0
10473.0,6,10,1065,5,534,2406.0,262.0,106.8,5,531,2308.0,259.0,106.2
56300.0,6,14,4740,7,653,9220.833333333334,249.0,93.28571428571428,7,4087,9232.5,1514.0,583.8571428571429
45030663.0,17,9,3086,8,2736,5134982.142857143,342.0,342.0,1,350,0.0,350.0,350.0
255417.0,17,4,6056,4,6056,85139.0,1514.0,1514.0,0,0,0.0,0.0,0.0
3502.0,17,2,414,1,88,0.0,88.0,88.0,1,326,0.0,326.0,326.0
90049097.0,17,27,12943,27,12943,3463426.8076923075,501.0,479.3703703703704,0,0,0.0,0.0,0.0
90258661.0,6,17,2434,9,1204,11282332.625,188.0,133.77777777777777,8,1230,12871063.0,204.0,153.75
108724957.0,6,37,2788,19,1471,6028283.444444444,139.0,77.42105263157895,18,1317,6382888.705882353,123.0,73.16666666666667
123508294.0,6,227,25578,114,17898,1092993.7522123894,284.0,157.0,113,7680,1065670.330357143,140.0,67.96460176991151
320.0,17,2,174,1,79,0.0,79.0,79.0,1,95,0.0,95.0,95.0
105552644.0,17,14,864,7,432,17501400.333333332,174.0,61.71428571428572,7,432,17500188.833333332,174.0,61.71428571428572
217807.0,6,3,426,2,280,0.0,214.0,140.0,1,146,0.0,146.0,146.0
228260.0,17,2,180,1,90,0.0,90.0,90.0,1,90,0.0,90.0,90.0
112367.0,17,2,700,2,700,0.0,350.0,350.0,0,0,0.0,0.0,0.0
228080.0,17,2,180,1,90,0.0,90.0,90.0,1,90,0.0,90.0,90.0
90051245.0,17,28,13364,28,13364,3335231.296296296,501.0,477.2857142857143,0,0,0.0,0.0,0.0
214159.0,17,4,1524,4,1524,71386.33333333333,381.0,381.0,0,0,0.0,0.0,0.0
317836.0,17,4,1400,4,1400,105945.33333333331,350.0,350.0,0,0,0.0,0.0,0.0
326626.0,6,3,1604,1,753,0.0,753.0,753.0,2,851,0.0,785.0,425.5
303006.0,6,3,202,2,128,0.0,74.0,64.0,1,74,0.0,74.0,74.0
1150744.0,6,13,3007,8,2379,164392.0,1514.0,297.375,5,628,219558.75,331.0,125.6
2384.0,17,4,344,2,150,0.0,75.0,75.0,2,194,0.0,103.0,97.0
42952.0,6,11,2098,6,590,8321.0,252.0,98.33333333333331,5,1508,10089.0,1236.0,301.6
122001155.0,17,15,907,8,475,17428736.42857143,174.0,59.375,7,432,17001321.666666668,174.0,61.71428571428572
105875.0,17,2,700,2,700,0.0,350.0,350.0,0,0,0.0,0.0,0.0
3885.0,17,4,704,2,148,0.0,74.0,74.0,2,556,0.0,280.0,278.0
2337.0,17,4,344,2,150,0.0,75.0,75.0,2,194,0.0,103.0,97.0
33222.0,6,14,4740,7,653,4843.333333333333,249.0,93.28571428571428,7,4087,5335.166666666667,1514.0,583.8571428571429
1343248.0,6,4,492,2,280,0.0,214.0,140.0,2,212,0.0,146.0,106.0
108105947.0,17,5,955,5,955,27026486.75,191.0,191.0,0,0,0.0,0.0,0.0
135125328.0,17,6,1206,6,1206,27025065.6,201.0,201.0,0,0,0.0,0.0,0.0
10460967.0,6,7,478,4,272,3441500.333333333,74.0,68.0,3,206,5162187.0,74.0,68.66666666666667
233163.0,6,3,337,2,214,0.0,160.0,107.0,1,123,0.0,123.0,123.0
40770.0,6,14,4740,7,653,6671.5,249.0,93.28571428571428,7,4087,5959.666666666667,1514.0,583.8571428571429
51179.0,6,14,4740,7,653,7554.5,249.0,93.28571428571428,7,4087,8317.0,1514.0,583.8571428571429
90282569.0,6,16,1192,8,596,12891105.57142857,95.0,74.5,8,596,12896294.142857144,95.0,74.5
120124309.0,6,13,2036,5,1020,30031077.25,204.0,204.0,8,1016,17137358.42857143,188.0,127.0
303989.0,6,6,412,4,272,101329.66666666669,74.0,68.0,2,140,0.0,74.0,70.0
14919.0,17,2,180,1,90,0.0,90.0,90.0,1,90,0.0,90.0,90.0
111994104.0,6,31,2166,16,1149,7451881.666666667,123.0,71.8125,15,1017,7984161.214285715,123.0,67.8
122613665.0,6,39,2786,20,1484,6453350.7894736845,139.0,74.2,19,1302,6245170.0,123.0,68.52631578947368
120314436.0,6,221,25024,111,17468,1093767.6,284.0,157.36936936936937,110,7556,1094208.8256880734,140.0,68.69090909090909
118692720.0,6,31,2176,16,1071,7912848.0,123.0,66.9375,15,1105,7913589.5,139.0,73.66666666666667
298415.0,6,6,412,4,272,99471.66666666669,74.0,68.0,2,140,0.0,74.0,70.0
2798934.0,6,2,132,1,66,0.0,66.0,66.0,1,66,0.0,66.0,66.0
90222163.0,6,22,1680,10,786,9996715.666666666,95.0,78.6,12,894,8182425.272727272,95.0,74.5
123455526.0,6,48,3168,24,1584,4986322.0869565215,66.0,66.0,24,1584,5281489.695652174,66.0,66.0
292.0,17,2,168,1,76,0.0,76.0,76.0,1,92,0.0,92.0,92.0
206050.0,6,3,426,2,280,0.0,214.0,140.0,1,146,0.0,146.0,146.0
848358.0,6,9,1096,6,625,169671.6,287.0,104.16666666666669,3,471,287874.0,331.0,157.0
96000972.0,17,11,735,6,389,19200194.4,174.0,64.83333333333333,5,346,19001435.5,174.0,69.2
2113.0,17,4,344,2,150,0.0,75.0,75.0,2,194,0.0,103.0,97.0
324256.0,6,6,412,4,272,108085.33333333331,74.0,68.0,2,140,0.0,74.0,70.0
117358357.0,6,48,3168,24,1584,5102537.260869565,66.0,66.0,24,1584,5089096.0869565215,66.0,66.0
448.0,17,2,267,1,83,0.0,83.0,83.0,1,184,0.0,184.0,184.0
242229.0,6,3,337,2,214,0.0,160.0,107.0,1,123,0.0,123.0,123.0
117000965.0,17,14,1126,8,606,16714423.57142857,174.0,75.75,6,520,15400540.8,174.0,86.66666666666667
326340.0,6,6,412,4,272,108780.0,74.0,68.0,2,140,0.0,74.0,70.0
247313.0,17,2,180,1,90,0.0,90.0,90.0,1,90,0.0,90.0,90.0
178823.0,17,4,704,2,148,0.0,74.0,74.0,2,556,0.0,280.0,278.0
90239727.0,6,12,1832,8,1016,12891389.57142857,188.0,127.0,4,816,30025650.666666668,204.0,204.0
47071.0,6,14,4740,7,653,7669.0,249.0,93.28571428571428,7,4087,7083.333333333333,1514.0,583.8571428571429
284430.0,17,2,363,1,79,0.0,79.0,79.0,1,284,0.0,284.0,284.0
24252.0,6,14,4740,7,653,3876.8333333333335,249.0,93.28571428571428,7,4087,3513.0,1514.0,583.8571428571429
337746.0,6,6,412,4,272,112582.0,74.0,68.0,2,140,0.0,74.0,70.0
5621285.0,6,5,336,2,134,0.0,68.0,67.0,3,202,1422143.0,70.0,67.33333333333333
217726.0,6,3,426,2,280,0.0,214.0,140.0,1,146,0.0,146.0,146.0
298386.0,6,6,412,4,272,99462.0,74.0,68.0,2,140,0.0,74.0,70.0
319.0,17,2,174,1,79,0.0,79.0,79.0,1,95,0.0,95.0,95.0
90523971.0,6,14,2240,8,1016,12931995.857142856,188.0,127.0,6,1224,18071916.4,204.0,204.0
282.0,17,2,156,1,78,0.0,78.0,78.0,1,78,0.0,78.0,78.0
120052291.0,17,29,13785,29,13785,4287581.821428572,501.0,475.3448275862069,0,0,0.0,0.0,0.0
90311105.0,6,19,1436,10,745,10029952.222222222,95.0,74.5,9,691,11288038.375,95.0,76.77777777777777
642825.0,6,7,942,4,572,214275.0,214.0,143.0,3,370,212928.0,146.0,123.33333333333331
134971.0,6,13,1513,7,882,22003.5,291.0,126.0,6,631,25955.2,293.0,105.16666666666669
308445.0,6,6,412,4,272,102815.0,74.0,68.0,2,140,0.0,74.0,70.0
108104312.0,17,5,955,5,955,27026078.0,191.0,191.0,0,0,0.0,0.0,0.0
157163.0,6,3,337,2,214,0.0,160.0,107.0,1,123,0.0,123.0,123.0
102727.0,17,2,286,2,286,0.0,143.0,143.0,0,0,0.0,0.0,0.0
5830612.0,6,5,336,2,134,0.0,68.0,67.0,3,202,1519555.0,70.0,67.33333333333333
405371.0,6,3,1604,2,851,0.0,785.0,425.5,1,753,0.0,753.0,753.0
90258875.0,6,12,1832,8,1016,12894125.0,188.0,127.0,4,816,30030313.0,204.0,204.0
33703.0,6,14,4740,7,653,5446.833333333333,249.0,93.28571428571428,7,4087,5044.166666666667,1514.0,583.8571428571429
69846.0,6,14,4740,7,653,10705.0,249.0,93.28571428571428,7,4087,11188.5,1514.0,583.8571428571429
2575637.0,6,2,132,1,66,0.0,66.0,66.0,1,66,0.0,66.0,66.0
10464158.0,6,6,412,3,206,5163773.0,74.0,68.66666666666667,3,206,5163699.0,74.0,68.66666666666667
86220.0,6,14,4740,7,653,13517.333333333334,249.0,93.28571428571428,7,4087,12323.5,1514.0,583.8571428571429
1001.0,17,4,438,2,148,0.0,74.0,74.0,2,290,0.0,147.0,145.0
91509883.0,6,37,3042,20,1641,4804946.736842105,123.0,82.05,17,1401,5705880.0625,123.0,82.41176470588235
10592986.0,6,7,478,4,272,3485494.333333333,74.0,68.0,3,206,5169565.0,74.0,68.66666666666667
4447.0,17,4,344,2,150,0.0,75.0,75.0,2,194,0.0,103.0,97.0
120361021.0,6,301,34126,151,24004,802406.8066666666,300.0,158.96688741721854,150,10122,800867.0738255034,140.0,67.48
53385.0,6,14,4740,7,653,7489.833333333333,249.0,93.28571428571428,7,4087,8743.833333333334,1514.0,583.8571428571429
1299933.0,6,4,264,2,132,0.0,66.0,66.0,2,132,0.0,66.0,66.0
927152.0,6,10,1336,6,799,185430.4,461.0,133.16666666666666,4,537,218176.0,331.0,134.25
216563.0,17,2,180,1,90,0.0,90.0,90.0,1,90,0.0,90.0,90.0
39648.0,6,10,2032,5,524,9680.0,252.0,104.8,5,1508,7990.75,1236.0,301.6
55988.0,6,14,4740,7,653,9019.666666666666,249.0,93.28571428571428,7,4087,9139.333333333334,1514.0,583.8571428571429
124001062.0,17,15,907,8,475,17714437.42857143,174.0,59.375,7,432,17335143.5,174.0,61.71428571428572
144783.0,17,2,180,1,70,0.0,70.0,70.0,1,110,0.0,110.0,110.0
96573.0,6,10,2032,5,524,18824.0,252.0,104.8,5,1508,22949.0,1236.0,301.6
90780196.0,6,17,1287,9,691,11339838.625,95.0,76.77777777777777,8,596,12967609.0,95.0,74.5
10522187.0,6,7,478,4,272,3461888.0,74.0,68.0,3,206,5192731.5,74.0,68.66666666666667
106780.0,17,2,286,2,286,0.0,143.0,143.0,0,0,0.0,0.0,0.0
101454.0,17,2,286,2,286,0.0,143.0,143.0,0,0,0.0,0.0,0.0
146398.0,6,3,337,2,214,0.0,160.0,107.0,1,123,0.0,123.0,123.0
264115.0,6,3,337,2,214,0.0,160.0,107.0,1,123,0.0,123.0,123.0
127518.0,6,3,337,2,214,0.0,160.0,107.0,1,123,0.0,123.0,123.0
306854.0,6,6,412,4,272,102284.66666666669,74.0,68.0,2,140,0.0,74.0,70.0
121474.0,6,3,337,2,214,0.0,160.0,107.0,1,123,0.0,123.0,123.0
7811925.0,6,10,1801,5,1132,1917092.75,432.0,226.4,5,669,1916832.5,219.0,133.8
107836786.0,6,28,1860,14,966,8295137.384615385,123.0,69.0,14,894,8279372.0,123.0,63.85714285714285
215519.0,17,2,180,1,90,0.0,90.0,90.0,1,90,0.0,90.0,90.0
873730.0,6,9,1270,6,799,174746.0,461.0,133.16666666666666,3,471,300490.5,331.0,157.0
5622154.0,6,4,270,2,134,0.0,68.0,67.0,2,136,0.0,70.0,68.0
1152232.0,6,13,3011,8,2383,164604.57142857142,1514.0,297.875,5,628,219877.25,331.0,125.6
128001300.0,17,17,1255,9,649,16000162.5,174.0,72.11111111111111,8,606,15526572.57142857,174.0,75.75
254594.0,6,10,1221,6,636,50918.8,298.0,106.0,4,585,79503.66666666667,379.0,146.25
108109286.0,17,5,955,5,955,27027321.5,191.0,191.0,0,0,0.0,0.0,0.0
273229.0,6,10,1221,6,636,54645.8,298.0,106.0,4,585,85207.33333333333,379.0,146.25
47067.0,6,13,1386,7,789,7844.5,253.0,112.71428571428572,6,597,8280.4,259.0,99.5
120598067.0,6,235,27028,118,19010,1030752.7094017094,284.0,161.10169491525423,117,8018,1030693.7327586206,140.0,68.52991452991454
143831.0,17,2,180,1,90,0.0,90.0,90.0,1,90,0.0,90.0,90.0
27846.0,6,14,4740,7,653,3400.6666666666665,249.0,93.28571428571428,7,4087,4373.333333333333,1514.0,583.8571428571429
440108.0,6,3,204,2,136,0.0,70.0,68.0,1,68,0.0,68.0,68.0
41858.0,6,11,2098,6,590,7869.4,252.0,98.33333333333331,5,1508,10195.75,1236.0,301.6
299985.0,6,6,412,4,272,99995.0,74.0,68.0,2,140,0.0,74.0,70.0
82026.0,6,14,4740,7,653,13547.666666666666,249.0,93.28571428571428,7,4087,12571.5,1514.0,583.8571428571429
235465.0,6,13,1394,7,797,39244.16666666666,253.0,113.85714285714286,6,597,45319.8,259.0,99.5
10838429.0,6,7,478,3,206,5350993.0,74.0,68.66666666666667,4,272,3567247.333333333,74.0,68.0
1633946.0,6,20,6434,12,1921,148540.54545454544,620.0,160.08333333333334,8,4513,192543.14285714287,1514.0,564.125
2097.0,17,4,344,2,150,0.0,75.0,75.0,2,194,0.0,103.0,97.0
38111.0,6,14,4740,7,653,6181.833333333333,249.0,93.28571428571428,7,4087,6195.5,1514.0,583.8571428571429
119789881.0,6,24,1788,13,989,9982490.083333334,95.0,76.07692307692308,11,799,11953321.3,95.0,72.63636363636364
16705.0,17,4,344,2,150,0.0,75.0,75.0,2,194,0.0,103.0,97.0
120003.0,17,2,180,1,70,0.0,70.0,70.0,1,110,0.0,110.0,110.0
90305179.0,6,24,1829,13,989,7520132.166666667,95.0,76.07692307692308,11,840,8859411.4,95.0,76.36363636363636
28373.0,6,10,2032,5,524,6597.5,252.0,104.8,5,1508,4798.5,1236.0,301.6
171777.0,17,2,180,1,90,0.0,90.0,90.0,1,90,0.0,90.0,90.0
170115.0,17,4,704,2,148,0.0,74.0,74.0,2,556,0.0,280.0,278.0
94275.0,6,13,1394,7,797,15712.5,253.0,113.85714285714286,6,597,17214.8,259.0,99.5
25272.0,6,10,1065,5,534,5445.5,262.0,106.8,5,531,5436.5,259.0,106.2
10520306.0,6,7,478,4,272,3461442.6666666665,74.0,68.0,3,206,5192063.0,74.0,68.66666666666667
2412.0,17,4,344,2,150,0.0,75.0,75.0,2,194,0.0,103.0,97.0
203857.0,17,2,762,2,762,0.0,381.0,381.0,0,0,0.0,0.0,0.0
2957820.0,6,12,2172,7,664,492838.5,252.0,94.85714285714286,5,1508,4079.75,1236.0,301.6
2369.0,17,4,344,2,150,0.0,75.0,75.0,2,194,0.0,103.0,97.0
146217.0,6,3,337,2,214,0.0,160.0,107.0,1,123,0.0,123.0,123.0
108102786.0,17,5,1005,5,1005,27025696.5,201.0,201.0,0,0,0.0,0.0,0.0
15206.0,17,2,582,1,83,0.0,83.0,83.0,1,499,0.0,499.0,499.0
313256.0,17,4,1400,4,1400,104418.66666666669,350.0,350.0,0,0,0.0,0.0,0.0
357.0,17,2,267,1,83,0.0,83.0,83.0,1,184,0.0,184.0,184.0
125001113.0,17,14,864,8,475,17857301.85714286,174.0,59.375,6,389,17201655.8,174.0,64.83333333333333
90183753.0,6,22,1739,10,845,9996377.444444444,154.0,84.5,12,894,8178845.090909091,95.0,74.5
2189.0,17,2,664,1,322,0.0,322.0,322.0,1,342,0.0,342.0,342.0
2511596.0,6,2,132,1,66,0.0,66.0,66.0,1,66,0.0,66.0,66.0
14328615.0,6,20,1607,10,975,1558465.2222222222,315.0,97.5,10,632,1558441.5555555555,78.0,63.2
1299717.0,17,7,490,7,490,216619.5,70.0,70.0,0,0,0.0,0.0,0.0
216440.0,17,2,180,1,90,0.0,90.0,90.0,1,90,0.0,90.0,90.0
10474590.0,6,7,478,4,272,3444175.0,74.0,68.0,3,206,5166096.5,74.0,68.66666666666667
2547185.0,6,25,7573,14,3735,195937.3076923077,1514.0,266.7857142857143,11,3838,229219.3,1514.0,348.90909090909093
833170.0,6,9,1118,6,586,166634.0,248.0,97.66666666666669,3,532,280253.0,392.0,177.33333333333334
118740193.0,6,48,3168,24,1584,5162617.0869565215,66.0,66.0,24,1584,5148221.0869565215,66.0,66.0
106284882.0,6,19,1436,10,745,11809431.333333334,95.0,74.5,9,691,13252569.125,95.0,76.77777777777777
104609.0,17,2,286,2,286,0.0,143.0,143.0,0,0,0.0,0.0,0.0
466676.0,6,3,204,2,136,0.0,70.0,68.0,1,68,0.0,68.0,68.0
30691.0,6,14,4740,7,653,4962.5,249.0,93.28571428571428,7,4087,4978.0,1514.0,583.8571428571429
206323.0,6,3,426,2,280,0.0,214.0,140.0,1,146,0.0,146.0,146.0
206965.0,6,3,426,2,280,0.0,214.0,140.0,1,146,0.0,146.0,146.0
424169.0,17,2,363,1,75,0.0,75.0,75.0,1,288,0.0,288.0,288.0
327418.0,6,6,412,4,272,109139.33333333331,74.0,68.0,2,140,0.0,74.0,70.0
1018824.0,6,11,1134,6,558,203764.8,220.0,93.0,5,576,254196.75,304.0,115.2
46186.0,6,10,2032,5,524,11307.0,252.0,104.8,5,1508,9377.75,1236.0,301.6
19990.0,17,2,582,1,83,0.0,83.0,83.0,1,499,0.0,499.0,499.0
191550.0,17,2,180,1,90,0.0,90.0,90.0,1,90,0.0,90.0,90.0
313653.0,17,4,1400,4,1400,104551.0,350.0,350.0,0,0,0.0,0.0,0.0
138636.0,17,2,192,1,88,0.0,88.0,88.0,1,104,0.0,104.0,104.0
2331.0,17,4,344,2,150,0.0,75.0,75.0,2,194,0.0,103.0,97.0
303731.0,6,2,132,1,66,0.0,66.0,66.0,1,66,0.0,66.0,66.0
282218.0,17,2,363,1,79,0.0,79.0,79.0,1,284,0.0,284.0,284.0
44054.0,6,14,4740,7,653,6552.166666666667,249.0,93.28571428571428,7,4087,6520.5,1514.0,583.8571428571429
97180599.0,6,30,2122,15,1105,6941471.357142857,139.0,73.66666666666667,15,1017,6926023.928571428,123.0,67.8
135136558.0,17,6,1206,6,1206,27027311.6,201.0,201.0,0,0,0.0,0.0,0.0
104819.0,17,2,286,2,286,0.0,143.0,143.0,0,0,0.0,0.0,0.0
337.0,17,2,160,1,80,0.0,80.0,80.0,1,80,0.0,80.0,80.0
153368.0,17,2,180,1,90,0.0,90.0,90.0,1,90,0.0,90.0,90.0
16344.0,6,10,1065,5,534,3495.0,262.0,106.8,5,531,3802.75,259.0,106.2
3025664.0,6,3,204,2,136,0.0,70.0,68.0,1,68,0.0,68.0,68.0
25201.0,6,14,4740,7,653,3786.5,249.0,93.28571428571428,7,4087,4063.1666666666665,1514.0,583.8571428571429
354.0,17,2,250,1,93,0.0,93.0,93.0,1,157,0.0,157.0,157.0
147127.0,6,3,373,2,238,0.0,172.0,119.0,1,135,0.0,135.0,135.0
216396.0,17,2,180,1,90,0.0,90.0,90.0,1,90,0.0,90.0,90.0
700391.0,17,4,820,2,156,0.0,78.0,78.0,2,664,0.0,332.0,332.0
14974.0,6,14,4740,7,653,2336.6666666666665,249.0,93.28571428571428,7,4087,2280.5,1514.0,583.8571428571429
316613.0,17,4,1400,4,1400,105537.66666666669,350.0,350.0,0,0,0.0,0.0,0.0
121720088.0,17,14,864,7,432,17000093.833333332,174.0,61.71428571428572,7,432,17000847.5,174.0,61.71428571428572
360534.0,17,4,1524,4,1524,120178.0,381.0,381.0,0,0,0.0,0.0,0.0
1926.0,17,2,192,1,88,0.0,88.0,88.0,1,104,0.0,104.0,104.0
3019143.0,6,11,2106,6,598,601743.2,252.0,99.66666666666669,5,1508,4734.0,1236.0,301.6
153881.0,6,2,132,1,66,0.0,66.0,66.0,1,66,0.0,66.0,66.0
321516.0,17,4,1400,4,1400,107172.0,350.0,350.0,0,0,0.0,0.0,0.0
120032.0,17,2,180,1,70,0.0,70.0,70.0,1,110,0.0,110.0,110.0
239015.0,6,3,337,2,214,0.0,160.0,107.0,1,123,0.0,123.0,123.0
314242.0,6,6,412,4,272,104747.33333333331,74.0,68.0,2,140,0.0,74.0,70.0
302364.0,6,2,132,1,66,0.0,66.0,66.0,1,66,0.0,66.0,66.0
29218.0,6,10,2032,5,524,6119.25,252.0,104.8,5,1508,5699.0,1236.0,301.6
90116979.0,6,26,1746,13,906,7491747.583333333,123.0,69.6923076923077,13,840,7491745.166666667,123.0,64.61538461538461
90866.0,6,13,1386,7,789,15144.333333333334,253.0,112.71428571428572,6,597,16058.6,259.0,99.5
220659.0,6,13,1386,7,789,36776.5,253.0,112.71428571428572,6,597,35747.0,259.0,99.5
23332.0,6,10,2032,5,524,5605.75,252.0,104.8,5,1508,4852.0,1236.0,301.6
90052461.0,17,28,13364,28,13364,3335276.333333333,501.0,477.2857142857143,0,0,0.0,0.0,0.0
25495.0,6,10,1067,5,536,6150.75,264.0,107.2,5,531,3696.0,259.0,106.2
1189305.0,6,13,3010,8,2382,169900.7142857143,1514.0,297.75,5,628,228438.0,331.0,125.6
147922.0,6,3,337,2,214,0.0,160.0,107.0,1,123,0.0,123.0,123.0
60583.0,6,14,4740,7,653,9859.0,249.0,93.28571428571428,7,4087,9880.0,1514.0,583.8571428571429
228226.0,17,2,180,1,90,0.0,90.0,90.0,1,90,0.0,90.0,90.0
90255954.0,6,13,2036,8,1016,12893707.714285716,188.0,127.0,5,1020,22522648.75,204.0,204.0
18041.0,6,10,2032,5,524,4256.0,252.0,104.8,5,1508,4128.0,1236.0,301.6
298627.0,6,6,412,4,272,99542.33333333331,74.0,68.0,2,140,0.0,74.0,70.0
121309.0,6,3,337,2,214,0.0,160.0,107.0,1,123,0.0,123.0,123.0
144931.0,17,2,180,1,70,0.0,70.0,70.0,1,110,0.0,110.0,110.0
107427.0,17,2,700,2,700,0.0,350.0,350.0,0,0,0.0,0.0,0.0
91792226.0,6,27,1948,14,963,7060940.461538462,123.0,68.78571428571429,13,985,7343641.333333333,139.0,75.76923076923077
72299.0,6,12,1320,6,723,14125.4,253.0,120.5,6,597,12412.4,259.0,99.5
107703.0,17,2,286,2,286,0.0,143.0,143.0,0,0,0.0,0.0,0.0
2305.0,17,4,344,2,150,0.0,75.0,75.0,2,194,0.0,103.0,97.0
2794699.0,6,2,132,1,66,0.0,66.0,66.0,1,66,0.0,66.0,66.0
21368.0,6,14,4740,7,653,2362.333333333333,249.0,93.28571428571428,7,4087,3266.5,1514.0,583.8571428571429
736.0,17,4,438,2,148,0.0,74.0,74.0,2,290,0.0,147.0,145.0
59520.0,6,14,4740,7,653,9692.5,249.0,93.28571428571428,7,4087,9251.833333333334,1514.0,583.8571428571429
2546109.0,6,25,7573,14,3735,195854.53846153847,1514.0,266.7857142857143,11,3838,230019.2,1514.0,348.90909090909093
108106182.0,17,5,1005,5,1005,27026545.5,201.0,201.0,0,0,0.0,0.0,0.0
2827.0,17,2,762,2,762,0.0,381.0,381.0,0,0,0.0,0.0,0.0
108568.0,17,2,286,2,286,0.0,143.0,143.0,0,0,0.0,0.0,0.0
33738.0,6,10,2032,5,524,8173.0,252.0,104.8,5,1508,5956.25,1236.0,301.6
153446.0,17,2,180,1,90,0.0,90.0,90.0,1,90,0.0,90.0,90.0
157849.0,17,2,180,1,90,0.0,90.0,90.0,1,90,0.0,90.0,90.0
108639146.0,6,32,2220,16,1149,7228224.0,123.0,71.8125,16,1071,7228217.733333333,123.0,66.9375
97795.0,6,11,2098,6,590,19381.6,252.0,98.33333333333331,5,1508,21772.5,1236.0,301.6
43586.0,6,14,4740,7,653,7146.833333333333,249.0,93.28571428571428,7,4087,6667.5,1514.0,583.8571428571429
5005157.0,17,4,849,2,166,0.0,83.0,83.0,2,683,0.0,499.0,341.5
9644.0,17,2,582,1,83,0.0,83.0,83.0,1,499,0.0,499.0,499.0
2391.0,17,4,344,2,150,0.0,75.0,75.0,2,194,0.0,103.0,97.0
20888.0,6,14,4740,7,653,3347.833333333333,249.0,93.28571428571428,7,4087,2681.5,1514.0,583.8571428571429
34728830.0,6,5,336,2,134,0.0,68.0,67.0,3,202,17297438.0,70.0,67.33333333333333
844795.0,6,9,1118,6,586,168959.0,248.0,97.66666666666669,3,532,284559.5,392.0,177.33333333333334
27403605.0,17,5,1710,5,1710,6850901.25,342.0,342.0,0,0,0.0,0.0,0.0
114127504.0,17,14,864,7,432,19001515.0,174.0,61.71428571428572,7,432,19000154.0,174.0,61.71428571428572
2313.0,17,4,344,2,150,0.0,75.0,75.0,2,194,0.0,103.0,97.0
38835.0,6,14,4740,7,653,6008.833333333333,249.0,93.28571428571428,7,4087,6294.666666666667,1514.0,583.8571428571429
54483.0,6,14,4740,7,653,8956.0,249.0,93.28571428571428,7,4087,8939.333333333334,1514.0,583.8571428571429
29307.0,6,14,4740,7,653,4676.166666666667,249.0,93.28571428571428,7,4087,4658.0,1514.0,583.8571428571429
110555306.0,6,206,23500,103,16480,1081765.9117647058,300.0,160.0,103,7020,1081763.9705882352,140.0,68.15533980582525
121291.0,6,3,337,2,214,0.0,160.0,107.0,1,123,0.0,123.0,123.0
60520.0,6,14,4740,7,653,9486.833333333334,249.0,93.28571428571428,7,4087,7725.0,1514.0,583.8571428571429
120072499.0,17,28,13364,28,13364,4447129.592592592,501.0,477.2857142857143,0,0,0.0,0.0,0.0
2591448.0,6,2,132,1,66,0.0,66.0,66.0,1,66,0.0,66.0,66.0
102984128.0,6,42,2772,21,1386,5135439.3,66.0,66.0,21,1386,5135447.95,66.0,66.0
90021046.0,17,28,13364,28,13364,3334112.814814815,501.0,477.2857142857143,0,0,0.0,0.0,0.0
116556735.0,6,220,24868,110,17312,1067353.7889908256,284.0,157.38181818181818,110,7556,1067354.1926605504,140.0,68.69090909090909
216773.0,17,2,180,1,90,0.0,90.0,90.0,1,90,0.0,90.0,90.0
336563.0,6,6,412,4,272,112187.66666666669,74.0,68.0,2,140,0.0,74.0,70.0
108102767.0,17,5,1005,5,1005,27025691.75,201.0,201.0,0,0,0.0,0.0,0.0
13611049.0,6,20,1605,10,973,1479113.3333333333,315.0,97.3,10,632,1479078.7777777778,78.0,63.2
40817.0,6,14,4740,7,653,5361.333333333333,249.0,93.28571428571428,7,4087,6473.833333333333,1514.0,583.8571428571429
10487824.0,6,7,478,4,272,3450485.6666666665,74.0,68.0,3,206,5175594.0,74.0,68.66666666666667
2333.0,17,4,344,2,150,0.0,75.0,75.0,2,194,0.0,103.0,97.0
14818.0,6,14,4740,7,653,2219.1666666666665,249.0,93.28571428571428,7,4087,2216.333333333333,1514.0,583.8571428571429
233293.0,6,3,373,2,238,0.0,172.0,119.0,1,135,0.0,135.0,135.0
176058.0,6,13,1394,7,797,29343.0,253.0,113.85714285714286,6,597,34557.0,259.0,99.5
108100744.0,17,5,1005,5,1005,27025186.0,201.0,201.0,0,0,0.0,0.0,0.0
90071053.0,17,28,13364,28,13364,3335964.925925926,501.0,477.2857142857143,0,0,0.0,0.0,0.0
209566.0,17,2,180,1,90,0.0,90.0,90.0,1,90,0.0,90.0,90.0
3214345.0,6,3,1777,2,951,0.0,885.0,475.5,1,826,0.0,826.0,826.0
28553.0,6,14,4740,7,653,4580.333333333333,249.0,93.28571428571428,7,4087,4376.0,1514.0,583.8571428571429
18517.0,6,14,4740,7,653,2754.1666666666665,249.0,93.28571428571428,7,4087,2913.1666666666665,1514.0,583.8571428571429
135135005.0,17,6,1146,6,1146,27027001.0,191.0,191.0,0,0,0.0,0.0,0.0
73409.0,6,14,4740,7,653,12109.666666666666,249.0,93.28571428571428,7,4087,12006.166666666666,1514.0,583.8571428571429
95000863.0,17,11,735,6,389,19000172.6,174.0,64.83333333333333,5,346,18750189.25,174.0,69.2
19972.0,6,10,2032,5,524,4694.75,252.0,104.8,5,1508,3028.75,1236.0,301.6
5040.0,17,2,614,1,72,0.0,72.0,72.0,1,542,0.0,542.0,542.0
217779.0,6,3,426,2,280,0.0,214.0,140.0,1,146,0.0,146.0,146.0
108121395.0,17,5,955,5,955,27030348.75,191.0,191.0,0,0,0.0,0.0,0.0
25390735.0,17,5,1718,4,1368,804768.0,342.0,342.0,1,350,0.0,350.0,350.0
165909.0,17,2,180,1,90,0.0,90.0,90.0,1,90,0.0,90.0,90.0
2806605.0,6,2,132,1,66,0.0,66.0,66.0,1,66,0.0,66.0,66.0
1050222.0,6,13,1386,7,789,175037.0,253.0,112.71428571428572,6,597,207444.2,259.0,99.5
234725.0,6,3,337,2,214,0.0,160.0,107.0,1,123,0.0,123.0,123.0
37587.0,6,14,4740,7,653,6143.5,249.0,93.28571428571428,7,4087,6130.0,1514.0,583.8571428571429
28160.0,6,10,2032,5,524,6603.25,252.0,104.8,5,1508,6750.5,1236.0,301.6
90303598.0,6,16,1192,8,596,12894466.714285716,95.0,74.5,8,596,12899482.714285716,95.0,74.5
544514.0,17,6,2100,6,2100,108902.8,350.0,350.0,0,0,0.0,0.0,0.0
146146.0,6,3,337,2,214,0.0,160.0,107.0,1,123,0.0,123.0,123.0
97559.0,17,2,762,2,762,0.0,381.0,381.0,0,0,0.0,0.0,0.0
57484.0,6,14,4740,7,653,9397.5,249.0,93.28571428571428,7,4087,8678.833333333334,1514.0,583.8571428571429
258422.0,6,3,337,2,214,0.0,160.0,107.0,1,123,0.0,123.0,123.0
3130050.0,6,167,123430,86,113782,36625.90588235294,1510.0,1323.046511627907,81,9648,35317.0625,1510.0,119.11111111111111
117594108.0,6,218,24742,109,17314,1086842.5925925926,336.0,158.8440366972477,109,7428,1086842.611111111,140.0,68.14678899082568
135130546.0,17,6,1206,6,1206,27026109.2,201.0,201.0,0,0,0.0,0.0,0.0
156137.0,6,3,337,2,214,0.0,160.0,107.0,1,123,0.0,123.0,123.0
242268.0,6,3,337,2,214,0.0,160.0,107.0,1,123,0.0,123.0,123.0
239694.0,17,2,180,1,90,0.0,90.0,90.0,1,90,0.0,90.0,90.0
135137510.0,17,6,1206,6,1206,27027502.0,201.0,201.0,0,0,0.0,0.0,0.0
90049394.0,17,27,12943,27,12943,3463438.230769231,501.0,479.3703703703704,0,0,0.0,0.0,0.0
34125.0,6,10,2032,5,524,8306.75,252.0,104.8,5,1508,7695.5,1236.0,301.6
56086.0,6,14,4740,7,653,8854.333333333334,249.0,93.28571428571428,7,4087,8994.666666666666,1514.0,583.8571428571429
205681.0,17,2,180,1,90,0.0,90.0,90.0,1,90,0.0,90.0,90.0
298424.0,6,6,412,4,272,99474.66666666669,74.0,68.0,2,140,0.0,74.0,70.0
121450.0,6,3,337,2,214,0.0,160.0,107.0,1,123,0.0,123.0,123.0
153511.0,17,2,180,1,90,0.0,90.0,90.0,1,90,0.0,90.0,90.0
2378.0,17,4,344,2,150,0.0,75.0,75.0,2,194,0.0,103.0,97.0
29087.0,6,10,2032,5,524,7031.5,252.0,104.8,5,1508,6693.0,1236.0,301.6
300.0,17,2,174,1,79,0.0,79.0,79.0,1,95,0.0,95.0,95.0
108108976.0,17,5,955,5,955,27027244.0,191.0,191.0,0,0,0.0,0.0,0.0
1399702.0,17,7,490,7,490,233283.66666666663,70.0,70.0,0,0,0.0,0.0,0.0
11462.0,6,11,1132,6,556,2292.4,218.0,92.66666666666669,5,576,2292.0,304.0,115.2
20751.0,6,10,2032,5,524,3360.0,252.0,104.8,5,1508,5030.5,1236.0,301.6
30737.0,6,14,4740,7,653,4617.666666666667,249.0,93.28571428571428,7,4087,4981.5,1514.0,583.8571428571429
108009.0,17,2,286,2,286,0.0,143.0,143.0,0,0,0.0,0.0,0.0
103911609.0,6,30,2122,15,1105,7406845.285714285,139.0,73.66666666666667,15,1017,7406827.714285715,123.0,67.8
2049.0,17,4,344,2,150,0.0,75.0,75.0,2,194,0.0,103.0,97.0
90285361.0,6,15,1097,8,596,12897908.714285716,95.0,74.5,7,501,14996804.0,95.0,71.57142857142857
44036.0,6,14,4740,7,653,6406.333333333333,249.0,93.28571428571428,7,4087,7162.0,1514.0,583.8571428571429
143979.0,17,2,180,1,90,0.0,90.0,90.0,1,90,0.0,90.0,90.0
9893.0,6,10,2032,5,524,2252.0,252.0,104.8,5,1508,2227.25,1236.0,301.6
348.0,17,2,156,1,78,0.0,78.0,78.0,1,78,0.0,78.0,78.0
50031.0,6,14,4740,7,653,7539.0,249.0,93.28571428571428,7,4087,8112.5,1514.0,583.8571428571429
307.0,17,2,174,1,79,0.0,79.0,79.0,1,95,0.0,95.0,95.0
3201163.0,6,15,2358,8,1068,457309.0,580.0,133.5,7,1290,498650.8333333333,731.0,184.28571428571428
254492.0,6,3,337,2,214,0.0,160.0,107.0,1,123,0.0,123.0,123.0
108109973.0,17,5,1005,5,1005,27027493.25,201.0,201.0,0,0,0.0,0.0,0.0
18495.0,17,2,582,1,83,0.0,83.0,83.0,1,499,0.0,499.0,499.0
153463.0,17,2,180,1,90,0.0,90.0,90.0,1,90,0.0,90.0,90.0
0.0,6,1,172,1,172,0.0,172.0,172.0,0,0,0.0,0.0,0.0
0.0,17,1,55,1,55,0.0,55.0,55.0,0,0,0.0,0.0,0.0
303660.0,6,2,132,1,66,0.0,66.0,66.0,1,66,0.0,66.0,66.0
90295254.0,6,19,1436,10,745,10027739.777777778,95.0,74.5,9,691,11286133.125,95.0,76.77777777777777
21142.0,6,20,7606,11,978,2114.2,310.0,88.9090909090909,9,6628,2321.875,1514.0,736.4444444444445
1982977.0,17,20,7488,20,7488,104367.2105263158,390.0,374.4,0,0,0.0,0.0,0.0
216968.0,6,3,426,2,280,0.0,214.0,140.0,1,146,0.0,146.0,146.0
38370.0,6,13,1479,7,882,5869.0,291.0,126.0,6,597,6995.0,259.0,99.5
2325.0,17,4,344,2,150,0.0,75.0,75.0,2,194,0.0,103.0,97.0
348.0,17,2,174,1,79,0.0,79.0,79.0,1,95,0.0,95.0,95.0
147912.0,17,2,180,1,90,0.0,90.0,90.0,1,90,0.0,90.0,90.0
149587919.0,6,26,2063,13,948,9983329.5,95.0,72.92307692307692,13,1115,12465069.666666666,221.0,85.76923076923077
90294003.0,6,19,1436,10,745,10028050.444444444,95.0,74.5,9,691,11285472.5,95.0,76.77777777777777
108109643.0,17,5,1005,5,1005,27027410.75,201.0,201.0,0,0,0.0,0.0,0.0
234120.0,6,3,337,2,214,0.0,160.0,107.0,1,123,0.0,123.0,123.0
147861.0,17,2,180,1,90,0.0,90.0,90.0,1,90,0.0,90.0,90.0
90258415.0,6,16,2368,9,1204,11282301.875,188.0,133.77777777777777,7,1164,15015670.833333334,204.0,166.28571428571428
52569.0,6,14,4740,7,653,8635.666666666666,249.0,93.28571428571428,7,4087,8084.333333333333,1514.0,583.8571428571429
120124866.0,6,14,2224,9,1204,15015608.25,188.0,133.77777777777777,5,1020,22526107.5,204.0,204.0
5603600.0,17,4,967,2,156,0.0,78.0,78.0,2,811,0.0,543.0,405.5
107725.0,17,2,700,2,700,0.0,350.0,350.0,0,0,0.0,0.0,0.0
314761.0,17,4,1400,4,1400,104920.33333333331,350.0,350.0,0,0,0.0,0.0,0.0
135126321.0,17,6,1206,6,1206,27025264.2,201.0,201.0,0,0,0.0,0.0,0.0
810.0,17,4,438,2,148,0.0,74.0,74.0,2,290,0.0,147.0,145.0
116639789.0,6,38,2710,19,1408,6479988.277777778,139.0,74.10526315789474,19,1302,6467950.5,123.0,68.52631578947368
90014669.0,17,27,12943,27,12943,3462102.653846154,501.0,479.3703703703704,0,0,0.0,0.0,0.0
9981.0,17,2,582,1,83,0.0,83.0,83.0,1,499,0.0,499.0,499.0
103242.0,17,2,286,2,286,0.0,143.0,143.0,0,0,0.0,0.0,0.0
110935929.0,6,30,1974,15,1026,7908580.357142857,123.0,68.4,15,948,7908581.0,123.0,63.2
354.0,17,2,267,1,83,0.0,83.0,83.0,1,184,0.0,184.0,184.0
46340.0,6,14,4740,7,653,7554.5,249.0,93.28571428571428,7,4087,6826.5,1514.0,583.8571428571429
2067.0,17,4,344,2,150,0.0,75.0,75.0,2,194,0.0,103.0,97.0
302416.0,6,2,132,1,66,0.0,66.0,66.0,1,66,0.0,66.0,66.0
3318.0,17,2,334,1,79,0.0,79.0,79.0,1,255,0.0,255.0,255.0
14665448.0,6,20,1648,10,1016,1592774.0,315.0,101.6,10,632,1592450.3333333333,78.0,63.2
866347.0,6,9,1118,6,586,173269.4,248.0,97.66666666666669,3,532,295344.0,392.0,177.33333333333334
104391297.0,17,16,5472,16,5472,6959419.8,342.0,342.0,0,0,0.0,0.0,0.0
27755357.0,17,5,1710,5,1710,6938839.25,342.0,342.0,0,0,0.0,0.0,0.0
245878.0,6,3,337,2,214,0.0,160.0,107.0,1,123,0.0,123.0,123.0
90287330.0,6,17,1287,9,691,11280530.125,95.0,76.77777777777777,8,596,12832375.0,95.0,74.5
3127829.0,6,3,1777,1,826,0.0,826.0,826.0,2,951,0.0,885.0,475.5
235193.0,6,3,373,2,238,0.0,172.0,119.0,1,135,0.0,135.0,135.0
1029104.0,6,11,1134,6,558,205820.8,220.0,93.0,5,576,255007.0,304.0,115.2
313762.0,6,6,412,4,272,104587.33333333331,74.0,68.0,2,140,0.0,74.0,70.0
11795.0,6,10,1067,5,536,2757.5,264.0,107.2,5,531,2160.5,259.0,106.2
143930.0,17,2,180,1,90,0.0,90.0,90.0,1,90,0.0,90.0,90.0
7030.0,17,2,458,1,85,0.0,85.0,85.0,1,373,0.0,373.0,373.0
37546.0,6,14,4740,7,653,6033.5,249.0,93.28571428571428,7,4087,6023.833333333333,1514.0,583.8571428571429
90259510.0,6,12,1832,8,1016,12894215.714285716,188.0,127.0,4,816,30031484.666666668,204.0,204.0
9215.0,6,10,2032,5,524,1931.25,252.0,104.8,5,1508,2024.75,1236.0,301.6
45356.0,6,2,132,1,66,0.0,66.0,66.0,1,66,0.0,66.0,66.0
324026.0,17,4,1400,4,1400,108008.66666666669,350.0,350.0,0,0,0.0,0.0,0.0
4255.0,17,2,614,1,72,0.0,72.0,72.0,1,542,0.0,542.0,542.0
308897.0,6,6,412,4,272,102965.66666666669,74.0,68.0,2,140,0.0,74.0,70.0
3744129.0,6,7,923,4,753,1179605.0,571.0,188.25,3,170,1769474.5,62.0,56.66666666666666
2589235.0,6,2,132,1,66,0.0,66.0,66.0,1,66,0.0,66.0,66.0
108102161.0,17,5,1005,5,1005,27025540.25,201.0,201.0,0,0,0.0,0.0,0.0
90094234.0,6,10,1440,7,828,15015705.666666666,188.0,118.28571428571428,3,612,30032324.0,204.0,204.0
135132225.0,17,6,1146,6,1146,27026445.0,191.0,191.0,0,0,0.0,0.0,0.0
153649.0,17,2,180,1,90,0.0,90.0,90.0,1,90,0.0,90.0,90.0
92345384.0,17,14,1126,7,563,15333469.166666666,174.0,80.42857142857143,7,563,15334482.833333334,174.0,80.42857142857143
315.0,17,2,174,1,79,0.0,79.0,79.0,1,95,0.0,95.0,95.0
91785181.0,6,243,28614,122,20406,758555.214876033,284.0,167.2622950819672,121,8208,756233.8666666667,140.0,67.83471074380165
44471.0,6,14,4740,7,653,7297.833333333333,249.0,93.28571428571428,7,4087,7087.5,1514.0,583.8571428571429
227019.0,6,13,1394,7,797,37836.5,253.0,113.85714285714286,6,597,43951.2,259.0,99.5
90803574.0,6,22,1680,12,894,8250436.181818182,95.0,74.5,10,786,10086902.888888888,95.0,78.6
321407.0,17,4,1400,4,1400,107135.66666666669,350.0,350.0,0,0,0.0,0.0,0.0
311592.0,17,4,1400,4,1400,103864.0,350.0,350.0,0,0,0.0,0.0,0.0
844557.0,6,9,1196,6,725,168911.4,387.0,120.83333333333331,3,471,284456.0,331.0,157.0
12098.0,6,11,2098,6,590,1992.8,252.0,98.33333333333331,5,1508,2659.0,1236.0,301.6
1379736.0,17,16,1120,16,1120,91982.4,70.0,70.0,0,0,0.0,0.0,0.0
108102942.0,17,5,1005,5,1005,27025735.5,201.0,201.0,0,0,0.0,0.0,0.0
116411805.0,6,216,24440,108,17090,1085949.476635514,284.0,158.24074074074073,108,7350,1085949.6728971964,140.0,68.05555555555556
296880.0,6,6,412,4,272,98960.0,74.0,68.0,2,140,0.0,74.0,70.0
36814.0,6,14,4740,7,653,4892.0,249.0,93.28571428571428,7,4087,5958.166666666667,1514.0,583.8571428571429
153629.0,17,2,180,1,90,0.0,90.0,90.0,1,90,0.0,90.0,90.0
6045.0,17,2,180,1,90,0.0,90.0,90.0,1,90,0.0,90.0,90.0
2780291.0,6,2,132,1,66,0.0,66.0,66.0,1,66,0.0,66.0,66.0
2073.0,17,4,344,2,150,0.0,75.0,75.0,2,194,0.0,103.0,97.0
166553.0,17,2,180,1,90,0.0,90.0,90.0,1,90,0.0,90.0,90.0
2391.0,17,4,344,2,150,0.0,75.0,75.0,2,194,0.0,103.0,97.0
51727685.0,6,8,2113,3,960,24545040.5,826.0,320.0,5,1153,12237387.75,885.0,230.6
9353.0,17,2,539,1,86,0.0,86.0,86.0,1,453,0.0,453.0,453.0
833.0,17,5,550,5,550,208.25,110.0,110.0,0,0,0.0,0.0,0.0
310571.0,17,4,1400,4,1400,103523.66666666669,350.0,350.0,0,0,0.0,0.0,0.0
181333.0,17,2,180,1,90,0.0,90.0,90.0,1,90,0.0,90.0,90.0
207284.0,6,3,426,2,280,0.0,214.0,140.0,1,146,0.0,146.0,146.0
90769262.0,6,23,1775,11,840,9052195.1,95.0,76.36363636363636,12,935,8232170.272727272,95.0,77.91666666666667
313147.0,6,6,412,4,272,104382.33333333331,74.0,68.0,2,140,0.0,74.0,70.0
53327.0,6,14,4740,7,653,8668.0,249.0,93.28571428571428,7,4087,7851.5,1514.0,583.8571428571429
302426.0,6,2,132,1,66,0.0,66.0,66.0,1,66,0.0,66.0,66.0
0.0,17,1,90,1,90,0.0,90.0,90.0,0,0,0.0,0.0,0.0
119217937.0,6,37,2910,20,1578,6263265.842105263,123.0,78.9,17,1332,7437628.875,123.0,78.3529411764706
0.0,17,1,80,1,80,0.0,80.0,80.0,0,0,0.0,0.0,0.0
105444865.0,17,14,864,7,432,17500960.166666668,174.0,61.71428571428572,7,432,17500145.5,174.0,61.71428571428572
37139.0,6,14,4740,7,653,6018.666666666667,249.0,93.28571428571428,7,4087,5948.666666666667,1514.0,583.8571428571429
104002.0,17,2,286,2,286,0.0,143.0,143.0,0,0,0.0,0.0,0.0
299009.0,6,6,412,4,272,99669.66666666669,74.0,68.0,2,140,0.0,74.0,70.0
2040.0,17,4,344,2,150,0.0,75.0,75.0,2,194,0.0,103.0,97.0
130219.0,6,3,337,2,214,0.0,160.0,107.0,1,123,0.0,123.0,123.0
245060.0,6,3,337,2,214,0.0,160.0,107.0,1,123,0.0,123.0,123.0
502.0,17,2,762,2,762,0.0,381.0,381.0,0,0,0.0,0.0,0.0
30887.0,6,16,4401,9,749,3860.875,213.0,83.22222222222223,7,3652,4332.666666666667,1514.0,521.7142857142857
330183.0,17,2,180,1,90,0.0,90.0,90.0,1,90,0.0,90.0,90.0
56492.0,6,11,2098,6,590,11029.4,252.0,98.33333333333331,5,1508,9903.0,1236.0,301.6
135133276.0,17,6,1206,6,1206,27026655.2,201.0,201.0,0,0,0.0,0.0,0.0
267410.0,6,10,1221,6,636,53482.0,298.0,106.0,4,585,83461.66666666667,379.0,146.25
91874974.0,17,16,5472,16,5472,6124998.266666667,342.0,342.0,0,0,0.0,0.0,0.0
245939.0,6,3,337,2,214,0.0,160.0,107.0,1,123,0.0,123.0,123.0
101252999.0,6,198,22404,99,15648,1030998.2040816328,284.0,158.06060606060606,99,6756,1030996.693877551,140.0,68.24242424242425
90044575.0,17,28,13364,28,13364,3334984.25925926,501.0,477.2857142857143,0,0,0.0,0.0,0.0
91421691.0,6,24,1829,13,989,7617389.833333333,95.0,76.07692307692308,11,840,9141856.9,95.0,76.36363636363636
145113.0,17,2,180,1,70,0.0,70.0,70.0,1,110,0.0,110.0,110.0
1302462.0,6,4,264,2,132,0.0,66.0,66.0,2,132,0.0,66.0,66.0
171669.0,17,2,180,1,90,0.0,90.0,90.0,1,90,0.0,90.0,90.0
285966.0,6,12,1373,7,714,47661.0,298.0,102.0,5,659,67442.25,379.0,131.8
10464623.0,6,7,478,4,272,3442847.333333333,74.0,68.0,3,206,5164144.5,74.0,68.66666666666667
90016646.0,17,28,13364,28,13364,3333949.851851852,501.0,477.2857142857143,0,0,0.0,0.0,0.0
153405.0,17,2,180,1,90,0.0,90.0,90.0,1,90,0.0,90.0,90.0
320251.0,6,6,412,4,272,106750.33333333331,74.0,68.0,2,140,0.0,74.0,70.0
135130218.0,17,6,1146,6,1146,27026043.6,191.0,191.0,0,0,0.0,0.0,0.0
232472.0,6,3,337,2,214,0.0,160.0,107.0,1,123,0.0,123.0,123.0
37559.0,6,10,1066,5,490,9121.25,218.0,98.0,5,576,9183.25,304.0,115.2
223281.0,6,3,426,2,280,0.0,214.0,140.0,1,146,0.0,146.0,146.0
332.0,17,2,267,1,83,0.0,83.0,83.0,1,184,0.0,184.0,184.0
205840.0,17,4,6056,4,6056,68613.33333333333,1514.0,1514.0,0,0,0.0,0.0,0.0
54860.0,6,14,4740,7,653,9032.833333333334,249.0,93.28571428571428,7,4087,8489.666666666666,1514.0,583.8571428571429
120018342.0,17,29,13785,29,13785,4286369.357142857,501.0,475.3448275862069,0,0,0.0,0.0,0.0
3134454.0,6,3,1604,1,753,0.0,753.0,753.0,2,851,0.0,785.0,425.5
311037.0,6,6,412,4,272,103679.0,74.0,68.0,2,140,0.0,74.0,70.0
96163851.0,6,66,15961,34,6715,2914056.090909091,1514.0,197.5,32,9246,3093438.35483871,1514.0,288.9375
60143.0,6,14,4740,7,653,9263.5,249.0,93.28571428571428,7,4087,7736.166666666667,1514.0,583.8571428571429
24776.0,6,10,2032,5,524,5772.75,252.0,104.8,5,1508,5934.0,1236.0,301.6
21525.0,6,14,4740,7,653,3241.833333333333,249.0,93.28571428571428,7,4087,3449.1666666666665,1514.0,583.8571428571429
3260.0,17,2,363,1,75,0.0,75.0,75.0,1,288,0.0,288.0,288.0
37863.0,6,14,4740,7,653,6189.833333333333,249.0,93.28571428571428,7,4087,5896.5,1514.0,583.8571428571429
1859.0,17,2,762,2,762,0.0,381.0,381.0,0,0,0.0,0.0,0.0
227609.0,17,2,180,1,90,0.0,90.0,90.0,1,90,0.0,90.0,90.0
115221947.0,6,31,2166,16,1149,7667823.8,123.0,71.8125,15,1017,8215536.214285715,123.0,67.8
216344.0,17,2,180,1,90,0.0,90.0,90.0,1,90,0.0,90.0,90.0
120122799.0,6,16,2356,9,1204,15015349.875,188.0,133.77777777777777,7,1152,15054662.5,204.0,164.57142857142858
346.0,17,2,267,1,83,0.0,83.0,83.0,1,184,0.0,184.0,184.0
1303560.0,6,4,264,2,132,0.0,66.0,66.0,2,132,0.0,66.0,66.0
329664.0,6,6,412,4,272,109888.0,74.0,68.0,2,140,0.0,74.0,70.0
2040236.0,17,4,820,2,156,0.0,78.0,78.0,2,664,0.0,332.0,332.0
2115.0,17,4,344,2,150,0.0,75.0,75.0,2,194,0.0,103.0,97.0
298409.0,6,6,412,4,272,99469.66666666669,74.0,68.0,2,140,0.0,74.0,70.0
148160.0,6,3,337,2,214,0.0,160.0,107.0,1,123,0.0,123.0,123.0
30620.0,6,14,4740,7,653,4904.666666666667,249.0,93.28571428571428,7,4087,4285.166666666667,1514.0,583.8571428571429
1307403.0,6,4,264,2,132,0.0,66.0,66.0,2,132,0.0,66.0,66.0
375.0,17,2,174,1,79,0.0,79.0,79.0,1,95,0.0,95.0,95.0
108104697.0,17,5,955,5,955,27026174.25,191.0,191.0,0,0,0.0,0.0,0.0
50768.0,17,2,180,1,90,0.0,90.0,90.0,1,90,0.0,90.0,90.0
42679.0,6,14,4740,7,653,6319.333333333333,249.0,93.28571428571428,7,4087,6969.333333333333,1514.0,583.8571428571429
118503629.0,6,48,3168,24,1584,5152331.695652174,66.0,66.0,24,1584,5138034.739130435,66.0,66.0
135114915.0,17,6,1146,6,1146,27022983.0,191.0,191.0,0,0,0.0,0.0,0.0
662933.0,17,4,883,2,156,0.0,78.0,78.0,2,727,0.0,395.0,363.5
837368.0,6,9,1118,6,586,167473.6,248.0,97.66666666666669,3,532,280931.0,392.0,177.33333333333334
118486637.0,6,216,24456,108,17106,1105377.4112149533,284.0,158.38888888888889,108,7350,1105377.289719626,140.0,68.05555555555556
25640.0,6,14,4740,7,653,3991.0,249.0,93.28571428571428,7,4087,4029.3333333333335,1514.0,583.8571428571429
58994.0,6,14,4740,7,653,9707.666666666666,249.0,93.28571428571428,7,4087,7705.833333333333,1514.0,583.8571428571429
2955810.0,6,3,1604,1,753,0.0,753.0,753.0,2,851,0.0,785.0,425.5
108101824.0,6,30,2106,15,1089,7706150.0,123.0,72.6,15,1017,7706138.0,123.0,67.8
2403.0,17,4,344,2,150,0.0,75.0,75.0,2,194,0.0,103.0,97.0
18161.0,6,10,2032,5,524,4311.75,252.0,104.8,5,1508,3609.0,1236.0,301.6
32177.0,6,12,1413,7,882,5362.833333333333,291.0,126.0,5,531,6441.0,259.0,106.2
1153966.0,6,13,3009,8,2381,164852.2857142857,1514.0,297.625,5,628,220393.25,331.0,125.6
307029.0,6,3,202,2,128,0.0,74.0,64.0,1,74,0.0,74.0,74.0
677887.0,6,4,508,2,238,0.0,172.0,119.0,2,270,0.0,135.0,135.0
241950.0,6,3,337,2,214,0.0,160.0,107.0,1,123,0.0,123.0,123.0
120041851.0,6,214,24218,107,16934,1130439.5188679246,284.0,158.26168224299064,107,7284,1130439.1981132077,140.0,68.07476635514018
106387.0,17,4,1400,4,1400,35462.333333333336,350.0,350.0,0,0,0.0,0.0,0.0
2044.0,17,4,344,2,150,0.0,75.0,75.0,2,194,0.0,103.0,97.0
508130.0,6,3,1777,1,826,0.0,826.0,826.0,2,951,0.0,885.0,475.5
253327.00000000003,6,10,1221,6,636,50665.4,298.0,106.0,4,585,79031.0,379.0,146.25
33731.0,6,14,4740,7,653,5496.166666666667,249.0,93.28571428571428,7,4087,5483.5,1514.0,583.8571428571429
21438.0,6,11,1133,6,602,4071.4,264.0,100.33333333333331,5,531,4723.25,259.0,106.2
36043.0,6,14,4740,7,653,5879.333333333333,249.0,93.28571428571428,7,4087,5868.5,1514.0,583.8571428571429
26781.0,6,10,2032,5,524,6460.25,252.0,104.8,5,1508,5726.5,1236.0,301.6
13365.0,6,11,1132,6,556,2559.2,218.0,92.66666666666669,5,576,3063.0,304.0,115.2
108144.0,17,2,286,2,286,0.0,143.0,143.0,0,0,0.0,0.0,0.0
118685108.0,6,220,24884,110,17402,1086871.128440367,284.0,158.2,110,7482,1086880.0550458715,140.0,68.01818181818182
102613.0,17,2,286,2,286,0.0,143.0,143.0,0,0,0.0,0.0,0.0
233382.0,6,3,337,2,214,0.0,160.0,107.0,1,123,0.0,123.0,123.0
105565.0,17,2,700,2,700,0.0,350.0,350.0,0,0,0.0,0.0,0.0
120122093.0,6,13,2020,9,1204,15015261.625,188.0,133.77777777777777,4,816,30030189.0,204.0,204.0
108117003.0,17,5,1005,5,1005,27029250.75,201.0,201.0,0,0,0.0,0.0,0.0
299106.0,6,6,412,4,272,99702.0,74.0,68.0,2,140,0.0,74.0,70.0
343.0,17,2,267,1,83,0.0,83.0,83.0,1,184,0.0,184.0,184.0
320786.0,17,4,1400,4,1400,106928.66666666669,350.0,350.0,0,0,0.0,0.0,0.0
512940.0,17,2,363,1,79,0.0,79.0,79.0,1,284,0.0,284.0,284.0
33081.0,6,13,1479,7,882,5397.666666666667,291.0,126.0,6,597,5540.6,259.0,99.5
108098337.0,17,5,955,5,955,27024584.25,191.0,191.0,0,0,0.0,0.0,0.0
556.0,17,2,267,1,83,0.0,83.0,83.0,1,184,0.0,184.0,184.0
205382.0,17,2,762,2,762,0.0,381.0,381.0,0,0,0.0,0.0,0.0
248226.0,6,3,337,2,214,0.0,160.0,107.0,1,123,0.0,123.0,123.0
322.0,17,2,160,1,80,0.0,80.0,80.0,1,80,0.0,80.0,80.0
368520.0,6,12,1373,7,714,61420.0,298.0,102.0,5,659,91296.25,379.0,131.8
121311.0,6,3,337,2,214,0.0,160.0,107.0,1,123,0.0,123.0,123.0
102596548.0,6,28,1860,14,966,7892042.153846154,123.0,69.0,14,894,7875389.230769231,123.0,63.85714285714285
118025511.0,6,30,1974,15,1026,8415790.92857143,123.0,68.4,15,948,8415790.0,123.0,63.2
29648.0,6,10,1065,5,534,6037.75,262.0,106.8,5,531,5937.5,259.0,106.2
30193.0,6,10,2032,5,524,6869.0,252.0,104.8,5,1508,6746.0,1236.0,301.6
56325.0,6,14,4740,7,653,8070.166666666667,249.0,93.28571428571428,7,4087,8520.0,1514.0,583.8571428571429
30482.0,6,14,4740,7,653,4923.666666666667,249.0,93.28571428571428,7,4087,4687.833333333333,1514.0,583.8571428571429
90026036.0,17,28,13364,28,13364,3334297.6296296297,501.0,477.2857142857143,0,0,0.0,0.0,0.0
1674501.0,17,18,1260,18,1260,98500.0588235294,70.0,70.0,0,0,0.0,0.0,0.0
0.0,6,1,172,1,172,0.0,172.0,172.0,0,0,0.0,0.0,0.0
135135252.0,17,6,1146,6,1146,27027050.4,191.0,191.0,0,0,0.0,0.0,0.0
104138160.0,17,15,5130,15,5130,7438440.0,342.0,342.0,0,0,0.0,0.0,0.0
139665.0,6,2,132,1,66,0.0,66.0,66.0,1,66,0.0,66.0,66.0
3066766.0,6,4,270,3,202,1533383.0,70.0,67.33333333333333,1,68,0.0,68.0,68.0
46529.0,6,14,4740,7,653,6006.333333333333,249.0,93.28571428571428,7,4087,7332.833333333333,1514.0,583.8571428571429
40378.0,6,10,2032,5,524,9803.5,252.0,104.8,5,1508,8730.5,1236.0,301.6
9483.0,17,2,582,1,83,0.0,83.0,83.0,1,499,0.0,499.0,499.0
1994.0,17,4,344,2,150,0.0,75.0,75.0,2,194,0.0,103.0,97.0
3006578.0,6,12,2172,7,664,500974.0,252.0,94.85714285714286,5,1508,1792.25,1236.0,301.6
82852653.0,17,14,4796,13,4446,6227528.583333333,342.0,342.0,1,350,0.0,350.0,350.0
92318499.0,17,14,4788,14,4788,7101423.0,342.0,342.0,0,0,0.0,0.0,0.0
62073.0,6,14,4740,7,653,10122.166666666666,249.0,93.28571428571428,7,4087,9598.833333333334,1514.0,583.8571428571429
136516.0,6,2,132,1,66,0.0,66.0,66.0,1,66,0.0,66.0,66.0
0.0,17,1,381,1,381,0.0,381.0,381.0,0,0,0.0,0.0,0.0
19114978.0,6,6,1981,4,1087,6371659.333333333,885.0,271.75,2,894,0.0,826.0,447.0
25455.0,6,14,4740,7,653,3876.8333333333335,249.0,93.28571428571428,7,4087,4102.0,1514.0,583.8571428571429
103225.0,17,2,286,2,286,0.0,143.0,143.0,0,0,0.0,0.0,0.0
135154944.0,17,6,1146,6,1146,27030988.8,191.0,191.0,0,0,0.0,0.0,0.0
3170506.0,6,18,1495,9,921,358383.0,315.0,102.33333333333331,9,574,358347.0,78.0,63.77777777777778
196933.0,17,2,180,1,90,0.0,90.0,90.0,1,90,0.0,90.0,90.0
120153266.0,6,248,28368,124,8406,973028.951219512,140.0,67.79032258064517,124,19962,970162.0162601626,464.0,160.98387096774192
123455873.0,6,48,3168,24,1584,4947729.956521739,66.0,66.0,24,1584,5320234.0869565215,66.0,66.0
18079.0,6,20,7606,11,978,1807.9,310.0,88.9090909090909,9,6628,1961.625,1514.0,736.4444444444445
108108216.0,17,5,955,5,955,27027054.0,191.0,191.0,0,0,0.0,0.0,0.0
1362913.0,17,6,1230,3,234,681237.5,78.0,78.0,3,996,681237.0,332.0,332.0
206654.0,6,3,426,2,280,0.0,214.0,140.0,1,146,0.0,146.0,146.0
17930.0,6,20,7606,11,978,1793.0,310.0,88.9090909090909,9,6628,1982.25,1514.0,736.4444444444445
216539.0,17,2,180,1,90,0.0,90.0,90.0,1,90,0.0,90.0,90.0
34348.0,6,2,145,2,145,0.0,91.0,72.5,0,0,0.0,0.0,0.0
93110777.0,6,40,2640,20,1320,4891792.157894737,66.0,66.0,20,1320,4897186.894736842,66.0,66.0
6968.0,17,2,582,1,83,0.0,83.0,83.0,1,499,0.0,499.0,499.0
142322.0,6,2,132,1,66,0.0,66.0,66.0,1,66,0.0,66.0,66.0
361.0,17,2,248,1,84,0.0,84.0,84.0,1,164,0.0,164.0,164.0
9968.0,17,2,571,1,86,0.0,86.0,86.0,1,485,0.0,485.0,485.0
105572.0,17,4,1400,4,1400,35190.666666666664,350.0,350.0,0,0,0.0,0.0,0.0
2689790.0,6,2,132,1,66,0.0,66.0,66.0,1,66,0.0,66.0,66.0
90004640.0,17,28,13364,28,13364,3333505.185185185,501.0,477.2857142857143,0,0,0.0,0.0,0.0
1582.0,17,2,762,2,762,0.0,381.0,381.0,0,0,0.0,0.0,0.0
110366490.0,6,30,1974,15,1026,7867891.357142857,123.0,68.4,15,948,7867890.928571428,123.0,63.2
3242.0,17,2,224,1,76,0.0,76.0,76.0,1,148,0.0,148.0,148.0
967193.0,6,20,6434,12,1921,87926.63636363637,620.0,160.08333333333334,8,4513,115623.42857142857,1514.0,564.125
1998.0,17,5,550,5,550,499.5,110.0,110.0,0,0,0.0,0.0,0.0
116459033.0,6,216,24296,108,16872,1086427.3925233644,284.0,156.22222222222223,108,7424,1086427.4392523365,140.0,68.74074074074075
0.0,6,1,66,1,66,0.0,66.0,66.0,0,0,0.0,0.0,0.0
108112734.0,17,5,955,5,955,27028183.5,191.0,191.0,0,0,0.0,0.0,0.0
90256194.0,6,13,2036,8,1016,12893742.0,188.0,127.0,5,1020,22520043.5,204.0,204.0
43542.0,6,14,4740,7,653,5734.666666666667,249.0,93.28571428571428,7,4087,7030.166666666667,1514.0,583.8571428571429
57427.0,6,10,2032,5,524,14020.75,252.0,104.8,5,1508,12033.75,1236.0,301.6
252462.00000000003,6,10,1221,6,636,50492.4,298.0,106.0,4,585,78413.66666666667,379.0,146.25
37027.0,6,14,4740,7,653,5508.5,249.0,93.28571428571428,7,4087,6029.5,1514.0,583.8571428571429
360.0,17,2,267,1,83,0.0,83.0,83.0,1,184,0.0,184.0,184.0
244416.0,17,4,6056,4,6056,81472.0,1514.0,1514.0,0,0,0.0,0.0,0.0
108105900.0,17,5,1005,5,1005,27026475.0,201.0,201.0,0,0,0.0,0.0,0.0
297999.0,6,6,412,4,272,99333.0,74.0,68.0,2,140,0.0,74.0,70.0
300411.0,17,2,180,1,90,0.0,90.0,90.0,1,90,0.0,90.0,90.0
90087385.0,6,11,1644,4,816,30028305.0,204.0,204.0,7,828,15014169.0,188.0,118.28571428571428
147994.0,17,2,180,1,90,0.0,90.0,90.0,1,90,0.0,90.0,90.0
120950074.0,6,35,2680,19,1471,6719448.555555556,139.0,77.42105263157895,16,1209,7384069.0,123.0,75.5625
90581106.0,6,26,1746,13,906,7530437.916666667,123.0,69.6923076923077,13,840,7530425.583333333,123.0,64.61538461538461
146108.0,6,3,337,2,214,0.0,160.0,107.0,1,123,0.0,123.0,123.0
5622898.0,6,5,336,2,134,0.0,68.0,67.0,3,202,1522607.5,70.0,67.33333333333333
35423.0,6,14,4740,7,653,5071.0,249.0,93.28571428571428,7,4087,5559.833333333333,1514.0,583.8571428571429
5560.0,17,4,823,2,163,0.0,89.0,81.5,2,660,0.0,443.0,330.0
2798396.0,6,2,132,1,66,0.0,66.0,66.0,1,66,0.0,66.0,66.0
2330540.0,6,3,1604,2,851,0.0,785.0,425.5,1,753,0.0,753.0,753.0
930272.0,6,10,1333,6,796,186054.4,458.0,132.66666666666666,4,537,218208.66666666663,331.0,134.25
97309604.0,17,14,1126,7,563,16166795.5,174.0,80.42857142857143,7,563,16170872.0,174.0,80.42857142857143
127805821.0,6,30,1974,15,948,8415784.214285715,123.0,63.2,15,1026,8415772.214285715,123.0,68.4
304739.0,6,6,412,4,272,101579.66666666669,74.0,68.0,2,140,0.0,74.0,70.0
102270.0,17,2,700,2,700,0.0,350.0,350.0,0,0,0.0,0.0,0.0
5624552.0,6,4,270,2,134,0.0,68.0,67.0,2,136,0.0,70.0,68.0
36207.0,6,10,2032,5,524,8380.0,252.0,104.8,5,1508,8807.25,1236.0,301.6
206076.0,6,3,426,2,280,0.0,214.0,140.0,1,146,0.0,146.0,146.0
61369.0,6,14,4740,7,653,9799.333333333334,249.0,93.28571428571428,7,4087,9773.666666666666,1514.0,583.8571428571429
153425.0,17,2,180,1,90,0.0,90.0,90.0,1,90,0.0,90.0,90.0
103267.0,17,2,286,2,286,0.0,143.0,143.0,0,0,0.0,0.0,0.0
308228.0,6,6,412,4,272,102742.66666666669,74.0,68.0,2,140,0.0,74.0,70.0
110476206.0,6,37,2788,19,1471,6137567.0,139.0,77.42105263157895,18,1317,6485865.176470588,123.0,73.16666666666667
2285.0,17,4,344,2,150,0.0,75.0,75.0,2,194,0.0,103.0,97.0
24519.0,17,2,582,1,83,0.0,83.0,83.0,1,499,0.0,499.0,499.0
2338.0,17,4,344,2,150,0.0,75.0,75.0,2,194,0.0,103.0,97.0
52920.0,6,14,4740,7,653,8690.5,249.0,93.28571428571428,7,4087,8188.833333333333,1514.0,583.8571428571429
207996.0,6,10,1221,6,636,41599.2,298.0,106.0,4,585,68219.66666666667,379.0,146.25
4430.0,17,2,614,1,72,0.0,72.0,72.0,1,542,0.0,542.0,542.0
48116.0,6,14,4740,7,653,7654.166666666667,249.0,93.28571428571428,7,4087,7345.0,1514.0,583.8571428571429
144447.0,6,2,132,1,66,0.0,66.0,66.0,1,66,0.0,66.0,66.0
757231.0,6,2,132,1,66,0.0,66.0,66.0,1,66,0.0,66.0,66.0
90312322.0,6,19,1436,10,745,10028569.222222222,95.0,74.5,9,691,11287526.75,95.0,76.77777777777777
318.0,17,2,174,1,79,0.0,79.0,79.0,1,95,0.0,95.0,95.0
146102.0,6,3,337,2,214,0.0,160.0,107.0,1,123,0.0,123.0,123.0
357226.0,17,2,363,1,75,0.0,75.0,75.0,1,288,0.0,288.0,288.0
97449007.0,6,33,2359,17,1194,6090562.9375,123.0,70.23529411764706,16,1165,6481852.866666666,139.0,72.8125
135144949.0,17,6,1146,6,1146,27028989.8,191.0,191.0,0,0,0.0,0.0,0.0
206469.0,17,2,180,1,90,0.0,90.0,90.0,1,90,0.0,90.0,90.0
309293.0,6,3,202,2,128,0.0,74.0,64.0,1,74,0.0,74.0,74.0
102858.0,17,2,700,2,700,0.0,350.0,350.0,0,0,0.0,0.0,0.0
39703.0,6,13,4416,6,409,7796.6,127.0,68.16666666666667,7,4007,5795.166666666667,1514.0,572.4285714285714
298679.0,6,6,412,4,272,99559.66666666669,74.0,68.0,2,140,0.0,74.0,70.0
21054.0,6,14,4740,7,653,3239.333333333333,249.0,93.28571428571428,7,4087,3174.0,1514.0,583.8571428571429
103022809.0,6,223,25134,112,17586,928133.4144144144,284.0,157.01785714285714,111,7548,927247.3272727272,140.0,68.0
869545.0,6,10,1333,6,796,173909.0,458.0,132.66666666666666,4,537,197908.66666666663,331.0,134.25
103167813.0,17,14,1126,7,563,17168148.666666668,174.0,80.42857142857143,7,563,17168151.833333332,174.0,80.42857142857143
104248289.0,6,195,22138,98,6764,1074724.6288659794,140.0,69.0204081632653,97,15374,1064282.8645833333,284.0,158.49484536082474
115989049.0,6,48,3168,24,1584,5043002.130434782,66.0,66.0,24,1584,5031030.0869565215,66.0,66.0
407.0,17,2,267,1,83,0.0,83.0,83.0,1,184,0.0,184.0,184.0
302.0,17,2,174,1,79,0.0,79.0,79.0,1,95,0.0,95.0,95.0
16939.0,6,14,4740,7,653,2263.333333333333,249.0,93.28571428571428,7,4087,2690.6666666666665,1514.0,583.8571428571429
102544.0,17,2,286,2,286,0.0,143.0,143.0,0,0,0.0,0.0,0.0
241145.0,6,11,1143,6,612,47763.2,262.0,102.0,5,531,3266.75,259.0,106.2
193693.0,6,3,337,2,214,0.0,160.0,107.0,1,123,0.0,123.0,123.0
827128.0,6,9,1118,6,586,165425.6,248.0,97.66666666666669,3,532,277288.5,392.0,177.33333333333334
5168.0,17,4,344,2,150,0.0,75.0,75.0,2,194,0.0,103.0,97.0
10478434.0,6,7,478,4,272,3447511.0,74.0,68.0,3,206,5171162.5,74.0,68.66666666666667
29118.0,6,10,2032,5,524,6784.25,252.0,104.8,5,1508,6611.5,1236.0,301.6
307462.0,6,6,412,4,272,102487.33333333331,74.0,68.0,2,140,0.0,74.0,70.0
98148723.0,6,252,28986,126,20448,783467.584,300.0,162.28571428571428,126,8538,783467.552,140.0,67.76190476190476
42480.0,6,10,2032,5,524,10387.75,252.0,104.8,5,1508,10156.25,1236.0,301.6
102001210.0,17,13,821,7,432,17000201.666666668,174.0,61.71428571428572,6,389,19999670.6,174.0,64.83333333333333
120034887.0,6,19,1395,10,745,13332313.888888888,95.0,74.5,9,650,14998056.0,95.0,72.22222222222223
1530379.0,6,4,276,2,128,0.0,74.0,64.0,2,148,0.0,74.0,74.0
90282194.0,6,21,1585,11,840,9023975.2,95.0,76.36363636363636,10,745,9999582.555555556,95.0,74.5
20369.0,6,11,2098,6,590,3917.4,252.0,98.33333333333331,5,1508,4644.75,1236.0,301.6
115070904.0,17,14,864,7,432,19167651.666666668,174.0,61.71428571428572,7,432,19166804.666666668,174.0,61.71428571428572
108108135.0,17,5,1005,5,1005,27027033.75,201.0,201.0,0,0,0.0,0.0,0.0
120127387.0,6,14,2240,6,1224,24025477.4,204.0,204.0,8,1016,17137474.285714287,188.0,127.0
2039662.0,17,2,876,2,876,0.0,438.0,438.0,0,0,0.0,0.0,0.0
122008187.0,17,15,907,8,475,17429741.0,174.0,59.375,7,432,17000204.833333332,174.0,61.71428571428572
39155.0,6,10,2032,5,524,9523.5,252.0,104.8,5,1508,9465.0,1236.0,301.6
2025.0,17,4,344,2,150,0.0,75.0,75.0,2,194,0.0,103.0,97.0
306851.0,6,6,412,4,272,102283.66666666669,74.0,68.0,2,140,0.0,74.0,70.0
17021.0,6,14,4740,7,653,2590.333333333333,249.0,93.28571428571428,7,4087,2689.6666666666665,1514.0,583.8571428571429
34434.0,6,14,4740,7,653,5332.0,249.0,93.28571428571428,7,4087,5176.5,1514.0,583.8571428571429
42414.0,6,10,2032,5,524,8709.25,252.0,104.8,5,1508,10247.25,1236.0,301.6
147039.0,6,3,373,2,238,0.0,172.0,119.0,1,135,0.0,135.0,135.0
55844.0,6,10,2032,5,524,13420.75,252.0,104.8,5,1508,13722.5,1236.0,301.6
315.0,17,2,174,1,79,0.0,79.0,79.0,1,95,0.0,95.0,95.0
90034536.0,17,28,13364,28,13364,3334612.4444444445,501.0,477.2857142857143,0,0,0.0,0.0,0.0
108112648.0,17,5,1005,5,1005,27028162.0,201.0,201.0,0,0,0.0,0.0,0.0
14884.0,6,14,4740,7,653,2356.333333333333,249.0,93.28571428571428,7,4087,2269.833333333333,1514.0,583.8571428571429
17691.0,6,10,2032,5,524,3901.5,252.0,104.8,5,1508,4129.25,1236.0,301.6
31348.0,6,14,4740,7,653,5111.333333333333,249.0,93.28571428571428,7,4087,5052.333333333333,1514.0,583.8571428571429
103522.0,17,2,286,2,286,0.0,143.0,143.0,0,0,0.0,0.0,0.0
2398.0,17,4,344,2,150,0.0,75.0,75.0,2,194,0.0,103.0,97.0
255388.0,6,3,337,2,214,0.0,160.0,107.0,1,123,0.0,123.0,123.0
108108575.0,17,5,1005,5,1005,27027143.75,201.0,201.0,0,0,0.0,0.0,0.0
120066317.0,17,28,13364,28,13364,4446900.62962963,501.0,477.2857142857143,0,0,0.0,0.0,0.0
9745.0,17,2,539,1,86,0.0,86.0,86.0,1,453,0.0,453.0,453.0
135133266.0,17,6,1206,6,1206,27026653.2,201.0,201.0,0,0,0.0,0.0,0.0
135132266.0,17,6,1206,6,1206,27026453.2,201.0,201.0,0,0,0.0,0.0,0.0
35253.0,6,14,4740,7,653,5756.166666666667,249.0,93.28571428571428,7,4087,5738.166666666667,1514.0,583.8571428571429
1530.0,17,2,762,2,762,0.0,381.0,381.0,0,0,0.0,0.0,0.0
299396.0,6,6,412,4,272,99798.66666666669,74.0,68.0,2,140,0.0,74.0,70.0
108108710.0,17,5,1005,5,1005,27027177.5,201.0,201.0,0,0,0.0,0.0,0.0
383.0,17,2,267,1,83,0.0,83.0,83.0,1,184,0.0,184.0,184.0
41320.0,6,10,2032,5,524,10109.0,252.0,104.8,5,1508,9964.75,1236.0,301.6
28385.0,6,12,1413,6,816,5483.4,291.0,136.0,6,597,5231.6,259.0,99.5
90255930.0,6,14,2240,8,1016,12893704.285714284,188.0,127.0,6,1224,18016665.6,204.0,204.0
533047.0,17,6,2100,6,2100,106609.4,350.0,350.0,0,0,0.0,0.0,0.0
135136277.0,17,6,1146,6,1146,27027255.4,191.0,191.0,0,0,0.0,0.0,0.0
1170821.0,6,13,3012,8,2384,167260.14285714287,1514.0,298.0,5,628,223880.0,331.0,125.6
207421.0,6,3,426,2,280,0.0,214.0,140.0,1,146,0.0,146.0,146.0
324901.0,17,4,1400,4,1400,108300.33333333331,350.0,350.0,0,0,0.0,0.0,0.0
22293.0,6,10,1067,5,536,5298.25,264.0,107.2,5,531,4470.75,259.0,106.2
39441.0,6,10,2032,5,524,9539.25,252.0,104.8,5,1508,8270.75,1236.0,301.6
29957.0,6,14,4740,7,653,4343.333333333333,249.0,93.28571428571428,7,4087,4627.5,1514.0,583.8571428571429
120123484.0,6,13,2020,9,1204,15015435.5,188.0,133.77777777777777,4,816,30032258.33333333,204.0,204.0
0.0,6,1,66,1,66,0.0,66.0,66.0,0,0,0.0,0.0,0.0
805.0,17,4,438,2,148,0.0,74.0,74.0,2,290,0.0,147.0,145.0
251986.0,6,3,337,2,214,0.0,160.0,107.0,1,123,0.0,123.0,123.0
295367.0,6,6,412,4,272,98455.66666666669,74.0,68.0,2,140,0.0,74.0,70.0
5345283.0,6,6,470,2,132,0.0,66.0,66.0,4,338,1781761.0,103.0,84.5
28736.0,6,14,4740,7,653,3953.3333333333335,249.0,93.28571428571428,7,4087,4652.333333333333,1514.0,583.8571428571429
90063071.0,17,28,13364,28,13364,3335669.296296296,501.0,477.2857142857143,0,0,0.0,0.0,0.0
153382.0,17,2,180,1,90,0.0,90.0,90.0,1,90,0.0,90.0,90.0
0.0,17,1,72,1,72,0.0,72.0,72.0,0,0,0.0,0.0,0.0
171965.0,6,14,4740,7,653,28304.83333333333,249.0,93.28571428571428,7,4087,23377.5,1514.0,583.8571428571429
90039716.0,17,28,13364,28,13364,3334804.296296296,501.0,477.2857142857143,0,0,0.0,0.0,0.0
135128666.0,17,6,1146,6,1146,27025733.2,191.0,191.0,0,0,0.0,0.0,0.0
57469.0,6,14,4740,7,653,7622.166666666667,249.0,93.28571428571428,7,4087,9345.333333333334,1514.0,583.8571428571429
114099480.0,6,35,2542,18,1348,6711734.117647059,139.0,74.88888888888889,17,1194,6493628.0625,123.0,70.23529411764706
5624209.0,6,4,270,2,134,0.0,68.0,67.0,2,136,0.0,70.0,68.0
128093.0,17,4,1524,4,1524,42697.66666666666,381.0,381.0,0,0,0.0,0.0,0.0
37114.0,6,10,2032,5,524,7364.0,252.0,104.8,5,1508,8749.75,1236.0,301.6
120348282.0,6,319,37034,160,26244,756907.4339622641,284.0,164.025,159,10790,755407.2405063291,140.0,67.86163522012579
121001127.0,17,15,907,8,475,17285875.285714287,174.0,59.375,7,432,16779800.166666668,174.0,61.71428571428572
2740015.0,6,3,1604,1,753,0.0,753.0,753.0,2,851,0.0,785.0,425.5
10471792.0,6,7,478,4,272,3445425.6666666665,74.0,68.0,3,206,5168065.5,74.0,68.66666666666667
25467.0,6,14,4740,7,653,3891.3333333333335,249.0,93.28571428571428,7,4087,4066.8333333333335,1514.0,583.8571428571429
95173426.0,6,176,19888,88,13858,1091473.8275862068,284.0,157.47727272727272,88,6030,1091473.8505747127,140.0,68.52272727272727
216415.0,17,2,180,1,90,0.0,90.0,90.0,1,90,0.0,90.0,90.0
135154863.0,17,6,1146,6,1146,27030972.6,191.0,191.0,0,0,0.0,0.0,0.0
13791.0,6,14,4740,7,653,2178.333333333333,249.0,93.28571428571428,7,4087,2115.833333333333,1514.0,583.8571428571429
120000554.0,6,22,1680,11,840,12000055.4,95.0,76.36363636363636,11,840,9001355.0,95.0,76.36363636363636
1758575.0,6,23,6508,12,1529,159870.45454545456,357.0,127.41666666666669,11,4979,144882.0,1510.0,452.6363636363636
12652205.0,6,7,499,4,301,3521455.333333333,103.0,75.25,3,198,4726685.5,66.0,66.0
347.0,17,2,250,1,93,0.0,93.0,93.0,1,157,0.0,157.0,157.0
42338.0,6,14,4740,7,653,6935.166666666667,249.0,93.28571428571428,7,4087,6502.333333333333,1514.0,583.8571428571429
16849.0,6,14,4740,7,653,2519.0,249.0,93.28571428571428,7,4087,2658.5,1514.0,583.8571428571429
105652.0,17,2,700,2,700,0.0,350.0,350.0,0,0,0.0,0.0,0.0
10837493.0,6,8,544,4,272,3567239.0,74.0,68.0,4,272,3567158.0,74.0,68.0
122975243.0,6,48,3168,24,1584,5043208.304347826,66.0,66.0,24,1584,5223824.130434782,66.0,66.0
198221.0,17,2,180,1,90,0.0,90.0,90.0,1,90,0.0,90.0,90.0
64634.0,6,14,4740,7,653,10394.833333333334,249.0,93.28571428571428,7,4087,9486.166666666666,1514.0,583.8571428571429
21856.0,6,10,2032,5,524,5126.25,252.0,104.8,5,1508,5178.0,1236.0,301.6
10474585.0,6,6,412,3,206,5168943.5,74.0,68.66666666666667,3,206,5169009.5,74.0,68.66666666666667
0.0,17,1,350,1,350,0.0,350.0,350.0,0,0,0.0,0.0,0.0
319.0,17,2,174,1,79,0.0,79.0,79.0,1,95,0.0,95.0,95.0
10871316.0,6,8,544,4,272,3576674.333333333,74.0,68.0,4,272,3576614.333333333,74.0,68.0
40338.0,6,14,4740,7,653,6488.666666666667,249.0,93.28571428571428,7,4087,5188.333333333333,1514.0,583.8571428571429
153815.0,6,10,1066,5,490,37446.5,218.0,98.0,5,576,38250.0,304.0,115.2
90262034.0,6,16,2368,9,1204,11282754.25,188.0,133.77777777777777,7,1164,15015678.0,204.0,166.28571428571428
363234.0,6,11,1021,6,444,48753.6,162.0,74.0,5,577,60918.5,349.0,115.4
298391.0,6,6,412,4,272,99463.66666666669,74.0,68.0,2,140,0.0,74.0,70.0
32471.0,17,2,180,1,90,0.0,90.0,90.0,1,90,0.0,90.0,90.0
29504.0,6,14,4740,7,653,3881.6666666666665,249.0,93.28571428571428,7,4087,4734.666666666667,1514.0,583.8571428571429
10532957.0,6,7,478,4,272,3465643.333333333,74.0,68.0,3,206,5198360.0,74.0,68.66666666666667
5751.0,17,2,231,1,78,0.0,78.0,78.0,1,153,0.0,153.0,153.0
205943.0,6,3,426,2,280,0.0,214.0,140.0,1,146,0.0,146.0,146.0
90050893.0,17,28,13364,28,13364,3335218.25925926,501.0,477.2857142857143,0,0,0.0,0.0,0.0
225646.0,6,3,426,2,280,0.0,214.0,140.0,1,146,0.0,146.0,146.0
74721.0,6,15,4806,8,719,10581.0,249.0,89.875,7,4087,11889.666666666666,1514.0,583.8571428571429
90347337.0,6,25,1686,13,840,7528944.75,123.0,64.61538461538461,12,846,7286021.0,123.0,70.5
90287317.0,6,16,1192,8,596,12891839.57142857,95.0,74.5,8,596,12897708.285714284,95.0,74.5
123011928.0,17,15,907,8,475,17573132.57142857,174.0,59.375,7,432,17166826.333333332,174.0,61.71428571428572
209915.0,6,10,1065,5,534,52059.0,262.0,106.8,5,531,3456.75,259.0,106.2
331.0,17,2,160,1,80,0.0,80.0,80.0,1,80,0.0,80.0,80.0
325849.0,6,6,412,4,272,108616.33333333331,74.0,68.0,2,140,0.0,74.0,70.0
109399736.0,17,16,1212,8,606,15628533.714285716,174.0,75.75,8,606,15538414.42857143,174.0,75.75
170282.0,17,4,704,2,148,0.0,74.0,74.0,2,556,0.0,280.0,278.0
37001.0,6,14,4740,7,653,5501.166666666667,249.0,93.28571428571428,7,4087,6012.5,1514.0,583.8571428571429
98882.0,6,2,132,1,66,0.0,66.0,66.0,1,66,0.0,66.0,66.0
363344.0,6,3,1604,2,851,0.0,785.0,425.5,1,753,0.0,753.0,753.0
2680955.0,6,2,132,1,66,0.0,66.0,66.0,1,66,0.0,66.0,66.0
828219.0,6,9,1118,6,586,165643.8,248.0,97.66666666666669,3,532,277842.5,392.0,177.33333333333334
153488.0,17,2,180,1,90,0.0,90.0,90.0,1,90,0.0,90.0,90.0
5617188.0,6,5,336,2,134,0.0,68.0,67.0,3,202,1524618.0,70.0,67.33333333333333
162223.0,17,2,180,1,90,0.0,90.0,90.0,1,90,0.0,90.0,90.0
113231261.0,6,217,24362,109,7490,1048437.6018518518,140.0,68.71559633027523,108,16872,1048600.0841121494,284.0,156.22222222222223
906.0,17,4,438,2,148,0.0,74.0,74.0,2,290,0.0,147.0,145.0
17565.0,6,11,2098,6,590,3229.8,252.0,98.33333333333331,5,1508,3569.5,1236.0,301.6
0.0,17,1,55,1,55,0.0,55.0,55.0,0,0,0.0,0.0,0.0
104673.0,17,2,700,2,700,0.0,350.0,350.0,0,0,0.0,0.0,0.0
107258846.0,6,44,2904,22,1452,5107564.095238095,66.0,66.0,22,1452,5092866.476190476,66.0,66.0
5108.0,17,4,344,2,150,0.0,75.0,75.0,2,194,0.0,103.0,97.0
0.0,6,1,60,1,60,0.0,60.0,60.0,0,0,0.0,0.0,0.0
90031275.0,17,28,13364,28,13364,3334491.6666666665,501.0,477.2857142857143,0,0,0.0,0.0,0.0
108875618.0,6,32,2220,16,1149,7243576.933333334,123.0,71.8125,16,1071,7243577.533333333,123.0,66.9375
326.0,17,2,166,1,75,0.0,75.0,75.0,1,91,0.0,91.0,91.0
848822.0,6,9,1096,6,625,169764.4,287.0,104.16666666666669,3,471,286551.5,331.0,157.0
132409152.0,6,21,1932,10,1133,11410902.666666666,336.0,113.3,11,799,13217047.7,95.0,72.63636363636364
233893.0,6,3,337,2,214,0.0,160.0,107.0,1,123,0.0,123.0,123.0
149757654.0,17,36,17126,36,17126,4278790.114285714,501.0,475.72222222222223,0,0,0.0,0.0,0.0
90255060.0,6,12,1832,8,1016,12893580.0,188.0,127.0,4,816,30030900.33333333,204.0,204.0
0.0,17,1,381,1,381,0.0,381.0,381.0,0,0,0.0,0.0,0.0
2444613.0,6,25,7573,14,3735,188047.15384615384,1514.0,266.7857142857143,11,3838,219986.0,1514.0,348.90909090909093
2435896.0,6,25,7573,14,3735,187376.6153846153,1514.0,266.7857142857143,11,3838,217816.5,1514.0,348.90909090909093
3725.0,17,4,344,2,150,0.0,75.0,75.0,2,194,0.0,103.0,97.0
135128999.0,17,6,1206,6,1206,27025799.8,201.0,201.0,0,0,0.0,0.0,0.0
104505.0,17,2,700,2,700,0.0,350.0,350.0,0,0,0.0,0.0,0.0
26994.0,6,14,4740,7,653,4240.0,249.0,93.28571428571428,7,4087,4016.0,1514.0,583.8571428571429
135090649.0,17,6,1206,6,1206,27018129.8,201.0,201.0,0,0,0.0,0.0,0.0
513437.00000000006,6,5,336,2,134,0.0,68.0,67.0,3,202,194406.0,70.0,67.33333333333333
90256263.0,6,12,1832,8,1016,12893751.857142856,188.0,127.0,4,816,30030457.0,204.0,204.0
5005122.0,17,4,849,2,166,0.0,83.0,83.0,2,683,0.0,499.0,341.5
228229.0,17,2,180,1,90,0.0,90.0,90.0,1,90,0.0,90.0,90.0
1313156.0,6,4,264,2,132,0.0,66.0,66.0,2,132,0.0,66.0,66.0
167500.0,17,4,704,2,148,0.0,74.0,74.0,2,556,0.0,280.0,278.0
135128906.0,17,6,1206,6,1206,27025781.2,201.0,201.0,0,0,0.0,0.0,0.0
12246.0,17,4,823,2,163,0.0,89.0,81.5,2,660,0.0,443.0,330.0
120051798.0,17,28,13364,28,13364,4446362.888888889,501.0,477.2857142857143,0,0,0.0,0.0,0.0
46720.0,6,14,4740,7,653,7103.833333333333,249.0,93.28571428571428,7,4087,7176.0,1514.0,583.8571428571429
90283088.0,6,16,1192,8,596,12891206.42857143,95.0,74.5,8,596,12896059.57142857,95.0,74.5
120001747.0,6,18,1341,9,691,14999999.0,95.0,76.77777777777777,9,650,14999997.0,95.0,72.22222222222223
27262.0,6,14,4740,7,653,4087.6666666666665,249.0,93.28571428571428,7,4087,4380.833333333333,1514.0,583.8571428571429
0.0,6,1,54,0,0,0.0,0.0,0.0,1,54,0.0,54.0,54.0
104873.0,17,2,286,2,286,0.0,143.0,143.0,0,0,0.0,0.0,0.0
121411722.0,6,31,2113,16,1165,8094114.8,139.0,72.8125,15,948,8107403.857142857,123.0,63.2
147968.0,17,2,180,1,90,0.0,90.0,90.0,1,90,0.0,90.0,90.0
10871379.0,6,8,544,4,272,3578098.0,74.0,68.0,4,272,3578023.6666666665,74.0,68.0
270721.0,6,12,1373,7,714,45120.16666666666,298.0,102.0,5,659,62705.0,379.0,131.8
90528756.0,6,13,2036,8,1016,12932679.42857143,188.0,127.0,5,1020,22591402.25,204.0,204.0
228400.0,17,2,180,1,90,0.0,90.0,90.0,1,90,0.0,90.0,90.0
220834.0,6,3,426,2,280,0.0,214.0,140.0,1,146,0.0,146.0,146.0
10503072.0,6,7,478,4,272,3455444.333333333,74.0,68.0,3,206,5183048.5,74.0,68.66666666666667
102793.0,17,2,762,2,762,0.0,381.0,381.0,0,0,0.0,0.0,0.0
2197.0,17,4,344,2,150,0.0,75.0,75.0,2,194,0.0,103.0,97.0
146194.0,6,3,337,2,214,0.0,160.0,107.0,1,123,0.0,123.0,123.0
111719782.0,6,31,2182,16,1165,7447985.466666667,139.0,72.8125,15,1017,7252203.428571428,123.0,67.8
13494.0,6,10,2032,5,524,2900.0,252.0,104.8,5,1508,3124.25,1236.0,301.6
354.0,17,2,174,1,79,0.0,79.0,79.0,1,95,0.0,95.0,95.0
33323.0,6,14,4740,7,653,4991.5,249.0,93.28571428571428,7,4087,5329.666666666667,1514.0,583.8571428571429
20681.0,6,2,145,2,145,0.0,91.0,72.5,0,0,0.0,0.0,0.0
119974917.0,17,35,16705,35,16705,3528674.029411765,501.0,477.2857142857143,0,0,0.0,0.0,0.0
10510665.0,6,7,478,4,272,3457815.0,74.0,68.0,3,206,5186618.0,74.0,68.66666666666667
363240.0,6,3,204,2,136,0.0,70.0,68.0,1,68,0.0,68.0,68.0
118944017.0,6,35,2542,18,1348,6996706.882352941,139.0,74.88888888888889,17,1194,7420473.625,123.0,70.23529411764706
232877.0,6,3,337,2,214,0.0,160.0,107.0,1,123,0.0,123.0,123.0
69575.0,6,14,4740,7,653,11469.0,249.0,93.28571428571428,7,4087,11204.833333333334,1514.0,583.8571428571429
302300.0,6,6,412,4,272,100766.66666666669,74.0,68.0,2,140,0.0,74.0,70.0
108110824.0,17,5,955,5,955,27027706.0,191.0,191.0,0,0,0.0,0.0,0.0
7090.0,17,2,582,1,83,0.0,83.0,83.0,1,499,0.0,499.0,499.0
108106186.0,17,5,955,5,955,27026546.5,191.0,191.0,0,0,0.0,0.0,0.0
17508.0,17,2,582,1,83,0.0,83.0,83.0,1,499,0.0,499.0,499.0
9419.0,17,2,571,1,86,0.0,86.0,86.0,1,485,0.0,485.0,485.0
108109576.0,17,5,1005,5,1005,27027394.0,201.0,201.0,0,0,0.0,0.0,0.0
358.0,17,2,174,1,79,0.0,79.0,79.0,1,95,0.0,95.0,95.0
18181.0,6,20,7606,11,978,1818.1,310.0,88.9090909090909,9,6628,1972.375,1514.0,736.4444444444445
2838220.0,6,3,1604,2,851,0.0,785.0,425.5,1,753,0.0,753.0,753.0
102971286.0,6,28,1860,14,966,7904252.153846154,123.0,69.0,14,894,7904257.384615385,123.0,63.85714285714285
21957.0,6,14,4740,7,653,3501.1666666666665,249.0,93.28571428571428,7,4087,3517.6666666666665,1514.0,583.8571428571429
90525133.0,6,14,2240,8,1016,12932161.857142856,188.0,127.0,6,1224,18072229.0,204.0,204.0
85.0,17,2,762,2,762,0.0,381.0,381.0,0,0,0.0,0.0,0.0
99421637.0,17,12,778,6,389,19884327.4,174.0,64.83333333333333,6,389,16118708.0,174.0,64.83333333333333
90533977.0,6,13,2036,8,1016,12933425.285714284,188.0,127.0,5,1020,22592850.75,204.0,204.0
30095.0,6,14,4740,7,653,3663.6666666666665,249.0,93.28571428571428,7,4087,4878.166666666667,1514.0,583.8571428571429
153465.0,17,2,180,1,90,0.0,90.0,90.0,1,90,0.0,90.0,90.0
48085.0,6,10,2032,5,524,11436.0,252.0,104.8,5,1508,11498.0,1236.0,301.6
2051.0,17,4,344,2,150,0.0,75.0,75.0,2,194,0.0,103.0,97.0
297483.0,6,6,412,4,272,99161.0,74.0,68.0,2,140,0.0,74.0,70.0
3252818.0,6,183,165645,115,156854,28533.491228070176,1510.0,1363.9478260869564,68,8791,43975.34328358209,1510.0,129.27941176470588
41697.0,6,10,2032,5,524,9237.5,252.0,104.8,5,1508,9770.75,1236.0,301.6
90956930.0,6,371,48598,186,36166,491659.08108108107,426.0,194.44086021505376,185,12432,493018.4782608696,140.0,67.2
204884.0,17,2,180,1,90,0.0,90.0,90.0,1,90,0.0,90.0,90.0
14947.0,17,2,180,1,90,0.0,90.0,90.0,1,90,0.0,90.0,90.0
16814.0,17,2,180,1,90,0.0,90.0,90.0,1,90,0.0,90.0,90.0
759.0,17,4,438,2,148,0.0,74.0,74.0,2,290,0.0,147.0,145.0
2844866.0,6,4,270,3,202,1422433.0,70.0,67.33333333333333,1,68,0.0,68.0,68.0
38122.0,6,14,4740,7,653,6167.833333333333,249.0,93.28571428571428,7,4087,5476.166666666667,1514.0,583.8571428571429
190763.0,17,2,180,1,90,0.0,90.0,90.0,1,90,0.0,90.0,90.0
135307.0,6,2,132,1,66,0.0,66.0,66.0,1,66,0.0,66.0,66.0
90377855.0,6,11,1644,7,828,15062975.833333334,188.0,118.28571428571428,4,816,20115097.33333333,204.0,204.0
104931192.0,6,43,2838,22,1452,4982036.095238095,66.0,66.0,21,1386,5150442.6,66.0,66.0
153491.0,17,2,180,1,90,0.0,90.0,90.0,1,90,0.0,90.0,90.0
90093358.0,6,14,2256,7,1428,15015326.0,204.0,204.0,7,828,15015381.666666666,188.0,118.28571428571428
10446618.0,6,6,412,3,206,5152642.0,74.0,68.66666666666667,3,206,5152530.0,74.0,68.66666666666667
90980415.0,6,23,1734,13,989,7577978.666666667,95.0,76.07692307692308,10,745,10101589.222222222,95.0,74.5
100973.0,17,2,286,2,286,0.0,143.0,143.0,0,0,0.0,0.0,0.0
40405.0,6,14,4740,7,653,6542.333333333333,249.0,93.28571428571428,7,4087,6591.833333333333,1514.0,583.8571428571429
107960035.0,6,216,24530,108,7350,1001151.5607476636,140.0,68.05555555555556,108,17180,1001105.046728972,284.0,159.07407407407408
2785124.0,6,2,132,1,66,0.0,66.0,66.0,1,66,0.0,66.0,66.0
120240514.0,6,29,3441,14,1548,9230230.0,361.0,110.57142857142856,15,1893,8570711.92857143,427.0,126.2
69000.0,6,14,4740,7,653,10030.666666666666,249.0,93.28571428571428,7,4087,9836.5,1514.0,583.8571428571429
33503.0,6,14,4740,7,653,5463.333333333333,249.0,93.28571428571428,7,4087,4877.166666666667,1514.0,583.8571428571429
46204.0,6,14,4740,7,653,7540.666666666667,249.0,93.28571428571428,7,4087,5922.666666666667,1514.0,583.8571428571429
14647519.0,6,20,1607,10,975,1592890.888888889,315.0,97.5,10,632,1592862.7777777778,78.0,63.2
40880.0,6,10,2032,5,524,9980.5,252.0,104.8,5,1508,7893.25,1236.0,301.6
33133519.0,6,7,1874,3,887,16491181.0,753.0,295.6666666666667,4,987,10996858.999999998,785.0,246.75
677072.0,6,4,508,2,238,0.0,172.0,119.0,2,270,0.0,135.0,135.0
106608151.0,6,44,2904,22,1452,5076578.619047619,66.0,66.0,22,1452,5061608.761904762,66.0,66.0
206183.0,6,3,426,2,280,0.0,214.0,140.0,1,146,0.0,146.0,146.0
751154.0,6,2,132,1,66,0.0,66.0,66.0,1,66,0.0,66.0,66.0
88147595.0,6,20,1429,10,735,9792938.888888888,95.0,73.5,10,694,9793858.333333334,95.0,69.4
146165.0,6,3,337,2,214,0.0,160.0,107.0,1,123,0.0,123.0,123.0
90057908.0,17,27,12943,27,12943,3463765.6923076925,501.0,479.3703703703704,0,0,0.0,0.0,0.0
76504.0,6,10,2032,5,524,17982.0,252.0,104.8,5,1508,17921.0,1236.0,301.6
32429.0,6,14,4740,7,653,5279.5,249.0,93.28571428571428,7,4087,4523.833333333333,1514.0,583.8571428571429
106703529.0,6,31,2166,16,1149,7113568.6,123.0,71.8125,15,1017,7607049.357142857,123.0,67.8
318703.0,6,3,202,2,128,0.0,74.0,64.0,1,74,0.0,74.0,74.0
41011.0,6,10,2032,5,524,9638.5,252.0,104.8,5,1508,8326.75,1236.0,301.6
43783.0,6,10,2032,5,524,10673.25,252.0,104.8,5,1508,10226.75,1236.0,301.6
119749.0,17,2,180,1,70,0.0,70.0,70.0,1,110,0.0,110.0,110.0
103885.0,17,2,700,2,700,0.0,350.0,350.0,0,0,0.0,0.0,0.0
349.0,17,2,248,1,84,0.0,84.0,84.0,1,164,0.0,164.0,164.0
90254187.0,6,12,1832,8,1016,12893455.285714284,188.0,127.0,4,816,30030522.0,204.0,204.0
5624643.0,6,5,336,2,134,0.0,68.0,67.0,3,202,1421960.0,70.0,67.33333333333333
46484.0,6,14,4740,7,653,7625.833333333333,249.0,93.28571428571428,7,4087,5277.0,1514.0,583.8571428571429
282834.0,17,4,1524,4,1524,94278.0,381.0,381.0,0,0,0.0,0.0,0.0
153440.0,17,2,180,1,90,0.0,90.0,90.0,1,90,0.0,90.0,90.0
45259.0,6,14,4740,7,653,7234.166666666667,249.0,93.28571428571428,7,4087,7296.833333333333,1514.0,583.8571428571429
90265871.0,6,12,1832,8,1016,12895124.42857143,188.0,127.0,4,816,30030920.33333333,204.0,204.0
1157505.0,6,13,3000,8,2372,165357.85714285713,1514.0,296.5,5,628,221254.5,331.0,125.6
308377.0,6,6,412,4,272,102792.33333333331,74.0,68.0,2,140,0.0,74.0,70.0
211743.0,6,3,426,2,280,0.0,214.0,140.0,1,146,0.0,146.0,146.0
2324.0,17,4,344,2,150,0.0,75.0,75.0,2,194,0.0,103.0,97.0
197020.0,17,2,180,1,90,0.0,90.0,90.0,1,90,0.0,90.0,90.0
67027.0,6,10,2032,5,524,12822.25,252.0,104.8,5,1508,14861.25,1236.0,301.6
108103720.0,17,5,1005,5,1005,27025930.0,201.0,201.0,0,0,0.0,0.0,0.0
18654.0,6,10,2032,5,524,4304.0,252.0,104.8,5,1508,4415.5,1236.0,301.6
108089642.0,17,5,955,5,955,27022410.5,191.0,191.0,0,0,0.0,0.0,0.0
206153.0,17,2,180,1,90,0.0,90.0,90.0,1,90,0.0,90.0,90.0
376.0,17,2,267,1,83,0.0,83.0,83.0,1,184,0.0,184.0,184.0
312540.0,6,6,412,4,272,104180.0,74.0,68.0,2,140,0.0,74.0,70.0
308098.0,6,6,412,4,272,102699.33333333331,74.0,68.0,2,140,0.0,74.0,70.0
72284.0,6,14,4740,7,653,11683.5,249.0,93.28571428571428,7,4087,9770.333333333334,1514.0,583.8571428571429
1305152.0,6,4,264,2,132,0.0,66.0,66.0,2,132,0.0,66.0,66.0
135134614.0,17,6,1146,6,1146,27026922.8,191.0,191.0,0,0,0.0,0.0,0.0
90284835.0,6,16,1192,8,596,12891880.57142857,95.0,74.5,8,596,12894056.142857144,95.0,74.5
5625820.0,6,5,336,2,134,0.0,68.0,67.0,3,202,1527644.0,70.0,67.33333333333333
4412.0,17,2,626,1,72,0.0,72.0,72.0,1,554,0.0,554.0,554.0
105001202.0,17,14,1126,7,563,17500200.333333332,174.0,80.42857142857143,7,563,14168597.666666666,174.0,80.42857142857143
248755.0,6,12,1373,7,714,41459.16666666666,298.0,102.0,5,659,60609.0,379.0,131.8
2068.0,17,2,932,1,590,0.0,590.0,590.0,1,342,0.0,342.0,342.0
1475.0,17,5,550,5,550,368.75,110.0,110.0,0,0,0.0,0.0,0.0
102452.0,17,2,762,2,762,0.0,381.0,381.0,0,0,0.0,0.0,0.0
846195.0,6,9,1096,6,625,169239.0,287.0,104.16666666666669,3,471,285140.0,331.0,157.0
123807975.0,6,49,3234,25,1650,5158665.625,66.0,66.0,24,1584,4970803.913043479,66.0,66.0
3375910.0,17,3,1026,3,1026,1687955.0,342.0,342.0,0,0,0.0,0.0,0.0
560.0,17,2,508,2,508,0.0,257.0,254.0,0,0,0.0,0.0,0.0
1852887.0,6,7,499,3,198,818814.5,66.0,66.0,4,301,547925.6666666666,103.0,75.25
5631644.0,6,5,336,2,134,0.0,68.0,67.0,3,202,1526370.5,70.0,67.33333333333333
5258.0,17,2,582,1,83,0.0,83.0,83.0,1,499,0.0,499.0,499.0
197612.0,17,2,180,1,90,0.0,90.0,90.0,1,90,0.0,90.0,90.0
579291.0,6,4,508,2,238,0.0,172.0,119.0,2,270,0.0,135.0,135.0
53971.0,6,14,4740,7,653,8869.5,249.0,93.28571428571428,7,4087,8630.0,1514.0,583.8571428571429
90510936.0,6,15,2444,8,1016,12930133.714285716,188.0,127.0,7,1428,15056485.166666666,204.0,204.0
2443.0,17,4,344,2,150,0.0,75.0,75.0,2,194,0.0,103.0,97.0
12791.0,17,4,823,2,163,0.0,89.0,81.5,2,660,0.0,443.0,330.0
209345.0,6,3,426,2,280,0.0,214.0,140.0,1,146,0.0,146.0,146.0
197265.0,17,2,180,1,90,0.0,90.0,90.0,1,90,0.0,90.0,90.0
2011.0,17,4,344,2,150,0.0,75.0,75.0,2,194,0.0,103.0,97.0
2528.0,17,4,344,2,150,0.0,75.0,75.0,2,194,0.0,103.0,97.0
209647.0,6,10,1221,6,636,41929.4,298.0,106.0,4,585,68494.66666666667,379.0,146.25
540704.0,6,2,132,1,66,0.0,66.0,66.0,1,66,0.0,66.0,66.0
196915.0,17,2,180,1,90,0.0,90.0,90.0,1,90,0.0,90.0,90.0
9646.0,17,2,762,2,762,0.0,381.0,381.0,0,0,0.0,0.0,0.0
14638285.0,6,20,1607,10,975,1592699.111111111,315.0,97.5,10,632,1592659.111111111,78.0,63.2
314377.0,6,6,412,4,272,104792.33333333331,74.0,68.0,2,140,0.0,74.0,70.0
1496.0,17,5,550,5,550,374.0,110.0,110.0,0,0,0.0,0.0,0.0
282152.0,6,10,1221,6,636,56430.4,298.0,106.0,4,585,92689.0,379.0,146.25
27503439.0,17,5,1710,5,1710,6875859.75,342.0,342.0,0,0,0.0,0.0,0.0
49415.0,6,10,2032,5,524,10948.25,252.0,104.8,5,1508,11812.75,1236.0,301.6
113520295.0,6,46,3036,23,1518,5160001.681818182,66.0,66.0,23,1518,5160002.545454546,66.0,66.0
2811597.0,6,12,2172,7,664,468461.3333333333,252.0,94.85714285714286,5,1508,3144.75,1236.0,301.6
42038.0,6,14,4740,7,653,6698.333333333333,249.0,93.28571428571428,7,4087,5951.666666666667,1514.0,583.8571428571429
151673.0,6,3,337,2,214,0.0,160.0,107.0,1,123,0.0,123.0,123.0
1519576.0,6,20,6434,12,1921,138143.27272727274,620.0,160.08333333333334,8,4513,177777.7142857143,1514.0,564.125
97.0,17,2,762,2,762,0.0,381.0,381.0,0,0,0.0,0.0,0.0
13361.0,6,10,1067,5,536,3066.25,264.0,107.2,5,531,2790.75,259.0,106.2
232303.0,6,3,337,2,214,0.0,160.0,107.0,1,123,0.0,123.0,123.0
120273935.0,6,212,23996,106,7218,1137628.6095238095,140.0,68.09433962264151,106,16778,1127454.066666667,284.0,158.28301886792454
4663.0,17,2,621,1,78,0.0,78.0,78.0,1,543,0.0,543.0,543.0
1306967.0,6,4,264,2,132,0.0,66.0,66.0,2,132,0.0,66.0,66.0
10710.0,6,12,1393,6,796,1965.6,271.0,132.66666666666666,6,597,1990.2,259.0,99.5
223268.0,17,4,1400,4,1400,74422.66666666667,350.0,350.0,0,0,0.0,0.0,0.0
5622904.0,6,4,270,2,134,0.0,68.0,67.0,2,136,0.0,70.0,68.0
34512.0,6,10,2032,5,524,8416.5,252.0,104.8,5,1508,8354.75,1236.0,301.6
40045.0,6,14,4740,7,653,6224.166666666667,249.0,93.28571428571428,7,4087,6451.0,1514.0,583.8571428571429
44549.0,6,14,4740,7,653,7298.5,249.0,93.28571428571428,7,4087,6498.166666666667,1514.0,583.8571428571429
342.0,17,2,160,1,80,0.0,80.0,80.0,1,80,0.0,80.0,80.0
202250.0,17,4,6056,4,6056,67416.66666666667,1514.0,1514.0,0,0,0.0,0.0,0.0
209514.0,17,2,180,1,90,0.0,90.0,90.0,1,90,0.0,90.0,90.0
284673.0,17,2,363,1,79,0.0,79.0,79.0,1,284,0.0,284.0,284.0
120112760.0,6,272,31948,136,9272,877656.5037037038,140.0,68.17647058823529,136,22676,887919.0518518519,300.0,166.73529411764707
3018497.0,6,12,2172,7,664,502951.1666666667,252.0,94.85714285714286,5,1508,4590.5,1236.0,301.6
1837.0,17,2,176,1,80,0.0,80.0,80.0,1,96,0.0,96.0,96.0
103114231.0,17,14,864,7,432,17167959.333333332,174.0,61.71428571428572,7,432,17166821.0,174.0,61.71428571428572
14139.0,6,13,1459,7,862,2196.6666666666665,271.0,123.14285714285714,6,597,2556.0,259.0,99.5
153613.0,17,2,180,1,90,0.0,90.0,90.0,1,90,0.0,90.0,90.0
24640.0,6,11,2098,6,590,4733.4,252.0,98.33333333333331,5,1508,5178.25,1236.0,301.6
320463.0,6,6,412,4,272,106821.0,74.0,68.0,2,140,0.0,74.0,70.0
965433.0,6,12,1354,6,723,191042.2,253.0,120.5,6,631,192247.8,293.0,105.16666666666669
2481319.0,6,3,1604,1,753,0.0,753.0,753.0,2,851,0.0,785.0,425.5
18200.0,6,14,4740,7,653,2884.0,249.0,93.28571428571428,7,4087,2756.5,1514.0,583.8571428571429
2595435.0,6,2,132,1,66,0.0,66.0,66.0,1,66,0.0,66.0,66.0
2396.0,17,4,344,2,150,0.0,75.0,75.0,2,194,0.0,103.0,97.0
206593.0,17,2,180,1,90,0.0,90.0,90.0,1,90,0.0,90.0,90.0
311298.0,17,4,1400,4,1400,103766.0,350.0,350.0,0,0,0.0,0.0,0.0
108724550.0,6,33,2412,17,1272,6781801.6875,123.0,74.82352941176471,16,1140,7233921.533333333,123.0,71.25
18552.0,6,10,2032,5,524,4400.75,252.0,104.8,5,1508,3963.5,1236.0,301.6
1090957.0,6,13,1386,7,789,181826.16666666663,253.0,112.71428571428572,6,597,214360.0,259.0,99.5
979.0,17,4,438,2,148,0.0,74.0,74.0,2,290,0.0,147.0,145.0
498.0,17,2,508,2,508,0.0,257.0,254.0,0,0,0.0,0.0,0.0
120119929.0,6,13,2036,5,1020,30029982.25,204.0,204.0,8,1016,17136461.85714286,188.0,127.0
2332.0,17,4,344,2,150,0.0,75.0,75.0,2,194,0.0,103.0,97.0
40519.0,6,14,4740,7,653,3874.8333333333335,249.0,93.28571428571428,7,4087,6618.166666666667,1514.0,583.8571428571429
0.0,6,1,54,0,0,0.0,0.0,0.0,1,54,0.0,54.0,54.0
104467.0,6,2,132,1,66,0.0,66.0,66.0,1,66,0.0,66.0,66.0
861121.0,6,9,1267,6,796,172224.2,458.0,132.66666666666666,3,471,292676.0,331.0,157.0
120050354.0,17,28,13364,28,13364,4446309.407407408,501.0,477.2857142857143,0,0,0.0,0.0,0.0
122918245.0,6,31,2113,16,1165,8194549.666666667,139.0,72.8125,15,948,8215099.857142857,123.0,63.2
43909.0,6,10,2032,5,524,10685.0,252.0,104.8,5,1508,10390.75,1236.0,301.6
66929.0,6,10,2032,5,524,16424.25,252.0,104.8,5,1508,11867.0,1236.0,301.6
855523.0,6,9,1268,6,797,171104.6,459.0,132.83333333333334,3,471,291395.5,331.0,157.0
299800.0,6,6,412,4,272,99933.33333333331,74.0,68.0,2,140,0.0,74.0,70.0
107042.0,17,2,286,2,286,0.0,143.0,143.0,0,0,0.0,0.0,0.0
120632728.0,6,254,28620,127,8604,950990.5317460316,140.0,67.74803149606299,127,20016,957319.126984127,284.0,157.60629921259843
147096.0,6,3,373,2,238,0.0,172.0,119.0,1,135,0.0,135.0,135.0
239659.0,6,3,337,2,214,0.0,160.0,107.0,1,123,0.0,123.0,123.0
122312.0,6,3,373,2,238,0.0,172.0,119.0,1,135,0.0,135.0,135.0
2032639.0,6,19,6869,11,1567,203263.9,408.0,142.45454545454547,8,5302,228514.57142857145,1514.0,662.75
219098.0,6,4,492,2,280,0.0,214.0,140.0,2,212,0.0,146.0,106.0
9969.0,6,10,1975,5,467,2010.0,195.0,93.4,5,1508,1928.5,1236.0,301.6
120241447.0,6,18,1341,9,691,14999601.25,95.0,76.77777777777777,9,650,15000000.875,95.0,72.22222222222223
120061571.0,6,230,25866,115,7812,1045990.6842105264,140.0,67.9304347826087,115,18054,1046026.394736842,284.0,156.9913043478261
240814.0,6,3,337,2,214,0.0,160.0,107.0,1,123,0.0,123.0,123.0
2423.0,17,2,932,1,590,0.0,590.0,590.0,1,342,0.0,342.0,342.0
118951771.0,6,37,2656,19,1408,6608431.722222222,139.0,74.10526315789474,18,1248,6985082.411764706,123.0,69.33333333333333
205232.0,17,2,762,2,762,0.0,381.0,381.0,0,0,0.0,0.0,0.0
187845.0,17,4,6056,4,6056,62615.0,1514.0,1514.0,0,0,0.0,0.0,0.0
146189.0,6,3,337,2,214,0.0,160.0,107.0,1,123,0.0,123.0,123.0
236990.0,6,3,337,2,214,0.0,160.0,107.0,1,123,0.0,123.0,123.0
330.0,17,2,166,1,75,0.0,75.0,75.0,1,91,0.0,91.0,91.0
28685.0,6,14,4740,7,653,4505.833333333333,249.0,93.28571428571428,7,4087,4281.833333333333,1514.0,583.8571428571429
216289.0,17,2,180,1,90,0.0,90.0,90.0,1,90,0.0,90.0,90.0
108111812.0,17,5,1005,5,1005,27027953.0,201.0,201.0,0,0,0.0,0.0,0.0
143868.0,17,2,180,1,90,0.0,90.0,90.0,1,90,0.0,90.0,90.0
2589545.0,6,2,132,1,66,0.0,66.0,66.0,1,66,0.0,66.0,66.0
216444.0,17,2,180,1,90,0.0,90.0,90.0,1,90,0.0,90.0,90.0
120024991.0,17,28,13364,28,13364,4445370.037037037,501.0,477.2857142857143,0,0,0.0,0.0,0.0
116252918.0,6,31,2166,16,1149,7735805.2,123.0,71.8125,15,1017,8288354.857142857,123.0,67.8
123897084.0,17,14,864,7,432,17276383.0,174.0,61.71428571428572,7,432,17334264.166666668,174.0,61.71428571428572
90746700.0,6,20,1531,11,840,9070083.8,95.0,76.36363636363636,9,691,11342262.25,95.0,76.77777777777777
111561651.0,17,14,864,7,432,18500678.5,174.0,61.71428571428572,7,432,18500164.83333333,174.0,61.71428571428572
113255095.0,6,46,3036,23,1518,5135441.318181818,66.0,66.0,23,1518,5135436.954545454,66.0,66.0
329.0,17,2,166,1,75,0.0,75.0,75.0,1,91,0.0,91.0,91.0
277474.0,17,2,363,1,79,0.0,79.0,79.0,1,284,0.0,284.0,284.0
2090322.0,6,25,7610,13,2516,174193.5,1034.0,193.53846153846155,12,5094,162606.72727272726,1510.0,424.5
112760449.0,6,32,2220,16,1149,7502964.2,123.0,71.8125,16,1071,7502963.266666667,123.0,66.9375
11690.0,17,2,582,1,83,0.0,83.0,83.0,1,499,0.0,499.0,499.0
206004.0,6,3,426,2,280,0.0,214.0,140.0,1,146,0.0,146.0,146.0
120125633.0,6,13,2020,9,1204,15015704.125,188.0,133.77777777777777,4,816,30031158.0,204.0,204.0
120030532.0,17,29,13785,29,13785,4286804.714285715,501.0,475.3448275862069,0,0,0.0,0.0,0.0
95377661.0,6,175,19806,88,13842,1096294.9540229884,284.0,157.29545454545453,87,5964,1103998.2674418604,140.0,68.55172413793103
102103.0,17,2,286,2,286,0.0,143.0,143.0,0,0,0.0,0.0,0.0
2442.0,17,4,344,2,150,0.0,75.0,75.0,2,194,0.0,103.0,97.0
32677.0,6,14,4740,7,653,5333.0,249.0,93.28571428571428,7,4087,4981.166666666667,1514.0,583.8571428571429
90504185.0,6,14,2114,6,1098,18100837.0,204.0,183.0,8,1016,12908068.714285716,188.0,127.0
118848815.0,6,39,2902,20,1531,6243841.631578947,139.0,76.55,19,1371,6590720.555555556,123.0,72.15789473684211
701785.0,6,5,336,2,134,0.0,68.0,67.0,3,202,298123.0,70.0,67.33333333333333
22390.0,6,10,2032,5,524,4955.75,252.0,104.8,5,1508,5315.5,1236.0,301.6
235672.0,6,10,1221,6,636,47134.4,298.0,106.0,4,585,77119.0,379.0,146.25
90281927.0,6,16,1192,8,596,12891731.714285716,95.0,74.5,8,596,12895469.0,95.0,74.5
95644484.0,6,28,1998,15,1089,6816331.285714285,123.0,72.6,13,909,7952385.916666667,123.0,69.92307692307692
0.0,17,1,72,1,72,0.0,72.0,72.0,0,0,0.0,0.0,0.0
120189738.0,6,204,23108,102,7028,1181789.7821782178,140.0,68.90196078431373,102,16080,1182976.8316831684,284.0,157.64705882352942
90049057.0,17,28,13364,28,13364,3335150.25925926,501.0,477.2857142857143,0,0,0.0,0.0,0.0
438300.0,6,11,1021,6,444,58785.4,162.0,74.0,5,577,73393.75,349.0,115.4
153691.0,17,2,180,1,90,0.0,90.0,90.0,1,90,0.0,90.0,90.0
379527.0,6,4,508,2,238,0.0,172.0,119.0,2,270,0.0,135.0,135.0
1009248.0,6,12,2718,7,743,168208.0,339.0,106.14285714285714,5,1975,184115.5,1514.0,395.0
103192119.0,6,242,28358,121,20150,858224.7833333333,336.0,166.52892561983472,121,8208,858222.7416666667,140.0,67.83471074380165
90043227.0,17,27,12943,27,12943,3463201.0384615385,501.0,479.3703703703704,0,0,0.0,0.0,0.0
2590038.0,6,2,132,1,66,0.0,66.0,66.0,1,66,0.0,66.0,66.0
2438669.0,6,3,1777,1,826,0.0,826.0,826.0,2,951,0.0,885.0,475.5
3007613.0,6,11,2106,6,598,601201.8,252.0,99.66666666666669,5,1508,2565.75,1236.0,301.6
135133486.0,17,6,1146,6,1146,27026697.2,191.0,191.0,0,0,0.0,0.0,0.0
1989.0,17,4,344,2,150,0.0,75.0,75.0,2,194,0.0,103.0,97.0
235349.0,6,10,1221,6,636,47069.8,298.0,106.0,4,585,76229.66666666667,379.0,146.25
108097842.0,17,5,955,5,955,27024460.5,191.0,191.0,0,0,0.0,0.0,0.0
90527601.0,6,13,2036,8,1016,12932514.42857143,188.0,127.0,5,1020,22591345.5,204.0,204.0
2583327.0,6,2,132,1,66,0.0,66.0,66.0,1,66,0.0,66.0,66.0
909329.0,6,10,1335,6,798,181865.8,460.0,133.0,4,537,211227.66666666663,331.0,134.25
842.0,17,4,438,2,148,0.0,74.0,74.0,2,290,0.0,147.0,145.0
27606.0,6,10,1065,5,534,6714.25,262.0,106.8,5,531,5775.5,259.0,106.2
14213227.0,17,6,2052,6,2052,2842645.4,342.0,342.0,0,0,0.0,0.0,0.0
30049.0,6,14,4740,7,653,4520.833333333333,249.0,93.28571428571428,7,4087,4667.5,1514.0,583.8571428571429
4636.0,17,2,614,1,72,0.0,72.0,72.0,1,542,0.0,542.0,542.0
12785.0,6,10,1067,5,536,2962.0,264.0,107.2,5,531,2779.5,259.0,106.2
120124443.0,6,14,2240,6,1224,24024888.6,204.0,204.0,8,1016,17136888.285714287,188.0,127.0
18078.0,6,2,145,2,145,0.0,91.0,72.5,0,0,0.0,0.0,0.0
90021632.0,17,28,13364,28,13364,3334134.5185185187,501.0,477.2857142857143,0,0,0.0,0.0,0.0
22917484.0,17,3,1034,2,684,0.0,342.0,342.0,1,350,0.0,350.0,350.0
148616.0,17,2,414,1,88,0.0,88.0,88.0,1,326,0.0,326.0,326.0
859767.0,6,9,1270,6,799,171953.4,461.0,133.16666666666666,3,471,292051.0,331.0,157.0
197712.0,17,2,180,1,90,0.0,90.0,90.0,1,90,0.0,90.0,90.0
221062.0,6,3,426,2,280,0.0,214.0,140.0,1,146,0.0,146.0,146.0
58825133.0,17,9,3086,8,2736,5107922.857142857,342.0,342.0,1,350,0.0,350.0,350.0
15039.0,6,10,2032,5,524,3414.75,252.0,104.8,5,1508,3018.25,1236.0,301.6
171600.0,17,2,180,1,90,0.0,90.0,90.0,1,90,0.0,90.0,90.0
248666.0,6,3,337,2,214,0.0,160.0,107.0,1,123,0.0,123.0,123.0
106387883.0,6,28,1876,14,982,8167071.230769231,139.0,70.14285714285714,14,894,8167084.076923077,123.0,63.85714285714285
204747.0,17,2,762,2,762,0.0,381.0,381.0,0,0,0.0,0.0,0.0
58275.0,6,14,4740,7,653,9152.833333333334,249.0,93.28571428571428,7,4087,8898.333333333334,1514.0,583.8571428571429
90285042.0,6,19,1436,10,745,10026733.888888888,95.0,74.5,9,691,11284645.0,95.0,76.77777777777777
108100219.0,17,5,955,5,955,27025054.75,191.0,191.0,0,0,0.0,0.0,0.0
5875.0,17,2,231,1,78,0.0,78.0,78.0,1,153,0.0,153.0,153.0
211586.0,6,10,1221,6,636,42317.2,298.0,106.0,4,585,69643.33333333333,379.0,146.25
5626990.0,6,5,336,2,134,0.0,68.0,67.0,3,202,1422939.5,70.0,67.33333333333333
23077.0,6,14,4740,7,653,3614.5,249.0,93.28571428571428,7,4087,3691.1666666666665,1514.0,583.8571428571429
90623235.0,6,28,1992,14,1029,6971018.076923077,123.0,73.5,14,963,6954343.0,123.0,68.78571428571429
149774.0,17,2,180,1,90,0.0,90.0,90.0,1,90,0.0,90.0,90.0
25384.0,6,10,2032,5,524,6114.0,252.0,104.8,5,1508,5759.5,1236.0,301.6
299070.0,6,6,412,4,272,99690.0,74.0,68.0,2,140,0.0,74.0,70.0
298123.0,6,6,412,4,272,99374.33333333331,74.0,68.0,2,140,0.0,74.0,70.0
111091155.0,6,32,2220,16,1149,7391625.466666667,123.0,71.8125,16,1071,7391670.4,123.0,66.9375
302075.0,6,6,412,4,272,100691.66666666669,74.0,68.0,2,140,0.0,74.0,70.0
135138325.0,17,6,1206,6,1206,27027665.0,201.0,201.0,0,0,0.0,0.0,0.0
120121302.0,6,14,2240,6,1224,24024260.4,204.0,204.0,8,1016,17097126.42857143,188.0,127.0
3164651.0,6,7,923,4,753,982823.3333333334,571.0,188.25,3,170,1474172.5,62.0,56.66666666666666
116896281.0,6,48,3168,24,1584,5082447.0,66.0,66.0,24,1584,5069399.347826087,66.0,66.0
31796750.0,6,26,7627,14,3735,195545.53846153847,1514.0,266.7857142857143,12,3892,2870867.090909091,1514.0,324.3333333333333
118890794.0,6,35,2542,18,1348,6980868.117647059,139.0,74.88888888888889,17,1194,7417171.0,123.0,70.23529411764706
303514.0,6,6,412,4,272,101171.33333333331,74.0,68.0,2,140,0.0,74.0,70.0
205825.0,17,2,180,1,90,0.0,90.0,90.0,1,90,0.0,90.0,90.0
162345.0,17,2,180,1,90,0.0,90.0,90.0,1,90,0.0,90.0,90.0
0.0,6,1,66,1,66,0.0,66.0,66.0,0,0,0.0,0.0,0.0
30570.0,6,10,2032,5,524,6859.5,252.0,104.8,5,1508,6916.75,1236.0,301.6
237969.0,6,10,1221,6,636,47593.8,298.0,106.0,4,585,78311.0,379.0,146.25
1308231.0,17,7,490,7,490,218038.5,70.0,70.0,0,0,0.0,0.0,0.0
197981.0,17,2,180,1,90,0.0,90.0,90.0,1,90,0.0,90.0,90.0
123839762.0,6,48,3168,24,1584,4969665.608695652,66.0,66.0,24,1584,5327764.217391305,66.0,66.0
13871.0,17,2,180,1,90,0.0,90.0,90.0,1,90,0.0,90.0,90.0
48453.0,6,14,4740,7,653,7954.166666666667,249.0,93.28571428571428,7,4087,7272.333333333333,1514.0,583.8571428571429
196990.0,17,2,180,1,90,0.0,90.0,90.0,1,90,0.0,90.0,90.0
1872.0,17,2,192,1,88,0.0,88.0,88.0,1,104,0.0,104.0,104.0
344015.0,17,2,180,1,90,0.0,90.0,90.0,1,90,0.0,90.0,90.0
1838057.0,6,2,132,1,66,0.0,66.0,66.0,1,66,0.0,66.0,66.0
120475142.0,6,209,23692,105,16532,1158414.826923077,284.0,157.44761904761904,104,7160,1159533.067961165,140.0,68.84615384615384
1190031.0,6,13,3012,8,2384,170004.42857142858,1514.0,298.0,5,628,228587.25,331.0,125.6
197088.0,17,2,180,1,90,0.0,90.0,90.0,1,90,0.0,90.0,90.0
308661.0,6,6,412,4,272,102887.0,74.0,68.0,2,140,0.0,74.0,70.0
100770.0,17,4,1400,4,1400,33590.0,350.0,350.0,0,0,0.0,0.0,0.0
0.0,17,1,342,1,342,0.0,342.0,342.0,0,0,0.0,0.0,0.0
117869392.0,6,256,28874,128,8744,922649.440944882,140.0,68.3125,128,20130,923462.8267716536,300.0,157.265625
2780043.0,6,2,132,1,66,0.0,66.0,66.0,1,66,0.0,66.0,66.0
10464983.0,6,7,478,4,272,3442712.333333333,74.0,68.0,3,206,5163941.0,74.0,68.66666666666667
169009.0,17,4,704,2,148,0.0,74.0,74.0,2,556,0.0,280.0,278.0
108101865.0,17,5,1005,5,1005,27025466.25,201.0,201.0,0,0,0.0,0.0,0.0
246590.0,6,3,337,2,214,0.0,160.0,107.0,1,123,0.0,123.0,123.0
41153.0,6,10,2032,5,524,10039.0,252.0,104.8,5,1508,8617.5,1236.0,301.6
108109734.0,17,5,1005,5,1005,27027433.5,201.0,201.0,0,0,0.0,0.0,0.0
104779243.0,17,15,5130,15,5130,7484231.642857143,342.0,342.0,0,0,0.0,0.0,0.0
104217524.0,6,31,2166,16,1149,6933445.8,123.0,71.8125,15,1017,7428685.214285715,123.0,67.8
104854137.0,17,15,5130,15,5130,7489581.214285715,342.0,342.0,0,0,0.0,0.0,0.0
6768.0,17,2,565,1,93,0.0,93.0,93.0,1,472,0.0,472.0,472.0
307.0,17,2,164,1,82,0.0,82.0,82.0,1,82,0.0,82.0,82.0
112092.0,17,2,700,2,700,0.0,350.0,350.0,0,0,0.0,0.0,0.0
10465695.0,6,7,478,4,272,3441742.333333333,74.0,68.0,3,206,5162476.0,74.0,68.66666666666667
90255736.0,6,14,2240,8,1016,12893676.57142857,188.0,127.0,6,1224,18018320.2,204.0,204.0
2800578.0,6,2,132,1,66,0.0,66.0,66.0,1,66,0.0,66.0,66.0
113831.0,17,4,1400,4,1400,37943.66666666666,350.0,350.0,0,0,0.0,0.0,0.0
153498.0,17,2,180,1,90,0.0,90.0,90.0,1,90,0.0,90.0,90.0
108114688.0,17,5,955,5,955,27028672.0,191.0,191.0,0,0,0.0,0.0,0.0
280933.0,17,2,180,1,90,0.0,90.0,90.0,1,90,0.0,90.0,90.0
3809.0,17,4,344,2,150,0.0,75.0,75.0,2,194,0.0,103.0,97.0
228175.0,17,2,180,1,90,0.0,90.0,90.0,1,90,0.0,90.0,90.0
26418.0,6,14,4740,7,653,3766.1666666666665,249.0,93.28571428571428,7,4087,4112.666666666667,1514.0,583.8571428571429
90528897.0,6,13,2036,8,1016,12932699.57142857,188.0,127.0,5,1020,22591955.5,204.0,204.0
143942.0,17,2,180,1,90,0.0,90.0,90.0,1,90,0.0,90.0,90.0
102937223.0,6,190,21426,95,6492,1086248.5106382978,140.0,68.33684210526316,95,14934,1087517.4361702127,284.0,157.2
90245413.0,6,22,1680,10,745,9998900.777777778,95.0,74.5,12,935,8184569.636363637,95.0,77.91666666666667
38748.0,6,10,2032,5,524,9454.5,252.0,104.8,5,1508,2574.75,1236.0,301.6
135132346.0,17,6,1146,6,1146,27026469.2,191.0,191.0,0,0,0.0,0.0,0.0
36116.0,6,14,4740,7,653,5851.833333333333,249.0,93.28571428571428,7,4087,5881.5,1514.0,583.8571428571429
2023.0,17,4,344,2,150,0.0,75.0,75.0,2,194,0.0,103.0,97.0
2322.0,17,4,344,2,150,0.0,75.0,75.0,2,194,0.0,103.0,97.0
10465240.0,6,6,412,3,206,5162185.0,74.0,68.66666666666667,3,206,5162095.5,74.0,68.66666666666667
34955.0,6,13,1386,7,789,5006.0,253.0,112.71428571428572,6,597,5570.2,259.0,99.5
2891771.0,6,3,1604,2,851,0.0,785.0,425.5,1,753,0.0,753.0,753.0
171687.0,17,2,180,1,90,0.0,90.0,90.0,1,90,0.0,90.0,90.0
9532.0,6,10,1975,5,467,2143.0,195.0,93.4,5,1508,1795.0,1236.0,301.6
135148877.0,17,6,1206,6,1206,27029775.4,201.0,201.0,0,0,0.0,0.0,0.0
90526969.0,6,13,2036,8,1016,12932424.142857144,188.0,127.0,5,1020,22590706.5,204.0,204.0
213662.0,17,2,414,1,88,0.0,88.0,88.0,1,326,0.0,326.0,326.0
29911.0,6,10,2032,5,524,7258.75,252.0,104.8,5,1508,7210.5,1236.0,301.6
155647.0,6,3,337,2,214,0.0,160.0,107.0,1,123,0.0,123.0,123.0
221520.0,6,11,1131,6,600,44256.6,262.0,100.0,5,531,3455.25,259.0,106.2
1314565.0,6,4,264,2,132,0.0,66.0,66.0,2,132,0.0,66.0,66.0
125001147.0,17,15,907,8,475,17857306.714285713,174.0,59.375,7,432,17500931.166666668,174.0,61.71428571428572
1163707.0,6,11,1134,6,558,232741.4,220.0,93.0,5,576,288732.75,304.0,115.2
4661.0,17,2,614,1,72,0.0,72.0,72.0,1,542,0.0,542.0,542.0
108105689.0,17,5,1005,5,1005,27026422.25,201.0,201.0,0,0,0.0,0.0,0.0
36541.0,6,14,4740,7,653,5741.666666666667,249.0,93.28571428571428,7,4087,5951.0,1514.0,583.8571428571429
119700123.0,17,35,16705,35,16705,3520591.8529411764,501.0,477.2857142857143,0,0,0.0,0.0,0.0
18580.0,6,14,4740,7,653,2859.5,249.0,93.28571428571428,7,4087,2960.1666666666665,1514.0,583.8571428571429
108107438.0,17,5,1005,5,1005,27026859.5,201.0,201.0,0,0,0.0,0.0,0.0
120296678.0,6,214,24102,107,7296,1127262.3679245282,140.0,68.18691588785046,107,16806,1127155.216981132,284.0,157.06542056074767
19173.0,6,2,145,2,145,0.0,91.0,72.5,0,0,0.0,0.0,0.0
208097.0,6,3,426,2,280,0.0,214.0,140.0,1,146,0.0,146.0,146.0
1315351.0,6,4,264,2,132,0.0,66.0,66.0,2,132,0.0,66.0,66.0
251307.0,6,10,1221,6,636,50261.4,298.0,106.0,4,585,78036.66666666667,379.0,146.25
65751.0,6,14,4740,7,653,9860.333333333334,249.0,93.28571428571428,7,4087,9698.0,1514.0,583.8571428571429
495.0,17,2,508,2,508,0.0,257.0,254.0,0,0,0.0,0.0,0.0
96997188.0,6,307,37656,154,27336,633968.5490196078,336.0,177.5064935064935,153,10320,634468.3355263158,140.0,67.45098039215686
196962.0,17,2,180,1,90,0.0,90.0,90.0,1,90,0.0,90.0,90.0
56787.0,6,14,4740,7,653,9337.166666666666,249.0,93.28571428571428,7,4087,8784.666666666666,1514.0,583.8571428571429
1302420.0,6,4,264,2,132,0.0,66.0,66.0,2,132,0.0,66.0,66.0
9011255.0,17,4,2996,4,2996,3003751.6666666665,749.0,749.0,0,0,0.0,0.0,0.0
35870.0,6,10,2032,5,524,8657.5,252.0,104.8,5,1508,8587.5,1236.0,301.6
123610293.0,6,49,3234,25,1650,5150428.875,66.0,66.0,24,1584,4938521.652173913,66.0,66.0
108100110.0,17,5,1005,5,1005,27025027.5,201.0,201.0,0,0,0.0,0.0,0.0
2591670.0,6,2,132,1,66,0.0,66.0,66.0,1,66,0.0,66.0,66.0
23146.0,6,10,2032,5,524,5554.0,252.0,104.8,5,1508,5208.5,1236.0,301.6
277208.0,6,3,337,2,214,0.0,160.0,107.0,1,123,0.0,123.0,123.0
101895.0,17,2,762,2,762,0.0,381.0,381.0,0,0,0.0,0.0,0.0
193847.0,17,2,180,1,90,0.0,90.0,90.0,1,90,0.0,90.0,90.0
253635.0,6,10,1221,6,636,50727.0,298.0,106.0,4,585,79149.66666666667,379.0,146.25
165130.0,17,2,414,1,88,0.0,88.0,88.0,1,326,0.0,326.0,326.0
15173.0,17,2,180,1,90,0.0,90.0,90.0,1,90,0.0,90.0,90.0
505722.0,6,4,270,2,134,0.0,68.0,67.0,2,136,0.0,70.0,68.0
860011.0,6,9,1269,6,798,172002.2,460.0,133.0,3,471,292212.0,331.0,157.0
34894990.0,6,26,7627,14,3735,197495.6153846153,1514.0,266.7857142857143,12,3892,3152689.272727273,1514.0,324.3333333333333
246117.0,6,3,337,2,214,0.0,160.0,107.0,1,123,0.0,123.0,123.0
37336.0,6,14,4740,7,653,5906.166666666667,249.0,93.28571428571428,7,4087,5761.5,1514.0,583.8571428571429
116346828.0,6,213,24046,107,7358,1097611.5849056605,140.0,68.76635514018692,106,16688,1099366.857142857,284.0,157.43396226415095
209571.0,17,2,180,1,90,0.0,90.0,90.0,1,90,0.0,90.0,90.0
137001101.0,17,15,907,8,475,19571585.85714286,174.0,59.375,7,432,19501930.0,174.0,61.71428571428572
114001084.0,17,13,821,7,432,19000180.666666668,174.0,61.71428571428572,6,389,19942857.6,174.0,64.83333333333333
42716.0,6,10,2032,5,524,9497.25,252.0,104.8,5,1508,10375.5,1236.0,301.6
120033588.0,17,29,13785,29,13785,4286913.857142857,501.0,475.3448275862069,0,0,0.0,0.0,0.0
120128185.0,6,13,2036,5,1020,30032046.25,204.0,204.0,8,1016,17137632.42857143,188.0,127.0
506782.0,6,5,336,2,134,0.0,68.0,67.0,3,202,192610.0,70.0,67.33333333333333
5264.0,17,4,344,2,150,0.0,75.0,75.0,2,194,0.0,103.0,97.0
113168455.0,6,46,3036,23,1518,5144008.954545454,66.0,66.0,23,1518,5144008.045454546,66.0,66.0
35390.0,6,2,145,2,145,0.0,91.0,72.5,0,0,0.0,0.0,0.0
0.0,6,1,66,1,66,0.0,66.0,66.0,0,0,0.0,0.0,0.0
2051.0,17,4,344,2,150,0.0,75.0,75.0,2,194,0.0,103.0,97.0
217281.0,6,3,426,2,280,0.0,214.0,140.0,1,146,0.0,146.0,146.0
103338.0,17,2,286,2,286,0.0,143.0,143.0,0,0,0.0,0.0,0.0
2793583.0,6,2,132,1,66,0.0,66.0,66.0,1,66,0.0,66.0,66.0
320222.0,17,4,1400,4,1400,106740.66666666669,350.0,350.0,0,0,0.0,0.0,0.0
49906.0,6,14,4740,7,653,7277.333333333333,249.0,93.28571428571428,7,4087,7178.833333333333,1514.0,583.8571428571429
107049.0,17,2,286,2,286,0.0,143.0,143.0,0,0,0.0,0.0,0.0
2019.0,17,4,344,2,150,0.0,75.0,75.0,2,194,0.0,103.0,97.0
63203.99999999999,6,12,1413,7,882,10534.0,291.0,126.0,5,531,14053.75,259.0,106.2
37632.0,6,14,4740,7,653,5947.0,249.0,93.28571428571428,7,4087,4804.5,1514.0,583.8571428571429
4105.0,17,4,571,2,148,0.0,74.0,74.0,2,423,0.0,276.0,211.5
95024130.0,6,40,2640,20,1320,5001270.0,66.0,66.0,20,1320,4986772.52631579,66.0,66.0
106887.0,17,2,286,2,286,0.0,143.0,143.0,0,0,0.0,0.0,0.0
123840029.0,6,49,3234,25,1650,5160001.208333333,66.0,66.0,24,1584,4976390.478260869,66.0,66.0
0.0,17,1,99,1,99,0.0,99.0,99.0,0,0,0.0,0.0,0.0
308312.0,6,6,412,4,272,102770.66666666669,74.0,68.0,2,140,0.0,74.0,70.0
17930.0,6,10,2032,5,524,4259.75,252.0,104.8,5,1508,3608.25,1236.0,301.6
135125719.0,17,6,1206,6,1206,27025143.8,201.0,201.0,0,0,0.0,0.0,0.0
385190.0,6,3,204,2,136,0.0,70.0,68.0,1,68,0.0,68.0,68.0
309083.0,6,6,412,4,272,103027.66666666669,74.0,68.0,2,140,0.0,74.0,70.0
209970.0,6,3,426,2,280,0.0,214.0,140.0,1,146,0.0,146.0,146.0
143810.0,17,2,180,1,90,0.0,90.0,90.0,1,90,0.0,90.0,90.0
444284.0,17,4,360,2,140,0.0,70.0,70.0,2,220,0.0,110.0,110.0
3010379.0,6,165,132850,94,123863,32369.666666666668,1510.0,1317.6914893617022,71,8987,38624.58571428571,1510.0,126.5774647887324
314427.0,17,4,1400,4,1400,104809.0,350.0,350.0,0,0,0.0,0.0,0.0
177386.0,17,2,180,1,90,0.0,90.0,90.0,1,90,0.0,90.0,90.0
263132.0,17,4,6056,4,6056,87710.66666666667,1514.0,1514.0,0,0,0.0,0.0,0.0
310357.0,17,4,1400,4,1400,103452.33333333331,350.0,350.0,0,0,0.0,0.0,0.0
140817.0,6,2,132,1,66,0.0,66.0,66.0,1,66,0.0,66.0,66.0
361.0,17,2,166,1,75,0.0,75.0,75.0,1,91,0.0,91.0,91.0
196934.0,17,2,180,1,90,0.0,90.0,90.0,1,90,0.0,90.0,90.0
113536392.0,6,46,3036,23,1518,5160729.454545454,66.0,66.0,23,1518,5160733.545454546,66.0,66.0
3009061.0,6,11,2106,6,598,601627.4,252.0,99.66666666666669,5,1508,2644.0,1236.0,301.6
117413456.0,6,228,25756,114,17936,1037152.5398230088,284.0,157.33333333333334,114,7820,1037152.1150442478,140.0,68.59649122807018
2320.0,17,4,344,2,150,0.0,75.0,75.0,2,194,0.0,103.0,97.0
42493.0,6,10,2032,5,524,10146.25,252.0,104.8,5,1508,9827.25,1236.0,301.6
108100242.0,17,5,1005,5,1005,27025060.5,201.0,201.0,0,0,0.0,0.0,0.0
2855091.0,6,3,204,2,136,0.0,70.0,68.0,1,68,0.0,68.0,68.0
114963060.0,6,30,1974,15,1026,8196240.571428572,123.0,68.4,15,948,8196241.5,123.0,63.2
90049314.0,17,28,13364,28,13364,3335159.777777778,501.0,477.2857142857143,0,0,0.0,0.0,0.0
63126.0,6,14,4740,7,653,10188.5,249.0,93.28571428571428,7,4087,9043.833333333334,1514.0,583.8571428571429
58701.0,6,11,2098,6,590,11408.2,252.0,98.33333333333331,5,1508,14391.25,1236.0,301.6
303770.0,17,2,363,1,79,0.0,79.0,79.0,1,284,0.0,284.0,284.0
23598.0,6,10,2032,5,524,5623.75,252.0,104.8,5,1508,5624.5,1236.0,301.6
120118311.0,6,16,2368,7,1164,20019718.5,204.0,166.28571428571428,9,1204,14994681.25,188.0,133.77777777777777
33519.0,6,10,2032,5,524,7990.75,252.0,104.8,5,1508,7931.25,1236.0,301.6
108085307.0,17,5,1005,5,1005,27021326.75,201.0,201.0,0,0,0.0,0.0,0.0
108093461.0,17,5,1005,5,1005,27023365.25,201.0,201.0,0,0,0.0,0.0,0.0
123250512.0,6,49,3234,25,1650,5135438.0,66.0,66.0,24,1584,5128063.043478261,66.0,66.0
10519023.0,6,7,478,4,272,3460601.6666666665,74.0,68.0,3,206,5190807.0,74.0,68.66666666666667
1319907.0,6,4,264,2,132,0.0,66.0,66.0,2,132,0.0,66.0,66.0
2128.0,17,4,344,2,150,0.0,75.0,75.0,2,194,0.0,103.0,97.0
232334.0,6,3,337,2,214,0.0,160.0,107.0,1,123,0.0,123.0,123.0
30209.0,6,14,4740,7,653,4500.666666666667,249.0,93.28571428571428,7,4087,4889.333333333333,1514.0,583.8571428571429
2053.0,17,4,344,2,150,0.0,75.0,75.0,2,194,0.0,103.0,97.0
39230.0,6,14,4740,7,653,6190.833333333333,249.0,93.28571428571428,7,4087,6391.666666666667,1514.0,583.8571428571429
281230.0,17,2,363,1,79,0.0,79.0,79.0,1,284,0.0,284.0,284.0
36437.0,6,13,1386,7,789,6072.833333333333,253.0,112.71428571428572,6,597,6625.0,259.0,99.5
2795518.0,6,2,132,1,66,0.0,66.0,66.0,1,66,0.0,66.0,66.0
90257640.0,6,13,2036,8,1016,12893948.57142857,188.0,127.0,5,1020,22523178.5,204.0,204.0
90244437.0,6,12,1832,8,1016,12892062.42857143,188.0,127.0,4,816,30026693.666666668,204.0,204.0
306.0,17,2,168,1,76,0.0,76.0,76.0,1,92,0.0,92.0,92.0
72764999.0,6,24,1786,12,843,6614601.727272728,95.0,70.25,12,943,6614638.545454546,154.0,78.58333333333333
2566827.0,6,2,132,1,66,0.0,66.0,66.0,1,66,0.0,66.0,66.0
33813.0,6,14,4740,7,653,5215.166666666667,249.0,93.28571428571428,7,4087,5095.166666666667,1514.0,583.8571428571429
102880.0,17,2,286,2,286,0.0,143.0,143.0,0,0,0.0,0.0,0.0
102510207.0,17,14,864,7,432,17000232.666666668,174.0,61.71428571428572,7,432,17001224.166666668,174.0,61.71428571428572
205729.0,17,2,180,1,90,0.0,90.0,90.0,1,90,0.0,90.0,90.0
106446883.0,6,33,2428,17,1288,6639450.75,139.0,75.76470588235294,16,1140,7082081.466666667,123.0,71.25
31461.000000000004,6,14,4740,7,653,5128.833333333333,249.0,93.28571428571428,7,4087,4835.833333333333,1514.0,583.8571428571429
27214684.0,17,5,1710,5,1710,6803671.0,342.0,342.0,0,0,0.0,0.0,0.0
95692590.0,17,12,778,6,389,19001138.8,174.0,64.83333333333333,6,389,19000170.8,174.0,64.83333333333333
32560.0,6,10,2032,5,524,7900.25,252.0,104.8,5,1508,7711.25,1236.0,301.6
109661049.0,6,28,1860,14,966,8419745.0,123.0,69.0,14,894,8419744.615384616,123.0,63.85714285714285
14062.0,6,11,2098,6,590,2668.2,252.0,98.33333333333331,5,1508,3163.25,1236.0,301.6
283646.0,17,2,180,1,90,0.0,90.0,90.0,1,90,0.0,90.0,90.0
23617.0,6,12,1393,6,796,4545.8,271.0,132.66666666666666,6,597,4224.4,259.0,99.5
230231.0,6,10,1221,6,636,46046.2,298.0,106.0,4,585,75872.0,379.0,146.25
2019909.0,17,4,525,2,150,0.0,75.0,75.0,2,375,0.0,284.0,187.5
544283.0,6,2,132,1,66,0.0,66.0,66.0,1,66,0.0,66.0,66.0
1041259.0,6,10,1065,5,534,259986.75,262.0,106.8,5,531,260070.25,259.0,106.2
64365.00000000001,6,14,4740,7,653,9311.666666666666,249.0,93.28571428571428,7,4087,10581.333333333334,1514.0,583.8571428571429
210800.0,6,10,1221,6,636,42160.0,298.0,106.0,4,585,69329.66666666667,379.0,146.25
5831450.0,6,5,336,2,134,0.0,68.0,67.0,3,202,1526510.0,70.0,67.33333333333333
6396.0,17,4,823,2,163,0.0,89.0,81.5,2,660,0.0,443.0,330.0
2527757.0,6,3,204,2,136,0.0,70.0,68.0,1,68,0.0,68.0,68.0
404.0,17,2,410,1,78,0.0,78.0,78.0,1,332,0.0,332.0,332.0
305370.0,17,2,246,1,76,0.0,76.0,76.0,1,170,0.0,170.0,170.0
1604281.0,6,7,499,4,301,516053.3333333333,103.0,75.25,3,198,716726.5,66.0,66.0
446702.0,17,4,360,2,140,0.0,70.0,70.0,2,220,0.0,110.0,110.0
10829.0,6,10,2032,5,524,2494.75,252.0,104.8,5,1508,2282.0,1236.0,301.6
20144.0,17,2,582,1,83,0.0,83.0,83.0,1,499,0.0,499.0,499.0
90522404.0,6,13,2036,8,1016,12931772.0,188.0,127.0,5,1020,22589998.75,204.0,204.0
206632.0,6,3,426,2,280,0.0,214.0,140.0,1,146,0.0,146.0,146.0
24790.0,6,14,4740,7,653,3904.6666666666665,249.0,93.28571428571428,7,4087,3901.8333333333335,1514.0,583.8571428571429
2726058.0,6,3,1777,1,826,0.0,826.0,826.0,2,951,0.0,885.0,475.5
216669.0,6,3,426,2,280,0.0,214.0,140.0,1,146,0.0,146.0,146.0
233394.0,6,3,337,2,214,0.0,160.0,107.0,1,123,0.0,123.0,123.0
10469334.0,6,7,478,4,272,3444285.333333333,74.0,68.0,3,206,5166290.0,74.0,68.66666666666667
97106170.0,6,31,2245,16,1140,6473744.666666667,123.0,71.25,15,1105,6920616.357142857,139.0,73.66666666666667
91300307.0,6,28,2130,15,1152,6506036.928571428,123.0,76.8,13,978,7590355.75,123.0,75.23076923076923
474.0,17,2,508,2,508,0.0,257.0,254.0,0,0,0.0,0.0,0.0
1303414.0,6,4,264,2,132,0.0,66.0,66.0,2,132,0.0,66.0,66.0
112304064.0,6,32,2236,16,1165,7472551.266666667,139.0,72.8125,16,1071,7472515.666666667,123.0,66.9375
108104435.0,17,5,955,5,955,27026108.75,191.0,191.0,0,0,0.0,0.0,0.0
90635341.0,6,15,2302,9,1204,11316285.5,188.0,133.77777777777777,6,1098,18094253.2,204.0,183.0
108109508.0,17,5,1005,5,1005,27027377.0,201.0,201.0,0,0,0.0,0.0,0.0
108064224.0,6,46,3036,23,1518,4911998.363636363,66.0,66.0,23,1518,4911998.181818182,66.0,66.0
236325.0,6,3,337,2,214,0.0,160.0,107.0,1,123,0.0,123.0,123.0
252462.00000000003,6,3,337,2,214,0.0,160.0,107.0,1,123,0.0,123.0,123.0
102000.0,17,2,762,2,762,0.0,381.0,381.0,0,0,0.0,0.0,0.0
14234.0,17,5,550,5,550,3558.5,110.0,110.0,0,0,0.0,0.0,0.0
3371.0,17,2,414,1,88,0.0,88.0,88.0,1,326,0.0,326.0,326.0
1306953.0,6,4,264,2,132,0.0,66.0,66.0,2,132,0.0,66.0,66.0
120044241.0,17,29,13785,29,13785,4287294.321428572,501.0,475.3448275862069,0,0,0.0,0.0,0.0
309198.0,17,4,1400,4,1400,103066.0,350.0,350.0,0,0,0.0,0.0,0.0
15006.0,6,14,4740,7,653,2378.833333333333,249.0,93.28571428571428,7,4087,2362.5,1514.0,583.8571428571429
148100.0,17,2,180,1,90,0.0,90.0,90.0,1,90,0.0,90.0,90.0
320974.0,17,4,1400,4,1400,106991.33333333331,350.0,350.0,0,0,0.0,0.0,0.0
39866.0,6,14,4740,7,653,6517.833333333333,249.0,93.28571428571428,7,4087,6152.666666666667,1514.0,583.8571428571429
2807367.0,6,2,132,1,66,0.0,66.0,66.0,1,66,0.0,66.0,66.0
0.0,6,1,66,1,66,0.0,66.0,66.0,0,0,0.0,0.0,0.0
2345.0,17,4,344,2,150,0.0,75.0,75.0,2,194,0.0,103.0,97.0
437244.0,6,11,1021,6,444,59495.2,162.0,74.0,5,577,73293.75,349.0,115.4
4142.0,17,2,598,1,72,0.0,72.0,72.0,1,526,0.0,526.0,526.0
511.0,17,2,508,2,508,0.0,257.0,254.0,0,0,0.0,0.0,0.0
106983.0,6,10,1067,5,536,26168.0,264.0,107.2,5,531,8444.5,259.0,106.2
90292487.0,6,16,1192,8,596,12892451.142857144,95.0,74.5,8,596,12897259.0,95.0,74.5
120069493.0,17,28,13364,28,13364,4447018.259259259,501.0,477.2857142857143,0,0,0.0,0.0,0.0
3348507.0,6,169,136795,96,127675,35247.44210526316,1510.0,1329.9479166666667,73,9120,42201.90277777778,1510.0,124.93150684931508
205939.0,6,3,426,2,280,0.0,214.0,140.0,1,146,0.0,146.0,146.0
90308614.0,6,16,1192,8,596,12894010.57142857,95.0,74.5,8,596,12899560.714285716,95.0,74.5
33747.0,6,14,4740,7,653,4937.833333333333,249.0,93.28571428571428,7,4087,4960.5,1514.0,583.8571428571429
112222915.0,6,215,24284,108,7350,1048812.289719626,140.0,68.05555555555556,107,16934,1048247.9056603772,284.0,158.26168224299064
90751884.0,6,27,2073,15,1138,6478704.928571428,95.0,75.86666666666666,12,935,8182588.818181818,95.0,77.91666666666667
121371.0,6,3,337,2,214,0.0,160.0,107.0,1,123,0.0,123.0,123.0
41688.0,6,14,4740,7,653,6825.833333333333,249.0,93.28571428571428,7,4087,6575.666666666667,1514.0,583.8571428571429
794452.0,6,5,1742,3,921,397226.0,785.0,307.0,2,821,0.0,753.0,410.5
103888970.0,17,14,864,7,432,17166827.333333332,174.0,61.71428571428572,7,432,17167450.833333332,174.0,61.71428571428572
215714.0,6,12,1373,7,714,35952.333333333336,298.0,102.0,5,659,53262.75,379.0,131.8
127679418.0,6,36,2533,18,1248,6923139.823529412,123.0,69.33333333333333,18,1285,7510459.294117647,139.0,71.38888888888889
53915.0,6,14,4740,7,653,7382.333333333333,249.0,93.28571428571428,7,4087,8297.166666666666,1514.0,583.8571428571429
123001434.0,17,15,907,8,475,17571633.42857143,174.0,59.375,7,432,17167846.5,174.0,61.71428571428572
120063607.0,17,28,13364,28,13364,4446800.259259259,501.0,477.2857142857143,0,0,0.0,0.0,0.0
2791.0,17,2,664,1,322,0.0,322.0,322.0,1,342,0.0,342.0,342.0
209001.0,6,3,426,2,280,0.0,214.0,140.0,1,146,0.0,146.0,146.0
20671.0,17,2,582,1,83,0.0,83.0,83.0,1,499,0.0,499.0,499.0
2403.0,17,4,344,2,150,0.0,75.0,75.0,2,194,0.0,103.0,97.0
700819.0,17,6,1230,3,234,350223.5,78.0,78.0,3,996,350196.0,332.0,332.0
236343.0,6,3,337,2,214,0.0,160.0,107.0,1,123,0.0,123.0,123.0
40180.0,6,14,4740,7,653,6574.833333333333,249.0,93.28571428571428,7,4087,6519.666666666667,1514.0,583.8571428571429
14249.0,6,14,4740,7,653,2065.833333333333,249.0,93.28571428571428,7,4087,2240.833333333333,1514.0,583.8571428571429
143974.0,17,2,180,1,90,0.0,90.0,90.0,1,90,0.0,90.0,90.0
0.0,6,1,66,1,66,0.0,66.0,66.0,0,0,0.0,0.0,0.0
90283495.0,6,17,1287,9,691,11280153.375,95.0,76.77777777777777,8,596,12831398.714285716,95.0,74.5
113254908.0,6,46,3036,23,1518,5135434.363636363,66.0,66.0,23,1518,5135426.545454546,66.0,66.0
311952.0,6,10,1221,6,636,62390.4,298.0,106.0,4,585,98193.0,379.0,146.25
5624494.0,6,4,270,2,134,0.0,68.0,67.0,2,136,0.0,70.0,68.0
18970.0,6,14,4740,7,653,3051.1666666666665,249.0,93.28571428571428,7,4087,2712.0,1514.0,583.8571428571429
450398.0,6,4,508,2,238,0.0,172.0,119.0,2,270,0.0,135.0,135.0
16976.0,17,2,180,1,90,0.0,90.0,90.0,1,90,0.0,90.0,90.0
229427.0,17,2,180,1,90,0.0,90.0,90.0,1,90,0.0,90.0,90.0
2064.0,17,4,344,2,150,0.0,75.0,75.0,2,194,0.0,103.0,97.0
299670.0,6,6,412,4,272,99890.0,74.0,68.0,2,140,0.0,74.0,70.0
92370476.0,6,27,2073,15,1138,6597364.357142857,95.0,75.86666666666666,12,935,8396863.636363637,95.0,77.91666666666667
1242263.0,6,7,499,4,301,405529.0,103.0,75.25,3,198,613712.5,66.0,66.0
48665.0,6,14,4740,7,653,7779.5,249.0,93.28571428571428,7,4087,7969.0,1514.0,583.8571428571429
108101292.0,17,5,1005,5,1005,27025323.0,201.0,201.0,0,0,0.0,0.0,0.0
107834293.0,6,28,1860,14,966,8278320.692307692,123.0,69.0,14,894,8278312.076923077,123.0,63.85714285714285
82898971.0,17,13,4454,12,4104,6952905.181818182,342.0,342.0,1,350,0.0,350.0,350.0
147920.0,17,2,180,1,90,0.0,90.0,90.0,1,90,0.0,90.0,90.0
107191773.0,6,44,2904,22,1452,5104370.142857143,66.0,66.0,22,1452,5090026.047619048,66.0,66.0
312.0,17,2,164,1,82,0.0,82.0,82.0,1,82,0.0,82.0,82.0
502502.0,6,5,336,2,134,0.0,68.0,67.0,3,202,194080.0,70.0,67.33333333333333
1307081.0,6,4,264,2,132,0.0,66.0,66.0,2,132,0.0,66.0,66.0
620121.0,17,2,335,1,88,0.0,88.0,88.0,1,247,0.0,247.0,247.0
97970702.0,6,187,21064,94,6352,1053448.4086021506,140.0,67.57446808510639,93,14712,1053637.6630434785,284.0,158.19354838709677
30037.0,6,10,2032,5,524,7099.5,252.0,104.8,5,1508,7244.5,1236.0,301.6
766.0,17,4,438,2,148,0.0,74.0,74.0,2,290,0.0,147.0,145.0
303802.0,6,3,202,2,128,0.0,74.0,64.0,1,74,0.0,74.0,74.0
32127.000000000004,6,10,2032,5,524,7608.0,252.0,104.8,5,1508,7090.75,1236.0,301.6
110067105.0,6,208,23548,104,7172,1060760.281553398,140.0,68.96153846153847,104,16376,1060756.6601941749,284.0,157.46153846153845
90255964.0,6,13,2036,8,1016,12893709.142857144,188.0,127.0,5,1020,22522370.25,204.0,204.0
10467022.0,6,7,478,4,272,3443496.6666666665,74.0,68.0,3,206,5165121.5,74.0,68.66666666666667
108108150.0,17,5,1005,5,1005,27027037.5,201.0,201.0,0,0,0.0,0.0,0.0
143934.0,17,2,180,1,90,0.0,90.0,90.0,1,90,0.0,90.0,90.0
2309.0,17,4,344,2,150,0.0,75.0,75.0,2,194,0.0,103.0,97.0
5409.0,17,2,180,1,90,0.0,90.0,90.0,1,90,0.0,90.0,90.0
90291632.0,6,19,1436,10,745,10027169.444444444,95.0,74.5,9,691,11285123.25,95.0,76.77777777777777
2302.0,17,4,344,2,150,0.0,75.0,75.0,2,194,0.0,103.0,97.0
2008.0,17,2,508,2,508,0.0,257.0,254.0,0,0,0.0,0.0,0.0
23739.0,6,10,2032,5,524,5412.0,252.0,104.8,5,1508,5288.25,1236.0,301.6
33637.0,6,10,2032,5,524,8177.75,252.0,104.8,5,1508,7742.75,1236.0,301.6
432.0,17,2,508,2,508,0.0,257.0,254.0,0,0,0.0,0.0,0.0
91000039.0,6,168,18984,84,13218,1093793.6626506024,284.0,157.35714285714286,84,5766,1093794.3373493976,140.0,68.64285714285714
113487196.0,17,14,864,7,432,18833501.33333333,174.0,61.71428571428572,7,432,18835025.166666668,174.0,61.71428571428572
120020848.0,17,28,13364,28,13364,4445216.592592592,501.0,477.2857142857143,0,0,0.0,0.0,0.0
2255.0,17,4,344,2,150,0.0,75.0,75.0,2,194,0.0,103.0,97.0
87571.0,6,10,2032,5,524,20753.25,252.0,104.8,5,1508,21633.0,1236.0,301.6
90255347.0,6,12,1832,8,1016,12893621.0,188.0,127.0,4,816,30024780.33333333,204.0,204.0
216659.0,17,2,180,1,90,0.0,90.0,90.0,1,90,0.0,90.0,90.0
2877.0,17,2,224,1,76,0.0,76.0,76.0,1,148,0.0,148.0,148.0
120463048.0,6,253,28762,127,20224,956055.9365079365,390.0,159.24409448818898,126,8538,955404.712,140.0,67.76190476190476
4232.0,17,2,602,1,72,0.0,72.0,72.0,1,530,0.0,530.0,530.0
1307327.0,6,4,264,2,132,0.0,66.0,66.0,2,132,0.0,66.0,66.0
4139.0,17,2,582,1,83,0.0,83.0,83.0,1,499,0.0,499.0,499.0
2104609.0,6,19,6869,11,1567,210460.9,408.0,142.45454545454547,8,5302,238643.8571428572,1514.0,662.75
120145.0,17,2,180,1,70,0.0,70.0,70.0,1,110,0.0,110.0,110.0
30251.0,6,14,4740,7,653,4922.0,249.0,93.28571428571428,7,4087,4907.166666666667,1514.0,583.8571428571429
101934.0,17,2,762,2,762,0.0,381.0,381.0,0,0,0.0,0.0,0.0
47826.0,6,14,4740,7,653,6916.166666666667,249.0,93.28571428571428,7,4087,7620.666666666667,1514.0,583.8571428571429
90000937.0,17,11,735,6,389,18000187.4,174.0,64.83333333333333,5,346,17501083.25,174.0,69.2
228215.0,17,2,180,1,90,0.0,90.0,90.0,1,90,0.0,90.0,90.0
884310.0,6,10,1162,6,625,176862.0,287.0,104.16666666666669,4,537,202874.0,331.0,134.25
22184.0,6,14,4740,7,653,3534.1666666666665,249.0,93.28571428571428,7,4087,3146.333333333333,1514.0,583.8571428571429
50008.0,6,14,4740,7,653,8210.5,249.0,93.28571428571428,7,4087,7336.5,1514.0,583.8571428571429
2058.0,17,2,664,1,322,0.0,322.0,322.0,1,342,0.0,342.0,342.0
320005.0,17,4,1400,4,1400,106668.33333333331,350.0,350.0,0,0,0.0,0.0,0.0
120039160.0,17,29,13785,29,13785,4287112.857142857,501.0,475.3448275862069,0,0,0.0,0.0,0.0
90254999.0,6,14,2240,8,1016,12893571.285714284,188.0,127.0,6,1224,18017813.0,204.0,204.0
15228062.0,17,6,2052,6,2052,3045612.4,342.0,342.0,0,0,0.0,0.0,0.0
90053095.0,17,28,13364,28,13364,3335299.814814815,501.0,477.2857142857143,0,0,0.0,0.0,0.0
294686.0,6,6,412,4,272,98228.66666666669,74.0,68.0,2,140,0.0,74.0,70.0
57862.0,6,14,4740,7,653,9512.666666666666,249.0,93.28571428571428,7,4087,9036.666666666666,1514.0,583.8571428571429
110960701.0,6,30,1974,15,1026,7911160.285714285,123.0,68.4,15,948,7911166.428571428,123.0,63.2
100797268.0,6,20,1651,9,811,12599658.5,215.0,90.11111111111111,11,840,10050007.5,95.0,76.36363636363636
198105.0,6,3,337,2,214,0.0,160.0,107.0,1,123,0.0,123.0,123.0
605794.0,6,4,508,2,238,0.0,172.0,119.0,2,270,0.0,135.0,135.0
2801609.0,6,2,132,1,66,0.0,66.0,66.0,1,66,0.0,66.0,66.0
120068561.0,17,29,13785,29,13785,4288162.892857143,501.0,475.3448275862069,0,0,0.0,0.0,0.0
33998.0,6,14,4740,7,653,4375.833333333333,249.0,93.28571428571428,7,4087,5532.833333333333,1514.0,583.8571428571429
106551.0,17,2,700,2,700,0.0,350.0,350.0,0,0,0.0,0.0,0.0
2057.0,17,4,344,2,150,0.0,75.0,75.0,2,194,0.0,103.0,97.0
16319215.0,17,6,2052,6,2052,3263843.0,342.0,342.0,0,0,0.0,0.0,0.0
50047.0,6,14,4740,7,653,8043.0,249.0,93.28571428571428,7,4087,7197.333333333333,1514.0,583.8571428571429
2796640.0,6,2,132,1,66,0.0,66.0,66.0,1,66,0.0,66.0,66.0
14646308.0,6,20,1648,10,1016,1593333.7777777778,315.0,101.6,10,632,1593317.3333333333,78.0,63.2
54800.0,6,14,4740,7,653,9011.333333333334,249.0,93.28571428571428,7,4087,8412.5,1514.0,583.8571428571429
108105483.0,17,5,1005,5,1005,27026370.75,201.0,201.0,0,0,0.0,0.0,0.0
115041203.0,6,48,3168,24,1584,5001791.434782608,66.0,66.0,24,1584,4989814.608695652,66.0,66.0
120067912.0,17,29,13785,29,13785,4288139.714285715,501.0,475.3448275862069,0,0,0.0,0.0,0.0
183485.0,6,10,1065,5,534,45194.5,262.0,106.8,5,531,3527.0,259.0,106.2
88798.0,6,15,4806,8,719,12542.285714285714,249.0,89.875,7,4087,14471.5,1514.0,583.8571428571429
118659066.0,6,35,2542,18,1348,6979945.05882353,139.0,74.88888888888889,17,1194,6778656.5,123.0,70.23529411764706
189204.0,17,4,1524,4,1524,63068.0,381.0,381.0,0,0,0.0,0.0,0.0
95610617.0,6,22,1578,10,735,10622491.777777778,95.0,73.5,12,843,8691626.090909092,95.0,70.25
123303.0,6,3,337,2,214,0.0,160.0,107.0,1,123,0.0,123.0,123.0
303.0,17,2,168,1,76,0.0,76.0,76.0,1,92,0.0,92.0,92.0
153395.0,17,2,180,1,90,0.0,90.0,90.0,1,90,0.0,90.0,90.0
118891169.0,6,35,2542,18,1348,6980899.529411765,139.0,74.88888888888889,17,1194,7417208.3125,123.0,70.23529411764706
2044930.0,6,19,6869,11,1567,204493.0,408.0,142.45454545454547,8,5302,229506.57142857145,1514.0,662.75
25410.0,6,12,1320,6,723,4689.0,253.0,120.5,6,597,4218.2,259.0,99.5
31683.000000000004,6,14,4740,7,653,5059.5,249.0,93.28571428571428,7,4087,4980.0,1514.0,583.8571428571429
3154.0,17,2,224,1,76,0.0,76.0,76.0,1,148,0.0,148.0,148.0
18550898.0,6,5,1736,2,819,0.0,753.0,409.5,3,917,9203460.0,785.0,305.6666666666667
120051654.0,17,29,13785,29,13785,4287559.071428572,501.0,475.3448275862069,0,0,0.0,0.0,0.0
112511174.0,6,30,1974,15,1026,8021078.285714285,123.0,68.4,15,948,8021061.0,123.0,63.2
239802.0,6,3,337,2,214,0.0,160.0,107.0,1,123,0.0,123.0,123.0
115830.0,17,2,286,2,286,0.0,143.0,143.0,0,0,0.0,0.0,0.0
325.0,17,2,174,1,79,0.0,79.0,79.0,1,95,0.0,95.0,95.0
32554.0,6,10,2032,5,524,7141.25,252.0,104.8,5,1508,7849.75,1236.0,301.6
63898.0,6,10,2032,5,524,13997.5,252.0,104.8,5,1508,14542.0,1236.0,301.6
2801294.0,6,2,132,1,66,0.0,66.0,66.0,1,66,0.0,66.0,66.0
21829957.0,6,11,3943,4,1024,7247323.0,826.0,256.0,7,2919,3614945.6666666665,885.0,417.0
112436484.0,6,31,2182,16,1165,7481359.0,139.0,72.8125,15,1017,8015747.142857143,123.0,67.8
146237.0,6,3,337,2,214,0.0,160.0,107.0,1,123,0.0,123.0,123.0
247165.0,6,3,337,2,214,0.0,160.0,107.0,1,123,0.0,123.0,123.0
2360.0,17,4,344,2,150,0.0,75.0,75.0,2,194,0.0,103.0,97.0
105048474.0,6,205,23174,103,7094,1029887.0,140.0,68.87378640776699,102,16080,1020611.1485148516,284.0,157.64705882352942
205825.0,6,3,426,2,280,0.0,214.0,140.0,1,146,0.0,146.0,146.0
317300.0,17,4,1400,4,1400,105766.66666666669,350.0,350.0,0,0,0.0,0.0,0.0
148051.0,17,2,180,1,90,0.0,90.0,90.0,1,90,0.0,90.0,90.0
179386.0,17,2,608,1,75,0.0,75.0,75.0,1,533,0.0,533.0,533.0
20373.0,17,2,582,1,83,0.0,83.0,83.0,1,499,0.0,499.0,499.0
204797.0,17,2,762,2,762,0.0,381.0,381.0,0,0,0.0,0.0,0.0
135134107.0,17,6,1206,6,1206,27026821.4,201.0,201.0,0,0,0.0,0.0,0.0
5821566.0,6,5,336,2,134,0.0,68.0,67.0,3,202,1526320.0,70.0,67.33333333333333
201105.0,17,4,6056,4,6056,67035.0,1514.0,1514.0,0,0,0.0,0.0,0.0
146359.0,6,3,337,2,214,0.0,160.0,107.0,1,123,0.0,123.0,123.0
216473.0,17,2,180,1,90,0.0,90.0,90.0,1,90,0.0,90.0,90.0
34476.0,6,10,2032,5,524,8397.5,252.0,104.8,5,1508,7988.5,1236.0,301.6
101210945.0,17,14,864,7,432,16833488.166666668,174.0,61.71428571428572,7,432,16834380.5,174.0,61.71428571428572
996913.0,6,4,264,2,132,0.0,66.0,66.0,2,132,0.0,66.0,66.0
121450918.0,17,14,864,7,432,17000165.5,174.0,61.71428571428572,7,432,17001394.0,174.0,61.71428571428572
29897318.0,6,4,270,3,202,14948659.0,70.0,67.33333333333333,1,68,0.0,68.0,68.0
41237.0,6,12,1413,7,882,6872.833333333333,291.0,126.0,5,531,9258.0,259.0,106.2
215003.0,6,12,1373,7,714,35833.833333333336,298.0,102.0,5,659,53097.0,379.0,131.8
112829333.0,6,34,2350,17,1225,7038343.5625,139.0,72.05882352941177,17,1125,7038340.6875,123.0,66.17647058823529
4127.0,17,4,344,2,150,0.0,75.0,75.0,2,194,0.0,103.0,97.0
467.0,17,2,267,1,83,0.0,83.0,83.0,1,184,0.0,184.0,184.0
120124546.0,6,13,2036,5,1020,30031136.5,204.0,204.0,8,1016,17136139.14285714,188.0,127.0
120123985.0,6,14,2224,9,1204,15015498.125,188.0,133.77777777777777,5,1020,22523713.0,204.0,204.0
107063.0,17,2,286,2,286,0.0,143.0,143.0,0,0,0.0,0.0,0.0
108111674.0,17,5,955,5,955,27027918.5,191.0,191.0,0,0,0.0,0.0,0.0
852.0,17,4,438,2,148,0.0,74.0,74.0,2,290,0.0,147.0,145.0
99497.0,17,2,762,2,762,0.0,381.0,381.0,0,0,0.0,0.0,0.0
146086.0,6,3,337,2,214,0.0,160.0,107.0,1,123,0.0,123.0,123.0
37108.0,6,14,4740,7,653,5518.666666666667,249.0,93.28571428571428,7,4087,5881.0,1514.0,583.8571428571429
309922.0,6,6,412,4,272,103307.33333333331,74.0,68.0,2,140,0.0,74.0,70.0
90015500.0,17,28,13364,28,13364,3333907.407407407,501.0,477.2857142857143,0,0,0.0,0.0,0.0
153362.0,17,2,180,1,90,0.0,90.0,90.0,1,90,0.0,90.0,90.0
17299.0,17,2,180,1,90,0.0,90.0,90.0,1,90,0.0,90.0,90.0
123309871.0,6,48,3168,24,1584,5092876.608695652,66.0,66.0,24,1584,5196407.260869565,66.0,66.0
90027864.0,17,27,12943,27,12943,3462610.153846154,501.0,479.3703703703704,0,0,0.0,0.0,0.0
2276180.0,6,49,23728,25,19797,94840.83333333331,1514.0,791.88,24,3931,89657.86956521739,1514.0,163.79166666666666
135120004.0,17,6,1206,6,1206,27024000.8,201.0,201.0,0,0,0.0,0.0,0.0
233073.0,6,3,373,2,238,0.0,172.0,119.0,1,135,0.0,135.0,135.0
135125852.0,17,6,1146,6,1146,27025170.4,191.0,191.0,0,0,0.0,0.0,0.0
238696.0,17,2,180,1,90,0.0,90.0,90.0,1,90,0.0,90.0,90.0
199593.0,17,4,6056,4,6056,66531.0,1514.0,1514.0,0,0,0.0,0.0,0.0
14638088.0,6,20,1607,10,975,1593061.888888889,315.0,97.5,10,632,1593031.5555555555,78.0,63.2
14965.0,17,2,180,1,90,0.0,90.0,90.0,1,90,0.0,90.0,90.0
302.0,17,2,174,1,79,0.0,79.0,79.0,1,95,0.0,95.0,95.0
1163184.0,6,13,3010,8,2382,166169.14285714287,1514.0,297.75,5,628,222605.75,331.0,125.6
10475223.0,6,6,412,3,206,5169298.5,74.0,68.66666666666667,3,206,5169178.0,74.0,68.66666666666667
108102430.0,17,5,1005,5,1005,27025607.5,201.0,201.0,0,0,0.0,0.0,0.0
1310024.0,6,4,264,2,132,0.0,66.0,66.0,2,132,0.0,66.0,66.0
135164189.0,17,6,1206,6,1206,27032837.8,201.0,201.0,0,0,0.0,0.0,0.0
30703.0,6,14,4740,7,653,4117.0,249.0,93.28571428571428,7,4087,4898.166666666667,1514.0,583.8571428571429
2843273.0,6,3,1604,1,753,0.0,753.0,753.0,2,851,0.0,785.0,425.5
205807.0,6,3,426,2,280,0.0,214.0,140.0,1,146,0.0,146.0,146.0
1172799.0,6,13,3007,8,2379,167542.7142857143,1514.0,297.375,5,628,224324.25,331.0,125.6
90258752.0,6,13,2036,8,1016,12894107.42857143,188.0,127.0,5,1020,22522347.0,204.0,204.0
6892.0,17,2,582,1,83,0.0,83.0,83.0,1,499,0.0,499.0,499.0
90255035.0,6,16,2368,9,1204,11281879.375,188.0,133.77777777777777,7,1164,15015348.333333334,204.0,166.28571428571428
115212691.0,6,48,3168,24,1584,5009247.434782608,66.0,66.0,24,1584,4995659.521739131,66.0,66.0
19669.0,6,14,4740,7,653,3107.833333333333,249.0,93.28571428571428,7,4087,3076.1666666666665,1514.0,583.8571428571429
20163.0,6,10,1066,5,490,4450.75,218.0,98.0,5,576,4750.0,304.0,115.2
135118423.0,17,6,1206,6,1206,27023684.6,201.0,201.0,0,0,0.0,0.0,0.0
114998325.0,6,47,3102,24,1584,4987958.130434782,66.0,66.0,23,1518,5135437.681818182,66.0,66.0
233837.0,6,3,373,2,238,0.0,172.0,119.0,1,135,0.0,135.0,135.0
115952685.0,6,35,2542,18,1348,6820746.176470588,139.0,74.88888888888889,17,1194,7233493.8125,123.0,70.23529411764706
62497.0,6,14,4740,7,653,10243.5,249.0,93.28571428571428,7,4087,8406.833333333334,1514.0,583.8571428571429
135133419.0,17,6,1146,6,1146,27026683.8,191.0,191.0,0,0,0.0,0.0,0.0
90271231.0,6,14,1964,8,1016,12895890.142857144,188.0,127.0,6,948,18019992.2,204.0,158.0
113648391.0,6,31,2182,16,1165,7562147.066666666,139.0,72.8125,15,1017,8102298.714285715,123.0,67.8
38796.0,6,10,2032,5,524,8755.75,252.0,104.8,5,1508,9358.25,1236.0,301.6
355.0,17,2,248,1,84,0.0,84.0,84.0,1,164,0.0,164.0,164.0
279917.0,17,2,363,1,79,0.0,79.0,79.0,1,284,0.0,284.0,284.0
41678.0,6,14,4740,7,653,5356.5,249.0,93.28571428571428,7,4087,6662.666666666667,1514.0,583.8571428571429
90257943.0,6,12,1832,8,1016,12893991.857142856,188.0,127.0,4,816,30030616.666666668,204.0,204.0
120108088.0,6,216,24296,108,7424,1114936.887850467,140.0,68.74074074074075,108,16872,1114759.38317757,284.0,156.22222222222223
112481956.0,6,46,3036,23,1518,5112804.590909091,66.0,66.0,23,1518,5112804.0,66.0,66.0
114726329.0,6,48,3168,24,1584,4988101.260869565,66.0,66.0,24,1584,4975011.304347826,66.0,66.0
135130887.0,17,6,1206,6,1206,27026177.4,201.0,201.0,0,0,0.0,0.0,0.0
14644917.0,6,20,1607,10,975,1592924.5555555555,315.0,97.5,10,632,1592907.7777777778,78.0,63.2
2317.0,17,4,344,2,150,0.0,75.0,75.0,2,194,0.0,103.0,97.0
108137370.0,6,197,22174,99,6756,1103442.551020408,140.0,68.24242424242425,98,15418,1104249.2164948457,284.0,157.3265306122449
90287056.0,6,16,1192,8,596,12892067.714285716,95.0,74.5,8,596,12896283.142857144,95.0,74.5
298161.0,6,6,412,4,272,99387.0,74.0,68.0,2,140,0.0,74.0,70.0
223105.0,6,10,1221,6,636,44621.0,298.0,106.0,4,585,71255.66666666667,379.0,146.25
301325.0,6,2,1711,1,885,0.0,885.0,885.0,1,826,0.0,826.0,826.0
90223148.0,6,17,1287,8,596,12852854.0,95.0,74.5,9,691,11250909.5,95.0,76.77777777777777
35614.0,6,2,145,2,145,0.0,91.0,72.5,0,0,0.0,0.0,0.0
4905.0,17,2,602,1,72,0.0,72.0,72.0,1,530,0.0,530.0,530.0
10470692.0,6,7,478,4,272,3444763.333333333,74.0,68.0,3,206,5167064.0,74.0,68.66666666666667
90975013.0,6,172,19438,86,13540,1067760.8352941177,300.0,157.4418604651163,86,5898,1067760.4,140.0,68.5813953488372
124001353.0,17,15,907,8,475,17714479.0,174.0,59.375,7,432,17334247.166666668,174.0,61.71428571428572
0.0,17,1,72,1,72,0.0,72.0,72.0,0,0,0.0,0.0,0.0
303462.0,6,6,412,4,272,101154.0,74.0,68.0,2,140,0.0,74.0,70.0
2430.0,17,4,344,2,150,0.0,75.0,75.0,2,194,0.0,103.0,97.0
2301.0,17,4,344,2,150,0.0,75.0,75.0,2,194,0.0,103.0,97.0
232932.0,6,3,337,2,214,0.0,160.0,107.0,1,123,0.0,123.0,123.0
91920716.0,6,30,2106,15,1089,6565765.428571428,123.0,72.6,15,1017,6549550.357142857,123.0,67.8
3428407.0,6,19,1549,10,975,347723.3333333333,315.0,97.5,9,574,391149.25,78.0,63.77777777777778
297403.0,17,2,363,1,79,0.0,79.0,79.0,1,284,0.0,284.0,284.0
509202.00000000006,6,5,336,2,134,0.0,68.0,67.0,3,202,195153.5,70.0,67.33333333333333
2007.0,17,2,664,1,322,0.0,322.0,322.0,1,342,0.0,342.0,342.0
146544.0,6,3,337,2,214,0.0,160.0,107.0,1,123,0.0,123.0,123.0
28164.0,6,14,4740,7,653,3891.8333333333335,249.0,93.28571428571428,7,4087,4538.833333333333,1514.0,583.8571428571429
188495.0,17,2,180,1,90,0.0,90.0,90.0,1,90,0.0,90.0,90.0
2942843.0,6,134,111403,79,103471,37728.756410256414,1510.0,1309.759493670886,55,7932,48865.51851851852,1510.0,144.21818181818182
108104912.0,17,5,955,5,955,27026228.0,191.0,191.0,0,0,0.0,0.0,0.0
34574.0,6,14,4740,7,653,5613.5,249.0,93.28571428571428,7,4087,5623.5,1514.0,583.8571428571429
306335.0,17,2,246,1,76,0.0,76.0,76.0,1,170,0.0,170.0,170.0
197014.0,17,2,180,1,90,0.0,90.0,90.0,1,90,0.0,90.0,90.0
110843.0,17,4,1400,4,1400,36947.66666666666,350.0,350.0,0,0,0.0,0.0,0.0
220211.0,6,10,1221,6,636,44042.2,298.0,106.0,4,585,72207.0,379.0,146.25
306320.0,6,6,412,4,272,102106.66666666669,74.0,68.0,2,140,0.0,74.0,70.0
30921.0,6,10,2032,5,524,7502.75,252.0,104.8,5,1508,7225.0,1236.0,301.6
83549.0,6,10,1065,5,534,20557.5,262.0,106.8,5,531,19595.75,259.0,106.2
35975.0,6,10,2032,5,524,8766.75,252.0,104.8,5,1508,8718.0,1236.0,301.6
90212656.0,6,16,1192,8,596,12853521.42857143,95.0,74.5,8,596,12857329.57142857,95.0,74.5
306262.0,6,6,412,4,272,102087.33333333331,74.0,68.0,2,140,0.0,74.0,70.0
2902264.0,6,3,1604,2,851,0.0,785.0,425.5,1,753,0.0,753.0,753.0
2477.0,17,4,344,2,150,0.0,75.0,75.0,2,194,0.0,103.0,97.0
153501.0,17,2,180,1,90,0.0,90.0,90.0,1,90,0.0,90.0,90.0
107700.0,17,2,286,2,286,0.0,143.0,143.0,0,0,0.0,0.0,0.0
302117.0,6,6,412,4,272,100705.66666666669,74.0,68.0,2,140,0.0,74.0,70.0
297.0,17,2,156,1,78,0.0,78.0,78.0,1,78,0.0,78.0,78.0
207146.0,6,3,426,2,280,0.0,214.0,140.0,1,146,0.0,146.0,146.0
502723.00000000006,6,5,336,2,134,0.0,68.0,67.0,3,202,193870.0,70.0,67.33333333333333
137790.0,6,2,132,1,66,0.0,66.0,66.0,1,66,0.0,66.0,66.0
62840.99999999999,6,14,4740,7,653,10352.5,249.0,93.28571428571428,7,4087,8986.166666666666,1514.0,583.8571428571429
120244075.0,6,224,25344,112,7614,1076937.4684684684,140.0,67.98214285714286,112,17730,1066602.4414414414,284.0,158.30357142857142
15497.0,6,10,1067,5,536,3592.5,264.0,107.2,5,531,2254.75,259.0,106.2
297470.0,6,6,412,4,272,99156.66666666669,74.0,68.0,2,140,0.0,74.0,70.0
135128397.0,17,6,1146,6,1146,27025679.4,191.0,191.0,0,0,0.0,0.0,0.0
1415776.0,17,16,1120,16,1120,94385.06666666668,70.0,70.0,0,0,0.0,0.0,0.0
1303525.0,6,4,264,2,132,0.0,66.0,66.0,2,132,0.0,66.0,66.0
68395.0,6,10,2032,5,524,12308.0,252.0,104.8,5,1508,15936.75,1236.0,301.6
2109155.0,6,18,6803,10,1501,234350.5555555556,408.0,150.1,8,5302,235638.2857142857,1514.0,662.75
112170690.0,6,201,22730,101,6888,1121706.9,140.0,68.1980198019802,100,15842,1122445.6464646466,284.0,158.42
146141.0,6,3,337,2,214,0.0,160.0,107.0,1,123,0.0,123.0,123.0
23124816.0,17,3,1034,2,684,0.0,342.0,342.0,1,350,0.0,350.0,350.0
97944342.0,6,181,20472,91,14310,1088270.4666666666,284.0,157.25274725274724,90,6162,1089020.5168539323,140.0,68.46666666666667
281518.0,17,2,363,1,79,0.0,79.0,79.0,1,284,0.0,284.0,284.0
304195.0,17,4,6056,4,6056,101398.33333333331,1514.0,1514.0,0,0,0.0,0.0,0.0
5618941.0,6,5,336,2,134,0.0,68.0,67.0,3,202,1421536.0,70.0,67.33333333333333
144014.0,17,2,180,1,90,0.0,90.0,90.0,1,90,0.0,90.0,90.0
108108023.0,17,5,955,5,955,27027005.75,191.0,191.0,0,0,0.0,0.0,0.0
304915.0,6,6,412,4,272,101638.33333333331,74.0,68.0,2,140,0.0,74.0,70.0
1314553.0,6,4,264,2,132,0.0,66.0,66.0,2,132,0.0,66.0,66.0
43451.0,6,14,4740,7,653,6813.666666666667,249.0,93.28571428571428,7,4087,7036.666666666667,1514.0,583.8571428571429
20113.0,6,11,2098,6,590,3357.4,252.0,98.33333333333331,5,1508,3560.25,1236.0,301.6
90293729.0,6,15,2306,8,1016,12899104.142857144,188.0,127.0,7,1290,15021984.833333334,204.0,184.28571428571428
41825.0,6,10,2032,5,524,10160.5,252.0,104.8,5,1508,7494.5,1236.0,301.6
108082707.0,17,5,955,5,955,27020676.75,191.0,191.0,0,0,0.0,0.0,0.0
107140.0,17,2,286,2,286,0.0,143.0,143.0,0,0,0.0,0.0,0.0
8394.0,17,2,582,1,83,0.0,83.0,83.0,1,499,0.0,499.0,499.0
10938221.0,6,8,544,4,272,3600736.6666666665,74.0,68.0,4,272,3600637.0,74.0,68.0
120118738.0,6,14,2240,8,1016,17136691.285714287,188.0,127.0,6,1224,18018055.4,204.0,204.0
92046756.0,6,23,1775,12,935,8363953.727272727,95.0,77.91666666666667,11,840,9203057.5,95.0,76.36363636363636
14232728.0,6,20,1607,10,975,1546743.0,315.0,97.5,10,632,1546722.0,78.0,63.2
120357225.0,6,283,32282,142,22680,853597.340425532,284.0,159.71830985915494,141,9602,852309.2714285714,140.0,68.09929078014184
24894123.0,6,26,7643,14,3751,197430.38461538465,1514.0,267.92857142857144,12,3892,2244481.909090909,1514.0,324.3333333333333
68274.0,6,14,4740,7,653,11250.666666666666,249.0,93.28571428571428,7,4087,9946.0,1514.0,583.8571428571429
153405.0,17,2,180,1,90,0.0,90.0,90.0,1,90,0.0,90.0,90.0
90704202.0,6,21,1585,10,745,10078244.666666666,95.0,74.5,11,840,9044552.8,95.0,76.36363636363636
270012.0,6,3,337,2,214,0.0,160.0,107.0,1,123,0.0,123.0,123.0
216087.0,6,10,1221,6,636,43217.4,298.0,106.0,4,585,70574.66666666667,379.0,146.25
0.0,17,1,84,1,84,0.0,84.0,84.0,0,0,0.0,0.0,0.0
120285683.0,6,19,1477,10,786,13333326.555555556,95.0,78.6,9,691,14975691.75,95.0,76.77777777777777
2481.0,17,4,344,2,150,0.0,75.0,75.0,2,194,0.0,103.0,97.0
90303443.0,6,16,1192,8,596,12894228.42857143,95.0,74.5,8,596,12898825.142857144,95.0,74.5
153411.0,17,2,180,1,90,0.0,90.0,90.0,1,90,0.0,90.0,90.0
153463.0,17,2,180,1,90,0.0,90.0,90.0,1,90,0.0,90.0,90.0
108110952.0,17,5,1005,5,1005,27027738.0,201.0,201.0,0,0,0.0,0.0,0.0
99677.0,6,2,132,1,66,0.0,66.0,66.0,1,66,0.0,66.0,66.0
107675.0,17,2,286,2,286,0.0,143.0,143.0,0,0,0.0,0.0,0.0
28464.0,6,20,7606,11,978,2846.4,310.0,88.9090909090909,9,6628,2517.25,1514.0,736.4444444444445
399.0,17,2,410,1,78,0.0,78.0,78.0,1,332,0.0,332.0,332.0
112801203.0,6,48,3168,24,1584,4904400.130434782,66.0,66.0,24,1584,4895013.130434782,66.0,66.0
120000001.0,6,22,1680,12,935,10909091.0,95.0,77.91666666666667,10,745,10104898.555555556,95.0,74.5
42046.0,6,10,2032,5,524,9169.75,252.0,104.8,5,1508,10234.75,1236.0,301.6
120318037.0,6,221,25024,111,17468,1093800.3363636364,284.0,157.36936936936937,110,7556,1094303.5688073395,140.0,68.69090909090909
815.0,17,5,550,5,550,203.75,110.0,110.0,0,0,0.0,0.0,0.0
153398.0,17,2,180,1,90,0.0,90.0,90.0,1,90,0.0,90.0,90.0
90294828.0,6,16,1192,8,596,12892245.57142857,95.0,74.5,8,596,12898911.42857143,95.0,74.5
34237.0,6,14,4740,7,653,5318.333333333333,249.0,93.28571428571428,7,4087,4878.166666666667,1514.0,583.8571428571429
206478.0,17,2,762,2,762,0.0,381.0,381.0,0,0,0.0,0.0,0.0
3086718.0,6,149,124282,89,116021,35076.34090909091,1510.0,1303.6067415730338,60,8261,47015.13559322034,1510.0,137.68333333333334
249313.0,6,3,337,2,214,0.0,160.0,107.0,1,123,0.0,123.0,123.0
159549.0,6,3,337,2,214,0.0,160.0,107.0,1,123,0.0,123.0,123.0
29819.0,6,14,4740,7,653,4822.833333333333,249.0,93.28571428571428,7,4087,4670.0,1514.0,583.8571428571429
0.0,17,1,350,1,350,0.0,350.0,350.0,0,0,0.0,0.0,0.0
1566431.0,6,2,132,1,66,0.0,66.0,66.0,1,66,0.0,66.0,66.0
102541.0,17,2,762,2,762,0.0,381.0,381.0,0,0,0.0,0.0,0.0
121419.0,6,3,337,2,214,0.0,160.0,107.0,1,123,0.0,123.0,123.0
107589.0,17,2,286,2,286,0.0,143.0,143.0,0,0,0.0,0.0,0.0
206025.0,6,3,426,2,280,0.0,214.0,140.0,1,146,0.0,146.0,146.0
4594860.0,6,187,141796,99,131688,46855.93877551021,1510.0,1330.1818181818182,88,10108,49291.379310344826,1510.0,114.86363636363636
63650.0,6,14,4740,7,653,9466.666666666666,249.0,93.28571428571428,7,4087,8684.833333333334,1514.0,583.8571428571429
871843.0,6,9,1270,6,799,174368.6,461.0,133.16666666666666,3,471,298044.0,331.0,157.0
205937.0,17,2,180,1,90,0.0,90.0,90.0,1,90,0.0,90.0,90.0
108117941.0,17,5,955,5,955,27029485.25,191.0,191.0,0,0,0.0,0.0,0.0
314.0,17,2,174,1,79,0.0,79.0,79.0,1,95,0.0,95.0,95.0
118527891.0,6,48,3168,24,1584,5153386.565217392,66.0,66.0,24,1584,5139928.869565218,66.0,66.0
88397.0,6,14,4740,7,653,14316.5,249.0,93.28571428571428,7,4087,14286.166666666666,1514.0,583.8571428571429
281487.0,17,2,363,1,79,0.0,79.0,79.0,1,284,0.0,284.0,284.0
298838.0,6,6,412,4,272,99612.66666666669,74.0,68.0,2,140,0.0,74.0,70.0
10865832.0,6,8,544,4,272,3576722.6666666665,74.0,68.0,4,272,3576660.6666666665,74.0,68.0
111322836.0,6,30,1974,15,1026,7937029.285714285,123.0,68.4,15,948,7937031.285714285,123.0,63.2
25828.0,6,10,2032,5,524,6003.25,252.0,104.8,5,1508,5895.75,1236.0,301.6
326.0,17,2,160,1,80,0.0,80.0,80.0,1,80,0.0,80.0,80.0
318953.0,17,4,1400,4,1400,106317.66666666669,350.0,350.0,0,0,0.0,0.0,0.0
90059142.0,17,28,13364,28,13364,3335523.777777778,501.0,477.2857142857143,0,0,0.0,0.0,0.0
317197.0,17,4,1400,4,1400,105732.33333333331,350.0,350.0,0,0,0.0,0.0,0.0
109110736.0,6,32,2236,16,1165,7274049.066666666,139.0,72.8125,16,1071,7260357.533333333,123.0,66.9375
205728.0,17,2,180,1,90,0.0,90.0,90.0,1,90,0.0,90.0,90.0
303680.0,6,2,132,1,66,0.0,66.0,66.0,1,66,0.0,66.0,66.0
94334186.0,6,387,49098,194,36138,488778.1658031088,374.0,186.278350515464,193,12960,490097.6822916667,140.0,67.15025906735751
297760.0,6,6,412,4,272,99253.33333333331,74.0,68.0,2,140,0.0,74.0,70.0
308220.0,6,6,412,4,272,102740.0,74.0,68.0,2,140,0.0,74.0,70.0
119269933.0,6,27,2032,15,1138,8519280.92857143,95.0,75.86666666666666,12,894,10652538.363636363,95.0,74.5
17987.0,6,14,4740,7,653,2581.0,249.0,93.28571428571428,7,4087,2831.0,1514.0,583.8571428571429
234213.0,6,3,337,2,214,0.0,160.0,107.0,1,123,0.0,123.0,123.0
38609.0,6,14,4740,7,653,6080.5,249.0,93.28571428571428,7,4087,5982.0,1514.0,583.8571428571429
30021.0,6,14,4740,7,653,4874.166666666667,249.0,93.28571428571428,7,4087,4869.166666666667,1514.0,583.8571428571429
210234.0,6,3,426,2,280,0.0,214.0,140.0,1,146,0.0,146.0,146.0
90255659.0,6,13,2036,8,1016,12893665.57142857,188.0,127.0,5,1020,22522243.75,204.0,204.0
54367.0,6,14,4740,7,653,8400.166666666666,249.0,93.28571428571428,7,4087,8234.333333333334,1514.0,583.8571428571429
5624850.0,6,4,270,2,134,0.0,68.0,67.0,2,136,0.0,70.0,68.0
205947.0,17,2,180,1,90,0.0,90.0,90.0,1,90,0.0,90.0,90.0
298437.0,6,6,412,4,272,99479.0,74.0,68.0,2,140,0.0,74.0,70.0
144062.0,17,2,180,1,90,0.0,90.0,90.0,1,90,0.0,90.0,90.0
2139.0,17,2,180,1,90,0.0,90.0,90.0,1,90,0.0,90.0,90.0
143322.0,6,2,132,1,66,0.0,66.0,66.0,1,66,0.0,66.0,66.0
1182869.0,6,13,3013,8,2385,168981.2857142857,1514.0,298.125,5,628,227557.0,331.0,125.6
135135038.0,17,6,1206,6,1206,27027007.6,201.0,201.0,0,0,0.0,0.0,0.0
153484.0,17,2,180,1,90,0.0,90.0,90.0,1,90,0.0,90.0,90.0
102853.0,17,2,286,2,286,0.0,143.0,143.0,0,0,0.0,0.0,0.0
97058232.0,6,167,18876,84,5766,1169376.2891566264,140.0,68.64285714285714,83,13110,1158292.024390244,300.0,157.95180722891567
284263.0,17,2,363,1,79,0.0,79.0,79.0,1,284,0.0,284.0,284.0
324.0,17,2,208,1,72,0.0,72.0,72.0,1,136,0.0,136.0,136.0
107069.0,17,3,1143,3,1143,53534.5,381.0,381.0,0,0,0.0,0.0,0.0
24644.0,6,14,4740,7,653,2944.833333333333,249.0,93.28571428571428,7,4087,3907.1666666666665,1514.0,583.8571428571429
90252663.0,6,14,2240,8,1016,12893237.57142857,188.0,127.0,6,1224,18018343.6,204.0,204.0
197106.0,17,2,180,1,90,0.0,90.0,90.0,1,90,0.0,90.0,90.0
844048.0,6,9,1268,6,797,168809.6,459.0,132.83333333333334,3,471,285738.0,331.0,157.0
50882.0,6,2,132,1,66,0.0,66.0,66.0,1,66,0.0,66.0,66.0
92880433.0,6,38,2508,19,1254,5160006.0,66.0,66.0,19,1254,5160010.055555556,66.0,66.0
205807.0,17,2,180,1,90,0.0,90.0,90.0,1,90,0.0,90.0,90.0
71921.0,6,13,1428,7,797,11740.833333333334,253.0,113.85714285714286,6,631,13584.4,293.0,105.16666666666669
2450.0,17,4,344,2,150,0.0,75.0,75.0,2,194,0.0,103.0,97.0
662594.0,6,2,132,1,66,0.0,66.0,66.0,1,66,0.0,66.0,66.0
329487.0,6,6,412,4,272,109829.0,74.0,68.0,2,140,0.0,74.0,70.0
24091150.0,17,5,1718,4,1368,825811.0,342.0,342.0,1,350,0.0,350.0,350.0
2355911.0,6,49,23728,25,19797,98162.95833333331,1514.0,791.88,24,3931,92733.47826086955,1514.0,163.79166666666666
297781.0,6,6,412,4,272,99260.33333333331,74.0,68.0,2,140,0.0,74.0,70.0
4064827.0,6,200,168088,116,158242,35346.321739130435,1510.0,1364.155172413793,84,9846,45366.90361445784,1510.0,117.21428571428572
10002893.0,6,13,1974,13,1974,833574.4166666666,160.0,151.84615384615384,0,0,0.0,0.0,0.0
361.0,17,2,174,1,79,0.0,79.0,79.0,1,95,0.0,95.0,95.0
30246.0,6,14,4740,7,653,4915.666666666667,249.0,93.28571428571428,7,4087,4908.5,1514.0,583.8571428571429
250427.0,6,3,337,2,214,0.0,160.0,107.0,1,123,0.0,123.0,123.0
322.0,17,2,174,1,79,0.0,79.0,79.0,1,95,0.0,95.0,95.0
2097.0,17,4,344,2,150,0.0,75.0,75.0,2,194,0.0,103.0,97.0
920705.0,6,12,2714,7,742,153450.83333333334,338.0,106.0,5,1972,161254.25,1514.0,394.4
107050.0,17,2,286,2,286,0.0,143.0,143.0,0,0,0.0,0.0,0.0
147486.0,6,3,337,2,214,0.0,160.0,107.0,1,123,0.0,123.0,123.0
45666.0,6,10,2032,5,524,10460.0,252.0,104.8,5,1508,8685.0,1236.0,301.6
12167.0,6,11,2098,6,590,2070.6,252.0,98.33333333333331,5,1508,2695.0,1236.0,301.6
2285.0,17,4,344,2,150,0.0,75.0,75.0,2,194,0.0,103.0,97.0
108099896.0,17,5,955,5,955,27024974.0,191.0,191.0,0,0,0.0,0.0,0.0
216874.0,6,3,426,2,280,0.0,214.0,140.0,1,146,0.0,146.0,146.0
120188944.0,6,222,25106,111,7622,1085299.3909090909,140.0,68.66666666666667,111,17484,1085129.481818182,284.0,157.51351351351352
211812.0,17,2,180,1,90,0.0,90.0,90.0,1,90,0.0,90.0,90.0
18553.0,6,10,2032,5,524,4058.0,252.0,104.8,5,1508,4310.0,1236.0,301.6
312430.0,17,4,1400,4,1400,104143.33333333331,350.0,350.0,0,0,0.0,0.0,0.0
102326.0,17,2,286,2,286,0.0,143.0,143.0,0,0,0.0,0.0,0.0
233493.0,6,3,337,2,214,0.0,160.0,107.0,1,123,0.0,123.0,123.0
68891.0,6,14,4740,7,653,10901.166666666666,249.0,93.28571428571428,7,4087,10935.166666666666,1514.0,583.8571428571429
7318.0,17,2,180,1,90,0.0,90.0,90.0,1,90,0.0,90.0,90.0
90309217.0,6,20,1490,10,704,10029340.111111112,95.0,70.4,10,786,10033427.666666666,95.0,78.6
196982.0,17,2,180,1,90,0.0,90.0,90.0,1,90,0.0,90.0,90.0
108101580.0,17,5,1005,5,1005,27025395.0,201.0,201.0,0,0,0.0,0.0,0.0
13824899.0,17,6,2052,6,2052,2764979.8,342.0,342.0,0,0,0.0,0.0,0.0
4806014.0,6,5,336,2,134,0.0,68.0,67.0,3,202,1526004.0,70.0,67.33333333333333
54303.0,6,10,2032,5,524,12052.75,252.0,104.8,5,1508,11855.5,1236.0,301.6
108110710.0,17,5,1005,5,1005,27027677.5,201.0,201.0,0,0,0.0,0.0,0.0
50997.0,17,2,180,1,90,0.0,90.0,90.0,1,90,0.0,90.0,90.0
123016434.0,17,15,907,8,475,17573776.285714287,174.0,59.375,7,432,17166892.5,174.0,61.71428571428572
36286.0,6,14,4740,7,653,5459.333333333333,249.0,93.28571428571428,7,4087,5585.166666666667,1514.0,583.8571428571429
54384.0,6,10,2032,5,524,12659.25,252.0,104.8,5,1508,11377.5,1236.0,301.6
107836394.0,6,762,156664,389,131602,277373.8608247423,1514.0,338.3084832904884,373,25062,289303.7284946237,214.0,67.19034852546918
115410123.0,6,48,3168,24,1584,5017831.434782608,66.0,66.0,24,1584,5004732.521739131,66.0,66.0
197920.0,17,4,6056,4,6056,65973.33333333333,1514.0,1514.0,0,0,0.0,0.0,0.0
49125.0,6,14,4740,7,653,8078.666666666667,249.0,93.28571428571428,7,4087,7535.833333333333,1514.0,583.8571428571429
150454.0,6,10,2032,5,524,33908.0,252.0,104.8,5,1508,37011.5,1236.0,301.6
73709.0,6,14,4740,7,653,12158.333333333334,249.0,93.28571428571428,7,4087,11718.5,1514.0,583.8571428571429
207646.0,6,3,426,2,280,0.0,214.0,140.0,1,146,0.0,146.0,146.0
147214.0,6,3,373,2,238,0.0,172.0,119.0,1,135,0.0,135.0,135.0
123250469.0,6,49,3234,25,1650,5135436.208333333,66.0,66.0,24,1584,5091191.043478261,66.0,66.0
99841.0,17,2,762,2,762,0.0,381.0,381.0,0,0,0.0,0.0,0.0
144062.0,17,2,180,1,90,0.0,90.0,90.0,1,90,0.0,90.0,90.0
209861.0,17,2,180,1,90,0.0,90.0,90.0,1,90,0.0,90.0,90.0
42464.0,6,14,4740,7,653,6956.0,249.0,93.28571428571428,7,4087,6061.166666666667,1514.0,583.8571428571429
35349.0,6,10,2032,5,524,7361.0,252.0,104.8,5,1508,8274.75,1236.0,301.6
17896.0,6,10,2032,5,524,3053.5,252.0,104.8,5,1508,3534.0,1236.0,301.6
108108840.0,17,5,1005,5,1005,27027210.0,201.0,201.0,0,0,0.0,0.0,0.0
478784.0,6,3,204,1,68,0.0,68.0,68.0,2,136,0.0,70.0,68.0
317651.0,6,6,412,4,272,105883.66666666669,74.0,68.0,2,140,0.0,74.0,70.0
2588861.0,6,2,132,1,66,0.0,66.0,66.0,1,66,0.0,66.0,66.0
102664.0,17,2,286,2,286,0.0,143.0,143.0,0,0,0.0,0.0,0.0
100797963.0,17,12,516,6,258,20000166.2,43.0,43.0,6,258,20004399.2,43.0,43.0
348723.0,6,10,1221,6,636,69744.6,298.0,106.0,4,585,110879.0,379.0,146.25
293158.0,17,2,363,1,79,0.0,79.0,79.0,1,284,0.0,284.0,284.0
113519888.0,6,46,3036,23,1518,5159983.5,66.0,66.0,23,1518,5159980.863636363,66.0,66.0
308365.0,6,6,412,4,272,102788.33333333331,74.0,68.0,2,140,0.0,74.0,70.0
108111119.0,17,5,1005,5,1005,27027779.75,201.0,201.0,0,0,0.0,0.0,0.0
2809.0,17,4,344,2,150,0.0,75.0,75.0,2,194,0.0,103.0,97.0
108123081.0,17,5,955,5,955,27030770.25,191.0,191.0,0,0,0.0,0.0,0.0
50946.0,17,2,180,1,90,0.0,90.0,90.0,1,90,0.0,90.0,90.0
135131481.0,17,6,1146,6,1146,27026296.2,191.0,191.0,0,0,0.0,0.0,0.0
203261.0,17,2,180,1,90,0.0,90.0,90.0,1,90,0.0,90.0,90.0
118875877.0,6,35,2526,18,1332,6979998.0,123.0,74.0,17,1194,7416250.625,123.0,70.23529411764706
2135.0,17,4,344,2,150,0.0,75.0,75.0,2,194,0.0,103.0,97.0
92165546.0,6,21,1711,11,799,9216554.6,95.0,72.63636363636364,10,912,10211502.888888888,221.0,91.2
120186244.0,6,376,65936,185,12580,648708.0,214.0,68.0,191,53356,628276.1842105263,1514.0,279.35078534031413
135128834.0,17,6,1146,6,1146,27025766.8,191.0,191.0,0,0,0.0,0.0,0.0
90254371.0,6,13,2036,8,1016,12893481.57142857,188.0,127.0,5,1020,22523111.25,204.0,204.0
115268532.0,6,48,3168,24,1584,5011675.304347826,66.0,66.0,24,1584,5002278.260869565,66.0,66.0
300106.0,6,6,412,4,272,100035.33333333331,74.0,68.0,2,140,0.0,74.0,70.0
148134.0,17,2,180,1,90,0.0,90.0,90.0,1,90,0.0,90.0,90.0
123863.0,6,11,2098,6,590,24586.6,252.0,98.33333333333331,5,1508,30454.75,1236.0,301.6
323.0,17,2,174,1,79,0.0,79.0,79.0,1,95,0.0,95.0,95.0
19277837.0,6,26,7627,14,3735,198254.0,1514.0,266.7857142857143,12,3892,1732909.181818182,1514.0,324.3333333333333
90035905.0,17,28,13364,28,13364,3334663.1481481483,501.0,477.2857142857143,0,0,0.0,0.0,0.0
297240.0,6,6,412,4,272,99080.0,74.0,68.0,2,140,0.0,74.0,70.0
17429.0,6,10,2032,5,524,3962.0,252.0,104.8,5,1508,3981.25,1236.0,301.6
213680.0,17,2,180,1,90,0.0,90.0,90.0,1,90,0.0,90.0,90.0
1028787.0,6,11,1134,6,558,205757.4,220.0,93.0,5,576,255739.0,304.0,115.2
135150663.0,17,6,1146,6,1146,27030132.6,191.0,191.0,0,0,0.0,0.0,0.0
3467.0,17,2,346,1,78,0.0,78.0,78.0,1,268,0.0,268.0,268.0
2322392.0,6,26,7627,14,3735,178645.53846153847,1514.0,266.7857142857143,12,3892,188000.36363636365,1514.0,324.3333333333333
519902.0,6,3,204,1,68,0.0,68.0,68.0,2,136,0.0,70.0,68.0
153450.0,17,2,180,1,90,0.0,90.0,90.0,1,90,0.0,90.0,90.0
14638949.0,6,19,1551,9,919,1791862.75,315.0,102.11111111111111,10,632,1592722.0,78.0,63.2
135130340.0,17,6,1146,6,1146,27026068.0,191.0,191.0,0,0,0.0,0.0,0.0
109001055.0,17,13,821,7,432,18166842.5,174.0,61.71428571428572,6,389,17802021.0,174.0,64.83333333333333
108113447.0,17,5,955,5,955,27028361.75,191.0,191.0,0,0,0.0,0.0,0.0
308179.0,6,6,412,4,272,102726.33333333331,74.0,68.0,2,140,0.0,74.0,70.0
90255510.0,6,12,1832,8,1016,12893644.285714284,188.0,127.0,4,816,30029705.33333333,204.0,204.0
1467764.0,17,16,1120,16,1120,97850.93333333332,70.0,70.0,0,0,0.0,0.0,0.0
316421.0,17,4,1400,4,1400,105473.66666666669,350.0,350.0,0,0,0.0,0.0,0.0
64858.0,6,14,4740,7,653,9345.0,249.0,93.28571428571428,7,4087,10439.0,1514.0,583.8571428571429
108104508.0,17,5,955,5,955,27026127.0,191.0,191.0,0,0,0.0,0.0,0.0
119994791.0,6,18,1501,9,650,13510065.75,95.0,72.22222222222223,9,851,14969365.25,255.0,94.55555555555556
11858.0,17,2,582,1,83,0.0,83.0,83.0,1,499,0.0,499.0,499.0
3279720.0,6,18,1495,9,921,370944.375,315.0,102.33333333333331,9,574,370867.375,78.0,63.77777777777778
90297079.0,6,21,1585,11,840,9025671.5,95.0,76.36363636363636,10,745,9951014.333333334,95.0,74.5
1162995.0,6,13,1386,7,789,193832.5,253.0,112.71428571428572,6,597,227147.4,259.0,99.5
90003387.0,17,28,13364,28,13364,3333458.777777778,501.0,477.2857142857143,0,0,0.0,0.0,0.0
10921507.0,6,8,544,4,272,3595077.6666666665,74.0,68.0,4,272,3595011.333333333,74.0,68.0
2327.0,17,4,344,2,150,0.0,75.0,75.0,2,194,0.0,103.0,97.0
4176.0,17,4,704,2,148,0.0,74.0,74.0,2,556,0.0,280.0,278.0
103712967.0,6,29,2052,15,1089,7392637.071428572,123.0,72.6,14,963,7961302.846153846,123.0,68.78571428571429
38636.0,6,14,4740,7,653,6274.833333333333,249.0,93.28571428571428,7,4087,5978.0,1514.0,583.8571428571429
2591657.0,6,2,132,1,66,0.0,66.0,66.0,1,66,0.0,66.0,66.0
20565.0,6,10,2032,5,524,3921.25,252.0,104.8,5,1508,4675.0,1236.0,301.6
123225301.0,6,31,2182,15,1017,8088575.0,123.0,67.8,16,1165,7549325.6,139.0,72.8125
209781.0,17,2,180,1,90,0.0,90.0,90.0,1,90,0.0,90.0,90.0
204242.0,6,10,1221,6,636,40848.4,298.0,106.0,4,585,67093.33333333333,379.0,146.25
446170.0,6,11,1021,6,444,60482.6,162.0,74.0,5,577,75518.0,349.0,115.4
247233.0,17,2,180,1,90,0.0,90.0,90.0,1,90,0.0,90.0,90.0
2590043.0,6,2,132,1,66,0.0,66.0,66.0,1,66,0.0,66.0,66.0
2394877.0,6,2,132,1,66,0.0,66.0,66.0,1,66,0.0,66.0,66.0
38895.0,6,10,2032,5,524,9012.25,252.0,104.8,5,1508,9050.75,1236.0,301.6
1304305.0,17,7,490,7,490,217384.16666666663,70.0,70.0,0,0,0.0,0.0,0.0
437626.0,6,3,1604,2,851,0.0,785.0,425.5,1,753,0.0,753.0,753.0
307726.0,6,6,412,4,272,102575.33333333331,74.0,68.0,2,140,0.0,74.0,70.0
37968.0,6,14,4740,7,653,6207.833333333333,249.0,93.28571428571428,7,4087,5903.833333333333,1514.0,583.8571428571429
102342.0,17,2,286,2,286,0.0,143.0,143.0,0,0,0.0,0.0,0.0
307154.0,6,6,412,4,272,102384.66666666669,74.0,68.0,2,140,0.0,74.0,70.0
216446.0,17,2,180,1,90,0.0,90.0,90.0,1,90,0.0,90.0,90.0
2800688.0,6,2,132,1,66,0.0,66.0,66.0,1,66,0.0,66.0,66.0
90264078.0,6,13,2036,8,1016,12894868.285714284,188.0,127.0,5,1020,22524947.0,204.0,204.0
312731.0,17,4,1400,4,1400,104243.66666666669,350.0,350.0,0,0,0.0,0.0,0.0
90246333.0,6,17,2572,9,1204,11280791.625,188.0,133.77777777777777,8,1368,12869018.42857143,204.0,171.0
108104577.0,17,5,1005,5,1005,27026144.25,201.0,201.0,0,0,0.0,0.0,0.0
113171528.0,6,46,3036,23,1518,5144148.090909091,66.0,66.0,23,1518,5144149.409090909,66.0,66.0
102094.0,17,2,286,2,286,0.0,143.0,143.0,0,0,0.0,0.0,0.0
90023659.0,17,28,13364,28,13364,3334209.592592593,501.0,477.2857142857143,0,0,0.0,0.0,0.0
34531.0,6,14,4740,7,653,5562.666666666667,249.0,93.28571428571428,7,4087,5624.166666666667,1514.0,583.8571428571429
250277.00000000003,6,3,337,2,214,0.0,160.0,107.0,1,123,0.0,123.0,123.0
108109747.0,17,5,1005,5,1005,27027436.75,201.0,201.0,0,0,0.0,0.0,0.0
500463.0,6,5,336,2,134,0.0,68.0,67.0,3,202,192747.5,70.0,67.33333333333333
108716355.0,6,36,3004,20,1657,5710552.894736842,139.0,82.85,16,1347,7233368.8,123.0,84.1875
4022.000000000001,17,4,704,2,148,0.0,74.0,74.0,2,556,0.0,280.0,278.0
3199270.0,6,3,1777,2,951,0.0,885.0,475.5,1,826,0.0,826.0,826.0
28923.0,6,11,2098,6,590,4945.2,252.0,98.33333333333331,5,1508,6491.25,1236.0,301.6
766.0,17,4,438,2,148,0.0,74.0,74.0,2,290,0.0,147.0,145.0
124179747.0,6,35,2394,18,1269,7304691.0,123.0,70.5,17,1125,7123642.375,123.0,66.17647058823529
116305700.0,6,48,3168,24,1584,5056769.565217392,66.0,66.0,24,1584,5043095.043478261,66.0,66.0
317056.0,17,4,1524,4,1524,105685.33333333331,381.0,381.0,0,0,0.0,0.0,0.0
444034.0,6,10,967,5,390,74967.5,162.0,78.0,5,577,74882.75,349.0,115.4
307688.0,6,6,412,4,272,102562.66666666669,74.0,68.0,2,140,0.0,74.0,70.0
153435.0,17,2,180,1,90,0.0,90.0,90.0,1,90,0.0,90.0,90.0
73857.0,6,11,1131,6,600,14456.2,262.0,100.0,5,531,14272.5,259.0,106.2
319.0,17,2,174,1,79,0.0,79.0,79.0,1,95,0.0,95.0,95.0
242285.0,6,3,337,2,214,0.0,160.0,107.0,1,123,0.0,123.0,123.0
97916030.0,6,705,142738,347,23494,282994.3063583815,214.0,67.70605187319885,358,119244,273637.85154061625,1514.0,333.08379888268155
62390.0,6,13,1394,7,797,10398.333333333334,253.0,113.85714285714286,6,597,10193.4,259.0,99.5
145435.0,6,3,337,2,214,0.0,160.0,107.0,1,123,0.0,123.0,123.0
247185.0,17,4,6056,4,6056,82395.0,1514.0,1514.0,0,0,0.0,0.0,0.0
119586631.0,6,250,28176,125,19630,962661.7822580644,284.0,157.04,125,8546,962670.7338709678,140.0,68.368
90036772.0,17,27,12943,27,12943,3462952.769230769,501.0,479.3703703703704,0,0,0.0,0.0,0.0
597398.0,17,2,473,1,78,0.0,78.0,78.0,1,395,0.0,395.0,395.0
47108.0,6,14,4740,7,653,7737.5,249.0,93.28571428571428,7,4087,6745.333333333333,1514.0,583.8571428571429
90280457.0,6,16,1192,8,596,12891313.714285716,95.0,74.5,8,596,12896617.285714284,95.0,74.5
307725.0,6,6,412,4,272,102575.0,74.0,68.0,2,140,0.0,74.0,70.0
246551.0,6,3,337,2,214,0.0,160.0,107.0,1,123,0.0,123.0,123.0
90260628.0,6,12,1832,8,1016,12894375.42857143,188.0,127.0,4,816,30031099.666666668,204.0,204.0
128580.0,17,4,1524,4,1524,42860.0,381.0,381.0,0,0,0.0,0.0,0.0
120833354.0,6,228,25734,114,7820,1055929.442477876,140.0,68.59649122807018,114,17914,1062183.6548672563,284.0,157.140350877193
90036624.0,17,28,13364,28,13364,3334689.777777778,501.0,477.2857142857143,0,0,0.0,0.0,0.0
90037676.0,17,28,13364,28,13364,3334728.7407407407,501.0,477.2857142857143,0,0,0.0,0.0,0.0
206189.0,6,3,426,2,280,0.0,214.0,140.0,1,146,0.0,146.0,146.0
0.0,6,1,66,1,66,0.0,66.0,66.0,0,0,0.0,0.0,0.0
308.0,17,2,164,1,82,0.0,82.0,82.0,1,82,0.0,82.0,82.0
217783.0,6,3,426,2,280,0.0,214.0,140.0,1,146,0.0,146.0,146.0
247538.0,6,3,426,2,280,0.0,214.0,140.0,1,146,0.0,146.0,146.0
24331.0,6,10,2032,5,524,5868.0,252.0,104.8,5,1508,5849.0,1236.0,301.6
311697.0,17,4,1400,4,1400,103899.0,350.0,350.0,0,0,0.0,0.0,0.0
39737.0,6,14,4740,7,653,6473.166666666667,249.0,93.28571428571428,7,4087,6132.666666666667,1514.0,583.8571428571429
77627.0,6,19,7540,10,912,8180.555555555556,310.0,91.2,9,6628,9172.375,1514.0,736.4444444444445
147926.0,17,2,180,1,90,0.0,90.0,90.0,1,90,0.0,90.0,90.0
2390981.0,6,25,7573,14,3735,183921.6153846153,1514.0,266.7857142857143,11,3838,214322.1,1514.0,348.90909090909093
120055853.0,17,29,13785,29,13785,4287709.035714285,501.0,475.3448275862069,0,0,0.0,0.0,0.0
153425.0,17,2,180,1,90,0.0,90.0,90.0,1,90,0.0,90.0,90.0
130.0,17,2,508,2,508,0.0,257.0,254.0,0,0,0.0,0.0,0.0
258237.0,6,10,1221,6,636,51647.4,298.0,106.0,4,585,80361.0,379.0,146.25
418.0,17,2,168,1,76,0.0,76.0,76.0,1,92,0.0,92.0,92.0
792.0,17,4,438,2,148,0.0,74.0,74.0,2,290,0.0,147.0,145.0
207943.0,6,10,1221,6,636,41588.6,298.0,106.0,4,585,67851.33333333333,379.0,146.25
43579.0,6,10,2032,5,524,10032.25,252.0,104.8,5,1508,7727.25,1236.0,301.6
2581292.0,6,3,1604,1,753,0.0,753.0,753.0,2,851,0.0,785.0,425.5
286.0,17,2,174,1,79,0.0,79.0,79.0,1,95,0.0,95.0,95.0
2008.0,17,4,344,2,150,0.0,75.0,75.0,2,194,0.0,103.0,97.0
1020179.0,6,11,1134,6,558,204035.8,220.0,93.0,5,576,254626.25,304.0,115.2
247016.0,6,3,373,2,238,0.0,172.0,119.0,1,135,0.0,135.0,135.0
137548.0,17,2,176,1,80,0.0,80.0,80.0,1,96,0.0,96.0,96.0
143970.0,17,2,180,1,90,0.0,90.0,90.0,1,90,0.0,90.0,90.0
128865161.0,6,37,2794,20,1531,6782376.894736842,139.0,76.55,17,1263,7416471.125,123.0,74.29411764705883
153403.0,17,2,180,1,90,0.0,90.0,90.0,1,90,0.0,90.0,90.0
10529202.0,6,7,478,4,272,3462557.333333333,74.0,68.0,3,206,5193716.0,74.0,68.66666666666667
2804343.0,6,2,132,1,66,0.0,66.0,66.0,1,66,0.0,66.0,66.0
283595.0,17,2,363,1,79,0.0,79.0,79.0,1,284,0.0,284.0,284.0
34274.0,6,10,2032,5,524,6883.25,252.0,104.8,5,1508,6256.25,1236.0,301.6
120915067.0,6,35,2410,18,1285,7112651.0,139.0,71.38888888888889,17,1125,6919657.875,123.0,66.17647058823529
303924.0,6,6,412,4,272,101308.0,74.0,68.0,2,140,0.0,74.0,70.0
299137.0,6,6,412,4,272,99712.33333333331,74.0,68.0,2,140,0.0,74.0,70.0
228224.0,17,2,180,1,90,0.0,90.0,90.0,1,90,0.0,90.0,90.0
147896.0,17,2,176,1,80,0.0,80.0,80.0,1,96,0.0,96.0,96.0
2598537.0,6,2,132,1,66,0.0,66.0,66.0,1,66,0.0,66.0,66.0
216546.0,17,2,180,1,90,0.0,90.0,90.0,1,90,0.0,90.0,90.0
149658.0,17,2,180,1,90,0.0,90.0,90.0,1,90,0.0,90.0,90.0
317142.0,17,4,1400,4,1400,105714.0,350.0,350.0,0,0,0.0,0.0,0.0
24951.0,6,14,4740,7,653,4036.8333333333335,249.0,93.28571428571428,7,4087,4009.1666666666665,1514.0,583.8571428571429
37828.0,6,10,2032,5,524,8201.75,252.0,104.8,5,1508,6616.0,1236.0,301.6
14470.0,17,4,823,2,163,0.0,89.0,81.5,2,660,0.0,443.0,330.0
45143.0,6,10,2032,5,524,11064.5,252.0,104.8,5,1508,10015.0,1236.0,301.6
90040312.0,17,28,13364,28,13364,3334826.3703703703,501.0,477.2857142857143,0,0,0.0,0.0,0.0
5626894.0,6,5,336,2,134,0.0,68.0,67.0,3,202,1526872.5,70.0,67.33333333333333
2303.0,17,4,344,2,150,0.0,75.0,75.0,2,194,0.0,103.0,97.0
41851.0,6,14,4740,7,653,6772.333333333333,249.0,93.28571428571428,7,4087,6774.5,1514.0,583.8571428571429
233047.0,6,3,337,2,214,0.0,160.0,107.0,1,123,0.0,123.0,123.0
15249.0,6,10,2032,5,524,3052.75,252.0,104.8,5,1508,3536.75,1236.0,301.6
124007345.0,17,15,1169,8,606,17715335.0,174.0,75.75,7,563,17333487.666666668,174.0,80.42857142857143
1066029.0,6,4,270,3,202,533014.5,70.0,67.33333333333333,1,68,0.0,68.0,68.0
106590.0,17,2,762,2,762,0.0,381.0,381.0,0,0,0.0,0.0,0.0
329.0,17,2,166,1,75,0.0,75.0,75.0,1,91,0.0,91.0,91.0
297443.0,6,6,412,4,272,99147.66666666669,74.0,68.0,2,140,0.0,74.0,70.0
120000055.0,6,17,1246,9,650,15000006.875,95.0,72.22222222222223,8,596,12852977.0,95.0,74.5
349.0,17,2,267,1,83,0.0,83.0,83.0,1,184,0.0,184.0,184.0
121236798.0,6,236,26656,118,8096,1021453.811965812,140.0,68.61016949152543,118,18560,1029186.9316239316,284.0,157.28813559322035
104067.0,17,2,700,2,700,0.0,350.0,350.0,0,0,0.0,0.0,0.0
135141170.0,17,6,1146,6,1146,27028234.0,191.0,191.0,0,0,0.0,0.0,0.0
196944.0,17,2,180,1,90,0.0,90.0,90.0,1,90,0.0,90.0,90.0
197864.0,17,2,180,1,90,0.0,90.0,90.0,1,90,0.0,90.0,90.0
1219706.0,6,13,3006,8,2378,174243.7142857143,1514.0,297.25,5,628,235984.75,331.0,125.6
1985.0,17,4,344,2,150,0.0,75.0,75.0,2,194,0.0,103.0,97.0
461207.0,17,6,2100,6,2100,92241.4,350.0,350.0,0,0,0.0,0.0,0.0
43785.0,6,10,2032,5,524,10573.0,252.0,104.8,5,1508,8638.75,1236.0,301.6
36970.0,6,14,4740,7,653,4854.833333333333,249.0,93.28571428571428,7,4087,6025.833333333333,1514.0,583.8571428571429
120416144.0,6,235,26594,118,18576,1029197.811965812,284.0,157.42372881355934,117,8018,1029236.2672413794,140.0,68.52991452991454
10456018.0,6,7,478,4,272,3439799.0,74.0,68.0,3,206,5159566.5,74.0,68.66666666666667
492632.0,6,5,336,2,134,0.0,68.0,67.0,3,202,193362.5,70.0,67.33333333333333
14390062.0,17,6,2052,6,2052,2878012.4,342.0,342.0,0,0,0.0,0.0,0.0
90956790.0,6,21,1585,11,840,9094968.3,95.0,76.36363636363636,10,745,10105428.555555556,95.0,74.5
196832.0,17,2,180,1,90,0.0,90.0,90.0,1,90,0.0,90.0,90.0
223439.0,6,3,426,2,280,0.0,214.0,140.0,1,146,0.0,146.0,146.0
316471.0,6,12,1373,7,714,52745.16666666666,298.0,102.0,5,659,78293.5,379.0,131.8
90305584.0,6,16,1192,8,596,12894602.714285716,95.0,74.5,8,596,12899022.285714284,95.0,74.5
1978.0,17,2,180,1,90,0.0,90.0,90.0,1,90,0.0,90.0,90.0
370805.0,17,4,1400,4,1400,123601.66666666669,350.0,350.0,0,0,0.0,0.0,0.0
43686.0,6,14,4740,7,653,7150.833333333333,249.0,93.28571428571428,7,4087,6127.666666666667,1514.0,583.8571428571429
281645.0,17,2,363,1,79,0.0,79.0,79.0,1,284,0.0,284.0,284.0
2784720.0,6,11,2106,6,598,556770.2,252.0,99.66666666666669,5,1508,2532.5,1236.0,301.6
108105502.0,17,5,1005,5,1005,27026375.5,201.0,201.0,0,0,0.0,0.0,0.0
94496733.0,6,40,2640,20,1320,4973512.263157895,66.0,66.0,20,1320,4957210.842105263,66.0,66.0
232929.0,6,3,337,2,214,0.0,160.0,107.0,1,123,0.0,123.0,123.0
2764.0,17,2,762,2,762,0.0,381.0,381.0,0,0,0.0,0.0,0.0
91432428.0,6,24,1829,13,989,7618742.166666667,95.0,76.07692307692308,11,840,9142076.5,95.0,76.36363636363636
619.0,17,2,508,2,508,0.0,257.0,254.0,0,0,0.0,0.0,0.0
90305062.0,6,21,1585,11,840,9026032.4,95.0,76.36363636363636,10,745,9998563.888888888,95.0,74.5
2389.0,17,4,344,2,150,0.0,75.0,75.0,2,194,0.0,103.0,97.0
2463062.0,6,25,7573,14,3735,189466.3076923077,1514.0,266.7857142857143,11,3838,220674.0,1514.0,348.90909090909093
743923.0,6,10,1065,5,534,185232.0,262.0,106.8,5,531,185558.0,259.0,106.2
15552.0,6,14,4740,7,653,2276.1666666666665,249.0,93.28571428571428,7,4087,2416.5,1514.0,583.8571428571429
108087862.0,17,5,955,5,955,27021965.5,191.0,191.0,0,0,0.0,0.0,0.0
233007.0,6,3,337,2,214,0.0,160.0,107.0,1,123,0.0,123.0,123.0
153492.0,17,2,180,1,90,0.0,90.0,90.0,1,90,0.0,90.0,90.0
120000193.0,6,20,1531,11,840,12000019.3,95.0,76.36363636363636,9,691,11283319.0,95.0,76.77777777777777
119752884.0,17,14,864,7,432,19834390.83333333,174.0,61.71428571428572,7,432,19833481.83333333,174.0,61.71428571428572
301915.0,6,3,202,2,128,0.0,74.0,64.0,1,74,0.0,74.0,74.0
121439.0,6,3,337,2,214,0.0,160.0,107.0,1,123,0.0,123.0,123.0
1306925.0,6,4,264,2,132,0.0,66.0,66.0,2,132,0.0,66.0,66.0
208882.0,17,2,762,2,762,0.0,381.0,381.0,0,0,0.0,0.0,0.0
205354.0,17,2,762,2,762,0.0,381.0,381.0,0,0,0.0,0.0,0.0
307656.0,6,6,412,4,272,102552.0,74.0,68.0,2,140,0.0,74.0,70.0
143438.0,6,2,132,1,66,0.0,66.0,66.0,1,66,0.0,66.0,66.0
120287291.0,6,226,25566,113,7680,1066635.5625,140.0,67.96460176991151,113,17886,1066701.0267857143,284.0,158.28318584070797
122046.0,6,3,373,2,238,0.0,172.0,119.0,1,135,0.0,135.0,135.0
272025.0,6,10,1221,6,636,54405.0,298.0,106.0,4,585,84776.0,379.0,146.25
276399.0,17,4,6056,4,6056,92133.0,1514.0,1514.0,0,0,0.0,0.0,0.0
21495.0,6,10,1066,5,490,4537.5,218.0,98.0,5,576,5169.0,304.0,115.2
222807.0,6,3,426,2,280,0.0,214.0,140.0,1,146,0.0,146.0,146.0
2503.0,17,2,508,2,508,0.0,257.0,254.0,0,0,0.0,0.0,0.0
135134552.0,17,6,1146,6,1146,27026910.4,191.0,191.0,0,0,0.0,0.0,0.0
114341122.0,6,31,2166,16,1149,7609083.2,123.0,71.8125,15,1017,8152613.714285715,123.0,67.8
106088.0,17,2,762,2,762,0.0,381.0,381.0,0,0,0.0,0.0,0.0
48627049.0,6,8,1940,3,887,22853673.0,753.0,295.6666666666667,5,1053,11514848.5,785.0,210.6
111809.0,6,15,4806,8,719,15869.285714285714,249.0,89.875,7,4087,18401.83333333333,1514.0,583.8571428571429
4372.0,17,2,180,1,90,0.0,90.0,90.0,1,90,0.0,90.0,90.0
875052.0,6,9,1269,6,798,175010.4,460.0,133.0,3,471,299676.5,331.0,157.0
59547.0,6,12,1328,7,797,9924.5,253.0,113.85714285714286,5,531,11532.0,259.0,106.2
90256762.0,6,12,1832,8,1016,12893823.142857144,188.0,127.0,4,816,30030615.33333333,204.0,204.0
14643346.0,6,20,1607,10,975,1592972.3333333333,315.0,97.5,10,632,1592944.4444444445,78.0,63.2
207452.0,6,3,426,2,280,0.0,214.0,140.0,1,146,0.0,146.0,146.0
108107875.0,17,5,955,5,955,27026968.75,191.0,191.0,0,0,0.0,0.0,0.0
54591.0,6,14,4740,7,653,8249.5,249.0,93.28571428571428,7,4087,6867.833333333333,1514.0,583.8571428571429
123001244.0,17,15,907,8,475,17571606.285714287,174.0,59.375,7,432,17129362.5,174.0,61.71428571428572
320452.0,17,4,1400,4,1400,106817.33333333331,350.0,350.0,0,0,0.0,0.0,0.0
205938.0,17,2,762,2,762,0.0,381.0,381.0,0,0,0.0,0.0,0.0
117575932.0,6,30,1990,15,1042,8383636.285714285,139.0,69.46666666666667,15,948,8383642.285714285,123.0,63.2
35858.0,6,14,4740,7,653,4899.333333333333,249.0,93.28571428571428,7,4087,5836.833333333333,1514.0,583.8571428571429
90027509.0,17,28,13364,28,13364,3334352.185185185,501.0,477.2857142857143,0,0,0.0,0.0,0.0
2099.0,17,4,344,2,150,0.0,75.0,75.0,2,194,0.0,103.0,97.0
113613422.0,6,48,3168,24,1584,4937655.217391305,66.0,66.0,24,1584,4933025.0,66.0,66.0
23189.0,6,14,4740,7,653,3242.333333333333,249.0,93.28571428571428,7,4087,3463.333333333333,1514.0,583.8571428571429
5004109.0,17,4,496,2,168,0.0,84.0,84.0,2,328,0.0,164.0,164.0
119963417.0,6,14,2102,6,1086,18074004.0,204.0,181.0,8,1016,17136829.0,188.0,127.0
90022510.0,17,27,12943,27,12943,3462404.230769231,501.0,479.3703703703704,0,0,0.0,0.0,0.0
168409.0,6,15,4806,8,719,23951.28571428572,249.0,89.875,7,4087,27241.5,1514.0,583.8571428571429
330.0,17,2,160,1,80,0.0,80.0,80.0,1,80,0.0,80.0,80.0
108095597.0,17,5,955,5,955,27023899.25,191.0,191.0,0,0,0.0,0.0,0.0
117723476.0,6,34,2350,17,1225,7344939.625,139.0,72.05882352941177,17,1125,7344941.6875,123.0,66.17647058823529
240678.0,6,3,373,2,238,0.0,172.0,119.0,1,135,0.0,135.0,135.0
297585.0,6,6,412,4,272,99195.0,74.0,68.0,2,140,0.0,74.0,70.0
111598603.0,17,16,1212,8,606,15857297.285714284,174.0,75.75,8,606,15858202.142857144,174.0,75.75
1167071.0,6,13,3020,8,2392,166724.42857142858,1514.0,299.0,5,628,222814.25,331.0,125.6
121414.0,6,3,337,2,214,0.0,160.0,107.0,1,123,0.0,123.0,123.0
1490499.0,6,19,7533,10,1403,165611.0,583.0,140.3,9,6130,154140.375,1484.0,681.1111111111111
317555.0,17,4,1400,4,1400,105851.66666666669,350.0,350.0,0,0,0.0,0.0,0.0
110139.0,17,4,1400,4,1400,36713.0,350.0,350.0,0,0,0.0,0.0,0.0
90533857.0,6,13,2036,8,1016,12933408.142857144,188.0,127.0,5,1020,22588419.0,204.0,204.0
1480.0,17,5,550,5,550,370.0,110.0,110.0,0,0,0.0,0.0,0.0
120210193.0,6,350,41828,175,11846,686132.5459770114,140.0,67.69142857142857,175,29982,686181.4137931034,390.0,171.3257142857143
102875.0,17,2,700,2,700,0.0,350.0,350.0,0,0,0.0,0.0,0.0
82424.0,6,13,1386,7,789,13737.333333333334,253.0,112.71428571428572,6,597,15132.8,259.0,99.5
196974.0,17,2,180,1,90,0.0,90.0,90.0,1,90,0.0,90.0,90.0
196815.0,17,2,180,1,90,0.0,90.0,90.0,1,90,0.0,90.0,90.0
5181788.0,6,5,336,2,134,0.0,68.0,67.0,3,202,1525875.5,70.0,67.33333333333333
35517.0,6,14,4740,7,653,5757.5,249.0,93.28571428571428,7,4087,5552.5,1514.0,583.8571428571429
307636.0,6,6,412,4,272,102545.33333333331,74.0,68.0,2,140,0.0,74.0,70.0
184384.0,17,2,180,1,90,0.0,90.0,90.0,1,90,0.0,90.0,90.0
17808.0,6,14,4740,7,653,2496.5,249.0,93.28571428571428,7,4087,2825.6666666666665,1514.0,583.8571428571429
58627.0,6,14,4740,7,653,9574.833333333334,249.0,93.28571428571428,7,4087,9477.166666666666,1514.0,583.8571428571429
90254232.0,6,13,1898,8,1016,12893461.714285716,188.0,127.0,5,882,22523228.0,204.0,176.4
1033133.0,6,11,1134,6,558,206626.60000000003,220.0,93.0,5,576,256412.25,304.0,115.2
102868.0,17,2,286,2,286,0.0,143.0,143.0,0,0,0.0,0.0,0.0
20788.0,17,2,582,1,83,0.0,83.0,83.0,1,499,0.0,499.0,499.0
577933.0,6,3,198,2,132,0.0,66.0,66.0,1,66,0.0,66.0,66.0
103072.0,17,2,286,2,286,0.0,143.0,143.0,0,0,0.0,0.0,0.0
5622523.0,6,5,336,2,134,0.0,68.0,67.0,3,202,1421738.0,70.0,67.33333333333333
39785.0,6,10,2032,5,524,9662.5,252.0,104.8,5,1508,8361.25,1236.0,301.6
90279950.0,6,16,2368,9,1204,11284993.75,188.0,133.77777777777777,7,1164,15019240.0,204.0,166.28571428571428
49680435.0,6,8,2113,3,960,23513125.0,826.0,320.0,5,1153,11724376.0,885.0,230.6
135134161.0,17,6,1206,6,1206,27026832.2,201.0,201.0,0,0,0.0,0.0,0.0
10482128.0,6,7,478,4,272,3448595.333333333,74.0,68.0,3,206,5172786.5,74.0,68.66666666666667
301643.0,6,6,412,4,272,100547.66666666669,74.0,68.0,2,140,0.0,74.0,70.0
120191871.0,6,248,28066,124,8480,970483.4471544717,140.0,68.38709677419355,124,19586,970559.951219512,284.0,157.9516129032258
209026.0,6,3,426,2,280,0.0,214.0,140.0,1,146,0.0,146.0,146.0
118718667.0,6,48,3168,24,1584,5161681.173913044,66.0,66.0,24,1584,5148408.304347826,66.0,66.0
306932.0,6,6,412,4,272,102310.66666666669,74.0,68.0,2,140,0.0,74.0,70.0
232336.0,6,3,337,2,214,0.0,160.0,107.0,1,123,0.0,123.0,123.0
1470849.0,17,2,664,1,322,0.0,322.0,322.0,1,342,0.0,342.0,342.0
27044059.0,17,5,1710,5,1710,6761014.75,342.0,342.0,0,0,0.0,0.0,0.0
210761.0,6,3,426,2,280,0.0,214.0,140.0,1,146,0.0,146.0,146.0
108103366.0,17,5,955,5,955,27025841.5,191.0,191.0,0,0,0.0,0.0,0.0
230884.0,6,13,1386,7,789,38480.66666666666,253.0,112.71428571428572,6,597,43916.2,259.0,99.5
53541.0,6,10,2032,5,524,13002.75,252.0,104.8,5,1508,12120.5,1236.0,301.6
105340.0,17,2,700,2,700,0.0,350.0,350.0,0,0,0.0,0.0,0.0
135125630.0,17,6,1146,6,1146,27025126.0,191.0,191.0,0,0,0.0,0.0,0.0
121285.0,6,3,337,2,214,0.0,160.0,107.0,1,123,0.0,123.0,123.0
839700.0,6,9,1118,6,586,167940.0,248.0,97.66666666666669,3,532,282110.0,392.0,177.33333333333334
33774.0,6,14,4740,7,653,5322.5,249.0,93.28571428571428,7,4087,4971.0,1514.0,583.8571428571429
0.0,17,1,350,1,350,0.0,350.0,350.0,0,0,0.0,0.0,0.0
56315.0,6,14,4740,7,653,7638.333333333333,249.0,93.28571428571428,7,4087,8271.166666666666,1514.0,583.8571428571429
34545.0,6,14,4740,7,653,5584.333333333333,249.0,93.28571428571428,7,4087,5580.5,1514.0,583.8571428571429
120276625.0,6,19,1477,9,732,15034578.125,95.0,81.33333333333333,10,745,13305174.888888888,95.0,74.5
143839.0,17,2,180,1,90,0.0,90.0,90.0,1,90,0.0,90.0,90.0
584442.0,6,3,198,2,132,0.0,66.0,66.0,1,66,0.0,66.0,66.0
4563.0,17,2,602,1,72,0.0,72.0,72.0,1,530,0.0,530.0,530.0
99861586.0,6,178,20078,89,6170,1134790.75,140.0,69.32584269662921,89,13908,1132249.5227272727,284.0,156.26966292134833
63757.99999999999,6,14,4740,7,653,10504.166666666666,249.0,93.28571428571428,7,4087,9982.666666666666,1514.0,583.8571428571429
122802706.0,17,14,864,7,432,19957174.166666668,174.0,61.71428571428572,7,432,17208436.166666668,174.0,61.71428571428572
190852.0,17,2,180,1,90,0.0,90.0,90.0,1,90,0.0,90.0,90.0
341.0,17,2,160,1,80,0.0,80.0,80.0,1,80,0.0,80.0,80.0
354.0,17,2,267,1,83,0.0,83.0,83.0,1,184,0.0,184.0,184.0
193351.0,17,2,180,1,90,0.0,90.0,90.0,1,90,0.0,90.0,90.0
90035695.0,17,28,13364,28,13364,3334655.3703703703,501.0,477.2857142857143,0,0,0.0,0.0,0.0
404.0,17,2,410,1,78,0.0,78.0,78.0,1,332,0.0,332.0,332.0
304238.0,6,20,7722,11,878,30423.8,210.0,79.81818181818181,9,6844,37469.25,1514.0,760.4444444444445
120850963.0,17,14,864,7,432,19963647.33333333,174.0,61.71428571428572,7,432,20115338.666666668,174.0,61.71428571428572
90061490.0,17,28,13364,28,13364,3335610.7407407407,501.0,477.2857142857143,0,0,0.0,0.0,0.0
116150013.0,6,47,3102,24,1584,5040614.0869565215,66.0,66.0,23,1518,5105435.590909091,66.0,66.0
217255.0,6,3,426,2,280,0.0,214.0,140.0,1,146,0.0,146.0,146.0
184677.0,17,2,180,1,90,0.0,90.0,90.0,1,90,0.0,90.0,90.0
153391.0,17,2,180,1,90,0.0,90.0,90.0,1,90,0.0,90.0,90.0
302375.0,6,2,132,1,66,0.0,66.0,66.0,1,66,0.0,66.0,66.0
108098757.0,17,5,955,5,955,27024689.25,191.0,191.0,0,0,0.0,0.0,0.0
147985.0,17,2,180,1,90,0.0,90.0,90.0,1,90,0.0,90.0,90.0
1771040.0,6,2,132,1,66,0.0,66.0,66.0,1,66,0.0,66.0,66.0
21745.0,6,14,4740,7,653,3000.6666666666665,249.0,93.28571428571428,7,4087,3491.833333333333,1514.0,583.8571428571429
44590.0,6,14,4740,7,653,7078.333333333333,249.0,93.28571428571428,7,4087,7289.5,1514.0,583.8571428571429
37152.0,6,10,2032,5,524,7957.75,252.0,104.8,5,1508,8269.25,1236.0,301.6
9179.0,17,2,582,1,83,0.0,83.0,83.0,1,499,0.0,499.0,499.0
108107568.0,17,5,955,5,955,27026892.0,191.0,191.0,0,0,0.0,0.0,0.0
372.0,17,2,174,1,79,0.0,79.0,79.0,1,95,0.0,95.0,95.0
307666.0,6,6,412,4,272,102555.33333333331,74.0,68.0,2,140,0.0,74.0,70.0
20305.0,17,2,582,1,83,0.0,83.0,83.0,1,499,0.0,499.0,499.0
244348.0,6,10,1221,6,636,48869.6,298.0,106.0,4,585,71497.66666666667,379.0,146.25
146037.0,17,4,704,2,148,0.0,74.0,74.0,2,556,0.0,280.0,278.0
56176.0,6,10,1065,5,534,13617.0,262.0,106.8,5,531,3037.75,259.0,106.2
135140084.0,17,6,1146,6,1146,27028016.8,191.0,191.0,0,0,0.0,0.0,0.0
322939.0,17,4,1400,4,1400,107646.33333333331,350.0,350.0,0,0,0.0,0.0,0.0
135129242.0,17,6,1146,6,1146,27025848.4,191.0,191.0,0,0,0.0,0.0,0.0
504720.0,17,4,820,2,156,0.0,78.0,78.0,2,664,0.0,332.0,332.0
46582293.0,6,8,1940,3,887,22039045.5,753.0,295.6666666666667,5,1053,10952272.75,785.0,210.6
856021.0,6,9,1096,6,625,171204.2,287.0,104.16666666666669,3,471,290034.5,331.0,157.0
98949.0,17,2,762,2,762,0.0,381.0,381.0,0,0,0.0,0.0,0.0
90283263.0,6,13,2036,8,1016,12897609.0,188.0,127.0,5,1020,22529521.0,204.0,204.0
19777.0,6,14,4740,7,653,3092.333333333333,249.0,93.28571428571428,7,4087,2843.333333333333,1514.0,583.8571428571429
320576.0,17,4,1400,4,1400,106858.66666666669,350.0,350.0,0,0,0.0,0.0,0.0
511228.0,6,3,1604,2,851,0.0,785.0,425.5,1,753,0.0,753.0,753.0
120040438.0,17,28,13364,28,13364,4445942.148148148,501.0,477.2857142857143,0,0,0.0,0.0,0.0
302968.0,6,6,412,4,272,100989.33333333331,74.0,68.0,2,140,0.0,74.0,70.0
33131.0,6,13,1386,7,789,4988.833333333333,253.0,112.71428571428572,6,597,5363.8,259.0,99.5
90008230.0,17,28,13364,28,13364,3333638.1481481483,501.0,477.2857142857143,0,0,0.0,0.0,0.0
90317002.0,6,21,1585,11,840,9025207.0,95.0,76.36363636363636,10,745,10002685.777777778,95.0,74.5
147924.0,17,2,180,1,90,0.0,90.0,90.0,1,90,0.0,90.0,90.0
36389.0,6,14,4740,7,653,5957.166666666667,249.0,93.28571428571428,7,4087,5583.333333333333,1514.0,583.8571428571429
55690.0,6,12,1328,7,797,9281.666666666666,253.0,113.85714285714286,5,531,11824.25,259.0,106.2
90285852.0,6,16,1192,8,596,12891112.0,95.0,74.5,8,596,12897046.42857143,95.0,74.5
298564.0,6,6,412,4,272,99521.33333333331,74.0,68.0,2,140,0.0,74.0,70.0
48515.0,6,10,2032,5,524,11821.25,252.0,104.8,5,1508,10543.0,1236.0,301.6
168349.0,6,3,337,2,214,0.0,160.0,107.0,1,123,0.0,123.0,123.0
889.0,17,5,550,5,550,222.25,110.0,110.0,0,0,0.0,0.0,0.0
840649.0,6,9,1118,6,586,168129.8,248.0,97.66666666666669,3,532,282238.0,392.0,177.33333333333334
212632.0,6,10,1221,6,636,42526.4,298.0,106.0,4,585,68974.0,379.0,146.25
28052.0,6,14,4740,7,653,4381.833333333333,249.0,93.28571428571428,7,4087,4522.166666666667,1514.0,583.8571428571429
120794673.0,17,14,864,7,432,16834261.833333332,174.0,61.71428571428572,7,432,16833473.666666668,174.0,61.71428571428572
71826.0,17,2,618,1,74,0.0,74.0,74.0,1,544,0.0,544.0,544.0
2193965.0,6,19,6869,11,1567,219396.5,408.0,142.45454545454547,8,5302,250535.14285714287,1514.0,662.75
48138.0,6,10,2032,5,524,11796.75,252.0,104.8,5,1508,9465.25,1236.0,301.6
107832860.0,6,28,1860,14,966,8278241.307692308,123.0,69.0,14,894,8278242.923076923,123.0,63.85714285714285
2796318.0,6,2,132,1,66,0.0,66.0,66.0,1,66,0.0,66.0,66.0
246128.0,6,3,337,2,214,0.0,160.0,107.0,1,123,0.0,123.0,123.0
103916.0,17,2,286,2,286,0.0,143.0,143.0,0,0,0.0,0.0,0.0
23776316.0,17,5,1718,4,1368,849374.3333333334,342.0,342.0,1,350,0.0,350.0,350.0
196809.0,17,2,180,1,90,0.0,90.0,90.0,1,90,0.0,90.0,90.0
119315361.0,6,225,25442,113,7754,1065315.7232142857,140.0,68.61946902654867,112,17688,1065610.3783783785,300.0,157.92857142857142
119820763.0,6,15,2306,9,1082,14977595.375,188.0,120.22222222222224,6,1224,18024297.2,204.0,204.0
306247.0,6,6,412,4,272,102082.33333333331,74.0,68.0,2,140,0.0,74.0,70.0
120262415.0,17,13,821,6,389,20103925.0,174.0,64.83333333333333,7,432,20017053.0,174.0,61.71428571428572
323484.0,17,4,1400,4,1400,107828.0,350.0,350.0,0,0,0.0,0.0,0.0
35249.0,6,14,4740,7,653,5306.0,249.0,93.28571428571428,7,4087,5737.333333333333,1514.0,583.8571428571429
40287.0,6,10,2032,5,524,9798.75,252.0,104.8,5,1508,9393.25,1236.0,301.6
326.0,17,2,160,1,80,0.0,80.0,80.0,1,80,0.0,80.0,80.0
90052584.0,17,28,13364,28,13364,3335280.888888889,501.0,477.2857142857143,0,0,0.0,0.0,0.0
315203.0,17,4,1400,4,1400,105067.66666666669,350.0,350.0,0,0,0.0,0.0,0.0
114316867.0,17,16,1212,8,606,16285853.57142857,174.0,75.75,8,606,16286969.142857144,174.0,75.75
399117.0,6,10,1221,6,636,79823.4,298.0,106.0,4,585,126367.0,379.0,146.25
1314589.0,6,4,264,2,132,0.0,66.0,66.0,2,132,0.0,66.0,66.0
28457.0,6,14,4740,7,653,4620.666666666667,249.0,93.28571428571428,7,4087,4391.833333333333,1514.0,583.8571428571429
830.0,17,4,438,2,148,0.0,74.0,74.0,2,290,0.0,147.0,145.0
93028750.0,6,198,22420,99,15664,947077.1326530612,374.0,158.22222222222223,99,6756,947076.9285714284,140.0,68.24242424242425
10474585.0,6,7,478,4,272,3445927.6666666665,74.0,68.0,3,206,5168798.0,74.0,68.66666666666667
135138524.0,17,6,1206,6,1206,27027704.8,201.0,201.0,0,0,0.0,0.0,0.0
147266.0,6,3,373,2,238,0.0,172.0,119.0,1,135,0.0,135.0,135.0
120125673.0,6,13,2036,5,1020,30031418.25,204.0,204.0,8,1016,17137526.14285714,188.0,127.0
5999.0,17,2,447,1,84,0.0,84.0,84.0,1,363,0.0,363.0,363.0
262679.0,6,3,337,2,214,0.0,160.0,107.0,1,123,0.0,123.0,123.0
90038424.0,17,28,13364,28,13364,3334756.4444444445,501.0,477.2857142857143,0,0,0.0,0.0,0.0
63989.00000000001,6,14,4740,7,653,9969.5,249.0,93.28571428571428,7,4087,8893.833333333334,1514.0,583.8571428571429
3365.0,17,2,359,1,75,0.0,75.0,75.0,1,284,0.0,284.0,284.0
216359.0,17,2,180,1,90,0.0,90.0,90.0,1,90,0.0,90.0,90.0
18630.0,6,14,4740,7,653,2916.333333333333,249.0,93.28571428571428,7,4087,2907.1666666666665,1514.0,583.8571428571429
90298260.0,6,16,1192,8,596,12892762.57142857,95.0,74.5,8,596,12899411.285714284,95.0,74.5
18507.0,6,14,4740,7,653,2964.333333333333,249.0,93.28571428571428,7,4087,2953.0,1514.0,583.8571428571429
114429763.0,6,48,3168,24,1584,4975207.0869565215,66.0,66.0,24,1584,4962158.521739131,66.0,66.0
135132771.0,17,6,1146,6,1146,27026554.2,191.0,191.0,0,0,0.0,0.0,0.0
103258.0,17,2,700,2,700,0.0,350.0,350.0,0,0,0.0,0.0,0.0
135142715.0,17,6,1146,6,1146,27028543.0,191.0,191.0,0,0,0.0,0.0,0.0
88.0,17,2,762,2,762,0.0,381.0,381.0,0,0,0.0,0.0,0.0
44889587.0,17,9,3086,8,2736,5107645.285714285,342.0,342.0,1,350,0.0,350.0,350.0
125836439.0,17,14,864,7,432,17833494.5,174.0,61.71428571428572,7,432,17667387.333333332,174.0,61.71428571428572
113510684.0,6,46,3036,23,1518,5159564.863636363,66.0,66.0,23,1518,5159553.954545454,66.0,66.0
120120597.0,6,226,25550,113,7754,1065187.0357142857,140.0,68.61946902654867,113,17796,1065135.642857143,284.0,157.4867256637168
224928.0,6,3,426,2,280,0.0,214.0,140.0,1,146,0.0,146.0,146.0
90285375.0,6,22,2023,11,758,9024471.7,95.0,68.9090909090909,11,1265,9027993.3,223.0,115.0
36817.0,6,14,4740,7,653,5389.5,249.0,93.28571428571428,7,4087,5205.166666666667,1514.0,583.8571428571429
107897.0,17,2,286,2,286,0.0,143.0,143.0,0,0,0.0,0.0,0.0
74122621.0,6,9,842,9,842,9265327.625,97.0,93.55555555555556,0,0,0.0,0.0,0.0
2077.0,17,4,344,2,150,0.0,75.0,75.0,2,194,0.0,103.0,97.0
120054491.0,17,29,13785,29,13785,4287660.392857143,501.0,475.3448275862069,0,0,0.0,0.0,0.0
105954.0,17,2,762,2,762,0.0,381.0,381.0,0,0,0.0,0.0,0.0
310625.0,17,4,1400,4,1400,103541.66666666669,350.0,350.0,0,0,0.0,0.0,0.0
90016601.0,17,27,12943,27,12943,3462176.961538461,501.0,479.3703703703704,0,0,0.0,0.0,0.0
206372.0,6,3,426,2,280,0.0,214.0,140.0,1,146,0.0,146.0,146.0
120122129.0,6,13,2036,8,1016,17136993.57142857,188.0,127.0,5,1020,22522721.0,204.0,204.0
30420.0,6,14,4740,7,653,4962.666666666667,249.0,93.28571428571428,7,4087,4568.5,1514.0,583.8571428571429
1040217.0,6,11,1134,6,558,208043.4,220.0,93.0,5,576,259100.0,304.0,115.2
197691.0,17,2,180,1,90,0.0,90.0,90.0,1,90,0.0,90.0,90.0
103861931.0,6,56,5208,34,2985,3140473.1515151514,123.0,87.79411764705883,22,2223,4934935.333333333,123.0,101.04545454545456
38057.0,6,14,4740,7,653,6124.333333333333,249.0,93.28571428571428,7,4087,6069.0,1514.0,583.8571428571429
101752.0,17,2,762,2,762,0.0,381.0,381.0,0,0,0.0,0.0,0.0
768.0,17,4,438,2,148,0.0,74.0,74.0,2,290,0.0,147.0,145.0
37568.0,6,14,4740,7,653,5485.833333333333,249.0,93.28571428571428,7,4087,6052.5,1514.0,583.8571428571429
325800.0,6,2,145,2,145,0.0,91.0,72.5,0,0,0.0,0.0,0.0
2780143.0,6,2,132,1,66,0.0,66.0,66.0,1,66,0.0,66.0,66.0
90047045.0,17,28,13364,28,13364,3335075.7407407407,501.0,477.2857142857143,0,0,0.0,0.0,0.0
2465.0,17,4,344,2,150,0.0,75.0,75.0,2,194,0.0,103.0,97.0
40584.0,6,10,2032,5,524,7858.25,252.0,104.8,5,1508,9589.75,1236.0,301.6
25166006.0,17,3,1034,2,684,0.0,342.0,342.0,1,350,0.0,350.0,350.0
303487.0,6,6,412,4,272,101162.33333333331,74.0,68.0,2,140,0.0,74.0,70.0
90089796.0,6,11,1644,4,816,30029182.33333333,204.0,204.0,7,828,15014418.666666666,188.0,118.28571428571428
43996.0,6,10,2032,5,524,9378.5,252.0,104.8,5,1508,10227.0,1236.0,301.6
142045.0,6,2,132,1,66,0.0,66.0,66.0,1,66,0.0,66.0,66.0
34670.0,6,10,2032,5,524,5914.5,252.0,104.8,5,1508,8309.0,1236.0,301.6
90267345.0,6,14,1043,7,542,15044557.5,95.0,77.42857142857143,7,501,14996568.0,95.0,71.57142857142857
90255361.0,6,12,1832,8,1016,12893623.0,188.0,127.0,4,816,30030404.0,204.0,204.0
826.0,17,5,550,5,550,206.5,110.0,110.0,0,0,0.0,0.0,0.0
3004751.0,6,12,2172,7,664,500638.1666666667,252.0,94.85714285714286,5,1508,1995.5,1236.0,301.6
307750.0,6,6,412,4,272,102583.33333333331,74.0,68.0,2,140,0.0,74.0,70.0
120350565.0,6,237,26800,119,18716,1019920.0423728812,284.0,157.27731092436974,118,8084,1019763.9658119658,140.0,68.50847457627118
2409.0,17,4,344,2,150,0.0,75.0,75.0,2,194,0.0,103.0,97.0
27039349.0,17,5,1710,5,1710,6759837.25,342.0,342.0,0,0,0.0,0.0,0.0
120182383.0,6,208,23424,104,7086,1158878.0194174757,140.0,68.13461538461539,104,16338,1158821.8932038834,284.0,157.09615384615384
30790.0,6,11,2098,6,590,6158.0,252.0,98.33333333333331,5,1508,6023.25,1236.0,301.6
501016.0,6,5,336,2,134,0.0,68.0,67.0,3,202,196438.5,70.0,67.33333333333333
2412.0,17,4,344,2,150,0.0,75.0,75.0,2,194,0.0,103.0,97.0
24528.0,6,14,4740,7,653,3617.3333333333335,249.0,93.28571428571428,7,4087,2916.5,1514.0,583.8571428571429
109782905.0,6,35,2542,18,1348,6445156.529411765,139.0,74.88888888888889,17,1194,6847979.4375,123.0,70.23529411764706
2755.0,17,2,762,2,762,0.0,381.0,381.0,0,0,0.0,0.0,0.0
6076.0,17,4,344,2,150,0.0,75.0,75.0,2,194,0.0,103.0,97.0
99932997.0,6,29,2046,15,1017,7138042.214285715,123.0,67.8,14,1029,6918936.384615385,123.0,73.5
119856892.0,6,15,2306,6,1224,23970917.6,204.0,204.0,9,1082,14981957.625,188.0,120.22222222222224
239589.0,6,3,373,2,238,0.0,172.0,119.0,1,135,0.0,135.0,135.0
207238.0,6,3,426,2,280,0.0,214.0,140.0,1,146,0.0,146.0,146.0
90258238.0,6,12,1832,8,1016,12894034.0,188.0,127.0,4,816,30031833.0,204.0,204.0
209477.0,17,2,180,1,90,0.0,90.0,90.0,1,90,0.0,90.0,90.0
307276.0,6,6,412,4,272,102425.33333333331,74.0,68.0,2,140,0.0,74.0,70.0
153658.0,17,2,180,1,90,0.0,90.0,90.0,1,90,0.0,90.0,90.0
119410601.0,6,223,25156,112,7688,1075738.801801802,140.0,68.64285714285714,111,17468,1078179.5454545454,284.0,157.36936936936937
10238.0,6,10,1067,5,536,2283.0,264.0,107.2,5,531,2226.0,259.0,106.2
319664.0,6,6,412,4,272,106554.66666666669,74.0,68.0,2,140,0.0,74.0,70.0
47578.0,6,14,4740,7,653,7760.5,249.0,93.28571428571428,7,4087,7783.666666666667,1514.0,583.8571428571429
848052.0,6,9,1270,6,799,169610.4,461.0,133.16666666666666,3,471,287821.0,331.0,157.0
5006662.0,17,4,629,2,156,0.0,78.0,78.0,2,473,0.0,268.0,236.5
206603.0,17,2,180,1,90,0.0,90.0,90.0,1,90,0.0,90.0,90.0
235081.0,6,3,337,2,214,0.0,160.0,107.0,1,123,0.0,123.0,123.0
117971835.0,6,32,2220,16,1149,7864789.0,123.0,71.8125,16,1071,7850367.666666667,123.0,66.9375
343.0,17,2,166,1,75,0.0,75.0,75.0,1,91,0.0,91.0,91.0
4390.0,17,2,614,1,72,0.0,72.0,72.0,1,542,0.0,542.0,542.0
4267.0,17,2,582,1,83,0.0,83.0,83.0,1,499,0.0,499.0,499.0
108102895.0,17,5,955,5,955,27025723.75,191.0,191.0,0,0,0.0,0.0,0.0
206668.0,6,3,426,2,280,0.0,214.0,140.0,1,146,0.0,146.0,146.0
35682.0,6,14,4740,7,653,5337.166666666667,249.0,93.28571428571428,7,4087,4553.666666666667,1514.0,583.8571428571429
90262453.0,6,13,2036,8,1016,12894636.142857144,188.0,127.0,5,1020,22524092.75,204.0,204.0
2465.0,17,4,344,2,150,0.0,75.0,75.0,2,194,0.0,103.0,97.0
44038.0,6,10,1065,5,534,9908.5,262.0,106.8,5,531,8920.75,259.0,106.2
216805.0,6,3,426,2,280,0.0,214.0,140.0,1,146,0.0,146.0,146.0
123455991.0,6,49,3234,25,1650,5143999.625,66.0,66.0,24,1584,5116655.0869565215,66.0,66.0
115394387.0,6,48,3168,24,1584,5017147.260869565,66.0,66.0,24,1584,5005175.217391305,66.0,66.0
887332.0,6,10,1333,6,796,177466.4,458.0,132.66666666666666,4,537,203830.0,331.0,134.25
135132700.0,17,6,1206,6,1206,27026540.0,201.0,201.0,0,0,0.0,0.0,0.0
90057898.0,17,27,12943,27,12943,3463765.3076923075,501.0,479.3703703703704,0,0,0.0,0.0,0.0
120121338.0,6,13,2020,9,1204,15015167.25,188.0,133.77777777777777,4,816,30030305.0,204.0,204.0
108100560.0,17,5,955,5,955,27025140.0,191.0,191.0,0,0,0.0,0.0,0.0
36623.0,6,14,4740,7,653,5980.833333333333,249.0,93.28571428571428,7,4087,5807.666666666667,1514.0,583.8571428571429
114067231.0,6,34,2488,18,1348,6709837.117647059,139.0,74.88888888888889,16,1140,7590048.6,123.0,71.25
204671.0,17,2,762,2,762,0.0,381.0,381.0,0,0,0.0,0.0,0.0
14622.0,6,10,2032,5,524,3442.5,252.0,104.8,5,1508,3362.25,1236.0,301.6
102547.0,17,2,286,2,286,0.0,143.0,143.0,0,0,0.0,0.0,0.0
108112755.0,17,5,1005,5,1005,27028188.75,201.0,201.0,0,0,0.0,0.0,0.0
26871008.0,17,5,1718,4,1368,914308.0,342.0,342.0,1,350,0.0,350.0,350.0
103371.0,17,2,286,2,286,0.0,143.0,143.0,0,0,0.0,0.0,0.0
153451.0,17,2,180,1,90,0.0,90.0,90.0,1,90,0.0,90.0,90.0
108099511.0,17,5,955,5,955,27024877.75,191.0,191.0,0,0,0.0,0.0,0.0
90044891.0,17,28,13364,28,13364,3334995.962962963,501.0,477.2857142857143,0,0,0.0,0.0,0.0
117001073.0,17,15,1169,8,606,16714439.0,174.0,75.75,7,563,16169879.166666666,174.0,80.42857142857143
319318.0,6,6,412,4,272,106439.33333333331,74.0,68.0,2,140,0.0,74.0,70.0
307184.0,6,6,412,4,272,102394.66666666669,74.0,68.0,2,140,0.0,74.0,70.0
382108.0,6,5,367,2,132,0.0,66.0,66.0,3,235,191054.0,103.0,78.33333333333333
363563.0,6,11,1021,6,444,48853.6,162.0,74.0,5,577,60981.0,349.0,115.4
119749843.0,17,34,16284,34,16284,3628783.121212121,501.0,478.9411764705882,0,0,0.0,0.0,0.0
232927.0,6,3,337,2,214,0.0,160.0,107.0,1,123,0.0,123.0,123.0
112316583.0,6,32,2236,16,1165,7473384.933333334,139.0,72.8125,16,1071,7473393.733333333,123.0,66.9375
359.0,17,2,174,1,79,0.0,79.0,79.0,1,95,0.0,95.0,95.0
155322.0,6,3,337,2,214,0.0,160.0,107.0,1,123,0.0,123.0,123.0
237683.0,17,2,180,1,90,0.0,90.0,90.0,1,90,0.0,90.0,90.0
236942.0,6,3,337,2,214,0.0,160.0,107.0,1,123,0.0,123.0,123.0
695612.0,6,10,1124,6,608,139122.4,222.0,101.33333333333331,4,516,146647.33333333334,206.0,129.0
197317.0,17,2,180,1,90,0.0,90.0,90.0,1,90,0.0,90.0,90.0
203790.0,17,2,762,2,762,0.0,381.0,381.0,0,0,0.0,0.0,0.0
303612.0,6,2,132,1,66,0.0,66.0,66.0,1,66,0.0,66.0,66.0
108116012.0,17,5,955,5,955,27029003.0,191.0,191.0,0,0,0.0,0.0,0.0
4324.0,17,2,598,1,72,0.0,72.0,72.0,1,526,0.0,526.0,526.0
5627256.0,6,5,336,2,134,0.0,68.0,67.0,3,202,1422097.0,70.0,67.33333333333333
2429.0,17,4,344,2,150,0.0,75.0,75.0,2,194,0.0,103.0,97.0
149719.0,17,2,180,1,90,0.0,90.0,90.0,1,90,0.0,90.0,90.0
62516.0,6,14,4740,7,653,8367.0,249.0,93.28571428571428,7,4087,10199.166666666666,1514.0,583.8571428571429
146346.0,6,3,337,2,214,0.0,160.0,107.0,1,123,0.0,123.0,123.0
815.0,17,4,438,2,148,0.0,74.0,74.0,2,290,0.0,147.0,145.0
108102293.0,17,5,1005,5,1005,27025573.25,201.0,201.0,0,0,0.0,0.0,0.0
107657.0,17,2,286,2,286,0.0,143.0,143.0,0,0,0.0,0.0,0.0
90257934.0,6,12,1832,8,1016,12893990.57142857,188.0,127.0,4,816,30030914.33333333,204.0,204.0
3176569.0,6,18,1536,9,962,358372.875,315.0,106.88888888888889,9,574,358353.5,78.0,63.77777777777778
671561.0,6,10,1124,6,608,134312.2,222.0,101.33333333333331,4,516,142478.66666666666,206.0,129.0
0.0,6,1,66,1,66,0.0,66.0,66.0,0,0,0.0,0.0,0.0
99557.0,17,2,762,2,762,0.0,381.0,381.0,0,0,0.0,0.0,0.0
303708.0,6,2,132,1,66,0.0,66.0,66.0,1,66,0.0,66.0,66.0
9009277.0,17,2,160,2,160,0.0,80.0,80.0,0,0,0.0,0.0,0.0
110874246.0,17,16,1212,8,606,15714425.142857144,174.0,75.75,8,606,15715125.285714284,174.0,75.75
151492.0,17,2,414,1,88,0.0,88.0,88.0,1,326,0.0,326.0,326.0
1314738.0,6,4,264,2,132,0.0,66.0,66.0,2,132,0.0,66.0,66.0
2337.0,17,4,344,2,150,0.0,75.0,75.0,2,194,0.0,103.0,97.0
313814.0,17,4,1400,4,1400,104604.66666666669,350.0,350.0,0,0,0.0,0.0,0.0
43826.0,6,10,2032,5,524,10107.75,252.0,104.8,5,1508,10195.25,1236.0,301.6
33136.0,6,14,4740,7,653,5363.666666666667,249.0,93.28571428571428,7,4087,5097.333333333333,1514.0,583.8571428571429
319963.0,17,4,1400,4,1400,106654.33333333331,350.0,350.0,0,0,0.0,0.0,0.0
119609245.0,6,34,2334,17,1209,7475577.8125,123.0,71.11764705882354,17,1125,7462048.6875,123.0,66.17647058823529
120218744.0,6,248,27992,124,8480,970731.1300813009,140.0,68.38709677419355,124,19512,970722.861788618,284.0,157.3548387096774
53299.0,6,14,4740,7,653,7887.166666666667,249.0,93.28571428571428,7,4087,8668.166666666666,1514.0,583.8571428571429
32302.0,6,14,4740,7,653,5214.166666666667,249.0,93.28571428571428,7,4087,5131.5,1514.0,583.8571428571429
216312.0,17,2,180,1,90,0.0,90.0,90.0,1,90,0.0,90.0,90.0
2067.0,17,4,344,2,150,0.0,75.0,75.0,2,194,0.0,103.0,97.0
146287.0,6,3,337,2,214,0.0,160.0,107.0,1,123,0.0,123.0,123.0
356.0,17,2,267,1,83,0.0,83.0,83.0,1,184,0.0,184.0,184.0
17254.0,6,10,2032,5,524,4041.5,252.0,104.8,5,1508,4087.75,1236.0,301.6
215489.0,17,2,180,1,90,0.0,90.0,90.0,1,90,0.0,90.0,90.0
6553.0,17,4,823,2,163,0.0,89.0,81.5,2,660,0.0,443.0,330.0
110000977.0,17,13,821,7,432,18333496.166666668,174.0,61.71428571428572,6,389,18000945.2,174.0,64.83333333333333
127001166.0,17,15,907,8,475,18143023.71428572,174.0,59.375,7,432,17834458.333333332,174.0,61.71428571428572
91253231.0,17,12,778,6,389,18200161.8,174.0,64.83333333333333,6,389,18203692.2,174.0,64.83333333333333
2353.0,17,4,344,2,150,0.0,75.0,75.0,2,194,0.0,103.0,97.0
398.0,17,2,166,1,75,0.0,75.0,75.0,1,91,0.0,91.0,91.0
93231329.0,17,16,5472,16,5472,6215421.933333334,342.0,342.0,0,0,0.0,0.0,0.0
19537.0,6,10,2032,5,524,4660.25,252.0,104.8,5,1508,4626.0,1236.0,301.6
21825.0,6,10,2032,5,524,5191.75,252.0,104.8,5,1508,5175.0,1236.0,301.6
307464.0,17,4,1400,4,1400,102488.0,350.0,350.0,0,0,0.0,0.0,0.0
901661.0,6,10,1335,6,798,180332.2,460.0,133.0,4,537,208703.3333333333,331.0,134.25
153367.0,17,2,180,1,90,0.0,90.0,90.0,1,90,0.0,90.0,90.0
3875.0,17,4,344,2,150,0.0,75.0,75.0,2,194,0.0,103.0,97.0
120132300.0,6,218,24646,109,7490,1104637.962962963,140.0,68.71559633027523,109,17156,1104612.9351851852,284.0,157.39449541284404
108560.0,6,13,1386,7,789,17134.166666666668,253.0,112.71428571428572,6,597,20521.0,259.0,99.5
575895.0,6,4,508,2,238,0.0,172.0,119.0,2,270,0.0,135.0,135.0
30041.0,6,14,4740,7,653,4885.666666666667,249.0,93.28571428571428,7,4087,4468.166666666667,1514.0,583.8571428571429
2803932.0,6,2,132,1,66,0.0,66.0,66.0,1,66,0.0,66.0,66.0
354.0,17,2,267,1,83,0.0,83.0,83.0,1,184,0.0,184.0,184.0
3175112.0,6,18,1495,9,921,358162.5,315.0,102.33333333333331,9,574,358132.375,78.0,63.77777777777778
828.0,17,4,438,2,148,0.0,74.0,74.0,2,290,0.0,147.0,145.0
120004447.0,6,18,1341,9,691,14999909.5,95.0,76.77777777777777,9,650,14999437.5,95.0,72.22222222222223
90042623.0,17,28,13364,28,13364,3334911.962962963,501.0,477.2857142857143,0,0,0.0,0.0,0.0
108100748.0,17,5,955,5,955,27025187.0,191.0,191.0,0,0,0.0,0.0,0.0
205707.0,17,2,180,1,90,0.0,90.0,90.0,1,90,0.0,90.0,90.0
96677369.0,6,40,2640,20,1320,5088282.578947368,66.0,66.0,20,1320,5071729.421052632,66.0,66.0
10532702.0,6,7,478,4,272,3465389.0,74.0,68.0,3,206,5197969.5,74.0,68.66666666666667
10461413.0,6,7,478,4,272,3440240.0,74.0,68.0,3,206,5160242.5,74.0,68.66666666666667
90283813.0,6,15,1097,8,596,12897687.57142857,95.0,74.5,7,501,14998298.5,95.0,71.57142857142857
216637.0,17,2,180,1,90,0.0,90.0,90.0,1,90,0.0,90.0,90.0
91711384.0,6,24,2109,13,1151,7638793.5,257.0,88.53846153846153,11,958,9169062.2,154.0,87.0909090909091
95207664.0,17,12,778,6,389,19000826.2,174.0,64.83333333333333,6,389,19000234.0,174.0,64.83333333333333
218904.0,6,3,426,2,280,0.0,214.0,140.0,1,146,0.0,146.0,146.0
15995840.0,17,6,2052,6,2052,3199168.0,342.0,342.0,0,0,0.0,0.0,0.0
119486093.0,6,234,26782,117,18764,1028272.3793103448,284.0,160.3760683760684,117,8018,1028288.5689655172,140.0,68.52991452991454
5836150.0,6,5,336,2,134,0.0,68.0,67.0,3,202,1527112.0,70.0,67.33333333333333
212057.0,6,12,1373,7,714,35342.833333333336,298.0,102.0,5,659,52158.75,379.0,131.8
107194449.0,6,33,2412,17,1272,6686173.3125,123.0,74.82352941176471,16,1140,7131918.0,123.0,71.25
10883213.0,6,8,544,4,272,3582410.0,74.0,68.0,4,272,3582343.0,74.0,68.0
217025.0,6,3,426,2,280,0.0,214.0,140.0,1,146,0.0,146.0,146.0
135128116.0,17,6,1146,6,1146,27025623.2,191.0,191.0,0,0,0.0,0.0,0.0
103848007.0,6,198,22298,99,6830,1051386.3163265309,140.0,68.98989898989899,99,15468,1051278.1530612244,284.0,156.24242424242425
52809.0,6,14,4740,7,653,7976.333333333333,249.0,93.28571428571428,7,4087,7531.0,1514.0,583.8571428571429
114989503.0,6,30,1974,15,1026,8198107.785714285,123.0,68.4,15,948,8198103.928571428,123.0,63.2
2333.0,17,4,344,2,150,0.0,75.0,75.0,2,194,0.0,103.0,97.0
119766457.0,17,34,16284,34,16284,3629286.575757576,501.0,478.9411764705882,0,0,0.0,0.0,0.0
48516.0,6,14,4740,7,653,7855.5,249.0,93.28571428571428,7,4087,6852.833333333333,1514.0,583.8571428571429
1310048.0,6,4,264,2,132,0.0,66.0,66.0,2,132,0.0,66.0,66.0
42712.0,6,14,4740,7,653,5859.666666666667,249.0,93.28571428571428,7,4087,6606.5,1514.0,583.8571428571429
222194.0,6,3,426,2,280,0.0,214.0,140.0,1,146,0.0,146.0,146.0
130141.0,6,2,132,1,66,0.0,66.0,66.0,1,66,0.0,66.0,66.0
59733.0,6,14,4740,7,653,9458.166666666666,249.0,93.28571428571428,7,4087,7948.833333333333,1514.0,583.8571428571429
108738272.0,6,34,2482,17,1288,6782640.875,139.0,75.76470588235294,17,1194,6782641.0,123.0,70.23529411764706
323.0,17,2,174,1,79,0.0,79.0,79.0,1,95,0.0,95.0,95.0
147018.0,6,3,373,2,238,0.0,172.0,119.0,1,135,0.0,135.0,135.0
9115.0,17,2,539,1,86,0.0,86.0,86.0,1,453,0.0,453.0,453.0
374788.0,6,3,204,2,136,0.0,70.0,68.0,1,68,0.0,68.0,68.0
321.0,17,2,174,1,79,0.0,79.0,79.0,1,95,0.0,95.0,95.0
247464.0,6,3,337,2,214,0.0,160.0,107.0,1,123,0.0,123.0,123.0
120052592.0,17,28,13364,28,13364,4446392.296296297,501.0,477.2857142857143,0,0,0.0,0.0,0.0
103317213.0,6,42,2772,21,1386,5150443.6,66.0,66.0,21,1386,5150442.45,66.0,66.0
317355.0,17,4,1400,4,1400,105785.0,350.0,350.0,0,0,0.0,0.0,0.0
108529789.0,6,31,2160,16,1071,7235319.266666667,123.0,66.9375,15,1089,7023501.571428572,123.0,72.6
228164.0,17,2,180,1,90,0.0,90.0,90.0,1,90,0.0,90.0,90.0
54985.0,17,2,180,1,90,0.0,90.0,90.0,1,90,0.0,90.0,90.0
225696.0,6,12,1373,7,714,37616.0,298.0,102.0,5,659,55777.0,379.0,131.8
26164.0,6,10,2032,5,524,6068.25,252.0,104.8,5,1508,6290.5,1236.0,301.6
205267.0,6,3,426,2,280,0.0,214.0,140.0,1,146,0.0,146.0,146.0
121360.0,6,3,337,2,214,0.0,160.0,107.0,1,123,0.0,123.0,123.0
21333.0,6,10,2032,5,524,4725.25,252.0,104.8,5,1508,4988.0,1236.0,301.6
2336.0,17,4,344,2,150,0.0,75.0,75.0,2,194,0.0,103.0,97.0
216680.0,6,3,426,2,280,0.0,214.0,140.0,1,146,0.0,146.0,146.0
270332.0,17,2,180,1,90,0.0,90.0,90.0,1,90,0.0,90.0,90.0
6467.0,17,4,823,2,163,0.0,89.0,81.5,2,660,0.0,443.0,330.0
90263902.0,6,12,1832,8,1016,12894843.142857144,188.0,127.0,4,816,30033590.666666668,204.0,204.0
1037997.0,6,11,1134,6,558,207599.4,220.0,93.0,5,576,256759.75,304.0,115.2
861.0,17,4,438,2,148,0.0,74.0,74.0,2,290,0.0,147.0,145.0
108590381.0,17,14,864,7,432,18001129.0,174.0,61.71428571428572,7,432,18000167.833333332,174.0,61.71428571428572
2454.0,17,2,939,1,590,0.0,590.0,590.0,1,349,0.0,349.0,349.0
120073324.0,17,28,13364,28,13364,4447160.148148148,501.0,477.2857142857143,0,0,0.0,0.0,0.0
38548.0,6,14,4740,7,653,6303.0,249.0,93.28571428571428,7,4087,6079.833333333333,1514.0,583.8571428571429
2357.0,17,4,344,2,150,0.0,75.0,75.0,2,194,0.0,103.0,97.0
106182272.0,6,42,3478,23,1900,4826466.909090909,139.0,82.6086956521739,19,1578,5886979.611111111,123.0,83.05263157894737
119526615.0,6,803,124336,403,97566,296817.84825870645,1514.0,242.09925558312656,400,26770,299049.8746867168,214.0,66.925
35212.0,6,14,4740,7,653,5682.666666666667,249.0,93.28571428571428,7,4087,5342.5,1514.0,583.8571428571429
46964.0,6,14,4740,7,653,7652.833333333333,249.0,93.28571428571428,7,4087,7142.166666666667,1514.0,583.8571428571429
65668.0,6,14,4740,7,653,10825.666666666666,249.0,93.28571428571428,7,4087,10131.833333333334,1514.0,583.8571428571429
2011.0,17,4,344,2,150,0.0,75.0,75.0,2,194,0.0,103.0,97.0
352314.0,6,3,204,2,136,0.0,70.0,68.0,1,68,0.0,68.0,68.0
90014761.0,17,27,12943,27,12943,3462106.1923076925,501.0,479.3703703703704,0,0,0.0,0.0,0.0
146061.0,6,3,337,2,214,0.0,160.0,107.0,1,123,0.0,123.0,123.0
2846615.0,6,3,204,1,68,0.0,68.0,68.0,2,136,0.0,70.0,68.0
90255372.0,6,16,2368,9,1204,11281921.5,188.0,133.77777777777777,7,1164,15015333.333333334,204.0,166.28571428571428
90291805.0,6,19,1436,10,745,10027914.888888888,95.0,74.5,9,691,11285440.875,95.0,76.77777777777777
55198.0,6,14,4740,7,653,8544.833333333334,249.0,93.28571428571428,7,4087,8710.5,1514.0,583.8571428571429
102045.0,17,4,1400,4,1400,34015.0,350.0,350.0,0,0,0.0,0.0,0.0
143889.0,17,2,180,1,90,0.0,90.0,90.0,1,90,0.0,90.0,90.0
2346.0,17,4,344,2,150,0.0,75.0,75.0,2,194,0.0,103.0,97.0
123034362.0,6,24,1870,11,840,12303436.2,95.0,76.36363636363636,13,1030,7732083.666666667,95.0,79.23076923076923
108105875.0,17,5,1005,5,1005,27026468.75,201.0,201.0,0,0,0.0,0.0,0.0
108108019.0,17,5,1005,5,1005,27027004.75,201.0,201.0,0,0,0.0,0.0,0.0
451091.0,17,2,180,1,90,0.0,90.0,90.0,1,90,0.0,90.0,90.0
859705.0,6,9,1096,6,625,171941.0,287.0,104.16666666666669,3,471,292069.0,331.0,157.0
120171192.0,6,222,24994,111,7548,1084935.1363636365,140.0,68.0,111,17446,1075507.4363636365,284.0,157.17117117117118
10455623.0,6,7,478,4,272,3439470.333333333,74.0,68.0,3,206,5159098.5,74.0,68.66666666666667
73694.0,6,14,4740,7,653,12140.666666666666,249.0,93.28571428571428,7,4087,11732.333333333334,1514.0,583.8571428571429
10902.0,6,10,1975,5,467,2490.25,195.0,93.4,5,1508,2368.0,1236.0,301.6
30697005.0,17,5,1718,4,1368,807784.3333333334,342.0,342.0,1,350,0.0,350.0,350.0
0.0,6,1,66,1,66,0.0,66.0,66.0,0,0,0.0,0.0,0.0
823.0,17,4,438,2,148,0.0,74.0,74.0,2,290,0.0,147.0,145.0
160224.0,17,2,180,1,90,0.0,90.0,90.0,1,90,0.0,90.0,90.0
842.0,17,4,438,2,148,0.0,74.0,74.0,2,290,0.0,147.0,145.0
2592675.0,6,2,132,1,66,0.0,66.0,66.0,1,66,0.0,66.0,66.0
120087201.0,6,218,24646,109,7490,1101761.962962963,140.0,68.71559633027523,109,17156,1105349.2222222222,284.0,157.39449541284404
90305219.0,6,17,1287,9,691,11282596.0,95.0,76.77777777777777,8,596,12900176.0,95.0,74.5
17115.0,6,14,4740,7,653,2742.333333333333,249.0,93.28571428571428,7,4087,2672.833333333333,1514.0,583.8571428571429
284514.0,17,2,363,1,79,0.0,79.0,79.0,1,284,0.0,284.0,284.0
242328.0,6,3,373,2,238,0.0,172.0,119.0,1,135,0.0,135.0,135.0
163174.0,6,2,132,1,66,0.0,66.0,66.0,1,66,0.0,66.0,66.0
9868.0,17,2,582,1,83,0.0,83.0,83.0,1,499,0.0,499.0,499.0
3377.0,17,2,359,1,75,0.0,75.0,75.0,1,284,0.0,284.0,284.0
90260757.0,6,12,1832,8,1016,12894393.857142856,188.0,127.0,4,816,30032934.33333333,204.0,204.0
153458.0,17,2,180,1,90,0.0,90.0,90.0,1,90,0.0,90.0,90.0
113400955.0,6,48,3168,24,1584,4930476.304347826,66.0,66.0,24,1584,4921078.608695652,66.0,66.0
2333.0,17,4,344,2,150,0.0,75.0,75.0,2,194,0.0,103.0,97.0
51727849.0,6,8,2113,3,960,24539870.5,826.0,320.0,5,1153,12236870.5,885.0,230.6
291.0,17,2,166,1,75,0.0,75.0,75.0,1,91,0.0,91.0,91.0
135136653.0,17,6,1206,6,1206,27027330.6,201.0,201.0,0,0,0.0,0.0,0.0
39068.0,6,14,4740,7,653,6322.333333333333,249.0,93.28571428571428,7,4087,6323.0,1514.0,583.8571428571429
143947.0,17,2,180,1,90,0.0,90.0,90.0,1,90,0.0,90.0,90.0
17407.0,6,10,2032,5,524,4015.5,252.0,104.8,5,1508,3323.5,1236.0,301.6
187160.0,17,4,1524,4,1524,62386.66666666666,381.0,381.0,0,0,0.0,0.0,0.0
298016.0,6,6,412,4,272,99338.66666666669,74.0,68.0,2,140,0.0,74.0,70.0
284323.0,17,2,363,1,79,0.0,79.0,79.0,1,284,0.0,284.0,284.0
196945.0,17,2,180,1,90,0.0,90.0,90.0,1,90,0.0,90.0,90.0
1024419.0,6,20,6434,12,1921,93129.0,620.0,160.08333333333334,8,4513,118165.85714285714,1514.0,564.125
116586855.0,6,36,2580,18,1332,6845322.705882353,123.0,74.0,18,1248,6845321.705882353,123.0,69.33333333333333
90265061.0,6,14,1043,7,542,15044176.833333334,95.0,77.42857142857143,7,501,14996437.666666666,95.0,71.57142857142857
279701.0,17,2,180,1,90,0.0,90.0,90.0,1,90,0.0,90.0,90.0
144780.0,17,2,180,1,70,0.0,70.0,70.0,1,110,0.0,110.0,110.0
426.0,17,2,166,1,75,0.0,75.0,75.0,1,91,0.0,91.0,91.0
2135.0,17,4,344,2,150,0.0,75.0,75.0,2,194,0.0,103.0,97.0
102347.0,17,2,286,2,286,0.0,143.0,143.0,0,0,0.0,0.0,0.0
47841.0,6,14,4740,7,653,7846.333333333333,249.0,93.28571428571428,7,4087,6694.5,1514.0,583.8571428571429
751034.0,6,2,132,1,66,0.0,66.0,66.0,1,66,0.0,66.0,66.0
208735.0,6,10,1221,6,636,41747.0,298.0,106.0,4,585,68638.66666666667,379.0,146.25
299896.0,6,6,412,4,272,99965.33333333331,74.0,68.0,2,140,0.0,74.0,70.0
2055.0,17,4,344,2,150,0.0,75.0,75.0,2,194,0.0,103.0,97.0
32531.0,6,14,4740,7,653,5017.333333333333,249.0,93.28571428571428,7,4087,4796.0,1514.0,583.8571428571429
134001382.0,17,15,907,8,475,19143054.57142857,174.0,59.375,7,432,19001205.83333333,174.0,61.71428571428572
196889.0,17,2,180,1,90,0.0,90.0,90.0,1,90,0.0,90.0,90.0
108092889.0,17,5,1005,5,1005,27023222.25,201.0,201.0,0,0,0.0,0.0,0.0
90028572.0,17,28,13364,28,13364,3334391.5555555555,501.0,477.2857142857143,0,0,0.0,0.0,0.0
148417.0,6,13,1394,7,797,24736.166666666668,253.0,113.85714285714286,6,597,27121.4,259.0,99.5
90216305.0,6,21,1585,10,745,9997044.111111112,95.0,74.5,11,840,9001173.2,95.0,76.36363636363636
24167.0,6,14,4740,7,653,3903.3333333333335,249.0,93.28571428571428,7,4087,3890.6666666666665,1514.0,583.8571428571429
11023.0,6,10,1067,5,536,2476.25,264.0,107.2,5,531,2415.0,259.0,106.2
228272.0,17,2,180,1,90,0.0,90.0,90.0,1,90,0.0,90.0,90.0
92818650.0,6,227,26748,114,7746,821403.9823008849,140.0,67.94736842105263,113,19002,826713.2410714285,336.0,168.15929203539824
341.0,17,2,166,1,75,0.0,75.0,75.0,1,91,0.0,91.0,91.0
146257.0,6,3,337,2,214,0.0,160.0,107.0,1,123,0.0,123.0,123.0
2799200.0,6,2,132,1,66,0.0,66.0,66.0,1,66,0.0,66.0,66.0
117951431.0,6,33,2280,17,1209,7358483.9375,123.0,71.11764705882354,16,1071,7849047.933333334,123.0,66.9375
1187795.0,6,13,3020,8,2392,169685.0,1514.0,299.0,5,628,228028.25,331.0,125.6
109115980.0,6,33,2550,18,1395,6406520.411764706,123.0,77.5,15,1155,7778586.5,123.0,77.0
378871.0,17,2,363,1,75,0.0,75.0,75.0,1,288,0.0,288.0,288.0
1140576.0,6,13,1394,7,797,190096.0,253.0,113.85714285714286,6,597,226625.8,259.0,99.5
115675779.0,6,31,2166,16,1149,7697329.8,123.0,71.8125,15,1017,8247129.214285715,123.0,67.8
757145.0,6,2,132,1,66,0.0,66.0,66.0,1,66,0.0,66.0,66.0
110718.0,17,4,1400,4,1400,36906.0,350.0,350.0,0,0,0.0,0.0,0.0
5628991.0,6,4,270,2,134,0.0,68.0,67.0,2,136,0.0,70.0,68.0
120069343.0,17,29,13785,29,13785,4288190.821428572,501.0,475.3448275862069,0,0,0.0,0.0,0.0
2780515.0,6,2,132,1,66,0.0,66.0,66.0,1,66,0.0,66.0,66.0
135128617.0,17,6,1146,6,1146,27025723.4,191.0,191.0,0,0,0.0,0.0,0.0
6981.0,17,2,762,2,762,0.0,381.0,381.0,0,0,0.0,0.0,0.0
313174.0,17,4,1400,4,1400,104391.33333333331,350.0,350.0,0,0,0.0,0.0,0.0
95457164.0,17,12,778,6,389,19000160.4,174.0,64.83333333333333,6,389,19000757.6,174.0,64.83333333333333
44968444.0,17,9,3086,8,2736,5108062.285714285,342.0,342.0,1,350,0.0,350.0,350.0
435746.0,6,3,1604,2,851,0.0,785.0,425.5,1,753,0.0,753.0,753.0
2379.0,17,4,344,2,150,0.0,75.0,75.0,2,194,0.0,103.0,97.0
310173.0,17,4,1400,4,1400,103391.0,350.0,350.0,0,0,0.0,0.0,0.0
299358.0,6,6,412,4,272,99786.0,74.0,68.0,2,140,0.0,74.0,70.0
1611.0,17,2,762,2,762,0.0,381.0,381.0,0,0,0.0,0.0,0.0
67756.0,6,10,2032,5,524,16705.25,252.0,104.8,5,1508,13824.25,1236.0,301.6
382.0,17,2,160,1,80,0.0,80.0,80.0,1,80,0.0,80.0,80.0
103872.0,17,2,286,2,286,0.0,143.0,143.0,0,0,0.0,0.0,0.0
10493268.0,6,7,478,4,272,3452175.0,74.0,68.0,3,206,5178141.5,74.0,68.66666666666667
280708.0,17,2,180,1,90,0.0,90.0,90.0,1,90,0.0,90.0,90.0
260560.0,6,3,337,2,214,0.0,160.0,107.0,1,123,0.0,123.0,123.0
17401.0,6,11,2098,6,590,3480.2,252.0,98.33333333333331,5,1508,4060.5,1236.0,301.6
233027.0,6,3,337,2,214,0.0,160.0,107.0,1,123,0.0,123.0,123.0
90063443.0,17,28,13364,28,13364,3335683.074074074,501.0,477.2857142857143,0,0,0.0,0.0,0.0
146448.0,6,3,337,2,214,0.0,160.0,107.0,1,123,0.0,123.0,123.0
108104014.0,17,5,955,5,955,27026003.5,191.0,191.0,0,0,0.0,0.0,0.0
39026.0,6,14,4740,7,653,6381.833333333333,249.0,93.28571428571428,7,4087,5614.833333333333,1514.0,583.8571428571429
233145.0,6,3,337,2,214,0.0,160.0,107.0,1,123,0.0,123.0,123.0
237068.0,6,3,337,2,214,0.0,160.0,107.0,1,123,0.0,123.0,123.0
228223.0,17,2,180,1,90,0.0,90.0,90.0,1,90,0.0,90.0,90.0
74647542.0,6,9,842,9,842,9330942.75,97.0,93.55555555555556,0,0,0.0,0.0,0.0
783.0,17,4,438,2,148,0.0,74.0,74.0,2,290,0.0,147.0,145.0
2034.0,17,4,344,2,150,0.0,75.0,75.0,2,194,0.0,103.0,97.0
297745.0,6,6,412,4,272,99248.33333333331,74.0,68.0,2,140,0.0,74.0,70.0
303556.0,6,6,412,4,272,101185.33333333331,74.0,68.0,2,140,0.0,74.0,70.0
202435.0,17,4,6056,4,6056,67478.33333333333,1514.0,1514.0,0,0,0.0,0.0,0.0
219012.0,6,3,426,2,280,0.0,214.0,140.0,1,146,0.0,146.0,146.0
103200078.0,6,41,2706,21,1386,5160003.9,66.0,66.0,20,1320,5115147.052631579,66.0,66.0
6458.0,17,4,823,2,163,0.0,89.0,81.5,2,660,0.0,443.0,330.0
1763377.0,6,2,132,1,66,0.0,66.0,66.0,1,66,0.0,66.0,66.0
120266220.0,6,450,56550,225,15146,534243.1964285715,140.0,67.31555555555556,225,41404,536833.7098214285,336.0,184.01777777777767
378.0,17,2,208,1,72,0.0,72.0,72.0,1,136,0.0,136.0,136.0
112176158.0,6,209,23630,105,7164,1078616.9038461538,140.0,68.22857142857143,104,16466,1069032.5922330096,284.0,158.32692307692307
1556280.0,6,4,276,2,128,0.0,74.0,64.0,2,148,0.0,74.0,74.0
51081.0,17,2,180,1,90,0.0,90.0,90.0,1,90,0.0,90.0,90.0
308115.0,6,10,1221,6,636,61623.0,298.0,106.0,4,585,97301.0,379.0,146.25
100519906.0,17,12,516,6,258,20000214.0,43.0,43.0,6,258,20000979.8,43.0,43.0
126370555.0,17,15,1038,8,606,18052936.42857143,174.0,75.75,7,432,18833501.33333333,174.0,61.71428571428572
2352966.0,6,24,7544,12,2450,213406.54545454544,1034.0,204.16666666666663,12,5094,185793.8181818181,1510.0,424.5
115722.0,17,2,286,2,286,0.0,143.0,143.0,0,0,0.0,0.0,0.0
135126040.0,17,6,1206,6,1206,27025208.0,201.0,201.0,0,0,0.0,0.0,0.0
100705916.0,17,14,1126,7,563,16667641.666666666,174.0,80.42857142857143,7,563,16666801.333333334,174.0,80.42857142857143
245468.0,6,3,337,2,214,0.0,160.0,107.0,1,123,0.0,123.0,123.0
135132399.0,17,6,1146,6,1146,27026479.8,191.0,191.0,0,0,0.0,0.0,0.0
46134262.0,6,8,1940,4,953,15128802.333333334,753.0,238.25,4,987,14453283.333333334,785.0,246.75
49948.0,6,14,4740,7,653,8201.666666666666,249.0,93.28571428571428,7,4087,6503.5,1514.0,583.8571428571429
9544.0,17,2,571,1,86,0.0,86.0,86.0,1,485,0.0,485.0,485.0
155185.0,6,3,337,2,214,0.0,160.0,107.0,1,123,0.0,123.0,123.0
51029.0,17,2,180,1,90,0.0,90.0,90.0,1,90,0.0,90.0,90.0
5823057.0,6,5,336,2,134,0.0,68.0,67.0,3,202,1528493.0,70.0,67.33333333333333
135125456.0,17,6,1146,6,1146,27025091.2,191.0,191.0,0,0,0.0,0.0,0.0
90021861.0,17,27,12943,27,12943,3462379.269230769,501.0,479.3703703703704,0,0,0.0,0.0,0.0
45207.0,6,14,4740,7,653,7417.5,249.0,93.28571428571428,7,4087,7293.666666666667,1514.0,583.8571428571429
34198.0,6,14,4740,7,653,4835.333333333333,249.0,93.28571428571428,7,4087,5562.833333333333,1514.0,583.8571428571429
108108601.0,17,5,1005,5,1005,27027150.25,201.0,201.0,0,0,0.0,0.0,0.0
108127388.0,17,5,955,5,955,27031847.0,191.0,191.0,0,0,0.0,0.0,0.0
143947.0,17,2,180,1,90,0.0,90.0,90.0,1,90,0.0,90.0,90.0
114042777.0,17,16,1212,8,606,16287902.0,174.0,75.75,8,606,16285859.714285716,174.0,75.75
116994086.0,6,47,3102,24,1584,5077314.869565218,66.0,66.0,23,1518,5105437.454545454,66.0,66.0
23647.0,6,14,4740,7,653,3782.8333333333335,249.0,93.28571428571428,7,4087,3202.6666666666665,1514.0,583.8571428571429
103846.0,17,2,286,2,286,0.0,143.0,143.0,0,0,0.0,0.0,0.0
251887.00000000003,17,4,6056,4,6056,83962.33333333333,1514.0,1514.0,0,0,0.0,0.0,0.0
47736.0,6,14,4740,7,653,7643.666666666667,249.0,93.28571428571428,7,4087,5908.333333333333,1514.0,583.8571428571429
52204.0,6,14,4740,7,653,8576.833333333334,249.0,93.28571428571428,7,4087,8186.166666666667,1514.0,583.8571428571429
45803.0,6,14,4740,7,653,7285.666666666667,249.0,93.28571428571428,7,4087,7477.666666666667,1514.0,583.8571428571429
12459.0,6,11,1131,6,600,2083.2,262.0,100.0,5,531,2899.5,259.0,106.2
246081.0,6,3,337,2,214,0.0,160.0,107.0,1,123,0.0,123.0,123.0
18860.0,6,14,4740,7,653,2882.0,249.0,93.28571428571428,7,4087,3000.333333333333,1514.0,583.8571428571429
123603121.0,6,33,2343,16,1071,7727675.066666666,123.0,66.9375,17,1272,7101119.1875,123.0,74.82352941176471
108099330.0,17,5,955,5,955,27024832.5,191.0,191.0,0,0,0.0,0.0,0.0
148741.0,17,2,414,1,88,0.0,88.0,88.0,1,326,0.0,326.0,326.0
232899.0,6,3,337,2,214,0.0,160.0,107.0,1,123,0.0,123.0,123.0
300.0,17,2,168,1,76,0.0,76.0,76.0,1,92,0.0,92.0,92.0
30390.0,6,14,4740,7,653,4853.666666666667,249.0,93.28571428571428,7,4087,4727.0,1514.0,583.8571428571429
37137.0,6,10,2032,5,524,9112.25,252.0,104.8,5,1508,7818.0,1236.0,301.6
10576.0,6,10,2032,5,524,1998.0,252.0,104.8,5,1508,2281.0,1236.0,301.6
315.0,17,2,174,1,79,0.0,79.0,79.0,1,95,0.0,95.0,95.0
160276.0,6,2,128,1,74,0.0,74.0,74.0,1,54,0.0,54.0,54.0
801.0,17,4,438,2,148,0.0,74.0,74.0,2,290,0.0,147.0,145.0
26928.0,6,10,2032,5,524,5744.25,252.0,104.8,5,1508,5906.75,1236.0,301.6
296331.0,17,2,180,1,90,0.0,90.0,90.0,1,90,0.0,90.0,90.0
35935.0,6,13,1386,7,789,5728.166666666667,253.0,112.71428571428572,6,597,6631.2,259.0,99.5
102887.0,17,2,286,2,286,0.0,143.0,143.0,0,0,0.0,0.0,0.0
108102467.0,17,5,1005,5,1005,27025616.75,201.0,201.0,0,0,0.0,0.0,0.0
107365.0,17,2,286,2,286,0.0,143.0,143.0,0,0,0.0,0.0,0.0
1090880.0,6,13,1394,7,797,181813.3333333333,253.0,113.85714285714286,6,597,216193.4,259.0,99.5
510909.0,6,5,336,2,134,0.0,68.0,67.0,3,202,191861.0,70.0,67.33333333333333
3329182.0,17,3,1026,3,1026,1664591.0,342.0,342.0,0,0,0.0,0.0,0.0
110297854.0,6,30,1974,15,1026,7863000.357142857,123.0,68.4,15,948,7863005.785714285,123.0,63.2
2266.0,17,4,344,2,150,0.0,75.0,75.0,2,194,0.0,103.0,97.0
107847675.0,6,28,1860,14,966,8279355.923076923,123.0,69.0,14,894,8279357.0,123.0,63.85714285714285
163205.0,6,14,4740,7,653,21289.166666666668,249.0,93.28571428571428,7,4087,26803.666666666668,1514.0,583.8571428571429
21895.0,6,10,2032,5,524,4764.0,252.0,104.8,5,1508,5089.0,1236.0,301.6
113610705.0,6,46,3036,23,1518,5150437.681818182,66.0,66.0,23,1518,5150434.090909091,66.0,66.0
90061987.0,17,28,13364,28,13364,3335629.1481481483,501.0,477.2857142857143,0,0,0.0,0.0,0.0
144004.0,17,2,180,1,90,0.0,90.0,90.0,1,90,0.0,90.0,90.0
135133187.0,17,6,1146,6,1146,27026637.4,191.0,191.0,0,0,0.0,0.0,0.0
46504.0,6,14,4740,7,653,7453.5,249.0,93.28571428571428,7,4087,6549.5,1514.0,583.8571428571429
90254194.0,6,12,1832,8,1016,12893456.285714284,188.0,127.0,4,816,30029549.0,204.0,204.0
0.0,17,1,350,1,350,0.0,350.0,350.0,0,0,0.0,0.0,0.0
122007.0,6,3,373,2,238,0.0,172.0,119.0,1,135,0.0,135.0,135.0
869686.0,6,9,1270,6,799,173937.2,461.0,133.16666666666666,3,471,298453.5,331.0,157.0
121309.0,6,4,439,2,238,0.0,172.0,119.0,2,201,0.0,135.0,100.5
14571.0,17,4,823,2,163,0.0,89.0,81.5,2,660,0.0,443.0,330.0
1993.0,17,4,344,2,150,0.0,75.0,75.0,2,194,0.0,103.0,97.0
107686.0,17,2,286,2,286,0.0,143.0,143.0,0,0,0.0,0.0,0.0
53246.0,6,14,4740,7,653,8746.666666666666,249.0,93.28571428571428,7,4087,8211.833333333334,1514.0,583.8571428571429
116065.0,17,2,180,1,90,0.0,90.0,90.0,1,90,0.0,90.0,90.0
4781.0,17,4,344,2,150,0.0,75.0,75.0,2,194,0.0,103.0,97.0
2382.0,17,4,344,2,150,0.0,75.0,75.0,2,194,0.0,103.0,97.0
103055.0,17,2,286,2,286,0.0,143.0,143.0,0,0,0.0,0.0,0.0
152433.0,17,2,414,1,88,0.0,88.0,88.0,1,326,0.0,326.0,326.0
152059.0,17,2,414,1,88,0.0,88.0,88.0,1,326,0.0,326.0,326.0
119783575.0,6,35,2526,18,1332,7046092.647058823,123.0,74.0,17,1194,7472954.0,123.0,70.23529411764706
98057984.0,6,211,24252,106,17100,933885.561904762,284.0,161.32075471698113,105,7152,922791.9807692308,140.0,68.11428571428571
90690345.0,6,24,1829,11,840,9069034.5,95.0,76.36363636363636,13,989,7536072.333333333,95.0,76.07692307692308
242218.0,6,3,337,2,214,0.0,160.0,107.0,1,123,0.0,123.0,123.0
210217.0,17,4,813,2,144,0.0,72.0,72.0,2,669,0.0,542.0,334.5
114722048.0,6,48,3168,24,1584,4987915.130434782,66.0,66.0,24,1584,4974656.652173913,66.0,66.0
34136.0,6,10,2032,5,524,7902.0,252.0,104.8,5,1508,8166.75,1236.0,301.6
54429.0,6,10,2032,5,524,13355.75,252.0,104.8,5,1508,12430.5,1236.0,301.6
216684.0,17,2,180,1,90,0.0,90.0,90.0,1,90,0.0,90.0,90.0
1416.0,17,2,762,2,762,0.0,381.0,381.0,0,0,0.0,0.0,0.0
112348.0,17,2,286,2,286,0.0,143.0,143.0,0,0,0.0,0.0,0.0
144097.0,17,2,180,1,90,0.0,90.0,90.0,1,90,0.0,90.0,90.0
1309106.0,17,7,490,7,490,218184.3333333333,70.0,70.0,0,0,0.0,0.0,0.0
90104987.0,6,11,1644,4,816,30033266.666666668,204.0,204.0,7,828,15017210.0,188.0,118.28571428571428
1320878.0,6,4,264,2,132,0.0,66.0,66.0,2,132,0.0,66.0,66.0
530332.0,17,6,2100,6,2100,106066.4,350.0,350.0,0,0,0.0,0.0,0.0
416831.0,17,2,180,1,90,0.0,90.0,90.0,1,90,0.0,90.0,90.0
14633818.0,6,20,1607,10,975,1592519.2222222222,315.0,97.5,10,632,1592486.3333333333,78.0,63.2
318447.0,17,4,1400,4,1400,106149.0,350.0,350.0,0,0,0.0,0.0,0.0
108107640.0,17,5,955,5,955,27026910.0,191.0,191.0,0,0,0.0,0.0,0.0
1149552.0,6,13,3011,8,2383,164221.7142857143,1514.0,297.875,5,628,219215.0,331.0,125.6
143846.0,17,2,180,1,90,0.0,90.0,90.0,1,90,0.0,90.0,90.0
11654797.0,17,4,1368,4,1368,3884932.3333333335,342.0,342.0,0,0,0.0,0.0,0.0
2792676.0,6,2,132,1,66,0.0,66.0,66.0,1,66,0.0,66.0,66.0
306487.0,6,6,412,4,272,102162.33333333331,74.0,68.0,2,140,0.0,74.0,70.0
10557497.0,6,7,478,4,272,3473827.333333333,74.0,68.0,3,206,5179409.5,74.0,68.66666666666667
495893.0,6,4,270,2,134,0.0,68.0,67.0,2,136,0.0,70.0,68.0
58663.0,6,10,2032,5,524,14411.5,252.0,104.8,5,1508,12327.25,1236.0,301.6
47340.0,6,10,1065,5,534,10058.75,262.0,106.8,5,531,10196.75,259.0,106.2
109211189.0,6,32,2358,17,1272,6812207.3125,123.0,74.82352941176471,15,1086,7785381.214285715,123.0,72.4
419.0,17,2,410,1,78,0.0,78.0,78.0,1,332,0.0,332.0,332.0
504.0,17,2,508,2,508,0.0,257.0,254.0,0,0,0.0,0.0,0.0
349.0,17,2,208,1,72,0.0,72.0,72.0,1,136,0.0,136.0,136.0
2384.0,17,4,344,2,150,0.0,75.0,75.0,2,194,0.0,103.0,97.0
2353222.0,6,49,23728,25,19797,98050.91666666669,1514.0,791.88,24,3931,92436.04347826086,1514.0,163.79166666666666
120121648.0,6,14,2224,9,1204,15015206.0,188.0,133.77777777777777,5,1020,22523811.0,204.0,204.0
112008696.0,17,13,821,7,432,18668116.0,174.0,61.71428571428572,6,389,18400154.6,174.0,64.83333333333333
303319.0,6,6,412,4,272,101106.33333333331,74.0,68.0,2,140,0.0,74.0,70.0
956466.0,6,12,1447,6,816,190097.8,291.0,136.0,6,631,190457.2,293.0,105.16666666666669
15155385.0,17,6,2718,6,2718,3031077.0,453.0,453.0,0,0,0.0,0.0,0.0
11339.0,17,2,582,1,83,0.0,83.0,83.0,1,499,0.0,499.0,499.0
6749.0,17,4,823,2,163,0.0,89.0,81.5,2,660,0.0,443.0,330.0
90780086.0,6,20,1590,11,840,9073034.3,95.0,76.36363636363636,9,750,11288091.875,154.0,83.33333333333333
1630842.0,17,6,1230,3,234,815238.0,78.0,78.0,3,996,815218.5,332.0,332.0
105886187.0,6,32,2236,16,1165,7044690.466666667,139.0,72.8125,16,1071,7044688.666666667,123.0,66.9375
441.0,17,2,410,1,78,0.0,78.0,78.0,1,332,0.0,332.0,332.0
220731.0,6,10,1221,6,636,44146.2,298.0,106.0,4,585,72405.33333333333,379.0,146.25
121001180.0,17,15,907,8,475,17285882.85714286,174.0,59.375,7,432,16834398.333333332,174.0,61.71428571428572
46585055.0,6,7,1874,3,887,22077061.0,753.0,295.6666666666667,4,987,14670618.333333334,785.0,246.75
217966.0,6,3,426,2,280,0.0,214.0,140.0,1,146,0.0,146.0,146.0
317331.0,17,4,1400,4,1400,105777.0,350.0,350.0,0,0,0.0,0.0,0.0
90257353.0,6,13,2036,8,1016,12893907.57142857,188.0,127.0,5,1020,22522538.75,204.0,204.0
90971007.0,6,165,18596,83,12950,1109402.524390244,284.0,156.02409638554218,82,5646,1097415.0,140.0,68.85365853658537
205972.0,6,3,426,2,280,0.0,214.0,140.0,1,146,0.0,146.0,146.0
153440.0,17,2,180,1,90,0.0,90.0,90.0,1,90,0.0,90.0,90.0
120195805.0,6,31,2050,16,1102,8013053.666666667,139.0,68.875,15,948,7856684.642857143,123.0,63.2
56051.0,6,14,4740,7,653,8553.833333333334,249.0,93.28571428571428,7,4087,7389.666666666667,1514.0,583.8571428571429
19463.0,17,2,539,1,86,0.0,86.0,86.0,1,453,0.0,453.0,453.0
2148.0,17,4,344,2,150,0.0,75.0,75.0,2,194,0.0,103.0,97.0
147304.0,6,3,373,2,238,0.0,172.0,119.0,1,135,0.0,135.0,135.0
4283.0,17,2,582,1,83,0.0,83.0,83.0,1,499,0.0,499.0,499.0
146066.0,6,3,337,2,214,0.0,160.0,107.0,1,123,0.0,123.0,123.0
300357.0,17,2,363,1,79,0.0,79.0,79.0,1,284,0.0,284.0,284.0
206380.0,6,3,426,2,280,0.0,214.0,140.0,1,146,0.0,146.0,146.0
299806.0,17,2,246,1,76,0.0,76.0,76.0,1,170,0.0,170.0,170.0
314.0,17,2,174,1,79,0.0,79.0,79.0,1,95,0.0,95.0,95.0
202022.0,17,2,180,1,90,0.0,90.0,90.0,1,90,0.0,90.0,90.0
3080938.0,6,149,124715,89,116453,35010.65909090909,1510.0,1308.4606741573034,60,8262,46920.49152542373,1510.0,137.7
103309716.0,6,42,2772,21,1386,5150436.05,66.0,66.0,21,1386,5150436.45,66.0,66.0
228287.0,17,2,180,1,90,0.0,90.0,90.0,1,90,0.0,90.0,90.0
141912.0,6,2,132,1,66,0.0,66.0,66.0,1,66,0.0,66.0,66.0
21352.0,17,2,498,1,80,0.0,80.0,80.0,1,418,0.0,418.0,418.0
40066.0,6,14,4740,7,653,5532.5,249.0,93.28571428571428,7,4087,6098.833333333333,1514.0,583.8571428571429
64208.0,6,14,4740,7,653,9835.166666666666,249.0,93.28571428571428,7,4087,9858.166666666666,1514.0,583.8571428571429
135128576.0,17,6,1146,6,1146,27025715.2,191.0,191.0,0,0,0.0,0.0,0.0
21066.0,6,14,4740,7,653,3323.1666666666665,249.0,93.28571428571428,7,4087,3374.333333333333,1514.0,583.8571428571429
27522159.0,17,5,1710,5,1710,6880539.75,342.0,342.0,0,0,0.0,0.0,0.0
18547423.0,6,27,8809,16,1869,1236494.8666666667,408.0,116.8125,11,6940,1753032.7,1514.0,630.9090909090909
30938.0,6,14,4740,7,653,4615.833333333333,249.0,93.28571428571428,7,4087,5018.166666666667,1514.0,583.8571428571429
198226.0,17,2,180,1,90,0.0,90.0,90.0,1,90,0.0,90.0,90.0
216946.0,6,10,1221,6,636,43389.2,298.0,106.0,4,585,71408.33333333333,379.0,146.25
90046744.0,17,28,13364,28,13364,3335064.592592593,501.0,477.2857142857143,0,0,0.0,0.0,0.0
274262.0,17,4,1524,4,1524,91420.66666666669,381.0,381.0,0,0,0.0,0.0,0.0
309961.0,17,4,1400,4,1400,103320.33333333331,350.0,350.0,0,0,0.0,0.0,0.0
108104488.0,17,5,955,5,955,27026122.0,191.0,191.0,0,0,0.0,0.0,0.0
42882.0,6,14,4740,7,653,6864.666666666667,249.0,93.28571428571428,7,4087,6391.5,1514.0,583.8571428571429
98657736.0,17,12,778,6,389,19401540.4,174.0,64.83333333333333,6,389,19600186.8,174.0,64.83333333333333
5612685.0,6,5,336,2,134,0.0,68.0,67.0,3,202,1526475.5,70.0,67.33333333333333
160178.0,17,2,180,1,90,0.0,90.0,90.0,1,90,0.0,90.0,90.0
13621427.0,6,20,1607,10,975,1479043.2222222222,315.0,97.5,10,632,1479014.5555555555,78.0,63.2
244168.0,6,3,426,2,280,0.0,214.0,140.0,1,146,0.0,146.0,146.0
315424.0,6,6,412,4,272,105141.33333333331,74.0,68.0,2,140,0.0,74.0,70.0
51250.0,6,14,4740,7,653,8410.666666666666,249.0,93.28571428571428,7,4087,8089.5,1514.0,583.8571428571429
304466.0,6,6,412,4,272,101488.66666666669,74.0,68.0,2,140,0.0,74.0,70.0
90036793.0,17,28,13364,28,13364,3334696.037037037,501.0,477.2857142857143,0,0,0.0,0.0,0.0
285680.0,17,2,363,1,79,0.0,79.0,79.0,1,284,0.0,284.0,284.0
145916.0,6,2,132,1,66,0.0,66.0,66.0,1,66,0.0,66.0,66.0
2771424.0,6,3,1604,1,753,0.0,753.0,753.0,2,851,0.0,785.0,425.5
36044.0,6,14,4740,7,653,5885.0,249.0,93.28571428571428,7,4087,5790.833333333333,1514.0,583.8571428571429
310681.0,6,6,412,4,272,103560.33333333331,74.0,68.0,2,140,0.0,74.0,70.0
3006817.0,6,12,2172,7,664,501014.1666666667,252.0,94.85714285714286,5,1508,1854.75,1236.0,301.6
103778438.0,6,44,2904,22,1452,4941830.380952381,66.0,66.0,22,1452,4927085.523809524,66.0,66.0
101693093.0,17,14,1126,7,563,16922364.333333332,174.0,80.42857142857143,7,563,16829423.833333332,174.0,80.42857142857143
135160450.0,17,6,1206,6,1206,27032090.0,201.0,201.0,0,0,0.0,0.0,0.0
108108682.0,17,5,1005,5,1005,27027170.5,201.0,201.0,0,0,0.0,0.0,0.0
306155.0,6,10,1221,6,636,61231.0,298.0,106.0,4,585,96733.33333333331,379.0,146.25
0.0,17,1,342,1,342,0.0,342.0,342.0,0,0,0.0,0.0,0.0
236036.0,6,3,337,2,214,0.0,160.0,107.0,1,123,0.0,123.0,123.0
1351007.0,17,6,1230,3,234,675322.0,78.0,78.0,3,996,675298.0,332.0,332.0
108110420.0,17,5,1005,5,1005,27027605.0,201.0,201.0,0,0,0.0,0.0,0.0
15495.0,6,10,2032,5,524,3719.25,252.0,104.8,5,1508,3525.5,1236.0,301.6
135130782.0,17,6,1146,6,1146,27026156.4,191.0,191.0,0,0,0.0,0.0,0.0
232999.0,6,3,337,2,214,0.0,160.0,107.0,1,123,0.0,123.0,123.0
2323.0,17,4,344,2,150,0.0,75.0,75.0,2,194,0.0,103.0,97.0
114897865.0,6,48,3168,24,1584,4995559.347826087,66.0,66.0,24,1584,4983707.217391305,66.0,66.0
135131772.0,17,6,1206,6,1206,27026354.4,201.0,201.0,0,0,0.0,0.0,0.0
540342.0,17,6,2100,6,2100,108068.4,350.0,350.0,0,0,0.0,0.0,0.0
90062864.0,17,27,12943,27,12943,3463956.3076923075,501.0,479.3703703703704,0,0,0.0,0.0,0.0
780.0,17,4,438,2,148,0.0,74.0,74.0,2,290,0.0,147.0,145.0
55803.0,6,10,2032,5,524,13609.25,252.0,104.8,5,1508,13548.5,1236.0,301.6
232484.0,6,3,337,2,214,0.0,160.0,107.0,1,123,0.0,123.0,123.0
57741.0,6,10,2032,5,524,14221.75,252.0,104.8,5,1508,14054.75,1236.0,301.6
5004258.0,17,4,849,2,166,0.0,83.0,83.0,2,683,0.0,499.0,341.5
97915022.0,6,191,21688,96,15196,1030684.4421052632,284.0,158.29166666666666,95,6492,1020452.7340425532,140.0,68.33684210526316
313084.0,17,4,1400,4,1400,104361.33333333331,350.0,350.0,0,0,0.0,0.0,0.0
90063902.0,17,28,13364,28,13364,3335700.074074074,501.0,477.2857142857143,0,0,0.0,0.0,0.0
297899.0,6,6,412,4,272,99299.66666666669,74.0,68.0,2,140,0.0,74.0,70.0
18647.0,6,14,4740,7,653,2900.833333333333,249.0,93.28571428571428,7,4087,2911.6666666666665,1514.0,583.8571428571429
254638.0,6,3,337,2,214,0.0,160.0,107.0,1,123,0.0,123.0,123.0
205187.0,17,2,762,2,762,0.0,381.0,381.0,0,0,0.0,0.0,0.0
2012.0,17,4,344,2,150,0.0,75.0,75.0,2,194,0.0,103.0,97.0
311914.0,17,4,1400,4,1400,103971.33333333331,350.0,350.0,0,0,0.0,0.0,0.0
19957.0,6,10,2032,5,524,4710.25,252.0,104.8,5,1508,3016.25,1236.0,301.6
12502.0,17,2,582,1,83,0.0,83.0,83.0,1,499,0.0,499.0,499.0
2475.0,17,4,344,2,150,0.0,75.0,75.0,2,194,0.0,103.0,97.0
2355.0,17,4,344,2,150,0.0,75.0,75.0,2,194,0.0,103.0,97.0
314295.0,17,4,1400,4,1400,104765.0,350.0,350.0,0,0,0.0,0.0,0.0
112530.0,17,4,1400,4,1400,37510.0,350.0,350.0,0,0,0.0,0.0,0.0
2003.0,17,4,344,2,150,0.0,75.0,75.0,2,194,0.0,103.0,97.0
39300.0,6,14,4740,7,653,6434.333333333333,249.0,93.28571428571428,7,4087,6378.833333333333,1514.0,583.8571428571429
108107031.0,17,5,955,5,955,27026757.75,191.0,191.0,0,0,0.0,0.0,0.0
118500585.0,6,201,22804,101,15908,1185005.85,284.0,157.5049504950495,100,6896,1193221.101010101,140.0,68.96
119478711.0,6,218,24550,109,17134,1104291.4814814816,284.0,157.19266055045873,109,7416,1104290.5462962964,140.0,68.03669724770643
118953.0,17,4,1400,4,1400,39651.0,350.0,350.0,0,0,0.0,0.0,0.0
1015395.0,6,11,2049,6,541,202559.0,195.0,90.16666666666669,5,1508,3450.75,1236.0,301.6
505570.0,6,4,270,2,134,0.0,68.0,67.0,2,136,0.0,70.0,68.0
23459.0,6,14,4740,7,653,3733.6666666666665,249.0,93.28571428571428,7,4087,3762.8333333333335,1514.0,583.8571428571429
2327.0,17,4,344,2,150,0.0,75.0,75.0,2,194,0.0,103.0,97.0
317069.0,17,4,1524,4,1524,105689.66666666669,381.0,381.0,0,0,0.0,0.0,0.0
2210114.0,6,26,7675,14,2582,170008.76923076922,1034.0,184.42857142857144,12,5093,172290.0,1510.0,424.4166666666667
120073743.0,17,28,13364,28,13364,4447175.666666667,501.0,477.2857142857143,0,0,0.0,0.0,0.0
29885.0,6,14,4740,7,653,4718.0,249.0,93.28571428571428,7,4087,4624.833333333333,1514.0,583.8571428571429
33441.0,6,14,4740,7,653,5044.666666666667,249.0,93.28571428571428,7,4087,4653.666666666667,1514.0,583.8571428571429
307424.0,6,6,412,4,272,102474.66666666669,74.0,68.0,2,140,0.0,74.0,70.0
580671.0,6,4,508,2,238,0.0,172.0,119.0,2,270,0.0,135.0,135.0
232246.0,6,3,426,2,280,0.0,214.0,140.0,1,146,0.0,146.0,146.0
302625.0,6,6,412,4,272,100875.0,74.0,68.0,2,140,0.0,74.0,70.0
107501.0,17,2,286,2,286,0.0,143.0,143.0,0,0,0.0,0.0,0.0
51132.0,17,2,180,1,90,0.0,90.0,90.0,1,90,0.0,90.0,90.0
205636.0,6,3,426,2,280,0.0,214.0,140.0,1,146,0.0,146.0,146.0
2327139.0,6,2,819,1,753,0.0,753.0,753.0,1,66,0.0,66.0,66.0
90217247.0,6,16,1192,8,596,12852842.714285716,95.0,74.5,8,596,12857278.285714284,95.0,74.5
18510.0,6,20,7606,11,978,1851.0,310.0,88.9090909090909,9,6628,2037.25,1514.0,736.4444444444445
2309.0,17,4,344,2,150,0.0,75.0,75.0,2,194,0.0,103.0,97.0
90295384.0,6,17,1287,9,691,11281283.25,95.0,76.77777777777777,8,596,12898819.42857143,95.0,74.5
51542.0,6,14,4740,7,653,7996.0,249.0,93.28571428571428,7,4087,8112.833333333333,1514.0,583.8571428571429
90573426.0,6,30,2392,16,1291,6038228.4,139.0,80.6875,14,1101,6950544.230769231,123.0,78.64285714285714
1921876.0,6,4,492,2,280,0.0,214.0,140.0,2,212,0.0,146.0,106.0
90055929.0,17,28,13364,28,13364,3335404.777777778,501.0,477.2857142857143,0,0,0.0,0.0,0.0
245461.0,6,3,337,2,214,0.0,160.0,107.0,1,123,0.0,123.0,123.0
146224.0,6,3,337,2,214,0.0,160.0,107.0,1,123,0.0,123.0,123.0
30874.0,6,10,2032,5,524,7483.5,252.0,104.8,5,1508,6907.75,1236.0,301.6
285212.0,17,2,363,1,79,0.0,79.0,79.0,1,284,0.0,284.0,284.0
15358.0,6,10,1067,5,536,3006.25,264.0,107.2,5,531,2817.0,259.0,106.2
1180044.0,6,13,3010,8,2382,168577.7142857143,1514.0,297.75,5,628,226057.0,331.0,125.6
2084823.0,6,2,132,1,66,0.0,66.0,66.0,1,66,0.0,66.0,66.0
88834.0,6,11,1132,6,556,17717.4,218.0,92.66666666666669,5,576,21903.0,304.0,115.2
146272.0,6,3,337,2,214,0.0,160.0,107.0,1,123,0.0,123.0,123.0
321.0,17,2,174,1,79,0.0,79.0,79.0,1,95,0.0,95.0,95.0
206206.0,6,3,426,2,280,0.0,214.0,140.0,1,146,0.0,146.0,146.0
19735.0,17,4,823,2,163,0.0,89.0,81.5,2,660,0.0,443.0,330.0
2596520.0,6,2,132,1,66,0.0,66.0,66.0,1,66,0.0,66.0,66.0
3114697.0,6,4,492,2,280,0.0,214.0,140.0,2,212,0.0,146.0,106.0
120047075.0,17,28,13364,28,13364,4446187.962962963,501.0,477.2857142857143,0,0,0.0,0.0,0.0
106479630.0,6,196,22104,98,15402,1095509.670103093,284.0,157.16326530612244,98,6702,1095509.7731958765,140.0,68.38775510204081
120123109.0,6,17,2556,10,1392,13347012.111111112,188.0,139.2,7,1164,15015216.666666666,204.0,166.28571428571428
144204.0,17,4,1524,4,1524,48068.0,381.0,381.0,0,0,0.0,0.0,0.0
2366.0,17,4,344,2,150,0.0,75.0,75.0,2,194,0.0,103.0,97.0
193130.0,17,2,180,1,90,0.0,90.0,90.0,1,90,0.0,90.0,90.0
121491164.0,6,47,3102,23,1518,5150439.954545454,66.0,66.0,24,1584,5269135.173913044,66.0,66.0
337.0,17,2,191,1,73,0.0,73.0,73.0,1,118,0.0,118.0,118.0
11719.0,6,10,1067,5,536,2734.5,264.0,107.2,5,531,2584.0,259.0,106.2
155795.0,6,3,337,2,214,0.0,160.0,107.0,1,123,0.0,123.0,123.0
121275.0,6,3,337,2,214,0.0,160.0,107.0,1,123,0.0,123.0,123.0
206083.0,17,2,180,1,90,0.0,90.0,90.0,1,90,0.0,90.0,90.0
206372.0,6,3,426,2,280,0.0,214.0,140.0,1,146,0.0,146.0,146.0
20777943.0,6,22,1719,11,1029,2047690.1,315.0,93.54545454545456,11,690,2047675.9,78.0,62.72727272727273
2302.0,17,4,344,2,150,0.0,75.0,75.0,2,194,0.0,103.0,97.0
63503116.0,6,8,1307,8,1307,9071873.714285716,172.0,163.375,0,0,0.0,0.0,0.0
0.0,17,1,381,1,381,0.0,381.0,381.0,0,0,0.0,0.0,0.0
135137075.0,17,6,1146,6,1146,27027415.0,191.0,191.0,0,0,0.0,0.0,0.0
317871.0,6,6,412,4,272,105957.0,74.0,68.0,2,140,0.0,74.0,70.0
310.0,17,2,174,1,79,0.0,79.0,79.0,1,95,0.0,95.0,95.0
108101768.0,17,5,955,5,955,27025442.0,191.0,191.0,0,0,0.0,0.0,0.0
120356846.0,6,221,25024,111,17468,1094153.1454545455,284.0,157.36936936936937,110,7556,1094676.0642201835,140.0,68.69090909090909
120501828.0,6,215,24336,108,16978,1126185.308411215,374.0,157.2037037037037,107,7358,1126965.4716981133,140.0,68.76635514018692
90034254.0,17,28,13364,28,13364,3334602.0,501.0,477.2857142857143,0,0,0.0,0.0,0.0
248444.0,6,3,337,2,214,0.0,160.0,107.0,1,123,0.0,123.0,123.0
2595509.0,6,2,132,1,66,0.0,66.0,66.0,1,66,0.0,66.0,66.0
5005623.0,17,4,849,2,166,0.0,83.0,83.0,2,683,0.0,499.0,341.5
2105025.0,6,18,6803,10,1501,233891.66666666663,408.0,150.1,8,5302,238275.57142857145,1514.0,662.75
886365.0,6,9,1265,6,794,177273.0,456.0,132.33333333333334,3,471,305555.0,331.0,157.0
323358.0,17,4,1400,4,1400,107786.0,350.0,350.0,0,0,0.0,0.0,0.0
359.0,17,2,267,1,83,0.0,83.0,83.0,1,184,0.0,184.0,184.0
2032.0,17,4,344,2,150,0.0,75.0,75.0,2,194,0.0,103.0,97.0
90755912.0,6,23,1789,12,853,8245041.636363637,95.0,71.08333333333333,11,936,9074561.9,154.0,85.0909090909091
135128598.0,17,6,1146,6,1146,27025719.6,191.0,191.0,0,0,0.0,0.0,0.0
34914.0,6,14,4740,7,653,5658.166666666667,249.0,93.28571428571428,7,4087,5468.166666666667,1514.0,583.8571428571429
37350.0,6,14,4740,7,653,4952.5,249.0,93.28571428571428,7,4087,5957.5,1514.0,583.8571428571429
3274820.0,6,7,923,4,753,1019543.0,571.0,188.25,3,170,1529173.0,62.0,56.66666666666666
121480.0,6,3,337,2,214,0.0,160.0,107.0,1,123,0.0,123.0,123.0
151849.0,17,2,414,1,88,0.0,88.0,88.0,1,326,0.0,326.0,326.0
306974.0,6,6,412,4,272,102324.66666666669,74.0,68.0,2,140,0.0,74.0,70.0
9277.0,17,2,582,1,83,0.0,83.0,83.0,1,499,0.0,499.0,499.0
120008357.0,17,13,821,7,432,20001392.83333333,174.0,61.71428571428572,6,389,20000163.4,174.0,64.83333333333333
149723553.0,6,15,2290,5,1020,29962963.5,204.0,204.0,10,1270,16634574.222222222,188.0,127.0
148380331.0,6,24,1829,11,840,11912225.7,95.0,76.36363636363636,13,989,12347962.416666666,95.0,76.07692307692308
39686.0,6,14,4740,7,653,6373.833333333333,249.0,93.28571428571428,7,4087,6182.333333333333,1514.0,583.8571428571429
298.0,17,2,164,1,82,0.0,82.0,82.0,1,82,0.0,82.0,82.0
22683.0,6,20,7606,11,978,2268.3,310.0,88.9090909090909,9,6628,2522.875,1514.0,736.4444444444445
110168.0,17,2,286,2,286,0.0,143.0,143.0,0,0,0.0,0.0,0.0
100108.0,17,2,762,2,762,0.0,381.0,381.0,0,0,0.0,0.0,0.0
497887.0,17,4,820,2,156,0.0,78.0,78.0,2,664,0.0,332.0,332.0
200174.0,17,2,180,1,90,0.0,90.0,90.0,1,90,0.0,90.0,90.0
120542971.0,17,14,864,7,432,20090495.166666668,174.0,61.71428571428572,7,432,19970963.166666668,174.0,61.71428571428572
232820.0,6,10,1221,6,636,46564.0,298.0,106.0,4,585,76575.33333333333,379.0,146.25
12014435.0,17,3,1026,3,1026,6007217.5,342.0,342.0,0,0,0.0,0.0,0.0
104010218.0,17,13,821,7,432,17335036.333333332,174.0,61.71428571428572,6,389,16800160.0,174.0,64.83333333333333
29214.0,6,10,2032,5,524,6373.5,252.0,104.8,5,1508,7024.0,1236.0,301.6
319312.0,6,6,412,4,272,106437.33333333331,74.0,68.0,2,140,0.0,74.0,70.0
32692.0,6,14,4740,7,653,5332.5,249.0,93.28571428571428,7,4087,4616.333333333333,1514.0,583.8571428571429
249339.0,6,10,1221,6,636,49867.8,298.0,106.0,4,585,81980.0,379.0,146.25
135133191.0,17,6,1206,6,1206,27026638.2,201.0,201.0,0,0,0.0,0.0,0.0
1982.0,17,2,192,1,88,0.0,88.0,88.0,1,104,0.0,104.0,104.0
108107334.0,17,5,955,5,955,27026833.5,191.0,191.0,0,0,0.0,0.0,0.0
25415.0,6,13,4519,6,512,4926.8,230.0,85.33333333333333,7,4007,3570.6666666666665,1514.0,572.4285714285714
37339.0,6,10,2032,5,524,7031.5,252.0,104.8,5,1508,8978.0,1236.0,301.6
287.0,17,2,156,1,78,0.0,78.0,78.0,1,78,0.0,78.0,78.0
27832.0,6,14,4740,7,653,4197.0,249.0,93.28571428571428,7,4087,4435.833333333333,1514.0,583.8571428571429
23496.0,6,14,4740,7,653,3805.8333333333335,249.0,93.28571428571428,7,4087,2876.333333333333,1514.0,583.8571428571429
328.0,17,2,166,1,75,0.0,75.0,75.0,1,91,0.0,91.0,91.0
9295.0,17,2,582,1,83,0.0,83.0,83.0,1,499,0.0,499.0,499.0
233139.0,6,3,373,2,238,0.0,172.0,119.0,1,135,0.0,135.0,135.0
18733.0,17,2,582,1,83,0.0,83.0,83.0,1,499,0.0,499.0,499.0
108101678.0,17,5,955,5,955,27025419.5,191.0,191.0,0,0,0.0,0.0,0.0
120122721.0,6,13,2020,9,1204,15015340.125,188.0,133.77777777777777,4,816,30030942.33333333,204.0,204.0
76064820.0,6,9,842,9,842,9508102.5,97.0,93.55555555555556,0,0,0.0,0.0,0.0
2402.0,17,4,344,2,150,0.0,75.0,75.0,2,194,0.0,103.0,97.0
0.0,6,1,66,1,66,0.0,66.0,66.0,0,0,0.0,0.0,0.0
135349755.0,17,8,1643,7,1337,22558292.5,191.0,191.0,1,306,0.0,306.0,306.0
228349.0,17,2,180,1,90,0.0,90.0,90.0,1,90,0.0,90.0,90.0
205219.0,17,2,762,2,762,0.0,381.0,381.0,0,0,0.0,0.0,0.0
21781.0,6,14,4740,7,653,3519.5,249.0,93.28571428571428,7,4087,3410.333333333333,1514.0,583.8571428571429
167452.0,17,2,180,1,90,0.0,90.0,90.0,1,90,0.0,90.0,90.0
1390623.0,17,16,1120,16,1120,92708.2,70.0,70.0,0,0,0.0,0.0,0.0
10525830.0,6,7,478,4,272,3461522.333333333,74.0,68.0,3,206,5192158.0,74.0,68.66666666666667
2374.0,17,4,344,2,150,0.0,75.0,75.0,2,194,0.0,103.0,97.0
6662.0,17,2,582,1,83,0.0,83.0,83.0,1,499,0.0,499.0,499.0
120005037.0,6,18,1341,9,691,14999982.0,95.0,76.77777777777777,9,650,14999516.125,95.0,72.22222222222223
329.0,17,2,166,1,75,0.0,75.0,75.0,1,91,0.0,91.0,91.0
197070.0,17,2,180,1,90,0.0,90.0,90.0,1,90,0.0,90.0,90.0
316989.0,17,4,1400,4,1400,105663.0,350.0,350.0,0,0,0.0,0.0,0.0
119671017.0,17,13,690,7,432,19945169.5,174.0,61.71428571428572,6,258,20000249.8,43.0,43.0
41004.0,6,14,4740,7,653,6458.0,249.0,93.28571428571428,7,4087,6292.5,1514.0,583.8571428571429
135140840.0,17,6,1206,6,1206,27028168.0,201.0,201.0,0,0,0.0,0.0,0.0
101060.0,17,2,762,2,762,0.0,381.0,381.0,0,0,0.0,0.0,0.0
364.0,17,2,208,1,72,0.0,72.0,72.0,1,136,0.0,136.0,136.0
90034818.0,17,28,13364,28,13364,3334622.888888889,501.0,477.2857142857143,0,0,0.0,0.0,0.0
104258520.0,6,250,28356,125,19884,839139.8709677419,284.0,159.072,125,8472,839139.1370967742,140.0,67.776
1303119.0,6,4,264,2,132,0.0,66.0,66.0,2,132,0.0,66.0,66.0
12009400.0,17,3,1026,3,1026,6004700.0,342.0,342.0,0,0,0.0,0.0,0.0
43370.0,6,14,4740,7,653,7106.666666666667,249.0,93.28571428571428,7,4087,6284.333333333333,1514.0,583.8571428571429
135135134.0,17,6,1146,6,1146,27027026.8,191.0,191.0,0,0,0.0,0.0,0.0
1175448.0,6,13,3010,8,2382,167921.14285714287,1514.0,297.75,5,628,225029.75,331.0,125.6
107836.0,17,2,762,2,762,0.0,381.0,381.0,0,0,0.0,0.0,0.0
340794.0,17,4,704,2,148,0.0,74.0,74.0,2,556,0.0,280.0,278.0
215364.0,17,2,180,1,90,0.0,90.0,90.0,1,90,0.0,90.0,90.0
113614496.0,6,46,3036,23,1518,5150438.818181818,66.0,66.0,23,1518,5150433.045454546,66.0,66.0
32101.0,6,14,4740,7,653,4039.0,249.0,93.28571428571428,7,4087,5207.333333333333,1514.0,583.8571428571429
17110.0,6,10,1932,5,480,4016.75,252.0,96.0,5,1452,4016.0,1224.0,290.4
22680.0,6,14,4740,7,653,3610.0,249.0,93.28571428571428,7,4087,3617.8333333333335,1514.0,583.8571428571429
7503594.0,17,7,1743,4,351,2498424.0,103.0,87.75,3,1392,3616342.0,545.0,464.0
105950.0,17,2,286,2,286,0.0,143.0,143.0,0,0,0.0,0.0,0.0
3011794.0,6,12,2172,7,664,501160.0,252.0,94.85714285714286,5,1508,2891.25,1236.0,301.6
122687802.0,6,49,3234,25,1650,5111991.75,66.0,66.0,24,1584,5041649.565217392,66.0,66.0
248908.0,6,3,337,2,214,0.0,160.0,107.0,1,123,0.0,123.0,123.0
90098164.0,6,10,1440,7,828,15016360.666666666,188.0,118.28571428571428,3,612,30020717.5,204.0,204.0
323157.0,17,4,1400,4,1400,107719.0,350.0,350.0,0,0,0.0,0.0,0.0
113610778.0,6,46,3036,23,1518,5150438.136363637,66.0,66.0,23,1518,5150443.954545454,66.0,66.0
1302411.0,6,4,264,2,132,0.0,66.0,66.0,2,132,0.0,66.0,66.0
135129709.0,17,6,1146,6,1146,27025941.8,191.0,191.0,0,0,0.0,0.0,0.0
3013040.0,6,151,118377,84,109654,36301.68674698795,1510.0,1305.404761904762,67,8723,40953.469696969696,1510.0,130.19402985074626
28036.0,6,14,4740,7,653,4547.5,249.0,93.28571428571428,7,4087,4492.0,1514.0,583.8571428571429
121408.0,6,3,337,2,214,0.0,160.0,107.0,1,123,0.0,123.0,123.0
45398.0,6,10,2032,5,524,10592.25,252.0,104.8,5,1508,10941.5,1236.0,301.6
135135524.0,17,6,1146,6,1146,27027104.8,191.0,191.0,0,0,0.0,0.0,0.0
378068.0,17,2,363,1,75,0.0,75.0,75.0,1,288,0.0,288.0,288.0
4171.0,17,2,610,1,72,0.0,72.0,72.0,1,538,0.0,538.0,538.0
307054.0,6,6,412,4,272,102351.33333333331,74.0,68.0,2,140,0.0,74.0,70.0
303677.0,6,2,132,1,66,0.0,66.0,66.0,1,66,0.0,66.0,66.0
155189.0,6,3,337,2,214,0.0,160.0,107.0,1,123,0.0,123.0,123.0
120123899.0,6,13,2020,9,1204,15015487.375,188.0,133.77777777777777,4,816,30030504.0,204.0,204.0
5002988.0,17,2,174,2,174,0.0,87.0,87.0,0,0,0.0,0.0,0.0
250148.0,6,3,337,2,214,0.0,160.0,107.0,1,123,0.0,123.0,123.0
54866.0,6,10,2032,5,524,11642.5,252.0,104.8,5,1508,12190.0,1236.0,301.6
98205775.0,6,198,22330,99,15574,999901.1632653062,284.0,157.31313131313132,99,6756,999904.5510204082,140.0,68.24242424242425
860567.0,6,9,1268,6,797,172113.4,459.0,132.83333333333334,3,471,294005.5,331.0,157.0
16650.0,6,13,1459,7,862,2642.333333333333,271.0,123.14285714285714,6,597,3046.8,259.0,99.5
125708217.0,6,52,4651,22,2016,5521127.523809524,123.0,91.63636363636364,30,2635,3990461.0689655175,139.0,87.83333333333333
5829182.0,6,5,336,2,134,0.0,68.0,67.0,3,202,1524000.0,70.0,67.33333333333333
45607.0,6,14,4740,7,653,7478.666666666667,249.0,93.28571428571428,7,4087,7290.666666666667,1514.0,583.8571428571429
862922.0,6,9,1269,6,798,172584.4,460.0,133.0,3,471,295162.0,331.0,157.0
146190.0,6,3,337,2,214,0.0,160.0,107.0,1,123,0.0,123.0,123.0
118786208.0,6,38,2842,19,1371,6599209.0,123.0,72.15789473684211,19,1471,6044321.055555556,139.0,77.42105263157895
103042.0,17,2,286,2,286,0.0,143.0,143.0,0,0,0.0,0.0,0.0
135123546.0,17,6,1146,6,1146,27024709.2,191.0,191.0,0,0,0.0,0.0,0.0
34708.0,6,14,4740,7,653,5541.333333333333,249.0,93.28571428571428,7,4087,5633.166666666667,1514.0,583.8571428571429
128009222.0,17,15,907,8,475,18287031.71428572,174.0,59.375,7,432,18000181.333333332,174.0,61.71428571428572
90292059.0,6,16,1192,8,596,12892940.142857144,95.0,74.5,8,596,12897299.57142857,95.0,74.5
113971647.0,6,48,3168,24,1584,4955289.0,66.0,66.0,24,1584,4943438.304347826,66.0,66.0
216289.0,17,2,180,1,90,0.0,90.0,90.0,1,90,0.0,90.0,90.0
0.0,17,1,44,1,44,0.0,44.0,44.0,0,0,0.0,0.0,0.0
207230.0,6,3,426,2,280,0.0,214.0,140.0,1,146,0.0,146.0,146.0
346.0,17,2,160,1,80,0.0,80.0,80.0,1,80,0.0,80.0,80.0
110892.0,17,2,286,2,286,0.0,143.0,143.0,0,0,0.0,0.0,0.0
2317.0,17,4,344,2,150,0.0,75.0,75.0,2,194,0.0,103.0,97.0
2583341.0,6,2,132,1,66,0.0,66.0,66.0,1,66,0.0,66.0,66.0
55500.0,6,14,4740,7,653,6776.333333333333,249.0,93.28571428571428,7,4087,8641.5,1514.0,583.8571428571429
108200.0,17,2,286,2,286,0.0,143.0,143.0,0,0,0.0,0.0,0.0
2095314.0,6,18,6803,10,1501,232812.66666666663,408.0,150.1,8,5302,236878.7142857143,1514.0,662.75
104363932.0,6,34,2482,17,1288,6522745.75,139.0,75.76470588235294,17,1194,6509236.0,123.0,70.23529411764706
349126.0,6,4,508,2,238,0.0,172.0,119.0,2,270,0.0,135.0,135.0
2855432.0,6,12,2172,7,664,475840.8333333333,252.0,94.85714285714286,5,1508,3366.75,1236.0,301.6
2007054.0,17,4,493,2,150,0.0,75.0,75.0,2,343,0.0,252.0,171.5
228312.0,17,2,180,1,90,0.0,90.0,90.0,1,90,0.0,90.0,90.0
18639.0,6,14,4740,7,653,2881.0,249.0,93.28571428571428,7,4087,2968.6666666666665,1514.0,583.8571428571429
25220.0,6,10,2032,5,524,5637.0,252.0,104.8,5,1508,4761.75,1236.0,301.6
102838.0,17,4,1400,4,1400,34279.333333333336,350.0,350.0,0,0,0.0,0.0,0.0
293919.0,17,2,230,1,79,0.0,79.0,79.0,1,151,0.0,151.0,151.0
108108496.0,17,5,1005,5,1005,27027124.0,201.0,201.0,0,0,0.0,0.0,0.0
106402.0,17,2,286,2,286,0.0,143.0,143.0,0,0,0.0,0.0,0.0
90961568.0,6,20,1531,11,840,9091985.0,95.0,76.36363636363636,9,691,11368163.5,95.0,76.77777777777777
148005.0,17,2,180,1,90,0.0,90.0,90.0,1,90,0.0,90.0,90.0
136410.0,6,2,132,1,66,0.0,66.0,66.0,1,66,0.0,66.0,66.0
152314.0,17,2,414,1,88,0.0,88.0,88.0,1,326,0.0,326.0,326.0
87650.0,6,13,1513,7,882,14468.0,291.0,126.0,6,631,12919.2,293.0,105.16666666666669
1915.0,17,2,508,2,508,0.0,257.0,254.0,0,0,0.0,0.0,0.0
20154.0,17,2,582,1,83,0.0,83.0,83.0,1,499,0.0,499.0,499.0
146658.0,6,3,373,2,238,0.0,172.0,119.0,1,135,0.0,135.0,135.0
42570.0,6,14,4740,7,653,6971.333333333333,249.0,93.28571428571428,7,4087,4700.0,1514.0,583.8571428571429
108102496.0,17,5,1005,5,1005,27025624.0,201.0,201.0,0,0,0.0,0.0,0.0
299386.0,6,6,412,4,272,99795.33333333331,74.0,68.0,2,140,0.0,74.0,70.0
1304381.0,6,4,264,2,132,0.0,66.0,66.0,2,132,0.0,66.0,66.0
22896.0,6,10,2032,5,524,3943.0,252.0,104.8,5,1508,5468.0,1236.0,301.6
108831779.0,6,28,1860,14,966,8355117.461538462,123.0,69.0,14,894,8355119.230769231,123.0,63.85714285714285
35081644.0,6,29,9249,16,3843,156020.86666666667,1514.0,240.1875,13,5406,2906347.333333333,1514.0,415.84615384615387
50160.0,6,10,2032,5,524,12203.75,252.0,104.8,5,1508,11828.25,1236.0,301.6
16884460.0,6,20,6951,11,1575,1688446.0,408.0,143.1818181818182,9,5376,1595045.125,1514.0,597.3333333333334
82947535.0,17,14,4796,13,4446,6229521.0,342.0,342.0,1,350,0.0,350.0,350.0
53185.0,6,14,4740,7,653,6620.333333333333,249.0,93.28571428571428,7,4087,8591.166666666666,1514.0,583.8571428571429
249685.0,17,4,6056,4,6056,83228.33333333333,1514.0,1514.0,0,0,0.0,0.0,0.0
5616052.0,6,5,336,2,134,0.0,68.0,67.0,3,202,1419864.0,70.0,67.33333333333333
1169062.0,6,13,3020,8,2392,167008.85714285713,1514.0,299.0,5,628,224123.75,331.0,125.6
16604.0,6,10,2032,5,524,3940.0,252.0,104.8,5,1508,2292.0,1236.0,301.6
106676872.0,17,17,2060,8,761,15143834.42857143,250.0,95.125,9,1299,13250122.75,394.0,144.33333333333334
1366822.0,6,4,492,2,280,0.0,214.0,140.0,2,212,0.0,146.0,106.0
3158973.0,6,3,1604,2,851,0.0,785.0,425.5,1,753,0.0,753.0,753.0
605201.0,17,2,346,1,78,0.0,78.0,78.0,1,268,0.0,268.0,268.0
3088978.0,6,3,204,2,134,0.0,68.0,67.0,1,70,0.0,70.0,70.0
106460.0,17,2,700,2,700,0.0,350.0,350.0,0,0,0.0,0.0,0.0
518092.0,17,4,1400,4,1400,172697.33333333334,350.0,350.0,0,0,0.0,0.0,0.0
2033.0,17,4,344,2,150,0.0,75.0,75.0,2,194,0.0,103.0,97.0
117527027.0,6,358,44872,179,32762,659054.6067415731,390.0,183.02793296089385,179,12110,659054.8932584269,140.0,67.6536312849162
436638.0,6,11,1021,6,444,58596.0,162.0,74.0,5,577,73053.25,349.0,115.4
241620.0,6,3,337,2,214,0.0,160.0,107.0,1,123,0.0,123.0,123.0
117451927.0,6,215,24284,108,7350,1097681.5607476635,140.0,68.05555555555556,107,16934,1088566.3018867923,284.0,158.26168224299064
23463.0,6,14,4740,7,653,3335.6666666666665,249.0,93.28571428571428,7,4087,3736.3333333333335,1514.0,583.8571428571429
216518.0,6,3,426,2,280,0.0,214.0,140.0,1,146,0.0,146.0,146.0
29126.0,6,10,2032,5,524,7033.25,252.0,104.8,5,1508,6813.0,1236.0,301.6
197131.0,17,2,180,1,90,0.0,90.0,90.0,1,90,0.0,90.0,90.0
307337.0,6,6,412,4,272,102445.66666666669,74.0,68.0,2,140,0.0,74.0,70.0
120051176.0,17,29,13785,29,13785,4287542.0,501.0,475.3448275862069,0,0,0.0,0.0,0.0
111052.0,17,4,1400,4,1400,37017.333333333336,350.0,350.0,0,0,0.0,0.0,0.0
5647657.0,6,5,1736,2,819,0.0,753.0,409.5,3,917,2754593.0,785.0,305.6666666666667
90031248.0,17,28,13364,28,13364,3334490.6666666665,501.0,477.2857142857143,0,0,0.0,0.0,0.0
46730.0,6,13,1386,7,789,7155.666666666667,253.0,112.71428571428572,6,597,8932.6,259.0,99.5
243150.0,6,3,337,2,214,0.0,160.0,107.0,1,123,0.0,123.0,123.0
18372.0,6,11,1132,6,556,3439.6,218.0,92.66666666666669,5,576,3571.5,304.0,115.2
90535000.0,6,13,2036,8,1016,12933571.42857143,188.0,127.0,5,1020,22591697.25,204.0,204.0
307921.0,6,6,412,4,272,102640.33333333331,74.0,68.0,2,140,0.0,74.0,70.0
99474476.0,6,26,1746,13,906,8271553.833333333,123.0,69.6923076923077,13,840,8271553.083333333,123.0,64.61538461538461
803.0,17,4,438,2,148,0.0,74.0,74.0,2,290,0.0,147.0,145.0
205803.0,17,2,180,1,90,0.0,90.0,90.0,1,90,0.0,90.0,90.0
52054.0,6,14,4740,7,653,8554.666666666666,249.0,93.28571428571428,7,4087,6337.833333333333,1514.0,583.8571428571429
312.0,17,2,174,1,79,0.0,79.0,79.0,1,95,0.0,95.0,95.0
30247.0,6,11,1133,6,602,6049.4,264.0,100.33333333333331,5,531,6332.75,259.0,106.2
2040.0,17,4,344,2,150,0.0,75.0,75.0,2,194,0.0,103.0,97.0
43245.0,6,10,2032,5,524,10581.25,252.0,104.8,5,1508,10116.5,1236.0,301.6
30953.0,6,14,4740,7,653,4559.5,249.0,93.28571428571428,7,4087,5026.333333333333,1514.0,583.8571428571429
162275.0,17,2,180,1,90,0.0,90.0,90.0,1,90,0.0,90.0,90.0
279312.0,6,10,1221,6,636,55862.4,298.0,106.0,4,585,90090.0,379.0,146.25
135139001.0,17,6,1146,6,1146,27027800.2,191.0,191.0,0,0,0.0,0.0,0.0
120353649.0,6,198,22442,99,6756,1219702.051020408,140.0,68.24242424242425,99,15686,1219657.6530612244,284.0,158.44444444444446
166140.0,17,2,414,1,88,0.0,88.0,88.0,1,326,0.0,326.0,326.0
90096615.0,6,12,1848,5,1020,22523567.25,204.0,204.0,7,828,15015418.166666666,188.0,118.28571428571428
343.0,17,2,267,1,83,0.0,83.0,83.0,1,184,0.0,184.0,184.0
59965.0,6,14,4740,7,653,9872.166666666666,249.0,93.28571428571428,7,4087,9644.166666666666,1514.0,583.8571428571429
118890774.0,6,34,2334,17,1209,7430673.375,123.0,71.11764705882354,17,1125,7417155.25,123.0,66.17647058823529
128896372.0,6,35,2410,18,1285,7582139.529411765,139.0,71.38888888888889,17,1125,7418443.5625,123.0,66.17647058823529
17446.0,6,20,7606,11,978,1744.6,310.0,88.9090909090909,9,6628,1873.0,1514.0,736.4444444444445
136472.0,6,2,132,1,66,0.0,66.0,66.0,1,66,0.0,66.0,66.0
113344417.0,6,46,3036,23,1518,5152005.545454546,66.0,66.0,23,1518,5152006.363636363,66.0,66.0
225453.0,6,3,426,2,280,0.0,214.0,140.0,1,146,0.0,146.0,146.0
91942529.0,17,16,5472,16,5472,6129501.933333334,342.0,342.0,0,0,0.0,0.0,0.0
157770.0,17,2,180,1,90,0.0,90.0,90.0,1,90,0.0,90.0,90.0
307259.0,6,6,412,4,272,102419.66666666669,74.0,68.0,2,140,0.0,74.0,70.0
112161490.0,6,232,26178,116,18226,973446.7565217392,284.0,157.1206896551724,116,7952,973445.5739130436,140.0,68.55172413793103
297469.0,6,6,412,4,272,99156.33333333331,74.0,68.0,2,140,0.0,74.0,70.0
94900617.0,6,183,20694,92,14466,1042863.9230769232,284.0,157.2391304347826,91,6228,1043072.1,140.0,68.43956043956044
9421.0,17,2,539,1,86,0.0,86.0,86.0,1,453,0.0,453.0,453.0
38208.0,6,14,4740,7,653,6241.5,249.0,93.28571428571428,7,4087,6063.0,1514.0,583.8571428571429
5623096.0,6,5,336,2,134,0.0,68.0,67.0,3,202,1523634.0,70.0,67.33333333333333
120075283.0,17,29,13785,29,13785,4288402.964285715,501.0,475.3448275862069,0,0,0.0,0.0,0.0
100357.0,6,2,132,1,66,0.0,66.0,66.0,1,66,0.0,66.0,66.0
96418753.0,6,40,2640,20,1320,5074671.210526316,66.0,66.0,20,1320,5063296.210526316,66.0,66.0
86156040.0,17,11,999,9,913,10769505.0,174.0,101.44444444444444,2,86,0.0,43.0,43.0
1302675.0,6,4,264,2,132,0.0,66.0,66.0,2,132,0.0,66.0,66.0
108628.0,17,2,286,2,286,0.0,143.0,143.0,0,0,0.0,0.0,0.0
67296.0,6,10,2032,5,524,16599.5,252.0,104.8,5,1508,14801.75,1236.0,301.6
14861.0,6,11,1133,6,602,2827.6,264.0,100.33333333333331,5,531,3525.75,259.0,106.2
207674.0,17,2,762,2,762,0.0,381.0,381.0,0,0,0.0,0.0,0.0
233373.0,6,3,337,2,214,0.0,160.0,107.0,1,123,0.0,123.0,123.0
92319886.0,17,15,5130,15,5130,6594277.571428572,342.0,342.0,0,0,0.0,0.0,0.0
34992.0,6,14,4740,7,653,5670.333333333333,249.0,93.28571428571428,7,4087,5692.0,1514.0,583.8571428571429
45564.0,6,10,2032,5,524,11163.75,252.0,104.8,5,1508,9796.5,1236.0,301.6
95872046.0,17,13,4454,12,4104,6796819.909090909,342.0,342.0,1,350,0.0,350.0,350.0
217854.0,6,3,426,2,280,0.0,214.0,140.0,1,146,0.0,146.0,146.0
92880370.0,6,38,2508,19,1254,5160005.055555556,66.0,66.0,19,1254,5160000.833333333,66.0,66.0
113983548.0,6,48,3168,24,1584,4955806.434782608,66.0,66.0,24,1584,4942588.652173913,66.0,66.0
73585.0,6,11,1131,6,600,14099.8,262.0,100.0,5,531,17934.0,259.0,106.2
108107538.0,17,5,1005,5,1005,27026884.5,201.0,201.0,0,0,0.0,0.0,0.0
135133143.0,17,6,1206,6,1206,27026628.6,201.0,201.0,0,0,0.0,0.0,0.0
146217.0,6,3,373,2,238,0.0,172.0,119.0,1,135,0.0,135.0,135.0
102885016.0,6,44,2904,22,1452,4899286.476190476,66.0,66.0,22,1452,4888987.047619048,66.0,66.0
325981.0,6,3,204,1,68,0.0,68.0,68.0,2,136,0.0,70.0,68.0
101178410.0,17,14,864,7,432,16834030.333333332,174.0,61.71428571428572,7,432,16833517.166666668,174.0,61.71428571428572
162257.0,17,2,180,1,90,0.0,90.0,90.0,1,90,0.0,90.0,90.0
1239930.0,17,7,490,7,490,206655.0,70.0,70.0,0,0,0.0,0.0,0.0
90017822.0,17,28,13364,28,13364,3333993.407407407,501.0,477.2857142857143,0,0,0.0,0.0,0.0
90299618.0,6,21,1585,11,840,9025620.5,95.0,76.36363636363636,10,745,10001004.111111112,95.0,74.5
320768.0,17,4,1400,4,1400,106922.66666666669,350.0,350.0,0,0,0.0,0.0,0.0
290254.0,17,2,246,1,76,0.0,76.0,76.0,1,170,0.0,170.0,170.0
767.0,17,4,438,2,148,0.0,74.0,74.0,2,290,0.0,147.0,145.0
60692.0,6,10,2032,5,524,14938.0,252.0,104.8,5,1508,14396.25,1236.0,301.6
101160.0,17,2,762,2,762,0.0,381.0,381.0,0,0,0.0,0.0,0.0
153461.0,17,2,180,1,90,0.0,90.0,90.0,1,90,0.0,90.0,90.0
214091.0,17,2,180,1,90,0.0,90.0,90.0,1,90,0.0,90.0,90.0
1162139.0,6,13,3010,8,2382,166019.85714285713,1514.0,297.75,5,628,222339.75,331.0,125.6
329.0,17,2,267,1,83,0.0,83.0,83.0,1,184,0.0,184.0,184.0
3593.0,17,2,414,1,88,0.0,88.0,88.0,1,326,0.0,326.0,326.0
348981.0,6,4,508,2,238,0.0,172.0,119.0,2,270,0.0,135.0,135.0
303250.0,6,6,412,4,272,101083.33333333331,74.0,68.0,2,140,0.0,74.0,70.0
27324035.0,17,5,1710,5,1710,6831008.75,342.0,342.0,0,0,0.0,0.0,0.0
0.0,17,1,90,1,90,0.0,90.0,90.0,0,0,0.0,0.0,0.0
2440.0,17,4,344,2,150,0.0,75.0,75.0,2,194,0.0,103.0,97.0
27008171.0,17,5,1710,5,1710,6752042.75,342.0,342.0,0,0,0.0,0.0,0.0
852.0,17,5,550,5,550,213.0,110.0,110.0,0,0,0.0,0.0,0.0
14058.0,6,10,2032,5,524,2570.75,252.0,104.8,5,1508,2937.0,1236.0,301.6
90504592.0,6,14,2114,6,1098,18100918.4,204.0,183.0,8,1016,12914217.285714284,188.0,127.0
10447966.0,6,7,478,4,272,3437212.0,74.0,68.0,3,206,5155727.5,74.0,68.66666666666667
0.0,17,1,80,1,80,0.0,80.0,80.0,0,0,0.0,0.0,0.0
108103322.0,17,5,955,5,955,27025830.5,191.0,191.0,0,0,0.0,0.0,0.0
42434.0,6,14,4740,7,653,6904.0,249.0,93.28571428571428,7,4087,6381.333333333333,1514.0,583.8571428571429
110957545.0,6,32,2236,16,1165,7382754.333333333,139.0,72.8125,16,1071,7382778.866666666,123.0,66.9375
92713140.0,6,38,2508,19,1254,5135436.611111111,66.0,66.0,19,1254,5135439.0,66.0,66.0
66675.0,6,13,1394,7,797,11112.5,253.0,113.85714285714286,6,597,12408.6,259.0,99.5
332580.0,6,6,412,4,272,110860.0,74.0,68.0,2,140,0.0,74.0,70.0
304137.0,6,6,412,4,272,101379.0,74.0,68.0,2,140,0.0,74.0,70.0
21000.0,6,2,145,2,145,0.0,91.0,72.5,0,0,0.0,0.0,0.0
24221.0,6,10,2032,5,524,5377.75,252.0,104.8,5,1508,5586.25,1236.0,301.6
514102.0,6,4,270,2,134,0.0,68.0,67.0,2,136,0.0,70.0,68.0
17032.0,17,2,180,1,90,0.0,90.0,90.0,1,90,0.0,90.0,90.0
101150460.0,17,14,864,7,432,16831918.166666668,174.0,61.71428571428572,7,432,16837605.833333332,174.0,61.71428571428572
9357.0,17,4,823,2,163,0.0,89.0,81.5,2,660,0.0,443.0,330.0
98165.0,17,2,286,2,286,0.0,143.0,143.0,0,0,0.0,0.0,0.0
574646.0,6,4,508,2,238,0.0,172.0,119.0,2,270,0.0,135.0,135.0
27361112.0,17,5,1710,5,1710,6840278.0,342.0,342.0,0,0,0.0,0.0,0.0
231911.0,6,3,337,2,214,0.0,160.0,107.0,1,123,0.0,123.0,123.0
2940.0,17,2,762,2,762,0.0,381.0,381.0,0,0,0.0,0.0,0.0
93561250.0,6,170,19206,85,5832,1104045.3214285714,140.0,68.61176470588235,85,13374,1105481.5952380951,284.0,157.34117647058824
3361645.0,6,141,124603,89,116869,38200.51136363636,1510.0,1313.134831460674,52,7734,59754.74509803922,1510.0,148.73076923076923
309285.0,6,3,202,2,128,0.0,74.0,64.0,1,74,0.0,74.0,74.0
90906452.0,6,20,1490,10,745,10100716.888888888,95.0,74.5,10,745,10073312.666666666,95.0,74.5
103199.0,17,2,286,2,286,0.0,143.0,143.0,0,0,0.0,0.0,0.0
135139835.0,17,6,1206,6,1206,27027967.0,201.0,201.0,0,0,0.0,0.0,0.0
47816.0,6,14,4740,7,653,6869.166666666667,249.0,93.28571428571428,7,4087,7776.666666666667,1514.0,583.8571428571429
135133222.0,17,6,1206,6,1206,27026644.4,201.0,201.0,0,0,0.0,0.0,0.0
127001124.0,17,15,907,8,475,18143017.71428572,174.0,59.375,7,432,17834012.0,174.0,61.71428571428572
2409.0,17,4,344,2,150,0.0,75.0,75.0,2,194,0.0,103.0,97.0
63722.0,6,14,4740,7,653,10159.666666666666,249.0,93.28571428571428,7,4087,9452.833333333334,1514.0,583.8571428571429
12021.0,17,2,582,1,83,0.0,83.0,83.0,1,499,0.0,499.0,499.0
2049465.0,17,6,1230,3,234,1024545.5,78.0,78.0,3,996,1024526.0,332.0,332.0
751839.0,6,2,132,1,66,0.0,66.0,66.0,1,66,0.0,66.0,66.0
16963.0,6,20,7606,11,978,1696.3,310.0,88.9090909090909,9,6628,1802.25,1514.0,736.4444444444445
2801157.0,6,2,132,1,66,0.0,66.0,66.0,1,66,0.0,66.0,66.0
96098418.0,6,52,11468,28,5946,3559200.6666666665,1514.0,212.3571428571429,24,5522,4167227.565217391,1514.0,230.0833333333333
21244.0,6,11,1133,6,602,3625.0,264.0,100.33333333333331,5,531,4612.25,259.0,106.2
223553.0,6,3,426,2,280,0.0,214.0,140.0,1,146,0.0,146.0,146.0
120123848.0,6,15,2428,9,1204,15015481.0,188.0,133.77777777777777,6,1224,18018313.8,204.0,204.0
346500.0,17,6,2100,6,2100,69300.0,350.0,350.0,0,0,0.0,0.0,0.0
36569.0,6,14,4740,7,653,5306.666666666667,249.0,93.28571428571428,7,4087,5598.0,1514.0,583.8571428571429
279484.0,17,2,180,1,90,0.0,90.0,90.0,1,90,0.0,90.0,90.0
324245.0,17,4,1400,4,1400,108081.66666666669,350.0,350.0,0,0,0.0,0.0,0.0
1307070.0,6,4,264,2,132,0.0,66.0,66.0,2,132,0.0,66.0,66.0
1306907.0,6,4,264,2,132,0.0,66.0,66.0,2,132,0.0,66.0,66.0
93112169.0,6,38,2508,19,1254,5155447.666666667,66.0,66.0,19,1254,5155447.833333333,66.0,66.0
251141.0,6,12,1373,7,714,41856.833333333336,298.0,102.0,5,659,58776.25,379.0,131.8
119846.0,17,2,180,1,70,0.0,70.0,70.0,1,110,0.0,110.0,110.0
143896.0,17,2,180,1,90,0.0,90.0,90.0,1,90,0.0,90.0,90.0
207928.0,6,10,1221,6,636,41585.6,298.0,106.0,4,585,67556.0,379.0,146.25
206046.0,6,3,426,2,280,0.0,214.0,140.0,1,146,0.0,146.0,146.0
105560.0,17,2,700,2,700,0.0,350.0,350.0,0,0,0.0,0.0,0.0
193033.0,17,3,1143,3,1143,96516.5,381.0,381.0,0,0,0.0,0.0,0.0
108109581.0,17,5,955,5,955,27027395.25,191.0,191.0,0,0,0.0,0.0,0.0
0.0,17,1,350,1,350,0.0,350.0,350.0,0,0,0.0,0.0,0.0
231433.0,17,2,180,1,90,0.0,90.0,90.0,1,90,0.0,90.0,90.0
57910.0,6,14,4740,7,653,9472.0,249.0,93.28571428571428,7,4087,7930.0,1514.0,583.8571428571429
119706963.0,6,48,3168,24,1584,5204650.565217392,66.0,66.0,24,1584,5190977.217391305,66.0,66.0
37618.0,6,14,4740,7,653,6149.5,249.0,93.28571428571428,7,4087,6124.833333333333,1514.0,583.8571428571429
48976.0,6,14,4740,7,653,7926.833333333333,249.0,93.28571428571428,7,4087,7556.0,1514.0,583.8571428571429
853400.0,6,9,1196,6,725,170680.0,387.0,120.83333333333331,3,471,288906.0,331.0,157.0
5240.0,17,4,344,2,150,0.0,75.0,75.0,2,194,0.0,103.0,97.0
103421.0,17,2,286,2,286,0.0,143.0,143.0,0,0,0.0,0.0,0.0
90300847.0,17,12,778,6,389,18002105.8,174.0,64.83333333333333,6,389,18000156.2,174.0,64.83333333333333
47586.0,6,10,2032,5,524,11663.5,252.0,104.8,5,1508,11252.5,1236.0,301.6
104586792.0,6,44,2904,22,1452,4980323.428571428,66.0,66.0,22,1452,4967185.80952381,66.0,66.0
120333.0,17,2,180,1,70,0.0,70.0,70.0,1,110,0.0,110.0,110.0
82564.0,6,11,2098,6,590,16246.2,252.0,98.33333333333331,5,1508,19874.25,1236.0,301.6
10514196.0,6,7,478,4,272,3459263.0,74.0,68.0,3,206,5188791.5,74.0,68.66666666666667
241206.0,6,3,337,2,214,0.0,160.0,107.0,1,123,0.0,123.0,123.0
2079.0,17,4,344,2,150,0.0,75.0,75.0,2,194,0.0,103.0,97.0
305078.0,6,6,412,4,272,101692.66666666669,74.0,68.0,2,140,0.0,74.0,70.0
90886422.0,6,27,1938,14,1029,6974672.846153846,123.0,73.5,13,909,7555895.833333333,123.0,69.92307692307692
3205374.0,6,3,1777,2,951,0.0,885.0,475.5,1,826,0.0,826.0,826.0
16710.0,6,14,4740,7,653,2633.5,249.0,93.28571428571428,7,4087,2644.0,1514.0,583.8571428571429
83259.0,6,10,2032,5,524,19950.75,252.0,104.8,5,1508,10190.0,1236.0,301.6
129097.0,6,11,1132,6,556,25620.6,218.0,92.66666666666669,5,576,31989.25,304.0,115.2
103246.0,6,15,4806,8,719,14235.57142857143,249.0,89.875,7,4087,13723.5,1514.0,583.8571428571429
307264.0,6,6,412,4,272,102421.33333333331,74.0,68.0,2,140,0.0,74.0,70.0
861328.0,6,9,1096,6,625,172265.6,287.0,104.16666666666669,3,471,294390.0,331.0,157.0
2298.0,17,4,344,2,150,0.0,75.0,75.0,2,194,0.0,103.0,97.0
108583.0,17,2,286,2,286,0.0,143.0,143.0,0,0,0.0,0.0,0.0
45030848.0,6,7,1872,5,1052,11257712.0,784.0,210.4,2,820,0.0,752.0,410.0
60525.0,6,14,4740,7,653,9966.333333333334,249.0,93.28571428571428,7,4087,8562.166666666666,1514.0,583.8571428571429
302.0,17,2,156,1,78,0.0,78.0,78.0,1,78,0.0,78.0,78.0
291918.0,17,2,246,1,76,0.0,76.0,76.0,1,170,0.0,170.0,170.0
1839.0,17,4,344,2,150,0.0,75.0,75.0,2,194,0.0,103.0,97.0
97917.0,17,2,286,2,286,0.0,143.0,143.0,0,0,0.0,0.0,0.0
212529.0,17,2,180,1,90,0.0,90.0,90.0,1,90,0.0,90.0,90.0
29021.0,6,10,2032,5,524,7038.75,252.0,104.8,5,1508,5334.25,1236.0,301.6
302413.0,6,2,132,1,66,0.0,66.0,66.0,1,66,0.0,66.0,66.0
13983.0,6,11,1132,6,556,2663.0,218.0,92.66666666666669,5,576,3086.75,304.0,115.2
310801.0,6,5,337,2,163,0.0,97.0,81.5,3,174,155400.5,66.0,58.0
118889868.0,6,34,2334,17,1209,7430616.75,123.0,71.11764705882354,17,1125,7417136.375,123.0,66.17647058823529
160127.0,17,2,180,1,90,0.0,90.0,90.0,1,90,0.0,90.0,90.0
228472.0,17,2,180,1,90,0.0,90.0,90.0,1,90,0.0,90.0,90.0
111368.0,6,13,1513,7,882,18123.666666666668,291.0,126.0,6,631,21647.8,293.0,105.16666666666669
43175.0,6,10,2032,5,524,10550.0,252.0,104.8,5,1508,8489.0,1236.0,301.6
108101428.0,17,5,955,5,955,27025357.0,191.0,191.0,0,0,0.0,0.0,0.0
0.0,17,1,381,1,381,0.0,381.0,381.0,0,0,0.0,0.0,0.0
319671.0,6,6,412,4,272,106557.0,74.0,68.0,2,140,0.0,74.0,70.0
9500.0,6,10,659,5,328,2174.75,100.0,65.6,5,331,1752.5,103.0,66.2
174064.0,6,3,337,2,214,0.0,160.0,107.0,1,123,0.0,123.0,123.0
117044394.0,17,14,1126,7,563,19480770.33333333,174.0,80.42857142857143,7,563,19480775.83333333,174.0,80.42857142857143
19579.0,6,10,2032,5,524,4631.5,252.0,104.8,5,1508,4632.25,1236.0,301.6
216501.0,6,3,426,2,280,0.0,214.0,140.0,1,146,0.0,146.0,146.0
120000034.0,6,25,1924,14,1084,9230771.846153846,95.0,77.42857142857143,11,840,11981574.2,95.0,76.36363636363636
98428689.0,17,12,778,6,389,19600732.6,174.0,64.83333333333333,6,389,19600057.4,174.0,64.83333333333333
135139391.0,17,6,1206,6,1206,27027878.2,201.0,201.0,0,0,0.0,0.0,0.0
90041088.0,17,27,12943,27,12943,3463118.769230769,501.0,479.3703703703704,0,0,0.0,0.0,0.0
46128.0,6,13,1394,7,797,7688.0,253.0,113.85714285714286,6,597,7869.2,259.0,99.5
120094977.0,6,244,27854,122,8348,986783.214876033,140.0,68.42622950819673,122,19506,977340.429752066,284.0,159.88524590163934
2419.0,17,4,344,2,150,0.0,75.0,75.0,2,194,0.0,103.0,97.0
53258.0,6,14,4740,7,653,7682.0,249.0,93.28571428571428,7,4087,8255.333333333334,1514.0,583.8571428571429
258122.00000000003,6,10,1221,6,636,51624.4,298.0,106.0,4,585,80646.0,379.0,146.25
218436.0,6,3,426,2,280,0.0,214.0,140.0,1,146,0.0,146.0,146.0
90071352.0,17,28,13364,28,13364,3335976.0,501.0,477.2857142857143,0,0,0.0,0.0,0.0
104977476.0,17,15,5130,15,5130,7498391.142857143,342.0,342.0,0,0,0.0,0.0,0.0
108091.0,17,2,286,2,286,0.0,143.0,143.0,0,0,0.0,0.0,0.0
738.0,17,5,550,5,550,184.5,110.0,110.0,0,0,0.0,0.0,0.0
103333.0,17,2,286,2,286,0.0,143.0,143.0,0,0,0.0,0.0,0.0
90730159.0,6,24,1829,13,989,7557086.75,95.0,76.07692307692308,11,840,9046046.7,95.0,76.36363636363636
368.0,17,2,160,1,80,0.0,80.0,80.0,1,80,0.0,80.0,80.0
120237385.0,6,21,1585,10,786,13333196.555555556,95.0,78.6,11,799,12000006.4,95.0,72.63636363636364
102003.0,17,2,762,2,762,0.0,381.0,381.0,0,0,0.0,0.0,0.0
121477.0,6,3,337,2,214,0.0,160.0,107.0,1,123,0.0,123.0,123.0
302398.0,6,2,132,1,66,0.0,66.0,66.0,1,66,0.0,66.0,66.0
204960.0,17,2,180,1,90,0.0,90.0,90.0,1,90,0.0,90.0,90.0
123001137.0,17,15,1169,8,606,17571591.0,174.0,75.75,7,563,17167478.666666668,174.0,80.42857142857143
145047.0,17,2,180,1,70,0.0,70.0,70.0,1,110,0.0,110.0,110.0
135124271.0,17,6,1206,6,1206,27024854.2,201.0,201.0,0,0,0.0,0.0,0.0
103665.0,17,2,286,2,286,0.0,143.0,143.0,0,0,0.0,0.0,0.0
783.0,17,4,438,2,148,0.0,74.0,74.0,2,290,0.0,147.0,145.0
90050321.0,17,28,13364,28,13364,3335197.074074074,501.0,477.2857142857143,0,0,0.0,0.0,0.0
110411.0,17,2,700,2,700,0.0,350.0,350.0,0,0,0.0,0.0,0.0
142363.0,17,2,176,1,80,0.0,80.0,80.0,1,96,0.0,96.0,96.0
10468731.0,6,7,478,4,272,3444340.333333333,74.0,68.0,3,206,5166401.5,74.0,68.66666666666667
63434.00000000001,6,14,4740,7,653,10417.833333333334,249.0,93.28571428571428,7,4087,10110.666666666666,1514.0,583.8571428571429
57263.0,6,14,4740,7,653,8545.333333333334,249.0,93.28571428571428,7,4087,9027.666666666666,1514.0,583.8571428571429
76792.0,6,14,4740,7,653,12626.5,249.0,93.28571428571428,7,4087,11844.0,1514.0,583.8571428571429
46657.0,6,10,2032,5,524,10496.75,252.0,104.8,5,1508,10323.5,1236.0,301.6
2843318.0,6,3,1604,1,753,0.0,753.0,753.0,2,851,0.0,785.0,425.5
302399.0,6,6,412,4,272,100799.66666666669,74.0,68.0,2,140,0.0,74.0,70.0
147061.0,6,3,373,2,238,0.0,172.0,119.0,1,135,0.0,135.0,135.0
97408.0,17,2,762,2,762,0.0,381.0,381.0,0,0,0.0,0.0,0.0
16975.0,6,10,1067,5,536,2522.75,264.0,107.2,5,531,3980.0,259.0,106.2
103050.0,17,2,286,2,286,0.0,143.0,143.0,0,0,0.0,0.0,0.0
122919423.0,17,15,1038,8,606,17559917.57142857,174.0,75.75,7,432,17333499.333333332,174.0,61.71428571428572
108099328.0,17,5,1005,5,1005,27024832.0,201.0,201.0,0,0,0.0,0.0,0.0
106431360.0,17,14,864,7,432,17666827.666666668,174.0,61.71428571428572,7,432,17667418.0,174.0,61.71428571428572
319367.0,17,4,1400,4,1400,106455.66666666669,350.0,350.0,0,0,0.0,0.0,0.0
216862.0,17,2,180,1,90,0.0,90.0,90.0,1,90,0.0,90.0,90.0
108105643.0,17,5,955,5,955,27026410.75,191.0,191.0,0,0,0.0,0.0,0.0
153440.0,17,2,180,1,90,0.0,90.0,90.0,1,90,0.0,90.0,90.0
31362.0,6,14,4740,7,653,4458.666666666667,249.0,93.28571428571428,7,4087,5020.666666666667,1514.0,583.8571428571429
10462716.0,6,7,478,4,272,3442187.6666666665,74.0,68.0,3,206,5163189.5,74.0,68.66666666666667
2599188.0,6,2,132,1,66,0.0,66.0,66.0,1,66,0.0,66.0,66.0
0.0,17,1,55,1,55,0.0,55.0,55.0,0,0,0.0,0.0,0.0
308132.0,6,6,412,4,272,102710.66666666669,74.0,68.0,2,140,0.0,74.0,70.0
120649943.0,17,14,864,7,432,16834221.666666668,174.0,61.71428571428572,7,432,16833486.833333332,174.0,61.71428571428572
92008539.0,17,14,1126,7,563,15334756.5,174.0,80.42857142857143,7,563,15333466.833333334,174.0,80.42857142857143
221732.0,6,3,426,2,280,0.0,214.0,140.0,1,146,0.0,146.0,146.0
90286906.0,6,18,1470,9,650,11279579.75,95.0,72.22222222222223,9,820,11285493.125,224.0,91.11111111111111
90026359.0,17,28,13364,28,13364,3334309.592592593,501.0,477.2857142857143,0,0,0.0,0.0,0.0
115490629.0,6,33,2296,17,1225,7204671.5625,139.0,72.05882352941177,16,1071,7684985.4,123.0,66.9375
113560922.0,6,30,2106,15,1017,8111494.428571428,123.0,67.8,15,1089,7383671.5,123.0,72.6
104520938.0,17,15,5130,15,5130,7465781.285714285,342.0,342.0,0,0,0.0,0.0,0.0
537135.0,17,6,2100,6,2100,107427.0,350.0,350.0,0,0,0.0,0.0,0.0
114271591.0,6,48,3168,24,1584,4968330.043478261,66.0,66.0,24,1584,4954870.434782608,66.0,66.0
104498.0,6,15,4806,8,719,14823.857142857143,249.0,89.875,7,4087,16836.833333333332,1514.0,583.8571428571429
90259598.0,6,13,2036,8,1016,12894228.285714284,188.0,127.0,5,1020,22523719.0,204.0,204.0
35516.0,6,12,1320,6,723,6627.2,253.0,120.5,6,597,6284.0,259.0,99.5
146164.0,6,3,337,2,214,0.0,160.0,107.0,1,123,0.0,123.0,123.0
846511.0,6,9,1196,6,725,169302.2,387.0,120.83333333333331,3,471,285626.0,331.0,157.0
7846.000000000001,17,2,180,1,90,0.0,90.0,90.0,1,90,0.0,90.0,90.0
289.0,17,2,156,1,78,0.0,78.0,78.0,1,78,0.0,78.0,78.0
90368043.0,6,16,2384,8,1368,12909562.857142856,204.0,171.0,8,1016,12872598.857142856,188.0,127.0
90032415.0,17,28,13364,28,13364,3334533.888888889,501.0,477.2857142857143,0,0,0.0,0.0,0.0
256930.0,6,3,337,2,214,0.0,160.0,107.0,1,123,0.0,123.0,123.0
209431.0,17,2,180,1,90,0.0,90.0,90.0,1,90,0.0,90.0,90.0
101503.0,17,2,762,2,762,0.0,381.0,381.0,0,0,0.0,0.0,0.0
149399551.0,17,36,17126,36,17126,4268558.6,501.0,475.72222222222223,0,0,0.0,0.0,0.0
192399.0,17,2,180,1,90,0.0,90.0,90.0,1,90,0.0,90.0,90.0
76679.0,6,14,4740,7,653,12142.0,249.0,93.28571428571428,7,4087,12635.833333333334,1514.0,583.8571428571429
206897.0,6,3,426,2,280,0.0,214.0,140.0,1,146,0.0,146.0,146.0
56724.0,6,14,4740,7,653,8426.166666666666,249.0,93.28571428571428,7,4087,8778.833333333334,1514.0,583.8571428571429
1070314.0,6,3,204,2,136,0.0,70.0,68.0,1,68,0.0,68.0,68.0
218113.0,6,3,426,2,280,0.0,214.0,140.0,1,146,0.0,146.0,146.0
44939.0,6,14,4740,7,653,7193.666666666667,249.0,93.28571428571428,7,4087,6255.333333333333,1514.0,583.8571428571429
2062.0,17,4,344,2,150,0.0,75.0,75.0,2,194,0.0,103.0,97.0
0.0,6,1,172,1,172,0.0,172.0,172.0,0,0,0.0,0.0,0.0
298981.0,6,6,412,4,272,99660.33333333331,74.0,68.0,2,140,0.0,74.0,70.0
39868.0,6,14,4740,7,653,6521.5,249.0,93.28571428571428,7,4087,5628.666666666667,1514.0,583.8571428571429
205947.0,6,10,1221,6,636,41189.4,298.0,106.0,4,585,67364.0,379.0,146.25
2325.0,17,4,344,2,150,0.0,75.0,75.0,2,194,0.0,103.0,97.0
103435.0,17,2,286,2,286,0.0,143.0,143.0,0,0,0.0,0.0,0.0
3166820.0,6,18,1536,9,962,358101.0,315.0,106.88888888888889,9,574,358058.875,78.0,63.77777777777778
81440.0,6,13,1386,7,789,11824.833333333334,253.0,112.71428571428572,6,597,13539.2,259.0,99.5
107409160.0,6,240,27172,120,19030,900788.462184874,284.0,158.58333333333334,120,8142,900788.6050420168,140.0,67.85
146086.0,6,3,337,2,214,0.0,160.0,107.0,1,123,0.0,123.0,123.0
326159.0,17,4,1400,4,1400,108719.66666666669,350.0,350.0,0,0,0.0,0.0,0.0
90052956.0,17,28,13364,28,13364,3335294.6666666665,501.0,477.2857142857143,0,0,0.0,0.0,0.0
114308731.0,6,48,3168,24,1584,4969944.826086956,66.0,66.0,24,1584,4956474.565217392,66.0,66.0
1492035.0,6,2,132,1,66,0.0,66.0,66.0,1,66,0.0,66.0,66.0
90035709.0,17,28,13364,28,13364,3334655.888888889,501.0,477.2857142857143,0,0,0.0,0.0,0.0
99420511.0,17,14,1126,7,563,16500135.5,174.0,80.42857142857143,7,563,16500733.0,174.0,80.42857142857143
1947877.0,17,20,7488,20,7488,102519.84210526316,390.0,374.4,0,0,0.0,0.0,0.0
0.0,17,1,350,1,350,0.0,350.0,350.0,0,0,0.0,0.0,0.0
95774096.0,6,191,21492,96,6558,1008148.3789473684,140.0,68.3125,95,14934,1005943.829787234,284.0,157.2
153454.0,17,2,180,1,90,0.0,90.0,90.0,1,90,0.0,90.0,90.0
120003715.0,6,17,1287,9,691,15000464.375,95.0,76.77777777777777,8,596,12858723.857142856,95.0,74.5
1782.0,17,2,691,1,349,0.0,349.0,349.0,1,342,0.0,342.0,342.0
13457.0,6,13,1459,7,862,2242.833333333333,271.0,123.14285714285714,6,597,2417.2,259.0,99.5
152442.0,17,2,414,1,88,0.0,88.0,88.0,1,326,0.0,326.0,326.0
320428.0,17,4,1400,4,1400,106809.33333333331,350.0,350.0,0,0,0.0,0.0,0.0
40226.0,6,14,4740,7,653,6427.833333333333,249.0,93.28571428571428,7,4087,5795.833333333333,1514.0,583.8571428571429
502966.0,6,5,336,2,134,0.0,68.0,67.0,3,202,194895.5,70.0,67.33333333333333
124001393.0,17,15,907,8,475,17714484.714285713,174.0,59.375,7,432,17334280.166666668,174.0,61.71428571428572
2662354.0,6,3,1777,1,826,0.0,826.0,826.0,2,951,0.0,885.0,475.5
30122.0,6,14,4740,7,653,4896.666666666667,249.0,93.28571428571428,7,4087,4380.666666666667,1514.0,583.8571428571429
33433.0,6,10,2032,5,524,7966.0,252.0,104.8,5,1508,7465.25,1236.0,301.6
209630.0,17,2,180,1,90,0.0,90.0,90.0,1,90,0.0,90.0,90.0
3205.0,17,2,363,1,79,0.0,79.0,79.0,1,284,0.0,284.0,284.0
27442960.0,17,5,1710,5,1710,6860740.0,342.0,342.0,0,0,0.0,0.0,0.0
204492.0,17,2,762,2,762,0.0,381.0,381.0,0,0,0.0,0.0,0.0
311763.0,17,4,1400,4,1400,103921.0,350.0,350.0,0,0,0.0,0.0,0.0
90742013.0,6,19,1436,10,745,10077728.666666666,95.0,74.5,9,691,11341681.75,95.0,76.77777777777777
53131.0,6,14,4740,7,653,8736.333333333334,249.0,93.28571428571428,7,4087,7628.166666666667,1514.0,583.8571428571429
0.0,17,1,55,1,55,0.0,55.0,55.0,0,0,0.0,0.0,0.0
120000026.0,6,20,1531,11,840,12000002.6,95.0,76.36363636363636,9,691,11350912.625,95.0,76.77777777777777
44914.0,6,2,132,1,66,0.0,66.0,66.0,1,66,0.0,66.0,66.0
270287.0,17,2,180,1,90,0.0,90.0,90.0,1,90,0.0,90.0,90.0
1681968.0,17,18,1260,18,1260,98939.29411764706,70.0,70.0,0,0,0.0,0.0,0.0
90105449.0,6,13,1776,6,948,18020620.2,204.0,158.0,7,828,15017175.0,188.0,118.28571428571428
206292.0,17,2,762,2,762,0.0,381.0,381.0,0,0,0.0,0.0,0.0
107000866.0,17,13,821,7,432,17833477.666666668,174.0,61.71428571428572,6,389,17400906.6,174.0,64.83333333333333
90028119.0,17,27,12943,27,12943,3462619.961538461,501.0,479.3703703703704,0,0,0.0,0.0,0.0
92838260.0,6,319,38104,160,10782,583888.427672956,140.0,67.3875,159,27322,574534.4430379746,300.0,171.83647798742138
220578.0,6,3,426,2,280,0.0,214.0,140.0,1,146,0.0,146.0,146.0
2220.0,17,4,344,2,150,0.0,75.0,75.0,2,194,0.0,103.0,97.0
26254.0,6,13,1459,7,862,4135.0,271.0,123.14285714285714,6,597,4960.0,259.0,99.5
141478.0,6,2,132,1,66,0.0,66.0,66.0,1,66,0.0,66.0,66.0
197176.0,17,2,180,1,90,0.0,90.0,90.0,1,90,0.0,90.0,90.0
143958.0,17,2,180,1,90,0.0,90.0,90.0,1,90,0.0,90.0,90.0
107842.0,17,2,286,2,286,0.0,143.0,143.0,0,0,0.0,0.0,0.0
103645.0,17,2,286,2,286,0.0,143.0,143.0,0,0,0.0,0.0,0.0
38728.0,6,14,4740,7,653,6113.0,249.0,93.28571428571428,7,4087,6313.5,1514.0,583.8571428571429
2086696.0,6,19,6869,11,1567,208669.6,408.0,142.45454545454547,8,5302,234805.0,1514.0,662.75
20748.0,6,10,2032,5,524,4843.75,252.0,104.8,5,1508,4900.5,1236.0,301.6
46039.0,6,10,2032,5,524,8602.25,252.0,104.8,5,1508,8790.5,1236.0,301.6
102983817.0,6,42,2772,21,1386,5135433.15,66.0,66.0,21,1386,5135430.05,66.0,66.0
35499.0,6,10,2032,5,524,8643.25,252.0,104.8,5,1508,8050.5,1236.0,301.6
5544.0,17,4,823,2,163,0.0,89.0,81.5,2,660,0.0,443.0,330.0
36564.0,6,14,4740,7,653,5977.666666666667,249.0,93.28571428571428,7,4087,5928.0,1514.0,583.8571428571429
120029267.0,17,29,13785,29,13785,4286759.535714285,501.0,475.3448275862069,0,0,0.0,0.0,0.0
230648.0,17,4,1524,4,1524,76882.66666666667,381.0,381.0,0,0,0.0,0.0,0.0
121706.0,6,3,373,2,238,0.0,172.0,119.0,1,135,0.0,135.0,135.0
0.0,17,1,381,1,381,0.0,381.0,381.0,0,0,0.0,0.0,0.0
228237.0,17,2,180,1,90,0.0,90.0,90.0,1,90,0.0,90.0,90.0
10478021.0,6,6,412,3,206,5170918.5,74.0,68.66666666666667,3,206,5170773.5,74.0,68.66666666666667
103509.0,17,2,286,2,286,0.0,143.0,143.0,0,0,0.0,0.0,0.0
90298820.0,6,23,1734,13,989,7520782.583333333,95.0,76.07692307692308,10,745,10032262.0,95.0,74.5
2150.0,17,4,344,2,150,0.0,75.0,75.0,2,194,0.0,103.0,97.0
350.0,17,2,267,1,83,0.0,83.0,83.0,1,184,0.0,184.0,184.0
90028025.0,17,28,13364,28,13364,3334371.296296296,501.0,477.2857142857143,0,0,0.0,0.0,0.0
319091.0,6,6,412,4,272,106363.66666666669,74.0,68.0,2,140,0.0,74.0,70.0
257645.0,6,3,337,2,214,0.0,160.0,107.0,1,123,0.0,123.0,123.0
1869.0,17,2,180,1,90,0.0,90.0,90.0,1,90,0.0,90.0,90.0
125811334.0,6,59,12303,29,6411,3432748.035714286,1514.0,221.06896551724137,30,5892,4331262.344827586,1514.0,196.4
135131263.0,17,6,1206,6,1206,27026252.6,201.0,201.0,0,0,0.0,0.0,0.0
73127263.0,6,15,1036,9,599,9140907.875,95.0,66.55555555555556,6,437,9619361.8,95.0,72.83333333333333
282312.0,6,10,1221,6,636,56462.4,298.0,106.0,4,585,84630.33333333333,379.0,146.25
119172137.0,17,35,16705,35,16705,3505062.8529411764,501.0,477.2857142857143,0,0,0.0,0.0,0.0
0.0,6,1,66,0,0,0.0,0.0,0.0,1,66,0.0,66.0,66.0
103200220.0,6,42,2772,21,1386,5159998.35,66.0,66.0,21,1386,5159998.75,66.0,66.0
137684.0,17,4,344,2,150,0.0,75.0,75.0,2,194,0.0,103.0,97.0
79297.0,6,14,4740,7,653,11022.833333333334,249.0,93.28571428571428,7,4087,12528.5,1514.0,583.8571428571429
90026859.0,17,28,13364,28,13364,3334328.111111111,501.0,477.2857142857143,0,0,0.0,0.0,0.0
308247.0,6,6,412,4,272,102749.0,74.0,68.0,2,140,0.0,74.0,70.0
294493.0,6,6,412,4,272,98164.33333333331,74.0,68.0,2,140,0.0,74.0,70.0
28228.0,6,14,4740,7,653,4579.166666666667,249.0,93.28571428571428,7,4087,4246.333333333333,1514.0,583.8571428571429
484087.0,6,3,204,1,68,0.0,68.0,68.0,2,136,0.0,70.0,68.0
13065.0,6,10,2032,5,524,2791.0,252.0,104.8,5,1508,2670.5,1236.0,301.6
4373.0,17,2,626,1,72,0.0,72.0,72.0,1,554,0.0,554.0,554.0
135132577.0,17,6,1206,6,1206,27026515.4,201.0,201.0,0,0,0.0,0.0,0.0
295779.0,6,6,412,4,272,98593.0,74.0,68.0,2,140,0.0,74.0,70.0
298571.0,6,6,412,4,272,99523.66666666669,74.0,68.0,2,140,0.0,74.0,70.0
54303.0,6,14,4740,7,653,8927.666666666666,249.0,93.28571428571428,7,4087,8682.833333333334,1514.0,583.8571428571429
143922.0,17,2,180,1,90,0.0,90.0,90.0,1,90,0.0,90.0,90.0
103304.0,17,2,286,2,286,0.0,143.0,143.0,0,0,0.0,0.0,0.0
114539385.0,6,222,25100,111,17478,1039310.8363636364,300.0,157.45945945945945,111,7622,1039311.6454545456,140.0,68.66666666666667
325.0,17,2,152,1,76,0.0,76.0,76.0,1,76,0.0,76.0,76.0
207117.0,6,3,426,2,280,0.0,214.0,140.0,1,146,0.0,146.0,146.0
135122436.0,17,6,1206,6,1206,27024487.2,201.0,201.0,0,0,0.0,0.0,0.0
25231.0,6,10,2032,5,524,5009.5,252.0,104.8,5,1508,5953.75,1236.0,301.6
97723000.0,6,28,2008,14,1045,7517153.846153846,139.0,74.64285714285714,14,963,7500513.230769231,123.0,68.78571428571429
135136891.0,17,6,1206,6,1206,27027378.2,201.0,201.0,0,0,0.0,0.0,0.0
233717.0,6,3,337,2,214,0.0,160.0,107.0,1,123,0.0,123.0,123.0
2340.0,17,4,344,2,150,0.0,75.0,75.0,2,194,0.0,103.0,97.0
299950.0,6,6,412,4,272,99983.33333333331,74.0,68.0,2,140,0.0,74.0,70.0
135125017.0,17,6,1146,6,1146,27025003.4,191.0,191.0,0,0,0.0,0.0,0.0
6601.0,17,2,582,1,83,0.0,83.0,83.0,1,499,0.0,499.0,499.0
107889.0,17,2,286,2,286,0.0,143.0,143.0,0,0,0.0,0.0,0.0
107207846.0,6,27,1875,13,909,8933987.166666666,123.0,69.92307692307692,14,966,8229649.769230769,123.0,69.0
34376.0,6,10,2032,5,524,7781.25,252.0,104.8,5,1508,7909.0,1236.0,301.6
5647355.0,6,5,336,2,134,0.0,68.0,67.0,3,202,1436606.5,70.0,67.33333333333333
218170.0,6,3,426,2,280,0.0,214.0,140.0,1,146,0.0,146.0,146.0
197057.0,17,4,6056,4,6056,65685.66666666667,1514.0,1514.0,0,0,0.0,0.0,0.0
2052.0,17,4,344,2,150,0.0,75.0,75.0,2,194,0.0,103.0,97.0
2583228.0,6,25,7573,14,3735,198709.84615384616,1514.0,266.7857142857143,11,3838,231850.8,1514.0,348.90909090909093
92348119.0,6,26,1762,13,922,7677694.5,139.0,70.92307692307692,13,840,7677693.666666667,123.0,64.61538461538461
212509.0,6,10,1221,6,636,42501.8,298.0,106.0,4,585,69531.66666666667,379.0,146.25
1302530.0,6,4,264,2,132,0.0,66.0,66.0,2,132,0.0,66.0,66.0
3006432.0,6,12,2172,7,664,501008.6666666667,252.0,94.85714285714286,5,1508,1693.5,1236.0,301.6
3026513.0,6,157,112040,83,102619,36908.69512195122,1510.0,1236.3734939759036,74,9421,37136.16438356164,1510.0,127.3108108108108
15451.0,6,20,7606,11,978,1545.1,310.0,88.9090909090909,9,6628,1760.5,1514.0,736.4444444444445
298610.0,6,6,412,4,272,99536.66666666669,74.0,68.0,2,140,0.0,74.0,70.0
3073082.0,6,11,738,5,342,768012.75,95.0,68.4,6,396,612492.2,95.0,66.0
2513620.0,6,25,7573,14,3735,193355.38461538465,1514.0,266.7857142857143,11,3838,225582.3,1514.0,348.90909090909093
120124537.0,6,13,2036,8,1016,17137488.0,188.0,127.0,5,1020,22506295.25,204.0,204.0
113618060.0,6,46,3036,23,1518,5150439.0,66.0,66.0,23,1518,5150441.318181818,66.0,66.0
0.0,17,1,350,1,350,0.0,350.0,350.0,0,0,0.0,0.0,0.0
120292317.0,6,227,25706,114,18026,1064533.7787610618,284.0,158.12280701754386,113,7680,1064638.080357143,140.0,67.96460176991151
114936345.0,6,218,24714,109,7416,1056570.9814814816,140.0,68.03669724770643,109,17298,1048613.9259259258,284.0,158.69724770642202
56519.0,6,14,4740,7,653,8846.333333333334,249.0,93.28571428571428,7,4087,7896.0,1514.0,583.8571428571429
92359429.0,17,16,5472,16,5472,6157295.266666667,342.0,342.0,0,0,0.0,0.0,0.0
63157184.0,6,123,13832,62,4240,1035363.6721311476,140.0,68.38709677419355,61,9592,1037135.7,284.0,157.24590163934425
3054839.0,6,3,204,1,68,0.0,68.0,68.0,2,136,0.0,70.0,68.0
217863.0,6,3,426,2,280,0.0,214.0,140.0,1,146,0.0,146.0,146.0
319.0,17,2,174,1,79,0.0,79.0,79.0,1,95,0.0,95.0,95.0
217819.0,6,4,492,2,280,0.0,214.0,140.0,2,212,0.0,146.0,106.0
34548.0,6,14,4740,7,653,5488.666666666667,249.0,93.28571428571428,7,4087,4772.833333333333,1514.0,583.8571428571429
66468.0,17,2,180,1,90,0.0,90.0,90.0,1,90,0.0,90.0,90.0
314.0,17,2,174,1,79,0.0,79.0,79.0,1,95,0.0,95.0,95.0
341.0,17,2,267,1,83,0.0,83.0,83.0,1,184,0.0,184.0,184.0
112270009.0,6,38,2848,20,1531,5897582.578947368,139.0,76.55,18,1317,6591418.823529412,123.0,73.16666666666667
119842972.0,6,3228,2740844,1169,79670,102596.48715753424,214.0,68.15226689478186,2059,2661174,58223.30223517978,1514.0,1292.4594463331714
135144599.0,17,6,1206,6,1206,27028919.8,201.0,201.0,0,0,0.0,0.0,0.0
104127.0,17,2,286,2,286,0.0,143.0,143.0,0,0,0.0,0.0,0.0
107015.0,17,2,700,2,700,0.0,350.0,350.0,0,0,0.0,0.0,0.0
22997.0,6,11,1132,6,556,4599.4,218.0,92.66666666666669,5,576,4899.0,304.0,115.2
196858.0,17,2,180,1,90,0.0,90.0,90.0,1,90,0.0,90.0,90.0
135139037.0,17,6,1206,6,1206,27027807.4,201.0,201.0,0,0,0.0,0.0,0.0
112678.0,17,4,1400,4,1400,37559.333333333336,350.0,350.0,0,0,0.0,0.0,0.0
12079564.0,6,33,8878,17,4676,754972.75,1514.0,275.05882352941177,16,4202,600335.8666666667,1514.0,262.625
104312659.0,6,202,22870,101,15908,1040975.25,284.0,157.5049504950495,101,6962,1040974.88,140.0,68.93069306930693
103570.0,17,2,700,2,700,0.0,350.0,350.0,0,0,0.0,0.0,0.0
236663.0,17,2,180,1,90,0.0,90.0,90.0,1,90,0.0,90.0,90.0
111868.0,17,4,1400,4,1400,37289.333333333336,350.0,350.0,0,0,0.0,0.0,0.0
116094744.0,17,14,864,7,432,19333494.0,174.0,61.71428571428572,7,432,19334540.83333333,174.0,61.71428571428572
107478926.0,17,14,864,7,432,17833495.333333332,174.0,61.71428571428572,7,432,17834712.5,174.0,61.71428571428572
90009891.0,17,27,12943,27,12943,3461918.8846153845,501.0,479.3703703703704,0,0,0.0,0.0,0.0
149702009.0,17,36,17126,36,17126,4277200.257142857,501.0,475.72222222222223,0,0,0.0,0.0,0.0
54856.0,6,10,2032,5,524,13478.25,252.0,104.8,5,1508,12953.0,1236.0,301.6
109610.0,17,2,286,2,286,0.0,143.0,143.0,0,0,0.0,0.0,0.0
90029159.0,17,28,13364,28,13364,3334413.296296296,501.0,477.2857142857143,0,0,0.0,0.0,0.0
318307.0,6,6,412,4,272,106102.33333333331,74.0,68.0,2,140,0.0,74.0,70.0
108098070.0,17,5,955,5,955,27024517.5,191.0,191.0,0,0,0.0,0.0,0.0
91699722.0,6,29,2200,15,1168,6534544.642857143,139.0,77.86666666666666,14,1032,7037208.692307692,123.0,73.71428571428571
16894.0,6,13,1459,7,862,2607.333333333333,271.0,123.14285714285714,6,597,3080.8,259.0,99.5
1810361.0,6,23,6509,12,1529,161969.45454545456,357.0,127.41666666666669,11,4980,150831.4,1510.0,452.7272727272728
33706030.0,6,5,336,2,134,0.0,68.0,67.0,3,202,16782349.0,70.0,67.33333333333333
800.0,17,4,438,2,148,0.0,74.0,74.0,2,290,0.0,147.0,145.0
107397617.0,6,37,2926,20,1594,5640594.368421053,139.0,79.7,17,1332,6698206.1875,123.0,78.3529411764706
153517.0,17,2,180,1,90,0.0,90.0,90.0,1,90,0.0,90.0,90.0
207087.0,6,3,426,2,280,0.0,214.0,140.0,1,146,0.0,146.0,146.0
80771.0,6,14,4740,7,653,13338.0,249.0,93.28571428571428,7,4087,13284.166666666666,1514.0,583.8571428571429
337971.0,6,3,1604,2,851,0.0,785.0,425.5,1,753,0.0,753.0,753.0
2607.0,17,4,344,2,150,0.0,75.0,75.0,2,194,0.0,103.0,97.0
355.0,17,2,160,1,80,0.0,80.0,80.0,1,80,0.0,80.0,80.0
255098.0,6,3,337,2,214,0.0,160.0,107.0,1,123,0.0,123.0,123.0
546441.0,6,2,132,1,66,0.0,66.0,66.0,1,66,0.0,66.0,66.0
43741.0,6,11,1132,6,556,8748.2,218.0,92.66666666666669,5,576,10555.75,304.0,115.2
118708100.0,6,33,2274,17,1125,7419229.9375,123.0,66.17647058823529,16,1149,7248034.4,123.0,71.8125
307611.0,6,6,412,4,272,102537.0,74.0,68.0,2,140,0.0,74.0,70.0
1306773.0,6,4,264,2,132,0.0,66.0,66.0,2,132,0.0,66.0,66.0
135177.0,6,2,132,1,66,0.0,66.0,66.0,1,66,0.0,66.0,66.0
242836.0,6,3,337,2,214,0.0,160.0,107.0,1,123,0.0,123.0,123.0
90312217.0,6,16,1192,8,596,12894370.0,95.0,74.5,8,596,12900223.714285716,95.0,74.5
2393.0,17,4,344,2,150,0.0,75.0,75.0,2,194,0.0,103.0,97.0
203940.0,17,2,762,2,762,0.0,381.0,381.0,0,0,0.0,0.0,0.0
2308.0,17,4,344,2,150,0.0,75.0,75.0,2,194,0.0,103.0,97.0
121336.0,6,3,337,2,214,0.0,160.0,107.0,1,123,0.0,123.0,123.0
108100144.0,17,5,1005,5,1005,27025036.0,201.0,201.0,0,0,0.0,0.0,0.0
30877.0,6,11,2098,6,590,6045.8,252.0,98.33333333333331,5,1508,7445.5,1236.0,301.6
934.0,17,4,316,2,158,0.0,79.0,79.0,2,158,0.0,79.0,79.0
90022033.0,17,28,13364,28,13364,3334149.3703703703,501.0,477.2857142857143,0,0,0.0,0.0,0.0
245803.0,6,3,337,2,214,0.0,160.0,107.0,1,123,0.0,123.0,123.0
1288381.0,6,3,198,2,132,0.0,66.0,66.0,1,66,0.0,66.0,66.0
48562.0,6,10,2032,5,524,10016.75,252.0,104.8,5,1508,8590.75,1236.0,301.6
107160814.0,6,33,2296,17,1225,6684063.6875,139.0,72.05882352941177,16,1071,7129665.466666667,123.0,66.9375
41576.0,6,10,2032,5,524,10068.25,252.0,104.8,5,1508,10232.25,1236.0,301.6
108107747.0,17,5,1005,5,1005,27026936.75,201.0,201.0,0,0,0.0,0.0,0.0
24412.0,6,14,4740,7,653,3946.6666666666665,249.0,93.28571428571428,7,4087,3874.8333333333335,1514.0,583.8571428571429
6767.0,17,2,582,1,83,0.0,83.0,83.0,1,499,0.0,499.0,499.0
300837.0,6,7,478,4,272,100279.0,74.0,68.0,3,206,77595.5,74.0,68.66666666666667
873952.0,6,9,1268,6,797,174790.4,459.0,132.83333333333334,3,471,299161.5,331.0,157.0
90094645.0,6,13,2052,6,1224,18018450.4,204.0,204.0,7,828,15015315.333333334,188.0,118.28571428571428
123456070.0,6,49,3234,25,1650,5144002.916666667,66.0,66.0,24,1584,4981532.391304348,66.0,66.0
120058631.0,6,37,2650,19,1302,6669923.944444444,123.0,68.52631578947368,18,1348,7009563.764705882,139.0,74.88888888888889
330.0,17,2,166,1,75,0.0,75.0,75.0,1,91,0.0,91.0,91.0
31272.0,6,10,1065,5,534,7437.75,262.0,106.8,5,531,7310.75,259.0,106.2
156262.0,17,2,180,1,90,0.0,90.0,90.0,1,90,0.0,90.0,90.0
338.0,17,2,166,1,75,0.0,75.0,75.0,1,91,0.0,91.0,91.0
2902.0,17,4,344,2,150,0.0,75.0,75.0,2,194,0.0,103.0,97.0
300534.0,6,6,412,4,272,100178.0,74.0,68.0,2,140,0.0,74.0,70.0
283940.0,17,2,363,1,79,0.0,79.0,79.0,1,284,0.0,284.0,284.0
26357.0,6,10,2032,5,524,6195.0,252.0,104.8,5,1508,5635.0,1236.0,301.6
107001159.0,17,13,821,7,432,17833526.5,174.0,61.71428571428572,6,389,17402213.8,174.0,64.83333333333333
312.0,17,2,156,1,78,0.0,78.0,78.0,1,78,0.0,78.0,78.0
234470.0,6,3,337,2,214,0.0,160.0,107.0,1,123,0.0,123.0,123.0
870095.0,6,9,1118,6,586,174019.0,248.0,97.66666666666669,3,532,297215.5,392.0,177.33333333333334
47212.0,6,14,4740,7,653,6712.5,249.0,93.28571428571428,7,4087,7710.833333333333,1514.0,583.8571428571429
50181.0,6,2,132,1,66,0.0,66.0,66.0,1,66,0.0,66.0,66.0
29544715.0,6,26,7627,14,3735,186559.2307692308,1514.0,266.7857142857143,12,3892,2666248.272727273,1514.0,324.3333333333333
2063.0,17,4,344,2,150,0.0,75.0,75.0,2,194,0.0,103.0,97.0
1319437.0,6,7,499,4,301,428662.6666666667,103.0,75.25,3,198,612485.0,66.0,66.0
2381.0,17,4,344,2,150,0.0,75.0,75.0,2,194,0.0,103.0,97.0
1743279.0,6,14,856,6,388,286679.8,106.0,64.66666666666667,8,468,204738.8571428572,78.0,58.5
45405629.0,6,8,1940,3,887,22314737.0,753.0,295.6666666666667,5,1053,10658090.0,785.0,210.6
109977386.0,6,33,2412,17,1272,6860102.375,123.0,74.82352941176471,16,1140,7317441.6,123.0,71.25
37248.0,6,14,4740,7,653,5241.666666666667,249.0,93.28571428571428,7,4087,5494.5,1514.0,583.8571428571429
80492.0,6,14,4740,7,653,13099.833333333334,249.0,93.28571428571428,7,4087,13277.666666666666,1514.0,583.8571428571429
449838.0,6,3,204,2,136,0.0,70.0,68.0,1,68,0.0,68.0,68.0
322088.0,17,4,1400,4,1400,107362.66666666669,350.0,350.0,0,0,0.0,0.0,0.0
41889.0,6,14,4740,7,653,6458.833333333333,249.0,93.28571428571428,7,4087,6438.166666666667,1514.0,583.8571428571429
143970.0,17,2,180,1,90,0.0,90.0,90.0,1,90,0.0,90.0,90.0
20503.0,6,10,2032,5,524,4599.25,252.0,104.8,5,1508,4540.75,1236.0,301.6
185947.0,17,2,180,1,90,0.0,90.0,90.0,1,90,0.0,90.0,90.0
27484.0,6,10,2032,5,524,5973.75,252.0,104.8,5,1508,4595.0,1236.0,301.6
119937301.0,17,34,16284,34,16284,3634463.6666666665,501.0,478.9411764705882,0,0,0.0,0.0,0.0
160005.0,6,2,128,1,74,0.0,74.0,74.0,1,54,0.0,54.0,54.0
90023879.0,17,28,13364,28,13364,3334217.7407407407,501.0,477.2857142857143,0,0,0.0,0.0,0.0
1321241.0,6,4,264,2,132,0.0,66.0,66.0,2,132,0.0,66.0,66.0
209005.0,17,2,180,1,90,0.0,90.0,90.0,1,90,0.0,90.0,90.0
119695564.0,17,35,16705,35,16705,3520457.7647058824,501.0,477.2857142857143,0,0,0.0,0.0,0.0
91232790.0,6,25,1708,13,922,7584555.75,139.0,70.92307692307692,12,786,8274143.636363637,123.0,65.5
0.0,17,1,72,1,72,0.0,72.0,72.0,0,0,0.0,0.0,0.0
17290.0,6,14,4740,7,653,2393.5,249.0,93.28571428571428,7,4087,2665.0,1514.0,583.8571428571429
759.0,17,4,438,2,148,0.0,74.0,74.0,2,290,0.0,147.0,145.0
328166.0,6,6,412,4,272,109388.66666666669,74.0,68.0,2,140,0.0,74.0,70.0
135419.0,6,13,1394,7,797,22569.83333333333,253.0,113.85714285714286,6,597,24964.2,259.0,99.5
90099801.0,6,11,1644,4,816,30032497.666666668,204.0,204.0,7,828,15016251.333333334,188.0,118.28571428571428
2803205.0,6,2,132,1,66,0.0,66.0,66.0,1,66,0.0,66.0,66.0
109714965.0,6,32,2236,16,1165,7299930.8,139.0,72.8125,16,1071,7299927.8,123.0,66.9375
2037949.0,6,19,6869,11,1567,203794.9,408.0,142.45454545454547,8,5302,228091.8571428572,1514.0,662.75
8066.0,6,10,2032,5,524,1782.5,252.0,104.8,5,1508,1728.0,1236.0,301.6
284626.0,17,2,363,1,79,0.0,79.0,79.0,1,284,0.0,284.0,284.0
2420.0,17,4,344,2,150,0.0,75.0,75.0,2,194,0.0,103.0,97.0
270805.0,6,10,1221,6,636,54161.0,298.0,106.0,4,585,84909.33333333333,379.0,146.25
499117.0,6,3,1604,2,851,0.0,785.0,425.5,1,753,0.0,753.0,753.0
103247.0,17,2,286,2,286,0.0,143.0,143.0,0,0,0.0,0.0,0.0
2576773.0,6,2,132,1,66,0.0,66.0,66.0,1,66,0.0,66.0,66.0
147994.0,17,2,180,1,90,0.0,90.0,90.0,1,90,0.0,90.0,90.0
110105583.0,6,201,22794,101,6888,1101055.83,140.0,68.1980198019802,100,15906,1102185.383838384,300.0,159.06
21060676.0,6,4,264,2,132,0.0,66.0,66.0,2,132,0.0,66.0,66.0
680270.0,6,14,4740,7,653,113074.0,249.0,93.28571428571428,7,4087,112755.83333333331,1514.0,583.8571428571429
162318.0,17,2,180,1,90,0.0,90.0,90.0,1,90,0.0,90.0,90.0
422.0,17,2,410,1,78,0.0,78.0,78.0,1,332,0.0,332.0,332.0
3261996.0,6,144,124056,89,116124,37068.13636363636,1510.0,1304.7640449438202,55,7932,54738.22222222222,1510.0,144.21818181818182
63913.0,6,10,2032,5,524,15464.0,252.0,104.8,5,1508,14454.0,1236.0,301.6
745654.0,6,6,758,3,410,349250.0,172.0,136.66666666666666,3,348,256945.5,135.0,116.0
80357.0,6,14,4740,7,653,12620.333333333334,249.0,93.28571428571428,7,4087,11232.666666666666,1514.0,583.8571428571429
8379481.999999999,17,4,1376,3,1026,72704.0,342.0,342.0,1,350,0.0,350.0,350.0
3050685.0,6,3,204,2,136,0.0,70.0,68.0,1,68,0.0,68.0,68.0
2178945.0,6,3,1604,2,851,0.0,785.0,425.5,1,753,0.0,753.0,753.0
28124.0,6,14,4740,7,653,3941.5,249.0,93.28571428571428,7,4087,4522.666666666667,1514.0,583.8571428571429
10463653.0,6,6,412,3,206,5161189.5,74.0,68.66666666666667,3,206,5161074.0,74.0,68.66666666666667
120069538.0,17,29,13785,29,13785,4288197.785714285,501.0,475.3448275862069,0,0,0.0,0.0,0.0
118319087.0,6,221,25024,111,7622,1075628.0636363635,140.0,68.66666666666667,110,17402,1076004.623853211,284.0,158.2
105342768.0,6,194,22014,97,15390,1095078.0625,284.0,158.659793814433,97,6624,1095078.7291666667,140.0,68.28865979381443
121450557.0,6,227,25706,114,18026,1074783.6902654867,284.0,158.12280701754386,113,7680,1067234.5714285714,140.0,67.96460176991151
220379.0,17,2,180,1,90,0.0,90.0,90.0,1,90,0.0,90.0,90.0
153468.0,17,2,180,1,90,0.0,90.0,90.0,1,90,0.0,90.0,90.0
162262.0,17,2,180,1,90,0.0,90.0,90.0,1,90,0.0,90.0,90.0
197634.0,17,2,180,1,90,0.0,90.0,90.0,1,90,0.0,90.0,90.0
213349.0,6,12,1373,7,714,35558.166666666664,298.0,102.0,5,659,52376.25,379.0,131.8
101012531.0,17,14,864,7,432,16833497.166666668,174.0,61.71428571428572,7,432,16834484.666666668,174.0,61.71428571428572
58794149.0,17,9,3086,8,2736,5110110.0,342.0,342.0,1,350,0.0,350.0,350.0
312524.0,17,4,1400,4,1400,104174.66666666669,350.0,350.0,0,0,0.0,0.0,0.0
307154.0,6,6,412,4,272,102384.66666666669,74.0,68.0,2,140,0.0,74.0,70.0
2802354.0,6,2,132,1,66,0.0,66.0,66.0,1,66,0.0,66.0,66.0
92707868.0,6,37,2442,19,1254,5150437.111111111,66.0,66.0,18,1188,4936404.588235294,66.0,66.0
33929.0,6,14,4740,7,653,5518.833333333333,249.0,93.28571428571428,7,4087,5516.166666666667,1514.0,583.8571428571429
265870.0,6,3,337,2,214,0.0,160.0,107.0,1,123,0.0,123.0,123.0
313934.0,17,4,1400,4,1400,104644.66666666669,350.0,350.0,0,0,0.0,0.0,0.0
94583544.0,6,39,2574,19,1254,5143996.222222222,66.0,66.0,20,1320,4978064.684210527,66.0,66.0
74094.0,6,14,4740,7,653,11639.333333333334,249.0,93.28571428571428,7,4087,10934.833333333334,1514.0,583.8571428571429
100105479.0,6,27,1800,14,894,7700421.461538462,123.0,63.85714285714285,13,906,7492081.0,123.0,69.6923076923077
103073.0,17,2,286,2,286,0.0,143.0,143.0,0,0,0.0,0.0,0.0
103733.0,17,2,286,2,286,0.0,143.0,143.0,0,0,0.0,0.0,0.0
320649.0,17,4,1400,4,1400,106883.0,350.0,350.0,0,0,0.0,0.0,0.0
90750953.0,6,20,1531,11,840,9070648.1,95.0,76.36363636363636,9,691,11228844.0,95.0,76.77777777777777
103728.0,17,2,286,2,286,0.0,143.0,143.0,0,0,0.0,0.0,0.0
1236648.0,17,7,490,7,490,206108.0,70.0,70.0,0,0,0.0,0.0,0.0
90018504.0,6,180,20316,90,14154,1009025.7752808988,284.0,157.26666666666668,90,6162,1009025.2247191012,140.0,68.46666666666667
90061589.0,17,28,13364,28,13364,3335614.407407407,501.0,477.2857142857143,0,0,0.0,0.0,0.0
108102111.0,17,5,955,5,955,27025527.75,191.0,191.0,0,0,0.0,0.0,0.0
109516288.0,17,14,864,7,432,18168208.83333333,174.0,61.71428571428572,7,432,18166866.666666668,174.0,61.71428571428572
90019122.0,17,28,13364,28,13364,3334041.5555555555,501.0,477.2857142857143,0,0,0.0,0.0,0.0
204980.0,17,2,762,2,762,0.0,381.0,381.0,0,0,0.0,0.0,0.0
90853385.0,6,169,19168,85,5844,1081587.9166666667,140.0,68.75294117647059,84,13324,1082059.3493975904,300.0,158.61904761904762
300544.0,6,6,412,4,272,100181.33333333331,74.0,68.0,2,140,0.0,74.0,70.0
69084.0,6,10,2032,5,524,11960.5,252.0,104.8,5,1508,16878.75,1236.0,301.6
120000038.0,6,28,2168,16,1233,8000002.533333333,95.0,77.0625,12,935,8395981.818181818,95.0,77.91666666666667
108108836.0,17,5,955,5,955,27027209.0,191.0,191.0,0,0,0.0,0.0,0.0
160639.0,17,2,180,1,90,0.0,90.0,90.0,1,90,0.0,90.0,90.0
44552.0,6,14,4740,7,653,4434.0,249.0,93.28571428571428,7,4087,7301.5,1514.0,583.8571428571429
302253.0,6,6,412,4,272,100751.0,74.0,68.0,2,140,0.0,74.0,70.0
2490508.0,6,4,1670,2,851,0.0,785.0,425.5,2,819,0.0,753.0,409.5
14983.0,6,14,4740,7,653,2354.6666666666665,249.0,93.28571428571428,7,4087,2360.6666666666665,1514.0,583.8571428571429
49979.0,6,12,1320,6,723,8609.4,253.0,120.5,6,597,7549.8,259.0,99.5
24360.0,6,13,1459,7,862,3874.1666666666665,271.0,123.14285714285714,6,597,4718.8,259.0,99.5
1179825.0,6,13,3000,8,2372,168546.42857142858,1514.0,296.5,5,628,226033.5,331.0,125.6
60269.0,6,14,4740,7,653,9674.833333333334,249.0,93.28571428571428,7,4087,9672.5,1514.0,583.8571428571429
71394.0,6,14,4740,7,653,10667.5,249.0,93.28571428571428,7,4087,11658.0,1514.0,583.8571428571429
308917.0,6,6,412,4,272,102972.33333333331,74.0,68.0,2,140,0.0,74.0,70.0
159282.0,6,3,337,2,214,0.0,160.0,107.0,1,123,0.0,123.0,123.0
106849706.0,6,44,2904,22,1452,5088081.238095238,66.0,66.0,22,1452,5073548.476190476,66.0,66.0
194182.0,6,4,391,2,214,0.0,160.0,107.0,2,177,0.0,123.0,88.5
17109.0,6,10,1066,5,490,3698.25,218.0,98.0,5,576,3788.25,304.0,115.2
144071.0,17,2,180,1,90,0.0,90.0,90.0,1,90,0.0,90.0,90.0
108102063.0,17,5,1005,5,1005,27025515.75,201.0,201.0,0,0,0.0,0.0,0.0
303815.0,6,6,412,4,272,101271.66666666669,74.0,68.0,2,140,0.0,74.0,70.0
337.0,17,2,166,1,75,0.0,75.0,75.0,1,91,0.0,91.0,91.0
162342.0,17,4,1524,4,1524,54114.0,381.0,381.0,0,0,0.0,0.0,0.0
22017.0,17,2,582,1,83,0.0,83.0,83.0,1,499,0.0,499.0,499.0
197934.0,17,2,180,1,90,0.0,90.0,90.0,1,90,0.0,90.0,90.0
418.0,17,2,410,1,78,0.0,78.0,78.0,1,332,0.0,332.0,332.0
118839158.0,6,18,1341,9,691,14822409.75,95.0,76.77777777777777,9,650,14826553.75,95.0,72.22222222222223
120015213.0,17,28,13364,28,13364,4445007.888888889,501.0,477.2857142857143,0,0,0.0,0.0,0.0
115229402.0,6,48,3168,24,1584,5009974.0,66.0,66.0,24,1584,4996300.826086956,66.0,66.0
90049220.0,17,28,13364,28,13364,3335156.296296296,501.0,477.2857142857143,0,0,0.0,0.0,0.0
51045.0,17,2,180,1,90,0.0,90.0,90.0,1,90,0.0,90.0,90.0
1019439.0,6,11,1134,6,558,203887.8,220.0,93.0,5,576,254344.25,304.0,115.2
202802.0,6,14,4740,7,653,28940.666666666668,249.0,93.28571428571428,7,4087,31562.33333333333,1514.0,583.8571428571429
302366.0,6,2,132,1,66,0.0,66.0,66.0,1,66,0.0,66.0,66.0
148387.0,17,2,414,1,88,0.0,88.0,88.0,1,326,0.0,326.0,326.0
298464.0,6,6,412,4,272,99488.0,74.0,68.0,2,140,0.0,74.0,70.0
209647.0,17,2,180,1,90,0.0,90.0,90.0,1,90,0.0,90.0,90.0
407.0,17,2,410,1,78,0.0,78.0,78.0,1,332,0.0,332.0,332.0
3008300.0,6,12,2172,7,664,500873.3333333333,252.0,94.85714285714286,5,1508,2762.75,1236.0,301.6
284739.0,17,2,414,1,88,0.0,88.0,88.0,1,326,0.0,326.0,326.0
853.0,17,5,550,5,550,213.25,110.0,110.0,0,0,0.0,0.0,0.0
92284919.0,17,16,5472,16,5472,6152327.933333334,342.0,342.0,0,0,0.0,0.0,0.0
2576560.0,6,2,132,1,66,0.0,66.0,66.0,1,66,0.0,66.0,66.0
34083259.0,6,22,4255,12,3360,202484.45454545456,1514.0,280.0,10,895,3763020.0,219.0,89.5
75110869.0,6,9,842,9,842,9388858.625,97.0,93.55555555555556,0,0,0.0,0.0,0.0
65099.00000000001,6,14,4740,7,653,10517.833333333334,249.0,93.28571428571428,7,4087,10679.833333333334,1514.0,583.8571428571429
2259.0,17,4,344,2,150,0.0,75.0,75.0,2,194,0.0,103.0,97.0
1447180.0,6,7,499,4,301,469201.3333333333,103.0,75.25,3,198,715974.0,66.0,66.0
2793617.0,6,2,132,1,66,0.0,66.0,66.0,1,66,0.0,66.0,66.0
45081.0,6,2,132,1,66,0.0,66.0,66.0,1,66,0.0,66.0,66.0
1207.0,17,4,438,2,148,0.0,74.0,74.0,2,290,0.0,147.0,145.0
172810.0,6,3,337,2,214,0.0,160.0,107.0,1,123,0.0,123.0,123.0
2791657.0,6,2,132,1,66,0.0,66.0,66.0,1,66,0.0,66.0,66.0
128135.0,17,2,180,1,70,0.0,70.0,70.0,1,110,0.0,110.0,110.0
100107094.0,17,14,1126,7,563,16667550.666666666,174.0,80.42857142857143,7,563,16666809.0,174.0,80.42857142857143
305707.0,6,2,1536,1,784,0.0,784.0,784.0,1,752,0.0,752.0,752.0
52326.0,6,14,4740,7,653,8591.0,249.0,93.28571428571428,7,4087,8521.833333333334,1514.0,583.8571428571429
144012.0,17,2,180,1,90,0.0,90.0,90.0,1,90,0.0,90.0,90.0
2299.0,17,4,344,2,150,0.0,75.0,75.0,2,194,0.0,103.0,97.0
6694.0,17,2,180,1,90,0.0,90.0,90.0,1,90,0.0,90.0,90.0
96104965.0,6,61,12487,30,6545,3313964.310344828,1514.0,218.16666666666663,31,5942,3194802.833333333,1514.0,191.67741935483872
90265386.0,6,12,1832,8,1016,12895055.142857144,188.0,127.0,4,816,30030895.666666668,204.0,204.0
303133.0,6,2,132,1,66,0.0,66.0,66.0,1,66,0.0,66.0,66.0
108106889.0,17,5,1005,5,1005,27026722.25,201.0,201.0,0,0,0.0,0.0,0.0
32939.0,6,10,2032,5,524,8001.5,252.0,104.8,5,1508,7624.75,1236.0,301.6
110145378.0,6,32,2236,16,1165,7343025.2,139.0,72.8125,16,1071,7328587.2,123.0,66.9375
3040.0,17,2,224,1,76,0.0,76.0,76.0,1,148,0.0,148.0,148.0
120100120.0,6,53,4504,24,2055,5221744.347826087,123.0,85.625,29,2449,4281516.428571428,139.0,84.44827586206897
120127394.0,6,13,2036,5,1020,30031848.5,204.0,204.0,8,1016,17137275.0,188.0,127.0
147986.0,17,2,180,1,90,0.0,90.0,90.0,1,90,0.0,90.0,90.0
45859.0,6,14,4740,7,653,7524.0,249.0,93.28571428571428,7,4087,7503.0,1514.0,583.8571428571429
31181.0,6,14,4740,7,653,4220.666666666667,249.0,93.28571428571428,7,4087,4973.5,1514.0,583.8571428571429
18340.0,6,14,4740,7,653,2866.6666666666665,249.0,93.28571428571428,7,4087,2916.0,1514.0,583.8571428571429
2027.0,17,4,344,2,150,0.0,75.0,75.0,2,194,0.0,103.0,97.0
55182.0,6,10,2032,5,524,7695.75,252.0,104.8,5,1508,13574.25,1236.0,301.6
3339806.0,6,155,124182,88,115118,38388.57471264368,1510.0,1308.159090909091,67,9064,45850.606060606064,1510.0,135.28358208955223
206325.0,6,3,426,2,280,0.0,214.0,140.0,1,146,0.0,146.0,146.0
102402.0,6,12,1328,6,731,13433.2,253.0,121.83333333333331,6,597,19167.4,259.0,99.5
93589795.0,6,176,19904,88,13948,1073270.7816091955,284.0,158.5,88,5956,1073268.4367816092,140.0,67.68181818181819
315.0,17,2,168,1,76,0.0,76.0,76.0,1,92,0.0,92.0,92.0
90254730.0,6,14,2240,8,1016,12893532.857142856,188.0,127.0,6,1224,18018703.8,204.0,204.0
310074.0,6,6,412,4,272,103358.0,74.0,68.0,2,140,0.0,74.0,70.0
322375.0,17,4,1400,4,1400,107458.33333333331,350.0,350.0,0,0,0.0,0.0,0.0
361.0,17,2,267,1,83,0.0,83.0,83.0,1,184,0.0,184.0,184.0
458.0,17,2,762,2,762,0.0,381.0,381.0,0,0,0.0,0.0,0.0
14348.0,6,10,2032,5,524,3246.0,252.0,104.8,5,1508,3135.5,1236.0,301.6
341.0,17,2,267,1,83,0.0,83.0,83.0,1,184,0.0,184.0,184.0
135128189.0,17,6,1206,6,1206,27025637.8,201.0,201.0,0,0,0.0,0.0,0.0
92289304.0,17,12,778,6,389,18401435.2,174.0,64.83333333333333,6,389,18400178.2,174.0,64.83333333333333
90527984.0,6,13,2036,8,1016,12932569.142857144,188.0,127.0,5,1020,22591781.75,204.0,204.0
755721.0,6,2,132,1,66,0.0,66.0,66.0,1,66,0.0,66.0,66.0
3166143.0,6,18,1495,9,921,358380.125,315.0,102.33333333333331,9,574,358346.75,78.0,63.77777777777778
215482.0,6,10,1221,6,636,43096.4,298.0,106.0,4,585,70551.0,379.0,146.25
90533395.0,6,14,2240,8,1016,12933342.142857144,188.0,127.0,6,1224,18074454.8,204.0,204.0
120160518.0,17,13,821,7,432,20026753.0,174.0,61.71428571428572,6,389,20007983.4,174.0,64.83333333333333
10462357.0,6,7,478,4,272,3440161.0,74.0,68.0,3,206,5160119.0,74.0,68.66666666666667
205984.0,17,2,762,2,762,0.0,381.0,381.0,0,0,0.0,0.0,0.0
9406.0,17,2,582,1,83,0.0,83.0,83.0,1,499,0.0,499.0,499.0
104386351.0,6,30,2122,15,1105,7440750.785714285,139.0,73.66666666666667,15,1017,7440749.142857143,123.0,67.8
29725.0,6,13,4412,6,409,5763.6,127.0,68.16666666666667,7,4003,4615.166666666667,1514.0,571.8571428571429
1349718.0,17,6,1230,3,234,674668.0,78.0,78.0,3,996,674649.5,332.0,332.0
284135.0,17,2,363,1,79,0.0,79.0,79.0,1,284,0.0,284.0,284.0
38100.0,6,10,2032,5,524,8613.25,252.0,104.8,5,1508,9280.25,1236.0,301.6
90018785.0,17,28,13364,28,13364,3334029.074074074,501.0,477.2857142857143,0,0,0.0,0.0,0.0
302445.0,6,2,132,1,66,0.0,66.0,66.0,1,66,0.0,66.0,66.0
55501.0,6,14,4740,7,653,7375.333333333333,249.0,93.28571428571428,7,4087,7743.166666666667,1514.0,583.8571428571429
43322.0,6,14,4740,7,653,6971.0,249.0,93.28571428571428,7,4087,7082.5,1514.0,583.8571428571429
90025291.0,17,28,13364,28,13364,3334270.037037037,501.0,477.2857142857143,0,0,0.0,0.0,0.0
209162.0,6,3,426,2,280,0.0,214.0,140.0,1,146,0.0,146.0,146.0
117539603.0,6,48,3168,24,1584,5110417.521739131,66.0,66.0,24,1584,5101021.0,66.0,66.0
10421466.0,6,7,478,4,272,3428105.6666666665,74.0,68.0,3,206,5142021.0,74.0,68.66666666666667
316257.0,6,6,412,4,272,105419.0,74.0,68.0,2,140,0.0,74.0,70.0
302932.0,6,6,412,4,272,100977.33333333331,74.0,68.0,2,140,0.0,74.0,70.0
167715.0,17,4,1400,4,1400,55905.0,350.0,350.0,0,0,0.0,0.0,0.0
6094638.0,17,6,2100,6,2100,1218927.6,350.0,350.0,0,0,0.0,0.0,0.0
25349.0,6,11,2098,6,590,4850.4,252.0,98.33333333333331,5,1508,6071.0,1236.0,301.6
121460.0,6,3,337,2,214,0.0,160.0,107.0,1,123,0.0,123.0,123.0
90304567.0,6,16,1192,8,596,12893864.42857143,95.0,74.5,8,596,12899844.142857144,95.0,74.5
102773.0,17,2,286,2,286,0.0,143.0,143.0,0,0,0.0,0.0,0.0
27533301.0,6,26,7627,14,3735,202164.2307692308,1514.0,266.7857142857143,12,3892,2484426.363636364,1514.0,324.3333333333333
50895.0,17,2,180,1,90,0.0,90.0,90.0,1,90,0.0,90.0,90.0
203589.0,17,2,762,2,762,0.0,381.0,381.0,0,0,0.0,0.0,0.0
232359.0,6,3,337,2,214,0.0,160.0,107.0,1,123,0.0,123.0,123.0
10771.0,6,10,1067,5,536,2530.5,264.0,107.2,5,531,2059.25,259.0,106.2
237472.0,17,2,180,1,90,0.0,90.0,90.0,1,90,0.0,90.0,90.0
123731957.0,6,49,3234,25,1650,5155498.208333333,66.0,66.0,24,1584,5173193.782608695,66.0,66.0
41809.0,6,14,4740,7,653,6055.833333333333,249.0,93.28571428571428,7,4087,6289.5,1514.0,583.8571428571429
232285.0,6,3,337,2,214,0.0,160.0,107.0,1,123,0.0,123.0,123.0
2007.0,17,4,344,2,150,0.0,75.0,75.0,2,194,0.0,103.0,97.0
108415500.0,6,31,2182,16,1165,7213310.066666666,139.0,72.8125,15,1017,7728542.928571428,123.0,67.8
2281.0,17,4,344,2,150,0.0,75.0,75.0,2,194,0.0,103.0,97.0
52272.0,6,10,2032,5,524,12856.75,252.0,104.8,5,1508,8471.25,1236.0,301.6
217299.0,17,2,180,1,90,0.0,90.0,90.0,1,90,0.0,90.0,90.0
120053534.0,17,28,13364,28,13364,4446427.185185186,501.0,477.2857142857143,0,0,0.0,0.0,0.0
120559421.0,6,32,2299,16,1071,7486578.4,123.0,66.9375,16,1228,7527607.533333333,139.0,76.75
90309925.0,6,16,1192,8,596,12894461.0,95.0,74.5,8,596,12900961.285714284,95.0,74.5
248149.0,6,3,337,2,214,0.0,160.0,107.0,1,123,0.0,123.0,123.0
298356.0,6,6,412,4,272,99452.0,74.0,68.0,2,140,0.0,74.0,70.0
301486.0,6,6,412,4,272,100495.33333333331,74.0,68.0,2,140,0.0,74.0,70.0
105233635.0,17,13,821,7,432,17538939.166666668,174.0,61.71428571428572,6,389,17125553.8,174.0,64.83333333333333
123610643.0,6,49,3234,25,1650,5150443.458333333,66.0,66.0,24,1584,4995954.043478261,66.0,66.0
344.0,17,2,250,1,93,0.0,93.0,93.0,1,157,0.0,157.0,157.0
2402.0,17,4,344,2,150,0.0,75.0,75.0,2,194,0.0,103.0,97.0
115818351.0,6,48,3168,24,1584,5035580.478260869,66.0,66.0,24,1584,5021910.173913044,66.0,66.0
103108512.0,6,41,2706,21,1386,5155425.6,66.0,66.0,20,1320,5204072.368421053,66.0,66.0
256427.00000000003,6,3,337,2,214,0.0,160.0,107.0,1,123,0.0,123.0,123.0
149703.0,17,2,180,1,90,0.0,90.0,90.0,1,90,0.0,90.0,90.0
155396.0,17,4,6056,4,6056,51798.66666666666,1514.0,1514.0,0,0,0.0,0.0,0.0
5722448.0,6,4,270,2,134,0.0,68.0,67.0,2,136,0.0,70.0,68.0
16031.0,6,14,4740,7,653,2501.0,249.0,93.28571428571428,7,4087,2505.0,1514.0,583.8571428571429
505065.0,6,5,336,2,134,0.0,68.0,67.0,3,202,191827.0,70.0,67.33333333333333
206892.0,6,3,426,2,280,0.0,214.0,140.0,1,146,0.0,146.0,146.0
2194301.0,6,20,6935,11,1567,219430.1,408.0,142.45454545454547,9,5368,230983.0,1514.0,596.4444444444445
103228.0,17,2,286,2,286,0.0,143.0,143.0,0,0,0.0,0.0,0.0
118461481.0,6,238,26866,119,18716,1002087.4237288137,284.0,157.27731092436974,119,8150,1002087.3898305084,140.0,68.4873949579832
14639879.0,6,20,1648,10,1016,1592791.4444444445,315.0,101.6,10,632,1592672.3333333333,78.0,63.2
90294106.0,6,19,1436,10,745,10027375.333333334,95.0,74.5,9,691,11286458.75,95.0,76.77777777777777
264965.0,6,10,1221,6,636,52993.0,298.0,106.0,4,585,82714.33333333333,379.0,146.25
97277345.0,6,438,70860,220,14816,444188.7899543379,214.0,67.34545454545454,218,56044,447207.6267281106,1514.0,257.08256880733944
113619195.0,6,46,3036,23,1518,5150447.227272728,66.0,66.0,23,1518,5150452.454545454,66.0,66.0
6581.0,17,2,762,2,762,0.0,381.0,381.0,0,0,0.0,0.0,0.0
5576.0,17,2,180,1,90,0.0,90.0,90.0,1,90,0.0,90.0,90.0
3106735.0,6,3,1604,2,851,0.0,785.0,425.5,1,753,0.0,753.0,753.0
217857.0,6,3,426,2,280,0.0,214.0,140.0,1,146,0.0,146.0,146.0
120500.0,6,3,337,2,214,0.0,160.0,107.0,1,123,0.0,123.0,123.0
5552.0,17,2,180,1,90,0.0,90.0,90.0,1,90,0.0,90.0,90.0
165778.0,17,2,414,1,88,0.0,88.0,88.0,1,326,0.0,326.0,326.0
297640.0,6,6,412,4,272,99213.33333333331,74.0,68.0,2,140,0.0,74.0,70.0
1310978.0,6,4,264,2,132,0.0,66.0,66.0,2,132,0.0,66.0,66.0
50716.0,6,14,4740,7,653,8019.333333333333,249.0,93.28571428571428,7,4087,7981.833333333333,1514.0,583.8571428571429
79494.0,6,12,1328,6,731,15128.8,253.0,121.83333333333331,6,597,15222.0,259.0,99.5
215437.0,6,12,1373,7,714,35906.166666666664,298.0,102.0,5,659,53041.75,379.0,131.8
47819.0,6,14,4740,7,653,7581.0,249.0,93.28571428571428,7,4087,7779.666666666667,1514.0,583.8571428571429
135128594.0,17,6,1146,6,1146,27025718.8,191.0,191.0,0,0,0.0,0.0,0.0
143893.0,17,2,180,1,90,0.0,90.0,90.0,1,90,0.0,90.0,90.0
122358120.0,6,33,2359,16,1071,7644801.2,123.0,66.9375,17,1288,7438348.25,139.0,75.76470588235294
9109.0,6,10,2032,5,524,2046.25,252.0,104.8,5,1508,1937.75,1236.0,301.6
2044.0,17,4,344,2,150,0.0,75.0,75.0,2,194,0.0,103.0,97.0
111028.0,6,12,1328,7,797,18504.666666666668,253.0,113.85714285714286,5,531,26075.25,259.0,106.2
143852.0,17,2,180,1,90,0.0,90.0,90.0,1,90,0.0,90.0,90.0
1174561.0,6,13,3020,8,2392,167794.42857142858,1514.0,299.0,5,628,224700.0,331.0,125.6
41254.0,6,2,132,1,66,0.0,66.0,66.0,1,66,0.0,66.0,66.0
228206.0,17,2,180,1,90,0.0,90.0,90.0,1,90,0.0,90.0,90.0
122496.0,6,3,373,2,238,0.0,172.0,119.0,1,135,0.0,135.0,135.0
7133455.0,17,6,1423,3,273,3562160.0,103.0,91.0,3,1150,3562223.5,449.0,383.3333333333333
110254.0,6,15,4806,8,719,15596.285714285714,249.0,89.875,7,4087,17475.5,1514.0,583.8571428571429
0.0,6,1,66,1,66,0.0,66.0,66.0,0,0,0.0,0.0,0.0
27295.0,6,10,2032,5,524,5981.0,252.0,104.8,5,1508,6187.0,1236.0,301.6
52167.0,6,14,4740,7,653,8141.166666666667,249.0,93.28571428571428,7,4087,8355.833333333334,1514.0,583.8571428571429
147257.0,17,4,1400,4,1400,49085.66666666666,350.0,350.0,0,0,0.0,0.0,0.0
31162029.0,17,8,12112,8,12112,4451718.428571428,1514.0,1514.0,0,0,0.0,0.0,0.0
151618.0,17,2,414,1,88,0.0,88.0,88.0,1,326,0.0,326.0,326.0
244345.0,6,3,337,2,214,0.0,160.0,107.0,1,123,0.0,123.0,123.0
4294.0,17,2,598,1,72,0.0,72.0,72.0,1,526,0.0,526.0,526.0
297896.0,6,6,412,4,272,99298.66666666669,74.0,68.0,2,140,0.0,74.0,70.0
9096.0,17,2,582,1,83,0.0,83.0,83.0,1,499,0.0,499.0,499.0
26712.0,6,14,4740,7,653,3983.8333333333335,249.0,93.28571428571428,7,4087,4299.166666666667,1514.0,583.8571428571429
882792.0,6,10,1336,6,799,176558.4,461.0,133.16666666666666,4,537,202413.3333333333,331.0,134.25
90025598.0,17,28,13364,28,13364,3334281.407407407,501.0,477.2857142857143,0,0,0.0,0.0,0.0
90034585.0,17,28,13364,28,13364,3334614.25925926,501.0,477.2857142857143,0,0,0.0,0.0,0.0
2481.0,17,4,344,2,150,0.0,75.0,75.0,2,194,0.0,103.0,97.0
140590.0,6,2,132,1,66,0.0,66.0,66.0,1,66,0.0,66.0,66.0
13617.0,6,13,1459,7,862,2063.333333333333,271.0,123.14285714285714,6,597,2432.8,259.0,99.5
14914.0,17,2,180,1,90,0.0,90.0,90.0,1,90,0.0,90.0,90.0
1762412.0,17,6,1230,3,234,881029.5,78.0,78.0,3,996,880998.0,332.0,332.0
100068190.0,17,12,778,6,389,20013638.0,174.0,64.83333333333333,6,389,19938134.4,174.0,64.83333333333333
114061680.0,6,48,3168,24,1584,4959203.478260869,66.0,66.0,24,1584,4947219.956521739,66.0,66.0
23224.0,6,10,2032,5,524,4473.25,252.0,104.8,5,1508,4962.75,1236.0,301.6
214665.0,6,10,1221,6,636,42933.0,298.0,106.0,4,585,70170.33333333333,379.0,146.25
108135069.0,17,5,1005,5,1005,27033767.25,201.0,201.0,0,0,0.0,0.0,0.0
120005164.0,6,29,2263,16,1274,7999993.0,95.0,79.625,13,989,9919903.083333334,95.0,76.07692307692308
35006.0,6,10,2032,5,524,8511.75,252.0,104.8,5,1508,8457.5,1236.0,301.6
3333.0,17,2,359,1,75,0.0,75.0,75.0,1,284,0.0,284.0,284.0
120120534.0,6,12,1832,8,1016,17136991.714285713,188.0,127.0,4,816,30030703.666666668,204.0,204.0
785.0,17,4,438,2,148,0.0,74.0,74.0,2,290,0.0,147.0,145.0
197908.0,17,2,180,1,90,0.0,90.0,90.0,1,90,0.0,90.0,90.0
2080871.0,6,18,6803,10,1501,231207.88888888888,408.0,150.1,8,5302,235175.14285714287,1514.0,662.75
146959.0,6,3,373,2,238,0.0,172.0,119.0,1,135,0.0,135.0,135.0
299570.0,6,6,412,4,272,99856.66666666669,74.0,68.0,2,140,0.0,74.0,70.0
19032.0,6,14,4740,7,653,2712.833333333333,249.0,93.28571428571428,7,4087,3039.833333333333,1514.0,583.8571428571429
90000902.0,17,11,735,6,389,18000180.4,174.0,64.83333333333333,5,346,17501691.25,174.0,69.2
209452.0,17,2,180,1,90,0.0,90.0,90.0,1,90,0.0,90.0,90.0
29214.0,6,14,4740,7,653,3622.5,249.0,93.28571428571428,7,4087,4478.666666666667,1514.0,583.8571428571429
0.0,6,1,66,1,66,0.0,66.0,66.0,0,0,0.0,0.0,0.0
118046505.0,6,48,3168,24,1584,5132456.739130435,66.0,66.0,24,1584,5123061.434782608,66.0,66.0
31471.0,6,11,2098,6,590,5730.8,252.0,98.33333333333331,5,1508,6482.0,1236.0,301.6
19985.0,6,14,4740,7,653,3203.833333333333,249.0,93.28571428571428,7,4087,3001.0,1514.0,583.8571428571429
25394.0,6,11,2098,6,590,3488.2,252.0,98.33333333333331,5,1508,5966.75,1236.0,301.6
2976276.0,6,11,2106,6,598,594947.0,252.0,99.66666666666669,5,1508,1782.75,1236.0,301.6
228362.0,17,2,180,1,90,0.0,90.0,90.0,1,90,0.0,90.0,90.0
98909.0,17,2,762,2,762,0.0,381.0,381.0,0,0,0.0,0.0,0.0
115837.0,17,4,1400,4,1400,38612.333333333336,350.0,350.0,0,0,0.0,0.0,0.0
102933.0,17,2,286,2,286,0.0,143.0,143.0,0,0,0.0,0.0,0.0
348.0,17,2,267,1,83,0.0,83.0,83.0,1,184,0.0,184.0,184.0
876239.0,6,12,2710,7,743,146039.83333333334,339.0,106.14285714285714,5,1967,150823.25,1514.0,393.4
34579.0,6,10,2032,5,524,7880.0,252.0,104.8,5,1508,8085.0,1236.0,301.6
205836.0,17,2,180,1,90,0.0,90.0,90.0,1,90,0.0,90.0,90.0
100298.0,17,2,762,2,762,0.0,381.0,381.0,0,0,0.0,0.0,0.0
135134964.0,17,6,1146,6,1146,27026992.8,191.0,191.0,0,0,0.0,0.0,0.0
120060067.0,17,29,13785,29,13785,4287859.535714285,501.0,475.3448275862069,0,0,0.0,0.0,0.0
43174.0,6,14,4740,7,653,6391.833333333333,249.0,93.28571428571428,7,4087,6952.5,1514.0,583.8571428571429
232953.0,6,3,337,2,214,0.0,160.0,107.0,1,123,0.0,123.0,123.0
119888406.0,17,34,16284,34,16284,3632982.0,501.0,478.9411764705882,0,0,0.0,0.0,0.0
1160260.0,6,13,3010,8,2382,165751.42857142858,1514.0,297.75,5,628,221101.75,331.0,125.6
2876286.0,6,3,1604,2,851,0.0,785.0,425.5,1,753,0.0,753.0,753.0
1468611.0,6,19,7533,10,1403,163179.0,583.0,140.3,9,6130,149945.625,1484.0,681.1111111111111
27545.0,6,10,1065,5,534,6687.5,262.0,106.8,5,531,2350.0,259.0,106.2
315714.0,17,4,1400,4,1400,105238.0,350.0,350.0,0,0,0.0,0.0,0.0
323539.0,17,4,704,2,148,0.0,74.0,74.0,2,556,0.0,280.0,278.0
110785.0,17,2,286,2,286,0.0,143.0,143.0,0,0,0.0,0.0,0.0
2790487.0,6,2,132,1,66,0.0,66.0,66.0,1,66,0.0,66.0,66.0
285590.0,17,2,363,1,79,0.0,79.0,79.0,1,284,0.0,284.0,284.0
355.0,17,2,166,1,75,0.0,75.0,75.0,1,91,0.0,91.0,91.0
197356.0,17,4,1400,4,1400,65785.33333333333,350.0,350.0,0,0,0.0,0.0,0.0
221935.0,6,3,426,2,280,0.0,214.0,140.0,1,146,0.0,146.0,146.0
100078887.0,17,12,778,6,389,19890499.4,174.0,64.83333333333333,6,389,19983820.2,174.0,64.83333333333333
16623570.0,6,20,6951,11,1575,1662357.0,408.0,143.1818181818182,9,5376,1559985.125,1514.0,597.3333333333334
67792.0,6,10,2032,5,524,16710.5,252.0,104.8,5,1508,16632.5,1236.0,301.6
135131198.0,17,6,1146,6,1146,27026239.6,191.0,191.0,0,0,0.0,0.0,0.0
24208852.0,6,466,432408,132,8882,184800.3969465649,204.0,67.28787878787878,334,423526,72656.82582582583,1514.0,1268.0419161676646
2794555.0,6,2,132,1,66,0.0,66.0,66.0,1,66,0.0,66.0,66.0
96304991.0,17,14,1126,7,563,16000152.333333334,174.0,80.42857142857143,7,563,16000722.166666666,174.0,80.42857142857143
117030656.0,6,48,3168,24,1584,5088289.391304348,66.0,66.0,24,1584,5074866.130434782,66.0,66.0
90033731.0,17,28,13364,28,13364,3334582.6296296297,501.0,477.2857142857143,0,0,0.0,0.0,0.0
90815016.0,6,167,18934,84,5766,1094156.8192771084,140.0,68.64285714285714,83,13168,1094839.536585366,374.0,158.65060240963857
216537.0,17,2,180,1,90,0.0,90.0,90.0,1,90,0.0,90.0,90.0
207982.0,6,10,1221,6,636,41596.4,298.0,106.0,4,585,68196.33333333333,379.0,146.25
135131312.0,17,6,1146,6,1146,27026262.4,191.0,191.0,0,0,0.0,0.0,0.0
3591106.0,6,5,367,2,132,0.0,66.0,66.0,3,235,1795553.0,103.0,78.33333333333333
13942.0,6,11,1132,6,556,2788.4,218.0,92.66666666666669,5,576,2731.75,304.0,115.2
315111.0,17,4,1400,4,1400,105037.0,350.0,350.0,0,0,0.0,0.0,0.0
46875.0,6,14,4740,7,653,6710.833333333333,249.0,93.28571428571428,7,4087,7671.666666666667,1514.0,583.8571428571429
123742142.0,6,49,3234,24,1584,4945446.391304348,66.0,66.0,25,1650,5155910.916666667,66.0,66.0
12010.0,6,10,1065,5,534,2578.5,262.0,106.8,5,531,2662.5,259.0,106.2
1185120.0,6,11,1134,6,558,237024.0,220.0,93.0,5,576,295324.0,304.0,115.2
90044540.0,17,28,13364,28,13364,3334982.962962963,501.0,477.2857142857143,0,0,0.0,0.0,0.0
19881.0,17,2,582,1,83,0.0,83.0,83.0,1,499,0.0,499.0,499.0
144004.0,17,2,180,1,90,0.0,90.0,90.0,1,90,0.0,90.0,90.0
48388.0,6,14,4740,7,653,7605.166666666667,249.0,93.28571428571428,7,4087,6619.666666666667,1514.0,583.8571428571429
2424994.0,6,25,7733,14,3895,186538.0,1514.0,278.2142857142857,11,3838,216933.2,1514.0,348.90909090909093
108104034.0,17,5,1005,5,1005,27026008.5,201.0,201.0,0,0,0.0,0.0,0.0
280946.0,17,2,363,1,79,0.0,79.0,79.0,1,284,0.0,284.0,284.0
90215761.0,6,17,1287,8,596,12853449.142857144,95.0,74.5,9,691,11251273.75,95.0,76.77777777777777
5616357.0,6,5,336,2,134,0.0,68.0,67.0,3,202,1523105.5,70.0,67.33333333333333
3196.0,17,2,224,1,76,0.0,76.0,76.0,1,148,0.0,148.0,148.0
41335.0,6,10,2032,5,524,9968.25,252.0,104.8,5,1508,8958.0,1236.0,301.6
31720.0,6,14,4740,7,653,4889.166666666667,249.0,93.28571428571428,7,4087,4850.333333333333,1514.0,583.8571428571429
425.0,17,2,166,1,75,0.0,75.0,75.0,1,91,0.0,91.0,91.0
242971.0,6,3,337,2,214,0.0,160.0,107.0,1,123,0.0,123.0,123.0
49254.0,6,14,4740,7,653,7584.0,249.0,93.28571428571428,7,4087,7405.666666666667,1514.0,583.8571428571429
827.0,17,4,438,2,148,0.0,74.0,74.0,2,290,0.0,147.0,145.0
304961.0,6,3,202,2,128,0.0,74.0,64.0,1,74,0.0,74.0,74.0
3164460.0,6,18,1536,9,962,358342.875,315.0,106.88888888888889,9,574,358316.125,78.0,63.77777777777778
102645636.0,6,654,126038,333,104408,309173.6024096386,1514.0,313.5375375375376,321,21630,320073.190625,214.0,67.38317757009345
10485394.0,6,7,478,4,272,3448137.6666666665,74.0,68.0,3,206,5172108.5,74.0,68.66666666666667
1312407.0,17,7,490,7,490,218734.5,70.0,70.0,0,0,0.0,0.0,0.0
144910.0,17,2,180,1,90,0.0,90.0,90.0,1,90,0.0,90.0,90.0
144806.0,17,2,180,1,70,0.0,70.0,70.0,1,110,0.0,110.0,110.0
1306993.0,6,4,264,2,132,0.0,66.0,66.0,2,132,0.0,66.0,66.0
120343063.0,6,233,26334,117,18456,1037440.198275862,284.0,157.74358974358975,116,7878,1037500.1130434782,140.0,67.91379310344827
120979774.0,6,503,82868,250,16944,485862.546184739,214.0,67.776,253,65924,471828.02777777775,1514.0,260.5691699604743
0.0,6,1,172,1,172,0.0,172.0,172.0,0,0,0.0,0.0,0.0
90036903.0,17,28,13364,28,13364,3334700.111111111,501.0,477.2857142857143,0,0,0.0,0.0,0.0
19412.0,17,2,239,1,82,0.0,82.0,82.0,1,157,0.0,157.0,157.0
2190930.0,6,2,132,1,66,0.0,66.0,66.0,1,66,0.0,66.0,66.0
2362.0,17,4,344,2,150,0.0,75.0,75.0,2,194,0.0,103.0,97.0
18550.0,6,14,4740,7,653,2967.833333333333,249.0,93.28571428571428,7,4087,2956.333333333333,1514.0,583.8571428571429
129621802.0,6,36,2517,18,1248,7037377.882352941,123.0,69.33333333333333,18,1269,7624676.05882353,123.0,70.5
120122611.0,6,15,2428,9,1204,15015326.375,188.0,133.77777777777777,6,1224,18069346.2,204.0,204.0
17516.0,17,2,582,1,83,0.0,83.0,83.0,1,499,0.0,499.0,499.0
402.0,17,2,762,2,762,0.0,381.0,381.0,0,0,0.0,0.0,0.0
216758.0,6,3,426,2,280,0.0,214.0,140.0,1,146,0.0,146.0,146.0
42429.0,6,10,2032,5,524,10379.25,252.0,104.8,5,1508,10316.75,1236.0,301.6
44077.0,6,14,4740,7,653,6952.166666666667,249.0,93.28571428571428,7,4087,7125.666666666667,1514.0,583.8571428571429
217717.0,6,3,426,2,280,0.0,214.0,140.0,1,146,0.0,146.0,146.0
302358.0,6,6,412,4,272,100786.0,74.0,68.0,2,140,0.0,74.0,70.0
98074979.0,6,30,2191,15,1086,7005355.642857143,123.0,72.4,15,1105,6989002.928571428,139.0,73.66666666666667
16271.999999999998,6,11,2098,6,590,2827.8,252.0,98.33333333333331,5,1508,2721.75,1236.0,301.6
65705.0,17,2,180,1,90,0.0,90.0,90.0,1,90,0.0,90.0,90.0
705.0,17,4,438,2,148,0.0,74.0,74.0,2,290,0.0,147.0,145.0
57007.0,6,2,145,2,145,0.0,91.0,72.5,0,0,0.0,0.0,0.0
239825.0,17,2,414,1,88,0.0,88.0,88.0,1,326,0.0,326.0,326.0
2088512.0,6,18,6803,10,1501,232056.88888888888,408.0,150.1,8,5302,237260.2857142857,1514.0,662.75
213710.0,17,2,180,1,90,0.0,90.0,90.0,1,90,0.0,90.0,90.0
2797131.0,6,2,132,1,66,0.0,66.0,66.0,1,66,0.0,66.0,66.0
101000938.0,17,13,821,7,432,16833489.666666668,174.0,61.71428571428572,6,389,16201699.8,174.0,64.83333333333333
248025.0,6,3,373,2,238,0.0,172.0,119.0,1,135,0.0,135.0,135.0
42309.0,6,14,4740,7,653,6880.5,249.0,93.28571428571428,7,4087,6096.833333333333,1514.0,583.8571428571429
30486.0,6,14,4740,7,653,4885.5,249.0,93.28571428571428,7,4087,4337.833333333333,1514.0,583.8571428571429
113733386.0,6,46,3036,23,1518,5155423.136363637,66.0,66.0,23,1518,5155420.545454546,66.0,66.0
12502.0,6,11,1133,6,602,2500.4,264.0,100.33333333333331,5,531,2162.0,259.0,106.2
120347519.0,6,216,24308,108,7436,1117044.4672897195,140.0,68.85185185185185,108,16872,1107349.1775700934,284.0,156.22222222222223
49262.0,6,2,132,1,66,0.0,66.0,66.0,1,66,0.0,66.0,66.0
403581.0,6,4,508,2,238,0.0,172.0,119.0,2,270,0.0,135.0,135.0
13079.0,17,2,539,1,86,0.0,86.0,86.0,1,453,0.0,453.0,453.0
299.0,17,2,164,1,82,0.0,82.0,82.0,1,82,0.0,82.0,82.0
304097.0,6,3,202,2,128,0.0,74.0,64.0,1,74,0.0,74.0,74.0
311657.0,17,4,1400,4,1400,103885.66666666669,350.0,350.0,0,0,0.0,0.0,0.0
1471980.0,17,2,110,2,110,0.0,55.0,55.0,0,0,0.0,0.0,0.0
20638.0,6,10,2032,5,524,4106.25,252.0,104.8,5,1508,4739.5,1236.0,301.6
1086.0,17,4,6056,4,6056,362.0,1514.0,1514.0,0,0,0.0,0.0,0.0
120019347.0,17,29,13785,29,13785,4286405.25,501.0,475.3448275862069,0,0,0.0,0.0,0.0
303147.0,6,2,132,1,66,0.0,66.0,66.0,1,66,0.0,66.0,66.0
216173.0,6,3,426,2,280,0.0,214.0,140.0,1,146,0.0,146.0,146.0
108101020.0,17,5,955,5,955,27025255.0,191.0,191.0,0,0,0.0,0.0,0.0
148597.0,17,2,414,1,88,0.0,88.0,88.0,1,326,0.0,326.0,326.0
216441.0,17,2,180,1,90,0.0,90.0,90.0,1,90,0.0,90.0,90.0
90027446.0,17,28,13364,28,13364,3334349.851851852,501.0,477.2857142857143,0,0,0.0,0.0,0.0
7854.0,17,2,166,1,75,0.0,75.0,75.0,1,91,0.0,91.0,91.0
326.0,17,2,174,1,79,0.0,79.0,79.0,1,95,0.0,95.0,95.0
2050.0,17,4,344,2,150,0.0,75.0,75.0,2,194,0.0,103.0,97.0
299394.0,6,6,412,4,272,99798.0,74.0,68.0,2,140,0.0,74.0,70.0
34429.0,6,11,2098,6,590,6885.8,252.0,98.33333333333331,5,1508,5722.75,1236.0,301.6
242393.0,6,3,337,2,214,0.0,160.0,107.0,1,123,0.0,123.0,123.0
298805.0,6,6,412,4,272,99601.66666666669,74.0,68.0,2,140,0.0,74.0,70.0
320412.0,17,4,1400,4,1400,106804.0,350.0,350.0,0,0,0.0,0.0,0.0
37002.0,6,14,4740,7,653,6042.333333333333,249.0,93.28571428571428,7,4087,5622.333333333333,1514.0,583.8571428571429
96632.0,17,2,762,2,762,0.0,381.0,381.0,0,0,0.0,0.0,0.0
792.0,17,4,438,2,148,0.0,74.0,74.0,2,290,0.0,147.0,145.0
1388047.0,17,2,110,2,110,0.0,55.0,55.0,0,0,0.0,0.0,0.0
85623.0,6,14,4740,7,653,13642.0,249.0,93.28571428571428,7,4087,13796.5,1514.0,583.8571428571429
107981.0,17,2,286,2,286,0.0,143.0,143.0,0,0,0.0,0.0,0.0
231063.0,17,2,180,1,90,0.0,90.0,90.0,1,90,0.0,90.0,90.0
10460805.0,6,7,478,4,272,3441549.0,74.0,68.0,3,206,5162240.0,74.0,68.66666666666667
112734973.0,6,31,2182,16,1165,7501284.333333333,139.0,72.8125,15,1017,8036957.071428572,123.0,67.8
121490438.0,6,217,24596,109,17246,1124911.462962963,284.0,158.22018348623854,108,7350,1117214.308411215,140.0,68.05555555555556
139374.0,6,3,337,2,214,0.0,160.0,107.0,1,123,0.0,123.0,123.0
1077.0,17,5,550,5,550,269.25,110.0,110.0,0,0,0.0,0.0,0.0
141682.0,17,4,704,2,148,0.0,74.0,74.0,2,556,0.0,280.0,278.0
321119.0,6,6,412,4,272,107039.66666666669,74.0,68.0,2,140,0.0,74.0,70.0
29989.0,6,10,2032,5,524,7194.0,252.0,104.8,5,1508,7154.75,1236.0,301.6
2587420.0,6,2,132,1,66,0.0,66.0,66.0,1,66,0.0,66.0,66.0
56387.0,6,13,1386,7,789,9397.833333333334,253.0,112.71428571428572,6,597,10474.8,259.0,99.5
12647.0,6,13,1459,7,862,1905.1666666666667,271.0,123.14285714285714,6,597,2257.8,259.0,99.5
146095.0,6,3,337,2,214,0.0,160.0,107.0,1,123,0.0,123.0,123.0
90059654.0,17,28,13364,28,13364,3335542.7407407407,501.0,477.2857142857143,0,0,0.0,0.0,0.0
9686.0,17,2,582,1,83,0.0,83.0,83.0,1,499,0.0,499.0,499.0
90288664.0,6,16,1192,8,596,12892023.0,95.0,74.5,8,596,12896852.142857144,95.0,74.5
119817884.0,6,28,2086,15,1138,8556343.285714285,95.0,75.86666666666666,13,948,9983969.083333334,95.0,72.92307692307692
90758806.0,6,21,1712,11,799,9071749.8,95.0,72.63636363636364,10,913,10083567.444444444,222.0,91.3
47937.0,6,14,4740,7,653,6738.833333333333,249.0,93.28571428571428,7,4087,6630.5,1514.0,583.8571428571429
108111929.0,17,5,955,5,955,27027982.25,191.0,191.0,0,0,0.0,0.0,0.0
106641544.0,17,14,864,7,432,17667947.833333332,174.0,61.71428571428572,7,432,17666836.333333332,174.0,61.71428571428572
218206.0,6,3,426,2,280,0.0,214.0,140.0,1,146,0.0,146.0,146.0
95364.0,6,10,2032,5,524,23622.75,252.0,104.8,5,1508,22657.0,1236.0,301.6
93016282.0,6,38,2508,19,1254,5150435.111111111,66.0,66.0,19,1254,5150441.0,66.0,66.0
103591.0,17,2,286,2,286,0.0,143.0,143.0,0,0,0.0,0.0,0.0
103001424.0,17,13,821,7,432,17166904.0,174.0,61.71428571428572,6,389,16601065.6,174.0,64.83333333333333
9952.0,17,2,582,1,83,0.0,83.0,83.0,1,499,0.0,499.0,499.0
120201.0,17,2,180,1,70,0.0,70.0,70.0,1,110,0.0,110.0,110.0
42455.0,6,14,4740,7,653,6482.666666666667,249.0,93.28571428571428,7,4087,6732.333333333333,1514.0,583.8571428571429
318109.0,17,4,1400,4,1400,106036.33333333331,350.0,350.0,0,0,0.0,0.0,0.0
306613.0,6,6,412,4,272,102204.33333333331,74.0,68.0,2,140,0.0,74.0,70.0
24629.0,6,10,2032,5,524,5831.25,252.0,104.8,5,1508,5579.25,1236.0,301.6
34383.0,6,14,4740,7,653,5484.833333333333,249.0,93.28571428571428,7,4087,5593.166666666667,1514.0,583.8571428571429
169747.0,17,4,704,2,148,0.0,74.0,74.0,2,556,0.0,280.0,278.0
96726990.0,6,33,2428,17,1288,6045436.875,139.0,75.76470588235294,16,1140,6434043.4,123.0,71.25
319.0,17,2,174,1,79,0.0,79.0,79.0,1,95,0.0,95.0,95.0
24397.0,6,14,4740,7,653,3903.6666666666665,249.0,93.28571428571428,7,4087,3818.5,1514.0,583.8571428571429
120363224.0,6,233,26356,117,18404,1037614.0,284.0,157.2991452991453,116,7952,1038037.008695652,140.0,68.55172413793103
104292320.0,6,748,148714,366,24822,284140.1780821918,214.0,67.81967213114754,382,123892,273679.9947506562,1514.0,324.32460732984293
5232387.0,6,5,336,2,134,0.0,68.0,67.0,3,202,1228064.5,70.0,67.33333333333333
309336.0,17,2,180,1,90,0.0,90.0,90.0,1,90,0.0,90.0,90.0
44603.0,6,14,4740,7,653,7292.166666666667,249.0,93.28571428571428,7,4087,6845.833333333333,1514.0,583.8571428571429
90028358.0,17,28,13364,28,13364,3334383.6296296297,501.0,477.2857142857143,0,0,0.0,0.0,0.0
63922.00000000001,6,14,4740,7,653,10527.333333333334,249.0,93.28571428571428,7,4087,9242.166666666666,1514.0,583.8571428571429
34708.0,6,10,2032,5,524,7682.0,252.0,104.8,5,1508,8242.75,1236.0,301.6
90121203.0,6,10,1440,7,828,15020200.5,188.0,118.28571428571428,3,612,30046177.0,204.0,204.0
99692.0,17,2,762,2,762,0.0,381.0,381.0,0,0,0.0,0.0,0.0
2360.0,17,4,344,2,150,0.0,75.0,75.0,2,194,0.0,103.0,97.0
482.0,17,2,508,2,508,0.0,257.0,254.0,0,0,0.0,0.0,0.0
120122224.0,6,16,2368,9,1204,14994918.25,188.0,133.77777777777777,7,1164,15015461.666666666,204.0,166.28571428571428
36356.0,6,10,2032,5,524,8786.75,252.0,104.8,5,1508,8580.25,1236.0,301.6
2411.0,17,4,344,2,150,0.0,75.0,75.0,2,194,0.0,103.0,97.0
239977.0,6,3,373,2,238,0.0,172.0,119.0,1,135,0.0,135.0,135.0
90000391.0,6,22,1680,11,840,9000039.1,95.0,76.36363636363636,11,840,8975394.8,95.0,76.36363636363636
160696.0,6,3,337,2,214,0.0,160.0,107.0,1,123,0.0,123.0,123.0
140705.0,6,2,132,1,66,0.0,66.0,66.0,1,66,0.0,66.0,66.0
104078545.0,17,14,864,7,432,17334240.5,174.0,61.71428571428572,7,432,17333501.333333332,174.0,61.71428571428572
244437.0,6,13,1394,7,797,40739.5,253.0,113.85714285714286,6,597,46786.0,259.0,99.5
5835106.0,6,5,336,2,134,0.0,68.0,67.0,3,202,1526878.0,70.0,67.33333333333333
4993055.0,17,4,534,2,166,0.0,83.0,83.0,2,368,0.0,184.0,184.0
205872.0,17,2,180,1,90,0.0,90.0,90.0,1,90,0.0,90.0,90.0
2280.0,17,2,691,1,349,0.0,349.0,349.0,1,342,0.0,342.0,342.0
144786.0,17,2,180,1,70,0.0,70.0,70.0,1,110,0.0,110.0,110.0
135142538.0,17,6,1146,6,1146,27028507.6,191.0,191.0,0,0,0.0,0.0,0.0
102664.0,17,2,286,2,286,0.0,143.0,143.0,0,0,0.0,0.0,0.0
4460.0,17,2,610,1,72,0.0,72.0,72.0,1,538,0.0,538.0,538.0
231414.0,6,3,426,2,280,0.0,214.0,140.0,1,146,0.0,146.0,146.0
90213941.0,6,16,1192,8,596,12853076.857142856,95.0,74.5,8,596,12858294.714285716,95.0,74.5
42388.0,6,14,4740,7,653,5943.166666666667,249.0,93.28571428571428,7,4087,6494.333333333333,1514.0,583.8571428571429
7557.0,17,2,582,1,83,0.0,83.0,83.0,1,499,0.0,499.0,499.0
108706.0,17,2,286,2,286,0.0,143.0,143.0,0,0,0.0,0.0,0.0
149715596.0,6,15,2290,5,1020,29962059.0,204.0,204.0,10,1270,16634873.555555556,188.0,127.0
842.0,17,4,438,2,148,0.0,74.0,74.0,2,290,0.0,147.0,145.0
70829.0,6,14,4740,7,653,11165.333333333334,249.0,93.28571428571428,7,4087,10961.833333333334,1514.0,583.8571428571429
246166.0,6,3,337,2,214,0.0,160.0,107.0,1,123,0.0,123.0,123.0
90757939.0,6,19,1436,10,745,10078889.888888888,95.0,74.5,9,691,11343815.875,95.0,76.77777777777777
285.0,17,2,164,1,82,0.0,82.0,82.0,1,82,0.0,82.0,82.0
218407.0,6,3,426,2,280,0.0,214.0,140.0,1,146,0.0,146.0,146.0
2400.0,17,4,344,2,150,0.0,75.0,75.0,2,194,0.0,103.0,97.0
90067685.0,17,28,13364,28,13364,3335840.185185185,501.0,477.2857142857143,0,0,0.0,0.0,0.0
2449.0,17,4,344,2,150,0.0,75.0,75.0,2,194,0.0,103.0,97.0
206954.0,17,2,762,2,762,0.0,381.0,381.0,0,0,0.0,0.0,0.0
298723.0,6,6,412,4,272,99574.33333333331,74.0,68.0,2,140,0.0,74.0,70.0
205136.0,17,2,180,1,90,0.0,90.0,90.0,1,90,0.0,90.0,90.0
204414.0,17,2,762,2,762,0.0,381.0,381.0,0,0,0.0,0.0,0.0
227331.0,6,3,426,2,280,0.0,214.0,140.0,1,146,0.0,146.0,146.0
224290.0,6,3,426,2,280,0.0,214.0,140.0,1,146,0.0,146.0,146.0
843958.0,6,9,1196,6,725,168791.6,387.0,120.83333333333331,3,471,285713.0,331.0,157.0
90208178.0,6,27,2073,12,935,8178927.090909091,95.0,77.91666666666667,15,1138,6428754.0,95.0,75.86666666666666
34288.0,6,14,4740,7,653,5135.0,249.0,93.28571428571428,7,4087,5115.666666666667,1514.0,583.8571428571429
31079.0,6,13,1386,7,789,5179.833333333333,253.0,112.71428571428572,6,597,4951.6,259.0,99.5
108110503.0,17,5,1005,5,1005,27027625.75,201.0,201.0,0,0,0.0,0.0,0.0
100123395.0,17,12,778,6,389,19892494.6,174.0,64.83333333333333,6,389,19992658.2,174.0,64.83333333333333
165849.0,17,2,180,1,90,0.0,90.0,90.0,1,90,0.0,90.0,90.0
731.0,17,4,438,2,148,0.0,74.0,74.0,2,290,0.0,147.0,145.0
148056.0,17,2,180,1,90,0.0,90.0,90.0,1,90,0.0,90.0,90.0
206583.0,6,3,426,2,280,0.0,214.0,140.0,1,146,0.0,146.0,146.0
151479.0,17,2,414,1,88,0.0,88.0,88.0,1,326,0.0,326.0,326.0
3396931.0,6,7,923,4,753,1063866.6666666667,571.0,188.25,3,170,1595608.0,62.0,56.66666666666666
1278262.0,6,7,499,3,198,613977.0,66.0,66.0,4,301,417840.3333333333,103.0,75.25
90094482.0,6,12,1848,5,1020,22523261.75,204.0,204.0,7,828,14968859.666666666,188.0,118.28571428571428
101520.0,17,2,762,2,762,0.0,381.0,381.0,0,0,0.0,0.0,0.0
352973.0,6,6,412,4,272,117657.66666666669,74.0,68.0,2,140,0.0,74.0,70.0
120004657.0,6,18,1341,9,691,14999981.125,95.0,76.77777777777777,9,650,14999612.625,95.0,72.22222222222223
121284.0,6,3,337,2,214,0.0,160.0,107.0,1,123,0.0,123.0,123.0
148038.0,17,2,180,1,90,0.0,90.0,90.0,1,90,0.0,90.0,90.0
2336.0,17,4,344,2,150,0.0,75.0,75.0,2,194,0.0,103.0,97.0
99010028.0,6,31,2314,16,1228,6600668.533333333,139.0,76.75,15,1086,7056708.357142857,123.0,72.4
891339.0,6,12,1427,6,796,175935.2,271.0,132.66666666666666,6,631,177066.4,293.0,105.16666666666669
25070.0,6,10,1810,5,358,5463.5,130.0,71.6,5,1452,5949.25,1224.0,290.4
41860.0,6,12,1320,6,723,7048.0,253.0,120.5,6,597,7905.2,259.0,99.5
208967.0,17,2,762,2,762,0.0,381.0,381.0,0,0,0.0,0.0,0.0
90257872.0,6,12,1832,8,1016,12893981.714285716,188.0,127.0,4,816,30030245.0,204.0,204.0
90254417.0,6,13,2036,8,1016,12893488.142857144,188.0,127.0,5,1020,22521999.75,204.0,204.0
5012640.0,17,4,849,2,166,0.0,83.0,83.0,2,683,0.0,499.0,341.5
1306985.0,6,4,264,2,132,0.0,66.0,66.0,2,132,0.0,66.0,66.0
43187.0,6,14,4740,7,653,6267.166666666667,249.0,93.28571428571428,7,4087,6936.0,1514.0,583.8571428571429
90959769.0,6,21,1585,11,840,9095664.5,95.0,76.36363636363636,10,745,10105968.111111112,95.0,74.5
27014364.0,17,5,1718,4,1368,1820395.0,342.0,342.0,1,350,0.0,350.0,350.0
37468.0,6,14,4740,7,653,6117.666666666667,249.0,93.28571428571428,7,4087,5224.833333333333,1514.0,583.8571428571429
2414996.0,6,3,204,2,136,0.0,70.0,68.0,1,68,0.0,68.0,68.0
105156450.0,17,15,5130,15,5130,7511175.0,342.0,342.0,0,0,0.0,0.0,0.0
108097318.0,17,5,1005,5,1005,27024329.5,201.0,201.0,0,0,0.0,0.0,0.0
31779044.0,6,26,7627,14,3735,186392.3076923077,1514.0,266.7857142857143,12,3892,2869337.909090909,1514.0,324.3333333333333
106219473.0,6,209,23618,105,7152,1021341.0865384616,140.0,68.11428571428571,104,16466,1021225.5825242718,284.0,158.32692307692307
207113.0,6,3,426,2,280,0.0,214.0,140.0,1,146,0.0,146.0,146.0
985329.0,6,12,1354,6,723,196364.8,253.0,120.5,6,631,195636.2,293.0,105.16666666666669
3067957.0,6,3,204,1,68,0.0,68.0,68.0,2,136,0.0,70.0,68.0
3052812.0,6,3,204,2,136,0.0,70.0,68.0,1,68,0.0,68.0,68.0
0.0,6,1,54,0,0,0.0,0.0,0.0,1,54,0.0,54.0,54.0
103184831.0,6,195,21936,98,6690,1063761.144329897,140.0,68.26530612244898,97,15246,1063981.125,284.0,157.17525773195877
91.0,17,2,762,2,762,0.0,381.0,381.0,0,0,0.0,0.0,0.0
108098380.0,17,5,955,5,955,27024595.0,191.0,191.0,0,0,0.0,0.0,0.0
39715.0,6,14,4740,7,653,6472.833333333333,249.0,93.28571428571428,7,4087,5470.0,1514.0,583.8571428571429
149882910.0,17,36,17126,36,17126,4282368.857142857,501.0,475.72222222222223,0,0,0.0,0.0,0.0
90046129.0,17,28,13364,28,13364,3335041.814814815,501.0,477.2857142857143,0,0,0.0,0.0,0.0
169349.0,17,2,414,1,88,0.0,88.0,88.0,1,326,0.0,326.0,326.0
10419288.0,6,7,478,4,272,3427540.6666666665,74.0,68.0,3,206,5141174.0,74.0,68.66666666666667
256992.0,6,3,337,2,214,0.0,160.0,107.0,1,123,0.0,123.0,123.0
18790.0,6,14,4740,7,653,2894.6666666666665,249.0,93.28571428571428,7,4087,2902.1666666666665,1514.0,583.8571428571429
239329.0,17,2,180,1,90,0.0,90.0,90.0,1,90,0.0,90.0,90.0
90286122.0,6,25,1938,13,948,7520092.416666667,95.0,72.92307692307692,12,990,8182982.454545454,154.0,82.5
228484.0,17,2,180,1,90,0.0,90.0,90.0,1,90,0.0,90.0,90.0
20691.0,6,10,2032,5,524,4932.75,252.0,104.8,5,1508,3867.75,1236.0,301.6
115589832.0,6,48,3168,24,1584,5025644.869565218,66.0,66.0,24,1584,5016247.0869565215,66.0,66.0
113979487.0,6,1022,206578,503,33790,227019.8147410359,214.0,67.17693836978131,519,172788,219986.2625482625,1514.0,332.9248554913295
5005391.0,17,4,496,2,168,0.0,84.0,84.0,2,328,0.0,164.0,164.0
220332.0,6,4,492,2,280,0.0,214.0,140.0,2,212,0.0,146.0,106.0
22441.0,6,14,4740,7,653,3611.3333333333335,249.0,93.28571428571428,7,4087,3517.0,1514.0,583.8571428571429
4350.0,17,2,180,1,90,0.0,90.0,90.0,1,90,0.0,90.0,90.0
106076.0,17,2,700,2,700,0.0,350.0,350.0,0,0,0.0,0.0,0.0
123730602.0,6,49,3234,25,1650,5155441.75,66.0,66.0,24,1584,4981971.391304348,66.0,66.0
25433.0,6,14,4740,7,653,4033.8333333333335,249.0,93.28571428571428,7,4087,3642.1666666666665,1514.0,583.8571428571429
318986.0,17,4,1400,4,1400,106328.66666666669,350.0,350.0,0,0,0.0,0.0,0.0
2427.0,17,4,344,2,150,0.0,75.0,75.0,2,194,0.0,103.0,97.0
3440691.0,6,164,131607,93,122619,37398.8152173913,1510.0,1318.483870967742,71,8988,44704.37142857143,1510.0,126.59154929577464
204930.0,17,2,762,2,762,0.0,381.0,381.0,0,0,0.0,0.0,0.0
122133.0,6,3,373,2,238,0.0,172.0,119.0,1,135,0.0,135.0,135.0
239045.0,6,3,337,2,214,0.0,160.0,107.0,1,123,0.0,123.0,123.0
106271.0,17,2,286,2,286,0.0,143.0,143.0,0,0,0.0,0.0,0.0
303108.0,6,2,132,1,66,0.0,66.0,66.0,1,66,0.0,66.0,66.0
297550.0,6,6,412,4,272,99183.33333333331,74.0,68.0,2,140,0.0,74.0,70.0
1319473.0,6,4,264,2,132,0.0,66.0,66.0,2,132,0.0,66.0,66.0
240636.0,6,3,337,2,214,0.0,160.0,107.0,1,123,0.0,123.0,123.0
14636277.0,6,20,1607,10,975,1593031.111111111,315.0,97.5,10,632,1593011.7777777778,78.0,63.2
33303.0,6,14,4740,7,653,5331.0,249.0,93.28571428571428,7,4087,4867.333333333333,1514.0,583.8571428571429
120011459.0,6,18,1341,9,691,14999926.75,95.0,76.77777777777777,9,650,15000004.625,95.0,72.22222222222223
238416.0,17,2,180,1,90,0.0,90.0,90.0,1,90,0.0,90.0,90.0
120098087.0,6,220,24900,110,17418,1099928.4220183487,284.0,158.34545454545454,110,7482,1099928.6697247706,140.0,68.01818181818182
34917.0,6,14,4740,7,653,5520.833333333333,249.0,93.28571428571428,7,4087,5681.166666666667,1514.0,583.8571428571429
29775.0,6,14,4740,7,653,4655.833333333333,249.0,93.28571428571428,7,4087,4823.666666666667,1514.0,583.8571428571429
54766.0,6,14,4740,7,653,8137.833333333333,249.0,93.28571428571428,7,4087,8971.5,1514.0,583.8571428571429
1581260.0,6,4,276,2,128,0.0,74.0,64.0,2,148,0.0,74.0,74.0
300463.0,6,6,412,4,272,100154.33333333331,74.0,68.0,2,140,0.0,74.0,70.0
246037.0,6,3,373,2,238,0.0,172.0,119.0,1,135,0.0,135.0,135.0
111005666.0,6,35,2542,18,1348,6517051.705882353,139.0,74.88888888888889,17,1194,6924366.75,123.0,70.23529411764706
310262.0,17,4,1400,4,1400,103420.66666666669,350.0,350.0,0,0,0.0,0.0,0.0
322172.0,17,4,1400,4,1400,107390.66666666669,350.0,350.0,0,0,0.0,0.0,0.0
314305.0,17,4,1400,4,1400,104768.33333333331,350.0,350.0,0,0,0.0,0.0,0.0
123455350.0,6,48,3168,24,1584,5017234.739130435,66.0,66.0,24,1584,5250579.956521739,66.0,66.0
104284.0,17,2,762,2,762,0.0,381.0,381.0,0,0,0.0,0.0,0.0
323331.0,17,4,1400,4,1400,107777.0,350.0,350.0,0,0,0.0,0.0,0.0
7644729.0,17,6,1667,3,273,3811860.0,103.0,91.0,3,1394,3817859.5,546.0,464.6666666666667
475125.0,6,3,204,2,136,0.0,70.0,68.0,1,68,0.0,68.0,68.0
400561.0,6,4,508,2,238,0.0,172.0,119.0,2,270,0.0,135.0,135.0
105962591.0,6,29,2052,15,1089,7553342.214285715,123.0,72.6,14,963,8134334.307692308,123.0,68.78571428571429
14743.0,6,12,1393,6,796,2635.4,271.0,132.66666666666666,6,597,2650.6,259.0,99.5
2793636.0,6,2,132,1,66,0.0,66.0,66.0,1,66,0.0,66.0,66.0
120077301.0,17,28,13364,28,13364,4447307.444444444,501.0,477.2857142857143,0,0,0.0,0.0,0.0
210009.0,6,10,1221,6,636,42001.8,298.0,106.0,4,585,68611.33333333333,379.0,146.25
10510584.0,6,7,478,4,272,3458066.333333333,74.0,68.0,3,206,5186972.5,74.0,68.66666666666667
306299.0,6,6,412,4,272,102099.66666666669,74.0,68.0,2,140,0.0,74.0,70.0
135134737.0,17,6,1146,6,1146,27026947.4,191.0,191.0,0,0,0.0,0.0,0.0
135130627.0,17,6,1146,6,1146,27026125.4,191.0,191.0,0,0,0.0,0.0,0.0
357.0,17,2,174,1,79,0.0,79.0,79.0,1,95,0.0,95.0,95.0
2867.0,17,2,224,1,76,0.0,76.0,76.0,1,148,0.0,148.0,148.0
2370.0,17,4,344,2,150,0.0,75.0,75.0,2,194,0.0,103.0,97.0
13174.0,6,13,1459,7,862,2010.3333333333333,271.0,123.14285714285714,6,597,2476.0,259.0,99.5
209064.0,17,2,762,2,762,0.0,381.0,381.0,0,0,0.0,0.0,0.0
17027183.0,17,10,3500,10,3500,1891909.2222222225,350.0,350.0,0,0,0.0,0.0,0.0
119459857.0,6,405,51040,203,13694,591347.8910891089,140.0,67.45812807881774,202,37346,590069.0796019901,336.0,184.88118811881188
119068224.0,6,35,2526,18,1332,6991306.823529412,123.0,74.0,17,1194,7428263.375,123.0,70.23529411764706
98860.0,17,2,762,2,762,0.0,381.0,381.0,0,0,0.0,0.0,0.0
10514632.0,6,7,478,4,272,3459211.333333333,74.0,68.0,3,206,5188660.0,74.0,68.66666666666667
5612863.0,6,5,336,2,134,0.0,68.0,67.0,3,202,1424384.0,70.0,67.33333333333333
232851.0,6,3,337,2,214,0.0,160.0,107.0,1,123,0.0,123.0,123.0
35170.0,6,14,4740,7,653,5022.666666666667,249.0,93.28571428571428,7,4087,5638.333333333333,1514.0,583.8571428571429
15163.0,6,14,4740,7,653,2366.5,249.0,93.28571428571428,7,4087,2386.6666666666665,1514.0,583.8571428571429
113646796.0,6,202,22902,101,16014,1134304.89,284.0,158.55445544554456,101,6888,1134316.18,140.0,68.1980198019802
90256016.0,6,16,2368,9,1204,11282002.0,188.0,133.77777777777777,7,1164,15015685.166666666,204.0,166.28571428571428
2796528.0,6,2,132,1,66,0.0,66.0,66.0,1,66,0.0,66.0,66.0
0.0,6,1,172,1,172,0.0,172.0,172.0,0,0,0.0,0.0,0.0
286193.0,17,2,180,1,90,0.0,90.0,90.0,1,90,0.0,90.0,90.0
891738.0,6,12,2718,7,743,148623.0,339.0,106.14285714285714,5,1975,154140.75,1514.0,395.0
135118376.0,17,6,1146,6,1146,27023675.2,191.0,191.0,0,0,0.0,0.0,0.0
103324.0,17,2,286,2,286,0.0,143.0,143.0,0,0,0.0,0.0,0.0
317443.0,17,4,1400,4,1400,105814.33333333331,350.0,350.0,0,0,0.0,0.0,0.0
40565.0,6,14,4740,7,653,6635.0,249.0,93.28571428571428,7,4087,5959.0,1514.0,583.8571428571429
103120.0,17,2,286,2,286,0.0,143.0,143.0,0,0,0.0,0.0,0.0
318842.0,17,4,1400,4,1400,106280.66666666669,350.0,350.0,0,0,0.0,0.0,0.0
14577.0,6,14,4740,7,653,2217.333333333333,249.0,93.28571428571428,7,4087,2286.833333333333,1514.0,583.8571428571429
389957.0,6,3,202,2,128,0.0,74.0,64.0,1,74,0.0,74.0,74.0
120011060.0,6,23,1734,12,935,10909088.181818182,95.0,77.91666666666667,11,799,11999890.9,95.0,72.63636363636364
144883.0,17,2,180,1,70,0.0,70.0,70.0,1,110,0.0,110.0,110.0
107690.0,17,2,286,2,286,0.0,143.0,143.0,0,0,0.0,0.0,0.0
39594.0,6,10,2032,5,524,9669.0,252.0,104.8,5,1508,7934.5,1236.0,301.6
119571762.0,6,24,1829,11,840,11957176.2,95.0,76.36363636363636,13,989,9941996.583333334,95.0,76.07692307692308
131011200.0,17,15,907,8,475,18715885.71428572,174.0,59.375,7,432,18552152.666666668,174.0,61.71428571428572
69210.0,17,2,614,1,72,0.0,72.0,72.0,1,542,0.0,542.0,542.0
90038365.0,17,27,12943,27,12943,3463014.0384615385,501.0,479.3703703703704,0,0,0.0,0.0,0.0
8011278.000000001,6,13,919,8,552,1142359.2857142857,78.0,69.0,5,367,1743355.5,103.0,73.4
50833.0,6,14,4740,7,653,8211.333333333334,249.0,93.28571428571428,7,4087,8095.5,1514.0,583.8571428571429
254529.0,6,3,337,2,214,0.0,160.0,107.0,1,123,0.0,123.0,123.0
105057.0,17,2,700,2,700,0.0,350.0,350.0,0,0,0.0,0.0,0.0
302169.0,6,6,412,4,272,100723.0,74.0,68.0,2,140,0.0,74.0,70.0
179800.0,17,2,180,1,90,0.0,90.0,90.0,1,90,0.0,90.0,90.0
48617.0,6,10,2032,5,524,11680.5,252.0,104.8,5,1508,11566.0,1236.0,301.6
266391.0,17,2,180,1,90,0.0,90.0,90.0,1,90,0.0,90.0,90.0
133410.0,6,2,132,1,66,0.0,66.0,66.0,1,66,0.0,66.0,66.0
21117.0,6,14,4740,7,653,2939.5,249.0,93.28571428571428,7,4087,3377.0,1514.0,583.8571428571429
329084.0,6,5,367,2,132,0.0,66.0,66.0,3,235,164542.0,103.0,78.33333333333333
91746240.0,6,359,44582,180,12028,512548.8268156425,140.0,66.82222222222222,179,32554,509604.5,374.0,181.8659217877095
90295200.0,6,17,1287,9,691,11281626.25,95.0,76.77777777777777,8,596,12764938.42857143,95.0,74.5
208430.0,6,3,426,2,280,0.0,214.0,140.0,1,146,0.0,146.0,146.0
147215.0,6,2,132,1,66,0.0,66.0,66.0,1,66,0.0,66.0,66.0
47676.0,6,14,4740,7,653,6749.0,249.0,93.28571428571428,7,4087,7106.5,1514.0,583.8571428571429
24021722.0,17,3,1026,3,1026,12010861.000000002,342.0,342.0,0,0,0.0,0.0,0.0
243279.0,6,3,337,2,214,0.0,160.0,107.0,1,123,0.0,123.0,123.0
33512.0,6,14,4740,7,653,5337.5,249.0,93.28571428571428,7,4087,5317.333333333333,1514.0,583.8571428571429
108107560.0,17,5,955,5,955,27026890.0,191.0,191.0,0,0,0.0,0.0,0.0
108109149.0,17,5,955,5,955,27027287.25,191.0,191.0,0,0,0.0,0.0,0.0
98324753.0,6,26,1746,13,906,8175756.333333333,123.0,69.6923076923077,13,840,8175753.833333333,123.0,64.61538461538461
2392.0,17,4,344,2,150,0.0,75.0,75.0,2,194,0.0,103.0,97.0
32033.0,6,10,2032,5,524,7778.75,252.0,104.8,5,1508,7077.0,1236.0,301.6
22302.0,6,10,2032,5,524,5349.5,252.0,104.8,5,1508,3482.5,1236.0,301.6
59147.0,6,14,4740,7,653,7075.166666666667,249.0,93.28571428571428,7,4087,9714.5,1514.0,583.8571428571429
110603159.0,17,16,1212,8,606,15714427.285714284,174.0,75.75,8,606,15715218.714285716,174.0,75.75
14264164.0,17,6,2052,6,2052,2852832.8,342.0,342.0,0,0,0.0,0.0,0.0
103069.0,17,2,286,2,286,0.0,143.0,143.0,0,0,0.0,0.0,0.0
14552.0,6,11,1132,6,556,2558.6,218.0,92.66666666666669,5,576,3329.5,304.0,115.2
90232683.0,6,16,1192,8,596,12854193.857142856,95.0,74.5,8,596,12859623.142857144,95.0,74.5
96110427.0,17,14,1126,7,563,16000131.0,174.0,80.42857142857143,7,563,16001624.666666666,174.0,80.42857142857143
43756.0,6,10,2032,5,524,10711.0,252.0,104.8,5,1508,9402.75,1236.0,301.6
90301958.0,6,17,1287,9,691,11282128.75,95.0,76.77777777777777,8,596,12899750.0,95.0,74.5
1313709.0,6,4,264,2,132,0.0,66.0,66.0,2,132,0.0,66.0,66.0
306277.0,6,3,202,2,128,0.0,74.0,64.0,1,74,0.0,74.0,74.0
138448.0,6,11,1132,6,556,27178.0,218.0,92.66666666666669,5,576,34311.25,304.0,115.2
99106.0,17,2,762,2,762,0.0,381.0,381.0,0,0,0.0,0.0,0.0
44207.0,6,14,4740,7,653,7206.166666666667,249.0,93.28571428571428,7,4087,7130.5,1514.0,583.8571428571429
302748.0,6,3,202,2,128,0.0,74.0,64.0,1,74,0.0,74.0,74.0
144028.0,17,2,180,1,90,0.0,90.0,90.0,1,90,0.0,90.0,90.0
90366932.0,6,11,1644,7,828,15061155.333333334,188.0,118.28571428571428,4,816,20112295.666666668,204.0,204.0
8798.0,17,2,582,1,83,0.0,83.0,83.0,1,499,0.0,499.0,499.0
123464703.0,17,14,864,7,432,17333518.166666668,174.0,61.71428571428572,7,432,17335159.333333332,174.0,61.71428571428572
33926.0,6,14,4740,7,653,5004.166666666667,249.0,93.28571428571428,7,4087,4589.666666666667,1514.0,583.8571428571429
135128688.0,17,6,1206,6,1206,27025737.6,201.0,201.0,0,0,0.0,0.0,0.0
41039.0,6,12,1413,7,882,6839.833333333333,291.0,126.0,5,531,7309.25,259.0,106.2
13945943.0,6,20,1607,10,975,1515708.3333333333,315.0,97.5,10,632,1515690.0,78.0,63.2
5631459.0,6,5,336,2,134,0.0,68.0,67.0,3,202,1527467.0,70.0,67.33333333333333
40528.0,6,10,2032,5,524,9905.75,252.0,104.8,5,1508,9539.25,1236.0,301.6
206393.0,17,2,180,1,90,0.0,90.0,90.0,1,90,0.0,90.0,90.0
284842.0,6,10,1221,6,636,56968.4,298.0,106.0,4,585,93824.66666666669,379.0,146.25
57739.0,6,10,2032,5,524,13975.0,252.0,104.8,5,1508,13273.0,1236.0,301.6
1028621.0,6,11,1134,6,558,205724.2,220.0,93.0,5,576,255889.75,304.0,115.2
300956.0,6,6,412,4,272,100318.66666666669,74.0,68.0,2,140,0.0,74.0,70.0
103912.0,17,2,286,2,286,0.0,143.0,143.0,0,0,0.0,0.0,0.0
6446.0,17,4,823,2,163,0.0,89.0,81.5,2,660,0.0,443.0,330.0
144722.0,17,2,180,1,70,0.0,70.0,70.0,1,110,0.0,110.0,110.0
35865.0,6,2,132,1,66,0.0,66.0,66.0,1,66,0.0,66.0,66.0
93127358.0,17,11,735,6,389,18625471.6,174.0,64.83333333333333,5,346,18408451.0,174.0,69.2
105948.0,17,2,286,2,286,0.0,143.0,143.0,0,0,0.0,0.0,0.0
108104295.0,17,5,955,5,955,27026073.75,191.0,191.0,0,0,0.0,0.0,0.0
39379.0,6,12,1320,7,789,6563.166666666667,253.0,112.71428571428572,5,531,8956.25,259.0,106.2
49841.0,6,14,4740,7,653,8137.166666666667,249.0,93.28571428571428,7,4087,7218.833333333333,1514.0,583.8571428571429
90945592.0,6,21,1585,11,840,9093452.7,95.0,76.36363636363636,10,745,10104178.555555556,95.0,74.5
21388.0,6,10,2032,5,524,4719.5,252.0,104.8,5,1508,5071.0,1236.0,301.6
27688.0,6,10,2032,5,524,6706.5,252.0,104.8,5,1508,5936.25,1236.0,301.6
315800.0,17,4,1400,4,1400,105266.66666666669,350.0,350.0,0,0,0.0,0.0,0.0
3004705.0,6,11,2106,6,598,600664.2,252.0,99.66666666666669,5,1508,1800.5,1236.0,301.6
197230.0,17,2,180,1,90,0.0,90.0,90.0,1,90,0.0,90.0,90.0
118627817.0,6,256,29366,128,20622,932382.6535433072,284.0,161.109375,128,8744,932382.3858267716,140.0,68.3125
1315998.0,17,7,490,7,490,219333.0,70.0,70.0,0,0,0.0,0.0,0.0
2642620.0,6,3,1604,2,851,0.0,785.0,425.5,1,753,0.0,753.0,753.0
307178.0,6,6,412,4,272,102392.66666666669,74.0,68.0,2,140,0.0,74.0,70.0
513655.0,17,2,363,1,79,0.0,79.0,79.0,1,284,0.0,284.0,284.0
175467.0,6,10,1066,5,490,42022.25,218.0,98.0,5,576,43029.75,304.0,115.2
206990.0,6,3,426,2,280,0.0,214.0,140.0,1,146,0.0,146.0,146.0
108254721.0,6,206,23218,103,16198,1059210.862745098,284.0,157.2621359223301,103,7020,1059210.725490196,140.0,68.15533980582525
29511.0,6,14,4740,7,653,4702.333333333333,249.0,93.28571428571428,7,4087,4779.5,1514.0,583.8571428571429
120129784.0,6,420,50270,210,14156,570866.033492823,140.0,67.4095238095238,210,36114,574705.7511961722,284.0,171.97142857142856
120222838.0,6,220,24846,110,7556,1095410.3027522936,140.0,68.69090909090909,110,17290,1095434.128440367,374.0,157.1818181818182
93148075.0,17,14,1126,7,563,15500153.333333334,174.0,80.42857142857143,7,563,15500956.5,174.0,80.42857142857143
20853.0,6,10,2032,5,524,4479.25,252.0,104.8,5,1508,4254.75,1236.0,301.6
108129435.0,17,5,955,5,955,27032358.75,191.0,191.0,0,0,0.0,0.0,0.0
27150.0,6,10,2032,5,524,5322.25,252.0,104.8,5,1508,6479.75,1236.0,301.6
342.0,17,2,160,1,80,0.0,80.0,80.0,1,80,0.0,80.0,80.0
1295279.0,6,4,264,2,132,0.0,66.0,66.0,2,132,0.0,66.0,66.0
135129434.0,17,6,1146,6,1146,27025886.8,191.0,191.0,0,0,0.0,0.0,0.0
2367.0,17,4,344,2,150,0.0,75.0,75.0,2,194,0.0,103.0,97.0
201679.0,17,4,6056,4,6056,67226.33333333333,1514.0,1514.0,0,0,0.0,0.0,0.0
233431.0,6,3,337,2,214,0.0,160.0,107.0,1,123,0.0,123.0,123.0
2600187.0,6,2,132,1,66,0.0,66.0,66.0,1,66,0.0,66.0,66.0
1207260.0,17,7,490,7,490,201210.0,70.0,70.0,0,0,0.0,0.0,0.0
2048.0,17,4,344,2,150,0.0,75.0,75.0,2,194,0.0,103.0,97.0
95000840.0,17,13,1083,7,563,15833473.333333334,174.0,80.42857142857143,6,520,15001537.0,174.0,86.66666666666667
303665.0,6,2,132,1,66,0.0,66.0,66.0,1,66,0.0,66.0,66.0
10480314.0,6,7,478,4,272,3448104.0,74.0,68.0,3,206,5172062.0,74.0,68.66666666666667
20490.0,17,2,582,1,83,0.0,83.0,83.0,1,499,0.0,499.0,499.0
196935.0,17,2,180,1,90,0.0,90.0,90.0,1,90,0.0,90.0,90.0
13918339.0,17,5,1710,5,1710,3479584.75,342.0,342.0,0,0,0.0,0.0,0.0
2795782.0,6,2,132,1,66,0.0,66.0,66.0,1,66,0.0,66.0,66.0
38600.0,6,12,1328,6,731,6927.2,253.0,121.83333333333331,6,597,7325.4,259.0,99.5
121645701.0,17,14,1126,7,563,17000155.333333332,174.0,80.42857142857143,7,563,17001422.666666668,174.0,80.42857142857143
47911.0,6,14,4740,7,653,7767.5,249.0,93.28571428571428,7,4087,7026.166666666667,1514.0,583.8571428571429
95254.0,6,11,1132,6,556,18636.4,218.0,92.66666666666669,5,576,21946.5,304.0,115.2
29773.0,6,14,4740,7,653,4523.666666666667,249.0,93.28571428571428,7,4087,4667.666666666667,1514.0,583.8571428571429
2600967.0,6,2,132,1,66,0.0,66.0,66.0,1,66,0.0,66.0,66.0
313818.0,6,3,1604,2,851,0.0,785.0,425.5,1,753,0.0,753.0,753.0
631715.0,6,4,508,2,238,0.0,172.0,119.0,2,270,0.0,135.0,135.0
300114.0,6,6,412,4,272,100038.0,74.0,68.0,2,140,0.0,74.0,70.0
206102.0,6,3,426,2,280,0.0,214.0,140.0,1,146,0.0,146.0,146.0
108113720.0,17,5,1005,5,1005,27028430.0,201.0,201.0,0,0,0.0,0.0,0.0
333.0,17,2,166,1,75,0.0,75.0,75.0,1,91,0.0,91.0,91.0
16219.0,6,10,2032,5,524,3617.0,252.0,104.8,5,1508,3817.0,1236.0,301.6
7447.0,17,2,231,1,78,0.0,78.0,78.0,1,153,0.0,153.0,153.0
67663.0,6,14,4740,7,653,11012.5,249.0,93.28571428571428,7,4087,11004.5,1514.0,583.8571428571429
2895467.0,6,2,132,1,66,0.0,66.0,66.0,1,66,0.0,66.0,66.0
2596096.0,6,2,132,1,66,0.0,66.0,66.0,1,66,0.0,66.0,66.0
71718.0,6,14,4740,7,653,10839.166666666666,249.0,93.28571428571428,7,4087,11027.5,1514.0,583.8571428571429
18412.0,6,14,4740,7,653,2761.6666666666665,249.0,93.28571428571428,7,4087,2928.333333333333,1514.0,583.8571428571429
234424.0,6,3,337,2,214,0.0,160.0,107.0,1,123,0.0,123.0,123.0
18247.0,6,10,2032,5,524,4144.0,252.0,104.8,5,1508,4291.5,1236.0,301.6
5622087.0,6,5,336,2,134,0.0,68.0,67.0,3,202,1523822.5,70.0,67.33333333333333
135129154.0,17,6,1206,6,1206,27025830.8,201.0,201.0,0,0,0.0,0.0,0.0
196998.0,17,2,180,1,90,0.0,90.0,90.0,1,90,0.0,90.0,90.0
118902573.0,6,34,2350,17,1225,7417956.5625,139.0,72.05882352941177,17,1125,7417956.625,123.0,66.17647058823529
153419.0,17,2,180,1,90,0.0,90.0,90.0,1,90,0.0,90.0,90.0
205837.0,17,2,180,1,90,0.0,90.0,90.0,1,90,0.0,90.0,90.0
0.0,17,1,55,1,55,0.0,55.0,55.0,0,0,0.0,0.0,0.0
10522599.0,6,7,478,4,272,3461999.333333333,74.0,68.0,3,206,5192855.5,74.0,68.66666666666667
52333.0,6,14,4740,7,653,8120.333333333333,249.0,93.28571428571428,7,4087,8577.333333333334,1514.0,583.8571428571429
158799.0,6,3,337,2,214,0.0,160.0,107.0,1,123,0.0,123.0,123.0
246582.0,6,3,337,2,214,0.0,160.0,107.0,1,123,0.0,123.0,123.0
108116385.0,17,5,955,5,955,27029096.25,191.0,191.0,0,0,0.0,0.0,0.0
27091855.0,17,5,1710,5,1710,6772963.75,342.0,342.0,0,0,0.0,0.0,0.0
112238267.0,6,235,27128,118,8084,959301.4273504274,140.0,68.50847457627118,117,19044,958758.2068965518,336.0,162.76923076923077
120122268.0,6,14,2240,8,1016,17137084.285714287,188.0,127.0,6,1224,18018898.6,204.0,204.0
135139600.0,17,6,1206,6,1206,27027920.0,201.0,201.0,0,0,0.0,0.0,0.0
209570.0,17,2,180,1,90,0.0,90.0,90.0,1,90,0.0,90.0,90.0
305941.0,6,6,412,4,272,101980.33333333331,74.0,68.0,2,140,0.0,74.0,70.0
51314.0,6,14,4740,7,653,8343.0,249.0,93.28571428571428,7,4087,8391.333333333334,1514.0,583.8571428571429
119000998.0,17,15,1169,8,606,17000142.57142857,174.0,75.75,7,563,16503409.333333334,174.0,80.42857142857143
59677.0,17,2,762,2,762,0.0,381.0,381.0,0,0,0.0,0.0,0.0
80192.0,6,12,1354,6,723,15453.8,253.0,120.5,6,631,15035.6,293.0,105.16666666666669
4298.0,17,2,626,1,72,0.0,72.0,72.0,1,554,0.0,554.0,554.0
147939.0,17,2,180,1,90,0.0,90.0,90.0,1,90,0.0,90.0,90.0
42268.0,6,14,4740,7,653,6842.833333333333,249.0,93.28571428571428,7,4087,6909.166666666667,1514.0,583.8571428571429
32479.0,6,10,2032,5,524,5315.75,252.0,104.8,5,1508,7651.0,1236.0,301.6
206233.0,6,3,426,2,280,0.0,214.0,140.0,1,146,0.0,146.0,146.0
2062.0,17,4,344,2,150,0.0,75.0,75.0,2,194,0.0,103.0,97.0
232259.0,6,3,337,2,214,0.0,160.0,107.0,1,123,0.0,123.0,123.0
90092344.0,6,13,1776,6,948,18018152.6,204.0,158.0,7,828,15015035.333333334,188.0,118.28571428571428
10769356.0,6,5,1736,2,819,0.0,753.0,409.5,3,917,5315659.5,785.0,305.6666666666667
305810.0,6,2,1538,1,753,0.0,753.0,753.0,1,785,0.0,785.0,785.0
98441.0,17,2,762,2,762,0.0,381.0,381.0,0,0,0.0,0.0,0.0
8725704.0,17,3,1034,2,684,0.0,342.0,342.0,1,350,0.0,350.0,350.0
10522891.0,6,7,478,4,272,3462409.0,74.0,68.0,3,206,5193508.0,74.0,68.66666666666667
576804.0,6,4,508,2,238,0.0,172.0,119.0,2,270,0.0,135.0,135.0
48626747.0,6,8,1940,3,887,22904518.0,753.0,295.6666666666667,5,1053,11463692.5,785.0,210.6
116975.0,6,13,1386,7,789,18451.33333333333,253.0,112.71428571428572,6,597,22384.8,259.0,99.5
120109376.0,6,13,2036,8,1016,17135429.714285713,188.0,127.0,5,1020,22522492.75,204.0,204.0
88980509.0,17,14,4788,14,4788,6844654.538461538,342.0,342.0,0,0,0.0,0.0,0.0
246712.0,6,3,337,1,123,0.0,123.0,123.0,2,214,0.0,160.0,107.0
52950.0,6,14,4740,7,653,8467.833333333334,249.0,93.28571428571428,7,4087,7975.166666666667,1514.0,583.8571428571429
31239.0,6,13,4416,6,409,6104.4,127.0,68.16666666666667,7,4007,4353.333333333333,1514.0,572.4285714285714
2569.0,17,2,762,2,762,0.0,381.0,381.0,0,0,0.0,0.0,0.0
103372879.0,6,43,2838,21,1386,5112001.25,66.0,66.0,22,1452,4922506.333333333,66.0,66.0
895974.0,6,12,2709,7,743,149329.0,339.0,106.14285714285714,5,1966,155057.5,1514.0,393.2
196992.0,17,2,180,1,90,0.0,90.0,90.0,1,90,0.0,90.0,90.0
90011888.0,17,28,13364,28,13364,3333773.6296296297,501.0,477.2857142857143,0,0,0.0,0.0,0.0
316.0,17,2,164,1,82,0.0,82.0,82.0,1,82,0.0,82.0,82.0
47485.0,6,14,4740,7,653,7381.5,249.0,93.28571428571428,7,4087,5817.833333333333,1514.0,583.8571428571429
120127226.0,6,14,2240,6,1224,24025445.2,204.0,204.0,8,1016,17137211.285714287,188.0,127.0
228317.0,17,2,180,1,90,0.0,90.0,90.0,1,90,0.0,90.0,90.0
29465.0,6,14,4740,7,653,4772.5,249.0,93.28571428571428,7,4087,4502.333333333333,1514.0,583.8571428571429
102010062.0,17,13,821,7,432,17001677.0,174.0,61.71428571428572,6,389,16400156.6,174.0,64.83333333333333
299112.0,6,6,412,4,272,99704.0,74.0,68.0,2,140,0.0,74.0,70.0
99808016.0,17,12,778,6,389,19799653.2,174.0,64.83333333333333,6,389,19800166.0,174.0,64.83333333333333
95000788.0,17,11,735,6,389,19000157.6,174.0,64.83333333333333,5,346,18751149.5,174.0,69.2
2331.0,17,4,344,2,150,0.0,75.0,75.0,2,194,0.0,103.0,97.0
47433.0,6,14,4740,7,653,7218.666666666667,249.0,93.28571428571428,7,4087,7640.333333333333,1514.0,583.8571428571429
148001.0,17,2,180,1,90,0.0,90.0,90.0,1,90,0.0,90.0,90.0
304624.0,6,6,412,4,272,101541.33333333331,74.0,68.0,2,140,0.0,74.0,70.0
97458.0,17,2,762,2,762,0.0,381.0,381.0,0,0,0.0,0.0,0.0
404896.0,6,3,1604,2,851,0.0,785.0,425.5,1,753,0.0,753.0,753.0
258476.0,6,10,1221,6,636,51695.2,298.0,106.0,4,585,80721.66666666667,379.0,146.25
380.0,17,2,762,2,762,0.0,381.0,381.0,0,0,0.0,0.0,0.0
21066.0,6,14,4740,7,653,2406.6666666666665,249.0,93.28571428571428,7,4087,3361.333333333333,1514.0,583.8571428571429
3099.0,17,2,224,1,76,0.0,76.0,76.0,1,148,0.0,148.0,148.0
120055597.0,17,28,13364,28,13364,4446503.592592592,501.0,477.2857142857143,0,0,0.0,0.0,0.0
143938.0,17,2,180,1,90,0.0,90.0,90.0,1,90,0.0,90.0,90.0
303620.0,6,2,132,1,66,0.0,66.0,66.0,1,66,0.0,66.0,66.0
47255.0,6,14,4740,7,653,7721.833333333333,249.0,93.28571428571428,7,4087,6618.666666666667,1514.0,583.8571428571429
32682088.0,6,5,336,2,134,0.0,68.0,67.0,3,202,14950547.0,70.0,67.33333333333333
206468.0,6,3,426,2,280,0.0,214.0,140.0,1,146,0.0,146.0,146.0
91431672.0,6,24,1829,13,989,7618760.5,95.0,76.07692307692308,11,840,9141926.1,95.0,76.36363636363636
2004.0,17,4,344,2,150,0.0,75.0,75.0,2,194,0.0,103.0,97.0
308047.0,6,6,412,4,272,102682.33333333331,74.0,68.0,2,140,0.0,74.0,70.0
23641.0,6,10,2032,5,524,4892.25,252.0,104.8,5,1508,5376.25,1236.0,301.6
2971.0,17,2,180,1,90,0.0,90.0,90.0,1,90,0.0,90.0,90.0
539540.0,17,6,2100,6,2100,107908.0,350.0,350.0,0,0,0.0,0.0,0.0
59011.0,6,14,4740,7,653,7601.333333333333,249.0,93.28571428571428,7,4087,9680.0,1514.0,583.8571428571429
1590.0,17,2,762,2,762,0.0,381.0,381.0,0,0,0.0,0.0,0.0
205678.0,17,2,180,1,90,0.0,90.0,90.0,1,90,0.0,90.0,90.0
211944.0,17,4,6056,4,6056,70648.0,1514.0,1514.0,0,0,0.0,0.0,0.0
206638.0,6,3,426,2,280,0.0,214.0,140.0,1,146,0.0,146.0,146.0
22810.0,6,14,4740,7,653,3122.6666666666665,249.0,93.28571428571428,7,4087,3665.5,1514.0,583.8571428571429
2335.0,17,4,344,2,150,0.0,75.0,75.0,2,194,0.0,103.0,97.0
2689476.0,6,28,9195,16,3843,179298.4,1514.0,240.1875,12,5352,220611.18181818185,1514.0,446.0
9903.0,6,10,2032,5,524,2192.75,252.0,104.8,5,1508,2192.75,1236.0,301.6
120000017.0,6,17,1287,9,691,15000002.125,95.0,76.77777777777777,8,596,12898378.0,95.0,74.5
302447.0,6,2,132,1,66,0.0,66.0,66.0,1,66,0.0,66.0,66.0
119329940.0,6,26,1937,14,1043,9179226.153846154,95.0,74.5,12,894,10826051.454545457,95.0,74.5
90000935.0,6,14,1043,7,542,15000155.833333334,95.0,77.42857142857143,7,501,14953139.666666666,95.0,71.57142857142857
3089082.0,6,4,270,2,134,0.0,68.0,67.0,2,136,0.0,70.0,68.0
49606.0,6,10,2032,5,524,12171.75,252.0,104.8,5,1508,10668.5,1236.0,301.6
92670.0,17,2,700,2,700,0.0,350.0,350.0,0,0,0.0,0.0,0.0
108105382.0,17,5,955,5,955,27026345.5,191.0,191.0,0,0,0.0,0.0,0.0
5622403.0,6,5,336,2,134,0.0,68.0,67.0,3,202,1422668.0,70.0,67.33333333333333
90486.0,17,4,1400,4,1400,30162.0,350.0,350.0,0,0,0.0,0.0,0.0
90300465.0,6,16,1192,8,596,12893398.0,95.0,74.5,8,596,12898277.142857144,95.0,74.5
9234.0,17,2,582,1,83,0.0,83.0,83.0,1,499,0.0,499.0,499.0
97516017.0,17,14,1126,7,563,16168706.666666666,174.0,80.42857142857143,7,563,16166819.5,174.0,80.42857142857143
343.0,17,2,160,1,80,0.0,80.0,80.0,1,80,0.0,80.0,80.0
213247.0,6,3,426,2,280,0.0,214.0,140.0,1,146,0.0,146.0,146.0
2997779.0,17,2,906,2,906,0.0,453.0,453.0,0,0,0.0,0.0,0.0
108118073.0,17,5,1005,5,1005,27029518.25,201.0,201.0,0,0,0.0,0.0,0.0
2004.0,17,4,344,2,150,0.0,75.0,75.0,2,194,0.0,103.0,97.0
121328.0,6,3,337,2,214,0.0,160.0,107.0,1,123,0.0,123.0,123.0
871743.0,6,9,1268,6,797,174348.6,459.0,132.83333333333334,3,471,298073.5,331.0,157.0
1020467.0,6,10,1065,5,534,254878.0,262.0,106.8,5,531,254004.0,259.0,106.2
14124030.0,17,6,2052,6,2052,2824806.0,342.0,342.0,0,0,0.0,0.0,0.0
328.0,17,2,166,1,75,0.0,75.0,75.0,1,91,0.0,91.0,91.0
22705.0,17,2,582,1,83,0.0,83.0,83.0,1,499,0.0,499.0,499.0
217895.0,6,3,426,2,280,0.0,214.0,140.0,1,146,0.0,146.0,146.0
314215.0,6,2,132,1,66,0.0,66.0,66.0,1,66,0.0,66.0,66.0
119809911.0,6,1006,239778,489,33310,245483.93032786885,214.0,68.11860940695297,517,206468,231090.1899224806,1514.0,399.357833655706
61472.0,6,10,1066,5,490,13941.0,218.0,98.0,5,576,15161.5,304.0,115.2
5005754.0,17,4,849,2,166,0.0,83.0,83.0,2,683,0.0,499.0,341.5
314224.0,17,4,1400,4,1400,104741.33333333331,350.0,350.0,0,0,0.0,0.0,0.0
90330988.0,6,24,1829,13,989,7521659.083333333,95.0,76.07692307692308,11,840,8959032.8,95.0,76.36363636363636
111815932.0,17,14,864,7,432,18500972.666666668,174.0,61.71428571428572,7,432,18500163.5,174.0,61.71428571428572
56095.0,6,14,4740,7,653,9224.5,249.0,93.28571428571428,7,4087,8721.333333333334,1514.0,583.8571428571429
30382.0,6,14,4740,7,653,4787.833333333333,249.0,93.28571428571428,7,4087,4865.833333333333,1514.0,583.8571428571429
135184203.0,17,6,1146,6,1146,27036840.6,191.0,191.0,0,0,0.0,0.0,0.0
117297796.0,17,14,864,7,432,19500160.666666668,174.0,61.71428571428572,7,432,19501600.166666668,174.0,61.71428571428572
27600630.0,17,5,1710,5,1710,6900157.5,342.0,342.0,0,0,0.0,0.0,0.0
362954.0,6,11,1021,6,444,48832.6,162.0,74.0,5,577,60834.75,349.0,115.4
120003960.0,6,447,52540,224,37526,538134.3497757848,336.0,167.52678571428572,223,15014,538479.2072072072,140.0,67.32735426008969
47088.0,6,14,4740,7,653,7318.833333333333,249.0,93.28571428571428,7,4087,7433.5,1514.0,583.8571428571429
144710.0,17,2,180,1,70,0.0,70.0,70.0,1,110,0.0,110.0,110.0
17731425.0,6,5,1736,2,819,0.0,753.0,409.5,3,917,8797405.5,785.0,305.6666666666667
2257.0,17,4,344,2,150,0.0,75.0,75.0,2,194,0.0,103.0,97.0
90730778.0,6,18,1382,9,691,7586696.875,95.0,76.77777777777777,9,691,11340001.75,95.0,76.77777777777777
25162.0,6,14,4740,7,653,3908.8333333333335,249.0,93.28571428571428,7,4087,3711.6666666666665,1514.0,583.8571428571429
0.0,17,1,55,1,55,0.0,55.0,55.0,0,0,0.0,0.0,0.0
11323.0,6,2,145,2,145,0.0,91.0,72.5,0,0,0.0,0.0,0.0
123475278.0,17,14,1126,7,563,17286987.5,174.0,80.42857142857143,7,563,17334123.666666668,174.0,80.42857142857143
34208.0,6,14,4740,7,653,5332.333333333333,249.0,93.28571428571428,7,4087,5262.666666666667,1514.0,583.8571428571429
123302230.0,6,48,3168,24,1584,5037302.521739131,66.0,66.0,24,1584,5259304.652173913,66.0,66.0
299261.0,6,6,412,4,272,99753.66666666669,74.0,68.0,2,140,0.0,74.0,70.0
2008910.0,17,4,525,2,150,0.0,75.0,75.0,2,375,0.0,284.0,187.5
127714994.0,6,30,1974,15,948,8409235.92857143,123.0,63.2,15,1026,8409240.785714285,123.0,68.4
5005091.0,17,4,849,2,166,0.0,83.0,83.0,2,683,0.0,499.0,341.5
1302549.0,6,4,264,2,132,0.0,66.0,66.0,2,132,0.0,66.0,66.0
0.0,17,1,179,1,179,0.0,179.0,179.0,0,0,0.0,0.0,0.0
120165192.0,6,254,28886,127,8678,947068.5476190476,140.0,68.33070866141732,127,20208,947126.4761904762,300.0,159.11811023622047
90036301.0,17,27,12943,27,12943,3462934.653846154,501.0,479.3703703703704,0,0,0.0,0.0,0.0
90037282.0,17,28,13364,28,13364,3334714.1481481483,501.0,477.2857142857143,0,0,0.0,0.0,0.0
216642.0,17,2,180,1,90,0.0,90.0,90.0,1,90,0.0,90.0,90.0
189806.0,6,12,1354,6,723,36904.0,253.0,120.5,6,631,37040.4,293.0,105.16666666666669
143944.0,17,2,180,1,90,0.0,90.0,90.0,1,90,0.0,90.0,90.0
243092.0,6,3,373,2,238,0.0,172.0,119.0,1,135,0.0,135.0,135.0
69382.0,6,14,4740,7,653,11156.666666666666,249.0,93.28571428571428,7,4087,11358.833333333334,1514.0,583.8571428571429
90366986.0,6,15,2460,8,1632,12908939.142857144,204.0,204.0,7,828,15015867.333333334,188.0,118.28571428571428
5619955.0,6,5,336,2,134,0.0,68.0,67.0,3,202,1423557.0,70.0,67.33333333333333
2301.0,17,4,344,2,150,0.0,75.0,75.0,2,194,0.0,103.0,97.0
12302.0,17,2,224,1,76,0.0,76.0,76.0,1,148,0.0,148.0,148.0
1054.0,17,4,438,2,148,0.0,74.0,74.0,2,290,0.0,147.0,145.0
691.0,17,2,762,2,762,0.0,381.0,381.0,0,0,0.0,0.0,0.0
218643.0,6,3,426,2,280,0.0,214.0,140.0,1,146,0.0,146.0,146.0
228258.0,17,2,180,1,90,0.0,90.0,90.0,1,90,0.0,90.0,90.0
233096.0,6,3,373,2,238,0.0,172.0,119.0,1,135,0.0,135.0,135.0
15784.0,6,10,1065,5,534,3039.25,262.0,106.8,5,531,3580.75,259.0,106.2
146582.0,6,3,337,2,214,0.0,160.0,107.0,1,123,0.0,123.0,123.0
1321337.0,6,4,264,2,132,0.0,66.0,66.0,2,132,0.0,66.0,66.0
0.0,17,1,381,1,381,0.0,381.0,381.0,0,0,0.0,0.0,0.0
108536629.0,6,198,22314,99,15558,1105321.448979592,284.0,157.15151515151516,99,6756,1105321.4795918367,140.0,68.24242424242425
108619.0,17,2,286,2,286,0.0,143.0,143.0,0,0,0.0,0.0,0.0
233735.0,6,3,337,2,214,0.0,160.0,107.0,1,123,0.0,123.0,123.0
33394.0,6,14,4740,7,653,5410.166666666667,249.0,93.28571428571428,7,4087,4966.166666666667,1514.0,583.8571428571429
90372534.0,6,26,1762,13,922,7513044.25,139.0,70.92307692307692,13,840,7513044.25,123.0,64.61538461538461
2310.0,17,4,344,2,150,0.0,75.0,75.0,2,194,0.0,103.0,97.0
1040827.0,6,11,1134,6,558,208165.4,220.0,93.0,5,576,258096.25,304.0,115.2
21280.0,6,11,2098,6,590,3054.8,252.0,98.33333333333331,5,1508,4884.25,1236.0,301.6
367.0,17,2,267,1,83,0.0,83.0,83.0,1,184,0.0,184.0,184.0
107197.0,17,2,286,2,286,0.0,143.0,143.0,0,0,0.0,0.0,0.0
253691.0,6,3,373,2,238,0.0,172.0,119.0,1,135,0.0,135.0,135.0
62068.0,6,10,2032,5,524,14927.5,252.0,104.8,5,1508,13605.5,1236.0,301.6
59239.0,6,14,4740,7,653,9710.5,249.0,93.28571428571428,7,4087,9593.333333333334,1514.0,583.8571428571429
401.0,17,2,410,1,78,0.0,78.0,78.0,1,332,0.0,332.0,332.0
36714.0,6,14,4740,7,653,5961.5,249.0,93.28571428571428,7,4087,5178.666666666667,1514.0,583.8571428571429
71440.0,6,14,4740,7,653,11007.0,249.0,93.28571428571428,7,4087,10400.0,1514.0,583.8571428571429
249783.0,6,3,337,2,214,0.0,160.0,107.0,1,123,0.0,123.0,123.0
101013.0,17,2,762,2,762,0.0,381.0,381.0,0,0,0.0,0.0,0.0
169193.0,17,2,414,1,88,0.0,88.0,88.0,1,326,0.0,326.0,326.0
103325.0,17,2,286,2,286,0.0,143.0,143.0,0,0,0.0,0.0,0.0
141207.0,6,11,1132,6,556,28241.4,218.0,92.66666666666669,5,576,35033.25,304.0,115.2
9873.0,17,2,582,1,83,0.0,83.0,83.0,1,499,0.0,499.0,499.0
843085.0,6,9,1096,6,625,168617.0,287.0,104.16666666666669,3,471,283948.0,331.0,157.0
51728695.0,6,8,2113,3,960,24537320.0,826.0,320.0,5,1153,12237094.0,885.0,230.6
111454451.0,17,18,1614,10,929,12383827.888888888,174.0,92.9,8,685,15565409.0,174.0,85.625
98298886.0,6,186,20982,93,14622,1066082.891304348,284.0,157.2258064516129,93,6360,1066113.4673913044,140.0,68.38709677419355
3243.0,17,2,224,1,76,0.0,76.0,76.0,1,148,0.0,148.0,148.0
0.0,6,1,66,1,66,0.0,66.0,66.0,0,0,0.0,0.0,0.0
90039747.0,17,28,13364,28,13364,3334805.4444444445,501.0,477.2857142857143,0,0,0.0,0.0,0.0
3511774.0,6,7,923,4,753,1101965.6666666667,571.0,188.25,3,170,1653597.0,62.0,56.66666666666666
281338.0,17,2,363,1,79,0.0,79.0,79.0,1,284,0.0,284.0,284.0
146079.0,6,3,337,2,214,0.0,160.0,107.0,1,123,0.0,123.0,123.0
120000104.0,6,20,1531,11,840,12000010.4,95.0,76.36363636363636,9,691,11342581.75,95.0,76.77777777777777
2298.0,17,4,344,2,150,0.0,75.0,75.0,2,194,0.0,103.0,97.0
437403.0,6,11,1021,6,444,58732.6,162.0,74.0,5,577,73209.0,349.0,115.4
107655475.0,6,27,1822,14,982,8281190.384615385,139.0,70.14285714285714,13,840,8121219.416666667,123.0,64.61538461538461
208539.0,6,3,426,2,280,0.0,214.0,140.0,1,146,0.0,146.0,146.0
135137963.0,17,6,1206,6,1206,27027592.6,201.0,201.0,0,0,0.0,0.0,0.0
146153.0,6,3,337,2,214,0.0,160.0,107.0,1,123,0.0,123.0,123.0
5918.0,17,2,180,1,90,0.0,90.0,90.0,1,90,0.0,90.0,90.0
90258790.0,6,13,2036,8,1016,12894112.857142856,188.0,127.0,5,1020,22523598.25,204.0,204.0
196963.0,17,2,180,1,90,0.0,90.0,90.0,1,90,0.0,90.0,90.0
77656.0,6,13,1386,7,789,8893.5,253.0,112.71428571428572,6,597,15041.0,259.0,99.5
114859.0,17,4,1400,4,1400,38286.333333333336,350.0,350.0,0,0,0.0,0.0,0.0
153824.0,17,2,180,1,90,0.0,90.0,90.0,1,90,0.0,90.0,90.0
90300975.0,6,21,1585,11,840,9025711.7,95.0,76.36363636363636,10,745,10000215.222222222,95.0,74.5
21466971.0,6,6,1981,4,1087,7155657.0,885.0,271.75,2,894,0.0,826.0,447.0
36400.0,6,14,4740,7,653,5918.5,249.0,93.28571428571428,7,4087,5407.666666666667,1514.0,583.8571428571429
81775.0,6,14,4740,7,653,13239.833333333334,249.0,93.28571428571428,7,4087,8980.666666666666,1514.0,583.8571428571429
148056.0,17,2,180,1,90,0.0,90.0,90.0,1,90,0.0,90.0,90.0
2055876.0,17,8,1640,4,312,685161.3333333334,78.0,78.0,4,1328,685146.0,332.0,332.0
100766043.0,6,31,2314,16,1228,6703357.466666667,139.0,76.75,15,1086,7182165.642857143,123.0,72.4
0.0,6,1,66,1,66,0.0,66.0,66.0,0,0,0.0,0.0,0.0
1049393.0,6,13,1394,7,797,174898.83333333334,253.0,113.85714285714286,6,597,206053.6,259.0,99.5
333.0,17,2,160,1,80,0.0,80.0,80.0,1,80,0.0,80.0,80.0
84108.0,6,14,4740,7,653,13532.333333333334,249.0,93.28571428571428,7,4087,12713.0,1514.0,583.8571428571429
503897.00000000006,6,5,336,2,134,0.0,68.0,67.0,3,202,190487.5,70.0,67.33333333333333
10478941.0,6,7,478,4,272,3447511.0,74.0,68.0,3,206,5171158.0,74.0,68.66666666666667
0.0,17,1,453,1,453,0.0,453.0,453.0,0,0,0.0,0.0,0.0
159134.0,6,2,128,1,74,0.0,74.0,74.0,1,54,0.0,54.0,54.0
126655.0,17,4,1400,4,1400,42218.333333333336,350.0,350.0,0,0,0.0,0.0,0.0
146189.0,6,3,337,2,214,0.0,160.0,107.0,1,123,0.0,123.0,123.0
120110594.0,6,13,2036,5,1020,30027648.5,204.0,204.0,8,1016,17135112.85714286,188.0,127.0
120183138.0,6,371,43272,186,12498,649638.5837837838,140.0,67.19354838709677,185,30774,651865.5054347826,284.0,166.34594594594594
0.0,17,1,342,1,342,0.0,342.0,342.0,0,0,0.0,0.0,0.0
5005402.0,17,2,174,2,174,0.0,87.0,87.0,0,0,0.0,0.0,0.0
108744912.0,6,34,2466,17,1272,6796557.0,123.0,74.82352941176471,17,1194,6783027.0625,123.0,70.23529411764706
117005145.0,17,13,821,7,432,19500857.5,174.0,61.71428571428572,6,389,19400182.2,174.0,64.83333333333333
307572.0,6,6,412,4,272,102524.0,74.0,68.0,2,140,0.0,74.0,70.0
2805952.0,6,2,132,1,66,0.0,66.0,66.0,1,66,0.0,66.0,66.0
587700.0,6,13,1439,7,714,97950.0,298.0,102.0,6,725,116999.0,379.0,120.83333333333331
37632.0,6,14,4740,7,653,5779.166666666667,249.0,93.28571428571428,7,4087,5792.333333333333,1514.0,583.8571428571429
1345234.0,17,16,1120,16,1120,89682.26666666666,70.0,70.0,0,0,0.0,0.0,0.0
120056681.0,6,296,35406,148,25416,815238.2585034013,374.0,171.72972972972974,148,9990,815240.0,140.0,67.5
119572298.0,6,21,1585,10,745,13285810.888888888,95.0,74.5,11,840,11930289.8,95.0,76.36363636363636
325.0,17,2,208,1,72,0.0,72.0,72.0,1,136,0.0,136.0,136.0
19749.0,6,11,2098,6,590,3620.0,252.0,98.33333333333331,5,1508,4116.0,1236.0,301.6
135132376.0,17,6,1206,6,1206,27026475.2,201.0,201.0,0,0,0.0,0.0,0.0
93619133.0,6,173,19600,87,13702,1088594.5697674418,284.0,157.49425287356323,86,5898,1091759.811764706,140.0,68.5813953488372
46143.0,6,14,4740,7,653,7547.333333333333,249.0,93.28571428571428,7,4087,7063.333333333333,1514.0,583.8571428571429
601296.0,17,3,551,2,156,0.0,78.0,78.0,1,395,0.0,395.0,395.0
120269303.0,6,17,1287,9,691,15033662.875,95.0,76.77777777777777,8,596,17107796.714285713,95.0,74.5
27236894.0,17,5,1710,5,1710,6809223.5,342.0,342.0,0,0,0.0,0.0,0.0
19826.0,6,10,2032,5,524,4332.75,252.0,104.8,5,1508,4639.0,1236.0,301.6
213645.0,17,2,180,1,90,0.0,90.0,90.0,1,90,0.0,90.0,90.0
90294940.0,6,16,1192,8,596,12891716.857142856,95.0,74.5,8,596,12896210.285714284,95.0,74.5
90253069.0,6,12,1832,8,1016,12893295.57142857,188.0,127.0,4,816,30029780.33333333,204.0,204.0
318.0,17,2,174,1,79,0.0,79.0,79.0,1,95,0.0,95.0,95.0
508389.0,6,5,336,2,134,0.0,68.0,67.0,3,202,194106.0,70.0,67.33333333333333
206130.0,17,2,180,1,90,0.0,90.0,90.0,1,90,0.0,90.0,90.0
2015.0,17,2,180,1,90,0.0,90.0,90.0,1,90,0.0,90.0,90.0
147997.0,17,2,180,1,90,0.0,90.0,90.0,1,90,0.0,90.0,90.0
153518.0,17,2,180,1,90,0.0,90.0,90.0,1,90,0.0,90.0,90.0
90256288.0,6,12,1832,8,1016,12893755.42857143,188.0,127.0,4,816,30030459.0,204.0,204.0
104872804.0,6,31,2314,16,1228,6977123.933333334,139.0,76.75,15,1086,7475493.428571428,123.0,72.4
2379.0,17,4,344,2,150,0.0,75.0,75.0,2,194,0.0,103.0,97.0
206130.0,17,2,180,1,90,0.0,90.0,90.0,1,90,0.0,90.0,90.0
2450.0,17,4,344,2,150,0.0,75.0,75.0,2,194,0.0,103.0,97.0
96834409.0,6,27,1954,14,1045,7432173.615384615,139.0,74.64285714285714,13,909,8051551.333333333,123.0,69.92307692307692
61386.0,6,14,4740,7,653,10110.333333333334,249.0,93.28571428571428,7,4087,8845.0,1514.0,583.8571428571429
120082507.0,17,29,13785,29,13785,4288660.964285715,501.0,475.3448275862069,0,0,0.0,0.0,0.0
109435231.0,6,2225,1945366,1535,1899814,71339.7855280313,1514.0,1237.6638436482085,690,45552,158820.2525399129,78.0,66.01739130434783
108098668.0,17,5,955,5,955,27024667.0,191.0,191.0,0,0,0.0,0.0,0.0
107538.0,17,4,1400,4,1400,35846.0,350.0,350.0,0,0,0.0,0.0,0.0
3166236.0,6,18,1495,9,921,358369.25,315.0,102.33333333333331,9,574,358350.0,78.0,63.77777777777778
2323.0,17,4,344,2,150,0.0,75.0,75.0,2,194,0.0,103.0,97.0
104215669.0,6,30,2128,16,1165,6931388.066666666,139.0,72.8125,14,963,7999987.0,123.0,68.78571428571429
234175.0,6,3,337,2,214,0.0,160.0,107.0,1,123,0.0,123.0,123.0
1589255.0,17,6,1230,3,234,794440.0,78.0,78.0,3,996,794419.5,332.0,332.0
91243685.0,6,33,2688,19,1518,5056520.833333333,123.0,79.89473684210526,14,1170,7001193.692307692,123.0,83.57142857142857
333592.0,6,6,412,4,272,111197.33333333331,74.0,68.0,2,140,0.0,74.0,70.0
332.0,17,2,166,1,75,0.0,75.0,75.0,1,91,0.0,91.0,91.0
234263.0,6,3,337,2,214,0.0,160.0,107.0,1,123,0.0,123.0,123.0
135132391.0,17,6,1146,6,1146,27026478.2,191.0,191.0,0,0,0.0,0.0,0.0
300.0,17,2,168,1,76,0.0,76.0,76.0,1,92,0.0,92.0,92.0
122001161.0,17,15,907,8,475,17428737.285714287,174.0,59.375,7,432,17001621.5,174.0,61.71428571428572
1550459.0,17,8,1640,4,312,516278.0,78.0,78.0,4,1328,516683.6666666667,332.0,332.0
16463.0,6,11,1133,6,602,2915.4,264.0,100.33333333333331,5,531,3791.75,259.0,106.2
239864.0,6,13,1394,7,797,39977.333333333336,253.0,113.85714285714286,6,597,46154.6,259.0,99.5
90259402.0,6,12,1832,8,1016,12894200.285714284,188.0,127.0,4,816,30032010.33333333,204.0,204.0
114174629.0,6,48,3168,24,1584,4964114.304347826,66.0,66.0,24,1584,4952135.0869565215,66.0,66.0
232879.0,6,3,337,2,214,0.0,160.0,107.0,1,123,0.0,123.0,123.0
117573535.0,6,34,2350,17,1225,7334864.9375,139.0,72.05882352941177,17,1125,7334866.4375,123.0,66.17647058823529
19872.0,17,2,582,1,83,0.0,83.0,83.0,1,499,0.0,499.0,499.0
491.0,17,2,267,1,83,0.0,83.0,83.0,1,184,0.0,184.0,184.0
106304.0,17,2,286,2,286,0.0,143.0,143.0,0,0,0.0,0.0,0.0
204730.0,17,2,762,2,762,0.0,381.0,381.0,0,0,0.0,0.0,0.0
21519.0,6,14,4740,7,653,3358.6666666666665,249.0,93.28571428571428,7,4087,3171.333333333333,1514.0,583.8571428571429
253205.0,17,4,6056,4,6056,84401.66666666666,1514.0,1514.0,0,0,0.0,0.0,0.0
2799152.0,6,2,132,1,66,0.0,66.0,66.0,1,66,0.0,66.0,66.0
90205951.0,6,24,1829,11,840,8996952.1,95.0,76.36363636363636,13,989,7500044.083333333,95.0,76.07692307692308
46372.0,6,14,4740,7,653,7577.0,249.0,93.28571428571428,7,4087,2508.833333333333,1514.0,583.8571428571429
34433.0,6,14,4740,7,653,5568.666666666667,249.0,93.28571428571428,7,4087,4880.833333333333,1514.0,583.8571428571429
23264.0,6,10,1066,5,490,3917.75,218.0,98.0,5,576,5606.25,304.0,115.2
106328.0,17,2,700,2,700,0.0,350.0,350.0,0,0,0.0,0.0,0.0
200359.0,17,2,180,1,90,0.0,90.0,90.0,1,90,0.0,90.0,90.0
200888.0,17,4,6056,4,6056,66962.66666666667,1514.0,1514.0,0,0,0.0,0.0,0.0
12750.0,6,12,1393,6,796,2328.6,271.0,132.66666666666666,6,597,2360.6,259.0,99.5
26577.0,6,10,2032,5,524,4136.5,252.0,104.8,5,1508,6237.0,1236.0,301.6
5623825.0,6,4,270,2,134,0.0,68.0,67.0,2,136,0.0,70.0,68.0
108101833.0,17,5,955,5,955,27025458.25,191.0,191.0,0,0,0.0,0.0,0.0
111577.0,17,2,286,2,286,0.0,143.0,143.0,0,0,0.0,0.0,0.0
9861.0,17,2,582,1,83,0.0,83.0,83.0,1,499,0.0,499.0,499.0
90219910.0,6,14,1964,8,1016,12888558.57142857,188.0,127.0,6,948,18011568.6,204.0,158.0
2329.0,17,4,344,2,150,0.0,75.0,75.0,2,194,0.0,103.0,97.0
43073.0,6,12,1447,6,816,8024.2,291.0,136.0,6,631,7226.8,293.0,105.16666666666669
68623.0,6,14,4740,7,653,11164.833333333334,249.0,93.28571428571428,7,4087,11287.5,1514.0,583.8571428571429
121980.0,6,3,337,2,214,0.0,160.0,107.0,1,123,0.0,123.0,123.0
108715468.0,6,32,2220,16,1149,7247697.866666666,123.0,71.8125,16,1071,7233277.466666667,123.0,66.9375
46261.0,6,14,4740,7,653,7585.333333333333,249.0,93.28571428571428,7,4087,7504.833333333333,1514.0,583.8571428571429
41542.0,6,14,4740,7,653,6798.333333333333,249.0,93.28571428571428,7,4087,6723.0,1514.0,583.8571428571429
319245.0,6,6,412,4,272,106415.0,74.0,68.0,2,140,0.0,74.0,70.0
135131882.0,17,6,1146,6,1146,27026376.4,191.0,191.0,0,0,0.0,0.0,0.0
120572735.0,17,14,995,8,606,17224676.42857143,174.0,75.75,6,389,19151285.0,174.0,64.83333333333333
108107589.0,17,5,955,5,955,27026897.25,191.0,191.0,0,0,0.0,0.0,0.0
306304.0,17,4,1524,4,1524,102101.33333333331,381.0,381.0,0,0,0.0,0.0,0.0
143971.0,17,2,180,1,90,0.0,90.0,90.0,1,90,0.0,90.0,90.0
90035821.0,17,28,13364,28,13364,3334660.037037037,501.0,477.2857142857143,0,0,0.0,0.0,0.0
119557509.0,6,229,25822,115,7886,1048750.0789473683,140.0,68.57391304347826,114,17936,1048975.8230088495,284.0,157.33333333333334
300175.0,6,6,412,4,272,100058.33333333331,74.0,68.0,2,140,0.0,74.0,70.0
919.0,17,5,550,5,550,229.75,110.0,110.0,0,0,0.0,0.0,0.0
16701979.999999998,6,5,1736,2,819,0.0,753.0,409.5,3,917,7053186.5,785.0,305.6666666666667
233280.0,6,3,337,2,214,0.0,160.0,107.0,1,123,0.0,123.0,123.0
135133769.0,17,6,1206,6,1206,27026753.8,201.0,201.0,0,0,0.0,0.0,0.0
37998.0,6,10,2032,5,524,8703.25,252.0,104.8,5,1508,6561.25,1236.0,301.6
1307638.0,6,4,264,2,132,0.0,66.0,66.0,2,132,0.0,66.0,66.0
108108944.0,17,5,1005,5,1005,27027236.0,201.0,201.0,0,0,0.0,0.0,0.0
19943.0,6,10,2032,5,524,4431.0,252.0,104.8,5,1508,4745.0,1236.0,301.6
2310.0,17,4,344,2,150,0.0,75.0,75.0,2,194,0.0,103.0,97.0
108102343.0,17,5,1005,5,1005,27025585.75,201.0,201.0,0,0,0.0,0.0,0.0
3494.0,17,2,359,1,75,0.0,75.0,75.0,1,284,0.0,284.0,284.0
395.0,17,2,191,1,73,0.0,73.0,73.0,1,118,0.0,118.0,118.0
51300.0,6,10,2032,5,524,11893.0,252.0,104.8,5,1508,10849.5,1236.0,301.6
32685302.0,6,5,336,2,134,0.0,68.0,67.0,3,202,14952694.5,70.0,67.33333333333333
90257439.0,6,14,2240,8,1016,12893919.857142856,188.0,127.0,6,1224,18018175.0,204.0,204.0
120235.0,17,2,180,1,70,0.0,70.0,70.0,1,110,0.0,110.0,110.0
109499.0,17,2,286,2,286,0.0,143.0,143.0,0,0,0.0,0.0,0.0
302399.0,6,2,132,1,66,0.0,66.0,66.0,1,66,0.0,66.0,66.0
2371.0,17,4,344,2,150,0.0,75.0,75.0,2,194,0.0,103.0,97.0
5004396.0,17,4,534,2,166,0.0,83.0,83.0,2,368,0.0,184.0,184.0
4354906.0,6,173,147493,104,138638,42280.64077669903,1510.0,1333.0576923076924,69,8855,59432.10294117647,1510.0,128.33333333333334
5004787.0,17,4,629,2,156,0.0,78.0,78.0,2,473,0.0,268.0,236.5
218337.0,17,2,180,1,90,0.0,90.0,90.0,1,90,0.0,90.0,90.0
87236.0,6,14,4740,7,653,13894.5,249.0,93.28571428571428,7,4087,13534.333333333334,1514.0,583.8571428571429
613.0,17,2,508,2,508,0.0,257.0,254.0,0,0,0.0,0.0,0.0
302598.0,6,6,412,4,272,100866.0,74.0,68.0,2,140,0.0,74.0,70.0
118001031.0,17,13,821,7,432,19666838.5,174.0,61.71428571428572,6,389,19601281.4,174.0,64.83333333333333
249636.0,6,3,373,2,238,0.0,172.0,119.0,1,135,0.0,135.0,135.0
2318.0,17,4,344,2,150,0.0,75.0,75.0,2,194,0.0,103.0,97.0
2439.0,17,4,344,2,150,0.0,75.0,75.0,2,194,0.0,103.0,97.0
256597.00000000003,6,3,337,2,214,0.0,160.0,107.0,1,123,0.0,123.0,123.0
38896.0,6,14,4740,7,653,4995.666666666667,249.0,93.28571428571428,7,4087,6344.833333333333,1514.0,583.8571428571429
22089.0,6,10,2032,5,524,5300.25,252.0,104.8,5,1508,4990.75,1236.0,301.6
98961059.0,6,243,29848,122,8274,817859.9917355372,140.0,67.81967213114754,121,21574,816114.0083333333,406.0,178.29752066115702
27251.0,6,14,4740,7,653,4426.666666666667,249.0,93.28571428571428,7,4087,4407.0,1514.0,583.8571428571429
2364.0,17,4,344,2,150,0.0,75.0,75.0,2,194,0.0,103.0,97.0
137011167.0,17,17,1255,9,649,17126395.875,174.0,72.11111111111111,8,606,16523896.42857143,174.0,75.75
206989.0,17,4,6056,4,6056,68996.33333333333,1514.0,1514.0,0,0,0.0,0.0,0.0
2074728.0,6,19,6869,11,1567,207472.8,408.0,142.45454545454547,8,5302,233592.8571428572,1514.0,662.75
90013334.0,17,28,13364,28,13364,3333827.185185185,501.0,477.2857142857143,0,0,0.0,0.0,0.0
140210.0,6,2,132,1,66,0.0,66.0,66.0,1,66,0.0,66.0,66.0
200158.0,17,2,180,1,90,0.0,90.0,90.0,1,90,0.0,90.0,90.0
198992.0,17,2,180,1,90,0.0,90.0,90.0,1,90,0.0,90.0,90.0
238942.0,6,3,337,2,214,0.0,160.0,107.0,1,123,0.0,123.0,123.0
105556.0,17,2,700,2,700,0.0,350.0,350.0,0,0,0.0,0.0,0.0
832.0,17,4,438,2,148,0.0,74.0,74.0,2,290,0.0,147.0,145.0
3234230.0,6,176,147200,103,138080,31708.13725490196,1510.0,1340.5825242718447,73,9120,40515.09722222222,1510.0,124.93150684931508
205922.0,6,3,426,2,280,0.0,214.0,140.0,1,146,0.0,146.0,146.0
63309.00000000001,6,10,2032,5,524,14423.25,252.0,104.8,5,1508,15208.75,1236.0,301.6
926245.0,6,10,1334,6,797,185249.0,459.0,132.83333333333334,4,537,217862.0,331.0,134.25
108115394.0,17,5,1005,5,1005,27028848.5,201.0,201.0,0,0,0.0,0.0,0.0
12953.0,6,11,1132,6,556,2543.6,218.0,92.66666666666669,5,576,2954.0,304.0,115.2
203266.0,17,2,180,1,90,0.0,90.0,90.0,1,90,0.0,90.0,90.0
306519.0,6,6,412,4,272,102173.0,74.0,68.0,2,140,0.0,74.0,70.0
404018.0,6,4,508,2,238,0.0,172.0,119.0,2,270,0.0,135.0,135.0
414.0,17,2,166,1,75,0.0,75.0,75.0,1,91,0.0,91.0,91.0
228242.0,17,2,180,1,90,0.0,90.0,90.0,1,90,0.0,90.0,90.0
245915.0,6,3,337,2,214,0.0,160.0,107.0,1,123,0.0,123.0,123.0
90038454.0,17,28,13364,28,13364,3334757.5555555555,501.0,477.2857142857143,0,0,0.0,0.0,0.0
250443.00000000003,6,10,1221,6,636,50088.6,298.0,106.0,4,585,81894.33333333333,379.0,146.25
108104803.0,17,5,1005,5,1005,27026200.75,201.0,201.0,0,0,0.0,0.0,0.0
143841.0,17,2,180,1,90,0.0,90.0,90.0,1,90,0.0,90.0,90.0
307971.0,6,6,412,4,272,102657.0,74.0,68.0,2,140,0.0,74.0,70.0
317968.0,6,6,412,4,272,105989.33333333331,74.0,68.0,2,140,0.0,74.0,70.0
304291.0,6,6,412,4,272,101430.33333333331,74.0,68.0,2,140,0.0,74.0,70.0
90255454.0,6,14,2240,8,1016,12893636.285714284,188.0,127.0,6,1224,18018297.8,204.0,204.0
208462.0,17,2,762,2,762,0.0,381.0,381.0,0,0,0.0,0.0,0.0
39070955.0,17,9,3078,9,3078,4883869.375,342.0,342.0,0,0,0.0,0.0,0.0
55689.0,6,14,4740,7,653,9152.166666666666,249.0,93.28571428571428,7,4087,8745.833333333334,1514.0,583.8571428571429
153416.0,17,2,180,1,90,0.0,90.0,90.0,1,90,0.0,90.0,90.0
11079.0,6,10,1067,5,536,2301.75,264.0,107.2,5,531,2474.5,259.0,106.2
2291.0,17,4,344,2,150,0.0,75.0,75.0,2,194,0.0,103.0,97.0
29901550.0,6,4,270,3,202,14950775.0,70.0,67.33333333333333,1,68,0.0,68.0,68.0
305.0,17,2,164,1,82,0.0,82.0,82.0,1,82,0.0,82.0,82.0
108106108.0,17,5,955,5,955,27026527.0,191.0,191.0,0,0,0.0,0.0,0.0
30737.0,6,2,132,1,66,0.0,66.0,66.0,1,66,0.0,66.0,66.0
213699.0,17,2,180,1,90,0.0,90.0,90.0,1,90,0.0,90.0,90.0
439581.0,6,11,1021,6,444,59154.2,162.0,74.0,5,577,73774.5,349.0,115.4
309230.0,6,6,412,4,272,103076.66666666669,74.0,68.0,2,140,0.0,74.0,70.0
95128192.0,17,12,778,6,389,19000162.8,174.0,64.83333333333333,6,389,19001190.8,174.0,64.83333333333333
45825.0,6,10,2032,5,524,11229.0,252.0,104.8,5,1508,11170.0,1236.0,301.6
153463.0,17,2,180,1,90,0.0,90.0,90.0,1,90,0.0,90.0,90.0
47038.0,6,14,4740,7,653,7679.666666666667,249.0,93.28571428571428,7,4087,6530.333333333333,1514.0,583.8571428571429
122277020.0,6,222,25106,111,7548,1086221.7818181815,140.0,68.0,111,17558,1094694.4363636365,284.0,158.18018018018017
228378.0,17,2,180,1,90,0.0,90.0,90.0,1,90,0.0,90.0,90.0
116504008.0,6,48,3168,24,1584,5065391.652173913,66.0,66.0,24,1584,5053421.173913044,66.0,66.0
90256882.0,6,12,1832,8,1016,12893840.285714284,188.0,127.0,4,816,30031387.666666668,204.0,204.0
322.0,17,2,164,1,82,0.0,82.0,82.0,1,82,0.0,82.0,82.0
135135869.0,17,6,1206,6,1206,27027173.8,201.0,201.0,0,0,0.0,0.0,0.0
235866.0,6,3,373,2,238,0.0,172.0,119.0,1,135,0.0,135.0,135.0
31528.0,6,14,4740,7,653,4308.666666666667,249.0,93.28571428571428,7,4087,4363.666666666667,1514.0,583.8571428571429
915.0,17,4,438,2,148,0.0,74.0,74.0,2,290,0.0,147.0,145.0
198844.0,17,2,180,1,90,0.0,90.0,90.0,1,90,0.0,90.0,90.0
119811916.0,17,35,16705,35,16705,3523879.882352941,501.0,477.2857142857143,0,0,0.0,0.0,0.0
228330.0,17,2,180,1,90,0.0,90.0,90.0,1,90,0.0,90.0,90.0
20588.0,6,14,4740,7,653,3275.1666666666665,249.0,93.28571428571428,7,4087,3195.6666666666665,1514.0,583.8571428571429
120025355.0,17,29,13785,29,13785,4286619.821428572,501.0,475.3448275862069,0,0,0.0,0.0,0.0
175579.0,6,10,1066,5,490,43005.25,218.0,98.0,5,576,43463.0,304.0,115.2
144126.0,17,2,180,1,90,0.0,90.0,90.0,1,90,0.0,90.0,90.0
14639178.0,6,20,1728,10,1096,1592720.7777777778,315.0,109.6,10,632,1592698.111111111,78.0,63.2
67038.0,6,14,4740,7,653,8138.5,249.0,93.28571428571428,7,4087,10554.333333333334,1514.0,583.8571428571429
17207.0,6,10,2032,5,524,3573.75,252.0,104.8,5,1508,3708.25,1236.0,301.6
108104255.0,17,5,1005,5,1005,27026063.75,201.0,201.0,0,0,0.0,0.0,0.0
15056663.0,17,6,2718,6,2718,3011332.6,453.0,453.0,0,0,0.0,0.0,0.0
2350.0,17,4,344,2,150,0.0,75.0,75.0,2,194,0.0,103.0,97.0
2672961.0,6,28,9195,16,3843,178197.4,1514.0,240.1875,12,5352,218936.8181818181,1514.0,446.0
3155100.0,6,3,1604,2,851,0.0,785.0,425.5,1,753,0.0,753.0,753.0
3007384.0,6,11,2106,6,598,601290.0,252.0,99.66666666666669,5,1508,1823.75,1236.0,301.6
6843.0,17,2,565,1,93,0.0,93.0,93.0,1,472,0.0,472.0,472.0
302403.0,6,2,132,1,66,0.0,66.0,66.0,1,66,0.0,66.0,66.0
298.0,17,2,156,1,78,0.0,78.0,78.0,1,78,0.0,78.0,78.0
34389.0,6,14,4740,7,653,5528.0,249.0,93.28571428571428,7,4087,5285.666666666667,1514.0,583.8571428571429
306195.0,6,6,412,4,272,102065.0,74.0,68.0,2,140,0.0,74.0,70.0
1117.0,17,5,550,5,550,279.25,110.0,110.0,0,0,0.0,0.0,0.0
12981.0,6,10,1067,5,536,2659.25,264.0,107.2,5,531,2895.5,259.0,106.2
27078.0,6,14,4740,7,653,4389.333333333333,249.0,93.28571428571428,7,4087,4161.833333333333,1514.0,583.8571428571429
22350.0,6,14,4740,7,653,3499.333333333333,249.0,93.28571428571428,7,4087,2929.6666666666665,1514.0,583.8571428571429
53598.0,6,14,4740,7,653,8353.166666666666,249.0,93.28571428571428,7,4087,8741.333333333334,1514.0,583.8571428571429
116211953.0,6,48,3168,24,1584,5052693.608695652,66.0,66.0,24,1584,5043296.478260869,66.0,66.0
3114233.0,6,3,1777,2,951,0.0,885.0,475.5,1,826,0.0,826.0,826.0
36783.0,6,14,4740,7,653,5891.166666666667,249.0,93.28571428571428,7,4087,5661.333333333333,1514.0,583.8571428571429
228165.0,17,2,180,1,90,0.0,90.0,90.0,1,90,0.0,90.0,90.0
204722.0,17,2,762,2,762,0.0,381.0,381.0,0,0,0.0,0.0,0.0
143914.0,17,2,180,1,90,0.0,90.0,90.0,1,90,0.0,90.0,90.0
258666.0,6,3,373,2,238,0.0,172.0,119.0,1,135,0.0,135.0,135.0
300373.0,6,6,412,4,272,100124.33333333331,74.0,68.0,2,140,0.0,74.0,70.0
90258567.0,6,14,2240,8,1016,12894081.0,188.0,127.0,6,1224,18018566.2,204.0,204.0
135139390.0,17,6,1146,6,1146,27027878.0,191.0,191.0,0,0,0.0,0.0,0.0
381288.0,6,4,270,3,202,190644.0,70.0,67.33333333333333,1,68,0.0,68.0,68.0
108108415.0,17,5,955,5,955,27027103.75,191.0,191.0,0,0,0.0,0.0,0.0
103429.0,17,2,762,2,762,0.0,381.0,381.0,0,0,0.0,0.0,0.0
330547.0,6,6,412,4,272,110182.33333333331,74.0,68.0,2,140,0.0,74.0,70.0
253451.0,6,3,337,2,214,0.0,160.0,107.0,1,123,0.0,123.0,123.0
2082.0,17,4,344,2,150,0.0,75.0,75.0,2,194,0.0,103.0,97.0
113282582.0,6,30,1974,15,1026,8076206.928571428,123.0,68.4,15,948,8076180.0,123.0,63.2
33501.0,6,11,1131,6,600,6540.2,262.0,100.0,5,531,8018.75,259.0,106.2
20771.0,6,11,1132,6,556,3818.2,218.0,92.66666666666669,5,576,4444.75,304.0,115.2
90288069.0,6,14,1043,7,542,15048011.5,95.0,77.42857142857143,7,501,15000308.166666666,95.0,71.57142857142857
3281412.0,6,3,1604,2,851,0.0,785.0,425.5,1,753,0.0,753.0,753.0
205616.0,6,10,1221,6,636,41123.2,298.0,106.0,4,585,66768.66666666667,379.0,146.25
839348.0,6,6,758,3,410,415931.5,172.0,136.66666666666666,3,348,297636.0,135.0,116.0
216625.0,17,2,180,1,90,0.0,90.0,90.0,1,90,0.0,90.0,90.0
153708.0,17,2,180,1,90,0.0,90.0,90.0,1,90,0.0,90.0,90.0
122557865.0,6,33,2296,17,1225,7659866.5625,139.0,72.05882352941177,16,1071,7490425.866666666,123.0,66.9375
196961.0,17,2,180,1,90,0.0,90.0,90.0,1,90,0.0,90.0,90.0
1760732.0,6,19,7533,10,1403,195636.88888888888,583.0,140.3,9,6130,188461.625,1484.0,681.1111111111111
135135816.0,17,6,1206,6,1206,27027163.2,201.0,201.0,0,0,0.0,0.0,0.0
90042030.0,17,28,13364,28,13364,3334890.0,501.0,477.2857142857143,0,0,0.0,0.0,0.0
19780.0,6,13,1459,7,862,2720.333333333333,271.0,123.14285714285714,6,597,3807.6,259.0,99.5
137342.0,6,2,132,1,66,0.0,66.0,66.0,1,66,0.0,66.0,66.0
171142.0,17,2,1500,1,994,0.0,994.0,994.0,1,506,0.0,506.0,506.0
213815.0,17,2,180,1,90,0.0,90.0,90.0,1,90,0.0,90.0,90.0
106570.0,17,2,286,2,286,0.0,143.0,143.0,0,0,0.0,0.0,0.0
38554.0,6,14,4740,7,653,6270.833333333333,249.0,93.28571428571428,7,4087,6288.333333333333,1514.0,583.8571428571429
1314880.0,6,4,264,2,132,0.0,66.0,66.0,2,132,0.0,66.0,66.0
120124636.0,6,14,2240,8,1016,17137105.57142857,188.0,127.0,6,1224,18019423.8,204.0,204.0
100610.0,17,2,286,2,286,0.0,143.0,143.0,0,0,0.0,0.0,0.0
2389.0,17,4,344,2,150,0.0,75.0,75.0,2,194,0.0,103.0,97.0
748025.0,6,2,132,1,66,0.0,66.0,66.0,1,66,0.0,66.0,66.0
22092.0,6,10,2032,5,524,5300.75,252.0,104.8,5,1508,3838.5,1236.0,301.6
10888477.0,6,7,478,3,206,5373529.5,74.0,68.66666666666667,4,272,3582270.333333333,74.0,68.0
53649.0,6,14,4740,7,653,8740.0,249.0,93.28571428571428,7,4087,8034.5,1514.0,583.8571428571429
0.0,6,1,66,1,66,0.0,66.0,66.0,0,0,0.0,0.0,0.0
2334.0,17,4,344,2,150,0.0,75.0,75.0,2,194,0.0,103.0,97.0
306636.0,6,6,412,4,272,102212.0,74.0,68.0,2,140,0.0,74.0,70.0
133010097.0,17,15,907,8,475,19001442.42857143,174.0,59.375,7,432,18826314.666666668,174.0,61.71428571428572
35740.0,6,10,2032,5,524,8664.25,252.0,104.8,5,1508,7360.0,1236.0,301.6
944.0,17,2,762,2,762,0.0,381.0,381.0,0,0,0.0,0.0,0.0
301328.0,6,6,412,4,272,100442.66666666669,74.0,68.0,2,140,0.0,74.0,70.0
44751.0,6,14,4740,7,653,7277.166666666667,249.0,93.28571428571428,7,4087,7128.833333333333,1514.0,583.8571428571429
205686.0,17,2,180,1,90,0.0,90.0,90.0,1,90,0.0,90.0,90.0
328.0,17,2,174,1,79,0.0,79.0,79.0,1,95,0.0,95.0,95.0
5004993.0,17,4,849,2,166,0.0,83.0,83.0,2,683,0.0,499.0,341.5
90369984.0,6,11,1644,7,828,15061664.0,188.0,118.28571428571428,4,816,20113378.0,204.0,204.0
11669.0,6,10,1067,5,536,2750.5,264.0,107.2,5,531,2123.0,259.0,106.2
90257636.0,6,12,1832,8,1016,12893948.0,188.0,127.0,4,816,30030876.33333333,204.0,204.0
108116306.0,17,5,955,5,955,27029076.5,191.0,191.0,0,0,0.0,0.0,0.0
827192.0,6,9,1118,6,586,165438.4,248.0,97.66666666666669,3,532,277229.5,392.0,177.33333333333334
318.0,17,2,174,1,79,0.0,79.0,79.0,1,95,0.0,95.0,95.0
171597.0,17,2,180,1,90,0.0,90.0,90.0,1,90,0.0,90.0,90.0
120004326.0,6,20,1490,10,745,13333814.0,95.0,74.5,10,745,13304579.333333334,95.0,74.5
221265.0,6,10,1221,6,636,44253.0,298.0,106.0,4,585,71755.33333333333,379.0,146.25
108107865.0,17,5,1005,5,1005,27026966.25,201.0,201.0,0,0,0.0,0.0,0.0
46588892.0,6,8,2113,3,960,22348081.5,826.0,320.0,5,1153,10949698.0,885.0,230.6
45777.0,6,14,4740,7,653,6935.166666666667,249.0,93.28571428571428,7,4087,7489.333333333333,1514.0,583.8571428571429
104853.0,17,2,700,2,700,0.0,350.0,350.0,0,0,0.0,0.0,0.0
100183.0,17,2,762,2,762,0.0,381.0,381.0,0,0,0.0,0.0,0.0
316625.0,17,4,1400,4,1400,105541.66666666669,350.0,350.0,0,0,0.0,0.0,0.0
308486.0,6,6,412,4,272,102828.66666666669,74.0,68.0,2,140,0.0,74.0,70.0
36561.0,6,14,4740,7,653,5899.166666666667,249.0,93.28571428571428,7,4087,5955.333333333333,1514.0,583.8571428571429
2405.0,17,4,344,2,150,0.0,75.0,75.0,2,194,0.0,103.0,97.0
90255611.0,6,14,2252,8,1028,12893658.714285716,188.0,128.5,6,1224,18018059.2,204.0,204.0
736.0,17,2,684,2,684,0.0,342.0,342.0,0,0,0.0,0.0,0.0
112578970.0,6,48,3168,24,1584,4894737.826086956,66.0,66.0,24,1584,4889739.304347826,66.0,66.0
108105395.0,17,5,1005,5,1005,27026348.75,201.0,201.0,0,0,0.0,0.0,0.0
147933.0,17,2,180,1,90,0.0,90.0,90.0,1,90,0.0,90.0,90.0
2267.0,17,4,344,2,150,0.0,75.0,75.0,2,194,0.0,103.0,97.0
120268150.0,6,238,27148,119,8162,1012267.4322033898,140.0,68.58823529411765,119,18986,1011796.7881355932,284.0,159.54621848739495
1324332.0,6,4,264,2,132,0.0,66.0,66.0,2,132,0.0,66.0,66.0
118116485.0,6,47,3102,23,1518,5112000.181818182,66.0,66.0,24,1584,5135488.782608695,66.0,66.0
1312072.0,17,7,490,7,490,218678.66666666663,70.0,70.0,0,0,0.0,0.0,0.0
228167.0,17,2,180,1,90,0.0,90.0,90.0,1,90,0.0,90.0,90.0
316361.0,17,4,1400,4,1400,105453.66666666669,350.0,350.0,0,0,0.0,0.0,0.0
157800.0,17,2,180,1,90,0.0,90.0,90.0,1,90,0.0,90.0,90.0
2153.0,17,2,180,1,90,0.0,90.0,90.0,1,90,0.0,90.0,90.0
234751.0,6,3,373,2,238,0.0,172.0,119.0,1,135,0.0,135.0,135.0
116161.0,17,4,1400,4,1400,38720.333333333336,350.0,350.0,0,0,0.0,0.0,0.0
20905.0,6,11,2098,6,590,3995.0,252.0,98.33333333333331,5,1508,4541.0,1236.0,301.6
153436.0,17,2,180,1,90,0.0,90.0,90.0,1,90,0.0,90.0,90.0
56804.0,6,2,132,1,66,0.0,66.0,66.0,1,66,0.0,66.0,66.0
123250442.0,6,49,3234,25,1650,5135435.083333333,66.0,66.0,24,1584,5079288.391304348,66.0,66.0
108108606.0,17,5,955,5,955,27027151.5,191.0,191.0,0,0,0.0,0.0,0.0
2410.0,17,4,344,2,150,0.0,75.0,75.0,2,194,0.0,103.0,97.0
20188.0,17,2,582,1,83,0.0,83.0,83.0,1,499,0.0,499.0,499.0
228548.0,17,2,180,1,90,0.0,90.0,90.0,1,90,0.0,90.0,90.0
162290.0,17,2,180,1,90,0.0,90.0,90.0,1,90,0.0,90.0,90.0
298180.0,17,2,180,1,90,0.0,90.0,90.0,1,90,0.0,90.0,90.0
120954093.0,6,33,2280,17,1209,7559630.8125,123.0,71.11764705882354,16,1071,7383552.333333333,123.0,66.9375
107024076.0,6,42,2772,22,1452,5096384.571428572,66.0,66.0,20,1320,5209062.315789473,66.0,66.0
78070.0,6,14,4740,7,653,12009.5,249.0,93.28571428571428,7,4087,12758.833333333334,1514.0,583.8571428571429
10455992.0,6,7,478,4,272,3439762.0,74.0,68.0,3,206,5159497.5,74.0,68.66666666666667
202065.0,17,2,762,2,762,0.0,381.0,381.0,0,0,0.0,0.0,0.0
144218.0,17,2,180,1,90,0.0,90.0,90.0,1,90,0.0,90.0,90.0
90531423.0,6,15,2444,8,1016,12933060.42857143,188.0,127.0,7,1428,15061200.333333334,204.0,204.0
36070.0,6,14,4740,7,653,5884.666666666667,249.0,93.28571428571428,7,4087,5750.833333333333,1514.0,583.8571428571429
90026975.0,17,27,12943,27,12943,3462575.961538461,501.0,479.3703703703704,0,0,0.0,0.0,0.0
32989.0,6,10,2032,5,524,7289.5,252.0,104.8,5,1508,7966.25,1236.0,301.6
51150796.0,6,8,1307,8,1307,7307256.571428572,172.0,163.375,0,0,0.0,0.0,0.0
314364.0,17,4,1400,4,1400,104788.0,350.0,350.0,0,0,0.0,0.0,0.0
17926.0,6,11,1133,6,602,2721.2,264.0,100.33333333333331,5,531,4269.75,259.0,106.2
2803068.0,6,2,132,1,66,0.0,66.0,66.0,1,66,0.0,66.0,66.0
20959770.0,17,3,1034,2,684,0.0,342.0,342.0,1,350,0.0,350.0,350.0
314.0,17,2,174,1,79,0.0,79.0,79.0,1,95,0.0,95.0,95.0
120116536.0,6,601,75780,301,20088,400388.4533333333,140.0,66.7375415282392,300,55692,398319.1304347826,390.0,185.64
216397.0,17,2,180,1,90,0.0,90.0,90.0,1,90,0.0,90.0,90.0
147073.0,17,4,704,2,148,0.0,74.0,74.0,2,556,0.0,280.0,278.0
27924.0,6,10,2032,5,524,6629.0,252.0,104.8,5,1508,6626.75,1236.0,301.6
155918.0,17,4,1524,4,1524,51972.66666666666,381.0,381.0,0,0,0.0,0.0,0.0
3002.0,17,2,224,1,76,0.0,76.0,76.0,1,148,0.0,148.0,148.0
395.0,17,2,762,2,762,0.0,381.0,381.0,0,0,0.0,0.0,0.0
282366.0,17,2,180,1,90,0.0,90.0,90.0,1,90,0.0,90.0,90.0
217453.0,6,3,426,2,280,0.0,214.0,140.0,1,146,0.0,146.0,146.0
1339889.0,17,16,1120,16,1120,89325.93333333333,70.0,70.0,0,0,0.0,0.0,0.0
14633361.0,6,20,1607,10,975,1592497.3333333333,315.0,97.5,10,632,1592474.0,78.0,63.2
299652.0,6,6,412,4,272,99884.0,74.0,68.0,2,140,0.0,74.0,70.0
303459.0,6,6,412,4,272,101153.0,74.0,68.0,2,140,0.0,74.0,70.0
3008122.0,6,12,2172,7,664,501281.3333333333,252.0,94.85714285714286,5,1508,2277.75,1236.0,301.6
28211.0,6,10,1067,5,536,6525.75,264.0,107.2,5,531,3926.5,259.0,106.2
302572.0,6,6,412,4,272,100857.33333333331,74.0,68.0,2,140,0.0,74.0,70.0
4151.0,17,2,582,1,83,0.0,83.0,83.0,1,499,0.0,499.0,499.0
107466770.0,17,16,1212,8,606,15352395.714285716,174.0,75.75,8,606,15279016.285714284,174.0,75.75
149720236.0,6,15,2290,5,1020,29962221.75,204.0,204.0,10,1270,16635406.888888888,188.0,127.0
312651.0,17,4,1400,4,1400,104217.0,350.0,350.0,0,0,0.0,0.0,0.0
1054733.0,6,3,1604,1,753,0.0,753.0,753.0,2,851,0.0,785.0,425.5
0.0,6,1,66,1,66,0.0,66.0,66.0,0,0,0.0,0.0,0.0
31585.000000000004,6,14,4740,7,653,5147.333333333333,249.0,93.28571428571428,7,4087,4992.666666666667,1514.0,583.8571428571429
40050.0,6,14,4740,7,653,6430.666666666667,249.0,93.28571428571428,7,4087,6195.333333333333,1514.0,583.8571428571429
297543.0,6,6,412,4,272,99181.0,74.0,68.0,2,140,0.0,74.0,70.0
108099408.0,17,5,1005,5,1005,27024852.0,201.0,201.0,0,0,0.0,0.0,0.0
2485.0,17,2,691,1,349,0.0,349.0,349.0,1,342,0.0,342.0,342.0
100015846.0,17,12,516,6,258,20000172.4,43.0,43.0,6,258,20000932.4,43.0,43.0
217896.0,6,3,426,2,280,0.0,214.0,140.0,1,146,0.0,146.0,146.0
10515112.0,6,7,478,4,272,3459623.333333333,74.0,68.0,3,206,5189379.0,74.0,68.66666666666667
417.0,17,2,410,1,78,0.0,78.0,78.0,1,332,0.0,332.0,332.0
16746.0,6,11,1133,6,602,3153.4,264.0,100.33333333333331,5,531,3849.0,259.0,106.2
108111529.0,17,5,955,5,955,27027882.25,191.0,191.0,0,0,0.0,0.0,0.0
120042565.0,6,22,1693,11,799,11999302.9,95.0,72.63636363636364,11,894,11999578.7,153.0,81.27272727272727
153390.0,17,2,180,1,90,0.0,90.0,90.0,1,90,0.0,90.0,90.0
26706.0,6,10,2032,5,524,6298.0,252.0,104.8,5,1508,6380.0,1236.0,301.6
152154.0,17,2,414,1,88,0.0,88.0,88.0,1,326,0.0,326.0,326.0
3228190.0,6,3,204,2,136,0.0,70.0,68.0,1,68,0.0,68.0,68.0
120216578.0,6,230,25940,115,7886,1047331.7631578948,140.0,68.57391304347826,115,18054,1047310.2368421052,284.0,156.9913043478261
1307647.0,6,4,264,2,132,0.0,66.0,66.0,2,132,0.0,66.0,66.0
40528.0,6,14,4740,7,653,6631.833333333333,249.0,93.28571428571428,7,4087,6379.666666666667,1514.0,583.8571428571429
43350.0,6,14,4740,7,653,7102.0,249.0,93.28571428571428,7,4087,7041.0,1514.0,583.8571428571429
5616.0,17,4,823,2,163,0.0,89.0,81.5,2,660,0.0,443.0,330.0
184418.0,17,2,180,1,90,0.0,90.0,90.0,1,90,0.0,90.0,90.0
120282490.0,6,226,25546,113,7766,1066576.5892857143,140.0,68.72566371681415,113,17780,1066613.3214285714,284.0,157.34513274336285
41497.0,6,14,4740,7,653,6199.833333333333,249.0,93.28571428571428,7,4087,6682.0,1514.0,583.8571428571429
1160877.0,6,13,3010,8,2382,165839.57142857142,1514.0,297.75,5,628,222063.25,331.0,125.6
2058.0,17,4,344,2,150,0.0,75.0,75.0,2,194,0.0,103.0,97.0
946.0,17,4,438,2,148,0.0,74.0,74.0,2,290,0.0,147.0,145.0
327.0,17,2,208,1,72,0.0,72.0,72.0,1,136,0.0,136.0,136.0
134928.0,6,2,132,1,66,0.0,66.0,66.0,1,66,0.0,66.0,66.0
76507327.0,6,26,7605,14,1892,5861551.615384615,408.0,135.14285714285714,12,5713,6927256.454545454,1514.0,476.0833333333333
5629769.0,6,5,336,2,134,0.0,68.0,67.0,3,202,1423194.5,70.0,67.33333333333333
18096.0,6,14,4740,7,653,2528.6666666666665,249.0,93.28571428571428,7,4087,2653.0,1514.0,583.8571428571429
146126.0,6,3,337,2,214,0.0,160.0,107.0,1,123,0.0,123.0,123.0
120361059.0,6,47,3102,23,1518,5143997.954545454,66.0,66.0,24,1584,5233078.826086956,66.0,66.0
10842030.0,6,8,544,4,272,3568531.6666666665,74.0,68.0,4,272,3568448.6666666665,74.0,68.0
65337.00000000001,6,10,2032,5,524,16105.5,252.0,104.8,5,1508,16132.5,1236.0,301.6
145594.0,6,2,132,1,66,0.0,66.0,66.0,1,66,0.0,66.0,66.0
204490.0,17,2,180,1,90,0.0,90.0,90.0,1,90,0.0,90.0,90.0
206491.0,17,2,762,2,762,0.0,381.0,381.0,0,0,0.0,0.0,0.0
313178.0,6,6,412,4,272,104392.66666666669,74.0,68.0,2,140,0.0,74.0,70.0
443.0,17,2,508,2,508,0.0,257.0,254.0,0,0,0.0,0.0,0.0
120421529.0,6,257,29396,129,20726,940793.1953125,284.0,160.66666666666666,128,8670,940137.7244094488,140.0,67.734375
298288.0,6,6,412,4,272,99429.33333333331,74.0,68.0,2,140,0.0,74.0,70.0
382.0,17,2,508,2,508,0.0,257.0,254.0,0,0,0.0,0.0,0.0
330.0,17,2,166,1,75,0.0,75.0,75.0,1,91,0.0,91.0,91.0
104693627.0,17,14,864,7,432,17333929.0,174.0,61.71428571428572,7,432,17333506.833333332,174.0,61.71428571428572
108103587.0,17,5,1005,5,1005,27025896.75,201.0,201.0,0,0,0.0,0.0,0.0
90293320.0,6,16,1192,8,596,12892568.0,95.0,74.5,8,596,12898201.142857144,95.0,74.5
120043672.0,17,28,13364,28,13364,4446061.925925926,501.0,477.2857142857143,0,0,0.0,0.0,0.0
1028868.0,6,11,1134,6,558,205773.60000000003,220.0,93.0,5,576,255379.75,304.0,115.2
90293564.0,6,14,1043,7,542,15048927.333333334,95.0,77.42857142857143,7,501,14998888.666666666,95.0,71.57142857142857
302429.0,6,6,412,4,272,100809.66666666669,74.0,68.0,2,140,0.0,74.0,70.0
693446.0,6,6,758,3,410,302342.5,172.0,136.66666666666666,3,348,227321.0,135.0,116.0
284312.0,17,2,363,1,79,0.0,79.0,79.0,1,284,0.0,284.0,284.0
107717.0,17,2,286,2,286,0.0,143.0,143.0,0,0,0.0,0.0,0.0
377594.0,17,2,363,1,75,0.0,75.0,75.0,1,288,0.0,288.0,288.0
1450613.0,6,7,499,3,198,717111.0,66.0,66.0,4,301,427837.6666666667,103.0,75.25
263181.0,6,3,337,2,214,0.0,160.0,107.0,1,123,0.0,123.0,123.0
162167.0,17,4,1400,4,1400,54055.66666666666,350.0,350.0,0,0,0.0,0.0,0.0
198249.0,17,2,762,2,762,0.0,381.0,381.0,0,0,0.0,0.0,0.0
90032618.0,17,28,13364,28,13364,3334541.407407407,501.0,477.2857142857143,0,0,0.0,0.0,0.0
103200201.0,6,42,2772,21,1386,5159997.5,66.0,66.0,21,1386,5159997.3,66.0,66.0
231864.0,6,3,337,2,214,0.0,160.0,107.0,1,123,0.0,123.0,123.0
3420661.0,6,5,336,2,134,0.0,68.0,67.0,3,202,1525932.5,70.0,67.33333333333333
2579.0,17,4,344,2,150,0.0,75.0,75.0,2,194,0.0,103.0,97.0
143744.0,6,2,132,1,66,0.0,66.0,66.0,1,66,0.0,66.0,66.0
303774.0,6,6,412,4,272,101258.0,74.0,68.0,2,140,0.0,74.0,70.0
1177459.0,6,13,3010,8,2382,168208.42857142858,1514.0,297.75,5,628,225443.0,331.0,125.6
2397.0,17,4,344,2,150,0.0,75.0,75.0,2,194,0.0,103.0,97.0
27403.0,6,14,4740,7,653,4088.0,249.0,93.28571428571428,7,4087,4438.333333333333,1514.0,583.8571428571429
2409.0,17,4,344,2,150,0.0,75.0,75.0,2,194,0.0,103.0,97.0
145100.0,17,2,180,1,90,0.0,90.0,90.0,1,90,0.0,90.0,90.0
90283987.0,6,14,1043,7,542,15047331.166666666,95.0,77.42857142857143,7,501,14997971.333333334,95.0,71.57142857142857
90783546.0,6,22,1680,12,894,8248981.181818182,95.0,74.5,10,786,10085939.111111112,95.0,78.6
90101783.0,6,11,1644,4,816,30033128.0,204.0,204.0,7,828,15016579.833333334,188.0,118.28571428571428
100772286.0,6,31,2182,16,1165,6704526.533333333,139.0,72.8125,15,1017,7183421.785714285,123.0,67.8
81312770.0,6,19,1334,9,640,10163026.375,95.0,71.11111111111111,10,694,9034313.0,95.0,69.4
45048.0,6,10,2032,5,524,10903.25,252.0,104.8,5,1508,9838.25,1236.0,301.6
2594340.0,6,2,132,1,66,0.0,66.0,66.0,1,66,0.0,66.0,66.0
70000694.0,17,9,649,5,346,17500173.5,174.0,69.2,4,303,16668524.0,174.0,75.75
26137816.0,6,33,10980,18,3951,145163.70588235295,1514.0,219.5,15,7029,1851590.142857143,1514.0,468.6
328.0,17,2,174,1,79,0.0,79.0,79.0,1,95,0.0,95.0,95.0
1475905.0,17,16,1120,16,1120,98393.66666666669,70.0,70.0,0,0,0.0,0.0,0.0
0.0,17,1,72,1,72,0.0,72.0,72.0,0,0,0.0,0.0,0.0
115286559.0,6,215,24336,108,7424,1077444.476635514,140.0,68.74074074074075,107,16912,1078902.8113207547,284.0,158.05607476635515
2050.0,17,4,344,2,150,0.0,75.0,75.0,2,194,0.0,103.0,97.0
109004934.0,17,13,821,7,432,18167489.0,174.0,61.71428571428572,6,389,17800201.4,174.0,64.83333333333333
100000851.0,17,11,473,6,258,20000170.2,43.0,43.0,5,215,20000813.75,43.0,43.0
316556.0,6,6,412,4,272,105518.66666666669,74.0,68.0,2,140,0.0,74.0,70.0
18267.0,6,11,2098,6,590,3587.8,252.0,98.33333333333331,5,1508,4343.75,1236.0,301.6
3176886.0,6,18,1495,9,921,358361.125,315.0,102.33333333333331,9,574,358392.5,78.0,63.77777777777778
2594205.0,6,2,132,1,66,0.0,66.0,66.0,1,66,0.0,66.0,66.0
908.0,17,5,550,5,550,227.0,110.0,110.0,0,0,0.0,0.0,0.0
45106.0,6,14,4740,7,653,7390.833333333333,249.0,93.28571428571428,7,4087,6907.666666666667,1514.0,583.8571428571429
2722.0,17,2,762,2,762,0.0,381.0,381.0,0,0,0.0,0.0,0.0
44242.0,6,14,4740,7,653,6116.166666666667,249.0,93.28571428571428,7,4087,7052.0,1514.0,583.8571428571429
48802.0,6,14,4740,7,653,7242.333333333333,249.0,93.28571428571428,7,4087,7946.0,1514.0,583.8571428571429
228216.0,17,2,180,1,90,0.0,90.0,90.0,1,90,0.0,90.0,90.0
284872.0,17,2,363,1,79,0.0,79.0,79.0,1,284,0.0,284.0,284.0
3601.0,17,4,344,2,150,0.0,75.0,75.0,2,194,0.0,103.0,97.0
120365404.0,6,225,25340,113,17652,1074691.107142857,284.0,156.21238938053096,112,7688,1075455.3423423425,140.0,68.64285714285714
201010.0,17,2,762,2,762,0.0,381.0,381.0,0,0,0.0,0.0,0.0
108109495.0,17,5,955,5,955,27027373.75,191.0,191.0,0,0,0.0,0.0,0.0
116404436.0,6,279,32626,140,9462,837441.9856115108,140.0,67.58571428571429,139,23164,836071.0652173914,374.0,166.6474820143885
116497251.0,6,224,25312,112,17624,1047585.4954954956,284.0,157.35714285714286,112,7688,1047584.5045045044,140.0,68.64285714285714
20376.0,6,14,4740,7,653,3129.333333333333,249.0,93.28571428571428,7,4087,3164.5,1514.0,583.8571428571429
90306504.0,6,16,1192,8,596,12892448.0,95.0,74.5,8,596,12900111.0,95.0,74.5
35818.0,6,14,4740,7,653,5622.5,249.0,93.28571428571428,7,4087,5829.166666666667,1514.0,583.8571428571429
2802077.0,6,2,132,1,66,0.0,66.0,66.0,1,66,0.0,66.0,66.0
0.0,17,1,72,1,72,0.0,72.0,72.0,0,0,0.0,0.0,0.0
3971.0,17,4,704,2,148,0.0,74.0,74.0,2,556,0.0,280.0,278.0
3761218.0,6,5,336,2,134,0.0,68.0,67.0,3,202,1524558.0,70.0,67.33333333333333
97425.0,17,2,762,2,762,0.0,381.0,381.0,0,0,0.0,0.0,0.0
103178157.0,17,14,864,7,432,17167611.833333332,174.0,61.71428571428572,7,432,17166826.333333332,174.0,61.71428571428572
314234.0,17,4,1400,4,1400,104744.66666666669,350.0,350.0,0,0,0.0,0.0,0.0
321.0,17,2,174,1,79,0.0,79.0,79.0,1,95,0.0,95.0,95.0
306830.0,6,10,1221,6,636,61366.0,298.0,106.0,4,585,96910.0,379.0,146.25
1848821.0,6,4,270,2,134,0.0,68.0,67.0,2,136,0.0,70.0,68.0
160255.0,17,2,414,1,88,0.0,88.0,88.0,1,326,0.0,326.0,326.0
172993.0,6,3,337,2,214,0.0,160.0,107.0,1,123,0.0,123.0,123.0
1254116.0,6,7,499,3,198,614170.5,66.0,66.0,4,301,387879.0,103.0,75.25
135127481.0,17,6,1206,6,1206,27025496.2,201.0,201.0,0,0,0.0,0.0,0.0
90294808.0,6,21,1746,11,1001,9025237.8,256.0,91.0,10,745,10032494.111111112,95.0,74.5
102665.0,17,2,286,2,286,0.0,143.0,143.0,0,0,0.0,0.0,0.0
26554.0,6,11,1132,6,556,4782.2,218.0,92.66666666666669,5,576,5832.5,304.0,115.2
107793073.0,6,28,1860,14,966,8275169.153846154,123.0,69.0,14,894,8275171.153846154,123.0,63.85714285714285
143157.0,6,2,132,1,66,0.0,66.0,66.0,1,66,0.0,66.0,66.0
57732.0,6,14,4740,7,653,9479.166666666666,249.0,93.28571428571428,7,4087,7443.833333333333,1514.0,583.8571428571429
320.0,17,2,174,1,79,0.0,79.0,79.0,1,95,0.0,95.0,95.0
539.0,17,2,508,2,508,0.0,257.0,254.0,0,0,0.0,0.0,0.0
169831.0,17,2,180,1,90,0.0,90.0,90.0,1,90,0.0,90.0,90.0
2540867.0,6,25,7573,14,3735,195451.3076923077,1514.0,266.7857142857143,11,3838,228225.7,1514.0,348.90909090909093
90049379.0,17,28,13364,28,13364,3335162.185185185,501.0,477.2857142857143,0,0,0.0,0.0,0.0
2326.0,17,4,344,2,150,0.0,75.0,75.0,2,194,0.0,103.0,97.0
287.0,17,2,174,1,79,0.0,79.0,79.0,1,95,0.0,95.0,95.0
2362.0,17,4,344,2,150,0.0,75.0,75.0,2,194,0.0,103.0,97.0
107000959.0,17,16,1666,8,905,15285851.285714284,394.0,113.125,8,761,15143918.142857144,250.0,95.125
108094777.0,17,5,1005,5,1005,27023694.25,201.0,201.0,0,0,0.0,0.0,0.0
108112282.0,17,5,955,5,955,27028070.5,191.0,191.0,0,0,0.0,0.0,0.0
90080697.0,6,13,2052,6,1224,18015671.4,204.0,204.0,7,828,14967280.666666666,188.0,118.28571428571428
120049925.0,17,28,13364,28,13364,4446293.518518519,501.0,477.2857142857143,0,0,0.0,0.0,0.0
105145.0,17,2,700,2,700,0.0,350.0,350.0,0,0,0.0,0.0,0.0
334.0,17,2,208,1,72,0.0,72.0,72.0,1,136,0.0,136.0,136.0
28365.0,6,10,2032,5,524,6273.0,252.0,104.8,5,1508,6407.25,1236.0,301.6
3166233.0,6,17,1441,8,867,409608.7142857143,315.0,108.375,9,574,358381.0,78.0,63.77777777777778
108106774.0,17,5,955,5,955,27026693.5,191.0,191.0,0,0,0.0,0.0,0.0
2804700.0,6,2,132,1,66,0.0,66.0,66.0,1,66,0.0,66.0,66.0
153594.0,17,2,180,1,90,0.0,90.0,90.0,1,90,0.0,90.0,90.0
132776.0,6,13,1394,7,797,22129.33333333333,253.0,113.85714285714286,6,597,25588.8,259.0,99.5
120056560.0,17,29,13785,29,13785,4287734.285714285,501.0,475.3448275862069,0,0,0.0,0.0,0.0
235175.0,6,3,337,2,214,0.0,160.0,107.0,1,123,0.0,123.0,123.0
779.0,17,4,438,2,148,0.0,74.0,74.0,2,290,0.0,147.0,145.0
208098.0,6,3,426,2,280,0.0,214.0,140.0,1,146,0.0,146.0,146.0
123250515.0,6,49,3234,25,1650,5135438.125,66.0,66.0,24,1584,5014442.173913044,66.0,66.0
5619169.0,6,4,270,2,134,0.0,68.0,67.0,2,136,0.0,70.0,68.0
90256821.0,6,12,1832,8,1016,12893831.57142857,188.0,127.0,4,816,30030510.33333333,204.0,204.0
2351.0,17,4,344,2,150,0.0,75.0,75.0,2,194,0.0,103.0,97.0
120514271.0,6,277,32622,139,23292,873291.8188405797,284.0,167.568345323741,138,9330,872160.3357664234,140.0,67.6086956521739
2356.0,17,4,344,2,150,0.0,75.0,75.0,2,194,0.0,103.0,97.0
37328.0,6,14,4740,7,653,6093.5,249.0,93.28571428571428,7,4087,5463.333333333333,1514.0,583.8571428571429
90093243.0,6,10,1440,7,828,15015540.5,188.0,118.28571428571428,3,612,30030842.5,204.0,204.0
23770.0,6,14,4740,7,653,3804.6666666666665,249.0,93.28571428571428,7,4087,3013.6666666666665,1514.0,583.8571428571429
106361677.0,17,14,864,7,432,17666829.666666668,174.0,61.71428571428572,7,432,17667762.0,174.0,61.71428571428572
0.0,6,1,172,1,172,0.0,172.0,172.0,0,0,0.0,0.0,0.0
14635218.0,6,20,1607,10,975,1592468.888888889,315.0,97.5,10,632,1592425.0,78.0,63.2
144913.0,17,2,180,1,70,0.0,70.0,70.0,1,110,0.0,110.0,110.0
76316.0,6,15,4806,8,719,10571.0,249.0,89.875,7,4087,12365.5,1514.0,583.8571428571429
13117515.0,6,22,7083,13,1707,1093126.25,408.0,131.30769230769232,9,5376,1123922.875,1514.0,597.3333333333334
0.0,17,1,55,1,55,0.0,55.0,55.0,0,0,0.0,0.0,0.0
29371.0,6,10,2032,5,524,6719.75,252.0,104.8,5,1508,6289.0,1236.0,301.6
47811345.0,6,8,1940,3,887,22641674.5,753.0,295.6666666666667,5,1053,11259255.25,785.0,210.6
8592.0,17,2,762,2,762,0.0,381.0,381.0,0,0,0.0,0.0,0.0
121026215.0,6,33,2296,17,1225,7564138.4375,139.0,72.05882352941177,16,1071,7386334.866666666,123.0,66.9375
306472.0,6,6,412,4,272,102157.33333333331,74.0,68.0,2,140,0.0,74.0,70.0
304646.0,6,6,412,4,272,101548.66666666669,74.0,68.0,2,140,0.0,74.0,70.0
90955565.0,6,21,1585,11,840,9095067.6,95.0,76.36363636363636,10,745,10104048.777777778,95.0,74.5
431551.0,6,4,508,2,238,0.0,172.0,119.0,2,270,0.0,135.0,135.0
406.0,17,2,762,2,762,0.0,381.0,381.0,0,0,0.0,0.0,0.0
9007855.0,17,2,160,2,160,0.0,80.0,80.0,0,0,0.0,0.0,0.0
737212.0,6,11,1021,6,444,98590.8,162.0,74.0,5,577,123357.25,349.0,115.4
210086.0,17,2,762,2,762,0.0,381.0,381.0,0,0,0.0,0.0,0.0
120035937.0,17,29,13785,29,13785,4286997.75,501.0,475.3448275862069,0,0,0.0,0.0,0.0
321.0,17,2,174,1,79,0.0,79.0,79.0,1,95,0.0,95.0,95.0
90012338.0,6,20,1490,10,745,10001370.888888888,95.0,74.5,10,745,9975868.0,95.0,74.5
146061.0,6,3,337,2,214,0.0,160.0,107.0,1,123,0.0,123.0,123.0
891.0,17,2,684,2,684,0.0,342.0,342.0,0,0,0.0,0.0,0.0
40869.0,6,14,4740,7,653,6405.833333333333,249.0,93.28571428571428,7,4087,6583.833333333333,1514.0,583.8571428571429
90292314.0,6,18,1341,9,691,11286539.25,95.0,76.77777777777777,9,650,11249829.375,95.0,72.22222222222223
52924.0,6,10,2032,5,524,12733.25,252.0,104.8,5,1508,12882.5,1236.0,301.6
293773.0,6,6,412,4,272,97924.33333333331,74.0,68.0,2,140,0.0,74.0,70.0
1310070.0,6,4,264,2,132,0.0,66.0,66.0,2,132,0.0,66.0,66.0
87724.0,6,14,4740,7,653,14113.0,249.0,93.28571428571428,7,4087,14483.833333333334,1514.0,583.8571428571429
318256.0,6,6,412,4,272,106085.33333333331,74.0,68.0,2,140,0.0,74.0,70.0
121693.0,6,3,337,2,214,0.0,160.0,107.0,1,123,0.0,123.0,123.0
37307.0,6,14,4740,7,653,6092.833333333333,249.0,93.28571428571428,7,4087,6040.833333333333,1514.0,583.8571428571429
203163.0,17,2,180,1,90,0.0,90.0,90.0,1,90,0.0,90.0,90.0
1236.0,17,4,438,2,148,0.0,74.0,74.0,2,290,0.0,147.0,145.0
109551015.0,6,26,2861,13,1409,9127473.0,425.0,108.3846153846154,13,1452,9128912.0,337.0,111.6923076923077
103263.0,17,2,286,2,286,0.0,143.0,143.0,0,0,0.0,0.0,0.0
115437854.0,6,227,25472,114,7820,1021573.92920354,140.0,68.59649122807018,113,17652,1020941.4553571428,284.0,156.21238938053096
162277.0,17,2,180,1,90,0.0,90.0,90.0,1,90,0.0,90.0,90.0
494430.0,6,5,336,2,134,0.0,68.0,67.0,3,202,193181.5,70.0,67.33333333333333
90293526.0,6,16,1192,8,596,12892085.142857144,95.0,74.5,8,596,12898308.714285716,95.0,74.5
105956641.0,6,28,1860,14,966,8133953.846153846,123.0,69.0,14,894,8133953.384615385,123.0,63.85714285714285
3315.0,17,4,407,2,144,0.0,72.0,72.0,2,263,0.0,136.0,131.5
375321.0,6,3,204,2,136,0.0,70.0,68.0,1,68,0.0,68.0,68.0
91774864.0,17,16,5472,16,5472,6118324.266666667,342.0,342.0,0,0,0.0,0.0,0.0
103217.0,17,2,286,2,286,0.0,143.0,143.0,0,0,0.0,0.0,0.0
310813.0,17,4,622,4,622,103604.33333333331,163.0,155.5,0,0,0.0,0.0,0.0
307658.0,6,6,412,4,272,102552.66666666669,74.0,68.0,2,140,0.0,74.0,70.0
178277.0,17,2,180,1,90,0.0,90.0,90.0,1,90,0.0,90.0,90.0
94438.0,17,2,286,2,286,0.0,143.0,143.0,0,0,0.0,0.0,0.0
51048.0,6,2,132,1,66,0.0,66.0,66.0,1,66,0.0,66.0,66.0
242058.0,6,3,337,2,214,0.0,160.0,107.0,1,123,0.0,123.0,123.0
3246.0,17,4,344,2,150,0.0,75.0,75.0,2,194,0.0,103.0,97.0
19865.0,6,14,4740,7,653,3099.0,249.0,93.28571428571428,7,4087,3175.6666666666665,1514.0,583.8571428571429
49674.0,6,10,2032,5,524,10865.25,252.0,104.8,5,1508,6591.75,1236.0,301.6
22991.0,6,14,4740,7,653,3712.0,249.0,93.28571428571428,7,4087,3452.6666666666665,1514.0,583.8571428571429
120120088.0,6,15,2444,7,1428,20020014.666666668,204.0,204.0,8,1016,17095762.714285713,188.0,127.0
108682582.0,6,34,2482,17,1288,6792661.375,139.0,75.76470588235294,17,1194,6779763.0625,123.0,70.23529411764706
5623317.0,6,5,336,2,134,0.0,68.0,67.0,3,202,1422964.5,70.0,67.33333333333333
119758629.0,17,35,16705,35,16705,3522312.617647059,501.0,477.2857142857143,0,0,0.0,0.0,0.0
92966269.0,6,39,2574,20,1320,4892947.315789473,66.0,66.0,19,1254,5160001.833333333,66.0,66.0
308494.0,6,6,412,4,272,102831.33333333331,74.0,68.0,2,140,0.0,74.0,70.0
215398.0,17,2,180,1,90,0.0,90.0,90.0,1,90,0.0,90.0,90.0
4467.0,17,2,610,1,72,0.0,72.0,72.0,1,538,0.0,538.0,538.0
108337.0,17,2,286,2,286,0.0,143.0,143.0,0,0,0.0,0.0,0.0
550.0,17,2,508,2,508,0.0,257.0,254.0,0,0,0.0,0.0,0.0
115480093.0,6,48,3168,24,1584,5020873.608695652,66.0,66.0,24,1584,5007210.608695652,66.0,66.0
216339.0,6,3,426,2,280,0.0,214.0,140.0,1,146,0.0,146.0,146.0
1976.0,17,2,192,1,88,0.0,88.0,88.0,1,104,0.0,104.0,104.0
4361.0,17,2,626,1,72,0.0,72.0,72.0,1,554,0.0,554.0,554.0
432.0,17,2,410,1,78,0.0,78.0,78.0,1,332,0.0,332.0,332.0
35113.0,6,10,2032,5,524,6641.0,252.0,104.8,5,1508,8460.0,1236.0,301.6
109928104.0,17,14,864,7,432,18168044.33333333,174.0,61.71428571428572,7,432,18166839.83333333,174.0,61.71428571428572
986494.0,6,12,1354,6,723,196303.8,253.0,120.5,6,631,195837.8,293.0,105.16666666666669
153443.0,17,2,180,1,90,0.0,90.0,90.0,1,90,0.0,90.0,90.0
278592.0,6,10,1221,6,636,55718.4,298.0,106.0,4,585,87113.66666666667,379.0,146.25
117757990.0,6,23,1734,11,840,11775799.0,95.0,76.36363636363636,12,894,10681585.272727272,95.0,74.5
2604580.0,6,25,7573,14,3735,200352.3076923077,1514.0,266.7857142857143,11,3838,234892.5,1514.0,348.90909090909093
143892.0,17,2,180,1,90,0.0,90.0,90.0,1,90,0.0,90.0,90.0
108101072.0,17,5,1005,5,1005,27025268.0,201.0,201.0,0,0,0.0,0.0,0.0
107216.0,17,2,286,2,286,0.0,143.0,143.0,0,0,0.0,0.0,0.0
43461.0,6,10,2032,5,524,8957.0,252.0,104.8,5,1508,10514.0,1236.0,301.6
442110.0,17,2,363,1,79,0.0,79.0,79.0,1,284,0.0,284.0,284.0
300040.0,6,6,412,4,272,100013.33333333331,74.0,68.0,2,140,0.0,74.0,70.0
48578.0,6,10,2032,5,524,11894.0,252.0,104.8,5,1508,11783.75,1236.0,301.6
135133832.0,17,6,1146,6,1146,27026766.4,191.0,191.0,0,0,0.0,0.0,0.0
2784339.0,6,2,132,1,66,0.0,66.0,66.0,1,66,0.0,66.0,66.0
39300.0,6,14,4740,7,653,5364.666666666667,249.0,93.28571428571428,7,4087,6018.166666666667,1514.0,583.8571428571429
109075.0,17,2,286,2,286,0.0,143.0,143.0,0,0,0.0,0.0,0.0
153490.0,17,2,180,1,90,0.0,90.0,90.0,1,90,0.0,90.0,90.0
108102739.0,17,5,955,5,955,27025684.75,191.0,191.0,0,0,0.0,0.0,0.0
110396706.0,6,210,23646,105,16420,1059436.875,284.0,156.38095238095238,105,7226,1059437.048076923,140.0,68.81904761904762
1158520.0,6,13,3010,8,2382,165502.85714285713,1514.0,297.75,5,628,221469.0,331.0,125.6
90033719.0,17,27,12943,27,12943,3462835.346153846,501.0,479.3703703703704,0,0,0.0,0.0,0.0
308102.0,6,6,412,4,272,102700.66666666669,74.0,68.0,2,140,0.0,74.0,70.0
36899.0,6,14,4740,7,653,5935.0,249.0,93.28571428571428,7,4087,5481.833333333333,1514.0,583.8571428571429
2576.0,17,4,344,2,150,0.0,75.0,75.0,2,194,0.0,103.0,97.0
106822.0,17,4,1400,4,1400,35607.333333333336,350.0,350.0,0,0,0.0,0.0,0.0
153481.0,17,2,180,1,90,0.0,90.0,90.0,1,90,0.0,90.0,90.0
2867134.0,17,2,906,2,906,0.0,453.0,453.0,0,0,0.0,0.0,0.0
6555.0,17,2,582,1,83,0.0,83.0,83.0,1,499,0.0,499.0,499.0
207201.0,6,3,426,2,280,0.0,214.0,140.0,1,146,0.0,146.0,146.0
72345.0,6,10,2032,5,524,17846.0,252.0,104.8,5,1508,16502.75,1236.0,301.6
90288177.0,6,14,1043,7,542,15048029.5,95.0,77.42857142857143,7,501,14999162.333333334,95.0,71.57142857142857
121686703.0,6,253,29206,126,20528,955979.472,284.0,162.9206349206349,127,8678,964059.261904762,140.0,68.33070866141732
0.0,17,1,80,1,80,0.0,80.0,80.0,0,0,0.0,0.0,0.0
120125747.0,6,15,2428,9,1204,15015718.375,188.0,133.77777777777777,6,1224,18031583.2,204.0,204.0
204674.0,17,2,762,2,762,0.0,381.0,381.0,0,0,0.0,0.0,0.0
9034.0,17,2,539,1,86,0.0,86.0,86.0,1,453,0.0,453.0,453.0
2597644.0,6,2,132,1,66,0.0,66.0,66.0,1,66,0.0,66.0,66.0
90258875.0,6,14,2240,8,1016,12894125.0,188.0,127.0,6,1224,18018030.8,204.0,204.0
90261559.0,6,13,2036,8,1016,12894508.42857143,188.0,127.0,5,1020,22524855.5,204.0,204.0
52718.0,6,14,4740,7,653,8380.833333333334,249.0,93.28571428571428,7,4087,8325.0,1514.0,583.8571428571429
90024393.0,17,28,13364,28,13364,3334236.777777778,501.0,477.2857142857143,0,0,0.0,0.0,0.0
90731876.0,6,18,1382,10,786,10075863.888888888,95.0,78.6,8,596,12894671.57142857,95.0,74.5
2334.0,17,4,344,2,150,0.0,75.0,75.0,2,194,0.0,103.0,97.0
157800.0,17,2,180,1,90,0.0,90.0,90.0,1,90,0.0,90.0,90.0
135122375.0,17,6,1206,6,1206,27024475.0,201.0,201.0,0,0,0.0,0.0,0.0
14540.0,6,14,4740,7,653,2153.333333333333,249.0,93.28571428571428,7,4087,2287.1666666666665,1514.0,583.8571428571429
165566.0,6,3,337,2,214,0.0,160.0,107.0,1,123,0.0,123.0,123.0
256094.0,6,12,1373,7,714,42682.333333333336,298.0,102.0,5,659,59721.0,379.0,131.8
90255878.0,6,12,1832,8,1016,12893696.857142856,188.0,127.0,4,816,30030453.33333333,204.0,204.0
48293.0,6,14,4740,7,653,7849.5,249.0,93.28571428571428,7,4087,7907.833333333333,1514.0,583.8571428571429
234274.0,6,3,373,2,238,0.0,172.0,119.0,1,135,0.0,135.0,135.0
73207.0,6,14,4740,7,653,11878.5,249.0,93.28571428571428,7,4087,11584.166666666666,1514.0,583.8571428571429
90014886.0,17,28,13364,28,13364,3333884.6666666665,501.0,477.2857142857143,0,0,0.0,0.0,0.0
863119.0,6,9,1096,6,625,172623.8,287.0,104.16666666666669,3,471,293710.5,331.0,157.0
315545.0,17,4,1400,4,1400,105181.66666666669,350.0,350.0,0,0,0.0,0.0,0.0
120645547.0,6,32,2226,17,1209,7540346.6875,123.0,71.11764705882354,15,1017,7888870.0,123.0,67.8
232909.0,6,3,337,2,214,0.0,160.0,107.0,1,123,0.0,123.0,123.0
147997.0,17,2,180,1,90,0.0,90.0,90.0,1,90,0.0,90.0,90.0
113033916.0,6,29,1914,15,948,8073851.142857143,123.0,63.2,14,966,7910086.461538462,123.0,69.0
607619.0,6,4,508,2,238,0.0,172.0,119.0,2,270,0.0,135.0,135.0
313415.0,6,6,412,4,272,104471.66666666669,74.0,68.0,2,140,0.0,74.0,70.0
101026.0,17,2,762,2,762,0.0,381.0,381.0,0,0,0.0,0.0,0.0
37544.0,6,14,4740,7,653,5114.333333333333,249.0,93.28571428571428,7,4087,5749.666666666667,1514.0,583.8571428571429
296.0,17,2,168,1,76,0.0,76.0,76.0,1,92,0.0,92.0,92.0
90256386.0,6,12,1832,8,1016,12893769.42857143,188.0,127.0,4,816,30031066.33333333,204.0,204.0
90924256.0,6,21,1585,11,840,9091236.3,95.0,76.36363636363636,10,745,10101829.777777778,95.0,74.5
1035599.0,6,11,1134,6,558,207119.8,220.0,93.0,5,576,256577.75,304.0,115.2
143926.0,17,2,180,1,90,0.0,90.0,90.0,1,90,0.0,90.0,90.0
10468675.0,6,7,478,4,272,3444207.0,74.0,68.0,3,206,5166179.5,74.0,68.66666666666667
40957057.0,6,4,1670,3,917,20478528.5,785.0,305.6666666666667,1,753,0.0,753.0,753.0
1016.0,17,2,762,2,762,0.0,381.0,381.0,0,0,0.0,0.0,0.0
38394.0,6,11,1131,6,600,7105.0,262.0,100.0,5,531,6235.0,259.0,106.2
10465540.0,6,7,478,4,272,3442936.333333333,74.0,68.0,3,206,5164297.5,74.0,68.66666666666667
2846071.0,6,3,204,1,68,0.0,68.0,68.0,2,136,0.0,70.0,68.0
121129781.0,6,32,2226,17,1209,7570611.3125,123.0,71.11764705882354,15,1017,7923368.428571428,123.0,67.8
2923206.0,6,11,2106,6,598,584397.0,252.0,99.66666666666669,5,1508,2255.5,1236.0,301.6
90288434.0,6,16,1192,8,596,12891390.285714284,95.0,74.5,8,596,12896695.0,95.0,74.5
291840.0,6,12,1373,7,714,48640.0,298.0,102.0,5,659,68820.0,379.0,131.8
206560.0,17,2,180,1,90,0.0,90.0,90.0,1,90,0.0,90.0,90.0
310046.0,6,6,412,4,272,103348.66666666669,74.0,68.0,2,140,0.0,74.0,70.0
16477.0,6,10,1066,5,490,3473.5,218.0,98.0,5,576,3699.5,304.0,115.2
15684361.0,6,5,1736,2,819,0.0,753.0,409.5,3,917,7770477.0,785.0,305.6666666666667
90214276.0,6,16,1192,8,596,12852423.0,95.0,74.5,8,596,12856965.285714284,95.0,74.5
1020105.0,6,11,1134,6,558,204021.00000000003,220.0,93.0,5,576,254578.25,304.0,115.2
2792137.0,6,3,204,2,136,0.0,70.0,68.0,1,68,0.0,68.0,68.0
171609.0,17,2,180,1,90,0.0,90.0,90.0,1,90,0.0,90.0,90.0
2463104.0,6,3,204,2,136,0.0,70.0,68.0,1,68,0.0,68.0,68.0
63587.00000000001,6,14,4740,7,653,9571.833333333334,249.0,93.28571428571428,7,4087,10221.833333333334,1514.0,583.8571428571429
32365.0,6,14,4740,7,653,5236.166666666667,249.0,93.28571428571428,7,4087,3986.6666666666665,1514.0,583.8571428571429
16569.0,6,11,2098,6,590,2779.8,252.0,98.33333333333331,5,1508,3329.5,1236.0,301.6
178176.0,17,2,180,1,90,0.0,90.0,90.0,1,90,0.0,90.0,90.0
796.0,17,5,550,5,550,199.0,110.0,110.0,0,0,0.0,0.0,0.0
2339.0,17,4,344,2,150,0.0,75.0,75.0,2,194,0.0,103.0,97.0
47616627.0,6,8,1940,3,887,22714782.5,753.0,295.6666666666667,5,1053,11261152.5,785.0,210.6
115259961.0,6,215,24284,108,7350,1077195.8971962617,140.0,68.05555555555556,107,16934,1077446.1226415094,284.0,158.26168224299064
220686.0,17,2,180,1,90,0.0,90.0,90.0,1,90,0.0,90.0,90.0
206908.0,17,2,180,1,90,0.0,90.0,90.0,1,90,0.0,90.0,90.0
121371.0,6,3,337,2,214,0.0,160.0,107.0,1,123,0.0,123.0,123.0
305.0,17,2,168,1,76,0.0,76.0,76.0,1,92,0.0,92.0,92.0
148659.0,17,2,414,1,88,0.0,88.0,88.0,1,326,0.0,326.0,326.0
2418.0,17,4,344,2,150,0.0,75.0,75.0,2,194,0.0,103.0,97.0
27786.0,6,14,4740,7,653,4497.333333333333,249.0,93.28571428571428,7,4087,4498.833333333333,1514.0,583.8571428571429
9765.0,6,10,2032,5,524,2221.0,252.0,104.8,5,1508,2172.0,1236.0,301.6
106948.0,17,2,286,2,286,0.0,143.0,143.0,0,0,0.0,0.0,0.0
101326.0,17,2,762,2,762,0.0,381.0,381.0,0,0,0.0,0.0,0.0
262157.0,6,3,337,2,214,0.0,160.0,107.0,1,123,0.0,123.0,123.0
121107.0,6,3,337,2,214,0.0,160.0,107.0,1,123,0.0,123.0,123.0
107033026.0,6,203,22808,102,7028,1059732.9306930692,140.0,68.90196078431373,101,15780,1067316.62,284.0,156.23762376237624
313500.0,17,4,1400,4,1400,104500.0,350.0,350.0,0,0,0.0,0.0,0.0
28878.0,6,14,4740,7,653,4601.166666666667,249.0,93.28571428571428,7,4087,4538.666666666667,1514.0,583.8571428571429
135132322.0,17,6,1146,6,1146,27026464.4,191.0,191.0,0,0,0.0,0.0,0.0
331.0,17,2,166,1,75,0.0,75.0,75.0,1,91,0.0,91.0,91.0
122644862.0,6,49,3234,24,1584,4897824.260869565,66.0,66.0,25,1650,5110189.416666667,66.0,66.0
91708413.0,17,16,5472,16,5472,6113894.2,342.0,342.0,0,0,0.0,0.0,0.0
90368625.0,6,12,1848,5,1020,22591887.5,204.0,204.0,7,828,15061060.5,188.0,118.28571428571428
936991.0,6,5,1736,2,819,0.0,753.0,409.5,3,917,396673.5,785.0,305.6666666666667
40921.0,6,10,2032,5,524,9838.5,252.0,104.8,5,1508,8067.5,1236.0,301.6
20159.0,6,10,1067,5,536,3081.25,264.0,107.2,5,531,4771.25,259.0,106.2
108107054.0,17,5,1005,5,1005,27026763.5,201.0,201.0,0,0,0.0,0.0,0.0
106015764.0,6,44,2904,22,1452,5048369.714285715,66.0,66.0,22,1452,5035246.952380952,66.0,66.0
222541.0,6,4,492,2,280,0.0,214.0,140.0,2,212,0.0,146.0,106.0
119875274.0,17,35,16705,35,16705,3525743.3529411764,501.0,477.2857142857143,0,0,0.0,0.0,0.0
107022262.0,6,44,2904,22,1452,5096298.19047619,66.0,66.0,22,1452,5081950.142857143,66.0,66.0
112174665.0,6,36,2596,18,1348,6598509.705882353,139.0,74.88888888888889,18,1248,6585794.294117647,123.0,69.33333333333333
218372.0,6,3,426,2,280,0.0,214.0,140.0,1,146,0.0,146.0,146.0
16817.0,6,14,4740,7,653,2058.6666666666665,249.0,93.28571428571428,7,4087,2665.0,1514.0,583.8571428571429
300808.0,6,6,412,4,272,100269.33333333331,74.0,68.0,2,140,0.0,74.0,70.0
144189.0,17,2,180,1,90,0.0,90.0,90.0,1,90,0.0,90.0,90.0
885748.0,6,12,2710,7,743,147624.66666666666,339.0,106.14285714285714,5,1967,152546.25,1514.0,393.4
43324.0,6,14,4740,7,653,6864.5,249.0,93.28571428571428,7,4087,7037.0,1514.0,583.8571428571429
154204.0,17,2,180,1,90,0.0,90.0,90.0,1,90,0.0,90.0,90.0
805910.0,6,14,4740,7,653,133791.5,249.0,93.28571428571428,7,4087,134126.16666666666,1514.0,583.8571428571429
320513.0,17,2,620,1,75,0.0,75.0,75.0,1,545,0.0,545.0,545.0
16105.999999999998,6,10,1067,5,536,3538.75,264.0,107.2,5,531,3214.75,259.0,106.2
39140.0,6,10,2032,5,524,9558.5,252.0,104.8,5,1508,8004.25,1236.0,301.6
737589.0,6,8,544,5,338,184397.25,74.0,67.6,3,206,295861.5,74.0,68.66666666666667
108108746.0,17,5,955,5,955,27027186.5,191.0,191.0,0,0,0.0,0.0,0.0
196929.0,17,2,180,1,90,0.0,90.0,90.0,1,90,0.0,90.0,90.0
55155.0,6,10,2032,5,524,13537.5,252.0,104.8,5,1508,12797.25,1236.0,301.6
19019.0,17,2,231,1,78,0.0,78.0,78.0,1,153,0.0,153.0,153.0
3007380.0,6,12,2172,7,664,501173.6666666667,252.0,94.85714285714286,5,1508,1826.5,1236.0,301.6
1343531.0,6,4,492,2,280,0.0,214.0,140.0,2,212,0.0,146.0,106.0
32237.0,6,11,2098,6,590,4658.6,252.0,98.33333333333331,5,1508,7746.25,1236.0,301.6
99151.0,17,2,762,2,762,0.0,381.0,381.0,0,0,0.0,0.0,0.0
120226478.0,6,412,52564,206,13818,582515.5658536585,140.0,67.07766990291262,206,38746,586420.9902439024,300.0,188.0873786407767
204658.0,17,2,762,2,762,0.0,381.0,381.0,0,0,0.0,0.0,0.0
439229.0,6,11,1021,6,444,59101.2,162.0,74.0,5,577,73628.75,349.0,115.4
312090.0,6,6,412,4,272,104030.0,74.0,68.0,2,140,0.0,74.0,70.0
21453.0,6,11,2098,6,590,4170.0,252.0,98.33333333333331,5,1508,4573.25,1236.0,301.6
27720.0,6,10,2032,5,524,6345.25,252.0,104.8,5,1508,6659.0,1236.0,301.6
121280.0,6,3,337,2,214,0.0,160.0,107.0,1,123,0.0,123.0,123.0
103682.0,17,2,286,2,286,0.0,143.0,143.0,0,0,0.0,0.0,0.0
91904696.0,6,24,1829,13,989,7657752.75,95.0,76.07692307692308,11,840,9190097.6,95.0,76.36363636363636
108378175.0,6,216,24312,108,16962,1010869.4953271028,284.0,157.05555555555554,108,7350,1010869.8504672896,140.0,68.05555555555556
3006124.0,6,12,2172,7,664,500855.3333333333,252.0,94.85714285714286,5,1508,1951.0,1236.0,301.6
14640901.0,6,20,1607,10,975,1592465.111111111,315.0,97.5,10,632,1592829.5555555555,78.0,63.2
318.0,17,2,174,1,79,0.0,79.0,79.0,1,95,0.0,95.0,95.0
112001697.0,6,30,1974,15,1026,7984707.357142857,123.0,68.4,15,948,7984704.5,123.0,63.2
134321.0,6,2,132,1,66,0.0,66.0,66.0,1,66,0.0,66.0,66.0
33945.0,6,11,2098,6,590,6035.4,252.0,98.33333333333331,5,1508,7946.5,1236.0,301.6
15182.0,6,11,1131,6,600,2745.6,262.0,100.0,5,531,3368.75,259.0,106.2
120000001.0,6,22,1680,12,935,10909091.0,95.0,77.91666666666667,10,745,10100214.111111112,95.0,74.5
2843446.0,6,3,204,1,68,0.0,68.0,68.0,2,136,0.0,70.0,68.0
17361.0,6,14,4740,7,653,2651.833333333333,249.0,93.28571428571428,7,4087,2758.333333333333,1514.0,583.8571428571429
1902.0,17,2,192,1,88,0.0,88.0,88.0,1,104,0.0,104.0,104.0
197052.0,17,2,180,1,90,0.0,90.0,90.0,1,90,0.0,90.0,90.0
228350.0,17,2,180,1,90,0.0,90.0,90.0,1,90,0.0,90.0,90.0
120050652.0,17,28,13364,28,13364,4446320.444444444,501.0,477.2857142857143,0,0,0.0,0.0,0.0
22165.0,6,10,2032,5,524,5297.75,252.0,104.8,5,1508,4926.5,1236.0,301.6
90663446.0,6,17,2434,9,1204,11316246.625,188.0,133.77777777777777,8,1230,12928727.42857143,204.0,153.75
98539.0,17,2,762,2,762,0.0,381.0,381.0,0,0,0.0,0.0,0.0
45780.0,6,14,4740,7,653,7429.5,249.0,93.28571428571428,7,4087,6860.0,1514.0,583.8571428571429
118677680.0,6,34,2466,17,1194,7417328.25,123.0,70.23529411764706,17,1272,6793280.875,123.0,74.82352941176471
96621264.0,6,59,11936,29,6048,3450759.4285714286,1514.0,208.55172413793105,30,5888,3323168.793103448,1514.0,196.26666666666668
0.0,6,1,66,1,66,0.0,66.0,66.0,0,0,0.0,0.0,0.0
2432299.0,6,25,7573,14,3735,187099.92307692303,1514.0,266.7857142857143,11,3838,218008.3,1514.0,348.90909090909093
307182.0,6,3,202,2,128,0.0,74.0,64.0,1,74,0.0,74.0,74.0
404250.0,6,4,508,2,238,0.0,172.0,119.0,2,270,0.0,135.0,135.0
301597.0,6,6,412,4,272,100532.33333333331,74.0,68.0,2,140,0.0,74.0,70.0
895020.0,6,10,1334,6,797,179004.0,459.0,132.83333333333334,4,537,206468.66666666663,331.0,134.25
98465.0,17,2,286,2,286,0.0,143.0,143.0,0,0,0.0,0.0,0.0
5618464.0,6,4,270,2,134,0.0,68.0,67.0,2,136,0.0,70.0,68.0
36513.0,6,10,2032,5,524,8895.75,252.0,104.8,5,1508,2081.0,1236.0,301.6
2098.0,17,4,344,2,150,0.0,75.0,75.0,2,194,0.0,103.0,97.0
412922.0,17,2,374,1,73,0.0,73.0,73.0,1,301,0.0,301.0,301.0
218919.0,6,3,426,2,280,0.0,214.0,140.0,1,146,0.0,146.0,146.0
302180.0,6,6,412,4,272,100726.66666666669,74.0,68.0,2,140,0.0,74.0,70.0
308730.0,6,6,412,4,272,102910.0,74.0,68.0,2,140,0.0,74.0,70.0
211752.0,6,3,426,2,280,0.0,214.0,140.0,1,146,0.0,146.0,146.0
120004220.0,6,18,1341,9,691,14999991.375,95.0,76.77777777777777,9,650,14999061.875,95.0,72.22222222222223
0.0,17,1,55,1,55,0.0,55.0,55.0,0,0,0.0,0.0,0.0
2802322.0,6,2,132,1,66,0.0,66.0,66.0,1,66,0.0,66.0,66.0
551108.0,6,2,132,1,66,0.0,66.0,66.0,1,66,0.0,66.0,66.0
90762204.0,6,22,1680,12,894,8247353.181818182,95.0,74.5,10,786,10083324.0,95.0,78.6
10805.0,17,4,823,2,163,0.0,89.0,81.5,2,660,0.0,443.0,330.0
316.0,17,2,208,1,72,0.0,72.0,72.0,1,136,0.0,136.0,136.0
1069.0,17,5,550,5,550,267.25,110.0,110.0,0,0,0.0,0.0,0.0
107150826.0,6,255,29946,128,8670,843707.2913385826,140.0,67.734375,127,21276,842150.9761904762,284.0,167.5275590551181
2410.0,17,4,344,2,150,0.0,75.0,75.0,2,194,0.0,103.0,97.0
155229.0,6,3,337,2,214,0.0,160.0,107.0,1,123,0.0,123.0,123.0
101319506.0,17,14,864,7,432,16886584.333333332,174.0,61.71428571428572,7,432,16785143.0,174.0,61.71428571428572
5644948.0,6,5,336,2,134,0.0,68.0,67.0,3,202,1429836.0,70.0,67.33333333333333
90534028.0,6,28,2008,14,1045,6964156.0,139.0,74.64285714285714,14,963,6947507.923076923,123.0,68.78571428571429
37932.0,6,12,1320,6,723,6189.2,253.0,120.5,6,597,6850.6,259.0,99.5
1166811.0,6,13,3010,8,2382,166687.2857142857,1514.0,297.75,5,628,223563.25,331.0,125.6
110223.0,17,4,1400,4,1400,36741.0,350.0,350.0,0,0,0.0,0.0,0.0
21699.0,6,14,4740,7,653,3502.833333333333,249.0,93.28571428571428,7,4087,3482.333333333333,1514.0,583.8571428571429
108111189.0,17,5,1005,5,1005,27027797.25,201.0,201.0,0,0,0.0,0.0,0.0
799.0,17,4,438,2,148,0.0,74.0,74.0,2,290,0.0,147.0,145.0
110977250.0,6,30,1990,15,1042,7911525.857142857,139.0,69.46666666666667,15,948,7911527.142857143,123.0,63.2
90252243.0,6,13,2036,8,1016,12893177.57142857,188.0,127.0,5,1020,22522115.5,204.0,204.0
638.0,17,2,762,2,762,0.0,381.0,381.0,0,0,0.0,0.0,0.0
217724.0,6,3,426,2,280,0.0,214.0,140.0,1,146,0.0,146.0,146.0
90013568.0,17,28,13364,28,13364,3333835.851851852,501.0,477.2857142857143,0,0,0.0,0.0,0.0
48320.0,6,14,4740,7,653,5502.833333333333,249.0,93.28571428571428,7,4087,7898.666666666667,1514.0,583.8571428571429
2454.0,17,4,344,2,150,0.0,75.0,75.0,2,194,0.0,103.0,97.0
103600.0,6,14,4740,7,653,17047.666666666668,249.0,93.28571428571428,7,4087,15561.833333333334,1514.0,583.8571428571429
90010242.0,17,27,12943,27,12943,3461932.3846153845,501.0,479.3703703703704,0,0,0.0,0.0,0.0
36265.0,6,14,4740,7,653,5912.0,249.0,93.28571428571428,7,4087,5906.166666666667,1514.0,583.8571428571429
315261.0,17,4,622,4,622,105087.0,163.0,155.5,0,0,0.0,0.0,0.0
163383.0,6,2,132,1,66,0.0,66.0,66.0,1,66,0.0,66.0,66.0
42686.0,6,14,4740,7,653,6352.0,249.0,93.28571428571428,7,4087,5030.5,1514.0,583.8571428571429
205328.0,17,2,906,2,906,0.0,453.0,453.0,0,0,0.0,0.0,0.0
2997886.0,6,11,2106,6,598,599333.4,252.0,99.66666666666669,5,1508,1620.0,1236.0,301.6
37349.0,6,14,4740,7,653,5630.166666666667,249.0,93.28571428571428,7,4087,6088.5,1514.0,583.8571428571429
0.0,17,1,289,1,289,0.0,289.0,289.0,0,0,0.0,0.0,0.0
135128451.0,17,6,1206,6,1206,27025690.2,201.0,201.0,0,0,0.0,0.0,0.0
34063.0,6,10,2032,5,524,6404.25,252.0,104.8,5,1508,7006.25,1236.0,301.6
114584257.0,6,48,3168,24,1584,4981924.217391305,66.0,66.0,24,1584,4970061.434782608,66.0,66.0
299402.0,6,6,412,4,272,99800.66666666669,74.0,68.0,2,140,0.0,74.0,70.0
146191.0,6,3,337,2,214,0.0,160.0,107.0,1,123,0.0,123.0,123.0
108103787.0,17,5,1005,5,1005,27025946.75,201.0,201.0,0,0,0.0,0.0,0.0
92218852.0,6,678,142708,334,22488,276912.04804804805,214.0,67.32934131736526,344,120220,268805.7346938776,1514.0,349.4767441860465
364801.0,6,10,967,5,390,61426.75,162.0,78.0,5,577,61363.0,349.0,115.4
381.0,17,2,267,1,83,0.0,83.0,83.0,1,184,0.0,184.0,184.0
1285.0,17,4,438,2,148,0.0,74.0,74.0,2,290,0.0,147.0,145.0
2100609.0,6,2,132,1,66,0.0,66.0,66.0,1,66,0.0,66.0,66.0
213607.0,17,2,180,1,90,0.0,90.0,90.0,1,90,0.0,90.0,90.0
303.0,17,2,164,1,82,0.0,82.0,82.0,1,82,0.0,82.0,82.0
105175320.0,6,198,22548,99,15792,1071022.275510204,374.0,159.5151515151515,99,6756,1071022.1020408163,140.0,68.24242424242425
2048.0,17,4,344,2,150,0.0,75.0,75.0,2,194,0.0,103.0,97.0
2146.0,17,4,344,2,150,0.0,75.0,75.0,2,194,0.0,103.0,97.0
29755.0,6,14,4740,7,653,4590.333333333333,249.0,93.28571428571428,7,4087,4824.0,1514.0,583.8571428571429
36443.0,6,14,4740,7,653,5954.833333333333,249.0,93.28571428571428,7,4087,5487.833333333333,1514.0,583.8571428571429
113254957.0,6,46,3036,23,1518,5135438.136363637,66.0,66.0,23,1518,5135444.045454546,66.0,66.0
90057625.0,17,28,13364,28,13364,3335467.592592593,501.0,477.2857142857143,0,0,0.0,0.0,0.0
228215.0,17,2,180,1,90,0.0,90.0,90.0,1,90,0.0,90.0,90.0
147974.0,17,2,180,1,90,0.0,90.0,90.0,1,90,0.0,90.0,90.0
65694.0,6,14,4740,7,653,10769.0,249.0,93.28571428571428,7,4087,10763.333333333334,1514.0,583.8571428571429
724.0,17,4,438,2,148,0.0,74.0,74.0,2,290,0.0,147.0,145.0
90035046.0,17,28,13364,28,13364,3334631.333333333,501.0,477.2857142857143,0,0,0.0,0.0,0.0
228730.0,17,2,180,1,90,0.0,90.0,90.0,1,90,0.0,90.0,90.0
32138.0,6,10,2032,5,524,7043.75,252.0,104.8,5,1508,7044.5,1236.0,301.6
14976702.0,17,6,2052,6,2052,2995340.4,342.0,342.0,0,0,0.0,0.0,0.0
2286.0,17,4,344,2,150,0.0,75.0,75.0,2,194,0.0,103.0,97.0
100166384.0,17,12,778,6,389,20033276.8,174.0,64.83333333333333,6,389,19950330.6,174.0,64.83333333333333
247140.0,17,2,180,1,90,0.0,90.0,90.0,1,90,0.0,90.0,90.0
135130598.0,17,6,1146,6,1146,27026119.6,191.0,191.0,0,0,0.0,0.0,0.0
2306.0,17,4,344,2,150,0.0,75.0,75.0,2,194,0.0,103.0,97.0
213655.0,17,2,180,1,90,0.0,90.0,90.0,1,90,0.0,90.0,90.0
61182.0,6,10,2032,5,524,15056.25,252.0,104.8,5,1508,13410.5,1236.0,301.6
2800228.0,6,2,132,1,66,0.0,66.0,66.0,1,66,0.0,66.0,66.0
16376.000000000002,6,14,4740,7,653,2540.833333333333,249.0,93.28571428571428,7,4087,2528.1666666666665,1514.0,583.8571428571429
2310.0,17,4,344,2,150,0.0,75.0,75.0,2,194,0.0,103.0,97.0
501112.0,6,4,270,2,134,0.0,68.0,67.0,2,136,0.0,70.0,68.0
467.0,17,2,508,2,508,0.0,257.0,254.0,0,0,0.0,0.0,0.0
115490864.0,6,226,25566,113,17886,1029245.2232142856,284.0,158.28318584070797,113,7680,1029247.0892857144,140.0,67.96460176991151
269809.0,6,10,1221,6,636,53961.8,298.0,106.0,4,585,83737.66666666667,379.0,146.25
102197.0,17,2,286,2,286,0.0,143.0,143.0,0,0,0.0,0.0,0.0
850.0,17,2,762,2,762,0.0,381.0,381.0,0,0,0.0,0.0,0.0
47207.0,6,14,4740,7,653,7736.666666666667,249.0,93.28571428571428,7,4087,7596.166666666667,1514.0,583.8571428571429
7900107.0,17,5,1710,5,1710,1975026.75,342.0,342.0,0,0,0.0,0.0,0.0
97822256.0,6,30,2106,15,1089,6971875.5,123.0,72.6,15,1017,6971896.071428572,123.0,67.8
2030.0,17,4,344,2,150,0.0,75.0,75.0,2,194,0.0,103.0,97.0
130136.0,6,3,337,2,214,0.0,160.0,107.0,1,123,0.0,123.0,123.0
346.0,17,2,267,1,83,0.0,83.0,83.0,1,184,0.0,184.0,184.0
349.0,17,2,160,1,80,0.0,80.0,80.0,1,80,0.0,80.0,80.0
135128094.0,17,6,1146,6,1146,27025618.8,191.0,191.0,0,0,0.0,0.0,0.0
102923.0,17,2,286,2,286,0.0,143.0,143.0,0,0,0.0,0.0,0.0
12201.0,6,10,1067,5,536,2812.0,264.0,107.2,5,531,2536.25,259.0,106.2
205697.0,17,2,762,2,762,0.0,381.0,381.0,0,0,0.0,0.0,0.0
3045.0,17,2,224,1,76,0.0,76.0,76.0,1,148,0.0,148.0,148.0
97726.0,17,2,762,2,762,0.0,381.0,381.0,0,0,0.0,0.0,0.0
9016509.0,17,4,1812,4,1812,3005503.0,453.0,453.0,0,0,0.0,0.0,0.0
14936.0,17,2,180,1,90,0.0,90.0,90.0,1,90,0.0,90.0,90.0
6769.0,17,2,582,1,83,0.0,83.0,83.0,1,499,0.0,499.0,499.0
108098834.0,17,5,1005,5,1005,27024708.5,201.0,201.0,0,0,0.0,0.0,0.0
298887.0,6,6,412,4,272,99629.0,74.0,68.0,2,140,0.0,74.0,70.0
120123256.0,6,15,2444,7,1428,20020542.666666668,204.0,204.0,8,1016,17098522.85714286,188.0,127.0
108102669.0,17,5,1005,5,1005,27025667.25,201.0,201.0,0,0,0.0,0.0,0.0
0.0,17,1,179,1,179,0.0,179.0,179.0,0,0,0.0,0.0,0.0
303645.0,6,6,412,4,272,101215.0,74.0,68.0,2,140,0.0,74.0,70.0
10418641.0,6,6,412,3,206,5140908.5,74.0,68.66666666666667,3,206,5140812.0,74.0,68.66666666666667
241083.0,6,3,337,2,214,0.0,160.0,107.0,1,123,0.0,123.0,123.0
631.0,17,2,762,2,762,0.0,381.0,381.0,0,0,0.0,0.0,0.0
197014.0,17,2,180,1,90,0.0,90.0,90.0,1,90,0.0,90.0,90.0
689658.0,6,14,4740,7,653,114486.33333333331,249.0,93.28571428571428,7,4087,114618.33333333331,1514.0,583.8571428571429
505082.00000000006,6,10,1221,6,636,101016.4,298.0,106.0,4,585,159667.0,379.0,146.25
42762.0,6,10,1066,5,490,9025.75,218.0,98.0,5,576,10487.75,304.0,115.2
2139771.0,6,24,6322,14,3631,164597.76923076922,1514.0,259.35714285714283,10,2691,211994.22222222225,1514.0,269.1
102265.0,17,2,286,2,286,0.0,143.0,143.0,0,0,0.0,0.0,0.0
248854.0,17,4,6056,4,6056,82951.33333333333,1514.0,1514.0,0,0,0.0,0.0,0.0
303094.0,17,2,604,1,75,0.0,75.0,75.0,1,529,0.0,529.0,529.0
315669.0,6,6,412,4,272,105223.0,74.0,68.0,2,140,0.0,74.0,70.0
16876.0,6,13,1459,7,862,2812.6666666666665,271.0,123.14285714285714,6,597,2998.0,259.0,99.5
2382.0,17,4,344,2,150,0.0,75.0,75.0,2,194,0.0,103.0,97.0
90000862.0,17,11,735,6,389,18000172.4,174.0,64.83333333333333,5,346,17251169.0,174.0,69.2
309885.0,6,6,412,4,272,103295.0,74.0,68.0,2,140,0.0,74.0,70.0
491341.0,6,4,270,2,134,0.0,68.0,67.0,2,136,0.0,70.0,68.0
29849.0,6,14,4740,7,653,4603.833333333333,249.0,93.28571428571428,7,4087,4212.333333333333,1514.0,583.8571428571429
308137.0,6,6,412,4,272,102712.33333333331,74.0,68.0,2,140,0.0,74.0,70.0
2796822.0,6,2,132,1,66,0.0,66.0,66.0,1,66,0.0,66.0,66.0
102519.0,17,2,286,2,286,0.0,143.0,143.0,0,0,0.0,0.0,0.0
310910.0,6,6,412,4,272,103636.66666666669,74.0,68.0,2,140,0.0,74.0,70.0
2050.0,17,4,344,2,150,0.0,75.0,75.0,2,194,0.0,103.0,97.0
71084630.0,6,9,842,9,842,8885578.75,97.0,93.55555555555556,0,0,0.0,0.0,0.0
216454.0,17,2,180,1,90,0.0,90.0,90.0,1,90,0.0,90.0,90.0
1777005.0,6,2,132,1,66,0.0,66.0,66.0,1,66,0.0,66.0,66.0
4998595.0,17,4,629,2,156,0.0,78.0,78.0,2,473,0.0,268.0,236.5
135437.0,6,2,132,1,66,0.0,66.0,66.0,1,66,0.0,66.0,66.0
60234.0,6,14,4740,7,653,7907.166666666667,249.0,93.28571428571428,7,4087,9877.333333333334,1514.0,583.8571428571429
346156.0,6,6,412,4,272,115385.33333333331,74.0,68.0,2,140,0.0,74.0,70.0
12386.0,6,13,1459,7,862,1829.3333333333333,271.0,123.14285714285714,6,597,2180.8,259.0,99.5
1025151.0,6,13,1394,7,797,170858.5,253.0,113.85714285714286,6,597,203395.4,259.0,99.5
121432.0,6,3,337,2,214,0.0,160.0,107.0,1,123,0.0,123.0,123.0
47480.0,6,14,4740,7,653,7426.0,249.0,93.28571428571428,7,4087,7328.166666666667,1514.0,583.8571428571429
102793.0,17,2,286,2,286,0.0,143.0,143.0,0,0,0.0,0.0,0.0
47901.0,6,10,2032,5,524,11665.0,252.0,104.8,5,1508,10977.0,1236.0,301.6
307703.0,6,6,412,4,272,102567.66666666669,74.0,68.0,2,140,0.0,74.0,70.0
305717.0,6,6,412,4,272,101905.66666666669,74.0,68.0,2,140,0.0,74.0,70.0
11998.0,6,10,1066,5,490,2141.75,218.0,98.0,5,576,2632.25,304.0,115.2
106558.0,17,2,286,2,286,0.0,143.0,143.0,0,0,0.0,0.0,0.0
120279797.0,6,18,1382,9,691,14999840.875,95.0,76.77777777777777,9,691,15033180.375,95.0,76.77777777777777
127825940.0,6,32,2157,16,1071,7855959.466666667,123.0,66.9375,16,1086,8521614.2,123.0,67.875
153571.0,17,2,180,1,90,0.0,90.0,90.0,1,90,0.0,90.0,90.0
90251862.0,6,12,1832,8,1016,12893123.142857144,188.0,127.0,4,816,30029166.0,204.0,204.0
25795.0,6,14,4740,7,653,3913.6666666666665,249.0,93.28571428571428,7,4087,3779.5,1514.0,583.8571428571429
843577.0,6,9,1118,6,586,168715.4,248.0,97.66666666666669,3,532,283881.0,392.0,177.33333333333334
115412450.0,6,48,3168,24,1584,5017932.608695652,66.0,66.0,24,1584,5005958.304347826,66.0,66.0
35997.0,6,14,4740,7,653,5444.833333333333,249.0,93.28571428571428,7,4087,4894.833333333333,1514.0,583.8571428571429
306543.0,6,6,412,4,272,102181.0,74.0,68.0,2,140,0.0,74.0,70.0
104165.0,17,2,286,2,286,0.0,143.0,143.0,0,0,0.0,0.0,0.0
308931.0,17,6,2100,6,2100,61786.2,350.0,350.0,0,0,0.0,0.0,0.0
103252.0,17,2,286,2,286,0.0,143.0,143.0,0,0,0.0,0.0,0.0
117028930.0,6,33,2274,17,1125,7314279.125,123.0,66.17647058823529,16,1149,7596976.0,123.0,71.8125
102991.0,17,2,762,2,762,0.0,381.0,381.0,0,0,0.0,0.0,0.0
143987.0,17,2,180,1,90,0.0,90.0,90.0,1,90,0.0,90.0,90.0
204233.0,6,10,1221,6,636,40846.6,298.0,106.0,4,585,66694.0,379.0,146.25
96493244.0,17,12,778,6,389,19200205.6,174.0,64.83333333333333,6,389,19201375.0,174.0,64.83333333333333
209533.0,17,2,180,1,90,0.0,90.0,90.0,1,90,0.0,90.0,90.0
4184.0,17,2,598,1,72,0.0,72.0,72.0,1,526,0.0,526.0,526.0
90043582.0,17,28,13364,28,13364,3334947.4814814813,501.0,477.2857142857143,0,0,0.0,0.0,0.0
104780033.0,6,33,2428,17,1288,6535251.5625,139.0,75.76470588235294,16,1140,6970931.066666666,123.0,71.25
158261.0,6,3,337,2,214,0.0,160.0,107.0,1,123,0.0,123.0,123.0
52695712.0,17,4,360,2,180,0.0,90.0,90.0,2,180,0.0,90.0,90.0
56290.0,6,14,4740,7,653,8048.833333333333,249.0,93.28571428571428,7,4087,8971.833333333334,1514.0,583.8571428571429
34953.0,6,14,4740,7,653,4887.666666666667,249.0,93.28571428571428,7,4087,5682.166666666667,1514.0,583.8571428571429
1027730.0,6,11,1134,6,558,205546.0,220.0,93.0,5,576,255437.75,304.0,115.2
2301.0,17,4,344,2,150,0.0,75.0,75.0,2,194,0.0,103.0,97.0
311297.0,6,3,202,2,128,0.0,74.0,64.0,1,74,0.0,74.0,74.0
239709.0,6,3,426,2,280,0.0,214.0,140.0,1,146,0.0,146.0,146.0
216644.0,17,2,180,1,90,0.0,90.0,90.0,1,90,0.0,90.0,90.0
42710.0,6,14,4740,7,653,6272.833333333333,249.0,93.28571428571428,7,4087,5799.5,1514.0,583.8571428571429
345.0,17,2,267,1,83,0.0,83.0,83.0,1,184,0.0,184.0,184.0
157358.0,6,3,337,2,214,0.0,160.0,107.0,1,123,0.0,123.0,123.0
302865.0,6,6,412,4,272,100955.0,74.0,68.0,2,140,0.0,74.0,70.0
108105911.0,17,5,955,5,955,27026477.75,191.0,191.0,0,0,0.0,0.0,0.0
308405.0,6,6,412,4,272,102801.66666666669,74.0,68.0,2,140,0.0,74.0,70.0
207393.0,6,3,426,2,280,0.0,214.0,140.0,1,146,0.0,146.0,146.0
120237654.0,6,18,1341,9,691,14999920.0,95.0,76.77777777777777,9,650,14999991.125,95.0,72.22222222222223
206054.0,6,3,426,2,280,0.0,214.0,140.0,1,146,0.0,146.0,146.0
2061.0,17,2,664,1,322,0.0,322.0,322.0,1,342,0.0,342.0,342.0
297428.0,6,10,1221,6,636,59485.6,298.0,106.0,4,585,97830.0,379.0,146.25
171526.0,6,2,132,1,66,0.0,66.0,66.0,1,66,0.0,66.0,66.0
313162.0,6,3,202,2,128,0.0,74.0,64.0,1,74,0.0,74.0,74.0
108104462.0,17,5,955,5,955,27026115.5,191.0,191.0,0,0,0.0,0.0,0.0
3723.0,17,4,438,2,148,0.0,74.0,74.0,2,290,0.0,147.0,145.0
103022949.0,6,201,22872,101,6888,1030229.49,140.0,68.1980198019802,100,15984,1030267.0707070708,336.0,159.84
216271.0,17,2,180,1,90,0.0,90.0,90.0,1,90,0.0,90.0,90.0
239080.0,17,2,180,1,90,0.0,90.0,90.0,1,90,0.0,90.0,90.0
166431.0,17,2,493,1,88,0.0,88.0,88.0,1,405,0.0,405.0,405.0
120452090.0,6,22,1680,13,989,10037674.166666666,95.0,76.07692307692308,9,691,14943661.25,95.0,76.77777777777777
120060911.0,17,28,13364,28,13364,4446700.407407408,501.0,477.2857142857143,0,0,0.0,0.0,0.0
375.0,17,2,174,1,79,0.0,79.0,79.0,1,95,0.0,95.0,95.0
239038.0,6,3,337,2,214,0.0,160.0,107.0,1,123,0.0,123.0,123.0
135130858.0,17,6,1206,6,1206,27026171.6,201.0,201.0,0,0,0.0,0.0,0.0
105254666.0,6,196,22092,98,15402,1082882.4226804124,284.0,157.16326530612244,98,6690,1082882.4020618557,140.0,68.26530612244898
90008871.0,17,27,12943,27,12943,3461879.653846154,501.0,479.3703703703704,0,0,0.0,0.0,0.0
108089984.0,17,5,955,5,955,27022496.0,191.0,191.0,0,0,0.0,0.0,0.0
391699.0,17,6,2100,6,2100,78339.8,350.0,350.0,0,0,0.0,0.0,0.0
40495.0,6,10,2032,5,524,8511.5,252.0,104.8,5,1508,8831.5,1236.0,301.6
0.0,17,1,44,1,44,0.0,44.0,44.0,0,0,0.0,0.0,0.0
254561.0,6,10,1221,6,636,50912.2,298.0,106.0,4,585,79072.0,379.0,146.25
10114.0,17,2,602,1,72,0.0,72.0,72.0,1,530,0.0,530.0,530.0
37121.0,6,10,2032,5,524,9063.0,252.0,104.8,5,1508,8900.0,1236.0,301.6
1607457.0,17,6,1230,3,234,803543.5,78.0,78.0,3,996,803522.0,332.0,332.0
34076.0,6,10,2032,5,524,7346.75,252.0,104.8,5,1508,8287.5,1236.0,301.6
307452.0,6,6,412,4,272,102484.0,74.0,68.0,2,140,0.0,74.0,70.0
67774.0,17,3,1143,3,1143,33887.0,381.0,381.0,0,0,0.0,0.0,0.0
667.0,17,2,762,2,762,0.0,381.0,381.0,0,0,0.0,0.0,0.0
310408.0,17,4,1400,4,1400,103469.33333333331,350.0,350.0,0,0,0.0,0.0,0.0
235606.0,6,3,426,2,280,0.0,214.0,140.0,1,146,0.0,146.0,146.0
845.0,17,4,438,2,148,0.0,74.0,74.0,2,290,0.0,147.0,145.0
9354.0,17,2,582,1,83,0.0,83.0,83.0,1,499,0.0,499.0,499.0
113254992.0,6,46,3036,23,1518,5135441.5,66.0,66.0,23,1518,5135446.090909091,66.0,66.0
216352.0,6,10,1221,6,636,43270.4,298.0,106.0,4,585,70962.0,379.0,146.25
4907.0,17,2,180,1,90,0.0,90.0,90.0,1,90,0.0,90.0,90.0
141585.0,6,2,132,1,66,0.0,66.0,66.0,1,66,0.0,66.0,66.0
3217.0,17,2,363,1,79,0.0,79.0,79.0,1,284,0.0,284.0,284.0
5615776.0,6,4,270,2,134,0.0,68.0,67.0,2,136,0.0,70.0,68.0
232746.0,6,3,337,2,214,0.0,160.0,107.0,1,123,0.0,123.0,123.0
120114398.0,6,13,2036,5,1020,30028599.5,204.0,204.0,8,1016,17133832.42857143,188.0,127.0
42568.0,6,10,2032,5,524,10069.25,252.0,104.8,5,1508,10036.0,1236.0,301.6
197081.0,17,2,180,1,90,0.0,90.0,90.0,1,90,0.0,90.0,90.0
1769005.0,6,2,132,1,66,0.0,66.0,66.0,1,66,0.0,66.0,66.0
6764.0,17,4,823,2,163,0.0,89.0,81.5,2,660,0.0,443.0,330.0
120281073.0,6,218,24690,109,7428,1106069.6944444445,140.0,68.14678899082568,109,17262,1105958.9814814816,284.0,158.36697247706422
121459.0,6,3,337,2,214,0.0,160.0,107.0,1,123,0.0,123.0,123.0
2002478.0,6,2,132,1,66,0.0,66.0,66.0,1,66,0.0,66.0,66.0
139219.0,6,2,132,1,66,0.0,66.0,66.0,1,66,0.0,66.0,66.0
3227522.0,6,15,2360,8,1068,461074.5714285714,580.0,133.5,7,1292,501068.5,733.0,184.57142857142856
414.0,17,2,168,1,76,0.0,76.0,76.0,1,92,0.0,92.0,92.0
504830.0,6,4,270,2,134,0.0,68.0,67.0,2,136,0.0,70.0,68.0
37011.0,6,10,2032,5,524,9017.25,252.0,104.8,5,1508,6117.75,1236.0,301.6
871918.0,6,9,1196,6,725,174383.6,387.0,120.83333333333331,3,471,298011.0,331.0,157.0
45204.0,6,10,2032,5,524,11079.0,252.0,104.8,5,1508,10635.5,1236.0,301.6
103006432.0,17,13,821,7,432,17167738.666666668,174.0,61.71428571428572,6,389,16600182.0,174.0,64.83333333333333
108286.0,17,2,286,2,286,0.0,143.0,143.0,0,0,0.0,0.0,0.0
436888.0,6,11,1021,6,444,58651.6,162.0,74.0,5,577,73140.75,349.0,115.4
67366202.0,6,58,13202,32,7022,2173103.290322581,1514.0,219.4375,26,6180,2684284.72,1514.0,237.69230769230768
16685794.000000002,6,19,1557,8,867,2340450.1428571427,315.0,108.375,11,690,1638297.5,78.0,62.72727272727273
301171.0,6,6,412,4,272,100390.33333333331,74.0,68.0,2,140,0.0,74.0,70.0
196864.0,17,2,180,1,90,0.0,90.0,90.0,1,90,0.0,90.0,90.0
314232.0,6,10,1221,6,636,62846.4,298.0,106.0,4,585,95914.66666666669,379.0,146.25
20390.0,6,10,2032,5,524,4545.0,252.0,104.8,5,1508,4516.5,1236.0,301.6
90063973.0,17,28,13364,28,13364,3335702.703703704,501.0,477.2857142857143,0,0,0.0,0.0,0.0
108684363.0,6,32,2220,16,1149,7245624.2,123.0,71.8125,16,1071,7231209.266666667,123.0,66.9375
153433.0,17,2,180,1,90,0.0,90.0,90.0,1,90,0.0,90.0,90.0
11757.0,17,4,823,2,163,0.0,89.0,81.5,2,660,0.0,443.0,330.0
90256714.0,6,12,1832,8,1016,12893816.285714284,188.0,127.0,4,816,30031230.666666668,204.0,204.0
958301.0,6,2,132,1,66,0.0,66.0,66.0,1,66,0.0,66.0,66.0
310261.0,17,4,1400,4,1400,103420.33333333331,350.0,350.0,0,0,0.0,0.0,0.0
1464.0,17,2,762,2,762,0.0,381.0,381.0,0,0,0.0,0.0,0.0
1303566.0,6,4,264,2,132,0.0,66.0,66.0,2,132,0.0,66.0,66.0
10633.0,6,10,1067,5,536,2490.5,264.0,107.2,5,531,2251.75,259.0,106.2
41982702.0,6,4,1843,3,1017,20991351.0,885.0,339.0,1,826,0.0,826.0,826.0
64253.00000000001,6,10,2032,5,524,12789.5,252.0,104.8,5,1508,15525.25,1236.0,301.6
58647.0,6,14,4740,7,653,9649.833333333334,249.0,93.28571428571428,7,4087,8243.333333333334,1514.0,583.8571428571429
110673375.0,6,32,2220,16,1149,7363837.8,123.0,71.8125,16,1071,7363837.933333334,123.0,66.9375
103318212.0,6,49,4282,28,2389,3826600.444444445,139.0,85.32142857142857,21,1893,5155093.3,123.0,90.14285714285714
28309.0,6,10,2032,5,524,6829.0,252.0,104.8,5,1508,6831.25,1236.0,301.6
105139481.0,17,15,5130,15,5130,7509962.928571428,342.0,342.0,0,0,0.0,0.0,0.0
306205.0,6,10,1221,6,636,61241.0,298.0,106.0,4,585,93428.0,379.0,146.25
135142661.0,17,6,1206,6,1206,27028532.2,201.0,201.0,0,0,0.0,0.0,0.0
311806.0,17,4,622,4,622,103935.33333333331,163.0,155.5,0,0,0.0,0.0,0.0
232352.0,6,3,337,2,214,0.0,160.0,107.0,1,123,0.0,123.0,123.0
1170567.0,6,13,3010,8,2382,167223.85714285713,1514.0,297.75,5,628,223656.0,331.0,125.6
10467629.0,6,7,478,4,272,3443778.6666666665,74.0,68.0,3,206,5165547.0,74.0,68.66666666666667
105412810.0,6,228,25824,114,18078,930952.7964601768,284.0,158.57894736842104,114,7746,930952.96460177,140.0,67.94736842105263
53806.0,6,14,4740,7,653,8853.0,249.0,93.28571428571428,7,4087,7796.0,1514.0,583.8571428571429
34620.0,6,10,2032,5,524,8441.5,252.0,104.8,5,1508,7248.0,1236.0,301.6
2416358.0,6,25,7573,14,3735,185873.6923076923,1514.0,266.7857142857143,11,3838,215594.5,1514.0,348.90909090909093
196822.0,17,2,180,1,90,0.0,90.0,90.0,1,90,0.0,90.0,90.0
291889.0,6,3,337,2,214,0.0,160.0,107.0,1,123,0.0,123.0,123.0
32352.0,6,10,2032,5,524,7783.5,252.0,104.8,5,1508,7106.0,1236.0,301.6
90044893.0,17,28,13364,28,13364,3334996.037037037,501.0,477.2857142857143,0,0,0.0,0.0,0.0
232170.0,6,10,1221,6,636,46434.0,298.0,106.0,4,585,75503.66666666667,379.0,146.25
104277.0,17,2,286,2,286,0.0,143.0,143.0,0,0,0.0,0.0,0.0
153487.0,17,2,180,1,90,0.0,90.0,90.0,1,90,0.0,90.0,90.0
219473.0,6,10,1221,6,636,43894.6,298.0,106.0,4,585,71849.33333333333,379.0,146.25
119709253.0,6,234,26422,117,18404,1030121.3448275862,284.0,157.2991452991453,117,8018,1030121.1379310344,140.0,68.52991452991454
122314501.0,6,48,3168,24,1584,5192916.304347826,66.0,66.0,24,1584,5014830.565217392,66.0,66.0
108109290.0,17,5,1005,5,1005,27027322.5,201.0,201.0,0,0,0.0,0.0,0.0
281889.0,6,3,337,2,214,0.0,160.0,107.0,1,123,0.0,123.0,123.0
103165.0,17,2,286,2,286,0.0,143.0,143.0,0,0,0.0,0.0,0.0
25451.0,6,11,2098,6,590,5005.2,252.0,98.33333333333331,5,1508,6035.0,1236.0,301.6
326885.0,6,6,412,4,272,108961.66666666669,74.0,68.0,2,140,0.0,74.0,70.0
135132008.0,17,6,1146,6,1146,27026401.6,191.0,191.0,0,0,0.0,0.0,0.0
311102.0,6,6,412,4,272,103700.66666666669,74.0,68.0,2,140,0.0,74.0,70.0
26705.0,6,10,2032,5,524,6436.5,252.0,104.8,5,1508,6072.5,1236.0,301.6
30026.0,6,14,4740,7,653,4872.166666666667,249.0,93.28571428571428,7,4087,4831.833333333333,1514.0,583.8571428571429
48796.0,6,14,4740,7,653,8009.0,249.0,93.28571428571428,7,4087,7929.666666666667,1514.0,583.8571428571429
144875.0,17,2,180,1,70,0.0,70.0,70.0,1,110,0.0,110.0,110.0
89148.0,6,10,2032,5,524,19663.0,252.0,104.8,5,1508,16490.75,1236.0,301.6
9507.0,17,4,823,2,163,0.0,89.0,81.5,2,660,0.0,443.0,330.0
120123249.0,6,14,2086,9,1204,15015406.125,188.0,133.77777777777777,5,882,22523827.5,204.0,176.4
2593600.0,6,2,132,1,66,0.0,66.0,66.0,1,66,0.0,66.0,66.0
47172.0,6,14,4740,7,653,7741.5,249.0,93.28571428571428,7,4087,6889.333333333333,1514.0,583.8571428571429
302176.0,6,6,412,4,272,100725.33333333331,74.0,68.0,2,140,0.0,74.0,70.0
97733332.0,17,14,1126,7,563,16167996.5,174.0,80.42857142857143,7,563,16166819.166666666,174.0,80.42857142857143
109314765.0,6,193,21854,97,6636,1138695.46875,140.0,68.41237113402062,96,15218,1139863.4421052632,284.0,158.52083333333334
31060.0,6,14,4740,7,653,2635.833333333333,249.0,93.28571428571428,7,4087,5032.666666666667,1514.0,583.8571428571429
303638.0,6,2,132,1,66,0.0,66.0,66.0,1,66,0.0,66.0,66.0
36451.0,6,10,2032,5,524,7010.25,252.0,104.8,5,1508,8879.5,1236.0,301.6
121511666.0,6,227,25668,114,17914,1075324.4778761065,390.0,157.140350877193,113,7754,1066157.4107142857,140.0,68.61946902654867
218210.0,6,12,1373,7,714,36368.333333333336,298.0,102.0,5,659,52954.5,379.0,131.8
0.0,6,1,54,0,0,0.0,0.0,0.0,1,54,0.0,54.0,54.0
21350.0,17,2,582,1,83,0.0,83.0,83.0,1,499,0.0,499.0,499.0
90008673.0,17,27,12943,27,12943,3461872.0384615385,501.0,479.3703703703704,0,0,0.0,0.0,0.0
410008.0,6,3,204,1,68,0.0,68.0,68.0,2,136,0.0,70.0,68.0
15057.0,17,2,180,1,90,0.0,90.0,90.0,1,90,0.0,90.0,90.0
23964.0,6,10,2032,5,524,5742.25,252.0,104.8,5,1508,5551.25,1236.0,301.6
108104801.0,17,5,1005,5,1005,27026200.25,201.0,201.0,0,0,0.0,0.0,0.0
24713.0,6,14,4740,7,653,3628.3333333333335,249.0,93.28571428571428,7,4087,2998.1666666666665,1514.0,583.8571428571429
407941.0,17,4,820,2,156,0.0,78.0,78.0,2,664,0.0,332.0,332.0
81297.0,6,14,4740,7,653,9932.833333333334,249.0,93.28571428571428,7,4087,10874.333333333334,1514.0,583.8571428571429
229142.0,17,4,1400,4,1400,76380.66666666667,350.0,350.0,0,0,0.0,0.0,0.0
120297874.0,6,241,27260,121,19044,1002482.2833333332,284.0,157.38842975206612,120,8216,1002265.6974789916,140.0,68.46666666666667
55950.0,6,10,2032,5,524,12611.25,252.0,104.8,5,1508,10811.75,1236.0,301.6
27018.0,6,14,4740,7,653,3959.5,249.0,93.28571428571428,7,4087,4345.5,1514.0,583.8571428571429
2194423.0,6,18,6803,10,1501,243824.7777777777,408.0,150.1,8,5302,251571.4285714285,1514.0,662.75
34611.0,6,14,4740,7,653,5049.833333333333,249.0,93.28571428571428,7,4087,5641.833333333333,1514.0,583.8571428571429
2528467.0,6,25,7573,14,3735,194497.4615384616,1514.0,266.7857142857143,11,3838,227028.8,1514.0,348.90909090909093
9541.0,17,4,823,2,163,0.0,89.0,81.5,2,660,0.0,443.0,330.0
120008667.0,6,16,1192,8,596,17144095.285714287,95.0,74.5,8,596,17106692.14285714,95.0,74.5
358.0,17,2,267,1,83,0.0,83.0,83.0,1,184,0.0,184.0,184.0
95355352.0,6,25,1822,12,884,8667286.727272727,95.0,73.66666666666667,13,938,7946039.25,95.0,72.15384615384616
2797280.0,6,2,132,1,66,0.0,66.0,66.0,1,66,0.0,66.0,66.0
152093.0,17,2,414,1,88,0.0,88.0,88.0,1,326,0.0,326.0,326.0
39747.0,6,14,4740,7,653,6503.833333333333,249.0,93.28571428571428,7,4087,6414.0,1514.0,583.8571428571429
99862.0,17,2,762,2,762,0.0,381.0,381.0,0,0,0.0,0.0,0.0
203302.0,17,4,6056,4,6056,67767.33333333333,1514.0,1514.0,0,0,0.0,0.0,0.0
1302479.0,6,4,264,2,132,0.0,66.0,66.0,2,132,0.0,66.0,66.0
0.0,6,1,54,1,54,0.0,54.0,54.0,0,0,0.0,0.0,0.0
108111714.0,17,5,955,5,955,27027928.5,191.0,191.0,0,0,0.0,0.0,0.0
224150.0,17,2,180,1,90,0.0,90.0,90.0,1,90,0.0,90.0,90.0
14140.0,6,10,2032,5,524,3312.75,252.0,104.8,5,1508,2895.75,1236.0,301.6
90015678.0,17,28,13364,28,13364,3333914.0,501.0,477.2857142857143,0,0,0.0,0.0,0.0
96751870.0,6,39,2574,20,1320,5076222.052631579,66.0,66.0,19,1254,5150430.944444444,66.0,66.0
121251.0,6,3,337,2,214,0.0,160.0,107.0,1,123,0.0,123.0,123.0
282540.0,6,10,1221,6,636,56508.0,298.0,106.0,4,585,88301.33333333333,379.0,146.25
2005916.0,6,2,132,1,66,0.0,66.0,66.0,1,66,0.0,66.0,66.0
116507398.0,6,48,3168,24,1584,5065539.043478261,66.0,66.0,24,1584,5052492.956521739,66.0,66.0
90032602.0,17,27,12943,27,12943,3462792.3846153845,501.0,479.3703703703704,0,0,0.0,0.0,0.0
379701.0,6,3,1604,2,851,0.0,785.0,425.5,1,753,0.0,753.0,753.0
143923.0,17,2,180,1,90,0.0,90.0,90.0,1,90,0.0,90.0,90.0
109647571.0,6,32,2220,16,1149,7295454.2,123.0,71.8125,16,1071,7295444.6,123.0,66.9375
96367742.0,6,40,2640,20,1320,5071986.421052632,66.0,66.0,20,1320,5055543.7894736845,66.0,66.0
313358.0,6,6,412,4,272,104452.66666666669,74.0,68.0,2,140,0.0,74.0,70.0
121048124.0,6,270,30974,135,9132,887914.604477612,140.0,67.64444444444445,135,21842,897078.5223880596,284.0,161.7925925925926
27173547.0,17,5,1710,5,1710,6793386.75,342.0,342.0,0,0,0.0,0.0,0.0
43672.0,6,10,2032,5,524,10594.0,252.0,104.8,5,1508,9239.25,1236.0,301.6
308051.0,17,4,1400,4,1400,102683.66666666669,350.0,350.0,0,0,0.0,0.0,0.0
30430231.0,6,5,336,3,202,15143880.5,70.0,67.33333333333333,2,134,0.0,68.0,67.0
115220115.0,6,48,3168,24,1584,5009570.217391305,66.0,66.0,24,1584,4997439.130434782,66.0,66.0
120125697.0,6,15,2428,9,1204,15015712.125,188.0,133.77777777777777,6,1224,18019943.8,204.0,204.0
66399.0,6,14,4740,7,653,10899.833333333334,249.0,93.28571428571428,7,4087,10910.833333333334,1514.0,583.8571428571429
818.0,17,4,438,2,148,0.0,74.0,74.0,2,290,0.0,147.0,145.0
103561443.0,6,43,2838,22,1452,4931484.476190476,66.0,66.0,21,1386,5160098.2,66.0,66.0
409.0,17,2,410,1,78,0.0,78.0,78.0,1,332,0.0,332.0,332.0
316205.0,6,6,412,4,272,105401.66666666669,74.0,68.0,2,140,0.0,74.0,70.0
30658.0,6,10,2032,5,524,7430.25,252.0,104.8,5,1508,7356.0,1236.0,301.6
13231.0,6,13,1459,7,862,2205.1666666666665,271.0,123.14285714285714,6,597,1990.0,259.0,99.5
120074412.0,17,28,13364,28,13364,4447200.444444444,501.0,477.2857142857143,0,0,0.0,0.0,0.0
38098.0,6,14,4740,7,653,5835.0,249.0,93.28571428571428,7,4087,5974.666666666667,1514.0,583.8571428571429
2788879.0,6,2,132,1,66,0.0,66.0,66.0,1,66,0.0,66.0,66.0
42704.0,6,14,4740,7,653,6946.0,249.0,93.28571428571428,7,4087,6239.5,1514.0,583.8571428571429
313015.0,6,6,412,4,272,104338.33333333331,74.0,68.0,2,140,0.0,74.0,70.0
11190.0,6,11,2098,6,590,1842.6,252.0,98.33333333333331,5,1508,2419.75,1236.0,301.6
107370198.0,6,32,2236,16,1165,7158013.2,139.0,72.8125,16,1071,7143603.8,123.0,66.9375
221487.0,6,3,426,2,280,0.0,214.0,140.0,1,146,0.0,146.0,146.0
21596.0,17,2,582,1,83,0.0,83.0,83.0,1,499,0.0,499.0,499.0
14125768.0,17,6,2052,6,2052,2825153.6,342.0,342.0,0,0,0.0,0.0,0.0
90031139.0,17,28,13364,28,13364,3334486.6296296297,501.0,477.2857142857143,0,0,0.0,0.0,0.0
105138646.0,6,199,22364,100,6896,1062006.5252525252,140.0,68.96,99,15468,1070611.0714285714,284.0,156.24242424242425
111382514.0,6,393,51576,197,13298,568278.1326530612,140.0,67.50253807106598,196,38278,565930.4051282051,336.0,195.29591836734693
108101737.0,17,5,955,5,955,27025434.25,191.0,191.0,0,0,0.0,0.0,0.0
205800.0,17,2,180,1,90,0.0,90.0,90.0,1,90,0.0,90.0,90.0
298437.0,6,6,412,4,272,99479.0,74.0,68.0,2,140,0.0,74.0,70.0
90012282.0,17,28,13364,28,13364,3333788.222222222,501.0,477.2857142857143,0,0,0.0,0.0,0.0
205940.0,17,2,180,1,90,0.0,90.0,90.0,1,90,0.0,90.0,90.0
147279.0,17,4,571,2,148,0.0,74.0,74.0,2,423,0.0,280.0,211.5
108106000.0,17,5,1005,5,1005,27026500.0,201.0,201.0,0,0,0.0,0.0,0.0
299855.0,6,6,412,4,272,99951.66666666669,74.0,68.0,2,140,0.0,74.0,70.0
26009769.0,6,140,31127,72,23842,366334.7746478873,566.0,331.1388888888889,68,7285,383951.3432835821,898.0,107.13235294117646
509550.0,6,4,270,2,134,0.0,68.0,67.0,2,136,0.0,70.0,68.0
1321475.0,6,4,264,2,132,0.0,66.0,66.0,2,132,0.0,66.0,66.0
18007.0,6,2,145,2,145,0.0,91.0,72.5,0,0,0.0,0.0,0.0
316787.0,17,4,1400,4,1400,105595.66666666669,350.0,350.0,0,0,0.0,0.0,0.0
91058605.0,6,166,18884,83,13258,1107845.1097560977,390.0,159.73493975903614,83,5626,1107846.1707317072,140.0,67.78313253012048
0.0,6,1,66,1,66,0.0,66.0,66.0,0,0,0.0,0.0,0.0
209113.0,6,3,426,2,280,0.0,214.0,140.0,1,146,0.0,146.0,146.0
90031571.0,17,28,13364,28,13364,3334502.6296296297,501.0,477.2857142857143,0,0,0.0,0.0,0.0
47604693.0,6,8,1940,3,887,22601762.0,753.0,295.6666666666667,5,1053,11258899.25,785.0,210.6
135135585.0,17,6,1146,6,1146,27027117.0,191.0,191.0,0,0,0.0,0.0,0.0
209562.0,17,2,180,1,90,0.0,90.0,90.0,1,90,0.0,90.0,90.0
90037526.0,17,27,12943,27,12943,3462981.769230769,501.0,479.3703703703704,0,0,0.0,0.0,0.0
0.0,17,1,90,1,90,0.0,90.0,90.0,0,0,0.0,0.0,0.0
108679710.0,6,32,2220,16,1149,7245314.0,123.0,71.8125,16,1071,7230888.8,123.0,66.9375
306.0,17,2,168,1,76,0.0,76.0,76.0,1,92,0.0,92.0,92.0
90045315.0,17,27,12943,27,12943,3463281.346153846,501.0,479.3703703703704,0,0,0.0,0.0,0.0
424.0,17,2,166,1,75,0.0,75.0,75.0,1,91,0.0,91.0,91.0
73869.0,6,14,4740,7,653,12180.166666666666,249.0,93.28571428571428,7,4087,11727.666666666666,1514.0,583.8571428571429
284505.0,17,2,363,1,79,0.0,79.0,79.0,1,284,0.0,284.0,284.0
108124563.0,17,5,1005,5,1005,27031140.75,201.0,201.0,0,0,0.0,0.0,0.0
3048.0,17,2,224,1,76,0.0,76.0,76.0,1,148,0.0,148.0,148.0
47958.0,6,14,4740,7,653,6924.833333333333,249.0,93.28571428571428,7,4087,6015.0,1514.0,583.8571428571429
120119927.0,6,14,2224,9,1204,15014990.875,188.0,133.77777777777777,5,1020,22522136.25,204.0,204.0
120161484.0,6,212,23980,106,7292,1136501.1333333333,140.0,68.79245283018868,106,16688,1136552.5714285714,284.0,157.43396226415095
108103522.0,17,5,955,5,955,27025880.5,191.0,191.0,0,0,0.0,0.0,0.0
178308.0,17,2,180,1,90,0.0,90.0,90.0,1,90,0.0,90.0,90.0
328.0,17,2,160,1,80,0.0,80.0,80.0,1,80,0.0,80.0,80.0
109117676.0,6,33,2428,17,1288,6806374.625,139.0,75.76470588235294,16,1140,7260132.933333334,123.0,71.25
6805.0,17,2,582,1,83,0.0,83.0,83.0,1,499,0.0,499.0,499.0
390431.0,6,3,1604,1,753,0.0,753.0,753.0,2,851,0.0,785.0,425.5
120066740.0,17,28,13364,28,13364,4446916.296296297,501.0,477.2857142857143,0,0,0.0,0.0,0.0
90255251.0,6,13,2036,8,1016,12893607.285714284,188.0,127.0,5,1020,22523181.25,204.0,204.0
0.0,17,1,381,1,381,0.0,381.0,381.0,0,0,0.0,0.0,0.0
106056656.0,17,14,864,7,432,17501133.0,174.0,61.71428571428572,7,432,17500161.833333332,174.0,61.71428571428572
2804484.0,6,2,132,1,66,0.0,66.0,66.0,1,66,0.0,66.0,66.0
146417.0,6,3,337,2,214,0.0,160.0,107.0,1,123,0.0,123.0,123.0
103444.0,17,2,286,2,286,0.0,143.0,143.0,0,0,0.0,0.0,0.0
104161752.0,6,198,22426,99,15596,1060679.2551020407,284.0,157.53535353535352,99,6830,1060678.948979592,140.0,68.98989898989899
10843.0,17,4,344,2,150,0.0,75.0,75.0,2,194,0.0,103.0,97.0
90268160.0,6,13,2036,8,1016,12895451.42857143,188.0,127.0,5,1020,22525937.25,204.0,204.0
77865733.0,17,14,4788,14,4788,5989671.769230769,342.0,342.0,0,0,0.0,0.0,0.0
209649.0,17,2,180,1,90,0.0,90.0,90.0,1,90,0.0,90.0,90.0
319441.0,17,4,1400,4,1400,106480.33333333331,350.0,350.0,0,0,0.0,0.0,0.0
119651975.0,6,240,27050,120,18834,1003660.2941176472,284.0,156.95,120,8216,1003660.2941176472,140.0,68.46666666666667
39508.0,6,14,4740,7,653,6373.833333333333,249.0,93.28571428571428,7,4087,6064.0,1514.0,583.8571428571429
232810.0,6,3,337,2,214,0.0,160.0,107.0,1,123,0.0,123.0,123.0
233984.0,6,3,373,2,238,0.0,172.0,119.0,1,135,0.0,135.0,135.0
45461.0,6,14,4740,7,653,7004.5,249.0,93.28571428571428,7,4087,6576.833333333333,1514.0,583.8571428571429
153433.0,17,2,180,1,90,0.0,90.0,90.0,1,90,0.0,90.0,90.0
14647.0,6,10,2032,5,524,3354.25,252.0,104.8,5,1508,3391.5,1236.0,301.6
91030909.0,6,158,17746,79,12310,1164302.8974358975,284.0,155.8227848101266,79,5436,1164303.1794871795,140.0,68.81012658227849
399780.0,6,10,1221,6,636,79956.0,298.0,106.0,4,585,131011.66666666669,379.0,146.25
602060.0,6,4,508,2,238,0.0,172.0,119.0,2,270,0.0,135.0,135.0
90026482.0,17,28,13364,28,13364,3334314.1481481483,501.0,477.2857142857143,0,0,0.0,0.0,0.0
17829.0,6,10,2032,5,524,3801.0,252.0,104.8,5,1508,4021.5,1236.0,301.6
4525.0,17,2,598,1,72,0.0,72.0,72.0,1,526,0.0,526.0,526.0
146979.0,6,3,373,2,238,0.0,172.0,119.0,1,135,0.0,135.0,135.0
2364.0,17,4,344,2,150,0.0,75.0,75.0,2,194,0.0,103.0,97.0
137449318.0,17,16,1212,8,606,16846510.85714286,174.0,75.75,8,606,18533366.0,174.0,75.75
107902323.0,17,14,864,7,432,17833500.833333332,174.0,61.71428571428572,7,432,17834150.166666668,174.0,61.71428571428572
2744757.0,6,25,7573,14,3735,211135.15384615384,1514.0,266.7857142857143,11,3838,248414.8,1514.0,348.90909090909093
104616521.0,17,15,5130,15,5130,7472608.642857143,342.0,342.0,0,0,0.0,0.0,0.0
3748.0,17,4,344,2,150,0.0,75.0,75.0,2,194,0.0,103.0,97.0
205728.0,17,2,180,1,90,0.0,90.0,90.0,1,90,0.0,90.0,90.0
5624595.0,6,5,336,2,134,0.0,68.0,67.0,3,202,1423151.0,70.0,67.33333333333333
116359029.0,6,48,3168,24,1584,5059088.217391305,66.0,66.0,24,1584,5045418.652173913,66.0,66.0
16975.0,17,4,823,2,163,0.0,89.0,81.5,2,660,0.0,443.0,330.0
1242409.0,6,7,499,3,198,614669.0,66.0,66.0,4,301,395859.0,103.0,75.25
2586252.0,6,2,132,1,66,0.0,66.0,66.0,1,66,0.0,66.0,66.0
11261734.0,17,4,1368,4,1368,3753911.3333333335,342.0,342.0,0,0,0.0,0.0,0.0
236519.0,6,3,337,2,214,0.0,160.0,107.0,1,123,0.0,123.0,123.0
92598.0,6,2,132,1,66,0.0,66.0,66.0,1,66,0.0,66.0,66.0
2076.0,17,4,344,2,150,0.0,75.0,75.0,2,194,0.0,103.0,97.0
11610595.0,6,23,7187,13,1723,967549.5833333334,408.0,132.53846153846155,10,5464,828050.1111111111,1514.0,546.4
51206.0,6,14,4740,7,653,8371.5,249.0,93.28571428571428,7,4087,7590.666666666667,1514.0,583.8571428571429
333.0,17,2,166,1,75,0.0,75.0,75.0,1,91,0.0,91.0,91.0
6636.0,17,4,823,2,163,0.0,89.0,81.5,2,660,0.0,443.0,330.0
321601.0,17,4,1400,4,1400,107200.33333333331,350.0,350.0,0,0,0.0,0.0,0.0
5621302.0,6,4,270,2,134,0.0,68.0,67.0,2,136,0.0,70.0,68.0
41371.0,6,10,2032,5,524,10001.0,252.0,104.8,5,1508,8295.75,1236.0,301.6
102977.0,17,2,286,2,286,0.0,143.0,143.0,0,0,0.0,0.0,0.0
397260.0,6,5,367,3,235,198630.0,103.0,78.33333333333333,2,132,0.0,66.0,66.0
80977.0,6,14,4740,7,653,12375.0,249.0,93.28571428571428,7,4087,13287.166666666666,1514.0,583.8571428571429
112238004.0,17,14,864,7,432,18667772.5,174.0,61.71428571428572,7,432,18666849.33333333,174.0,61.71428571428572
54927.0,6,10,2032,5,524,13208.0,252.0,104.8,5,1508,11413.75,1236.0,301.6
2807.0,17,2,762,2,762,0.0,381.0,381.0,0,0,0.0,0.0,0.0
35849.0,6,12,1413,7,882,5974.833333333333,291.0,126.0,5,531,7358.75,259.0,106.2
216632.0,17,2,180,1,90,0.0,90.0,90.0,1,90,0.0,90.0,90.0
31712.0,6,14,4740,7,653,5160.166666666667,249.0,93.28571428571428,7,4087,5144.833333333333,1514.0,583.8571428571429
135144627.0,17,6,1206,6,1206,27028925.4,201.0,201.0,0,0,0.0,0.0,0.0
340.0,17,2,160,1,80,0.0,80.0,80.0,1,80,0.0,80.0,80.0
118749470.0,6,48,3168,24,1584,5163020.434782608,66.0,66.0,24,1584,5149569.043478261,66.0,66.0
228384.0,17,2,180,1,90,0.0,90.0,90.0,1,90,0.0,90.0,90.0
125771859.0,6,33,2280,17,1209,7860741.1875,123.0,71.11764705882354,16,1071,7704634.2,123.0,66.9375
103538.0,17,2,286,2,286,0.0,143.0,143.0,0,0,0.0,0.0,0.0
106208362.0,6,33,2497,16,1209,7080557.466666667,123.0,75.5625,17,1288,6623410.3125,139.0,75.76470588235294
64515387.00000001,6,9,1479,9,1479,8064423.375,172.0,164.33333333333334,0,0,0.0,0.0,0.0
21116.0,6,14,4740,7,653,3001.0,249.0,93.28571428571428,7,4087,3105.1666666666665,1514.0,583.8571428571429
2006.0,17,4,344,2,150,0.0,75.0,75.0,2,194,0.0,103.0,97.0
320815.0,17,4,1400,4,1400,106938.33333333331,350.0,350.0,0,0,0.0,0.0,0.0
216479.0,6,3,426,2,280,0.0,214.0,140.0,1,146,0.0,146.0,146.0
225750.0,6,13,1394,7,797,37625.0,253.0,113.85714285714286,6,597,43670.2,259.0,99.5
100867038.0,6,34,2482,17,1288,6290711.8125,139.0,75.76470588235294,17,1194,6290700.0,123.0,70.23529411764706
1181095.0,6,13,3000,8,2372,168727.85714285713,1514.0,296.5,5,628,226352.25,331.0,125.6
205900.0,6,3,426,2,280,0.0,214.0,140.0,1,146,0.0,146.0,146.0
153524.0,17,2,180,1,90,0.0,90.0,90.0,1,90,0.0,90.0,90.0
331.0,17,2,166,1,75,0.0,75.0,75.0,1,91,0.0,91.0,91.0
119526782.0,6,226,25422,113,17742,1065281.7142857143,284.0,157.00884955752213,113,7680,1065282.2589285714,140.0,67.96460176991151
122975407.0,6,48,3168,24,1584,5071912.260869565,66.0,66.0,24,1584,5195183.608695652,66.0,66.0
816.0,17,4,438,2,148,0.0,74.0,74.0,2,290,0.0,147.0,145.0
41903.0,6,14,4740,7,653,6297.0,249.0,93.28571428571428,7,4087,6791.5,1514.0,583.8571428571429
99050.0,17,2,286,2,286,0.0,143.0,143.0,0,0,0.0,0.0,0.0
135137366.0,17,6,1146,6,1146,27027473.2,191.0,191.0,0,0,0.0,0.0,0.0
90254622.0,6,13,2036,8,1016,12893517.42857143,188.0,127.0,5,1020,22521287.25,204.0,204.0
228142.0,17,2,180,1,90,0.0,90.0,90.0,1,90,0.0,90.0,90.0
432.0,17,2,166,1,75,0.0,75.0,75.0,1,91,0.0,91.0,91.0
111625.0,6,2,132,1,66,0.0,66.0,66.0,1,66,0.0,66.0,66.0
143843.0,17,2,180,1,90,0.0,90.0,90.0,1,90,0.0,90.0,90.0
90094146.0,6,12,1848,5,1020,22522965.75,204.0,204.0,7,828,15015299.333333334,188.0,118.28571428571428
112486253.0,17,14,864,7,432,18666827.0,174.0,61.71428571428572,7,432,18667709.5,174.0,61.71428571428572
16420673.0,6,27,9227,15,2193,1172905.2142857143,408.0,146.2,12,7034,1118024.3636363635,1514.0,586.1666666666666
135131202.0,17,6,1206,6,1206,27026240.4,201.0,201.0,0,0,0.0,0.0,0.0
2373.0,17,4,344,2,150,0.0,75.0,75.0,2,194,0.0,103.0,97.0
299.0,17,2,156,1,78,0.0,78.0,78.0,1,78,0.0,78.0,78.0
127231.0,17,4,1400,4,1400,42410.333333333336,350.0,350.0,0,0,0.0,0.0,0.0
196968.0,17,2,180,1,90,0.0,90.0,90.0,1,90,0.0,90.0,90.0
726.0,17,4,438,2,148,0.0,74.0,74.0,2,290,0.0,147.0,145.0
108150944.0,17,5,955,5,955,27037736.0,191.0,191.0,0,0,0.0,0.0,0.0
2428.0,17,4,344,2,150,0.0,75.0,75.0,2,194,0.0,103.0,97.0
60220.0,6,14,4740,7,653,9905.666666666666,249.0,93.28571428571428,7,4087,9822.0,1514.0,583.8571428571429
90231037.0,6,21,1585,10,745,9997376.222222222,95.0,74.5,11,840,9001568.7,95.0,76.36363636363636
24280.0,6,14,4740,7,653,3831.0,249.0,93.28571428571428,7,4087,3851.3333333333335,1514.0,583.8571428571429
117312875.0,6,235,26360,118,8084,1002674.1452991453,140.0,68.50847457627118,117,18276,1002500.4396551724,284.0,156.2051282051282
315862.0,17,4,1400,4,1400,105287.33333333331,350.0,350.0,0,0,0.0,0.0,0.0
307096.0,6,6,412,4,272,102365.33333333331,74.0,68.0,2,140,0.0,74.0,70.0
27530.0,6,14,4740,7,653,4387.833333333333,249.0,93.28571428571428,7,4087,4127.833333333333,1514.0,583.8571428571429
93067858.0,17,12,778,6,389,18601423.0,174.0,64.83333333333333,6,389,18600169.2,174.0,64.83333333333333
24067.0,6,12,1413,7,882,4011.1666666666665,291.0,126.0,5,531,5095.0,259.0,106.2
90123528.0,6,28,2008,14,1045,6915960.846153846,139.0,74.64285714285714,14,963,6915960.846153846,123.0,68.78571428571429
123178.0,6,3,337,2,214,0.0,160.0,107.0,1,123,0.0,123.0,123.0
200391.0,17,4,6056,4,6056,66797.0,1514.0,1514.0,0,0,0.0,0.0,0.0
146269.0,6,3,337,2,214,0.0,160.0,107.0,1,123,0.0,123.0,123.0
148539.0,17,2,414,1,88,0.0,88.0,88.0,1,326,0.0,326.0,326.0
33162.0,6,14,4740,7,653,5298.166666666667,249.0,93.28571428571428,7,4087,5142.833333333333,1514.0,583.8571428571429
120249594.0,6,220,24900,110,7482,1095750.3027522936,140.0,68.01818181818182,110,17418,1095669.495412844,284.0,158.34545454545454
146257.0,6,3,337,2,214,0.0,160.0,107.0,1,123,0.0,123.0,123.0
101748.0,17,2,762,2,762,0.0,381.0,381.0,0,0,0.0,0.0,0.0
120299075.0,6,218,24662,109,7490,1106182.1574074074,140.0,68.71559633027523,109,17172,1106345.8796296297,284.0,157.54128440366972
32061.0,6,14,4740,7,653,4655.166666666667,249.0,93.28571428571428,7,4087,4986.0,1514.0,583.8571428571429
5827797.0,6,5,336,2,134,0.0,68.0,67.0,3,202,1524822.5,70.0,67.33333333333333
592684.0,6,4,508,2,238,0.0,172.0,119.0,2,270,0.0,135.0,135.0
91727648.0,6,29,2200,15,1168,6536531.285714285,139.0,77.86666666666666,14,1032,7039373.0,123.0,73.71428571428571
5620852.0,6,5,336,2,134,0.0,68.0,67.0,3,202,1523485.0,70.0,67.33333333333333
90053929.0,17,28,13364,28,13364,3335330.703703704,501.0,477.2857142857143,0,0,0.0,0.0,0.0
2003210.0,17,4,525,2,150,0.0,75.0,75.0,2,375,0.0,284.0,187.5
146500.0,6,3,337,2,214,0.0,160.0,107.0,1,123,0.0,123.0,123.0
208010.0,17,2,180,1,90,0.0,90.0,90.0,1,90,0.0,90.0,90.0
413877.0,17,2,762,2,762,0.0,381.0,381.0,0,0,0.0,0.0,0.0
22822.0,6,14,4740,7,653,3464.0,249.0,93.28571428571428,7,4087,3665.1666666666665,1514.0,583.8571428571429
53468.0,6,10,2032,5,524,12878.0,252.0,104.8,5,1508,13095.0,1236.0,301.6
539176.0,17,6,2100,6,2100,107835.2,350.0,350.0,0,0,0.0,0.0,0.0
30107001.0,6,4,270,3,202,15053500.5,70.0,67.33333333333333,1,68,0.0,68.0,68.0
1562.0,17,2,180,1,90,0.0,90.0,90.0,1,90,0.0,90.0,90.0
309486.0,17,2,180,1,90,0.0,90.0,90.0,1,90,0.0,90.0,90.0
135128192.0,17,6,1146,6,1146,27025638.4,191.0,191.0,0,0,0.0,0.0,0.0
3004113.0,6,11,2106,6,598,600630.6,252.0,99.66666666666669,5,1508,1707.25,1236.0,301.6
10470165.0,6,7,478,4,272,3443186.6666666665,74.0,68.0,3,206,5164723.0,74.0,68.66666666666667
120001030.0,17,15,907,8,475,17143004.285714287,174.0,59.375,7,432,16678526.166666666,174.0,61.71428571428572
235497.0,6,3,337,2,214,0.0,160.0,107.0,1,123,0.0,123.0,123.0
216533.0,6,3,426,2,280,0.0,214.0,140.0,1,146,0.0,146.0,146.0
120518714.0,6,263,30438,132,21496,919990.1832061068,300.0,162.84848484848484,131,8942,918962.0384615384,140.0,68.25954198473282
347.0,17,2,250,1,93,0.0,93.0,93.0,1,157,0.0,157.0,157.0
302417.0,6,2,132,1,66,0.0,66.0,66.0,1,66,0.0,66.0,66.0
165886.0,17,2,180,1,90,0.0,90.0,90.0,1,90,0.0,90.0,90.0
15222.0,6,11,1131,6,600,2666.4,262.0,100.0,5,531,3481.0,259.0,106.2
499831.0,6,4,270,2,134,0.0,68.0,67.0,2,136,0.0,70.0,68.0
19591.0,6,2,145,2,145,0.0,91.0,72.5,0,0,0.0,0.0,0.0
278261.0,6,10,1221,6,636,55652.2,298.0,106.0,4,585,87326.33333333333,379.0,146.25
303010.0,6,6,412,4,272,101003.33333333331,74.0,68.0,2,140,0.0,74.0,70.0
117179147.0,6,42,3346,23,1837,5326324.863636363,139.0,79.8695652173913,19,1509,6497861.555555556,123.0,79.42105263157895
28592.0,6,10,2032,5,524,6612.25,252.0,104.8,5,1508,6863.0,1236.0,301.6
22216.0,6,13,4412,6,409,4285.4,127.0,68.16666666666667,7,4003,3522.833333333333,1514.0,571.8571428571429
5004770.0,17,8,1149,4,288,1668167.6666666667,72.0,72.0,4,861,1667143.3333333333,526.0,215.25
28516.0,6,11,2098,6,590,4983.6,252.0,98.33333333333331,5,1508,6183.0,1236.0,301.6
47971.0,6,10,2032,5,524,11667.25,252.0,104.8,5,1508,11720.25,1236.0,301.6
90543438.0,6,14,2240,8,1016,12934776.857142856,188.0,127.0,6,1224,18072854.2,204.0,204.0
15390.0,6,13,1459,7,862,2517.1666666666665,271.0,123.14285714285714,6,597,2276.8,259.0,99.5
358.0,17,2,762,2,762,0.0,381.0,381.0,0,0,0.0,0.0,0.0
833625.0,6,9,1096,6,625,166725.0,287.0,104.16666666666669,3,471,280510.0,331.0,157.0
108105571.0,17,5,955,5,955,27026392.75,191.0,191.0,0,0,0.0,0.0,0.0
2049811.0,17,8,1640,4,312,683140.3333333334,78.0,78.0,4,1328,683131.6666666666,332.0,332.0
90940971.0,6,15,1138,7,542,15156828.5,95.0,77.42857142857143,8,596,12948780.285714284,95.0,74.5
294.0,17,2,174,1,79,0.0,79.0,79.0,1,95,0.0,95.0,95.0
297.0,17,2,164,1,82,0.0,82.0,82.0,1,82,0.0,82.0,82.0
309678.0,6,6,412,4,272,103226.0,74.0,68.0,2,140,0.0,74.0,70.0
33640.0,6,10,2032,5,524,7522.75,252.0,104.8,5,1508,7841.0,1236.0,301.6
0.0,6,1,66,1,66,0.0,66.0,66.0,0,0,0.0,0.0,0.0
242439.0,6,3,337,2,214,0.0,160.0,107.0,1,123,0.0,123.0,123.0
32037.000000000004,6,14,4740,7,653,5219.333333333333,249.0,93.28571428571428,7,4087,4839.5,1514.0,583.8571428571429
13875.0,17,2,180,1,90,0.0,90.0,90.0,1,90,0.0,90.0,90.0
242151.0,6,3,337,2,214,0.0,160.0,107.0,1,123,0.0,123.0,123.0
847114.0,6,2,132,1,66,0.0,66.0,66.0,1,66,0.0,66.0,66.0
353.0,17,2,160,1,80,0.0,80.0,80.0,1,80,0.0,80.0,80.0
26950.0,6,13,4412,6,409,5245.4,127.0,68.16666666666667,7,4003,4303.666666666667,1514.0,571.8571428571429
35894.0,6,14,4740,7,653,5826.333333333333,249.0,93.28571428571428,7,4087,5843.333333333333,1514.0,583.8571428571429
108115142.0,17,5,1005,5,1005,27028785.5,201.0,201.0,0,0,0.0,0.0,0.0
1772844.0,6,2,132,1,66,0.0,66.0,66.0,1,66,0.0,66.0,66.0
10472804.0,6,7,478,4,272,3444262.0,74.0,68.0,3,206,5166801.0,74.0,68.66666666666667
253334.0,6,3,337,2,214,0.0,160.0,107.0,1,123,0.0,123.0,123.0
14660.0,6,11,1132,6,556,2932.0,218.0,92.66666666666669,5,576,2773.5,304.0,115.2
2136331.0,6,24,7545,12,2450,194211.9090909091,1034.0,204.16666666666663,12,5095,165662.0,1510.0,424.5833333333333
308997.0,6,6,412,4,272,102999.0,74.0,68.0,2,140,0.0,74.0,70.0
14532.0,6,11,1133,6,602,2666.6,264.0,100.33333333333331,5,531,2843.5,259.0,106.2
6701.0,17,4,823,2,163,0.0,89.0,81.5,2,660,0.0,443.0,330.0
281210.0,17,2,363,1,79,0.0,79.0,79.0,1,284,0.0,284.0,284.0
1302492.0,6,4,264,2,132,0.0,66.0,66.0,2,132,0.0,66.0,66.0
10421245.0,6,6,412,3,206,5142455.5,74.0,68.66666666666667,3,206,5142360.5,74.0,68.66666666666667
108106059.0,17,5,1005,5,1005,27026514.75,201.0,201.0,0,0,0.0,0.0,0.0
246033.0,6,3,337,2,214,0.0,160.0,107.0,1,123,0.0,123.0,123.0
135142204.0,17,6,1146,6,1146,27028440.8,191.0,191.0,0,0,0.0,0.0,0.0
90103018.0,6,12,1848,5,1020,22525160.25,204.0,204.0,7,828,14970892.666666666,188.0,118.28571428571428
120197.0,17,2,180,1,70,0.0,70.0,70.0,1,110,0.0,110.0,110.0
30596.0,6,11,1133,6,602,5751.8,264.0,100.33333333333331,5,531,5453.5,259.0,106.2
309868.0,17,4,1400,4,1400,103289.33333333331,350.0,350.0,0,0,0.0,0.0,0.0
182918.0,17,2,762,2,762,0.0,381.0,381.0,0,0,0.0,0.0,0.0
90049080.0,17,28,13364,28,13364,3335151.111111111,501.0,477.2857142857143,0,0,0.0,0.0,0.0
47616.0,6,2,132,1,66,0.0,66.0,66.0,1,66,0.0,66.0,66.0
2435.0,17,4,344,2,150,0.0,75.0,75.0,2,194,0.0,103.0,97.0
2978997.0,6,3,1777,2,951,0.0,885.0,475.5,1,826,0.0,826.0,826.0
10563251.0,6,7,478,4,272,3475862.0,74.0,68.0,3,206,5213706.0,74.0,68.66666666666667
90000970.0,17,11,735,6,389,18000194.0,174.0,64.83333333333333,5,346,19931427.0,174.0,69.2
149671.0,17,2,180,1,90,0.0,90.0,90.0,1,90,0.0,90.0,90.0
201995.0,6,10,1066,5,490,49976.75,218.0,98.0,5,576,50290.75,304.0,115.2
90524583.0,6,13,2036,8,1016,12932083.285714284,188.0,127.0,5,1020,22590318.5,204.0,204.0
192890.0,17,2,180,1,90,0.0,90.0,90.0,1,90,0.0,90.0,90.0
114667401.0,6,30,1990,15,1042,8175125.357142857,139.0,69.46666666666667,15,948,8175121.285714285,123.0,63.2
108105465.0,17,5,955,5,955,27026366.25,191.0,191.0,0,0,0.0,0.0,0.0
149783.0,17,4,6056,4,6056,49927.66666666666,1514.0,1514.0,0,0,0.0,0.0,0.0
90515110.0,6,14,2240,8,1016,12930730.0,188.0,127.0,6,1224,18070750.6,204.0,204.0
123341756.0,6,49,3234,24,1584,4928106.826086956,66.0,66.0,25,1650,5139229.708333333,66.0,66.0
0.0,17,1,90,1,90,0.0,90.0,90.0,0,0,0.0,0.0,0.0
90038356.0,17,24,11474,24,11474,3914711.130434783,501.0,478.0833333333333,0,0,0.0,0.0,0.0
18614.0,6,14,4740,7,653,2850.833333333333,249.0,93.28571428571428,7,4087,2964.6666666666665,1514.0,583.8571428571429
39173.0,6,10,2032,5,524,6614.25,252.0,104.8,5,1508,9216.25,1236.0,301.6
75489.0,6,14,4740,7,653,11818.0,249.0,93.28571428571428,7,4087,12048.333333333334,1514.0,583.8571428571429
284433.0,17,2,363,1,79,0.0,79.0,79.0,1,284,0.0,284.0,284.0
303971.0,6,6,412,4,272,101323.66666666669,74.0,68.0,2,140,0.0,74.0,70.0
135137257.0,17,6,1146,6,1146,27027451.4,191.0,191.0,0,0,0.0,0.0,0.0
228477.0,17,2,180,1,90,0.0,90.0,90.0,1,90,0.0,90.0,90.0
24793.0,6,14,4740,7,653,3915.3333333333335,249.0,93.28571428571428,7,4087,3905.0,1514.0,583.8571428571429
144060.0,17,2,180,1,90,0.0,90.0,90.0,1,90,0.0,90.0,90.0
237505.0,17,2,180,1,90,0.0,90.0,90.0,1,90,0.0,90.0,90.0
132348.0,6,3,337,2,214,0.0,160.0,107.0,1,123,0.0,123.0,123.0
146240.0,6,3,337,2,214,0.0,160.0,107.0,1,123,0.0,123.0,123.0
153447.0,17,2,180,1,90,0.0,90.0,90.0,1,90,0.0,90.0,90.0
146799.0,6,3,337,2,214,0.0,160.0,107.0,1,123,0.0,123.0,123.0
137088.0,6,2,132,1,66,0.0,66.0,66.0,1,66,0.0,66.0,66.0
833304.0,6,9,1118,6,586,166660.8,248.0,97.66666666666669,3,532,280032.0,392.0,177.33333333333334
153541.0,17,2,180,1,90,0.0,90.0,90.0,1,90,0.0,90.0,90.0
16888.0,17,2,180,1,90,0.0,90.0,90.0,1,90,0.0,90.0,90.0
218952.0,6,3,426,2,280,0.0,214.0,140.0,1,146,0.0,146.0,146.0
197043.0,17,2,180,1,90,0.0,90.0,90.0,1,90,0.0,90.0,90.0
1309962.0,6,4,264,2,132,0.0,66.0,66.0,2,132,0.0,66.0,66.0
347.0,17,2,267,1,83,0.0,83.0,83.0,1,184,0.0,184.0,184.0
56059.0,6,14,4740,7,653,9129.833333333334,249.0,93.28571428571428,7,4087,8724.333333333334,1514.0,583.8571428571429
11299377.0,6,8,544,4,272,3721107.6666666665,74.0,68.0,4,272,3721010.0,74.0,68.0
120121624.0,6,14,2224,9,1204,15015203.0,188.0,133.77777777777777,5,1020,22589939.75,204.0,204.0
18196.0,6,10,2032,5,524,4345.0,252.0,104.8,5,1508,4181.75,1236.0,301.6
135132593.0,17,6,1146,6,1146,27026518.6,191.0,191.0,0,0,0.0,0.0,0.0
36690.0,6,14,4740,7,653,5757.333333333333,249.0,93.28571428571428,7,4087,5975.833333333333,1514.0,583.8571428571429
56191.0,6,10,2032,5,524,13191.25,252.0,104.8,5,1508,12251.25,1236.0,301.6
1309069.0,6,4,264,2,132,0.0,66.0,66.0,2,132,0.0,66.0,66.0
6933.0,17,2,582,1,83,0.0,83.0,83.0,1,499,0.0,499.0,499.0
472900.0,6,3,1604,1,753,0.0,753.0,753.0,2,851,0.0,785.0,425.5
157685.0,6,3,337,2,214,0.0,160.0,107.0,1,123,0.0,123.0,123.0
228339.0,17,2,180,1,90,0.0,90.0,90.0,1,90,0.0,90.0,90.0
224051.0,6,3,426,2,280,0.0,214.0,140.0,1,146,0.0,146.0,146.0
47451.0,6,12,1413,7,882,7908.5,291.0,126.0,5,531,9432.5,259.0,106.2
10951002.0,6,8,544,4,272,3603432.6666666665,74.0,68.0,4,272,3603362.3333333335,74.0,68.0
213857.0,6,3,426,2,280,0.0,214.0,140.0,1,146,0.0,146.0,146.0
46702.0,6,10,2032,5,524,11261.0,252.0,104.8,5,1508,10919.25,1236.0,301.6
17755.0,6,10,2032,5,524,2975.0,252.0,104.8,5,1508,4241.25,1236.0,301.6
27413561.0,17,5,1710,5,1710,6853390.25,342.0,342.0,0,0,0.0,0.0,0.0
153534.0,17,2,180,1,90,0.0,90.0,90.0,1,90,0.0,90.0,90.0
90012994.0,17,27,12943,27,12943,3462038.230769231,501.0,479.3703703703704,0,0,0.0,0.0,0.0
100792644.0,6,28,1860,14,966,7736680.307692308,123.0,69.0,14,894,7736666.769230769,123.0,63.85714285714285
90252313.0,6,12,1832,8,1016,12893187.57142857,188.0,127.0,4,816,30028441.0,204.0,204.0
120054500.0,17,29,13785,29,13785,4287660.714285715,501.0,475.3448275862069,0,0,0.0,0.0,0.0
289527.0,17,4,1400,4,1400,96509.0,350.0,350.0,0,0,0.0,0.0,0.0
9007087.0,17,2,160,2,160,0.0,80.0,80.0,0,0,0.0,0.0,0.0
1105159.0,6,12,1362,6,731,219126.6,253.0,121.83333333333331,6,631,220101.2,293.0,105.16666666666669
2404.0,17,4,344,2,150,0.0,75.0,75.0,2,194,0.0,103.0,97.0
301694.0,6,6,412,4,272,100564.66666666669,74.0,68.0,2,140,0.0,74.0,70.0
142785.0,6,2,132,1,66,0.0,66.0,66.0,1,66,0.0,66.0,66.0
45582250.0,17,9,3086,8,2736,5107701.142857143,342.0,342.0,1,350,0.0,350.0,350.0
26252.0,6,11,2098,6,590,4986.8,252.0,98.33333333333331,5,1508,6334.0,1236.0,301.6
167531.0,17,2,414,1,88,0.0,88.0,88.0,1,326,0.0,326.0,326.0
375668.0,6,10,1221,6,636,75133.6,298.0,106.0,4,585,124056.33333333331,379.0,146.25
49326.0,6,12,1320,7,789,8221.0,253.0,112.71428571428572,5,531,8898.5,259.0,106.2
206623.0,6,3,426,2,280,0.0,214.0,140.0,1,146,0.0,146.0,146.0
281626.0,17,2,365,1,80,0.0,80.0,80.0,1,285,0.0,285.0,285.0
1518278.0,6,7,499,3,198,714823.0,66.0,66.0,4,301,439839.0,103.0,75.25
153703.0,17,2,180,1,90,0.0,90.0,90.0,1,90,0.0,90.0,90.0
119355396.0,6,37,2650,19,1302,6630829.611111111,123.0,68.52631578947368,18,1348,6433362.94117647,139.0,74.88888888888889
144893.0,17,2,180,1,70,0.0,70.0,70.0,1,110,0.0,110.0,110.0
31717.000000000004,6,14,4740,7,653,4789.666666666667,249.0,93.28571428571428,7,4087,5058.833333333333,1514.0,583.8571428571429
121400840.0,6,248,28438,124,8492,971874.5528455283,140.0,68.48387096774194,124,19946,980303.951219512,284.0,160.8548387096774
205989.0,17,2,180,1,90,0.0,90.0,90.0,1,90,0.0,90.0,90.0
34344.0,6,13,4519,6,512,6395.2,230.0,85.33333333333333,7,4007,5188.0,1514.0,572.4285714285714
108113560.0,17,5,955,5,955,27028390.0,191.0,191.0,0,0,0.0,0.0,0.0
153410.0,17,2,180,1,90,0.0,90.0,90.0,1,90,0.0,90.0,90.0
2108972.0,6,51,42370,21,1551,105448.6,211.0,73.85714285714286,30,40819,72602.86206896552,1514.0,1360.6333333333334
32486.0,6,14,4740,7,653,5163.833333333333,249.0,93.28571428571428,7,4087,5095.833333333333,1514.0,583.8571428571429
8786.0,17,2,507,1,86,0.0,86.0,86.0,1,421,0.0,421.0,421.0
50644.0,6,14,4740,7,653,7761.833333333333,249.0,93.28571428571428,7,4087,7484.166666666667,1514.0,583.8571428571429
10458452.0,6,7,478,4,272,3440884.0,74.0,68.0,3,206,5161197.5,74.0,68.66666666666667
39953.0,6,14,4740,7,653,6445.666666666667,249.0,93.28571428571428,7,4087,5771.666666666667,1514.0,583.8571428571429
70019992.0,6,19,1334,9,640,8752260.75,95.0,71.11111111111111,10,694,7779080.222222222,95.0,69.4
90254430.0,6,16,2368,9,1204,11281803.75,188.0,133.77777777777777,7,1164,15015248.666666666,204.0,166.28571428571428
114309954.0,6,48,3168,24,1584,4969998.0,66.0,66.0,24,1584,4958019.304347826,66.0,66.0
10577922.0,6,7,478,4,272,3478631.333333333,74.0,68.0,3,206,5217841.0,74.0,68.66666666666667
90006866.0,6,18,1341,10,745,10000762.888888888,95.0,74.5,8,596,12787925.714285716,95.0,74.5
2353871.0,6,25,7573,14,3735,181067.0,1514.0,266.7857142857143,11,3838,210618.2,1514.0,348.90909090909093
107352666.0,6,44,2904,22,1452,5112031.714285715,66.0,66.0,22,1452,5097048.333333333,66.0,66.0
82.0,17,2,762,2,762,0.0,381.0,381.0,0,0,0.0,0.0,0.0
120219.0,17,2,180,1,70,0.0,70.0,70.0,1,110,0.0,110.0,110.0
114693897.0,6,48,3168,24,1584,4986691.173913044,66.0,66.0,24,1584,4973472.217391305,66.0,66.0
451.0,17,2,267,1,83,0.0,83.0,83.0,1,184,0.0,184.0,184.0
302020.0,6,6,412,4,272,100673.33333333331,74.0,68.0,2,140,0.0,74.0,70.0
2366.0,17,4,344,2,150,0.0,75.0,75.0,2,194,0.0,103.0,97.0
206202.0,6,3,426,2,280,0.0,214.0,140.0,1,146,0.0,146.0,146.0
6986.0,17,4,344,2,150,0.0,75.0,75.0,2,194,0.0,103.0,97.0
216629.0,6,3,426,2,280,0.0,214.0,140.0,1,146,0.0,146.0,146.0
0.0,17,1,161,1,161,0.0,161.0,161.0,0,0,0.0,0.0,0.0
305615.0,6,6,412,4,272,101871.66666666669,74.0,68.0,2,140,0.0,74.0,70.0
217939.0,6,3,426,2,280,0.0,214.0,140.0,1,146,0.0,146.0,146.0
1066908.0,17,6,1230,3,234,533266.5,78.0,78.0,3,996,533249.5,332.0,332.0
90294832.0,6,16,1192,8,596,12893284.285714284,95.0,74.5,8,596,12898969.57142857,95.0,74.5
2595830.0,6,2,132,1,66,0.0,66.0,66.0,1,66,0.0,66.0,66.0
2356.0,17,4,344,2,150,0.0,75.0,75.0,2,194,0.0,103.0,97.0
90036271.0,17,28,13364,28,13364,3334676.703703704,501.0,477.2857142857143,0,0,0.0,0.0,0.0
216368.0,17,2,180,1,90,0.0,90.0,90.0,1,90,0.0,90.0,90.0
103373181.0,6,30,1990,15,1042,7368390.857142857,139.0,69.46666666666667,15,948,7368390.928571428,123.0,63.2
120001518.0,6,26,2672,13,1222,10000126.5,212.0,94.0,13,1450,9978017.833333334,425.0,111.53846153846152
107966934.0,6,30,2106,15,1089,7696517.928571428,123.0,72.6,15,1017,7696516.0,123.0,67.8
268887.0,6,10,1221,6,636,53777.4,298.0,106.0,4,585,84270.33333333333,379.0,146.25
21751.0,6,14,4740,7,653,3470.1666666666665,249.0,93.28571428571428,7,4087,3395.333333333333,1514.0,583.8571428571429
42595.0,6,14,4740,7,653,6838.333333333333,249.0,93.28571428571428,7,4087,6520.5,1514.0,583.8571428571429
4444.0,17,2,598,1,72,0.0,72.0,72.0,1,526,0.0,526.0,526.0
82922.0,6,11,2098,6,590,16314.0,252.0,98.33333333333331,5,1508,5765.0,1236.0,301.6
127009557.0,17,15,907,8,475,18144222.42857143,174.0,59.375,7,432,17833562.0,174.0,61.71428571428572
147999.0,17,2,180,1,90,0.0,90.0,90.0,1,90,0.0,90.0,90.0
109424978.0,6,30,2106,15,1089,7816069.857142857,123.0,72.6,15,1017,7800609.642857143,123.0,67.8
111000962.0,17,13,821,7,432,18500160.33333333,174.0,61.71428571428572,6,389,18201558.4,174.0,64.83333333333333
90040157.0,17,28,13364,28,13364,3334820.6296296297,501.0,477.2857142857143,0,0,0.0,0.0,0.0
120214.0,17,2,180,1,70,0.0,70.0,70.0,1,110,0.0,110.0,110.0
323995.0,6,12,1373,7,714,53999.16666666666,298.0,102.0,5,659,75742.25,379.0,131.8
1025027.0,6,11,1134,6,558,205005.4,220.0,93.0,5,576,255252.5,304.0,115.2
108108453.0,17,5,1005,5,1005,27027113.25,201.0,201.0,0,0,0.0,0.0,0.0
206288.0,6,3,426,2,280,0.0,214.0,140.0,1,146,0.0,146.0,146.0
35119.0,6,14,4740,7,653,5294.0,249.0,93.28571428571428,7,4087,5556.666666666667,1514.0,583.8571428571429
28870.0,6,14,4740,7,653,4218.833333333333,249.0,93.28571428571428,7,4087,4082.8333333333335,1514.0,583.8571428571429
205936.0,6,3,426,2,280,0.0,214.0,140.0,1,146,0.0,146.0,146.0
103454.0,17,2,286,2,286,0.0,143.0,143.0,0,0,0.0,0.0,0.0
327766.0,6,6,412,4,272,109255.33333333331,74.0,68.0,2,140,0.0,74.0,70.0
10907410.0,6,7,478,3,206,5382992.0,74.0,68.66666666666667,4,272,3588594.333333333,74.0,68.0
6666.0,17,2,582,1,83,0.0,83.0,83.0,1,499,0.0,499.0,499.0
287952.0,17,4,571,2,148,0.0,74.0,74.0,2,423,0.0,280.0,211.5
272015.0,6,10,1221,6,636,54403.0,298.0,106.0,4,585,89532.0,379.0,146.25
99188083.0,6,208,23694,104,16608,960902.6213592232,284.0,159.69230769230768,104,7086,960902.854368932,140.0,68.13461538461539
1180891.0,6,13,3009,8,2381,168698.7142857143,1514.0,297.625,5,628,226190.25,331.0,125.6
712027.0,6,5,336,2,134,0.0,68.0,67.0,3,202,298120.5,70.0,67.33333333333333
90061605.0,17,28,13364,28,13364,3335615.0,501.0,477.2857142857143,0,0,0.0,0.0,0.0
300347.0,6,6,412,4,272,100115.66666666669,74.0,68.0,2,140,0.0,74.0,70.0
216836.0,6,3,426,2,280,0.0,214.0,140.0,1,146,0.0,146.0,146.0
13123029.0,6,20,1607,10,975,1424284.3333333333,315.0,97.5,10,632,1424232.5555555555,78.0,63.2
1400051.0,17,16,1120,16,1120,93336.73333333334,70.0,70.0,0,0,0.0,0.0,0.0
120006059.0,17,28,13364,28,13364,4444668.851851852,501.0,477.2857142857143,0,0,0.0,0.0,0.0
111936060.0,6,30,1974,15,1026,7980018.714285715,123.0,68.4,15,948,7980016.357142857,123.0,63.2
298354.0,6,6,412,4,272,99451.33333333331,74.0,68.0,2,140,0.0,74.0,70.0
90040491.0,17,27,12943,27,12943,3463095.8076923075,501.0,479.3703703703704,0,0,0.0,0.0,0.0
27380.0,6,10,2032,5,524,6468.0,252.0,104.8,5,1508,6268.5,1236.0,301.6
279874.0,6,10,1221,6,636,55974.8,298.0,106.0,4,585,87607.66666666667,379.0,146.25
412.0,17,2,174,1,79,0.0,79.0,79.0,1,95,0.0,95.0,95.0
9393.0,17,2,571,1,86,0.0,86.0,86.0,1,485,0.0,485.0,485.0
3020.0,17,2,224,1,76,0.0,76.0,76.0,1,148,0.0,148.0,148.0
6466.0,17,2,447,1,84,0.0,84.0,84.0,1,363,0.0,363.0,363.0
2470466.0,6,3,1604,1,753,0.0,753.0,753.0,2,851,0.0,785.0,425.5
90228684.0,6,16,1192,8,596,12853581.57142857,95.0,74.5,8,596,12858938.42857143,95.0,74.5
205308.0,17,2,180,1,90,0.0,90.0,90.0,1,90,0.0,90.0,90.0
202539.0,17,4,6056,4,6056,67513.0,1514.0,1514.0,0,0,0.0,0.0,0.0
120739896.0,6,27,2114,15,1179,8571391.785714285,95.0,78.6,12,935,10889347.0,95.0,77.91666666666667
9150.0,17,2,571,1,86,0.0,86.0,86.0,1,485,0.0,485.0,485.0
109188097.0,6,28,1860,14,966,8382477.461538462,123.0,69.0,14,894,8382492.384615385,123.0,63.85714285714285
145051.0,17,2,180,1,70,0.0,70.0,70.0,1,110,0.0,110.0,110.0
121365.0,6,3,337,2,214,0.0,160.0,107.0,1,123,0.0,123.0,123.0
317929.0,17,4,1400,4,1400,105976.33333333331,350.0,350.0,0,0,0.0,0.0,0.0
217993.0,6,3,426,2,280,0.0,214.0,140.0,1,146,0.0,146.0,146.0
153416.0,17,2,180,1,90,0.0,90.0,90.0,1,90,0.0,90.0,90.0
92870612.0,6,163,18506,82,13012,1146550.7654320989,284.0,158.6829268292683,81,5494,1147820.075,140.0,67.82716049382717
2919.0,17,2,762,2,762,0.0,381.0,381.0,0,0,0.0,0.0,0.0
116085116.0,6,48,3168,24,1584,5047178.956521739,66.0,66.0,24,1584,5033795.391304348,66.0,66.0
39374.0,6,14,4740,7,653,5240.333333333333,249.0,93.28571428571428,7,4087,6205.0,1514.0,583.8571428571429
103280.0,17,2,286,2,286,0.0,143.0,143.0,0,0,0.0,0.0,0.0
509968.0,6,10,1221,6,636,101993.6,298.0,106.0,4,585,164597.66666666666,379.0,146.25
106801.0,17,2,286,2,286,0.0,143.0,143.0,0,0,0.0,0.0,0.0
102980850.0,6,42,2772,21,1386,5135435.85,66.0,66.0,21,1386,5135428.9,66.0,66.0
24607.0,6,14,4740,7,653,3978.6666666666665,249.0,93.28571428571428,7,4087,3965.3333333333335,1514.0,583.8571428571429
79266.0,6,12,1362,6,731,13963.4,253.0,121.83333333333331,6,631,14745.6,293.0,105.16666666666669
19471.0,6,14,4740,7,653,3085.833333333333,249.0,93.28571428571428,7,4087,3109.1666666666665,1514.0,583.8571428571429
135135772.0,17,6,1146,6,1146,27027154.4,191.0,191.0,0,0,0.0,0.0,0.0
120055441.0,17,29,13785,29,13785,4287694.321428572,501.0,475.3448275862069,0,0,0.0,0.0,0.0
0.0,17,1,44,1,44,0.0,44.0,44.0,0,0,0.0,0.0,0.0
5629317.0,6,5,336,2,134,0.0,68.0,67.0,3,202,1530141.0,70.0,67.33333333333333
297781.0,6,6,412,4,272,99260.33333333331,74.0,68.0,2,140,0.0,74.0,70.0
135128061.0,17,6,1146,6,1146,27025612.2,191.0,191.0,0,0,0.0,0.0,0.0
75916.0,6,10,2032,5,524,17946.5,252.0,104.8,5,1508,6485.75,1236.0,301.6
218392.0,6,3,426,2,280,0.0,214.0,140.0,1,146,0.0,146.0,146.0
298907.0,6,6,412,4,272,99635.66666666669,74.0,68.0,2,140,0.0,74.0,70.0
196778.0,17,2,180,1,90,0.0,90.0,90.0,1,90,0.0,90.0,90.0
17083.0,6,10,2032,5,524,4000.25,252.0,104.8,5,1508,3876.75,1236.0,301.6
90335202.0,6,12,1848,7,828,15055867.0,188.0,118.28571428571428,5,1020,15082665.75,204.0,204.0
108295891.0,6,224,25328,112,17640,973688.5495495496,284.0,157.5,112,7688,973683.3333333334,140.0,68.64285714285714
5823659.0,6,5,336,2,134,0.0,68.0,67.0,3,202,1525367.5,70.0,67.33333333333333
108106313.0,17,5,955,5,955,27026578.25,191.0,191.0,0,0,0.0,0.0,0.0
212520.0,6,3,426,2,280,0.0,214.0,140.0,1,146,0.0,146.0,146.0
99887727.0,6,353,43090,177,11904,567543.9034090909,140.0,67.2542372881356,176,31186,564846.8971428572,300.0,177.1931818181818
196916.0,17,2,180,1,90,0.0,90.0,90.0,1,90,0.0,90.0,90.0
121131951.0,6,23,1775,11,840,12113195.1,95.0,76.36363636363636,12,935,8262829.909090909,95.0,77.91666666666667
307223.0,6,6,412,4,272,102407.66666666669,74.0,68.0,2,140,0.0,74.0,70.0
119997.0,17,2,180,1,70,0.0,70.0,70.0,1,110,0.0,110.0,110.0
90756365.0,6,17,1287,9,691,11339092.875,95.0,76.77777777777777,8,596,12964081.285714284,95.0,74.5
213439.0,6,12,1373,7,714,35573.166666666664,298.0,102.0,5,659,52600.0,379.0,131.8
35794.0,6,14,4740,7,653,5372.5,249.0,93.28571428571428,7,4087,5691.0,1514.0,583.8571428571429
29845.0,6,14,4740,7,653,4816.5,249.0,93.28571428571428,7,4087,3847.0,1514.0,583.8571428571429
149119.0,6,3,373,2,238,0.0,172.0,119.0,1,135,0.0,135.0,135.0
247198.0,17,2,180,1,90,0.0,90.0,90.0,1,90,0.0,90.0,90.0
10828526.0,6,7,478,3,206,5346071.5,74.0,68.66666666666667,4,272,3563966.0,74.0,68.0
246621.0,6,3,337,2,214,0.0,160.0,107.0,1,123,0.0,123.0,123.0
120061837.0,17,29,13785,29,13785,4287922.75,501.0,475.3448275862069,0,0,0.0,0.0,0.0
85.0,17,2,762,2,762,0.0,381.0,381.0,0,0,0.0,0.0,0.0
108110391.0,17,5,1005,5,1005,27027597.75,201.0,201.0,0,0,0.0,0.0,0.0
101223996.0,17,14,864,7,432,16833487.166666668,174.0,61.71428571428572,7,432,16835678.333333332,174.0,61.71428571428572
12889.0,17,2,507,1,86,0.0,86.0,86.0,1,421,0.0,421.0,421.0
301226.0,6,6,412,4,272,100408.66666666669,74.0,68.0,2,140,0.0,74.0,70.0
328.0,17,2,166,1,75,0.0,75.0,75.0,1,91,0.0,91.0,91.0
120019546.0,6,17,1287,9,691,15002443.25,95.0,76.77777777777777,8,596,12861489.285714284,95.0,74.5
132952.0,6,15,4806,8,719,18860.714285714286,249.0,89.875,7,4087,21567.33333333333,1514.0,583.8571428571429
40059.0,6,14,4740,7,653,6552.666666666667,249.0,93.28571428571428,7,4087,6275.833333333333,1514.0,583.8571428571429
10760276.0,6,5,1736,3,917,5305655.0,785.0,305.6666666666667,2,819,0.0,753.0,409.5
306781.0,6,3,202,2,128,0.0,74.0,64.0,1,74,0.0,74.0,74.0
116143247.0,17,16,1474,8,737,16569069.42857143,174.0,92.125,8,737,16569062.42857143,174.0,92.125
746.0,17,4,438,2,148,0.0,74.0,74.0,2,290,0.0,147.0,145.0
45552.0,6,14,4740,7,653,7441.666666666667,249.0,93.28571428571428,7,4087,6415.166666666667,1514.0,583.8571428571429
318359.0,17,4,1400,4,1400,106119.66666666669,350.0,350.0,0,0,0.0,0.0,0.0
247289.0,6,3,337,2,214,0.0,160.0,107.0,1,123,0.0,123.0,123.0
135134582.0,17,6,1206,6,1206,27026916.4,201.0,201.0,0,0,0.0,0.0,0.0
25216.0,6,14,4740,7,653,4081.0,249.0,93.28571428571428,7,4087,4067.3333333333335,1514.0,583.8571428571429
90086350.0,6,10,1440,7,828,15014391.666666666,188.0,118.28571428571428,3,612,30030110.0,204.0,204.0
2981161.0,6,3,1604,1,753,0.0,753.0,753.0,2,851,0.0,785.0,425.5
153495.0,17,2,180,1,90,0.0,90.0,90.0,1,90,0.0,90.0,90.0
540591.0,6,10,1221,6,636,108118.2,298.0,106.0,4,585,179315.33333333334,379.0,146.25
55822.0,6,14,4740,7,653,9139.5,249.0,93.28571428571428,7,4087,8025.333333333333,1514.0,583.8571428571429
234972.0,17,2,180,1,90,0.0,90.0,90.0,1,90,0.0,90.0,90.0
112523681.0,6,200,22536,100,15714,1134429.8484848484,284.0,157.14,100,6822,1134429.7777777778,140.0,68.22
120124631.0,6,15,2152,9,1204,15015578.875,188.0,133.77777777777777,6,948,18011583.2,204.0,158.0
285330.0,17,2,180,1,90,0.0,90.0,90.0,1,90,0.0,90.0,90.0
64796.00000000001,6,10,2032,5,524,14222.25,252.0,104.8,5,1508,14872.25,1236.0,301.6
61127.0,6,14,4740,7,653,10003.5,249.0,93.28571428571428,7,4087,8496.166666666666,1514.0,583.8571428571429
307121.0,6,6,412,4,272,102373.66666666669,74.0,68.0,2,140,0.0,74.0,70.0
58423.0,6,14,4740,7,653,9606.0,249.0,93.28571428571428,7,4087,9425.166666666666,1514.0,583.8571428571429
13607233.0,6,20,1607,10,975,1478714.111111111,315.0,97.5,10,632,1478690.0,78.0,63.2
0.0,17,1,453,1,453,0.0,453.0,453.0,0,0,0.0,0.0,0.0
1029369.0,6,11,1134,6,558,205873.8,220.0,93.0,5,576,255085.0,304.0,115.2
196934.0,17,2,180,1,90,0.0,90.0,90.0,1,90,0.0,90.0,90.0
9722.0,17,2,539,1,86,0.0,86.0,86.0,1,453,0.0,453.0,453.0
198733.0,17,2,180,1,90,0.0,90.0,90.0,1,90,0.0,90.0,90.0
47108.0,6,14,4740,7,653,7722.166666666667,249.0,93.28571428571428,7,4087,7490.666666666667,1514.0,583.8571428571429
0.0,17,1,55,1,55,0.0,55.0,55.0,0,0,0.0,0.0,0.0
153501.0,17,2,180,1,90,0.0,90.0,90.0,1,90,0.0,90.0,90.0
45708.0,6,14,4740,7,653,6329.0,249.0,93.28571428571428,7,4087,7461.333333333333,1514.0,583.8571428571429
17438796.0,6,21,7017,11,1575,1743879.6,408.0,143.1818181818182,10,5442,1502316.6666666667,1514.0,544.2
27886.0,6,14,4740,7,653,4435.5,249.0,93.28571428571428,7,4087,3326.833333333333,1514.0,583.8571428571429
108109839.0,17,5,1005,5,1005,27027459.75,201.0,201.0,0,0,0.0,0.0,0.0
36518.0,6,14,4740,7,653,5920.5,249.0,93.28571428571428,7,4087,5845.166666666667,1514.0,583.8571428571429
123840009.0,6,49,3234,25,1650,5160000.375,66.0,66.0,24,1584,5089022.913043479,66.0,66.0
1870585.0,6,4,276,2,128,0.0,74.0,64.0,2,148,0.0,74.0,74.0
90258323.0,6,13,2036,8,1016,12894046.142857144,188.0,127.0,5,1020,22523100.25,204.0,204.0
108124297.0,17,5,1005,5,1005,27031074.25,201.0,201.0,0,0,0.0,0.0,0.0
231920.0,6,3,337,2,214,0.0,160.0,107.0,1,123,0.0,123.0,123.0
90681776.0,6,21,1585,10,745,10075752.888888888,95.0,74.5,11,840,9043291.3,95.0,76.36363636363636
3672.0,17,4,344,2,150,0.0,75.0,75.0,2,194,0.0,103.0,97.0
119411796.0,6,221,25162,111,7548,1085561.7818181815,140.0,68.0,110,17614,1077517.724770642,374.0,160.12727272727273
242056.0,6,3,337,2,214,0.0,160.0,107.0,1,123,0.0,123.0,123.0
10516143.0,6,7,478,4,272,3459941.333333333,74.0,68.0,3,206,5189810.0,74.0,68.66666666666667
2291.0,17,4,344,2,150,0.0,75.0,75.0,2,194,0.0,103.0,97.0
238069.0,6,3,337,2,214,0.0,160.0,107.0,1,123,0.0,123.0,123.0
110540873.0,6,30,1974,15,1026,7880365.642857143,123.0,68.4,15,948,7880368.357142857,123.0,63.2
135136363.0,17,6,1146,6,1146,27027272.6,191.0,191.0,0,0,0.0,0.0,0.0
26102.0,6,14,4740,7,653,3512.833333333333,249.0,93.28571428571428,7,4087,4183.0,1514.0,583.8571428571429
90013703.0,17,28,13364,28,13364,3333840.851851852,501.0,477.2857142857143,0,0,0.0,0.0,0.0
314376.0,17,4,1400,4,1400,104792.0,350.0,350.0,0,0,0.0,0.0,0.0
4711.0,17,2,626,1,72,0.0,72.0,72.0,1,554,0.0,554.0,554.0
1992.0,17,4,344,2,150,0.0,75.0,75.0,2,194,0.0,103.0,97.0
112137059.0,6,227,25600,114,7820,992363.3539823008,140.0,68.59649122807018,113,17780,991944.6875,284.0,157.34513274336285
13027.0,6,10,1975,5,467,2999.25,195.0,93.4,5,1508,1528.75,1236.0,301.6
2353.0,17,4,344,2,150,0.0,75.0,75.0,2,194,0.0,103.0,97.0
108110035.0,17,5,1005,5,1005,27027508.75,201.0,201.0,0,0,0.0,0.0,0.0
37152.0,6,14,4740,7,653,5364.333333333333,249.0,93.28571428571428,7,4087,5710.5,1514.0,583.8571428571429
1323767.0,6,4,264,2,132,0.0,66.0,66.0,2,132,0.0,66.0,66.0
161071.0,6,2,128,1,74,0.0,74.0,74.0,1,54,0.0,54.0,54.0
245132.0,6,3,337,2,214,0.0,160.0,107.0,1,123,0.0,123.0,123.0
326511.0,17,4,1400,4,1400,108837.0,350.0,350.0,0,0,0.0,0.0,0.0
307223.0,6,6,412,4,272,102407.66666666669,74.0,68.0,2,140,0.0,74.0,70.0
90038947.0,17,28,13364,28,13364,3334775.814814815,501.0,477.2857142857143,0,0,0.0,0.0,0.0
41887.0,6,10,1949,5,441,8595.25,169.0,88.2,5,1508,9748.0,1236.0,301.6
99966.0,17,2,762,2,762,0.0,381.0,381.0,0,0,0.0,0.0,0.0
261031.0,6,12,1373,7,714,43505.16666666666,298.0,102.0,5,659,60938.0,379.0,131.8
100344940.0,17,12,516,6,258,20001022.4,43.0,43.0,6,258,20000158.6,43.0,43.0
90050530.0,17,28,13364,28,13364,3335204.814814815,501.0,477.2857142857143,0,0,0.0,0.0,0.0
10276.0,6,10,1975,5,467,2245.75,195.0,93.4,5,1508,2241.25,1236.0,301.6
1488.0,17,2,762,2,762,0.0,381.0,381.0,0,0,0.0,0.0,0.0
2367.0,17,4,344,2,150,0.0,75.0,75.0,2,194,0.0,103.0,97.0
1282.0,17,4,438,2,148,0.0,74.0,74.0,2,290,0.0,147.0,145.0
90031242.0,17,27,12943,27,12943,3462740.076923077,501.0,479.3703703703704,0,0,0.0,0.0,0.0
112197910.0,6,213,24040,107,7284,1058470.849056604,140.0,68.07476635514018,106,16756,1058627.6095238095,374.0,158.0754716981132
120437751.0,6,221,24928,111,17446,1094888.6454545455,284.0,157.17117117117118,110,7482,1095350.5596330275,140.0,68.01818181818182
302159.0,6,6,412,4,272,100719.66666666669,74.0,68.0,2,140,0.0,74.0,70.0
21949.0,6,10,2032,5,524,5134.25,252.0,104.8,5,1508,4529.75,1236.0,301.6
1148772.0,6,11,1134,6,558,229754.4,220.0,93.0,5,576,284957.75,304.0,115.2
197578.0,17,2,180,1,90,0.0,90.0,90.0,1,90,0.0,90.0,90.0
94023398.0,6,176,19872,88,13842,1078240.3103448276,284.0,157.29545454545453,88,6030,1078240.8045977012,140.0,68.52272727272727
36561472.0,6,5,336,2,134,0.0,68.0,67.0,3,202,18215312.5,70.0,67.33333333333333
4829.0,17,2,180,1,90,0.0,90.0,90.0,1,90,0.0,90.0,90.0
144164.0,17,2,180,1,90,0.0,90.0,90.0,1,90,0.0,90.0,90.0
226456.0,6,14,4740,7,653,22540.83333333333,249.0,93.28571428571428,7,4087,30753.666666666668,1514.0,583.8571428571429
120205343.0,6,234,26438,117,8018,1029260.0086206896,140.0,68.52991452991454,117,18420,1029214.2413793104,284.0,157.43589743589743
108026.0,17,2,286,2,286,0.0,143.0,143.0,0,0,0.0,0.0,0.0
5819924.0,6,5,336,2,134,0.0,68.0,67.0,3,202,1527130.0,70.0,67.33333333333333
263207.0,6,3,337,2,214,0.0,160.0,107.0,1,123,0.0,123.0,123.0
2349.0,17,4,344,2,150,0.0,75.0,75.0,2,194,0.0,103.0,97.0
120132790.0,6,13,2036,5,1020,30033197.5,204.0,204.0,8,1016,17136829.714285713,188.0,127.0
2853992.0,6,3,1604,2,851,0.0,785.0,425.5,1,753,0.0,753.0,753.0
41342.0,6,14,4740,7,653,6771.166666666667,249.0,93.28571428571428,7,4087,5978.5,1514.0,583.8571428571429
155791.0,6,3,337,2,214,0.0,160.0,107.0,1,123,0.0,123.0,123.0
232268.0,6,3,337,2,214,0.0,160.0,107.0,1,123,0.0,123.0,123.0
203420.0,17,2,762,2,762,0.0,381.0,381.0,0,0,0.0,0.0,0.0
639.0,17,2,762,2,762,0.0,381.0,381.0,0,0,0.0,0.0,0.0
121425.0,6,3,337,2,214,0.0,160.0,107.0,1,123,0.0,123.0,123.0
105234844.0,17,15,5130,15,5130,7516774.571428572,342.0,342.0,0,0,0.0,0.0,0.0
174531.0,6,22,9370,12,954,15866.454545454546,220.0,79.5,10,8416,18168.666666666668,1514.0,841.6
8991.0,17,4,823,2,163,0.0,89.0,81.5,2,660,0.0,443.0,330.0
28940.0,6,14,4740,7,653,4171.166666666667,249.0,93.28571428571428,7,4087,4688.166666666667,1514.0,583.8571428571429
143928.0,17,2,180,1,90,0.0,90.0,90.0,1,90,0.0,90.0,90.0
52097.0,6,10,2032,5,524,12778.25,252.0,104.8,5,1508,12154.75,1236.0,301.6
45593.0,6,12,1320,6,723,8743.6,253.0,120.5,6,597,7617.2,259.0,99.5
217038.0,6,3,426,2,280,0.0,214.0,140.0,1,146,0.0,146.0,146.0
50624.0,6,10,2032,5,524,12038.0,252.0,104.8,5,1508,12145.0,1236.0,301.6
9937.0,17,2,571,1,86,0.0,86.0,86.0,1,485,0.0,485.0,485.0
104794416.0,17,15,5130,15,5130,7485315.428571428,342.0,342.0,0,0,0.0,0.0,0.0
153525.0,17,2,180,1,90,0.0,90.0,90.0,1,90,0.0,90.0,90.0
246116.0,6,3,337,2,214,0.0,160.0,107.0,1,123,0.0,123.0,123.0
1166300.0,6,13,3000,8,2372,166614.2857142857,1514.0,296.5,5,628,222643.25,331.0,125.6
148081.0,17,2,180,1,90,0.0,90.0,90.0,1,90,0.0,90.0,90.0
204509.0,17,2,762,2,762,0.0,381.0,381.0,0,0,0.0,0.0,0.0
314263.0,6,6,412,4,272,104754.33333333331,74.0,68.0,2,140,0.0,74.0,70.0
312206.0,6,6,412,4,272,104068.66666666669,74.0,68.0,2,140,0.0,74.0,70.0
43077.0,6,14,4740,7,653,7022.0,249.0,93.28571428571428,7,4087,4866.666666666667,1514.0,583.8571428571429
2303.0,17,4,344,2,150,0.0,75.0,75.0,2,194,0.0,103.0,97.0
316203.0,17,4,1400,4,1400,105401.0,350.0,350.0,0,0,0.0,0.0,0.0
146106.0,6,3,337,2,214,0.0,160.0,107.0,1,123,0.0,123.0,123.0
64729.99999999999,6,14,4740,7,653,10552.833333333334,249.0,93.28571428571428,7,4087,9195.666666666666,1514.0,583.8571428571429
219711.0,6,3,426,2,280,0.0,214.0,140.0,1,146,0.0,146.0,146.0
259147.00000000003,6,10,1221,6,636,51829.4,298.0,106.0,4,585,80774.0,379.0,146.25
106906.0,17,2,700,2,700,0.0,350.0,350.0,0,0,0.0,0.0,0.0
247028.0,17,2,180,1,90,0.0,90.0,90.0,1,90,0.0,90.0,90.0
90308952.0,6,16,1192,8,596,12894174.714285716,95.0,74.5,8,596,12900603.857142856,95.0,74.5
101006744.0,17,13,1083,7,563,16834457.333333332,174.0,80.42857142857143,6,520,16200222.6,174.0,86.66666666666667
120338782.0,6,582,101858,294,82332,410712.566552901,1514.0,280.0408163265306,288,19526,415675.031358885,214.0,67.79861111111111
2406.0,17,4,344,2,150,0.0,75.0,75.0,2,194,0.0,103.0,97.0
147224.0,6,3,373,2,238,0.0,172.0,119.0,1,135,0.0,135.0,135.0
810.0,17,4,438,2,148,0.0,74.0,74.0,2,290,0.0,147.0,145.0
108106898.0,17,5,1005,5,1005,27026724.5,201.0,201.0,0,0,0.0,0.0,0.0
39671721.0,6,5,336,2,134,0.0,68.0,67.0,3,202,19764718.5,70.0,67.33333333333333
25875.0,6,10,1066,5,490,5753.5,218.0,98.0,5,576,6158.75,304.0,115.2
830289.0,6,9,1118,6,586,166057.8,248.0,97.66666666666669,3,532,278856.0,392.0,177.33333333333334
96096538.0,6,64,15353,33,6156,3003016.8125,1514.0,186.54545454545453,31,9197,3194743.9,1514.0,296.6774193548387
61140637.0,6,21,1524,11,789,6114063.7,95.0,71.72727272727273,10,735,6770038.333333333,95.0,73.5
143942.0,17,2,180,1,90,0.0,90.0,90.0,1,90,0.0,90.0,90.0
839883.0,6,9,1118,6,586,167976.6,248.0,97.66666666666669,3,532,282043.5,392.0,177.33333333333334
207025.0,17,4,6056,4,6056,69008.33333333333,1514.0,1514.0,0,0,0.0,0.0,0.0
90257178.0,6,13,2036,8,1016,12893882.57142857,188.0,127.0,5,1020,22523141.5,204.0,204.0
23016.0,6,14,4740,7,653,3470.833333333333,249.0,93.28571428571428,7,4087,3634.0,1514.0,583.8571428571429
45414670.0,17,9,3086,8,2736,5599493.285714285,342.0,342.0,1,350,0.0,350.0,350.0
106645437.0,17,14,864,7,432,17666824.333333332,174.0,61.71428571428572,7,432,17668470.666666668,174.0,61.71428571428572
90291252.0,6,13,2036,8,1016,12898750.285714284,188.0,127.0,5,1020,22530859.0,204.0,204.0
296826.0,17,2,616,1,75,0.0,75.0,75.0,1,541,0.0,541.0,541.0
28713.0,6,10,2032,5,524,6958.5,252.0,104.8,5,1508,6606.0,1236.0,301.6
316412.0,17,4,1400,4,1400,105470.66666666669,350.0,350.0,0,0,0.0,0.0,0.0
17426680.0,6,25,7635,14,2115,1340513.8461538462,408.0,151.07142857142858,11,5520,1232115.6,1514.0,501.8181818181818
326.0,17,2,166,1,75,0.0,75.0,75.0,1,91,0.0,91.0,91.0
325140.0,6,6,412,4,272,108380.0,74.0,68.0,2,140,0.0,74.0,70.0
0.0,17,1,72,1,72,0.0,72.0,72.0,0,0,0.0,0.0,0.0
90257251.0,6,12,1832,8,1016,12893893.0,188.0,127.0,4,816,30031579.0,204.0,204.0
110964769.0,6,31,2166,16,1149,7383267.2,123.0,71.8125,15,1017,7910646.642857143,123.0,67.8
119861928.0,6,20,1490,11,840,11978470.3,95.0,76.36363636363636,9,650,14981637.375,95.0,72.22222222222223
321.0,17,2,174,1,79,0.0,79.0,79.0,1,95,0.0,95.0,95.0
2057.0,17,4,344,2,150,0.0,75.0,75.0,2,194,0.0,103.0,97.0
90299854.0,6,16,1192,8,596,12892960.857142856,95.0,74.5,8,596,12898842.285714284,95.0,74.5
15606.0,6,10,2032,5,524,2736.0,252.0,104.8,5,1508,3544.75,1236.0,301.6
301832.0,6,6,412,4,272,100610.66666666669,74.0,68.0,2,140,0.0,74.0,70.0
206008.0,17,2,180,1,90,0.0,90.0,90.0,1,90,0.0,90.0,90.0
90255463.0,6,13,2036,8,1016,12893637.57142857,188.0,127.0,5,1020,22522518.0,204.0,204.0
99011489.0,6,166,18746,83,5774,1207333.146341463,140.0,69.56626506024097,83,12972,1207304.6707317072,284.0,156.289156626506
153333.0,17,2,180,1,90,0.0,90.0,90.0,1,90,0.0,90.0,90.0
3297426.0,6,204,162848,113,152539,29441.30357142857,1510.0,1349.9026548672566,91,10309,33154.7,1510.0,113.28571428571428
121464.0,6,3,337,2,214,0.0,160.0,107.0,1,123,0.0,123.0,123.0
273116.0,6,10,1221,6,636,54623.2,298.0,106.0,4,585,87540.33333333333,379.0,146.25
310963.0,17,4,1400,4,1400,103654.33333333331,350.0,350.0,0,0,0.0,0.0,0.0
10476898.0,6,7,478,4,272,3445231.6666666665,74.0,68.0,3,206,5167724.0,74.0,68.66666666666667
209447.0,17,2,180,1,90,0.0,90.0,90.0,1,90,0.0,90.0,90.0
90042658.0,17,28,13364,28,13364,3334913.25925926,501.0,477.2857142857143,0,0,0.0,0.0,0.0
108125429.0,17,5,1005,5,1005,27031357.25,201.0,201.0,0,0,0.0,0.0,0.0
209269.0,6,3,426,2,280,0.0,214.0,140.0,1,146,0.0,146.0,146.0
20452.0,6,14,4740,7,653,2612.1666666666665,249.0,93.28571428571428,7,4087,2830.5,1514.0,583.8571428571429
845.0,17,4,438,2,148,0.0,74.0,74.0,2,290,0.0,147.0,145.0
173388.0,6,14,4740,7,653,22478.5,249.0,93.28571428571428,7,4087,27109.0,1514.0,583.8571428571429
2729576.0,6,3,1604,1,753,0.0,753.0,753.0,2,851,0.0,785.0,425.5
122126.0,6,3,337,2,214,0.0,160.0,107.0,1,123,0.0,123.0,123.0
15293.0,6,11,2098,6,590,2488.6,252.0,98.33333333333331,5,1508,3563.0,1236.0,301.6
228251.0,17,2,180,1,90,0.0,90.0,90.0,1,90,0.0,90.0,90.0
0.0,17,1,55,1,55,0.0,55.0,55.0,0,0,0.0,0.0,0.0
4487.0,17,2,614,1,72,0.0,72.0,72.0,1,542,0.0,542.0,542.0
1136064.0,6,20,6434,12,1921,103278.54545454546,620.0,160.08333333333334,8,4513,133645.42857142858,1514.0,564.125
145287.0,17,2,180,1,70,0.0,70.0,70.0,1,110,0.0,110.0,110.0
130008966.0,17,15,907,8,475,18572709.42857143,174.0,59.375,7,432,18333540.83333333,174.0,61.71428571428572
99579.0,17,2,762,2,762,0.0,381.0,381.0,0,0,0.0,0.0,0.0
516813.0,6,3,204,1,68,0.0,68.0,68.0,2,136,0.0,70.0,68.0
5825900.0,6,4,270,2,134,0.0,68.0,67.0,2,136,0.0,70.0,68.0
2800508.0,6,2,132,1,66,0.0,66.0,66.0,1,66,0.0,66.0,66.0
100897196.0,17,12,778,6,389,20179439.2,174.0,64.83333333333333,6,389,20088379.6,174.0,64.83333333333333
14950.0,17,2,180,1,90,0.0,90.0,90.0,1,90,0.0,90.0,90.0
207185.0,6,3,426,2,280,0.0,214.0,140.0,1,146,0.0,146.0,146.0
303163.0,6,2,132,1,66,0.0,66.0,66.0,1,66,0.0,66.0,66.0
436939.0,6,11,1021,6,444,58664.6,162.0,74.0,5,577,73153.5,349.0,115.4
298281.0,6,6,412,4,272,99427.0,74.0,68.0,2,140,0.0,74.0,70.0
1762849.0,6,23,6509,12,1529,160259.0,357.0,127.41666666666669,11,4980,145745.6,1510.0,452.7272727272728
19896.0,6,14,4740,7,653,2720.0,249.0,93.28571428571428,7,4087,3082.333333333333,1514.0,583.8571428571429
2397438.0,6,25,7573,14,3735,184418.3076923077,1514.0,266.7857142857143,11,3838,213291.1,1514.0,348.90909090909093
25231.0,6,10,2032,5,524,5805.25,252.0,104.8,5,1508,6045.5,1236.0,301.6
838.0,17,4,438,2,148,0.0,74.0,74.0,2,290,0.0,147.0,145.0
59407.0,6,14,4740,7,653,9397.5,249.0,93.28571428571428,7,4087,9124.333333333334,1514.0,583.8571428571429
108783.0,17,2,286,2,286,0.0,143.0,143.0,0,0,0.0,0.0,0.0
153337.0,17,2,180,1,90,0.0,90.0,90.0,1,90,0.0,90.0,90.0
115559807.0,6,234,26692,117,18674,994348.7931034482,284.0,159.60683760683762,117,8018,994350.0948275862,140.0,68.52991452991454
39380.0,6,11,2098,6,590,7774.6,252.0,98.33333333333331,5,1508,9273.25,1236.0,301.6
10570544.0,6,7,478,4,272,3477849.6666666665,74.0,68.0,3,206,5216657.0,74.0,68.66666666666667
108178.0,17,2,700,2,700,0.0,350.0,350.0,0,0,0.0,0.0,0.0
120066174.0,17,28,13364,28,13364,4446895.333333333,501.0,477.2857142857143,0,0,0.0,0.0,0.0
145088.0,17,2,180,1,70,0.0,70.0,70.0,1,110,0.0,110.0,110.0
34183.0,6,14,4740,7,653,5541.5,249.0,93.28571428571428,7,4087,5561.666666666667,1514.0,583.8571428571429
94890950.0,6,30,2122,15,1017,6777925.0,123.0,67.8,15,1105,6715017.428571428,139.0,73.66666666666667
135131846.0,17,6,1146,6,1146,27026369.2,191.0,191.0,0,0,0.0,0.0,0.0
228220.0,17,2,180,1,90,0.0,90.0,90.0,1,90,0.0,90.0,90.0
107954.0,17,2,286,2,286,0.0,143.0,143.0,0,0,0.0,0.0,0.0
66446.0,6,10,2032,5,524,14179.75,252.0,104.8,5,1508,14775.0,1236.0,301.6
49626.0,6,12,1328,7,797,8271.0,253.0,113.85714285714286,5,531,10613.25,259.0,106.2
144900.0,17,2,180,1,70,0.0,70.0,70.0,1,110,0.0,110.0,110.0
108105694.0,17,5,1005,5,1005,27026423.5,201.0,201.0,0,0,0.0,0.0,0.0
318.0,17,2,174,1,79,0.0,79.0,79.0,1,95,0.0,95.0,95.0
37521.0,6,14,4740,7,653,5977.333333333333,249.0,93.28571428571428,7,4087,6072.166666666667,1514.0,583.8571428571429
298281.0,6,6,412,4,272,99427.0,74.0,68.0,2,140,0.0,74.0,70.0
36279.0,6,14,4740,7,653,4704.833333333333,249.0,93.28571428571428,7,4087,5793.666666666667,1514.0,583.8571428571429
90317061.0,6,16,1192,8,596,12895954.857142856,95.0,74.5,8,596,12901359.714285716,95.0,74.5
217642.0,6,3,426,2,280,0.0,214.0,140.0,1,146,0.0,146.0,146.0
135135972.0,17,6,1206,6,1206,27027194.4,201.0,201.0,0,0,0.0,0.0,0.0
206280.0,6,3,426,2,280,0.0,214.0,140.0,1,146,0.0,146.0,146.0
21574.0,17,2,582,1,83,0.0,83.0,83.0,1,499,0.0,499.0,499.0
550.0,17,2,762,2,762,0.0,381.0,381.0,0,0,0.0,0.0,0.0
153473.0,17,4,6056,4,6056,51157.66666666666,1514.0,1514.0,0,0,0.0,0.0,0.0
103421.0,17,2,286,2,286,0.0,143.0,143.0,0,0,0.0,0.0,0.0
0.0,6,1,66,1,66,0.0,66.0,66.0,0,0,0.0,0.0,0.0
5621289.0,6,4,270,2,134,0.0,68.0,67.0,2,136,0.0,70.0,68.0
90017507.0,17,28,13364,28,13364,3333981.7407407407,501.0,477.2857142857143,0,0,0.0,0.0,0.0
13826.0,6,13,1459,7,862,2304.333333333333,271.0,123.14285714285714,6,597,2179.4,259.0,99.5
153396.0,17,2,180,1,90,0.0,90.0,90.0,1,90,0.0,90.0,90.0
115822.0,6,13,1386,7,789,19303.666666666668,253.0,112.71428571428572,6,597,20530.6,259.0,99.5
153387.0,17,2,180,1,90,0.0,90.0,90.0,1,90,0.0,90.0,90.0
139043.0,6,2,132,1,66,0.0,66.0,66.0,1,66,0.0,66.0,66.0
75868.0,6,12,1320,7,789,12644.666666666666,253.0,112.71428571428572,5,531,17128.25,259.0,106.2
203212.0,17,2,180,1,90,0.0,90.0,90.0,1,90,0.0,90.0,90.0
2292.0,17,4,344,2,150,0.0,75.0,75.0,2,194,0.0,103.0,97.0
381856.0,17,2,363,1,75,0.0,75.0,75.0,1,288,0.0,288.0,288.0
303648.0,6,2,132,1,66,0.0,66.0,66.0,1,66,0.0,66.0,66.0
52221.0,6,14,4740,7,653,7385.666666666667,249.0,93.28571428571428,7,4087,8374.833333333334,1514.0,583.8571428571429
2797072.0,6,2,132,1,66,0.0,66.0,66.0,1,66,0.0,66.0,66.0
21414331.0,6,26,7627,14,3735,178637.46153846153,1514.0,266.7857142857143,12,3892,1928164.818181818,1514.0,324.3333333333333
38237.0,6,14,4740,7,653,5984.833333333333,249.0,93.28571428571428,7,4087,6240.666666666667,1514.0,583.8571428571429
90585910.0,6,27,1938,14,1029,6951552.538461538,123.0,73.5,13,909,7530852.833333333,123.0,69.92307692307692
95672.0,17,2,762,2,762,0.0,381.0,381.0,0,0,0.0,0.0,0.0
76679.0,6,12,1328,7,797,12779.833333333334,253.0,113.85714285714286,5,531,13911.75,259.0,106.2
219597.0,6,4,492,2,280,0.0,214.0,140.0,2,212,0.0,146.0,106.0
50975.0,6,14,4740,7,653,7700.833333333333,249.0,93.28571428571428,7,4087,6496.0,1514.0,583.8571428571429
26128.0,6,10,2032,5,524,6304.0,252.0,104.8,5,1508,4083.75,1236.0,301.6
928.0,17,4,438,2,148,0.0,74.0,74.0,2,290,0.0,147.0,145.0
0.0,17,1,90,1,90,0.0,90.0,90.0,0,0,0.0,0.0,0.0
14643385.0,6,20,1648,10,1016,1592333.7777777778,315.0,101.6,10,632,1592296.111111111,78.0,63.2
123826480.0,17,14,864,7,432,17333493.0,174.0,61.71428571428572,7,432,17334099.5,174.0,61.71428571428572
3165323.0,6,18,1495,9,921,358563.0,315.0,102.33333333333331,9,574,358532.875,78.0,63.77777777777778
2355743.0,6,49,23728,25,19797,98155.95833333331,1514.0,791.88,24,3931,92667.34782608696,1514.0,163.79166666666666
26666.0,6,10,2032,5,524,5393.0,252.0,104.8,5,1508,6113.5,1236.0,301.6
135123396.0,17,6,1146,6,1146,27024679.2,191.0,191.0,0,0,0.0,0.0,0.0
298191.0,6,6,412,4,272,99397.0,74.0,68.0,2,140,0.0,74.0,70.0
149.0,17,3,1143,3,1143,74.5,381.0,381.0,0,0,0.0,0.0,0.0
833343.0,6,9,1118,6,586,166668.6,248.0,97.66666666666669,3,532,280287.0,392.0,177.33333333333334
35539.0,6,10,2032,5,524,8500.0,252.0,104.8,5,1508,8563.25,1236.0,301.6
24248.0,6,10,2032,5,524,5453.0,252.0,104.8,5,1508,5772.0,1236.0,301.6
742819.0,6,2,132,1,66,0.0,66.0,66.0,1,66,0.0,66.0,66.0
117348843.0,6,213,24136,107,16844,1107064.5566037735,284.0,157.42056074766356,106,7292,1107794.761904762,140.0,68.79245283018868
116914981.0,17,14,864,7,432,19459338.166666668,174.0,61.71428571428572,7,432,19373814.666666668,174.0,61.71428571428572
118037441.0,6,264,30382,132,9008,887816.6183206107,140.0,68.24242424242425,132,21374,894826.0534351146,284.0,161.92424242424244
102369.0,17,2,286,2,286,0.0,143.0,143.0,0,0,0.0,0.0,0.0
1306950.0,6,4,264,2,132,0.0,66.0,66.0,2,132,0.0,66.0,66.0
303486.0,6,6,412,4,272,101162.0,74.0,68.0,2,140,0.0,74.0,70.0
118633737.0,6,30,1974,15,1026,8458410.857142856,123.0,68.4,15,948,8458409.57142857,123.0,63.2
108111539.0,17,5,1005,5,1005,27027884.75,201.0,201.0,0,0,0.0,0.0,0.0
10458379.0,6,7,478,4,272,3440606.0,74.0,68.0,3,206,5160806.5,74.0,68.66666666666667
120212223.0,6,18,1341,9,691,14999592.125,95.0,76.77777777777777,9,650,14999597.125,95.0,72.22222222222223
397.0,17,2,508,2,508,0.0,257.0,254.0,0,0,0.0,0.0,0.0
113520779.0,6,46,3036,23,1518,5160020.545454546,66.0,66.0,23,1518,5160024.090909091,66.0,66.0
2338.0,17,4,344,2,150,0.0,75.0,75.0,2,194,0.0,103.0,97.0
115668896.0,17,14,864,7,432,19166820.33333333,174.0,61.71428571428572,7,432,19166357.0,174.0,61.71428571428572
122592134.0,17,14,864,7,432,17167721.666666668,174.0,61.71428571428572,7,432,17166831.833333332,174.0,61.71428571428572
292331.0,17,2,246,1,76,0.0,76.0,76.0,1,170,0.0,170.0,170.0
90060303.0,17,27,12943,27,12943,3463857.8076923075,501.0,479.3703703703704,0,0,0.0,0.0,0.0
120138872.0,6,16,2368,9,1204,14995073.375,188.0,133.77777777777777,7,1164,15017863.833333334,204.0,166.28571428571428
8809472.0,17,3,1034,2,684,0.0,342.0,342.0,1,350,0.0,350.0,350.0
10460812.0,6,6,412,3,206,5159862.5,74.0,68.66666666666667,3,206,5159757.5,74.0,68.66666666666667
206008.0,6,3,426,2,280,0.0,214.0,140.0,1,146,0.0,146.0,146.0
205633.0,17,2,180,1,90,0.0,90.0,90.0,1,90,0.0,90.0,90.0
101596.0,6,10,2032,5,524,23554.5,252.0,104.8,5,1508,10618.5,1236.0,301.6
313230.0,17,4,1400,4,1400,104410.0,350.0,350.0,0,0,0.0,0.0,0.0
90287329.0,6,15,1097,8,596,12898189.857142856,95.0,74.5,7,501,14999894.833333334,95.0,71.57142857142857
37145748.0,6,26,7627,14,3735,187537.7692307692,1514.0,266.7857142857143,12,3892,3357296.909090909,1514.0,324.3333333333333
120114456.0,6,14,2240,6,1224,24022891.2,204.0,204.0,8,1016,17135639.0,188.0,127.0
218095.0,6,3,426,2,280,0.0,214.0,140.0,1,146,0.0,146.0,146.0
24402.0,6,10,2032,5,524,5525.5,252.0,104.8,5,1508,3558.75,1236.0,301.6
298145.0,6,6,412,4,272,99381.66666666669,74.0,68.0,2,140,0.0,74.0,70.0
197147.0,17,2,180,1,90,0.0,90.0,90.0,1,90,0.0,90.0,90.0
3400259.0,17,3,1026,3,1026,1700129.5,342.0,342.0,0,0,0.0,0.0,0.0
3313728.0,6,184,152884,107,143500,31261.584905660377,1510.0,1341.1214953271028,77,9384,39530.59210526316,1510.0,121.87012987012989
66639.0,6,14,4740,7,653,10939.0,249.0,93.28571428571428,7,4087,9837.666666666666,1514.0,583.8571428571429
182246.0,6,3,337,2,214,0.0,160.0,107.0,1,123,0.0,123.0,123.0
2450.0,17,4,344,2,150,0.0,75.0,75.0,2,194,0.0,103.0,97.0
10472715.0,6,6,412,3,206,5166590.0,74.0,68.66666666666667,3,206,5166517.0,74.0,68.66666666666667
333.0,17,2,166,1,75,0.0,75.0,75.0,1,91,0.0,91.0,91.0
215420.0,17,2,180,1,90,0.0,90.0,90.0,1,90,0.0,90.0,90.0
52653.0,6,14,4740,7,653,7711.666666666667,249.0,93.28571428571428,7,4087,7586.333333333333,1514.0,583.8571428571429
366.0,17,2,160,1,80,0.0,80.0,80.0,1,80,0.0,80.0,80.0
106398658.0,6,44,2904,22,1452,5066602.761904762,66.0,66.0,22,1452,5051622.142857143,66.0,66.0
13524.0,6,14,4740,7,653,2002.1666666666667,249.0,93.28571428571428,7,4087,2115.333333333333,1514.0,583.8571428571429
34775.0,6,10,2032,5,524,8455.0,252.0,104.8,5,1508,8151.5,1236.0,301.6
90536464.0,6,14,2240,8,1016,12933780.57142857,188.0,127.0,6,1224,18074496.2,204.0,204.0
90288169.0,6,17,1287,9,691,11280053.0,95.0,76.77777777777777,8,596,12832023.285714284,95.0,74.5
109083.0,17,2,286,2,286,0.0,143.0,143.0,0,0,0.0,0.0,0.0
218084.0,6,3,426,2,280,0.0,214.0,140.0,1,146,0.0,146.0,146.0
2081449.0,17,3,1026,3,1026,1040724.5,342.0,342.0,0,0,0.0,0.0,0.0
297797.0,6,6,412,4,272,99265.66666666669,74.0,68.0,2,140,0.0,74.0,70.0
5542.0,6,2,132,1,66,0.0,66.0,66.0,1,66,0.0,66.0,66.0
3181510.0,6,3,1604,1,753,0.0,753.0,753.0,2,851,0.0,785.0,425.5
199918.0,17,2,180,1,90,0.0,90.0,90.0,1,90,0.0,90.0,90.0
97731041.0,6,853,208158,417,28262,234866.6177884616,214.0,67.77458033573141,436,179896,224643.1379310345,1514.0,412.605504587156
455.0,17,2,166,1,75,0.0,75.0,75.0,1,91,0.0,91.0,91.0
329399.0,6,6,412,4,272,109799.66666666669,74.0,68.0,2,140,0.0,74.0,70.0
103390023.0,17,14,1126,7,563,17166872.333333332,174.0,80.42857142857143,7,563,17168530.5,174.0,80.42857142857143
118026978.0,6,29,1914,15,948,8430498.42857143,123.0,63.2,14,966,8294293.461538462,123.0,69.0
35174.0,6,14,4740,7,653,5738.833333333333,249.0,93.28571428571428,7,4087,5721.833333333333,1514.0,583.8571428571429
9441.0,17,2,571,1,86,0.0,86.0,86.0,1,485,0.0,485.0,485.0
402393.0,17,2,363,1,75,0.0,75.0,75.0,1,288,0.0,288.0,288.0
14159.0,6,11,2098,6,590,2666.0,252.0,98.33333333333331,5,1508,2671.5,1236.0,301.6
35236.0,6,10,2032,5,524,8493.25,252.0,104.8,5,1508,8468.75,1236.0,301.6
326596.0,17,2,238,1,74,0.0,74.0,74.0,1,164,0.0,164.0,164.0
315487.0,17,4,1400,4,1400,105162.33333333331,350.0,350.0,0,0,0.0,0.0,0.0
107831662.0,6,28,1860,14,966,8294743.230769231,123.0,69.0,14,894,8278118.461538462,123.0,63.85714285714285
15263533.0,17,12,5436,12,5436,1387593.9090909092,453.0,453.0,0,0,0.0,0.0,0.0
512384.0,6,3,1604,2,851,0.0,785.0,425.5,1,753,0.0,753.0,753.0
113621897.0,6,48,3168,24,1584,4940082.478260869,66.0,66.0,24,1584,4927990.130434782,66.0,66.0
161352.0,17,2,180,1,90,0.0,90.0,90.0,1,90,0.0,90.0,90.0
120073484.0,17,29,13785,29,13785,4288338.714285715,501.0,475.3448275862069,0,0,0.0,0.0,0.0
43945.0,6,10,2032,5,524,8056.75,252.0,104.8,5,1508,10315.25,1236.0,301.6
90500611.0,6,13,2036,8,1016,12928658.714285716,188.0,127.0,5,1020,22584890.75,204.0,204.0
10488214.0,6,7,478,4,272,3449544.333333333,74.0,68.0,3,206,5174225.0,74.0,68.66666666666667
196965.0,17,2,180,1,90,0.0,90.0,90.0,1,90,0.0,90.0,90.0
273089.0,6,10,1221,6,636,54617.8,298.0,106.0,4,585,85284.0,379.0,146.25
300.0,17,2,174,1,79,0.0,79.0,79.0,1,95,0.0,95.0,95.0
3003973.0,6,11,2106,6,598,600666.6,252.0,99.66666666666669,5,1508,2670.25,1236.0,301.6
31041.0,6,10,2032,5,524,7544.25,252.0,104.8,5,1508,7520.75,1236.0,301.6
206136.0,6,3,426,2,280,0.0,214.0,140.0,1,146,0.0,146.0,146.0
40908.0,6,14,4740,7,653,6652.333333333333,249.0,93.28571428571428,7,4087,6594.666666666667,1514.0,583.8571428571429
207601.0,17,2,762,2,762,0.0,381.0,381.0,0,0,0.0,0.0,0.0
27057120.0,17,5,1710,5,1710,6764280.0,342.0,342.0,0,0,0.0,0.0,0.0
886.0,17,5,550,5,550,221.5,110.0,110.0,0,0,0.0,0.0,0.0
120000112.0,6,20,1531,11,840,12000011.2,95.0,76.36363636363636,9,691,11346596.0,95.0,76.77777777777777
217813.0,6,3,426,2,280,0.0,214.0,140.0,1,146,0.0,146.0,146.0
108110341.0,17,5,955,5,955,27027585.25,191.0,191.0,0,0,0.0,0.0,0.0
143915.0,17,2,180,1,90,0.0,90.0,90.0,1,90,0.0,90.0,90.0
575100.0,6,4,508,2,238,0.0,172.0,119.0,2,270,0.0,135.0,135.0
10849.0,17,4,823,2,163,0.0,89.0,81.5,2,660,0.0,443.0,330.0
35736.0,6,14,4740,7,653,5244.833333333333,249.0,93.28571428571428,7,4087,5464.333333333333,1514.0,583.8571428571429
2356.0,17,4,344,2,150,0.0,75.0,75.0,2,194,0.0,103.0,97.0
108109107.0,17,5,1005,5,1005,27027276.75,201.0,201.0,0,0,0.0,0.0,0.0
110469425.0,6,234,28328,117,20310,950467.1637931034,464.0,173.5897435897436,117,8018,950466.6206896552,140.0,68.52991452991454
2978753.0,6,11,2106,6,598,595572.6,252.0,99.66666666666669,5,1508,1684.0,1236.0,301.6
5553.0,17,2,239,1,82,0.0,82.0,82.0,1,157,0.0,157.0,157.0
207380.0,6,10,1221,6,636,41476.0,298.0,106.0,4,585,68293.33333333333,379.0,146.25
1302438.0,6,4,264,2,132,0.0,66.0,66.0,2,132,0.0,66.0,66.0
855929.0,6,9,1096,6,625,171185.8,287.0,104.16666666666669,3,471,291614.0,331.0,157.0
110390822.0,6,254,28620,127,20016,874397.2698412698,284.0,157.60629921259843,127,8604,874398.2777777778,140.0,67.74803149606299
102125782.0,6,206,23202,103,16182,999192.6666666666,284.0,157.10679611650485,103,7020,999202.7352941176,140.0,68.15533980582525
52876.0,6,10,2032,5,524,12983.5,252.0,104.8,5,1508,11725.0,1236.0,301.6
0.0,6,1,54,0,0,0.0,0.0,0.0,1,54,0.0,54.0,54.0
40129.0,6,14,4740,7,653,6560.0,249.0,93.28571428571428,7,4087,6079.333333333333,1514.0,583.8571428571429
90273681.0,6,15,1097,8,596,12896240.142857144,95.0,74.5,7,501,14997495.5,95.0,71.57142857142857
540853.0,6,10,1221,6,636,108170.6,298.0,106.0,4,585,179352.66666666666,379.0,146.25
118532024.0,6,230,25978,115,18092,1037866.4736842106,284.0,157.3217391304348,115,7886,1037866.6842105264,140.0,68.57391304347826
244373.0,6,3,337,2,214,0.0,160.0,107.0,1,123,0.0,123.0,123.0
33976.0,6,14,4740,7,653,5468.0,249.0,93.28571428571428,7,4087,5424.833333333333,1514.0,583.8571428571429
16601.0,6,10,2032,5,524,3924.25,252.0,104.8,5,1508,3706.0,1236.0,301.6
135124887.0,17,6,1206,6,1206,27024977.4,201.0,201.0,0,0,0.0,0.0,0.0
581847.0,6,10,1221,6,636,116369.4,298.0,106.0,4,585,192762.3333333333,379.0,146.25
38819.0,6,14,4740,7,653,6340.666666666667,249.0,93.28571428571428,7,4087,5653.666666666667,1514.0,583.8571428571429
310032.0,17,4,1400,4,1400,103344.0,350.0,350.0,0,0,0.0,0.0,0.0
159489.0,6,3,337,2,214,0.0,160.0,107.0,1,123,0.0,123.0,123.0
90016430.0,17,28,13364,28,13364,3333941.851851852,501.0,477.2857142857143,0,0,0.0,0.0,0.0
108710459.0,17,14,864,7,432,18091923.5,174.0,61.71428571428572,7,432,18001330.0,174.0,61.71428571428572
32310.0,6,14,4740,7,653,5195.0,249.0,93.28571428571428,7,4087,5253.166666666667,1514.0,583.8571428571429
94549868.0,17,14,1126,7,563,15666803.5,174.0,80.42857142857143,7,563,15667756.5,174.0,80.42857142857143
253948.0,6,4,439,2,238,0.0,172.0,119.0,2,201,0.0,135.0,100.5
124001100.0,17,15,907,8,475,17714442.85714286,174.0,59.375,7,432,17334441.166666668,174.0,61.71428571428572
37199.0,6,12,1320,7,789,6199.833333333333,253.0,112.71428571428572,5,531,7833.25,259.0,106.2
77618758.0,17,14,4788,14,4788,5970673.692307692,342.0,342.0,0,0,0.0,0.0,0.0
103893.0,17,2,286,2,286,0.0,143.0,143.0,0,0,0.0,0.0,0.0
120201593.0,6,306,35578,153,10320,785427.2039473684,140.0,67.45098039215686,153,25258,785393.8092105263,336.0,165.08496732026143
298.0,17,2,156,1,78,0.0,78.0,78.0,1,78,0.0,78.0,78.0
380237.0,6,3,1604,2,851,0.0,785.0,425.5,1,753,0.0,753.0,753.0
128651705.0,6,31,2034,16,1086,8576780.333333334,123.0,67.875,15,948,8460730.5,123.0,63.2
98709395.0,17,12,778,6,389,19601267.2,174.0,64.83333333333333,6,389,19400178.0,174.0,64.83333333333333
157161.0,6,3,337,2,214,0.0,160.0,107.0,1,123,0.0,123.0,123.0
209705.0,6,3,426,2,280,0.0,214.0,140.0,1,146,0.0,146.0,146.0
216684.0,6,3,426,2,280,0.0,214.0,140.0,1,146,0.0,146.0,146.0
208159.0,6,3,426,2,280,0.0,214.0,140.0,1,146,0.0,146.0,146.0
111463.0,17,2,286,2,286,0.0,143.0,143.0,0,0,0.0,0.0,0.0
18471.0,6,12,1393,6,796,3331.2,271.0,132.66666666666666,6,597,3228.4,259.0,99.5
146269.0,6,3,337,2,214,0.0,160.0,107.0,1,123,0.0,123.0,123.0
3371142.0,6,7,923,4,753,1051460.0,571.0,188.25,3,170,1577542.5,62.0,56.66666666666666
10033.0,6,10,1067,5,536,2288.25,264.0,107.2,5,531,2191.25,259.0,106.2
90286579.0,6,16,1192,8,596,12891807.57142857,95.0,74.5,8,596,12896536.285714284,95.0,74.5
469769.0,17,2,346,1,78,0.0,78.0,78.0,1,268,0.0,268.0,268.0
90299309.0,6,16,1192,8,596,12893393.285714284,95.0,74.5,8,596,12898028.0,95.0,74.5
90258239.0,6,14,2240,8,1016,12894034.142857144,188.0,127.0,6,1224,18018713.4,204.0,204.0
234592.0,6,3,373,2,238,0.0,172.0,119.0,1,135,0.0,135.0,135.0
135133117.0,17,6,1146,6,1146,27026623.4,191.0,191.0,0,0,0.0,0.0,0.0
104076.0,17,2,286,2,286,0.0,143.0,143.0,0,0,0.0,0.0,0.0
2812821.0,6,2,132,1,66,0.0,66.0,66.0,1,66,0.0,66.0,66.0
97489303.0,17,14,4796,13,4446,6221111.333333333,342.0,342.0,1,350,0.0,350.0,350.0
31801.000000000004,6,14,4740,7,653,5042.833333333333,249.0,93.28571428571428,7,4087,4467.833333333333,1514.0,583.8571428571429
303216.0,6,2,132,1,66,0.0,66.0,66.0,1,66,0.0,66.0,66.0
18941.0,6,14,4740,7,653,2860.5,249.0,93.28571428571428,7,4087,3025.833333333333,1514.0,583.8571428571429
304264.0,6,6,412,4,272,101421.33333333331,74.0,68.0,2,140,0.0,74.0,70.0
1172397.0,6,9,1196,6,725,234479.4,387.0,120.83333333333331,3,471,449830.0,331.0,157.0
2419.0,17,4,344,2,150,0.0,75.0,75.0,2,194,0.0,103.0,97.0
2429.0,17,4,344,2,150,0.0,75.0,75.0,2,194,0.0,103.0,97.0
14634072.0,6,20,1648,10,1016,1592773.2222222222,315.0,101.6,10,632,1592748.888888889,78.0,63.2
99538904.0,17,12,778,6,389,19798470.2,174.0,64.83333333333333,6,389,19800177.6,174.0,64.83333333333333
98250.0,17,2,286,2,286,0.0,143.0,143.0,0,0,0.0,0.0,0.0
117994841.0,17,15,1169,8,606,16833701.42857143,174.0,75.75,7,563,18319446.0,174.0,80.42857142857143
308446.0,6,6,412,4,272,102815.33333333331,74.0,68.0,2,140,0.0,74.0,70.0
100975366.0,6,239,27090,120,8216,848532.487394958,140.0,68.46666666666667,119,18874,852331.313559322,300.0,158.60504201680672
2437.0,17,4,344,2,150,0.0,75.0,75.0,2,194,0.0,103.0,97.0
921.0,17,4,438,2,148,0.0,74.0,74.0,2,290,0.0,147.0,145.0
147922.0,17,2,180,1,90,0.0,90.0,90.0,1,90,0.0,90.0,90.0
100140853.0,17,12,778,6,389,20028170.6,174.0,64.83333333333333,6,389,19956302.0,174.0,64.83333333333333
120100480.0,6,29,2074,16,1165,8006698.666666667,139.0,72.8125,13,909,9158173.5,123.0,69.92307692307692
2530.0,17,4,344,2,150,0.0,75.0,75.0,2,194,0.0,103.0,97.0
153509.0,17,2,180,1,90,0.0,90.0,90.0,1,90,0.0,90.0,90.0
228113.0,17,2,180,1,90,0.0,90.0,90.0,1,90,0.0,90.0,90.0
10443449.0,6,7,478,4,272,3435825.333333333,74.0,68.0,3,206,5153615.0,74.0,68.66666666666667
146185.0,6,3,337,2,214,0.0,160.0,107.0,1,123,0.0,123.0,123.0
90048517.0,17,28,13364,28,13364,3335130.25925926,501.0,477.2857142857143,0,0,0.0,0.0,0.0
161728.0,6,2,132,1,66,0.0,66.0,66.0,1,66,0.0,66.0,66.0
90246541.0,6,14,2240,8,1016,12892363.0,188.0,127.0,6,1224,18016669.6,204.0,204.0
2849380.0,6,5,336,3,202,1424690.0,70.0,67.33333333333333,2,134,0.0,68.0,67.0
219520.0,6,3,426,2,280,0.0,214.0,140.0,1,146,0.0,146.0,146.0
10472291.0,6,7,478,4,272,3445419.333333333,74.0,68.0,3,206,5168029.0,74.0,68.66666666666667
121243.0,6,3,337,2,214,0.0,160.0,107.0,1,123,0.0,123.0,123.0
102959.0,17,2,286,2,286,0.0,143.0,143.0,0,0,0.0,0.0,0.0
90026785.0,17,28,13364,28,13364,3334325.3703703703,501.0,477.2857142857143,0,0,0.0,0.0,0.0
47732.0,6,14,4740,7,653,7152.0,249.0,93.28571428571428,7,4087,7712.833333333333,1514.0,583.8571428571429
41028.0,6,10,2032,5,524,9975.25,252.0,104.8,5,1508,9775.0,1236.0,301.6
106464.0,17,2,700,2,700,0.0,350.0,350.0,0,0,0.0,0.0,0.0
28087.0,6,10,2032,5,524,6685.75,252.0,104.8,5,1508,6452.25,1236.0,301.6
246691.0,6,12,1373,7,714,41115.16666666666,298.0,102.0,5,659,57758.5,379.0,131.8
2361.0,17,4,344,2,150,0.0,75.0,75.0,2,194,0.0,103.0,97.0
120958664.0,6,35,2410,18,1285,7115215.529411765,139.0,71.38888888888889,17,1125,6922356.1875,123.0,66.17647058823529
2381.0,17,4,344,2,150,0.0,75.0,75.0,2,194,0.0,103.0,97.0
170941.0,17,4,1524,4,1524,56980.333333333336,381.0,381.0,0,0,0.0,0.0,0.0
70611142.0,6,9,1479,9,1479,8826392.75,172.0,164.33333333333334,0,0,0.0,0.0,0.0
0.0,17,1,80,1,80,0.0,80.0,80.0,0,0,0.0,0.0,0.0
32686.0,6,14,4740,7,653,5033.5,249.0,93.28571428571428,7,4087,5162.5,1514.0,583.8571428571429
143889.0,17,2,180,1,90,0.0,90.0,90.0,1,90,0.0,90.0,90.0
153451.0,17,2,180,1,90,0.0,90.0,90.0,1,90,0.0,90.0,90.0
107226239.0,6,28,1860,14,966,8231579.307692308,123.0,69.0,14,894,8231580.230769231,123.0,63.85714285714285
2591078.0,6,2,132,1,66,0.0,66.0,66.0,1,66,0.0,66.0,66.0
118406.0,17,4,1524,4,1524,39468.66666666666,381.0,381.0,0,0,0.0,0.0,0.0
103338069.0,17,14,864,7,432,17166817.5,174.0,61.71428571428572,7,432,17165321.166666668,174.0,61.71428571428572
32906.0,6,11,2098,6,590,6581.2,252.0,98.33333333333331,5,1508,7480.75,1236.0,301.6
442.0,17,2,508,2,508,0.0,257.0,254.0,0,0,0.0,0.0,0.0
11945.0,17,4,823,2,163,0.0,89.0,81.5,2,660,0.0,443.0,330.0
90316444.0,6,16,1192,8,596,12892448.57142857,95.0,74.5,8,596,12900712.57142857,95.0,74.5
332615.0,17,4,1400,4,1400,110871.66666666669,350.0,350.0,0,0,0.0,0.0,0.0
90042614.0,17,28,13364,28,13364,3334911.6296296297,501.0,477.2857142857143,0,0,0.0,0.0,0.0
99900446.0,6,263,30744,132,8934,762598.8244274809,140.0,67.68181818181819,131,21810,760423.8461538461,284.0,166.4885496183206
2803055.0,6,2,132,1,66,0.0,66.0,66.0,1,66,0.0,66.0,66.0
74117.0,6,12,1447,6,816,14051.8,291.0,136.0,6,631,13104.0,293.0,105.16666666666669
2313.0,17,4,344,2,150,0.0,75.0,75.0,2,194,0.0,103.0,97.0
45391.0,6,14,4740,7,653,6661.833333333333,249.0,93.28571428571428,7,4087,7371.666666666667,1514.0,583.8571428571429
2048924.0,17,6,1230,3,234,1024263.0,78.0,78.0,3,996,1024255.5,332.0,332.0
207188.0,6,3,426,2,280,0.0,214.0,140.0,1,146,0.0,146.0,146.0
9659.0,17,2,571,1,86,0.0,86.0,86.0,1,485,0.0,485.0,485.0
14732095.0,6,20,1607,10,975,1603745.111111111,315.0,97.5,10,632,1603716.4444444445,78.0,63.2
90031733.0,17,28,13364,28,13364,3334508.6296296297,501.0,477.2857142857143,0,0,0.0,0.0,0.0
73800.0,6,14,4740,7,653,11165.5,249.0,93.28571428571428,7,4087,10823.166666666666,1514.0,583.8571428571429
113317346.0,6,48,3168,24,1584,4926841.130434782,66.0,66.0,24,1584,4920346.217391305,66.0,66.0
2597006.0,6,2,132,1,66,0.0,66.0,66.0,1,66,0.0,66.0,66.0
123001186.0,17,15,907,8,475,17571598.0,174.0,59.375,7,432,17167568.666666668,174.0,61.71428571428572
93888905.0,6,40,2640,20,1320,4941521.315789473,66.0,66.0,20,1320,4925276.157894737,66.0,66.0
50480.0,6,14,4740,7,653,7591.5,249.0,93.28571428571428,7,4087,7802.0,1514.0,583.8571428571429
55028.0,6,14,4740,7,653,7087.0,249.0,93.28571428571428,7,4087,8994.5,1514.0,583.8571428571429
119369.0,17,4,1400,4,1400,39789.66666666666,350.0,350.0,0,0,0.0,0.0,0.0
102964.0,17,2,286,2,286,0.0,143.0,143.0,0,0,0.0,0.0,0.0
211783.0,17,2,180,1,90,0.0,90.0,90.0,1,90,0.0,90.0,90.0
196803.0,17,2,180,1,90,0.0,90.0,90.0,1,90,0.0,90.0,90.0
256023.0,6,10,1221,6,636,51204.6,298.0,106.0,4,585,79436.33333333333,379.0,146.25
237931.0,6,3,337,2,214,0.0,160.0,107.0,1,123,0.0,123.0,123.0
113613949.0,6,46,3036,23,1518,5150438.318181818,66.0,66.0,23,1518,5150437.227272728,66.0,66.0
100770098.0,6,28,1860,14,966,7734942.0,123.0,69.0,14,894,7734944.692307692,123.0,63.85714285714285
90532817.0,6,16,2648,8,1016,12933259.57142857,188.0,127.0,8,1632,12910265.142857144,204.0,204.0
108104133.0,17,5,955,5,955,27026033.25,191.0,191.0,0,0,0.0,0.0,0.0
70192.0,6,14,4740,7,653,11060.333333333334,249.0,93.28571428571428,7,4087,8810.333333333334,1514.0,583.8571428571429
297253.0,6,6,412,4,272,99084.33333333331,74.0,68.0,2,140,0.0,74.0,70.0
25622.0,6,10,2032,5,524,6175.25,252.0,104.8,5,1508,5783.5,1236.0,301.6
118857548.0,6,48,3168,24,1584,5167719.478260869,66.0,66.0,24,1584,5154265.782608695,66.0,66.0
21764.0,6,14,4740,7,653,3399.833333333333,249.0,93.28571428571428,7,4087,3001.5,1514.0,583.8571428571429
206513.0,6,3,426,2,280,0.0,214.0,140.0,1,146,0.0,146.0,146.0
107305.0,17,2,700,2,700,0.0,350.0,350.0,0,0,0.0,0.0,0.0
205885.0,17,2,180,1,90,0.0,90.0,90.0,1,90,0.0,90.0,90.0
5829198.0,6,5,336,2,134,0.0,68.0,67.0,3,202,1525817.0,70.0,67.33333333333333
2388.0,17,4,344,2,150,0.0,75.0,75.0,2,194,0.0,103.0,97.0
17031.0,6,14,4740,7,653,2552.0,249.0,93.28571428571428,7,4087,2337.5,1514.0,583.8571428571429
304.0,17,2,174,1,79,0.0,79.0,79.0,1,95,0.0,95.0,95.0
26755.0,6,10,2032,5,524,4947.0,252.0,104.8,5,1508,5284.25,1236.0,301.6
135139996.0,17,6,1146,6,1146,27027999.2,191.0,191.0,0,0,0.0,0.0,0.0
99025345.0,17,14,1126,7,563,16500122.166666666,174.0,80.42857142857143,7,563,16500701.5,174.0,80.42857142857143
118769946.0,6,32,2226,17,1209,7423121.625,123.0,71.11764705882354,15,1017,7754872.214285715,123.0,67.8
3073026.0,6,155,124033,87,115243,35732.86046511628,1510.0,1324.632183908046,68,8790,40777.91044776119,1510.0,129.26470588235293
91023939.0,17,12,778,6,389,18201166.8,174.0,64.83333333333333,6,389,18200176.4,174.0,64.83333333333333
17448.0,6,14,4740,7,653,2500.6666666666665,249.0,93.28571428571428,7,4087,2709.6666666666665,1514.0,583.8571428571429
153461.0,17,2,180,1,90,0.0,90.0,90.0,1,90,0.0,90.0,90.0
216515.0,17,2,180,1,90,0.0,90.0,90.0,1,90,0.0,90.0,90.0
108136088.0,17,5,955,5,955,27034022.0,191.0,191.0,0,0,0.0,0.0,0.0
852417.0,6,12,1354,6,723,165316.0,253.0,120.5,6,631,169979.6,293.0,105.16666666666669
57761.0,6,14,4740,7,653,8903.0,249.0,93.28571428571428,7,4087,6577.666666666667,1514.0,583.8571428571429
39955.0,6,14,4740,7,653,6386.666666666667,249.0,93.28571428571428,7,4087,6197.666666666667,1514.0,583.8571428571429
118421776.0,6,33,2280,17,1209,7387880.3125,123.0,71.11764705882354,16,1071,7880407.333333333,123.0,66.9375
228384.0,17,2,180,1,90,0.0,90.0,90.0,1,90,0.0,90.0,90.0
4152.0,17,4,344,2,150,0.0,75.0,75.0,2,194,0.0,103.0,97.0
10515192.0,6,6,412,3,206,5189295.5,74.0,68.66666666666667,3,206,5189176.0,74.0,68.66666666666667
101103.0,17,2,700,2,700,0.0,350.0,350.0,0,0,0.0,0.0,0.0
90087919.0,17,28,13364,28,13364,3336589.592592593,501.0,477.2857142857143,0,0,0.0,0.0,0.0
118882134.0,6,37,2656,19,1408,6604563.0,139.0,74.10526315789474,18,1248,6980341.882352941,123.0,69.33333333333333
66089.0,6,12,1320,6,723,13023.6,253.0,120.5,6,597,10618.0,259.0,99.5
228317.0,17,2,180,1,90,0.0,90.0,90.0,1,90,0.0,90.0,90.0
46227113.0,6,9,1479,9,1479,5778389.125,172.0,164.33333333333334,0,0,0.0,0.0,0.0
256546.0,6,3,337,2,214,0.0,160.0,107.0,1,123,0.0,123.0,123.0
120065201.0,17,28,13364,28,13364,4446859.296296297,501.0,477.2857142857143,0,0,0.0,0.0,0.0
15775.999999999998,6,10,1949,5,441,2377.75,169.0,88.2,5,1508,3612.75,1236.0,301.6
94980980.0,6,32,2644,18,1474,5575013.647058823,139.0,81.88888888888889,14,1170,7290221.307692308,123.0,83.57142857142857
135007098.0,17,15,907,8,475,19286728.285714287,174.0,59.375,7,432,19166868.666666668,174.0,61.71428571428572
112907685.0,6,31,2166,16,1149,7512772.133333334,123.0,71.8125,15,1017,8049405.5,123.0,67.8
508079.0,6,5,336,2,134,0.0,68.0,67.0,3,202,196521.5,70.0,67.33333333333333
2596746.0,6,2,132,1,66,0.0,66.0,66.0,1,66,0.0,66.0,66.0
135128733.0,17,6,1206,6,1206,27025746.6,201.0,201.0,0,0,0.0,0.0,0.0
29153.0,6,14,4740,7,653,3946.1666666666665,249.0,93.28571428571428,7,4087,4718.0,1514.0,583.8571428571429
10860375.0,6,8,544,4,272,3574659.0,74.0,68.0,4,272,3574582.0,74.0,68.0
353.0,17,2,166,1,75,0.0,75.0,75.0,1,91,0.0,91.0,91.0
3008176.0,6,11,2106,6,598,601502.0,252.0,99.66666666666669,5,1508,2761.75,1236.0,301.6
269.0,17,3,1050,3,1050,134.5,350.0,350.0,0,0,0.0,0.0,0.0
119357590.0,6,22,1680,12,935,10846727.909090908,95.0,77.91666666666667,10,745,13235725.888888888,95.0,74.5
15104.0,17,2,180,1,90,0.0,90.0,90.0,1,90,0.0,90.0,90.0
106600794.0,17,14,864,7,432,17667614.166666668,174.0,61.71428571428572,7,432,17666834.666666668,174.0,61.71428571428572
311720.0,17,4,622,4,622,103906.66666666669,163.0,155.5,0,0,0.0,0.0,0.0
90773986.0,6,19,1436,10,745,10081215.777777778,95.0,74.5,9,691,11345517.25,95.0,76.77777777777777
204697.0,17,3,1143,3,1143,102348.5,381.0,381.0,0,0,0.0,0.0,0.0
146055.0,6,3,337,2,214,0.0,160.0,107.0,1,123,0.0,123.0,123.0
360.0,17,2,214,1,75,0.0,75.0,75.0,1,139,0.0,139.0,139.0
144586.0,17,2,180,1,70,0.0,70.0,70.0,1,110,0.0,110.0,110.0
107493772.0,6,44,2904,22,1452,5118751.047619048,66.0,66.0,22,1452,5105621.666666667,66.0,66.0
97057834.0,17,12,778,6,389,19401135.0,174.0,64.83333333333333,6,389,19400235.4,174.0,64.83333333333333
538514.0,17,6,2100,6,2100,107702.8,350.0,350.0,0,0,0.0,0.0,0.0
153455.0,17,2,180,1,90,0.0,90.0,90.0,1,90,0.0,90.0,90.0
49450.0,6,14,4740,7,653,5059.833333333333,249.0,93.28571428571428,7,4087,8104.5,1514.0,583.8571428571429
46306.0,6,14,4740,7,653,7590.666666666667,249.0,93.28571428571428,7,4087,7048.833333333333,1514.0,583.8571428571429
90308944.0,6,17,1287,9,691,11282360.75,95.0,76.77777777777777,8,596,12900684.0,95.0,74.5
2090150.0,6,20,6935,11,1567,209015.0,408.0,142.45454545454547,9,5368,218239.875,1514.0,596.4444444444445
120371167.0,6,241,27206,121,18990,1003093.0583333332,284.0,156.94214876033058,120,8216,1002785.7310924368,140.0,68.46666666666667
100363865.0,17,12,516,6,258,20001966.8,43.0,43.0,6,258,20000168.6,43.0,43.0
31407.0,6,14,4740,7,653,5107.833333333333,249.0,93.28571428571428,7,4087,4849.833333333333,1514.0,583.8571428571429
302708.0,6,6,412,4,272,100902.66666666669,74.0,68.0,2,140,0.0,74.0,70.0
299523.0,6,6,412,4,272,99841.0,74.0,68.0,2,140,0.0,74.0,70.0
120462711.0,6,215,24422,108,17052,1125819.7289719626,336.0,157.88888888888889,107,7370,1126676.783018868,140.0,68.8785046728972
36448.0,6,14,4740,7,653,5362.833333333333,249.0,93.28571428571428,7,4087,5871.333333333333,1514.0,583.8571428571429
122978323.0,6,48,3168,24,1584,5059000.217391305,66.0,66.0,24,1584,5208227.782608695,66.0,66.0
306807.0,6,6,412,4,272,102269.0,74.0,68.0,2,140,0.0,74.0,70.0
234174.0,6,3,337,2,214,0.0,160.0,107.0,1,123,0.0,123.0,123.0
205937.0,6,3,426,2,280,0.0,214.0,140.0,1,146,0.0,146.0,146.0
92243554.0,17,16,5472,16,5472,6149570.266666667,342.0,342.0,0,0,0.0,0.0,0.0
17539.0,6,11,1131,6,600,3235.2,262.0,100.0,5,531,3598.25,259.0,106.2
314009.0,6,6,412,4,272,104669.66666666669,74.0,68.0,2,140,0.0,74.0,70.0
143898.0,17,2,180,1,90,0.0,90.0,90.0,1,90,0.0,90.0,90.0
147423.0,6,3,373,2,238,0.0,172.0,119.0,1,135,0.0,135.0,135.0
149718341.0,6,15,2290,5,1020,29962124.75,204.0,204.0,10,1270,16635233.666666666,188.0,127.0
13315.0,6,13,1459,7,862,2219.1666666666665,271.0,123.14285714285714,6,597,2335.2,259.0,99.5
103712.0,17,2,762,2,762,0.0,381.0,381.0,0,0,0.0,0.0,0.0
108411017.0,6,44,2904,22,1452,5162429.380952381,66.0,66.0,22,1452,5147556.333333333,66.0,66.0
32681939.0,6,5,336,2,134,0.0,68.0,67.0,3,202,16272493.0,70.0,67.33333333333333
90530290.0,6,13,2036,8,1016,12932898.57142857,188.0,127.0,5,1020,22591967.75,204.0,204.0
206701.0,6,3,426,2,280,0.0,214.0,140.0,1,146,0.0,146.0,146.0
30221.0,6,14,4740,7,653,4376.833333333333,249.0,93.28571428571428,7,4087,4726.666666666667,1514.0,583.8571428571429
120254982.0,6,34,2488,18,1348,7073822.470588235,139.0,74.88888888888889,16,1140,7336908.533333333,123.0,71.25
9465.0,17,2,582,1,83,0.0,83.0,83.0,1,499,0.0,499.0,499.0
42383.0,6,14,4740,7,653,6331.166666666667,249.0,93.28571428571428,7,4087,6733.333333333333,1514.0,583.8571428571429
107173.0,17,2,286,2,286,0.0,143.0,143.0,0,0,0.0,0.0,0.0
233089.0,6,3,337,2,214,0.0,160.0,107.0,1,123,0.0,123.0,123.0
123006976.0,17,15,907,8,475,17572425.14285714,174.0,59.375,7,432,17089443.0,174.0,61.71428571428572
108103075.0,17,5,955,5,955,27025768.75,191.0,191.0,0,0,0.0,0.0,0.0
1159194.0,6,13,3020,8,2392,165599.14285714287,1514.0,299.0,5,628,221630.75,331.0,125.6
90225211.0,6,16,1192,8,596,12853509.285714284,95.0,74.5,8,596,12858448.142857144,95.0,74.5
100860.0,6,10,2032,5,524,24918.5,252.0,104.8,5,1508,24496.5,1236.0,301.6
311934.0,17,4,1400,4,1400,103978.0,350.0,350.0,0,0,0.0,0.0,0.0
120642886.0,6,32,2236,16,1071,7377158.866666666,123.0,66.9375,16,1165,7377146.333333333,139.0,72.8125
2334284.0,6,25,7573,14,3735,179560.3076923077,1514.0,266.7857142857143,11,3838,208694.4,1514.0,348.90909090909093
120967934.0,6,47,3102,23,1518,5135441.136363637,66.0,66.0,24,1584,5247641.695652174,66.0,66.0
12651.0,6,10,2032,5,524,2930.75,252.0,104.8,5,1508,2880.25,1236.0,301.6
94250116.0,17,12,778,6,389,18800956.2,174.0,64.83333333333333,6,389,18800209.6,174.0,64.83333333333333
208125.0,6,3,426,2,280,0.0,214.0,140.0,1,146,0.0,146.0,146.0
24134.0,6,14,4740,7,653,3503.6666666666665,249.0,93.28571428571428,7,4087,3010.6666666666665,1514.0,583.8571428571429
135132356.0,17,6,1206,6,1206,27026471.2,201.0,201.0,0,0,0.0,0.0,0.0
138927.0,6,2,132,1,66,0.0,66.0,66.0,1,66,0.0,66.0,66.0
42330.0,6,14,4740,7,653,6583.833333333333,249.0,93.28571428571428,7,4087,5832.666666666667,1514.0,583.8571428571429
285017.0,17,2,363,1,79,0.0,79.0,79.0,1,284,0.0,284.0,284.0
399609.0,17,2,363,1,75,0.0,75.0,75.0,1,288,0.0,288.0,288.0
104144.0,17,2,286,2,286,0.0,143.0,143.0,0,0,0.0,0.0,0.0
1289320.0,17,7,490,7,490,214886.66666666663,70.0,70.0,0,0,0.0,0.0,0.0
100673.0,17,2,762,2,762,0.0,381.0,381.0,0,0,0.0,0.0,0.0
283881.0,17,4,1400,4,1400,94627.0,350.0,350.0,0,0,0.0,0.0,0.0
103109.0,17,2,286,2,286,0.0,143.0,143.0,0,0,0.0,0.0,0.0
242094.0,6,3,337,2,214,0.0,160.0,107.0,1,123,0.0,123.0,123.0
195415.0,17,4,6056,4,6056,65138.333333333336,1514.0,1514.0,0,0,0.0,0.0,0.0
34180.0,6,14,4740,7,653,5484.666666666667,249.0,93.28571428571428,7,4087,5140.666666666667,1514.0,583.8571428571429
1040368.0,6,11,1134,6,558,208073.60000000003,220.0,93.0,5,576,257796.5,304.0,115.2
2388.0,17,4,344,2,150,0.0,75.0,75.0,2,194,0.0,103.0,97.0
135134166.0,17,6,1146,6,1146,27026833.2,191.0,191.0,0,0,0.0,0.0,0.0
206138.0,6,3,426,2,280,0.0,214.0,140.0,1,146,0.0,146.0,146.0
29289.0,6,14,4740,7,653,4604.166666666667,249.0,93.28571428571428,7,4087,4742.5,1514.0,583.8571428571429
2048569.0,17,6,1230,3,234,1024077.5,78.0,78.0,3,996,1023982.0,332.0,332.0
452172.0,17,8,12112,8,12112,64596.0,1514.0,1514.0,0,0,0.0,0.0,0.0
926274.0,6,12,2715,7,743,154379.0,339.0,106.14285714285714,5,1972,162650.75,1514.0,394.4
303208.0,6,2,132,1,66,0.0,66.0,66.0,1,66,0.0,66.0,66.0
2419.0,17,4,344,2,150,0.0,75.0,75.0,2,194,0.0,103.0,97.0
107163744.0,17,14,864,7,432,17834718.5,174.0,61.71428571428572,7,432,17833486.833333332,174.0,61.71428571428572
103000961.0,17,13,821,7,432,17166826.833333332,174.0,61.71428571428572,6,389,19963864.6,174.0,64.83333333333333
298.0,17,2,156,1,78,0.0,78.0,78.0,1,78,0.0,78.0,78.0
104492218.0,17,15,5130,15,5130,7463729.857142857,342.0,342.0,0,0,0.0,0.0,0.0
108124195.0,17,5,955,5,955,27031048.75,191.0,191.0,0,0,0.0,0.0,0.0
147225.0,6,3,373,2,238,0.0,172.0,119.0,1,135,0.0,135.0,135.0
135132980.0,17,6,1206,6,1206,27026596.0,201.0,201.0,0,0,0.0,0.0,0.0
38845.0,6,10,1913,5,461,5158.75,233.0,92.2,5,1452,9368.5,1224.0,290.4
90228232.0,6,19,1436,9,691,11247572.5,95.0,76.77777777777777,10,745,10001349.444444444,95.0,74.5
228696.0,6,12,1373,7,714,38116.0,298.0,102.0,5,659,56115.25,379.0,131.8
934780.0,17,10,3736,10,3736,103864.44444444444,390.0,373.6,0,0,0.0,0.0,0.0
143851.0,17,2,180,1,90,0.0,90.0,90.0,1,90,0.0,90.0,90.0
301580.0,6,6,412,4,272,100526.66666666669,74.0,68.0,2,140,0.0,74.0,70.0
117461335.0,6,2406,2084648,1661,2035466,70756.57228915663,1514.0,1225.44611679711,745,49182,157862.7997311828,78.0,66.01610738255033
601336.0,17,2,473,1,78,0.0,78.0,78.0,1,395,0.0,395.0,395.0
1180640.0,6,11,1134,6,558,236128.0,220.0,93.0,5,576,294078.25,304.0,115.2
135134147.0,17,6,1206,6,1206,27026829.4,201.0,201.0,0,0,0.0,0.0,0.0
27924.0,6,11,2098,6,590,5430.0,252.0,98.33333333333331,5,1508,6627.0,1236.0,301.6
2316.0,17,4,344,2,150,0.0,75.0,75.0,2,194,0.0,103.0,97.0
111555.0,17,2,286,2,286,0.0,143.0,143.0,0,0,0.0,0.0,0.0
121324.0,6,3,337,2,214,0.0,160.0,107.0,1,123,0.0,123.0,123.0
86.0,17,2,700,2,700,0.0,350.0,350.0,0,0,0.0,0.0,0.0
10436458.0,6,6,412,3,206,5149991.5,74.0,68.66666666666667,3,206,5149878.5,74.0,68.66666666666667
2364.0,17,4,344,2,150,0.0,75.0,75.0,2,194,0.0,103.0,97.0
3044114.0,6,3,1604,2,851,0.0,785.0,425.5,1,753,0.0,753.0,753.0
68318.0,6,10,2032,5,524,16858.25,252.0,104.8,5,1508,16778.25,1236.0,301.6
44022.0,6,14,4740,7,653,6951.5,249.0,93.28571428571428,7,4087,7117.833333333333,1514.0,583.8571428571429
129445375.0,17,15,907,7,432,18333496.33333333,174.0,61.71428571428572,8,475,18430051.71428572,174.0,59.375
90027654.0,17,28,13364,28,13364,3334357.5555555555,501.0,477.2857142857143,0,0,0.0,0.0,0.0
315320.0,17,4,622,4,622,105106.66666666669,163.0,155.5,0,0,0.0,0.0,0.0
505226.0,6,4,270,2,134,0.0,68.0,67.0,2,136,0.0,70.0,68.0
211750.0,6,3,426,2,280,0.0,214.0,140.0,1,146,0.0,146.0,146.0
2382.0,17,4,344,2,150,0.0,75.0,75.0,2,194,0.0,103.0,97.0
165893.0,17,2,180,1,90,0.0,90.0,90.0,1,90,0.0,90.0,90.0
3031.0,17,2,224,1,76,0.0,76.0,76.0,1,148,0.0,148.0,148.0
0.0,17,1,289,1,289,0.0,289.0,289.0,0,0,0.0,0.0,0.0
320119.0,6,6,412,4,272,106706.33333333331,74.0,68.0,2,140,0.0,74.0,70.0
788.0,17,5,550,5,550,197.0,110.0,110.0,0,0,0.0,0.0,0.0
120217425.0,6,22,1639,11,840,11996327.5,95.0,76.36363636363636,11,799,11993654.8,95.0,72.63636363636364
312549.0,6,6,412,4,272,104183.0,74.0,68.0,2,140,0.0,74.0,70.0
119578184.0,6,287,33266,144,9800,836211.0769230769,140.0,68.05555555555556,143,23466,840453.4154929577,284.0,164.0979020979021
135138331.0,17,6,1146,6,1146,27027666.2,191.0,191.0,0,0,0.0,0.0,0.0
108095041.0,17,5,955,5,955,27023760.25,191.0,191.0,0,0,0.0,0.0,0.0
298078.0,6,6,412,4,272,99359.33333333331,74.0,68.0,2,140,0.0,74.0,70.0
97612055.0,17,12,778,6,389,19522411.0,174.0,64.83333333333333,6,389,19450211.2,174.0,64.83333333333333
120029802.0,17,28,13364,28,13364,4445548.222222222,501.0,477.2857142857143,0,0,0.0,0.0,0.0
878657.0,6,4,492,2,280,0.0,214.0,140.0,2,212,0.0,146.0,106.0
24009016.0,17,3,1034,2,684,0.0,342.0,342.0,1,350,0.0,350.0,350.0
2346.0,17,4,344,2,150,0.0,75.0,75.0,2,194,0.0,103.0,97.0
255978.0,6,12,1373,7,714,42663.0,298.0,102.0,5,659,62897.5,379.0,131.8
701.0,17,4,438,2,148,0.0,74.0,74.0,2,290,0.0,147.0,145.0
104828.0,17,2,700,2,700,0.0,350.0,350.0,0,0,0.0,0.0,0.0
2050.0,17,4,344,2,150,0.0,75.0,75.0,2,194,0.0,103.0,97.0
80524.0,6,14,4740,7,653,12801.5,249.0,93.28571428571428,7,4087,11192.5,1514.0,583.8571428571429
10415960.0,6,6,412,3,206,5139707.5,74.0,68.66666666666667,3,206,5139597.5,74.0,68.66666666666667
32681329.0,6,5,336,2,134,0.0,68.0,67.0,3,202,16268750.000000002,70.0,67.33333333333333
2802739.0,6,2,132,1,66,0.0,66.0,66.0,1,66,0.0,66.0,66.0
66236.0,6,14,4740,7,653,10911.5,249.0,93.28571428571428,7,4087,10054.333333333334,1514.0,583.8571428571429
41495.0,6,14,4740,7,653,6748.5,249.0,93.28571428571428,7,4087,6775.5,1514.0,583.8571428571429
7005.0,17,2,582,1,83,0.0,83.0,83.0,1,499,0.0,499.0,499.0
274626.0,6,10,1221,6,636,54925.2,298.0,106.0,4,585,83874.0,379.0,146.25
573607.0,17,6,1230,3,234,286624.0,78.0,78.0,3,996,286593.0,332.0,332.0
107269.0,17,2,286,2,286,0.0,143.0,143.0,0,0,0.0,0.0,0.0
1469684.0,17,16,1120,16,1120,97978.93333333332,70.0,70.0,0,0,0.0,0.0,0.0
116415758.0,6,34,2350,17,1225,7275984.875,139.0,72.05882352941177,17,1125,7262469.6875,123.0,66.17647058823529
216645.0,6,3,426,2,280,0.0,214.0,140.0,1,146,0.0,146.0,146.0
1829213.0,6,4,276,2,128,0.0,74.0,64.0,2,148,0.0,74.0,74.0
90018735.0,17,28,13364,28,13364,3334027.222222222,501.0,477.2857142857143,0,0,0.0,0.0,0.0
119939501.0,6,378,45890,189,33120,636831.1170212766,480.0,175.23809523809524,189,12770,636830.4734042553,140.0,67.56613756613757
147019.0,6,2,132,1,66,0.0,66.0,66.0,1,66,0.0,66.0,66.0
5004088.0,17,4,849,2,166,0.0,83.0,83.0,2,683,0.0,499.0,341.5
102060739.0,6,187,21150,94,14778,1097427.3010752688,284.0,157.2127659574468,93,6372,1099288.5652173914,140.0,68.51612903225806
699.0,17,4,360,2,172,0.0,86.0,86.0,2,188,0.0,102.0,94.0
107661.0,17,2,700,2,700,0.0,350.0,350.0,0,0,0.0,0.0,0.0
61859.0,6,10,2032,5,524,15228.75,252.0,104.8,5,1508,12490.75,1236.0,301.6
125335044.0,17,14,864,7,432,17833456.833333332,174.0,61.71428571428572,7,432,19892488.666666668,174.0,61.71428571428572
33064598.0,6,26,7627,14,3735,183280.0,1514.0,266.7857142857143,12,3892,2986180.363636364,1514.0,324.3333333333333
3269.0,17,4,625,2,163,0.0,89.0,81.5,2,462,0.0,245.0,231.0
213717.0,17,2,180,1,90,0.0,90.0,90.0,1,90,0.0,90.0,90.0
9055.0,17,2,582,1,83,0.0,83.0,83.0,1,499,0.0,499.0,499.0
12181.0,6,13,1459,7,862,1830.3333333333333,271.0,123.14285714285714,6,597,2175.8,259.0,99.5
0.0,17,1,55,1,55,0.0,55.0,55.0,0,0,0.0,0.0,0.0
153498.0,17,2,180,1,90,0.0,90.0,90.0,1,90,0.0,90.0,90.0
36032.0,6,12,1413,7,882,6005.333333333333,291.0,126.0,5,531,7680.0,259.0,106.2
318050.0,17,4,1400,4,1400,106016.66666666669,350.0,350.0,0,0,0.0,0.0,0.0
90253726.0,6,14,2240,8,1016,12893389.42857143,188.0,127.0,6,1224,18018200.0,204.0,204.0
335.0,17,2,166,1,75,0.0,75.0,75.0,1,91,0.0,91.0,91.0
217585.0,6,3,426,2,280,0.0,214.0,140.0,1,146,0.0,146.0,146.0
2787764.0,17,3,1026,3,1026,1393882.0,342.0,342.0,0,0,0.0,0.0,0.0
272068.0,17,4,1400,4,1400,90689.33333333331,350.0,350.0,0,0,0.0,0.0,0.0
43991.0,6,14,4740,7,653,7208.166666666667,249.0,93.28571428571428,7,4087,6876.5,1514.0,583.8571428571429
135129130.0,17,6,1146,6,1146,27025826.0,191.0,191.0,0,0,0.0,0.0,0.0
1514356.0,6,2,132,1,66,0.0,66.0,66.0,1,66,0.0,66.0,66.0
2260.0,17,4,344,2,150,0.0,75.0,75.0,2,194,0.0,103.0,97.0
297567.0,6,6,412,4,272,99189.0,74.0,68.0,2,140,0.0,74.0,70.0
266676.0,17,4,1400,4,1400,88892.0,350.0,350.0,0,0,0.0,0.0,0.0
291600.0,17,2,252,1,79,0.0,79.0,79.0,1,173,0.0,173.0,173.0
102285022.0,6,35,2674,18,1411,6016766.0,139.0,78.38888888888889,17,1263,6379295.75,123.0,74.29411764705883
90021421.0,17,28,13364,28,13364,3334126.703703704,501.0,477.2857142857143,0,0,0.0,0.0,0.0
108097292.0,17,5,1005,5,1005,27024323.0,201.0,201.0,0,0,0.0,0.0,0.0
298130.0,6,6,412,4,272,99376.66666666669,74.0,68.0,2,140,0.0,74.0,70.0
37791.0,6,14,4740,7,653,5819.333333333333,249.0,93.28571428571428,7,4087,5642.833333333333,1514.0,583.8571428571429
325.0,17,2,174,1,79,0.0,79.0,79.0,1,95,0.0,95.0,95.0
93855459.0,6,349,43996,175,11772,539399.1896551724,140.0,67.26857142857143,174,32224,537251.2080924856,480.0,185.19540229885047
90026556.0,17,28,13364,28,13364,3334316.888888889,501.0,477.2857142857143,0,0,0.0,0.0,0.0
1063087.0,6,3,1602,1,752,0.0,752.0,752.0,2,850,0.0,784.0,425.0
22063.0,6,10,2032,5,524,4951.25,252.0,104.8,5,1508,5064.5,1236.0,301.6
135132118.0,17,6,1206,6,1206,27026423.6,201.0,201.0,0,0,0.0,0.0,0.0
2038.0,17,4,344,2,150,0.0,75.0,75.0,2,194,0.0,103.0,97.0
1183228.0,6,13,3020,8,2392,169032.57142857142,1514.0,299.0,5,628,226896.5,331.0,125.6
95922.0,17,2,762,2,762,0.0,381.0,381.0,0,0,0.0,0.0,0.0
74606354.0,6,9,842,9,842,9325794.25,97.0,93.55555555555556,0,0,0.0,0.0,0.0
791.0,17,4,438,2,148,0.0,74.0,74.0,2,290,0.0,147.0,145.0
233365.0,6,3,337,2,214,0.0,160.0,107.0,1,123,0.0,123.0,123.0
170.0,17,2,3028,2,3028,0.0,1514.0,1514.0,0,0,0.0,0.0,0.0
2376005.0,6,49,23728,25,19797,99000.20833333331,1514.0,791.88,24,3931,93201.34782608696,1514.0,163.79166666666666
114479940.0,6,48,3168,24,1584,4977388.695652174,66.0,66.0,24,1584,4963049.521739131,66.0,66.0
39758.0,6,14,4740,7,653,6402.666666666667,249.0,93.28571428571428,7,4087,5513.5,1514.0,583.8571428571429
317742.0,17,4,1400,4,1400,105914.0,350.0,350.0,0,0,0.0,0.0,0.0
279845.0,17,2,180,1,90,0.0,90.0,90.0,1,90,0.0,90.0,90.0
352225.0,6,6,412,4,272,117408.33333333331,74.0,68.0,2,140,0.0,74.0,70.0
114344231.0,6,47,3102,24,1584,4962101.173913044,66.0,66.0,23,1518,5105432.090909091,66.0,66.0
1302523.0,6,4,264,2,132,0.0,66.0,66.0,2,132,0.0,66.0,66.0
695.0,17,4,438,2,148,0.0,74.0,74.0,2,290,0.0,147.0,145.0
40333.0,6,14,4740,7,653,6559.666666666667,249.0,93.28571428571428,7,4087,6067.833333333333,1514.0,583.8571428571429
314.0,17,2,174,1,79,0.0,79.0,79.0,1,95,0.0,95.0,95.0
505171.00000000006,6,5,336,2,134,0.0,68.0,67.0,3,202,193315.0,70.0,67.33333333333333
280636.0,6,10,2032,5,524,61122.0,252.0,104.8,5,1508,50580.5,1236.0,301.6
232504.0,6,3,337,2,214,0.0,160.0,107.0,1,123,0.0,123.0,123.0
121343.0,6,3,337,2,214,0.0,160.0,107.0,1,123,0.0,123.0,123.0
47040.0,6,2,132,1,66,0.0,66.0,66.0,1,66,0.0,66.0,66.0
1156901.0,6,13,3010,8,2382,165271.57142857142,1514.0,297.75,5,628,221069.75,331.0,125.6
490037.0,6,5,336,2,134,0.0,68.0,67.0,3,202,191099.5,70.0,67.33333333333333
158243.0,6,3,337,2,214,0.0,160.0,107.0,1,123,0.0,123.0,123.0
2034.0,17,4,344,2,150,0.0,75.0,75.0,2,194,0.0,103.0,97.0
216413.0,17,2,180,1,90,0.0,90.0,90.0,1,90,0.0,90.0,90.0
2819.0,17,2,224,1,76,0.0,76.0,76.0,1,148,0.0,148.0,148.0
340691.0,6,10,1221,6,636,68138.2,298.0,106.0,4,585,112378.66666666669,379.0,146.25
302436.0,6,2,132,1,66,0.0,66.0,66.0,1,66,0.0,66.0,66.0
884530.0,6,12,2717,7,742,147421.66666666666,338.0,106.0,5,1975,152234.0,1514.0,395.0
2793372.0,6,2,132,1,66,0.0,66.0,66.0,1,66,0.0,66.0,66.0
240739.0,6,3,373,2,238,0.0,172.0,119.0,1,135,0.0,135.0,135.0
23489934.0,6,6,1981,4,1087,7829978.0,885.0,271.75,2,894,0.0,826.0,447.0
90018594.0,17,27,12943,27,12943,3462253.6153846155,501.0,479.3703703703704,0,0,0.0,0.0,0.0
1153797.0,6,13,3009,8,2381,164828.14285714287,1514.0,297.625,5,628,220332.25,331.0,125.6
2867.0,17,2,224,1,76,0.0,76.0,76.0,1,148,0.0,148.0,148.0
29616.0,6,14,4740,7,653,4819.5,249.0,93.28571428571428,7,4087,4513.5,1514.0,583.8571428571429
50744.0,17,2,180,1,90,0.0,90.0,90.0,1,90,0.0,90.0,90.0
207181.0,6,3,426,2,280,0.0,214.0,140.0,1,146,0.0,146.0,146.0
322561.0,17,4,1400,4,1400,107520.33333333331,350.0,350.0,0,0,0.0,0.0,0.0
197380.0,17,2,180,1,90,0.0,90.0,90.0,1,90,0.0,90.0,90.0
2003222.0,6,7,499,4,301,636300.0,103.0,75.25,3,198,920460.0,66.0,66.0
38274.0,6,14,4740,7,653,6248.0,249.0,93.28571428571428,7,4087,5823.166666666667,1514.0,583.8571428571429
265056.0,6,3,337,2,214,0.0,160.0,107.0,1,123,0.0,123.0,123.0
90028104.0,17,28,13364,28,13364,3334374.222222222,501.0,477.2857142857143,0,0,0.0,0.0,0.0
228206.0,17,2,180,1,90,0.0,90.0,90.0,1,90,0.0,90.0,90.0
119496272.0,17,35,16705,35,16705,3514596.2352941176,501.0,477.2857142857143,0,0,0.0,0.0,0.0
224957.0,6,10,1221,6,636,44991.4,298.0,106.0,4,585,73615.66666666667,379.0,146.25
209573.0,17,2,762,2,762,0.0,381.0,381.0,0,0,0.0,0.0,0.0
196821.0,17,2,180,1,90,0.0,90.0,90.0,1,90,0.0,90.0,90.0
4250.0,17,2,414,1,88,0.0,88.0,88.0,1,326,0.0,326.0,326.0
4623.0,17,2,626,1,72,0.0,72.0,72.0,1,554,0.0,554.0,554.0
303388.0,6,6,412,4,272,101129.33333333331,74.0,68.0,2,140,0.0,74.0,70.0
206294.0,17,2,180,1,90,0.0,90.0,90.0,1,90,0.0,90.0,90.0
102193.0,17,2,762,2,762,0.0,381.0,381.0,0,0,0.0,0.0,0.0
90237925.0,6,12,1832,8,1016,12891132.142857144,188.0,127.0,4,816,30022890.666666668,204.0,204.0
774.0,17,4,438,2,148,0.0,74.0,74.0,2,290,0.0,147.0,145.0
98638038.0,6,40,2640,20,1320,5191475.684210527,66.0,66.0,20,1320,5175185.421052632,66.0,66.0
209632.0,17,2,180,1,90,0.0,90.0,90.0,1,90,0.0,90.0,90.0
135128173.0,17,6,1206,6,1206,27025634.6,201.0,201.0,0,0,0.0,0.0,0.0
21767.0,6,10,2032,5,524,5134.5,252.0,104.8,5,1508,4883.5,1236.0,301.6
320175.0,17,4,1400,4,1400,106725.0,350.0,350.0,0,0,0.0,0.0,0.0
2806469.0,6,2,132,1,66,0.0,66.0,66.0,1,66,0.0,66.0,66.0
345215.0,6,2,132,1,66,0.0,66.0,66.0,1,66,0.0,66.0,66.0
515734.0,6,3,1604,2,851,0.0,785.0,425.5,1,753,0.0,753.0,753.0
12441151.0,6,7,499,4,301,2855613.6666666665,103.0,75.25,3,198,6144270.5,66.0,66.0
249763.0,6,3,337,2,214,0.0,160.0,107.0,1,123,0.0,123.0,123.0
107388.0,17,2,286,2,286,0.0,143.0,143.0,0,0,0.0,0.0,0.0
205559.0,17,2,180,1,90,0.0,90.0,90.0,1,90,0.0,90.0,90.0
37455.0,6,14,4740,7,653,5722.333333333333,249.0,93.28571428571428,7,4087,6103.0,1514.0,583.8571428571429
116013096.0,6,32,2220,16,1149,7734206.4,123.0,71.8125,16,1071,7719790.8,123.0,66.9375
50735.0,6,14,4740,7,653,8074.5,249.0,93.28571428571428,7,4087,8272.833333333334,1514.0,583.8571428571429
148030.0,17,2,180,1,90,0.0,90.0,90.0,1,90,0.0,90.0,90.0
2282.0,17,4,344,2,150,0.0,75.0,75.0,2,194,0.0,103.0,97.0
304377.0,17,4,704,2,148,0.0,74.0,74.0,2,556,0.0,280.0,278.0
2197046.0,6,2,132,1,66,0.0,66.0,66.0,1,66,0.0,66.0,66.0
3390.0,17,2,359,1,75,0.0,75.0,75.0,1,284,0.0,284.0,284.0
108098778.0,17,5,955,5,955,27024694.5,191.0,191.0,0,0,0.0,0.0,0.0
219076.0,17,4,1400,4,1400,73025.33333333333,350.0,350.0,0,0,0.0,0.0,0.0
233805.0,6,3,373,2,238,0.0,172.0,119.0,1,135,0.0,135.0,135.0
2049.0,17,4,344,2,150,0.0,75.0,75.0,2,194,0.0,103.0,97.0
815.0,17,4,438,2,148,0.0,74.0,74.0,2,290,0.0,147.0,145.0
80234.0,6,14,4740,7,653,12023.833333333334,249.0,93.28571428571428,7,4087,13230.666666666666,1514.0,583.8571428571429
212628.0,6,10,1221,6,636,42525.6,298.0,106.0,4,585,69754.0,379.0,146.25
209637.0,17,2,180,1,90,0.0,90.0,90.0,1,90,0.0,90.0,90.0
115551369.0,6,48,3168,24,1584,5023972.565217392,66.0,66.0,24,1584,5010875.695652174,66.0,66.0
90300912.0,6,26,2864,13,1412,7521078.25,427.0,108.6153846153846,13,1452,7524646.583333333,338.0,111.6923076923077
68361.0,6,14,4740,7,653,11220.666666666666,249.0,93.28571428571428,7,4087,10958.666666666666,1514.0,583.8571428571429
212446.0,6,10,1221,6,636,42489.2,298.0,106.0,4,585,69906.0,379.0,146.25
90277040.0,6,18,1341,9,691,11284630.0,95.0,76.77777777777777,9,650,11248353.125,95.0,72.22222222222223
243146.0,6,3,354,2,288,0.0,222.0,144.0,1,66,0.0,66.0,66.0
236945.0,6,3,337,2,214,0.0,160.0,107.0,1,123,0.0,123.0,123.0
120119327.0,6,13,1760,8,1016,17137029.714285713,188.0,127.0,5,744,22522737.25,204.0,148.8
441315.0,17,2,363,1,79,0.0,79.0,79.0,1,284,0.0,284.0,284.0
98782541.0,6,26,1746,13,906,8213880.666666667,123.0,69.6923076923077,13,840,8213875.666666667,123.0,64.61538461538461
289449.0,6,10,1221,6,636,57889.8,298.0,106.0,4,585,91146.66666666669,379.0,146.25
2347155.0,6,47,23596,24,19731,102050.21739130437,1514.0,822.125,23,3865,96985.81818181818,1514.0,168.04347826086956
116156505.0,6,33,2290,17,1125,7259781.5625,123.0,66.17647058823529,16,1165,7064470.666666667,139.0,72.8125
107532.0,17,2,286,2,286,0.0,143.0,143.0,0,0,0.0,0.0,0.0
135128063.0,17,6,1146,6,1146,27025612.6,191.0,191.0,0,0,0.0,0.0,0.0
120036410.0,17,29,13785,29,13785,4287014.642857143,501.0,475.3448275862069,0,0,0.0,0.0,0.0
90256846.0,6,13,2036,8,1016,12893835.142857144,188.0,127.0,5,1020,22523713.75,204.0,204.0
100428195.0,6,213,25154,116,18338,873288.6521739131,284.0,158.08620689655172,97,6816,1035096.2916666666,140.0,70.26804123711341
155053.0,17,2,180,1,90,0.0,90.0,90.0,1,90,0.0,90.0,90.0
117284596.0,6,257,29718,129,21048,916285.90625,284.0,163.1627906976744,128,8670,915406.7874015748,140.0,67.734375
108107627.0,17,5,1005,5,1005,27026906.75,201.0,201.0,0,0,0.0,0.0,0.0
102171.0,6,11,1132,6,556,20251.4,218.0,92.66666666666669,5,576,22545.0,304.0,115.2
298168.0,6,6,412,4,272,99389.33333333331,74.0,68.0,2,140,0.0,74.0,70.0
842.0,17,4,438,2,148,0.0,74.0,74.0,2,290,0.0,147.0,145.0
1308108.0,17,7,490,7,490,218018.0,70.0,70.0,0,0,0.0,0.0,0.0
238764.0,6,3,337,2,214,0.0,160.0,107.0,1,123,0.0,123.0,123.0
35191.0,6,14,4740,7,653,5451.333333333333,249.0,93.28571428571428,7,4087,5595.0,1514.0,583.8571428571429
105973.0,17,2,762,2,762,0.0,381.0,381.0,0,0,0.0,0.0,0.0
57644.0,6,14,4740,7,653,9048.0,249.0,93.28571428571428,7,4087,8957.833333333334,1514.0,583.8571428571429
146153.0,6,3,337,2,214,0.0,160.0,107.0,1,123,0.0,123.0,123.0
3171479.0,6,18,1495,9,921,358346.875,315.0,102.33333333333331,9,574,358314.0,78.0,63.77777777777778
208655.0,17,2,762,2,762,0.0,381.0,381.0,0,0,0.0,0.0,0.0
79237.0,6,14,4740,7,653,13099.0,249.0,93.28571428571428,7,4087,13032.833333333334,1514.0,583.8571428571429
37316.0,6,10,2032,5,524,9083.5,252.0,104.8,5,1508,9044.75,1236.0,301.6
146174.0,6,3,337,2,214,0.0,160.0,107.0,1,123,0.0,123.0,123.0
108244.0,17,2,286,2,286,0.0,143.0,143.0,0,0,0.0,0.0,0.0
113254765.0,6,46,3036,23,1518,5135437.909090909,66.0,66.0,23,1518,5135432.863636363,66.0,66.0
144823.0,17,2,180,1,70,0.0,70.0,70.0,1,110,0.0,110.0,110.0
36699.0,6,14,4740,7,653,5997.5,249.0,93.28571428571428,7,4087,5984.666666666667,1514.0,583.8571428571429
20256.0,6,2,145,2,145,0.0,91.0,72.5,0,0,0.0,0.0,0.0
1194961.0,6,13,3010,8,2382,170708.7142857143,1514.0,297.75,5,628,229761.75,331.0,125.6
345.0,17,2,267,1,83,0.0,83.0,83.0,1,184,0.0,184.0,184.0
120256.0,17,2,180,1,70,0.0,70.0,70.0,1,110,0.0,110.0,110.0
206107.0,6,3,426,2,280,0.0,214.0,140.0,1,146,0.0,146.0,146.0
10487043.0,6,7,478,4,272,3448472.333333333,74.0,68.0,3,206,5172622.5,74.0,68.66666666666667
30448.0,6,14,4740,7,653,4535.666666666667,249.0,93.28571428571428,7,4087,4790.0,1514.0,583.8571428571429
494904.0,6,5,336,2,134,0.0,68.0,67.0,3,202,194098.5,70.0,67.33333333333333
887633.0,6,9,1269,6,798,177526.6,460.0,133.0,3,471,307434.5,331.0,157.0
757.0,17,5,550,5,550,189.25,110.0,110.0,0,0,0.0,0.0,0.0
2017.0,17,4,344,2,150,0.0,75.0,75.0,2,194,0.0,103.0,97.0
2463.0,17,4,344,2,150,0.0,75.0,75.0,2,194,0.0,103.0,97.0
0.0,17,1,99,1,99,0.0,99.0,99.0,0,0,0.0,0.0,0.0
233085.0,6,4,439,2,238,0.0,172.0,119.0,2,201,0.0,135.0,100.5
298919.0,6,6,412,4,272,99639.66666666669,74.0,68.0,2,140,0.0,74.0,70.0
104377324.0,6,497,82430,249,65692,420876.3064516129,1514.0,263.82329317269074,248,16738,421631.7368421053,214.0,67.49193548387096
1483.0,17,5,550,5,550,370.75,110.0,110.0,0,0,0.0,0.0,0.0
382.0,17,2,174,1,79,0.0,79.0,79.0,1,95,0.0,95.0,95.0
728.0,17,4,438,2,148,0.0,74.0,74.0,2,290,0.0,147.0,145.0
288025.0,17,2,363,1,79,0.0,79.0,79.0,1,284,0.0,284.0,284.0
2471.0,17,4,344,2,150,0.0,75.0,75.0,2,194,0.0,103.0,97.0
19427.0,6,14,4740,7,653,2730.333333333333,249.0,93.28571428571428,7,4087,3048.0,1514.0,583.8571428571429
120263326.0,6,212,23996,106,7218,1137506.580952381,140.0,68.09433962264151,106,16778,1143402.619047619,284.0,158.28301886792454
1731428.0,6,23,6509,12,1529,157402.54545454544,357.0,127.41666666666669,11,4980,142721.5,1510.0,452.7272727272728
90923772.0,6,21,1585,11,840,9092179.9,95.0,76.36363636363636,10,745,10101350.333333334,95.0,74.5
4312.0,17,2,614,1,72,0.0,72.0,72.0,1,542,0.0,542.0,542.0
105509.0,17,2,762,2,762,0.0,381.0,381.0,0,0,0.0,0.0,0.0
30339.0,6,10,2032,5,524,6818.5,252.0,104.8,5,1508,7299.5,1236.0,301.6
108107085.0,17,5,955,5,955,27026771.25,191.0,191.0,0,0,0.0,0.0,0.0
0.0,17,1,350,1,350,0.0,350.0,350.0,0,0,0.0,0.0,0.0
60890.0,6,14,4740,7,653,9983.166666666666,249.0,93.28571428571428,7,4087,8365.333333333334,1514.0,583.8571428571429
90052956.0,17,28,13364,28,13364,3335294.6666666665,501.0,477.2857142857143,0,0,0.0,0.0,0.0
2877.0,17,2,224,1,76,0.0,76.0,76.0,1,148,0.0,148.0,148.0
17801.0,6,11,2098,6,590,2987.8,252.0,98.33333333333331,5,1508,4111.75,1236.0,301.6
120000108.0,6,17,1287,9,691,15000013.5,95.0,76.77777777777777,8,596,12895447.714285716,95.0,74.5
326.0,17,2,160,1,80,0.0,80.0,80.0,1,80,0.0,80.0,80.0
300682.0,6,3,202,2,128,0.0,74.0,64.0,1,74,0.0,74.0,74.0
1930182.0,17,4,820,2,156,0.0,78.0,78.0,2,664,0.0,332.0,332.0
5821695.0,6,4,270,2,134,0.0,68.0,67.0,2,136,0.0,70.0,68.0
235903.0,6,3,373,2,238,0.0,172.0,119.0,1,135,0.0,135.0,135.0
38967.0,6,14,4740,7,653,6293.333333333333,249.0,93.28571428571428,7,4087,6304.166666666667,1514.0,583.8571428571429
305278.0,6,6,412,4,272,101759.33333333331,74.0,68.0,2,140,0.0,74.0,70.0
119003461.0,6,33,2274,17,1125,7437716.3125,123.0,66.17647058823529,16,1149,7253576.066666666,123.0,71.8125
144881.0,17,2,180,1,70,0.0,70.0,70.0,1,110,0.0,110.0,110.0
317651.0,17,4,1400,4,1400,105883.66666666669,350.0,350.0,0,0,0.0,0.0,0.0
108673792.0,6,18,1501,9,851,13578046.875,255.0,94.55555555555556,9,650,13583912.5,95.0,72.22222222222223
426314.0,17,2,363,1,75,0.0,75.0,75.0,1,288,0.0,288.0,288.0
317822.0,17,4,1400,4,1400,105940.66666666669,350.0,350.0,0,0,0.0,0.0,0.0
47366.0,6,10,2032,5,524,11461.5,252.0,104.8,5,1508,10032.75,1236.0,301.6
126494184.0,6,32,2289,17,1272,7905886.5,123.0,74.82352941176471,15,1017,8470504.285714285,123.0,67.8
2003.0,17,4,344,2,150,0.0,75.0,75.0,2,194,0.0,103.0,97.0
120125340.0,6,12,1832,8,1016,17137438.85714286,188.0,127.0,4,816,30032782.0,204.0,204.0
242356.0,6,3,373,2,238,0.0,172.0,119.0,1,135,0.0,135.0,135.0
97157098.0,6,198,22494,99,15738,989203.7040816328,336.0,158.96969696969697,99,6756,989203.581632653,140.0,68.24242424242425
71420.0,6,14,4740,7,653,11782.0,249.0,93.28571428571428,7,4087,9423.666666666666,1514.0,583.8571428571429
144507.0,6,2,132,1,66,0.0,66.0,66.0,1,66,0.0,66.0,66.0
302813.0,6,3,202,2,128,0.0,74.0,64.0,1,74,0.0,74.0,74.0
120121064.0,6,14,2224,9,1204,15015133.0,188.0,133.77777777777777,5,1020,22520641.0,204.0,204.0
2636500.0,6,3,1604,2,851,0.0,785.0,425.5,1,753,0.0,753.0,753.0
113686955.0,6,30,1974,15,1026,8105083.285714285,123.0,68.4,15,948,8105080.285714285,123.0,63.2
10466064.0,6,7,478,4,272,3442970.0,74.0,68.0,3,206,5164344.5,74.0,68.66666666666667
47958.0,6,10,2032,5,524,11760.0,252.0,104.8,5,1508,10248.0,1236.0,301.6
91916954.0,6,389,52354,195,39328,473798.73195876286,336.0,201.68205128205128,194,13026,472000.4196891192,140.0,67.14432989690722
211816.0,6,10,1221,6,636,42363.2,298.0,106.0,4,585,69251.33333333333,379.0,146.25
120727073.0,6,30,1974,15,948,7910057.642857143,123.0,63.2,15,1026,7910036.714285715,123.0,68.4
25157.0,6,12,1413,7,882,4192.833333333333,291.0,126.0,5,531,5100.75,259.0,106.2
349275.0,6,3,204,2,136,0.0,70.0,68.0,1,68,0.0,68.0,68.0
90986310.0,17,17,5814,17,5814,5686644.375,342.0,342.0,0,0,0.0,0.0,0.0
427.0,17,2,166,1,75,0.0,75.0,75.0,1,91,0.0,91.0,91.0
22875.0,6,14,4740,7,653,3545.0,249.0,93.28571428571428,7,4087,3679.3333333333335,1514.0,583.8571428571429
90220615.0,6,16,1192,8,596,12852176.57142857,95.0,74.5,8,596,12857794.142857144,95.0,74.5
146163.0,6,3,337,2,214,0.0,160.0,107.0,1,123,0.0,123.0,123.0
10420248.0,6,7,478,4,272,3428042.333333333,74.0,68.0,3,206,5141259.0,74.0,68.66666666666667
26526.0,6,10,1065,5,534,5453.5,262.0,106.8,5,531,5864.0,259.0,106.2
35668.0,6,14,4740,7,653,4881.5,249.0,93.28571428571428,7,4087,5673.666666666667,1514.0,583.8571428571429
270941.0,17,2,180,1,90,0.0,90.0,90.0,1,90,0.0,90.0,90.0
106073786.0,17,15,1169,8,606,15130577.714285716,174.0,75.75,7,563,17419046.0,174.0,80.42857142857143
2519.0,17,4,344,2,150,0.0,75.0,75.0,2,194,0.0,103.0,97.0
153558.0,17,2,180,1,90,0.0,90.0,90.0,1,90,0.0,90.0,90.0
19204.0,6,14,4740,7,653,3061.6666666666665,249.0,93.28571428571428,7,4087,3001.833333333333,1514.0,583.8571428571429
121770204.0,6,35,2473,18,1348,7162953.176470588,139.0,74.88888888888889,17,1125,7116588.375,123.0,66.17647058823529
1170174.0,6,13,3010,8,2382,167167.7142857143,1514.0,297.75,5,628,223629.75,331.0,125.6
2572526.0,6,3,1604,2,851,0.0,785.0,425.5,1,753,0.0,753.0,753.0
110850808.0,6,278,32556,139,23074,803266.7246376812,464.0,166.0,139,9482,801620.4275362319,140.0,68.2158273381295
1984.0,17,4,344,2,150,0.0,75.0,75.0,2,194,0.0,103.0,97.0
101655108.0,17,14,1126,7,563,16833918.0,174.0,80.42857142857143,7,563,16833493.0,174.0,80.42857142857143
14133.0,6,14,4740,7,653,2203.0,249.0,93.28571428571428,7,4087,2186.833333333333,1514.0,583.8571428571429
104295913.0,6,34,2689,16,1278,6953032.6,123.0,79.875,18,1411,6135025.94117647,139.0,78.38888888888889
25367.0,6,14,4740,7,653,3864.1666666666665,249.0,93.28571428571428,7,4087,4088.5,1514.0,583.8571428571429
113242651.0,6,947,215132,466,31570,243521.9591397849,214.0,67.74678111587983,481,183562,235903.1125,1514.0,381.6257796257796
14036.0,6,10,1067,5,536,3330.5,264.0,107.2,5,531,2242.75,259.0,106.2
120127927.0,6,15,2444,7,1428,20021321.166666668,204.0,204.0,8,1016,17137256.14285714,188.0,127.0
45517.0,6,10,2032,5,524,11156.5,252.0,104.8,5,1508,10032.5,1236.0,301.6
54992.0,6,14,4740,7,653,8726.166666666666,249.0,93.28571428571428,7,4087,8859.5,1514.0,583.8571428571429
53337.0,6,14,4740,7,653,7545.666666666667,249.0,93.28571428571428,7,4087,8536.166666666666,1514.0,583.8571428571429
2345.0,17,4,344,2,150,0.0,75.0,75.0,2,194,0.0,103.0,97.0
12374.0,6,10,1065,5,534,2662.0,262.0,106.8,5,531,2754.25,259.0,106.2
13934.0,6,14,4740,7,653,1928.8333333333333,249.0,93.28571428571428,7,4087,2136.833333333333,1514.0,583.8571428571429
113610588.0,6,46,3036,23,1518,5150438.909090909,66.0,66.0,23,1518,5150432.181818182,66.0,66.0
33564.0,6,14,4740,7,653,5462.833333333333,249.0,93.28571428571428,7,4087,4899.333333333333,1514.0,583.8571428571429
135135785.0,17,6,1146,6,1146,27027157.0,191.0,191.0,0,0,0.0,0.0,0.0
90049317.0,17,28,13364,28,13364,3335159.888888889,501.0,477.2857142857143,0,0,0.0,0.0,0.0
2396.0,17,4,344,2,150,0.0,75.0,75.0,2,194,0.0,103.0,97.0
216954.0,6,3,426,2,280,0.0,214.0,140.0,1,146,0.0,146.0,146.0
525202.0,17,6,2100,6,2100,105040.4,350.0,350.0,0,0,0.0,0.0,0.0
6341.0,17,2,762,2,762,0.0,381.0,381.0,0,0,0.0,0.0,0.0
5619402.0,6,4,270,2,134,0.0,68.0,67.0,2,136,0.0,70.0,68.0
19979.0,6,14,4740,7,653,3221.5,249.0,93.28571428571428,7,4087,3140.6666666666665,1514.0,583.8571428571429
508484.00000000006,6,3,1604,1,753,0.0,753.0,753.0,2,851,0.0,785.0,425.5
104621876.0,6,33,2412,17,1272,6538867.25,123.0,74.82352941176471,16,1140,6960368.666666667,123.0,71.25
117619.0,17,2,286,2,286,0.0,143.0,143.0,0,0,0.0,0.0,0.0
120433098.0,6,199,22598,100,15768,1216495.9393939397,284.0,157.68,99,6830,1207829.295918367,140.0,68.98989898989899
301964.0,6,6,412,4,272,100654.66666666669,74.0,68.0,2,140,0.0,74.0,70.0
108393500.0,6,204,23124,102,16170,1071071.6831683167,284.0,158.52941176470588,102,6954,1071071.4059405942,140.0,68.17647058823529
90052457.0,17,28,13364,28,13364,3335276.185185185,501.0,477.2857142857143,0,0,0.0,0.0,0.0
109879210.0,6,28,1860,14,966,8435613.461538462,123.0,69.0,14,894,8435621.0,123.0,63.85714285714285
113754514.0,6,56,4932,32,2739,3662543.967741936,123.0,85.59375,24,2193,4936471.739130435,123.0,91.375
120123703.0,6,13,2020,9,1204,15015462.875,188.0,133.77777777777777,4,816,30029797.666666668,204.0,204.0
284522.0,17,2,363,1,79,0.0,79.0,79.0,1,284,0.0,284.0,284.0
5809863.0,6,5,336,2,134,0.0,68.0,67.0,3,202,1523926.5,70.0,67.33333333333333
122003.0,6,3,337,2,214,0.0,160.0,107.0,1,123,0.0,123.0,123.0
24838.0,6,10,2032,5,524,5590.75,252.0,104.8,5,1508,5874.5,1236.0,301.6
3238523.0,6,203,168348,117,158370,27918.30172413793,1510.0,1353.5897435897436,86,9978,34509.55294117647,1510.0,116.02325581395348
209354.0,17,2,180,1,90,0.0,90.0,90.0,1,90,0.0,90.0,90.0
103303.0,17,2,286,2,286,0.0,143.0,143.0,0,0,0.0,0.0,0.0
102575.0,17,2,286,2,286,0.0,143.0,143.0,0,0,0.0,0.0,0.0
1119016.0,6,13,1386,7,789,186502.66666666663,253.0,112.71428571428572,6,597,222126.8,259.0,99.5
203000.0,17,2,180,1,90,0.0,90.0,90.0,1,90,0.0,90.0,90.0
98770836.0,6,29,2068,15,1105,7039643.285714285,139.0,73.66666666666667,14,963,7581155.076923077,123.0,68.78571428571429
90008994.0,17,28,13364,28,13364,3333666.4444444445,501.0,477.2857142857143,0,0,0.0,0.0,0.0
1724517.0,6,7,499,3,198,819767.5,66.0,66.0,4,301,522075.6666666667,103.0,75.25
311420.0,6,6,412,4,272,103806.66666666669,74.0,68.0,2,140,0.0,74.0,70.0
90256915.0,6,13,1898,8,1016,12893845.0,188.0,127.0,5,882,22523853.0,204.0,176.4
90205378.0,6,21,1585,10,745,9996562.777777778,95.0,74.5,11,840,8999980.3,95.0,76.36363636363636
61543.0,6,11,2098,6,590,11350.8,252.0,98.33333333333331,5,1508,13942.25,1236.0,301.6
119809971.0,6,23,1693,12,894,10891815.545454543,95.0,74.5,11,799,11954888.3,95.0,72.63636363636364
198848.0,17,2,180,1,90,0.0,90.0,90.0,1,90,0.0,90.0,90.0
108718.0,17,2,286,2,286,0.0,143.0,143.0,0,0,0.0,0.0,0.0
2440.0,17,4,344,2,150,0.0,75.0,75.0,2,194,0.0,103.0,97.0
406097.0,6,3,1604,2,851,0.0,785.0,425.5,1,753,0.0,753.0,753.0
218924.0,6,3,426,2,280,0.0,214.0,140.0,1,146,0.0,146.0,146.0
135132392.0,17,6,1206,6,1206,27026478.4,201.0,201.0,0,0,0.0,0.0,0.0
1170340.0,6,13,3020,8,2392,167191.42857142858,1514.0,299.0,5,628,223643.75,331.0,125.6
118314820.0,6,235,26572,118,8084,1011237.7777777778,140.0,68.50847457627118,117,18488,1011169.1724137932,336.0,158.01709401709402
5622604.0,6,5,336,2,134,0.0,68.0,67.0,3,202,1408567.5,70.0,67.33333333333333
50193.0,6,14,4740,7,653,8037.833333333333,249.0,93.28571428571428,7,4087,8185.5,1514.0,583.8571428571429
751836.0,6,2,132,1,66,0.0,66.0,66.0,1,66,0.0,66.0,66.0
248976.0,6,13,1386,7,789,41496.0,253.0,112.71428571428572,6,597,47107.8,259.0,99.5
316613.0,17,4,1400,4,1400,105537.66666666669,350.0,350.0,0,0,0.0,0.0,0.0
108098108.0,17,5,955,5,955,27024527.0,191.0,191.0,0,0,0.0,0.0,0.0
93641030.0,17,12,778,6,389,18696418.0,174.0,64.83333333333333,6,389,18649261.2,174.0,64.83333333333333
103654.0,17,2,286,2,286,0.0,143.0,143.0,0,0,0.0,0.0,0.0
339072.0,17,2,180,1,90,0.0,90.0,90.0,1,90,0.0,90.0,90.0
42687.0,6,14,4740,7,653,5934.333333333333,249.0,93.28571428571428,7,4087,6952.333333333333,1514.0,583.8571428571429
307950.0,6,6,412,4,272,102650.0,74.0,68.0,2,140,0.0,74.0,70.0
743.0,17,4,438,2,148,0.0,74.0,74.0,2,290,0.0,147.0,145.0
33437.0,6,14,4740,7,653,5447.5,249.0,93.28571428571428,7,4087,5354.166666666667,1514.0,583.8571428571429
34738.0,6,14,4740,7,653,5582.833333333333,249.0,93.28571428571428,7,4087,5551.5,1514.0,583.8571428571429
120572193.0,6,223,25246,112,17624,1086235.972972973,284.0,157.35714285714286,111,7622,1086731.6545454543,140.0,68.66666666666667
2594370.0,6,2,132,1,66,0.0,66.0,66.0,1,66,0.0,66.0,66.0
90288441.0,6,18,1341,9,650,11280101.625,95.0,72.22222222222223,9,691,11285596.5,95.0,76.77777777777777
249751.0,6,3,373,2,238,0.0,172.0,119.0,1,135,0.0,135.0,135.0
291464.0,6,12,1373,7,714,48577.333333333336,298.0,102.0,5,659,68739.25,379.0,131.8
6782.0,17,4,823,2,163,0.0,89.0,81.5,2,660,0.0,443.0,330.0
35811.0,6,14,4740,7,653,5013.5,249.0,93.28571428571428,7,4087,5467.333333333333,1514.0,583.8571428571429
120186603.0,6,220,24772,110,7482,1095085.8256880734,140.0,68.01818181818182,110,17290,1095170.8073394496,284.0,157.1818181818182
119586320.0,17,35,16705,35,16705,3517244.705882353,501.0,477.2857142857143,0,0,0.0,0.0,0.0
232747.0,6,3,337,2,214,0.0,160.0,107.0,1,123,0.0,123.0,123.0
2333.0,17,4,344,2,150,0.0,75.0,75.0,2,194,0.0,103.0,97.0
36771.0,6,10,2032,5,524,8991.75,252.0,104.8,5,1508,8430.5,1236.0,301.6
30199.0,6,10,2032,5,524,6521.0,252.0,104.8,5,1508,7197.5,1236.0,301.6
108103570.0,17,5,1005,5,1005,27025892.5,201.0,201.0,0,0,0.0,0.0,0.0
37862.0,6,14,4740,7,653,6187.333333333333,249.0,93.28571428571428,7,4087,5830.0,1514.0,583.8571428571429
995.0,17,2,508,2,508,0.0,257.0,254.0,0,0,0.0,0.0,0.0
2287.0,17,4,344,2,150,0.0,75.0,75.0,2,194,0.0,103.0,97.0
156075.0,6,3,337,2,214,0.0,160.0,107.0,1,123,0.0,123.0,123.0
207008.0,6,3,426,2,280,0.0,214.0,140.0,1,146,0.0,146.0,146.0
153395.0,17,2,180,1,90,0.0,90.0,90.0,1,90,0.0,90.0,90.0
20982.0,6,14,4740,7,653,3374.5,249.0,93.28571428571428,7,4087,3348.1666666666665,1514.0,583.8571428571429
1132057.0,6,20,6434,12,1921,102914.27272727272,620.0,160.08333333333334,8,4513,134825.42857142858,1514.0,564.125
90036933.0,17,28,13364,28,13364,3334701.222222222,501.0,477.2857142857143,0,0,0.0,0.0,0.0
355.0,17,2,267,1,83,0.0,83.0,83.0,1,184,0.0,184.0,184.0
70408.0,6,14,4740,7,653,11563.666666666666,249.0,93.28571428571428,7,4087,11563.833333333334,1514.0,583.8571428571429
207778.0,17,2,762,2,762,0.0,381.0,381.0,0,0,0.0,0.0,0.0
119687872.0,6,47,3102,24,1584,5203809.478260869,66.0,66.0,23,1518,5144002.681818182,66.0,66.0
102108653.0,6,41,2706,21,1386,5105432.65,66.0,66.0,20,1320,5287991.947368421,66.0,66.0
875438.0,6,10,1336,6,799,175087.6,461.0,133.16666666666666,4,537,199859.66666666663,331.0,134.25
120252235.0,17,15,1169,7,563,16833496.333333332,174.0,80.42857142857143,8,606,17143695.714285713,174.0,75.75
31363.000000000004,6,14,4740,7,653,5055.166666666667,249.0,93.28571428571428,7,4087,4938.833333333333,1514.0,583.8571428571429
299.0,17,2,168,1,76,0.0,76.0,76.0,1,92,0.0,92.0,92.0
422297.0,6,3,204,1,68,0.0,68.0,68.0,2,136,0.0,70.0,68.0
321497.0,17,4,1400,4,1400,107165.66666666669,350.0,350.0,0,0,0.0,0.0,0.0
64874072.0,17,12,8159,12,8159,5897642.909090909,892.0,679.9166666666666,0,0,0.0,0.0,0.0
206521.0,17,2,180,1,90,0.0,90.0,90.0,1,90,0.0,90.0,90.0
90303513.0,6,18,1470,9,650,11280733.25,95.0,72.22222222222223,9,820,11286902.375,224.0,91.11111111111111
153425.0,17,2,180,1,90,0.0,90.0,90.0,1,90,0.0,90.0,90.0
90682656.0,6,21,1585,10,745,10075850.666666666,95.0,74.5,11,840,9043339.9,95.0,76.36363636363636
135126789.0,17,6,1206,6,1206,27025357.8,201.0,201.0,0,0,0.0,0.0,0.0
149846086.0,17,36,17126,36,17126,4281316.742857143,501.0,475.72222222222223,0,0,0.0,0.0,0.0
102244365.0,6,195,22166,98,15530,1051837.93814433,284.0,158.46938775510205,97,6636,1057894.7395833333,140.0,68.41237113402062
29661.0,6,14,4740,7,653,4826.166666666667,249.0,93.28571428571428,7,4087,4807.666666666667,1514.0,583.8571428571429
1816.0,17,2,176,1,80,0.0,80.0,80.0,1,96,0.0,96.0,96.0
146143.0,6,3,337,2,214,0.0,160.0,107.0,1,123,0.0,123.0,123.0
24215.0,6,14,4740,7,653,3925.1666666666665,249.0,93.28571428571428,7,4087,3610.5,1514.0,583.8571428571429
4485.0,17,2,602,1,72,0.0,72.0,72.0,1,530,0.0,530.0,530.0
135133231.0,17,6,1206,6,1206,27026646.2,201.0,201.0,0,0,0.0,0.0,0.0
73041.0,6,14,4740,7,653,11778.833333333334,249.0,93.28571428571428,7,4087,11978.666666666666,1514.0,583.8571428571429
1035913.0,6,11,1134,6,558,207182.6,220.0,93.0,5,576,255629.75,304.0,115.2
47395.0,6,10,2032,5,524,10801.75,252.0,104.8,5,1508,11142.5,1236.0,301.6
19819.0,6,14,4740,7,653,2767.1666666666665,249.0,93.28571428571428,7,4087,3154.1666666666665,1514.0,583.8571428571429
90284125.0,6,16,1192,8,596,12891570.857142856,95.0,74.5,8,596,12897360.714285716,95.0,74.5
507181.0,6,5,336,2,134,0.0,68.0,67.0,3,202,193388.0,70.0,67.33333333333333
28701.0,6,14,4740,7,653,4623.166666666667,249.0,93.28571428571428,7,4087,4307.833333333333,1514.0,583.8571428571429
48146.0,6,14,4740,7,653,7905.333333333333,249.0,93.28571428571428,7,4087,7236.166666666667,1514.0,583.8571428571429
298746.0,6,6,412,4,272,99582.0,74.0,68.0,2,140,0.0,74.0,70.0
106336654.0,6,192,21738,96,15180,1117066.6842105263,284.0,158.125,96,6558,1117066.5578947368,140.0,68.3125
301277.0,6,6,412,4,272,100425.66666666669,74.0,68.0,2,140,0.0,74.0,70.0
4794.0,17,4,344,2,150,0.0,75.0,75.0,2,194,0.0,103.0,97.0
44218.0,6,14,4740,7,653,7242.833333333333,249.0,93.28571428571428,7,4087,6968.166666666667,1514.0,583.8571428571429
114964939.0,6,35,2542,18,1348,6749938.0,139.0,74.88888888888889,17,1194,7171808.5625,123.0,70.23529411764706
47605402.0,6,8,1940,3,887,22564819.5,753.0,295.6666666666667,5,1053,11206763.0,785.0,210.6
14638897.0,6,20,1607,10,975,1592811.6666666667,315.0,97.5,10,632,1592787.6666666667,78.0,63.2
2977051.0,6,3,1604,2,851,0.0,785.0,425.5,1,753,0.0,753.0,753.0
3372282.0,6,149,125614,89,117352,38321.38636363636,1510.0,1318.561797752809,60,8262,51805.84745762712,1510.0,137.7
1827.0,17,2,176,1,80,0.0,80.0,80.0,1,96,0.0,96.0,96.0
1056788.0,6,13,1386,7,789,176131.33333333334,253.0,112.71428571428572,6,597,209688.4,259.0,99.5
250042.0,17,4,6056,4,6056,83347.33333333333,1514.0,1514.0,0,0,0.0,0.0,0.0
21365.0,6,10,2032,5,524,5099.5,252.0,104.8,5,1508,5123.75,1236.0,301.6
109164369.0,6,191,21492,96,6558,1149098.6210526316,140.0,68.3125,95,14934,1150478.255319149,284.0,157.2
872641.0,6,9,1269,6,798,174528.2,460.0,133.0,3,471,298444.0,331.0,157.0
335.0,17,2,160,1,80,0.0,80.0,80.0,1,80,0.0,80.0,80.0
22491.0,6,13,1386,7,789,3532.1666666666665,253.0,112.71428571428572,6,597,4131.0,259.0,99.5
153329.0,17,2,180,1,90,0.0,90.0,90.0,1,90,0.0,90.0,90.0
1515338.0,6,20,6434,12,1921,137758.0,620.0,160.08333333333334,8,4513,177959.0,1514.0,564.125
103169253.0,6,44,2904,22,1452,4912821.571428572,66.0,66.0,22,1452,4899703.619047619,66.0,66.0
32129.0,6,14,4740,7,653,4931.333333333333,249.0,93.28571428571428,7,4087,5220.0,1514.0,583.8571428571429
5629260.0,6,5,336,2,134,0.0,68.0,67.0,3,202,1424667.0,70.0,67.33333333333333
310599.0,6,6,412,4,272,103533.0,74.0,68.0,2,140,0.0,74.0,70.0
207735.0,6,3,426,2,280,0.0,214.0,140.0,1,146,0.0,146.0,146.0
326.0,17,2,174,1,79,0.0,79.0,79.0,1,95,0.0,95.0,95.0
27204.0,6,14,4740,7,653,3067.6666666666665,249.0,93.28571428571428,7,4087,4394.0,1514.0,583.8571428571429
53969.0,6,14,4740,7,653,8873.166666666666,249.0,93.28571428571428,7,4087,8334.0,1514.0,583.8571428571429
298300.0,6,6,412,4,272,99433.33333333331,74.0,68.0,2,140,0.0,74.0,70.0
94001030.0,17,11,735,6,389,18800206.0,174.0,64.83333333333333,5,346,18501707.5,174.0,69.2
103187.0,17,2,700,2,700,0.0,350.0,350.0,0,0,0.0,0.0,0.0
2596986.0,6,2,132,1,66,0.0,66.0,66.0,1,66,0.0,66.0,66.0
60809.0,6,14,4740,7,653,10001.833333333334,249.0,93.28571428571428,7,4087,9960.166666666666,1514.0,583.8571428571429
1474.0,17,5,550,5,550,368.5,110.0,110.0,0,0,0.0,0.0,0.0
1062109.0,17,2,626,1,72,0.0,72.0,72.0,1,554,0.0,554.0,554.0
128262.0,6,2,132,1,66,0.0,66.0,66.0,1,66,0.0,66.0,66.0
146326.0,6,3,337,2,214,0.0,160.0,107.0,1,123,0.0,123.0,123.0
62641.0,6,14,4740,7,653,8574.333333333334,249.0,93.28571428571428,7,4087,9546.333333333334,1514.0,583.8571428571429
3009301.0,6,12,2172,7,664,501148.0,252.0,94.85714285714286,5,1508,2718.0,1236.0,301.6
204358.0,17,2,762,2,762,0.0,381.0,381.0,0,0,0.0,0.0,0.0
232727.0,6,3,337,2,214,0.0,160.0,107.0,1,123,0.0,123.0,123.0
169499.0,17,2,414,1,88,0.0,88.0,88.0,1,326,0.0,326.0,326.0
72741.0,6,14,4740,7,653,11788.666666666666,249.0,93.28571428571428,7,4087,11379.166666666666,1514.0,583.8571428571429
501535.0,6,5,336,2,134,0.0,68.0,67.0,3,202,191657.0,70.0,67.33333333333333
42803.0,6,10,2032,5,524,10430.5,252.0,104.8,5,1508,9160.75,1236.0,301.6
0.0,17,1,90,1,90,0.0,90.0,90.0,0,0,0.0,0.0,0.0
562.0,17,2,508,2,508,0.0,257.0,254.0,0,0,0.0,0.0,0.0
209414.0,17,2,180,1,90,0.0,90.0,90.0,1,90,0.0,90.0,90.0
98534328.0,6,30,2106,15,1089,7038166.285714285,123.0,72.6,15,1017,7022715.571428572,123.0,67.8
90028699.0,17,28,13364,28,13364,3334396.25925926,501.0,477.2857142857143,0,0,0.0,0.0,0.0
33359.0,6,14,4740,7,653,5381.5,249.0,93.28571428571428,7,4087,5434.5,1514.0,583.8571428571429
60483.0,6,12,1328,6,731,10397.4,253.0,121.83333333333331,6,597,11045.6,259.0,99.5
143867.0,17,2,180,1,90,0.0,90.0,90.0,1,90,0.0,90.0,90.0
0.0,17,1,90,1,90,0.0,90.0,90.0,0,0,0.0,0.0,0.0
10473270.0,6,7,478,4,272,3445887.333333333,74.0,68.0,3,206,5168731.0,74.0,68.66666666666667
749.0,17,4,438,2,148,0.0,74.0,74.0,2,290,0.0,147.0,145.0
299049.0,6,6,412,4,272,99683.0,74.0,68.0,2,140,0.0,74.0,70.0
46970.0,6,14,4740,7,653,7357.166666666667,249.0,93.28571428571428,7,4087,7674.166666666667,1514.0,583.8571428571429
39545.0,6,14,4740,7,653,4576.0,249.0,93.28571428571428,7,4087,6445.333333333333,1514.0,583.8571428571429
1305311.0,17,7,490,7,490,217551.8333333333,70.0,70.0,0,0,0.0,0.0,0.0
24195.0,6,14,4740,7,653,3628.8333333333335,249.0,93.28571428571428,7,4087,3782.6666666666665,1514.0,583.8571428571429
289.0,17,2,156,1,78,0.0,78.0,78.0,1,78,0.0,78.0,78.0
2509465.0,6,3,1604,2,851,0.0,785.0,425.5,1,753,0.0,753.0,753.0
0.0,17,1,453,1,453,0.0,453.0,453.0,0,0,0.0,0.0,0.0
21057112.0,6,6,1981,4,1087,7019037.333333333,885.0,271.75,2,894,0.0,826.0,447.0
145085.0,17,2,180,1,70,0.0,70.0,70.0,1,110,0.0,110.0,110.0
108099648.0,17,5,955,5,955,27024912.0,191.0,191.0,0,0,0.0,0.0,0.0
1126902.0,17,6,1230,3,234,563230.0,78.0,78.0,3,996,563201.5,332.0,332.0
147437.0,6,3,337,2,214,0.0,160.0,107.0,1,123,0.0,123.0,123.0
205915.0,17,2,762,2,762,0.0,381.0,381.0,0,0,0.0,0.0,0.0
306468.0,6,6,412,4,272,102156.0,74.0,68.0,2,140,0.0,74.0,70.0
99257644.0,17,12,778,6,389,19801897.6,174.0,64.83333333333333,6,389,19800163.0,174.0,64.83333333333333
209186.0,6,3,426,2,280,0.0,214.0,140.0,1,146,0.0,146.0,146.0
103190.0,17,2,286,2,286,0.0,143.0,143.0,0,0,0.0,0.0,0.0
30470.0,6,10,2032,5,524,5931.5,252.0,104.8,5,1508,6690.25,1236.0,301.6
10889217.0,6,8,544,4,272,3584014.0,74.0,68.0,4,272,3583935.6666666665,74.0,68.0
0.0,17,1,55,1,55,0.0,55.0,55.0,0,0,0.0,0.0,0.0
115654417.0,6,294,35988,147,26064,790678.0410958905,300.0,177.30612244897958,147,9924,790678.6232876712,140.0,67.51020408163265
90058780.0,17,27,12943,27,12943,3463799.230769231,501.0,479.3703703703704,0,0,0.0,0.0,0.0
59622.0,6,14,4740,7,653,9729.5,249.0,93.28571428571428,7,4087,9346.5,1514.0,583.8571428571429
228472.0,17,2,180,1,90,0.0,90.0,90.0,1,90,0.0,90.0,90.0
324.0,17,2,174,1,79,0.0,79.0,79.0,1,95,0.0,95.0,95.0
142183.0,6,2,132,1,66,0.0,66.0,66.0,1,66,0.0,66.0,66.0
214460.0,6,3,426,2,280,0.0,214.0,140.0,1,146,0.0,146.0,146.0
323.0,17,2,174,1,79,0.0,79.0,79.0,1,95,0.0,95.0,95.0
90020207.0,17,27,12943,27,12943,3462315.653846154,501.0,479.3703703703704,0,0,0.0,0.0,0.0
105148.0,17,2,762,2,762,0.0,381.0,381.0,0,0,0.0,0.0,0.0
43158.0,6,14,4740,7,653,6060.833333333333,249.0,93.28571428571428,7,4087,5824.833333333333,1514.0,583.8571428571429
12955.0,6,11,1133,6,602,2591.0,264.0,100.33333333333331,5,531,2283.5,259.0,106.2
302570.0,6,7,478,4,272,100856.66666666669,74.0,68.0,3,206,75180.5,74.0,68.66666666666667
91836347.0,6,25,1924,14,1084,7064234.384615385,95.0,77.42857142857143,11,840,9182714.3,95.0,76.36363636363636
122636179.0,6,47,3102,23,1518,5155443.181818182,66.0,66.0,24,1584,5318353.739130435,66.0,66.0
387.0,17,2,267,1,83,0.0,83.0,83.0,1,184,0.0,184.0,184.0
205869.0,17,2,180,1,90,0.0,90.0,90.0,1,90,0.0,90.0,90.0
90255845.0,6,12,1832,8,1016,12893692.142857144,188.0,127.0,4,816,30031321.33333333,204.0,204.0
135132901.0,17,6,1206,6,1206,27026580.2,201.0,201.0,0,0,0.0,0.0,0.0
6658.0,17,2,582,1,83,0.0,83.0,83.0,1,499,0.0,499.0,499.0
228308.0,17,2,180,1,90,0.0,90.0,90.0,1,90,0.0,90.0,90.0
305929.0,6,6,412,4,272,101976.33333333331,74.0,68.0,2,140,0.0,74.0,70.0
144886.0,17,2,180,1,70,0.0,70.0,70.0,1,110,0.0,110.0,110.0
5436.0,17,2,180,1,90,0.0,90.0,90.0,1,90,0.0,90.0,90.0
85941477.0,6,1650,1509591,462,30650,186424.0281995661,204.0,66.34199134199135,1188,1478941,72396.23336141533,1514.0,1244.8998316498316
16776.0,17,2,180,1,90,0.0,90.0,90.0,1,90,0.0,90.0,90.0
171650.0,17,2,180,1,90,0.0,90.0,90.0,1,90,0.0,90.0,90.0
24454.0,6,11,2098,6,590,4480.6,252.0,98.33333333333331,5,1508,5718.25,1236.0,301.6
85937.0,6,14,4740,7,653,9941.5,249.0,93.28571428571428,7,4087,13803.166666666666,1514.0,583.8571428571429
201917.0,17,4,6056,4,6056,67305.66666666667,1514.0,1514.0,0,0,0.0,0.0,0.0
235568.0,6,3,337,2,214,0.0,160.0,107.0,1,123,0.0,123.0,123.0
90023095.0,17,28,13364,28,13364,3334188.703703704,501.0,477.2857142857143,0,0,0.0,0.0,0.0
2321.0,17,4,344,2,150,0.0,75.0,75.0,2,194,0.0,103.0,97.0
24232.0,6,11,2098,6,590,4624.6,252.0,98.33333333333331,5,1508,5884.5,1236.0,301.6
29826.0,6,14,4740,7,653,4479.0,249.0,93.28571428571428,7,4087,4493.833333333333,1514.0,583.8571428571429
107106823.0,6,203,22824,102,7028,1060463.5940594058,140.0,68.90196078431373,101,15796,1062024.86,284.0,156.3960396039604
113184544.0,6,276,33848,138,24518,824593.4817518248,300.0,177.66666666666666,138,9330,824592.0948905109,140.0,67.6086956521739
38714.0,6,14,4740,7,653,5734.5,249.0,93.28571428571428,7,4087,6010.333333333333,1514.0,583.8571428571429
90288062.0,6,14,1043,7,542,15048010.333333334,95.0,77.42857142857143,7,501,14999383.333333334,95.0,71.57142857142857
34108.0,6,14,4740,7,653,4925.666666666667,249.0,93.28571428571428,7,4087,5188.5,1514.0,583.8571428571429
359.0,17,2,267,1,83,0.0,83.0,83.0,1,184,0.0,184.0,184.0
200091.0,17,2,180,1,90,0.0,90.0,90.0,1,90,0.0,90.0,90.0
90768791.0,6,19,1494,10,745,10080687.111111112,95.0,74.5,9,749,11345531.375,153.0,83.22222222222223
6606.0,17,4,823,2,163,0.0,89.0,81.5,2,660,0.0,443.0,330.0
10471254.0,6,7,478,4,272,3444705.333333333,74.0,68.0,3,206,5166973.5,74.0,68.66666666666667
325712.0,6,6,412,4,272,108570.66666666669,74.0,68.0,2,140,0.0,74.0,70.0
134514.0,6,2,132,1,66,0.0,66.0,66.0,1,66,0.0,66.0,66.0
120122452.0,6,14,2224,9,1204,15015306.5,188.0,133.77777777777777,5,1020,22522860.0,204.0,204.0
2176.0,17,4,344,2,150,0.0,75.0,75.0,2,194,0.0,103.0,97.0
120324949.0,6,324,37704,162,10914,742213.1863354037,140.0,67.37037037037037,162,26790,742159.8944099379,374.0,165.37037037037038
2373.0,17,4,344,2,150,0.0,75.0,75.0,2,194,0.0,103.0,97.0
292862.0,6,18,7864,10,848,32540.222222222223,234.0,84.8,8,7016,40188.42857142857,1514.0,877.0
2653330.0,6,3,1604,2,851,0.0,785.0,425.5,1,753,0.0,753.0,753.0
119722146.0,6,48,3168,24,1584,5205310.695652174,66.0,66.0,24,1584,5195908.217391305,66.0,66.0
91485.0,17,2,762,2,762,0.0,381.0,381.0,0,0,0.0,0.0,0.0
90016746.0,17,28,13364,28,13364,3333953.5555555555,501.0,477.2857142857143,0,0,0.0,0.0,0.0
15061.0,6,10,1067,5,536,3172.5,264.0,107.2,5,531,3503.5,259.0,106.2
42242.0,6,14,4740,7,653,6697.833333333333,249.0,93.28571428571428,7,4087,6901.0,1514.0,583.8571428571429
207354.0,6,3,426,2,280,0.0,214.0,140.0,1,146,0.0,146.0,146.0
155014.0,6,3,337,2,214,0.0,160.0,107.0,1,123,0.0,123.0,123.0
39296.0,6,10,2032,5,524,9336.5,252.0,104.8,5,1508,9440.5,1236.0,301.6
103677.0,17,2,286,2,286,0.0,143.0,143.0,0,0,0.0,0.0,0.0
226537.0,6,3,426,2,280,0.0,214.0,140.0,1,146,0.0,146.0,146.0
90224126.0,6,24,1829,11,840,8997395.5,95.0,76.36363636363636,13,989,7500730.75,95.0,76.07692307692308
90052294.0,17,28,13364,28,13364,3335270.1481481483,501.0,477.2857142857143,0,0,0.0,0.0,0.0
37720.0,6,14,4740,7,653,6110.333333333333,249.0,93.28571428571428,7,4087,5851.833333333333,1514.0,583.8571428571429
20866.0,6,14,4740,7,653,3336.6666666666665,249.0,93.28571428571428,7,4087,3291.833333333333,1514.0,583.8571428571429
18633.0,6,10,2032,5,524,4433.75,252.0,104.8,5,1508,4203.25,1236.0,301.6
108104761.0,17,5,955,5,955,27026190.25,191.0,191.0,0,0,0.0,0.0,0.0
135133808.0,17,6,1206,6,1206,27026761.6,201.0,201.0,0,0,0.0,0.0,0.0
123260474.0,6,49,3234,25,1650,5135853.083333333,66.0,66.0,24,1584,4920388.869565218,66.0,66.0
41883.0,6,14,4740,7,653,6851.0,249.0,93.28571428571428,7,4087,6707.833333333333,1514.0,583.8571428571429
146251.0,6,3,337,2,214,0.0,160.0,107.0,1,123,0.0,123.0,123.0
64921.00000000001,6,12,1354,6,723,11321.8,253.0,120.5,6,631,10615.8,293.0,105.16666666666669
7075.0,17,2,582,1,83,0.0,83.0,83.0,1,499,0.0,499.0,499.0
203920.0,17,2,762,2,762,0.0,381.0,381.0,0,0,0.0,0.0,0.0
102379.0,17,2,286,2,286,0.0,143.0,143.0,0,0,0.0,0.0,0.0
101247767.0,17,14,864,7,432,16834783.0,174.0,61.71428571428572,7,432,16833505.666666668,174.0,61.71428571428572
90014105.0,17,28,13364,28,13364,3333855.7407407407,501.0,477.2857142857143,0,0,0.0,0.0,0.0
96157.0,17,2,762,2,762,0.0,381.0,381.0,0,0,0.0,0.0,0.0
18362.0,6,14,4740,7,653,2833.5,249.0,93.28571428571428,7,4087,2874.333333333333,1514.0,583.8571428571429
319.0,17,2,168,1,76,0.0,76.0,76.0,1,92,0.0,92.0,92.0
2805868.0,6,2,132,1,66,0.0,66.0,66.0,1,66,0.0,66.0,66.0
307632.0,6,6,412,4,272,102544.0,74.0,68.0,2,140,0.0,74.0,70.0
120123068.0,6,15,2428,9,1204,15015383.5,188.0,133.77777777777777,6,1224,18019400.0,204.0,204.0
90033699.0,17,28,13364,28,13364,3334581.4444444445,501.0,477.2857142857143,0,0,0.0,0.0,0.0
76297.0,6,14,4740,7,653,11044.166666666666,249.0,93.28571428571428,7,4087,12468.166666666666,1514.0,583.8571428571429
2438.0,17,4,344,2,150,0.0,75.0,75.0,2,194,0.0,103.0,97.0
3079213.0,6,4,270,2,134,0.0,68.0,67.0,2,136,0.0,70.0,68.0
204928.0,17,2,762,2,762,0.0,381.0,381.0,0,0,0.0,0.0,0.0
7394635.0,6,24,8675,14,1785,568818.0769230769,408.0,127.5,10,6890,783910.1111111111,1514.0,689.0
153419.0,17,2,180,1,90,0.0,90.0,90.0,1,90,0.0,90.0,90.0
190796.0,17,2,180,1,90,0.0,90.0,90.0,1,90,0.0,90.0,90.0
102835.0,17,2,762,2,762,0.0,381.0,381.0,0,0,0.0,0.0,0.0
57693.0,6,12,1328,7,797,9615.5,253.0,113.85714285714286,5,531,12624.75,259.0,106.2
262552.0,17,4,1400,4,1400,87517.33333333333,350.0,350.0,0,0,0.0,0.0,0.0
111211742.0,6,46,3838,25,2083,4633822.583333333,139.0,83.32,21,1755,5549780.9,123.0,83.57142857142857
3009969.0,6,11,2106,6,598,601758.0,252.0,99.66666666666669,5,1508,2239.5,1236.0,301.6
52266.0,6,14,4740,7,653,8588.166666666666,249.0,93.28571428571428,7,4087,7849.833333333333,1514.0,583.8571428571429
5629010.0,6,5,336,2,134,0.0,68.0,67.0,3,202,1424196.0,70.0,67.33333333333333
310545.0,17,4,1400,4,1400,103515.0,350.0,350.0,0,0,0.0,0.0,0.0
35572.0,6,10,2032,5,524,6659.5,252.0,104.8,5,1508,8644.75,1236.0,301.6
3361968.0,6,172,139356,97,130104,35020.5,1510.0,1341.278350515464,75,9252,41320.25675675676,1510.0,123.36
113192018.0,6,34,2350,17,1225,7061022.375,139.0,72.05882352941177,17,1125,7061017.0,123.0,66.17647058823529
4542.0,17,2,626,1,72,0.0,72.0,72.0,1,554,0.0,554.0,554.0
233547.0,6,3,337,2,214,0.0,160.0,107.0,1,123,0.0,123.0,123.0
76500.0,6,14,4740,7,653,9771.166666666666,249.0,93.28571428571428,7,4087,12364.333333333334,1514.0,583.8571428571429
105712311.0,6,27,1800,14,894,8131716.230769231,123.0,63.85714285714285,13,906,7959137.833333333,123.0,69.6923076923077
148011.0,17,2,180,1,90,0.0,90.0,90.0,1,90,0.0,90.0,90.0
106049295.0,17,14,864,7,432,17666847.666666668,174.0,61.71428571428572,7,432,17667545.666666668,174.0,61.71428571428572
28887.0,6,10,2032,5,524,7022.75,252.0,104.8,5,1508,6709.0,1236.0,301.6
2479527.0,6,25,7573,14,3735,190732.84615384616,1514.0,266.7857142857143,11,3838,221481.6,1514.0,348.90909090909093
26838.0,6,14,4740,7,653,4068.1666666666665,249.0,93.28571428571428,7,4087,3900.6666666666665,1514.0,583.8571428571429
42976.0,17,2,180,1,90,0.0,90.0,90.0,1,90,0.0,90.0,90.0
34362.0,6,10,2032,5,524,8364.0,252.0,104.8,5,1508,8247.75,1236.0,301.6
100814475.0,6,33,2428,17,1288,6287388.0,139.0,75.76470588235294,16,1140,6706517.533333333,123.0,71.25
113309614.0,6,45,2970,23,1518,5150437.0,66.0,66.0,22,1452,5108922.571428572,66.0,66.0
24924.0,6,14,4740,7,653,4044.5,249.0,93.28571428571428,7,4087,3282.1666666666665,1514.0,583.8571428571429
554527.0,6,43,28557,22,1621,26406.04761904762,215.0,73.68181818181819,21,26936,27164.8,1514.0,1282.6666666666667
202916.0,17,4,6056,4,6056,67638.66666666667,1514.0,1514.0,0,0,0.0,0.0,0.0
1299057.0,6,4,264,2,132,0.0,66.0,66.0,2,132,0.0,66.0,66.0
2779526.0,6,2,132,1,66,0.0,66.0,66.0,1,66,0.0,66.0,66.0
44118.0,6,14,4740,7,653,6724.166666666667,249.0,93.28571428571428,7,4087,5545.333333333333,1514.0,583.8571428571429
2803672.0,6,2,132,1,66,0.0,66.0,66.0,1,66,0.0,66.0,66.0
166074.0,17,4,571,2,148,0.0,74.0,74.0,2,423,0.0,280.0,211.5
22965.0,6,14,4740,7,653,3225.1666666666665,249.0,93.28571428571428,7,4087,3591.1666666666665,1514.0,583.8571428571429
114546973.0,6,222,25090,111,17468,1039473.3909090908,284.0,157.36936936936937,111,7622,1039475.4545454546,140.0,68.66666666666667
204506.0,6,10,1221,6,636,40901.2,298.0,106.0,4,585,67338.33333333333,379.0,146.25
299501.0,6,6,412,4,272,99833.66666666669,74.0,68.0,2,140,0.0,74.0,70.0
93855554.0,6,30,2122,15,1105,6688594.642857143,139.0,73.66666666666667,15,1017,6688595.0,123.0,67.8
343999.0,6,3,204,2,136,0.0,70.0,68.0,1,68,0.0,68.0,68.0
156539.0,6,3,337,2,214,0.0,160.0,107.0,1,123,0.0,123.0,123.0
321010.0,6,6,412,4,272,107003.33333333331,74.0,68.0,2,140,0.0,74.0,70.0
139978.0,6,2,132,1,66,0.0,66.0,66.0,1,66,0.0,66.0,66.0
411.0,17,2,508,2,508,0.0,257.0,254.0,0,0,0.0,0.0,0.0
14265.0,6,10,2032,5,524,3343.0,252.0,104.8,5,1508,2859.75,1236.0,301.6
35334.0,6,10,2032,5,524,8504.25,252.0,104.8,5,1508,8002.0,1236.0,301.6
306865.0,6,6,412,4,272,102288.33333333331,74.0,68.0,2,140,0.0,74.0,70.0
24676.0,6,20,7606,11,978,2401.0,310.0,88.9090909090909,9,6628,2957.0,1514.0,736.4444444444445
107655849.0,6,32,2236,16,1165,7177056.6,139.0,72.8125,16,1071,7162615.666666667,123.0,66.9375
197035.0,17,2,180,1,90,0.0,90.0,90.0,1,90,0.0,90.0,90.0
15569.0,17,4,823,2,163,0.0,89.0,81.5,2,660,0.0,443.0,330.0
2796928.0,6,2,132,1,66,0.0,66.0,66.0,1,66,0.0,66.0,66.0
244676.0,6,3,337,2,214,0.0,160.0,107.0,1,123,0.0,123.0,123.0
246166.0,6,3,337,2,214,0.0,160.0,107.0,1,123,0.0,123.0,123.0
10990.0,6,11,2098,6,590,2056.8,252.0,98.33333333333331,5,1508,2464.75,1236.0,301.6
284582.0,17,2,414,1,88,0.0,88.0,88.0,1,326,0.0,326.0,326.0
113254712.0,6,46,3036,23,1518,5135437.045454546,66.0,66.0,23,1518,5135431.045454546,66.0,66.0
27692.0,6,14,4740,7,653,3854.5,249.0,93.28571428571428,7,4087,4389.333333333333,1514.0,583.8571428571429
39046.0,6,14,4740,7,653,6301.833333333333,249.0,93.28571428571428,7,4087,5805.5,1514.0,583.8571428571429
95310384.0,6,27,1869,14,963,7331568.0,123.0,68.78571428571429,13,906,7921079.333333333,123.0,69.6923076923077
121164334.0,6,576,77858,288,19304,416936.4703832752,140.0,67.02777777777777,288,58554,422146.56097560975,480.0,203.3125
101362408.0,17,14,864,7,432,16893734.666666668,174.0,61.71428571428572,7,432,16820453.5,174.0,61.71428571428572
27398982.0,17,5,1710,5,1710,6849745.5,342.0,342.0,0,0,0.0,0.0,0.0
108102709.0,17,5,955,5,955,27025677.25,191.0,191.0,0,0,0.0,0.0,0.0
113610732.0,6,46,3036,23,1518,5150441.7727272725,66.0,66.0,23,1518,5150443.136363637,66.0,66.0
90058893.0,17,28,13364,28,13364,3335514.5555555555,501.0,477.2857142857143,0,0,0.0,0.0,0.0
9003.0,17,2,498,1,80,0.0,80.0,80.0,1,418,0.0,418.0,418.0
2575538.0,6,2,132,1,66,0.0,66.0,66.0,1,66,0.0,66.0,66.0
120099121.0,6,14,2240,6,1224,24019824.2,204.0,204.0,8,1016,17127542.714285713,188.0,127.0
107722.0,17,2,286,2,286,0.0,143.0,143.0,0,0,0.0,0.0,0.0
311618.0,6,3,202,2,128,0.0,74.0,64.0,1,74,0.0,74.0,74.0
311125.0,6,6,412,4,272,103708.33333333331,74.0,68.0,2,140,0.0,74.0,70.0
153356.0,17,2,180,1,90,0.0,90.0,90.0,1,90,0.0,90.0,90.0
90289482.0,6,16,1192,8,596,12892532.714285716,95.0,74.5,8,596,12897311.57142857,95.0,74.5
483.0,17,2,166,1,75,0.0,75.0,75.0,1,91,0.0,91.0,91.0
1556.0,17,2,192,1,88,0.0,88.0,88.0,1,104,0.0,104.0,104.0
10531576.0,6,7,478,4,272,3464916.6666666665,74.0,68.0,3,206,5197272.0,74.0,68.66666666666667
7055.0,17,2,582,1,83,0.0,83.0,83.0,1,499,0.0,499.0,499.0
322.0,17,2,174,1,79,0.0,79.0,79.0,1,95,0.0,95.0,95.0
38079.0,6,14,4740,7,653,6177.666666666667,249.0,93.28571428571428,7,4087,5217.0,1514.0,583.8571428571429
361.0,17,2,166,1,75,0.0,75.0,75.0,1,91,0.0,91.0,91.0
2975390.0,6,12,2172,7,664,495758.0,252.0,94.85714285714286,5,1508,4009.25,1236.0,301.6
120116019.0,6,13,2036,8,1016,17136470.0,188.0,127.0,5,1020,22523604.25,204.0,204.0
854883.0,6,9,1096,6,625,170976.6,287.0,104.16666666666669,3,471,289629.0,331.0,157.0
105080894.0,6,30,2106,15,1089,7490360.5,123.0,72.6,15,1017,7490361.928571428,123.0,67.8
206297.0,6,3,426,2,280,0.0,214.0,140.0,1,146,0.0,146.0,146.0
143838.0,17,2,180,1,90,0.0,90.0,90.0,1,90,0.0,90.0,90.0
228444.0,17,2,180,1,90,0.0,90.0,90.0,1,90,0.0,90.0,90.0
90262813.0,6,14,1964,8,1016,12894687.57142857,188.0,127.0,6,948,18012439.6,204.0,158.0
90029347.0,17,28,13364,28,13364,3334420.25925926,501.0,477.2857142857143,0,0,0.0,0.0,0.0
53586.0,6,14,4740,7,653,8805.666666666666,249.0,93.28571428571428,7,4087,8195.333333333334,1514.0,583.8571428571429
216316.0,17,2,180,1,90,0.0,90.0,90.0,1,90,0.0,90.0,90.0
3052493.0,6,3,204,2,136,0.0,70.0,68.0,1,68,0.0,68.0,68.0
26856.0,6,14,4740,7,653,4365.0,249.0,93.28571428571428,7,4087,4336.833333333333,1514.0,583.8571428571429
135123862.0,17,6,1146,6,1146,27024772.4,191.0,191.0,0,0,0.0,0.0,0.0
108103464.0,17,5,955,5,955,27025866.0,191.0,191.0,0,0,0.0,0.0,0.0
1537879.0,6,2,132,1,66,0.0,66.0,66.0,1,66,0.0,66.0,66.0
2804734.0,6,2,132,1,66,0.0,66.0,66.0,1,66,0.0,66.0,66.0
344.0,17,2,250,1,93,0.0,93.0,93.0,1,157,0.0,157.0,157.0
210356.0,17,2,180,1,90,0.0,90.0,90.0,1,90,0.0,90.0,90.0
354.0,17,2,160,1,80,0.0,80.0,80.0,1,80,0.0,80.0,80.0
103193978.0,17,14,864,7,432,17166825.833333332,174.0,61.71428571428572,7,432,17167955.333333332,174.0,61.71428571428572
90038491.0,17,27,12943,27,12943,3463018.8846153845,501.0,479.3703703703704,0,0,0.0,0.0,0.0
320.0,17,2,174,1,79,0.0,79.0,79.0,1,95,0.0,95.0,95.0
10532773.0,6,7,478,4,272,3465071.0,74.0,68.0,3,206,5197502.0,74.0,68.66666666666667
216628.0,17,2,180,1,90,0.0,90.0,90.0,1,90,0.0,90.0,90.0
117831089.0,6,29,1999,15,1105,8416506.357142856,139.0,73.66666666666667,14,894,8455889.076923076,123.0,63.85714285714285
136107.0,6,2,132,1,66,0.0,66.0,66.0,1,66,0.0,66.0,66.0
45290.0,6,14,4740,7,653,7357.833333333333,249.0,93.28571428571428,7,4087,6089.5,1514.0,583.8571428571429
2290.0,17,4,344,2,150,0.0,75.0,75.0,2,194,0.0,103.0,97.0
123455783.0,6,48,3168,24,1584,5111454.913043479,66.0,66.0,24,1584,5156381.130434782,66.0,66.0
6749.0,17,2,582,1,83,0.0,83.0,83.0,1,499,0.0,499.0,499.0
29360.0,6,10,2032,5,524,7133.5,252.0,104.8,5,1508,6695.5,1236.0,301.6
90217614.0,6,16,1192,8,596,12852914.714285716,95.0,74.5,8,596,12857477.857142856,95.0,74.5
90287397.0,6,16,1192,8,596,12891542.857142856,95.0,74.5,8,596,12894948.142857144,95.0,74.5
33941.0,6,2,145,2,145,0.0,91.0,72.5,0,0,0.0,0.0,0.0
2084.0,17,4,344,2,150,0.0,75.0,75.0,2,194,0.0,103.0,97.0
155703.0,6,3,337,1,123,0.0,123.0,123.0,2,214,0.0,160.0,107.0
44552.0,6,14,4740,7,653,7005.666666666667,249.0,93.28571428571428,7,4087,6824.0,1514.0,583.8571428571429
121295.0,6,3,337,2,214,0.0,160.0,107.0,1,123,0.0,123.0,123.0
101928.0,17,2,762,2,762,0.0,381.0,381.0,0,0,0.0,0.0,0.0
103436.0,17,2,286,2,286,0.0,143.0,143.0,0,0,0.0,0.0,0.0
272241.0,6,10,1221,6,636,54448.2,298.0,106.0,4,585,84932.33333333333,379.0,146.25
204846.0,17,2,762,2,762,0.0,381.0,381.0,0,0,0.0,0.0,0.0
220305.0,17,2,180,1,90,0.0,90.0,90.0,1,90,0.0,90.0,90.0
135139793.0,17,6,1146,6,1146,27027958.6,191.0,191.0,0,0,0.0,0.0,0.0
2304.0,17,4,344,2,150,0.0,75.0,75.0,2,194,0.0,103.0,97.0
2688874.0,6,2,132,1,66,0.0,66.0,66.0,1,66,0.0,66.0,66.0
0.0,6,1,172,1,172,0.0,172.0,172.0,0,0,0.0,0.0,0.0
314563.0,17,4,1400,4,1400,104854.33333333331,350.0,350.0,0,0,0.0,0.0,0.0
2573.0,17,2,762,2,762,0.0,381.0,381.0,0,0,0.0,0.0,0.0
3180068.0,6,17,1441,8,867,409712.28571428574,315.0,108.375,9,574,358465.5,78.0,63.77777777777778
2592504.0,6,2,132,1,66,0.0,66.0,66.0,1,66,0.0,66.0,66.0
506337.00000000006,6,4,270,2,134,0.0,68.0,67.0,2,136,0.0,70.0,68.0
120065475.0,17,29,13785,29,13785,4288052.678571428,501.0,475.3448275862069,0,0,0.0,0.0,0.0
558691.0,6,2,132,1,66,0.0,66.0,66.0,1,66,0.0,66.0,66.0
30885.0,6,14,4740,7,653,4879.5,249.0,93.28571428571428,7,4087,4140.0,1514.0,583.8571428571429
213873.0,6,12,1373,7,714,35645.5,298.0,102.0,5,659,52567.75,379.0,131.8
27189.0,6,10,2032,5,524,6313.75,252.0,104.8,5,1508,5117.75,1236.0,301.6
1802474.0,6,19,7533,10,1403,200274.88888888888,583.0,140.3,9,6130,192820.875,1484.0,681.1111111111111
108103503.0,17,5,1005,5,1005,27025875.75,201.0,201.0,0,0,0.0,0.0,0.0
363.0,17,2,160,1,80,0.0,80.0,80.0,1,80,0.0,80.0,80.0
41386.0,6,14,4740,7,653,5879.333333333333,249.0,93.28571428571428,7,4087,6756.333333333333,1514.0,583.8571428571429
108109530.0,17,5,955,5,955,27027382.5,191.0,191.0,0,0,0.0,0.0,0.0
135136943.0,17,6,1206,6,1206,27027388.6,201.0,201.0,0,0,0.0,0.0,0.0
90224688.0,6,16,1192,8,596,12854082.142857144,95.0,74.5,8,596,12858482.57142857,95.0,74.5
122148.0,6,3,337,2,214,0.0,160.0,107.0,1,123,0.0,123.0,123.0
117844620.0,6,48,3168,24,1584,5123679.130434782,66.0,66.0,24,1584,5110251.956521739,66.0,66.0
32822.0,6,10,2032,5,524,7982.0,252.0,104.8,5,1508,7122.25,1236.0,301.6
1471.0,17,5,550,5,550,367.75,110.0,110.0,0,0,0.0,0.0,0.0
123250505.0,6,49,3234,25,1650,5135437.708333333,66.0,66.0,24,1584,5130148.652173913,66.0,66.0
148072.0,17,2,180,1,90,0.0,90.0,90.0,1,90,0.0,90.0,90.0
8998.0,17,2,498,1,80,0.0,80.0,80.0,1,418,0.0,418.0,418.0
196848.0,17,2,180,1,90,0.0,90.0,90.0,1,90,0.0,90.0,90.0
153401.0,17,2,180,1,90,0.0,90.0,90.0,1,90,0.0,90.0,90.0
135153551.0,17,6,1146,6,1146,27030710.2,191.0,191.0,0,0,0.0,0.0,0.0
1312957.0,6,4,264,2,132,0.0,66.0,66.0,2,132,0.0,66.0,66.0
40327.0,6,12,1447,6,816,7108.8,291.0,136.0,6,631,7236.8,293.0,105.16666666666669
92393527.0,6,25,1924,14,1084,7107089.923076923,95.0,77.42857142857143,11,840,9238971.8,95.0,76.36363636363636
28131.0,6,10,2032,5,524,6629.5,252.0,104.8,5,1508,6540.0,1236.0,301.6
146509.0,6,3,337,2,214,0.0,160.0,107.0,1,123,0.0,123.0,123.0
104125.0,17,2,286,2,286,0.0,143.0,143.0,0,0,0.0,0.0,0.0
101001012.0,17,13,821,7,432,16833502.0,174.0,61.71428571428572,6,389,16200803.4,174.0,64.83333333333333
57228913.0,17,9,3086,8,2736,5178141.0,342.0,342.0,1,350,0.0,350.0,350.0
62991220.0,6,9,1479,9,1479,7873902.5,172.0,164.33333333333334,0,0,0.0,0.0,0.0
396597.0,6,10,1221,6,636,79319.4,298.0,106.0,4,585,125459.0,379.0,146.25
108688292.0,6,32,2220,16,1149,7245886.133333334,123.0,71.8125,16,1071,7231480.266666667,123.0,66.9375
2309.0,17,4,344,2,150,0.0,75.0,75.0,2,194,0.0,103.0,97.0
100290.0,17,2,762,2,762,0.0,381.0,381.0,0,0,0.0,0.0,0.0
217521.0,6,13,1394,7,797,36253.5,253.0,113.85714285714286,6,597,41473.8,259.0,99.5
14916.0,6,14,4740,7,653,2314.1666666666665,249.0,93.28571428571428,7,4087,2270.1666666666665,1514.0,583.8571428571429
59155.0,6,11,2098,6,590,11533.8,252.0,98.33333333333331,5,1508,14309.75,1236.0,301.6
302149.0,6,6,412,4,272,100716.33333333331,74.0,68.0,2,140,0.0,74.0,70.0
34667.0,6,14,4740,7,653,5570.5,249.0,93.28571428571428,7,4087,5184.833333333333,1514.0,583.8571428571429
10469332.0,6,7,478,4,272,3441639.0,74.0,68.0,3,206,5162361.0,74.0,68.66666666666667
303643.0,6,2,132,1,66,0.0,66.0,66.0,1,66,0.0,66.0,66.0
112894.0,17,2,286,2,286,0.0,143.0,143.0,0,0,0.0,0.0,0.0
31884.000000000004,6,14,4740,7,653,4669.166666666667,249.0,93.28571428571428,7,4087,4182.833333333333,1514.0,583.8571428571429
96890.0,17,2,762,2,762,0.0,381.0,381.0,0,0,0.0,0.0,0.0
447856.0,6,11,1021,6,444,60827.8,162.0,74.0,5,577,75834.0,349.0,115.4
120122746.0,6,14,2240,6,1224,24024549.2,204.0,204.0,8,1016,17097145.57142857,188.0,127.0
42406.0,6,10,2032,5,524,8312.25,252.0,104.8,5,1508,9924.25,1236.0,301.6
135130722.0,17,6,1206,6,1206,27026144.4,201.0,201.0,0,0,0.0,0.0,0.0
108591011.0,6,32,2374,17,1288,6773447.5,139.0,75.76470588235294,15,1086,7741073.285714285,123.0,72.4
50087.0,6,14,4740,7,653,6282.166666666667,249.0,93.28571428571428,7,4087,7147.333333333333,1514.0,583.8571428571429
0.0,6,1,66,0,0,0.0,0.0,0.0,1,66,0.0,66.0,66.0
114984377.0,6,47,3102,24,1584,4999320.739130435,66.0,66.0,23,1518,5212698.454545454,66.0,66.0
120332331.0,6,222,25102,111,7634,1067744.4181818182,140.0,68.77477477477477,111,17468,1086537.818181818,284.0,157.36936936936937
298546.0,6,6,412,4,272,99515.33333333331,74.0,68.0,2,140,0.0,74.0,70.0
50336.0,6,10,2032,5,524,10713.5,252.0,104.8,5,1508,12310.5,1236.0,301.6
438306.0,6,11,1021,6,444,58860.4,162.0,74.0,5,577,73397.25,349.0,115.4
2599623.0,6,2,132,1,66,0.0,66.0,66.0,1,66,0.0,66.0,66.0
40288.0,6,14,4740,7,653,6598.166666666667,249.0,93.28571428571428,7,4087,6326.0,1514.0,583.8571428571429
3776926.0,6,4,270,2,134,0.0,68.0,67.0,2,136,0.0,70.0,68.0
136951.0,6,2,132,1,66,0.0,66.0,66.0,1,66,0.0,66.0,66.0
262762.0,6,10,1221,6,636,52552.4,298.0,106.0,4,585,81242.33333333333,379.0,146.25
90256921.0,6,12,1832,8,1016,12893845.857142856,188.0,127.0,4,816,30031320.666666668,204.0,204.0
120068487.0,17,28,13364,28,13364,4446981.0,501.0,477.2857142857143,0,0,0.0,0.0,0.0
34209.0,6,14,4740,7,653,5365.666666666667,249.0,93.28571428571428,7,4087,4783.833333333333,1514.0,583.8571428571429
209205.0,6,3,426,2,280,0.0,214.0,140.0,1,146,0.0,146.0,146.0
233405.0,6,10,1221,6,636,46681.0,298.0,106.0,4,585,76196.66666666667,379.0,146.25
1086156.0,6,13,1386,7,789,181026.0,253.0,112.71428571428572,6,597,216274.6,259.0,99.5
107984.0,17,2,700,2,700,0.0,350.0,350.0,0,0,0.0,0.0,0.0
171749.0,17,2,180,1,90,0.0,90.0,90.0,1,90,0.0,90.0,90.0
5504.0,17,2,762,2,762,0.0,381.0,381.0,0,0,0.0,0.0,0.0
2340100.0,6,3,204,2,136,0.0,70.0,68.0,1,68,0.0,68.0,68.0
40812.0,6,10,2032,5,524,8675.25,252.0,104.8,5,1508,8722.75,1236.0,301.6
165763.0,17,2,180,1,90,0.0,90.0,90.0,1,90,0.0,90.0,90.0
218791.0,6,12,1373,7,714,36465.16666666666,298.0,102.0,5,659,53852.0,379.0,131.8
1180256.0,6,13,3010,8,2382,168608.0,1514.0,297.75,5,628,226120.75,331.0,125.6
120366523.0,6,231,26240,116,18354,1046665.4173913044,374.0,158.22413793103448,115,7886,1046840.4824561405,140.0,68.57391304347826
13920680.0,17,6,2052,6,2052,2784136.0,342.0,342.0,0,0,0.0,0.0,0.0
2584378.0,6,2,132,1,66,0.0,66.0,66.0,1,66,0.0,66.0,66.0
281542.0,17,2,363,1,79,0.0,79.0,79.0,1,284,0.0,284.0,284.0
33662.0,6,10,2032,5,524,7922.0,252.0,104.8,5,1508,6463.5,1236.0,301.6
46495.0,6,14,4740,7,653,7626.166666666667,249.0,93.28571428571428,7,4087,6766.833333333333,1514.0,583.8571428571429
90008747.0,17,27,12943,27,12943,3461874.8846153845,501.0,479.3703703703704,0,0,0.0,0.0,0.0
48842.0,6,14,4740,7,653,8007.333333333333,249.0,93.28571428571428,7,4087,7614.5,1514.0,583.8571428571429
2780988.0,6,2,132,1,66,0.0,66.0,66.0,1,66,0.0,66.0,66.0
731730.0,6,14,4740,7,653,121376.5,249.0,93.28571428571428,7,4087,121453.5,1514.0,583.8571428571429
302202.0,6,6,412,4,272,100734.0,74.0,68.0,2,140,0.0,74.0,70.0
241884.0,6,3,337,2,214,0.0,160.0,107.0,1,123,0.0,123.0,123.0
53627.0,6,11,2098,6,590,9834.0,252.0,98.33333333333331,5,1508,13151.0,1236.0,301.6
2802640.0,6,2,132,1,66,0.0,66.0,66.0,1,66,0.0,66.0,66.0
204419.0,17,2,762,2,762,0.0,381.0,381.0,0,0,0.0,0.0,0.0
37681.0,6,10,2032,5,524,8684.25,252.0,104.8,5,1508,9015.0,1236.0,301.6
90214982.0,6,19,1436,9,691,11246643.75,95.0,76.77777777777777,10,745,10001131.333333334,95.0,74.5
12345.0,6,13,1459,7,862,2007.0,271.0,123.14285714285714,6,597,2226.6,259.0,99.5
31231.0,6,10,2032,5,524,7569.75,252.0,104.8,5,1508,7158.0,1236.0,301.6
36584.0,6,14,4740,7,653,5896.666666666667,249.0,93.28571428571428,7,4087,4857.666666666667,1514.0,583.8571428571429
44185.0,6,14,4740,7,653,7182.166666666667,249.0,93.28571428571428,7,4087,7167.666666666667,1514.0,583.8571428571429
90095163.0,6,12,1848,5,1020,22522696.0,204.0,204.0,7,828,15015356.166666666,188.0,118.28571428571428
117865168.0,6,38,2848,20,1531,6192632.736842105,139.0,76.55,18,1317,6921190.764705882,123.0,73.16666666666667
113344252.0,6,46,3036,23,1518,5152000.2727272725,66.0,66.0,23,1518,5152000.136363637,66.0,66.0
206407.0,6,3,426,2,280,0.0,214.0,140.0,1,146,0.0,146.0,146.0
108972974.0,6,32,2220,16,1149,7250478.2,123.0,71.8125,16,1071,7250484.533333333,123.0,66.9375
158457.0,6,13,1386,7,789,26409.5,253.0,112.71428571428572,6,597,29739.4,259.0,99.5
125326680.0,6,32,2220,16,1071,7689451.4,123.0,66.9375,16,1149,7842474.4,123.0,71.8125
37103.0,6,14,4740,7,653,5992.666666666667,249.0,93.28571428571428,7,4087,5974.333333333333,1514.0,583.8571428571429
147997.0,17,2,180,1,90,0.0,90.0,90.0,1,90,0.0,90.0,90.0
2448.0,17,4,344,2,150,0.0,75.0,75.0,2,194,0.0,103.0,97.0
449266.0,6,11,1021,6,444,61111.4,162.0,74.0,5,577,76211.0,349.0,115.4
756939.0,6,2,132,1,66,0.0,66.0,66.0,1,66,0.0,66.0,66.0
2025.0,17,2,664,1,322,0.0,322.0,322.0,1,342,0.0,342.0,342.0
102897.0,17,2,286,2,286,0.0,143.0,143.0,0,0,0.0,0.0,0.0
22251.0,6,14,4740,7,653,3562.833333333333,249.0,93.28571428571428,7,4087,3495.833333333333,1514.0,583.8571428571429
302377.0,6,2,132,1,66,0.0,66.0,66.0,1,66,0.0,66.0,66.0
53655.0,6,14,4740,7,653,8338.333333333334,249.0,93.28571428571428,7,4087,7932.166666666667,1514.0,583.8571428571429
107789.0,17,2,286,2,286,0.0,143.0,143.0,0,0,0.0,0.0,0.0
56304.0,6,10,2032,5,524,13835.75,252.0,104.8,5,1508,13811.25,1236.0,301.6
201791.0,17,4,6056,4,6056,67263.66666666667,1514.0,1514.0,0,0,0.0,0.0,0.0
206118.0,6,3,426,2,280,0.0,214.0,140.0,1,146,0.0,146.0,146.0
298807.0,6,6,412,4,272,99602.33333333331,74.0,68.0,2,140,0.0,74.0,70.0
31666.0,6,14,4740,7,653,4972.333333333333,249.0,93.28571428571428,7,4087,5140.333333333333,1514.0,583.8571428571429
283861.0,17,2,363,1,79,0.0,79.0,79.0,1,284,0.0,284.0,284.0
232147.0,6,3,337,2,214,0.0,160.0,107.0,1,123,0.0,123.0,123.0
233188.0,6,3,337,2,214,0.0,160.0,107.0,1,123,0.0,123.0,123.0
37016.0,6,14,4740,7,653,5924.833333333333,249.0,93.28571428571428,7,4087,5730.333333333333,1514.0,583.8571428571429
91441873.0,6,22,1680,12,935,8312552.909090909,95.0,77.91666666666667,10,745,10159236.777777778,95.0,74.5
76705483.0,17,14,4788,14,4788,5900421.769230769,342.0,342.0,0,0,0.0,0.0,0.0
96884407.0,6,321,38352,161,27570,605527.54375,374.0,171.24223602484471,160,10782,602871.2955974842,140.0,67.3875
132001123.0,17,15,907,8,475,18857303.285714287,174.0,59.375,7,432,18676742.33333333,174.0,61.71428571428572
1314766.0,6,4,264,2,132,0.0,66.0,66.0,2,132,0.0,66.0,66.0
3322675.0,6,221,169882,117,158715,28552.068965517243,1510.0,1356.5384615384614,104,11167,29220.81553398058,1510.0,107.375
321112.0,6,6,412,4,272,107037.33333333331,74.0,68.0,2,140,0.0,74.0,70.0
38474.0,6,14,4740,7,653,6259.0,249.0,93.28571428571428,7,4087,5356.333333333333,1514.0,583.8571428571429
359.0,17,2,152,1,76,0.0,76.0,76.0,1,76,0.0,76.0,76.0
114216137.0,6,45,2970,23,1518,5191631.409090909,66.0,66.0,22,1452,5137491.047619048,66.0,66.0
207806.0,17,2,604,1,75,0.0,75.0,75.0,1,529,0.0,529.0,529.0
222097.0,6,10,1221,6,636,44419.4,298.0,106.0,4,585,72211.33333333333,379.0,146.25
120005274.0,17,28,13364,28,13364,4444639.777777778,501.0,477.2857142857143,0,0,0.0,0.0,0.0
305766.0,6,6,412,4,272,101922.0,74.0,68.0,2,140,0.0,74.0,70.0
301992.0,6,6,412,4,272,100664.0,74.0,68.0,2,140,0.0,74.0,70.0
51784.0,6,14,4740,7,653,8471.0,249.0,93.28571428571428,7,4087,7524.666666666667,1514.0,583.8571428571429
143999.0,17,2,180,1,90,0.0,90.0,90.0,1,90,0.0,90.0,90.0
120048833.0,17,29,13785,29,13785,4287458.321428572,501.0,475.3448275862069,0,0,0.0,0.0,0.0
1770418.0,6,2,132,1,66,0.0,66.0,66.0,1,66,0.0,66.0,66.0
57095.0,6,14,4740,7,653,9394.5,249.0,93.28571428571428,7,4087,9372.333333333334,1514.0,583.8571428571429
50532.0,6,10,2032,5,524,12404.25,252.0,104.8,5,1508,11888.75,1236.0,301.6
189352.0,6,13,1386,7,789,31558.666666666668,253.0,112.71428571428572,6,597,35877.8,259.0,99.5
896.0,17,4,438,2,148,0.0,74.0,74.0,2,290,0.0,147.0,145.0
316270.0,17,4,622,4,622,105423.33333333331,163.0,155.5,0,0,0.0,0.0,0.0
181460.0,6,11,1132,6,556,36068.2,218.0,92.66666666666669,5,576,44963.25,304.0,115.2
316736.0,17,2,335,1,88,0.0,88.0,88.0,1,247,0.0,247.0,247.0
115490322.0,6,198,22314,99,15558,1176316.5612244897,284.0,157.15151515151516,99,6756,1176316.4897959183,140.0,68.24242424242425
44236.0,6,14,4740,7,653,5239.5,249.0,93.28571428571428,7,4087,5072.0,1514.0,583.8571428571429
10515662.0,6,7,478,4,272,3459863.0,74.0,68.0,3,206,5189681.5,74.0,68.66666666666667
12769.0,6,11,2098,6,590,2338.8,252.0,98.33333333333331,5,1508,2871.75,1236.0,301.6
310369.0,17,4,1400,4,1400,103456.33333333331,350.0,350.0,0,0,0.0,0.0,0.0
276285.0,6,10,1221,6,636,55257.0,298.0,106.0,4,585,86402.33333333333,379.0,146.25
255446.0,6,3,373,2,238,0.0,172.0,119.0,1,135,0.0,135.0,135.0
143906.0,17,2,180,1,90,0.0,90.0,90.0,1,90,0.0,90.0,90.0
135131734.0,17,6,1206,6,1206,27026346.8,201.0,201.0,0,0,0.0,0.0,0.0
125328211.0,17,16,1343,9,780,15666026.375,174.0,86.66666666666667,7,563,17500682.666666668,174.0,80.42857142857143
43234.0,6,14,4740,7,653,6568.5,249.0,93.28571428571428,7,4087,6165.333333333333,1514.0,583.8571428571429
120611086.0,6,236,26660,118,8010,1021147.4615384616,140.0,67.88135593220339,118,18650,1024870.5982905984,284.0,158.05084745762713
120120843.0,6,14,2224,9,1204,15015105.375,188.0,133.77777777777777,5,1020,22522398.75,204.0,204.0
132560.0,6,12,1320,6,723,26002.4,253.0,120.5,6,597,23011.8,259.0,99.5
47612922.0,6,8,2113,3,960,22538796.5,826.0,320.0,5,1153,11260097.75,885.0,230.6
90276741.0,6,16,1192,8,596,12896677.285714284,95.0,74.5,8,596,12856134.142857144,95.0,74.5
135129163.0,17,6,1206,6,1206,27025832.6,201.0,201.0,0,0,0.0,0.0,0.0
153410.0,17,2,180,1,90,0.0,90.0,90.0,1,90,0.0,90.0,90.0
304342.0,17,4,820,2,156,0.0,78.0,78.0,2,664,0.0,332.0,332.0
4492.0,17,2,614,1,72,0.0,72.0,72.0,1,542,0.0,542.0,542.0
257234.00000000003,17,4,6056,4,6056,85744.66666666667,1514.0,1514.0,0,0,0.0,0.0,0.0
104751450.0,6,378,44492,189,31722,556100.2234042553,374.0,167.84126984126985,189,12770,556100.2180851063,140.0,67.56613756613757
29775.0,6,14,4740,7,653,4298.833333333333,249.0,93.28571428571428,7,4087,3108.5,1514.0,583.8571428571429
41883.0,6,14,4740,7,653,6492.5,249.0,93.28571428571428,7,4087,6730.333333333333,1514.0,583.8571428571429
224457.0,6,3,426,2,280,0.0,214.0,140.0,1,146,0.0,146.0,146.0
120063717.0,17,28,13364,28,13364,4446804.333333333,501.0,477.2857142857143,0,0,0.0,0.0,0.0
307035.0,6,6,412,4,272,102345.0,74.0,68.0,2,140,0.0,74.0,70.0
20013.0,17,2,582,1,83,0.0,83.0,83.0,1,499,0.0,499.0,499.0
196883.0,17,2,180,1,90,0.0,90.0,90.0,1,90,0.0,90.0,90.0
2401328.0,6,32,10926,18,3951,141254.58823529413,1514.0,219.5,14,6975,165013.53846153847,1514.0,498.2142857142857
108105494.0,17,5,955,5,955,27026373.5,191.0,191.0,0,0,0.0,0.0,0.0
106833.0,6,14,4740,7,653,16956.666666666668,249.0,93.28571428571428,7,4087,17617.5,1514.0,583.8571428571429
833.0,17,4,438,2,148,0.0,74.0,74.0,2,290,0.0,147.0,145.0
90033738.0,17,28,13364,28,13364,3334582.888888889,501.0,477.2857142857143,0,0,0.0,0.0,0.0
2413.0,17,4,344,2,150,0.0,75.0,75.0,2,194,0.0,103.0,97.0
500683.0,6,5,336,2,134,0.0,68.0,67.0,3,202,187938.0,70.0,67.33333333333333
2323.0,17,4,344,2,150,0.0,75.0,75.0,2,194,0.0,103.0,97.0
51168.0,17,2,180,1,90,0.0,90.0,90.0,1,90,0.0,90.0,90.0
315371.0,17,4,1400,4,1400,105123.66666666669,350.0,350.0,0,0,0.0,0.0,0.0
2366.0,17,4,344,2,150,0.0,75.0,75.0,2,194,0.0,103.0,97.0
90260331.0,6,12,1876,8,1080,12894333.0,204.0,135.0,4,796,30032437.33333333,199.0,199.0
108109112.0,17,5,955,5,955,27027278.0,191.0,191.0,0,0,0.0,0.0,0.0
23894.0,6,10,2032,5,524,5741.5,252.0,104.8,5,1508,5544.75,1236.0,301.6
90091574.0,6,10,1440,7,828,15015262.333333334,188.0,118.28571428571428,3,612,30030305.5,204.0,204.0
37282.0,6,14,4740,7,653,6035.0,249.0,93.28571428571428,7,4087,5990.5,1514.0,583.8571428571429
468507.0,17,2,363,1,75,0.0,75.0,75.0,1,288,0.0,288.0,288.0
313912.0,6,6,412,4,272,104637.33333333331,74.0,68.0,2,140,0.0,74.0,70.0
23087.0,6,14,4740,7,653,3657.6666666666665,249.0,93.28571428571428,7,4087,3669.5,1514.0,583.8571428571429
228490.0,17,2,180,1,90,0.0,90.0,90.0,1,90,0.0,90.0,90.0
275237.0,17,2,238,1,74,0.0,74.0,74.0,1,164,0.0,164.0,164.0
77686.0,6,12,1320,6,723,13217.8,253.0,120.5,6,597,14065.2,259.0,99.5
2154327.0,6,19,6869,11,1567,215432.7,408.0,142.45454545454547,8,5302,247617.8571428572,1514.0,662.75
39069.0,6,14,4740,7,653,6391.666666666667,249.0,93.28571428571428,7,4087,5781.5,1514.0,583.8571428571429
1478.0,17,2,762,2,762,0.0,381.0,381.0,0,0,0.0,0.0,0.0
149714.0,17,2,180,1,90,0.0,90.0,90.0,1,90,0.0,90.0,90.0
5602391.0,6,4,270,2,134,0.0,68.0,67.0,2,136,0.0,70.0,68.0
42129.0,6,14,4740,7,653,5988.0,249.0,93.28571428571428,7,4087,6220.666666666667,1514.0,583.8571428571429
12649.0,6,13,1459,7,862,1964.8333333333333,271.0,123.14285714285714,6,597,2326.0,259.0,99.5
59471036.0,6,8,1307,8,1307,8495862.285714285,172.0,163.375,0,0,0.0,0.0,0.0
949751.0,6,12,1354,6,723,188801.6,253.0,120.5,6,631,189677.2,293.0,105.16666666666669
45995.0,6,14,4740,7,653,7539.333333333333,249.0,93.28571428571428,7,4087,7316.666666666667,1514.0,583.8571428571429
102201.0,17,2,286,2,286,0.0,143.0,143.0,0,0,0.0,0.0,0.0
119368798.0,6,33,2280,17,1209,7447060.0625,123.0,71.11764705882354,16,1071,7943532.133333334,123.0,66.9375
326.0,17,2,191,1,73,0.0,73.0,73.0,1,118,0.0,118.0,118.0
108104442.0,17,5,1005,5,1005,27026110.5,201.0,201.0,0,0,0.0,0.0,0.0
1310792.0,6,4,264,2,132,0.0,66.0,66.0,2,132,0.0,66.0,66.0
58530.0,6,14,4740,7,653,8490.5,249.0,93.28571428571428,7,4087,9557.833333333334,1514.0,583.8571428571429
46762.0,6,10,2032,5,524,11463.75,252.0,104.8,5,1508,7889.75,1236.0,301.6
29565.0,6,14,4740,7,653,4796.333333333333,249.0,93.28571428571428,7,4087,4767.5,1514.0,583.8571428571429
14157.0,6,14,4740,7,653,2188.0,249.0,93.28571428571428,7,4087,2211.833333333333,1514.0,583.8571428571429
300249.0,6,6,412,4,272,100083.0,74.0,68.0,2,140,0.0,74.0,70.0
302527.0,6,2,132,1,66,0.0,66.0,66.0,1,66,0.0,66.0,66.0
190919.0,17,2,180,1,90,0.0,90.0,90.0,1,90,0.0,90.0,90.0
26437.0,6,14,4740,7,653,3981.6666666666665,249.0,93.28571428571428,7,4087,3888.0,1514.0,583.8571428571429
311359.0,6,6,412,4,272,103786.33333333331,74.0,68.0,2,140,0.0,74.0,70.0
43041.0,6,10,2032,5,524,10532.25,252.0,104.8,5,1508,9919.5,1236.0,301.6
102528343.0,17,14,864,7,432,17001779.833333332,174.0,61.71428571428572,7,432,17000149.833333332,174.0,61.71428571428572
280.0,17,2,174,1,79,0.0,79.0,79.0,1,95,0.0,95.0,95.0
108103081.0,17,5,955,5,955,27025770.25,191.0,191.0,0,0,0.0,0.0,0.0
335.0,17,2,166,1,75,0.0,75.0,75.0,1,91,0.0,91.0,91.0
215324.0,17,2,180,1,90,0.0,90.0,90.0,1,90,0.0,90.0,90.0
316743.0,17,4,1400,4,1400,105581.0,350.0,350.0,0,0,0.0,0.0,0.0
237259.0,17,2,180,1,90,0.0,90.0,90.0,1,90,0.0,90.0,90.0
115350646.0,6,47,3102,23,1518,5160007.909090909,66.0,66.0,24,1584,5015234.869565218,66.0,66.0
106625810.0,6,44,2904,22,1452,5077419.523809524,66.0,66.0,22,1452,5064427.476190476,66.0,66.0
9829.0,17,2,571,1,86,0.0,86.0,86.0,1,485,0.0,485.0,485.0
308366.0,6,6,412,4,272,102788.66666666669,74.0,68.0,2,140,0.0,74.0,70.0
43752.0,6,14,4740,7,653,7168.5,249.0,93.28571428571428,7,4087,6648.166666666667,1514.0,583.8571428571429
2412741.0,6,3,1604,2,851,0.0,785.0,425.5,1,753,0.0,753.0,753.0
107725.0,17,2,286,2,286,0.0,143.0,143.0,0,0,0.0,0.0,0.0
151464.0,17,2,414,1,88,0.0,88.0,88.0,1,326,0.0,326.0,326.0
3578305.0,6,173,139031,98,129779,36889.74226804124,1510.0,1324.2755102040817,75,9252,44063.0,1510.0,123.36
298206.0,6,6,412,4,272,99402.0,74.0,68.0,2,140,0.0,74.0,70.0
90024304.0,17,28,13364,28,13364,3334233.4814814813,501.0,477.2857142857143,0,0,0.0,0.0,0.0
254761.00000000003,17,4,6056,4,6056,84920.33333333333,1514.0,1514.0,0,0,0.0,0.0,0.0
99418555.0,17,12,778,6,389,19876265.0,174.0,64.83333333333333,6,389,19851924.6,174.0,64.83333333333333
17908.0,6,10,2032,5,524,4219.75,252.0,104.8,5,1508,4072.75,1236.0,301.6
2371803.0,6,2,132,1,66,0.0,66.0,66.0,1,66,0.0,66.0,66.0
30781.0,6,14,4740,7,653,4860.666666666667,249.0,93.28571428571428,7,4087,4991.666666666667,1514.0,583.8571428571429
207816.0,6,3,426,2,280,0.0,214.0,140.0,1,146,0.0,146.0,146.0
197341.0,17,2,180,1,90,0.0,90.0,90.0,1,90,0.0,90.0,90.0
10908.0,6,11,2098,6,590,2078.0,252.0,98.33333333333331,5,1508,2403.75,1236.0,301.6
2301.0,17,4,344,2,150,0.0,75.0,75.0,2,194,0.0,103.0,97.0
2569676.0,6,3,202,1,66,0.0,66.0,66.0,2,136,0.0,70.0,68.0
206733.0,6,3,426,2,280,0.0,214.0,140.0,1,146,0.0,146.0,146.0
90307696.0,6,13,1898,8,1016,12901099.42857143,188.0,127.0,5,882,22532835.0,204.0,176.4
235499.0,6,3,373,2,238,0.0,172.0,119.0,1,135,0.0,135.0,135.0
105972.0,17,2,700,2,700,0.0,350.0,350.0,0,0,0.0,0.0,0.0
5620956.0,6,4,270,2,134,0.0,68.0,67.0,2,136,0.0,70.0,68.0
45681.0,6,10,2032,5,524,10071.5,252.0,104.8,5,1508,7700.25,1236.0,301.6
1477366.0,6,4,276,2,128,0.0,74.0,64.0,2,148,0.0,74.0,74.0
48903.0,6,14,4740,7,653,7983.166666666667,249.0,93.28571428571428,7,4087,7223.5,1514.0,583.8571428571429
2387.0,17,4,344,2,150,0.0,75.0,75.0,2,194,0.0,103.0,97.0
2196.0,17,4,344,2,150,0.0,75.0,75.0,2,194,0.0,103.0,97.0
5638197.0,6,5,336,2,134,0.0,68.0,67.0,3,202,1429348.5,70.0,67.33333333333333
280190.0,6,10,1221,6,636,56038.0,298.0,106.0,4,585,84552.66666666667,379.0,146.25
40241.0,6,14,4740,7,653,6481.0,249.0,93.28571428571428,7,4087,6154.333333333333,1514.0,583.8571428571429
299811.0,6,6,412,4,272,99937.0,74.0,68.0,2,140,0.0,74.0,70.0
312847.0,6,3,202,2,128,0.0,74.0,64.0,1,74,0.0,74.0,74.0
117408065.0,6,215,24284,108,7350,1097271.6355140186,140.0,68.05555555555556,107,16934,1097857.1320754718,284.0,158.26168224299064
119707019.0,17,34,16284,34,16284,3627485.424242424,501.0,478.9411764705882,0,0,0.0,0.0,0.0
216505.0,17,2,180,1,90,0.0,90.0,90.0,1,90,0.0,90.0,90.0
61631.0,6,10,2032,5,524,15172.75,252.0,104.8,5,1508,13110.0,1236.0,301.6
143928.0,17,2,180,1,90,0.0,90.0,90.0,1,90,0.0,90.0,90.0
53014.0,6,14,4740,7,653,8557.166666666666,249.0,93.28571428571428,7,4087,7008.333333333333,1514.0,583.8571428571429
10188.0,17,4,823,2,163,0.0,89.0,81.5,2,660,0.0,443.0,330.0
103460.0,17,2,286,2,286,0.0,143.0,143.0,0,0,0.0,0.0,0.0
90294278.0,6,16,1192,8,596,12892764.142857144,95.0,74.5,8,596,12898473.857142856,95.0,74.5
197028.0,17,2,180,1,90,0.0,90.0,90.0,1,90,0.0,90.0,90.0
305502.0,6,3,202,2,128,0.0,74.0,64.0,1,74,0.0,74.0,74.0
90292127.0,6,16,1192,8,596,12893171.285714284,95.0,74.5,8,596,12898211.714285716,95.0,74.5
123839757.0,6,48,3168,24,1584,5059055.608695652,66.0,66.0,24,1584,5238537.0,66.0,66.0
98076565.0,6,191,21688,96,6558,1032384.894736842,140.0,68.3125,95,15130,1032310.3510638296,284.0,159.26315789473685
435706.0,6,11,1021,6,444,58389.2,162.0,74.0,5,577,72902.0,349.0,115.4
46646.0,6,10,2032,5,524,9353.5,252.0,104.8,5,1508,10334.75,1236.0,301.6
10437236.0,6,7,478,4,272,3433604.6666666665,74.0,68.0,3,206,5150098.0,74.0,68.66666666666667
93010420.0,6,179,20160,90,6162,1044687.4719101124,140.0,68.46666666666667,89,13998,1050579.818181818,284.0,157.2808988764045
120061435.0,17,28,13364,28,13364,4446719.814814814,501.0,477.2857142857143,0,0,0.0,0.0,0.0
288287.0,17,2,180,1,90,0.0,90.0,90.0,1,90,0.0,90.0,90.0
20554.0,17,2,582,1,83,0.0,83.0,83.0,1,499,0.0,499.0,499.0
10534.0,17,2,582,1,83,0.0,83.0,83.0,1,499,0.0,499.0,499.0
90258784.0,6,12,1832,8,1016,12894112.0,188.0,127.0,4,816,30031535.33333333,204.0,204.0
116239689.0,6,35,2542,18,1348,6824917.94117647,139.0,74.88888888888889,17,1194,7251490.0625,123.0,70.23529411764706
2616990.0,6,3,1604,1,753,0.0,753.0,753.0,2,851,0.0,785.0,425.5
210462.0,6,3,426,2,280,0.0,214.0,140.0,1,146,0.0,146.0,146.0
102968.0,17,2,762,2,762,0.0,381.0,381.0,0,0,0.0,0.0,0.0
10472410.0,6,7,478,4,272,3445064.0,74.0,68.0,3,206,5167490.5,74.0,68.66666666666667
98691701.0,6,893,212266,436,29602,226834.17931034483,214.0,67.89449541284404,457,182664,216403.45614035087,1514.0,399.7024070021882
1169898.0,6,13,3020,8,2392,167128.2857142857,1514.0,299.0,5,628,223581.0,331.0,125.6
135132489.0,17,6,1146,6,1146,27026497.8,191.0,191.0,0,0,0.0,0.0,0.0
108434.0,17,2,762,2,762,0.0,381.0,381.0,0,0,0.0,0.0,0.0
114288204.0,6,47,3102,24,1584,4969041.478260869,66.0,66.0,23,1518,5143988.318181818,66.0,66.0
109229.0,17,4,1400,4,1400,36409.66666666666,350.0,350.0,0,0,0.0,0.0,0.0
332031.0,6,6,412,4,272,110677.0,74.0,68.0,2,140,0.0,74.0,70.0
206347.0,6,3,426,2,280,0.0,214.0,140.0,1,146,0.0,146.0,146.0
209376.0,17,2,180,1,90,0.0,90.0,90.0,1,90,0.0,90.0,90.0
90530138.0,6,13,2036,8,1016,12932876.857142856,188.0,127.0,5,1020,22592278.75,204.0,204.0
179841.0,17,2,180,1,90,0.0,90.0,90.0,1,90,0.0,90.0,90.0
241745.0,6,3,373,2,238,0.0,172.0,119.0,1,135,0.0,135.0,135.0
90309970.0,6,21,1585,11,840,9025918.1,95.0,76.36363636363636,10,745,9949020.444444444,95.0,74.5
121110819.0,6,46,3036,24,1584,5265687.782608695,66.0,66.0,22,1452,5019485.19047619,66.0,66.0
218716.0,6,3,426,2,280,0.0,214.0,140.0,1,146,0.0,146.0,146.0
100807.0,17,2,762,2,762,0.0,381.0,381.0,0,0,0.0,0.0,0.0
36103.0,6,14,4740,7,653,5896.666666666667,249.0,93.28571428571428,7,4087,5810.666666666667,1514.0,583.8571428571429
680.0,17,2,762,2,762,0.0,381.0,381.0,0,0,0.0,0.0,0.0
135145463.0,17,6,1146,6,1146,27029092.6,191.0,191.0,0,0,0.0,0.0,0.0
90263462.0,6,12,1832,8,1016,12894780.285714284,188.0,127.0,4,816,30032398.0,204.0,204.0
301.0,17,2,168,1,76,0.0,76.0,76.0,1,92,0.0,92.0,92.0
5569.0,17,4,823,2,163,0.0,89.0,81.5,2,660,0.0,443.0,330.0
2334.0,17,4,344,2,150,0.0,75.0,75.0,2,194,0.0,103.0,97.0
106181169.0,6,31,2113,16,1071,7078744.6,123.0,66.9375,15,1042,7568860.5,139.0,69.46666666666667
791.0,17,4,438,2,148,0.0,74.0,74.0,2,290,0.0,147.0,145.0
297.0,17,2,156,1,78,0.0,78.0,78.0,1,78,0.0,78.0,78.0
298443.0,6,6,412,4,272,99481.0,74.0,68.0,2,140,0.0,74.0,70.0
2576603.0,6,2,132,1,66,0.0,66.0,66.0,1,66,0.0,66.0,66.0
9273.0,17,2,539,1,86,0.0,86.0,86.0,1,453,0.0,453.0,453.0
90014361.0,17,28,13364,28,13364,3333865.222222222,501.0,477.2857142857143,0,0,0.0,0.0,0.0
320.0,17,2,174,1,79,0.0,79.0,79.0,1,95,0.0,95.0,95.0
103503.0,17,2,286,2,286,0.0,143.0,143.0,0,0,0.0,0.0,0.0
3363337.0,6,187,145118,101,135140,33633.37,1510.0,1338.019801980198,86,9978,35922.24705882353,1510.0,116.02325581395348
144013.0,17,2,180,1,90,0.0,90.0,90.0,1,90,0.0,90.0,90.0
2078070.0,6,18,6803,10,1501,230896.66666666663,408.0,150.1,8,5302,236310.8571428572,1514.0,662.75
28114.0,6,13,4416,6,409,5441.8,127.0,68.16666666666667,7,4007,4516.0,1514.0,572.4285714285714
155672.0,6,3,337,2,214,0.0,160.0,107.0,1,123,0.0,123.0,123.0
104592778.0,17,13,4446,13,4446,8716064.833333334,342.0,342.0,0,0,0.0,0.0,0.0
108157261.0,17,16,1736,8,868,15428332.714285716,174.0,108.5,8,868,15428334.285714284,174.0,108.5
24982.0,6,10,2032,5,524,5540.0,252.0,104.8,5,1508,5975.75,1236.0,301.6
15287.0,6,14,4740,7,653,2243.5,249.0,93.28571428571428,7,4087,2178.333333333333,1514.0,583.8571428571429
32615.0,6,10,2032,5,524,7905.5,252.0,104.8,5,1508,7809.75,1236.0,301.6
216368.0,17,4,6056,4,6056,72122.66666666667,1514.0,1514.0,0,0,0.0,0.0,0.0
115328.0,17,2,582,1,83,0.0,83.0,83.0,1,499,0.0,499.0,499.0
120066173.0,17,29,13785,29,13785,4288077.607142857,501.0,475.3448275862069,0,0,0.0,0.0,0.0
220277.0,17,2,180,1,90,0.0,90.0,90.0,1,90,0.0,90.0,90.0
39764.0,6,14,4740,7,653,6443.0,249.0,93.28571428571428,7,4087,6115.666666666667,1514.0,583.8571428571429
119033471.0,6,48,3168,24,1584,5175368.304347826,66.0,66.0,24,1584,5161909.260869565,66.0,66.0
2361.0,17,4,344,2,150,0.0,75.0,75.0,2,194,0.0,103.0,97.0
130090.0,6,3,337,2,214,0.0,160.0,107.0,1,123,0.0,123.0,123.0
236889.0,17,2,180,1,90,0.0,90.0,90.0,1,90,0.0,90.0,90.0
2380.0,17,4,344,2,150,0.0,75.0,75.0,2,194,0.0,103.0,97.0
120041622.0,17,29,13785,29,13785,4287200.785714285,501.0,475.3448275862069,0,0,0.0,0.0,0.0
101107.0,17,2,286,2,286,0.0,143.0,143.0,0,0,0.0,0.0,0.0
29263.0,6,14,4740,7,653,4657.5,249.0,93.28571428571428,7,4087,4599.5,1514.0,583.8571428571429
7119.0,17,2,582,1,83,0.0,83.0,83.0,1,499,0.0,499.0,499.0
1691.0,17,6,1230,3,234,545.5,78.0,78.0,3,996,638.5,332.0,332.0
135133630.0,17,6,1206,6,1206,27026726.0,201.0,201.0,0,0,0.0,0.0,0.0
232978.0,6,3,337,2,214,0.0,160.0,107.0,1,123,0.0,123.0,123.0
135762.0,17,4,1400,4,1400,45254.0,350.0,350.0,0,0,0.0,0.0,0.0
142833.0,17,4,1400,4,1400,47611.0,350.0,350.0,0,0,0.0,0.0,0.0
208140.0,6,3,426,2,280,0.0,214.0,140.0,1,146,0.0,146.0,146.0
108105931.0,17,5,955,5,955,27026482.75,191.0,191.0,0,0,0.0,0.0,0.0
153431.0,17,2,180,1,90,0.0,90.0,90.0,1,90,0.0,90.0,90.0
90037516.0,17,28,13364,28,13364,3334722.814814815,501.0,477.2857142857143,0,0,0.0,0.0,0.0
2447655.0,6,25,7573,14,3735,188281.15384615384,1514.0,266.7857142857143,11,3838,219044.8,1514.0,348.90909090909093
90194479.0,17,14,1126,7,563,15001048.333333334,174.0,80.42857142857143,7,563,15000181.833333334,174.0,80.42857142857143
16832.0,17,2,180,1,90,0.0,90.0,90.0,1,90,0.0,90.0,90.0
91000897.0,17,11,735,6,389,18200179.4,174.0,64.83333333333333,5,346,17751210.75,174.0,69.2
4419.0,17,2,626,1,72,0.0,72.0,72.0,1,554,0.0,554.0,554.0
103560.0,17,2,700,2,700,0.0,350.0,350.0,0,0,0.0,0.0,0.0
85644.0,6,14,4740,7,653,11215.5,249.0,93.28571428571428,7,4087,13492.833333333334,1514.0,583.8571428571429
317574.0,17,4,1400,4,1400,105858.0,350.0,350.0,0,0,0.0,0.0,0.0
2226.0,17,2,180,1,90,0.0,90.0,90.0,1,90,0.0,90.0,90.0
90257223.0,6,13,2036,8,1016,12893889.0,188.0,127.0,5,1020,22523062.0,204.0,204.0
207330.0,6,3,426,2,280,0.0,214.0,140.0,1,146,0.0,146.0,146.0
304562.0,6,6,412,4,272,101520.66666666669,74.0,68.0,2,140,0.0,74.0,70.0
23279.0,6,14,4740,7,653,3709.6666666666665,249.0,93.28571428571428,7,4087,3737.0,1514.0,583.8571428571429
2955934.0,6,3,1604,2,851,0.0,785.0,425.5,1,753,0.0,753.0,753.0
153482.0,17,2,180,1,90,0.0,90.0,90.0,1,90,0.0,90.0,90.0
20300.0,17,2,582,1,83,0.0,83.0,83.0,1,499,0.0,499.0,499.0
25352.0,6,10,2032,5,524,6087.0,252.0,104.8,5,1508,6096.25,1236.0,301.6
100778496.0,6,32,2236,16,1165,6704167.0,139.0,72.8125,16,1071,6704165.333333333,123.0,66.9375
135138275.0,17,6,1146,6,1146,27027655.0,191.0,191.0,0,0,0.0,0.0,0.0
2073.0,17,4,344,2,150,0.0,75.0,75.0,2,194,0.0,103.0,97.0
179884.0,17,2,762,2,762,0.0,381.0,381.0,0,0,0.0,0.0,0.0
196877.0,17,2,180,1,90,0.0,90.0,90.0,1,90,0.0,90.0,90.0
12576.0,6,11,1133,6,602,2072.4,264.0,100.33333333333331,5,531,2746.75,259.0,106.2
2476.0,17,4,344,2,150,0.0,75.0,75.0,2,194,0.0,103.0,97.0
107428.0,17,2,286,2,286,0.0,143.0,143.0,0,0,0.0,0.0,0.0
264.0,17,2,700,2,700,0.0,350.0,350.0,0,0,0.0,0.0,0.0
120628.0,6,3,337,2,214,0.0,160.0,107.0,1,123,0.0,123.0,123.0
2375.0,17,4,344,2,150,0.0,75.0,75.0,2,194,0.0,103.0,97.0
232814.0,6,3,337,2,214,0.0,160.0,107.0,1,123,0.0,123.0,123.0
52919.0,6,14,4740,7,653,7011.333333333333,249.0,93.28571428571428,7,4087,8680.333333333334,1514.0,583.8571428571429
460.0,17,2,508,2,508,0.0,257.0,254.0,0,0,0.0,0.0,0.0
90016517.0,17,28,13364,28,13364,3333945.074074074,501.0,477.2857142857143,0,0,0.0,0.0,0.0
9376.0,6,10,1067,5,536,2176.5,264.0,107.2,5,531,2048.75,259.0,106.2
257981.00000000003,6,3,337,2,214,0.0,160.0,107.0,1,123,0.0,123.0,123.0
122975282.0,6,48,3168,24,1584,4953335.739130435,66.0,66.0,24,1584,5313743.260869565,66.0,66.0
4654.0,17,2,180,1,90,0.0,90.0,90.0,1,90,0.0,90.0,90.0
45677939.0,17,9,3086,8,2736,5110337.142857143,342.0,342.0,1,350,0.0,350.0,350.0
2314.0,17,4,344,2,150,0.0,75.0,75.0,2,194,0.0,103.0,97.0
27566220.0,17,5,1710,5,1710,6891555.0,342.0,342.0,0,0,0.0,0.0,0.0
104034.0,17,2,700,2,700,0.0,350.0,350.0,0,0,0.0,0.0,0.0
311231.0,17,4,1400,4,1400,103743.66666666669,350.0,350.0,0,0,0.0,0.0,0.0
233879.0,6,3,337,2,214,0.0,160.0,107.0,1,123,0.0,123.0,123.0
304021.0,6,6,412,4,272,101340.33333333331,74.0,68.0,2,140,0.0,74.0,70.0
2565622.0,6,26,7627,14,3735,197355.53846153847,1514.0,266.7857142857143,12,3892,209976.9090909091,1514.0,324.3333333333333
314.0,17,2,174,1,79,0.0,79.0,79.0,1,95,0.0,95.0,95.0
2239.0,17,4,344,2,150,0.0,75.0,75.0,2,194,0.0,103.0,97.0
194099.0,6,12,1362,6,731,36624.4,253.0,121.83333333333331,6,631,37908.8,293.0,105.16666666666669
96220528.0,6,29,2046,15,1017,6872894.857142857,123.0,67.8,14,1029,6617794.846153846,123.0,73.5
228236.0,17,2,180,1,90,0.0,90.0,90.0,1,90,0.0,90.0,90.0
246616.0,6,3,337,2,214,0.0,160.0,107.0,1,123,0.0,123.0,123.0
45045038.0,17,9,3086,8,2736,5108308.285714285,342.0,342.0,1,350,0.0,350.0,350.0
104254.0,17,2,286,2,286,0.0,143.0,143.0,0,0,0.0,0.0,0.0
16700.0,6,14,4740,7,653,2282.833333333333,249.0,93.28571428571428,7,4087,2641.0,1514.0,583.8571428571429
0.0,6,1,66,1,66,0.0,66.0,66.0,0,0,0.0,0.0,0.0
207301.0,6,3,426,2,280,0.0,214.0,140.0,1,146,0.0,146.0,146.0
247002.0,6,3,337,2,214,0.0,160.0,107.0,1,123,0.0,123.0,123.0
499694.0,6,5,336,2,134,0.0,68.0,67.0,3,202,191802.5,70.0,67.33333333333333
153552.0,17,2,180,1,90,0.0,90.0,90.0,1,90,0.0,90.0,90.0
298474.0,6,6,412,4,272,99491.33333333331,74.0,68.0,2,140,0.0,74.0,70.0
249024.0,6,3,337,2,214,0.0,160.0,107.0,1,123,0.0,123.0,123.0
286397.0,17,2,363,1,79,0.0,79.0,79.0,1,284,0.0,284.0,284.0
91416499.0,6,22,1680,12,935,8309416.727272727,95.0,77.91666666666667,10,745,10156211.0,95.0,74.5
33078.0,6,14,4740,7,653,5389.333333333333,249.0,93.28571428571428,7,4087,4984.666666666667,1514.0,583.8571428571429
101727.0,17,2,762,2,762,0.0,381.0,381.0,0,0,0.0,0.0,0.0
2433.0,17,4,344,2,150,0.0,75.0,75.0,2,194,0.0,103.0,97.0
1170303.0,6,13,3010,8,2382,167186.14285714287,1514.0,297.75,5,628,223675.75,331.0,125.6
42494.0,6,14,4740,7,653,6881.666666666667,249.0,93.28571428571428,7,4087,5769.666666666667,1514.0,583.8571428571429
115847402.0,6,48,3168,24,1584,5036843.565217392,66.0,66.0,24,1584,5024864.826086956,66.0,66.0
29127.0,6,14,4740,7,653,4671.0,249.0,93.28571428571428,7,4087,4651.0,1514.0,583.8571428571429
228249.0,17,2,180,1,90,0.0,90.0,90.0,1,90,0.0,90.0,90.0
144761.0,17,2,180,1,70,0.0,70.0,70.0,1,110,0.0,110.0,110.0
120005735.0,6,19,1436,10,786,13333315.666666666,95.0,78.6,9,650,14999931.375,95.0,72.22222222222223
90311902.0,6,21,1585,11,840,9026076.5,95.0,76.36363636363636,10,745,10004703.666666666,95.0,74.5
29073.0,6,14,4740,7,653,4536.0,249.0,93.28571428571428,7,4087,4148.0,1514.0,583.8571428571429
146994.0,6,3,373,2,238,0.0,172.0,119.0,1,135,0.0,135.0,135.0
209492.0,17,2,180,1,90,0.0,90.0,90.0,1,90,0.0,90.0,90.0
318819.0,6,7,478,4,272,106273.0,74.0,68.0,3,206,77300.0,74.0,68.66666666666667
2741654.0,6,25,7573,14,3735,210896.4615384616,1514.0,266.7857142857143,11,3838,247226.8,1514.0,348.90909090909093
120132194.0,6,13,2020,9,1204,15016524.25,188.0,133.77777777777777,4,816,30031766.666666668,204.0,204.0
306394.0,6,6,412,4,272,102131.33333333331,74.0,68.0,2,140,0.0,74.0,70.0
2334.0,17,4,344,2,150,0.0,75.0,75.0,2,194,0.0,103.0,97.0
1020335.0,6,11,1134,6,558,204067.0,220.0,93.0,5,576,254334.0,304.0,115.2
298052.0,6,6,412,4,272,99350.66666666669,74.0,68.0,2,140,0.0,74.0,70.0
117569674.0,6,48,3168,24,1584,5111724.956521739,66.0,66.0,24,1584,5098258.695652174,66.0,66.0
41257.0,6,12,1320,7,789,6876.166666666667,253.0,112.71428571428572,5,531,8951.75,259.0,106.2
90027796.0,17,27,12943,27,12943,3462607.5384615385,501.0,479.3703703703704,0,0,0.0,0.0,0.0
48342.0,6,12,1320,6,723,9338.6,253.0,120.5,6,597,8598.0,259.0,99.5
10846886.0,6,7,478,3,206,5355104.5,74.0,68.66666666666667,4,272,3570026.6666666665,74.0,68.0
120137979.0,6,15,2428,9,1204,15017247.375,188.0,133.77777777777777,6,1224,18023826.4,204.0,204.0
17645.0,6,14,4740,7,653,2762.5,249.0,93.28571428571428,7,4087,2767.5,1514.0,583.8571428571429
306596.0,6,6,412,4,272,102198.66666666669,74.0,68.0,2,140,0.0,74.0,70.0
1771381.0,6,2,132,1,66,0.0,66.0,66.0,1,66,0.0,66.0,66.0
5625402.0,6,5,336,2,134,0.0,68.0,67.0,3,202,1424317.0,70.0,67.33333333333333
43962.0,6,10,1065,5,534,10604.0,262.0,106.8,5,531,7612.0,259.0,106.2
28390.0,6,14,4740,7,653,4248.333333333333,249.0,93.28571428571428,7,4087,4138.5,1514.0,583.8571428571429
23004950.0,17,3,1034,2,684,0.0,342.0,342.0,1,350,0.0,350.0,350.0
120146566.0,6,214,24218,107,7284,1125848.283018868,140.0,68.07476635514018,107,16934,1125789.7264150945,284.0,158.26168224299064
25414.0,6,11,2098,6,590,4921.4,252.0,98.33333333333331,5,1508,5991.25,1236.0,301.6
34682.0,6,14,4740,7,653,4953.166666666667,249.0,93.28571428571428,7,4087,5248.0,1514.0,583.8571428571429
67817.0,6,14,4740,7,653,11003.666666666666,249.0,93.28571428571428,7,4087,8269.5,1514.0,583.8571428571429
32225.0,6,14,4740,7,653,4897.5,249.0,93.28571428571428,7,4087,4743.333333333333,1514.0,583.8571428571429
2594255.0,6,2,132,1,66,0.0,66.0,66.0,1,66,0.0,66.0,66.0
29448.0,6,14,4740,7,653,4797.833333333333,249.0,93.28571428571428,7,4087,4688.166666666667,1514.0,583.8571428571429
123839641.0,6,48,3168,24,1584,5061943.521739131,66.0,66.0,24,1584,5235445.826086956,66.0,66.0
0.0,17,1,381,1,381,0.0,381.0,381.0,0,0,0.0,0.0,0.0
153458.0,17,2,180,1,90,0.0,90.0,90.0,1,90,0.0,90.0,90.0
316153.0,17,4,1400,4,1400,105384.33333333331,350.0,350.0,0,0,0.0,0.0,0.0
15980.000000000002,6,10,2032,5,524,3721.75,252.0,104.8,5,1508,3715.0,1236.0,301.6
4341.0,17,2,614,1,72,0.0,72.0,72.0,1,542,0.0,542.0,542.0
232554.0,6,3,337,2,214,0.0,160.0,107.0,1,123,0.0,123.0,123.0
216435.0,17,2,180,1,90,0.0,90.0,90.0,1,90,0.0,90.0,90.0
105000973.0,17,13,821,7,432,17500162.166666668,174.0,61.71428571428572,6,389,17002181.4,174.0,64.83333333333333
1756.0,17,2,684,1,342,0.0,342.0,342.0,1,342,0.0,342.0,342.0
104848893.0,6,28,1876,14,982,8048688.692307692,139.0,70.14285714285714,14,894,8048701.153846154,123.0,63.85714285714285
108105910.0,17,5,955,5,955,27026477.5,191.0,191.0,0,0,0.0,0.0,0.0
34221.0,6,14,4740,7,653,5045.0,249.0,93.28571428571428,7,4087,5508.0,1514.0,583.8571428571429
90547720.0,6,14,2240,8,1016,12935388.57142857,188.0,127.0,6,1224,18076674.8,204.0,204.0
205145.0,17,2,762,2,762,0.0,381.0,381.0,0,0,0.0,0.0,0.0
96201512.0,17,12,778,6,389,19240302.4,174.0,64.83333333333333,6,389,19187567.6,174.0,64.83333333333333
2802539.0,6,2,132,1,66,0.0,66.0,66.0,1,66,0.0,66.0,66.0
249973.0,17,4,6056,4,6056,83324.33333333333,1514.0,1514.0,0,0,0.0,0.0,0.0
302865.0,17,2,616,1,75,0.0,75.0,75.0,1,541,0.0,541.0,541.0
2491311.0,6,2,132,1,66,0.0,66.0,66.0,1,66,0.0,66.0,66.0
315565.0,17,4,1400,4,1400,105188.33333333331,350.0,350.0,0,0,0.0,0.0,0.0
93478835.0,17,12,778,6,389,18601195.4,174.0,64.83333333333333,6,389,18600160.8,174.0,64.83333333333333
572639.0,6,4,508,2,238,0.0,172.0,119.0,2,270,0.0,135.0,135.0
628433.0,17,2,346,1,78,0.0,78.0,78.0,1,268,0.0,268.0,268.0
10473751.0,6,7,478,4,272,3445719.6666666665,74.0,68.0,3,206,5168466.0,74.0,68.66666666666667
337097.0,6,6,412,4,272,112365.66666666669,74.0,68.0,2,140,0.0,74.0,70.0
90269004.0,6,12,1832,8,1016,12895572.0,188.0,127.0,4,816,30025504.0,204.0,204.0
90752521.0,6,27,2073,15,1138,6479037.642857143,95.0,75.86666666666666,12,935,8182108.090909091,95.0,77.91666666666667
351.0,17,2,267,1,83,0.0,83.0,83.0,1,184,0.0,184.0,184.0
312977.0,17,4,1400,4,1400,104325.66666666669,350.0,350.0,0,0,0.0,0.0,0.0
305017.0,6,6,412,4,272,101672.33333333331,74.0,68.0,2,140,0.0,74.0,70.0
143857.0,17,2,180,1,90,0.0,90.0,90.0,1,90,0.0,90.0,90.0
28776.0,6,14,4740,7,653,4183.666666666667,249.0,93.28571428571428,7,4087,4539.333333333333,1514.0,583.8571428571429
107414.0,17,2,286,2,286,0.0,143.0,143.0,0,0,0.0,0.0,0.0
55128.0,6,10,2032,5,524,13496.25,252.0,104.8,5,1508,11288.25,1236.0,301.6
99808.0,6,2,132,1,66,0.0,66.0,66.0,1,66,0.0,66.0,66.0
312564.0,6,3,202,2,128,0.0,74.0,64.0,1,74,0.0,74.0,74.0
544.0,17,2,174,1,79,0.0,79.0,79.0,1,95,0.0,95.0,95.0
323.0,17,2,174,1,79,0.0,79.0,79.0,1,95,0.0,95.0,95.0
117637033.0,17,14,864,7,432,19500158.33333333,174.0,61.71428571428572,7,432,19500983.166666668,174.0,61.71428571428572
295984.0,17,4,813,2,144,0.0,72.0,72.0,2,669,0.0,542.0,334.5
93744306.0,6,40,2640,20,1320,4933910.842105263,66.0,66.0,20,1320,4917662.263157895,66.0,66.0
282687.0,6,12,1373,7,714,47114.5,298.0,102.0,5,659,66266.5,379.0,131.8
92592493.0,6,38,2508,19,1254,5144007.611111111,66.0,66.0,19,1254,5144008.666666667,66.0,66.0
145683.0,6,3,337,2,214,0.0,160.0,107.0,1,123,0.0,123.0,123.0
22350.0,6,10,2032,5,524,5338.25,252.0,104.8,5,1508,5367.0,1236.0,301.6
108110288.0,17,5,1005,5,1005,27027572.0,201.0,201.0,0,0,0.0,0.0,0.0
340137.0,17,2,180,1,90,0.0,90.0,90.0,1,90,0.0,90.0,90.0
29985.0,6,14,4740,7,653,4882.833333333333,249.0,93.28571428571428,7,4087,3861.8333333333335,1514.0,583.8571428571429
312220.0,17,4,1400,4,1400,104073.33333333331,350.0,350.0,0,0,0.0,0.0,0.0
115234660.0,6,48,3168,24,1584,5010202.608695652,66.0,66.0,24,1584,4998198.478260869,66.0,66.0
201566.0,17,2,180,1,90,0.0,90.0,90.0,1,90,0.0,90.0,90.0
108106323.0,17,5,955,5,955,27026580.75,191.0,191.0,0,0,0.0,0.0,0.0
119550669.0,6,294,33944,147,23946,817363.7191780822,336.0,162.89795918367346,147,9998,817366.0890410959,140.0,68.01360544217687
98522928.0,6,56,12394,28,6530,3648997.3333333335,1514.0,233.2142857142857,28,5864,3639154.0,1514.0,209.42857142857144
303129.0,6,2,132,1,66,0.0,66.0,66.0,1,66,0.0,66.0,66.0
123250456.0,6,49,3234,25,1650,5135435.666666667,66.0,66.0,24,1584,5080948.695652174,66.0,66.0
2041.0,17,2,180,1,90,0.0,90.0,90.0,1,90,0.0,90.0,90.0
146210.0,6,3,337,2,214,0.0,160.0,107.0,1,123,0.0,123.0,123.0
97854327.0,17,10,692,5,346,19501580.5,174.0,69.2,5,346,19885643.75,174.0,69.2
1303579.0,6,4,264,2,132,0.0,66.0,66.0,2,132,0.0,66.0,66.0
90253719.0,6,13,1898,8,1016,12893388.42857143,188.0,127.0,5,882,22523102.5,204.0,176.4
15022.0,17,2,180,1,90,0.0,90.0,90.0,1,90,0.0,90.0,90.0
406.0,17,2,762,2,762,0.0,381.0,381.0,0,0,0.0,0.0,0.0
135136433.0,17,6,1206,6,1206,27027286.6,201.0,201.0,0,0,0.0,0.0,0.0
131529030.0,17,17,1517,8,737,15997404.42857143,174.0,92.125,9,780,16421013.75,174.0,86.66666666666667
108105192.0,17,5,1005,5,1005,27026298.0,201.0,201.0,0,0,0.0,0.0,0.0
16016767.000000002,17,2,684,2,684,0.0,342.0,342.0,0,0,0.0,0.0,0.0
90097187.0,6,11,1644,7,828,15016197.833333334,188.0,118.28571428571428,4,816,20020731.666666668,204.0,204.0
117179858.0,6,48,3168,24,1584,5094776.434782608,66.0,66.0,24,1584,5082806.173913044,66.0,66.0
117791536.0,6,284,32846,142,23178,833867.7446808511,300.0,163.22535211267606,142,9668,833873.914893617,140.0,68.08450704225352
9168.0,17,2,571,1,86,0.0,86.0,86.0,1,485,0.0,485.0,485.0
498387.0,6,5,336,2,134,0.0,68.0,67.0,3,202,196414.5,70.0,67.33333333333333
124361657.0,6,31,2034,16,1086,8290777.133333334,123.0,67.875,15,948,8154345.714285715,123.0,63.2
115913760.0,6,48,3168,24,1584,5039728.695652174,66.0,66.0,24,1584,5026268.173913044,66.0,66.0
331778.0,6,6,412,4,272,110592.66666666669,74.0,68.0,2,140,0.0,74.0,70.0
10933864.0,6,8,544,4,272,3599052.0,74.0,68.0,4,272,3598968.333333333,74.0,68.0
220821.0,17,4,1524,4,1524,73607.0,381.0,381.0,0,0,0.0,0.0,0.0
107487799.0,6,29,2062,15,1017,7677669.214285715,123.0,67.8,14,1045,7500208.461538462,139.0,74.64285714285714
120115334.0,6,12,1832,8,1016,17135954.285714287,188.0,127.0,4,816,30029490.33333333,204.0,204.0
60003.0,6,14,4740,7,653,9877.833333333334,249.0,93.28571428571428,7,4087,6244.333333333333,1514.0,583.8571428571429
302072.0,6,6,412,4,272,100690.66666666669,74.0,68.0,2,140,0.0,74.0,70.0
153391.0,17,2,180,1,90,0.0,90.0,90.0,1,90,0.0,90.0,90.0
209640.0,17,2,180,1,90,0.0,90.0,90.0,1,90,0.0,90.0,90.0
148049.0,17,2,180,1,90,0.0,90.0,90.0,1,90,0.0,90.0,90.0
100424990.0,17,13,821,7,432,16737498.333333334,174.0,61.71428571428572,6,389,19962373.0,174.0,64.83333333333333
103397.0,17,2,286,2,286,0.0,143.0,143.0,0,0,0.0,0.0,0.0
385499.0,6,10,1221,6,636,77099.8,298.0,106.0,4,585,119505.66666666669,379.0,146.25
263931.0,6,3,337,2,214,0.0,160.0,107.0,1,123,0.0,123.0,123.0
90028866.0,17,27,12943,27,12943,3462648.6923076925,501.0,479.3703703703704,0,0,0.0,0.0,0.0
224453.0,17,2,414,1,88,0.0,88.0,88.0,1,326,0.0,326.0,326.0
108102194.0,17,5,955,5,955,27025548.5,191.0,191.0,0,0,0.0,0.0,0.0
240704.0,6,3,337,2,214,0.0,160.0,107.0,1,123,0.0,123.0,123.0
104344809.0,6,30,2106,15,1089,7437781.142857143,123.0,72.6,15,1017,7437767.428571428,123.0,67.8
28033.0,6,14,4740,7,653,4188.333333333333,249.0,93.28571428571428,7,4087,4162.5,1514.0,583.8571428571429
3709.0,17,2,180,1,90,0.0,90.0,90.0,1,90,0.0,90.0,90.0
16610.0,6,10,1066,5,490,3226.5,218.0,98.0,5,576,3941.25,304.0,115.2
157017.0,17,2,180,1,90,0.0,90.0,90.0,1,90,0.0,90.0,90.0
64861.0,6,14,4740,7,653,10393.833333333334,249.0,93.28571428571428,7,4087,10118.0,1514.0,583.8571428571429
229539.0,6,13,1394,7,797,38256.5,253.0,113.85714285714286,6,597,43801.6,259.0,99.5
305.0,17,2,164,1,82,0.0,82.0,82.0,1,82,0.0,82.0,82.0
122001099.0,17,15,907,8,475,17428728.42857143,174.0,59.375,7,432,17000991.833333332,174.0,61.71428571428572
319.0,17,2,174,1,79,0.0,79.0,79.0,1,95,0.0,95.0,95.0
127113992.0,17,19,1795,9,948,13499976.0,394.0,105.33333333333331,10,847,14112532.555555556,250.0,84.7
312.0,17,2,174,1,79,0.0,79.0,79.0,1,95,0.0,95.0,95.0
146210.0,6,3,337,2,214,0.0,160.0,107.0,1,123,0.0,123.0,123.0
842539.0,6,9,1118,6,586,168507.8,248.0,97.66666666666669,3,532,283349.5,392.0,177.33333333333334
305985.0,6,3,202,2,128,0.0,74.0,64.0,1,74,0.0,74.0,74.0
100288.0,17,2,762,2,762,0.0,381.0,381.0,0,0,0.0,0.0,0.0
65412.0,6,14,4740,7,653,10771.666666666666,249.0,93.28571428571428,7,4087,8263.333333333334,1514.0,583.8571428571429
308585.0,6,6,412,4,272,102861.66666666669,74.0,68.0,2,140,0.0,74.0,70.0
120083625.0,6,14,2102,6,1086,24016725.0,204.0,181.0,8,1016,17130403.285714287,188.0,127.0
9589.0,17,2,582,1,83,0.0,83.0,83.0,1,499,0.0,499.0,499.0
309719.0,6,3,202,2,128,0.0,74.0,64.0,1,74,0.0,74.0,74.0
110741529.0,6,44,2904,22,1452,5273406.142857143,66.0,66.0,22,1452,5258430.19047619,66.0,66.0
1302305.0,6,4,264,2,132,0.0,66.0,66.0,2,132,0.0,66.0,66.0
90054122.0,17,28,13364,28,13364,3335337.851851852,501.0,477.2857142857143,0,0,0.0,0.0,0.0
120204344.0,6,18,1341,9,691,14999952.0,95.0,76.77777777777777,9,650,14999942.375,95.0,72.22222222222223
113520338.0,6,46,3036,23,1518,5160002.545454546,66.0,66.0,23,1518,5160003.636363637,66.0,66.0
331.0,17,2,166,1,75,0.0,75.0,75.0,1,91,0.0,91.0,91.0
90257578.0,6,12,1832,8,1016,12893939.714285716,188.0,127.0,4,816,30030814.33333333,204.0,204.0
30507.0,6,14,4740,7,653,3804.0,249.0,93.28571428571428,7,4087,4850.0,1514.0,583.8571428571429
206451.0,6,3,426,2,280,0.0,214.0,140.0,1,146,0.0,146.0,146.0
92359625.0,17,16,5472,16,5472,6157308.333333333,342.0,342.0,0,0,0.0,0.0,0.0
10524809.0,6,7,478,4,272,3462605.6666666665,74.0,68.0,3,206,5193729.0,74.0,68.66666666666667
312248.0,17,4,1400,4,1400,104082.66666666669,350.0,350.0,0,0,0.0,0.0,0.0
135133565.0,17,6,1206,6,1206,27026713.0,201.0,201.0,0,0,0.0,0.0,0.0
307881.0,17,4,704,2,148,0.0,74.0,74.0,2,556,0.0,280.0,278.0
246618.0,6,3,373,2,238,0.0,172.0,119.0,1,135,0.0,135.0,135.0
143874.0,17,2,180,1,90,0.0,90.0,90.0,1,90,0.0,90.0,90.0
10465025.0,6,7,478,4,272,3443039.0,74.0,68.0,3,206,5164440.0,74.0,68.66666666666667
124895779.0,17,15,1038,8,606,17842254.14285714,174.0,75.75,7,432,18500156.83333333,174.0,61.71428571428572
298549.0,6,6,412,4,272,99516.33333333331,74.0,68.0,2,140,0.0,74.0,70.0
240698.0,6,3,373,2,238,0.0,172.0,119.0,1,135,0.0,135.0,135.0
120898100.0,17,14,995,8,606,17271157.14285714,174.0,75.75,6,389,19847933.8,174.0,64.83333333333333
107901.0,17,2,286,2,286,0.0,143.0,143.0,0,0,0.0,0.0,0.0
263.0,17,2,762,2,762,0.0,381.0,381.0,0,0,0.0,0.0,0.0
288042.0,6,10,1221,6,636,57608.4,298.0,106.0,4,585,90621.33333333331,379.0,146.25
217693.0,6,3,426,2,280,0.0,214.0,140.0,1,146,0.0,146.0,146.0
321217.0,17,4,1400,4,1400,107072.33333333331,350.0,350.0,0,0,0.0,0.0,0.0
113424285.0,6,46,3036,23,1518,5155636.5,66.0,66.0,23,1518,5155637.590909091,66.0,66.0
34619.0,6,14,4740,7,653,5125.666666666667,249.0,93.28571428571428,7,4087,5331.333333333333,1514.0,583.8571428571429
204686.0,17,2,762,2,762,0.0,381.0,381.0,0,0,0.0,0.0,0.0
34790.0,6,14,4740,7,653,5214.333333333333,249.0,93.28571428571428,7,4087,5514.333333333333,1514.0,583.8571428571429
1301475.0,6,4,264,2,132,0.0,66.0,66.0,2,132,0.0,66.0,66.0
304.0,17,2,164,1,82,0.0,82.0,82.0,1,82,0.0,82.0,82.0
120030.0,17,2,180,1,70,0.0,70.0,70.0,1,110,0.0,110.0,110.0
332237.0,17,6,1230,3,234,165930.0,78.0,78.0,3,996,165913.0,332.0,332.0
5621921.0,6,4,270,2,134,0.0,68.0,67.0,2,136,0.0,70.0,68.0
10923136.0,6,8,544,4,272,3595606.6666666665,74.0,68.0,4,272,3595533.0,74.0,68.0
91436.0,6,12,1328,7,797,15239.333333333334,253.0,113.85714285714286,5,531,20241.5,259.0,106.2
243743.0,6,3,337,2,214,0.0,160.0,107.0,1,123,0.0,123.0,123.0
12745.0,6,13,1459,7,862,2124.1666666666665,271.0,123.14285714285714,6,597,2152.2,259.0,99.5
228114.0,17,2,180,1,90,0.0,90.0,90.0,1,90,0.0,90.0,90.0
305530.0,6,6,412,4,272,101843.33333333331,74.0,68.0,2,140,0.0,74.0,70.0
120042624.0,17,28,13364,28,13364,4446023.111111111,501.0,477.2857142857143,0,0,0.0,0.0,0.0
3166435.0,6,18,1495,9,921,358278.375,315.0,102.33333333333331,9,574,358244.0,78.0,63.77777777777778
103916.0,17,2,286,2,286,0.0,143.0,143.0,0,0,0.0,0.0,0.0
116598560.0,6,388,46194,194,33094,604137.6165803109,464.0,170.58762886597938,194,13100,602902.2797927461,140.0,67.52577319587628
120048111.0,17,28,13364,28,13364,4446226.333333333,501.0,477.2857142857143,0,0,0.0,0.0,0.0
63492.00000000001,6,10,2032,5,524,14766.75,252.0,104.8,5,1508,15618.75,1236.0,301.6
28487.0,6,14,4740,7,653,4447.0,249.0,93.28571428571428,7,4087,3541.6666666666665,1514.0,583.8571428571429
110035185.0,6,31,2182,16,1165,7321287.933333334,139.0,72.8125,15,1017,7844239.0,123.0,67.8
5005343.0,17,4,849,2,166,0.0,83.0,83.0,2,683,0.0,499.0,341.5
103187688.0,17,14,864,7,432,17163344.0,174.0,61.71428571428572,7,432,17166831.0,174.0,61.71428571428572
198177.0,17,2,180,1,90,0.0,90.0,90.0,1,90,0.0,90.0,90.0
119356921.0,17,35,16705,35,16705,3510497.6764705884,501.0,477.2857142857143,0,0,0.0,0.0,0.0
1589181.0,6,4,276,2,128,0.0,74.0,64.0,2,148,0.0,74.0,74.0
135133524.0,17,6,1146,6,1146,27026704.8,191.0,191.0,0,0,0.0,0.0,0.0
280496.0,17,2,363,1,79,0.0,79.0,79.0,1,284,0.0,284.0,284.0
100516381.0,17,12,516,6,258,20000167.2,43.0,43.0,6,258,20001312.4,43.0,43.0
300977.0,6,6,412,4,272,100325.66666666669,74.0,68.0,2,140,0.0,74.0,70.0
222183.0,6,10,1221,6,636,44436.6,298.0,106.0,4,585,72232.66666666667,379.0,146.25
943004.0,6,5,1742,3,921,471502.0,785.0,307.0,2,821,0.0,753.0,410.5
135132701.0,17,6,1146,6,1146,27026540.2,191.0,191.0,0,0,0.0,0.0,0.0
335836.0,6,6,412,4,272,111945.33333333331,74.0,68.0,2,140,0.0,74.0,70.0
102556496.0,6,33,2428,17,1288,6396290.625,139.0,75.76470588235294,16,1140,6822708.533333333,123.0,71.25
105000990.0,17,13,821,7,432,17500165.0,174.0,61.71428571428572,6,389,17001423.0,174.0,64.83333333333333
146193.0,6,3,337,2,214,0.0,160.0,107.0,1,123,0.0,123.0,123.0
3356.0,17,2,414,1,88,0.0,88.0,88.0,1,326,0.0,326.0,326.0
438802.0,17,2,363,1,79,0.0,79.0,79.0,1,284,0.0,284.0,284.0
1158167.0,6,13,3012,8,2384,165452.42857142858,1514.0,298.0,5,628,221395.0,331.0,125.6
56937.0,6,14,4740,7,653,9343.833333333334,249.0,93.28571428571428,7,4087,9027.666666666666,1514.0,583.8571428571429
90017385.0,17,28,13364,28,13364,3333977.222222222,501.0,477.2857142857143,0,0,0.0,0.0,0.0
298389.0,6,6,412,4,272,99463.0,74.0,68.0,2,140,0.0,74.0,70.0
93154551.0,17,13,1083,7,563,15499076.166666666,174.0,80.42857142857143,6,520,14774250.6,174.0,86.66666666666667
90256918.0,6,12,1832,8,1016,12893845.42857143,188.0,127.0,4,816,30030981.33333333,204.0,204.0
23620.0,6,10,2032,5,524,5264.0,252.0,104.8,5,1508,5644.25,1236.0,301.6
51075.0,17,2,180,1,90,0.0,90.0,90.0,1,90,0.0,90.0,90.0
0.0,6,1,54,0,0,0.0,0.0,0.0,1,54,0.0,54.0,54.0
51920.0,6,14,4740,7,653,8424.666666666666,249.0,93.28571428571428,7,4087,8024.5,1514.0,583.8571428571429
135134567.0,17,6,1146,6,1146,27026913.4,191.0,191.0,0,0,0.0,0.0,0.0
0.0,17,1,90,1,90,0.0,90.0,90.0,0,0,0.0,0.0,0.0
2033.0,17,4,344,2,150,0.0,75.0,75.0,2,194,0.0,103.0,97.0
108105504.0,17,5,1005,5,1005,27026376.0,201.0,201.0,0,0,0.0,0.0,0.0
303921.0,6,6,412,4,272,101307.0,74.0,68.0,2,140,0.0,74.0,70.0
100531.0,17,2,762,2,762,0.0,381.0,381.0,0,0,0.0,0.0,0.0
219611.0,6,3,426,2,280,0.0,214.0,140.0,1,146,0.0,146.0,146.0
23200.0,6,10,2032,5,524,5508.25,252.0,104.8,5,1508,5585.75,1236.0,301.6
2800530.0,6,2,132,1,66,0.0,66.0,66.0,1,66,0.0,66.0,66.0
51728829.0,6,8,2113,3,960,24538716.5,826.0,320.0,5,1153,12236983.5,885.0,230.6
1311297.0,17,7,490,7,490,218549.5,70.0,70.0,0,0,0.0,0.0,0.0
24766.0,6,14,4740,7,653,3961.8333333333335,249.0,93.28571428571428,7,4087,3768.6666666666665,1514.0,583.8571428571429
15946990.0,17,6,2052,6,2052,3189398.0,342.0,342.0,0,0,0.0,0.0,0.0
603150.0,6,4,508,2,238,0.0,172.0,119.0,2,270,0.0,135.0,135.0
2793498.0,6,2,132,1,66,0.0,66.0,66.0,1,66,0.0,66.0,66.0
306992.0,6,6,412,4,272,102330.66666666669,74.0,68.0,2,140,0.0,74.0,70.0
101230.0,17,2,762,2,762,0.0,381.0,381.0,0,0,0.0,0.0,0.0
213221.0,17,4,1524,4,1524,71073.66666666667,381.0,381.0,0,0,0.0,0.0,0.0
90258143.0,6,13,2036,8,1016,12894020.42857143,188.0,127.0,5,1020,22523160.5,204.0,204.0
232934.0,6,3,337,2,214,0.0,160.0,107.0,1,123,0.0,123.0,123.0
99671.0,17,2,762,2,762,0.0,381.0,381.0,0,0,0.0,0.0,0.0
1724824.0,6,23,6508,12,1529,156802.18181818182,357.0,127.41666666666669,11,4979,141472.5,1510.0,452.6363636363636
26101.0,6,14,4740,7,653,3531.333333333333,249.0,93.28571428571428,7,4087,3930.3333333333335,1514.0,583.8571428571429
108107205.0,17,5,1005,5,1005,27026801.25,201.0,201.0,0,0,0.0,0.0,0.0
2447.0,17,4,344,2,150,0.0,75.0,75.0,2,194,0.0,103.0,97.0
64475.00000000001,6,12,1328,6,731,12315.0,253.0,121.83333333333331,6,597,11520.2,259.0,99.5
38496.0,6,14,4740,7,653,6288.666666666667,249.0,93.28571428571428,7,4087,5726.166666666667,1514.0,583.8571428571429
318393.0,6,3,202,2,128,0.0,74.0,64.0,1,74,0.0,74.0,74.0
1451314.0,6,8,602,3,198,201172.5,66.0,66.0,5,404,340904.25,103.0,80.8
216530.0,17,2,180,1,90,0.0,90.0,90.0,1,90,0.0,90.0,90.0
90023203.0,17,28,13364,28,13364,3334192.703703704,501.0,477.2857142857143,0,0,0.0,0.0,0.0
107864020.0,6,28,1860,14,966,8280629.307692308,123.0,69.0,14,894,8280629.923076923,123.0,63.85714285714285
305735.0,17,4,1400,4,1400,101911.66666666669,350.0,350.0,0,0,0.0,0.0,0.0
103068.0,17,2,286,2,286,0.0,143.0,143.0,0,0,0.0,0.0,0.0
209511.0,17,2,180,1,90,0.0,90.0,90.0,1,90,0.0,90.0,90.0
90448609.0,17,12,778,6,389,18089721.8,174.0,64.83333333333333,6,389,17971636.4,174.0,64.83333333333333
20417.0,6,10,2032,5,524,3945.0,252.0,104.8,5,1508,4853.25,1236.0,301.6
59218.0,6,14,4740,7,653,9343.166666666666,249.0,93.28571428571428,7,4087,9734.0,1514.0,583.8571428571429
30505.0,6,10,2032,5,524,7369.75,252.0,104.8,5,1508,6368.25,1236.0,301.6
35195.0,6,14,4740,7,653,5153.5,249.0,93.28571428571428,7,4087,5713.0,1514.0,583.8571428571429
143813.0,6,2,132,1,66,0.0,66.0,66.0,1,66,0.0,66.0,66.0
96993.0,17,2,762,2,762,0.0,381.0,381.0,0,0,0.0,0.0,0.0
222283.0,6,10,1221,6,636,44456.6,298.0,106.0,4,585,73051.66666666667,379.0,146.25
15931.0,6,10,2032,5,524,3657.75,252.0,104.8,5,1508,3679.75,1236.0,301.6
256914.0,6,3,337,2,214,0.0,160.0,107.0,1,123,0.0,123.0,123.0
90003935.0,17,28,13364,28,13364,3333479.074074074,501.0,477.2857142857143,0,0,0.0,0.0,0.0
113941186.0,6,34,2334,17,1209,7107453.125,123.0,71.11764705882354,17,1125,7107450.875,123.0,66.17647058823529
90026074.0,17,28,13364,28,13364,3334299.037037037,501.0,477.2857142857143,0,0,0.0,0.0,0.0
39627119.0,6,8,2113,3,960,18735291.0,826.0,320.0,5,1153,9261396.0,885.0,230.6
33552.0,6,14,4740,7,653,4653.166666666667,249.0,93.28571428571428,7,4087,4478.5,1514.0,583.8571428571429
44988.0,6,14,4740,7,653,6063.166666666667,249.0,93.28571428571428,7,4087,6447.166666666667,1514.0,583.8571428571429
40918.0,6,10,2032,5,524,9982.75,252.0,104.8,5,1508,9836.75,1236.0,301.6
44341.0,6,14,4740,7,653,6592.166666666667,249.0,93.28571428571428,7,4087,7049.5,1514.0,583.8571428571429
2066.0,17,4,344,2,150,0.0,75.0,75.0,2,194,0.0,103.0,97.0
324126.0,17,4,1400,4,1400,108042.0,350.0,350.0,0,0,0.0,0.0,0.0
146337.0,6,3,337,2,214,0.0,160.0,107.0,1,123,0.0,123.0,123.0
63922.99999999999,6,14,4740,7,653,10129.333333333334,249.0,93.28571428571428,7,4087,8847.0,1514.0,583.8571428571429
23254.0,6,14,4740,7,653,3479.6666666666665,249.0,93.28571428571428,7,4087,3565.333333333333,1514.0,583.8571428571429
17733.0,6,20,7606,11,978,1773.3,310.0,88.9090909090909,9,6628,1885.875,1514.0,736.4444444444445
116065504.0,6,224,25312,112,7688,1038247.7117117116,140.0,68.64285714285714,112,17624,1038219.8108108108,284.0,157.35714285714286
2627459.0,6,25,7573,14,3735,202112.2307692308,1514.0,266.7857142857143,11,3838,237762.4,1514.0,348.90909090909093
410779.0,17,2,176,1,80,0.0,80.0,80.0,1,96,0.0,96.0,96.0
580080.0,17,2,346,1,78,0.0,78.0,78.0,1,268,0.0,268.0,268.0
30667.0,6,10,2032,5,524,6310.5,252.0,104.8,5,1508,6980.25,1236.0,301.6
2444.0,17,4,344,2,150,0.0,75.0,75.0,2,194,0.0,103.0,97.0
2600602.0,6,2,132,1,66,0.0,66.0,66.0,1,66,0.0,66.0,66.0
3044486.0,6,3,204,2,136,0.0,70.0,68.0,1,68,0.0,68.0,68.0
8973.0,17,2,498,1,80,0.0,80.0,80.0,1,418,0.0,418.0,418.0
205765.0,17,2,180,1,90,0.0,90.0,90.0,1,90,0.0,90.0,90.0
206435.0,6,3,426,2,280,0.0,214.0,140.0,1,146,0.0,146.0,146.0
37635.0,6,11,2098,6,590,7406.4,252.0,98.33333333333331,5,1508,7173.25,1236.0,301.6
1000938.0,6,12,2717,7,742,166823.0,338.0,106.0,5,1975,181337.25,1514.0,395.0
38586.0,6,14,4740,7,653,6232.5,249.0,93.28571428571428,7,4087,6294.833333333333,1514.0,583.8571428571429
13654.0,6,12,1393,6,796,2552.4,271.0,132.66666666666666,6,597,2492.2,259.0,99.5
103385.0,17,2,762,2,762,0.0,381.0,381.0,0,0,0.0,0.0,0.0
201353.0,17,4,6056,4,6056,67117.66666666667,1514.0,1514.0,0,0,0.0,0.0,0.0
122011432.0,17,15,907,8,475,17430204.57142857,174.0,59.375,7,432,17000205.0,174.0,61.71428571428572
25419409.0,6,20,6943,11,1575,2541940.9,408.0,143.1818181818182,9,5368,2992013.0,1514.0,596.4444444444445
121448103.0,6,32,2226,17,1209,7590506.4375,123.0,71.11764705882354,15,1017,7946231.142857143,123.0,67.8
135131722.0,17,6,1146,6,1146,27026344.4,191.0,191.0,0,0,0.0,0.0,0.0
206028.0,6,3,426,2,280,0.0,214.0,140.0,1,146,0.0,146.0,146.0
311698.0,17,4,704,2,148,0.0,74.0,74.0,2,556,0.0,280.0,278.0
403.0,17,2,762,2,762,0.0,381.0,381.0,0,0,0.0,0.0,0.0
90030803.0,17,28,13364,28,13364,3334474.185185185,501.0,477.2857142857143,0,0,0.0,0.0,0.0
118237155.0,17,14,864,7,432,19666208.83333333,174.0,61.71428571428572,7,432,19666831.666666668,174.0,61.71428571428572
245118.0,6,3,373,2,238,0.0,172.0,119.0,1,135,0.0,135.0,135.0
54566.0,6,12,1320,6,723,10412.6,253.0,120.5,6,597,8507.4,259.0,99.5
919.0,17,2,762,2,762,0.0,381.0,381.0,0,0,0.0,0.0,0.0
153665.0,17,2,180,1,90,0.0,90.0,90.0,1,90,0.0,90.0,90.0
90041076.0,17,28,13364,28,13364,3334854.6666666665,501.0,477.2857142857143,0,0,0.0,0.0,0.0
279970.0,17,2,346,1,78,0.0,78.0,78.0,1,268,0.0,268.0,268.0
315213.0,17,4,1400,4,1400,105071.0,350.0,350.0,0,0,0.0,0.0,0.0
32681184.0,6,5,336,2,134,0.0,68.0,67.0,3,202,15053143.0,70.0,67.33333333333333
246879.0,6,3,373,2,238,0.0,172.0,119.0,1,135,0.0,135.0,135.0
49748.0,6,14,4740,7,653,8182.833333333333,249.0,93.28571428571428,7,4087,7125.0,1514.0,583.8571428571429
135125763.0,17,6,1206,6,1206,27025152.6,201.0,201.0,0,0,0.0,0.0,0.0
281373.0,17,2,363,1,79,0.0,79.0,79.0,1,284,0.0,284.0,284.0
0.0,6,1,172,1,172,0.0,172.0,172.0,0,0,0.0,0.0,0.0
20576.0,6,10,2032,5,524,4854.25,252.0,104.8,5,1508,4822.25,1236.0,301.6
309698.0,17,4,1400,4,1400,103232.66666666669,350.0,350.0,0,0,0.0,0.0,0.0
20961.0,6,14,4740,7,653,2680.833333333333,249.0,93.28571428571428,7,4087,3299.5,1514.0,583.8571428571429
214254.0,6,10,1221,6,636,42850.8,298.0,106.0,4,585,66131.33333333333,379.0,146.25
90255179.0,6,13,2036,8,1016,12893597.0,188.0,127.0,5,1020,22515188.0,204.0,204.0
102595.0,17,2,286,2,286,0.0,143.0,143.0,0,0,0.0,0.0,0.0
1296399.0,6,4,264,2,132,0.0,66.0,66.0,2,132,0.0,66.0,66.0
205867.0,17,2,180,1,90,0.0,90.0,90.0,1,90,0.0,90.0,90.0
6612.0,17,4,823,2,163,0.0,89.0,81.5,2,660,0.0,443.0,330.0
308847.0,6,6,412,4,272,102949.0,74.0,68.0,2,140,0.0,74.0,70.0
59015.0,6,13,1394,7,797,9641.333333333334,253.0,113.85714285714286,6,597,9796.6,259.0,99.5
115469.0,17,4,1400,4,1400,38489.66666666666,350.0,350.0,0,0,0.0,0.0,0.0
113691864.0,6,46,3036,23,1518,5167800.818181818,66.0,66.0,23,1518,5167800.090909091,66.0,66.0
108097377.0,17,5,955,5,955,27024344.25,191.0,191.0,0,0,0.0,0.0,0.0
4478.0,17,2,614,1,72,0.0,72.0,72.0,1,542,0.0,542.0,542.0
146220.0,6,3,337,2,214,0.0,160.0,107.0,1,123,0.0,123.0,123.0
2839.0,17,4,344,2,150,0.0,75.0,75.0,2,194,0.0,103.0,97.0
121340.0,6,3,337,2,214,0.0,160.0,107.0,1,123,0.0,123.0,123.0
297390.0,17,4,6056,4,6056,99130.0,1514.0,1514.0,0,0,0.0,0.0,0.0
257715.00000000003,6,10,1221,6,636,51543.0,298.0,106.0,4,585,80537.33333333333,379.0,146.25
120129141.0,6,15,2428,9,1204,15016142.625,188.0,133.77777777777777,6,1224,18073270.0,204.0,204.0
338424.0,17,4,704,2,148,0.0,74.0,74.0,2,556,0.0,280.0,278.0
233677.0,6,3,337,2,214,0.0,160.0,107.0,1,123,0.0,123.0,123.0
324.0,17,2,174,1,79,0.0,79.0,79.0,1,95,0.0,95.0,95.0
121269.0,6,3,337,2,214,0.0,160.0,107.0,1,123,0.0,123.0,123.0
147176.0,6,3,373,2,238,0.0,172.0,119.0,1,135,0.0,135.0,135.0
104071.0,17,2,286,2,286,0.0,143.0,143.0,0,0,0.0,0.0,0.0
107470.0,17,2,286,2,286,0.0,143.0,143.0,0,0,0.0,0.0,0.0
34363.0,6,10,2032,5,524,8346.5,252.0,104.8,5,1508,7704.0,1236.0,301.6
42462.0,6,14,4740,7,653,6910.5,249.0,93.28571428571428,7,4087,6859.666666666667,1514.0,583.8571428571429
93049120.0,17,12,778,6,389,18600171.6,174.0,64.83333333333333,6,389,18600967.2,174.0,64.83333333333333
120505947.0,6,219,24818,110,17402,1105559.1467889908,284.0,158.2,109,7416,1106494.861111111,140.0,68.03669724770643
9681.0,17,2,582,1,83,0.0,83.0,83.0,1,499,0.0,499.0,499.0
2344.0,17,4,344,2,150,0.0,75.0,75.0,2,194,0.0,103.0,97.0
47817050.0,6,8,2113,3,960,22433082.0,826.0,320.0,5,1153,11259166.75,885.0,230.6
33463.0,6,14,4740,7,653,5454.833333333333,249.0,93.28571428571428,7,4087,5339.833333333333,1514.0,583.8571428571429
120037068.0,6,12562,10443161,7968,10194113,15066.783983933728,1514.0,1279.3816516064255,4594,249048,26117.83213585892,66.0,54.211580322159335
57704.0,6,10,2032,5,524,13659.75,252.0,104.8,5,1508,12896.0,1236.0,301.6
135150770.0,17,6,1146,6,1146,27030154.0,191.0,191.0,0,0,0.0,0.0,0.0
205630.0,6,3,426,2,280,0.0,214.0,140.0,1,146,0.0,146.0,146.0
107033440.0,6,28,1860,14,966,8233341.538461538,123.0,69.0,14,894,8216693.0,123.0,63.85714285714285
19753.0,6,20,7606,11,978,1917.0,310.0,88.9090909090909,9,6628,2341.0,1514.0,736.4444444444445
108111135.0,17,5,1005,5,1005,27027783.75,201.0,201.0,0,0,0.0,0.0,0.0
212369.0,6,12,1373,7,714,35394.833333333336,298.0,102.0,5,659,52047.0,379.0,131.8
90259307.0,6,14,2240,8,1016,12894186.714285716,188.0,127.0,6,1224,18018765.8,204.0,204.0
241652.0,6,3,337,2,214,0.0,160.0,107.0,1,123,0.0,123.0,123.0
108101930.0,17,5,955,5,955,27025482.5,191.0,191.0,0,0,0.0,0.0,0.0
246443.0,6,3,337,2,214,0.0,160.0,107.0,1,123,0.0,123.0,123.0
207223.0,6,3,426,2,280,0.0,214.0,140.0,1,146,0.0,146.0,146.0
233029.0,6,3,373,2,238,0.0,172.0,119.0,1,135,0.0,135.0,135.0
334.0,17,2,267,1,83,0.0,83.0,83.0,1,184,0.0,184.0,184.0
219795.0,6,3,426,2,280,0.0,214.0,140.0,1,146,0.0,146.0,146.0
26995.0,6,10,1067,5,536,6579.25,264.0,107.2,5,531,2703.75,259.0,106.2
21423.0,6,14,4740,7,653,3267.1666666666665,249.0,93.28571428571428,7,4087,3430.333333333333,1514.0,583.8571428571429
48476.0,6,14,4740,7,653,7266.333333333333,249.0,93.28571428571428,7,4087,7941.0,1514.0,583.8571428571429
207104.0,6,3,426,2,280,0.0,214.0,140.0,1,146,0.0,146.0,146.0
14647419.0,6,20,1607,10,975,1593803.111111111,315.0,97.5,10,632,1593776.2222222222,78.0,63.2
368.0,17,2,267,1,83,0.0,83.0,83.0,1,184,0.0,184.0,184.0
856067.0,6,9,1267,6,796,171213.4,458.0,132.66666666666666,3,471,291783.5,331.0,157.0
120446918.0,6,21,1626,9,691,11363736.875,95.0,76.77777777777777,12,935,10928187.272727272,95.0,77.91666666666667
309.0,17,2,174,1,79,0.0,79.0,79.0,1,95,0.0,95.0,95.0
153481.0,17,2,180,1,90,0.0,90.0,90.0,1,90,0.0,90.0,90.0
299625.0,6,6,412,4,272,99875.0,74.0,68.0,2,140,0.0,74.0,70.0
108104330.0,17,5,1005,5,1005,27026082.5,201.0,201.0,0,0,0.0,0.0,0.0
199562.0,17,4,6056,4,6056,66520.66666666667,1514.0,1514.0,0,0,0.0,0.0,0.0
16066.0,6,10,2032,5,524,2309.5,252.0,104.8,5,1508,3300.25,1236.0,301.6
29886.0,6,14,4740,7,653,4385.833333333333,249.0,93.28571428571428,7,4087,4841.333333333333,1514.0,583.8571428571429
55403.0,6,14,4740,7,653,8983.5,249.0,93.28571428571428,7,4087,9093.5,1514.0,583.8571428571429
837.0,17,4,438,2,148,0.0,74.0,74.0,2,290,0.0,147.0,145.0
240406.0,6,3,337,2,214,0.0,160.0,107.0,1,123,0.0,123.0,123.0
120245505.0,6,226,25534,113,7754,1066424.6875,140.0,68.61946902654867,113,17780,1066261.642857143,284.0,157.34513274336285
90258962.0,6,13,2036,8,1016,12894137.42857143,188.0,127.0,5,1020,22522648.75,204.0,204.0
97629581.0,6,26,1746,13,906,8135798.416666667,123.0,69.6923076923077,13,840,8117773.916666667,123.0,64.61538461538461
301011.0,6,6,412,4,272,100337.0,74.0,68.0,2,140,0.0,74.0,70.0
242838.0,6,3,337,2,214,0.0,160.0,107.0,1,123,0.0,123.0,123.0
734691.0,6,2,132,1,66,0.0,66.0,66.0,1,66,0.0,66.0,66.0
143887.0,17,2,180,1,90,0.0,90.0,90.0,1,90,0.0,90.0,90.0
407.0,17,2,410,1,78,0.0,78.0,78.0,1,332,0.0,332.0,332.0
104379175.0,6,30,2122,15,1105,7455655.357142857,139.0,73.66666666666667,15,1017,7440156.428571428,123.0,67.8
110213812.0,6,30,1974,15,1026,7856995.214285715,123.0,68.4,15,948,7856998.214285715,123.0,63.2
120119090.0,6,12,1832,8,1016,17136821.14285714,188.0,127.0,4,816,30030751.666666668,204.0,204.0
103740.0,17,2,286,2,286,0.0,143.0,143.0,0,0,0.0,0.0,0.0
59682.0,6,10,1066,5,490,12758.0,218.0,98.0,5,576,14562.25,304.0,115.2
113408243.0,6,46,3036,23,1518,5154907.7727272725,66.0,66.0,23,1518,5154908.590909091,66.0,66.0
9659.0,17,2,523,1,99,0.0,99.0,99.0,1,424,0.0,424.0,424.0
148537.0,17,2,414,1,88,0.0,88.0,88.0,1,326,0.0,326.0,326.0
12439.0,6,10,2032,5,524,2888.5,252.0,104.8,5,1508,2696.5,1236.0,301.6
79108532.0,6,9,842,9,842,9888566.5,97.0,93.55555555555556,0,0,0.0,0.0,0.0
30719.0,6,10,2032,5,524,5989.75,252.0,104.8,5,1508,7367.75,1236.0,301.6
14635245.0,6,20,1648,10,1016,1592408.4444444445,315.0,101.6,10,632,1592386.7777777778,78.0,63.2
135127354.0,17,6,1206,6,1206,27025470.8,201.0,201.0,0,0,0.0,0.0,0.0
135127675.0,17,6,1146,6,1146,27025535.0,191.0,191.0,0,0,0.0,0.0,0.0
22694.0,6,10,2032,5,524,5444.25,252.0,104.8,5,1508,5423.0,1236.0,301.6
9878.0,17,2,582,1,83,0.0,83.0,83.0,1,499,0.0,499.0,499.0
103448052.0,6,292,33198,146,23340,711977.5586206897,284.0,159.86301369863014,146,9858,711977.3448275862,140.0,67.52054794520548
120232535.0,6,30,3496,15,1605,8571217.5,362.0,107.0,15,1891,8570713.0,426.0,126.06666666666666
119601369.0,6,19,1395,10,745,13284307.111111112,95.0,74.5,9,650,14944322.75,95.0,72.22222222222223
1463457.0,17,2,876,2,876,0.0,438.0,438.0,0,0,0.0,0.0,0.0
9390.0,17,2,582,1,83,0.0,83.0,83.0,1,499,0.0,499.0,499.0
49342.0,6,14,4740,7,653,7812.5,249.0,93.28571428571428,7,4087,6523.5,1514.0,583.8571428571429
118437377.0,6,213,24274,107,7284,1117333.7452830188,140.0,68.07476635514018,106,16990,1118054.7142857143,390.0,160.28301886792454
2366.0,17,4,344,2,150,0.0,75.0,75.0,2,194,0.0,103.0,97.0
103209.0,17,2,286,2,286,0.0,143.0,143.0,0,0,0.0,0.0,0.0
1981.0,17,4,344,2,150,0.0,75.0,75.0,2,194,0.0,103.0,97.0
228374.0,17,2,180,1,90,0.0,90.0,90.0,1,90,0.0,90.0,90.0
147358.0,6,3,373,2,238,0.0,172.0,119.0,1,135,0.0,135.0,135.0
212094.0,6,10,1221,6,636,42418.8,298.0,106.0,4,585,69528.66666666667,379.0,146.25
2049817.0,17,5,961,3,234,1024722.5,78.0,78.0,2,727,0.0,395.0,363.5
90034588.0,17,28,13364,28,13364,3334614.3703703703,501.0,477.2857142857143,0,0,0.0,0.0,0.0
66280851.99999999,6,20,1429,10,735,7364273.888888889,95.0,73.5,10,694,7362900.0,95.0,69.4
135130444.0,17,6,1206,6,1206,27026088.8,201.0,201.0,0,0,0.0,0.0,0.0
54510.0,6,14,4740,7,653,8822.0,249.0,93.28571428571428,7,4087,8729.333333333334,1514.0,583.8571428571429
91006122.0,17,11,735,6,389,18201224.4,174.0,64.83333333333333,5,346,19895799.5,174.0,69.2
282461.0,17,2,363,1,79,0.0,79.0,79.0,1,284,0.0,284.0,284.0
30024.0,6,10,2032,5,524,7277.75,252.0,104.8,5,1508,7346.5,1236.0,301.6
120068560.0,17,29,13785,29,13785,4288162.857142857,501.0,475.3448275862069,0,0,0.0,0.0,0.0
302720.0,6,3,202,2,128,0.0,74.0,64.0,1,74,0.0,74.0,74.0
5625458.0,6,5,336,2,134,0.0,68.0,67.0,3,202,1524969.5,70.0,67.33333333333333
206794.0,6,3,426,2,280,0.0,214.0,140.0,1,146,0.0,146.0,146.0
206070.0,6,3,426,2,280,0.0,214.0,140.0,1,146,0.0,146.0,146.0
218816.0,17,2,180,1,90,0.0,90.0,90.0,1,90,0.0,90.0,90.0
218914.0,6,3,426,2,280,0.0,214.0,140.0,1,146,0.0,146.0,146.0
210626.0,6,3,426,2,280,0.0,214.0,140.0,1,146,0.0,146.0,146.0
2049.0,17,4,344,2,150,0.0,75.0,75.0,2,194,0.0,103.0,97.0
2372.0,17,4,344,2,150,0.0,75.0,75.0,2,194,0.0,103.0,97.0
28608.0,6,14,4740,7,653,4445.833333333333,249.0,93.28571428571428,7,4087,4539.833333333333,1514.0,583.8571428571429
104183.0,17,2,286,2,286,0.0,143.0,143.0,0,0,0.0,0.0,0.0
99499241.0,6,280,31866,140,22404,714272.9064748201,284.0,160.02857142857144,140,9462,714273.5971223022,140.0,67.58571428571429
5018406.0,17,4,534,2,166,0.0,83.0,83.0,2,368,0.0,184.0,184.0
15014.0,17,2,180,1,90,0.0,90.0,90.0,1,90,0.0,90.0,90.0
120112678.0,6,233,27156,122,19402,987037.429752066,284.0,159.0327868852459,111,7754,1089923.8818181818,140.0,69.85585585585585
11859.0,6,12,1393,6,796,2119.0,271.0,132.66666666666666,6,597,2180.4,259.0,99.5
95092784.0,6,172,19428,86,13530,1116206.905882353,284.0,157.32558139534885,86,5898,1116207.1647058823,140.0,68.5813953488372
311287.0,6,6,412,4,272,103762.33333333331,74.0,68.0,2,140,0.0,74.0,70.0
820.0,17,4,438,2,148,0.0,74.0,74.0,2,290,0.0,147.0,145.0
45196.0,6,14,4740,7,653,7298.166666666667,249.0,93.28571428571428,7,4087,7395.333333333333,1514.0,583.8571428571429
93189225.0,6,40,2640,20,1320,4904696.052631579,66.0,66.0,20,1320,4893319.421052632,66.0,66.0
45498.0,6,14,4740,7,653,7396.0,249.0,93.28571428571428,7,4087,6549.333333333333,1514.0,583.8571428571429
192266.0,17,4,1524,4,1524,64088.66666666666,381.0,381.0,0,0,0.0,0.0,0.0
148038.0,17,2,180,1,90,0.0,90.0,90.0,1,90,0.0,90.0,90.0
100207.0,17,2,762,2,762,0.0,381.0,381.0,0,0,0.0,0.0,0.0
11605.0,6,10,1065,5,534,2732.75,262.0,106.8,5,531,2581.5,259.0,106.2
303.0,17,2,164,1,82,0.0,82.0,82.0,1,82,0.0,82.0,82.0
308453.0,6,6,412,4,272,102817.66666666669,74.0,68.0,2,140,0.0,74.0,70.0
5334.0,17,4,344,2,150,0.0,75.0,75.0,2,194,0.0,103.0,97.0
308492.0,6,6,412,4,272,102830.66666666669,74.0,68.0,2,140,0.0,74.0,70.0
22457.0,6,10,2032,5,524,5388.75,252.0,104.8,5,1508,4843.25,1236.0,301.6
108737775.0,6,33,2412,17,1272,6796110.9375,123.0,74.82352941176471,16,1140,7235531.533333333,123.0,71.25
20243.0,6,10,1065,5,534,4144.5,262.0,106.8,5,531,4454.25,259.0,106.2
527342.0,6,5,1736,2,819,0.0,753.0,409.5,3,917,193755.5,785.0,305.6666666666667
34438.0,6,14,4740,7,653,5619.666666666667,249.0,93.28571428571428,7,4087,5395.0,1514.0,583.8571428571429
119809943.0,6,25,1883,14,1043,9212919.307692308,95.0,74.5,11,840,11980744.0,95.0,76.36363636363636
40848.0,6,14,4740,7,653,5954.166666666667,249.0,93.28571428571428,7,4087,5816.166666666667,1514.0,583.8571428571429
108469.0,17,2,286,2,286,0.0,143.0,143.0,0,0,0.0,0.0,0.0
146192.0,6,3,337,2,214,0.0,160.0,107.0,1,123,0.0,123.0,123.0
90019299.0,17,28,13364,28,13364,3334048.111111111,501.0,477.2857142857143,0,0,0.0,0.0,0.0
108098532.0,17,5,955,5,955,27024633.0,191.0,191.0,0,0,0.0,0.0,0.0
48344.0,6,13,1386,7,789,7977.666666666667,253.0,112.71428571428572,6,597,7887.8,259.0,99.5
811.0,17,4,438,2,148,0.0,74.0,74.0,2,290,0.0,147.0,145.0
32119.0,6,10,2032,5,524,6065.25,252.0,104.8,5,1508,6805.0,1236.0,301.6
96320733.0,6,29,2068,15,1105,6864620.785714285,139.0,73.66666666666667,14,963,7392672.384615385,123.0,68.78571428571429
190832.0,17,2,180,1,90,0.0,90.0,90.0,1,90,0.0,90.0,90.0
116107800.0,17,14,864,7,432,19334743.166666668,174.0,61.71428571428572,7,432,19333502.83333333,174.0,61.71428571428572
108471775.0,6,206,23202,103,16182,1061325.794117647,284.0,157.10679611650485,103,7020,1061339.0784313723,140.0,68.15533980582525
26241.0,6,2,145,2,145,0.0,91.0,72.5,0,0,0.0,0.0,0.0
2448.0,17,4,344,2,150,0.0,75.0,75.0,2,194,0.0,103.0,97.0
4553.0,17,2,614,1,72,0.0,72.0,72.0,1,542,0.0,542.0,542.0
327977.0,6,6,412,4,272,109325.66666666669,74.0,68.0,2,140,0.0,74.0,70.0
107835641.0,6,28,1860,14,966,8295049.307692308,123.0,69.0,14,894,8279222.538461538,123.0,63.85714285714285
298867.0,6,6,412,4,272,99622.33333333331,74.0,68.0,2,140,0.0,74.0,70.0
107068860.0,6,33,2412,17,1272,6679026.8125,123.0,74.82352941176471,16,1140,7124297.333333333,123.0,71.25
228291.0,17,2,180,1,90,0.0,90.0,90.0,1,90,0.0,90.0,90.0
146254.0,6,3,337,2,214,0.0,160.0,107.0,1,123,0.0,123.0,123.0
62506.99999999999,6,14,4740,7,653,10191.833333333334,249.0,93.28571428571428,7,4087,9584.666666666666,1514.0,583.8571428571429
135133891.0,17,6,1146,6,1146,27026778.2,191.0,191.0,0,0,0.0,0.0,0.0
22784.0,6,14,4740,7,653,3675.0,249.0,93.28571428571428,7,4087,3658.8333333333335,1514.0,583.8571428571429
1515389.0,6,20,6434,12,1921,137762.63636363635,620.0,160.08333333333334,8,4513,177839.42857142858,1514.0,564.125
216867.0,6,3,426,2,280,0.0,214.0,140.0,1,146,0.0,146.0,146.0
18544.0,6,10,2032,5,524,4230.25,252.0,104.8,5,1508,4276.5,1236.0,301.6
90300805.0,6,16,1192,8,596,12894125.714285716,95.0,74.5,8,596,12899500.42857143,95.0,74.5
119588345.0,6,23,1861,11,967,11958834.5,222.0,87.9090909090909,12,894,10848337.181818182,95.0,74.5
2556025.0,6,2,132,1,66,0.0,66.0,66.0,1,66,0.0,66.0,66.0
3002.0,17,4,344,2,150,0.0,75.0,75.0,2,194,0.0,103.0,97.0
72002.0,6,13,1386,7,789,11490.0,253.0,112.71428571428572,6,597,11761.4,259.0,99.5
56702.0,6,11,2098,6,590,11270.2,252.0,98.33333333333331,5,1508,11190.0,1236.0,301.6
797.0,17,4,438,2,148,0.0,74.0,74.0,2,290,0.0,147.0,145.0
128660110.0,6,34,2334,17,1125,7417197.25,123.0,66.17647058823529,17,1209,7556778.75,123.0,71.11764705882354
110742.0,17,2,286,2,286,0.0,143.0,143.0,0,0,0.0,0.0,0.0
2457.0,17,4,344,2,150,0.0,75.0,75.0,2,194,0.0,103.0,97.0
33721.0,6,10,2032,5,524,8131.5,252.0,104.8,5,1508,8185.75,1236.0,301.6
108156486.0,17,14,1126,7,563,17999593.666666668,174.0,80.42857142857143,7,563,17999597.833333332,174.0,80.42857142857143
506701.0,6,12,1373,7,714,84450.16666666667,298.0,102.0,5,659,122648.5,379.0,131.8
297424.0,6,6,412,4,272,99141.33333333331,74.0,68.0,2,140,0.0,74.0,70.0
105042614.0,17,14,4788,14,4788,8080201.076923077,342.0,342.0,0,0,0.0,0.0,0.0
42502.0,6,14,4740,7,653,6866.0,249.0,93.28571428571428,7,4087,5637.0,1514.0,583.8571428571429
59491.0,6,14,4740,7,653,8940.166666666666,249.0,93.28571428571428,7,4087,9589.333333333334,1514.0,583.8571428571429
108106551.0,17,5,955,5,955,27026637.75,191.0,191.0,0,0,0.0,0.0,0.0
90361964.0,6,13,2052,6,1224,18072152.8,204.0,204.0,7,828,15060133.0,188.0,118.28571428571428
26791.0,17,4,820,2,156,0.0,78.0,78.0,2,664,0.0,332.0,332.0
120005882.0,6,18,1341,9,691,14999982.625,95.0,76.77777777777777,9,650,14999456.25,95.0,72.22222222222223
4067.000000000001,17,2,582,1,83,0.0,83.0,83.0,1,499,0.0,499.0,499.0
14660440.0,6,19,1553,9,921,1793293.625,315.0,102.33333333333331,10,632,1594013.2222222222,78.0,63.2
113168256.0,6,46,3036,23,1518,5144000.545454546,66.0,66.0,23,1518,5144000.0,66.0,66.0
29988.0,6,11,2098,6,590,4990.0,252.0,98.33333333333331,5,1508,6919.0,1236.0,301.6
306223.0,6,6,412,4,272,102074.33333333331,74.0,68.0,2,140,0.0,74.0,70.0
21420.0,17,2,582,1,83,0.0,83.0,83.0,1,499,0.0,499.0,499.0
35227.0,6,14,4740,7,653,5378.0,249.0,93.28571428571428,7,4087,5158.5,1514.0,583.8571428571429
246111.0,6,3,337,2,214,0.0,160.0,107.0,1,123,0.0,123.0,123.0
327.0,17,2,174,1,79,0.0,79.0,79.0,1,95,0.0,95.0,95.0
2230.0,17,2,180,1,90,0.0,90.0,90.0,1,90,0.0,90.0,90.0
135124879.0,17,6,1146,6,1146,27024975.8,191.0,191.0,0,0,0.0,0.0,0.0
48261.0,6,10,2032,5,524,11320.5,252.0,104.8,5,1508,9104.75,1236.0,301.6
41945.0,6,14,4740,7,653,6484.666666666667,249.0,93.28571428571428,7,4087,6076.5,1514.0,583.8571428571429
495.0,17,2,762,2,762,0.0,381.0,381.0,0,0,0.0,0.0,0.0
199008.0,17,2,180,1,90,0.0,90.0,90.0,1,90,0.0,90.0,90.0
164653.0,6,7,744,4,455,54884.333333333336,249.0,113.75,3,289,65534.0,149.0,96.33333333333331
371768.0,6,11,1021,6,444,50557.6,162.0,74.0,5,577,63033.0,349.0,115.4
91397998.0,6,24,1829,13,989,7615157.916666667,95.0,76.07692307692308,11,840,9138860.9,95.0,76.36363636363636
0.0,17,1,55,1,55,0.0,55.0,55.0,0,0,0.0,0.0,0.0
356.0,17,2,267,1,83,0.0,83.0,83.0,1,184,0.0,184.0,184.0
207467.0,6,3,426,2,280,0.0,214.0,140.0,1,146,0.0,146.0,146.0
491.0,17,2,508,2,508,0.0,257.0,254.0,0,0,0.0,0.0,0.0
17262.0,6,10,2032,5,524,3455.75,252.0,104.8,5,1508,3908.75,1236.0,301.6
106507.0,17,2,286,2,286,0.0,143.0,143.0,0,0,0.0,0.0,0.0
103633.0,17,2,286,2,286,0.0,143.0,143.0,0,0,0.0,0.0,0.0
90531001.0,6,14,2240,8,1016,12933000.142857144,188.0,127.0,6,1224,18073740.2,204.0,204.0
21020367.0,17,3,1034,2,684,0.0,342.0,342.0,1,350,0.0,350.0,350.0
90097036.0,6,11,1644,4,816,30031914.0,204.0,204.0,7,828,15015977.833333334,188.0,118.28571428571428
85.0,17,2,762,2,762,0.0,381.0,381.0,0,0,0.0,0.0,0.0
103905777.0,6,198,22314,99,15558,1058066.795918367,284.0,157.15151515151516,99,6756,1058067.0714285714,140.0,68.24242424242425
513627.0,6,4,270,2,134,0.0,68.0,67.0,2,136,0.0,70.0,68.0
1310848.0,6,4,264,2,132,0.0,66.0,66.0,2,132,0.0,66.0,66.0
682.0,17,2,762,2,762,0.0,381.0,381.0,0,0,0.0,0.0,0.0
1159755.0,6,13,3016,8,2388,165679.2857142857,1514.0,298.5,5,628,220946.0,331.0,125.6
107624346.0,6,31,2166,16,1149,7160557.533333333,123.0,71.8125,15,1017,7672023.857142857,123.0,67.8
32312.0,6,10,2032,5,524,6347.25,252.0,104.8,5,1508,7498.25,1236.0,301.6
202484.0,17,4,6056,4,6056,67494.66666666667,1514.0,1514.0,0,0,0.0,0.0,0.0
9008302.0,6,13,1279,8,748,1286722.5714285714,262.0,93.5,5,531,2163.75,259.0,106.2
8821402.0,6,22,7083,13,1707,735116.8333333334,408.0,131.30769230769232,9,5376,1060288.625,1514.0,597.3333333333334
393110.0,6,3,204,2,136,0.0,70.0,68.0,1,68,0.0,68.0,68.0
90523518.0,6,13,2036,8,1016,12931931.142857144,188.0,127.0,5,1020,22590616.25,204.0,204.0
2047.0,17,4,344,2,150,0.0,75.0,75.0,2,194,0.0,103.0,97.0
217334.0,17,4,1524,4,1524,72444.66666666667,381.0,381.0,0,0,0.0,0.0,0.0
90257846.0,6,13,2036,8,1016,12893978.0,188.0,127.0,5,1020,22523505.75,204.0,204.0
120339624.0,6,219,24818,110,17402,1104033.247706422,284.0,158.2,109,7416,1104602.4722222222,140.0,68.03669724770643
246296.0,6,3,337,2,214,0.0,160.0,107.0,1,123,0.0,123.0,123.0
386842.0,17,2,363,1,75,0.0,75.0,75.0,1,288,0.0,288.0,288.0
148689.0,17,2,414,1,88,0.0,88.0,88.0,1,326,0.0,326.0,326.0
43492.0,6,14,4740,7,653,6514.666666666667,249.0,93.28571428571428,7,4087,6895.666666666667,1514.0,583.8571428571429
123000989.0,17,15,907,8,475,17571569.85714286,174.0,59.375,7,432,17167685.833333332,174.0,61.71428571428572
35509.0,6,14,4740,7,653,4188.0,249.0,93.28571428571428,7,4087,5318.166666666667,1514.0,583.8571428571429
142912.0,17,2,176,1,80,0.0,80.0,80.0,1,96,0.0,96.0,96.0
90765797.0,6,17,1287,9,691,11339855.0,95.0,76.77777777777777,8,596,12965160.0,95.0,74.5
120489052.0,6,223,25352,112,17804,1085486.954954955,284.0,158.96428571428572,111,7548,1085876.3,140.0,68.0
36289.0,6,14,4740,7,653,5939.833333333333,249.0,93.28571428571428,7,4087,5115.666666666667,1514.0,583.8571428571429
45467.0,6,14,4740,7,653,7420.0,249.0,93.28571428571428,7,4087,7019.5,1514.0,583.8571428571429
221615.0,6,3,426,2,280,0.0,214.0,140.0,1,146,0.0,146.0,146.0
107495.0,17,2,286,2,286,0.0,143.0,143.0,0,0,0.0,0.0,0.0
967287.0,6,12,1362,6,731,192019.8,253.0,121.83333333333331,6,631,192927.2,293.0,105.16666666666669
117007868.0,17,13,821,7,432,19501311.33333333,174.0,61.71428571428572,6,389,19400172.6,174.0,64.83333333333333
123029.0,6,12,1328,7,797,20504.83333333333,253.0,113.85714285714286,5,531,28762.75,259.0,106.2
1306992.0,6,4,264,2,132,0.0,66.0,66.0,2,132,0.0,66.0,66.0
59244.0,6,2,132,1,66,0.0,66.0,66.0,1,66,0.0,66.0,66.0
146218.0,6,3,337,2,214,0.0,160.0,107.0,1,123,0.0,123.0,123.0
120147681.0,6,222,25090,111,7622,1084749.309090909,140.0,68.66666666666667,111,17468,1084968.527272727,284.0,157.36936936936937
90030457.0,17,28,13364,28,13364,3334461.3703703703,501.0,477.2857142857143,0,0,0.0,0.0,0.0
413.0,17,2,168,1,76,0.0,76.0,76.0,1,92,0.0,92.0,92.0
115526120.0,6,48,3168,24,1584,5022874.782608695,66.0,66.0,24,1584,5008752.608695652,66.0,66.0
162401.0,17,2,180,1,90,0.0,90.0,90.0,1,90,0.0,90.0,90.0
297633.0,6,6,412,4,272,99211.0,74.0,68.0,2,140,0.0,74.0,70.0
30642.0,6,14,4740,7,653,4986.333333333333,249.0,93.28571428571428,7,4087,4788.833333333333,1514.0,583.8571428571429
137166.0,6,2,132,1,66,0.0,66.0,66.0,1,66,0.0,66.0,66.0
206121.0,6,3,426,2,280,0.0,214.0,140.0,1,146,0.0,146.0,146.0
23073.0,6,11,2098,6,590,3737.0,252.0,98.33333333333331,5,1508,5401.5,1236.0,301.6
2345.0,17,4,344,2,150,0.0,75.0,75.0,2,194,0.0,103.0,97.0
32644.0,6,10,2032,5,524,7185.75,252.0,104.8,5,1508,7612.75,1236.0,301.6
95461258.0,6,39,2574,20,1320,5024264.368421053,66.0,66.0,19,1254,5112013.666666667,66.0,66.0
18616.0,6,11,1133,6,602,3512.0,264.0,100.33333333333331,5,531,3637.0,259.0,106.2
67464.0,6,14,4740,7,653,10622.666666666666,249.0,93.28571428571428,7,4087,10845.833333333334,1514.0,583.8571428571429
107061.0,17,2,286,2,286,0.0,143.0,143.0,0,0,0.0,0.0,0.0
383388.0,17,2,363,1,75,0.0,75.0,75.0,1,288,0.0,288.0,288.0
80387.0,6,10,2032,5,524,18734.75,252.0,104.8,5,1508,18546.75,1236.0,301.6
103985.0,17,2,286,2,286,0.0,143.0,143.0,0,0,0.0,0.0,0.0
107085.0,17,2,286,2,286,0.0,143.0,143.0,0,0,0.0,0.0,0.0
43135.0,6,14,4740,7,653,7021.166666666667,249.0,93.28571428571428,7,4087,6652.166666666667,1514.0,583.8571428571429
99465764.0,17,12,778,6,389,19801579.0,174.0,64.83333333333333,6,389,19800163.8,174.0,64.83333333333333
90293499.0,6,17,1287,9,691,11280436.25,95.0,76.77777777777777,8,596,12832261.42857143,95.0,74.5
197109.0,17,2,180,1,90,0.0,90.0,90.0,1,90,0.0,90.0,90.0
135134272.0,17,6,1146,6,1146,27026854.4,191.0,191.0,0,0,0.0,0.0,0.0
299121.0,6,6,412,4,272,99707.0,74.0,68.0,2,140,0.0,74.0,70.0
27476684.0,17,5,1710,5,1710,6869171.0,342.0,342.0,0,0,0.0,0.0,0.0
205550.0,17,2,180,1,90,0.0,90.0,90.0,1,90,0.0,90.0,90.0
138205.0,6,13,1386,7,789,23034.166666666668,253.0,112.71428571428572,6,597,25729.2,259.0,99.5
39184.0,6,14,4740,7,653,6361.5,249.0,93.28571428571428,7,4087,6250.833333333333,1514.0,583.8571428571429
299898.0,6,6,412,4,272,99966.0,74.0,68.0,2,140,0.0,74.0,70.0
316451.0,17,4,1400,4,1400,105483.66666666669,350.0,350.0,0,0,0.0,0.0,0.0
309097.0,17,4,1400,4,1400,103032.33333333331,350.0,350.0,0,0,0.0,0.0,0.0
91454118.0,17,12,778,6,389,18200163.2,174.0,64.83333333333333,6,389,18201242.8,174.0,64.83333333333333
100781359.0,6,28,1860,14,966,7735821.846153846,123.0,69.0,14,894,7735813.923076923,123.0,63.85714285714285
7126.0,17,2,582,1,83,0.0,83.0,83.0,1,499,0.0,499.0,499.0
90735017.0,6,17,1287,8,637,12962145.285714284,95.0,79.625,9,650,11305052.125,95.0,72.22222222222223
59110.0,6,14,4740,7,653,9516.666666666666,249.0,93.28571428571428,7,4087,9185.5,1514.0,583.8571428571429
108099990.0,17,5,955,5,955,27024997.5,191.0,191.0,0,0,0.0,0.0,0.0
128008991.0,17,15,907,8,475,18286998.71428572,174.0,59.375,7,432,18000175.666666668,174.0,61.71428571428572
324.0,17,2,174,1,79,0.0,79.0,79.0,1,95,0.0,95.0,95.0
1450.0,17,2,762,2,762,0.0,381.0,381.0,0,0,0.0,0.0,0.0
74709.0,17,4,1400,4,1400,24903.0,350.0,350.0,0,0,0.0,0.0,0.0
21680837.0,6,6,1981,4,1087,7226945.666666667,885.0,271.75,2,894,0.0,826.0,447.0
120502711.0,6,213,24008,107,16716,1136818.0283018867,284.0,156.22429906542055,106,7292,1137684.2857142857,140.0,68.79245283018868
3166395.0,6,3,204,2,136,0.0,70.0,68.0,1,68,0.0,68.0,68.0
8111.0,17,2,762,2,762,0.0,381.0,381.0,0,0,0.0,0.0,0.0
596810.0,17,2,473,1,78,0.0,78.0,78.0,1,395,0.0,395.0,395.0
108264119.0,17,14,864,7,432,18000158.5,174.0,61.71428571428572,7,432,18000914.833333332,174.0,61.71428571428572
118058844.0,6,280,31760,140,9536,843433.3741007195,140.0,68.11428571428571,140,22224,843470.8201438849,374.0,158.74285714285713
126010491.0,17,15,907,8,475,18001498.714285713,174.0,59.375,7,432,17666878.833333332,174.0,61.71428571428572
5596879.0,6,5,336,2,134,0.0,68.0,67.0,3,202,1522433.0,70.0,67.33333333333333
143826.0,17,2,180,1,90,0.0,90.0,90.0,1,90,0.0,90.0,90.0
36295.0,6,14,4740,7,653,5925.833333333333,249.0,93.28571428571428,7,4087,5805.0,1514.0,583.8571428571429
700.0,17,4,438,2,148,0.0,74.0,74.0,2,290,0.0,147.0,145.0
90300137.0,6,19,1436,10,745,10027818.333333334,95.0,74.5,9,691,11283656.125,95.0,76.77777777777777
148085.0,17,2,180,1,90,0.0,90.0,90.0,1,90,0.0,90.0,90.0
36142.0,6,14,4740,7,653,5771.0,249.0,93.28571428571428,7,4087,5118.333333333333,1514.0,583.8571428571429
90254644.0,6,12,1832,8,1016,12893520.57142857,188.0,127.0,4,816,30030479.0,204.0,204.0
344.0,17,2,250,1,93,0.0,93.0,93.0,1,157,0.0,157.0,157.0
218569.0,6,3,426,2,280,0.0,214.0,140.0,1,146,0.0,146.0,146.0
16170.0,17,2,582,1,83,0.0,83.0,83.0,1,499,0.0,499.0,499.0
90046016.0,17,28,13364,28,13364,3335037.6296296297,501.0,477.2857142857143,0,0,0.0,0.0,0.0
2658599.0,6,25,7573,14,3735,204507.6153846153,1514.0,266.7857142857143,11,3838,239257.5,1514.0,348.90909090909093
29943.0,6,14,4740,7,653,4865.166666666667,249.0,93.28571428571428,7,4087,4515.166666666667,1514.0,583.8571428571429
217501.0,6,3,426,2,280,0.0,214.0,140.0,1,146,0.0,146.0,146.0
216266.0,17,2,180,1,90,0.0,90.0,90.0,1,90,0.0,90.0,90.0
118556623.0,6,219,24738,110,7556,1087675.4403669725,140.0,68.69090909090909,109,17182,1095544.0648148148,300.0,157.63302752293578
90297144.0,6,24,1829,13,989,7521057.0,95.0,76.07692307692308,11,840,8989331.7,95.0,76.36363636363636
108156.0,6,13,1386,7,789,18026.0,253.0,112.71428571428572,6,597,19031.6,259.0,99.5
135136976.0,17,6,1146,6,1146,27027395.2,191.0,191.0,0,0,0.0,0.0,0.0
298980.0,6,6,412,4,272,99660.0,74.0,68.0,2,140,0.0,74.0,70.0
135001069.0,17,15,907,8,475,19285867.0,174.0,59.375,7,432,19168135.5,174.0,61.71428571428572
35045.0,6,10,2032,5,524,7523.0,252.0,104.8,5,1508,8108.75,1236.0,301.6
120124362.0,6,13,2020,9,1204,15015545.25,188.0,133.77777777777777,4,816,30030178.0,204.0,204.0
14503.0,6,10,1066,5,490,2310.5,218.0,98.0,5,576,3431.0,304.0,115.2
348613.0,6,12,1373,7,714,58102.16666666666,298.0,102.0,5,659,82977.5,379.0,131.8
90256132.0,6,13,2036,8,1016,12893733.142857144,188.0,127.0,5,1020,22521048.25,204.0,204.0
67094.0,6,14,4740,7,653,11060.0,249.0,93.28571428571428,7,4087,10893.0,1514.0,583.8571428571429
14778.0,6,13,1459,7,862,2272.333333333333,271.0,123.14285714285714,6,597,2287.8,259.0,99.5
301679.0,6,6,412,4,272,100559.66666666669,74.0,68.0,2,140,0.0,74.0,70.0
43749.0,6,14,4740,7,653,7125.666666666667,249.0,93.28571428571428,7,4087,5587.833333333333,1514.0,583.8571428571429
112408133.0,6,34,2334,17,1209,7012003.8125,123.0,71.11764705882354,17,1125,7012006.75,123.0,66.17647058823529
102071.0,17,3,1143,3,1143,51035.5,381.0,381.0,0,0,0.0,0.0,0.0
21683.0,6,14,4740,7,653,3299.5,249.0,93.28571428571428,7,4087,3471.1666666666665,1514.0,583.8571428571429
102772.0,17,2,286,2,286,0.0,143.0,143.0,0,0,0.0,0.0,0.0
253478.0,17,4,6056,4,6056,84492.66666666667,1514.0,1514.0,0,0,0.0,0.0,0.0
120124325.0,6,13,2020,9,1204,15015540.625,188.0,133.77777777777777,4,816,30021951.666666668,204.0,204.0
314394.0,6,3,1604,2,851,0.0,785.0,425.5,1,753,0.0,753.0,753.0
108110059.0,17,5,955,5,955,27027514.75,191.0,191.0,0,0,0.0,0.0,0.0
108105705.0,17,5,955,5,955,27026426.25,191.0,191.0,0,0,0.0,0.0,0.0
90036343.0,17,28,13364,28,13364,3334679.3703703703,501.0,477.2857142857143,0,0,0.0,0.0,0.0
108109313.0,17,5,955,5,955,27027328.25,191.0,191.0,0,0,0.0,0.0,0.0
102683.0,17,2,286,2,286,0.0,143.0,143.0,0,0,0.0,0.0,0.0
2880414.0,6,3,1604,2,851,0.0,785.0,425.5,1,753,0.0,753.0,753.0
1590.0,17,2,762,2,762,0.0,381.0,381.0,0,0,0.0,0.0,0.0
2016.0,17,4,344,2,150,0.0,75.0,75.0,2,194,0.0,103.0,97.0
2169482.0,6,25,7610,13,2516,180790.16666666663,1034.0,193.53846153846155,12,5094,168907.0909090909,1510.0,424.5
1162154.0,6,13,3000,8,2372,166022.0,1514.0,296.5,5,628,222412.5,331.0,125.6
280800.0,17,2,414,1,88,0.0,88.0,88.0,1,326,0.0,326.0,326.0
311414.0,17,4,622,4,622,103804.66666666669,163.0,155.5,0,0,0.0,0.0,0.0
108106457.0,17,5,955,5,955,27026614.25,191.0,191.0,0,0,0.0,0.0,0.0
27741.0,6,14,4740,7,653,4502.833333333333,249.0,93.28571428571428,7,4087,4472.0,1514.0,583.8571428571429
119494980.0,17,14,864,7,432,16666810.0,174.0,61.71428571428572,7,432,16668006.833333334,174.0,61.71428571428572
281995.0,17,2,363,1,79,0.0,79.0,79.0,1,284,0.0,284.0,284.0
122560421.0,6,33,2296,17,1225,7660026.3125,139.0,72.05882352941177,16,1071,7490576.266666667,123.0,66.9375
37609.0,6,14,4740,7,653,5223.833333333333,249.0,93.28571428571428,7,4087,5918.666666666667,1514.0,583.8571428571429
1065442.0,6,13,1394,7,797,177573.66666666666,253.0,113.85714285714286,6,597,211120.8,259.0,99.5
149433.0,17,2,414,1,88,0.0,88.0,88.0,1,326,0.0,326.0,326.0
116074724.0,6,47,3102,24,1584,5046715.478260869,66.0,66.0,23,1518,5152000.590909091,66.0,66.0
99187200.0,6,180,20316,90,14154,1112044.4943820224,284.0,157.26666666666668,90,6162,1112043.808988764,140.0,68.46666666666667
349509.0,6,11,1287,6,636,69901.8,298.0,106.0,5,651,86771.0,379.0,130.2
2596814.0,6,2,132,1,66,0.0,66.0,66.0,1,66,0.0,66.0,66.0
42711.0,6,14,4740,7,653,6057.333333333333,249.0,93.28571428571428,7,4087,6883.0,1514.0,583.8571428571429
116331190.0,6,215,24140,108,7424,1087207.38317757,140.0,68.74074074074075,107,16716,1095384.283018868,284.0,156.22429906542055
25625.0,6,14,4740,7,653,4110.833333333333,249.0,93.28571428571428,7,4087,4002.0,1514.0,583.8571428571429
10458751.0,6,7,478,4,272,3440857.333333333,74.0,68.0,3,206,5161177.5,74.0,68.66666666666667
318054.0,17,4,1400,4,1400,106018.0,350.0,350.0,0,0,0.0,0.0,0.0
307294.0,6,6,412,4,272,102431.33333333331,74.0,68.0,2,140,0.0,74.0,70.0
108105646.0,17,5,955,5,955,27026411.5,191.0,191.0,0,0,0.0,0.0,0.0
135125110.0,17,6,1206,6,1206,27025022.0,201.0,201.0,0,0,0.0,0.0,0.0
17397.0,6,10,2032,5,524,4119.5,252.0,104.8,5,1508,3724.75,1236.0,301.6
10747.0,6,10,2032,5,524,1847.75,252.0,104.8,5,1508,2403.5,1236.0,301.6
2572829.0,6,2,132,1,66,0.0,66.0,66.0,1,66,0.0,66.0,66.0
3135560.0,6,3,1777,2,951,0.0,885.0,475.5,1,826,0.0,826.0,826.0
47008.0,6,10,2032,5,524,11512.0,252.0,104.8,5,1508,11515.75,1236.0,301.6
116611488.0,17,16,1212,8,606,16636081.142857144,174.0,75.75,8,606,16597728.0,174.0,75.75
217337.0,6,3,426,2,280,0.0,214.0,140.0,1,146,0.0,146.0,146.0
135130890.0,17,6,1146,6,1146,27026178.0,191.0,191.0,0,0,0.0,0.0,0.0
5063.0,17,2,598,1,72,0.0,72.0,72.0,1,526,0.0,526.0,526.0
62948.00000000001,6,13,1394,7,797,10288.166666666666,253.0,113.85714285714286,6,597,9289.8,259.0,99.5
41410.0,6,14,4740,7,653,6401.333333333333,249.0,93.28571428571428,7,4087,6355.166666666667,1514.0,583.8571428571429
10502877.0,6,7,478,4,272,3455875.333333333,74.0,68.0,3,206,5183718.0,74.0,68.66666666666667
100262945.0,17,12,778,6,389,20052589.0,174.0,64.83333333333333,6,389,19964091.4,174.0,64.83333333333333
135132540.0,17,6,1146,6,1146,27026508.0,191.0,191.0,0,0,0.0,0.0,0.0
115566311.0,6,218,24646,109,17156,1068066.3240740742,284.0,157.39449541284404,109,7490,1068066.3148148148,140.0,68.71559633027523
120342134.0,6,226,25534,113,7754,1067162.6875,140.0,68.61946902654867,113,17780,1067160.1964285714,284.0,157.34513274336285
389.0,17,2,166,1,75,0.0,75.0,75.0,1,91,0.0,91.0,91.0
228287.0,17,2,180,1,90,0.0,90.0,90.0,1,90,0.0,90.0,90.0
112398.0,17,4,1524,4,1524,37466.0,381.0,381.0,0,0,0.0,0.0,0.0
214753.0,6,12,1373,7,714,35792.166666666664,298.0,102.0,5,659,52762.5,379.0,131.8
120007340.0,17,23,10929,23,10929,5454879.090909091,501.0,475.1739130434783,0,0,0.0,0.0,0.0
1313213.0,6,4,264,2,132,0.0,66.0,66.0,2,132,0.0,66.0,66.0
143927.0,17,2,180,1,90,0.0,90.0,90.0,1,90,0.0,90.0,90.0
100275403.0,17,12,778,6,389,20021431.4,174.0,64.83333333333333,6,389,20023297.2,174.0,64.83333333333333
92211474.0,17,12,778,6,389,18400162.0,174.0,64.83333333333333,6,389,18399972.2,174.0,64.83333333333333
90299881.0,6,17,1287,9,691,11282106.625,95.0,76.77777777777777,8,596,12831131.0,95.0,74.5
120222111.0,6,212,23980,106,7292,1133870.9619047618,140.0,68.79245283018868,106,16688,1137131.980952381,284.0,157.43396226415095
131.0,17,2,700,2,700,0.0,350.0,350.0,0,0,0.0,0.0,0.0
135132907.0,17,6,1206,6,1206,27026581.4,201.0,201.0,0,0,0.0,0.0,0.0
14643805.0,6,20,1648,10,1016,1592786.6666666667,315.0,101.6,10,632,1592762.6666666667,78.0,63.2
79106.0,6,10,2032,5,524,19523.0,252.0,104.8,5,1508,15275.0,1236.0,301.6
8920.0,17,2,507,1,86,0.0,86.0,86.0,1,421,0.0,421.0,421.0
37112.0,6,10,2032,5,524,9046.5,252.0,104.8,5,1508,8927.25,1236.0,301.6
10539871.0,6,7,478,4,272,3467990.0,74.0,68.0,3,206,5201872.0,74.0,68.66666666666667
16374.0,6,11,2098,6,590,3195.6,252.0,98.33333333333331,5,1508,3443.25,1236.0,301.6
313911.0,17,4,1400,4,1400,104637.0,350.0,350.0,0,0,0.0,0.0,0.0
43182.0,6,14,4740,7,653,7034.166666666667,249.0,93.28571428571428,7,4087,6930.0,1514.0,583.8571428571429
4399.0,17,2,598,1,72,0.0,72.0,72.0,1,526,0.0,526.0,526.0
120762552.0,6,238,26754,119,8150,1016432.9152542372,140.0,68.4873949579832,119,18604,1020075.4576271188,284.0,156.3361344537815
113613404.0,6,46,3036,23,1518,5150442.7727272725,66.0,66.0,23,1518,5150439.7727272725,66.0,66.0
2084.0,17,4,344,2,150,0.0,75.0,75.0,2,194,0.0,103.0,97.0
205675.0,17,2,180,1,90,0.0,90.0,90.0,1,90,0.0,90.0,90.0
31247.0,6,14,4740,7,653,5028.333333333333,249.0,93.28571428571428,7,4087,4832.0,1514.0,583.8571428571429
41091.0,6,14,4740,7,653,6724.0,249.0,93.28571428571428,7,4087,6446.166666666667,1514.0,583.8571428571429
227092.0,17,2,180,1,90,0.0,90.0,90.0,1,90,0.0,90.0,90.0
7990.000000000001,17,4,823,2,163,0.0,89.0,81.5,2,660,0.0,443.0,330.0
419861.0,6,3,1604,1,753,0.0,753.0,753.0,2,851,0.0,785.0,425.5
10473110.0,6,6,412,3,206,5167863.5,74.0,68.66666666666667,3,206,5167778.0,74.0,68.66666666666667
871854.0,6,9,1270,6,799,174370.8,461.0,133.16666666666666,3,471,297943.0,331.0,157.0
197176.0,17,2,180,1,90,0.0,90.0,90.0,1,90,0.0,90.0,90.0
206343.0,6,3,426,2,280,0.0,214.0,140.0,1,146,0.0,146.0,146.0
228220.0,17,2,180,1,90,0.0,90.0,90.0,1,90,0.0,90.0,90.0
1479870.0,17,16,1120,16,1120,98658.0,70.0,70.0,0,0,0.0,0.0,0.0
207752.0,6,10,1221,6,636,41550.4,298.0,106.0,4,585,67930.0,379.0,146.25
36890.0,6,14,4740,7,653,5354.0,249.0,93.28571428571428,7,4087,4919.333333333333,1514.0,583.8571428571429
211276.0,17,2,359,1,75,0.0,75.0,75.0,1,284,0.0,284.0,284.0
90538949.0,6,13,2036,8,1016,12934135.57142857,188.0,127.0,5,1020,22593794.5,204.0,204.0
135125635.0,17,6,1206,6,1206,27025127.0,201.0,201.0,0,0,0.0,0.0,0.0
120004316.0,6,17,1246,9,650,15000539.5,95.0,72.22222222222223,8,596,17105770.42857143,95.0,74.5
34155554.0,6,7,1874,3,887,17003268.0,753.0,295.6666666666667,4,987,11338513.666666666,785.0,246.75
9744.0,17,2,571,1,86,0.0,86.0,86.0,1,485,0.0,485.0,485.0
6774.0,17,2,180,1,90,0.0,90.0,90.0,1,90,0.0,90.0,90.0
4480.0,17,2,614,1,72,0.0,72.0,72.0,1,542,0.0,542.0,542.0
71337.0,6,10,2032,5,524,17613.5,252.0,104.8,5,1508,16424.0,1236.0,301.6
699054.0,6,10,1124,6,608,139810.8,222.0,101.33333333333331,4,516,147134.66666666666,206.0,129.0
228297.0,17,2,180,1,90,0.0,90.0,90.0,1,90,0.0,90.0,90.0
103552.0,17,2,286,2,286,0.0,143.0,143.0,0,0,0.0,0.0,0.0
148113.0,17,2,180,1,90,0.0,90.0,90.0,1,90,0.0,90.0,90.0
256697.0,6,3,337,2,214,0.0,160.0,107.0,1,123,0.0,123.0,123.0
41891.0,6,14,4740,7,653,6843.833333333333,249.0,93.28571428571428,7,4087,6041.166666666667,1514.0,583.8571428571429
27691.0,6,11,1133,6,602,4827.8,264.0,100.33333333333331,5,531,6176.0,259.0,106.2
90038720.0,17,28,13364,28,13364,3334767.407407407,501.0,477.2857142857143,0,0,0.0,0.0,0.0
13110296.0,6,26,7627,14,3735,186733.6153846153,1514.0,266.7857142857143,12,3892,1173164.0909090908,1514.0,324.3333333333333
39851067.0,6,5,336,2,134,0.0,68.0,67.0,3,202,19854971.0,70.0,67.33333333333333
108105589.0,17,5,1005,5,1005,27026397.25,201.0,201.0,0,0,0.0,0.0,0.0
114610.0,17,4,1400,4,1400,38203.333333333336,350.0,350.0,0,0,0.0,0.0,0.0
2367.0,17,4,344,2,150,0.0,75.0,75.0,2,194,0.0,103.0,97.0
17285.0,6,10,2032,5,524,3228.25,252.0,104.8,5,1508,4063.25,1236.0,301.6
0.0,17,1,99,1,99,0.0,99.0,99.0,0,0,0.0,0.0,0.0
149776564.0,17,36,17126,36,17126,4279330.4,501.0,475.72222222222223,0,0,0.0,0.0,0.0
5001.0,17,2,180,1,90,0.0,90.0,90.0,1,90,0.0,90.0,90.0
3108.0,17,2,224,1,76,0.0,76.0,76.0,1,148,0.0,148.0,148.0
98546.0,6,2,132,1,66,0.0,66.0,66.0,1,66,0.0,66.0,66.0
75615535.0,6,9,842,9,842,9451941.875,97.0,93.55555555555556,0,0,0.0,0.0,0.0
104046.0,6,10,2032,5,524,23948.25,252.0,104.8,5,1508,25081.5,1236.0,301.6
208380.0,6,3,426,2,280,0.0,214.0,140.0,1,146,0.0,146.0,146.0
232999.0,6,3,337,2,214,0.0,160.0,107.0,1,123,0.0,123.0,123.0
251541.00000000003,6,3,373,2,238,0.0,172.0,119.0,1,135,0.0,135.0,135.0
72808.0,6,14,4740,7,653,11347.666666666666,249.0,93.28571428571428,7,4087,11994.333333333334,1514.0,583.8571428571429
6053494.0,17,5,1710,5,1710,1513373.5,342.0,342.0,0,0,0.0,0.0,0.0
32784967.0,6,5,336,2,134,0.0,68.0,67.0,3,202,15002820.5,70.0,67.33333333333333
134159.0,6,3,337,2,214,0.0,160.0,107.0,1,123,0.0,123.0,123.0
108109167.0,17,5,955,5,955,27027291.75,191.0,191.0,0,0,0.0,0.0,0.0
1215.0,17,2,508,2,508,0.0,257.0,254.0,0,0,0.0,0.0,0.0
317256.0,17,4,1400,4,1400,105752.0,350.0,350.0,0,0,0.0,0.0,0.0
232275.0,6,3,337,2,214,0.0,160.0,107.0,1,123,0.0,123.0,123.0
108103751.0,17,5,1005,5,1005,27025937.75,201.0,201.0,0,0,0.0,0.0,0.0
39369.0,6,10,2032,5,524,9599.25,252.0,104.8,5,1508,8146.75,1236.0,301.6
108107500.0,17,5,955,5,955,27026875.0,191.0,191.0,0,0,0.0,0.0,0.0
108099547.0,17,5,1005,5,1005,27024886.75,201.0,201.0,0,0,0.0,0.0,0.0
5427.0,17,2,180,1,90,0.0,90.0,90.0,1,90,0.0,90.0,90.0
105037696.0,17,14,4788,14,4788,8079822.769230769,342.0,342.0,0,0,0.0,0.0,0.0
206077.0,6,3,426,2,280,0.0,214.0,140.0,1,146,0.0,146.0,146.0
90020619.0,17,28,13364,28,13364,3334097.0,501.0,477.2857142857143,0,0,0.0,0.0,0.0
23044006.0,17,3,1034,2,684,0.0,342.0,342.0,1,350,0.0,350.0,350.0
91204973.0,6,23,1775,13,1030,7596336.583333333,95.0,79.23076923076923,10,745,10102322.555555556,95.0,74.5
1550194.0,6,4,276,2,128,0.0,74.0,64.0,2,148,0.0,74.0,74.0
67215.0,6,14,4740,7,653,11082.166666666666,249.0,93.28571428571428,7,4087,9899.333333333334,1514.0,583.8571428571429
216491.0,17,2,180,1,90,0.0,90.0,90.0,1,90,0.0,90.0,90.0
2689150.0,6,25,7573,14,3735,206857.6923076923,1514.0,266.7857142857143,11,3838,243653.0,1514.0,348.90909090909093
696799.0,6,10,1124,6,608,139359.8,222.0,101.33333333333331,4,516,146962.0,206.0,129.0
402364.0,6,4,508,2,238,0.0,172.0,119.0,2,270,0.0,135.0,135.0
187981.0,17,4,1400,4,1400,62660.333333333336,350.0,350.0,0,0,0.0,0.0,0.0
5005077.0,17,4,849,2,166,0.0,83.0,83.0,2,683,0.0,499.0,341.5
5375.0,17,2,598,1,72,0.0,72.0,72.0,1,526,0.0,526.0,526.0
90289905.0,6,16,1192,8,596,12892184.42857143,95.0,74.5,8,596,12896608.857142856,95.0,74.5
209562.0,17,2,180,1,90,0.0,90.0,90.0,1,90,0.0,90.0,90.0
114302.0,17,2,762,2,762,0.0,381.0,381.0,0,0,0.0,0.0,0.0
42575.0,6,10,2032,5,524,10420.5,252.0,104.8,5,1508,10338.75,1236.0,301.6
3082.0,17,2,224,1,76,0.0,76.0,76.0,1,148,0.0,148.0,148.0
1030853.0,6,11,1134,6,558,206170.6,220.0,93.0,5,576,256067.0,304.0,115.2
37578.0,6,10,2032,5,524,9153.75,252.0,104.8,5,1508,8862.0,1236.0,301.6
299938.0,6,6,412,4,272,99979.33333333331,74.0,68.0,2,140,0.0,74.0,70.0
90302376.0,6,16,1192,8,596,12893914.857142856,95.0,74.5,8,596,12899516.714285716,95.0,74.5
110943422.0,6,32,2236,16,1165,7381850.133333334,139.0,72.8125,16,1071,7381848.133333334,123.0,66.9375
160148.0,6,2,128,1,74,0.0,74.0,74.0,1,54,0.0,54.0,54.0
147456.0,6,3,373,2,238,0.0,172.0,119.0,1,135,0.0,135.0,135.0
3027.0,17,2,224,1,76,0.0,76.0,76.0,1,148,0.0,148.0,148.0
19753041.0,6,26,7627,14,3735,178419.84615384616,1514.0,266.7857142857143,12,3892,1777048.181818182,1514.0,324.3333333333333
17032.0,17,4,823,2,163,0.0,89.0,81.5,2,660,0.0,443.0,330.0
28827.0,6,14,4740,7,653,4673.666666666667,249.0,93.28571428571428,7,4087,4640.166666666667,1514.0,583.8571428571429
90047876.0,17,28,13364,28,13364,3335106.5185185187,501.0,477.2857142857143,0,0,0.0,0.0,0.0
117290.0,17,2,700,2,700,0.0,350.0,350.0,0,0,0.0,0.0,0.0
312286.0,6,6,412,4,272,104095.33333333331,74.0,68.0,2,140,0.0,74.0,70.0
228360.0,17,2,180,1,90,0.0,90.0,90.0,1,90,0.0,90.0,90.0
2427.0,17,4,344,2,150,0.0,75.0,75.0,2,194,0.0,103.0,97.0
10514741.0,6,7,478,4,272,3459452.0,74.0,68.0,3,206,5189058.0,74.0,68.66666666666667
403.0,17,2,174,1,79,0.0,79.0,79.0,1,95,0.0,95.0,95.0
299911.0,6,6,412,4,272,99970.33333333331,74.0,68.0,2,140,0.0,74.0,70.0
101859.0,17,2,286,2,286,0.0,143.0,143.0,0,0,0.0,0.0,0.0
119622842.0,6,544,74634,272,56386,440614.2804428045,426.0,207.3014705882353,272,18248,440614.0996309963,140.0,67.08823529411765
300545.0,6,6,412,4,272,100181.66666666669,74.0,68.0,2,140,0.0,74.0,70.0
119761799.0,6,26,1978,14,1084,9212446.076923076,95.0,77.42857142857143,12,894,10844625.090909092,95.0,74.5
102654217.0,17,14,864,7,432,17000869.0,174.0,61.71428571428572,7,432,17000195.166666668,174.0,61.71428571428572
16806.0,6,14,4740,7,653,2569.833333333333,249.0,93.28571428571428,7,4087,2664.1666666666665,1514.0,583.8571428571429
3246033.0,6,14,4740,7,653,540876.1666666666,249.0,93.28571428571428,7,4087,540231.6666666666,1514.0,583.8571428571429
90359274.0,6,12,1848,7,828,15059879.0,188.0,118.28571428571428,5,1020,15082052.25,204.0,204.0
260147.00000000003,6,3,337,2,214,0.0,160.0,107.0,1,123,0.0,123.0,123.0
120057222.0,17,29,13785,29,13785,4287757.928571428,501.0,475.3448275862069,0,0,0.0,0.0,0.0
21637.0,6,14,4740,7,653,3496.5,249.0,93.28571428571428,7,4087,3009.833333333333,1514.0,583.8571428571429
103365.0,17,2,286,2,286,0.0,143.0,143.0,0,0,0.0,0.0,0.0
36841.0,6,14,4740,7,653,5837.166666666667,249.0,93.28571428571428,7,4087,5763.5,1514.0,583.8571428571429
17449010.0,6,24,8675,14,1785,1342231.5384615385,408.0,127.5,10,6890,1479766.4444444445,1514.0,689.0
197162.0,17,2,180,1,90,0.0,90.0,90.0,1,90,0.0,90.0,90.0
217058.0,17,2,180,1,90,0.0,90.0,90.0,1,90,0.0,90.0,90.0
102441414.0,6,32,2236,16,1165,6815016.8,139.0,72.8125,16,1071,6815024.4,123.0,66.9375
246140.0,6,3,337,2,214,0.0,160.0,107.0,1,123,0.0,123.0,123.0
284576.0,17,4,704,2,148,0.0,74.0,74.0,2,556,0.0,280.0,278.0
141666.0,6,2,132,1,66,0.0,66.0,66.0,1,66,0.0,66.0,66.0
91025861.0,6,174,19650,87,13686,1055938.5930232557,284.0,157.31034482758622,87,5964,1055939.0,140.0,68.55172413793103
67302.0,6,14,4740,7,653,11109.0,249.0,93.28571428571428,7,4087,10096.666666666666,1514.0,583.8571428571429
53934.0,6,13,1386,7,789,8820.5,253.0,112.71428571428572,6,597,8609.2,259.0,99.5
135126905.0,17,6,1146,6,1146,27025381.0,191.0,191.0,0,0,0.0,0.0,0.0
11744.0,6,10,2032,5,524,1888.25,252.0,104.8,5,1508,2680.75,1236.0,301.6
96596.0,17,2,762,2,762,0.0,381.0,381.0,0,0,0.0,0.0,0.0
1774791.0,6,2,132,1,66,0.0,66.0,66.0,1,66,0.0,66.0,66.0
329627.0,6,6,412,4,272,109875.66666666669,74.0,68.0,2,140,0.0,74.0,70.0
108135137.0,17,5,955,5,955,27033784.25,191.0,191.0,0,0,0.0,0.0,0.0
241005.0,6,13,1386,7,789,40167.5,253.0,112.71428571428572,6,597,47360.0,259.0,99.5
2330.0,17,4,344,2,150,0.0,75.0,75.0,2,194,0.0,103.0,97.0
126181275.0,6,35,2394,18,1269,7422427.94117647,123.0,70.5,17,1125,7248701.5,123.0,66.17647058823529
216691.0,6,3,426,2,280,0.0,214.0,140.0,1,146,0.0,146.0,146.0
208671.0,6,10,1221,6,636,41734.2,298.0,106.0,4,585,68382.0,379.0,146.25
205909.0,17,2,180,1,90,0.0,90.0,90.0,1,90,0.0,90.0,90.0
11885.0,6,10,2032,5,524,2426.25,252.0,104.8,5,1508,2612.0,1236.0,301.6
108103507.0,17,5,1005,5,1005,27025876.75,201.0,201.0,0,0,0.0,0.0,0.0
172481.0,17,2,180,1,90,0.0,90.0,90.0,1,90,0.0,90.0,90.0
29816.0,6,10,2032,5,524,6483.75,252.0,104.8,5,1508,4854.0,1236.0,301.6
90259036.0,6,14,2240,8,1016,12894148.0,188.0,127.0,6,1224,18018574.2,204.0,204.0
340520.0,6,3,204,1,68,0.0,68.0,68.0,2,136,0.0,70.0,68.0
129007849.0,17,15,907,8,475,18429692.71428572,174.0,59.375,7,432,18166837.83333333,174.0,61.71428571428572
90062780.0,17,28,13364,28,13364,3335658.5185185187,501.0,477.2857142857143,0,0,0.0,0.0,0.0
17695.0,6,11,2098,6,590,2846.0,252.0,98.33333333333331,5,1508,3963.0,1236.0,301.6
147964.0,17,2,180,1,90,0.0,90.0,90.0,1,90,0.0,90.0,90.0
147126.0,6,3,373,2,238,0.0,172.0,119.0,1,135,0.0,135.0,135.0
4010.0,17,4,704,2,148,0.0,74.0,74.0,2,556,0.0,280.0,278.0
2325.0,17,4,344,2,150,0.0,75.0,75.0,2,194,0.0,103.0,97.0
9208599.0,17,4,1376,3,1026,981743.0,342.0,342.0,1,350,0.0,350.0,350.0
241284.0,6,3,337,2,214,0.0,160.0,107.0,1,123,0.0,123.0,123.0
2021884.0,17,4,525,2,150,0.0,75.0,75.0,2,375,0.0,284.0,187.5
351.0,17,2,152,1,76,0.0,76.0,76.0,1,76,0.0,76.0,76.0
228285.0,17,2,180,1,90,0.0,90.0,90.0,1,90,0.0,90.0,90.0
107639.0,17,2,286,2,286,0.0,143.0,143.0,0,0,0.0,0.0,0.0
272376.0,6,10,1221,6,636,54475.2,298.0,106.0,4,585,87031.66666666667,379.0,146.25
135137253.0,17,6,1146,6,1146,27027450.6,191.0,191.0,0,0,0.0,0.0,0.0
137113.0,6,2,132,1,66,0.0,66.0,66.0,1,66,0.0,66.0,66.0
135136242.0,17,6,1146,6,1146,27027248.4,191.0,191.0,0,0,0.0,0.0,0.0
3118661.0,6,3,1604,1,753,0.0,753.0,753.0,2,851,0.0,785.0,425.5
27091254.0,17,5,1710,5,1710,6772813.5,342.0,342.0,0,0,0.0,0.0,0.0
112464360.0,6,46,3036,23,1518,5112001.090909091,66.0,66.0,23,1518,5111995.681818182,66.0,66.0
310336.0,6,6,412,4,272,103445.33333333331,74.0,68.0,2,140,0.0,74.0,70.0
329.0,17,2,208,1,72,0.0,72.0,72.0,1,136,0.0,136.0,136.0
90043605.0,17,28,13364,28,13364,3334948.333333333,501.0,477.2857142857143,0,0,0.0,0.0,0.0
90044099.0,17,28,13364,28,13364,3334966.6296296297,501.0,477.2857142857143,0,0,0.0,0.0,0.0
143942.0,17,2,180,1,90,0.0,90.0,90.0,1,90,0.0,90.0,90.0
0.0,17,1,381,1,381,0.0,381.0,381.0,0,0,0.0,0.0,0.0
90061853.0,17,28,13364,28,13364,3335624.185185185,501.0,477.2857142857143,0,0,0.0,0.0,0.0
207948.0,6,3,426,2,280,0.0,214.0,140.0,1,146,0.0,146.0,146.0
42503.0,6,10,2032,5,524,10225.75,252.0,104.8,5,1508,9750.0,1236.0,301.6
15341.0,17,2,180,1,90,0.0,90.0,90.0,1,90,0.0,90.0,90.0
2478.0,17,4,344,2,150,0.0,75.0,75.0,2,194,0.0,103.0,97.0
47815293.0,6,8,2113,3,960,22784891.0,826.0,320.0,5,1153,11258060.25,885.0,230.6
62404.0,6,10,2032,5,524,15356.75,252.0,104.8,5,1508,14657.0,1236.0,301.6
90051253.0,17,28,13364,28,13364,3335231.592592593,501.0,477.2857142857143,0,0,0.0,0.0,0.0
91125932.0,6,33,2412,17,1272,5681884.5625,123.0,74.82352941176471,16,1140,6060636.4,123.0,71.25
228428.0,17,2,180,1,90,0.0,90.0,90.0,1,90,0.0,90.0,90.0
2717667.0,6,25,7589,14,3751,209051.3076923077,1514.0,267.92857142857144,11,3838,245519.4,1514.0,348.90909090909093
298180.0,6,6,412,4,272,99393.33333333331,74.0,68.0,2,140,0.0,74.0,70.0
19788.0,6,11,1133,6,602,3862.0,264.0,100.33333333333331,5,531,4059.25,259.0,106.2
50512.0,6,14,4740,7,653,8213.833333333334,249.0,93.28571428571428,7,4087,7880.333333333333,1514.0,583.8571428571429
0.0,6,1,66,1,66,0.0,66.0,66.0,0,0,0.0,0.0,0.0
31877.000000000004,6,14,4740,7,653,5190.333333333333,249.0,93.28571428571428,7,4087,5109.0,1514.0,583.8571428571429
15855253.0,17,6,2052,6,2052,3171050.6,342.0,342.0,0,0,0.0,0.0,0.0
108106738.0,17,5,1005,5,1005,27026684.5,201.0,201.0,0,0,0.0,0.0,0.0
228152.0,17,2,180,1,90,0.0,90.0,90.0,1,90,0.0,90.0,90.0
120155914.0,6,238,26866,119,8150,1011286.2966101696,140.0,68.4873949579832,119,18716,1012355.754237288,284.0,157.27731092436974
179817.0,17,2,180,1,90,0.0,90.0,90.0,1,90,0.0,90.0,90.0
106240784.0,6,193,21742,97,6636,1106674.8333333333,140.0,68.41237113402062,96,15106,1107365.4736842106,284.0,157.35416666666666
144.0,17,3,1050,3,1050,72.0,350.0,350.0,0,0,0.0,0.0,0.0
127005787.0,17,17,1255,9,649,15875723.375,174.0,72.11111111111111,8,606,15261070.42857143,174.0,75.75
199036.0,17,2,180,1,90,0.0,90.0,90.0,1,90,0.0,90.0,90.0
503300.0,17,2,876,2,876,0.0,438.0,438.0,0,0,0.0,0.0,0.0
2396.0,17,4,344,2,150,0.0,75.0,75.0,2,194,0.0,103.0,97.0
123999817.0,17,16,1343,8,606,17021896.57142857,174.0,75.75,8,737,16713432.857142856,174.0,92.125
200924.0,17,4,6056,4,6056,66974.66666666667,1514.0,1514.0,0,0,0.0,0.0,0.0
148690.0,6,3,337,2,214,0.0,160.0,107.0,1,123,0.0,123.0,123.0
246401.0,6,3,373,2,238,0.0,172.0,119.0,1,135,0.0,135.0,135.0
313.0,17,2,174,1,79,0.0,79.0,79.0,1,95,0.0,95.0,95.0
1098454.0,17,6,1230,3,234,549048.0,78.0,78.0,3,996,548842.0,332.0,332.0
135132562.0,17,6,1206,6,1206,27026512.4,201.0,201.0,0,0,0.0,0.0,0.0
166616.0,17,2,180,1,90,0.0,90.0,90.0,1,90,0.0,90.0,90.0
10524813.0,6,7,478,4,272,3461368.333333333,74.0,68.0,3,206,5191957.5,74.0,68.66666666666667
153837.0,17,2,180,1,90,0.0,90.0,90.0,1,90,0.0,90.0,90.0
74573488.0,6,9,842,9,842,9321686.0,97.0,93.55555555555556,0,0,0.0,0.0,0.0
120153336.0,6,579,109908,284,19188,421682.98233215546,214.0,67.56338028169014,295,90720,405920.2653061224,1514.0,307.5254237288136
4466.0,17,2,622,1,75,0.0,75.0,75.0,1,547,0.0,547.0,547.0
47517.0,6,14,4740,7,653,7801.333333333333,249.0,93.28571428571428,7,4087,7778.5,1514.0,583.8571428571429
120211.0,17,2,180,1,70,0.0,70.0,70.0,1,110,0.0,110.0,110.0
177282.0,17,2,180,1,90,0.0,90.0,90.0,1,90,0.0,90.0,90.0
206312.0,6,3,426,2,280,0.0,214.0,140.0,1,146,0.0,146.0,146.0
135132906.0,17,6,1146,6,1146,27026581.2,191.0,191.0,0,0,0.0,0.0,0.0
120274914.0,6,233,26388,117,18510,1036852.7068965518,284.0,158.2051282051282,116,7878,1028835.4608695653,140.0,67.91379310344827
202012.0,17,4,6056,4,6056,67337.33333333333,1514.0,1514.0,0,0,0.0,0.0,0.0
757.0,17,4,438,2,148,0.0,74.0,74.0,2,290,0.0,147.0,145.0
309368.0,17,6,1230,3,234,154504.5,78.0,78.0,3,996,154479.0,332.0,332.0
228240.0,17,2,180,1,90,0.0,90.0,90.0,1,90,0.0,90.0,90.0
146282.0,6,3,337,2,214,0.0,160.0,107.0,1,123,0.0,123.0,123.0
377991.0,17,6,2100,6,2100,75598.2,350.0,350.0,0,0,0.0,0.0,0.0
1302429.0,6,4,264,2,132,0.0,66.0,66.0,2,132,0.0,66.0,66.0
135131720.0,17,6,1146,6,1146,27026344.0,191.0,191.0,0,0,0.0,0.0,0.0
9255.0,17,2,539,1,86,0.0,86.0,86.0,1,453,0.0,453.0,453.0
361.0,17,2,160,1,80,0.0,80.0,80.0,1,80,0.0,80.0,80.0
333343.0,6,3,1604,2,851,0.0,785.0,425.5,1,753,0.0,753.0,753.0
110964499.0,6,32,2236,16,1165,7383195.2,139.0,72.8125,16,1071,7383234.466666667,123.0,66.9375
144840.0,17,2,180,1,70,0.0,70.0,70.0,1,110,0.0,110.0,110.0
135121547.0,17,6,1146,6,1146,27024309.4,191.0,191.0,0,0,0.0,0.0,0.0
206050.0,6,3,426,2,280,0.0,214.0,140.0,1,146,0.0,146.0,146.0
16015673.0,17,2,684,2,684,0.0,342.0,342.0,0,0,0.0,0.0,0.0
90256846.0,6,12,1876,8,1080,12893835.142857144,204.0,135.0,4,796,30030879.33333333,199.0,199.0
297130.0,6,6,412,4,272,99043.33333333331,74.0,68.0,2,140,0.0,74.0,70.0
1313512.0,6,4,264,2,132,0.0,66.0,66.0,2,132,0.0,66.0,66.0
324968.0,6,10,1221,6,636,64993.6,298.0,106.0,4,585,102719.66666666669,379.0,146.25
15482.0,6,10,2032,5,524,3640.0,252.0,104.8,5,1508,3585.75,1236.0,301.6
829561.0,6,9,1118,6,586,165912.2,248.0,97.66666666666669,3,532,278444.5,392.0,177.33333333333334
230849.0,17,2,180,1,90,0.0,90.0,90.0,1,90,0.0,90.0,90.0
144147.0,17,2,180,1,90,0.0,90.0,90.0,1,90,0.0,90.0,90.0
3010066.0,6,11,2106,6,598,601833.2,252.0,99.66666666666669,5,1508,2760.75,1236.0,301.6
105460647.0,17,14,864,7,432,17501467.166666668,174.0,61.71428571428572,7,432,17500185.166666668,174.0,61.71428571428572
308411.0,6,6,412,4,272,102803.66666666669,74.0,68.0,2,140,0.0,74.0,70.0
68353.0,17,4,1400,4,1400,22784.33333333333,350.0,350.0,0,0,0.0,0.0,0.0
153597.0,6,3,373,2,238,0.0,172.0,119.0,1,135,0.0,135.0,135.0
10472643.0,6,7,478,4,272,3443880.6666666665,74.0,68.0,3,206,5165729.5,74.0,68.66666666666667
146206.0,6,3,337,2,214,0.0,160.0,107.0,1,123,0.0,123.0,123.0
208619.0,6,10,1221,6,636,41723.8,298.0,106.0,4,585,68315.66666666667,379.0,146.25
20156.0,17,2,582,1,83,0.0,83.0,83.0,1,499,0.0,499.0,499.0
313298.0,6,3,1604,2,851,0.0,785.0,425.5,1,753,0.0,753.0,753.0
19741.0,17,2,582,1,83,0.0,83.0,83.0,1,499,0.0,499.0,499.0
116631415.0,6,220,24842,110,17274,1068038.394495413,284.0,157.03636363636363,110,7568,1068038.0642201835,140.0,68.8
0.0,17,1,44,1,44,0.0,44.0,44.0,0,0,0.0,0.0,0.0
48653.0,6,14,4740,7,653,7947.333333333333,249.0,93.28571428571428,7,4087,6295.666666666667,1514.0,583.8571428571429
812.0,17,4,438,2,148,0.0,74.0,74.0,2,290,0.0,147.0,145.0
23827.0,6,14,4740,7,653,3495.833333333333,249.0,93.28571428571428,7,4087,3757.8333333333335,1514.0,583.8571428571429
207584.0,6,3,426,2,280,0.0,214.0,140.0,1,146,0.0,146.0,146.0
54106.0,6,10,2032,5,524,12253.75,252.0,104.8,5,1508,11879.75,1236.0,301.6
16935.0,6,10,1975,5,467,4015.75,195.0,93.4,5,1508,3698.5,1236.0,301.6
246324.0,6,3,337,2,214,0.0,160.0,107.0,1,123,0.0,123.0,123.0
24227.0,6,10,1949,5,441,5815.25,169.0,88.2,5,1508,5789.0,1236.0,301.6
14638113.0,6,20,1607,10,975,1592320.888888889,315.0,97.5,10,632,1592266.5555555555,78.0,63.2
123459018.0,6,49,3234,25,1650,5144125.75,66.0,66.0,24,1584,4997022.130434782,66.0,66.0
90185039.0,6,21,1711,10,912,9996549.333333334,221.0,91.2,11,799,8996882.8,95.0,72.63636363636364
135130082.0,17,6,1206,6,1206,27026016.4,201.0,201.0,0,0,0.0,0.0,0.0
121370.0,6,3,337,2,214,0.0,160.0,107.0,1,123,0.0,123.0,123.0
26183826.0,17,3,1034,2,684,0.0,342.0,342.0,1,350,0.0,350.0,350.0
95882941.0,6,25,1686,13,840,7990245.083333333,123.0,64.61538461538461,12,846,8138516.272727272,123.0,70.5
90265536.0,6,13,2036,8,1016,12895076.57142857,188.0,127.0,5,1020,22525669.75,204.0,204.0
90034775.0,17,28,13364,28,13364,3334621.296296296,501.0,477.2857142857143,0,0,0.0,0.0,0.0
135118893.0,17,6,1206,6,1206,27023778.6,201.0,201.0,0,0,0.0,0.0,0.0
2564648.0,6,3,1777,2,951,0.0,885.0,475.5,1,826,0.0,826.0,826.0
1240.0,17,2,684,2,684,0.0,342.0,342.0,0,0,0.0,0.0,0.0
891282.0,6,9,1270,6,799,178256.4,461.0,133.16666666666666,3,471,307718.5,331.0,157.0
724.0,17,2,508,2,508,0.0,257.0,254.0,0,0,0.0,0.0,0.0
4358.0,17,2,614,1,72,0.0,72.0,72.0,1,542,0.0,542.0,542.0
315867.0,17,4,1400,4,1400,105289.0,350.0,350.0,0,0,0.0,0.0,0.0
1815885.0,17,6,1230,3,234,907758.0,78.0,78.0,3,996,907707.0,332.0,332.0
90221126.0,6,16,1192,8,596,12852258.42857143,95.0,74.5,8,596,12857859.42857143,95.0,74.5
216455.0,17,2,180,1,90,0.0,90.0,90.0,1,90,0.0,90.0,90.0
207234.0,6,3,426,2,280,0.0,214.0,140.0,1,146,0.0,146.0,146.0
0.0,6,1,54,0,0,0.0,0.0,0.0,1,54,0.0,54.0,54.0
228423.0,17,2,180,1,90,0.0,90.0,90.0,1,90,0.0,90.0,90.0
102339.0,17,2,286,2,286,0.0,143.0,143.0,0,0,0.0,0.0,0.0
143896.0,17,2,180,1,90,0.0,90.0,90.0,1,90,0.0,90.0,90.0
90755983.0,6,19,1436,10,745,10079379.222222222,95.0,74.5,9,691,11343707.625,95.0,76.77777777777777
120654.0,17,4,1400,4,1400,40218.0,350.0,350.0,0,0,0.0,0.0,0.0
308223.0,6,6,412,4,272,102741.0,74.0,68.0,2,140,0.0,74.0,70.0
227147.0,17,2,180,1,90,0.0,90.0,90.0,1,90,0.0,90.0,90.0
316073.0,17,4,1400,4,1400,105357.66666666669,350.0,350.0,0,0,0.0,0.0,0.0
110629501.0,6,34,2482,17,1288,6900834.875,139.0,75.76470588235294,17,1194,6900841.9375,123.0,70.23529411764706
108109274.0,17,5,1005,5,1005,27027318.5,201.0,201.0,0,0,0.0,0.0,0.0
301226.0,6,6,412,4,272,100408.66666666669,74.0,68.0,2,140,0.0,74.0,70.0
42565.0,6,10,2032,5,524,10403.25,252.0,104.8,5,1508,9702.5,1236.0,301.6
207029.0,6,3,426,2,280,0.0,214.0,140.0,1,146,0.0,146.0,146.0
122360.0,6,3,373,2,238,0.0,172.0,119.0,1,135,0.0,135.0,135.0
332038.0,6,10,1102,5,570,82713.5,298.0,114.0,5,532,82657.75,260.0,106.4
228214.0,17,2,180,1,90,0.0,90.0,90.0,1,90,0.0,90.0,90.0
39369.0,6,10,2032,5,524,9639.75,252.0,104.8,5,1508,9349.0,1236.0,301.6
138890.0,6,14,4740,7,653,23022.5,249.0,93.28571428571428,7,4087,21857.83333333333,1514.0,583.8571428571429
302483.0,6,6,412,4,272,100827.66666666669,74.0,68.0,2,140,0.0,74.0,70.0
20343.0,17,2,582,1,83,0.0,83.0,83.0,1,499,0.0,499.0,499.0
504889.00000000006,6,5,336,2,134,0.0,68.0,67.0,3,202,192678.0,70.0,67.33333333333333
217855.0,6,3,426,2,280,0.0,214.0,140.0,1,146,0.0,146.0,146.0
108889.0,6,11,2098,6,590,20977.0,252.0,98.33333333333331,5,1508,26369.5,1236.0,301.6
246426.0,17,2,180,1,90,0.0,90.0,90.0,1,90,0.0,90.0,90.0
1311239.0,6,4,264,2,132,0.0,66.0,66.0,2,132,0.0,66.0,66.0
44287.0,6,14,4740,7,653,5948.166666666667,249.0,93.28571428571428,7,4087,7065.0,1514.0,583.8571428571429
394868.0,6,3,204,1,68,0.0,68.0,68.0,2,136,0.0,70.0,68.0
101000891.0,17,13,1083,7,563,16833481.833333332,174.0,80.42857142857143,6,520,16887965.4,174.0,86.66666666666667
197900.0,17,2,180,1,90,0.0,90.0,90.0,1,90,0.0,90.0,90.0
98254051.0,6,29,2046,15,1017,7018116.214285715,123.0,67.8,14,1029,6967131.615384615,123.0,73.5
45046.0,6,14,4740,7,653,6942.5,249.0,93.28571428571428,7,4087,6075.333333333333,1514.0,583.8571428571429
90044729.0,17,28,13364,28,13364,3334989.962962963,501.0,477.2857142857143,0,0,0.0,0.0,0.0
16415897.000000002,6,21,7017,12,1641,1492354.2727272727,408.0,136.75,9,5376,1537344.25,1514.0,597.3333333333334
120335561.0,17,11,473,4,172,20001886.0,43.0,43.0,7,301,20000171.83333333,43.0,43.0
162276.0,17,2,180,1,90,0.0,90.0,90.0,1,90,0.0,90.0,90.0
2288313.0,6,25,7573,14,3735,176024.07692307694,1514.0,266.7857142857143,11,3838,204261.6,1514.0,348.90909090909093
215356.0,17,2,180,1,90,0.0,90.0,90.0,1,90,0.0,90.0,90.0
135131471.0,17,6,1206,6,1206,27026294.2,201.0,201.0,0,0,0.0,0.0,0.0
197342.0,17,2,180,1,90,0.0,90.0,90.0,1,90,0.0,90.0,90.0
197095.0,17,2,180,1,90,0.0,90.0,90.0,1,90,0.0,90.0,90.0
90215397.0,6,16,1192,8,596,12853628.142857144,95.0,74.5,8,596,12858551.57142857,95.0,74.5
2050.0,17,4,344,2,150,0.0,75.0,75.0,2,194,0.0,103.0,97.0
120280730.0,6,217,24558,109,17208,1113710.462962963,284.0,157.87155963302752,108,7350,1114201.7009345794,140.0,68.05555555555556
313922.0,6,3,202,2,128,0.0,74.0,64.0,1,74,0.0,74.0,74.0
35162.0,6,14,4740,7,653,5692.0,249.0,93.28571428571428,7,4087,5722.666666666667,1514.0,583.8571428571429
3577361.0,6,5,336,2,134,0.0,68.0,67.0,3,202,1523225.5,70.0,67.33333333333333
38873.0,6,10,2032,5,524,9329.0,252.0,104.8,5,1508,9153.0,1236.0,301.6
120487370.0,6,213,24168,107,16950,1136673.3018867923,284.0,158.41121495327104,106,7218,1139794.8285714283,140.0,68.09433962264151
36784.0,6,10,2032,5,524,8659.25,252.0,104.8,5,1508,8649.0,1236.0,301.6
2420.0,17,2,180,1,90,0.0,90.0,90.0,1,90,0.0,90.0,90.0
135137252.0,17,6,1146,6,1146,27027450.4,191.0,191.0,0,0,0.0,0.0,0.0
34727.0,6,14,4740,7,653,5427.833333333333,249.0,93.28571428571428,7,4087,4616.333333333333,1514.0,583.8571428571429
108103098.0,17,5,1005,5,1005,27025774.5,201.0,201.0,0,0,0.0,0.0,0.0
26205.0,6,14,4740,7,653,3497.5,249.0,93.28571428571428,7,4087,4232.166666666667,1514.0,583.8571428571429
147355.0,6,3,373,2,238,0.0,172.0,119.0,1,135,0.0,135.0,135.0
216753.0,6,3,426,2,280,0.0,214.0,140.0,1,146,0.0,146.0,146.0
306593.0,6,6,412,4,272,102197.66666666669,74.0,68.0,2,140,0.0,74.0,70.0
359435.0,6,3,1604,2,851,0.0,785.0,425.5,1,753,0.0,753.0,753.0
324232.0,17,4,1400,4,1400,108077.33333333331,350.0,350.0,0,0,0.0,0.0,0.0
6841.0,17,2,582,1,83,0.0,83.0,83.0,1,499,0.0,499.0,499.0
113614080.0,6,46,3036,23,1518,5150438.227272728,66.0,66.0,23,1518,5150436.227272728,66.0,66.0
108106653.0,17,5,1005,5,1005,27026663.25,201.0,201.0,0,0,0.0,0.0,0.0
2051789.0,17,6,1230,3,234,1025666.5,78.0,78.0,3,996,1025681.0,332.0,332.0
312091.0,6,6,412,4,272,104030.33333333331,74.0,68.0,2,140,0.0,74.0,70.0
2976290.0,6,154,123454,88,114456,34210.22988505747,1510.0,1300.6363636363635,66,8998,41062.09230769231,1510.0,136.33333333333334
284222.0,17,2,363,1,79,0.0,79.0,79.0,1,284,0.0,284.0,284.0
0.0,17,1,381,1,381,0.0,381.0,381.0,0,0,0.0,0.0,0.0
135127895.0,17,6,1146,6,1146,27025579.0,191.0,191.0,0,0,0.0,0.0,0.0
4113.0,17,4,704,2,148,0.0,74.0,74.0,2,556,0.0,280.0,278.0
14743.0,17,4,823,2,163,0.0,89.0,81.5,2,660,0.0,443.0,330.0
78792.0,6,12,1328,7,797,13132.0,253.0,113.85714285714286,5,531,16795.5,259.0,106.2
238360.0,6,3,337,2,214,0.0,160.0,107.0,1,123,0.0,123.0,123.0
1598043.0,6,4,276,2,128,0.0,74.0,64.0,2,148,0.0,74.0,74.0
95391524.0,17,12,778,6,389,19001041.8,174.0,64.83333333333333,6,389,19000190.2,174.0,64.83333333333333
28356.0,6,13,4515,6,512,5441.6,230.0,85.33333333333333,7,4003,3921.5,1514.0,571.8571428571429
58183.0,6,14,4740,7,653,9430.666666666666,249.0,93.28571428571428,7,4087,9565.166666666666,1514.0,583.8571428571429
2313.0,17,4,344,2,150,0.0,75.0,75.0,2,194,0.0,103.0,97.0
40378.0,6,10,2032,5,524,9880.25,252.0,104.8,5,1508,8557.75,1236.0,301.6
5830862.0,6,5,336,2,134,0.0,68.0,67.0,3,202,1525658.0,70.0,67.33333333333333
90300340.0,6,23,1897,12,1098,8204722.454545454,258.0,91.5,11,799,9001110.6,95.0,72.63636363636364
120115228.0,6,13,2036,5,1020,30028807.0,204.0,204.0,8,1016,17136059.714285713,188.0,127.0
10565440.0,6,7,478,4,272,3475117.0,74.0,68.0,3,206,5212572.0,74.0,68.66666666666667
23896.0,6,14,4740,7,653,3866.1666666666665,249.0,93.28571428571428,7,4087,3788.8333333333335,1514.0,583.8571428571429
14912.0,6,14,4740,7,653,2282.833333333333,249.0,93.28571428571428,7,4087,2351.1666666666665,1514.0,583.8571428571429
437599.0,6,11,1021,6,444,58762.2,162.0,74.0,5,577,73262.75,349.0,115.4
2797322.0,6,2,132,1,66,0.0,66.0,66.0,1,66,0.0,66.0,66.0
107513.0,17,2,286,2,286,0.0,143.0,143.0,0,0,0.0,0.0,0.0
107217151.0,6,28,1860,14,966,8230879.923076923,123.0,69.0,14,894,8230880.692307692,123.0,63.85714285714285
13595.0,17,4,823,2,163,0.0,89.0,81.5,2,660,0.0,443.0,330.0
10487885.0,6,7,478,4,272,3450322.0,74.0,68.0,3,206,5175348.0,74.0,68.66666666666667
173386.0,17,4,704,2,148,0.0,74.0,74.0,2,556,0.0,280.0,278.0
310641.0,17,4,622,4,622,103547.0,163.0,155.5,0,0,0.0,0.0,0.0
42531.0,6,10,2032,5,524,9459.5,252.0,104.8,5,1508,10364.5,1236.0,301.6
389.0,17,2,166,1,75,0.0,75.0,75.0,1,91,0.0,91.0,91.0
23002.0,6,10,2032,5,524,5511.0,252.0,104.8,5,1508,5404.25,1236.0,301.6
317421.0,17,4,1400,4,1400,105807.0,350.0,350.0,0,0,0.0,0.0,0.0
9491.0,17,2,539,1,86,0.0,86.0,86.0,1,453,0.0,453.0,453.0
2420.0,17,4,344,2,150,0.0,75.0,75.0,2,194,0.0,103.0,97.0
121497.0,6,3,337,2,214,0.0,160.0,107.0,1,123,0.0,123.0,123.0
115956293.0,6,403,49458,202,35884,576896.9800995025,390.0,177.64356435643563,201,13574,578690.955,140.0,67.53233830845771
53539.0,6,12,1413,6,816,9408.4,291.0,136.0,6,597,8688.4,259.0,99.5
120334930.0,6,205,23264,103,16310,1179754.2156862745,284.0,158.3495145631068,102,6954,1182325.5742574255,140.0,68.17647058823529
18344.0,6,14,4740,7,653,2220.0,249.0,93.28571428571428,7,4087,2876.333333333333,1514.0,583.8571428571429
108109762.0,17,5,1005,5,1005,27027440.5,201.0,201.0,0,0,0.0,0.0,0.0
255303.0,6,3,337,2,214,0.0,160.0,107.0,1,123,0.0,123.0,123.0
10482432.0,6,7,478,4,272,3448695.333333333,74.0,68.0,3,206,5172942.0,74.0,68.66666666666667
35547.0,6,14,4740,7,653,5523.0,249.0,93.28571428571428,7,4087,5511.333333333333,1514.0,583.8571428571429
235015.0,6,3,337,2,214,0.0,160.0,107.0,1,123,0.0,123.0,123.0
223430.0,17,2,180,1,90,0.0,90.0,90.0,1,90,0.0,90.0,90.0
108082.0,17,2,286,2,286,0.0,143.0,143.0,0,0,0.0,0.0,0.0
153460.0,17,2,180,1,90,0.0,90.0,90.0,1,90,0.0,90.0,90.0
143910.0,17,2,180,1,90,0.0,90.0,90.0,1,90,0.0,90.0,90.0
19993.0,6,14,4740,7,653,3223.5,249.0,93.28571428571428,7,4087,3197.833333333333,1514.0,583.8571428571429
4412.0,17,2,614,1,72,0.0,72.0,72.0,1,542,0.0,542.0,542.0
90027404.0,17,28,13364,28,13364,3334348.296296296,501.0,477.2857142857143,0,0,0.0,0.0,0.0
37734.0,6,10,2032,5,524,9041.0,252.0,104.8,5,1508,8896.5,1236.0,301.6
1720.0,17,2,762,2,762,0.0,381.0,381.0,0,0,0.0,0.0,0.0
309894.0,6,6,412,4,272,103298.0,74.0,68.0,2,140,0.0,74.0,70.0
120449381.0,6,265,30930,133,21996,912495.3106060604,352.0,165.38345864661653,132,8934,895901.4045801527,140.0,67.68181818181819
110245.0,17,2,286,2,286,0.0,143.0,143.0,0,0,0.0,0.0,0.0
81.0,17,2,762,2,762,0.0,381.0,381.0,0,0,0.0,0.0,0.0
4856.0,17,2,614,1,72,0.0,72.0,72.0,1,542,0.0,542.0,542.0
135132137.0,17,6,1206,6,1206,27026427.4,201.0,201.0,0,0,0.0,0.0,0.0
339285.0,6,10,1221,6,636,67857.0,298.0,106.0,4,585,106721.33333333331,379.0,146.25
90256033.0,6,12,1832,8,1016,12893719.0,188.0,127.0,4,816,30030874.33333333,204.0,204.0
90047823.0,17,28,13364,28,13364,3335104.5555555555,501.0,477.2857142857143,0,0,0.0,0.0,0.0
135130787.0,17,6,1206,6,1206,27026157.4,201.0,201.0,0,0,0.0,0.0,0.0
120120734.0,6,17,2556,10,1392,13346748.222222222,188.0,139.2,7,1164,15016409.5,204.0,166.28571428571428
25367386.0,17,5,1718,4,1368,817938.3333333334,342.0,342.0,1,350,0.0,350.0,350.0
135128526.0,17,6,1146,6,1146,27025705.2,191.0,191.0,0,0,0.0,0.0,0.0
314589.0,17,4,1400,4,1400,104863.0,350.0,350.0,0,0,0.0,0.0,0.0
135156951.0,17,6,1146,6,1146,27031390.2,191.0,191.0,0,0,0.0,0.0,0.0
309142.0,17,4,1400,4,1400,103047.33333333331,350.0,350.0,0,0,0.0,0.0,0.0
90253222.0,6,14,2240,8,1016,12893317.42857143,188.0,127.0,6,1224,18018206.2,204.0,204.0
124812.0,6,3,373,2,238,0.0,172.0,119.0,1,135,0.0,135.0,135.0
837340.0,6,9,1096,6,625,167468.0,287.0,104.16666666666669,3,471,282387.5,331.0,157.0
206853.0,6,10,1221,6,636,41370.6,298.0,106.0,4,585,67724.0,379.0,146.25
781.0,17,4,438,2,148,0.0,74.0,74.0,2,290,0.0,147.0,145.0
84661.0,6,14,4740,7,653,13975.0,249.0,93.28571428571428,7,4087,13711.333333333334,1514.0,583.8571428571429
302801.0,17,4,1400,4,1400,100933.66666666669,350.0,350.0,0,0,0.0,0.0,0.0
90255828.0,6,13,2036,8,1016,12893689.714285716,188.0,127.0,5,1020,22522687.0,204.0,204.0
116507.0,6,2,132,1,66,0.0,66.0,66.0,1,66,0.0,66.0,66.0
35758.0,6,14,4740,7,653,5784.5,249.0,93.28571428571428,7,4087,5786.333333333333,1514.0,583.8571428571429
90057071.0,17,28,13364,28,13364,3335447.074074074,501.0,477.2857142857143,0,0,0.0,0.0,0.0
303724.0,6,6,412,4,272,101241.33333333331,74.0,68.0,2,140,0.0,74.0,70.0
340.0,17,2,250,1,93,0.0,93.0,93.0,1,157,0.0,157.0,157.0
26342.0,6,12,1393,6,796,5083.2,271.0,132.66666666666666,6,597,2929.0,259.0,99.5
128006935.0,17,15,907,8,475,18286705.0,174.0,59.375,7,432,18166826.166666668,174.0,61.71428571428572
304690.0,6,6,412,4,272,101563.33333333331,74.0,68.0,2,140,0.0,74.0,70.0
323179.0,17,4,1400,4,1400,107726.33333333331,350.0,350.0,0,0,0.0,0.0,0.0
304934.0,6,6,412,4,272,101644.66666666669,74.0,68.0,2,140,0.0,74.0,70.0
345190.0,6,3,204,1,68,0.0,68.0,68.0,2,136,0.0,70.0,68.0
1302440.0,6,4,264,2,132,0.0,66.0,66.0,2,132,0.0,66.0,66.0
132866.0,6,2,132,1,66,0.0,66.0,66.0,1,66,0.0,66.0,66.0
10863027.0,6,8,544,4,272,3574381.333333333,74.0,68.0,4,272,3574314.0,74.0,68.0
90280866.0,6,15,1097,8,596,12897266.57142857,95.0,74.5,7,501,14999165.166666666,95.0,71.57142857142857
827.0,17,4,438,2,148,0.0,74.0,74.0,2,290,0.0,147.0,145.0
10495975.0,6,7,478,4,272,3453293.333333333,74.0,68.0,3,206,5179801.0,74.0,68.66666666666667
90272682.0,6,12,1832,8,1016,12896097.42857143,188.0,127.0,4,816,30035693.0,204.0,204.0
307725.0,17,4,704,2,148,0.0,74.0,74.0,2,556,0.0,280.0,278.0
90276628.0,6,14,1043,7,542,15046104.666666666,95.0,77.42857142857143,7,501,14998093.333333334,95.0,71.57142857142857
25077252.0,17,3,1034,2,684,0.0,342.0,342.0,1,350,0.0,350.0,350.0
92444158.0,17,12,778,6,389,18401164.0,174.0,64.83333333333333,6,389,18400150.4,174.0,64.83333333333333
235946.0,6,3,337,2,214,0.0,160.0,107.0,1,123,0.0,123.0,123.0
109279788.0,17,14,864,7,432,18166851.5,174.0,61.71428571428572,7,432,18168150.0,174.0,61.71428571428572
2800191.0,6,2,132,1,66,0.0,66.0,66.0,1,66,0.0,66.0,66.0
3066.0,17,2,224,1,76,0.0,76.0,76.0,1,148,0.0,148.0,148.0
49179.0,6,14,4740,7,653,8043.0,249.0,93.28571428571428,7,4087,7259.0,1514.0,583.8571428571429
135126794.0,17,6,1206,6,1206,27025358.8,201.0,201.0,0,0,0.0,0.0,0.0
0.0,17,1,72,1,72,0.0,72.0,72.0,0,0,0.0,0.0,0.0
233018.0,6,3,337,2,214,0.0,160.0,107.0,1,123,0.0,123.0,123.0
208240.0,6,3,426,2,280,0.0,214.0,140.0,1,146,0.0,146.0,146.0
120043106.0,17,28,13364,28,13364,4446040.962962963,501.0,477.2857142857143,0,0,0.0,0.0,0.0
289628.0,17,2,620,1,75,0.0,75.0,75.0,1,545,0.0,545.0,545.0
2322.0,17,4,344,2,150,0.0,75.0,75.0,2,194,0.0,103.0,97.0
228245.0,17,2,180,1,90,0.0,90.0,90.0,1,90,0.0,90.0,90.0
607862.0,6,4,508,2,238,0.0,172.0,119.0,2,270,0.0,135.0,135.0
519369.0,6,5,336,2,134,0.0,68.0,67.0,3,202,199812.5,70.0,67.33333333333333
145984.0,6,3,337,2,214,0.0,160.0,107.0,1,123,0.0,123.0,123.0
28547.0,6,10,2032,5,524,6975.25,252.0,104.8,5,1508,6555.5,1236.0,301.6
119977.0,17,2,180,1,70,0.0,70.0,70.0,1,110,0.0,110.0,110.0
312.0,17,2,174,1,79,0.0,79.0,79.0,1,95,0.0,95.0,95.0
2343.0,17,4,344,2,150,0.0,75.0,75.0,2,194,0.0,103.0,97.0
1307026.0,6,4,264,2,132,0.0,66.0,66.0,2,132,0.0,66.0,66.0
76188.0,6,14,4740,7,653,12320.333333333334,249.0,93.28571428571428,7,4087,11275.166666666666,1514.0,583.8571428571429
74198.0,6,14,4740,7,653,11686.0,249.0,93.28571428571428,7,4087,11126.833333333334,1514.0,583.8571428571429
314085.0,17,4,1400,4,1400,104695.0,350.0,350.0,0,0,0.0,0.0,0.0
437784.0,6,11,1021,6,444,58752.6,162.0,74.0,5,577,73274.5,349.0,115.4
119611999.0,6,230,25978,115,18092,1047340.8596491228,284.0,157.3217391304348,115,7886,1047341.0087719298,140.0,68.57391304347826
233813.0,6,3,426,2,280,0.0,214.0,140.0,1,146,0.0,146.0,146.0
119262581.0,6,216,24340,108,7362,1106530.0373831776,140.0,68.16666666666667,108,16978,1107023.1028037383,284.0,157.2037037037037
120119458.0,6,13,2020,9,1204,15014932.25,188.0,133.77777777777777,4,816,30029662.666666668,204.0,204.0
228216.0,17,2,180,1,90,0.0,90.0,90.0,1,90,0.0,90.0,90.0
52050.0,6,14,4740,7,653,8193.166666666666,249.0,93.28571428571428,7,4087,7520.0,1514.0,583.8571428571429
332.0,17,2,166,1,75,0.0,75.0,75.0,1,91,0.0,91.0,91.0
56099.0,6,14,4740,7,653,9236.833333333334,249.0,93.28571428571428,7,4087,9155.333333333334,1514.0,583.8571428571429
209417.0,17,2,180,1,90,0.0,90.0,90.0,1,90,0.0,90.0,90.0
260786.00000000003,6,10,1221,6,636,52157.2,298.0,106.0,4,585,81437.66666666667,379.0,146.25
118888060.0,6,34,2334,17,1209,7430503.75,123.0,71.11764705882354,17,1125,7416910.375,123.0,66.17647058823529
107573.0,17,2,762,2,762,0.0,381.0,381.0,0,0,0.0,0.0,0.0
0.0,17,1,90,1,90,0.0,90.0,90.0,0,0,0.0,0.0,0.0
214948.0,6,3,426,2,280,0.0,214.0,140.0,1,146,0.0,146.0,146.0
47490.0,6,14,4740,7,653,7519.5,249.0,93.28571428571428,7,4087,7199.333333333333,1514.0,583.8571428571429
2199.0,17,2,664,1,322,0.0,322.0,322.0,1,342,0.0,342.0,342.0
232188.0,17,4,6056,4,6056,77396.0,1514.0,1514.0,0,0,0.0,0.0,0.0
315406.0,17,4,1400,4,1400,105135.33333333331,350.0,350.0,0,0,0.0,0.0,0.0
111468.0,17,2,286,2,286,0.0,143.0,143.0,0,0,0.0,0.0,0.0
1027023.0,6,11,1134,6,558,205404.60000000003,220.0,93.0,5,576,255566.0,304.0,115.2
209518.0,6,4,492,2,280,0.0,214.0,140.0,2,212,0.0,146.0,106.0
32683284.0,6,5,336,3,202,14948823.0,70.0,67.33333333333333,2,134,0.0,68.0,67.0
388.0,17,2,508,2,508,0.0,257.0,254.0,0,0,0.0,0.0,0.0
298827.0,6,6,412,4,272,99609.0,74.0,68.0,2,140,0.0,74.0,70.0
31196.0,6,14,4740,7,653,5076.166666666667,249.0,93.28571428571428,7,4087,4845.166666666667,1514.0,583.8571428571429
121987.0,6,3,337,2,214,0.0,160.0,107.0,1,123,0.0,123.0,123.0
254876.0,6,12,1373,7,714,42479.333333333336,298.0,102.0,5,659,58294.25,379.0,131.8
121368.0,6,3,337,2,214,0.0,160.0,107.0,1,123,0.0,123.0,123.0
90527820.0,6,14,2240,8,1016,12932545.714285716,188.0,127.0,6,1224,18073409.6,204.0,204.0
2300.0,17,4,344,2,150,0.0,75.0,75.0,2,194,0.0,103.0,97.0
4259.0,17,2,598,1,72,0.0,72.0,72.0,1,526,0.0,526.0,526.0
111135466.0,6,239,27266,120,19116,933911.4789915966,300.0,159.3,119,8150,939492.406779661,140.0,68.4873949579832
90312735.0,6,21,1585,11,840,9024525.0,95.0,76.36363636363636,10,745,9953493.222222222,95.0,74.5
130894.0,6,2,132,1,66,0.0,66.0,66.0,1,66,0.0,66.0,66.0
90033855.0,17,28,13364,28,13364,3334587.222222222,501.0,477.2857142857143,0,0,0.0,0.0,0.0
606.0,17,2,508,2,508,0.0,257.0,254.0,0,0,0.0,0.0,0.0
4251477.0,6,218,167484,115,156386,37293.65789473684,1510.0,1359.878260869565,103,11098,38722.12745098039,1510.0,107.747572815534
123305893.0,6,48,3168,24,1584,5216436.260869565,66.0,66.0,24,1584,5080158.956521739,66.0,66.0
61120839.0,6,6,674,4,428,20373613.0,160.0,107.0,2,246,0.0,123.0,123.0
38096.0,6,14,4740,7,653,6217.166666666667,249.0,93.28571428571428,7,4087,5896.5,1514.0,583.8571428571429
213595.0,17,2,180,1,90,0.0,90.0,90.0,1,90,0.0,90.0,90.0
135129540.0,17,6,1206,6,1206,27025908.0,201.0,201.0,0,0,0.0,0.0,0.0
108342251.0,17,7,1512,6,1206,21668450.2,201.0,201.0,1,306,0.0,306.0,306.0
1303651.0,6,4,264,2,132,0.0,66.0,66.0,2,132,0.0,66.0,66.0
245692.0,6,3,337,2,214,0.0,160.0,107.0,1,123,0.0,123.0,123.0
317953.0,6,12,1373,7,714,52992.16666666666,298.0,102.0,5,659,74958.5,379.0,131.8
1034614.0,6,11,1134,6,558,206922.8,220.0,93.0,5,576,257825.0,304.0,115.2
2956021.0,6,3,204,2,136,0.0,70.0,68.0,1,68,0.0,68.0,68.0
216377.0,17,2,180,1,90,0.0,90.0,90.0,1,90,0.0,90.0,90.0
90257308.0,6,12,1832,8,1016,12893901.142857144,188.0,127.0,4,816,30030067.33333333,204.0,204.0
14504.0,6,11,2098,6,590,2763.4,252.0,98.33333333333331,5,1508,3336.5,1236.0,301.6
284303.0,17,2,363,1,79,0.0,79.0,79.0,1,284,0.0,284.0,284.0
302693.0,6,6,412,4,272,100897.66666666669,74.0,68.0,2,140,0.0,74.0,70.0
43834.0,6,14,4740,7,653,6725.0,249.0,93.28571428571428,7,4087,5932.666666666667,1514.0,583.8571428571429
92585334.0,17,12,778,6,389,18401361.6,174.0,64.83333333333333,6,389,18400162.8,174.0,64.83333333333333
1451908.0,6,7,499,4,301,442223.6666666667,103.0,75.25,3,198,717240.5,66.0,66.0
222628.0,6,3,426,2,280,0.0,214.0,140.0,1,146,0.0,146.0,146.0
795.0,17,4,438,2,148,0.0,74.0,74.0,2,290,0.0,147.0,145.0
5617863.0,6,5,336,2,134,0.0,68.0,67.0,3,202,1420520.5,70.0,67.33333333333333
153464.0,17,2,180,1,90,0.0,90.0,90.0,1,90,0.0,90.0,90.0
116458834.0,6,207,23486,104,7086,1130668.2912621358,140.0,68.13461538461539,103,16400,1131685.1470588236,284.0,159.2233009708738
297548.0,6,6,412,4,272,99182.66666666669,74.0,68.0,2,140,0.0,74.0,70.0
101179435.0,6,196,22108,98,15418,1040868.1958762888,284.0,157.3265306122449,98,6690,1040867.9072164948,140.0,68.26530612244898
24950.0,6,10,2032,5,524,5678.0,252.0,104.8,5,1508,5818.0,1236.0,301.6
123250397.0,6,49,3234,25,1650,5135433.208333333,66.0,66.0,24,1584,5147266.782608695,66.0,66.0
44800.0,6,14,4740,7,653,6136.0,249.0,93.28571428571428,7,4087,6910.166666666667,1514.0,583.8571428571429
82971325.0,17,14,4796,13,4446,6229206.333333333,342.0,342.0,1,350,0.0,350.0,350.0
748.0,17,4,438,2,148,0.0,74.0,74.0,2,290,0.0,147.0,145.0
119825599.0,17,34,16284,34,16284,3631078.757575758,501.0,478.9411764705882,0,0,0.0,0.0,0.0
90053815.0,17,28,13364,28,13364,3335326.4814814813,501.0,477.2857142857143,0,0,0.0,0.0,0.0
119975113.0,6,28,2127,13,989,9977247.583333334,95.0,76.07692307692308,15,1138,8556424.785714285,95.0,75.86666666666666
20439.0,6,10,2032,5,524,4590.25,252.0,104.8,5,1508,4502.25,1236.0,301.6
9031810.0,6,6,433,2,132,0.0,66.0,66.0,4,301,3010603.333333333,103.0,75.25
61698.0,6,14,4740,7,653,9835.666666666666,249.0,93.28571428571428,7,4087,7965.0,1514.0,583.8571428571429
231919.0,17,4,1400,4,1400,77306.33333333333,350.0,350.0,0,0,0.0,0.0,0.0
229051.0,6,12,1373,7,714,38175.16666666666,298.0,102.0,5,659,56240.0,379.0,131.8
47611480.0,6,8,1940,3,887,22327139.0,753.0,295.6666666666667,5,1053,11256870.5,785.0,210.6
90012786.0,6,17,1287,9,691,11251598.25,95.0,76.77777777777777,8,596,12815482.142857144,95.0,74.5
90057655.0,17,28,13364,28,13364,3335468.703703704,501.0,477.2857142857143,0,0,0.0,0.0,0.0
26337.0,6,14,4740,7,653,4164.666666666667,249.0,93.28571428571428,7,4087,4072.6666666666665,1514.0,583.8571428571429
5620702.0,6,5,336,2,134,0.0,68.0,67.0,3,202,1419235.5,70.0,67.33333333333333
309645.0,6,6,412,4,272,103215.0,74.0,68.0,2,140,0.0,74.0,70.0
106729067.0,6,44,2904,22,1452,5082336.523809524,66.0,66.0,22,1452,5067638.380952381,66.0,66.0
90261345.0,6,12,1832,8,1016,12894477.857142856,188.0,127.0,4,816,30031899.666666668,204.0,204.0
307951.0,6,6,412,4,272,102650.33333333331,74.0,68.0,2,140,0.0,74.0,70.0
111962.0,17,4,1400,4,1400,37320.66666666666,350.0,350.0,0,0,0.0,0.0,0.0
377966.0,6,3,1604,2,851,0.0,785.0,425.5,1,753,0.0,753.0,753.0
108072031.0,17,5,955,5,955,27018007.75,191.0,191.0,0,0,0.0,0.0,0.0
42083.0,6,14,4740,7,653,6882.166666666667,249.0,93.28571428571428,7,4087,6745.666666666667,1514.0,583.8571428571429
264267.0,6,3,337,2,214,0.0,160.0,107.0,1,123,0.0,123.0,123.0
113319693.0,6,48,3168,24,1584,4926943.173913044,66.0,66.0,24,1584,4920356.652173913,66.0,66.0
178158.0,17,2,180,1,90,0.0,90.0,90.0,1,90,0.0,90.0,90.0
105676.0,17,2,700,2,700,0.0,350.0,350.0,0,0,0.0,0.0,0.0
98339.0,6,14,4740,7,653,16263.5,249.0,93.28571428571428,7,4087,15833.5,1514.0,583.8571428571429
42798.0,6,14,4740,7,653,6927.5,249.0,93.28571428571428,7,4087,6750.833333333333,1514.0,583.8571428571429
2333.0,17,4,344,2,150,0.0,75.0,75.0,2,194,0.0,103.0,97.0
143963.0,17,2,180,1,90,0.0,90.0,90.0,1,90,0.0,90.0,90.0
7098.0,17,4,823,2,163,0.0,89.0,81.5,2,660,0.0,443.0,330.0
206201.0,6,3,426,2,280,0.0,214.0,140.0,1,146,0.0,146.0,146.0
113491582.0,6,194,21998,97,15374,1179962.5,284.0,158.49484536082474,97,6624,1179962.5833333333,140.0,68.28865979381443
204497.0,17,2,762,2,762,0.0,381.0,381.0,0,0,0.0,0.0,0.0
120002641.0,6,24,1829,13,1030,9999992.583333334,95.0,79.23076923076923,11,799,11924058.3,95.0,72.63636363636364
144049.0,17,2,180,1,90,0.0,90.0,90.0,1,90,0.0,90.0,90.0
108107536.0,17,5,955,5,955,27026884.0,191.0,191.0,0,0,0.0,0.0,0.0
23136.0,6,10,2032,5,524,3728.5,252.0,104.8,5,1508,4748.25,1236.0,301.6
107740.0,17,2,286,2,286,0.0,143.0,143.0,0,0,0.0,0.0,0.0
15969.0,6,14,4740,7,653,2493.1666666666665,249.0,93.28571428571428,7,4087,2526.5,1514.0,583.8571428571429
2797901.0,6,2,132,1,66,0.0,66.0,66.0,1,66,0.0,66.0,66.0
120118090.0,6,220,24884,110,7482,1094582.2935779816,140.0,68.01818181818182,110,17402,1094401.8073394496,284.0,158.2
143955.0,17,2,180,1,90,0.0,90.0,90.0,1,90,0.0,90.0,90.0
378.0,17,2,300,1,80,0.0,80.0,80.0,1,220,0.0,220.0,220.0
40199.0,6,10,2032,5,524,9791.75,252.0,104.8,5,1508,9229.25,1236.0,301.6
33705375.0,6,5,336,2,134,0.0,68.0,67.0,3,202,15565079.0,70.0,67.33333333333333
205825.0,17,2,180,1,90,0.0,90.0,90.0,1,90,0.0,90.0,90.0
90021202.0,17,28,13364,28,13364,3334118.592592593,501.0,477.2857142857143,0,0,0.0,0.0,0.0
90260557.0,6,13,2036,8,1016,12894365.285714284,188.0,127.0,5,1020,22523770.5,204.0,204.0
0.0,6,1,66,1,66,0.0,66.0,66.0,0,0,0.0,0.0,0.0
90962244.0,6,21,1585,11,840,9095070.5,95.0,76.36363636363636,10,745,10105418.0,95.0,74.5
49665.0,6,14,4740,7,653,8120.166666666667,249.0,93.28571428571428,7,4087,7604.833333333333,1514.0,583.8571428571429
27744.0,6,14,4740,7,653,4181.5,249.0,93.28571428571428,7,4087,4432.0,1514.0,583.8571428571429
113572853.0,6,33,2296,17,1225,7084821.8125,139.0,72.05882352941177,16,1071,7557137.2,123.0,66.9375
3409.0,17,2,414,1,88,0.0,88.0,88.0,1,326,0.0,326.0,326.0
50668.0,6,14,4740,7,653,7746.5,249.0,93.28571428571428,7,4087,6479.833333333333,1514.0,583.8571428571429
252579.0,6,10,1221,6,636,50515.8,298.0,106.0,4,585,78249.0,379.0,146.25
2502.0,17,4,344,2,150,0.0,75.0,75.0,2,194,0.0,103.0,97.0
3007150.0,6,12,2172,7,664,501135.5,252.0,94.85714285714286,5,1508,1722.75,1236.0,301.6
219840.0,6,3,426,2,280,0.0,214.0,140.0,1,146,0.0,146.0,146.0
20539.0,17,2,582,1,83,0.0,83.0,83.0,1,499,0.0,499.0,499.0
117439288.0,6,33,2274,17,1125,7339955.5,123.0,66.17647058823529,16,1149,7149177.8,123.0,71.8125
90253490.0,6,12,1832,8,1016,12893355.714285716,188.0,127.0,4,816,30029682.666666668,204.0,204.0
90298760.0,17,12,778,6,389,18001531.0,174.0,64.83333333333333,6,389,18000165.8,174.0,64.83333333333333
108112918.0,17,5,955,5,955,27028229.5,191.0,191.0,0,0,0.0,0.0,0.0
90052816.0,17,28,13364,28,13364,3335289.4814814813,501.0,477.2857142857143,0,0,0.0,0.0,0.0
44047.0,6,10,2032,5,524,9937.75,252.0,104.8,5,1508,10787.5,1236.0,301.6
298402.0,6,6,412,4,272,99467.33333333331,74.0,68.0,2,140,0.0,74.0,70.0
10467917.0,6,6,412,3,206,5163709.5,74.0,68.66666666666667,3,206,5163595.5,74.0,68.66666666666667
327776.0,6,6,412,4,272,109258.66666666669,74.0,68.0,2,140,0.0,74.0,70.0
167069.0,17,4,704,2,148,0.0,74.0,74.0,2,556,0.0,280.0,278.0
29926.0,6,14,4740,7,653,4729.333333333333,249.0,93.28571428571428,7,4087,4759.166666666667,1514.0,583.8571428571429
2345.0,17,4,344,2,150,0.0,75.0,75.0,2,194,0.0,103.0,97.0
31871.0,6,14,4740,7,653,5155.833333333333,249.0,93.28571428571428,7,4087,5159.833333333333,1514.0,583.8571428571429
111310702.0,6,219,25432,110,17942,1021199.1009174312,284.0,163.1090909090909,109,7490,1021369.8703703705,140.0,68.71559633027523
90269120.0,6,12,1832,8,1016,12895588.57142857,188.0,127.0,4,816,30034905.33333333,204.0,204.0
207511.0,6,3,426,2,280,0.0,214.0,140.0,1,146,0.0,146.0,146.0
108111486.0,17,5,1005,5,1005,27027871.5,201.0,201.0,0,0,0.0,0.0,0.0
320750.0,17,4,1400,4,1400,106916.66666666669,350.0,350.0,0,0,0.0,0.0,0.0
107773.0,17,2,286,2,286,0.0,143.0,143.0,0,0,0.0,0.0,0.0
1302533.0,6,4,264,2,132,0.0,66.0,66.0,2,132,0.0,66.0,66.0
72587.0,6,14,4740,7,653,11927.166666666666,249.0,93.28571428571428,7,4087,10596.5,1514.0,583.8571428571429
90770352.0,6,22,1680,12,935,8247413.454545454,95.0,77.91666666666667,10,745,10050914.333333334,95.0,74.5
120131084.0,6,224,25312,112,7688,1076654.198198198,140.0,68.64285714285714,112,17624,1066443.027027027,284.0,157.35714285714286
0.0,17,1,342,1,342,0.0,342.0,342.0,0,0,0.0,0.0,0.0
53028.0,6,14,4740,7,653,8702.166666666666,249.0,93.28571428571428,7,4087,7285.5,1514.0,583.8571428571429
2787044.0,6,2,132,1,66,0.0,66.0,66.0,1,66,0.0,66.0,66.0
188750.0,17,4,820,2,156,0.0,78.0,78.0,2,664,0.0,332.0,332.0
216027.0,6,10,1221,6,636,43205.4,298.0,106.0,4,585,71137.66666666667,379.0,146.25
313221.0,6,6,412,4,272,104407.0,74.0,68.0,2,140,0.0,74.0,70.0
135136952.0,17,6,1146,6,1146,27027390.4,191.0,191.0,0,0,0.0,0.0,0.0
1306765.0,6,4,264,2,132,0.0,66.0,66.0,2,132,0.0,66.0,66.0
90259127.0,6,12,1832,8,1016,12894161.0,188.0,127.0,4,816,30031534.33333333,204.0,204.0
43798.0,6,14,4740,7,653,6257.666666666667,249.0,93.28571428571428,7,4087,7000.333333333333,1514.0,583.8571428571429
23775.0,6,14,4740,7,653,3853.8333333333335,249.0,93.28571428571428,7,4087,3776.3333333333335,1514.0,583.8571428571429
216482.0,17,2,180,1,90,0.0,90.0,90.0,1,90,0.0,90.0,90.0
90304811.0,6,17,1287,9,691,11281875.25,95.0,76.77777777777777,8,596,12834511.285714284,95.0,74.5
207018.0,6,3,426,2,280,0.0,214.0,140.0,1,146,0.0,146.0,146.0
218639.0,6,3,426,2,280,0.0,214.0,140.0,1,146,0.0,146.0,146.0
206689.0,6,3,426,2,280,0.0,214.0,140.0,1,146,0.0,146.0,146.0
116457198.0,6,223,25246,112,7688,1049163.945945946,140.0,68.64285714285714,111,17558,1049368.790909091,284.0,158.18018018018017
153492.0,6,11,1132,6,556,30540.4,218.0,92.66666666666669,5,576,38006.75,304.0,115.2
39080.0,6,14,4740,7,653,6072.666666666667,249.0,93.28571428571428,7,4087,5627.333333333333,1514.0,583.8571428571429
2357.0,17,4,344,2,150,0.0,75.0,75.0,2,194,0.0,103.0,97.0
90255787.0,6,13,2036,8,1016,12893683.857142856,188.0,127.0,5,1020,22522341.5,204.0,204.0
10509598.0,6,7,478,4,272,3458084.6666666665,74.0,68.0,3,206,5187037.0,74.0,68.66666666666667
47609847.0,6,8,2113,3,960,22530536.0,826.0,320.0,5,1153,11259439.5,885.0,230.6
90066400.0,17,28,13364,28,13364,3335792.592592593,501.0,477.2857142857143,0,0,0.0,0.0,0.0
209501.0,17,2,180,1,90,0.0,90.0,90.0,1,90,0.0,90.0,90.0
25708.0,17,2,180,1,90,0.0,90.0,90.0,1,90,0.0,90.0,90.0
171695.0,17,2,180,1,90,0.0,90.0,90.0,1,90,0.0,90.0,90.0
51149.0,17,2,180,1,90,0.0,90.0,90.0,1,90,0.0,90.0,90.0
135144776.0,17,6,1206,6,1206,27028955.2,201.0,201.0,0,0,0.0,0.0,0.0
948.0,17,2,762,2,762,0.0,381.0,381.0,0,0,0.0,0.0,0.0
269601.0,6,10,1221,6,636,53920.2,298.0,106.0,4,585,84491.33333333333,379.0,146.25
34688.0,6,14,4740,7,653,5661.666666666667,249.0,93.28571428571428,7,4087,5494.166666666667,1514.0,583.8571428571429
2287638.0,6,3,1604,1,753,0.0,753.0,753.0,2,851,0.0,785.0,425.5
16586.0,6,13,1459,7,862,2764.333333333333,271.0,123.14285714285714,6,597,2903.0,259.0,99.5
839.0,17,4,438,2,148,0.0,74.0,74.0,2,290,0.0,147.0,145.0
108103115.0,17,5,955,5,955,27025778.75,191.0,191.0,0,0,0.0,0.0,0.0
113902708.0,6,30,1974,15,1026,8120430.357142857,123.0,68.4,15,948,8120483.571428572,123.0,63.2
113520306.0,6,46,3036,23,1518,5159999.045454546,66.0,66.0,23,1518,5160002.363636363,66.0,66.0
309870.0,6,6,412,4,272,103290.0,74.0,68.0,2,140,0.0,74.0,70.0
40553.0,6,14,4740,7,653,6353.666666666667,249.0,93.28571428571428,7,4087,5507.666666666667,1514.0,583.8571428571429
341.0,17,2,174,1,79,0.0,79.0,79.0,1,95,0.0,95.0,95.0
120124689.0,6,13,2020,9,1204,15015586.125,188.0,133.77777777777777,4,816,30033100.33333333,204.0,204.0
3049367.0,6,3,204,2,136,0.0,70.0,68.0,1,68,0.0,68.0,68.0
43192.0,6,14,4740,7,653,7048.0,249.0,93.28571428571428,7,4087,7027.666666666667,1514.0,583.8571428571429
306351.0,17,2,180,1,90,0.0,90.0,90.0,1,90,0.0,90.0,90.0
74599613.0,6,9,842,9,842,9324951.625,97.0,93.55555555555556,0,0,0.0,0.0,0.0
108105768.0,17,5,955,5,955,27026442.0,191.0,191.0,0,0,0.0,0.0,0.0
2326.0,17,4,344,2,150,0.0,75.0,75.0,2,194,0.0,103.0,97.0
38465.0,6,10,2032,5,524,9306.5,252.0,104.8,5,1508,8510.75,1236.0,301.6
122085.0,6,3,337,2,214,0.0,160.0,107.0,1,123,0.0,123.0,123.0
1411215.0,17,2,664,1,322,0.0,322.0,322.0,1,342,0.0,342.0,342.0
120229635.0,17,14,864,7,432,19968894.5,174.0,61.71428571428572,7,432,20011767.5,174.0,61.71428571428572
300453.0,6,6,412,4,272,100151.0,74.0,68.0,2,140,0.0,74.0,70.0
167475.0,17,4,704,2,148,0.0,74.0,74.0,2,556,0.0,280.0,278.0
119870215.0,17,35,16705,35,16705,3525594.5588235296,501.0,477.2857142857143,0,0,0.0,0.0,0.0
308726.0,6,6,412,4,272,102908.66666666669,74.0,68.0,2,140,0.0,74.0,70.0
108108184.0,17,5,955,5,955,27027046.0,191.0,191.0,0,0,0.0,0.0,0.0
233027.0,6,3,337,2,214,0.0,160.0,107.0,1,123,0.0,123.0,123.0
120224329.0,6,222,24990,112,7700,1083102.063063063,140.0,68.75,110,17290,1086373.394495413,284.0,157.1818181818182
159386.0,17,4,6056,4,6056,53128.66666666666,1514.0,1514.0,0,0,0.0,0.0,0.0
27651.0,6,10,2032,5,524,6162.25,252.0,104.8,5,1508,6390.5,1236.0,301.6
41991.0,6,14,4740,7,653,6459.166666666667,249.0,93.28571428571428,7,4087,6813.333333333333,1514.0,583.8571428571429
49375.0,6,10,2032,5,524,12125.5,252.0,104.8,5,1508,10114.5,1236.0,301.6
113881918.0,6,48,3168,24,1584,4951387.739130435,66.0,66.0,24,1584,4939408.304347826,66.0,66.0
118134654.0,6,48,3168,24,1584,5136289.304347826,66.0,66.0,24,1584,5122830.043478261,66.0,66.0
298869.0,6,6,412,4,272,99623.0,74.0,68.0,2,140,0.0,74.0,70.0
300762.0,6,6,412,4,272,100254.0,74.0,68.0,2,140,0.0,74.0,70.0
5617540.0,6,5,336,2,134,0.0,68.0,67.0,3,202,1422125.0,70.0,67.33333333333333
209356.0,17,2,180,1,90,0.0,90.0,90.0,1,90,0.0,90.0,90.0
307828.0,6,6,412,4,272,102609.33333333331,74.0,68.0,2,140,0.0,74.0,70.0
68839.0,6,12,1320,6,723,9335.4,253.0,120.5,6,597,12922.0,259.0,99.5
3408.0,17,2,414,1,88,0.0,88.0,88.0,1,326,0.0,326.0,326.0
105462.0,17,2,700,2,700,0.0,350.0,350.0,0,0,0.0,0.0,0.0
90013853.0,17,28,13364,28,13364,3333846.407407407,501.0,477.2857142857143,0,0,0.0,0.0,0.0
274927.0,6,3,337,2,214,0.0,160.0,107.0,1,123,0.0,123.0,123.0
122001243.0,17,16,1212,9,649,15250155.375,174.0,72.11111111111111,7,563,17000808.5,174.0,80.42857142857143
1012293.0,17,2,614,1,72,0.0,72.0,72.0,1,542,0.0,542.0,542.0
23110.0,17,2,582,1,83,0.0,83.0,83.0,1,499,0.0,499.0,499.0
2358.0,17,4,344,2,150,0.0,75.0,75.0,2,194,0.0,103.0,97.0
328.0,17,2,166,1,75,0.0,75.0,75.0,1,91,0.0,91.0,91.0
301534.0,6,3,202,2,128,0.0,74.0,64.0,1,74,0.0,74.0,74.0
12679.0,6,10,1067,5,536,3006.0,264.0,107.2,5,531,2434.75,259.0,106.2
302070.0,6,6,412,4,272,100690.0,74.0,68.0,2,140,0.0,74.0,70.0
14270.0,6,10,1065,5,534,2658.25,262.0,106.8,5,531,3171.75,259.0,106.2
119000974.0,17,15,1169,8,606,17000139.14285714,174.0,75.75,7,563,17405205.5,174.0,80.42857142857143
2344.0,17,4,344,2,150,0.0,75.0,75.0,2,194,0.0,103.0,97.0
90064706.0,17,28,13364,28,13364,3335729.851851852,501.0,477.2857142857143,0,0,0.0,0.0,0.0
90257586.0,6,14,2240,8,1016,12893940.857142856,188.0,127.0,6,1224,18018422.8,204.0,204.0
300946.0,6,6,412,4,272,100315.33333333331,74.0,68.0,2,140,0.0,74.0,70.0
10822407.0,6,7,478,3,206,5342828.5,74.0,68.66666666666667,4,272,3561823.333333333,74.0,68.0
90055844.0,17,28,13364,28,13364,3335401.6296296297,501.0,477.2857142857143,0,0,0.0,0.0,0.0
57176.0,6,14,4740,7,653,9410.666666666666,249.0,93.28571428571428,7,4087,8935.0,1514.0,583.8571428571429
120046833.0,17,29,13785,29,13785,4287386.892857143,501.0,475.3448275862069,0,0,0.0,0.0,0.0
121279.0,6,3,337,2,214,0.0,160.0,107.0,1,123,0.0,123.0,123.0
1207917.0,17,7,490,7,490,201319.5,70.0,70.0,0,0,0.0,0.0,0.0
2035.0,17,2,932,1,590,0.0,590.0,590.0,1,342,0.0,342.0,342.0
307.0,17,2,168,1,76,0.0,76.0,76.0,1,92,0.0,92.0,92.0
191215.0,17,2,180,1,90,0.0,90.0,90.0,1,90,0.0,90.0,90.0
91870066.0,6,24,1829,13,989,7655033.916666667,95.0,76.07692307692308,11,840,9186721.2,95.0,76.36363636363636
254512.00000000003,6,3,337,2,214,0.0,160.0,107.0,1,123,0.0,123.0,123.0
135135321.0,17,6,1206,6,1206,27027064.2,201.0,201.0,0,0,0.0,0.0,0.0
21928.0,17,2,582,1,83,0.0,83.0,83.0,1,499,0.0,499.0,499.0
116821090.0,6,329,42110,165,11186,712323.7195121951,140.0,67.7939393939394,164,30924,713163.4355828221,336.0,188.5609756097561
2319.0,17,4,344,2,150,0.0,75.0,75.0,2,194,0.0,103.0,97.0
196809.0,17,2,180,1,90,0.0,90.0,90.0,1,90,0.0,90.0,90.0
71335.0,6,14,4740,7,653,9862.0,249.0,93.28571428571428,7,4087,10915.5,1514.0,583.8571428571429
90058122.0,17,28,13364,28,13364,3335486.0,501.0,477.2857142857143,0,0,0.0,0.0,0.0
2434.0,17,2,691,1,349,0.0,349.0,349.0,1,342,0.0,342.0,342.0
108105694.0,17,5,955,5,955,27026423.5,191.0,191.0,0,0,0.0,0.0,0.0
366528.0,6,3,1604,2,851,0.0,785.0,425.5,1,753,0.0,753.0,753.0
20210.0,6,10,2032,5,524,4812.5,252.0,104.8,5,1508,4724.75,1236.0,301.6
13452.0,6,10,2032,5,524,3075.25,252.0,104.8,5,1508,3071.0,1236.0,301.6
233495.0,6,3,373,2,238,0.0,172.0,119.0,1,135,0.0,135.0,135.0
90036183.0,17,28,13364,28,13364,3334673.4444444445,501.0,477.2857142857143,0,0,0.0,0.0,0.0
113255176.0,6,46,3036,23,1518,5135437.7727272725,66.0,66.0,23,1518,5135452.5,66.0,66.0
41092.0,6,14,4740,7,653,6527.0,249.0,93.28571428571428,7,4087,5871.5,1514.0,583.8571428571429
90363904.0,6,14,2256,7,1428,15060405.5,204.0,204.0,7,828,15060268.666666666,188.0,118.28571428571428
4276.0,17,2,598,1,72,0.0,72.0,72.0,1,526,0.0,526.0,526.0
82824.0,6,14,4740,7,653,13522.666666666666,249.0,93.28571428571428,7,4087,12885.666666666666,1514.0,583.8571428571429
121006759.0,17,15,1169,8,606,17286679.85714286,174.0,75.75,7,563,16833488.666666668,174.0,80.42857142857143
300046.0,6,6,412,4,272,100015.33333333331,74.0,68.0,2,140,0.0,74.0,70.0
90535857.0,6,14,2240,8,1016,12933693.857142856,188.0,127.0,6,1224,18075040.6,204.0,204.0
321306.0,6,6,412,4,272,107102.0,74.0,68.0,2,140,0.0,74.0,70.0
64655.00000000001,6,14,4740,7,653,9577.333333333334,249.0,93.28571428571428,7,4087,9116.333333333334,1514.0,583.8571428571429
281658.0,17,2,363,1,79,0.0,79.0,79.0,1,284,0.0,284.0,284.0
221938.0,6,3,426,2,280,0.0,214.0,140.0,1,146,0.0,146.0,146.0
108106823.0,17,5,1005,5,1005,27026705.75,201.0,201.0,0,0,0.0,0.0,0.0
108098606.0,17,5,955,5,955,27024651.5,191.0,191.0,0,0,0.0,0.0,0.0
233033.0,6,3,373,2,238,0.0,172.0,119.0,1,135,0.0,135.0,135.0
123001117.0,17,15,1169,8,606,17571588.14285714,174.0,75.75,7,563,17064768.5,174.0,80.42857142857143
2393.0,17,4,344,2,150,0.0,75.0,75.0,2,194,0.0,103.0,97.0
90249616.0,6,12,1832,8,1016,12892802.285714284,188.0,127.0,4,816,30028505.33333333,204.0,204.0
113520193.0,6,46,3036,23,1518,5159997.090909091,66.0,66.0,23,1518,5159996.545454546,66.0,66.0
1174075.0,6,13,3000,8,2372,167725.0,1514.0,296.5,5,628,224557.25,331.0,125.6
2418.0,17,4,344,2,150,0.0,75.0,75.0,2,194,0.0,103.0,97.0
330378.0,17,4,571,2,148,0.0,74.0,74.0,2,423,0.0,280.0,211.5
120011888.0,17,28,13364,28,13364,4444884.740740741,501.0,477.2857142857143,0,0,0.0,0.0,0.0
2046960.0,17,8,1640,4,312,682190.3333333334,78.0,78.0,4,1328,682155.3333333334,332.0,332.0
122017.0,6,3,373,2,238,0.0,172.0,119.0,1,135,0.0,135.0,135.0
102824.0,17,2,286,2,286,0.0,143.0,143.0,0,0,0.0,0.0,0.0
10515871.0,6,7,478,4,272,3459631.0,74.0,68.0,3,206,5189320.0,74.0,68.66666666666667
91329106.0,6,25,1840,12,855,8302646.0,123.0,71.25,13,985,6760574.166666667,139.0,75.76923076923077
113319908.0,6,47,3102,23,1518,5143993.727272728,66.0,66.0,24,1584,4926937.217391305,66.0,66.0
10417839.0,6,6,412,3,206,5141169.0,74.0,68.66666666666667,3,206,5141039.0,74.0,68.66666666666667
146112.0,6,3,337,2,214,0.0,160.0,107.0,1,123,0.0,123.0,123.0
43095.0,6,14,4740,7,653,6876.0,249.0,93.28571428571428,7,4087,5538.333333333333,1514.0,583.8571428571429
120531692.0,6,217,24596,109,17246,1116034.1851851852,284.0,158.22018348623854,108,7350,1116768.6448598132,140.0,68.05555555555556
14641947.0,6,20,1648,10,1016,1592467.2222222222,315.0,101.6,10,632,1592433.2222222222,78.0,63.2
232877.0,6,3,373,2,238,0.0,172.0,119.0,1,135,0.0,135.0,135.0
64344.0,6,14,4740,7,653,10426.833333333334,249.0,93.28571428571428,7,4087,9943.0,1514.0,583.8571428571429
146275.0,6,3,337,2,214,0.0,160.0,107.0,1,123,0.0,123.0,123.0
160289.0,6,2,128,1,74,0.0,74.0,74.0,1,54,0.0,54.0,54.0
114442093.0,6,34,2334,17,1209,7139120.8125,123.0,71.11764705882354,17,1125,7139146.625,123.0,66.17647058823529
129001131.0,17,15,907,8,475,18428733.0,174.0,59.375,7,432,18166571.83333333,174.0,61.71428571428572
3074251.0,6,4,270,2,134,0.0,68.0,67.0,2,136,0.0,70.0,68.0
8210338.0,17,3,1034,2,684,0.0,342.0,342.0,1,350,0.0,350.0,350.0
232819.0,6,3,337,2,214,0.0,160.0,107.0,1,123,0.0,123.0,123.0
42843.0,6,14,4740,7,653,6965.833333333333,249.0,93.28571428571428,7,4087,5501.833333333333,1514.0,583.8571428571429
206242.0,17,2,180,1,90,0.0,90.0,90.0,1,90,0.0,90.0,90.0
40645.0,6,14,4740,7,653,6652.666666666667,249.0,93.28571428571428,7,4087,5753.0,1514.0,583.8571428571429
1482946.0,17,16,1120,16,1120,98863.06666666668,70.0,70.0,0,0,0.0,0.0,0.0
763.0,17,4,438,2,148,0.0,74.0,74.0,2,290,0.0,147.0,145.0
43515.0,6,14,4740,7,653,6788.833333333333,249.0,93.28571428571428,7,4087,6683.5,1514.0,583.8571428571429
859321.0,6,9,1096,6,625,171864.2,287.0,104.16666666666669,3,471,291787.5,331.0,157.0
120121470.0,6,12,1832,8,1016,17137057.57142857,188.0,127.0,4,816,30031269.33333333,204.0,204.0
90765063.0,6,17,1287,9,691,11340353.375,95.0,76.77777777777777,8,596,12965375.0,95.0,74.5
442.0,17,2,166,1,75,0.0,75.0,75.0,1,91,0.0,91.0,91.0
90902050.0,6,19,1436,9,691,11362756.25,95.0,76.77777777777777,10,745,10073295.666666666,95.0,74.5
62430.0,6,10,2032,5,524,14996.0,252.0,104.8,5,1508,12466.0,1236.0,301.6
32291.0,6,14,4740,7,653,5207.5,249.0,93.28571428571428,7,4087,5241.166666666667,1514.0,583.8571428571429
35495.0,6,11,2098,6,590,6773.6,252.0,98.33333333333331,5,1508,7601.25,1236.0,301.6
2777831.0,6,3,1777,1,826,0.0,826.0,826.0,2,951,0.0,885.0,475.5
525621.0,6,3,1604,2,851,0.0,785.0,425.5,1,753,0.0,753.0,753.0
2845999.0,6,3,204,1,68,0.0,68.0,68.0,2,136,0.0,70.0,68.0
50245.0,6,14,4740,7,653,7696.166666666667,249.0,93.28571428571428,7,4087,8176.333333333333,1514.0,583.8571428571429
228134.0,17,2,180,1,90,0.0,90.0,90.0,1,90,0.0,90.0,90.0
121300.0,6,3,337,2,214,0.0,160.0,107.0,1,123,0.0,123.0,123.0
8808.0,17,4,823,2,163,0.0,89.0,81.5,2,660,0.0,443.0,330.0
46071.0,6,14,4740,7,653,6635.833333333333,249.0,93.28571428571428,7,4087,7159.333333333333,1514.0,583.8571428571429
146044.0,6,3,337,2,214,0.0,160.0,107.0,1,123,0.0,123.0,123.0
1314517.0,6,4,264,2,132,0.0,66.0,66.0,2,132,0.0,66.0,66.0
233045.0,6,3,337,2,214,0.0,160.0,107.0,1,123,0.0,123.0,123.0
50790.0,17,2,180,1,90,0.0,90.0,90.0,1,90,0.0,90.0,90.0
33707.0,6,14,4740,7,653,5495.333333333333,249.0,93.28571428571428,7,4087,5447.166666666667,1514.0,583.8571428571429
300981.0,6,6,412,4,272,100327.0,74.0,68.0,2,140,0.0,74.0,70.0
0.0,6,1,66,1,66,0.0,66.0,66.0,0,0,0.0,0.0,0.0
2022029.0,17,4,497,2,150,0.0,75.0,75.0,2,347,0.0,256.0,173.5
303777.0,6,6,412,4,272,101259.0,74.0,68.0,2,140,0.0,74.0,70.0
308092.0,6,6,412,4,272,102697.33333333331,74.0,68.0,2,140,0.0,74.0,70.0
150765.0,17,2,414,1,88,0.0,88.0,88.0,1,326,0.0,326.0,326.0
103036.0,17,2,286,2,286,0.0,143.0,143.0,0,0,0.0,0.0,0.0
104042271.0,6,44,2904,22,1452,4954393.857142857,66.0,66.0,22,1452,4941276.952380952,66.0,66.0
37724.0,6,10,2032,5,524,7275.0,252.0,104.8,5,1508,9067.75,1236.0,301.6
90300579.0,6,16,1192,8,596,12893175.857142856,95.0,74.5,8,596,12899492.0,95.0,74.5
217911.0,6,3,426,2,280,0.0,214.0,140.0,1,146,0.0,146.0,146.0
298699.0,6,6,412,4,272,99566.33333333331,74.0,68.0,2,140,0.0,74.0,70.0
21298.0,6,14,4740,7,653,3188.5,249.0,93.28571428571428,7,4087,3412.0,1514.0,583.8571428571429
12187.0,6,11,1132,6,556,2211.2,218.0,92.66666666666669,5,576,2473.25,304.0,115.2
300159.0,6,6,412,4,272,100053.0,74.0,68.0,2,140,0.0,74.0,70.0
15036.0,17,2,180,1,90,0.0,90.0,90.0,1,90,0.0,90.0,90.0
113168218.0,6,46,3036,23,1518,5143998.181818182,66.0,66.0,23,1518,5143998.727272728,66.0,66.0
108109103.0,17,5,955,5,955,27027275.75,191.0,191.0,0,0,0.0,0.0,0.0
0.0,17,1,179,1,179,0.0,179.0,179.0,0,0,0.0,0.0,0.0
20161.0,6,11,2098,6,590,3850.8,252.0,98.33333333333331,5,1508,4470.75,1236.0,301.6
139414.0,6,2,132,1,66,0.0,66.0,66.0,1,66,0.0,66.0,66.0
863.0,17,4,438,2,148,0.0,74.0,74.0,2,290,0.0,147.0,145.0
205814.0,17,2,762,2,762,0.0,381.0,381.0,0,0,0.0,0.0,0.0
99789.0,17,2,286,2,286,0.0,143.0,143.0,0,0,0.0,0.0,0.0
93875431.0,6,173,19494,87,5964,1091574.779069767,140.0,68.55172413793103,86,13530,1092184.705882353,284.0,157.32558139534885
120459171.0,6,217,24468,109,17044,1115362.6944444445,284.0,156.36697247706422,108,7424,1116210.1028037383,140.0,68.74074074074075
6722.0,17,2,582,1,83,0.0,83.0,83.0,1,499,0.0,499.0,499.0
796.0,17,4,438,2,148,0.0,74.0,74.0,2,290,0.0,147.0,145.0
41460.0,6,14,4740,7,653,6801.666666666667,249.0,93.28571428571428,7,4087,6050.333333333333,1514.0,583.8571428571429
37927.0,6,14,4740,7,653,5823.0,249.0,93.28571428571428,7,4087,6120.0,1514.0,583.8571428571429
168705.0,6,11,1132,6,556,32794.8,218.0,92.66666666666669,5,576,41816.25,304.0,115.2
153871.0,17,2,180,1,90,0.0,90.0,90.0,1,90,0.0,90.0,90.0
0.0,17,1,72,1,72,0.0,72.0,72.0,0,0,0.0,0.0,0.0
93835352.0,6,203,22962,102,6954,929062.8910891088,140.0,68.17647058823529,101,16008,927987.79,300.0,158.4950495049505
215504.0,17,2,762,2,762,0.0,381.0,381.0,0,0,0.0,0.0,0.0
106360897.0,6,44,2904,22,1452,5064804.619047619,66.0,66.0,22,1452,5049113.619047619,66.0,66.0
85720.0,6,12,1320,6,723,14930.6,253.0,120.5,6,597,14631.8,259.0,99.5
233448.0,6,3,337,2,214,0.0,160.0,107.0,1,123,0.0,123.0,123.0
147819.0,17,2,180,1,90,0.0,90.0,90.0,1,90,0.0,90.0,90.0
2796147.0,6,2,132,1,66,0.0,66.0,66.0,1,66,0.0,66.0,66.0
298687.0,6,6,412,4,272,99562.33333333331,74.0,68.0,2,140,0.0,74.0,70.0
2610671.0,6,3,204,2,136,0.0,70.0,68.0,1,68,0.0,68.0,68.0
115329631.0,6,34,2350,17,1225,7194619.375,139.0,72.05882352941177,17,1125,7194616.5625,123.0,66.17647058823529
5623928.0,6,5,336,2,134,0.0,68.0,67.0,3,202,1420601.0,70.0,67.33333333333333
308378.0,6,6,412,4,272,102792.66666666669,74.0,68.0,2,140,0.0,74.0,70.0
302736.0,6,6,412,4,272,100912.0,74.0,68.0,2,140,0.0,74.0,70.0
0.0,6,1,172,1,172,0.0,172.0,172.0,0,0,0.0,0.0,0.0
40428.0,6,10,2032,5,524,9794.0,252.0,104.8,5,1508,8449.5,1236.0,301.6
144774.0,17,2,180,1,70,0.0,70.0,70.0,1,110,0.0,110.0,110.0
91930621.0,6,387,49294,194,13026,476324.4611398964,140.0,67.14432989690722,193,36268,462618.84375,554.0,187.91709844559583
2443.0,17,4,344,2,150,0.0,75.0,75.0,2,194,0.0,103.0,97.0
107061586.0,17,14,864,7,432,17833514.833333332,174.0,61.71428571428572,7,432,17834318.0,174.0,61.71428571428572
0.0,17,1,453,1,453,0.0,453.0,453.0,0,0,0.0,0.0,0.0
323908.0,17,4,1400,4,1400,107969.33333333331,350.0,350.0,0,0,0.0,0.0,0.0
90074278.0,17,28,13364,28,13364,3336084.3703703703,501.0,477.2857142857143,0,0,0.0,0.0,0.0
146097.0,6,3,337,2,214,0.0,160.0,107.0,1,123,0.0,123.0,123.0
357.0,17,2,204,1,88,0.0,88.0,88.0,1,116,0.0,116.0,116.0
103550.0,17,2,286,2,286,0.0,143.0,143.0,0,0,0.0,0.0,0.0
10392.0,6,10,2032,5,524,2350.0,252.0,104.8,5,1508,2322.5,1236.0,301.6
354.0,17,2,267,1,83,0.0,83.0,83.0,1,184,0.0,184.0,184.0
216909.0,6,3,426,2,280,0.0,214.0,140.0,1,146,0.0,146.0,146.0
99040571.0,17,14,1126,7,563,16500170.5,174.0,80.42857142857143,7,563,16501444.0,174.0,80.42857142857143
334865.0,6,10,1221,6,636,66973.0,298.0,106.0,4,585,110712.66666666669,379.0,146.25
135135331.0,17,6,1146,6,1146,27027066.2,191.0,191.0,0,0,0.0,0.0,0.0
120355170.0,6,239,27112,120,18962,1011387.9831932771,284.0,158.01666666666668,119,8150,1012249.466101695,140.0,68.4873949579832
90247588.0,6,14,2240,8,1016,12892512.57142857,188.0,127.0,6,1224,18015921.4,204.0,204.0
114145320.0,6,668,104950,331,22216,345860.5303030303,214.0,67.1178247734139,337,82734,337623.23511904763,1514.0,245.5014836795252
90076921.0,6,11,1644,7,828,15012820.166666666,188.0,118.28571428571428,4,816,20017818.33333333,204.0,204.0
108113732.0,17,5,955,5,955,27028433.0,191.0,191.0,0,0,0.0,0.0,0.0
60523.0,6,10,2032,5,524,14677.5,252.0,104.8,5,1508,12633.75,1236.0,301.6
138001249.0,17,15,907,8,475,19714464.14285714,174.0,59.375,7,432,19667674.83333333,174.0,61.71428571428572
9727.0,17,2,582,1,83,0.0,83.0,83.0,1,499,0.0,499.0,499.0
119679975.0,6,228,25734,114,17914,1057209.371681416,284.0,157.140350877193,114,7820,1057210.460176991,140.0,68.59649122807018
1178437.0,6,11,1134,6,558,235687.4,220.0,93.0,5,576,293826.5,304.0,115.2
2880667.0,6,3,1604,1,753,0.0,753.0,753.0,2,851,0.0,785.0,425.5
310506.0,6,6,412,4,272,103502.0,74.0,68.0,2,140,0.0,74.0,70.0
112000980.0,17,13,821,7,432,18666830.0,174.0,61.71428571428572,6,389,19992662.2,174.0,64.83333333333333
1871439.0,6,22,6442,11,1463,187143.9,357.0,133.0,11,4979,155831.0,1510.0,452.6363636363636
573.0,17,2,508,2,508,0.0,257.0,254.0,0,0,0.0,0.0,0.0
115514910.0,6,216,24440,108,17090,1077567.1962616823,284.0,158.24074074074073,108,7350,1077567.074766355,140.0,68.05555555555556
79864.0,6,14,4740,7,653,8503.5,249.0,93.28571428571428,7,4087,12614.333333333334,1514.0,583.8571428571429
311057.0,17,4,704,2,148,0.0,74.0,74.0,2,556,0.0,280.0,278.0
936917.0,6,12,1447,6,816,185395.2,291.0,136.0,6,631,186898.4,293.0,105.16666666666669
90298460.0,6,16,1192,8,596,12892760.42857143,95.0,74.5,8,596,12899575.857142856,95.0,74.5
2829766.0,6,12,2172,7,664,471466.0,252.0,94.85714285714286,5,1508,2155.5,1236.0,301.6
47611216.0,6,8,2113,3,960,22380486.5,826.0,320.0,5,1153,11257286.0,885.0,230.6
198632.0,17,2,180,1,90,0.0,90.0,90.0,1,90,0.0,90.0,90.0
90057268.0,17,28,13364,28,13364,3335454.3703703703,501.0,477.2857142857143,0,0,0.0,0.0,0.0
20396.0,6,10,2032,5,524,4768.75,252.0,104.8,5,1508,4886.25,1236.0,301.6
14646413.0,6,20,1607,10,975,1592974.2222222222,315.0,97.5,10,632,1592906.6666666667,78.0,63.2
792.0,17,5,550,5,550,198.0,110.0,110.0,0,0,0.0,0.0,0.0
108104265.0,17,5,955,5,955,27026066.25,191.0,191.0,0,0,0.0,0.0,0.0
106554.0,17,2,286,2,286,0.0,143.0,143.0,0,0,0.0,0.0,0.0
90257552.0,6,12,1832,8,1016,12893936.0,188.0,127.0,4,816,30031749.666666668,204.0,204.0
33664.0,6,14,4740,7,653,5482.0,249.0,93.28571428571428,7,4087,4910.333333333333,1514.0,583.8571428571429
190875.0,17,2,180,1,90,0.0,90.0,90.0,1,90,0.0,90.0,90.0
83.0,17,2,762,2,762,0.0,381.0,381.0,0,0,0.0,0.0,0.0
91711651.0,17,16,5472,16,5472,6114110.066666666,342.0,342.0,0,0,0.0,0.0,0.0
126218.0,6,2,132,1,66,0.0,66.0,66.0,1,66,0.0,66.0,66.0
3405684.0,6,7,923,4,753,1063078.0,571.0,188.25,3,170,1594916.5,62.0,56.66666666666666
146863.0,17,2,180,1,70,0.0,70.0,70.0,1,110,0.0,110.0,110.0
121262.0,6,3,337,2,214,0.0,160.0,107.0,1,123,0.0,123.0,123.0
40384.0,6,14,4740,7,653,6566.666666666667,249.0,93.28571428571428,7,4087,6186.5,1514.0,583.8571428571429
436946.0,6,11,1021,6,444,58661.6,162.0,74.0,5,577,73050.75,349.0,115.4
630362.0,6,12,1386,7,586,105060.33333333331,222.0,83.71428571428571,5,800,156834.0,299.0,160.0
239923.0,6,3,337,2,214,0.0,160.0,107.0,1,123,0.0,123.0,123.0
2412.0,17,4,344,2,150,0.0,75.0,75.0,2,194,0.0,103.0,97.0
108084672.0,17,5,955,5,955,27021168.0,191.0,191.0,0,0,0.0,0.0,0.0
155841.0,6,3,337,2,214,0.0,160.0,107.0,1,123,0.0,123.0,123.0
0.0,17,1,453,1,453,0.0,453.0,453.0,0,0,0.0,0.0,0.0
104936768.0,6,43,2838,22,1452,4982474.19047619,66.0,66.0,21,1386,5150431.1,66.0,66.0
315415.0,17,4,1400,4,1400,105138.33333333331,350.0,350.0,0,0,0.0,0.0,0.0
0.0,17,1,342,1,342,0.0,342.0,342.0,0,0,0.0,0.0,0.0
113372668.0,6,218,24646,109,7490,1049243.611111111,140.0,68.71559633027523,109,17156,1042141.8888888888,284.0,157.39449541284404
119596483.0,6,22,1639,12,894,10867589.363636363,95.0,74.5,10,745,13281304.333333334,95.0,74.5
66520.0,6,14,4740,7,653,10961.666666666666,249.0,93.28571428571428,7,4087,10454.5,1514.0,583.8571428571429
305806.0,6,3,202,2,128,0.0,74.0,64.0,1,74,0.0,74.0,74.0
202787.0,17,4,6056,4,6056,67595.66666666667,1514.0,1514.0,0,0,0.0,0.0,0.0
335.0,17,2,208,1,72,0.0,72.0,72.0,1,136,0.0,136.0,136.0
90531380.0,6,14,2102,8,1016,12933054.285714284,188.0,127.0,6,1086,18073683.0,204.0,181.0
284668.0,17,2,363,1,79,0.0,79.0,79.0,1,284,0.0,284.0,284.0
120604190.0,6,495,63908,248,47310,488276.072874494,336.0,190.76612903225808,247,16598,486047.4512195122,140.0,67.19838056680162
503811.0,6,5,336,2,134,0.0,68.0,67.0,3,202,194808.5,70.0,67.33333333333333
40828.0,6,14,4740,7,653,6479.5,249.0,93.28571428571428,7,4087,6641.833333333333,1514.0,583.8571428571429
3789884.0,6,5,336,2,134,0.0,68.0,67.0,3,202,1528196.5,70.0,67.33333333333333
200331.0,17,4,6056,4,6056,66777.0,1514.0,1514.0,0,0,0.0,0.0,0.0
37800.0,6,14,4740,7,653,6183.0,249.0,93.28571428571428,7,4087,5381.0,1514.0,583.8571428571429
106104038.0,17,14,864,7,432,17657322.5,174.0,61.71428571428572,7,432,17605902.333333332,174.0,61.71428571428572
315984.0,6,6,412,4,272,105328.0,74.0,68.0,2,140,0.0,74.0,70.0
108113104.0,17,5,955,5,955,27028276.0,191.0,191.0,0,0,0.0,0.0,0.0
121396.0,6,3,337,2,214,0.0,160.0,107.0,1,123,0.0,123.0,123.0
21175.0,6,11,1131,6,600,3960.0,262.0,100.0,5,531,4990.5,259.0,106.2
516.0,17,2,762,2,762,0.0,381.0,381.0,0,0,0.0,0.0,0.0
840504.0,6,9,1118,6,586,168100.8,248.0,97.66666666666669,3,532,282432.5,392.0,177.33333333333334
108106659.0,17,5,955,5,955,27026664.75,191.0,191.0,0,0,0.0,0.0,0.0
30811.0,6,14,4740,7,653,4669.333333333333,249.0,93.28571428571428,7,4087,4600.0,1514.0,583.8571428571429
205995.0,6,3,426,2,280,0.0,214.0,140.0,1,146,0.0,146.0,146.0
9969.0,6,10,2032,5,524,2283.5,252.0,104.8,5,1508,2210.75,1236.0,301.6
278015.0,17,2,365,1,80,0.0,80.0,80.0,1,285,0.0,285.0,285.0
36842.0,6,14,4740,7,653,6008.166666666667,249.0,93.28571428571428,7,4087,5402.666666666667,1514.0,583.8571428571429
9606.0,17,2,582,1,83,0.0,83.0,83.0,1,499,0.0,499.0,499.0
93810013.0,6,172,19640,86,13816,1101116.5882352942,374.0,160.65116279069767,86,5824,1101116.5647058825,140.0,67.72093023255815
7611805.0,6,16,1131,8,586,1086566.857142857,95.0,73.25,8,545,1041268.8571428572,95.0,68.125
48159.0,6,14,4740,7,653,7874.833333333333,249.0,93.28571428571428,7,4087,6831.0,1514.0,583.8571428571429
860326.0,6,9,1268,6,797,172065.2,459.0,132.83333333333334,3,471,292558.0,331.0,157.0
27606.0,6,12,1320,6,723,4813.4,253.0,120.5,6,597,5047.8,259.0,99.5
15620.0,6,10,2032,5,524,3596.0,252.0,104.8,5,1508,3551.75,1236.0,301.6
116150335.0,6,47,3102,24,1584,5050003.391304348,66.0,66.0,23,1518,5111997.636363637,66.0,66.0
153543.0,17,2,180,1,90,0.0,90.0,90.0,1,90,0.0,90.0,90.0
2042.0,17,4,344,2,150,0.0,75.0,75.0,2,194,0.0,103.0,97.0
42474.0,6,10,2032,5,524,9456.75,252.0,104.8,5,1508,9930.25,1236.0,301.6
119744622.0,17,35,16705,35,16705,3521900.647058824,501.0,477.2857142857143,0,0,0.0,0.0,0.0
252457.0,6,3,337,2,214,0.0,160.0,107.0,1,123,0.0,123.0,123.0
111942.0,17,4,1400,4,1400,37314.0,350.0,350.0,0,0,0.0,0.0,0.0
310530.0,17,4,1400,4,1400,103510.0,350.0,350.0,0,0,0.0,0.0,0.0
974270.0,6,12,1447,6,816,192844.4,291.0,136.0,6,631,194250.2,293.0,105.16666666666669
21819.0,6,14,4740,7,653,3510.6666666666665,249.0,93.28571428571428,7,4087,3500.6666666666665,1514.0,583.8571428571429
108106023.0,17,5,1005,5,1005,27026505.75,201.0,201.0,0,0,0.0,0.0,0.0
116133838.0,6,30,1990,15,1042,8279858.0,139.0,69.46666666666667,15,948,8279849.428571428,123.0,63.2
19675.0,6,11,1133,6,602,3810.0,264.0,100.33333333333331,5,531,3743.0,259.0,106.2
135128047.0,17,6,1146,6,1146,27025609.4,191.0,191.0,0,0,0.0,0.0,0.0
90294772.0,6,16,1192,8,596,12892664.285714284,95.0,74.5,8,596,12897737.714285716,95.0,74.5
233730.0,6,3,337,2,214,0.0,160.0,107.0,1,123,0.0,123.0,123.0
198115.0,17,2,180,1,90,0.0,90.0,90.0,1,90,0.0,90.0,90.0
1989.0,17,4,344,2,150,0.0,75.0,75.0,2,194,0.0,103.0,97.0
5004653.0,17,4,849,2,166,0.0,83.0,83.0,2,683,0.0,499.0,341.5
35729.0,6,14,4740,7,653,5773.333333333333,249.0,93.28571428571428,7,4087,5782.0,1514.0,583.8571428571429
206840.0,6,3,426,2,280,0.0,214.0,140.0,1,146,0.0,146.0,146.0
77.0,17,2,762,2,762,0.0,381.0,381.0,0,0,0.0,0.0,0.0
255997.0,6,3,337,2,214,0.0,160.0,107.0,1,123,0.0,123.0,123.0
54472.0,6,14,4740,7,653,8314.5,249.0,93.28571428571428,7,4087,8939.166666666666,1514.0,583.8571428571429
120444696.0,6,225,25356,113,17742,1075399.0714285714,284.0,157.00884955752213,112,7614,1075741.18018018,140.0,67.98214285714286
39582.0,6,10,2032,5,524,9296.25,252.0,104.8,5,1508,8931.75,1236.0,301.6
2678636.0,6,13,1386,7,789,446439.3333333333,253.0,112.71428571428572,6,597,533120.6,259.0,99.5
450032.0,6,6,758,3,410,187958.0,172.0,136.66666666666666,3,348,165070.5,135.0,116.0
35134.0,6,14,4740,7,653,5697.0,249.0,93.28571428571428,7,4087,4216.833333333333,1514.0,583.8571428571429
50405.0,6,14,4740,7,653,8246.0,249.0,93.28571428571428,7,4087,7297.166666666667,1514.0,583.8571428571429
216390.0,17,2,180,1,90,0.0,90.0,90.0,1,90,0.0,90.0,90.0
9254.0,17,2,582,1,83,0.0,83.0,83.0,1,499,0.0,499.0,499.0
1762346.0,6,2,132,1,66,0.0,66.0,66.0,1,66,0.0,66.0,66.0
34278.0,6,14,4740,7,653,5586.333333333333,249.0,93.28571428571428,7,4087,5575.166666666667,1514.0,583.8571428571429
1204.0,17,4,438,2,148,0.0,74.0,74.0,2,290,0.0,147.0,145.0
21758.0,6,10,2032,5,524,5208.25,252.0,104.8,5,1508,5184.75,1236.0,301.6
102686.0,17,2,286,2,286,0.0,143.0,143.0,0,0,0.0,0.0,0.0
32425.000000000004,6,10,2032,5,524,7501.5,252.0,104.8,5,1508,6432.25,1236.0,301.6
239731.0,6,3,337,2,214,0.0,160.0,107.0,1,123,0.0,123.0,123.0
320.0,17,2,174,1,79,0.0,79.0,79.0,1,95,0.0,95.0,95.0
297504.0,6,6,412,4,272,99168.0,74.0,68.0,2,140,0.0,74.0,70.0
1510927.0,6,4,276,2,128,0.0,74.0,64.0,2,148,0.0,74.0,74.0
316077.0,17,4,1400,4,1400,105359.0,350.0,350.0,0,0,0.0,0.0,0.0
245446.0,6,3,337,2,214,0.0,160.0,107.0,1,123,0.0,123.0,123.0
312.0,17,2,174,1,79,0.0,79.0,79.0,1,95,0.0,95.0,95.0
10427016.0,6,7,478,4,272,3430018.333333333,74.0,68.0,3,206,5144912.5,74.0,68.66666666666667
153468.0,17,2,180,1,90,0.0,90.0,90.0,1,90,0.0,90.0,90.0
221526.0,6,3,426,2,280,0.0,214.0,140.0,1,146,0.0,146.0,146.0
102982.0,17,2,286,2,286,0.0,143.0,143.0,0,0,0.0,0.0,0.0
104429708.0,17,15,5130,15,5130,7459264.857142857,342.0,342.0,0,0,0.0,0.0,0.0
356241.0,6,4,508,2,238,0.0,172.0,119.0,2,270,0.0,135.0,135.0
319776.0,6,6,412,4,272,106592.0,74.0,68.0,2,140,0.0,74.0,70.0
108109837.0,17,5,955,5,955,27027459.25,191.0,191.0,0,0,0.0,0.0,0.0
303936.0,6,6,412,4,272,101312.0,74.0,68.0,2,140,0.0,74.0,70.0
103933.0,17,2,286,2,286,0.0,143.0,143.0,0,0,0.0,0.0,0.0
67676839.0,6,6,402,3,202,1004757.5,70.0,67.33333333333333,3,200,32985283.5,68.0,66.66666666666667
108251.0,17,2,286,2,286,0.0,143.0,143.0,0,0,0.0,0.0,0.0
303632.0,6,2,132,1,66,0.0,66.0,66.0,1,66,0.0,66.0,66.0
120012815.0,17,29,13785,29,13785,4286171.964285715,501.0,475.3448275862069,0,0,0.0,0.0,0.0
116384411.0,6,30,1974,15,1026,8297757.071428572,123.0,68.4,15,948,8297754.142857143,123.0,63.2
90094765.0,6,11,1644,4,816,30030791.666666668,204.0,204.0,7,828,15015389.5,188.0,118.28571428571428
2000.0,17,4,344,2,150,0.0,75.0,75.0,2,194,0.0,103.0,97.0
2395.0,17,4,344,2,150,0.0,75.0,75.0,2,194,0.0,103.0,97.0
113254806.0,6,46,3036,23,1518,5135436.363636363,66.0,66.0,23,1518,5135437.454545454,66.0,66.0
97966629.0,6,30,2122,15,1105,6982185.5,139.0,73.66666666666667,15,1017,6982185.5,123.0,67.8
3592.0,17,5,550,5,550,898.0,110.0,110.0,0,0,0.0,0.0,0.0
1325909.0,6,4,264,2,132,0.0,66.0,66.0,2,132,0.0,66.0,66.0
356.0,17,2,160,1,80,0.0,80.0,80.0,1,80,0.0,80.0,80.0
108095144.0,17,14,864,7,432,18000714.666666668,174.0,61.71428571428572,7,432,18000131.5,174.0,61.71428571428572
120195342.0,6,234,26422,117,8018,1020043.0862068966,140.0,68.52991452991454,117,18404,1029074.2413793104,284.0,157.2991452991453
60656.0,6,10,2032,5,524,14210.5,252.0,104.8,5,1508,11851.5,1236.0,301.6
143879.0,17,2,180,1,90,0.0,90.0,90.0,1,90,0.0,90.0,90.0
15381.0,6,11,1132,6,556,2067.6,218.0,92.66666666666669,5,576,3539.0,304.0,115.2
227175.0,6,10,1221,6,636,45435.0,298.0,106.0,4,585,73954.33333333333,379.0,146.25
108284612.0,6,192,21648,96,15090,1137572.2,284.0,157.1875,96,6558,1137572.505263158,140.0,68.3125
90957872.0,6,21,1585,11,840,9094548.0,95.0,76.36363636363636,10,745,10105302.111111112,95.0,74.5
171626.0,17,2,180,1,90,0.0,90.0,90.0,1,90,0.0,90.0,90.0
299482.0,6,6,412,4,272,99827.33333333331,74.0,68.0,2,140,0.0,74.0,70.0
147989.0,17,2,180,1,90,0.0,90.0,90.0,1,90,0.0,90.0,90.0
13613011.0,6,20,1648,10,1016,1478287.3333333333,315.0,101.6,10,632,1478256.3333333333,78.0,63.2
306030.0,6,6,412,4,272,102010.0,74.0,68.0,2,140,0.0,74.0,70.0
46977.0,6,20,7606,11,978,4697.7,310.0,88.9090909090909,9,6628,5565.125,1514.0,736.4444444444445
135130018.0,17,6,1206,6,1206,27026003.6,201.0,201.0,0,0,0.0,0.0,0.0
319415.0,6,6,412,4,272,106471.66666666669,74.0,68.0,2,140,0.0,74.0,70.0
63473.0,6,12,1413,6,816,12136.6,291.0,136.0,6,597,9390.2,259.0,99.5
1029036.0,6,11,1134,6,558,205807.2,220.0,93.0,5,576,256217.0,304.0,115.2
108739.0,17,2,286,2,286,0.0,143.0,143.0,0,0,0.0,0.0,0.0
13709.0,6,14,4740,7,653,2164.1666666666665,249.0,93.28571428571428,7,4087,2103.333333333333,1514.0,583.8571428571429
33046.0,6,14,4740,7,653,5374.0,249.0,93.28571428571428,7,4087,5329.666666666667,1514.0,583.8571428571429
0.0,17,1,55,1,55,0.0,55.0,55.0,0,0,0.0,0.0,0.0
90245966.0,6,15,1138,8,596,12892280.857142856,95.0,74.5,7,542,15005272.166666666,95.0,77.42857142857143
108490485.0,6,44,4000,26,2269,4339619.4,139.0,87.26923076923077,18,1731,6369080.823529412,123.0,96.16666666666669
156488.0,17,2,180,1,90,0.0,90.0,90.0,1,90,0.0,90.0,90.0
90061687.0,17,28,13364,28,13364,3335618.037037037,501.0,477.2857142857143,0,0,0.0,0.0,0.0
856736.0,6,9,1096,6,625,171347.2,287.0,104.16666666666669,3,471,292062.5,331.0,157.0
209578.0,17,2,180,1,90,0.0,90.0,90.0,1,90,0.0,90.0,90.0
113251894.0,6,46,3036,23,1518,5135441.136363637,66.0,66.0,23,1518,5135445.818181818,66.0,66.0
126896331.0,6,34,2350,17,1125,7306860.125,123.0,66.17647058823529,17,1225,7306856.4375,139.0,72.05882352941177
70553.0,17,2,700,2,700,0.0,350.0,350.0,0,0,0.0,0.0,0.0
86159.0,6,2,132,1,66,0.0,66.0,66.0,1,66,0.0,66.0,66.0
207220.0,6,3,426,2,280,0.0,214.0,140.0,1,146,0.0,146.0,146.0
478278.0,17,2,363,1,79,0.0,79.0,79.0,1,284,0.0,284.0,284.0
5618733.0,6,5,336,2,134,0.0,68.0,67.0,3,202,1524426.0,70.0,67.33333333333333
3590.0,17,2,346,1,78,0.0,78.0,78.0,1,268,0.0,268.0,268.0
94364167.0,6,404,54166,202,13566,469345.0646766169,140.0,67.15841584158416,202,40600,469430.6368159204,480.0,200.990099009901
90045589.0,17,27,12943,27,12943,3463291.8846153845,501.0,479.3703703703704,0,0,0.0,0.0,0.0
146887.0,6,3,373,2,238,0.0,172.0,119.0,1,135,0.0,135.0,135.0
30152.0,6,14,4740,7,653,4504.5,249.0,93.28571428571428,7,4087,4566.0,1514.0,583.8571428571429
0.0,6,1,66,1,66,0.0,66.0,66.0,0,0,0.0,0.0,0.0
99924.0,17,2,762,2,762,0.0,381.0,381.0,0,0,0.0,0.0,0.0
108222.0,17,2,286,2,286,0.0,143.0,143.0,0,0,0.0,0.0,0.0
120005146.0,6,19,1436,10,745,13333905.111111112,95.0,74.5,9,691,14968147.875,95.0,76.77777777777777
26473.0,6,13,4412,6,409,4436.6,127.0,68.16666666666667,7,4003,3694.0,1514.0,571.8571428571429
12512076.0,6,7,499,4,301,2980360.0,103.0,75.25,3,198,6143431.0,66.0,66.0
206390.0,17,2,359,1,75,0.0,75.0,75.0,1,284,0.0,284.0,284.0
90275265.0,6,15,1097,8,596,12896466.42857143,95.0,74.5,7,501,15003135.0,95.0,71.57142857142857
515620.0,6,4,492,2,280,0.0,214.0,140.0,2,212,0.0,146.0,106.0
15154796.0,17,12,5436,12,5436,1377708.7272727273,453.0,453.0,0,0,0.0,0.0,0.0
120122924.0,6,13,2020,9,1204,15015365.5,188.0,133.77777777777777,4,816,30030924.0,204.0,204.0
41156.0,6,14,4740,7,653,6517.333333333333,249.0,93.28571428571428,7,4087,6404.5,1514.0,583.8571428571429
310683.0,17,4,1400,4,1400,103561.0,350.0,350.0,0,0,0.0,0.0,0.0
90286627.0,6,16,1192,8,596,12892057.0,95.0,74.5,8,596,12896570.857142856,95.0,74.5
2311.0,17,4,344,2,150,0.0,75.0,75.0,2,194,0.0,103.0,97.0
33499.0,6,14,4740,7,653,5412.5,249.0,93.28571428571428,7,4087,4048.8333333333335,1514.0,583.8571428571429
135129711.0,17,6,1146,6,1146,27025942.2,191.0,191.0,0,0,0.0,0.0,0.0
3323970.0,6,7,923,4,753,1035397.3333333334,571.0,188.25,3,170,1553723.0,62.0,56.66666666666666
50208.0,6,14,4740,7,653,6031.666666666667,249.0,93.28571428571428,7,4087,7069.333333333333,1514.0,583.8571428571429
147872.0,17,2,180,1,90,0.0,90.0,90.0,1,90,0.0,90.0,90.0
7682.0,17,4,344,2,150,0.0,75.0,75.0,2,194,0.0,103.0,97.0
148007.0,17,2,180,1,90,0.0,90.0,90.0,1,90,0.0,90.0,90.0
417.0,17,2,410,1,78,0.0,78.0,78.0,1,332,0.0,332.0,332.0
299648.0,6,6,412,4,272,99882.66666666669,74.0,68.0,2,140,0.0,74.0,70.0
90291273.0,6,14,1043,7,542,15048545.5,95.0,77.42857142857143,7,501,14997884.833333334,95.0,71.57142857142857
153420.0,17,2,180,1,90,0.0,90.0,90.0,1,90,0.0,90.0,90.0
135135311.0,17,6,1146,6,1146,27027062.2,191.0,191.0,0,0,0.0,0.0,0.0
210192.0,17,2,762,2,762,0.0,381.0,381.0,0,0,0.0,0.0,0.0
49656960.0,6,4,1670,2,851,0.0,785.0,425.5,2,819,0.0,753.0,409.5
0.0,6,1,66,1,66,0.0,66.0,66.0,0,0,0.0,0.0,0.0
2976891.0,6,3,1777,1,826,0.0,826.0,826.0,2,951,0.0,885.0,475.5
12654.0,17,4,823,2,163,0.0,89.0,81.5,2,660,0.0,443.0,330.0
9758.0,17,4,823,2,163,0.0,89.0,81.5,2,660,0.0,443.0,330.0
90296027.0,6,16,1192,8,596,12891902.142857144,95.0,74.5,8,596,12897715.0,95.0,74.5
3242209.0,6,161,123787,87,114601,37700.1046511628,1510.0,1317.2528735632184,74,9186,40217.16438356164,1510.0,124.13513513513512
4130.0,17,4,704,2,148,0.0,74.0,74.0,2,556,0.0,280.0,278.0
119962479.0,6,17,2622,8,1338,12871428.714285716,199.0,167.25,9,1284,14995025.375,204.0,142.66666666666666
2996694.0,6,146,123401,87,115206,34845.27906976744,1510.0,1324.2068965517242,59,8195,46437.206896551725,1510.0,138.89830508474577
252857.0,6,3,337,2,214,0.0,160.0,107.0,1,123,0.0,123.0,123.0
305009.0,6,6,412,4,272,101669.66666666669,74.0,68.0,2,140,0.0,74.0,70.0
118695710.0,6,37,2650,19,1302,6594206.111111111,123.0,68.52631578947368,18,1348,6883526.588235294,139.0,74.88888888888889
363281.0,6,11,1021,6,444,48903.8,162.0,74.0,5,577,60943.25,349.0,115.4
106825.0,17,2,286,2,286,0.0,143.0,143.0,0,0,0.0,0.0,0.0
1091139.0,6,10,1333,6,796,218227.8,458.0,132.66666666666666,4,537,271825.6666666667,331.0,134.25
100087967.0,17,12,778,6,389,20017593.4,174.0,64.83333333333333,6,389,19978146.2,174.0,64.83333333333333
4038.0,17,2,582,1,83,0.0,83.0,83.0,1,499,0.0,499.0,499.0
155900.0,6,3,337,2,214,0.0,160.0,107.0,1,123,0.0,123.0,123.0
119854387.0,6,16,2234,7,1152,19975581.33333333,204.0,164.57142857142858,9,1082,14981608.625,188.0,120.22222222222224
303564.0,6,6,412,4,272,101188.0,74.0,68.0,2,140,0.0,74.0,70.0
121281.0,6,3,337,2,214,0.0,160.0,107.0,1,123,0.0,123.0,123.0
3305444.0,6,3,204,2,136,0.0,70.0,68.0,1,68,0.0,68.0,68.0
112260150.0,6,221,24912,111,7548,1020546.8181818182,140.0,68.0,110,17364,1020161.8165137614,284.0,157.85454545454544
135130965.0,17,6,1146,6,1146,27026193.0,191.0,191.0,0,0,0.0,0.0,0.0
299.0,17,2,164,1,82,0.0,82.0,82.0,1,82,0.0,82.0,82.0
228388.0,17,2,180,1,90,0.0,90.0,90.0,1,90,0.0,90.0,90.0
54201.0,6,10,2032,5,524,13313.25,252.0,104.8,5,1508,10003.25,1236.0,301.6
103340.0,17,2,286,2,286,0.0,143.0,143.0,0,0,0.0,0.0,0.0
52824.0,6,11,2098,6,590,9993.0,252.0,98.33333333333331,5,1508,3569.0,1236.0,301.6
15376.0,6,14,4740,7,653,2453.1666666666665,249.0,93.28571428571428,7,4087,2425.833333333333,1514.0,583.8571428571429
90269087.0,6,13,2036,8,1016,12895583.857142856,188.0,127.0,5,1020,22525618.5,204.0,204.0
10514456.0,6,7,478,4,272,3459454.333333333,74.0,68.0,3,206,5189059.5,74.0,68.66666666666667
1057.0,17,2,762,2,762,0.0,381.0,381.0,0,0,0.0,0.0,0.0
113612886.0,6,48,3168,24,1584,4939690.695652174,66.0,66.0,24,1584,4930290.869565218,66.0,66.0
21315.0,6,11,2098,6,590,3699.8,252.0,98.33333333333331,5,1508,5012.0,1236.0,301.6
81.0,17,2,762,2,762,0.0,381.0,381.0,0,0,0.0,0.0,0.0
242013.0,6,3,337,2,214,0.0,160.0,107.0,1,123,0.0,123.0,123.0
2393.0,17,4,344,2,150,0.0,75.0,75.0,2,194,0.0,103.0,97.0
101387.0,17,2,762,2,762,0.0,381.0,381.0,0,0,0.0,0.0,0.0
10946085.0,6,8,544,4,272,3603024.3333333335,74.0,68.0,4,272,3602953.3333333335,74.0,68.0
90277641.0,6,15,1097,8,596,12896805.857142856,95.0,74.5,7,501,14999986.5,95.0,71.57142857142857
120330282.0,6,229,26002,115,18182,1055528.7894736845,284.0,158.10434782608695,114,7820,1055750.4336283186,140.0,68.59649122807018
32147.000000000004,6,14,4740,7,653,5161.333333333333,249.0,93.28571428571428,7,4087,5218.166666666667,1514.0,583.8571428571429
85274.0,6,13,1386,7,789,14212.333333333334,253.0,112.71428571428572,6,597,14986.6,259.0,99.5
100414.0,17,2,762,2,762,0.0,381.0,381.0,0,0,0.0,0.0,0.0
376.0,17,2,762,2,762,0.0,381.0,381.0,0,0,0.0,0.0,0.0
196943.0,17,2,180,1,90,0.0,90.0,90.0,1,90,0.0,90.0,90.0
116443330.0,6,203,23042,102,16154,1152904.2574257427,284.0,158.37254901960785,101,6888,1108476.22,140.0,68.1980198019802
207078.0,6,3,426,2,280,0.0,214.0,140.0,1,146,0.0,146.0,146.0
60987.0,6,14,4740,7,653,10034.166666666666,249.0,93.28571428571428,7,4087,7912.333333333333,1514.0,583.8571428571429
90018593.0,17,28,13364,28,13364,3334021.962962963,501.0,477.2857142857143,0,0,0.0,0.0,0.0
1680840.0,6,23,6509,12,1529,152803.63636363635,357.0,127.41666666666669,11,4980,137826.6,1510.0,452.7272727272728
308891.0,6,6,412,4,272,102963.66666666669,74.0,68.0,2,140,0.0,74.0,70.0
35050.0,6,14,4740,7,653,5681.5,249.0,93.28571428571428,7,4087,4797.166666666667,1514.0,583.8571428571429
246100.0,6,3,337,2,214,0.0,160.0,107.0,1,123,0.0,123.0,123.0
9458.0,17,2,582,1,83,0.0,83.0,83.0,1,499,0.0,499.0,499.0
196854.0,17,2,180,1,90,0.0,90.0,90.0,1,90,0.0,90.0,90.0
147312.0,6,3,373,2,238,0.0,172.0,119.0,1,135,0.0,135.0,135.0
318.0,17,2,174,1,79,0.0,79.0,79.0,1,95,0.0,95.0,95.0
91382974.0,6,24,1829,13,989,7614357.75,95.0,76.07692307692308,11,840,9136826.9,95.0,76.36363636363636
1778935.0,6,2,132,1,66,0.0,66.0,66.0,1,66,0.0,66.0,66.0
111294772.0,6,30,1974,15,1026,7934193.928571428,123.0,68.4,15,948,7934207.214285715,123.0,63.2
66023165.00000001,6,8,1307,8,1307,9431880.714285716,172.0,163.375,0,0,0.0,0.0,0.0
14638678.0,6,20,1648,10,1016,1592111.3333333333,315.0,101.6,10,632,1592096.6666666667,78.0,63.2
149710578.0,17,36,17126,36,17126,4277445.085714285,501.0,475.72222222222223,0,0,0.0,0.0,0.0
246000.0,6,3,337,2,214,0.0,160.0,107.0,1,123,0.0,123.0,123.0
783.0,17,4,438,2,148,0.0,74.0,74.0,2,290,0.0,147.0,145.0
316.0,17,2,174,1,79,0.0,79.0,79.0,1,95,0.0,95.0,95.0
0.0,17,1,381,1,381,0.0,381.0,381.0,0,0,0.0,0.0,0.0
14392.0,6,11,1131,6,600,2468.4,262.0,100.0,5,531,3268.5,259.0,106.2
103335.0,17,2,286,2,286,0.0,143.0,143.0,0,0,0.0,0.0,0.0
90255325.0,6,12,1832,8,1016,12893617.857142856,188.0,127.0,4,816,30030607.0,204.0,204.0
4563.0,17,2,614,1,72,0.0,72.0,72.0,1,542,0.0,542.0,542.0
121230.0,6,3,337,2,214,0.0,160.0,107.0,1,123,0.0,123.0,123.0
145705.0,17,4,704,2,148,0.0,74.0,74.0,2,556,0.0,280.0,278.0
90031690.0,17,28,13364,28,13364,3334507.037037037,501.0,477.2857142857143,0,0,0.0,0.0,0.0
43674.0,6,14,4740,7,653,7162.333333333333,249.0,93.28571428571428,7,4087,6432.166666666667,1514.0,583.8571428571429
27543382.0,17,5,1710,5,1710,6885845.5,342.0,342.0,0,0,0.0,0.0,0.0
857514.0,6,9,1096,6,625,171502.8,287.0,104.16666666666669,3,471,290934.5,331.0,157.0
104849067.0,6,28,1860,14,966,8065312.846153846,123.0,69.0,14,894,8048686.692307692,123.0,63.85714285714285
25276.0,6,14,4740,7,653,4028.6666666666665,249.0,93.28571428571428,7,4087,3722.8333333333335,1514.0,583.8571428571429
141304.0,6,2,132,1,66,0.0,66.0,66.0,1,66,0.0,66.0,66.0
1831251.0,6,22,6443,11,1463,183125.1,357.0,133.0,11,4980,152645.8,1510.0,452.7272727272728
143918.0,17,2,180,1,90,0.0,90.0,90.0,1,90,0.0,90.0,90.0
104167045.0,6,44,2904,22,1452,4960335.476190476,66.0,66.0,22,1452,4945351.904761905,66.0,66.0
46792.0,6,12,1320,6,723,7046.4,253.0,120.5,6,597,8779.2,259.0,99.5
2050.0,17,4,344,2,150,0.0,75.0,75.0,2,194,0.0,103.0,97.0
2812.0,17,4,344,2,150,0.0,75.0,75.0,2,194,0.0,103.0,97.0
108092563.0,17,5,1005,5,1005,27023140.75,201.0,201.0,0,0,0.0,0.0,0.0
90027220.0,17,28,13364,28,13364,3334341.4814814813,501.0,477.2857142857143,0,0,0.0,0.0,0.0
1318763.0,6,4,264,2,132,0.0,66.0,66.0,2,132,0.0,66.0,66.0
241339.0,6,3,373,2,238,0.0,172.0,119.0,1,135,0.0,135.0,135.0
253095.0,6,3,337,2,214,0.0,160.0,107.0,1,123,0.0,123.0,123.0
128524941.0,17,14,864,7,432,18167453.0,174.0,61.71428571428572,7,432,18166865.0,174.0,61.71428571428572
118054329.0,6,30,1974,15,1026,8417811.785714285,123.0,68.4,15,948,8417813.857142856,123.0,63.2
858.0,17,4,438,2,148,0.0,74.0,74.0,2,290,0.0,147.0,145.0
107815637.0,6,32,2236,16,1165,7187709.133333334,139.0,72.8125,16,1071,7173999.266666667,123.0,66.9375
90032184.0,17,28,13364,28,13364,3334525.333333333,501.0,477.2857142857143,0,0,0.0,0.0,0.0
90047775.0,17,27,12943,27,12943,3463375.961538461,501.0,479.3703703703704,0,0,0.0,0.0,0.0
865742.0,6,9,1267,6,796,173148.4,458.0,132.66666666666666,3,471,294975.5,331.0,157.0
37530.0,6,14,4740,7,653,6129.5,249.0,93.28571428571428,7,4087,5889.0,1514.0,583.8571428571429
42511.0,6,10,2032,5,524,10411.5,252.0,104.8,5,1508,8790.5,1236.0,301.6
2263.0,17,4,344,2,150,0.0,75.0,75.0,2,194,0.0,103.0,97.0
312252.0,17,4,1400,4,1400,104084.0,350.0,350.0,0,0,0.0,0.0,0.0
321819.0,17,4,1400,4,1400,107273.0,350.0,350.0,0,0,0.0,0.0,0.0
110962.0,6,12,1328,7,797,18493.666666666668,253.0,113.85714285714286,5,531,23604.75,259.0,106.2
100414534.0,6,28,1860,14,966,7707592.615384615,123.0,69.0,14,894,7707588.769230769,123.0,63.85714285714285
3516.0,17,2,414,1,88,0.0,88.0,88.0,1,326,0.0,326.0,326.0
118001198.0,17,15,1169,8,606,16857314.0,174.0,75.75,7,563,16332095.166666666,174.0,80.42857142857143
50899.0,17,2,180,1,90,0.0,90.0,90.0,1,90,0.0,90.0,90.0
191199.0,17,2,180,1,90,0.0,90.0,90.0,1,90,0.0,90.0,90.0
0.0,6,1,54,1,54,0.0,54.0,54.0,0,0,0.0,0.0,0.0
196992.0,17,2,180,1,90,0.0,90.0,90.0,1,90,0.0,90.0,90.0
110557739.0,17,14,864,7,432,18333492.5,174.0,61.71428571428572,7,432,18334160.666666668,174.0,61.71428571428572
108333.0,17,2,286,2,286,0.0,143.0,143.0,0,0,0.0,0.0,0.0
120124943.0,6,13,2036,5,1020,30031235.75,204.0,204.0,8,1016,17137050.285714287,188.0,127.0
335.0,17,2,166,1,75,0.0,75.0,75.0,1,91,0.0,91.0,91.0
2615385.0,6,50,23782,26,19851,104615.4,1514.0,763.5,24,3931,103759.82608695651,1514.0,163.79166666666666
328.0,17,2,160,1,80,0.0,80.0,80.0,1,80,0.0,80.0,80.0
1515135.0,6,7,499,3,198,715597.0,66.0,66.0,4,301,478371.0,103.0,75.25
1046450.0,6,13,1386,7,789,174408.33333333334,253.0,112.71428571428572,6,597,205824.0,259.0,99.5
2299.0,17,4,344,2,150,0.0,75.0,75.0,2,194,0.0,103.0,97.0
106808.0,17,2,700,2,700,0.0,350.0,350.0,0,0,0.0,0.0,0.0
118625157.0,6,268,30742,134,21676,890371.1954887218,300.0,161.76119402985074,134,9066,890370.5639097744,140.0,67.65671641791045
90526059.0,6,13,2036,8,1016,12932294.142857144,188.0,127.0,5,1020,22590432.5,204.0,204.0
9335.0,17,4,823,2,163,0.0,89.0,81.5,2,660,0.0,443.0,330.0
10182.0,17,4,823,2,163,0.0,89.0,81.5,2,660,0.0,443.0,330.0
2366.0,17,4,344,2,150,0.0,75.0,75.0,2,194,0.0,103.0,97.0
90060265.0,17,28,13364,28,13364,3335565.3703703703,501.0,477.2857142857143,0,0,0.0,0.0,0.0
1030207.0,6,11,1134,6,558,206041.4,220.0,93.0,5,576,255314.5,304.0,115.2
313194.0,17,4,1400,4,1400,104398.0,350.0,350.0,0,0,0.0,0.0,0.0
122030691.0,6,33,2280,17,1209,7626918.1875,123.0,71.11764705882354,16,1071,7456067.533333333,123.0,66.9375
237273.0,17,2,180,1,90,0.0,90.0,90.0,1,90,0.0,90.0,90.0
90256358.0,6,14,2240,8,1016,12893765.42857143,188.0,127.0,6,1224,18018734.6,204.0,204.0
34214.0,6,14,4740,7,653,5578.833333333333,249.0,93.28571428571428,7,4087,5096.5,1514.0,583.8571428571429
246876.0,6,3,373,2,238,0.0,172.0,119.0,1,135,0.0,135.0,135.0
258651.00000000003,6,12,1373,7,714,43108.5,298.0,102.0,5,659,60635.25,379.0,131.8
2383.0,17,4,344,2,150,0.0,75.0,75.0,2,194,0.0,103.0,97.0
120065445.0,6,234,26422,117,8018,1029062.724137931,140.0,68.52991452991454,117,18404,1028044.0603448276,284.0,157.2991452991453
107041.0,17,2,286,2,286,0.0,143.0,143.0,0,0,0.0,0.0,0.0
246256.0,6,3,337,2,214,0.0,160.0,107.0,1,123,0.0,123.0,123.0
198259.0,17,2,180,1,90,0.0,90.0,90.0,1,90,0.0,90.0,90.0
19934.0,6,2,145,2,145,0.0,91.0,72.5,0,0,0.0,0.0,0.0
44206.0,6,10,2032,5,524,10808.25,252.0,104.8,5,1508,8465.0,1236.0,301.6
3187615.0,6,3,204,1,68,0.0,68.0,68.0,2,136,0.0,70.0,68.0
26997344.0,17,5,1710,5,1710,6749336.0,342.0,342.0,0,0,0.0,0.0,0.0
307558.0,6,3,202,2,128,0.0,74.0,64.0,1,74,0.0,74.0,74.0
447713.0,6,10,1221,6,636,89542.6,298.0,106.0,4,585,147798.0,379.0,146.25
2386.0,17,4,344,2,150,0.0,75.0,75.0,2,194,0.0,103.0,97.0
108100814.0,17,5,1005,5,1005,27025203.5,201.0,201.0,0,0,0.0,0.0,0.0
27103.0,6,14,4740,7,653,4292.333333333333,249.0,93.28571428571428,7,4087,4098.166666666667,1514.0,583.8571428571429
9743570.0,6,5,1736,2,819,0.0,753.0,409.5,3,917,4802204.0,785.0,305.6666666666667
2331.0,17,4,344,2,150,0.0,75.0,75.0,2,194,0.0,103.0,97.0
1317768.0,6,4,264,2,132,0.0,66.0,66.0,2,132,0.0,66.0,66.0
6505.0,17,4,823,2,163,0.0,89.0,81.5,2,660,0.0,443.0,330.0
276798.0,6,10,1221,6,636,55359.6,298.0,106.0,4,585,90603.0,379.0,146.25
310885.0,6,6,412,4,272,103628.33333333331,74.0,68.0,2,140,0.0,74.0,70.0
216329.0,17,2,180,1,90,0.0,90.0,90.0,1,90,0.0,90.0,90.0
100350244.0,6,28,1860,14,966,7702630.230769231,123.0,69.0,14,894,7702633.0,123.0,63.85714285714285
303077.0,6,2,132,1,66,0.0,66.0,66.0,1,66,0.0,66.0,66.0
76959.0,6,14,4740,7,653,11886.5,249.0,93.28571428571428,7,4087,12670.166666666666,1514.0,583.8571428571429
430.0,17,2,216,1,84,0.0,84.0,84.0,1,132,0.0,132.0,132.0
120012924.0,17,28,13364,28,13364,4444923.111111111,501.0,477.2857142857143,0,0,0.0,0.0,0.0
2338.0,17,4,344,2,150,0.0,75.0,75.0,2,194,0.0,103.0,97.0
1321436.0,6,4,264,2,132,0.0,66.0,66.0,2,132,0.0,66.0,66.0
120911.0,6,3,337,2,214,0.0,160.0,107.0,1,123,0.0,123.0,123.0
171610.0,17,2,180,1,90,0.0,90.0,90.0,1,90,0.0,90.0,90.0
47533.0,6,14,4740,7,653,7798.833333333333,249.0,93.28571428571428,7,4087,7156.833333333333,1514.0,583.8571428571429
117292234.0,6,31,2166,16,1149,7805084.133333334,123.0,71.8125,15,1017,8362586.714285715,123.0,67.8
9153.0,17,2,498,1,80,0.0,80.0,80.0,1,418,0.0,418.0,418.0
2048141.0,17,6,1039,4,312,682574.3333333334,78.0,78.0,2,727,0.0,395.0,363.5
48970.0,6,14,4740,7,653,7993.833333333333,249.0,93.28571428571428,7,4087,7550.833333333333,1514.0,583.8571428571429
54586.0,6,10,2032,5,524,13416.75,252.0,104.8,5,1508,13081.75,1236.0,301.6
40064.0,6,14,4740,7,653,6259.666666666667,249.0,93.28571428571428,7,4087,5889.166666666667,1514.0,583.8571428571429
787827.0,6,2,132,1,66,0.0,66.0,66.0,1,66,0.0,66.0,66.0
108109378.0,17,5,955,5,955,27027344.5,191.0,191.0,0,0,0.0,0.0,0.0
135134867.0,17,6,1206,6,1206,27026973.4,201.0,201.0,0,0,0.0,0.0,0.0
217838.0,6,3,426,2,280,0.0,214.0,140.0,1,146,0.0,146.0,146.0
197358.0,17,2,180,1,90,0.0,90.0,90.0,1,90,0.0,90.0,90.0
104641959.0,17,14,864,7,432,17167352.666666668,174.0,61.71428571428572,7,432,17166834.666666668,174.0,61.71428571428572
32908.0,6,10,2032,5,524,8014.0,252.0,104.8,5,1508,7254.5,1236.0,301.6
108109787.0,17,5,1005,5,1005,27027446.75,201.0,201.0,0,0,0.0,0.0,0.0
113664642.0,6,47,3102,24,1584,4941930.434782608,66.0,66.0,23,1518,5159994.136363637,66.0,66.0
322466.0,17,4,1400,4,1400,107488.66666666669,350.0,350.0,0,0,0.0,0.0,0.0
93188141.0,17,12,1040,6,520,14802581.4,174.0,86.66666666666667,6,520,14800160.6,174.0,86.66666666666667
100554021.0,6,28,1992,14,963,7734924.692307692,123.0,68.78571428571429,14,1029,6950188.923076923,123.0,73.5
316.0,17,2,166,1,75,0.0,75.0,75.0,1,91,0.0,91.0,91.0
137318.0,6,2,132,1,66,0.0,66.0,66.0,1,66,0.0,66.0,66.0
681.0,17,4,438,2,148,0.0,74.0,74.0,2,290,0.0,147.0,145.0
43052.0,6,14,4740,7,653,6903.833333333333,249.0,93.28571428571428,7,4087,6401.5,1514.0,583.8571428571429
2055.0,17,4,344,2,150,0.0,75.0,75.0,2,194,0.0,103.0,97.0
120094288.0,6,240,27708,120,8142,1003166.756302521,140.0,67.85,120,19566,1002321.6638655462,300.0,163.05
9269.0,6,10,1067,5,536,2139.5,264.0,107.2,5,531,2125.0,259.0,106.2
1447684.0,6,7,499,4,301,445548.0,103.0,75.25,3,198,717258.0,66.0,66.0
117253784.0,6,227,25790,114,7820,1037644.1061946902,140.0,68.59649122807018,113,17970,1037667.2678571428,336.0,159.02654867256638
264498.0,6,10,1221,6,636,52899.6,298.0,106.0,4,585,82706.66666666667,379.0,146.25
310.0,17,2,174,1,79,0.0,79.0,79.0,1,95,0.0,95.0,95.0
90529285.0,6,13,2036,8,1016,12932755.0,188.0,127.0,5,1020,22591268.0,204.0,204.0
135124293.0,17,6,1206,6,1206,27024858.6,201.0,201.0,0,0,0.0,0.0,0.0
108109706.0,17,5,1005,5,1005,27027426.5,201.0,201.0,0,0,0.0,0.0,0.0
133666.0,6,2,132,1,66,0.0,66.0,66.0,1,66,0.0,66.0,66.0
286111.0,17,2,363,1,79,0.0,79.0,79.0,1,284,0.0,284.0,284.0
2597533.0,6,2,132,1,66,0.0,66.0,66.0,1,66,0.0,66.0,66.0
120027384.0,17,28,13364,28,13364,4445458.666666667,501.0,477.2857142857143,0,0,0.0,0.0,0.0
320294.0,17,4,1400,4,1400,106764.66666666669,350.0,350.0,0,0,0.0,0.0,0.0
103696.0,17,2,286,2,286,0.0,143.0,143.0,0,0,0.0,0.0,0.0
410.0,17,2,410,1,78,0.0,78.0,78.0,1,332,0.0,332.0,332.0
115548060.0,6,48,3168,24,1584,5023828.695652174,66.0,66.0,24,1584,5010240.913043479,66.0,66.0
308986.0,17,4,622,4,622,102995.33333333331,163.0,155.5,0,0,0.0,0.0,0.0
90028180.0,17,28,13364,28,13364,3334377.037037037,501.0,477.2857142857143,0,0,0.0,0.0,0.0
22576.0,6,14,4740,7,653,3544.6666666666665,249.0,93.28571428571428,7,4087,3197.6666666666665,1514.0,583.8571428571429
2438.0,17,4,344,2,150,0.0,75.0,75.0,2,194,0.0,103.0,97.0
234095.0,6,3,337,2,214,0.0,160.0,107.0,1,123,0.0,123.0,123.0
38602919.0,6,8,1940,3,887,18138819.0,753.0,295.6666666666667,5,1053,8954109.5,785.0,210.6
410392.0,6,3,1604,1,753,0.0,753.0,753.0,2,851,0.0,785.0,425.5
90763545.0,6,17,1287,9,691,11339685.25,95.0,76.77777777777777,8,596,12964325.57142857,95.0,74.5
299334.0,6,6,412,4,272,99778.0,74.0,68.0,2,140,0.0,74.0,70.0
285111.0,17,2,363,1,79,0.0,79.0,79.0,1,284,0.0,284.0,284.0
264219.0,6,3,337,2,214,0.0,160.0,107.0,1,123,0.0,123.0,123.0
226668.0,6,10,1221,6,636,45333.6,298.0,106.0,4,585,74054.0,379.0,146.25
108115858.0,17,5,955,5,955,27028964.5,191.0,191.0,0,0,0.0,0.0,0.0
72143833.0,6,9,842,9,842,9017979.125,97.0,93.55555555555556,0,0,0.0,0.0,0.0
2454.0,17,4,344,2,150,0.0,75.0,75.0,2,194,0.0,103.0,97.0
348.0,17,2,166,1,75,0.0,75.0,75.0,1,91,0.0,91.0,91.0
80613.0,6,14,4740,7,653,13186.0,249.0,93.28571428571428,7,4087,12985.0,1514.0,583.8571428571429
301903.0,6,6,412,4,272,100634.33333333331,74.0,68.0,2,140,0.0,74.0,70.0
93277214.0,6,39,2574,20,1320,4897965.210526316,66.0,66.0,19,1254,5105435.111111111,66.0,66.0
41965.0,6,10,1065,5,534,9412.0,262.0,106.8,5,531,9635.25,259.0,106.2
151529.0,6,3,337,2,214,0.0,160.0,107.0,1,123,0.0,123.0,123.0
62175.0,6,14,4740,7,653,10071.0,249.0,93.28571428571428,7,4087,10079.833333333334,1514.0,583.8571428571429
2400.0,17,4,344,2,150,0.0,75.0,75.0,2,194,0.0,103.0,97.0
108110301.0,17,5,1005,5,1005,27027575.25,201.0,201.0,0,0,0.0,0.0,0.0
2002.0,17,4,344,2,150,0.0,75.0,75.0,2,194,0.0,103.0,97.0
108108377.0,17,5,1005,5,1005,27027094.25,201.0,201.0,0,0,0.0,0.0,0.0
216227.0,17,2,180,1,90,0.0,90.0,90.0,1,90,0.0,90.0,90.0
205547.0,17,2,180,1,90,0.0,90.0,90.0,1,90,0.0,90.0,90.0
135123268.0,17,6,1146,6,1146,27024653.6,191.0,191.0,0,0,0.0,0.0,0.0
198207.0,17,2,180,1,90,0.0,90.0,90.0,1,90,0.0,90.0,90.0
27488837.0,17,5,1710,5,1710,6872209.25,342.0,342.0,0,0,0.0,0.0,0.0
120119944.0,6,14,2240,6,1224,24023988.8,204.0,204.0,8,1016,17136714.85714286,188.0,127.0
2304.0,17,4,344,2,150,0.0,75.0,75.0,2,194,0.0,103.0,97.0
10522821.0,6,7,478,4,272,3460592.333333333,74.0,68.0,3,206,5190774.0,74.0,68.66666666666667
207559.0,17,2,762,2,762,0.0,381.0,381.0,0,0,0.0,0.0,0.0
744346.0,6,2,132,1,66,0.0,66.0,66.0,1,66,0.0,66.0,66.0
268938.0,6,12,1373,7,714,44823.0,298.0,102.0,5,659,62078.75,379.0,131.8
10262.0,6,11,2098,6,590,1727.4,252.0,98.33333333333331,5,1508,2290.25,1236.0,301.6
341540.0,17,4,1524,4,1524,113846.66666666669,381.0,381.0,0,0,0.0,0.0,0.0
302104.0,6,6,412,4,272,100701.33333333331,74.0,68.0,2,140,0.0,74.0,70.0
108100802.0,17,5,955,5,955,27025200.5,191.0,191.0,0,0,0.0,0.0,0.0
889694.0,6,12,1354,6,723,176522.0,253.0,120.5,6,631,176962.2,293.0,105.16666666666669
206406.0,6,3,426,2,280,0.0,214.0,140.0,1,146,0.0,146.0,146.0
148659.0,17,2,414,1,88,0.0,88.0,88.0,1,326,0.0,326.0,326.0
279305.0,6,12,1373,7,714,46550.833333333336,298.0,102.0,5,659,65733.0,379.0,131.8
90092371.0,6,12,1848,5,1020,22522485.0,204.0,204.0,7,828,15015004.666666666,188.0,118.28571428571428
293828.0,17,2,246,1,76,0.0,76.0,76.0,1,170,0.0,170.0,170.0
120182405.0,6,224,25376,112,7688,1075328.8738738738,140.0,68.64285714285714,112,17688,1080842.7297297297,300.0,157.92857142857142
11752242.0,6,6,433,2,132,0.0,66.0,66.0,4,301,3917414.0,103.0,75.25
50980.0,17,2,180,1,90,0.0,90.0,90.0,1,90,0.0,90.0,90.0
43467.0,6,10,2032,5,524,10540.25,252.0,104.8,5,1508,8416.25,1236.0,301.6
108970.0,17,2,286,2,286,0.0,143.0,143.0,0,0,0.0,0.0,0.0
2950.0,17,2,224,1,76,0.0,76.0,76.0,1,148,0.0,148.0,148.0
2027.0,17,4,344,2,150,0.0,75.0,75.0,2,194,0.0,103.0,97.0
96026579.0,6,40,2640,20,1320,5054030.47368421,66.0,66.0,20,1320,5039533.894736842,66.0,66.0
45000924.0,17,9,3086,8,2736,5110719.285714285,342.0,342.0,1,350,0.0,350.0,350.0
3214211.0,6,158,126093,90,117303,36114.730337078654,1510.0,1303.3666666666666,68,8790,43397.37313432836,1510.0,129.26470588235293
307635.0,17,8,12112,8,12112,43947.857142857145,1514.0,1514.0,0,0,0.0,0.0,0.0
36765.0,6,10,2032,5,524,8962.25,252.0,104.8,5,1508,8907.25,1236.0,301.6
135001146.0,17,15,907,8,475,19285878.0,174.0,59.375,7,432,19168590.33333333,174.0,61.71428571428572
298161.0,6,6,412,4,272,99387.0,74.0,68.0,2,140,0.0,74.0,70.0
2864450.0,6,11,2106,6,598,572709.8,252.0,99.66666666666669,5,1508,4278.0,1236.0,301.6
228358.0,17,2,180,1,90,0.0,90.0,90.0,1,90,0.0,90.0,90.0
2945.0,17,2,224,1,76,0.0,76.0,76.0,1,148,0.0,148.0,148.0
117507594.0,6,48,3168,24,1584,5109025.826086956,66.0,66.0,24,1584,5099626.304347826,66.0,66.0
26563.0,6,10,2032,5,524,4061.75,252.0,104.8,5,1508,6467.75,1236.0,301.6
207939.0,6,14,4740,7,653,34268.166666666664,249.0,93.28571428571428,7,4087,33759.166666666664,1514.0,583.8571428571429
98938.0,17,2,762,2,762,0.0,381.0,381.0,0,0,0.0,0.0,0.0
500947.00000000006,6,5,336,2,134,0.0,68.0,67.0,3,202,190346.0,70.0,67.33333333333333
5003892.0,17,4,534,2,166,0.0,83.0,83.0,2,368,0.0,184.0,184.0
153448.0,17,2,180,1,90,0.0,90.0,90.0,1,90,0.0,90.0,90.0
106026.0,17,2,286,2,286,0.0,143.0,143.0,0,0,0.0,0.0,0.0
13609312.0,6,20,1607,10,975,1478652.4444444445,315.0,97.5,10,632,1478628.2222222222,78.0,63.2
1302494.0,6,4,264,2,132,0.0,66.0,66.0,2,132,0.0,66.0,66.0
110992888.0,6,32,2220,16,1149,7399525.866666666,123.0,71.8125,16,1071,7385111.066666666,123.0,66.9375
143871.0,17,2,180,1,90,0.0,90.0,90.0,1,90,0.0,90.0,90.0
206014.0,17,2,180,1,90,0.0,90.0,90.0,1,90,0.0,90.0,90.0
147991.0,17,2,180,1,90,0.0,90.0,90.0,1,90,0.0,90.0,90.0
120122620.0,6,13,2020,9,1204,15015327.5,188.0,133.77777777777777,4,816,30030606.33333333,204.0,204.0
1526.0,17,2,176,1,80,0.0,80.0,80.0,1,96,0.0,96.0,96.0
102849.0,17,2,286,2,286,0.0,143.0,143.0,0,0,0.0,0.0,0.0
40868.0,6,14,4740,7,653,6291.666666666667,249.0,93.28571428571428,7,4087,6340.833333333333,1514.0,583.8571428571429
15396.0,6,14,4740,7,653,2362.1666666666665,249.0,93.28571428571428,7,4087,2376.6666666666665,1514.0,583.8571428571429
43448.0,6,10,2032,5,524,10278.75,252.0,104.8,5,1508,9250.25,1236.0,301.6
2895037.0,6,3,204,2,136,0.0,70.0,68.0,1,68,0.0,68.0,68.0
69378.0,6,14,4740,7,653,11439.333333333334,249.0,93.28571428571428,7,4087,11419.666666666666,1514.0,583.8571428571429
1179743.0,6,13,3005,8,2377,168534.7142857143,1514.0,297.125,5,628,226005.5,331.0,125.6
101194.0,17,2,762,2,762,0.0,381.0,381.0,0,0,0.0,0.0,0.0
121253710.0,6,232,26216,116,7952,1038246.4260869564,140.0,68.55172413793103,116,18264,1047247.0695652174,284.0,157.44827586206895
206773.0,17,2,762,2,762,0.0,381.0,381.0,0,0,0.0,0.0,0.0
71681.0,6,14,4740,7,653,11540.166666666666,249.0,93.28571428571428,7,4087,10185.0,1514.0,583.8571428571429
111817261.0,6,37,2788,19,1471,6200079.888888889,139.0,77.42105263157895,18,1317,6564788.294117647,123.0,73.16666666666667
2062.0,17,4,344,2,150,0.0,75.0,75.0,2,194,0.0,103.0,97.0
54009.0,6,10,2032,5,524,12711.25,252.0,104.8,5,1508,11731.0,1236.0,301.6
153439.0,17,2,180,1,90,0.0,90.0,90.0,1,90,0.0,90.0,90.0
9286.0,17,4,823,2,163,0.0,89.0,81.5,2,660,0.0,443.0,330.0
2387.0,17,4,344,2,150,0.0,75.0,75.0,2,194,0.0,103.0,97.0
43988.0,6,14,4740,7,653,4420.333333333333,249.0,93.28571428571428,7,4087,6773.833333333333,1514.0,583.8571428571429
615927.0,6,4,508,2,238,0.0,172.0,119.0,2,270,0.0,135.0,135.0
103216.0,17,2,286,2,286,0.0,143.0,143.0,0,0,0.0,0.0,0.0
120114451.0,6,273,31426,137,9338,883194.4926470588,140.0,68.16058394160584,136,22088,882129.7851851851,284.0,162.41176470588235
197950.0,17,2,180,1,90,0.0,90.0,90.0,1,90,0.0,90.0,90.0
99322.0,17,2,762,2,762,0.0,381.0,381.0,0,0,0.0,0.0,0.0
101663.0,17,2,286,2,286,0.0,143.0,143.0,0,0,0.0,0.0,0.0
106864.0,17,2,286,2,286,0.0,143.0,143.0,0,0,0.0,0.0,0.0
22913.0,17,2,582,1,83,0.0,83.0,83.0,1,499,0.0,499.0,499.0
103774.0,17,2,286,2,286,0.0,143.0,143.0,0,0,0.0,0.0,0.0
241834.0,6,3,337,2,214,0.0,160.0,107.0,1,123,0.0,123.0,123.0
2923714.0,6,3,1602,1,752,0.0,752.0,752.0,2,850,0.0,784.0,425.0
100760.0,17,2,700,2,700,0.0,350.0,350.0,0,0,0.0,0.0,0.0
2825387.0,6,3,1604,1,753,0.0,753.0,753.0,2,851,0.0,785.0,425.5
24284595.0,6,5,1736,2,819,0.0,753.0,409.5,3,917,12073232.5,785.0,305.6666666666667
333.0,17,2,267,1,83,0.0,83.0,83.0,1,184,0.0,184.0,184.0
27443.0,6,14,4740,7,653,2927.1666666666665,249.0,93.28571428571428,7,4087,4402.5,1514.0,583.8571428571429
209077.0,6,3,426,2,280,0.0,214.0,140.0,1,146,0.0,146.0,146.0
5826842.0,6,5,336,2,134,0.0,68.0,67.0,3,202,1523338.0,70.0,67.33333333333333
142437.0,17,2,192,1,88,0.0,88.0,88.0,1,104,0.0,104.0,104.0
216729.0,6,3,426,2,280,0.0,214.0,140.0,1,146,0.0,146.0,146.0
294244.0,17,2,246,1,76,0.0,76.0,76.0,1,170,0.0,170.0,170.0
91953.0,6,14,4740,7,653,15194.833333333334,249.0,93.28571428571428,7,4087,14577.166666666666,1514.0,583.8571428571429
3771235.0,6,5,336,2,134,0.0,68.0,67.0,3,202,1527336.0,70.0,67.33333333333333
123610545.0,6,49,3234,25,1650,5150439.375,66.0,66.0,24,1584,4949020.434782608,66.0,66.0
1168751.0,6,13,3020,8,2392,166964.42857142858,1514.0,299.0,5,628,223268.0,331.0,125.6
2124999.0,6,23,7479,12,2450,193181.7272727273,1034.0,204.16666666666663,11,5029,181172.7,1510.0,457.1818181818182
309099.0,6,6,412,4,272,103033.0,74.0,68.0,2,140,0.0,74.0,70.0
123001168.0,17,15,1169,8,606,17571595.42857143,174.0,75.75,7,563,17156638.333333332,174.0,80.42857142857143
90017322.0,17,28,13364,28,13364,3333974.888888889,501.0,477.2857142857143,0,0,0.0,0.0,0.0
103498.0,17,2,286,2,286,0.0,143.0,143.0,0,0,0.0,0.0,0.0
2387.0,17,4,344,2,150,0.0,75.0,75.0,2,194,0.0,103.0,97.0
115746307.0,6,48,3168,24,1584,5032448.130434782,66.0,66.0,24,1584,5020600.304347826,66.0,66.0
612868.0,17,2,346,1,78,0.0,78.0,78.0,1,268,0.0,268.0,268.0
2594809.0,6,2,132,1,66,0.0,66.0,66.0,1,66,0.0,66.0,66.0
204573.0,17,2,762,2,762,0.0,381.0,381.0,0,0,0.0,0.0,0.0
120235099.0,6,26,1978,13,989,9999704.333333334,95.0,76.07692307692308,13,989,9999162.166666666,95.0,76.07692307692308
102729.0,17,2,762,2,762,0.0,381.0,381.0,0,0,0.0,0.0,0.0
147988.0,17,2,180,1,90,0.0,90.0,90.0,1,90,0.0,90.0,90.0
90049668.0,17,27,12943,27,12943,3463448.769230769,501.0,479.3703703703704,0,0,0.0,0.0,0.0
736298.0,6,11,1021,6,444,98611.4,162.0,74.0,5,577,123047.0,349.0,115.4
108684557.0,6,32,2220,16,1149,7245637.133333334,123.0,71.8125,16,1071,7231221.533333333,123.0,66.9375
2297.0,17,4,344,2,150,0.0,75.0,75.0,2,194,0.0,103.0,97.0
574.0,17,2,508,2,508,0.0,257.0,254.0,0,0,0.0,0.0,0.0
2835028.0,6,12,2172,7,664,472318.6666666667,252.0,94.85714285714286,5,1508,6056.25,1236.0,301.6
135134534.0,17,6,1146,6,1146,27026906.8,191.0,191.0,0,0,0.0,0.0,0.0
102803.0,17,2,286,2,286,0.0,143.0,143.0,0,0,0.0,0.0,0.0
120023789.0,17,29,13785,29,13785,4286563.892857143,501.0,475.3448275862069,0,0,0.0,0.0,0.0
147346.0,6,3,373,2,238,0.0,172.0,119.0,1,135,0.0,135.0,135.0
334.0,17,2,166,1,75,0.0,75.0,75.0,1,91,0.0,91.0,91.0
228291.0,17,2,180,1,90,0.0,90.0,90.0,1,90,0.0,90.0,90.0
201345.0,6,10,1221,6,636,40269.0,298.0,106.0,4,585,65779.66666666667,379.0,146.25
343223.0,6,3,204,1,68,0.0,68.0,68.0,2,136,0.0,70.0,68.0
119861942.0,6,2481,2130126,1709,2079162,70152.71662763465,1514.0,1216.5956699824458,772,50964,155450.02853437094,78.0,66.01554404145078
103703.0,17,2,762,2,762,0.0,381.0,381.0,0,0,0.0,0.0,0.0
153525.0,17,2,180,1,90,0.0,90.0,90.0,1,90,0.0,90.0,90.0
531753.0,17,6,2100,6,2100,106350.6,350.0,350.0,0,0,0.0,0.0,0.0
4528.0,17,2,626,1,72,0.0,72.0,72.0,1,554,0.0,554.0,554.0
217045.0,6,10,1221,6,636,43409.0,298.0,106.0,4,585,71355.66666666667,379.0,146.25
642.0,17,2,762,2,762,0.0,381.0,381.0,0,0,0.0,0.0,0.0
1307013.0,6,4,264,2,132,0.0,66.0,66.0,2,132,0.0,66.0,66.0
378.0,17,2,160,1,80,0.0,80.0,80.0,1,80,0.0,80.0,80.0
6497.0,17,4,823,2,163,0.0,89.0,81.5,2,660,0.0,443.0,330.0
108103187.0,17,5,1005,5,1005,27025796.75,201.0,201.0,0,0,0.0,0.0,0.0
203363.0,17,2,762,2,762,0.0,381.0,381.0,0,0,0.0,0.0,0.0
103956603.0,6,44,2904,22,1452,4950314.428571428,66.0,66.0,22,1452,4935845.666666667,66.0,66.0
33400.0,6,2,145,2,145,0.0,91.0,72.5,0,0,0.0,0.0,0.0
57318.0,6,10,2032,5,524,11752.25,252.0,104.8,5,1508,14058.5,1236.0,301.6
303044.0,6,6,412,4,272,101014.66666666669,74.0,68.0,2,140,0.0,74.0,70.0
98377.0,6,2,132,1,66,0.0,66.0,66.0,1,66,0.0,66.0,66.0
104968079.0,6,27,1806,14,966,8057910.384615385,123.0,69.0,13,840,8729404.583333334,123.0,64.61538461538461
1086.0,17,2,762,2,762,0.0,381.0,381.0,0,0,0.0,0.0,0.0
9398.0,17,2,539,1,86,0.0,86.0,86.0,1,453,0.0,453.0,453.0
90531812.0,6,13,2036,8,1016,12933116.0,188.0,127.0,5,1020,22591997.25,204.0,204.0
2954.0,17,2,224,1,76,0.0,76.0,76.0,1,148,0.0,148.0,148.0
143864.0,17,2,180,1,90,0.0,90.0,90.0,1,90,0.0,90.0,90.0
216367.0,17,2,180,1,90,0.0,90.0,90.0,1,90,0.0,90.0,90.0
108106515.0,17,5,955,5,955,27026628.75,191.0,191.0,0,0,0.0,0.0,0.0
195938.0,17,6,1230,3,234,97783.5,78.0,78.0,3,996,97764.5,332.0,332.0
317906.0,17,4,1400,4,1400,105968.66666666669,350.0,350.0,0,0,0.0,0.0,0.0
2588590.0,6,2,132,1,66,0.0,66.0,66.0,1,66,0.0,66.0,66.0
197045.0,17,2,180,1,90,0.0,90.0,90.0,1,90,0.0,90.0,90.0
318057.0,6,6,412,4,272,106019.0,74.0,68.0,2,140,0.0,74.0,70.0
153516.0,17,2,180,1,90,0.0,90.0,90.0,1,90,0.0,90.0,90.0
32681710.000000004,6,5,336,2,134,0.0,68.0,67.0,3,202,15052901.5,70.0,67.33333333333333
96865398.0,6,165,18696,83,13062,1181285.3414634147,284.0,157.3734939759036,82,5634,1183147.87654321,140.0,68.70731707317073
34279.0,6,14,4740,7,653,5596.833333333333,249.0,93.28571428571428,7,4087,5575.166666666667,1514.0,583.8571428571429
120070500.0,17,28,13364,28,13364,4447055.555555556,501.0,477.2857142857143,0,0,0.0,0.0,0.0
27627.0,6,14,4740,7,653,4379.166666666667,249.0,93.28571428571428,7,4087,3706.8333333333335,1514.0,583.8571428571429
315894.0,6,6,412,4,272,105298.0,74.0,68.0,2,140,0.0,74.0,70.0
320310.0,6,6,412,4,272,106770.0,74.0,68.0,2,140,0.0,74.0,70.0
36524829.0,6,29,9265,16,3859,173113.33333333334,1514.0,241.1875,13,5406,3026676.9166666665,1514.0,415.84615384615387
9686.0,17,2,582,1,83,0.0,83.0,83.0,1,499,0.0,499.0,499.0
1799149.0,6,4,276,2,128,0.0,74.0,64.0,2,148,0.0,74.0,74.0
290828.0,17,2,180,1,90,0.0,90.0,90.0,1,90,0.0,90.0,90.0
108080243.0,17,5,955,5,955,27020060.75,191.0,191.0,0,0,0.0,0.0,0.0
143947.0,17,2,180,1,90,0.0,90.0,90.0,1,90,0.0,90.0,90.0
326.0,17,2,250,1,93,0.0,93.0,93.0,1,157,0.0,157.0,157.0
120102431.0,6,210,23646,105,7152,1146998.5673076925,140.0,68.11428571428571,105,16494,1147012.7788461538,284.0,157.0857142857143
216340.0,6,3,426,2,280,0.0,214.0,140.0,1,146,0.0,146.0,146.0
104387270.0,6,190,21410,95,14844,1108214.074468085,284.0,156.25263157894736,95,6566,1108213.8829787234,140.0,69.11578947368422
101786.0,17,2,286,2,286,0.0,143.0,143.0,0,0,0.0,0.0,0.0
324.0,17,2,174,1,79,0.0,79.0,79.0,1,95,0.0,95.0,95.0
1669999.0,6,7,499,3,198,818417.0,66.0,66.0,4,301,504485.0,103.0,75.25
123534.0,17,4,1400,4,1400,41178.0,350.0,350.0,0,0,0.0,0.0,0.0
141765.0,6,13,1394,7,797,23627.5,253.0,113.85714285714286,6,597,26736.8,259.0,99.5
120277744.0,6,18,1382,9,691,14999965.25,95.0,76.77777777777777,9,691,15033377.75,95.0,76.77777777777777
380.0,17,2,166,1,75,0.0,75.0,75.0,1,91,0.0,91.0,91.0
90258793.0,6,14,1964,8,1016,12894113.285714284,188.0,127.0,6,948,18011622.2,204.0,158.0
149107109.0,6,25,1883,13,989,9944169.583333334,95.0,76.07692307692308,12,894,13555069.727272728,95.0,74.5
196907.0,17,2,180,1,90,0.0,90.0,90.0,1,90,0.0,90.0,90.0
299977.0,6,6,412,4,272,99992.33333333331,74.0,68.0,2,140,0.0,74.0,70.0
125466905.0,6,31,2097,16,1149,8364460.333333333,123.0,71.8125,15,948,8397298.642857144,123.0,63.2
205897.0,6,3,426,2,280,0.0,214.0,140.0,1,146,0.0,146.0,146.0
209311.0,17,2,180,1,90,0.0,90.0,90.0,1,90,0.0,90.0,90.0
298191.0,6,6,412,4,272,99397.0,74.0,68.0,2,140,0.0,74.0,70.0
284613.0,17,2,363,1,79,0.0,79.0,79.0,1,284,0.0,284.0,284.0
27128.0,6,11,2098,6,590,4857.0,252.0,98.33333333333331,5,1508,6221.25,1236.0,301.6
147797.0,6,3,337,2,214,0.0,160.0,107.0,1,123,0.0,123.0,123.0
311584.0,17,4,1400,4,1400,103861.33333333331,350.0,350.0,0,0,0.0,0.0,0.0
293.0,17,2,174,1,79,0.0,79.0,79.0,1,95,0.0,95.0,95.0
13065.0,6,11,1132,6,556,2228.2,218.0,92.66666666666669,5,576,2969.25,304.0,115.2
299100.0,6,6,412,4,272,99700.0,74.0,68.0,2,140,0.0,74.0,70.0
10439304.0,6,7,478,4,272,3434106.6666666665,74.0,68.0,3,206,5151042.5,74.0,68.66666666666667
205620.0,17,2,180,1,90,0.0,90.0,90.0,1,90,0.0,90.0,90.0
10431326.0,6,6,412,3,206,5146282.0,74.0,68.66666666666667,3,206,5146144.5,74.0,68.66666666666667
2693.0,17,4,344,2,150,0.0,75.0,75.0,2,194,0.0,103.0,97.0
228175.0,17,2,180,1,90,0.0,90.0,90.0,1,90,0.0,90.0,90.0
11598.0,6,11,1132,6,556,2319.6,218.0,92.66666666666669,5,576,2235.25,304.0,115.2
103301.0,17,2,700,2,700,0.0,350.0,350.0,0,0,0.0,0.0,0.0
120067421.0,17,28,13364,28,13364,4446941.518518519,501.0,477.2857142857143,0,0,0.0,0.0,0.0
100030207.0,6,19,1674,9,650,12503775.875,95.0,72.22222222222223,10,1024,11090694.0,337.0,102.4
19931.0,17,2,582,1,83,0.0,83.0,83.0,1,499,0.0,499.0,499.0
220677.0,6,3,426,2,280,0.0,214.0,140.0,1,146,0.0,146.0,146.0
103679.0,17,2,286,2,286,0.0,143.0,143.0,0,0,0.0,0.0,0.0
27368526.0,17,5,1710,5,1710,6842131.5,342.0,342.0,0,0,0.0,0.0,0.0
5582.0,17,2,239,1,82,0.0,82.0,82.0,1,157,0.0,157.0,157.0
281.0,17,2,156,1,78,0.0,78.0,78.0,1,78,0.0,78.0,78.0
90280766.0,6,14,1043,7,542,15046794.333333334,95.0,77.42857142857143,7,501,14998014.166666666,95.0,71.57142857142857
6395.0,17,2,508,2,508,0.0,257.0,254.0,0,0,0.0,0.0,0.0
396.0,17,2,508,2,508,0.0,257.0,254.0,0,0,0.0,0.0,0.0
121390.0,6,3,337,2,214,0.0,160.0,107.0,1,123,0.0,123.0,123.0
305.0,17,2,164,1,82,0.0,82.0,82.0,1,82,0.0,82.0,82.0
501830.0,6,5,336,2,134,0.0,68.0,67.0,3,202,194327.5,70.0,67.33333333333333
2377429.0,6,48,23662,25,19797,99059.54166666669,1514.0,791.88,23,3865,97902.27272727272,1514.0,168.04347826086956
5629457.0,6,5,336,2,134,0.0,68.0,67.0,3,202,1423451.0,70.0,67.33333333333333
205785.0,17,2,180,1,90,0.0,90.0,90.0,1,90,0.0,90.0,90.0
12115.0,6,10,1066,5,490,2859.25,218.0,98.0,5,576,2425.0,304.0,115.2
11610.0,6,10,2032,5,524,2680.5,252.0,104.8,5,1508,2659.5,1236.0,301.6
1424838.0,6,4,276,2,128,0.0,74.0,64.0,2,148,0.0,74.0,74.0
120124601.0,6,14,2240,6,1224,24024920.2,204.0,204.0,8,1016,17137472.42857143,188.0,127.0
118665212.0,6,31,2097,16,1149,7911014.133333334,123.0,71.8125,15,948,7911414.642857143,123.0,63.2
101528.0,17,2,700,2,700,0.0,350.0,350.0,0,0,0.0,0.0,0.0
19157.0,6,11,1133,6,602,2893.4,264.0,100.33333333333331,5,531,4075.0,259.0,106.2
120043650.0,6,19,1395,10,745,13332822.888888888,95.0,74.5,9,650,14998993.25,95.0,72.22222222222223
179929.0,17,4,1400,4,1400,59976.333333333336,350.0,350.0,0,0,0.0,0.0,0.0
2802031.0,6,2,132,1,66,0.0,66.0,66.0,1,66,0.0,66.0,66.0
118923148.0,6,34,2334,17,1209,7432696.75,123.0,71.11764705882354,17,1125,7419179.25,123.0,66.17647058823529
120123369.0,6,14,2224,9,1204,15015421.125,188.0,133.77777777777777,5,1020,22523305.25,204.0,204.0
135136252.0,17,6,1146,6,1146,27027250.4,191.0,191.0,0,0,0.0,0.0,0.0
143912.0,17,2,180,1,90,0.0,90.0,90.0,1,90,0.0,90.0,90.0
120538204.0,6,233,26388,117,18510,1039122.448275862,284.0,158.2051282051282,116,7878,1039253.8173913044,140.0,67.91379310344827
241080.0,6,3,337,2,214,0.0,160.0,107.0,1,123,0.0,123.0,123.0
31454.000000000004,6,14,4740,7,653,4507.166666666667,249.0,93.28571428571428,7,4087,4852.333333333333,1514.0,583.8571428571429
247165.0,17,2,180,1,90,0.0,90.0,90.0,1,90,0.0,90.0,90.0
108112133.0,17,5,955,5,955,27028033.25,191.0,191.0,0,0,0.0,0.0,0.0
2562090.0,6,2,132,1,66,0.0,66.0,66.0,1,66,0.0,66.0,66.0
103088.0,17,2,286,2,286,0.0,143.0,143.0,0,0,0.0,0.0,0.0
3005774.0,6,11,2106,6,598,600976.2,252.0,99.66666666666669,5,1508,1847.25,1236.0,301.6
143856.0,17,2,180,1,90,0.0,90.0,90.0,1,90,0.0,90.0,90.0
2699294.0,6,3,1604,1,753,0.0,753.0,753.0,2,851,0.0,785.0,425.5
2022413.0,17,4,525,2,150,0.0,75.0,75.0,2,375,0.0,284.0,187.5
124043.0,6,14,4740,7,653,20540.83333333333,249.0,93.28571428571428,7,4087,17372.0,1514.0,583.8571428571429
113705690.0,17,16,1212,8,606,16220969.57142857,174.0,75.75,8,606,16140392.857142856,174.0,75.75
90061344.0,17,27,12943,27,12943,3463897.846153846,501.0,479.3703703703704,0,0,0.0,0.0,0.0
309465.0,6,3,202,2,128,0.0,74.0,64.0,1,74,0.0,74.0,74.0
2612260.0,6,25,7573,14,3735,200943.0769230769,1514.0,266.7857142857143,11,3838,234175.2,1514.0,348.90909090909093
90257916.0,6,13,2036,8,1016,12893988.0,188.0,127.0,5,1020,22523296.5,204.0,204.0
121568979.0,6,35,2680,16,1209,7438781.533333333,123.0,75.5625,19,1471,6198989.388888889,139.0,77.42105263157895
216388.0,17,2,180,1,90,0.0,90.0,90.0,1,90,0.0,90.0,90.0
311952.0,17,4,1400,4,1400,103984.0,350.0,350.0,0,0,0.0,0.0,0.0
90175114.0,17,12,778,6,389,18000218.8,174.0,64.83333333333333,6,389,18000930.6,174.0,64.83333333333333
224563.0,6,11,1132,6,556,44619.2,218.0,92.66666666666669,5,576,55931.5,304.0,115.2
136359.0,6,2,132,1,66,0.0,66.0,66.0,1,66,0.0,66.0,66.0
2119.0,17,4,344,2,150,0.0,75.0,75.0,2,194,0.0,103.0,97.0
118063376.0,6,31,2166,16,1149,7870891.733333333,123.0,71.8125,15,1017,8417487.57142857,123.0,67.8
317.0,17,2,174,1,79,0.0,79.0,79.0,1,95,0.0,95.0,95.0
120055320.0,17,29,13785,29,13785,4287690.0,501.0,475.3448275862069,0,0,0.0,0.0,0.0
143879.0,17,2,180,1,90,0.0,90.0,90.0,1,90,0.0,90.0,90.0
204926.0,17,2,762,2,762,0.0,381.0,381.0,0,0,0.0,0.0,0.0
205605.0,17,2,762,2,762,0.0,381.0,381.0,0,0,0.0,0.0,0.0
135122137.0,17,6,1146,6,1146,27024427.4,191.0,191.0,0,0,0.0,0.0,0.0
1734.0,17,2,664,1,322,0.0,322.0,322.0,1,342,0.0,342.0,342.0
146340.0,6,3,337,2,214,0.0,160.0,107.0,1,123,0.0,123.0,123.0
117312477.0,6,219,24870,110,17380,1076261.256880734,284.0,158.0,109,7490,1076572.1203703703,140.0,68.71559633027523
3208.0,17,2,224,1,76,0.0,76.0,76.0,1,148,0.0,148.0,148.0
316089.0,6,5,337,2,163,0.0,97.0,81.5,3,174,158044.5,66.0,58.0
323234.0,17,4,1400,4,1400,107744.66666666669,350.0,350.0,0,0,0.0,0.0,0.0
10458832.0,6,7,478,4,272,3439366.0,74.0,68.0,3,206,5158959.0,74.0,68.66666666666667
120315115.0,6,38,2848,20,1531,6332374.47368421,139.0,76.55,18,1317,6477293.470588235,123.0,73.16666666666667
27381.0,6,14,4740,7,653,3844.8333333333335,249.0,93.28571428571428,7,4087,4367.5,1514.0,583.8571428571429
90310265.0,6,16,1192,8,596,12893541.285714284,95.0,74.5,8,596,12899484.57142857,95.0,74.5
56519.0,6,13,1479,7,882,9326.0,291.0,126.0,6,597,10490.8,259.0,99.5
108107462.0,17,5,1005,5,1005,27026865.5,201.0,201.0,0,0,0.0,0.0,0.0
101145426.0,6,32,2236,16,1165,6728639.266666667,139.0,72.8125,16,1071,6728632.6,123.0,66.9375
303284.0,6,6,412,4,272,101094.66666666669,74.0,68.0,2,140,0.0,74.0,70.0
256268.0,6,3,337,2,214,0.0,160.0,107.0,1,123,0.0,123.0,123.0
125868781.0,6,71,14292,35,7494,3153841.382352941,1514.0,214.11428571428573,36,6798,3590075.0,1514.0,188.8333333333333
43003.0,6,14,4740,7,653,6999.166666666667,249.0,93.28571428571428,7,4087,6843.666666666667,1514.0,583.8571428571429
838.0,17,5,550,5,550,209.5,110.0,110.0,0,0,0.0,0.0,0.0
1056954.0,6,13,1386,7,789,176159.0,253.0,112.71428571428572,6,597,209236.4,259.0,99.5
51616.0,6,14,4740,7,653,8351.5,249.0,93.28571428571428,7,4087,6690.666666666667,1514.0,583.8571428571429
30520.0,6,14,4740,7,653,4963.5,249.0,93.28571428571428,7,4087,4948.833333333333,1514.0,583.8571428571429
637.0,17,5,550,5,550,159.25,110.0,110.0,0,0,0.0,0.0,0.0
120205137.0,6,244,27728,122,8348,986648.6611570248,140.0,68.42622950819673,122,19380,983973.73553719,374.0,158.85245901639345
2976802.0,6,11,2106,6,598,595193.8,252.0,99.66666666666669,5,1508,1618.0,1236.0,301.6
90257827.0,6,14,2240,8,1016,12893975.285714284,188.0,127.0,6,1224,18018561.4,204.0,204.0
135133021.0,17,6,1206,6,1206,27026604.2,201.0,201.0,0,0,0.0,0.0,0.0
219156.0,6,3,426,2,280,0.0,214.0,140.0,1,146,0.0,146.0,146.0
119942.0,17,2,180,1,70,0.0,70.0,70.0,1,110,0.0,110.0,110.0
108259422.0,6,44,2904,22,1452,5155210.571428572,66.0,66.0,22,1452,5139374.333333333,66.0,66.0
55466.0,6,14,4740,7,653,9126.5,249.0,93.28571428571428,7,4087,8170.166666666667,1514.0,583.8571428571429
121142.0,6,3,337,2,214,0.0,160.0,107.0,1,123,0.0,123.0,123.0
353.0,17,2,160,1,80,0.0,80.0,80.0,1,80,0.0,80.0,80.0
273669.0,17,2,180,1,90,0.0,90.0,90.0,1,90,0.0,90.0,90.0
201739.0,17,2,180,1,90,0.0,90.0,90.0,1,90,0.0,90.0,90.0
2803581.0,6,2,132,1,66,0.0,66.0,66.0,1,66,0.0,66.0,66.0
3127542.0,6,3,1604,2,851,0.0,785.0,425.5,1,753,0.0,753.0,753.0
205873.0,6,3,426,2,280,0.0,214.0,140.0,1,146,0.0,146.0,146.0
119964.0,17,2,180,1,70,0.0,70.0,70.0,1,110,0.0,110.0,110.0
0.0,6,1,66,1,66,0.0,66.0,66.0,0,0,0.0,0.0,0.0
410.0,17,2,410,1,78,0.0,78.0,78.0,1,332,0.0,332.0,332.0
207804.0,6,3,426,2,280,0.0,214.0,140.0,1,146,0.0,146.0,146.0
134575714.0,17,16,1212,8,606,16382838.142857144,174.0,75.75,8,606,18114210.285714287,174.0,75.75
323446.0,6,6,412,4,272,107815.33333333331,74.0,68.0,2,140,0.0,74.0,70.0
119415699.0,6,201,22816,101,6974,1194156.99,140.0,69.04950495049505,100,15842,1195757.0707070706,284.0,158.42
10654.0,6,10,2032,5,524,2209.25,252.0,104.8,5,1508,2378.0,1236.0,301.6
135131996.0,17,6,1146,6,1146,27026399.2,191.0,191.0,0,0,0.0,0.0,0.0
48775.0,6,10,2032,5,524,11925.5,252.0,104.8,5,1508,10968.5,1236.0,301.6
92938954.0,6,173,19686,87,13776,1080685.511627907,284.0,158.3448275862069,86,5910,1081192.988235294,140.0,68.72093023255815
112261.0,17,2,286,2,286,0.0,143.0,143.0,0,0,0.0,0.0,0.0
206094.0,6,3,426,2,280,0.0,214.0,140.0,1,146,0.0,146.0,146.0
94719065.0,6,688,141330,348,118298,272965.60518731986,1514.0,339.9367816091954,340,23032,278711.01474926254,214.0,67.74117647058823
205839.0,17,2,180,1,90,0.0,90.0,90.0,1,90,0.0,90.0,90.0
113207566.0,17,14,864,7,432,18834090.5,174.0,61.71428571428572,7,432,18833502.33333333,174.0,61.71428571428572
120124681.0,6,13,2020,9,1204,15015585.125,188.0,133.77777777777777,4,816,30034957.33333333,204.0,204.0
14773.0,17,2,180,1,90,0.0,90.0,90.0,1,90,0.0,90.0,90.0
111074.0,6,10,1066,5,490,26470.0,218.0,98.0,5,576,27564.0,304.0,115.2
2801421.0,6,2,132,1,66,0.0,66.0,66.0,1,66,0.0,66.0,66.0
147988.0,17,2,180,1,90,0.0,90.0,90.0,1,90,0.0,90.0,90.0
246962.0,17,2,180,1,90,0.0,90.0,90.0,1,90,0.0,90.0,90.0
228240.0,17,2,180,1,90,0.0,90.0,90.0,1,90,0.0,90.0,90.0
77606.0,6,14,4740,7,653,12453.833333333334,249.0,93.28571428571428,7,4087,12717.5,1514.0,583.8571428571429
209696.0,6,10,1221,6,636,41939.2,298.0,106.0,4,585,69033.66666666667,379.0,146.25
300157.0,6,6,412,4,272,100052.33333333331,74.0,68.0,2,140,0.0,74.0,70.0
115423.0,17,4,1400,4,1400,38474.333333333336,350.0,350.0,0,0,0.0,0.0,0.0
144052.0,17,2,180,1,90,0.0,90.0,90.0,1,90,0.0,90.0,90.0
120118609.0,6,13,2020,9,1204,15014826.125,188.0,133.77777777777777,4,816,30026433.33333333,204.0,204.0
40360.0,6,14,4740,7,653,5957.0,249.0,93.28571428571428,7,4087,5983.833333333333,1514.0,583.8571428571429
108107417.0,17,5,955,5,955,27026854.25,191.0,191.0,0,0,0.0,0.0,0.0
22296.0,6,14,4740,7,653,3528.5,249.0,93.28571428571428,7,4087,3578.0,1514.0,583.8571428571429
53185.0,6,14,4740,7,653,8624.666666666666,249.0,93.28571428571428,7,4087,8693.333333333334,1514.0,583.8571428571429
1356024.0,17,16,1120,16,1120,90401.6,70.0,70.0,0,0,0.0,0.0,0.0
3016414.0,6,3,1604,2,851,0.0,785.0,425.5,1,753,0.0,753.0,753.0
104194276.0,17,14,864,7,432,17333499.833333332,174.0,61.71428571428572,7,432,17334149.333333332,174.0,61.71428571428572
1124036.0,6,13,1386,7,789,187339.3333333333,253.0,112.71428571428572,6,597,222538.6,259.0,99.5
54256.0,6,14,4740,7,653,7561.666666666667,249.0,93.28571428571428,7,4087,8832.333333333334,1514.0,583.8571428571429
156567.0,6,3,337,2,214,0.0,160.0,107.0,1,123,0.0,123.0,123.0
67567.0,6,10,2032,5,524,15834.0,252.0,104.8,5,1508,10897.0,1236.0,301.6
115834639.0,6,48,3168,24,1584,5036288.652173913,66.0,66.0,24,1584,5023078.043478261,66.0,66.0
217750.0,6,3,426,2,280,0.0,214.0,140.0,1,146,0.0,146.0,146.0
318029.0,17,4,1400,4,1400,106009.66666666669,350.0,350.0,0,0,0.0,0.0,0.0
120031264.0,17,29,13785,29,13785,4286830.857142857,501.0,475.3448275862069,0,0,0.0,0.0,0.0
171711.0,17,2,180,1,90,0.0,90.0,90.0,1,90,0.0,90.0,90.0
29198.0,6,14,4740,7,653,4697.0,249.0,93.28571428571428,7,4087,4485.166666666667,1514.0,583.8571428571429
120069797.0,6,236,26532,118,8084,1019149.4017094016,140.0,68.50847457627118,118,18448,993501.4188034188,284.0,156.33898305084745
123839715.0,6,48,3168,24,1584,4979645.956521739,66.0,66.0,24,1584,5317755.826086956,66.0,66.0
1104982.0,6,13,1394,7,797,184163.66666666663,253.0,113.85714285714286,6,597,217242.6,259.0,99.5
90283278.0,6,19,1436,10,745,10026819.666666666,95.0,74.5,9,691,11284180.0,95.0,76.77777777777777
26814.0,6,14,4740,7,653,4345.166666666667,249.0,93.28571428571428,7,4087,4042.0,1514.0,583.8571428571429
10513144.0,6,7,478,4,272,3459126.333333333,74.0,68.0,3,206,5188651.0,74.0,68.66666666666667
153478.0,17,2,180,1,90,0.0,90.0,90.0,1,90,0.0,90.0,90.0
233056.0,6,3,337,2,214,0.0,160.0,107.0,1,123,0.0,123.0,123.0
46740.0,6,11,2098,6,590,9062.8,252.0,98.33333333333331,5,1508,11456.75,1236.0,301.6
8078.0,6,10,2032,5,524,1558.75,252.0,104.8,5,1508,1706.25,1236.0,301.6
90022880.0,17,28,13364,28,13364,3334180.7407407407,501.0,477.2857142857143,0,0,0.0,0.0,0.0
136918.0,6,2,132,1,66,0.0,66.0,66.0,1,66,0.0,66.0,66.0
46614.0,6,10,2032,5,524,10971.75,252.0,104.8,5,1508,8754.25,1236.0,301.6
285203.0,17,4,571,2,148,0.0,74.0,74.0,2,423,0.0,280.0,211.5
100289.0,17,4,1400,4,1400,33429.666666666664,350.0,350.0,0,0,0.0,0.0,0.0
299157.0,6,6,412,4,272,99719.0,74.0,68.0,2,140,0.0,74.0,70.0
111490.0,17,2,286,2,286,0.0,143.0,143.0,0,0,0.0,0.0,0.0
122348.0,6,3,373,2,238,0.0,172.0,119.0,1,135,0.0,135.0,135.0
108101885.0,17,5,1005,5,1005,27025471.25,201.0,201.0,0,0,0.0,0.0,0.0
11546.0,6,11,1132,6,556,1756.0,218.0,92.66666666666669,5,576,2685.0,304.0,115.2
107913.0,17,2,286,2,286,0.0,143.0,143.0,0,0,0.0,0.0,0.0
302347.0,6,6,412,4,272,100782.33333333331,74.0,68.0,2,140,0.0,74.0,70.0
11043968.0,6,8,544,4,272,3635822.0,74.0,68.0,4,272,3635728.3333333335,74.0,68.0
135129536.0,17,6,1146,6,1146,27025907.2,191.0,191.0,0,0,0.0,0.0,0.0
26934.0,6,14,4740,7,653,3909.5,249.0,93.28571428571428,7,4087,4355.0,1514.0,583.8571428571429
90040224.0,17,28,13364,28,13364,3334823.111111111,501.0,477.2857142857143,0,0,0.0,0.0,0.0
90086401.0,17,27,12943,27,12943,3464861.576923077,501.0,479.3703703703704,0,0,0.0,0.0,0.0
82.0,17,2,762,2,762,0.0,381.0,381.0,0,0,0.0,0.0,0.0
207422.0,6,3,426,2,280,0.0,214.0,140.0,1,146,0.0,146.0,146.0
30469.0,6,14,4740,7,653,4076.1666666666665,249.0,93.28571428571428,7,4087,4944.666666666667,1514.0,583.8571428571429
16888.0,17,2,180,1,90,0.0,90.0,90.0,1,90,0.0,90.0,90.0
27172.0,6,10,2032,5,524,6487.25,252.0,104.8,5,1508,2701.25,1236.0,301.6
242317.0,6,3,337,2,214,0.0,160.0,107.0,1,123,0.0,123.0,123.0
42999.0,6,14,4740,7,653,6356.0,249.0,93.28571428571428,7,4087,6805.833333333333,1514.0,583.8571428571429
216614.0,17,2,180,1,90,0.0,90.0,90.0,1,90,0.0,90.0,90.0
40191.0,6,10,2032,5,524,9116.0,252.0,104.8,5,1508,9573.75,1236.0,301.6
120489776.0,6,227,25578,114,17824,1066281.203539823,284.0,156.35087719298247,113,7754,1066657.3214285714,140.0,68.61946902654867
153366.0,17,2,180,1,90,0.0,90.0,90.0,1,90,0.0,90.0,90.0
196920.0,17,2,180,1,90,0.0,90.0,90.0,1,90,0.0,90.0,90.0
125022004.0,6,32,2157,16,1071,7668980.266666667,123.0,66.9375,16,1086,8334653.866666666,123.0,67.875
120031718.0,17,29,13785,29,13785,4286847.071428572,501.0,475.3448275862069,0,0,0.0,0.0,0.0
3058947.0,6,3,1777,2,951,0.0,885.0,475.5,1,826,0.0,826.0,826.0
4005.0,17,4,344,2,150,0.0,75.0,75.0,2,194,0.0,103.0,97.0
103117131.0,6,44,2904,22,1452,4910339.571428572,66.0,66.0,22,1452,4900047.619047619,66.0,66.0
297583.0,6,6,412,4,272,99194.33333333331,74.0,68.0,2,140,0.0,74.0,70.0
1031290.0,6,11,1134,6,558,206258.00000000003,220.0,93.0,5,576,256848.5,304.0,115.2
197677.0,17,2,180,1,90,0.0,90.0,90.0,1,90,0.0,90.0,90.0
121234.0,6,3,337,2,214,0.0,160.0,107.0,1,123,0.0,123.0,123.0
90042184.0,17,28,13364,28,13364,3334895.703703704,501.0,477.2857142857143,0,0,0.0,0.0,0.0
2589796.0,6,2,132,1,66,0.0,66.0,66.0,1,66,0.0,66.0,66.0
245467.0,6,3,337,2,214,0.0,160.0,107.0,1,123,0.0,123.0,123.0
171664.0,17,2,180,1,90,0.0,90.0,90.0,1,90,0.0,90.0,90.0
2591985.0,6,2,132,1,66,0.0,66.0,66.0,1,66,0.0,66.0,66.0
147928.0,17,2,180,1,90,0.0,90.0,90.0,1,90,0.0,90.0,90.0
27308932.0,17,5,1710,5,1710,6827233.0,342.0,342.0,0,0,0.0,0.0,0.0
90258435.0,6,13,2036,8,1016,12894062.142857144,188.0,127.0,5,1020,22523504.25,204.0,204.0
247036.0,17,2,180,1,90,0.0,90.0,90.0,1,90,0.0,90.0,90.0
108104581.0,17,5,955,5,955,27026145.25,191.0,191.0,0,0,0.0,0.0,0.0
308.0,17,2,168,1,76,0.0,76.0,76.0,1,92,0.0,92.0,92.0
370229.0,6,3,1604,1,753,0.0,753.0,753.0,2,851,0.0,785.0,425.5
0.0,17,1,55,1,55,0.0,55.0,55.0,0,0,0.0,0.0,0.0
40626.0,6,10,2032,5,524,9670.0,252.0,104.8,5,1508,9633.5,1236.0,301.6
153714.0,17,2,180,1,90,0.0,90.0,90.0,1,90,0.0,90.0,90.0
224575.0,6,3,426,2,280,0.0,214.0,140.0,1,146,0.0,146.0,146.0
135127154.0,17,6,1206,6,1206,27025430.8,201.0,201.0,0,0,0.0,0.0,0.0
1026722.0,6,11,1134,6,558,205344.4,220.0,93.0,5,576,255807.0,304.0,115.2
216403.0,17,2,180,1,90,0.0,90.0,90.0,1,90,0.0,90.0,90.0
857369.0,6,9,1096,6,625,171473.8,287.0,104.16666666666669,3,471,290868.0,331.0,157.0
119602321.0,6,23,1734,11,840,11960232.1,95.0,76.36363636363636,12,894,10850209.818181818,95.0,74.5
18504.0,6,11,1132,6,556,3572.0,218.0,92.66666666666669,5,576,2931.75,304.0,115.2
90527129.0,6,13,2036,8,1016,12932447.0,188.0,127.0,5,1020,22591197.0,204.0,204.0
245493.0,6,3,337,2,214,0.0,160.0,107.0,1,123,0.0,123.0,123.0
908.0,17,4,438,2,148,0.0,74.0,74.0,2,290,0.0,147.0,145.0
204295.0,17,2,762,2,762,0.0,381.0,381.0,0,0,0.0,0.0,0.0
92797700.0,6,37,2442,19,1254,5155427.777777778,66.0,66.0,18,1188,5316750.529411765,66.0,66.0
38348.0,6,14,4740,7,653,5969.666666666667,249.0,93.28571428571428,7,4087,6179.333333333333,1514.0,583.8571428571429
135948.0,6,2,132,1,66,0.0,66.0,66.0,1,66,0.0,66.0,66.0
9000153.0,17,4,300,4,300,3000051.0,75.0,75.0,0,0,0.0,0.0,0.0
103390.0,17,2,286,2,286,0.0,143.0,143.0,0,0,0.0,0.0,0.0
47220.0,6,14,4740,7,653,7669.833333333333,249.0,93.28571428571428,7,4087,7268.666666666667,1514.0,583.8571428571429
319256.0,17,4,1400,4,1400,106418.66666666669,350.0,350.0,0,0,0.0,0.0,0.0
97380805.0,6,66,12857,33,6725,3043150.15625,1514.0,203.7878787878788,33,6132,3034924.59375,1514.0,185.8181818181818
106688697.0,6,28,1876,14,982,8190224.923076923,139.0,70.14285714285714,14,894,8190225.538461538,123.0,63.85714285714285
205811.0,17,2,180,1,90,0.0,90.0,90.0,1,90,0.0,90.0,90.0
31938.0,6,14,4740,7,653,4661.666666666667,249.0,93.28571428571428,7,4087,5191.166666666667,1514.0,583.8571428571429
10533909.0,6,7,478,4,272,3466122.0,74.0,68.0,3,206,5199029.0,74.0,68.66666666666667
105188327.0,17,14,1126,7,563,17524849.833333332,174.0,80.42857142857143,7,563,17504895.5,174.0,80.42857142857143
210318.0,6,3,426,2,280,0.0,214.0,140.0,1,146,0.0,146.0,146.0
487449.0,6,3,204,1,68,0.0,68.0,68.0,2,136,0.0,70.0,68.0
108104956.0,17,5,955,5,955,27026239.0,191.0,191.0,0,0,0.0,0.0,0.0
19852.0,17,2,582,1,83,0.0,83.0,83.0,1,499,0.0,499.0,499.0
122000389.0,17,15,1300,8,737,17428627.0,174.0,92.125,7,563,19497860.83333333,174.0,80.42857142857143
121311.0,6,3,337,2,214,0.0,160.0,107.0,1,123,0.0,123.0,123.0
2136615.0,6,20,6935,11,1567,213661.5,408.0,142.45454545454547,9,5368,223982.5,1514.0,596.4444444444445
914583.0,6,12,2715,7,743,152430.5,339.0,106.14285714285714,5,1972,158776.5,1514.0,394.4
311235.0,17,4,1400,4,1400,103745.0,350.0,350.0,0,0,0.0,0.0,0.0
113746828.0,6,37,2656,19,1408,6307267.444444444,139.0,74.10526315789474,18,1248,6678284.588235294,123.0,69.33333333333333
814.0,17,4,438,2,148,0.0,74.0,74.0,2,290,0.0,147.0,145.0
246708.0,6,3,337,2,214,0.0,160.0,107.0,1,123,0.0,123.0,123.0
169068.0,17,2,414,1,88,0.0,88.0,88.0,1,326,0.0,326.0,326.0
30635344.0,6,5,336,2,134,0.0,68.0,67.0,3,202,15248267.5,70.0,67.33333333333333
204924.0,17,2,180,1,90,0.0,90.0,90.0,1,90,0.0,90.0,90.0
446709.0,6,4,508,2,238,0.0,172.0,119.0,2,270,0.0,135.0,135.0
167323.0,17,4,704,2,148,0.0,74.0,74.0,2,556,0.0,280.0,278.0
34195.0,6,14,4740,7,653,4256.0,249.0,93.28571428571428,7,4087,5482.5,1514.0,583.8571428571429
113782403.0,6,48,3168,24,1584,4947061.0,66.0,66.0,24,1584,4935646.043478261,66.0,66.0
41002.0,6,14,4740,7,653,6686.333333333333,249.0,93.28571428571428,7,4087,6623.666666666667,1514.0,583.8571428571429
253703.0,6,10,1221,6,636,50740.6,298.0,106.0,4,585,79178.66666666667,379.0,146.25
17321.0,6,14,4740,7,653,2776.833333333333,249.0,93.28571428571428,7,4087,2397.833333333333,1514.0,583.8571428571429
2335.0,17,4,344,2,150,0.0,75.0,75.0,2,194,0.0,103.0,97.0
15388.0,17,2,180,1,90,0.0,90.0,90.0,1,90,0.0,90.0,90.0
35223.0,6,14,4740,7,653,5642.166666666667,249.0,93.28571428571428,7,4087,4571.666666666667,1514.0,583.8571428571429
10526184.0,6,7,478,4,272,3463388.0,74.0,68.0,3,206,5194991.5,74.0,68.66666666666667
207337.0,6,3,426,2,280,0.0,214.0,140.0,1,146,0.0,146.0,146.0
315697.0,17,4,1400,4,1400,105232.33333333331,350.0,350.0,0,0,0.0,0.0,0.0
119793724.0,6,32,2220,16,1071,7986248.266666667,123.0,66.9375,16,1149,7306235.533333333,123.0,71.8125
133641106.0,17,16,1212,8,606,16172482.42857143,174.0,75.75,8,606,18474954.71428572,174.0,75.75
126500085.0,6,34,2334,17,1125,7282158.25,123.0,66.17647058823529,17,1209,7282149.9375,123.0,71.11764705882354
97748751.0,6,40,2640,20,1320,5144671.105263158,66.0,66.0,20,1320,5128122.947368421,66.0,66.0
122314525.0,6,48,3168,24,1584,5079092.521739131,66.0,66.0,24,1584,5128656.521739131,66.0,66.0
209452.0,17,2,180,1,90,0.0,90.0,90.0,1,90,0.0,90.0,90.0
208019.0,6,3,426,2,280,0.0,214.0,140.0,1,146,0.0,146.0,146.0
828351.0,6,9,1118,6,586,165670.2,248.0,97.66666666666669,3,532,277888.5,392.0,177.33333333333334
54886.0,6,10,2032,5,524,11812.5,252.0,104.8,5,1508,13184.25,1236.0,301.6
146125.0,6,3,337,2,214,0.0,160.0,107.0,1,123,0.0,123.0,123.0
135130013.0,17,6,1146,6,1146,27026002.6,191.0,191.0,0,0,0.0,0.0,0.0
118049276.0,6,47,3102,24,1584,5119166.695652174,66.0,66.0,23,1518,5150442.363636363,66.0,66.0
50138.0,6,14,4740,7,653,8184.333333333333,249.0,93.28571428571428,7,4087,7255.0,1514.0,583.8571428571429
90266002.0,6,12,1832,8,1016,12895143.142857144,188.0,127.0,4,816,30034212.33333333,204.0,204.0
317503.0,6,6,412,4,272,105834.33333333331,74.0,68.0,2,140,0.0,74.0,70.0
4141.0,17,2,598,1,72,0.0,72.0,72.0,1,526,0.0,526.0,526.0
46586784.0,6,8,2113,3,960,22346090.0,826.0,320.0,5,1153,10951354.75,885.0,230.6
44007.0,6,14,4740,7,653,7189.0,249.0,93.28571428571428,7,4087,6051.333333333333,1514.0,583.8571428571429
41050.0,6,14,4740,7,653,6731.5,249.0,93.28571428571428,7,4087,6658.166666666667,1514.0,583.8571428571429
4316.0,17,2,614,1,72,0.0,72.0,72.0,1,542,0.0,542.0,542.0
90258800.0,6,12,1832,8,1016,12894114.285714284,188.0,127.0,4,816,30030582.0,204.0,204.0
205962.0,17,2,180,1,90,0.0,90.0,90.0,1,90,0.0,90.0,90.0
51861.0,6,10,2032,5,524,12716.25,252.0,104.8,5,1508,12158.75,1236.0,301.6
120032528.0,17,28,13364,28,13364,4445649.185185186,501.0,477.2857142857143,0,0,0.0,0.0,0.0
28626.0,6,10,2032,5,524,6941.0,252.0,104.8,5,1508,6018.25,1236.0,301.6
2805536.0,6,2,132,1,66,0.0,66.0,66.0,1,66,0.0,66.0,66.0
90020645.0,17,27,12943,27,12943,3462332.5,501.0,479.3703703703704,0,0,0.0,0.0,0.0
101490.0,17,2,762,2,762,0.0,381.0,381.0,0,0,0.0,0.0,0.0
298360.0,6,6,412,4,272,99453.33333333331,74.0,68.0,2,140,0.0,74.0,70.0
2309.0,17,4,344,2,150,0.0,75.0,75.0,2,194,0.0,103.0,97.0
90259215.0,6,13,2036,8,1016,12894173.57142857,188.0,127.0,5,1020,22523210.75,204.0,204.0
128606538.0,6,36,2596,18,1248,6977767.647058823,123.0,69.33333333333333,18,1348,6977770.117647059,139.0,74.88888888888889
143973.0,17,2,180,1,90,0.0,90.0,90.0,1,90,0.0,90.0,90.0
66023162.0,6,8,1307,8,1307,9431880.285714284,172.0,163.375,0,0,0.0,0.0,0.0
94975045.0,6,203,23322,102,6954,940346.9801980198,140.0,68.17647058823529,101,16368,939365.75,300.0,162.05940594059405
505808.00000000006,6,5,336,2,134,0.0,68.0,67.0,3,202,194496.0,70.0,67.33333333333333
1171157.0,6,11,1134,6,558,234231.4,220.0,93.0,5,576,291870.75,304.0,115.2
1950698.0,6,24,6999,13,2047,162558.16666666666,575.0,157.46153846153845,11,4952,165121.2,1510.0,450.1818181818182
90248978.0,6,14,2240,8,1016,12892711.142857144,188.0,127.0,6,1224,18017406.8,204.0,204.0
121966588.0,17,14,864,7,432,17001734.166666668,174.0,61.71428571428572,7,432,17000162.5,174.0,61.71428571428572
229215.0,17,4,820,2,156,0.0,78.0,78.0,2,664,0.0,332.0,332.0
247078.0,17,2,180,1,90,0.0,90.0,90.0,1,90,0.0,90.0,90.0
90045954.0,17,28,13364,28,13364,3335035.333333333,501.0,477.2857142857143,0,0,0.0,0.0,0.0
108119053.0,17,5,1005,5,1005,27029763.25,201.0,201.0,0,0,0.0,0.0,0.0
1248822.0,6,7,499,3,198,613980.5,66.0,66.0,4,301,377397.3333333333,103.0,75.25
306892.0,6,6,412,4,272,102297.33333333331,74.0,68.0,2,140,0.0,74.0,70.0
10950203.0,6,8,544,4,272,3603040.3333333335,74.0,68.0,4,272,3602945.6666666665,74.0,68.0
335.0,17,2,166,1,75,0.0,75.0,75.0,1,91,0.0,91.0,91.0
96819.0,17,2,762,2,762,0.0,381.0,381.0,0,0,0.0,0.0,0.0
3008575.0,6,11,2106,6,598,600983.8,252.0,99.66666666666669,5,1508,2288.0,1236.0,301.6
107099006.0,17,14,864,7,432,17834143.5,174.0,61.71428571428572,7,432,17833545.166666668,174.0,61.71428571428572
109075.0,17,2,286,2,286,0.0,143.0,143.0,0,0,0.0,0.0,0.0
90943195.0,6,21,1585,11,840,9093694.5,95.0,76.36363636363636,10,745,10104548.888888888,95.0,74.5
90299736.0,6,16,1192,8,596,12892476.857142856,95.0,74.5,8,596,12898425.0,95.0,74.5
197217.0,17,2,180,1,90,0.0,90.0,90.0,1,90,0.0,90.0,90.0
197137.0,17,2,762,2,762,0.0,381.0,381.0,0,0,0.0,0.0,0.0
107412.0,17,2,286,2,286,0.0,143.0,143.0,0,0,0.0,0.0,0.0
135131197.0,17,6,1206,6,1206,27026239.4,201.0,201.0,0,0,0.0,0.0,0.0
135124546.0,17,6,1206,6,1206,27024909.2,201.0,201.0,0,0,0.0,0.0,0.0
148112.0,17,2,180,1,90,0.0,90.0,90.0,1,90,0.0,90.0,90.0
108102165.0,17,5,955,5,955,27025541.25,191.0,191.0,0,0,0.0,0.0,0.0
80.0,17,2,762,2,762,0.0,381.0,381.0,0,0,0.0,0.0,0.0
105801.0,6,10,1949,5,441,26178.0,169.0,88.2,5,1508,26190.25,1236.0,301.6
112001022.0,17,14,864,7,432,18666837.0,174.0,61.71428571428572,7,432,18500896.33333333,174.0,61.71428571428572
2794214.0,6,2,132,1,66,0.0,66.0,66.0,1,66,0.0,66.0,66.0
687.0,17,2,762,2,762,0.0,381.0,381.0,0,0,0.0,0.0,0.0
2345.0,17,4,344,2,150,0.0,75.0,75.0,2,194,0.0,103.0,97.0
236143.0,6,3,426,2,280,0.0,214.0,140.0,1,146,0.0,146.0,146.0
90262439.0,6,14,2240,8,1016,12894634.142857144,188.0,127.0,6,1224,18018655.8,204.0,204.0
135136579.0,17,6,1206,6,1206,27027315.8,201.0,201.0,0,0,0.0,0.0,0.0
5622888.0,6,5,336,2,134,0.0,68.0,67.0,3,202,1421649.0,70.0,67.33333333333333
1306749.0,6,4,264,2,132,0.0,66.0,66.0,2,132,0.0,66.0,66.0
90256233.0,6,12,1832,8,1016,12893747.57142857,188.0,127.0,4,816,30030941.33333333,204.0,204.0
1042105.0,6,11,1134,6,558,208421.0,220.0,93.0,5,576,259609.5,304.0,115.2
104620043.0,6,33,2428,17,1288,6538752.6875,139.0,75.76470588235294,16,1140,6960258.466666667,123.0,71.25
97001233.0,17,11,735,6,389,19400246.6,174.0,64.83333333333333,5,346,19250689.5,174.0,69.2
90248116.0,6,13,2036,8,1016,12892588.0,188.0,127.0,5,1020,22521352.0,204.0,204.0
841.0,17,4,438,2,148,0.0,74.0,74.0,2,290,0.0,147.0,145.0
209583.0,6,3,426,2,280,0.0,214.0,140.0,1,146,0.0,146.0,146.0
2591301.0,6,2,132,1,66,0.0,66.0,66.0,1,66,0.0,66.0,66.0
220705.0,17,2,180,1,90,0.0,90.0,90.0,1,90,0.0,90.0,90.0
299598.0,6,6,412,4,272,99866.0,74.0,68.0,2,140,0.0,74.0,70.0
92125835.0,17,12,778,6,389,18393379.4,174.0,64.83333333333333,6,389,18360489.6,174.0,64.83333333333333
2419.0,17,4,344,2,150,0.0,75.0,75.0,2,194,0.0,103.0,97.0
2060161.0,6,25,7610,13,2516,171680.08333333334,1034.0,193.53846153846155,12,5094,159500.0,1510.0,424.5
143912.0,17,2,180,1,90,0.0,90.0,90.0,1,90,0.0,90.0,90.0
2313.0,17,4,344,2,150,0.0,75.0,75.0,2,194,0.0,103.0,97.0
302404.0,6,2,132,1,66,0.0,66.0,66.0,1,66,0.0,66.0,66.0
17449.0,6,11,1133,6,602,2161.8,264.0,100.33333333333331,5,531,3903.5,259.0,106.2
98440493.0,17,12,778,6,389,19601115.0,174.0,64.83333333333333,6,389,19600177.0,174.0,64.83333333333333
90266407.0,6,12,1832,8,1016,12895201.0,188.0,127.0,4,816,30032649.0,204.0,204.0
103576.0,17,2,286,2,286,0.0,143.0,143.0,0,0,0.0,0.0,0.0
111103964.0,6,30,1974,15,1026,7920579.857142857,123.0,68.4,15,948,7920579.571428572,123.0,63.2
104442805.0,6,28,1860,14,966,8017460.153846154,123.0,69.0,14,894,8017457.307692308,123.0,63.85714285714285
16905.0,17,2,180,1,90,0.0,90.0,90.0,1,90,0.0,90.0,90.0
90073923.0,17,28,13364,28,13364,3336071.222222222,501.0,477.2857142857143,0,0,0.0,0.0,0.0
38578.0,6,11,1132,6,556,7715.6,218.0,92.66666666666669,5,576,8916.75,304.0,115.2
120672707.0,6,22,1680,11,840,12067270.7,95.0,76.36363636363636,11,840,9043462.2,95.0,76.36363636363636
94331024.0,17,12,778,6,389,18800613.4,174.0,64.83333333333333,6,389,18800213.0,174.0,64.83333333333333
48125.0,6,14,4740,7,653,7176.833333333333,249.0,93.28571428571428,7,4087,7479.333333333333,1514.0,583.8571428571429
254108.0,6,10,1221,6,636,50821.6,298.0,106.0,4,585,78794.0,379.0,146.25
90522027.0,6,14,2240,8,1016,12931718.142857144,188.0,127.0,6,1224,18071560.2,204.0,204.0
214213.0,6,10,1221,6,636,42842.6,298.0,106.0,4,585,69928.0,379.0,146.25
1160457.0,6,13,3018,8,2390,165779.57142857142,1514.0,298.75,5,628,221945.0,331.0,125.6
49964.0,6,14,4740,7,653,8116.333333333333,249.0,93.28571428571428,7,4087,7938.5,1514.0,583.8571428571429
118288860.0,6,251,28624,126,20078,946310.88,374.0,159.34920634920636,125,8546,945505.3306451612,140.0,68.368
46561.0,6,14,4740,7,653,7295.166666666667,249.0,93.28571428571428,7,4087,6383.833333333333,1514.0,583.8571428571429
68677.0,6,14,4740,7,653,10739.0,249.0,93.28571428571428,7,4087,10195.333333333334,1514.0,583.8571428571429
101006050.0,17,19,5758,8,1128,14429435.714285716,506.0,141.0,11,4630,10042132.5,1214.0,420.9090909090909
233224.0,6,3,337,2,214,0.0,160.0,107.0,1,123,0.0,123.0,123.0
108005926.0,6,32,2220,16,1149,7186005.8,123.0,71.8125,16,1071,7185892.0,123.0,66.9375
109786121.0,6,28,1860,14,966,8428494.615384616,123.0,69.0,14,894,8428495.846153846,123.0,63.85714285714285
1344657.0,17,16,1120,16,1120,89643.8,70.0,70.0,0,0,0.0,0.0,0.0
135136411.0,17,6,1146,6,1146,27027282.2,191.0,191.0,0,0,0.0,0.0,0.0
0.0,17,1,55,1,55,0.0,55.0,55.0,0,0,0.0,0.0,0.0
1295.0,17,4,438,2,148,0.0,74.0,74.0,2,290,0.0,147.0,145.0
51752.0,6,10,2032,5,524,12443.75,252.0,104.8,5,1508,12465.75,1236.0,301.6
5986648.0,17,4,1722,4,1722,1995549.3333333333,453.0,430.5,0,0,0.0,0.0,0.0
185245.0,17,4,1524,4,1524,61748.333333333336,381.0,381.0,0,0,0.0,0.0,0.0
135132334.0,17,6,1146,6,1146,27026466.8,191.0,191.0,0,0,0.0,0.0,0.0
20120.0,6,10,2032,5,524,4815.0,252.0,104.8,5,1508,4543.0,1236.0,301.6
320926.0,17,4,1400,4,1400,106975.33333333331,350.0,350.0,0,0,0.0,0.0,0.0
5830390.0,6,5,336,2,134,0.0,68.0,67.0,3,202,1524381.5,70.0,67.33333333333333
146130.0,6,3,337,2,214,0.0,160.0,107.0,1,123,0.0,123.0,123.0
217829.0,6,3,426,2,280,0.0,214.0,140.0,1,146,0.0,146.0,146.0
299312.0,6,6,412,4,272,99770.66666666669,74.0,68.0,2,140,0.0,74.0,70.0
143908.0,17,2,180,1,90,0.0,90.0,90.0,1,90,0.0,90.0,90.0
119329128.0,6,26,1937,14,1043,9179163.692307692,95.0,74.5,12,894,10825594.272727272,95.0,74.5
66371.0,6,10,2032,5,524,14343.25,252.0,104.8,5,1508,14621.25,1236.0,301.6
206334.0,6,3,426,2,280,0.0,214.0,140.0,1,146,0.0,146.0,146.0
16142.0,6,10,1067,5,536,3850.75,264.0,107.2,5,531,3018.5,259.0,106.2
90279530.0,6,17,1287,9,691,11279777.875,95.0,76.77777777777777,8,596,12896693.0,95.0,74.5
15661.999999999998,6,13,1459,7,862,2389.333333333333,271.0,123.14285714285714,6,597,2916.8,259.0,99.5
251146.0,17,2,180,1,90,0.0,90.0,90.0,1,90,0.0,90.0,90.0
261781.0,6,3,337,2,214,0.0,160.0,107.0,1,123,0.0,123.0,123.0
1033720.0,6,11,1134,6,558,206744.0,220.0,93.0,5,576,255263.5,304.0,115.2
153455.0,17,2,180,1,90,0.0,90.0,90.0,1,90,0.0,90.0,90.0
31238.0,6,14,4740,7,653,5052.5,249.0,93.28571428571428,7,4087,4545.833333333333,1514.0,583.8571428571429
2329.0,17,4,344,2,150,0.0,75.0,75.0,2,194,0.0,103.0,97.0
117271012.0,6,253,29296,127,8678,930722.3174603176,140.0,68.33070866141732,126,20618,929807.76,464.0,163.63492063492063
217593.0,6,3,426,2,280,0.0,214.0,140.0,1,146,0.0,146.0,146.0
37384.0,6,14,4740,7,653,6078.333333333333,249.0,93.28571428571428,7,4087,5486.833333333333,1514.0,583.8571428571429
322306.0,6,6,412,4,272,107435.33333333331,74.0,68.0,2,140,0.0,74.0,70.0
228228.0,17,2,180,1,90,0.0,90.0,90.0,1,90,0.0,90.0,90.0
302485.0,6,2,132,1,66,0.0,66.0,66.0,1,66,0.0,66.0,66.0
527113.0,6,6,758,3,410,246629.5,172.0,136.66666666666666,3,348,191336.0,135.0,116.0
309.0,17,2,174,1,79,0.0,79.0,79.0,1,95,0.0,95.0,95.0
41320.0,6,14,4740,7,653,6759.833333333333,249.0,93.28571428571428,7,4087,6369.833333333333,1514.0,583.8571428571429
204826.0,17,2,762,2,762,0.0,381.0,381.0,0,0,0.0,0.0,0.0
90260307.0,6,12,1832,8,1016,12894329.57142857,188.0,127.0,4,816,30031586.33333333,204.0,204.0
251938.0,6,3,337,2,214,0.0,160.0,107.0,1,123,0.0,123.0,123.0
212011.0,6,10,1221,6,636,42402.2,298.0,106.0,4,585,69561.0,379.0,146.25
2365.0,17,4,344,2,150,0.0,75.0,75.0,2,194,0.0,103.0,97.0
350.0,17,2,160,1,80,0.0,80.0,80.0,1,80,0.0,80.0,80.0
144123.0,17,2,180,1,90,0.0,90.0,90.0,1,90,0.0,90.0,90.0
322196.0,6,5,337,2,163,0.0,97.0,81.5,3,174,161098.0,66.0,58.0
5953.0,17,2,371,1,77,0.0,77.0,77.0,1,294,0.0,294.0,294.0
21570.0,6,10,2032,5,524,4691.5,252.0,104.8,5,1508,4897.5,1236.0,301.6
204480.0,17,2,762,2,762,0.0,381.0,381.0,0,0,0.0,0.0,0.0
107604021.0,6,29,2052,15,1089,7686001.5,123.0,72.6,14,963,8260576.384615385,123.0,68.78571428571429
1063814.0,6,13,1386,7,789,177302.33333333334,253.0,112.71428571428572,6,597,210425.8,259.0,99.5
40532.0,6,14,4740,7,653,6634.833333333333,249.0,93.28571428571428,7,4087,5936.666666666667,1514.0,583.8571428571429
42557.0,6,14,4740,7,653,6498.333333333333,249.0,93.28571428571428,7,4087,6934.166666666667,1514.0,583.8571428571429
303589.0,6,2,132,1,66,0.0,66.0,66.0,1,66,0.0,66.0,66.0
153444.0,17,2,180,1,90,0.0,90.0,90.0,1,90,0.0,90.0,90.0
112523045.0,17,13,821,6,389,22401309.0,174.0,64.83333333333333,7,432,18666834.5,174.0,61.71428571428572
90936595.0,6,178,20094,89,13998,1030925.5568181818,284.0,157.2808988764045,89,6096,1030925.5454545454,140.0,68.49438202247191
891813.0,6,10,1334,6,797,178362.6,459.0,132.83333333333334,4,537,205375.66666666663,331.0,134.25
508679.0,6,5,336,2,134,0.0,68.0,67.0,3,202,193494.0,70.0,67.33333333333333
47696.0,6,14,4740,7,653,7107.0,249.0,93.28571428571428,7,4087,7436.5,1514.0,583.8571428571429
9635.0,17,4,823,2,163,0.0,89.0,81.5,2,660,0.0,443.0,330.0
59212.0,6,10,2032,5,524,14572.25,252.0,104.8,5,1508,12478.5,1236.0,301.6
111023400.0,6,32,2236,16,1165,7387159.866666666,139.0,72.8125,16,1071,7387158.666666667,123.0,66.9375
5628821.0,6,4,270,2,134,0.0,68.0,67.0,2,136,0.0,70.0,68.0
7750846.0,17,4,1376,3,1026,862206.5,342.0,342.0,1,350,0.0,350.0,350.0
131578.0,6,3,337,2,214,0.0,160.0,107.0,1,123,0.0,123.0,123.0
120131257.0,6,13,2020,9,1204,15016407.125,188.0,133.77777777777777,4,816,30033202.666666668,204.0,204.0
90259762.0,6,12,1832,8,1016,12894251.714285716,188.0,127.0,4,816,30031086.33333333,204.0,204.0
156791.0,6,3,337,2,214,0.0,160.0,107.0,1,123,0.0,123.0,123.0
34298.0,6,14,4740,7,653,5525.333333333333,249.0,93.28571428571428,7,4087,4999.166666666667,1514.0,583.8571428571429
1109636.0,6,11,1134,6,558,221927.2,220.0,93.0,5,576,276572.75,304.0,115.2
105035640.0,6,44,2904,22,1452,5001697.142857143,66.0,66.0,22,1452,4991404.19047619,66.0,66.0
108104019.0,17,5,1005,5,1005,27026004.75,201.0,201.0,0,0,0.0,0.0,0.0
24994.0,6,14,4740,7,653,3670.6666666666665,249.0,93.28571428571428,7,4087,4028.1666666666665,1514.0,583.8571428571429
135136242.0,17,6,1206,6,1206,27027248.4,201.0,201.0,0,0,0.0,0.0,0.0
31065.0,6,14,4740,7,653,4593.833333333333,249.0,93.28571428571428,7,4087,4230.333333333333,1514.0,583.8571428571429
308538.0,17,4,1400,4,1400,102846.0,350.0,350.0,0,0,0.0,0.0,0.0
1877691.0,6,22,6441,12,1529,170699.18181818182,357.0,127.41666666666669,10,4912,174963.0,1510.0,491.2
53326.0,6,14,4740,7,653,8709.333333333334,249.0,93.28571428571428,7,4087,8475.333333333334,1514.0,583.8571428571429
304148.0,6,6,412,4,272,101382.66666666669,74.0,68.0,2,140,0.0,74.0,70.0
34535915.0,6,26,7627,14,3735,209976.0,1514.0,266.7857142857143,12,3892,3121019.090909091,1514.0,324.3333333333333
18184.0,6,10,1067,5,536,4317.25,264.0,107.2,5,531,4037.0,259.0,106.2
312762.0,17,4,1400,4,1400,104254.0,350.0,350.0,0,0,0.0,0.0,0.0
0.0,6,1,66,1,66,0.0,66.0,66.0,0,0,0.0,0.0,0.0
301349.0,6,6,412,4,272,100449.66666666669,74.0,68.0,2,140,0.0,74.0,70.0
18407.0,6,10,1065,5,534,4228.0,262.0,106.8,5,531,4256.5,259.0,106.2
37732.0,6,14,4740,7,653,6110.5,249.0,93.28571428571428,7,4087,5626.0,1514.0,583.8571428571429
90055387.0,6,15,1220,5,393,15065346.75,95.0,78.6,10,827,10005606.333333334,95.0,82.7
23498.0,6,14,4740,7,653,3733.6666666666665,249.0,93.28571428571428,7,4087,3515.333333333333,1514.0,583.8571428571429
157541.0,6,3,337,2,214,0.0,160.0,107.0,1,123,0.0,123.0,123.0
97119.0,17,2,762,2,762,0.0,381.0,381.0,0,0,0.0,0.0,0.0
43111.0,6,14,4740,7,653,5200.833333333333,249.0,93.28571428571428,7,4087,6781.833333333333,1514.0,583.8571428571429
32104.0,6,14,4740,7,653,5063.5,249.0,93.28571428571428,7,4087,3991.3333333333335,1514.0,583.8571428571429
28309.0,6,14,4740,7,653,4572.666666666667,249.0,93.28571428571428,7,4087,4474.0,1514.0,583.8571428571429
4061081.0,17,2,876,2,876,0.0,438.0,438.0,0,0,0.0,0.0,0.0
13997.0,6,14,4740,7,653,2063.0,249.0,93.28571428571428,7,4087,2195.833333333333,1514.0,583.8571428571429
90261450.0,6,12,1832,8,1016,12894492.857142856,188.0,127.0,4,816,30032332.666666668,204.0,204.0
108695085.0,6,32,2220,16,1149,7246339.0,123.0,71.8125,16,1071,7231891.133333334,123.0,66.9375
85368.0,6,14,4740,7,653,14046.833333333334,249.0,93.28571428571428,7,4087,13556.166666666666,1514.0,583.8571428571429
1314827.0,6,4,264,2,132,0.0,66.0,66.0,2,132,0.0,66.0,66.0
31536.0,6,14,4740,7,653,4736.333333333333,249.0,93.28571428571428,7,4087,4656.166666666667,1514.0,583.8571428571429
120029070.0,17,28,13364,28,13364,4445521.111111111,501.0,477.2857142857143,0,0,0.0,0.0,0.0
63494.99999999999,6,14,4740,7,653,10172.0,249.0,93.28571428571428,7,4087,7724.166666666667,1514.0,583.8571428571429
27418870.0,17,5,1710,5,1710,6854717.5,342.0,342.0,0,0,0.0,0.0,0.0
240735.0,6,3,337,2,214,0.0,160.0,107.0,1,123,0.0,123.0,123.0
10866511.0,6,8,544,4,272,3576879.6666666665,74.0,68.0,4,272,3576806.6666666665,74.0,68.0
16933419.0,6,26,7627,14,3735,178504.3076923077,1514.0,266.7857142857143,12,3892,1520755.3636363635,1514.0,324.3333333333333
97908941.0,6,26,1746,13,906,8159078.416666667,123.0,69.6923076923077,13,840,8141058.166666667,123.0,64.61538461538461
2014.0,17,4,344,2,150,0.0,75.0,75.0,2,194,0.0,103.0,97.0
135134825.0,17,6,1206,6,1206,27026965.0,201.0,201.0,0,0,0.0,0.0,0.0
105205812.0,17,15,5130,15,5130,7514700.857142857,342.0,342.0,0,0,0.0,0.0,0.0
2378.0,17,4,344,2,150,0.0,75.0,75.0,2,194,0.0,103.0,97.0
308161.0,6,3,202,2,128,0.0,74.0,64.0,1,74,0.0,74.0,74.0
212854.0,17,2,180,1,90,0.0,90.0,90.0,1,90,0.0,90.0,90.0
121402.0,6,3,337,2,214,0.0,160.0,107.0,1,123,0.0,123.0,123.0
158475.0,6,3,337,2,214,0.0,160.0,107.0,1,123,0.0,123.0,123.0
2104426.0,6,18,6803,10,1501,233825.11111111112,408.0,150.1,8,5302,237911.7142857143,1514.0,662.75
63579.0,6,10,2032,5,524,15662.5,252.0,104.8,5,1508,14874.75,1236.0,301.6
46940.0,6,14,4740,7,653,7069.333333333333,249.0,93.28571428571428,7,4087,7072.5,1514.0,583.8571428571429
36085.0,6,10,2032,5,524,8391.75,252.0,104.8,5,1508,8036.25,1236.0,301.6
115449206.0,6,208,23424,104,16264,1118777.640776699,284.0,156.3846153846154,104,7160,1118776.572815534,140.0,68.84615384615384
37313.0,6,10,2032,5,524,5581.0,252.0,104.8,5,1508,9068.5,1236.0,301.6
302097.0,6,6,412,4,272,100699.0,74.0,68.0,2,140,0.0,74.0,70.0
105980178.0,6,44,2904,22,1452,5046675.142857143,66.0,66.0,22,1452,5031977.80952381,66.0,66.0
228201.0,17,2,180,1,90,0.0,90.0,90.0,1,90,0.0,90.0,90.0
90042387.0,17,28,13364,28,13364,3334903.222222222,501.0,477.2857142857143,0,0,0.0,0.0,0.0
90258535.0,6,12,1832,8,1016,12894076.42857143,188.0,127.0,4,816,30030938.33333333,204.0,204.0
19764.0,17,2,582,1,83,0.0,83.0,83.0,1,499,0.0,499.0,499.0
1275930.0,17,5,961,3,234,637779.0,78.0,78.0,2,727,0.0,395.0,363.5
256325.00000000003,6,10,1221,6,636,51265.0,298.0,106.0,4,585,79679.66666666667,379.0,146.25
250565.0,6,3,337,2,214,0.0,160.0,107.0,1,123,0.0,123.0,123.0
46715.0,6,14,4740,7,653,6774.833333333333,249.0,93.28571428571428,7,4087,7333.666666666667,1514.0,583.8571428571429
1302556.0,6,4,264,2,132,0.0,66.0,66.0,2,132,0.0,66.0,66.0
9025.0,17,2,539,1,86,0.0,86.0,86.0,1,453,0.0,453.0,453.0
204900.0,17,2,762,2,762,0.0,381.0,381.0,0,0,0.0,0.0,0.0
55573.0,6,14,4740,7,653,8894.333333333334,249.0,93.28571428571428,7,4087,8220.833333333334,1514.0,583.8571428571429
50771.0,17,2,180,1,90,0.0,90.0,90.0,1,90,0.0,90.0,90.0
113709840.0,6,35,2542,18,1348,6676128.117647059,139.0,74.88888888888889,17,1194,7093386.75,123.0,70.23529411764706
90515051.0,6,14,2240,8,1016,12930721.57142857,188.0,127.0,6,1224,18070411.2,204.0,204.0
113372233.0,6,46,3036,23,1518,5153272.045454546,66.0,66.0,23,1518,5153271.136363637,66.0,66.0
102290173.0,6,28,1992,14,963,7868442.538461538,123.0,68.78571428571429,14,1029,7100390.384615385,123.0,73.5
250556.0,17,2,180,1,70,0.0,70.0,70.0,1,110,0.0,110.0,110.0
121385.0,6,3,337,2,214,0.0,160.0,107.0,1,123,0.0,123.0,123.0
7004.0,17,2,582,1,83,0.0,83.0,83.0,1,499,0.0,499.0,499.0
108108589.0,17,5,1005,5,1005,27027147.25,201.0,201.0,0,0,0.0,0.0,0.0
384.0,17,2,267,1,83,0.0,83.0,83.0,1,184,0.0,184.0,184.0
159651.0,6,2,132,1,66,0.0,66.0,66.0,1,66,0.0,66.0,66.0
233665.0,6,3,337,2,214,0.0,160.0,107.0,1,123,0.0,123.0,123.0
97778515.0,17,12,778,6,389,19555703.0,174.0,64.83333333333333,6,389,19419504.0,174.0,64.83333333333333
105267.0,17,2,700,2,700,0.0,350.0,350.0,0,0,0.0,0.0,0.0
108110983.0,17,5,1005,5,1005,27027745.75,201.0,201.0,0,0,0.0,0.0,0.0
135129547.0,17,6,1146,6,1146,27025909.4,191.0,191.0,0,0,0.0,0.0,0.0
104938.0,6,14,4740,7,653,17287.833333333332,249.0,93.28571428571428,7,4087,16372.333333333334,1514.0,583.8571428571429
2426.0,17,4,344,2,150,0.0,75.0,75.0,2,194,0.0,103.0,97.0
108108768.0,17,5,955,5,955,27027192.0,191.0,191.0,0,0,0.0,0.0,0.0
377636.0,17,2,363,1,75,0.0,75.0,75.0,1,288,0.0,288.0,288.0
14324.0,17,2,180,1,90,0.0,90.0,90.0,1,90,0.0,90.0,90.0
120204176.0,6,224,25274,112,7688,1075460.063063063,140.0,68.64285714285714,112,17586,1076782.3783783785,284.0,157.01785714285714
90259817.0,6,12,1832,8,1016,12894259.57142857,188.0,127.0,4,816,30030551.0,204.0,204.0
10776.0,17,2,582,1,83,0.0,83.0,83.0,1,499,0.0,499.0,499.0
15619.0,6,10,1065,5,534,3545.0,262.0,106.8,5,531,3561.5,259.0,106.2
108106605.0,17,5,1005,5,1005,27026651.25,201.0,201.0,0,0,0.0,0.0,0.0
3197.0,17,2,224,1,76,0.0,76.0,76.0,1,148,0.0,148.0,148.0
113520236.0,6,46,3036,23,1518,5159999.590909091,66.0,66.0,23,1518,5159999.409090909,66.0,66.0
90257769.0,6,13,2036,8,1016,12893967.0,188.0,127.0,5,1020,22523969.5,204.0,204.0
303622.0,6,6,412,4,272,101207.33333333331,74.0,68.0,2,140,0.0,74.0,70.0
798760.0,6,21,6835,11,1164,79876.0,288.0,105.8181818181818,10,5671,69126.55555555556,1514.0,567.1
114169718.0,17,14,1126,7,563,19001466.0,174.0,80.42857142857143,7,563,19001459.166666668,174.0,80.42857142857143
234008.0,6,3,373,2,238,0.0,172.0,119.0,1,135,0.0,135.0,135.0
47560.0,6,11,2098,6,590,8231.2,252.0,98.33333333333331,5,1508,11348.0,1236.0,301.6
10916404.0,6,8,544,4,272,3593044.333333333,74.0,68.0,4,272,3592949.333333333,74.0,68.0
104409640.0,17,14,864,7,432,17333483.666666668,174.0,61.71428571428572,7,432,17334139.5,174.0,61.71428571428572
2371.0,17,4,344,2,150,0.0,75.0,75.0,2,194,0.0,103.0,97.0
5621238.0,6,4,270,2,134,0.0,68.0,67.0,2,136,0.0,70.0,68.0
330.0,17,2,166,1,75,0.0,75.0,75.0,1,91,0.0,91.0,91.0
90302280.0,6,21,1585,11,840,9026101.7,95.0,76.36363636363636,10,745,10000934.444444444,95.0,74.5
113059887.0,17,14,864,7,432,18833498.83333333,174.0,61.71428571428572,7,432,18834296.666666668,174.0,61.71428571428572
102985.0,17,2,286,2,286,0.0,143.0,143.0,0,0,0.0,0.0,0.0
196929.0,17,2,180,1,90,0.0,90.0,90.0,1,90,0.0,90.0,90.0
135137953.0,17,6,1206,6,1206,27027590.6,201.0,201.0,0,0,0.0,0.0,0.0
209204.0,6,3,426,2,280,0.0,214.0,140.0,1,146,0.0,146.0,146.0
58846044.0,17,9,3086,8,2736,5107276.857142857,342.0,342.0,1,350,0.0,350.0,350.0
116082129.0,17,16,1212,8,606,16560455.857142856,174.0,75.75,8,606,16470134.714285716,174.0,75.75
117096.0,17,4,1400,4,1400,39032.0,350.0,350.0,0,0,0.0,0.0,0.0
1231771.0,17,7,490,7,490,205295.16666666663,70.0,70.0,0,0,0.0,0.0,0.0
56371.0,6,14,4740,7,653,8721.333333333334,249.0,93.28571428571428,7,4087,8628.333333333334,1514.0,583.8571428571429
2057.0,17,4,344,2,150,0.0,75.0,75.0,2,194,0.0,103.0,97.0
99836.0,17,2,762,2,762,0.0,381.0,381.0,0,0,0.0,0.0,0.0
145047.0,17,2,180,1,70,0.0,70.0,70.0,1,110,0.0,110.0,110.0
303662.0,6,2,132,1,66,0.0,66.0,66.0,1,66,0.0,66.0,66.0
305265.0,6,6,412,4,272,101755.0,74.0,68.0,2,140,0.0,74.0,70.0
108106648.0,17,5,1005,5,1005,27026662.0,201.0,201.0,0,0,0.0,0.0,0.0
331.0,17,2,160,1,80,0.0,80.0,80.0,1,80,0.0,80.0,80.0
102665.0,17,2,286,2,286,0.0,143.0,143.0,0,0,0.0,0.0,0.0
68385.0,6,10,2032,5,524,16165.75,252.0,104.8,5,1508,16424.25,1236.0,301.6
1320126.0,6,4,264,2,132,0.0,66.0,66.0,2,132,0.0,66.0,66.0
23586.0,6,14,4740,7,653,3284.333333333333,249.0,93.28571428571428,7,4087,3796.8333333333335,1514.0,583.8571428571429
10940.0,17,4,823,2,163,0.0,89.0,81.5,2,660,0.0,443.0,330.0
2037680.0,6,24,7544,12,2450,185243.63636363635,1034.0,204.16666666666663,12,5094,156222.63636363635,1510.0,424.5
50423.0,6,10,2032,5,524,11775.25,252.0,104.8,5,1508,10890.5,1236.0,301.6
0.0,17,1,55,1,55,0.0,55.0,55.0,0,0,0.0,0.0,0.0
47415.0,6,14,4740,7,653,7724.0,249.0,93.28571428571428,7,4087,7616.0,1514.0,583.8571428571429
66104.0,6,14,4740,7,653,10744.166666666666,249.0,93.28571428571428,7,4087,10878.666666666666,1514.0,583.8571428571429
30043.0,6,14,4740,7,653,4818.5,249.0,93.28571428571428,7,4087,3867.5,1514.0,583.8571428571429
40329.0,6,10,2032,5,524,9422.75,252.0,104.8,5,1508,8638.0,1236.0,301.6
90528511.0,6,17,2572,9,1204,11316063.875,188.0,133.77777777777777,8,1368,12909144.142857144,204.0,171.0
10460686.0,6,7,478,4,272,3441668.333333333,74.0,68.0,3,206,5162413.5,74.0,68.66666666666667
1160169.0,6,13,3011,8,2383,165738.42857142858,1514.0,297.875,5,628,221913.0,331.0,125.6
129006029.0,17,15,907,8,475,18429432.71428572,174.0,59.375,7,432,18166980.5,174.0,61.71428571428572
600700.0,17,2,346,1,78,0.0,78.0,78.0,1,268,0.0,268.0,268.0
202128.0,17,2,180,1,90,0.0,90.0,90.0,1,90,0.0,90.0,90.0
1309566.0,6,4,264,2,132,0.0,66.0,66.0,2,132,0.0,66.0,66.0
303099.0,6,6,412,4,272,101033.0,74.0,68.0,2,140,0.0,74.0,70.0
135123334.0,17,6,1146,6,1146,27024666.8,191.0,191.0,0,0,0.0,0.0,0.0
209821.0,17,2,180,1,90,0.0,90.0,90.0,1,90,0.0,90.0,90.0
90258173.0,6,12,1832,8,1016,12894024.714285716,188.0,127.0,4,816,30030775.666666668,204.0,204.0
228231.0,6,13,1394,7,797,38038.5,253.0,113.85714285714286,6,597,43495.0,259.0,99.5
90101979.0,6,11,1644,4,816,30032916.666666668,204.0,204.0,7,828,15016606.333333334,188.0,118.28571428571428
2795730.0,6,2,132,1,66,0.0,66.0,66.0,1,66,0.0,66.0,66.0
108101421.0,17,5,1005,5,1005,27025355.25,201.0,201.0,0,0,0.0,0.0,0.0
228642.0,17,2,180,1,90,0.0,90.0,90.0,1,90,0.0,90.0,90.0
4475.0,17,2,598,1,72,0.0,72.0,72.0,1,526,0.0,526.0,526.0
700074.0,17,2,180,1,90,0.0,90.0,90.0,1,90,0.0,90.0,90.0
345449.0,17,6,2100,6,2100,69089.8,350.0,350.0,0,0,0.0,0.0,0.0
17185.0,17,2,582,1,83,0.0,83.0,83.0,1,499,0.0,499.0,499.0
217944.0,6,3,426,2,280,0.0,214.0,140.0,1,146,0.0,146.0,146.0
75046425.0,6,9,842,9,842,9380803.125,97.0,93.55555555555556,0,0,0.0,0.0,0.0
250365.0,6,4,439,2,238,0.0,172.0,119.0,2,201,0.0,135.0,100.5
112762239.0,17,16,1212,8,606,16000713.42857143,174.0,75.75,8,606,16000146.857142856,174.0,75.75
209648.0,17,2,180,1,90,0.0,90.0,90.0,1,90,0.0,90.0,90.0
94962444.0,6,40,2640,20,1320,4998023.368421053,66.0,66.0,20,1320,4981779.631578947,66.0,66.0
120105475.0,6,222,25106,111,7548,1084225.318181818,140.0,68.0,111,17558,1084388.7818181815,284.0,158.18018018018017
453.0,17,2,410,1,78,0.0,78.0,78.0,1,332,0.0,332.0,332.0
146017.0,6,3,337,2,214,0.0,160.0,107.0,1,123,0.0,123.0,123.0
36274.0,6,10,2032,5,524,8443.0,252.0,104.8,5,1508,7979.75,1236.0,301.6
118059060.0,6,214,24218,107,7358,1096961.066037736,140.0,68.76635514018692,107,16860,1107072.2452830188,284.0,157.57009345794393
16299.000000000002,6,11,1132,6,556,3259.8,218.0,92.66666666666669,5,576,3526.0,304.0,115.2
32360.0,6,14,4740,7,653,5279.166666666667,249.0,93.28571428571428,7,4087,4844.833333333333,1514.0,583.8571428571429
284447.0,17,2,363,1,79,0.0,79.0,79.0,1,284,0.0,284.0,284.0
2349.0,17,4,344,2,150,0.0,75.0,75.0,2,194,0.0,103.0,97.0
35383.0,6,14,4740,7,653,5602.5,249.0,93.28571428571428,7,4087,5680.666666666667,1514.0,583.8571428571429
260070.00000000003,17,2,180,1,90,0.0,90.0,90.0,1,90,0.0,90.0,90.0
209842.0,17,2,762,2,762,0.0,381.0,381.0,0,0,0.0,0.0,0.0
108131886.0,17,5,1005,5,1005,27032971.5,201.0,201.0,0,0,0.0,0.0,0.0
10429187.0,6,6,412,3,206,5146519.5,74.0,68.66666666666667,3,206,5146394.0,74.0,68.66666666666667
151875.0,6,2,132,1,66,0.0,66.0,66.0,1,66,0.0,66.0,66.0
28433.0,6,14,4740,7,653,4537.666666666667,249.0,93.28571428571428,7,4087,4602.333333333333,1514.0,583.8571428571429
99002081.0,6,25,1686,13,840,8250173.416666667,123.0,64.61538461538461,12,846,8072658.727272727,123.0,70.5
309780.0,6,6,412,4,272,103260.0,74.0,68.0,2,140,0.0,74.0,70.0
248827.0,6,3,337,2,214,0.0,160.0,107.0,1,123,0.0,123.0,123.0
4296.0,17,2,614,1,72,0.0,72.0,72.0,1,542,0.0,542.0,542.0
37853.0,6,14,4740,7,653,6183.0,249.0,93.28571428571428,7,4087,6169.0,1514.0,583.8571428571429
103092004.0,17,14,864,7,432,17166859.666666668,174.0,61.71428571428572,7,432,17167993.333333332,174.0,61.71428571428572
95072001.0,6,151,17170,76,11986,1267626.68,284.0,157.71052631578948,75,5184,1270870.0945945946,140.0,69.12
321320.0,6,6,412,4,272,107106.66666666669,74.0,68.0,2,140,0.0,74.0,70.0
1475671.0,17,16,1120,16,1120,98378.06666666668,70.0,70.0,0,0,0.0,0.0,0.0
90529424.0,6,13,2036,8,1016,12932774.857142856,188.0,127.0,5,1020,22591477.25,204.0,204.0
38015.0,6,14,4740,7,653,5812.833333333333,249.0,93.28571428571428,7,4087,5091.666666666667,1514.0,583.8571428571429
759.0,17,4,438,2,148,0.0,74.0,74.0,2,290,0.0,147.0,145.0
19300.0,17,2,180,1,90,0.0,90.0,90.0,1,90,0.0,90.0,90.0
108113410.0,17,5,955,5,955,27028352.5,191.0,191.0,0,0,0.0,0.0,0.0
331.0,17,2,166,1,75,0.0,75.0,75.0,1,91,0.0,91.0,91.0
27076.0,6,14,4740,7,653,3916.0,249.0,93.28571428571428,7,4087,4327.5,1514.0,583.8571428571429
2594814.0,6,2,132,1,66,0.0,66.0,66.0,1,66,0.0,66.0,66.0
108111545.0,17,5,1005,5,1005,27027886.25,201.0,201.0,0,0,0.0,0.0,0.0
101131.0,17,2,762,2,762,0.0,381.0,381.0,0,0,0.0,0.0,0.0
108109248.0,17,5,1005,5,1005,27027312.0,201.0,201.0,0,0,0.0,0.0,0.0
37359.0,6,14,4740,7,653,6027.0,249.0,93.28571428571428,7,4087,5536.0,1514.0,583.8571428571429
1468341.0,6,19,7533,10,1403,163149.0,583.0,140.3,9,6130,151013.5,1484.0,681.1111111111111
90360110.0,6,11,1644,7,828,15060018.333333334,188.0,118.28571428571428,4,816,20111176.0,204.0,204.0
135148927.0,17,6,1146,6,1146,27029785.4,191.0,191.0,0,0,0.0,0.0,0.0
58756.0,6,14,4740,7,653,9503.333333333334,249.0,93.28571428571428,7,4087,9596.833333333334,1514.0,583.8571428571429
135001232.0,17,15,907,8,475,19285890.285714287,174.0,59.375,7,432,19168194.666666668,174.0,61.71428571428572
285994.0,17,2,363,1,79,0.0,79.0,79.0,1,284,0.0,284.0,284.0
91665642.0,6,24,1829,11,840,9166564.2,95.0,76.36363636363636,13,989,7617087.0,95.0,76.07692307692308
102489.0,17,2,762,2,762,0.0,381.0,381.0,0,0,0.0,0.0,0.0
2756712.0,6,2,132,1,66,0.0,66.0,66.0,1,66,0.0,66.0,66.0
117326364.0,6,209,23618,105,7152,1128138.1153846155,140.0,68.11428571428571,104,16466,1129111.4563106797,284.0,158.32692307692307
9522.0,17,2,582,1,83,0.0,83.0,83.0,1,499,0.0,499.0,499.0
92738073.0,6,39,3172,21,1717,4636903.65,139.0,81.76190476190476,18,1455,5443051.117647059,123.0,80.83333333333333
360.0,17,2,204,1,88,0.0,88.0,88.0,1,116,0.0,116.0,116.0
103325.0,17,2,286,2,286,0.0,143.0,143.0,0,0,0.0,0.0,0.0
107995.0,17,2,700,2,700,0.0,350.0,350.0,0,0,0.0,0.0,0.0
324047.0,17,4,1400,4,1400,108015.66666666669,350.0,350.0,0,0,0.0,0.0,0.0
30998.0,6,14,4740,7,653,5041.333333333333,249.0,93.28571428571428,7,4087,4980.166666666667,1514.0,583.8571428571429
6610.0,17,4,823,2,163,0.0,89.0,81.5,2,660,0.0,443.0,330.0
90295702.0,6,16,1192,8,596,12891925.42857143,95.0,74.5,8,596,12897701.285714284,95.0,74.5
300261.0,6,6,412,4,272,100087.0,74.0,68.0,2,140,0.0,74.0,70.0
40122.0,6,14,4740,7,653,6563.333333333333,249.0,93.28571428571428,7,4087,6160.333333333333,1514.0,583.8571428571429
312364.0,6,6,412,4,272,104121.33333333331,74.0,68.0,2,140,0.0,74.0,70.0
299893.0,6,6,412,4,272,99964.33333333331,74.0,68.0,2,140,0.0,74.0,70.0
62009.0,6,14,4740,7,653,8958.5,249.0,93.28571428571428,7,4087,8096.833333333333,1514.0,583.8571428571429
864958.0,6,9,1096,6,625,172991.6,287.0,104.16666666666669,3,471,294622.0,331.0,157.0
14638850.0,6,20,1607,10,975,1592770.5555555555,315.0,97.5,10,632,1592739.4444444445,78.0,63.2
296374.0,6,6,412,4,272,98791.33333333331,74.0,68.0,2,140,0.0,74.0,70.0
8670605.0,17,3,1034,2,684,0.0,342.0,342.0,1,350,0.0,350.0,350.0
108106861.0,17,5,1005,5,1005,27026715.25,201.0,201.0,0,0,0.0,0.0,0.0
248471.0,17,4,6056,4,6056,82823.66666666667,1514.0,1514.0,0,0,0.0,0.0,0.0
1300181.0,6,4,264,2,132,0.0,66.0,66.0,2,132,0.0,66.0,66.0
39693.0,6,10,2032,5,524,9667.5,252.0,104.8,5,1508,9432.0,1236.0,301.6
60358.0,6,14,4740,7,653,8942.666666666666,249.0,93.28571428571428,7,4087,9927.5,1514.0,583.8571428571429
52431.0,6,10,2032,5,524,12201.25,252.0,104.8,5,1508,11336.5,1236.0,301.6
54507.0,6,14,4740,7,653,8752.666666666666,249.0,93.28571428571428,7,4087,8700.166666666666,1514.0,583.8571428571429
232963.0,6,3,337,2,214,0.0,160.0,107.0,1,123,0.0,123.0,123.0
14965.0,17,2,180,1,90,0.0,90.0,90.0,1,90,0.0,90.0,90.0
303654.0,6,2,132,1,66,0.0,66.0,66.0,1,66,0.0,66.0,66.0
90206028.0,6,16,1192,8,596,12852802.857142856,95.0,74.5,8,596,12857336.57142857,95.0,74.5
204643.0,17,2,762,2,762,0.0,381.0,381.0,0,0,0.0,0.0,0.0
31656.0,6,14,4740,7,653,4908.666666666667,249.0,93.28571428571428,7,4087,3549.333333333333,1514.0,583.8571428571429
317500.0,17,4,1400,4,1400,105833.33333333331,350.0,350.0,0,0,0.0,0.0,0.0
36077.0,6,14,4740,7,653,5415.333333333333,249.0,93.28571428571428,7,4087,5819.666666666667,1514.0,583.8571428571429
311738.0,17,4,1400,4,1400,103912.66666666669,350.0,350.0,0,0,0.0,0.0,0.0
335.0,17,2,267,1,83,0.0,83.0,83.0,1,184,0.0,184.0,184.0
245776.0,6,3,337,2,214,0.0,160.0,107.0,1,123,0.0,123.0,123.0
51078.0,6,14,4740,7,653,8275.166666666666,249.0,93.28571428571428,7,4087,7702.0,1514.0,583.8571428571429
242349.0,6,3,337,2,214,0.0,160.0,107.0,1,123,0.0,123.0,123.0
31682.000000000004,6,10,2032,5,524,7595.5,252.0,104.8,5,1508,6650.25,1236.0,301.6
5610876.0,6,5,336,2,134,0.0,68.0,67.0,3,202,1422201.5,70.0,67.33333333333333
323560.0,17,4,1400,4,1400,107853.33333333331,350.0,350.0,0,0,0.0,0.0,0.0
33004769.000000004,6,26,7627,14,3735,190435.0769230769,1514.0,266.7857142857143,12,3892,2981814.5454545454,1514.0,324.3333333333333
43130.0,6,14,4740,7,653,6657.166666666667,249.0,93.28571428571428,7,4087,6868.166666666667,1514.0,583.8571428571429
2346695.0,6,28,9195,16,3843,156446.33333333334,1514.0,240.1875,12,5352,189024.45454545456,1514.0,446.0
9189.0,17,2,571,1,86,0.0,86.0,86.0,1,485,0.0,485.0,485.0
207161.0,6,3,426,2,280,0.0,214.0,140.0,1,146,0.0,146.0,146.0
308877.0,6,10,1221,6,636,61775.4,298.0,106.0,4,585,100557.33333333331,379.0,146.25
131159.0,6,3,337,2,214,0.0,160.0,107.0,1,123,0.0,123.0,123.0
119480023.0,17,35,16705,35,16705,3514118.323529412,501.0,477.2857142857143,0,0,0.0,0.0,0.0
16016575.0,17,2,684,2,684,0.0,342.0,342.0,0,0,0.0,0.0,0.0
105344837.0,6,219,24690,110,7556,966433.6238532112,140.0,68.69090909090909,109,17134,958210.8425925926,284.0,157.19266055045873
206409.0,6,3,426,2,280,0.0,214.0,140.0,1,146,0.0,146.0,146.0
113520210.0,6,46,3036,23,1518,5159998.318181818,66.0,66.0,23,1518,5159991.227272728,66.0,66.0
315137.0,6,6,412,4,272,105045.66666666669,74.0,68.0,2,140,0.0,74.0,70.0
1316302.0,6,4,264,2,132,0.0,66.0,66.0,2,132,0.0,66.0,66.0
232240.0,6,3,337,2,214,0.0,160.0,107.0,1,123,0.0,123.0,123.0
332.0,17,2,166,1,75,0.0,75.0,75.0,1,91,0.0,91.0,91.0
153412.0,17,2,180,1,90,0.0,90.0,90.0,1,90,0.0,90.0,90.0
107034.0,17,2,286,2,286,0.0,143.0,143.0,0,0,0.0,0.0,0.0
316866.0,6,6,412,4,272,105622.0,74.0,68.0,2,140,0.0,74.0,70.0
197279.0,17,2,180,1,90,0.0,90.0,90.0,1,90,0.0,90.0,90.0
809.0,17,4,438,2,148,0.0,74.0,74.0,2,290,0.0,147.0,145.0
103478.0,17,2,286,2,286,0.0,143.0,143.0,0,0,0.0,0.0,0.0
4666.0,17,4,344,2,150,0.0,75.0,75.0,2,194,0.0,103.0,97.0
10768.0,6,10,2032,5,524,2425.5,252.0,104.8,5,1508,2269.5,1236.0,301.6
25364.0,6,13,4412,6,409,4833.6,127.0,68.16666666666667,7,4003,2878.6666666666665,1514.0,571.8571428571429
7087.0,17,2,582,1,83,0.0,83.0,83.0,1,499,0.0,499.0,499.0
90092961.0,6,12,1970,7,950,15015493.5,188.0,135.71428571428572,5,1020,15015460.0,204.0,204.0
90299301.0,6,16,1192,8,596,12893354.0,95.0,74.5,8,596,12899383.714285716,95.0,74.5
101940.0,17,2,762,2,762,0.0,381.0,381.0,0,0,0.0,0.0,0.0
118540853.0,6,48,3168,24,1584,5153950.130434782,66.0,66.0,24,1584,5140529.434782608,66.0,66.0
1458206.0,6,4,276,2,128,0.0,74.0,64.0,2,148,0.0,74.0,74.0
39076.0,6,10,2032,5,524,7147.25,252.0,104.8,5,1508,9494.5,1236.0,301.6
108714.0,17,2,286,2,286,0.0,143.0,143.0,0,0,0.0,0.0,0.0
97174442.0,6,190,21426,95,14934,1031480.7872340424,284.0,157.2,95,6492,1031478.0212765958,140.0,68.33684210526316
108108715.0,17,5,1005,5,1005,27027178.75,201.0,201.0,0,0,0.0,0.0,0.0
44215.0,6,14,4740,7,653,7243.0,249.0,93.28571428571428,7,4087,6928.166666666667,1514.0,583.8571428571429
42477.0,6,14,4740,7,653,6953.333333333333,249.0,93.28571428571428,7,4087,6894.0,1514.0,583.8571428571429
3187720.0,6,3,1777,1,826,0.0,826.0,826.0,2,951,0.0,885.0,475.5
241686.0,6,3,337,2,214,0.0,160.0,107.0,1,123,0.0,123.0,123.0
311525.0,17,4,622,4,622,103841.66666666669,163.0,155.5,0,0,0.0,0.0,0.0
2864436.0,6,4,270,3,202,1432218.0,70.0,67.33333333333333,1,68,0.0,68.0,68.0
303173.0,6,2,132,1,66,0.0,66.0,66.0,1,66,0.0,66.0,66.0
475411.0,6,3,204,2,136,0.0,70.0,68.0,1,68,0.0,68.0,68.0
20806.0,6,11,1131,6,600,4092.6,262.0,100.0,5,531,4480.75,259.0,106.2
120243.0,17,2,180,1,70,0.0,70.0,70.0,1,110,0.0,110.0,110.0
121423.0,17,4,1400,4,1400,40474.333333333336,350.0,350.0,0,0,0.0,0.0,0.0
43789.0,6,14,4740,7,653,6881.0,249.0,93.28571428571428,7,4087,7114.833333333333,1514.0,583.8571428571429
2078.0,17,4,344,2,150,0.0,75.0,75.0,2,194,0.0,103.0,97.0
1519.0,6,2,177,1,123,0.0,123.0,123.0,1,54,0.0,54.0,54.0
90292208.0,6,16,1192,8,596,12891823.42857143,95.0,74.5,8,596,12898409.714285716,95.0,74.5
90915.0,6,10,1065,5,534,22314.5,262.0,106.8,5,531,2322.25,259.0,106.2
90259922.0,6,13,2036,8,1016,12894274.57142857,188.0,127.0,5,1020,22521035.75,204.0,204.0
120123451.0,6,16,2490,10,1392,13347050.111111112,188.0,139.2,6,1098,18099195.0,204.0,183.0
27293573.0,17,5,1710,5,1710,6823393.25,342.0,342.0,0,0,0.0,0.0,0.0
120123653.0,6,14,2240,6,1224,24024730.6,204.0,204.0,8,1016,17137008.85714286,188.0,127.0
37681.0,6,14,4740,7,653,6085.666666666667,249.0,93.28571428571428,7,4087,6020.5,1514.0,583.8571428571429
110001314.0,17,14,864,7,432,18333552.33333333,174.0,61.71428571428572,7,432,18172985.5,174.0,61.71428571428572
90282251.0,6,15,1097,8,596,12897464.42857143,95.0,74.5,7,501,14997268.833333334,95.0,71.57142857142857
298376.0,6,6,412,4,272,99458.66666666669,74.0,68.0,2,140,0.0,74.0,70.0
308764.0,6,6,412,4,272,102921.33333333331,74.0,68.0,2,140,0.0,74.0,70.0
91366366.0,6,24,1829,13,989,7613648.25,95.0,76.07692307692308,11,840,9135908.4,95.0,76.36363636363636
76249.0,6,12,1328,7,797,12708.166666666666,253.0,113.85714285714286,5,531,16897.0,259.0,106.2
101499.0,17,2,286,2,286,0.0,143.0,143.0,0,0,0.0,0.0,0.0
322.0,17,2,174,1,79,0.0,79.0,79.0,1,95,0.0,95.0,95.0
121349.0,6,3,337,2,214,0.0,160.0,107.0,1,123,0.0,123.0,123.0
90260499.0,6,13,2036,8,1016,12894357.0,188.0,127.0,5,1020,22524010.25,204.0,204.0
1466047.0,17,16,1120,16,1120,97736.46666666666,70.0,70.0,0,0,0.0,0.0,0.0
27308354.0,17,5,1710,5,1710,6827088.5,342.0,342.0,0,0,0.0,0.0,0.0
207176.0,6,3,426,2,280,0.0,214.0,140.0,1,146,0.0,146.0,146.0
109804245.0,6,30,1990,15,1042,7827752.0,139.0,69.46666666666667,15,948,7827752.785714285,123.0,63.2
298243.0,6,6,412,4,272,99414.33333333331,74.0,68.0,2,140,0.0,74.0,70.0
147996.0,17,2,180,1,90,0.0,90.0,90.0,1,90,0.0,90.0,90.0
2376.0,17,4,344,2,150,0.0,75.0,75.0,2,194,0.0,103.0,97.0
216336.0,17,2,180,1,90,0.0,90.0,90.0,1,90,0.0,90.0,90.0
104545.0,6,2,132,1,66,0.0,66.0,66.0,1,66,0.0,66.0,66.0
93806374.0,6,177,19954,89,6022,1065981.5227272727,140.0,67.66292134831461,88,13932,1067634.183908046,284.0,158.3181818181818
8729.0,6,10,2032,5,524,1961.5,252.0,104.8,5,1508,1948.5,1236.0,301.6
333.0,17,2,166,1,75,0.0,75.0,75.0,1,91,0.0,91.0,91.0
160195.0,17,2,180,1,90,0.0,90.0,90.0,1,90,0.0,90.0,90.0
303631.0,6,2,132,1,66,0.0,66.0,66.0,1,66,0.0,66.0,66.0
269473.0,17,2,180,1,90,0.0,90.0,90.0,1,90,0.0,90.0,90.0
117507823.0,6,246,27642,123,19302,961415.31147541,284.0,156.9268292682927,123,8340,961415.368852459,140.0,67.8048780487805
4493.0,17,2,180,1,90,0.0,90.0,90.0,1,90,0.0,90.0,90.0
120122648.0,6,15,2428,9,1204,15015331.0,188.0,133.77777777777777,6,1224,18073763.0,204.0,204.0
150244.0,6,3,373,2,238,0.0,172.0,119.0,1,135,0.0,135.0,135.0
124188.0,6,3,373,2,238,0.0,172.0,119.0,1,135,0.0,135.0,135.0
105503.0,17,2,286,2,286,0.0,143.0,143.0,0,0,0.0,0.0,0.0
1034764.0,6,11,1134,6,558,206952.8,220.0,93.0,5,576,257120.5,304.0,115.2
135138804.0,17,6,1206,6,1206,27027760.8,201.0,201.0,0,0,0.0,0.0,0.0
104765139.0,6,28,1860,14,966,8042264.0,123.0,69.0,14,894,8042254.769230769,123.0,63.85714285714285
95580648.0,17,12,778,6,389,19001471.8,174.0,64.83333333333333,6,389,19000194.0,174.0,64.83333333333333
1471917.0,17,16,1120,16,1120,98127.8,70.0,70.0,0,0,0.0,0.0,0.0
74440.0,6,14,4740,7,653,12021.5,249.0,93.28571428571428,7,4087,12270.333333333334,1514.0,583.8571428571429
1586008.0,6,20,7599,11,1469,158600.8,583.0,133.54545454545453,9,6130,165453.625,1484.0,681.1111111111111
17963.0,6,14,4740,7,653,2860.0,249.0,93.28571428571428,7,4087,2859.6666666666665,1514.0,583.8571428571429
17684.0,6,11,2098,6,590,3335.8,252.0,98.33333333333331,5,1508,3856.0,1236.0,301.6
111017068.0,6,31,2182,16,1165,7386732.533333333,139.0,72.8125,15,1017,7914358.357142857,123.0,67.8
30972.0,6,14,4740,7,653,4576.666666666667,249.0,93.28571428571428,7,4087,4964.0,1514.0,583.8571428571429
2473.0,17,4,344,2,150,0.0,75.0,75.0,2,194,0.0,103.0,97.0
108792058.0,6,32,2236,16,1165,7239117.866666666,139.0,72.8125,16,1071,7239127.933333334,123.0,66.9375
101143563.0,17,14,864,7,432,16834530.166666668,174.0,61.71428571428572,7,432,16833493.833333332,174.0,61.71428571428572
14281.0,6,10,2032,5,524,3133.75,252.0,104.8,5,1508,3210.75,1236.0,301.6
30675.0,6,14,4740,7,653,4978.833333333333,249.0,93.28571428571428,7,4087,4938.666666666667,1514.0,583.8571428571429
249162.0,6,3,337,2,214,0.0,160.0,107.0,1,123,0.0,123.0,123.0
90041727.0,17,28,13364,28,13364,3334878.777777778,501.0,477.2857142857143,0,0,0.0,0.0,0.0
53501.0,6,14,4740,7,653,8017.0,249.0,93.28571428571428,7,4087,7443.833333333333,1514.0,583.8571428571429
25211.0,6,14,4740,7,653,3975.1666666666665,249.0,93.28571428571428,7,4087,3386.6666666666665,1514.0,583.8571428571429
120122643.0,6,14,2224,9,1204,15015330.375,188.0,133.77777777777777,5,1020,22522937.25,204.0,204.0
38864.0,6,14,4740,7,653,6302.833333333333,249.0,93.28571428571428,7,4087,6103.333333333333,1514.0,583.8571428571429
121229455.0,6,33,2296,17,1225,7576840.9375,139.0,72.05882352941177,16,1071,7401805.733333333,123.0,66.9375
90082847.0,6,12,1848,5,1020,22520117.25,204.0,204.0,7,828,14967979.666666666,188.0,118.28571428571428
35076.0,6,10,2032,5,524,8071.5,252.0,104.8,5,1508,8378.5,1236.0,301.6
19283.0,6,2,145,2,145,0.0,91.0,72.5,0,0,0.0,0.0,0.0
306.0,17,2,164,1,82,0.0,82.0,82.0,1,82,0.0,82.0,82.0
22212.0,6,10,2032,5,524,5199.0,252.0,104.8,5,1508,4698.0,1236.0,301.6
209389.0,17,2,180,1,90,0.0,90.0,90.0,1,90,0.0,90.0,90.0
35028.0,6,14,4740,7,653,5148.666666666667,249.0,93.28571428571428,7,4087,5656.5,1514.0,583.8571428571429
102640.0,17,2,286,2,286,0.0,143.0,143.0,0,0,0.0,0.0,0.0
33647.0,6,14,4740,7,653,3945.0,249.0,93.28571428571428,7,4087,5418.333333333333,1514.0,583.8571428571429
139338.0,6,2,132,1,66,0.0,66.0,66.0,1,66,0.0,66.0,66.0
4217.0,17,2,614,1,72,0.0,72.0,72.0,1,542,0.0,542.0,542.0
135130055.0,17,6,1206,6,1206,27026011.0,201.0,201.0,0,0,0.0,0.0,0.0
107722.0,17,2,286,2,286,0.0,143.0,143.0,0,0,0.0,0.0,0.0
146116.0,6,3,337,2,214,0.0,160.0,107.0,1,123,0.0,123.0,123.0
104298.0,17,2,286,2,286,0.0,143.0,143.0,0,0,0.0,0.0,0.0
13626.0,17,2,231,1,78,0.0,78.0,78.0,1,153,0.0,153.0,153.0
30906.0,6,14,4740,7,653,4515.0,249.0,93.28571428571428,7,4087,5008.666666666667,1514.0,583.8571428571429
322467.0,6,6,412,4,272,107489.0,74.0,68.0,2,140,0.0,74.0,70.0
108107735.0,17,5,1005,5,1005,27026933.75,201.0,201.0,0,0,0.0,0.0,0.0
214757.0,6,3,426,2,280,0.0,214.0,140.0,1,146,0.0,146.0,146.0
2021714.0,17,4,525,2,150,0.0,75.0,75.0,2,375,0.0,284.0,187.5
2311.0,17,4,344,2,150,0.0,75.0,75.0,2,194,0.0,103.0,97.0
308239.0,6,6,412,4,272,102746.33333333331,74.0,68.0,2,140,0.0,74.0,70.0
52681.0,6,14,4740,7,653,7766.333333333333,249.0,93.28571428571428,7,4087,8304.666666666666,1514.0,583.8571428571429
113847197.0,6,48,3168,24,1584,4949878.130434782,66.0,66.0,24,1584,4940482.043478261,66.0,66.0
197057.0,17,4,6056,4,6056,65685.66666666667,1514.0,1514.0,0,0,0.0,0.0,0.0
108113630.0,17,5,955,5,955,27028407.5,191.0,191.0,0,0,0.0,0.0,0.0
90297360.0,6,21,1585,11,840,9025597.6,95.0,76.36363636363636,10,745,10001817.555555556,95.0,74.5
108113222.0,17,5,955,5,955,27028305.5,191.0,191.0,0,0,0.0,0.0,0.0
90300781.0,6,21,1585,11,840,9025107.1,95.0,76.36363636363636,10,745,10000924.444444444,95.0,74.5
25484.0,6,14,4740,7,653,4117.166666666667,249.0,93.28571428571428,7,4087,4018.8333333333335,1514.0,583.8571428571429
107723.0,17,2,286,2,286,0.0,143.0,143.0,0,0,0.0,0.0,0.0
5015602.0,17,4,849,2,166,0.0,83.0,83.0,2,683,0.0,499.0,341.5
218148.0,6,4,492,2,280,0.0,214.0,140.0,2,212,0.0,146.0,106.0
88978.0,6,14,4740,7,653,14553.666666666666,249.0,93.28571428571428,7,4087,12582.333333333334,1514.0,583.8571428571429
1166824.0,6,13,3010,8,2382,166689.14285714287,1514.0,297.75,5,628,222917.75,331.0,125.6
305329.0,6,3,202,2,128,0.0,74.0,64.0,1,74,0.0,74.0,74.0
10751.0,6,11,1133,6,602,2150.2,264.0,100.33333333333331,5,531,2104.5,259.0,106.2
316858.0,17,4,1400,4,1400,105619.33333333331,350.0,350.0,0,0,0.0,0.0,0.0
45636277.0,17,9,3086,8,2736,5134512.285714285,342.0,342.0,1,350,0.0,350.0,350.0
120123313.0,6,15,2444,7,1428,20020552.166666668,204.0,204.0,8,1016,17137059.42857143,188.0,127.0
2048.0,17,4,344,2,150,0.0,75.0,75.0,2,194,0.0,103.0,97.0
59818.0,6,10,2032,5,524,14443.25,252.0,104.8,5,1508,14349.75,1236.0,301.6
123324.0,6,3,337,2,214,0.0,160.0,107.0,1,123,0.0,123.0,123.0
112234.0,17,4,1400,4,1400,37411.333333333336,350.0,350.0,0,0,0.0,0.0,0.0
330.0,17,2,166,1,75,0.0,75.0,75.0,1,91,0.0,91.0,91.0
48767.0,6,14,4740,7,653,7802.666666666667,249.0,93.28571428571428,7,4087,7062.833333333333,1514.0,583.8571428571429
55844.0,6,10,1065,5,534,13716.75,262.0,106.8,5,531,11418.0,259.0,106.2
28958.0,6,20,7606,11,978,2895.8,310.0,88.9090909090909,9,6628,3360.875,1514.0,736.4444444444445
39512.0,6,14,4740,7,653,6466.0,249.0,93.28571428571428,7,4087,6104.833333333333,1514.0,583.8571428571429
26893.0,6,14,4740,7,653,4331.166666666667,249.0,93.28571428571428,7,4087,4044.1666666666665,1514.0,583.8571428571429
113610637.0,6,46,3036,23,1518,5150437.454545454,66.0,66.0,23,1518,5150433.318181818,66.0,66.0
90045604.0,17,28,13364,28,13364,3335022.3703703703,501.0,477.2857142857143,0,0,0.0,0.0,0.0
219011.0,6,10,1221,6,636,43802.2,298.0,106.0,4,585,71828.0,379.0,146.25
112979600.0,6,45,2970,23,1518,5135436.363636363,66.0,66.0,22,1452,5243696.619047619,66.0,66.0
33483.0,6,10,1066,5,490,7851.0,218.0,98.0,5,576,7519.75,304.0,115.2
7407137.0,17,6,1665,3,273,3699023.0,103.0,91.0,3,1392,3573645.0,545.0,464.0
217430.0,6,3,426,2,280,0.0,214.0,140.0,1,146,0.0,146.0,146.0
9003.0,6,11,2098,6,590,1610.6,252.0,98.33333333333331,5,1508,1938.75,1236.0,301.6
113628509.0,17,14,864,7,432,18834260.0,174.0,61.71428571428572,7,432,18833490.666666668,174.0,61.71428571428572
216154.0,17,2,180,1,90,0.0,90.0,90.0,1,90,0.0,90.0,90.0
135132570.0,17,6,1206,6,1206,27026514.0,201.0,201.0,0,0,0.0,0.0,0.0
237722.0,6,3,337,2,214,0.0,160.0,107.0,1,123,0.0,123.0,123.0
107294.0,17,2,286,2,286,0.0,143.0,143.0,0,0,0.0,0.0,0.0
108094274.0,17,5,955,5,955,27023568.5,191.0,191.0,0,0,0.0,0.0,0.0
90287947.0,6,16,1192,8,596,12891276.0,95.0,74.5,8,596,12895811.285714284,95.0,74.5
4601539.0,6,5,336,2,134,0.0,68.0,67.0,3,202,1527123.0,70.0,67.33333333333333
93145919.0,6,174,19666,87,13776,1080589.976744186,284.0,158.3448275862069,87,5890,1080589.6976744186,140.0,67.70114942528735
0.0,17,1,381,1,381,0.0,381.0,381.0,0,0,0.0,0.0,0.0
198792.0,17,2,180,1,90,0.0,90.0,90.0,1,90,0.0,90.0,90.0
1961.0,17,4,438,2,148,0.0,74.0,74.0,2,290,0.0,147.0,145.0
300999.0,6,6,412,4,272,100333.0,74.0,68.0,2,140,0.0,74.0,70.0
112830.0,17,2,762,2,762,0.0,381.0,381.0,0,0,0.0,0.0,0.0
9648.0,6,11,2098,6,590,1779.4,252.0,98.33333333333331,5,1508,2092.0,1236.0,301.6
106991234.0,6,30,2106,15,1089,7626829.142857143,123.0,72.6,15,1017,7626823.5,123.0,67.8
65267.00000000001,6,10,2032,5,524,16092.0,252.0,104.8,5,1508,15838.75,1236.0,301.6
29250.0,6,13,1479,7,882,4875.0,291.0,126.0,6,597,4651.2,259.0,99.5
16881.0,6,14,4740,7,653,2563.833333333333,249.0,93.28571428571428,7,4087,2678.0,1514.0,583.8571428571429
3223211.0,17,3,1026,3,1026,1611605.5,342.0,342.0,0,0,0.0,0.0,0.0
108098874.0,17,5,1005,5,1005,27024718.5,201.0,201.0,0,0,0.0,0.0,0.0
16796.0,6,14,4740,7,653,2513.6666666666665,249.0,93.28571428571428,7,4087,2662.833333333333,1514.0,583.8571428571429
108116059.0,17,5,1005,5,1005,27029014.75,201.0,201.0,0,0,0.0,0.0,0.0
197940.0,17,2,180,1,90,0.0,90.0,90.0,1,90,0.0,90.0,90.0
2647.0,17,2,762,2,762,0.0,381.0,381.0,0,0,0.0,0.0,0.0
215156.0,6,3,426,2,280,0.0,214.0,140.0,1,146,0.0,146.0,146.0
205908.0,17,2,180,1,90,0.0,90.0,90.0,1,90,0.0,90.0,90.0
108123452.0,17,5,955,5,955,27030863.0,191.0,191.0,0,0,0.0,0.0,0.0
25419.0,6,14,4740,7,653,3980.3333333333335,249.0,93.28571428571428,7,4087,3828.0,1514.0,583.8571428571429
298798.0,6,6,412,4,272,99599.33333333331,74.0,68.0,2,140,0.0,74.0,70.0
16694.0,6,14,4740,7,653,2588.1666666666665,249.0,93.28571428571428,7,4087,2339.333333333333,1514.0,583.8571428571429
144817.0,17,2,180,1,70,0.0,70.0,70.0,1,110,0.0,110.0,110.0
239133.0,17,2,180,1,90,0.0,90.0,90.0,1,90,0.0,90.0,90.0
5627396.0,6,5,336,2,134,0.0,68.0,67.0,3,202,1526817.5,70.0,67.33333333333333
90241432.0,6,13,2036,8,1016,12891633.142857144,188.0,127.0,5,1020,22519185.0,204.0,204.0
220549.0,6,3,426,2,280,0.0,214.0,140.0,1,146,0.0,146.0,146.0
147971.0,17,2,180,1,90,0.0,90.0,90.0,1,90,0.0,90.0,90.0
135134793.0,17,6,1206,6,1206,27026958.6,201.0,201.0,0,0,0.0,0.0,0.0
32383.000000000004,6,10,2032,5,524,7503.25,252.0,104.8,5,1508,7804.25,1236.0,301.6
120124668.0,6,14,2240,6,1224,24024933.6,204.0,204.0,8,1016,17137677.285714287,188.0,127.0
43345.0,6,14,4740,7,653,6208.333333333333,249.0,93.28571428571428,7,4087,7056.833333333333,1514.0,583.8571428571429
204542.0,17,2,762,2,762,0.0,381.0,381.0,0,0,0.0,0.0,0.0
108108313.0,17,5,955,5,955,27027078.25,191.0,191.0,0,0,0.0,0.0,0.0
320.0,17,2,174,1,79,0.0,79.0,79.0,1,95,0.0,95.0,95.0
55278.0,6,14,4740,7,653,8164.666666666667,249.0,93.28571428571428,7,4087,8746.166666666666,1514.0,583.8571428571429
309381.0,17,4,1400,4,1400,103127.0,350.0,350.0,0,0,0.0,0.0,0.0
307.0,17,2,164,1,82,0.0,82.0,82.0,1,82,0.0,82.0,82.0
319716.0,6,6,412,4,272,106572.0,74.0,68.0,2,140,0.0,74.0,70.0
135140999.0,17,6,1146,6,1146,27028199.8,191.0,191.0,0,0,0.0,0.0,0.0
283212.0,17,2,582,1,83,0.0,83.0,83.0,1,499,0.0,499.0,499.0
1311752.0,6,4,264,2,132,0.0,66.0,66.0,2,132,0.0,66.0,66.0
34102.0,6,14,4740,7,653,5558.333333333333,249.0,93.28571428571428,7,4087,5146.166666666667,1514.0,583.8571428571429
48898.0,6,14,4740,7,653,8013.666666666667,249.0,93.28571428571428,7,4087,6184.5,1514.0,583.8571428571429
120112163.0,6,12,1832,8,1016,17135697.0,188.0,127.0,4,816,30032038.33333333,204.0,204.0
43504.0,6,14,4740,7,653,7129.833333333333,249.0,93.28571428571428,7,4087,6395.666666666667,1514.0,583.8571428571429
845061.0,6,9,1118,6,586,169012.2,248.0,97.66666666666669,3,532,284736.5,392.0,177.33333333333334
101171706.0,17,24,10872,24,10872,4398769.826086956,453.0,453.0,0,0,0.0,0.0,0.0
2017.0,17,2,176,1,80,0.0,80.0,80.0,1,96,0.0,96.0,96.0
2024.0,17,4,344,2,150,0.0,75.0,75.0,2,194,0.0,103.0,97.0
228249.0,17,2,180,1,90,0.0,90.0,90.0,1,90,0.0,90.0,90.0
273290.0,6,10,1221,6,636,54658.0,298.0,106.0,4,585,85683.0,379.0,146.25
216452.0,17,2,180,1,90,0.0,90.0,90.0,1,90,0.0,90.0,90.0
120121844.0,6,13,2020,9,1204,15015230.5,188.0,133.77777777777777,4,816,30030084.666666668,204.0,204.0
113699460.0,6,46,3036,23,1518,5168146.227272728,66.0,66.0,23,1518,5168143.181818182,66.0,66.0
272043.0,6,10,1221,6,636,54408.6,298.0,106.0,4,585,83441.0,379.0,146.25
20640.0,6,14,4740,7,653,3221.5,249.0,93.28571428571428,7,4087,3299.1666666666665,1514.0,583.8571428571429
42270.0,6,10,2032,5,524,8922.5,252.0,104.8,5,1508,10277.0,1236.0,301.6
41316.0,6,14,4740,7,653,6763.833333333333,249.0,93.28571428571428,7,4087,6525.166666666667,1514.0,583.8571428571429
91718719.0,6,25,1924,14,1084,7050669.692307692,95.0,77.42857142857143,11,840,9096067.0,95.0,76.36363636363636
2077.0,17,4,344,2,150,0.0,75.0,75.0,2,194,0.0,103.0,97.0
69474.0,17,2,620,1,75,0.0,75.0,75.0,1,545,0.0,545.0,545.0
301.0,17,2,174,1,79,0.0,79.0,79.0,1,95,0.0,95.0,95.0
171621.0,17,2,180,1,90,0.0,90.0,90.0,1,90,0.0,90.0,90.0
44531421.0,6,5,1911,2,894,0.0,826.0,447.0,3,1017,20941893.0,885.0,339.0
206404.0,6,3,426,2,280,0.0,214.0,140.0,1,146,0.0,146.0,146.0
120158892.0,6,14,2224,9,1204,15019861.5,188.0,133.77777777777777,5,1020,22593111.25,204.0,204.0
33724.0,6,14,4740,7,653,5407.666666666667,249.0,93.28571428571428,7,4087,5469.833333333333,1514.0,583.8571428571429
144849.0,17,2,180,1,70,0.0,70.0,70.0,1,110,0.0,110.0,110.0
213702.0,17,2,180,1,90,0.0,90.0,90.0,1,90,0.0,90.0,90.0
128004673.0,17,15,907,8,475,18286381.85714286,174.0,59.375,7,432,18000160.333333332,174.0,61.71428571428572
100585940.0,17,12,516,6,258,20000538.0,43.0,43.0,6,258,20000153.4,43.0,43.0
2048600.0,17,6,1039,4,312,682739.0000000001,78.0,78.0,2,727,0.0,395.0,363.5
90301316.0,6,32,3553,16,1980,6020087.733333333,342.0,123.75,16,1573,6000021.066666666,427.0,98.3125
204722.0,17,2,762,2,762,0.0,381.0,381.0,0,0,0.0,0.0,0.0
304.0,17,2,164,1,82,0.0,82.0,82.0,1,82,0.0,82.0,82.0
103556.0,17,2,286,2,286,0.0,143.0,143.0,0,0,0.0,0.0,0.0
1284004.0,17,7,490,7,490,214000.66666666663,70.0,70.0,0,0,0.0,0.0,0.0
120053572.0,17,28,13364,28,13364,4446428.592592592,501.0,477.2857142857143,0,0,0.0,0.0,0.0
55432.0,6,14,4740,7,653,9075.0,249.0,93.28571428571428,7,4087,9013.166666666666,1514.0,583.8571428571429
218824.0,6,3,426,2,280,0.0,214.0,140.0,1,146,0.0,146.0,146.0
116404507.0,6,47,3102,24,1584,5061054.391304348,66.0,66.0,23,1518,5160002.318181818,66.0,66.0
298.0,17,2,164,1,82,0.0,82.0,82.0,1,82,0.0,82.0,82.0
281349.0,17,2,363,1,79,0.0,79.0,79.0,1,284,0.0,284.0,284.0
6510.0,17,4,344,2,150,0.0,75.0,75.0,2,194,0.0,103.0,97.0
364808.0,6,11,1021,6,444,49196.6,162.0,74.0,5,577,61318.5,349.0,115.4
33715.0,6,14,4740,7,653,5250.5,249.0,93.28571428571428,7,4087,4732.333333333333,1514.0,583.8571428571429
41070.0,6,10,2032,5,524,8359.25,252.0,104.8,5,1508,9995.0,1236.0,301.6
24198.0,6,10,2032,5,524,5647.5,252.0,104.8,5,1508,5094.25,1236.0,301.6
36841.0,6,10,2032,5,524,7157.75,252.0,104.8,5,1508,8560.25,1236.0,301.6
36911.0,6,14,4740,7,653,5983.5,249.0,93.28571428571428,7,4087,5373.333333333333,1514.0,583.8571428571429
240007.0,6,3,337,2,214,0.0,160.0,107.0,1,123,0.0,123.0,123.0
280675.0,17,2,363,1,79,0.0,79.0,79.0,1,284,0.0,284.0,284.0
75197.0,6,12,1328,7,797,12532.833333333334,253.0,113.85714285714286,5,531,12563.0,259.0,106.2
45418.0,6,10,2032,5,524,11153.25,252.0,104.8,5,1508,10119.0,1236.0,301.6
47703354.0,6,7,1874,3,887,22562365.0,753.0,295.6666666666667,4,987,15006857.0,785.0,246.75
9244.0,17,2,582,1,83,0.0,83.0,83.0,1,499,0.0,499.0,499.0
234423.0,17,2,180,1,90,0.0,90.0,90.0,1,90,0.0,90.0,90.0
135138226.0,17,6,1146,6,1146,27027645.2,191.0,191.0,0,0,0.0,0.0,0.0
2926076.0,6,3,204,2,136,0.0,70.0,68.0,1,68,0.0,68.0,68.0
135130286.0,17,6,1146,6,1146,27026057.2,191.0,191.0,0,0,0.0,0.0,0.0
135106512.0,17,6,1206,6,1206,27021302.4,201.0,201.0,0,0,0.0,0.0,0.0
15028872.0,17,6,2718,6,2718,3005774.4,453.0,453.0,0,0,0.0,0.0,0.0
15460.0,6,10,2032,5,524,3657.5,252.0,104.8,5,1508,3474.25,1236.0,301.6
232522.0,6,3,337,2,214,0.0,160.0,107.0,1,123,0.0,123.0,123.0
52967.0,6,14,4740,7,653,7881.333333333333,249.0,93.28571428571428,7,4087,8684.333333333334,1514.0,583.8571428571429
21455.0,6,10,2032,5,524,5128.5,252.0,104.8,5,1508,5067.5,1236.0,301.6
90298574.0,6,16,1192,8,596,12890942.57142857,95.0,74.5,8,596,12898292.857142856,95.0,74.5
205636.0,17,2,180,1,90,0.0,90.0,90.0,1,90,0.0,90.0,90.0
90265450.0,6,13,2036,8,1016,12895064.285714284,188.0,127.0,5,1020,22523930.75,204.0,204.0
25694.0,6,14,4740,7,653,4080.5,249.0,93.28571428571428,7,4087,4146.333333333333,1514.0,583.8571428571429
103489.0,17,2,286,2,286,0.0,143.0,143.0,0,0,0.0,0.0,0.0
147794.0,6,3,373,2,238,0.0,172.0,119.0,1,135,0.0,135.0,135.0
2599752.0,6,2,132,1,66,0.0,66.0,66.0,1,66,0.0,66.0,66.0
0.0,6,1,172,1,172,0.0,172.0,172.0,0,0,0.0,0.0,0.0
2600049.0,6,2,132,1,66,0.0,66.0,66.0,1,66,0.0,66.0,66.0
120075270.0,17,29,13785,29,13785,4288402.5,501.0,475.3448275862069,0,0,0.0,0.0,0.0
135138051.0,17,6,1146,6,1146,27027610.2,191.0,191.0,0,0,0.0,0.0,0.0
153401.0,17,2,180,1,90,0.0,90.0,90.0,1,90,0.0,90.0,90.0
7952.000000000001,6,10,1975,5,467,1778.25,195.0,93.4,5,1508,1734.75,1236.0,301.6
258420.0,6,3,337,2,214,0.0,160.0,107.0,1,123,0.0,123.0,123.0
119333774.0,6,223,25118,112,7688,1075079.045045045,140.0,68.64285714285714,111,17430,1076323.1636363636,284.0,157.02702702702703
148727.0,17,2,414,1,88,0.0,88.0,88.0,1,326,0.0,326.0,326.0
147936.0,17,2,180,1,90,0.0,90.0,90.0,1,90,0.0,90.0,90.0
931276.0,6,12,1362,6,731,184803.8,253.0,121.83333333333331,6,631,185380.8,293.0,105.16666666666669
307812.0,6,6,412,4,272,102604.0,74.0,68.0,2,140,0.0,74.0,70.0
36348.0,6,14,4740,7,653,5937.166666666667,249.0,93.28571428571428,7,4087,5918.0,1514.0,583.8571428571429
2071.0,17,4,344,2,150,0.0,75.0,75.0,2,194,0.0,103.0,97.0
99166.0,17,2,286,2,286,0.0,143.0,143.0,0,0,0.0,0.0,0.0
309253.0,17,4,622,4,622,103084.33333333331,163.0,155.5,0,0,0.0,0.0,0.0
204637.0,17,2,762,2,762,0.0,381.0,381.0,0,0,0.0,0.0,0.0
15510.0,6,10,2032,5,524,3632.5,252.0,104.8,5,1508,3614.25,1236.0,301.6
312543.0,6,6,412,4,272,104181.0,74.0,68.0,2,140,0.0,74.0,70.0
120060744.0,17,28,13364,28,13364,4446694.222222222,501.0,477.2857142857143,0,0,0.0,0.0,0.0
90093209.0,6,12,1848,5,1020,22523006.75,204.0,204.0,7,828,15015345.666666666,188.0,118.28571428571428
307419.0,6,3,202,2,128,0.0,74.0,64.0,1,74,0.0,74.0,74.0
109243.0,17,2,700,2,700,0.0,350.0,350.0,0,0,0.0,0.0,0.0
2594099.0,6,2,132,1,66,0.0,66.0,66.0,1,66,0.0,66.0,66.0
27636.0,6,10,2032,5,524,6283.5,252.0,104.8,5,1508,6646.25,1236.0,301.6
108107782.0,17,5,1005,5,1005,27026945.5,201.0,201.0,0,0,0.0,0.0,0.0
90036642.0,17,27,12943,27,12943,3462947.769230769,501.0,479.3703703703704,0,0,0.0,0.0,0.0
120055445.0,17,28,13364,28,13364,4446497.962962963,501.0,477.2857142857143,0,0,0.0,0.0,0.0
521736.0,17,6,2100,6,2100,104347.2,350.0,350.0,0,0,0.0,0.0,0.0
90290373.0,6,16,1192,8,596,12892824.857142856,95.0,74.5,8,596,12898363.0,95.0,74.5
108113390.0,17,5,955,5,955,27028347.5,191.0,191.0,0,0,0.0,0.0,0.0
17023.0,6,10,2032,5,524,3948.75,252.0,104.8,5,1508,3906.5,1236.0,301.6
30069.0,6,14,4740,7,653,4633.5,249.0,93.28571428571428,7,4087,4772.333333333333,1514.0,583.8571428571429
121222.0,6,3,337,2,214,0.0,160.0,107.0,1,123,0.0,123.0,123.0
507418.00000000006,6,5,336,2,134,0.0,68.0,67.0,3,202,191944.0,70.0,67.33333333333333
32502.000000000004,6,14,4740,7,653,5203.0,249.0,93.28571428571428,7,4087,4405.666666666667,1514.0,583.8571428571429
220641.0,17,2,180,1,90,0.0,90.0,90.0,1,90,0.0,90.0,90.0
105666799.0,6,33,2428,17,1288,6604174.9375,139.0,75.76470588235294,16,1140,7029970.466666667,123.0,71.25
4281.0,17,2,598,1,72,0.0,72.0,72.0,1,526,0.0,526.0,526.0
66746.0,6,14,4740,7,653,10993.833333333334,249.0,93.28571428571428,7,4087,10022.666666666666,1514.0,583.8571428571429
3502.0,17,4,571,2,148,0.0,74.0,74.0,2,423,0.0,280.0,211.5
107618.0,17,2,286,2,286,0.0,143.0,143.0,0,0,0.0,0.0,0.0
91003914.0,17,11,735,6,389,18200782.8,174.0,64.83333333333333,5,346,17750166.0,174.0,69.2
108108657.0,17,5,1005,5,1005,27027164.25,201.0,201.0,0,0,0.0,0.0,0.0
90224645.0,6,16,1192,8,596,12853727.142857144,95.0,74.5,8,596,12858476.857142856,95.0,74.5
46301.0,6,14,4740,7,653,7555.166666666667,249.0,93.28571428571428,7,4087,7415.0,1514.0,583.8571428571429
109348302.0,6,29,2052,15,1089,7795138.428571428,123.0,72.6,14,963,8394773.76923077,123.0,68.78571428571429
142325.0,6,2,132,1,66,0.0,66.0,66.0,1,66,0.0,66.0,66.0
135142446.0,17,6,1146,6,1146,27028489.2,191.0,191.0,0,0,0.0,0.0,0.0
207032.0,6,3,426,2,280,0.0,214.0,140.0,1,146,0.0,146.0,146.0
90021541.0,17,28,13364,28,13364,3334131.1481481483,501.0,477.2857142857143,0,0,0.0,0.0,0.0
90252661.0,6,14,1043,7,542,15042110.166666666,95.0,77.42857142857143,7,501,14993993.833333334,95.0,71.57142857142857
305316.0,6,6,412,4,272,101772.0,74.0,68.0,2,140,0.0,74.0,70.0
119854203.0,6,15,2306,6,1224,23970247.6,204.0,204.0,9,1082,14981625.0,188.0,120.22222222222224
90027921.0,17,28,13364,28,13364,3334367.4444444445,501.0,477.2857142857143,0,0,0.0,0.0,0.0
135128716.0,17,6,1146,6,1146,27025743.2,191.0,191.0,0,0,0.0,0.0,0.0
59370.0,6,14,4740,7,653,9288.833333333334,249.0,93.28571428571428,7,4087,9698.5,1514.0,583.8571428571429
27142637.0,17,5,1710,5,1710,6785659.25,342.0,342.0,0,0,0.0,0.0,0.0
132289.0,17,2,286,2,286,0.0,143.0,143.0,0,0,0.0,0.0,0.0
130797.0,6,13,1513,7,882,20384.166666666668,291.0,126.0,6,631,25777.6,293.0,105.16666666666669
15243.0,17,2,180,1,90,0.0,90.0,90.0,1,90,0.0,90.0,90.0
90315421.0,6,18,1382,10,786,10027351.777777778,95.0,78.6,8,596,12836515.0,95.0,74.5
392115.0,17,2,363,1,75,0.0,75.0,75.0,1,288,0.0,288.0,288.0
108115935.0,17,5,955,5,955,27028983.75,191.0,191.0,0,0,0.0,0.0,0.0
42133.0,6,10,2032,5,524,10319.25,252.0,104.8,5,1508,7715.0,1236.0,301.6
18388.0,6,11,1133,6,602,3494.8,264.0,100.33333333333331,5,531,3822.0,259.0,106.2
4596982.0,6,5,336,2,134,0.0,68.0,67.0,3,202,1423402.5,70.0,67.33333333333333
208154.0,6,3,426,2,280,0.0,214.0,140.0,1,146,0.0,146.0,146.0
107237.0,17,2,286,2,286,0.0,143.0,143.0,0,0,0.0,0.0,0.0
12235.0,6,10,2032,5,524,2602.5,252.0,104.8,5,1508,2722.75,1236.0,301.6
14077.0,6,13,1459,7,862,2288.333333333333,271.0,123.14285714285714,6,597,2538.2,259.0,99.5
10509031.0,6,7,478,4,272,3457431.0,74.0,68.0,3,206,5186019.5,74.0,68.66666666666667
9919.0,17,4,823,2,163,0.0,89.0,81.5,2,660,0.0,443.0,330.0
40527.0,6,14,4740,7,653,6050.0,249.0,93.28571428571428,7,4087,6620.5,1514.0,583.8571428571429
10456291.0,6,7,478,4,272,3439864.333333333,74.0,68.0,3,206,5159679.0,74.0,68.66666666666667
318109.0,6,5,336,3,202,159054.5,70.0,67.33333333333333,2,134,0.0,68.0,67.0
113952102.0,6,48,3168,24,1584,4954439.217391305,66.0,66.0,24,1584,4940850.521739131,66.0,66.0
228356.0,17,2,180,1,90,0.0,90.0,90.0,1,90,0.0,90.0,90.0
205003.0,6,10,1221,6,636,41000.6,298.0,106.0,4,585,67161.66666666667,379.0,146.25
198149.0,17,2,180,1,90,0.0,90.0,90.0,1,90,0.0,90.0,90.0
98269400.0,17,12,778,6,389,19622095.6,174.0,64.83333333333333,6,389,19603779.2,174.0,64.83333333333333
307910.0,6,6,412,4,272,102636.66666666669,74.0,68.0,2,140,0.0,74.0,70.0
706.0,17,4,438,2,148,0.0,74.0,74.0,2,290,0.0,147.0,145.0
90029458.0,17,27,12943,27,12943,3462671.461538461,501.0,479.3703703703704,0,0,0.0,0.0,0.0
119691316.0,6,34,2350,17,1225,7467199.3125,139.0,72.05882352941177,17,1125,7467207.4375,123.0,66.17647058823529
38788.0,6,14,4740,7,653,6338.333333333333,249.0,93.28571428571428,7,4087,6253.166666666667,1514.0,583.8571428571429
489916.0,6,5,367,2,132,0.0,66.0,66.0,3,235,244958.0,103.0,78.33333333333333
308126.0,6,6,412,4,272,102708.66666666669,74.0,68.0,2,140,0.0,74.0,70.0
103512767.0,17,14,864,7,432,17252127.833333332,174.0,61.71428571428572,7,432,17190908.666666668,174.0,61.71428571428572
398.0,17,2,174,1,79,0.0,79.0,79.0,1,95,0.0,95.0,95.0
2328.0,17,4,344,2,150,0.0,75.0,75.0,2,194,0.0,103.0,97.0
123287623.0,6,49,3234,24,1584,4925596.0,66.0,66.0,25,1650,5136965.583333333,66.0,66.0
212725.0,6,3,426,2,280,0.0,214.0,140.0,1,146,0.0,146.0,146.0
119956029.0,6,25,1883,12,894,10883024.454545457,95.0,74.5,13,989,9981662.25,95.0,76.07692307692308
0.0,17,1,90,1,90,0.0,90.0,90.0,0,0,0.0,0.0,0.0
1792345.0,17,3,1026,3,1026,896172.5,342.0,342.0,0,0,0.0,0.0,0.0
1855833.0,6,4,276,2,128,0.0,74.0,64.0,2,148,0.0,74.0,74.0
196981.0,17,2,180,1,90,0.0,90.0,90.0,1,90,0.0,90.0,90.0
2799341.0,6,2,132,1,66,0.0,66.0,66.0,1,66,0.0,66.0,66.0
107323.0,17,2,286,2,286,0.0,143.0,143.0,0,0,0.0,0.0,0.0
736640.0,6,11,1021,6,444,98754.2,162.0,74.0,5,577,122993.5,349.0,115.4
120159.0,17,2,180,1,70,0.0,70.0,70.0,1,110,0.0,110.0,110.0
2021071.0,17,4,525,2,150,0.0,75.0,75.0,2,375,0.0,284.0,187.5
108119250.0,17,5,1005,5,1005,27029812.5,201.0,201.0,0,0,0.0,0.0,0.0
2301248.0,6,24,6503,14,2100,177019.07692307694,544.0,150.0,10,4403,229137.22222222225,1514.0,440.3
946565.0,6,12,2717,7,742,157760.83333333334,338.0,106.0,5,1975,167744.0,1514.0,395.0
3042.0,17,2,224,1,76,0.0,76.0,76.0,1,148,0.0,148.0,148.0
100538.0,17,4,6056,4,6056,33512.666666666664,1514.0,1514.0,0,0,0.0,0.0,0.0
1133593.0,6,13,3011,8,2383,161941.85714285713,1514.0,297.875,5,628,214444.0,331.0,125.6
129001142.0,17,15,907,8,475,18428734.57142857,174.0,59.375,7,432,18167570.666666668,174.0,61.71428571428572
2483213.0,6,3,1604,1,753,0.0,753.0,753.0,2,851,0.0,785.0,425.5
148075.0,17,2,180,1,90,0.0,90.0,90.0,1,90,0.0,90.0,90.0
37010.0,6,14,4740,7,653,6046.5,249.0,93.28571428571428,7,4087,6017.666666666667,1514.0,583.8571428571429
302761.0,6,6,412,4,272,100920.33333333331,74.0,68.0,2,140,0.0,74.0,70.0
47049.0,6,14,4740,7,653,7669.0,249.0,93.28571428571428,7,4087,6815.333333333333,1514.0,583.8571428571429
93838256.0,6,209,24004,105,7078,902290.9230769232,140.0,67.4095238095238,104,16926,903273.1262135922,300.0,162.75
90300086.0,6,16,1192,8,596,12892911.0,95.0,74.5,8,596,12898186.57142857,95.0,74.5
48624.0,6,10,2032,5,524,11906.0,252.0,104.8,5,1508,11325.25,1236.0,301.6
50759.0,17,2,180,1,90,0.0,90.0,90.0,1,90,0.0,90.0,90.0
3047830.0,17,3,1026,3,1026,1523915.0,342.0,342.0,0,0,0.0,0.0,0.0
1114090.0,6,4,264,3,198,531220.5,66.0,66.0,1,66,0.0,66.0,66.0
109000964.0,17,13,821,7,432,18166827.33333333,174.0,61.71428571428572,6,389,17802070.2,174.0,64.83333333333333
135603829.0,17,14,864,7,432,19333500.33333333,174.0,61.71428571428572,7,432,19334437.33333333,174.0,61.71428571428572
55215.0,6,14,4740,7,653,8430.166666666666,249.0,93.28571428571428,7,4087,8082.333333333333,1514.0,583.8571428571429
229265.0,17,2,180,1,90,0.0,90.0,90.0,1,90,0.0,90.0,90.0
135130645.0,17,6,1146,6,1146,27026129.0,191.0,191.0,0,0,0.0,0.0,0.0
143840.0,17,2,180,1,90,0.0,90.0,90.0,1,90,0.0,90.0,90.0
120035393.0,17,29,13785,29,13785,4286978.321428572,501.0,475.3448275862069,0,0,0.0,0.0,0.0
1303311.0,6,4,264,2,132,0.0,66.0,66.0,2,132,0.0,66.0,66.0
40769.0,6,14,4740,7,653,4922.166666666667,249.0,93.28571428571428,7,4087,6139.0,1514.0,583.8571428571429
205802.0,6,3,426,2,280,0.0,214.0,140.0,1,146,0.0,146.0,146.0
108104961.0,17,5,955,5,955,27026240.25,191.0,191.0,0,0,0.0,0.0,0.0
303684.0,6,6,412,4,272,101228.0,74.0,68.0,2,140,0.0,74.0,70.0
135134709.0,17,6,1146,6,1146,27026941.8,191.0,191.0,0,0,0.0,0.0,0.0
208838.0,17,2,359,1,75,0.0,75.0,75.0,1,284,0.0,284.0,284.0
108102566.0,17,5,1005,5,1005,27025641.5,201.0,201.0,0,0,0.0,0.0,0.0
217512.0,6,3,426,2,280,0.0,214.0,140.0,1,146,0.0,146.0,146.0
3017022.0,6,3,1604,2,851,0.0,785.0,425.5,1,753,0.0,753.0,753.0
6842.0,17,2,582,1,83,0.0,83.0,83.0,1,499,0.0,499.0,499.0
2253.0,17,4,344,2,150,0.0,75.0,75.0,2,194,0.0,103.0,97.0
90046703.0,17,28,13364,28,13364,3335063.074074074,501.0,477.2857142857143,0,0,0.0,0.0,0.0
36316.0,6,14,4740,7,653,5032.833333333333,249.0,93.28571428571428,7,4087,5693.0,1514.0,583.8571428571429
102909.0,17,2,286,2,286,0.0,143.0,143.0,0,0,0.0,0.0,0.0
19454.0,6,20,7606,11,978,1945.4,310.0,88.9090909090909,9,6628,2083.25,1514.0,736.4444444444445
14626695.0,6,19,1635,9,1003,1790564.5,315.0,111.44444444444444,10,632,1591729.3333333333,78.0,63.2
0.0,17,1,347,1,347,0.0,347.0,347.0,0,0,0.0,0.0,0.0
329.0,17,2,166,1,75,0.0,75.0,75.0,1,91,0.0,91.0,91.0
1310452.0,6,4,264,2,132,0.0,66.0,66.0,2,132,0.0,66.0,66.0
53322.0,6,14,4740,7,653,8399.333333333334,249.0,93.28571428571428,7,4087,7290.5,1514.0,583.8571428571429
90309414.0,6,25,3179,12,1724,8205895.090909091,424.0,143.66666666666666,13,1455,7525076.666666667,362.0,111.92307692307692
90034092.0,17,27,12943,27,12943,3462849.6923076925,501.0,479.3703703703704,0,0,0.0,0.0,0.0
3416.0,17,2,352,1,72,0.0,72.0,72.0,1,280,0.0,280.0,280.0
90727920.0,6,15,2302,9,1204,11322910.625,188.0,133.77777777777777,6,1098,18110056.6,204.0,183.0
2256.0,17,4,344,2,150,0.0,75.0,75.0,2,194,0.0,103.0,97.0
90276045.0,6,16,1192,8,596,12890722.57142857,95.0,74.5,8,596,12895267.42857143,95.0,74.5
2867035.0,6,3,1777,2,951,0.0,885.0,475.5,1,826,0.0,826.0,826.0
12502.0,17,4,823,2,163,0.0,89.0,81.5,2,660,0.0,443.0,330.0
162291.0,17,2,180,1,90,0.0,90.0,90.0,1,90,0.0,90.0,90.0
92237660.0,17,12,778,6,389,18401552.6,174.0,64.83333333333333,6,389,18400159.6,174.0,64.83333333333333
934993.0,17,10,3776,10,3776,103888.11111111112,394.0,377.6,0,0,0.0,0.0,0.0
108106726.0,17,5,1005,5,1005,27026681.5,201.0,201.0,0,0,0.0,0.0,0.0
135127207.0,17,6,1206,6,1206,27025441.4,201.0,201.0,0,0,0.0,0.0,0.0
0.0,6,1,66,1,66,0.0,66.0,66.0,0,0,0.0,0.0,0.0
146299.0,6,3,337,2,214,0.0,160.0,107.0,1,123,0.0,123.0,123.0
125001217.0,17,15,907,8,475,17857316.714285713,174.0,59.375,7,432,17501490.333333332,174.0,61.71428571428572
108106431.0,17,5,955,5,955,27026607.75,191.0,191.0,0,0,0.0,0.0,0.0
228409.0,17,2,180,1,90,0.0,90.0,90.0,1,90,0.0,90.0,90.0
105825337.0,6,28,1860,14,966,8123808.461538462,123.0,69.0,14,894,8123803.230769231,123.0,63.85714285714285
146166.0,6,3,337,2,214,0.0,160.0,107.0,1,123,0.0,123.0,123.0
41120.0,6,14,4740,7,653,6727.0,249.0,93.28571428571428,7,4087,6712.666666666667,1514.0,583.8571428571429
35562322.0,6,26,7627,14,3735,206924.38461538465,1514.0,266.7857142857143,12,3892,3213304.4545454546,1514.0,324.3333333333333
135137429.0,17,6,1146,6,1146,27027485.8,191.0,191.0,0,0,0.0,0.0,0.0
395046.0,6,3,204,2,136,0.0,70.0,68.0,1,68,0.0,68.0,68.0
232906.0,6,3,337,2,214,0.0,160.0,107.0,1,123,0.0,123.0,123.0
0.0,17,1,44,1,44,0.0,44.0,44.0,0,0,0.0,0.0,0.0
15569.0,6,20,7606,11,978,1556.9,310.0,88.9090909090909,9,6628,1728.75,1514.0,736.4444444444445
153481.0,17,2,180,1,90,0.0,90.0,90.0,1,90,0.0,90.0,90.0
726.0,17,2,684,2,684,0.0,342.0,342.0,0,0,0.0,0.0,0.0
3232.0,17,2,363,1,75,0.0,75.0,75.0,1,288,0.0,288.0,288.0
110483041.0,6,35,2542,18,1348,6499002.411764706,139.0,74.88888888888889,17,1194,6892390.375,123.0,70.23529411764706
113412189.0,6,46,3036,23,1518,5155087.2727272725,66.0,66.0,23,1518,5155087.727272728,66.0,66.0
2780889.0,6,3,202,1,66,0.0,66.0,66.0,2,136,0.0,70.0,68.0
299300.0,6,6,412,4,272,99766.66666666669,74.0,68.0,2,140,0.0,74.0,70.0
51923.0,6,10,2032,5,524,10871.5,252.0,104.8,5,1508,12420.0,1236.0,301.6
5846.0,17,4,344,2,150,0.0,75.0,75.0,2,194,0.0,103.0,97.0
90260439.0,6,12,1832,8,1016,12894348.42857143,188.0,127.0,4,816,30031681.33333333,204.0,204.0
2068.0,17,4,344,2,150,0.0,75.0,75.0,2,194,0.0,103.0,97.0
209424.0,17,2,180,1,90,0.0,90.0,90.0,1,90,0.0,90.0,90.0
149030.0,17,2,180,1,90,0.0,90.0,90.0,1,90,0.0,90.0,90.0
1410.0,17,5,550,5,550,352.5,110.0,110.0,0,0,0.0,0.0,0.0
1022097.0,6,11,1134,6,558,204419.4,220.0,93.0,5,576,254864.75,304.0,115.2
146940.0,6,3,373,2,238,0.0,172.0,119.0,1,135,0.0,135.0,135.0
304.0,17,2,208,1,72,0.0,72.0,72.0,1,136,0.0,136.0,136.0
503895.0,6,5,336,2,134,0.0,68.0,67.0,3,202,190805.0,70.0,67.33333333333333
206047.0,17,2,180,1,90,0.0,90.0,90.0,1,90,0.0,90.0,90.0
298557.0,6,6,412,4,272,99519.0,74.0,68.0,2,140,0.0,74.0,70.0
298476.0,6,6,412,4,272,99492.0,74.0,68.0,2,140,0.0,74.0,70.0
21417170.0,6,5,1736,2,819,0.0,753.0,409.5,3,917,10634033.5,785.0,305.6666666666667
39437.0,6,14,4740,7,653,6338.333333333333,249.0,93.28571428571428,7,4087,6153.666666666667,1514.0,583.8571428571429
208908.0,6,4,492,2,280,0.0,214.0,140.0,2,212,0.0,146.0,106.0
9083.0,6,11,2098,6,590,1655.6,252.0,98.33333333333331,5,1508,1994.5,1236.0,301.6
205433.0,17,2,762,2,762,0.0,381.0,381.0,0,0,0.0,0.0,0.0
54860.0,6,14,4740,7,653,8164.5,249.0,93.28571428571428,7,4087,7484.166666666667,1514.0,583.8571428571429
248486.0,6,3,337,2,214,0.0,160.0,107.0,1,123,0.0,123.0,123.0
196917.0,17,2,180,1,90,0.0,90.0,90.0,1,90,0.0,90.0,90.0
869212.0,6,9,1269,6,798,173842.4,460.0,133.0,3,471,296857.0,331.0,157.0
216454.0,17,2,180,1,90,0.0,90.0,90.0,1,90,0.0,90.0,90.0
267550.0,6,3,337,2,214,0.0,160.0,107.0,1,123,0.0,123.0,123.0
36866.0,6,14,4740,7,653,6019.333333333333,249.0,93.28571428571428,7,4087,5868.666666666667,1514.0,583.8571428571429
337.0,17,2,166,1,75,0.0,75.0,75.0,1,91,0.0,91.0,91.0
50991.0,6,14,4740,7,653,7546.833333333333,249.0,93.28571428571428,7,4087,6169.5,1514.0,583.8571428571429
10468461.0,6,7,478,4,272,3443830.6666666665,74.0,68.0,3,206,5165640.5,74.0,68.66666666666667
153458.0,17,2,180,1,90,0.0,90.0,90.0,1,90,0.0,90.0,90.0
90024241.0,17,28,13364,28,13364,3334231.1481481483,501.0,477.2857142857143,0,0,0.0,0.0,0.0
302301.0,6,6,412,4,272,100767.0,74.0,68.0,2,140,0.0,74.0,70.0
90301747.0,6,16,1192,8,596,12894140.285714284,95.0,74.5,8,596,12899429.857142856,95.0,74.5
357.0,17,2,267,1,83,0.0,83.0,83.0,1,184,0.0,184.0,184.0
120011651.0,6,21,1585,11,840,11999998.2,95.0,76.36363636363636,10,745,13334172.222222222,95.0,74.5
8827.0,6,10,1067,5,536,2041.5,264.0,107.2,5,531,1971.75,259.0,106.2
24703247.0,17,5,1718,4,1368,867951.0,342.0,342.0,1,350,0.0,350.0,350.0
758.0,17,5,550,5,550,189.5,110.0,110.0,0,0,0.0,0.0,0.0
21150.0,6,10,2032,5,524,5063.75,252.0,104.8,5,1508,4360.75,1236.0,301.6
838.0,17,2,762,2,762,0.0,381.0,381.0,0,0,0.0,0.0,0.0
366868.0,17,2,363,1,75,0.0,75.0,75.0,1,288,0.0,288.0,288.0
90055735.0,17,28,13364,28,13364,3335397.592592593,501.0,477.2857142857143,0,0,0.0,0.0,0.0
114668166.0,6,47,3102,24,1584,4976185.826086956,66.0,66.0,23,1518,5105422.363636363,66.0,66.0
45395.0,6,14,4740,7,653,6391.166666666667,249.0,93.28571428571428,7,4087,7410.0,1514.0,583.8571428571429
14556.0,6,13,1459,7,862,2185.833333333333,271.0,123.14285714285714,6,597,2746.4,259.0,99.5
2435.0,17,4,344,2,150,0.0,75.0,75.0,2,194,0.0,103.0,97.0
33434.0,6,10,2032,5,524,8131.5,252.0,104.8,5,1508,7864.0,1236.0,301.6
115415527.0,6,203,22952,102,6954,1142727.9900990098,140.0,68.17647058823529,101,15998,1143914.95,284.0,158.3960396039604
108341828.0,6,200,22552,100,15730,1092188.616161616,284.0,157.3,100,6822,1092187.6363636365,140.0,68.22
863913.0,6,9,1268,6,797,172782.6,459.0,132.83333333333334,3,471,294391.5,331.0,157.0
115409319.0,6,204,22964,102,15936,1140536.5445544554,284.0,156.23529411764707,102,7028,1140535.7623762377,140.0,68.90196078431373
1926.0,17,4,344,2,150,0.0,75.0,75.0,2,194,0.0,103.0,97.0
172053.0,6,13,1394,7,797,28675.5,253.0,113.85714285714286,6,597,33194.2,259.0,99.5
2029.0,17,4,344,2,150,0.0,75.0,75.0,2,194,0.0,103.0,97.0
18064.0,6,11,2098,6,590,3366.8,252.0,98.33333333333331,5,1508,4011.5,1236.0,301.6
5629147.0,6,5,336,2,134,0.0,68.0,67.0,3,202,1521934.5,70.0,67.33333333333333
111421111.0,6,228,26290,114,18544,984119.150442478,284.0,162.66666666666666,114,7746,984122.407079646,140.0,67.94736842105263
104617548.0,17,15,5130,15,5130,7472682.0,342.0,342.0,0,0,0.0,0.0,0.0
741992.0,6,2,132,1,66,0.0,66.0,66.0,1,66,0.0,66.0,66.0
143841.0,17,2,180,1,90,0.0,90.0,90.0,1,90,0.0,90.0,90.0
45987.0,6,14,4740,7,653,7453.333333333333,249.0,93.28571428571428,7,4087,7460.5,1514.0,583.8571428571429
96000942.0,17,11,735,6,389,19200188.4,174.0,64.83333333333333,5,346,19867814.0,174.0,69.2
301943.0,6,6,412,4,272,100647.66666666669,74.0,68.0,2,140,0.0,74.0,70.0
116596544.0,6,306,34568,153,24174,765665.9802631579,300.0,158.0,153,10394,765665.5986842106,140.0,67.93464052287581
102228536.0,6,193,21842,97,6624,1064880.5833333333,140.0,68.28865979381443,96,15218,1070631.8736842105,284.0,158.52083333333334
40938.0,6,14,4740,7,653,6232.833333333333,249.0,93.28571428571428,7,4087,6367.333333333333,1514.0,583.8571428571429
862532.0,6,10,1334,6,797,172506.4,459.0,132.83333333333334,4,537,196648.3333333333,331.0,134.25
232880.0,6,3,337,2,214,0.0,160.0,107.0,1,123,0.0,123.0,123.0
120125187.0,6,13,2020,9,1204,15015648.375,188.0,133.77777777777777,4,816,30031569.0,204.0,204.0
45470.0,6,14,4740,7,653,7368.5,249.0,93.28571428571428,7,4087,7327.166666666667,1514.0,583.8571428571429
120123463.0,6,13,2020,9,1204,15015432.875,188.0,133.77777777777777,4,816,30033657.33333333,204.0,204.0
49672292.0,6,4,270,2,136,0.0,70.0,68.0,2,134,0.0,68.0,67.0
120069419.0,17,28,13364,28,13364,4447015.518518519,501.0,477.2857142857143,0,0,0.0,0.0,0.0
101675.0,6,14,4740,7,653,11871.0,249.0,93.28571428571428,7,4087,15246.333333333334,1514.0,583.8571428571429
14918.0,6,2,132,1,66,0.0,66.0,66.0,1,66,0.0,66.0,66.0
119844323.0,17,34,16284,34,16284,3631646.151515152,501.0,478.9411764705882,0,0,0.0,0.0,0.0
157663.0,6,3,337,2,214,0.0,160.0,107.0,1,123,0.0,123.0,123.0
135124065.0,17,6,1206,6,1206,27024813.0,201.0,201.0,0,0,0.0,0.0,0.0
51071.0,17,2,180,1,90,0.0,90.0,90.0,1,90,0.0,90.0,90.0
33132408.0,6,7,1874,3,887,16492118.5,753.0,295.6666666666667,4,987,10998853.333333334,785.0,246.75
123455588.0,6,49,3234,25,1650,5143982.833333333,66.0,66.0,24,1584,4937766.391304348,66.0,66.0
200276.0,17,4,1524,4,1524,66758.66666666667,381.0,381.0,0,0,0.0,0.0,0.0
362.0,17,2,160,1,80,0.0,80.0,80.0,1,80,0.0,80.0,80.0
22054.0,6,10,2032,5,524,5309.0,252.0,104.8,5,1508,4588.0,1236.0,301.6
92203638.0,17,12,778,6,389,18401457.2,174.0,64.83333333333333,6,389,18400161.8,174.0,64.83333333333333
21292.0,17,2,582,1,83,0.0,83.0,83.0,1,499,0.0,499.0,499.0
77583.0,6,14,4740,7,653,10531.0,249.0,93.28571428571428,7,4087,11618.5,1514.0,583.8571428571429
90045123.0,17,28,13364,28,13364,3335004.5555555555,501.0,477.2857142857143,0,0,0.0,0.0,0.0
133580.0,17,2,700,2,700,0.0,350.0,350.0,0,0,0.0,0.0,0.0
90048065.0,17,27,12943,27,12943,3463387.1153846155,501.0,479.3703703703704,0,0,0.0,0.0,0.0
150728.0,6,13,1386,7,789,25121.33333333333,253.0,112.71428571428572,6,597,27883.2,259.0,99.5
11431.0,6,10,1066,5,490,2695.0,218.0,98.0,5,576,2528.0,304.0,115.2
110789.0,17,2,286,2,286,0.0,143.0,143.0,0,0,0.0,0.0,0.0
233175.0,6,3,337,2,214,0.0,160.0,107.0,1,123,0.0,123.0,123.0
90241500.0,6,14,2240,8,1016,12891642.857142856,188.0,127.0,6,1224,18013945.4,204.0,204.0
10513478.0,6,7,478,4,272,3459297.333333333,74.0,68.0,3,206,5188835.5,74.0,68.66666666666667
232767.0,6,3,337,2,214,0.0,160.0,107.0,1,123,0.0,123.0,123.0
102335294.0,17,14,864,7,432,17001943.0,174.0,61.71428571428572,7,432,17000208.666666668,174.0,61.71428571428572
107832773.0,6,28,1860,14,966,8294828.692307692,123.0,69.0,14,894,8278204.230769231,123.0,63.85714285714285
49001.0,6,14,4740,7,653,8010.5,249.0,93.28571428571428,7,4087,8012.666666666667,1514.0,583.8571428571429
2798756.0,6,2,132,1,66,0.0,66.0,66.0,1,66,0.0,66.0,66.0
1303730.0,6,4,264,2,132,0.0,66.0,66.0,2,132,0.0,66.0,66.0
25862.0,6,14,4740,7,653,3577.6666666666665,249.0,93.28571428571428,7,4087,4115.666666666667,1514.0,583.8571428571429
204704.0,17,2,762,2,762,0.0,381.0,381.0,0,0,0.0,0.0,0.0
14640054.0,6,19,1553,9,921,1791266.75,315.0,102.33333333333331,10,632,1592293.3333333333,78.0,63.2
1782519.0,17,6,1230,3,234,891074.0,78.0,78.0,3,996,891051.0,332.0,332.0
2565744.0,6,2,136,1,66,0.0,66.0,66.0,1,70,0.0,70.0,70.0
302653.0,6,6,412,4,272,100884.33333333331,74.0,68.0,2,140,0.0,74.0,70.0
1159113.0,6,13,3010,8,2382,165587.57142857142,1514.0,297.75,5,628,221000.0,331.0,125.6
36612.0,6,14,4740,7,653,5224.833333333333,249.0,93.28571428571428,7,4087,5916.0,1514.0,583.8571428571429
2054096.0,6,23,7478,12,2450,186736.0,1034.0,204.16666666666663,11,5028,175277.4,1510.0,457.09090909090907
24729.0,6,10,2032,5,524,5698.5,252.0,104.8,5,1508,4891.0,1236.0,301.6
394.0,17,2,762,2,762,0.0,381.0,381.0,0,0,0.0,0.0,0.0
62277.0,6,14,4740,7,653,7951.333333333333,249.0,93.28571428571428,7,4087,8811.333333333334,1514.0,583.8571428571429
119914316.0,6,32,2220,16,1071,7994287.733333333,123.0,66.9375,16,1149,7314222.6,123.0,71.8125
213614.0,17,2,180,1,90,0.0,90.0,90.0,1,90,0.0,90.0,90.0
20209.0,17,2,582,1,83,0.0,83.0,83.0,1,499,0.0,499.0,499.0
106190067.0,17,14,864,7,432,17665580.5,174.0,61.71428571428572,7,432,17666816.833333332,174.0,61.71428571428572
90281706.0,6,16,1192,8,596,12891083.857142856,95.0,74.5,8,596,12895745.857142856,95.0,74.5
894295.0,6,12,2709,7,743,149049.16666666666,339.0,106.14285714285714,5,1966,154682.5,1514.0,393.2
254008.0,6,3,337,2,214,0.0,160.0,107.0,1,123,0.0,123.0,123.0
90733467.0,6,22,1680,12,894,8244628.0,95.0,74.5,10,786,10080676.777777778,95.0,78.6
334.0,17,2,166,1,75,0.0,75.0,75.0,1,91,0.0,91.0,91.0
90043682.0,17,28,13364,28,13364,3334951.185185185,501.0,477.2857142857143,0,0,0.0,0.0,0.0
120009858.0,17,15,1169,8,606,17144265.42857143,174.0,75.75,7,563,19836065.33333333,174.0,80.42857142857143
107992.0,17,2,286,2,286,0.0,143.0,143.0,0,0,0.0,0.0,0.0
100720.0,17,2,762,2,762,0.0,381.0,381.0,0,0,0.0,0.0,0.0
71675838.0,6,9,842,9,842,8959479.75,97.0,93.55555555555556,0,0,0.0,0.0,0.0
20810.0,6,11,2098,6,590,3801.4,252.0,98.33333333333331,5,1508,4073.75,1236.0,301.6
120054212.0,17,28,13364,28,13364,4446452.296296297,501.0,477.2857142857143,0,0,0.0,0.0,0.0
153419.0,17,2,180,1,90,0.0,90.0,90.0,1,90,0.0,90.0,90.0
26647.0,6,10,2032,5,524,6404.5,252.0,104.8,5,1508,6217.5,1236.0,301.6
1167527.0,6,13,3011,8,2383,166789.57142857142,1514.0,297.875,5,628,222907.25,331.0,125.6
18477.0,6,2,145,2,145,0.0,91.0,72.5,0,0,0.0,0.0,0.0
5630654.0,6,4,270,2,134,0.0,68.0,67.0,2,136,0.0,70.0,68.0
220390.0,6,3,426,2,280,0.0,214.0,140.0,1,146,0.0,146.0,146.0
108108905.0,17,5,1005,5,1005,27027226.25,201.0,201.0,0,0,0.0,0.0,0.0
90029835.0,17,28,13364,28,13364,3334438.333333333,501.0,477.2857142857143,0,0,0.0,0.0,0.0
251665.00000000003,6,10,1221,6,636,50333.0,298.0,106.0,4,585,78470.0,379.0,146.25
27116860.0,17,5,1710,5,1710,6779215.0,342.0,342.0,0,0,0.0,0.0,0.0
92185971.0,17,16,5472,16,5472,6145731.4,342.0,342.0,0,0,0.0,0.0,0.0
306830.0,17,2,180,1,90,0.0,90.0,90.0,1,90,0.0,90.0,90.0
121333.0,6,3,337,2,214,0.0,160.0,107.0,1,123,0.0,123.0,123.0
108104189.0,17,5,955,5,955,27026047.25,191.0,191.0,0,0,0.0,0.0,0.0
3170752.0,6,18,1577,9,1003,358111.0,315.0,111.44444444444444,9,574,358075.625,78.0,63.77777777777778
95863704.0,6,169,19050,85,5832,1141234.5714285714,140.0,68.61176470588235,84,13218,1142887.9759036144,284.0,157.35714285714286
120399764.0,17,14,1126,7,563,16742115.5,174.0,80.42857142857143,7,563,16833498.833333332,174.0,80.42857142857143
237093.0,6,3,337,2,214,0.0,160.0,107.0,1,123,0.0,123.0,123.0
96812123.0,6,70,16316,36,6878,2766060.657142857,1514.0,191.0555555555556,34,9438,2925813.212121212,1514.0,277.5882352941176
90046431.0,17,28,13364,28,13364,3335053.0,501.0,477.2857142857143,0,0,0.0,0.0,0.0
120292283.0,6,214,24324,107,7284,1127083.650943396,140.0,68.07476635514018,107,17040,1127138.8207547169,374.0,159.25233644859813
132331.0,6,3,337,2,214,0.0,160.0,107.0,1,123,0.0,123.0,123.0
92797941.0,6,37,2442,19,1254,5155441.166666667,66.0,66.0,18,1188,5246821.882352941,66.0,66.0
32155.000000000004,6,10,2032,5,524,7818.0,252.0,104.8,5,1508,6309.5,1236.0,301.6
205774.0,17,2,180,1,90,0.0,90.0,90.0,1,90,0.0,90.0,90.0
106461.0,17,2,700,2,700,0.0,350.0,350.0,0,0,0.0,0.0,0.0
5725384.0,6,5,336,2,134,0.0,68.0,67.0,3,202,1522709.5,70.0,67.33333333333333
37755.0,6,14,4740,7,653,5888.833333333333,249.0,93.28571428571428,7,4087,6153.666666666667,1514.0,583.8571428571429
119239949.0,6,405,46940,203,13694,590296.7772277228,140.0,67.45812807881774,202,33246,591306.5422885572,336.0,164.5841584158416
205905.0,17,2,180,1,90,0.0,90.0,90.0,1,90,0.0,90.0,90.0
49714.0,6,14,4740,7,653,7236.166666666667,249.0,93.28571428571428,7,4087,7985.333333333333,1514.0,583.8571428571429
153455.0,17,2,180,1,90,0.0,90.0,90.0,1,90,0.0,90.0,90.0
302478.0,6,6,412,4,272,100826.0,74.0,68.0,2,140,0.0,74.0,70.0
1971.0,17,4,344,2,150,0.0,75.0,75.0,2,194,0.0,103.0,97.0
108070.0,17,2,286,2,286,0.0,143.0,143.0,0,0,0.0,0.0,0.0
42335.0,6,10,2032,5,524,9535.5,252.0,104.8,5,1508,9310.5,1236.0,301.6
24999.0,6,10,2032,5,524,5056.0,252.0,104.8,5,1508,5610.75,1236.0,301.6
119542232.0,6,209,23502,105,7164,1149444.5384615385,140.0,68.22857142857143,104,16338,1150616.475728155,284.0,157.09615384615384
135131640.0,17,6,1146,6,1146,27026328.0,191.0,191.0,0,0,0.0,0.0,0.0
166202.0,6,10,1065,5,534,41070.25,262.0,106.8,5,531,3547.25,259.0,106.2
68306.0,6,14,4740,7,653,10842.166666666666,249.0,93.28571428571428,7,4087,10628.5,1514.0,583.8571428571429
309447.0,17,4,1400,4,1400,103149.0,350.0,350.0,0,0,0.0,0.0,0.0
135132719.0,17,6,1146,6,1146,27026543.8,191.0,191.0,0,0,0.0,0.0,0.0
20289.0,6,14,4740,7,653,3157.333333333333,249.0,93.28571428571428,7,4087,2794.1666666666665,1514.0,583.8571428571429
120007647.0,6,25,1924,12,935,10909786.090909092,95.0,77.91666666666667,13,989,7501606.833333333,95.0,76.07692307692308
2581788.0,6,2,132,1,66,0.0,66.0,66.0,1,66,0.0,66.0,66.0
91017633.0,17,17,5814,17,5814,5688602.0625,342.0,342.0,0,0,0.0,0.0,0.0
243020.0,6,3,373,2,238,0.0,172.0,119.0,1,135,0.0,135.0,135.0
1144771.0,6,11,1134,6,558,228954.2,220.0,93.0,5,576,282951.25,304.0,115.2
198317.0,17,2,180,1,90,0.0,90.0,90.0,1,90,0.0,90.0,90.0
207012.0,17,2,762,2,762,0.0,381.0,381.0,0,0,0.0,0.0,0.0
155529.0,6,3,337,2,214,0.0,160.0,107.0,1,123,0.0,123.0,123.0
3040774.0,6,3,204,2,136,0.0,70.0,68.0,1,68,0.0,68.0,68.0
302740.0,6,6,412,4,272,100913.33333333331,74.0,68.0,2,140,0.0,74.0,70.0
52947.0,6,14,4740,7,653,8703.166666666666,249.0,93.28571428571428,7,4087,7705.0,1514.0,583.8571428571429
90594343.0,6,26,1746,13,906,7530959.25,123.0,69.6923076923077,13,840,7530504.583333333,123.0,64.61538461538461
619154.0,17,3,551,2,156,0.0,78.0,78.0,1,395,0.0,395.0,395.0
307068.0,6,6,412,4,272,102356.0,74.0,68.0,2,140,0.0,74.0,70.0
117107787.0,6,239,27552,120,19390,984099.050420168,284.0,161.58333333333334,119,8162,989695.9915254236,140.0,68.58823529411765
37661.0,6,14,4740,7,653,6122.5,249.0,93.28571428571428,7,4087,4237.833333333333,1514.0,583.8571428571429
322.0,17,2,174,1,79,0.0,79.0,79.0,1,95,0.0,95.0,95.0
110366855.0,6,222,25042,111,17494,1001469.7090909092,300.0,157.6036036036036,111,7548,1001470.3181818182,140.0,68.0
304951.0,6,6,412,4,272,101650.33333333331,74.0,68.0,2,140,0.0,74.0,70.0
317219.0,6,6,412,4,272,105739.66666666669,74.0,68.0,2,140,0.0,74.0,70.0
143991.0,17,2,180,1,90,0.0,90.0,90.0,1,90,0.0,90.0,90.0
123727961.0,6,49,3234,25,1650,5155331.708333333,66.0,66.0,24,1584,5029840.956521739,66.0,66.0
205370.0,6,3,426,2,280,0.0,214.0,140.0,1,146,0.0,146.0,146.0
2702375.0,6,2,132,1,66,0.0,66.0,66.0,1,66,0.0,66.0,66.0
218032.0,6,3,426,2,280,0.0,214.0,140.0,1,146,0.0,146.0,146.0
203864.0,17,4,6056,4,6056,67954.66666666667,1514.0,1514.0,0,0,0.0,0.0,0.0
110770052.0,6,26,2400,13,1503,9230743.333333334,256.0,115.6153846153846,13,897,9229823.5,95.0,69.0
308001.0,6,6,412,4,272,102667.0,74.0,68.0,2,140,0.0,74.0,70.0
106376.0,17,2,286,2,286,0.0,143.0,143.0,0,0,0.0,0.0,0.0
295992.0,17,2,180,1,90,0.0,90.0,90.0,1,90,0.0,90.0,90.0
30247.0,6,14,4740,7,653,4836.0,249.0,93.28571428571428,7,4087,4251.666666666667,1514.0,583.8571428571429
100336948.0,6,27,1806,14,966,7702452.692307692,123.0,69.0,13,840,8344327.333333333,123.0,64.61538461538461
816.0,17,4,438,2,148,0.0,74.0,74.0,2,290,0.0,147.0,145.0
1315539.0,6,4,264,2,132,0.0,66.0,66.0,2,132,0.0,66.0,66.0
846145.0,6,2,132,1,66,0.0,66.0,66.0,1,66,0.0,66.0,66.0
123610524.0,6,49,3234,25,1650,5150438.5,66.0,66.0,24,1584,5153935.652173913,66.0,66.0
10477730.0,6,7,478,4,272,3446891.0,74.0,68.0,3,206,5170193.0,74.0,68.66666666666667
106935.0,17,2,286,2,286,0.0,143.0,143.0,0,0,0.0,0.0,0.0
113788219.0,6,48,3168,24,1584,4947313.869565218,66.0,66.0,24,1584,4935330.304347826,66.0,66.0
2793289.0,6,2,132,1,66,0.0,66.0,66.0,1,66,0.0,66.0,66.0
255447.0,6,3,337,2,214,0.0,160.0,107.0,1,123,0.0,123.0,123.0
2315.0,17,4,344,2,150,0.0,75.0,75.0,2,194,0.0,103.0,97.0
102486943.0,17,14,864,7,432,17001453.666666668,174.0,61.71428571428572,7,432,17000175.666666668,174.0,61.71428571428572
2393665.0,6,25,7573,14,3735,184128.0769230769,1514.0,266.7857142857143,11,3838,213884.2,1514.0,348.90909090909093
216597.0,17,2,180,1,90,0.0,90.0,90.0,1,90,0.0,90.0,90.0
32484.0,6,10,2032,5,524,6127.75,252.0,104.8,5,1508,6521.0,1236.0,301.6
108016080.0,6,32,2236,16,1165,7186692.333333333,139.0,72.8125,16,1071,7186692.8,123.0,66.9375
2794336.0,6,2,132,1,66,0.0,66.0,66.0,1,66,0.0,66.0,66.0
153568.0,17,2,180,1,90,0.0,90.0,90.0,1,90,0.0,90.0,90.0
100141.0,17,2,762,2,762,0.0,381.0,381.0,0,0,0.0,0.0,0.0
108105022.0,17,5,1005,5,1005,27026255.5,201.0,201.0,0,0,0.0,0.0,0.0
2331.0,17,4,344,2,150,0.0,75.0,75.0,2,194,0.0,103.0,97.0
7084968.0,6,25,7611,13,2516,590414.0,1034.0,193.53846153846155,12,5095,615157.2727272727,1510.0,424.5833333333333
32608.0,6,14,4740,7,653,5046.166666666667,249.0,93.28571428571428,7,4087,4352.166666666667,1514.0,583.8571428571429
130499.0,6,3,337,2,214,0.0,160.0,107.0,1,123,0.0,123.0,123.0
225116.0,6,3,426,2,280,0.0,214.0,140.0,1,146,0.0,146.0,146.0
108105739.0,17,5,1005,5,1005,27026434.75,201.0,201.0,0,0,0.0,0.0,0.0
40403.0,6,14,4740,7,653,6610.166666666667,249.0,93.28571428571428,7,4087,5246.666666666667,1514.0,583.8571428571429
316637.0,17,4,1400,4,1400,105545.66666666669,350.0,350.0,0,0,0.0,0.0,0.0
354.0,17,2,160,1,80,0.0,80.0,80.0,1,80,0.0,80.0,80.0
90046549.0,17,28,13364,28,13364,3335057.3703703703,501.0,477.2857142857143,0,0,0.0,0.0,0.0
220871.0,6,3,426,2,280,0.0,214.0,140.0,1,146,0.0,146.0,146.0
90275483.0,6,16,1192,8,596,12890477.285714284,95.0,74.5,8,596,12894938.857142856,95.0,74.5
90262736.0,6,13,2036,8,1016,12894676.57142857,188.0,127.0,5,1020,22524371.0,204.0,204.0
20202.0,17,2,180,1,90,0.0,90.0,90.0,1,90,0.0,90.0,90.0
2800271.0,6,2,132,1,66,0.0,66.0,66.0,1,66,0.0,66.0,66.0
314343.0,17,4,1400,4,1400,104781.0,350.0,350.0,0,0,0.0,0.0,0.0
43028.0,6,14,4740,7,653,6053.333333333333,249.0,93.28571428571428,7,4087,7033.5,1514.0,583.8571428571429
50953.0,17,2,180,1,90,0.0,90.0,90.0,1,90,0.0,90.0,90.0
31259.000000000004,6,14,4740,7,653,4783.333333333333,249.0,93.28571428571428,7,4087,4671.5,1514.0,583.8571428571429
216973.0,6,3,426,2,280,0.0,214.0,140.0,1,146,0.0,146.0,146.0
116296446.0,6,213,24062,107,7284,1097136.283018868,140.0,68.07476635514018,106,16778,1097731.066666667,284.0,158.28301886792454
229290.0,6,10,1065,5,534,56766.75,262.0,106.8,5,531,3273.0,259.0,106.2
72241.0,6,14,4740,7,653,11295.333333333334,249.0,93.28571428571428,7,4087,10437.666666666666,1514.0,583.8571428571429
309839.0,6,6,412,4,272,103279.66666666669,74.0,68.0,2,140,0.0,74.0,70.0
2431.0,17,4,344,2,150,0.0,75.0,75.0,2,194,0.0,103.0,97.0
39962.0,6,14,4740,7,653,6533.5,249.0,93.28571428571428,7,4087,6520.833333333333,1514.0,583.8571428571429
2457535.0,6,3,204,2,136,0.0,70.0,68.0,1,68,0.0,68.0,68.0
239137.0,17,2,180,1,90,0.0,90.0,90.0,1,90,0.0,90.0,90.0
108106843.0,17,5,955,5,955,27026710.75,191.0,191.0,0,0,0.0,0.0,0.0
41282.0,6,14,4740,7,653,6208.5,249.0,93.28571428571428,7,4087,6710.333333333333,1514.0,583.8571428571429
108104197.0,17,5,955,5,955,27026049.25,191.0,191.0,0,0,0.0,0.0,0.0
303638.0,6,2,132,1,66,0.0,66.0,66.0,1,66,0.0,66.0,66.0
44288.0,6,14,4740,7,653,6639.333333333333,249.0,93.28571428571428,7,4087,5324.333333333333,1514.0,583.8571428571429
2446.0,17,2,762,2,762,0.0,381.0,381.0,0,0,0.0,0.0,0.0
102330902.0,6,44,2904,22,1452,4872900.095238095,66.0,66.0,22,1452,4868569.952380952,66.0,66.0
120181640.0,6,235,26610,118,18666,1027193.5042735044,284.0,158.1864406779661,117,7944,1028101.6896551724,140.0,67.8974358974359
233100.0,6,3,337,2,214,0.0,160.0,107.0,1,123,0.0,123.0,123.0
91451826.0,6,22,1680,10,786,10161314.0,95.0,78.6,12,894,8289871.727272727,95.0,74.5
2476.0,17,4,344,2,150,0.0,75.0,75.0,2,194,0.0,103.0,97.0
500.0,17,2,508,2,508,0.0,257.0,254.0,0,0,0.0,0.0,0.0
1309079.0,6,4,264,2,132,0.0,66.0,66.0,2,132,0.0,66.0,66.0
240950.0,6,14,4740,7,653,35556.0,249.0,93.28571428571428,7,4087,38643.0,1514.0,583.8571428571429
25116.0,6,10,2032,5,524,6042.25,252.0,104.8,5,1508,5969.0,1236.0,301.6
38189.0,6,11,2098,6,590,7122.8,252.0,98.33333333333331,5,1508,5619.0,1236.0,301.6
254652.0,6,3,337,2,214,0.0,160.0,107.0,1,123,0.0,123.0,123.0
120060811.0,17,28,13364,28,13364,4446696.703703703,501.0,477.2857142857143,0,0,0.0,0.0,0.0
250709.00000000003,6,3,337,2,214,0.0,160.0,107.0,1,123,0.0,123.0,123.0
32679.0,6,14,4740,7,653,4459.666666666667,249.0,93.28571428571428,7,4087,5028.5,1514.0,583.8571428571429
108098557.0,17,5,955,5,955,27024639.25,191.0,191.0,0,0,0.0,0.0,0.0
120141347.0,6,12,1832,8,1016,17137531.42857143,188.0,127.0,4,816,30036234.33333333,204.0,204.0
90039794.0,17,28,13364,28,13364,3334807.185185185,501.0,477.2857142857143,0,0,0.0,0.0,0.0
306445.0,6,6,412,4,272,102148.33333333331,74.0,68.0,2,140,0.0,74.0,70.0
120123952.0,6,13,2020,9,1204,15015494.0,188.0,133.77777777777777,4,816,30029542.666666668,204.0,204.0
869.0,17,5,550,5,550,217.25,110.0,110.0,0,0,0.0,0.0,0.0
2415.0,17,4,344,2,150,0.0,75.0,75.0,2,194,0.0,103.0,97.0
228387.0,17,2,180,1,90,0.0,90.0,90.0,1,90,0.0,90.0,90.0
108102860.0,17,5,955,5,955,27025715.0,191.0,191.0,0,0,0.0,0.0,0.0
248503.0,6,3,337,2,214,0.0,160.0,107.0,1,123,0.0,123.0,123.0
10497778.0,6,7,478,4,272,3453793.0,74.0,68.0,3,206,5180596.0,74.0,68.66666666666667
2871.0,17,2,224,1,76,0.0,76.0,76.0,1,148,0.0,148.0,148.0
63353.99999999999,6,14,4740,7,653,10193.166666666666,249.0,93.28571428571428,7,4087,10353.833333333334,1514.0,583.8571428571429
268272.0,6,10,1221,6,636,53654.4,298.0,106.0,4,585,83661.0,379.0,146.25
2697231.0,6,25,7573,14,3735,207479.3076923077,1514.0,266.7857142857143,11,3838,243306.8,1514.0,348.90909090909093
121844.0,6,3,337,2,214,0.0,160.0,107.0,1,123,0.0,123.0,123.0
120046835.0,17,29,13785,29,13785,4287386.964285715,501.0,475.3448275862069,0,0,0.0,0.0,0.0
5621364.0,6,5,336,2,134,0.0,68.0,67.0,3,202,1421718.5,70.0,67.33333333333333
12740018.0,6,26,7627,14,3735,191229.0,1514.0,266.7857142857143,12,3892,1139568.5454545454,1514.0,324.3333333333333
228404.0,17,2,180,1,90,0.0,90.0,90.0,1,90,0.0,90.0,90.0
2399.0,17,4,344,2,150,0.0,75.0,75.0,2,194,0.0,103.0,97.0
2512249.0,6,11,1134,6,558,502449.8,220.0,93.0,5,576,625956.25,304.0,115.2
206427.0,6,3,426,2,280,0.0,214.0,140.0,1,146,0.0,146.0,146.0
97336951.0,17,12,778,6,389,19400175.0,174.0,64.83333333333333,6,389,19401281.2,174.0,64.83333333333333
307406.0,6,6,412,4,272,102468.66666666669,74.0,68.0,2,140,0.0,74.0,70.0
58790964.0,17,9,3086,8,2736,5110526.714285715,342.0,342.0,1,350,0.0,350.0,350.0
2604153.0,6,3,1604,2,851,0.0,785.0,425.5,1,753,0.0,753.0,753.0
158506.0,6,3,337,2,214,0.0,160.0,107.0,1,123,0.0,123.0,123.0
90289815.0,6,14,1964,8,1016,12898545.0,188.0,127.0,6,948,18018022.8,204.0,158.0
304480.0,6,6,412,4,272,101493.33333333331,74.0,68.0,2,140,0.0,74.0,70.0
317164.0,17,4,1400,4,1400,105721.33333333331,350.0,350.0,0,0,0.0,0.0,0.0
120242729.0,17,13,690,7,432,20040454.83333333,174.0,61.71428571428572,6,258,20001832.2,43.0,43.0
108114167.0,17,5,955,5,955,27028541.75,191.0,191.0,0,0,0.0,0.0,0.0
115375762.0,6,215,24268,108,7424,1078278.1495327102,140.0,68.74074074074075,107,16844,1078869.70754717,284.0,157.42056074766356
120122572.0,6,12,1832,8,1016,17136971.14285714,188.0,127.0,4,816,30030331.0,204.0,204.0
93643927.0,17,14,4796,13,4446,6229636.0,342.0,342.0,1,350,0.0,350.0,350.0
1306950.0,6,4,264,2,132,0.0,66.0,66.0,2,132,0.0,66.0,66.0
16344.0,6,10,2032,5,524,3845.0,252.0,104.8,5,1508,3791.0,1236.0,301.6
120462883.0,6,24,2008,12,1155,10951171.181818182,220.0,96.25,12,853,8224701.545454546,95.0,71.08333333333333
381.0,17,2,208,1,72,0.0,72.0,72.0,1,136,0.0,136.0,136.0
130280.0,6,2,132,1,66,0.0,66.0,66.0,1,66,0.0,66.0,66.0
316827.0,17,4,1400,4,1400,105609.0,350.0,350.0,0,0,0.0,0.0,0.0
22564.0,6,10,2032,5,524,3902.25,252.0,104.8,5,1508,4438.75,1236.0,301.6
27319960.0,17,5,1710,5,1710,6829990.0,342.0,342.0,0,0,0.0,0.0,0.0
154230.0,17,2,180,1,90,0.0,90.0,90.0,1,90,0.0,90.0,90.0
108134628.0,17,5,955,5,955,27033657.0,191.0,191.0,0,0,0.0,0.0,0.0
120003859.0,6,18,1341,9,691,14999987.5,95.0,76.77777777777777,9,650,14999478.375,95.0,72.22222222222223
29938.0,6,14,4740,7,653,4454.5,249.0,93.28571428571428,7,4087,4320.0,1514.0,583.8571428571429
90298155.0,6,16,1192,8,596,12893780.42857143,95.0,74.5,8,596,12898546.57142857,95.0,74.5
196782.0,17,2,180,1,90,0.0,90.0,90.0,1,90,0.0,90.0,90.0
3013487.0,6,12,2172,7,664,501936.3333333333,252.0,94.85714285714286,5,1508,2971.5,1236.0,301.6
14781.0,6,20,7606,11,978,1478.1,310.0,88.9090909090909,9,6628,1582.25,1514.0,736.4444444444445
46355.0,6,14,4740,7,653,5749.0,249.0,93.28571428571428,7,4087,6432.166666666667,1514.0,583.8571428571429
108105501.0,17,5,955,5,955,27026375.25,191.0,191.0,0,0,0.0,0.0,0.0
120772910.0,6,264,30382,132,9008,915705.9007633588,140.0,68.24242424242425,132,21374,918387.427480916,464.0,161.92424242424244
209525.0,17,2,180,1,90,0.0,90.0,90.0,1,90,0.0,90.0,90.0
120350534.0,6,231,26558,116,18672,1046526.3826086957,300.0,160.9655172413793,115,7886,1038581.649122807,140.0,68.57391304347826
1525367.0,6,4,276,2,128,0.0,74.0,64.0,2,148,0.0,74.0,74.0
37048.0,6,14,4740,7,653,5836.666666666667,249.0,93.28571428571428,7,4087,4281.833333333333,1514.0,583.8571428571429
266663.0,6,10,1221,6,636,53332.6,298.0,106.0,4,585,83246.0,379.0,146.25
106394.0,17,2,286,2,286,0.0,143.0,143.0,0,0,0.0,0.0,0.0
73932953.0,6,22,1578,11,789,7393295.3,95.0,71.72727272727273,11,789,7366289.8,95.0,71.72727272727273
15380.0,6,10,2032,5,524,3622.75,252.0,104.8,5,1508,3254.0,1236.0,301.6
108109091.0,17,5,1005,5,1005,27027272.75,201.0,201.0,0,0,0.0,0.0,0.0
40913.0,6,10,2032,5,524,9886.5,252.0,104.8,5,1508,9358.75,1236.0,301.6
134009503.0,17,15,907,8,475,19144214.71428572,174.0,59.375,7,432,19000159.666666668,174.0,61.71428571428572
39839.0,6,14,4740,7,653,6449.166666666667,249.0,93.28571428571428,7,4087,6500.833333333333,1514.0,583.8571428571429
46596305.0,6,8,1940,3,887,21906698.0,753.0,295.6666666666667,5,1053,11518067.75,785.0,210.6
935360.0,17,10,3776,10,3776,103928.88888888888,394.0,377.6,0,0,0.0,0.0,0.0
70543.0,6,14,4740,7,653,11617.833333333334,249.0,93.28571428571428,7,4087,11623.5,1514.0,583.8571428571429
119335467.0,17,14,1126,7,563,16666792.833333334,174.0,80.42857142857143,7,563,16834218.166666668,174.0,80.42857142857143
2573096.0,6,2,132,1,66,0.0,66.0,66.0,1,66,0.0,66.0,66.0
90256827.0,6,13,2036,8,1016,12893832.42857143,188.0,127.0,5,1020,22522974.0,204.0,204.0
108106923.0,17,5,1005,5,1005,27026730.75,201.0,201.0,0,0,0.0,0.0,0.0
11441.0,6,11,2098,6,590,2080.6,252.0,98.33333333333331,5,1508,2618.0,1236.0,301.6
31070.0,6,14,4740,7,653,5071.0,249.0,93.28571428571428,7,4087,4409.833333333333,1514.0,583.8571428571429
0.0,17,1,179,1,179,0.0,179.0,179.0,0,0,0.0,0.0,0.0
1905.0,17,2,192,1,88,0.0,88.0,88.0,1,104,0.0,104.0,104.0
574.0,17,2,508,2,508,0.0,257.0,254.0,0,0,0.0,0.0,0.0
104568.0,17,2,286,2,286,0.0,143.0,143.0,0,0,0.0,0.0,0.0
298838.0,6,6,412,4,272,99612.66666666669,74.0,68.0,2,140,0.0,74.0,70.0
122493.0,6,3,373,2,238,0.0,172.0,119.0,1,135,0.0,135.0,135.0
135133591.0,17,6,1206,6,1206,27026718.2,201.0,201.0,0,0,0.0,0.0,0.0
217574.0,6,3,426,2,280,0.0,214.0,140.0,1,146,0.0,146.0,146.0
227971.0,17,2,180,1,90,0.0,90.0,90.0,1,90,0.0,90.0,90.0
29915.0,6,10,2032,5,524,7014.75,252.0,104.8,5,1508,7152.75,1236.0,301.6
135123250.0,17,6,1206,6,1206,27024650.0,201.0,201.0,0,0,0.0,0.0,0.0
108106110.0,17,5,955,5,955,27026527.5,191.0,191.0,0,0,0.0,0.0,0.0
3163892.0,6,18,1495,9,921,357762.5,315.0,102.33333333333331,9,574,357736.75,78.0,63.77777777777778
43603.0,6,14,4740,7,653,7144.666666666667,249.0,93.28571428571428,7,4087,5437.833333333333,1514.0,583.8571428571429
203945.0,17,2,762,2,762,0.0,381.0,381.0,0,0,0.0,0.0,0.0
310304.0,17,4,1400,4,1400,103434.66666666669,350.0,350.0,0,0,0.0,0.0,0.0
34516.0,6,14,4740,7,653,5179.833333333333,249.0,93.28571428571428,7,4087,4973.333333333333,1514.0,583.8571428571429
147943.0,17,2,180,1,90,0.0,90.0,90.0,1,90,0.0,90.0,90.0
49820.0,6,14,4740,7,653,8182.333333333333,249.0,93.28571428571428,7,4087,8150.0,1514.0,583.8571428571429
310918.0,17,4,622,4,622,103639.33333333331,163.0,155.5,0,0,0.0,0.0,0.0
2344.0,17,4,344,2,150,0.0,75.0,75.0,2,194,0.0,103.0,97.0
279962.0,17,4,1400,4,1400,93320.66666666669,350.0,350.0,0,0,0.0,0.0,0.0
1041301.0,6,11,1134,6,558,208260.2,220.0,93.0,5,576,256566.25,304.0,115.2
108116463.0,17,5,1005,5,1005,27029115.75,201.0,201.0,0,0,0.0,0.0,0.0
90285849.0,6,16,1192,8,596,12891594.285714284,95.0,74.5,8,596,12897406.285714284,95.0,74.5
4624994.0,6,33,8797,18,4931,272058.4705882353,1514.0,273.94444444444446,15,3866,215018.7857142857,1514.0,257.7333333333333
45277.0,6,14,4740,7,653,7417.833333333333,249.0,93.28571428571428,7,4087,6850.333333333333,1514.0,583.8571428571429
30158.0,6,14,4740,7,653,4067.1666666666665,249.0,93.28571428571428,7,4087,4389.833333333333,1514.0,583.8571428571429
147071.0,6,3,337,2,214,0.0,160.0,107.0,1,123,0.0,123.0,123.0
115464272.0,6,197,22334,99,6830,1178206.857142857,140.0,68.98989898989899,98,15504,1168921.5360824745,300.0,158.20408163265307
90039371.0,17,28,13364,28,13364,3334791.5185185187,501.0,477.2857142857143,0,0,0.0,0.0,0.0
474.0,17,2,508,2,508,0.0,257.0,254.0,0,0,0.0,0.0,0.0
309667.0,6,6,412,4,272,103222.33333333331,74.0,68.0,2,140,0.0,74.0,70.0
32680641.0,6,5,336,2,134,0.0,68.0,67.0,3,202,15053192.0,70.0,67.33333333333333
198617.0,17,2,180,1,90,0.0,90.0,90.0,1,90,0.0,90.0,90.0
103923347.0,6,44,2904,22,1452,4948730.80952381,66.0,66.0,22,1452,4938439.476190476,66.0,66.0
206462.0,6,10,1221,6,636,41292.4,298.0,106.0,4,585,67805.33333333333,379.0,146.25
153303.0,17,2,180,1,90,0.0,90.0,90.0,1,90,0.0,90.0,90.0
196735.0,17,2,180,1,90,0.0,90.0,90.0,1,90,0.0,90.0,90.0
228070.0,6,3,426,2,280,0.0,214.0,140.0,1,146,0.0,146.0,146.0
2882198.0,6,4,270,2,134,0.0,68.0,67.0,2,136,0.0,70.0,68.0
280168.0,17,2,363,1,79,0.0,79.0,79.0,1,284,0.0,284.0,284.0
2072750.0,6,19,6869,11,1567,207275.0,408.0,142.45454545454547,8,5302,233538.0,1514.0,662.75
207140.0,6,3,426,2,280,0.0,214.0,140.0,1,146,0.0,146.0,146.0
3019951.0,6,3,1604,2,851,0.0,785.0,425.5,1,753,0.0,753.0,753.0
5234996.0,6,5,336,2,134,0.0,68.0,67.0,3,202,1526354.5,70.0,67.33333333333333
106680.0,17,2,700,2,700,0.0,350.0,350.0,0,0,0.0,0.0,0.0
352.0,17,2,166,1,75,0.0,75.0,75.0,1,91,0.0,91.0,91.0
85267.0,6,14,4740,7,653,13157.833333333334,249.0,93.28571428571428,7,4087,14075.5,1514.0,583.8571428571429
2353.0,17,4,344,2,150,0.0,75.0,75.0,2,194,0.0,103.0,97.0
69224.0,6,14,4740,7,653,9713.833333333334,249.0,93.28571428571428,7,4087,9535.666666666666,1514.0,583.8571428571429
302425.0,6,6,412,4,272,100808.33333333331,74.0,68.0,2,140,0.0,74.0,70.0
98415148.0,6,39,2574,20,1320,5179730.842105263,66.0,66.0,19,1254,5111994.888888889,66.0,66.0
90287488.0,6,20,1490,11,840,9024705.6,95.0,76.36363636363636,9,650,11285673.625,95.0,72.22222222222223
312347.0,17,4,1400,4,1400,104115.66666666669,350.0,350.0,0,0,0.0,0.0,0.0
2366306.0,6,25,7573,14,3735,182023.53846153847,1514.0,266.7857142857143,11,3838,211017.9,1514.0,348.90909090909093
123836461.0,6,32,2220,16,1071,7590128.933333334,123.0,66.9375,16,1149,7743149.533333333,123.0,71.8125
108114360.0,17,5,955,5,955,27028590.0,191.0,191.0,0,0,0.0,0.0,0.0
29735.0,6,14,4740,7,653,4756.666666666667,249.0,93.28571428571428,7,4087,4467.5,1514.0,583.8571428571429
932.0,17,2,762,2,762,0.0,381.0,381.0,0,0,0.0,0.0,0.0
97092.0,17,2,762,2,762,0.0,381.0,381.0,0,0,0.0,0.0,0.0
44318.0,6,13,1479,7,882,7092.666666666667,291.0,126.0,6,597,8026.4,259.0,99.5
138465.0,17,2,176,1,80,0.0,80.0,80.0,1,96,0.0,96.0,96.0
279552.0,6,12,1373,7,714,46592.0,298.0,102.0,5,659,65843.75,379.0,131.8
19476.0,6,14,4740,7,653,2730.833333333333,249.0,93.28571428571428,7,4087,2744.6666666666665,1514.0,583.8571428571429
236136.0,6,3,373,2,238,0.0,172.0,119.0,1,135,0.0,135.0,135.0
120430851.0,6,217,24680,109,17256,1115100.4722222222,300.0,158.3119266055046,108,7424,1106561.9626168224,140.0,68.74074074074075
118056381.0,6,29,1914,15,948,8432598.642857144,123.0,63.2,14,966,8296503.307692308,123.0,69.0
119634893.0,6,230,26068,115,18182,1047540.0789473684,284.0,158.10434782608695,115,7886,1047539.5877192982,140.0,68.57391304347826
33968.0,6,14,4740,7,653,5538.333333333333,249.0,93.28571428571428,7,4087,5461.166666666667,1514.0,583.8571428571429
317.0,17,2,174,1,79,0.0,79.0,79.0,1,95,0.0,95.0,95.0
217173.0,6,3,426,2,280,0.0,214.0,140.0,1,146,0.0,146.0,146.0
213679.0,6,12,1373,7,714,35613.166666666664,298.0,102.0,5,659,52530.5,379.0,131.8
90069629.0,17,28,13364,28,13364,3335912.185185185,501.0,477.2857142857143,0,0,0.0,0.0,0.0
119187499.0,17,14,1126,7,563,19838097.166666668,174.0,80.42857142857143,7,563,19838098.0,174.0,80.42857142857143
3131140.0,6,3,204,2,136,0.0,70.0,68.0,1,68,0.0,68.0,68.0
17612555.0,17,11,4983,11,4983,1761255.5,453.0,453.0,0,0,0.0,0.0,0.0
301527.0,6,6,412,4,272,100509.0,74.0,68.0,2,140,0.0,74.0,70.0
317194.0,17,4,1400,4,1400,105731.33333333331,350.0,350.0,0,0,0.0,0.0,0.0
291906.0,6,10,1221,6,636,58381.2,298.0,106.0,4,585,85844.33333333333,379.0,146.25
35206.0,6,10,2032,5,524,8515.25,252.0,104.8,5,1508,8351.25,1236.0,301.6
233721.0,6,3,337,2,214,0.0,160.0,107.0,1,123,0.0,123.0,123.0
55590.0,6,14,4740,7,653,8445.5,249.0,93.28571428571428,7,4087,7446.833333333333,1514.0,583.8571428571429
114256747.0,6,48,3168,24,1584,4967684.652173913,66.0,66.0,24,1584,4958288.043478261,66.0,66.0
118303075.0,6,48,3168,24,1584,5143611.956521739,66.0,66.0,24,1584,5130025.173913044,66.0,66.0
106040786.0,6,197,22264,99,6756,1082048.836734694,140.0,68.24242424242425,98,15508,1082427.2474226805,300.0,158.24489795918367
34155293.0,6,7,1874,3,887,17003753.0,753.0,295.6666666666667,4,987,11338112.0,785.0,246.75
7105.0,17,2,582,1,83,0.0,83.0,83.0,1,499,0.0,499.0,499.0
241263.0,6,3,373,2,238,0.0,172.0,119.0,1,135,0.0,135.0,135.0
5005432.0,17,4,849,2,166,0.0,83.0,83.0,2,683,0.0,499.0,341.5
84286.0,6,12,1413,7,882,14047.666666666666,291.0,126.0,5,531,18901.75,259.0,106.2
90260499.0,6,13,2036,8,1016,12894357.0,188.0,127.0,5,1020,22523941.5,204.0,204.0
51516.0,6,14,4740,7,653,7589.333333333333,249.0,93.28571428571428,7,4087,8399.166666666666,1514.0,583.8571428571429
6707.0,17,2,582,1,83,0.0,83.0,83.0,1,499,0.0,499.0,499.0
300797.0,6,6,412,4,272,100265.66666666669,74.0,68.0,2,140,0.0,74.0,70.0
120121653.0,6,14,2240,8,1016,17137058.714285713,188.0,127.0,6,1224,18018550.0,204.0,204.0
2315.0,17,4,344,2,150,0.0,75.0,75.0,2,194,0.0,103.0,97.0
1239794.0,17,7,490,7,490,206632.3333333333,70.0,70.0,0,0,0.0,0.0,0.0
208697.0,17,2,762,2,762,0.0,381.0,381.0,0,0,0.0,0.0,0.0
504.0,17,2,267,1,83,0.0,83.0,83.0,1,184,0.0,184.0,184.0
39554.0,6,14,4740,7,653,5502.333333333333,249.0,93.28571428571428,7,4087,6157.333333333333,1514.0,583.8571428571429
120370212.0,6,201,22676,101,15780,1203702.12,284.0,156.23762376237624,100,6896,1205362.3636363635,140.0,68.96
12340.0,17,4,823,2,163,0.0,89.0,81.5,2,660,0.0,443.0,330.0
101451523.0,6,29,2068,15,1105,7231109.428571428,139.0,73.66666666666667,14,963,7787347.692307692,123.0,68.78571428571429
209369.0,17,2,180,1,90,0.0,90.0,90.0,1,90,0.0,90.0,90.0
120022441.0,17,28,13364,28,13364,4445275.592592592,501.0,477.2857142857143,0,0,0.0,0.0,0.0
100065727.0,17,12,778,6,389,19956032.8,174.0,64.83333333333333,6,389,19981357.6,174.0,64.83333333333333
2309.0,17,2,762,2,762,0.0,381.0,381.0,0,0,0.0,0.0,0.0
2432.0,17,4,344,2,150,0.0,75.0,75.0,2,194,0.0,103.0,97.0
1055189.0,6,10,1065,5,534,263115.0,262.0,106.8,5,531,263586.5,259.0,106.2
108334.0,17,2,286,2,286,0.0,143.0,143.0,0,0,0.0,0.0,0.0
117000959.0,17,13,821,7,432,19500159.83333333,174.0,61.71428571428572,6,389,19401259.2,174.0,64.83333333333333
32908.0,6,14,4740,7,653,5358.166666666667,249.0,93.28571428571428,7,4087,5335.0,1514.0,583.8571428571429
1319916.0,17,7,490,7,490,219986.0,70.0,70.0,0,0,0.0,0.0,0.0
12469.0,17,4,823,2,163,0.0,89.0,81.5,2,660,0.0,443.0,330.0
120489726.0,6,31,2097,16,1149,8032648.4,123.0,71.8125,15,948,8414497.07142857,123.0,63.2
24174.0,6,14,4740,7,653,3746.3333333333335,249.0,93.28571428571428,7,4087,3524.0,1514.0,583.8571428571429
496339.0,6,4,270,2,134,0.0,68.0,67.0,2,136,0.0,70.0,68.0
313419.0,17,4,1400,4,1400,104473.0,350.0,350.0,0,0,0.0,0.0,0.0
10766554.0,6,5,1736,3,917,5315533.0,785.0,305.6666666666667,2,819,0.0,753.0,409.5
241598.0,6,3,337,2,214,0.0,160.0,107.0,1,123,0.0,123.0,123.0
233280.0,6,3,337,2,214,0.0,160.0,107.0,1,123,0.0,123.0,123.0
144011.0,17,2,180,1,90,0.0,90.0,90.0,1,90,0.0,90.0,90.0
104890.0,17,4,1400,4,1400,34963.333333333336,350.0,350.0,0,0,0.0,0.0,0.0
207655.0,6,3,426,2,280,0.0,214.0,140.0,1,146,0.0,146.0,146.0
228338.0,17,2,180,1,90,0.0,90.0,90.0,1,90,0.0,90.0,90.0
52147.0,6,14,4740,7,653,8563.5,249.0,93.28571428571428,7,4087,8277.166666666666,1514.0,583.8571428571429
410298.0,6,4,492,2,280,0.0,214.0,140.0,2,212,0.0,146.0,106.0
108107360.0,17,5,955,5,955,27026840.0,191.0,191.0,0,0,0.0,0.0,0.0
38260.0,6,10,2032,5,524,8209.5,252.0,104.8,5,1508,9237.0,1236.0,301.6
6542.0,17,4,823,2,163,0.0,89.0,81.5,2,660,0.0,443.0,330.0
59028.0,6,10,2032,5,524,14221.0,252.0,104.8,5,1508,14486.75,1236.0,301.6
256186.00000000003,6,3,337,2,214,0.0,160.0,107.0,1,123,0.0,123.0,123.0
144037.0,17,2,180,1,90,0.0,90.0,90.0,1,90,0.0,90.0,90.0
1158454.0,6,13,3006,8,2378,165493.42857142858,1514.0,297.25,5,628,220655.5,331.0,125.6
108105660.0,17,5,1005,5,1005,27026415.0,201.0,201.0,0,0,0.0,0.0,0.0
220803.0,6,3,426,2,280,0.0,214.0,140.0,1,146,0.0,146.0,146.0
5620623.0,6,5,336,2,134,0.0,68.0,67.0,3,202,1524386.5,70.0,67.33333333333333
314813.0,17,4,1400,4,1400,104937.66666666669,350.0,350.0,0,0,0.0,0.0,0.0
3240.0,17,4,344,2,150,0.0,75.0,75.0,2,194,0.0,103.0,97.0
677745.0,6,10,1065,5,534,169061.0,262.0,106.8,5,531,166054.25,259.0,106.2
33757.0,6,11,2098,6,590,6751.4,252.0,98.33333333333331,5,1508,7263.5,1236.0,301.6
147390.0,6,3,373,2,238,0.0,172.0,119.0,1,135,0.0,135.0,135.0
146296.0,6,3,337,2,214,0.0,160.0,107.0,1,123,0.0,123.0,123.0
2422.0,17,4,344,2,150,0.0,75.0,75.0,2,194,0.0,103.0,97.0
135128521.0,17,6,1206,6,1206,27025704.2,201.0,201.0,0,0,0.0,0.0,0.0
104232082.0,17,15,5130,15,5130,7445148.714285715,342.0,342.0,0,0,0.0,0.0,0.0
90284763.0,6,16,1192,8,596,12891309.714285716,95.0,74.5,8,596,12897266.857142856,95.0,74.5
54331.0,6,14,4740,7,653,8814.833333333334,249.0,93.28571428571428,7,4087,7730.166666666667,1514.0,583.8571428571429
329.0,17,2,166,1,75,0.0,75.0,75.0,1,91,0.0,91.0,91.0
123743654.0,6,48,3168,24,1584,5146691.173913044,66.0,66.0,24,1584,5146782.304347826,66.0,66.0
2896748.0,6,3,1777,2,951,0.0,885.0,475.5,1,826,0.0,826.0,826.0
126530973.0,6,30,2112,14,963,9141497.692307692,123.0,68.78571428571429,16,1149,8435369.333333334,123.0,71.8125
1325589.0,6,4,264,2,132,0.0,66.0,66.0,2,132,0.0,66.0,66.0
94305247.0,17,12,778,6,389,18800167.4,174.0,64.83333333333333,6,389,18801176.0,174.0,64.83333333333333
116797756.0,6,33,2428,16,1140,7786517.066666666,123.0,71.25,17,1288,6802167.3125,139.0,75.76470588235294
2154.0,17,4,344,2,150,0.0,75.0,75.0,2,194,0.0,103.0,97.0
90294471.0,6,16,1192,8,596,12892829.857142856,95.0,74.5,8,596,12896182.0,95.0,74.5
2396.0,17,4,344,2,150,0.0,75.0,75.0,2,194,0.0,103.0,97.0
242083.0,6,3,337,2,214,0.0,160.0,107.0,1,123,0.0,123.0,123.0
9247.0,17,2,539,1,86,0.0,86.0,86.0,1,453,0.0,453.0,453.0
301443.0,6,6,412,4,272,100481.0,74.0,68.0,2,140,0.0,74.0,70.0
90619722.0,6,28,2008,14,1045,6954130.615384615,139.0,74.64285714285714,14,963,6954132.076923077,123.0,68.78571428571429
2936.0,17,2,224,1,76,0.0,76.0,76.0,1,148,0.0,148.0,148.0
120128988.0,6,14,2224,9,1204,15016123.5,188.0,133.77777777777777,5,1020,22525158.75,204.0,204.0
43432.0,6,13,1479,7,882,6379.833333333333,291.0,126.0,6,597,7768.4,259.0,99.5
234881.0,6,3,337,2,214,0.0,160.0,107.0,1,123,0.0,123.0,123.0
119502956.0,17,35,16705,35,16705,3514792.823529412,501.0,477.2857142857143,0,0,0.0,0.0,0.0
1415735.0,17,16,1120,16,1120,94382.33333333331,70.0,70.0,0,0,0.0,0.0,0.0
2313.0,17,4,344,2,150,0.0,75.0,75.0,2,194,0.0,103.0,97.0
300132.0,17,2,246,1,76,0.0,76.0,76.0,1,170,0.0,170.0,170.0
55751.0,6,10,2032,5,524,12203.25,252.0,104.8,5,1508,13662.75,1236.0,301.6
124738524.0,17,15,1169,7,563,17532550.0,174.0,80.42857142857143,8,606,17796918.42857143,174.0,75.75
69615.0,6,13,1386,7,789,11602.5,253.0,112.71428571428572,6,597,11751.8,259.0,99.5
120145992.0,6,222,25286,111,7622,1075419.518181818,140.0,68.66666666666667,111,17664,1084782.3636363635,374.0,159.13513513513513
90286111.0,6,13,1898,8,1016,12898015.857142856,188.0,127.0,5,882,22529753.5,204.0,176.4
102324813.0,6,42,2772,21,1386,5105445.15,66.0,66.0,21,1386,5105449.9,66.0,66.0
2453.0,17,4,344,2,150,0.0,75.0,75.0,2,194,0.0,103.0,97.0
72449.0,6,12,1320,7,789,12074.833333333334,253.0,112.71428571428572,5,531,15976.5,259.0,106.2
809.0,17,4,438,2,148,0.0,74.0,74.0,2,290,0.0,147.0,145.0
1392.0,17,2,762,2,762,0.0,381.0,381.0,0,0,0.0,0.0,0.0
50790.0,6,10,2032,5,524,12392.0,252.0,104.8,5,1508,12048.25,1236.0,301.6
46462.0,6,11,2098,6,590,8282.4,252.0,98.33333333333331,5,1508,10514.5,1236.0,301.6
318.0,17,2,174,1,79,0.0,79.0,79.0,1,95,0.0,95.0,95.0
332953.0,6,6,412,4,272,110984.33333333331,74.0,68.0,2,140,0.0,74.0,70.0
113171416.0,6,46,3036,23,1518,5144143.181818182,66.0,66.0,23,1518,5144143.363636363,66.0,66.0
121427.0,6,3,337,2,214,0.0,160.0,107.0,1,123,0.0,123.0,123.0
107680.0,17,2,286,2,286,0.0,143.0,143.0,0,0,0.0,0.0,0.0
82460.0,6,12,1362,6,731,15264.2,253.0,121.83333333333331,6,631,15269.2,293.0,105.16666666666669
0.0,17,1,55,1,55,0.0,55.0,55.0,0,0,0.0,0.0,0.0
113888996.0,6,48,3168,24,1584,4951695.478260869,66.0,66.0,24,1584,4938111.434782608,66.0,66.0
105009.0,17,2,700,2,700,0.0,350.0,350.0,0,0,0.0,0.0,0.0
105509.0,17,2,700,2,700,0.0,350.0,350.0,0,0,0.0,0.0,0.0
382.0,17,2,208,1,72,0.0,72.0,72.0,1,136,0.0,136.0,136.0
99984.0,17,2,906,2,906,0.0,453.0,453.0,0,0,0.0,0.0,0.0
59669.0,6,14,4740,7,653,8583.166666666666,249.0,93.28571428571428,7,4087,8791.5,1514.0,583.8571428571429
266.0,17,2,700,2,700,0.0,350.0,350.0,0,0,0.0,0.0,0.0
90260202.0,6,12,1832,8,1016,12894314.57142857,188.0,127.0,4,816,30031712.666666668,204.0,204.0
1476.0,17,2,762,2,762,0.0,381.0,381.0,0,0,0.0,0.0,0.0
2022074.0,17,4,525,2,150,0.0,75.0,75.0,2,375,0.0,284.0,187.5
93108661.0,6,40,2640,20,1320,4900455.842105263,66.0,66.0,20,1320,4886108.7894736845,66.0,66.0
46585582.0,6,8,2113,3,960,22134821.5,826.0,320.0,5,1153,11002345.5,885.0,230.6
28872298.0,6,8,602,5,404,7192155.75,103.0,80.8,3,198,204350.5,66.0,66.0
10488205.0,6,7,478,4,272,3450684.0,74.0,68.0,3,206,5175907.0,74.0,68.66666666666667
274853.0,17,4,1400,4,1400,91617.66666666669,350.0,350.0,0,0,0.0,0.0,0.0
2049680.0,17,6,1039,4,312,683101.0,78.0,78.0,2,727,0.0,395.0,363.5
228711.0,6,2,132,1,66,0.0,66.0,66.0,1,66,0.0,66.0,66.0
94506325.0,17,12,778,6,389,18800784.8,174.0,64.83333333333333,6,389,18800160.0,174.0,64.83333333333333
246743.0,6,3,337,2,214,0.0,160.0,107.0,1,123,0.0,123.0,123.0
15038334.0,6,5,370,5,370,3759583.5,74.0,74.0,0,0,0.0,0.0,0.0
101129.0,17,2,762,2,762,0.0,381.0,381.0,0,0,0.0,0.0,0.0
93016289.0,6,38,2508,19,1254,5150439.888888889,66.0,66.0,19,1254,5150442.166666667,66.0,66.0
9318.0,17,2,498,1,80,0.0,80.0,80.0,1,418,0.0,418.0,418.0
135131443.0,17,6,1146,6,1146,27026288.6,191.0,191.0,0,0,0.0,0.0,0.0
2576427.0,6,2,132,1,66,0.0,66.0,66.0,1,66,0.0,66.0,66.0
228265.0,17,2,180,1,90,0.0,90.0,90.0,1,90,0.0,90.0,90.0
2333.0,17,4,344,2,150,0.0,75.0,75.0,2,194,0.0,103.0,97.0
106058296.0,17,14,864,7,432,17501399.166666668,174.0,61.71428571428572,7,432,17666825.333333332,174.0,61.71428571428572
25219.0,6,14,4740,7,653,4064.1666666666665,249.0,93.28571428571428,7,4087,4027.1666666666665,1514.0,583.8571428571429
113168372.0,6,46,3036,23,1518,5144004.363636363,66.0,66.0,23,1518,5144001.5,66.0,66.0
102370.0,17,2,286,2,286,0.0,143.0,143.0,0,0,0.0,0.0,0.0
18018.0,6,14,4740,7,653,2887.833333333333,249.0,93.28571428571428,7,4087,2839.6666666666665,1514.0,583.8571428571429
27126.0,6,10,2032,5,524,6551.75,252.0,104.8,5,1508,6409.5,1236.0,301.6
171906.0,17,2,180,1,90,0.0,90.0,90.0,1,90,0.0,90.0,90.0
33001.0,6,10,2032,5,524,7500.0,252.0,104.8,5,1508,7635.25,1236.0,301.6
2410.0,17,4,344,2,150,0.0,75.0,75.0,2,194,0.0,103.0,97.0
120041234.0,17,29,13785,29,13785,4287186.928571428,501.0,475.3448275862069,0,0,0.0,0.0,0.0
25594.0,6,14,4740,7,653,3955.8333333333335,249.0,93.28571428571428,7,4087,3656.6666666666665,1514.0,583.8571428571429
107247.0,17,2,286,2,286,0.0,143.0,143.0,0,0,0.0,0.0,0.0
90217529.0,6,19,1436,9,691,11246053.5,95.0,76.77777777777777,10,745,10000152.333333334,95.0,74.5
108104019.0,17,5,955,5,955,27026004.75,191.0,191.0,0,0,0.0,0.0,0.0
237374.0,17,2,180,1,90,0.0,90.0,90.0,1,90,0.0,90.0,90.0
128800616.0,6,37,2656,19,1408,7155589.777777778,139.0,74.10526315789474,18,1248,6976449.176470588,123.0,69.33333333333333
117000986.0,17,13,821,7,432,19500164.33333333,174.0,61.71428571428572,6,389,19401094.0,174.0,64.83333333333333
27469495.0,17,5,1710,5,1710,6867373.75,342.0,342.0,0,0,0.0,0.0,0.0
55507.0,6,14,4740,7,653,8184.166666666667,249.0,93.28571428571428,7,4087,8779.833333333334,1514.0,583.8571428571429
19230.0,6,14,4740,7,653,3094.0,249.0,93.28571428571428,7,4087,3076.6666666666665,1514.0,583.8571428571429
354.0,17,2,267,1,83,0.0,83.0,83.0,1,184,0.0,184.0,184.0
90043580.0,17,28,13364,28,13364,3334947.407407407,501.0,477.2857142857143,0,0,0.0,0.0,0.0
48895.0,6,14,4740,7,653,8026.5,249.0,93.28571428571428,7,4087,7693.5,1514.0,583.8571428571429
90754450.0,6,22,1680,12,894,8245506.181818182,95.0,74.5,10,786,10083374.111111112,95.0,78.6
200117.0,17,2,762,2,762,0.0,381.0,381.0,0,0,0.0,0.0,0.0
5828773.0,6,4,270,2,134,0.0,68.0,67.0,2,136,0.0,70.0,68.0
6364.0,17,2,237,1,81,0.0,81.0,81.0,1,156,0.0,156.0,156.0
391753.0,17,6,2100,6,2100,78350.6,350.0,350.0,0,0,0.0,0.0,0.0
2800660.0,6,2,132,1,66,0.0,66.0,66.0,1,66,0.0,66.0,66.0
135130849.0,17,6,1146,6,1146,27026169.8,191.0,191.0,0,0,0.0,0.0,0.0
3179815.0,6,18,1577,9,1003,358413.75,315.0,111.44444444444444,9,574,358625.125,78.0,63.77777777777778
196912.0,17,2,180,1,90,0.0,90.0,90.0,1,90,0.0,90.0,90.0
35962.0,6,14,4740,7,653,5265.5,249.0,93.28571428571428,7,4087,5435.333333333333,1514.0,583.8571428571429
216645.0,17,2,180,1,90,0.0,90.0,90.0,1,90,0.0,90.0,90.0
220086.0,6,13,1394,7,797,36681.0,253.0,113.85714285714286,6,597,42210.4,259.0,99.5
5629661.0,6,5,336,2,134,0.0,68.0,67.0,3,202,1527557.5,70.0,67.33333333333333
102936.0,17,2,286,2,286,0.0,143.0,143.0,0,0,0.0,0.0,0.0
1654938.0,6,7,499,4,301,502966.3333333333,103.0,75.25,3,198,818692.0,66.0,66.0
102860.0,17,2,286,2,286,0.0,143.0,143.0,0,0,0.0,0.0,0.0
40851.0,6,14,4740,7,653,6690.0,249.0,93.28571428571428,7,4087,6057.166666666667,1514.0,583.8571428571429
121172166.0,6,230,25850,115,7886,1046466.0701754388,140.0,68.57391304347826,115,17964,1056669.1929824562,284.0,156.2086956521739
4560010.0,6,14,1460,8,863,651430.0,253.0,107.875,6,597,310488.4,259.0,99.5
10480908.0,6,7,478,4,272,3446459.333333333,74.0,68.0,3,206,5169560.0,74.0,68.66666666666667
206031.0,6,3,426,2,280,0.0,214.0,140.0,1,146,0.0,146.0,146.0
3251462.0,6,3,1604,2,851,0.0,785.0,425.5,1,753,0.0,753.0,753.0
12014823.0,17,3,1026,3,1026,6007411.499999999,342.0,342.0,0,0,0.0,0.0,0.0
108098796.0,17,5,955,5,955,27024699.0,191.0,191.0,0,0,0.0,0.0,0.0
91389072.0,6,22,1680,12,935,8307349.272727272,95.0,77.91666666666667,10,745,10154040.333333334,95.0,74.5
2353.0,17,4,344,2,150,0.0,75.0,75.0,2,194,0.0,103.0,97.0
90040879.0,17,28,13364,28,13364,3334847.3703703703,501.0,477.2857142857143,0,0,0.0,0.0,0.0
2054.0,17,4,344,2,150,0.0,75.0,75.0,2,194,0.0,103.0,97.0
153460.0,17,2,180,1,90,0.0,90.0,90.0,1,90,0.0,90.0,90.0
352.0,17,2,174,1,79,0.0,79.0,79.0,1,95,0.0,95.0,95.0
2998232.0,17,2,906,2,906,0.0,453.0,453.0,0,0,0.0,0.0,0.0
224194.0,6,3,426,2,280,0.0,214.0,140.0,1,146,0.0,146.0,146.0
108108233.0,17,5,955,5,955,27027058.25,191.0,191.0,0,0,0.0,0.0,0.0
27411.0,6,14,4740,7,653,3999.3333333333335,249.0,93.28571428571428,7,4087,4302.166666666667,1514.0,583.8571428571429
67899.0,6,10,2032,5,524,14882.25,252.0,104.8,5,1508,16550.75,1236.0,301.6
90057840.0,17,28,13364,28,13364,3335475.5555555555,501.0,477.2857142857143,0,0,0.0,0.0,0.0
11588122.0,6,5,1736,3,917,5725590.0,785.0,305.6666666666667,2,819,0.0,753.0,409.5
307350.0,6,6,412,4,272,102450.0,74.0,68.0,2,140,0.0,74.0,70.0
153460.0,17,2,180,1,90,0.0,90.0,90.0,1,90,0.0,90.0,90.0
10932.0,6,11,1132,6,556,1975.8,218.0,92.66666666666669,5,576,2342.25,304.0,115.2
216422.0,17,2,180,1,90,0.0,90.0,90.0,1,90,0.0,90.0,90.0
135132266.0,17,6,1206,6,1206,27026453.2,201.0,201.0,0,0,0.0,0.0,0.0
2085063.0,6,19,6869,11,1567,208506.3,408.0,142.45454545454547,8,5302,234950.14285714287,1514.0,662.75
30625463.0,6,5,336,2,134,0.0,68.0,67.0,3,202,15246705.5,70.0,67.33333333333333
107439.0,17,2,286,2,286,0.0,143.0,143.0,0,0,0.0,0.0,0.0
121269.0,6,3,337,2,214,0.0,160.0,107.0,1,123,0.0,123.0,123.0
307386.0,6,6,412,4,272,102462.0,74.0,68.0,2,140,0.0,74.0,70.0
9188.0,17,2,582,1,83,0.0,83.0,83.0,1,499,0.0,499.0,499.0
2324.0,17,4,344,2,150,0.0,75.0,75.0,2,194,0.0,103.0,97.0
213745.0,17,2,180,1,90,0.0,90.0,90.0,1,90,0.0,90.0,90.0
313.0,17,2,174,1,79,0.0,79.0,79.0,1,95,0.0,95.0,95.0
232897.0,6,3,373,2,238,0.0,172.0,119.0,1,135,0.0,135.0,135.0
28613.0,6,14,4740,7,653,4446.333333333333,249.0,93.28571428571428,7,4087,4425.666666666667,1514.0,583.8571428571429
135133299.0,17,6,1206,6,1206,27026659.8,201.0,201.0,0,0,0.0,0.0,0.0
118826103.0,6,24,1788,12,894,10780267.0,95.0,74.5,12,894,10780905.636363637,95.0,74.5
20933.0,6,14,4740,7,653,2714.333333333333,249.0,93.28571428571428,7,4087,3351.0,1514.0,583.8571428571429
307160.0,6,6,412,4,272,102386.66666666669,74.0,68.0,2,140,0.0,74.0,70.0
247109.0,17,2,180,1,90,0.0,90.0,90.0,1,90,0.0,90.0,90.0
300526.0,6,6,412,4,272,100175.33333333331,74.0,68.0,2,140,0.0,74.0,70.0
2754341.0,6,3,1604,1,753,0.0,753.0,753.0,2,851,0.0,785.0,425.5
27879.0,6,14,4740,7,653,4224.333333333333,249.0,93.28571428571428,7,4087,4228.333333333333,1514.0,583.8571428571429
38323.0,6,14,4740,7,653,5274.166666666667,249.0,93.28571428571428,7,4087,6126.666666666667,1514.0,583.8571428571429
119451662.0,6,227,25706,114,17952,1057094.353982301,284.0,157.47368421052633,113,7754,1057273.919642857,140.0,68.61946902654867
108105444.0,17,5,1005,5,1005,27026361.0,201.0,201.0,0,0,0.0,0.0,0.0
91656205.0,6,20,1692,11,1042,9160844.2,256.0,94.72727272727272,9,650,11455624.5,95.0,72.22222222222223
106233283.0,6,44,2904,22,1452,5058727.761904762,66.0,66.0,22,1452,5045611.714285715,66.0,66.0
135128499.0,17,6,1206,6,1206,27025699.8,201.0,201.0,0,0,0.0,0.0,0.0
168245.0,17,2,414,1,88,0.0,88.0,88.0,1,326,0.0,326.0,326.0
245463.0,6,3,337,2,214,0.0,160.0,107.0,1,123,0.0,123.0,123.0
22164.0,6,2,145,2,145,0.0,91.0,72.5,0,0,0.0,0.0,0.0
102839.0,17,2,286,2,286,0.0,143.0,143.0,0,0,0.0,0.0,0.0
90256624.0,6,15,2444,8,1016,12893803.42857143,188.0,127.0,7,1428,15015555.166666666,204.0,204.0
8933.0,17,2,539,1,86,0.0,86.0,86.0,1,453,0.0,453.0,453.0
51018.0,17,2,180,1,90,0.0,90.0,90.0,1,90,0.0,90.0,90.0
299.0,17,2,156,1,78,0.0,78.0,78.0,1,78,0.0,78.0,78.0
40217.0,6,12,1320,7,789,6702.833333333333,253.0,112.71428571428572,5,531,8704.75,259.0,106.2
233737.0,6,3,337,2,214,0.0,160.0,107.0,1,123,0.0,123.0,123.0
120048636.0,17,28,13364,28,13364,4446245.777777778,501.0,477.2857142857143,0,0,0.0,0.0,0.0
215313.0,6,10,1221,6,636,43062.6,298.0,106.0,4,585,70884.33333333333,379.0,146.25
306278.0,6,6,412,4,272,102092.66666666669,74.0,68.0,2,140,0.0,74.0,70.0
221707.0,17,2,180,1,90,0.0,90.0,90.0,1,90,0.0,90.0,90.0
162983.0,6,15,4806,8,719,22625.14285714286,249.0,89.875,7,4087,27024.166666666668,1514.0,583.8571428571429
197035.0,17,2,180,1,90,0.0,90.0,90.0,1,90,0.0,90.0,90.0
268805.0,6,10,1221,6,636,53761.0,298.0,106.0,4,585,84276.33333333333,379.0,146.25
100153405.0,17,12,1040,6,520,19998711.6,174.0,86.66666666666667,6,520,19998709.4,174.0,86.66666666666667
111023624.0,6,29,1983,15,1089,7930258.857142857,123.0,72.6,14,894,8279239.384615385,123.0,63.85714285714285
203858.0,17,2,359,1,75,0.0,75.0,75.0,1,284,0.0,284.0,284.0
10431886.0,6,7,478,4,272,3431949.6666666665,74.0,68.0,3,206,5147823.0,74.0,68.66666666666667
753984.0,6,10,1065,5,534,188243.0,262.0,106.8,5,531,187902.25,259.0,106.2
244637.0,6,3,337,2,214,0.0,160.0,107.0,1,123,0.0,123.0,123.0
114160416.0,6,48,3168,24,1584,4963496.347826087,66.0,66.0,24,1584,4950038.782608695,66.0,66.0
119239362.0,6,34,2350,17,1225,7452460.125,139.0,72.05882352941177,17,1125,7438952.75,123.0,66.17647058823529
135127789.0,17,6,1146,6,1146,27025557.8,191.0,191.0,0,0,0.0,0.0,0.0
107137960.0,6,44,2904,22,1452,5101807.619047619,66.0,66.0,22,1452,5088686.761904762,66.0,66.0
201169.0,17,2,762,2,762,0.0,381.0,381.0,0,0,0.0,0.0,0.0
99889733.0,6,28,1860,14,966,7667214.384615385,123.0,69.0,14,894,7667233.461538462,123.0,63.85714285714285
223482.0,6,12,1373,7,714,37247.0,298.0,102.0,5,659,54351.5,379.0,131.8
146189.0,6,3,337,2,214,0.0,160.0,107.0,1,123,0.0,123.0,123.0
920.0,17,4,438,2,148,0.0,74.0,74.0,2,290,0.0,147.0,145.0
135133132.0,17,6,1206,6,1206,27026626.4,201.0,201.0,0,0,0.0,0.0,0.0
341.0,17,2,250,1,93,0.0,93.0,93.0,1,157,0.0,157.0,157.0
2869048.0,6,12,2172,7,664,478091.0,252.0,94.85714285714286,5,1508,2634.0,1236.0,301.6
90297236.0,6,19,1436,10,745,10027938.222222222,95.0,74.5,9,691,11285469.5,95.0,76.77777777777777
108108765.0,17,5,955,5,955,27027191.25,191.0,191.0,0,0,0.0,0.0,0.0
90016818.0,17,28,13364,28,13364,3333956.222222222,501.0,477.2857142857143,0,0,0.0,0.0,0.0
102218.0,17,2,286,2,286,0.0,143.0,143.0,0,0,0.0,0.0,0.0
2009327.0,17,4,525,2,150,0.0,75.0,75.0,2,375,0.0,284.0,187.5
123001230.0,17,15,907,8,475,17571604.285714287,174.0,59.375,7,432,17146032.166666668,174.0,61.71428571428572
120025566.0,6,2496,2139248,1723,2088230,69680.22299651567,1514.0,1211.9733023795704,773,51018,155465.09067357512,66.0,66.0
2469.0,17,4,344,2,150,0.0,75.0,75.0,2,194,0.0,103.0,97.0
119630647.0,6,218,24752,109,17262,1105698.6944444445,374.0,158.36697247706422,109,7490,1105699.1851851852,140.0,68.71559633027523
232380.0,6,3,337,2,214,0.0,160.0,107.0,1,123,0.0,123.0,123.0
118883339.0,6,36,2464,18,1285,6980444.764705882,139.0,71.38888888888889,18,1179,6980446.0,123.0,65.5
3170608.0,6,3,1604,2,851,0.0,785.0,425.5,1,753,0.0,753.0,753.0
93169866.0,17,12,778,6,389,18600171.2,174.0,64.83333333333333,6,389,18600833.6,174.0,64.83333333333333
108113210.0,17,5,1005,5,1005,27028302.5,201.0,201.0,0,0,0.0,0.0,0.0
46008.0,6,14,4740,7,653,6949.333333333333,249.0,93.28571428571428,7,4087,7195.833333333333,1514.0,583.8571428571429
124859.0,17,4,1524,4,1524,41619.66666666666,381.0,381.0,0,0,0.0,0.0,0.0
232887.0,6,3,337,2,214,0.0,160.0,107.0,1,123,0.0,123.0,123.0
34128238.0,6,26,7627,14,3735,208880.7692307692,1514.0,266.7857142857143,12,3892,3082986.0,1514.0,324.3333333333333
90735205.0,6,19,1436,10,745,10076948.666666666,95.0,74.5,9,691,11341258.75,95.0,76.77777777777777
135139358.0,17,6,1206,6,1206,27027871.6,201.0,201.0,0,0,0.0,0.0,0.0
73672.0,6,14,4740,7,653,11780.333333333334,249.0,93.28571428571428,7,4087,11885.666666666666,1514.0,583.8571428571429
2399.0,17,4,344,2,150,0.0,75.0,75.0,2,194,0.0,103.0,97.0
119851534.0,6,13,2036,5,1020,29962883.5,204.0,204.0,8,1016,17098480.0,188.0,127.0
205421.0,17,2,762,2,762,0.0,381.0,381.0,0,0,0.0,0.0,0.0
52644.0,6,14,4740,7,653,7061.0,249.0,93.28571428571428,7,4087,8271.0,1514.0,583.8571428571429
34056.0,6,14,4740,7,653,5526.666666666667,249.0,93.28571428571428,7,4087,5540.666666666667,1514.0,583.8571428571429
308167.0,17,2,238,1,74,0.0,74.0,74.0,1,164,0.0,164.0,164.0
38793.0,6,14,4740,7,653,5649.0,249.0,93.28571428571428,7,4087,6323.0,1514.0,583.8571428571429
26732.0,6,10,2032,5,524,5796.75,252.0,104.8,5,1508,6051.25,1236.0,301.6
310861.0,6,6,412,4,272,103620.33333333331,74.0,68.0,2,140,0.0,74.0,70.0
41732438.0,6,26,7627,14,3735,189493.92307692303,1514.0,266.7857142857143,12,3892,3774190.090909091,1514.0,324.3333333333333
24234.0,6,14,4740,7,653,3691.3333333333335,249.0,93.28571428571428,7,4087,3895.0,1514.0,583.8571428571429
3180781.0,6,3,1604,2,851,0.0,785.0,425.5,1,753,0.0,753.0,753.0
27357973.0,17,5,1718,4,1368,747757.3333333334,342.0,342.0,1,350,0.0,350.0,350.0
315738.0,17,4,1400,4,1400,105246.0,350.0,350.0,0,0,0.0,0.0,0.0
3475.0,17,2,359,1,75,0.0,75.0,75.0,1,284,0.0,284.0,284.0
228353.0,17,2,180,1,90,0.0,90.0,90.0,1,90,0.0,90.0,90.0
3718728.0,6,5,336,2,134,0.0,68.0,67.0,3,202,1526148.0,70.0,67.33333333333333
105381314.0,17,13,821,7,432,17563552.333333332,174.0,61.71428571428572,6,389,17119930.6,174.0,64.83333333333333
96019462.0,6,157,17808,79,12438,1231018.7435897435,284.0,157.4430379746835,78,5370,1233536.0779220778,140.0,68.84615384615384
501545.0,6,5,336,2,134,0.0,68.0,67.0,3,202,195053.5,70.0,67.33333333333333
514386.0,6,6,758,3,410,201968.0,172.0,136.66666666666666,3,348,184973.5,135.0,116.0
120128117.0,6,15,2444,7,1428,20021352.83333333,204.0,204.0,8,1016,17137139.14285714,188.0,127.0
119722505.0,6,223,25172,112,17624,1076642.1261261262,284.0,157.35714285714286,111,7548,1085446.4181818182,140.0,68.0
233605.0,6,3,337,2,214,0.0,160.0,107.0,1,123,0.0,123.0,123.0
2579077.0,6,2,132,1,66,0.0,66.0,66.0,1,66,0.0,66.0,66.0
51054.0,17,2,180,1,90,0.0,90.0,90.0,1,90,0.0,90.0,90.0
321808.0,6,6,412,4,272,107269.33333333331,74.0,68.0,2,140,0.0,74.0,70.0
120220501.0,6,608,76126,304,20360,394070.4191419142,140.0,66.97368421052632,304,55766,394427.6501650165,464.0,183.44078947368425
103199943.0,6,41,2706,21,1386,5159997.15,66.0,66.0,20,1320,5324919.47368421,66.0,66.0
99932015.0,6,26,1746,13,906,8309677.5,123.0,69.6923076923077,13,840,8309652.5,123.0,64.61538461538461
320152.0,6,6,412,4,272,106717.33333333331,74.0,68.0,2,140,0.0,74.0,70.0
309796.0,6,6,412,4,272,103265.33333333331,74.0,68.0,2,140,0.0,74.0,70.0
338.0,17,2,166,1,75,0.0,75.0,75.0,1,91,0.0,91.0,91.0
121303033.0,17,14,1126,7,563,17000791.5,174.0,80.42857142857143,7,563,17000222.666666668,174.0,80.42857142857143
561.0,17,2,508,2,508,0.0,257.0,254.0,0,0,0.0,0.0,0.0
157810.0,17,2,180,1,90,0.0,90.0,90.0,1,90,0.0,90.0,90.0
9306.0,17,2,582,1,83,0.0,83.0,83.0,1,499,0.0,499.0,499.0
120122862.0,6,14,2224,9,1204,15015357.75,188.0,133.77777777777777,5,1020,22523222.0,204.0,204.0
117510509.0,6,228,25756,114,17936,1038011.0530973452,284.0,157.33333333333334,114,7820,1038011.4601769912,140.0,68.59649122807018
2010.0,17,4,344,2,150,0.0,75.0,75.0,2,194,0.0,103.0,97.0
36200.0,6,10,2032,5,524,7989.75,252.0,104.8,5,1508,8690.5,1236.0,301.6
228245.0,17,2,180,1,90,0.0,90.0,90.0,1,90,0.0,90.0,90.0
2952.0,17,2,224,1,76,0.0,76.0,76.0,1,148,0.0,148.0,148.0
130957.0,6,3,337,2,214,0.0,160.0,107.0,1,123,0.0,123.0,123.0
52202.0,6,14,4740,7,653,7553.166666666667,249.0,93.28571428571428,7,4087,8327.166666666666,1514.0,583.8571428571429
298220.0,6,6,412,4,272,99406.66666666669,74.0,68.0,2,140,0.0,74.0,70.0
34822.0,6,10,1066,5,490,7817.0,218.0,98.0,5,576,8492.75,304.0,115.2
215379.0,17,2,180,1,90,0.0,90.0,90.0,1,90,0.0,90.0,90.0
2593531.0,6,2,132,1,66,0.0,66.0,66.0,1,66,0.0,66.0,66.0
30955.0,6,10,2032,5,524,7519.75,252.0,104.8,5,1508,7521.5,1236.0,301.6
20160.0,6,14,4740,7,653,2843.1666666666665,249.0,93.28571428571428,7,4087,3198.6666666666665,1514.0,583.8571428571429
19401.0,6,14,4740,7,653,2883.5,249.0,93.28571428571428,7,4087,2865.1666666666665,1514.0,583.8571428571429
306927.0,6,3,202,2,128,0.0,74.0,64.0,1,74,0.0,74.0,74.0
104963910.0,17,15,5130,15,5130,7497422.142857143,342.0,342.0,0,0,0.0,0.0,0.0
33331.0,6,14,4740,7,653,4951.166666666667,249.0,93.28571428571428,7,4087,5419.833333333333,1514.0,583.8571428571429
43690.0,6,14,4740,7,653,7157.666666666667,249.0,93.28571428571428,7,4087,6217.166666666667,1514.0,583.8571428571429
50947.0,6,14,4740,7,653,8255.166666666666,249.0,93.28571428571428,7,4087,7582.666666666667,1514.0,583.8571428571429
53579.0,6,14,4740,7,653,8803.666666666666,249.0,93.28571428571428,7,4087,8766.833333333334,1514.0,583.8571428571429
246830.0,6,3,373,2,238,0.0,172.0,119.0,1,135,0.0,135.0,135.0
140.0,17,2,700,2,700,0.0,350.0,350.0,0,0,0.0,0.0,0.0
26041.0,6,14,4740,7,653,4178.333333333333,249.0,93.28571428571428,7,4087,4109.666666666667,1514.0,583.8571428571429
241506.0,6,3,337,2,214,0.0,160.0,107.0,1,123,0.0,123.0,123.0
79409.0,6,14,4740,7,653,12744.833333333334,249.0,93.28571428571428,7,4087,13035.5,1514.0,583.8571428571429
2493.0,17,4,344,2,150,0.0,75.0,75.0,2,194,0.0,103.0,97.0
22442050.0,6,5,1736,2,819,0.0,753.0,409.5,3,917,11152290.5,785.0,305.6666666666667
833686.0,6,9,1118,6,586,166737.2,248.0,97.66666666666669,3,532,280647.0,392.0,177.33333333333334
204581.0,17,2,762,2,762,0.0,381.0,381.0,0,0,0.0,0.0,0.0
229318.0,6,3,426,2,280,0.0,214.0,140.0,1,146,0.0,146.0,146.0
107156.0,17,2,286,2,286,0.0,143.0,143.0,0,0,0.0,0.0,0.0
14216.0,6,10,1067,5,536,2932.75,264.0,107.2,5,531,2847.0,259.0,106.2
119000978.0,17,13,821,7,432,19833496.33333333,174.0,61.71428571428572,6,389,19802451.4,174.0,64.83333333333333
42107.0,6,14,4740,7,653,5282.333333333333,249.0,93.28571428571428,7,4087,6574.333333333333,1514.0,583.8571428571429
243222.0,6,3,337,2,214,0.0,160.0,107.0,1,123,0.0,123.0,123.0
75666.0,6,14,4740,7,653,12485.166666666666,249.0,93.28571428571428,7,4087,12466.333333333334,1514.0,583.8571428571429
156704.0,6,3,337,2,214,0.0,160.0,107.0,1,123,0.0,123.0,123.0
316245.0,17,4,1400,4,1400,105415.0,350.0,350.0,0,0,0.0,0.0,0.0
23088666.0,17,3,1034,2,684,0.0,342.0,342.0,1,350,0.0,350.0,350.0
224866.0,6,10,1221,6,636,44973.2,298.0,106.0,4,585,74037.33333333333,379.0,146.25
207849.0,6,3,426,2,280,0.0,214.0,140.0,1,146,0.0,146.0,146.0
220234.0,6,3,426,2,280,0.0,214.0,140.0,1,146,0.0,146.0,146.0
104598.0,17,2,286,2,286,0.0,143.0,143.0,0,0,0.0,0.0,0.0
2394.0,17,4,344,2,150,0.0,75.0,75.0,2,194,0.0,103.0,97.0
777.0,17,5,550,5,550,194.25,110.0,110.0,0,0,0.0,0.0,0.0
146449.0,6,3,337,2,214,0.0,160.0,107.0,1,123,0.0,123.0,123.0
898931.0,6,12,2709,7,743,149821.83333333334,339.0,106.14285714285714,5,1966,156570.5,1514.0,393.2
2589592.0,6,2,132,1,66,0.0,66.0,66.0,1,66,0.0,66.0,66.0
42660.0,6,14,4740,7,653,6514.5,249.0,93.28571428571428,7,4087,5738.166666666667,1514.0,583.8571428571429
127917.0,17,4,1524,4,1524,42639.0,381.0,381.0,0,0,0.0,0.0,0.0
317362.0,17,4,1400,4,1400,105787.33333333331,350.0,350.0,0,0,0.0,0.0,0.0
108104296.0,17,5,955,5,955,27026074.0,191.0,191.0,0,0,0.0,0.0,0.0
217180.0,6,10,1221,6,636,43436.0,298.0,106.0,4,585,71151.66666666667,379.0,146.25
60503.0,6,14,4740,7,653,7200.166666666667,249.0,93.28571428571428,7,4087,8241.333333333334,1514.0,583.8571428571429
2925209.0,6,3,1777,1,826,0.0,826.0,826.0,2,951,0.0,885.0,475.5
402.0,17,2,166,1,75,0.0,75.0,75.0,1,91,0.0,91.0,91.0
1421553.0,17,16,1120,16,1120,94770.2,70.0,70.0,0,0,0.0,0.0,0.0
1310796.0,6,4,264,2,132,0.0,66.0,66.0,2,132,0.0,66.0,66.0
17994.0,6,10,2032,5,524,4296.5,252.0,104.8,5,1508,3748.5,1236.0,301.6
90097115.0,6,12,1848,5,1020,22524013.0,204.0,204.0,7,828,15015892.666666666,188.0,118.28571428571428
5627757.0,6,5,336,2,134,0.0,68.0,67.0,3,202,1525298.5,70.0,67.33333333333333
199780.0,17,4,6056,4,6056,66593.33333333333,1514.0,1514.0,0,0,0.0,0.0,0.0
206211.0,6,3,426,2,280,0.0,214.0,140.0,1,146,0.0,146.0,146.0
141974.0,17,4,344,2,150,0.0,75.0,75.0,2,194,0.0,103.0,97.0
101718.0,17,2,286,2,286,0.0,143.0,143.0,0,0,0.0,0.0,0.0
10438038.0,6,6,412,3,206,5148186.5,74.0,68.66666666666667,3,206,5148073.0,74.0,68.66666666666667
119737226.0,17,34,16284,34,16284,3628400.787878788,501.0,478.9411764705882,0,0,0.0,0.0,0.0
40145.0,6,13,1386,7,789,6637.666666666667,253.0,112.71428571428572,6,597,7260.6,259.0,99.5
322405.0,17,4,1400,4,1400,107468.33333333331,350.0,350.0,0,0,0.0,0.0,0.0
58861.0,6,14,4740,7,653,7993.0,249.0,93.28571428571428,7,4087,9678.166666666666,1514.0,583.8571428571429
108107435.0,17,5,1005,5,1005,27026858.75,201.0,201.0,0,0,0.0,0.0,0.0
36674.0,6,14,4740,7,653,5580.333333333333,249.0,93.28571428571428,7,4087,5219.333333333333,1514.0,583.8571428571429
2526.0,17,4,344,2,150,0.0,75.0,75.0,2,194,0.0,103.0,97.0
90006904.0,17,28,13364,28,13364,3333589.037037037,501.0,477.2857142857143,0,0,0.0,0.0,0.0
1967.0,17,4,344,2,150,0.0,75.0,75.0,2,194,0.0,103.0,97.0
24125.0,6,10,2032,5,524,5772.0,252.0,104.8,5,1508,5397.0,1236.0,301.6
100100947.0,17,12,516,6,258,20001716.6,43.0,43.0,6,258,20000194.2,43.0,43.0
2401.0,17,4,344,2,150,0.0,75.0,75.0,2,194,0.0,103.0,97.0
90254014.0,6,12,1832,8,1016,12893430.57142857,188.0,127.0,4,816,30029667.33333333,204.0,204.0
15956.000000000002,6,11,1131,6,600,2984.0,262.0,100.0,5,531,2790.25,259.0,106.2
39967.0,6,14,4740,7,653,5869.666666666667,249.0,93.28571428571428,7,4087,6261.333333333333,1514.0,583.8571428571429
320162.0,6,6,412,4,272,106720.66666666669,74.0,68.0,2,140,0.0,74.0,70.0
31559.0,6,13,4412,6,409,6166.0,127.0,68.16666666666667,7,4003,4703.833333333333,1514.0,571.8571428571429
56698.0,6,13,1386,7,789,8979.166666666666,253.0,112.71428571428572,6,597,9691.0,259.0,99.5
95783202.0,6,40,2640,20,1320,5041221.157894737,66.0,66.0,20,1320,5024670.736842105,66.0,66.0
348111.0,6,3,1604,2,851,0.0,785.0,425.5,1,753,0.0,753.0,753.0
359997.0,6,3,204,2,136,0.0,70.0,68.0,1,68,0.0,68.0,68.0
315846.0,17,4,1400,4,1400,105282.0,350.0,350.0,0,0,0.0,0.0,0.0
32300.000000000004,6,14,4740,7,653,5255.666666666667,249.0,93.28571428571428,7,4087,5252.166666666667,1514.0,583.8571428571429
110991841.0,6,36,2596,18,1348,6516235.05882353,139.0,74.88888888888889,18,1248,6516233.764705882,123.0,69.33333333333333
2553886.0,6,25,7573,14,3735,196452.7692307692,1514.0,266.7857142857143,11,3838,230584.2,1514.0,348.90909090909093
107840480.0,6,28,1860,14,966,8278826.461538462,123.0,69.0,14,894,8278825.307692308,123.0,63.85714285714285
153459.0,17,2,180,1,90,0.0,90.0,90.0,1,90,0.0,90.0,90.0
93689635.0,17,12,778,6,389,18705718.2,174.0,64.83333333333333,6,389,18652487.6,174.0,64.83333333333333
397747.0,17,2,363,1,75,0.0,75.0,75.0,1,288,0.0,288.0,288.0
90258180.0,6,15,2444,8,1016,12894025.714285716,188.0,127.0,7,1428,15016020.166666666,204.0,204.0
217924.0,6,3,426,2,280,0.0,214.0,140.0,1,146,0.0,146.0,146.0
153410.0,17,2,180,1,90,0.0,90.0,90.0,1,90,0.0,90.0,90.0
90532875.0,6,13,2036,8,1016,12933267.857142856,188.0,127.0,5,1020,22592095.75,204.0,204.0
108126979.0,17,5,1005,5,1005,27031744.75,201.0,201.0,0,0,0.0,0.0,0.0
206107.0,6,3,426,2,280,0.0,214.0,140.0,1,146,0.0,146.0,146.0
3547271.0,6,5,336,2,134,0.0,68.0,67.0,3,202,1423666.5,70.0,67.33333333333333
223574.0,6,10,1221,6,636,44714.8,298.0,106.0,4,585,73671.33333333333,379.0,146.25
6425.0,17,4,823,2,163,0.0,89.0,81.5,2,660,0.0,443.0,330.0
42365.0,6,14,4740,7,653,6849.5,249.0,93.28571428571428,7,4087,6905.833333333333,1514.0,583.8571428571429
196885.0,17,2,180,1,90,0.0,90.0,90.0,1,90,0.0,90.0,90.0
135134172.0,17,6,1146,6,1146,27026834.4,191.0,191.0,0,0,0.0,0.0,0.0
264408.0,6,10,1221,6,636,52881.6,298.0,106.0,4,585,82345.33333333333,379.0,146.25
153439.0,17,2,180,1,90,0.0,90.0,90.0,1,90,0.0,90.0,90.0
90038902.0,6,13,948,7,501,14998403.0,95.0,71.57142857142857,6,447,12047060.8,95.0,74.5
297737.0,6,6,412,4,272,99245.66666666669,74.0,68.0,2,140,0.0,74.0,70.0
9208.0,17,2,582,1,83,0.0,83.0,83.0,1,499,0.0,499.0,499.0
142227.0,6,2,132,1,66,0.0,66.0,66.0,1,66,0.0,66.0,66.0
2299.0,17,4,344,2,150,0.0,75.0,75.0,2,194,0.0,103.0,97.0
227840.0,6,3,426,2,280,0.0,214.0,140.0,1,146,0.0,146.0,146.0
322.0,17,2,174,1,79,0.0,79.0,79.0,1,95,0.0,95.0,95.0
160051.0,17,2,180,1,90,0.0,90.0,90.0,1,90,0.0,90.0,90.0
121287.0,6,3,337,2,214,0.0,160.0,107.0,1,123,0.0,123.0,123.0
1168280.0,6,13,3020,8,2392,166897.14285714287,1514.0,299.0,5,628,223155.25,331.0,125.6
252436.0,6,3,373,2,238,0.0,172.0,119.0,1,135,0.0,135.0,135.0
232916.0,6,3,337,2,214,0.0,160.0,107.0,1,123,0.0,123.0,123.0
3421052.0,6,7,923,4,753,1071727.0,571.0,188.25,3,170,1607932.5,62.0,56.66666666666666
5623833.0,6,5,336,2,134,0.0,68.0,67.0,3,202,1520344.0,70.0,67.33333333333333
77077.0,6,14,4740,7,653,11825.666666666666,249.0,93.28571428571428,7,4087,12581.0,1514.0,583.8571428571429
10934443.0,6,8,544,4,272,3584370.333333333,74.0,68.0,4,272,3599318.6666666665,74.0,68.0
47010.0,6,14,4740,7,653,7607.166666666667,249.0,93.28571428571428,7,4087,7624.5,1514.0,583.8571428571429
228342.0,17,2,180,1,90,0.0,90.0,90.0,1,90,0.0,90.0,90.0
47690.0,6,14,4740,7,653,7375.666666666667,249.0,93.28571428571428,7,4087,7803.0,1514.0,583.8571428571429
30421.0,6,14,4740,7,653,4828.5,249.0,93.28571428571428,7,4087,4860.0,1514.0,583.8571428571429
26790.0,6,13,1386,7,789,4084.8333333333335,253.0,112.71428571428572,6,597,5099.8,259.0,99.5
13598759.0,6,29,9249,16,3843,170215.6,1514.0,240.1875,13,5406,1116172.1666666667,1514.0,415.84615384615387
88491.0,6,20,7606,11,978,8849.1,310.0,88.9090909090909,9,6628,9450.625,1514.0,736.4444444444445
47208.0,6,14,4740,7,653,7745.166666666667,249.0,93.28571428571428,7,4087,7606.666666666667,1514.0,583.8571428571429
1310050.0,6,4,264,2,132,0.0,66.0,66.0,2,132,0.0,66.0,66.0
242827.0,6,3,337,2,214,0.0,160.0,107.0,1,123,0.0,123.0,123.0
108121946.0,17,5,1005,5,1005,27030486.5,201.0,201.0,0,0,0.0,0.0,0.0
2082018.0,6,19,6869,11,1567,208201.8,408.0,142.45454545454547,8,5302,235026.8571428572,1514.0,662.75
220621.0,17,2,180,1,90,0.0,90.0,90.0,1,90,0.0,90.0,90.0
2589950.0,6,2,132,1,66,0.0,66.0,66.0,1,66,0.0,66.0,66.0
213449.0,17,2,180,1,90,0.0,90.0,90.0,1,90,0.0,90.0,90.0
108110819.0,17,5,1005,5,1005,27027704.75,201.0,201.0,0,0,0.0,0.0,0.0
92880268.0,6,38,2508,19,1254,5160000.0,66.0,66.0,19,1254,5160000.222222222,66.0,66.0
835330.0,6,9,1118,6,586,167066.0,248.0,97.66666666666669,3,532,281322.5,392.0,177.33333333333334
63670.00000000001,6,14,4740,7,653,8115.833333333333,249.0,93.28571428571428,7,4087,9412.5,1514.0,583.8571428571429
120052795.0,17,28,13364,28,13364,4446399.814814814,501.0,477.2857142857143,0,0,0.0,0.0,0.0
334534.0,17,2,180,1,90,0.0,90.0,90.0,1,90,0.0,90.0,90.0
47984.0,6,10,2032,5,524,8984.0,252.0,104.8,5,1508,11397.75,1236.0,301.6
117512818.0,17,16,1212,8,606,16715013.857142856,174.0,75.75,8,606,16714467.0,174.0,75.75
5622071.0,6,4,270,2,134,0.0,68.0,67.0,2,136,0.0,70.0,68.0
151786.0,17,2,414,1,88,0.0,88.0,88.0,1,326,0.0,326.0,326.0
4588.0,17,2,180,1,90,0.0,90.0,90.0,1,90,0.0,90.0,90.0
33538.0,6,14,4740,7,653,5416.333333333333,249.0,93.28571428571428,7,4087,4292.0,1514.0,583.8571428571429
245761.0,6,3,337,2,214,0.0,160.0,107.0,1,123,0.0,123.0,123.0
1186394.0,6,13,3010,8,2382,169484.85714285713,1514.0,297.75,5,628,227686.5,331.0,125.6
48475.0,6,14,4740,7,653,7952.833333333333,249.0,93.28571428571428,7,4087,6691.166666666667,1514.0,583.8571428571429
0.0,6,1,66,1,66,0.0,66.0,66.0,0,0,0.0,0.0,0.0
44668.0,6,14,4740,7,653,6764.0,249.0,93.28571428571428,7,4087,7102.166666666667,1514.0,583.8571428571429
18527.0,6,10,2032,5,524,4326.25,252.0,104.8,5,1508,3962.5,1236.0,301.6
73891.0,6,14,4740,7,653,12143.5,249.0,93.28571428571428,7,4087,11068.833333333334,1514.0,583.8571428571429
197673.0,17,2,180,1,90,0.0,90.0,90.0,1,90,0.0,90.0,90.0
122688013.0,6,49,3234,25,1650,5112000.541666667,66.0,66.0,24,1584,4968955.260869565,66.0,66.0
199837.0,17,4,6056,4,6056,66612.33333333333,1514.0,1514.0,0,0,0.0,0.0,0.0
510208.0,6,5,336,2,134,0.0,68.0,67.0,3,202,191816.5,70.0,67.33333333333333
0.0,17,1,453,1,453,0.0,453.0,453.0,0,0,0.0,0.0,0.0
201805.0,17,2,180,1,90,0.0,90.0,90.0,1,90,0.0,90.0,90.0
3152.0,17,2,231,1,78,0.0,78.0,78.0,1,153,0.0,153.0,153.0
248110.0,17,4,1400,4,1400,82703.33333333333,350.0,350.0,0,0,0.0,0.0,0.0
90080665.0,6,13,1776,6,948,18015393.8,204.0,158.0,7,828,15013253.5,188.0,118.28571428571428
90024363.0,17,28,13364,28,13364,3334235.6666666665,501.0,477.2857142857143,0,0,0.0,0.0,0.0
88468.0,17,2,762,2,762,0.0,381.0,381.0,0,0,0.0,0.0,0.0
16288.0,6,11,1133,6,602,3004.6,264.0,100.33333333333331,5,531,3619.75,259.0,106.2
335929.0,17,2,180,1,90,0.0,90.0,90.0,1,90,0.0,90.0,90.0
149915018.0,17,35,16705,35,16705,4409265.235294118,501.0,477.2857142857143,0,0,0.0,0.0,0.0
160299.0,6,2,128,1,74,0.0,74.0,74.0,1,54,0.0,54.0,54.0
119736743.0,6,254,28722,127,20044,948584.484126984,300.0,157.82677165354332,127,8678,948583.8174603176,140.0,68.33070866141732
2297.0,17,4,344,2,150,0.0,75.0,75.0,2,194,0.0,103.0,97.0
501444.0,6,3,1604,2,851,0.0,785.0,425.5,1,753,0.0,753.0,753.0
5878.0,17,2,180,1,90,0.0,90.0,90.0,1,90,0.0,90.0,90.0
12381.0,6,13,1459,7,862,1876.3333333333333,271.0,123.14285714285714,6,597,2229.8,259.0,99.5
42584.0,6,14,4740,7,653,5928.5,249.0,93.28571428571428,7,4087,6731.666666666667,1514.0,583.8571428571429
36427.0,6,10,2032,5,524,8775.5,252.0,104.8,5,1508,8804.0,1236.0,301.6
135134703.0,17,6,1206,6,1206,27026940.6,201.0,201.0,0,0,0.0,0.0,0.0
86986.0,17,2,286,2,286,0.0,143.0,143.0,0,0,0.0,0.0,0.0
90256178.0,6,16,2368,9,1204,11282022.25,188.0,133.77777777777777,7,1164,15015212.666666666,204.0,166.28571428571428
108103626.0,17,5,1005,5,1005,27025906.5,201.0,201.0,0,0,0.0,0.0,0.0
108496.0,17,2,286,2,286,0.0,143.0,143.0,0,0,0.0,0.0,0.0
119609610.0,6,234,26338,117,18382,1029252.3965517242,284.0,157.11111111111111,117,7956,1029252.3189655172,140.0,68.0
2601614.0,6,3,1602,2,850,0.0,784.0,425.0,1,752,0.0,752.0,752.0
304370.0,6,6,412,4,272,101456.66666666669,74.0,68.0,2,140,0.0,74.0,70.0
2421.0,17,4,344,2,150,0.0,75.0,75.0,2,194,0.0,103.0,97.0
90738107.0,6,19,1436,10,745,10077410.222222222,95.0,74.5,9,691,11341773.25,95.0,76.77777777777777
206277.0,6,3,426,2,280,0.0,214.0,140.0,1,146,0.0,146.0,146.0
108105205.0,17,5,955,5,955,27026301.25,191.0,191.0,0,0,0.0,0.0,0.0
90031231.0,17,28,13364,28,13364,3334490.037037037,501.0,477.2857142857143,0,0,0.0,0.0,0.0
1532.0,6,2,177,1,123,0.0,123.0,123.0,1,54,0.0,54.0,54.0
103737.0,17,2,286,2,286,0.0,143.0,143.0,0,0,0.0,0.0,0.0
108104136.0,17,5,1005,5,1005,27026034.0,201.0,201.0,0,0,0.0,0.0,0.0
207067.0,6,3,426,2,280,0.0,214.0,140.0,1,146,0.0,146.0,146.0
1314468.0,6,4,264,2,132,0.0,66.0,66.0,2,132,0.0,66.0,66.0
37112.0,6,14,4740,7,653,5472.5,249.0,93.28571428571428,7,4087,5808.166666666667,1514.0,583.8571428571429
10535338.0,6,7,478,4,272,3464628.6666666665,74.0,68.0,3,206,5196821.0,74.0,68.66666666666667
2574330.0,6,2,132,1,66,0.0,66.0,66.0,1,66,0.0,66.0,66.0
90257999.0,6,12,1832,8,1016,12893999.857142856,188.0,127.0,4,816,30031477.666666668,204.0,204.0
367546.0,6,12,1373,7,714,61257.66666666666,298.0,102.0,5,659,90987.25,379.0,131.8
319.0,17,2,250,1,93,0.0,93.0,93.0,1,157,0.0,157.0,157.0
141012.0,6,2,132,1,66,0.0,66.0,66.0,1,66,0.0,66.0,66.0
35440.0,6,14,4740,7,653,5516.333333333333,249.0,93.28571428571428,7,4087,3906.5,1514.0,583.8571428571429
9355.0,17,2,571,1,86,0.0,86.0,86.0,1,485,0.0,485.0,485.0
2362.0,17,4,344,2,150,0.0,75.0,75.0,2,194,0.0,103.0,97.0
58101.0,6,14,4740,7,653,9551.833333333334,249.0,93.28571428571428,7,4087,9543.666666666666,1514.0,583.8571428571429
121257.0,6,3,337,2,214,0.0,160.0,107.0,1,123,0.0,123.0,123.0
240617.0,6,3,337,2,214,0.0,160.0,107.0,1,123,0.0,123.0,123.0
745.0,17,4,438,2,148,0.0,74.0,74.0,2,290,0.0,147.0,145.0
2312.0,17,4,344,2,150,0.0,75.0,75.0,2,194,0.0,103.0,97.0
0.0,17,1,44,1,44,0.0,44.0,44.0,0,0,0.0,0.0,0.0
35612.0,6,14,4740,7,653,4881.833333333333,249.0,93.28571428571428,7,4087,5798.5,1514.0,583.8571428571429
35185.0,6,14,4740,7,653,4485.666666666667,249.0,93.28571428571428,7,4087,5723.833333333333,1514.0,583.8571428571429
112306.0,17,4,1400,4,1400,37435.333333333336,350.0,350.0,0,0,0.0,0.0,0.0
119896.0,17,2,180,1,70,0.0,70.0,70.0,1,110,0.0,110.0,110.0
53571.0,6,14,4740,7,653,8174.5,249.0,93.28571428571428,7,4087,8204.333333333334,1514.0,583.8571428571429
21724.0,6,14,4740,7,653,3504.1666666666665,249.0,93.28571428571428,7,4087,3479.6666666666665,1514.0,583.8571428571429
120001100.0,17,15,1169,8,606,17143014.285714287,174.0,75.75,7,563,16665056.5,174.0,80.42857142857143
311230.0,17,4,1400,4,1400,103743.33333333331,350.0,350.0,0,0,0.0,0.0,0.0
31073.0,6,10,2032,5,524,7392.5,252.0,104.8,5,1508,6736.75,1236.0,301.6
2980916.0,6,3,1602,2,850,0.0,784.0,425.0,1,752,0.0,752.0,752.0
5637168.0,6,5,336,2,134,0.0,68.0,67.0,3,202,1429588.5,70.0,67.33333333333333
228204.0,17,2,180,1,90,0.0,90.0,90.0,1,90,0.0,90.0,90.0
257193.0,6,3,337,2,214,0.0,160.0,107.0,1,123,0.0,123.0,123.0
15153957.0,17,6,2718,6,2718,3030791.4,453.0,453.0,0,0,0.0,0.0,0.0
2026.0,17,4,344,2,150,0.0,75.0,75.0,2,194,0.0,103.0,97.0
111346367.0,6,228,25788,114,18042,983461.4601769912,284.0,158.26315789473685,114,7746,983462.8230088496,140.0,67.94736842105263
322149.0,6,10,1221,6,636,64429.8,298.0,106.0,4,585,102004.0,379.0,146.25
146877.0,6,3,373,2,238,0.0,172.0,119.0,1,135,0.0,135.0,135.0
231828.0,17,4,1400,4,1400,77276.0,350.0,350.0,0,0,0.0,0.0,0.0
285730.0,17,2,363,1,79,0.0,79.0,79.0,1,284,0.0,284.0,284.0
108113113.0,17,5,955,5,955,27028278.25,191.0,191.0,0,0,0.0,0.0,0.0
140915.0,6,2,132,1,66,0.0,66.0,66.0,1,66,0.0,66.0,66.0
111494.0,6,14,4740,7,653,10363.0,249.0,93.28571428571428,7,4087,16986.166666666668,1514.0,583.8571428571429
14478.0,6,14,4740,7,653,2125.6666666666665,249.0,93.28571428571428,7,4087,2276.5,1514.0,583.8571428571429
204597.0,17,2,762,2,762,0.0,381.0,381.0,0,0,0.0,0.0,0.0
18437.0,6,10,2032,5,524,4253.75,252.0,104.8,5,1508,3925.5,1236.0,301.6
3016.0,17,2,224,1,76,0.0,76.0,76.0,1,148,0.0,148.0,148.0
377606.0,6,10,1221,6,636,75521.2,298.0,106.0,4,585,124412.66666666669,379.0,146.25
50760.0,17,2,180,1,90,0.0,90.0,90.0,1,90,0.0,90.0,90.0
120058527.0,17,28,13364,28,13364,4446612.111111111,501.0,477.2857142857143,0,0,0.0,0.0,0.0
297720.0,6,6,412,4,272,99240.0,74.0,68.0,2,140,0.0,74.0,70.0
331.0,17,2,166,1,75,0.0,75.0,75.0,1,91,0.0,91.0,91.0
207250.0,6,3,426,2,280,0.0,214.0,140.0,1,146,0.0,146.0,146.0
9861.0,6,11,2098,6,590,1845.2,252.0,98.33333333333331,5,1508,1895.75,1236.0,301.6
309837.0,6,3,202,2,128,0.0,74.0,64.0,1,74,0.0,74.0,74.0
0.0,6,1,66,0,0,0.0,0.0,0.0,1,66,0.0,66.0,66.0
300015.0,17,2,180,1,90,0.0,90.0,90.0,1,90,0.0,90.0,90.0
301337.0,6,6,412,4,272,100445.66666666669,74.0,68.0,2,140,0.0,74.0,70.0
232136.0,6,3,337,2,214,0.0,160.0,107.0,1,123,0.0,123.0,123.0
6866.0,17,2,582,1,83,0.0,83.0,83.0,1,499,0.0,499.0,499.0
11793457.0,6,5,1909,2,892,0.0,826.0,446.0,3,1017,5827845.0,885.0,339.0
120418719.0,6,211,23802,106,16650,1146844.9428571428,284.0,157.0754716981132,105,7152,1147866.9807692308,140.0,68.11428571428571
39800.0,6,10,2032,5,524,7342.25,252.0,104.8,5,1508,9375.0,1236.0,301.6
105371943.0,17,14,864,7,432,17561990.5,174.0,61.71428571428572,7,432,17526665.166666668,174.0,61.71428571428572
96005121.0,17,13,1083,7,563,16000853.5,174.0,80.42857142857143,6,520,17015223.0,174.0,86.66666666666667
16176.0,6,20,7606,11,978,1617.6,310.0,88.9090909090909,9,6628,1653.375,1514.0,736.4444444444445
303736.0,6,6,412,4,272,101245.33333333331,74.0,68.0,2,140,0.0,74.0,70.0
2802462.0,6,2,132,1,66,0.0,66.0,66.0,1,66,0.0,66.0,66.0
23370.0,6,14,4740,7,653,3443.833333333333,249.0,93.28571428571428,7,4087,3712.5,1514.0,583.8571428571429
90283926.0,6,16,1192,8,596,12891354.142857144,95.0,74.5,8,596,12896457.142857144,95.0,74.5
40983.0,6,14,4740,7,653,6699.333333333333,249.0,93.28571428571428,7,4087,6693.5,1514.0,583.8571428571429
19781.0,17,2,582,1,83,0.0,83.0,83.0,1,499,0.0,499.0,499.0
48210.0,6,14,4740,7,653,7486.5,249.0,93.28571428571428,7,4087,7835.833333333333,1514.0,583.8571428571429
333.0,17,2,166,1,75,0.0,75.0,75.0,1,91,0.0,91.0,91.0
57016.0,6,12,1328,7,797,9502.666666666666,253.0,113.85714285714286,5,531,11826.5,259.0,106.2
153391.0,17,2,180,1,90,0.0,90.0,90.0,1,90,0.0,90.0,90.0
303364.0,6,3,202,2,128,0.0,74.0,64.0,1,74,0.0,74.0,74.0
203662.0,17,4,1524,4,1524,67887.33333333333,381.0,381.0,0,0,0.0,0.0,0.0
36789.0,6,14,4740,7,653,5375.0,249.0,93.28571428571428,7,4087,5935.333333333333,1514.0,583.8571428571429
68390.0,6,10,2032,5,524,16696.5,252.0,104.8,5,1508,14782.5,1236.0,301.6
105629.0,17,2,762,2,762,0.0,381.0,381.0,0,0,0.0,0.0,0.0
59597.0,6,14,4740,7,653,9807.5,249.0,93.28571428571428,7,4087,8576.0,1514.0,583.8571428571429
10869282.0,6,8,544,4,272,3577803.6666666665,74.0,68.0,4,272,3577717.6666666665,74.0,68.0
119718553.0,17,35,16705,35,16705,3521133.911764706,501.0,477.2857142857143,0,0,0.0,0.0,0.0
18907.0,6,10,2032,5,524,3870.0,252.0,104.8,5,1508,4440.0,1236.0,301.6
1248286.0,6,7,499,3,198,614045.0,66.0,66.0,4,301,387427.6666666667,103.0,75.25
286848.0,6,10,1221,6,636,57369.6,298.0,106.0,4,585,89876.0,379.0,146.25
120002986.0,6,19,1436,9,691,15000373.25,95.0,76.77777777777777,10,745,13305400.444444444,95.0,74.5
198649.0,17,2,180,1,90,0.0,90.0,90.0,1,90,0.0,90.0,90.0
322234.0,17,4,1400,4,1400,107411.33333333331,350.0,350.0,0,0,0.0,0.0,0.0
90028410.0,17,28,13364,28,13364,3334385.5555555555,501.0,477.2857142857143,0,0,0.0,0.0,0.0
108296229.0,17,14,864,7,432,18001582.333333332,174.0,61.71428571428572,7,432,18000173.833333332,174.0,61.71428571428572
317919.0,6,6,412,4,272,105973.0,74.0,68.0,2,140,0.0,74.0,70.0
120102190.0,6,238,27588,119,8088,1010904.7033898304,140.0,67.96638655462185,119,19500,1010835.720338983,300.0,163.8655462184874
90759481.0,6,20,1531,11,840,9071543.6,95.0,76.36363636363636,9,691,11344273.5,95.0,76.77777777777777
3979.0,17,4,344,2,150,0.0,75.0,75.0,2,194,0.0,103.0,97.0
58892.0,6,14,4740,7,653,8748.5,249.0,93.28571428571428,7,4087,9615.0,1514.0,583.8571428571429
307990.0,6,6,412,4,272,102663.33333333331,74.0,68.0,2,140,0.0,74.0,70.0
108107896.0,17,5,955,5,955,27026974.0,191.0,191.0,0,0,0.0,0.0,0.0
120049453.0,17,28,13364,28,13364,4446276.037037037,501.0,477.2857142857143,0,0,0.0,0.0,0.0
135124776.0,17,6,1206,6,1206,27024955.2,201.0,201.0,0,0,0.0,0.0,0.0
120041150.0,6,18,1341,9,691,14999644.75,95.0,76.77777777777777,9,650,14999461.375,95.0,72.22222222222223
113347019.0,6,215,24348,108,7424,1059317.9345794392,140.0,68.74074074074075,107,16924,1060703.349056604,300.0,158.16822429906543
246121.0,6,3,337,2,214,0.0,160.0,107.0,1,123,0.0,123.0,123.0
100443.0,17,2,762,2,762,0.0,381.0,381.0,0,0,0.0,0.0,0.0
90752889.0,6,19,1436,10,745,10078585.666666666,95.0,74.5,9,691,11343632.125,95.0,76.77777777777777
21448662.0,6,6,1981,4,1087,7149554.0,885.0,271.75,2,894,0.0,826.0,447.0
119695656.0,6,252,29692,126,21068,955843.512,284.0,167.20634920634922,126,8624,956106.888,140.0,68.44444444444444
120035484.0,17,29,13785,29,13785,4286981.571428572,501.0,475.3448275862069,0,0,0.0,0.0,0.0
403679.0,6,13,1439,7,714,67279.83333333333,298.0,102.0,6,725,77007.8,379.0,120.83333333333331
436741.0,6,11,1021,6,444,58618.6,162.0,74.0,5,577,73081.5,349.0,115.4
21240758.0,6,26,7627,14,3735,186780.53846153847,1514.0,266.7857142857143,12,3892,1911310.0909090908,1514.0,324.3333333333333
46117.0,6,14,4740,7,653,6326.5,249.0,93.28571428571428,7,4087,7548.0,1514.0,583.8571428571429
300618.0,6,6,412,4,272,100206.0,74.0,68.0,2,140,0.0,74.0,70.0
63503119.0,6,8,1307,8,1307,9071874.142857144,172.0,163.375,0,0,0.0,0.0,0.0
94887244.0,6,159,17956,80,5428,1201104.3544303798,140.0,67.85,79,12528,1203215.8846153845,284.0,158.58227848101265
72907.0,6,14,4740,7,653,11916.333333333334,249.0,93.28571428571428,7,4087,11945.0,1514.0,583.8571428571429
90763205.0,6,22,1680,12,894,8246910.363636363,95.0,74.5,10,786,10083712.111111112,95.0,78.6
2299.0,17,4,344,2,150,0.0,75.0,75.0,2,194,0.0,103.0,97.0
978705.0,6,4,264,2,132,0.0,66.0,66.0,2,132,0.0,66.0,66.0
308216.0,6,6,412,4,272,102738.66666666669,74.0,68.0,2,140,0.0,74.0,70.0
74898.0,6,14,4740,7,653,12358.0,249.0,93.28571428571428,7,4087,11734.666666666666,1514.0,583.8571428571429
143953.0,17,2,180,1,90,0.0,90.0,90.0,1,90,0.0,90.0,90.0
241264.0,6,3,337,2,214,0.0,160.0,107.0,1,123,0.0,123.0,123.0
100619442.0,6,379,45314,190,12836,532378.0,140.0,67.5578947368421,189,32478,532877.8297872341,284.0,171.84126984126985
215920.0,17,2,180,1,90,0.0,90.0,90.0,1,90,0.0,90.0,90.0
2804501.0,6,2,132,1,66,0.0,66.0,66.0,1,66,0.0,66.0,66.0
205812.0,17,2,180,1,90,0.0,90.0,90.0,1,90,0.0,90.0,90.0
2123.0,17,4,344,2,150,0.0,75.0,75.0,2,194,0.0,103.0,97.0
107060.0,17,4,1400,4,1400,35686.666666666664,350.0,350.0,0,0,0.0,0.0,0.0
153530.0,17,2,180,1,90,0.0,90.0,90.0,1,90,0.0,90.0,90.0
57698.0,6,14,4740,7,653,9488.833333333334,249.0,93.28571428571428,7,4087,6526.166666666667,1514.0,583.8571428571429
13924.0,6,10,1065,5,534,2728.25,262.0,106.8,5,531,3146.5,259.0,106.2
9203.0,17,2,539,1,86,0.0,86.0,86.0,1,453,0.0,453.0,453.0
99136138.0,6,204,23352,102,16398,979403.4653465346,300.0,160.76470588235293,102,6954,979402.5247524752,140.0,68.17647058823529
1305755.0,6,4,264,2,132,0.0,66.0,66.0,2,132,0.0,66.0,66.0
299507.0,6,6,412,4,272,99835.66666666669,74.0,68.0,2,140,0.0,74.0,70.0
217284.0,6,3,426,2,280,0.0,214.0,140.0,1,146,0.0,146.0,146.0
234913.0,6,3,337,2,214,0.0,160.0,107.0,1,123,0.0,123.0,123.0
14943.0,17,2,180,1,90,0.0,90.0,90.0,1,90,0.0,90.0,90.0
2805016.0,6,5,367,2,132,0.0,66.0,66.0,3,235,1402508.0,103.0,78.33333333333333
135134879.0,17,6,1206,6,1206,27026975.8,201.0,201.0,0,0,0.0,0.0,0.0
90209216.0,6,16,1192,8,596,12852708.714285716,95.0,74.5,8,596,12857668.42857143,95.0,74.5
1191804.0,6,13,3010,8,2382,170257.7142857143,1514.0,297.75,5,628,229139.0,331.0,125.6
47812838.0,6,8,1940,3,887,22551984.5,753.0,295.6666666666667,5,1053,11257336.25,785.0,210.6
36590.0,6,14,4740,7,653,5316.333333333333,249.0,93.28571428571428,7,4087,5802.5,1514.0,583.8571428571429
196737.0,17,2,180,1,90,0.0,90.0,90.0,1,90,0.0,90.0,90.0
120000016.0,6,17,1287,9,691,15000002.0,95.0,76.77777777777777,8,596,12901155.285714284,95.0,74.5
277699.0,17,2,363,1,79,0.0,79.0,79.0,1,284,0.0,284.0,284.0
937.0,17,5,550,5,550,234.25,110.0,110.0,0,0,0.0,0.0,0.0
857177.0,6,9,1269,6,798,171435.4,460.0,133.0,3,471,290790.5,331.0,157.0
209389.0,17,2,180,1,90,0.0,90.0,90.0,1,90,0.0,90.0,90.0
0.0,6,1,66,1,66,0.0,66.0,66.0,0,0,0.0,0.0,0.0
123456113.0,6,49,3234,25,1650,5144004.708333333,66.0,66.0,24,1584,5149849.304347826,66.0,66.0
3641579.0,17,3,1026,3,1026,1820789.5,342.0,342.0,0,0,0.0,0.0,0.0
120110190.0,6,242,27326,121,8208,993967.325,140.0,67.83471074380165,121,19118,993932.6,284.0,158.0
96435162.0,6,26,1746,13,906,8018277.083333333,123.0,69.6923076923077,13,840,8017568.666666667,123.0,64.61538461538461
4505.0,17,2,614,1,72,0.0,72.0,72.0,1,542,0.0,542.0,542.0
103211271.0,6,214,24090,107,16806,971661.4716981133,284.0,157.06542056074767,107,7284,971662.4811320754,140.0,68.07476635514018
103715.0,17,2,286,2,286,0.0,143.0,143.0,0,0,0.0,0.0,0.0
39416.0,6,14,4740,7,653,6433.166666666667,249.0,93.28571428571428,7,4087,5954.5,1514.0,583.8571428571429
120000151.0,6,17,1287,9,691,15000018.875,95.0,76.77777777777777,8,596,12897739.0,95.0,74.5
90253795.0,6,12,1832,8,1016,12893399.285714284,188.0,127.0,4,816,30029357.33333333,204.0,204.0
144104.0,17,2,180,1,90,0.0,90.0,90.0,1,90,0.0,90.0,90.0
228334.0,17,2,180,1,90,0.0,90.0,90.0,1,90,0.0,90.0,90.0
9636.0,6,10,1067,5,536,2157.75,264.0,107.2,5,531,2094.75,259.0,106.2
9283.0,17,2,582,1,83,0.0,83.0,83.0,1,499,0.0,499.0,499.0
5818118.0,6,4,270,2,134,0.0,68.0,67.0,2,136,0.0,70.0,68.0
90002271.0,6,17,1287,9,691,11250283.875,95.0,76.77777777777777,8,596,12789297.285714284,95.0,74.5
90255298.0,6,12,1832,8,1016,12893614.0,188.0,127.0,4,816,30030768.666666668,204.0,204.0
135153308.0,17,6,1206,6,1206,27030661.6,201.0,201.0,0,0,0.0,0.0,0.0
330040.0,6,6,412,4,272,110013.33333333331,74.0,68.0,2,140,0.0,74.0,70.0
19086.0,6,2,145,2,145,0.0,91.0,72.5,0,0,0.0,0.0,0.0
116896244.0,6,30,1974,15,1026,8334291.857142857,123.0,68.4,15,948,8334297.357142857,123.0,63.2
12554.0,6,13,1459,7,862,2017.0,271.0,123.14285714285714,6,597,2323.0,259.0,99.5
0.0,17,1,381,1,381,0.0,381.0,381.0,0,0,0.0,0.0,0.0
31000.0,6,14,4740,7,653,5044.833333333333,249.0,93.28571428571428,7,4087,4510.0,1514.0,583.8571428571429
201607.0,17,4,1524,4,1524,67202.33333333333,381.0,381.0,0,0,0.0,0.0,0.0
241808.0,6,3,373,2,238,0.0,172.0,119.0,1,135,0.0,135.0,135.0
39695.0,6,10,2032,5,524,8467.0,252.0,104.8,5,1508,9069.75,1236.0,301.6
108809.0,17,2,286,2,286,0.0,143.0,143.0,0,0,0.0,0.0,0.0
42084.0,6,10,2032,5,524,10282.5,252.0,104.8,5,1508,10163.25,1236.0,301.6
3455534.0,6,145,123444,90,115512,38826.22471910113,1510.0,1283.4666666666667,55,7932,57617.14814814815,1510.0,144.21818181818182
4509.0,17,4,344,2,150,0.0,75.0,75.0,2,194,0.0,103.0,97.0
12573.0,6,10,1067,5,536,2547.25,264.0,107.2,5,531,2893.75,259.0,106.2
180439.0,6,11,1132,6,556,36087.8,218.0,92.66666666666669,5,576,44333.25,304.0,115.2
1029687.0,6,11,1134,6,558,205937.4,220.0,93.0,5,576,255988.25,304.0,115.2
90290490.0,6,16,1192,8,596,12892241.0,95.0,74.5,8,596,12897963.285714284,95.0,74.5
124815505.0,17,14,864,7,432,19988767.166666668,174.0,61.71428571428572,7,432,17581991.666666668,174.0,61.71428571428572
2906.0,17,4,344,2,150,0.0,75.0,75.0,2,194,0.0,103.0,97.0
108107511.0,17,5,1005,5,1005,27026877.75,201.0,201.0,0,0,0.0,0.0,0.0
16495.0,6,14,4740,7,653,2366.1666666666665,249.0,93.28571428571428,7,4087,2569.5,1514.0,583.8571428571429
108001146.0,17,14,864,7,432,18000191.0,174.0,61.71428571428572,7,432,17834629.0,174.0,61.71428571428572
45171.0,6,14,4740,7,653,6894.666666666667,249.0,93.28571428571428,7,4087,6634.5,1514.0,583.8571428571429
284633.0,17,2,363,1,79,0.0,79.0,79.0,1,284,0.0,284.0,284.0
821.0,17,4,438,2,148,0.0,74.0,74.0,2,290,0.0,147.0,145.0
103797.0,17,2,286,2,286,0.0,143.0,143.0,0,0,0.0,0.0,0.0
1052823.0,6,11,1134,6,558,210564.6,220.0,93.0,5,576,260615.25,304.0,115.2
135129671.0,17,6,1146,6,1146,27025934.2,191.0,191.0,0,0,0.0,0.0,0.0
135131313.0,17,6,1206,6,1206,27026262.6,201.0,201.0,0,0,0.0,0.0,0.0
709438.0,6,5,336,2,134,0.0,68.0,67.0,3,202,296739.0,70.0,67.33333333333333
171628.0,17,2,180,1,90,0.0,90.0,90.0,1,90,0.0,90.0,90.0
202967.0,17,2,180,1,90,0.0,90.0,90.0,1,90,0.0,90.0,90.0
4008.000000000001,17,2,586,1,81,0.0,81.0,81.0,1,505,0.0,505.0,505.0
2010825.0,17,4,525,2,150,0.0,75.0,75.0,2,375,0.0,284.0,187.5
209735.0,6,10,1221,6,636,41947.0,298.0,106.0,4,585,68661.33333333333,379.0,146.25
608686.0,17,2,346,1,78,0.0,78.0,78.0,1,268,0.0,268.0,268.0
876583.0,6,9,1096,6,625,175316.6,287.0,104.16666666666669,3,471,300558.5,331.0,157.0
91134915.0,6,160,18112,80,12610,1150881.0379746836,284.0,157.625,80,5502,1150879.3797468354,140.0,68.775
4605.0,17,2,614,1,72,0.0,72.0,72.0,1,542,0.0,542.0,542.0
16687951.000000002,6,20,1611,9,921,2047379.25,315.0,102.33333333333331,11,690,1637888.2,78.0,62.72727272727273
2265.0,17,2,180,1,90,0.0,90.0,90.0,1,90,0.0,90.0,90.0
99275762.0,17,11,604,6,389,19855152.4,174.0,64.83333333333333,5,215,19999495.75,43.0,43.0
161.0,17,2,3028,2,3028,0.0,1514.0,1514.0,0,0,0.0,0.0,0.0
5628771.0,6,4,270,2,134,0.0,68.0,67.0,2,136,0.0,70.0,68.0
122302021.0,6,35,2410,18,1285,7194236.529411765,139.0,71.38888888888889,17,1125,7006337.6875,123.0,66.17647058823529
244881.0,6,10,1221,6,636,48976.2,298.0,106.0,4,585,79391.66666666667,379.0,146.25
102871.0,17,2,762,2,762,0.0,381.0,381.0,0,0,0.0,0.0,0.0
108089593.0,17,5,955,5,955,27022398.25,191.0,191.0,0,0,0.0,0.0,0.0
120122826.0,6,13,2020,9,1204,15015353.25,188.0,133.77777777777777,4,816,30030358.666666668,204.0,204.0
114250460.0,6,47,3102,24,1584,4967399.695652174,66.0,66.0,23,1518,5151994.318181818,66.0,66.0
104022.0,17,2,286,2,286,0.0,143.0,143.0,0,0,0.0,0.0,0.0
2169.0,17,2,932,1,590,0.0,590.0,590.0,1,342,0.0,342.0,342.0
1476206.0,17,16,1120,16,1120,98413.73333333334,70.0,70.0,0,0,0.0,0.0,0.0
135125175.0,17,6,1206,6,1206,27025035.0,201.0,201.0,0,0,0.0,0.0,0.0
90095057.0,6,11,1644,4,816,30030887.33333333,204.0,204.0,7,828,15015451.666666666,188.0,118.28571428571428
90040248.0,17,28,13364,28,13364,3334824.0,501.0,477.2857142857143,0,0,0.0,0.0,0.0
322760.0,17,4,1400,4,1400,107586.66666666669,350.0,350.0,0,0,0.0,0.0,0.0
90046831.0,17,28,13364,28,13364,3335067.814814815,501.0,477.2857142857143,0,0,0.0,0.0,0.0
93284790.0,6,23,1775,10,786,10364976.666666666,95.0,78.6,13,989,7752670.0,95.0,76.07692307692308
204240.0,17,3,1143,3,1143,102120.0,381.0,381.0,0,0,0.0,0.0,0.0
146397.0,6,3,337,2,214,0.0,160.0,107.0,1,123,0.0,123.0,123.0
321.0,17,2,174,1,79,0.0,79.0,79.0,1,95,0.0,95.0,95.0
107116.0,17,2,286,2,286,0.0,143.0,143.0,0,0,0.0,0.0,0.0
120149000.0,6,280,32480,140,9536,858621.964028777,140.0,68.11428571428571,140,22944,858454.7841726618,284.0,163.88571428571427
209441.0,17,2,180,1,90,0.0,90.0,90.0,1,90,0.0,90.0,90.0
36454.0,6,11,2098,6,590,4234.6,252.0,98.33333333333331,5,1508,8710.0,1236.0,301.6
562.0,17,2,508,2,508,0.0,257.0,254.0,0,0,0.0,0.0,0.0
90120857.0,6,11,1644,4,816,30033825.0,204.0,204.0,7,828,15019759.166666666,188.0,118.28571428571428
237457.0,17,2,180,1,90,0.0,90.0,90.0,1,90,0.0,90.0,90.0
1320915.0,6,4,264,2,132,0.0,66.0,66.0,2,132,0.0,66.0,66.0
105423.0,17,2,700,2,700,0.0,350.0,350.0,0,0,0.0,0.0,0.0
401848.0,6,4,508,2,238,0.0,172.0,119.0,2,270,0.0,135.0,135.0
2386.0,17,4,344,2,150,0.0,75.0,75.0,2,194,0.0,103.0,97.0
60731410.0,6,8,1307,8,1307,8675915.714285715,172.0,163.375,0,0,0.0,0.0,0.0
245499.0,6,3,337,2,214,0.0,160.0,107.0,1,123,0.0,123.0,123.0
2810102.0,6,2,132,1,66,0.0,66.0,66.0,1,66,0.0,66.0,66.0
121292.0,6,3,337,2,214,0.0,160.0,107.0,1,123,0.0,123.0,123.0
226437.0,17,4,1400,4,1400,75479.0,350.0,350.0,0,0,0.0,0.0,0.0
36725.0,6,10,2032,5,524,8881.75,252.0,104.8,5,1508,7750.5,1236.0,301.6
344.0,17,2,267,1,83,0.0,83.0,83.0,1,184,0.0,184.0,184.0
2045.0,17,4,344,2,150,0.0,75.0,75.0,2,194,0.0,103.0,97.0
508092.0,6,3,1604,2,851,0.0,785.0,425.5,1,753,0.0,753.0,753.0
108107623.0,17,5,955,5,955,27026905.75,191.0,191.0,0,0,0.0,0.0,0.0
108109936.0,17,5,1005,5,1005,27027484.0,201.0,201.0,0,0,0.0,0.0,0.0
135133758.0,17,6,1206,6,1206,27026751.6,201.0,201.0,0,0,0.0,0.0,0.0
2603339.0,6,2,132,1,66,0.0,66.0,66.0,1,66,0.0,66.0,66.0
110001081.0,17,13,821,7,432,18333513.5,174.0,61.71428571428572,6,389,18003160.6,174.0,64.83333333333333
121749.0,6,3,337,2,214,0.0,160.0,107.0,1,123,0.0,123.0,123.0
3084.0,17,2,224,1,76,0.0,76.0,76.0,1,148,0.0,148.0,148.0
120020875.0,17,29,13785,29,13785,4286459.821428572,501.0,475.3448275862069,0,0,0.0,0.0,0.0
149740683.0,17,36,17126,36,17126,4278305.228571429,501.0,475.72222222222223,0,0,0.0,0.0,0.0
204991.0,17,2,180,1,90,0.0,90.0,90.0,1,90,0.0,90.0,90.0
10486986.0,6,6,412,3,206,5175483.5,74.0,68.66666666666667,3,206,5175388.5,74.0,68.66666666666667
120351595.0,6,342,41432,171,11582,703070.405882353,140.0,67.73099415204679,171,29850,707770.9470588235,336.0,174.56140350877192
2029.0,17,4,344,2,150,0.0,75.0,75.0,2,194,0.0,103.0,97.0
209690.0,17,2,180,1,90,0.0,90.0,90.0,1,90,0.0,90.0,90.0
10534811.0,6,7,478,4,272,3464500.0,74.0,68.0,3,206,5196629.0,74.0,68.66666666666667
90257021.0,6,12,1832,8,1016,12893860.142857144,188.0,127.0,4,816,30031011.0,204.0,204.0
107597.0,17,2,286,2,286,0.0,143.0,143.0,0,0,0.0,0.0,0.0
207181.0,6,3,426,2,280,0.0,214.0,140.0,1,146,0.0,146.0,146.0
2157127.0,6,26,7676,14,2582,165536.38461538462,1034.0,184.42857142857144,12,5094,168133.72727272726,1510.0,424.5
107833646.0,6,28,1860,14,966,8278292.307692308,123.0,69.0,14,894,8278284.307692308,123.0,63.85714285714285
103422978.0,6,44,2904,22,1452,4922100.0,66.0,66.0,22,1452,4917104.333333333,66.0,66.0
216492.0,17,2,180,1,90,0.0,90.0,90.0,1,90,0.0,90.0,90.0
108106400.0,17,5,955,5,955,27026600.0,191.0,191.0,0,0,0.0,0.0,0.0
99191.0,17,4,1400,4,1400,33063.666666666664,350.0,350.0,0,0,0.0,0.0,0.0
220496.0,17,2,180,1,90,0.0,90.0,90.0,1,90,0.0,90.0,90.0
309595.0,17,4,1400,4,1400,103198.33333333331,350.0,350.0,0,0,0.0,0.0,0.0
790962.0,6,10,1065,5,534,196978.75,262.0,106.8,5,531,197268.25,259.0,106.2
81885.0,6,12,1328,7,797,13647.5,253.0,113.85714285714286,5,531,18205.0,259.0,106.2
232231.0,6,3,337,2,214,0.0,160.0,107.0,1,123,0.0,123.0,123.0
253610.0,6,3,337,2,214,0.0,160.0,107.0,1,123,0.0,123.0,123.0
106954.0,17,2,286,2,286,0.0,143.0,143.0,0,0,0.0,0.0,0.0
1592473.0,6,18,6507,10,1598,176941.44444444444,505.0,159.8,8,4909,183127.2857142857,1510.0,613.625
2024889.0,17,4,525,2,150,0.0,75.0,75.0,2,375,0.0,284.0,187.5
20545.0,6,14,4740,7,653,3292.833333333333,249.0,93.28571428571428,7,4087,3286.6666666666665,1514.0,583.8571428571429
235253.0,6,3,337,2,214,0.0,160.0,107.0,1,123,0.0,123.0,123.0
232338.0,6,3,337,2,214,0.0,160.0,107.0,1,123,0.0,123.0,123.0
217830.0,6,3,426,2,280,0.0,214.0,140.0,1,146,0.0,146.0,146.0
113731937.0,6,46,3036,23,1518,5155441.863636363,66.0,66.0,23,1518,5155442.954545454,66.0,66.0
90533099.0,6,13,2036,8,1016,12933299.857142856,188.0,127.0,5,1020,22591899.0,204.0,204.0
18015.0,6,14,4740,7,653,2755.0,249.0,93.28571428571428,7,4087,2821.5,1514.0,583.8571428571429
47608340.0,6,7,1874,3,887,22589858.5,753.0,295.6666666666667,4,987,15011988.333333334,785.0,246.75
127738497.0,6,33,2280,17,1209,7983656.0625,123.0,71.11764705882354,16,1071,7835762.8,123.0,66.9375
102814.0,17,2,286,2,286,0.0,143.0,143.0,0,0,0.0,0.0,0.0
90014042.0,17,27,12943,27,12943,3462078.5384615385,501.0,479.3703703703704,0,0,0.0,0.0,0.0
135130383.0,17,6,1146,6,1146,27026076.6,191.0,191.0,0,0,0.0,0.0,0.0
2045.0,17,4,344,2,150,0.0,75.0,75.0,2,194,0.0,103.0,97.0
32267590.0,17,5,1718,4,1368,964932.6666666666,342.0,342.0,1,350,0.0,350.0,350.0
101796.0,17,2,762,2,762,0.0,381.0,381.0,0,0,0.0,0.0,0.0
243357.0,6,10,1221,6,636,48671.4,298.0,106.0,4,585,79762.66666666667,379.0,146.25
92196085.0,17,15,5130,15,5130,6585434.642857143,342.0,342.0,0,0,0.0,0.0,0.0
363.0,17,2,166,1,75,0.0,75.0,75.0,1,91,0.0,91.0,91.0
2304.0,17,4,344,2,150,0.0,75.0,75.0,2,194,0.0,103.0,97.0
99432.0,17,2,762,2,762,0.0,381.0,381.0,0,0,0.0,0.0,0.0
0.0,6,1,54,0,0,0.0,0.0,0.0,1,54,0.0,54.0,54.0
35766.0,6,14,4740,7,653,5246.166666666667,249.0,93.28571428571428,7,4087,5805.0,1514.0,583.8571428571429
40672.0,6,10,2032,5,524,9924.5,252.0,104.8,5,1508,9158.5,1236.0,301.6
95013610.0,17,14,1126,7,563,15834556.0,174.0,80.42857142857143,7,563,15833468.333333334,174.0,80.42857142857143
135129093.0,17,6,1206,6,1206,27025818.6,201.0,201.0,0,0,0.0,0.0,0.0
7889.0,17,2,610,1,72,0.0,72.0,72.0,1,538,0.0,538.0,538.0
1490619.0,6,4,276,2,128,0.0,74.0,64.0,2,148,0.0,74.0,74.0
115283528.0,6,30,1974,15,1026,8219109.714285715,123.0,68.4,15,948,8219108.0,123.0,63.2
0.0,6,1,66,1,66,0.0,66.0,66.0,0,0,0.0,0.0,0.0
26865.0,6,14,4740,7,653,3516.5,249.0,93.28571428571428,7,4087,4205.5,1514.0,583.8571428571429
278803.0,6,12,1373,7,714,46467.16666666666,298.0,102.0,5,659,65638.75,379.0,131.8
108106013.0,17,5,955,5,955,27026503.25,191.0,191.0,0,0,0.0,0.0,0.0
120118741.0,6,13,2020,9,1204,15014842.625,188.0,133.77777777777777,4,816,30042128.0,204.0,204.0
302.0,17,2,164,1,82,0.0,82.0,82.0,1,82,0.0,82.0,82.0
14644352.0,6,20,1607,10,975,1593061.4444444445,315.0,97.5,10,632,1593039.0,78.0,63.2
79670.0,6,14,4740,7,653,12700.166666666666,249.0,93.28571428571428,7,4087,11789.666666666666,1514.0,583.8571428571429
2651772.0,6,3,1777,2,951,0.0,885.0,475.5,1,826,0.0,826.0,826.0
91156278.0,6,24,1829,11,840,9115627.8,95.0,76.36363636363636,13,989,7574616.916666667,95.0,76.07692307692308
121227.0,6,3,337,2,214,0.0,160.0,107.0,1,123,0.0,123.0,123.0
9249.0,17,2,582,1,83,0.0,83.0,83.0,1,499,0.0,499.0,499.0
84.0,17,2,762,2,762,0.0,381.0,381.0,0,0,0.0,0.0,0.0
232934.0,6,3,337,2,214,0.0,160.0,107.0,1,123,0.0,123.0,123.0
162307.0,17,2,180,1,90,0.0,90.0,90.0,1,90,0.0,90.0,90.0
302436.0,6,6,412,4,272,100812.0,74.0,68.0,2,140,0.0,74.0,70.0
319879.0,6,6,412,4,272,106626.33333333331,74.0,68.0,2,140,0.0,74.0,70.0
10419286.0,6,6,412,3,206,5141033.5,74.0,68.66666666666667,3,206,5140931.5,74.0,68.66666666666667
120276792.0,6,226,25546,113,7766,1057134.8839285714,140.0,68.72566371681415,113,17780,1064374.9732142857,284.0,157.34513274336285
115412272.0,6,47,3102,24,1584,5004673.478260869,66.0,66.0,23,1518,5150440.227272728,66.0,66.0
117414494.0,6,48,3168,24,1584,5104978.0,66.0,66.0,24,1584,5091519.391304348,66.0,66.0
16571.0,6,14,4740,7,653,2545.5,249.0,93.28571428571428,7,4087,2481.1666666666665,1514.0,583.8571428571429
38704.0,6,14,4740,7,653,5775.5,249.0,93.28571428571428,7,4087,6277.833333333333,1514.0,583.8571428571429
2614197.0,6,3,1604,2,851,0.0,785.0,425.5,1,753,0.0,753.0,753.0
24642.0,17,2,180,1,90,0.0,90.0,90.0,1,90,0.0,90.0,90.0
883995.0,6,12,2710,7,743,147332.5,339.0,106.14285714285714,5,1967,152905.25,1514.0,393.4
15622.0,6,10,1975,5,467,3668.75,195.0,93.4,5,1508,3643.5,1236.0,301.6
1298068.0,6,4,264,2,132,0.0,66.0,66.0,2,132,0.0,66.0,66.0
32888.0,6,14,4740,7,653,5304.666666666667,249.0,93.28571428571428,7,4087,5303.833333333333,1514.0,583.8571428571429
98243735.0,17,12,778,6,389,19601222.4,174.0,64.83333333333333,6,389,19600162.2,174.0,64.83333333333333
232964.0,6,3,337,2,214,0.0,160.0,107.0,1,123,0.0,123.0,123.0
976154.0,6,12,1354,6,723,194363.0,253.0,120.5,6,631,191836.4,293.0,105.16666666666669
306722.0,6,6,412,4,272,102240.66666666669,74.0,68.0,2,140,0.0,74.0,70.0
69124.0,17,2,616,1,75,0.0,75.0,75.0,1,541,0.0,541.0,541.0
124008755.0,17,15,907,8,475,17715536.42857143,174.0,59.375,7,432,17500156.333333332,174.0,61.71428571428572
90037184.0,17,28,13364,28,13364,3334710.5185185187,501.0,477.2857142857143,0,0,0.0,0.0,0.0
27777.0,6,14,4740,7,653,4366.0,249.0,93.28571428571428,7,4087,4119.0,1514.0,583.8571428571429
153383.0,17,2,180,1,90,0.0,90.0,90.0,1,90,0.0,90.0,90.0
41704.0,6,2,132,1,66,0.0,66.0,66.0,1,66,0.0,66.0,66.0
216494.0,17,2,180,1,90,0.0,90.0,90.0,1,90,0.0,90.0,90.0
104113.0,17,2,286,2,286,0.0,143.0,143.0,0,0,0.0,0.0,0.0
302052.0,6,6,412,4,272,100684.0,74.0,68.0,2,140,0.0,74.0,70.0
118910743.0,6,34,2350,17,1225,7419112.875,139.0,72.05882352941177,17,1125,7419110.5,123.0,66.17647058823529
6092210.0,6,10,684,6,396,1218442.0,95.0,66.0,4,288,1957884.0,95.0,72.0
120106585.0,6,34,2397,17,1125,7506661.5625,123.0,66.17647058823529,17,1272,6869161.875,123.0,74.82352941176471
120119062.0,6,15,2444,7,1428,20019843.666666668,204.0,204.0,8,1016,17097592.85714286,188.0,127.0
879864.0,6,12,2718,7,743,146644.0,339.0,106.14285714285714,5,1975,151802.0,1514.0,395.0
92235704.0,17,12,778,6,389,18447140.8,174.0,64.83333333333333,6,389,18356373.6,174.0,64.83333333333333
44696.0,6,11,1132,6,556,8939.2,218.0,92.66666666666669,5,576,7975.5,304.0,115.2
304141.0,6,6,412,4,272,101380.33333333331,74.0,68.0,2,140,0.0,74.0,70.0
146355.0,6,3,337,2,214,0.0,160.0,107.0,1,123,0.0,123.0,123.0
327.0,17,2,164,1,82,0.0,82.0,82.0,1,82,0.0,82.0,82.0
493031.0,6,4,270,2,134,0.0,68.0,67.0,2,136,0.0,70.0,68.0
2713807.0,6,3,1604,2,851,0.0,785.0,425.5,1,753,0.0,753.0,753.0
29913.0,6,14,4740,7,653,4861.833333333333,249.0,93.28571428571428,7,4087,4396.0,1514.0,583.8571428571429
121158482.0,6,28,2168,13,1030,10096540.166666666,95.0,79.23076923076923,15,1138,6493420.928571428,95.0,75.86666666666666
90276150.0,6,21,1585,11,840,9023422.9,95.0,76.36363636363636,10,745,9999429.333333334,95.0,74.5
9489.0,17,2,582,1,83,0.0,83.0,83.0,1,499,0.0,499.0,499.0
120052653.0,17,28,13364,28,13364,4446394.555555556,501.0,477.2857142857143,0,0,0.0,0.0,0.0
301746.0,6,6,412,4,272,100582.0,74.0,68.0,2,140,0.0,74.0,70.0
118307037.0,6,36,2596,18,1248,6959237.470588235,123.0,69.33333333333333,18,1348,6359065.05882353,139.0,74.88888888888889
266445.0,6,10,1221,6,636,53289.0,298.0,106.0,4,585,83428.33333333333,379.0,146.25
90253731.0,6,13,2036,8,1016,12893390.142857144,188.0,127.0,5,1020,22522753.75,204.0,204.0
93098233.0,6,210,24922,105,17770,893104.8269230769,374.0,169.23809523809524,105,7152,893093.8653846154,140.0,68.11428571428571
16080.0,6,14,4740,7,653,2373.0,249.0,93.28571428571428,7,4087,2505.1666666666665,1514.0,583.8571428571429
204618.0,6,10,1221,6,636,40923.6,298.0,106.0,4,585,67020.0,379.0,146.25
505734.0,6,5,336,2,134,0.0,68.0,67.0,3,202,191851.0,70.0,67.33333333333333
108074975.0,17,5,1005,5,1005,27018743.75,201.0,201.0,0,0,0.0,0.0,0.0
267560.0,17,2,180,1,90,0.0,90.0,90.0,1,90,0.0,90.0,90.0
88395.0,6,13,1386,7,789,14732.5,253.0,112.71428571428572,6,597,14579.6,259.0,99.5
29262.0,6,14,4740,7,653,4715.666666666667,249.0,93.28571428571428,7,4087,4521.0,1514.0,583.8571428571429
420922.0,6,3,204,2,136,0.0,70.0,68.0,1,68,0.0,68.0,68.0
2318.0,17,4,344,2,150,0.0,75.0,75.0,2,194,0.0,103.0,97.0
39238.0,6,14,4740,7,653,6087.833333333333,249.0,93.28571428571428,7,4087,5955.166666666667,1514.0,583.8571428571429
360953.0,6,10,1221,6,636,72190.6,298.0,106.0,4,585,118776.0,379.0,146.25
90091819.0,6,13,2052,6,1224,18017673.2,204.0,204.0,7,828,15014954.0,188.0,118.28571428571428
286180.0,17,2,180,1,90,0.0,90.0,90.0,1,90,0.0,90.0,90.0
2333.0,17,4,344,2,150,0.0,75.0,75.0,2,194,0.0,103.0,97.0
791168.0,6,2,132,1,66,0.0,66.0,66.0,1,66,0.0,66.0,66.0
374.0,17,2,166,1,75,0.0,75.0,75.0,1,91,0.0,91.0,91.0
27593315.0,17,5,1710,5,1710,6898328.75,342.0,342.0,0,0,0.0,0.0,0.0
3074341.0,6,4,270,2,134,0.0,68.0,67.0,2,136,0.0,70.0,68.0
497109.0,6,5,336,2,134,0.0,68.0,67.0,3,202,190312.0,70.0,67.33333333333333
38246.0,6,14,4740,7,653,6213.666666666667,249.0,93.28571428571428,7,4087,4599.5,1514.0,583.8571428571429
34106.0,6,14,4740,7,653,5201.333333333333,249.0,93.28571428571428,7,4087,5524.0,1514.0,583.8571428571429
253013.0,17,4,6056,4,6056,84337.66666666667,1514.0,1514.0,0,0,0.0,0.0,0.0
90298998.0,6,16,1192,8,596,12892567.714285716,95.0,74.5,8,596,12898937.42857143,95.0,74.5
2394.0,17,4,344,2,150,0.0,75.0,75.0,2,194,0.0,103.0,97.0
2080104.0,6,23,4355,12,1447,189100.36363636365,311.0,120.58333333333331,11,2908,187425.4,1514.0,264.3636363636364
108107424.0,17,5,955,5,955,27026856.0,191.0,191.0,0,0,0.0,0.0,0.0
3954.0,17,2,582,1,83,0.0,83.0,83.0,1,499,0.0,499.0,499.0
90298313.0,6,16,1192,8,596,12892621.0,95.0,74.5,8,596,12898739.857142856,95.0,74.5
149835248.0,17,36,17126,36,17126,4281007.085714285,501.0,475.72222222222223,0,0,0.0,0.0,0.0
90023635.0,17,28,13364,28,13364,3334208.703703704,501.0,477.2857142857143,0,0,0.0,0.0,0.0
1181874.0,6,4,492,2,280,0.0,214.0,140.0,2,212,0.0,146.0,106.0
69854.0,17,2,620,1,75,0.0,75.0,75.0,1,545,0.0,545.0,545.0
92296221.0,6,29,2068,15,1105,6577174.0,139.0,73.66666666666667,14,963,7083108.230769231,123.0,68.78571428571429
90119287.0,6,11,1644,7,828,15019881.166666666,188.0,118.28571428571428,4,816,20031626.0,204.0,204.0
107792.0,17,2,286,2,286,0.0,143.0,143.0,0,0,0.0,0.0,0.0
103199.0,17,2,286,2,286,0.0,143.0,143.0,0,0,0.0,0.0,0.0
215439.0,17,2,180,1,90,0.0,90.0,90.0,1,90,0.0,90.0,90.0
518241.0,6,3,1604,2,851,0.0,785.0,425.5,1,753,0.0,753.0,753.0
363.0,17,2,166,1,75,0.0,75.0,75.0,1,91,0.0,91.0,91.0
31315949.0,6,17,1226,8,586,4472426.714285715,95.0,73.25,9,640,3913082.25,95.0,71.11111111111111
134883.0,6,2,132,1,66,0.0,66.0,66.0,1,66,0.0,66.0,66.0
90686345.0,6,21,1585,10,745,10076260.555555556,95.0,74.5,11,840,9042498.5,95.0,76.36363636363636
108257963.0,6,27,1806,14,966,8327535.615384615,123.0,69.0,13,840,8171378.416666667,123.0,64.61538461538461
90256585.0,6,13,2036,8,1016,12893797.857142856,188.0,127.0,5,1020,22522798.5,204.0,204.0
145145.0,6,2,132,1,66,0.0,66.0,66.0,1,66,0.0,66.0,66.0
216588.0,17,2,180,1,90,0.0,90.0,90.0,1,90,0.0,90.0,90.0
7401240.0,6,4,276,2,132,0.0,66.0,66.0,2,144,0.0,78.0,72.0
217949.0,6,3,426,2,280,0.0,214.0,140.0,1,146,0.0,146.0,146.0
90921416.0,6,21,1585,11,840,9091563.0,95.0,76.36363636363636,10,745,10102012.444444444,95.0,74.5
149283054.0,6,21,2958,11,1458,14928305.4,188.0,132.54545454545453,10,1500,13254551.777777778,204.0,150.0
297952.0,6,6,412,4,272,99317.33333333331,74.0,68.0,2,140,0.0,74.0,70.0
108114613.0,17,5,1005,5,1005,27028653.25,201.0,201.0,0,0,0.0,0.0,0.0
153507.0,17,2,180,1,90,0.0,90.0,90.0,1,90,0.0,90.0,90.0
304953.0,6,6,412,4,272,101651.0,74.0,68.0,2,140,0.0,74.0,70.0
6160123.0,17,8,1284,4,306,2053280.3333333333,89.0,76.5,4,978,2003802.6666666667,443.0,244.5
90287559.0,6,16,1192,8,596,12892254.857142856,95.0,74.5,8,596,12897864.142857144,95.0,74.5
209548.0,17,2,180,1,90,0.0,90.0,90.0,1,90,0.0,90.0,90.0
24452.0,6,10,2032,5,524,5760.75,252.0,104.8,5,1508,5673.25,1236.0,301.6
102984129.0,6,42,2772,21,1386,5135437.75,66.0,66.0,21,1386,5135435.15,66.0,66.0
94772.0,6,13,1394,7,797,15795.333333333334,253.0,113.85714285714286,6,597,16945.2,259.0,99.5
90531133.0,6,13,2036,8,1016,12933019.0,188.0,127.0,5,1020,22591748.5,204.0,204.0
104843357.0,17,14,1126,7,563,17473892.833333332,174.0,80.42857142857143,7,563,17409509.5,174.0,80.42857142857143
149568.0,17,2,414,1,88,0.0,88.0,88.0,1,326,0.0,326.0,326.0
2594979.0,6,2,132,1,66,0.0,66.0,66.0,1,66,0.0,66.0,66.0
345.0,17,2,267,1,83,0.0,83.0,83.0,1,184,0.0,184.0,184.0
21838827.0,17,3,1034,2,684,0.0,342.0,342.0,1,350,0.0,350.0,350.0
93000812.0,17,13,1083,7,563,15500135.333333334,174.0,80.42857142857143,6,520,16838205.0,174.0,86.66666666666667
6940.0,17,2,582,1,83,0.0,83.0,83.0,1,499,0.0,499.0,499.0
2444.0,17,4,344,2,150,0.0,75.0,75.0,2,194,0.0,103.0,97.0
93111876.0,6,38,2508,19,1254,5155437.555555556,66.0,66.0,19,1254,5155438.111111111,66.0,66.0
365.0,17,2,267,1,83,0.0,83.0,83.0,1,184,0.0,184.0,184.0
34489.0,6,14,4740,7,653,5622.5,249.0,93.28571428571428,7,4087,4972.333333333333,1514.0,583.8571428571429
1308553.0,17,2,876,2,876,0.0,438.0,438.0,0,0,0.0,0.0,0.0
151958.0,17,2,414,1,88,0.0,88.0,88.0,1,326,0.0,326.0,326.0
101876.0,17,2,286,2,286,0.0,143.0,143.0,0,0,0.0,0.0,0.0
14636156.0,6,19,1553,9,921,1792020.375,315.0,102.33333333333331,10,632,1592879.5555555555,78.0,63.2
311115.0,6,6,412,4,272,103705.0,74.0,68.0,2,140,0.0,74.0,70.0
3179627.0,6,18,1536,9,962,358378.0,315.0,106.88888888888889,9,574,358368.5,78.0,63.77777777777778
833613.0,6,9,1118,6,586,166722.6,248.0,97.66666666666669,3,532,280503.0,392.0,177.33333333333334
2079.0,17,4,344,2,150,0.0,75.0,75.0,2,194,0.0,103.0,97.0
108096696.0,17,5,1005,5,1005,27024174.0,201.0,201.0,0,0,0.0,0.0,0.0
108105969.0,17,5,955,5,955,27026492.25,191.0,191.0,0,0,0.0,0.0,0.0
306823.0,6,6,412,4,272,102274.33333333331,74.0,68.0,2,140,0.0,74.0,70.0
90257838.0,6,14,2240,8,1016,12893976.857142856,188.0,127.0,6,1224,18018836.2,204.0,204.0
120383111.0,6,239,27038,120,18888,1011622.781512605,284.0,157.4,119,8150,1011476.8983050848,140.0,68.4873949579832
92880286.0,6,38,2508,19,1254,5160002.111111111,66.0,66.0,19,1254,5160001.555555556,66.0,66.0
308981.0,17,4,1400,4,1400,102993.66666666669,350.0,350.0,0,0,0.0,0.0,0.0
119528109.0,6,24,1870,10,786,13258154.111111112,95.0,78.6,14,1084,9178682.461538462,95.0,77.42857142857143
135130856.0,17,6,1206,6,1206,27026171.2,201.0,201.0,0,0,0.0,0.0,0.0
113601715.0,6,48,3168,24,1584,4939205.0,66.0,66.0,24,1584,4929803.043478261,66.0,66.0
120469584.0,6,20,1531,10,786,10048164.777777778,95.0,78.6,10,745,13380222.111111112,95.0,74.5
10524515.0,6,7,478,4,272,3462522.333333333,74.0,68.0,3,206,5193721.0,74.0,68.66666666666667
807.0,17,4,438,2,148,0.0,74.0,74.0,2,290,0.0,147.0,145.0
306339.0,6,6,412,4,272,102113.0,74.0,68.0,2,140,0.0,74.0,70.0
245306.0,6,3,337,2,214,0.0,160.0,107.0,1,123,0.0,123.0,123.0
135126363.0,17,6,1146,6,1146,27025272.6,191.0,191.0,0,0,0.0,0.0,0.0
0.0,17,1,55,1,55,0.0,55.0,55.0,0,0,0.0,0.0,0.0
18341.0,6,10,2032,5,524,4221.75,252.0,104.8,5,1508,3854.25,1236.0,301.6
23269.0,6,10,1065,5,534,5498.25,262.0,106.8,5,531,4926.75,259.0,106.2
90030472.0,17,28,13364,28,13364,3334461.925925926,501.0,477.2857142857143,0,0,0.0,0.0,0.0
299209.0,6,6,412,4,272,99736.33333333331,74.0,68.0,2,140,0.0,74.0,70.0
140219.0,6,12,1362,6,731,25511.0,253.0,121.83333333333331,6,631,26565.0,293.0,105.16666666666669
0.0,17,1,350,1,350,0.0,350.0,350.0,0,0,0.0,0.0,0.0
90254758.0,6,14,2240,8,1016,12893536.857142856,188.0,127.0,6,1224,18018319.8,204.0,204.0
3007316.0,6,11,2106,6,598,601274.6,252.0,99.66666666666669,5,1508,1772.5,1236.0,301.6
108102767.0,17,5,1005,5,1005,27025691.75,201.0,201.0,0,0,0.0,0.0,0.0
284464.0,17,2,363,1,79,0.0,79.0,79.0,1,284,0.0,284.0,284.0
144065.0,6,2,132,1,66,0.0,66.0,66.0,1,66,0.0,66.0,66.0
90097540.0,6,12,1848,5,1020,22523997.25,204.0,204.0,7,828,15015228.0,188.0,118.28571428571428
112611653.0,6,31,2176,16,1071,7507413.866666666,123.0,66.9375,15,1105,7330476.857142857,139.0,73.66666666666667
229963.0,17,4,1400,4,1400,76654.33333333333,350.0,350.0,0,0,0.0,0.0,0.0
46348.0,6,14,4740,7,653,6998.333333333333,249.0,93.28571428571428,7,4087,7451.0,1514.0,583.8571428571429
103036536.0,6,183,20604,92,6294,1132269.6263736263,140.0,68.41304347826087,91,14310,1133333.822222222,284.0,157.25274725274724
108106001.0,17,5,955,5,955,27026500.25,191.0,191.0,0,0,0.0,0.0,0.0
192944.0,17,2,180,1,90,0.0,90.0,90.0,1,90,0.0,90.0,90.0
206810.0,6,3,426,2,280,0.0,214.0,140.0,1,146,0.0,146.0,146.0
92223124.0,6,28,2008,14,1045,7077494.384615385,139.0,74.64285714285714,14,963,7077496.615384615,123.0,68.78571428571429
291.0,17,2,156,1,78,0.0,78.0,78.0,1,78,0.0,78.0,78.0
151996.0,17,4,6056,4,6056,50665.333333333336,1514.0,1514.0,0,0,0.0,0.0,0.0
9157.0,17,4,823,2,163,0.0,89.0,81.5,2,660,0.0,443.0,330.0
338323.0,6,6,412,4,272,112774.33333333331,74.0,68.0,2,140,0.0,74.0,70.0
228389.0,17,2,180,1,90,0.0,90.0,90.0,1,90,0.0,90.0,90.0
90292508.0,6,15,1097,8,596,12898929.714285716,95.0,74.5,7,501,14999310.666666666,95.0,71.57142857142857
208962.0,6,3,426,2,280,0.0,214.0,140.0,1,146,0.0,146.0,146.0
186366.0,17,2,180,1,90,0.0,90.0,90.0,1,90,0.0,90.0,90.0
50049.0,6,14,4740,7,653,7731.333333333333,249.0,93.28571428571428,7,4087,7641.833333333333,1514.0,583.8571428571429
309505.0,17,2,180,1,90,0.0,90.0,90.0,1,90,0.0,90.0,90.0
71159766.0,6,9,842,9,842,8894970.75,97.0,93.55555555555556,0,0,0.0,0.0,0.0
30941.0,6,10,2032,5,524,7386.25,252.0,104.8,5,1508,7041.5,1236.0,301.6
97264.0,6,14,4740,7,653,14519.166666666666,249.0,93.28571428571428,7,4087,16063.833333333334,1514.0,583.8571428571429
90253666.0,6,12,1832,8,1016,12893380.857142856,188.0,127.0,4,816,30029675.0,204.0,204.0
13191.0,6,13,1459,7,862,2106.0,271.0,123.14285714285714,6,597,2463.8,259.0,99.5
2317.0,17,4,344,2,150,0.0,75.0,75.0,2,194,0.0,103.0,97.0
9102.0,17,2,762,2,762,0.0,381.0,381.0,0,0,0.0,0.0,0.0
1311989.0,17,7,490,7,490,218664.8333333333,70.0,70.0,0,0,0.0,0.0,0.0
17520.0,6,10,2032,5,524,4143.25,252.0,104.8,5,1508,3445.75,1236.0,301.6
95209114.0,17,12,778,6,389,19000815.6,174.0,64.83333333333333,6,389,19000169.8,174.0,64.83333333333333
29570.0,6,14,4740,7,653,4728.0,249.0,93.28571428571428,7,4087,4254.333333333333,1514.0,583.8571428571429
108103766.0,17,5,955,5,955,27025941.5,191.0,191.0,0,0,0.0,0.0,0.0
255332.0,6,3,337,2,214,0.0,160.0,107.0,1,123,0.0,123.0,123.0
4310.0,17,2,598,1,72,0.0,72.0,72.0,1,526,0.0,526.0,526.0
120149117.0,6,232,26216,116,7878,1028752.9391304348,140.0,67.91379310344827,116,18338,1037751.7391304348,284.0,158.08620689655172
332.0,17,2,166,1,75,0.0,75.0,75.0,1,91,0.0,91.0,91.0
39807.0,6,14,4740,7,653,5292.166666666667,249.0,93.28571428571428,7,4087,6339.333333333333,1514.0,583.8571428571429
232842.0,6,3,337,2,214,0.0,160.0,107.0,1,123,0.0,123.0,123.0
312219.0,17,4,704,2,148,0.0,74.0,74.0,2,556,0.0,280.0,278.0
91000395.0,6,21,1585,11,840,9098883.0,95.0,76.36363636363636,10,745,10109891.444444444,95.0,74.5
309618.0,17,4,1400,4,1400,103206.0,350.0,350.0,0,0,0.0,0.0,0.0
99997982.0,6,193,21730,97,6624,1041645.6458333334,140.0,68.28865979381443,96,15106,1041635.8842105264,284.0,157.35416666666666
98085.0,6,14,4740,7,653,15210.333333333334,249.0,93.28571428571428,7,4087,15967.5,1514.0,583.8571428571429
120125259.0,6,13,2020,9,1204,15015657.375,188.0,133.77777777777777,4,816,30031619.33333333,204.0,204.0
169810.0,17,2,180,1,90,0.0,90.0,90.0,1,90,0.0,90.0,90.0
329.0,17,2,166,1,75,0.0,75.0,75.0,1,91,0.0,91.0,91.0
78308.0,6,13,4519,6,512,15473.4,230.0,85.33333333333333,7,4007,11379.833333333334,1514.0,572.4285714285714
227365.0,17,2,359,1,75,0.0,75.0,75.0,1,284,0.0,284.0,284.0
206084.0,17,2,180,1,90,0.0,90.0,90.0,1,90,0.0,90.0,90.0
0.0,6,1,172,1,172,0.0,172.0,172.0,0,0,0.0,0.0,0.0
7255.0,17,2,582,1,83,0.0,83.0,83.0,1,499,0.0,499.0,499.0
90058526.0,17,27,12943,27,12943,3463789.461538461,501.0,479.3703703703704,0,0,0.0,0.0,0.0
141978.0,6,2,132,1,66,0.0,66.0,66.0,1,66,0.0,66.0,66.0
21439.0,6,14,4740,7,653,3259.6666666666665,249.0,93.28571428571428,7,4087,2714.0,1514.0,583.8571428571429
116078379.0,17,17,1763,9,807,14509797.375,174.0,89.66666666666667,8,956,13737100.285714284,218.0,119.5
108323.0,17,2,286,2,286,0.0,143.0,143.0,0,0,0.0,0.0,0.0
149015.0,6,3,373,2,238,0.0,172.0,119.0,1,135,0.0,135.0,135.0
146046.0,6,3,337,2,214,0.0,160.0,107.0,1,123,0.0,123.0,123.0
281015.0,17,2,363,1,79,0.0,79.0,79.0,1,284,0.0,284.0,284.0
104932.0,17,2,762,2,762,0.0,381.0,381.0,0,0,0.0,0.0,0.0
4989886.0,17,4,629,2,156,0.0,78.0,78.0,2,473,0.0,268.0,236.5
35651.0,6,14,4740,7,653,5821.333333333333,249.0,93.28571428571428,7,4087,5802.5,1514.0,583.8571428571429
135127342.0,17,6,1146,6,1146,27025468.4,191.0,191.0,0,0,0.0,0.0,0.0
14815.0,6,13,1459,7,862,2199.5,271.0,123.14285714285714,6,597,2592.4,259.0,99.5
31426.000000000004,6,10,2032,5,524,7352.5,252.0,104.8,5,1508,7248.25,1236.0,301.6
100539183.0,17,12,778,6,389,20007171.0,174.0,64.83333333333333,6,389,20076047.8,174.0,64.83333333333333
90287644.0,6,12,1832,8,1016,12898234.857142856,188.0,127.0,4,816,30041739.666666668,204.0,204.0
543545.0,6,2,132,1,66,0.0,66.0,66.0,1,66,0.0,66.0,66.0
50577.0,6,14,4740,7,653,7323.0,249.0,93.28571428571428,7,4087,7404.666666666667,1514.0,583.8571428571429
327.0,17,2,191,1,73,0.0,73.0,73.0,1,118,0.0,118.0,118.0
108108228.0,17,5,1005,5,1005,27027057.0,201.0,201.0,0,0,0.0,0.0,0.0
102294.0,17,2,286,2,286,0.0,143.0,143.0,0,0,0.0,0.0,0.0
107377.0,17,2,286,2,286,0.0,143.0,143.0,0,0,0.0,0.0,0.0
315899.0,17,4,1400,4,1400,105299.66666666669,350.0,350.0,0,0,0.0,0.0,0.0
107422.0,17,2,700,2,700,0.0,350.0,350.0,0,0,0.0,0.0,0.0
103493049.0,6,44,2904,22,1452,4928240.428571428,66.0,66.0,22,1452,4915117.619047619,66.0,66.0
1484492.0,17,16,1120,16,1120,98966.13333333332,70.0,70.0,0,0,0.0,0.0,0.0
233105.0,6,3,337,2,214,0.0,160.0,107.0,1,123,0.0,123.0,123.0
122649.0,6,3,337,2,214,0.0,160.0,107.0,1,123,0.0,123.0,123.0
99134.0,17,2,286,2,286,0.0,143.0,143.0,0,0,0.0,0.0,0.0
1172292.0,6,13,3000,8,2372,167470.2857142857,1514.0,296.5,5,628,224136.0,331.0,125.6
19224938.0,6,6,1981,4,1087,6408312.666666667,885.0,271.75,2,894,0.0,826.0,447.0
28923.0,6,14,4740,7,653,4668.166666666667,249.0,93.28571428571428,7,4087,4448.0,1514.0,583.8571428571429
21560.0,17,2,582,1,83,0.0,83.0,83.0,1,499,0.0,499.0,499.0
45776.0,6,10,2032,5,524,9441.0,252.0,104.8,5,1508,9075.5,1236.0,301.6
94977843.0,6,25,1686,13,840,7914820.25,123.0,64.61538461538461,12,846,7706977.454545454,123.0,70.5
91568916.0,6,29,2052,15,1089,6525986.357142857,123.0,72.6,14,963,7027977.230769231,123.0,68.78571428571429
36789.0,6,14,4740,7,653,6000.5,249.0,93.28571428571428,7,4087,5665.333333333333,1514.0,583.8571428571429
1404679.0,6,7,499,4,301,459153.6666666667,103.0,75.25,3,198,612690.5,66.0,66.0
849735.0,6,9,1196,6,725,169947.0,387.0,120.83333333333331,3,471,287051.5,331.0,157.0
34241.0,6,10,2032,5,524,8298.25,252.0,104.8,5,1508,8237.0,1236.0,301.6
1306899.0,6,4,264,2,132,0.0,66.0,66.0,2,132,0.0,66.0,66.0
807421.0,6,6,758,3,410,393832.5,172.0,136.66666666666666,3,348,287498.5,135.0,116.0
1310328.0,6,4,264,2,132,0.0,66.0,66.0,2,132,0.0,66.0,66.0
238138.0,6,3,337,2,214,0.0,160.0,107.0,1,123,0.0,123.0,123.0
216651.0,17,2,180,1,90,0.0,90.0,90.0,1,90,0.0,90.0,90.0
5626439.0,6,5,336,2,134,0.0,68.0,67.0,3,202,1527667.0,70.0,67.33333333333333
1307078.0,6,4,264,2,132,0.0,66.0,66.0,2,132,0.0,66.0,66.0
90037114.0,17,28,13364,28,13364,3334707.925925926,501.0,477.2857142857143,0,0,0.0,0.0,0.0
276023.0,6,10,1221,6,636,55204.6,298.0,106.0,4,585,83390.66666666667,379.0,146.25
147332.0,6,3,373,2,238,0.0,172.0,119.0,1,135,0.0,135.0,135.0
153449.0,17,2,180,1,90,0.0,90.0,90.0,1,90,0.0,90.0,90.0
2586106.0,6,3,1777,1,826,0.0,826.0,826.0,2,951,0.0,885.0,475.5
35722.0,6,14,4740,7,653,5810.5,249.0,93.28571428571428,7,4087,5812.333333333333,1514.0,583.8571428571429
145162.0,6,2,132,1,66,0.0,66.0,66.0,1,66,0.0,66.0,66.0
2347.0,17,4,344,2,150,0.0,75.0,75.0,2,194,0.0,103.0,97.0
99011.0,17,2,762,2,762,0.0,381.0,381.0,0,0,0.0,0.0,0.0
204389.0,17,2,180,1,90,0.0,90.0,90.0,1,90,0.0,90.0,90.0
102822.0,17,2,286,2,286,0.0,143.0,143.0,0,0,0.0,0.0,0.0
123839811.0,6,48,3168,24,1584,5007058.0,66.0,66.0,24,1584,5290532.565217392,66.0,66.0
108101259.0,17,5,1005,5,1005,27025314.75,201.0,201.0,0,0,0.0,0.0,0.0
216680.0,17,2,180,1,90,0.0,90.0,90.0,1,90,0.0,90.0,90.0
2060.0,17,4,344,2,150,0.0,75.0,75.0,2,194,0.0,103.0,97.0
90259891.0,6,12,1832,8,1016,12894270.142857144,188.0,127.0,4,816,30031578.0,204.0,204.0
112460691.0,6,32,2220,16,1149,7483000.133333334,123.0,71.8125,16,1071,7482999.666666667,123.0,66.9375
143964.0,17,2,180,1,90,0.0,90.0,90.0,1,90,0.0,90.0,90.0
205795.0,17,2,180,1,90,0.0,90.0,90.0,1,90,0.0,90.0,90.0
2593275.0,6,2,132,1,66,0.0,66.0,66.0,1,66,0.0,66.0,66.0
19741.0,17,2,582,1,83,0.0,83.0,83.0,1,499,0.0,499.0,499.0
41855.0,6,10,2032,5,524,10249.75,252.0,104.8,5,1508,10232.25,1236.0,301.6
6116.0,17,4,823,2,163,0.0,89.0,81.5,2,660,0.0,443.0,330.0
90027349.0,17,27,12943,27,12943,3462590.346153846,501.0,479.3703703703704,0,0,0.0,0.0,0.0
57245.0,6,14,4740,7,653,9254.333333333334,249.0,93.28571428571428,7,4087,8732.0,1514.0,583.8571428571429
108272.0,17,2,286,2,286,0.0,143.0,143.0,0,0,0.0,0.0,0.0
131004689.0,17,15,907,8,475,18714955.57142857,174.0,59.375,7,432,18500192.33333333,174.0,61.71428571428572
663.0,17,2,762,2,762,0.0,381.0,381.0,0,0,0.0,0.0,0.0
2341.0,17,4,344,2,150,0.0,75.0,75.0,2,194,0.0,103.0,97.0
45857.0,6,10,2032,5,524,11211.75,252.0,104.8,5,1508,7673.5,1236.0,301.6
39610.0,6,12,1413,7,882,6601.666666666667,291.0,126.0,5,531,8538.25,259.0,106.2
148005.0,17,2,180,1,90,0.0,90.0,90.0,1,90,0.0,90.0,90.0
90266899.0,6,15,2074,8,1080,12895271.285714284,204.0,135.0,7,994,15017443.166666666,199.0,142.0
45832.0,6,14,4740,7,653,6922.5,249.0,93.28571428571428,7,4087,7360.0,1514.0,583.8571428571429
115203296.0,6,32,2220,16,1149,7680219.733333333,123.0,71.8125,16,1071,7665811.533333333,123.0,66.9375
105066031.0,17,15,5130,15,5130,7504716.5,342.0,342.0,0,0,0.0,0.0,0.0
17952.0,6,11,1133,6,602,3380.0,264.0,100.33333333333331,5,531,3892.25,259.0,106.2
209724.0,17,2,180,1,90,0.0,90.0,90.0,1,90,0.0,90.0,90.0
34326.0,6,14,4740,7,653,5558.333333333333,249.0,93.28571428571428,7,4087,5582.166666666667,1514.0,583.8571428571429
111521.0,17,2,286,2,286,0.0,143.0,143.0,0,0,0.0,0.0,0.0
107911163.0,6,43,2838,22,1452,5138614.476190476,66.0,66.0,21,1386,5143984.25,66.0,66.0
20711.0,6,13,1459,7,862,3233.1666666666665,271.0,123.14285714285714,6,597,3707.2,259.0,99.5
312583.0,6,6,412,4,272,104194.33333333331,74.0,68.0,2,140,0.0,74.0,70.0
33569.0,6,11,2098,6,590,6590.0,252.0,98.33333333333331,5,1508,8087.75,1236.0,301.6
10453976.0,6,7,478,4,272,3438920.0,74.0,68.0,3,206,5158270.0,74.0,68.66666666666667
733370.0,6,11,1021,6,444,100759.4,162.0,74.0,5,577,125750.25,349.0,115.4
206368.0,6,3,426,2,280,0.0,214.0,140.0,1,146,0.0,146.0,146.0
27866.0,6,10,1067,5,536,6795.5,264.0,107.2,5,531,5939.25,259.0,106.2
241754.0,6,3,337,2,214,0.0,160.0,107.0,1,123,0.0,123.0,123.0
2531802.0,6,3,1604,2,851,0.0,785.0,425.5,1,753,0.0,753.0,753.0
102707.0,17,2,286,2,286,0.0,143.0,143.0,0,0,0.0,0.0,0.0
506457.00000000006,6,5,336,2,134,0.0,68.0,67.0,3,202,191403.5,70.0,67.33333333333333
320334.0,17,4,704,2,148,0.0,74.0,74.0,2,556,0.0,280.0,278.0
1172249.0,6,13,3010,8,2382,167464.14285714287,1514.0,297.75,5,628,224081.25,331.0,125.6
79475.0,6,12,1413,6,816,15378.4,291.0,136.0,6,597,12872.4,259.0,99.5
1595864.0,6,4,492,2,280,0.0,214.0,140.0,2,212,0.0,146.0,106.0
16702.0,6,14,4740,7,653,2630.5,249.0,93.28571428571428,7,4087,2648.333333333333,1514.0,583.8571428571429
209708.0,6,10,1221,6,636,41941.6,298.0,106.0,4,585,68980.33333333333,379.0,146.25
139061.0,17,2,192,1,88,0.0,88.0,88.0,1,104,0.0,104.0,104.0
47520.0,6,10,2032,5,524,11502.25,252.0,104.8,5,1508,10593.5,1236.0,301.6
10420451.0,6,7,478,4,272,3428160.0,74.0,68.0,3,206,5142088.5,74.0,68.66666666666667
0.0,6,1,97,1,97,0.0,97.0,97.0,0,0,0.0,0.0,0.0
120153329.0,6,234,26438,117,8018,1028681.6034482758,140.0,68.52991452991454,117,18420,1028733.6724137932,284.0,157.43589743589743
31258.0,6,14,4740,7,653,5028.333333333333,249.0,93.28571428571428,7,4087,5071.0,1514.0,583.8571428571429
752194.0,6,2,132,1,66,0.0,66.0,66.0,1,66,0.0,66.0,66.0
120051755.0,17,29,13785,29,13785,4287562.678571428,501.0,475.3448275862069,0,0,0.0,0.0,0.0
17052.0,17,2,180,1,90,0.0,90.0,90.0,1,90,0.0,90.0,90.0
113617235.0,6,46,3036,23,1518,5150437.7727272725,66.0,66.0,23,1518,5150441.590909091,66.0,66.0
15861426.0,17,6,2052,6,2052,3172285.2,342.0,342.0,0,0,0.0,0.0,0.0
197669.0,17,2,180,1,90,0.0,90.0,90.0,1,90,0.0,90.0,90.0
35877.0,6,10,2032,5,524,8314.5,252.0,104.8,5,1508,8218.5,1236.0,301.6
295.0,17,2,156,1,78,0.0,78.0,78.0,1,78,0.0,78.0,78.0
102408.0,17,2,286,2,286,0.0,143.0,143.0,0,0,0.0,0.0,0.0
306845.0,6,3,202,2,128,0.0,74.0,64.0,1,74,0.0,74.0,74.0
216440.0,6,3,426,2,280,0.0,214.0,140.0,1,146,0.0,146.0,146.0
106630223.0,6,28,1876,14,982,8186519.923076923,139.0,70.14285714285714,14,894,8186536.153846154,123.0,63.85714285714285
447.0,17,2,410,1,78,0.0,78.0,78.0,1,332,0.0,332.0,332.0
498953.0,6,5,336,2,134,0.0,68.0,67.0,3,202,193596.0,70.0,67.33333333333333
90032243.0,17,28,13364,28,13364,3334527.5185185187,501.0,477.2857142857143,0,0,0.0,0.0,0.0
23306.0,6,14,4740,7,653,3700.8333333333335,249.0,93.28571428571428,7,4087,3706.0,1514.0,583.8571428571429
172494.0,17,4,704,2,148,0.0,74.0,74.0,2,556,0.0,280.0,278.0
196999.0,17,2,180,1,90,0.0,90.0,90.0,1,90,0.0,90.0,90.0
16739.0,6,14,4740,7,653,2610.5,249.0,93.28571428571428,7,4087,2653.833333333333,1514.0,583.8571428571429
206047.0,17,2,180,1,90,0.0,90.0,90.0,1,90,0.0,90.0,90.0
1391361.0,17,16,1120,16,1120,92757.4,70.0,70.0,0,0,0.0,0.0,0.0
33697923.0,6,5,336,2,134,0.0,68.0,67.0,3,202,15564300.5,70.0,67.33333333333333
925717.0,6,12,1354,6,723,184073.0,253.0,120.5,6,631,184430.8,293.0,105.16666666666669
6736.0,17,2,582,1,83,0.0,83.0,83.0,1,499,0.0,499.0,499.0
885.0,17,4,438,2,148,0.0,74.0,74.0,2,290,0.0,147.0,145.0
38384.0,6,14,4740,7,653,5834.833333333333,249.0,93.28571428571428,7,4087,6258.333333333333,1514.0,583.8571428571429
107937042.0,6,28,1860,14,966,8287109.461538462,123.0,69.0,14,894,8287081.461538462,123.0,63.85714285714285
118138198.0,6,47,3102,24,1584,5136432.304347826,66.0,66.0,23,1518,5111997.0,66.0,66.0
1024076.0,6,11,1134,6,558,204815.2,220.0,93.0,5,576,255208.75,304.0,115.2
5585.0,17,4,438,2,148,0.0,74.0,74.0,2,290,0.0,147.0,145.0
90035325.0,17,28,13364,28,13364,3334641.6666666665,501.0,477.2857142857143,0,0,0.0,0.0,0.0
108105265.0,17,5,955,5,955,27026316.25,191.0,191.0,0,0,0.0,0.0,0.0
314.0,17,2,174,1,79,0.0,79.0,79.0,1,95,0.0,95.0,95.0
97053627.0,17,14,1126,7,563,16175604.5,174.0,80.42857142857143,7,563,16092136.333333334,174.0,80.42857142857143
120125852.0,6,16,2648,8,1632,17160836.0,204.0,204.0,8,1016,17137341.42857143,188.0,127.0
303602.0,6,2,132,1,66,0.0,66.0,66.0,1,66,0.0,66.0,66.0
294910.0,17,2,224,1,76,0.0,76.0,76.0,1,148,0.0,148.0,148.0
153478.0,17,2,180,1,90,0.0,90.0,90.0,1,90,0.0,90.0,90.0
96065833.0,6,31,2412,18,1382,5648021.352941177,95.0,76.77777777777777,13,1030,7980898.666666667,95.0,79.23076923076923
31287.000000000004,6,10,2032,5,524,6906.0,252.0,104.8,5,1508,7524.0,1236.0,301.6
107083038.0,6,28,1876,14,982,8220541.153846154,139.0,70.14285714285714,14,894,8220540.769230769,123.0,63.85714285714285
505623.00000000006,17,6,1230,3,234,252631.0,78.0,78.0,3,996,252600.00000000003,332.0,332.0
246257.0,6,3,337,2,214,0.0,160.0,107.0,1,123,0.0,123.0,123.0
143926.0,17,2,180,1,90,0.0,90.0,90.0,1,90,0.0,90.0,90.0
113879682.0,6,48,3168,24,1584,4951290.521739131,66.0,66.0,24,1584,4938038.478260869,66.0,66.0
143847.0,17,2,180,1,90,0.0,90.0,90.0,1,90,0.0,90.0,90.0
298331.0,6,6,412,4,272,99443.66666666669,74.0,68.0,2,140,0.0,74.0,70.0
120116962.0,6,13,2036,5,1020,30029240.5,204.0,204.0,8,1016,17136008.85714286,188.0,127.0
16259.0,6,20,7606,11,978,1625.9,310.0,88.9090909090909,9,6628,1780.0,1514.0,736.4444444444445
290975.0,17,2,246,1,76,0.0,76.0,76.0,1,170,0.0,170.0,170.0
360026.0,17,4,571,2,148,0.0,74.0,74.0,2,423,0.0,280.0,211.5
110963212.0,6,30,1974,15,1026,7910509.714285715,123.0,68.4,15,948,7910513.5,123.0,63.2
19700.0,6,10,2032,5,524,4698.75,252.0,104.8,5,1508,4582.75,1236.0,301.6
874222.0,6,9,1096,6,625,174844.4,287.0,104.16666666666669,3,471,299271.0,331.0,157.0
35992511.0,6,26,7627,14,3735,197571.6923076923,1514.0,266.7857142857143,12,3892,3252460.8181818184,1514.0,324.3333333333333
234231.0,6,3,426,2,280,0.0,214.0,140.0,1,146,0.0,146.0,146.0
119829537.0,17,34,16284,34,16284,3631198.090909091,501.0,478.9411764705882,0,0,0.0,0.0,0.0
1013343.0,6,11,2023,6,515,202480.2,169.0,85.83333333333333,5,1508,3261.5,1236.0,301.6
41349.0,6,14,4740,7,653,6773.0,249.0,93.28571428571428,7,4087,5307.833333333333,1514.0,583.8571428571429
16699.0,6,13,1459,7,862,2742.833333333333,271.0,123.14285714285714,6,597,3117.8,259.0,99.5
34824541.0,6,26,7643,14,3751,191299.15384615384,1514.0,267.92857142857144,12,3892,3147216.0,1514.0,324.3333333333333
144053.0,17,2,180,1,90,0.0,90.0,90.0,1,90,0.0,90.0,90.0
298380.0,6,6,412,4,272,99460.0,74.0,68.0,2,140,0.0,74.0,70.0
212885.0,17,2,762,2,762,0.0,381.0,381.0,0,0,0.0,0.0,0.0
299027.0,6,6,412,4,272,99675.66666666669,74.0,68.0,2,140,0.0,74.0,70.0
97040854.0,17,12,778,6,389,19400179.0,174.0,64.83333333333333,6,389,19401016.4,174.0,64.83333333333333
314766.0,17,4,1400,4,1400,104922.0,350.0,350.0,0,0,0.0,0.0,0.0
90022467.0,17,28,13364,28,13364,3334165.4444444445,501.0,477.2857142857143,0,0,0.0,0.0,0.0
302412.0,6,2,132,1,66,0.0,66.0,66.0,1,66,0.0,66.0,66.0
94745781.0,17,11,735,6,389,18949156.2,174.0,64.83333333333333,5,346,18749899.0,174.0,69.2
206322.0,17,2,180,1,90,0.0,90.0,90.0,1,90,0.0,90.0,90.0
98990.0,17,2,762,2,762,0.0,381.0,381.0,0,0,0.0,0.0,0.0
128071993.0,6,33,2280,17,1209,8004499.5625,123.0,71.11764705882354,16,1071,7858769.133333334,123.0,66.9375
839959.0,6,9,1118,6,586,167991.8,248.0,97.66666666666669,3,532,282171.0,392.0,177.33333333333334
38344.0,6,14,4740,7,653,5845.0,249.0,93.28571428571428,7,4087,6253.833333333333,1514.0,583.8571428571429
90227671.0,6,16,1192,8,596,12853871.0,95.0,74.5,8,596,12858751.714285716,95.0,74.5
49759.0,6,14,4740,7,653,7260.833333333333,249.0,93.28571428571428,7,4087,7355.5,1514.0,583.8571428571429
2416.0,17,4,344,2,150,0.0,75.0,75.0,2,194,0.0,103.0,97.0
2112.0,17,4,344,2,150,0.0,75.0,75.0,2,194,0.0,103.0,97.0
123610606.0,6,49,3234,25,1650,5150441.916666667,66.0,66.0,24,1584,4944545.304347826,66.0,66.0
143997.0,17,2,180,1,90,0.0,90.0,90.0,1,90,0.0,90.0,90.0
8715810.0,6,5,1736,2,819,0.0,753.0,409.5,3,917,3061877.5,785.0,305.6666666666667
103151198.0,6,28,1860,14,966,7918075.0,123.0,69.0,14,894,7918077.0,123.0,63.85714285714285
143811.0,17,2,180,1,90,0.0,90.0,90.0,1,90,0.0,90.0,90.0
15607.0,6,13,1459,7,862,2454.833333333333,271.0,123.14285714285714,6,597,2955.8,259.0,99.5
97006508.0,17,11,735,6,389,19401301.6,174.0,64.83333333333333,5,346,19250153.5,174.0,69.2
50780.0,17,2,180,1,90,0.0,90.0,90.0,1,90,0.0,90.0,90.0
181634.0,6,10,1065,5,534,44727.5,262.0,106.8,5,531,3372.5,259.0,106.2
90039524.0,17,27,12943,27,12943,3463058.6153846155,501.0,479.3703703703704,0,0,0.0,0.0,0.0
38768.0,6,14,4740,7,653,5795.166666666667,249.0,93.28571428571428,7,4087,5465.5,1514.0,583.8571428571429
118303303.0,6,47,3102,24,1584,5131659.565217392,66.0,66.0,23,1518,5135888.2727272725,66.0,66.0
862098.0,6,9,1268,6,797,172419.6,459.0,132.83333333333334,3,471,293205.5,331.0,157.0
217461.0,6,3,426,2,280,0.0,214.0,140.0,1,146,0.0,146.0,146.0
1023250.0,6,11,1134,6,558,204650.0,220.0,93.0,5,576,255260.0,304.0,115.2
90254739.0,6,12,1832,8,1016,12893534.142857144,188.0,127.0,4,816,30030471.666666668,204.0,204.0
280729.0,17,2,414,1,88,0.0,88.0,88.0,1,326,0.0,326.0,326.0
90300618.0,6,20,1531,11,840,9024159.9,95.0,76.36363636363636,9,691,11228386.375,95.0,76.77777777777777
306918.0,6,6,412,4,272,102306.0,74.0,68.0,2,140,0.0,74.0,70.0
153431.0,17,2,180,1,90,0.0,90.0,90.0,1,90,0.0,90.0,90.0
27355.0,6,14,4740,7,653,4211.666666666667,249.0,93.28571428571428,7,4087,4194.0,1514.0,583.8571428571429
120085321.0,6,244,28304,122,8348,985593.917355372,140.0,68.42622950819673,122,19956,985610.2479338844,284.0,163.5737704918033
186439.0,6,10,1066,5,490,46096.5,218.0,98.0,5,576,46279.5,304.0,115.2
120128103.0,6,15,2444,7,1428,20021350.5,204.0,204.0,8,1016,17098761.85714286,188.0,127.0
37508.0,6,14,4740,7,653,5991.833333333333,249.0,93.28571428571428,7,4087,6069.5,1514.0,583.8571428571429
2278.0,17,4,344,2,150,0.0,75.0,75.0,2,194,0.0,103.0,97.0
1184418.0,6,13,3016,8,2388,169202.57142857142,1514.0,298.5,5,628,227165.25,331.0,125.6
10065.0,6,10,2032,5,524,2263.75,252.0,104.8,5,1508,2257.0,1236.0,301.6
50770.0,6,14,4740,7,653,5630.333333333333,249.0,93.28571428571428,7,4087,8324.166666666666,1514.0,583.8571428571429
2575009.0,6,2,132,1,66,0.0,66.0,66.0,1,66,0.0,66.0,66.0
73440.0,6,12,1320,7,789,12240.0,253.0,112.71428571428572,5,531,16309.75,259.0,106.2
0.0,6,1,66,0,0,0.0,0.0,0.0,1,66,0.0,66.0,66.0
313283.0,6,3,202,2,128,0.0,74.0,64.0,1,74,0.0,74.0,74.0
2371.0,17,4,344,2,150,0.0,75.0,75.0,2,194,0.0,103.0,97.0
313158.0,17,4,1400,4,1400,104386.0,350.0,350.0,0,0,0.0,0.0,0.0
24911.0,6,10,2032,5,524,6002.75,252.0,104.8,5,1508,5945.75,1236.0,301.6
124485.0,6,3,373,2,238,0.0,172.0,119.0,1,135,0.0,135.0,135.0
90096548.0,6,11,1644,7,828,15016091.333333334,188.0,118.28571428571428,4,816,20022267.33333333,204.0,204.0
2802617.0,6,2,132,1,66,0.0,66.0,66.0,1,66,0.0,66.0,66.0
27760.0,6,10,1066,5,490,6038.25,218.0,98.0,5,576,6732.75,304.0,115.2
54895.0,6,13,1386,7,789,8989.833333333334,253.0,112.71428571428572,6,597,10747.8,259.0,99.5
123455561.0,6,48,3168,24,1584,5004893.0,66.0,66.0,24,1584,5262924.130434782,66.0,66.0
1232257.0,17,7,490,7,490,205376.16666666663,70.0,70.0,0,0,0.0,0.0,0.0
135134755.0,17,6,1206,6,1206,27026951.0,201.0,201.0,0,0,0.0,0.0,0.0
19222.0,6,10,2032,5,524,4360.75,252.0,104.8,5,1508,4372.25,1236.0,301.6
206668.0,17,2,876,2,876,0.0,438.0,438.0,0,0,0.0,0.0,0.0
117000998.0,17,15,1169,8,606,16714428.285714284,174.0,75.75,7,563,17455278.166666668,174.0,80.42857142857143
38068.0,6,14,4740,7,653,6160.833333333333,249.0,93.28571428571428,7,4087,6205.5,1514.0,583.8571428571429
2075990.0,6,25,7609,13,2516,172999.16666666666,1034.0,193.53846153846155,12,5093,160747.9090909091,1510.0,424.4166666666667
53779201.0,6,8,2113,3,960,25539574.0,826.0,320.0,5,1153,12749911.5,885.0,230.6
915.0,17,5,550,5,550,228.75,110.0,110.0,0,0,0.0,0.0,0.0
322409.0,17,4,1400,4,1400,107469.66666666669,350.0,350.0,0,0,0.0,0.0,0.0
135169033.0,17,6,1206,6,1206,27033806.6,201.0,201.0,0,0,0.0,0.0,0.0
36224.0,6,14,4740,7,653,5911.666666666667,249.0,93.28571428571428,7,4087,5250.666666666667,1514.0,583.8571428571429
27608.0,6,10,2032,5,524,6665.25,252.0,104.8,5,1508,6615.75,1236.0,301.6
1029953.0,6,11,1134,6,558,205990.60000000003,220.0,93.0,5,576,256637.75,304.0,115.2
196216.0,6,11,1131,6,600,38928.6,262.0,100.0,5,531,3446.0,259.0,106.2
103348004.0,6,188,21332,94,14906,1108954.623655914,284.0,158.5744680851064,94,6426,1108954.8064516129,140.0,68.36170212765957
31361.0,6,10,2032,5,524,6965.25,252.0,104.8,5,1508,7613.75,1236.0,301.6
108104290.0,17,5,955,5,955,27026072.5,191.0,191.0,0,0,0.0,0.0,0.0
108107402.0,17,5,955,5,955,27026850.5,191.0,191.0,0,0,0.0,0.0,0.0
121357.0,6,3,337,2,214,0.0,160.0,107.0,1,123,0.0,123.0,123.0
334.0,17,2,166,1,75,0.0,75.0,75.0,1,91,0.0,91.0,91.0
14205.0,6,10,1067,5,536,3225.5,264.0,107.2,5,531,2413.0,259.0,106.2
128903350.0,6,37,2794,20,1531,6784386.842105263,139.0,76.55,17,1263,7418820.6875,123.0,74.29411764705883
37818.0,6,14,4740,7,653,6142.5,249.0,93.28571428571428,7,4087,5779.5,1514.0,583.8571428571429
52334.0,6,14,4740,7,653,8591.333333333334,249.0,93.28571428571428,7,4087,8303.333333333334,1514.0,583.8571428571429
118702064.0,6,34,2466,17,1194,7418851.5,123.0,70.23529411764706,17,1272,6794661.5,123.0,74.82352941176471
90248569.0,6,14,2240,8,1016,12892652.714285716,188.0,127.0,6,1224,18017310.8,204.0,204.0
45043647.0,17,9,3086,8,2736,5138345.0,342.0,342.0,1,350,0.0,350.0,350.0
5824171.0,6,5,336,2,134,0.0,68.0,67.0,3,202,1524866.5,70.0,67.33333333333333
121737645.0,17,14,864,7,432,17000164.333333332,174.0,61.71428571428572,7,432,17001283.333333332,174.0,61.71428571428572
44741.0,6,10,2032,5,524,8069.25,252.0,104.8,5,1508,10893.5,1236.0,301.6
108487.0,17,2,286,2,286,0.0,143.0,143.0,0,0,0.0,0.0,0.0
177416.0,17,2,180,1,90,0.0,90.0,90.0,1,90,0.0,90.0,90.0
303408.0,17,4,1524,4,1524,101136.0,381.0,381.0,0,0,0.0,0.0,0.0
42652.0,6,14,4740,7,653,6976.666666666667,249.0,93.28571428571428,7,4087,6503.666666666667,1514.0,583.8571428571429
135130103.0,17,6,1146,6,1146,27026020.6,191.0,191.0,0,0,0.0,0.0,0.0
2163.0,17,4,344,2,150,0.0,75.0,75.0,2,194,0.0,103.0,97.0
147082.0,6,3,373,2,238,0.0,172.0,119.0,1,135,0.0,135.0,135.0
217592.0,6,3,426,2,280,0.0,214.0,140.0,1,146,0.0,146.0,146.0
24466.0,6,10,2032,5,524,5102.5,252.0,104.8,5,1508,5454.25,1236.0,301.6
120001433.0,6,19,1436,10,745,13333492.555555556,95.0,74.5,9,691,14944084.5,95.0,76.77777777777777
2378.0,17,4,344,2,150,0.0,75.0,75.0,2,194,0.0,103.0,97.0
28660.0,6,10,2032,5,524,6791.0,252.0,104.8,5,1508,4213.25,1236.0,301.6
368270.0,6,6,412,4,272,122756.66666666669,74.0,68.0,2,140,0.0,74.0,70.0
20578.0,6,11,1131,6,600,4115.6,262.0,100.0,5,531,4281.0,259.0,106.2
159140.0,6,2,128,1,74,0.0,74.0,74.0,1,54,0.0,54.0,54.0
18678.0,6,14,4740,7,653,2740.0,249.0,93.28571428571428,7,4087,2978.333333333333,1514.0,583.8571428571429
556338.0,17,4,629,3,234,73652.5,78.0,78.0,1,395,0.0,395.0,395.0
10477379.0,6,7,478,4,272,3447237.6666666665,74.0,68.0,3,206,5170785.0,74.0,68.66666666666667
442921.0,6,3,204,1,68,0.0,68.0,68.0,2,136,0.0,70.0,68.0
844267.0,6,9,1118,6,586,168853.4,248.0,97.66666666666669,3,532,284335.5,392.0,177.33333333333334
26820.0,6,14,4740,7,653,4188.166666666667,249.0,93.28571428571428,7,4087,4329.166666666667,1514.0,583.8571428571429
306918.0,6,6,412,4,272,102306.0,74.0,68.0,2,140,0.0,74.0,70.0
90366562.0,6,12,1848,7,828,15061093.666666666,188.0,118.28571428571428,5,1020,15084014.25,204.0,204.0
3174699.0,6,18,1495,9,921,358371.125,315.0,102.33333333333331,9,574,358354.625,78.0,63.77777777777778
13572937.0,17,6,2052,6,2052,2714587.4,342.0,342.0,0,0,0.0,0.0,0.0
1842.0,17,2,192,1,88,0.0,88.0,88.0,1,104,0.0,104.0,104.0
108114342.0,17,5,1005,5,1005,27028585.5,201.0,201.0,0,0,0.0,0.0,0.0
143876.0,17,2,180,1,90,0.0,90.0,90.0,1,90,0.0,90.0,90.0
108215.0,17,2,700,2,700,0.0,350.0,350.0,0,0,0.0,0.0,0.0
299948.0,6,6,412,4,272,99982.66666666669,74.0,68.0,2,140,0.0,74.0,70.0
2799452.0,6,2,132,1,66,0.0,66.0,66.0,1,66,0.0,66.0,66.0
281500.0,17,2,363,1,79,0.0,79.0,79.0,1,284,0.0,284.0,284.0
90258365.0,6,14,2240,8,1016,12894052.142857144,188.0,127.0,6,1224,18018705.0,204.0,204.0
2484132.0,6,25,7573,14,3735,191087.0769230769,1514.0,266.7857142857143,11,3838,222765.9,1514.0,348.90909090909093
369573.0,6,3,1604,1,753,0.0,753.0,753.0,2,851,0.0,785.0,425.5
127955824.0,6,33,2280,17,1209,7997239.0,123.0,71.11764705882354,16,1071,7851068.8,123.0,66.9375
303685.0,6,2,132,1,66,0.0,66.0,66.0,1,66,0.0,66.0,66.0
119933032.0,6,40,2824,20,1468,6300912.421052632,139.0,73.4,20,1356,6300913.52631579,123.0,67.8
219010.0,6,3,426,2,280,0.0,214.0,140.0,1,146,0.0,146.0,146.0
333.0,17,2,166,1,75,0.0,75.0,75.0,1,91,0.0,91.0,91.0
153483.0,17,2,180,1,90,0.0,90.0,90.0,1,90,0.0,90.0,90.0
27209.0,6,10,2032,5,524,6533.75,252.0,104.8,5,1508,6513.75,1236.0,301.6
317480.0,6,6,412,4,272,105826.66666666669,74.0,68.0,2,140,0.0,74.0,70.0
120008821.0,6,21,1585,11,840,11999999.9,95.0,76.36363636363636,10,745,13333682.666666666,95.0,74.5
898216.0,6,10,1336,6,799,179643.2,461.0,133.16666666666666,4,537,207498.3333333333,331.0,134.25
108106100.0,17,5,955,5,955,27026525.0,191.0,191.0,0,0,0.0,0.0,0.0
147148.0,6,3,373,2,238,0.0,172.0,119.0,1,135,0.0,135.0,135.0
90012679.0,17,28,13364,28,13364,3333802.925925926,501.0,477.2857142857143,0,0,0.0,0.0,0.0
742.0,17,4,438,2,148,0.0,74.0,74.0,2,290,0.0,147.0,145.0
1531000.0,6,12,1373,7,714,255166.66666666663,298.0,102.0,5,659,374420.0,379.0,131.8
313317.0,6,6,412,4,272,104439.0,74.0,68.0,2,140,0.0,74.0,70.0
42431.0,6,10,2032,5,524,10428.0,252.0,104.8,5,1508,10353.5,1236.0,301.6
882759.0,6,12,2715,7,743,147126.5,339.0,106.14285714285714,5,1972,152518.25,1514.0,394.4
5621821.0,6,4,270,2,134,0.0,68.0,67.0,2,136,0.0,70.0,68.0
90260425.0,6,13,2036,8,1016,12894346.42857143,188.0,127.0,5,1020,22523870.75,204.0,204.0
26555.0,6,14,4740,7,653,4236.166666666667,249.0,93.28571428571428,7,4087,4287.833333333333,1514.0,583.8571428571429
232223.0,6,3,373,2,238,0.0,172.0,119.0,1,135,0.0,135.0,135.0
135135444.0,17,6,1146,6,1146,27027088.8,191.0,191.0,0,0,0.0,0.0,0.0
146172.0,6,3,337,2,214,0.0,160.0,107.0,1,123,0.0,123.0,123.0
324.0,17,2,152,1,76,0.0,76.0,76.0,1,76,0.0,76.0,76.0
22437.0,6,10,2032,5,524,5392.5,252.0,104.8,5,1508,5275.25,1236.0,301.6
37380.0,6,10,2032,5,524,7367.0,252.0,104.8,5,1508,7312.75,1236.0,301.6
135128118.0,17,6,1146,6,1146,27025623.6,191.0,191.0,0,0,0.0,0.0,0.0
44236.0,6,10,2032,5,524,10764.5,252.0,104.8,5,1508,9948.25,1236.0,301.6
65700.0,6,10,1065,5,534,15537.5,262.0,106.8,5,531,2994.5,259.0,106.2
135131437.0,17,6,1146,6,1146,27026287.4,191.0,191.0,0,0,0.0,0.0,0.0
45538.0,6,10,2032,5,524,11104.75,252.0,104.8,5,1508,11103.75,1236.0,301.6
108104396.0,17,5,1005,5,1005,27026099.0,201.0,201.0,0,0,0.0,0.0,0.0
206258.0,6,3,426,2,280,0.0,214.0,140.0,1,146,0.0,146.0,146.0
240978.0,6,3,337,2,214,0.0,160.0,107.0,1,123,0.0,123.0,123.0
40630.0,6,10,2032,5,524,9942.25,252.0,104.8,5,1508,9442.75,1236.0,301.6
19643.0,17,4,344,2,150,0.0,75.0,75.0,2,194,0.0,103.0,97.0
197096.0,17,2,180,1,90,0.0,90.0,90.0,1,90,0.0,90.0,90.0
46002.0,6,14,4740,7,653,7542.333333333333,249.0,93.28571428571428,7,4087,6752.5,1514.0,583.8571428571429
105058841.0,6,44,2904,22,1452,5002801.952380952,66.0,66.0,22,1452,4988106.285714285,66.0,66.0
281113.0,17,2,180,1,90,0.0,90.0,90.0,1,90,0.0,90.0,90.0
40865.0,6,14,4740,7,653,6352.5,249.0,93.28571428571428,7,4087,6351.333333333333,1514.0,583.8571428571429
305372.0,6,6,412,4,272,101790.66666666669,74.0,68.0,2,140,0.0,74.0,70.0
2329.0,17,4,344,2,150,0.0,75.0,75.0,2,194,0.0,103.0,97.0
298166.0,6,6,412,4,272,99388.66666666669,74.0,68.0,2,140,0.0,74.0,70.0
132643919.0,17,15,1169,8,606,18949131.285714287,174.0,75.75,7,563,18837151.83333333,174.0,80.42857142857143
1091237.0,6,13,1386,7,789,181872.8333333333,253.0,112.71428571428572,6,597,214318.6,259.0,99.5
108102187.0,17,5,1005,5,1005,27025546.75,201.0,201.0,0,0,0.0,0.0,0.0
2586869.0,6,25,7573,14,3735,198989.92307692303,1514.0,266.7857142857143,11,3838,233115.2,1514.0,348.90909090909093
62774.0,6,14,4740,7,653,9889.0,249.0,93.28571428571428,7,4087,9445.0,1514.0,583.8571428571429
47066.0,6,14,4740,7,653,7695.0,249.0,93.28571428571428,7,4087,7484.666666666667,1514.0,583.8571428571429
309317.0,17,4,1400,4,1400,103105.66666666669,350.0,350.0,0,0,0.0,0.0,0.0
108108580.0,17,5,955,5,955,27027145.0,191.0,191.0,0,0,0.0,0.0,0.0
108112284.0,17,5,955,5,955,27028071.0,191.0,191.0,0,0,0.0,0.0,0.0
2796184.0,6,2,132,1,66,0.0,66.0,66.0,1,66,0.0,66.0,66.0
243534.0,6,3,337,2,214,0.0,160.0,107.0,1,123,0.0,123.0,123.0
201731.0,17,4,6056,4,6056,67243.66666666667,1514.0,1514.0,0,0,0.0,0.0,0.0
507076.0,6,5,336,2,134,0.0,68.0,67.0,3,202,196429.5,70.0,67.33333333333333
156224.0,6,3,337,2,214,0.0,160.0,107.0,1,123,0.0,123.0,123.0
224069.0,6,10,1221,6,636,44813.8,298.0,106.0,4,585,71653.33333333333,379.0,146.25
90254756.0,6,12,1832,8,1016,12893536.57142857,188.0,127.0,4,816,30030050.666666668,204.0,204.0
120113155.0,6,663,118700,338,96806,356418.8575667656,1514.0,286.4082840236686,325,21894,367531.10802469135,214.0,67.36615384615385
28724.0,6,10,2032,5,524,6669.25,252.0,104.8,5,1508,6627.0,1236.0,301.6
96070.0,6,11,2098,6,590,18783.8,252.0,98.33333333333331,5,1508,9381.25,1236.0,301.6
16015191.000000002,17,2,684,2,684,0.0,342.0,342.0,0,0,0.0,0.0,0.0
90311938.0,6,17,1287,9,691,11282722.625,95.0,76.77777777777777,8,596,12899984.42857143,95.0,74.5
3176826.0,6,18,1495,9,921,358346.125,315.0,102.33333333333331,9,574,358310.25,78.0,63.77777777777778
108098745.0,17,5,955,5,955,27024686.25,191.0,191.0,0,0,0.0,0.0,0.0
59176.0,17,2,180,1,90,0.0,90.0,90.0,1,90,0.0,90.0,90.0
216513.0,6,3,426,2,280,0.0,214.0,140.0,1,146,0.0,146.0,146.0
90066570.0,17,28,13364,28,13364,3335798.888888889,501.0,477.2857142857143,0,0,0.0,0.0,0.0
45139.0,6,10,2032,5,524,11044.75,252.0,104.8,5,1508,9262.75,1236.0,301.6
82938017.0,17,14,4796,13,4446,6228627.75,342.0,342.0,1,350,0.0,350.0,350.0
1313669.0,6,4,264,2,132,0.0,66.0,66.0,2,132,0.0,66.0,66.0
2371.0,17,4,344,2,150,0.0,75.0,75.0,2,194,0.0,103.0,97.0
351009.0,6,3,204,1,68,0.0,68.0,68.0,2,136,0.0,70.0,68.0
298059.0,6,6,412,4,272,99353.0,74.0,68.0,2,140,0.0,74.0,70.0
90004542.0,6,14,1043,7,542,15000757.0,95.0,77.42857142857143,7,501,14952652.5,95.0,71.57142857142857
71264.0,6,14,4740,7,653,8668.833333333334,249.0,93.28571428571428,7,4087,11077.333333333334,1514.0,583.8571428571429
216299.0,17,2,180,1,90,0.0,90.0,90.0,1,90,0.0,90.0,90.0
120880766.0,6,47,3102,23,1518,5160891.909090909,66.0,66.0,24,1584,5241351.0,66.0,66.0
301191.0,6,6,412,4,272,100397.0,74.0,68.0,2,140,0.0,74.0,70.0
1085012.0,6,11,1134,6,558,217002.4,220.0,93.0,5,576,267704.25,304.0,115.2
90255958.0,6,12,1832,8,1016,12893708.285714284,188.0,127.0,4,816,30030503.0,204.0,204.0
405320.0,6,4,508,2,238,0.0,172.0,119.0,2,270,0.0,135.0,135.0
217677.0,6,3,426,2,280,0.0,214.0,140.0,1,146,0.0,146.0,146.0
98790146.0,6,188,21204,94,14778,1059945.6989247312,284.0,157.2127659574468,94,6426,1059946.0215053763,140.0,68.36170212765957
144816.0,17,2,180,1,70,0.0,70.0,70.0,1,110,0.0,110.0,110.0
216438.0,17,2,180,1,90,0.0,90.0,90.0,1,90,0.0,90.0,90.0
2754051.0,6,32,10926,18,3951,162003.0,1514.0,219.5,14,6975,191370.38461538465,1514.0,498.2142857142857
105190.0,17,2,700,2,700,0.0,350.0,350.0,0,0,0.0,0.0,0.0
120126892.0,6,14,2224,9,1204,15015861.5,188.0,133.77777777777777,5,1020,22529549.25,204.0,204.0
40899.0,6,14,4740,7,653,6613.0,249.0,93.28571428571428,7,4087,6502.666666666667,1514.0,583.8571428571429
180980.0,6,10,1066,5,490,43777.25,218.0,98.0,5,576,44956.0,304.0,115.2
98033790.0,17,12,778,6,389,19601295.8,174.0,64.83333333333333,6,389,19600168.4,174.0,64.83333333333333
0.0,17,1,90,1,90,0.0,90.0,90.0,0,0,0.0,0.0,0.0
155561.0,6,11,2098,6,590,23559.6,252.0,98.33333333333331,5,1508,32182.0,1236.0,301.6
90259091.0,6,13,2036,8,1016,12894155.857142856,188.0,127.0,5,1020,22523378.25,204.0,204.0
13926127.0,6,256,242886,74,5054,190768.86301369863,204.0,68.29729729729729,182,237832,76864.58011049723,1514.0,1306.7692307692307
508640.0,6,5,336,2,134,0.0,68.0,67.0,3,202,193073.5,70.0,67.33333333333333
3004948.0,6,11,2106,6,598,600818.4,252.0,99.66666666666669,5,1508,2130.0,1236.0,301.6
103153.0,17,2,286,2,286,0.0,143.0,143.0,0,0,0.0,0.0,0.0
182872.0,17,2,180,1,90,0.0,90.0,90.0,1,90,0.0,90.0,90.0
506336.0,6,5,336,2,134,0.0,68.0,67.0,3,202,194615.0,70.0,67.33333333333333
90958858.0,6,21,1585,11,840,9094314.1,95.0,76.36363636363636,10,745,10106254.333333334,95.0,74.5
119382616.0,6,19,1395,10,745,13258947.666666666,95.0,74.5,9,650,14922097.625,95.0,72.22222222222223
321.0,17,2,267,1,83,0.0,83.0,83.0,1,184,0.0,184.0,184.0
103629.0,17,2,286,2,286,0.0,143.0,143.0,0,0,0.0,0.0,0.0
94242189.0,6,172,19444,86,13546,1106325.7294117648,284.0,157.51162790697674,86,5898,1106325.905882353,140.0,68.5813953488372
356.0,17,2,166,1,75,0.0,75.0,75.0,1,91,0.0,91.0,91.0
119895048.0,17,34,16284,34,16284,3633183.272727273,501.0,478.9411764705882,0,0,0.0,0.0,0.0
131523.0,6,3,337,2,214,0.0,160.0,107.0,1,123,0.0,123.0,123.0
116924.0,17,4,1400,4,1400,38974.66666666666,350.0,350.0,0,0,0.0,0.0,0.0
135136617.0,17,6,1146,6,1146,27027323.4,191.0,191.0,0,0,0.0,0.0,0.0
108177810.0,17,14,864,7,432,18000203.666666668,174.0,61.71428571428572,7,432,18000837.0,174.0,61.71428571428572
135124813.0,17,6,1206,6,1206,27024962.6,201.0,201.0,0,0,0.0,0.0,0.0
30158.0,6,14,4740,7,653,4904.0,249.0,93.28571428571428,7,4087,4893.833333333333,1514.0,583.8571428571429
10496712.0,6,7,478,4,272,3451823.0,74.0,68.0,3,206,5177638.5,74.0,68.66666666666667
111127119.0,6,33,2428,17,1288,6945444.9375,139.0,75.76470588235294,16,1140,7394093.933333334,123.0,71.25
114835625.0,6,48,3168,24,1584,4992853.260869565,66.0,66.0,24,1584,4979769.869565218,66.0,66.0
2497.0,17,4,344,2,150,0.0,75.0,75.0,2,194,0.0,103.0,97.0
233473.0,6,3,337,2,214,0.0,160.0,107.0,1,123,0.0,123.0,123.0
205324.0,17,4,1400,4,1400,68441.33333333333,350.0,350.0,0,0,0.0,0.0,0.0
90024285.0,17,27,12943,27,12943,3462472.5,501.0,479.3703703703704,0,0,0.0,0.0,0.0
2902615.0,6,11,2106,6,598,580264.0,252.0,99.66666666666669,5,1508,5596.25,1236.0,301.6
90060499.0,6,13,1776,6,948,18011643.0,204.0,158.0,7,828,15008954.666666666,188.0,118.28571428571428
135130464.0,17,6,1206,6,1206,27026092.8,201.0,201.0,0,0,0.0,0.0,0.0
18535.0,6,13,1459,7,862,2794.6666666666665,271.0,123.14285714285714,6,597,3507.6,259.0,99.5
1194752.0,6,13,3010,8,2382,170678.85714285713,1514.0,297.75,5,628,229735.25,331.0,125.6
111351412.0,6,216,24312,108,16888,1038655.7289719626,284.0,156.37037037037038,108,7424,1038656.476635514,140.0,68.74074074074075
24940618.0,17,5,1718,4,1368,993575.6666666666,342.0,342.0,1,350,0.0,350.0,350.0
67262.0,6,10,1065,5,534,16638.25,262.0,106.8,5,531,15964.25,259.0,106.2
17995957.0,17,8,1427,4,306,5998543.0,89.0,76.5,4,1121,5889487.0,443.0,280.25
435.0,17,2,508,2,508,0.0,257.0,254.0,0,0,0.0,0.0,0.0
307887.0,6,6,412,4,272,102629.0,74.0,68.0,2,140,0.0,74.0,70.0
5695784.0,6,100,101235,29,2076,203420.8571428572,208.0,71.58620689655173,71,99159,81245.57142857143,1514.0,1396.605633802817
102509.0,17,2,286,2,286,0.0,143.0,143.0,0,0,0.0,0.0,0.0
42587.0,6,10,2032,5,524,10218.25,252.0,104.8,5,1508,9722.25,1236.0,301.6
212374.0,6,3,426,2,280,0.0,214.0,140.0,1,146,0.0,146.0,146.0
208537.0,17,2,180,1,90,0.0,90.0,90.0,1,90,0.0,90.0,90.0
191152.0,17,4,820,2,156,0.0,78.0,78.0,2,664,0.0,332.0,332.0
54950.0,17,3,1143,3,1143,27475.0,381.0,381.0,0,0,0.0,0.0,0.0
41192.0,6,14,4740,7,653,6712.333333333333,249.0,93.28571428571428,7,4087,5335.833333333333,1514.0,583.8571428571429
404.0,17,2,267,1,83,0.0,83.0,83.0,1,184,0.0,184.0,184.0
26682.0,6,10,2032,5,524,5358.75,252.0,104.8,5,1508,6083.75,1236.0,301.6
18883.0,6,14,4740,7,653,2955.1666666666665,249.0,93.28571428571428,7,4087,2995.0,1514.0,583.8571428571429
98228085.0,6,196,22092,98,15402,1010442.237113402,284.0,157.16326530612244,98,6690,1010442.1237113402,140.0,68.26530612244898
6374.0,17,4,823,2,163,0.0,89.0,81.5,2,660,0.0,443.0,330.0
0.0,6,1,54,1,54,0.0,54.0,54.0,0,0,0.0,0.0,0.0
1028748.0,6,11,1134,6,558,205749.6,220.0,93.0,5,576,256406.75,304.0,115.2
2366.0,17,4,344,2,150,0.0,75.0,75.0,2,194,0.0,103.0,97.0
217834.0,6,3,426,2,280,0.0,214.0,140.0,1,146,0.0,146.0,146.0
153420.0,17,2,180,1,90,0.0,90.0,90.0,1,90,0.0,90.0,90.0
2172.0,17,4,344,2,150,0.0,75.0,75.0,2,194,0.0,103.0,97.0
258457.0,6,3,373,2,238,0.0,172.0,119.0,1,135,0.0,135.0,135.0
102896700.0,6,41,2706,21,1386,5144835.0,66.0,66.0,20,1320,5062759.421052632,66.0,66.0
93016264.0,6,38,2508,19,1254,5150442.666666667,66.0,66.0,19,1254,5150433.5,66.0,66.0
90256038.0,6,13,2036,8,1016,12893719.714285716,188.0,127.0,5,1020,22520326.75,204.0,204.0
16912.0,17,2,180,1,90,0.0,90.0,90.0,1,90,0.0,90.0,90.0
346.0,17,2,267,1,83,0.0,83.0,83.0,1,184,0.0,184.0,184.0
18264593.0,6,10,643,6,396,3652918.6,95.0,66.0,4,247,6003191.0,85.0,61.75
103334.0,17,2,286,2,286,0.0,143.0,143.0,0,0,0.0,0.0,0.0
5605180.0,6,5,336,2,134,0.0,68.0,67.0,3,202,1524467.0,70.0,67.33333333333333
370.0,17,2,267,1,83,0.0,83.0,83.0,1,184,0.0,184.0,184.0
2499644.0,6,25,7573,14,3735,192280.3076923077,1514.0,266.7857142857143,11,3838,223860.5,1514.0,348.90909090909093
14206.0,6,13,1459,7,862,2192.6666666666665,271.0,123.14285714285714,6,597,2529.4,259.0,99.5
108107612.0,17,5,1005,5,1005,27026903.0,201.0,201.0,0,0,0.0,0.0,0.0
116023490.0,6,47,3102,23,1518,5143989.227272728,66.0,66.0,24,1584,5044488.695652174,66.0,66.0
104797526.0,6,30,2122,15,1105,7485537.571428572,139.0,73.66666666666667,15,1017,7470085.071428572,123.0,67.8
55600.0,6,10,2032,5,524,13021.5,252.0,104.8,5,1508,12321.0,1236.0,301.6
318949.0,6,6,412,4,272,106316.33333333331,74.0,68.0,2,140,0.0,74.0,70.0
118857422.0,6,36,2596,18,1348,6991613.05882353,139.0,74.88888888888889,18,1248,6979504.94117647,123.0,69.33333333333333
2229795.0,6,59,47354,25,1819,92908.125,215.0,72.76,34,45535,67160.90909090909,1514.0,1339.264705882353
120189706.0,6,246,27860,123,8414,978347.237704918,140.0,68.40650406504065,123,19446,981838.6229508196,284.0,158.09756097560975
111121889.0,6,202,22742,101,6962,1102781.87,140.0,68.93069306930693,101,15780,1062317.02,284.0,156.23762376237624
216866.0,6,3,426,2,280,0.0,214.0,140.0,1,146,0.0,146.0,146.0
120060689.0,17,28,13364,28,13364,4446692.185185186,501.0,477.2857142857143,0,0,0.0,0.0,0.0
77061.0,6,10,2032,5,524,18427.0,252.0,104.8,5,1508,18164.0,1236.0,301.6
1732541.0,6,23,6509,12,1529,155333.18181818182,357.0,127.41666666666669,11,4980,143054.6,1510.0,452.7272727272728
316750.0,17,4,1400,4,1400,105583.33333333331,350.0,350.0,0,0,0.0,0.0,0.0
42238.0,6,10,2032,5,524,9539.25,252.0,104.8,5,1508,9834.0,1236.0,301.6
2343.0,17,4,344,2,150,0.0,75.0,75.0,2,194,0.0,103.0,97.0
108291858.0,17,14,864,7,432,18000162.833333332,174.0,61.71428571428572,7,432,18001006.166666668,174.0,61.71428571428572
2474.0,17,2,762,2,762,0.0,381.0,381.0,0,0,0.0,0.0,0.0
108108206.0,17,5,955,5,955,27027051.5,191.0,191.0,0,0,0.0,0.0,0.0
4500.0,17,2,598,1,72,0.0,72.0,72.0,1,526,0.0,526.0,526.0
9656.0,17,2,571,1,86,0.0,86.0,86.0,1,485,0.0,485.0,485.0
108106051.0,17,5,1005,5,1005,27026512.75,201.0,201.0,0,0,0.0,0.0,0.0
105051896.0,17,14,4788,14,4788,8080915.076923077,342.0,342.0,0,0,0.0,0.0,0.0
147292.0,6,3,373,2,238,0.0,172.0,119.0,1,135,0.0,135.0,135.0
22470.0,6,14,4740,7,653,3501.833333333333,249.0,93.28571428571428,7,4087,3609.1666666666665,1514.0,583.8571428571429
232508.0,6,3,337,2,214,0.0,160.0,107.0,1,123,0.0,123.0,123.0
217138.0,6,3,426,2,280,0.0,214.0,140.0,1,146,0.0,146.0,146.0
121240335.0,6,214,24218,107,7284,1093805.8301886793,140.0,68.07476635514018,107,16934,1143576.7452830188,284.0,158.26168224299064
819.0,17,4,438,2,148,0.0,74.0,74.0,2,290,0.0,147.0,145.0
3328113.0,6,5,336,2,134,0.0,68.0,67.0,3,202,1423661.5,70.0,67.33333333333333
284522.0,17,2,363,1,79,0.0,79.0,79.0,1,284,0.0,284.0,284.0
108098348.0,17,5,1005,5,1005,27024587.0,201.0,201.0,0,0,0.0,0.0,0.0
2381.0,17,4,344,2,150,0.0,75.0,75.0,2,194,0.0,103.0,97.0
575930.0,17,2,335,1,88,0.0,88.0,88.0,1,247,0.0,247.0,247.0
305293.0,6,6,412,4,272,101764.33333333331,74.0,68.0,2,140,0.0,74.0,70.0
31157.0,6,14,4740,7,653,4969.833333333333,249.0,93.28571428571428,7,4087,4561.0,1514.0,583.8571428571429
205792.0,17,2,180,1,90,0.0,90.0,90.0,1,90,0.0,90.0,90.0
13169.0,6,10,1067,5,536,2974.75,264.0,107.2,5,531,2749.75,259.0,106.2
0.0,17,1,381,1,381,0.0,381.0,381.0,0,0,0.0,0.0,0.0
10484446.0,6,6,412,3,206,5172888.0,74.0,68.66666666666667,3,206,5172768.5,74.0,68.66666666666667
36123.0,6,10,2032,5,524,8800.5,252.0,104.8,5,1508,8356.5,1236.0,301.6
124937501.0,6,33,2227,17,1225,7808593.8125,139.0,72.05882352941177,16,1002,7802045.933333334,123.0,62.625
120038188.0,17,29,13785,29,13785,4287078.142857143,501.0,475.3448275862069,0,0,0.0,0.0,0.0
118684219.0,6,34,2350,17,1225,7417763.6875,139.0,72.05882352941177,17,1125,7404236.3125,123.0,66.17647058823529
45201.0,6,14,4740,7,653,6188.5,249.0,93.28571428571428,7,4087,6650.333333333333,1514.0,583.8571428571429
1183176.0,6,13,3014,8,2386,169025.14285714287,1514.0,298.25,5,628,226892.0,331.0,125.6
4319.0,17,4,704,2,148,0.0,74.0,74.0,2,556,0.0,280.0,278.0
146257.0,6,3,337,2,214,0.0,160.0,107.0,1,123,0.0,123.0,123.0
91811.0,17,2,286,2,286,0.0,143.0,143.0,0,0,0.0,0.0,0.0
32322.0,6,14,4740,7,653,5163.333333333333,249.0,93.28571428571428,7,4087,4444.5,1514.0,583.8571428571429
11264.0,6,10,1067,5,536,2360.75,264.0,107.2,5,531,2472.25,259.0,106.2
106390.0,17,2,286,2,286,0.0,143.0,143.0,0,0,0.0,0.0,0.0
204982.0,6,13,1386,7,789,34163.666666666664,253.0,112.71428571428572,6,597,39256.8,259.0,99.5
3012071.0,6,11,1979,6,527,602222.0,233.0,87.83333333333333,5,1452,2823.25,1224.0,290.4
18407.0,6,14,4740,7,653,2870.833333333333,249.0,93.28571428571428,7,4087,2500.5,1514.0,583.8571428571429
117000965.0,17,13,821,7,432,19500160.83333333,174.0,61.71428571428572,6,389,19401472.6,174.0,64.83333333333333
30156.0,6,14,4740,7,653,4674.5,249.0,93.28571428571428,7,4087,4887.833333333333,1514.0,583.8571428571429
4460.0,17,2,622,1,75,0.0,75.0,75.0,1,547,0.0,547.0,547.0
10441935.0,6,7,478,4,272,3435079.0,74.0,68.0,3,206,5152531.5,74.0,68.66666666666667
43797.0,6,14,4740,7,653,7188.5,249.0,93.28571428571428,7,4087,7158.833333333333,1514.0,583.8571428571429
49801.0,6,14,4740,7,653,8112.0,249.0,93.28571428571428,7,4087,7363.166666666667,1514.0,583.8571428571429
93035373.0,6,186,21162,93,14802,1008913.5652173914,336.0,159.16129032258064,93,6360,1008913.4891304348,140.0,68.38709677419355
108106960.0,17,5,1005,5,1005,27026740.0,201.0,201.0,0,0,0.0,0.0,0.0
221000.0,6,10,1221,6,636,44200.0,298.0,106.0,4,585,70342.0,379.0,146.25
306925.0,6,6,412,4,272,102308.33333333331,74.0,68.0,2,140,0.0,74.0,70.0
407276.0,6,10,1221,6,636,81455.2,298.0,106.0,4,585,134048.33333333334,379.0,146.25
52423.0,6,14,4740,7,653,6549.166666666667,249.0,93.28571428571428,7,4087,8563.5,1514.0,583.8571428571429
108107719.0,17,5,1005,5,1005,27026929.75,201.0,201.0,0,0,0.0,0.0,0.0
120061741.0,17,28,13364,28,13364,4446731.148148148,501.0,477.2857142857143,0,0,0.0,0.0,0.0
47829.0,6,14,4740,7,653,7797.666666666667,249.0,93.28571428571428,7,4087,7655.666666666667,1514.0,583.8571428571429
90031275.0,17,28,13364,28,13364,3334491.6666666665,501.0,477.2857142857143,0,0,0.0,0.0,0.0
62724.0,6,14,4740,7,653,9919.833333333334,249.0,93.28571428571428,7,4087,10189.333333333334,1514.0,583.8571428571429
129710.0,6,2,132,1,66,0.0,66.0,66.0,1,66,0.0,66.0,66.0
108117388.0,17,5,1005,5,1005,27029347.0,201.0,201.0,0,0,0.0,0.0,0.0
90041499.0,17,28,13364,28,13364,3334870.333333333,501.0,477.2857142857143,0,0,0.0,0.0,0.0
114757702.0,6,30,1974,15,1026,8181572.642857143,123.0,68.4,15,948,8181572.214285715,123.0,63.2
43784.0,6,10,2032,5,524,10645.0,252.0,104.8,5,1508,9604.25,1236.0,301.6
226278.0,17,2,180,1,90,0.0,90.0,90.0,1,90,0.0,90.0,90.0
1067.0,17,2,508,2,508,0.0,257.0,254.0,0,0,0.0,0.0,0.0
120118200.0,6,15,2428,9,1204,15014775.0,188.0,133.77777777777777,6,1224,18077217.0,204.0,204.0
52402.0,6,14,4740,7,653,7675.5,249.0,93.28571428571428,7,4087,8196.333333333334,1514.0,583.8571428571429
113618190.0,6,46,3036,23,1518,5150442.863636363,66.0,66.0,23,1518,5150444.818181818,66.0,66.0
91947159.0,6,176,19888,88,13932,1054389.5172413792,284.0,158.3181818181818,88,5956,1054389.551724138,140.0,67.68181818181819
40761.0,6,14,4740,7,653,6669.666666666667,249.0,93.28571428571428,7,4087,6072.5,1514.0,583.8571428571429
23937.0,6,14,4740,7,653,3687.3333333333335,249.0,93.28571428571428,7,4087,3516.0,1514.0,583.8571428571429
2912357.0,6,3,1602,2,850,0.0,784.0,425.0,1,752,0.0,752.0,752.0
334.0,17,2,160,1,80,0.0,80.0,80.0,1,80,0.0,80.0,80.0
43816.0,6,14,4740,7,653,5430.0,249.0,93.28571428571428,7,4087,6432.666666666667,1514.0,583.8571428571429
112824065.0,6,615,128294,306,20788,367251.4426229508,214.0,67.93464052287581,309,107506,366255.8538961039,1514.0,347.915857605178
284546.0,17,2,363,1,79,0.0,79.0,79.0,1,284,0.0,284.0,284.0
6990.0,17,4,344,2,150,0.0,75.0,75.0,2,194,0.0,103.0,97.0
139008.0,6,2,132,1,66,0.0,66.0,66.0,1,66,0.0,66.0,66.0
31916.0,6,14,4740,7,653,5170.666666666667,249.0,93.28571428571428,7,4087,5111.333333333333,1514.0,583.8571428571429
147892.0,17,2,180,1,90,0.0,90.0,90.0,1,90,0.0,90.0,90.0
33693.0,6,14,4740,7,653,5443.833333333333,249.0,93.28571428571428,7,4087,5299.833333333333,1514.0,583.8571428571429
850503.0,6,9,1196,6,725,170100.6,387.0,120.83333333333331,3,471,287421.0,331.0,157.0
64128.00000000001,6,14,4740,7,653,10564.666666666666,249.0,93.28571428571428,7,4087,10447.333333333334,1514.0,583.8571428571429
108105394.0,17,5,955,5,955,27026348.5,191.0,191.0,0,0,0.0,0.0,0.0
120460621.0,6,243,27482,122,19274,995542.3223140496,284.0,157.98360655737704,121,8208,995058.875,140.0,67.83471074380165
115430273.0,17,16,1212,8,606,16490039.0,174.0,75.75,8,606,16350612.0,174.0,75.75
52202.0,6,14,4740,7,653,8484.666666666666,249.0,93.28571428571428,7,4087,7754.5,1514.0,583.8571428571429
281909.0,6,2,132,1,66,0.0,66.0,66.0,1,66,0.0,66.0,66.0
217345.0,6,3,426,2,280,0.0,214.0,140.0,1,146,0.0,146.0,146.0
135132780.0,17,6,1146,6,1146,27026556.0,191.0,191.0,0,0,0.0,0.0,0.0
2471279.0,6,3,1604,2,851,0.0,785.0,425.5,1,753,0.0,753.0,753.0
90215796.0,6,16,1192,8,596,12853194.857142856,95.0,74.5,8,596,12858732.0,95.0,74.5
112321774.0,17,15,1169,7,563,15500133.5,174.0,80.42857142857143,8,606,16001963.142857144,174.0,75.75
252253.0,6,3,337,2,214,0.0,160.0,107.0,1,123,0.0,123.0,123.0
341.0,17,2,267,1,83,0.0,83.0,83.0,1,184,0.0,184.0,184.0
113961468.0,6,32,2220,16,1149,7583050.733333333,123.0,71.8125,16,1071,7583051.466666667,123.0,66.9375
35796.0,6,14,4740,7,653,4927.0,249.0,93.28571428571428,7,4087,5476.666666666667,1514.0,583.8571428571429
134695.0,17,4,1524,4,1524,44898.333333333336,381.0,381.0,0,0,0.0,0.0,0.0
120357366.0,6,225,25468,113,17780,1074619.3392857143,284.0,157.34513274336285,112,7688,1074954.7117117117,140.0,68.64285714285714
36955.0,6,10,2032,5,524,8261.0,252.0,104.8,5,1508,8992.25,1236.0,301.6
116118018.0,6,20,1490,10,745,12902002.0,95.0,74.5,10,745,12872427.444444444,95.0,74.5
2596909.0,6,2,132,1,66,0.0,66.0,66.0,1,66,0.0,66.0,66.0
90222705.0,6,16,1192,8,596,12852782.714285716,95.0,74.5,8,596,12858086.142857144,95.0,74.5
45353.0,6,14,4740,7,653,7431.166666666667,249.0,93.28571428571428,7,4087,5348.0,1514.0,583.8571428571429
156605.0,6,3,337,2,214,0.0,160.0,107.0,1,123,0.0,123.0,123.0
14282.0,6,14,4740,7,653,2271.333333333333,249.0,93.28571428571428,7,4087,2245.1666666666665,1514.0,583.8571428571429
1295865.0,6,4,264,2,132,0.0,66.0,66.0,2,132,0.0,66.0,66.0
216603.0,17,2,180,1,90,0.0,90.0,90.0,1,90,0.0,90.0,90.0
31658312.0,6,5,336,2,134,0.0,68.0,67.0,3,202,15758963.0,70.0,67.33333333333333
91353108.0,6,23,1734,11,840,9135310.8,95.0,76.36363636363636,12,894,8282722.0,95.0,74.5
119594140.0,17,34,16284,34,16284,3624064.8484848486,501.0,478.9411764705882,0,0,0.0,0.0,0.0
30641.0,6,10,2032,5,524,7422.5,252.0,104.8,5,1508,7287.0,1236.0,301.6
206099.0,6,3,426,2,280,0.0,214.0,140.0,1,146,0.0,146.0,146.0
209513.0,17,2,180,1,90,0.0,90.0,90.0,1,90,0.0,90.0,90.0
75121385.0,6,9,842,9,842,9390173.125,97.0,93.55555555555556,0,0,0.0,0.0,0.0
772.0,17,4,438,2,148,0.0,74.0,74.0,2,290,0.0,147.0,145.0
120318500.0,6,33,2296,17,1225,7519906.25,139.0,72.05882352941177,16,1071,7341251.333333333,123.0,66.9375
108654140.0,6,36,2596,18,1348,6378729.823529412,139.0,74.88888888888889,18,1248,6378727.764705882,123.0,69.33333333333333
38608.0,6,14,4740,7,653,6193.833333333333,249.0,93.28571428571428,7,4087,6105.5,1514.0,583.8571428571429
9439.0,17,2,571,1,86,0.0,86.0,86.0,1,485,0.0,485.0,485.0
46768.0,6,14,4740,7,653,6734.166666666667,249.0,93.28571428571428,7,4087,7661.666666666667,1514.0,583.8571428571429
153411.0,17,2,180,1,90,0.0,90.0,90.0,1,90,0.0,90.0,90.0
76453.0,6,10,2032,5,524,18001.0,252.0,104.8,5,1508,15518.5,1236.0,301.6
70496.0,17,2,620,1,75,0.0,75.0,75.0,1,545,0.0,545.0,545.0
1984843.0,17,20,7488,20,7488,104465.42105263156,390.0,374.4,0,0,0.0,0.0,0.0
15477818.0,6,5,1736,2,819,0.0,753.0,409.5,3,917,7668798.0,785.0,305.6666666666667
232848.0,6,3,337,2,214,0.0,160.0,107.0,1,123,0.0,123.0,123.0
795.0,17,4,438,2,148,0.0,74.0,74.0,2,290,0.0,147.0,145.0
108101814.0,17,5,1005,5,1005,27025453.5,201.0,201.0,0,0,0.0,0.0,0.0
431424.0,6,4,508,2,238,0.0,172.0,119.0,2,270,0.0,135.0,135.0
220140.0,6,10,1221,6,636,44028.0,298.0,106.0,4,585,71524.33333333333,379.0,146.25
148800.0,17,2,414,1,88,0.0,88.0,88.0,1,326,0.0,326.0,326.0
143972.0,17,2,180,1,90,0.0,90.0,90.0,1,90,0.0,90.0,90.0
47225.0,6,11,2098,6,590,8764.6,252.0,98.33333333333331,5,1508,10628.0,1236.0,301.6
13638082.0,6,20,1607,10,975,1478374.111111111,315.0,97.5,10,632,1478413.4444444445,78.0,63.2
138687.0,17,2,176,1,80,0.0,80.0,80.0,1,96,0.0,96.0,96.0
259864.0,6,10,1221,6,636,51972.8,298.0,106.0,4,585,79590.66666666667,379.0,146.25
241279.0,6,3,337,2,214,0.0,160.0,107.0,1,123,0.0,123.0,123.0
835550.0,6,9,1118,6,586,167110.0,248.0,97.66666666666669,3,532,280013.5,392.0,177.33333333333334
98997449.0,6,29,3104,15,1558,7070652.428571428,426.0,103.86666666666666,14,1546,7614722.538461538,357.0,110.42857142857144
200004.0,17,2,762,2,762,0.0,381.0,381.0,0,0,0.0,0.0,0.0
136250.0,6,2,132,1,66,0.0,66.0,66.0,1,66,0.0,66.0,66.0
209730.0,17,2,180,1,90,0.0,90.0,90.0,1,90,0.0,90.0,90.0
90101866.0,6,10,1440,7,828,15016977.666666666,188.0,118.28571428571428,3,612,30034590.5,204.0,204.0
232304.0,6,3,337,2,214,0.0,160.0,107.0,1,123,0.0,123.0,123.0
316195.0,6,6,412,4,272,105398.33333333331,74.0,68.0,2,140,0.0,74.0,70.0
90760037.0,6,23,1775,13,1030,7559107.833333333,95.0,79.23076923076923,10,745,10054438.666666666,95.0,74.5
24056728.0,17,3,1034,2,684,0.0,342.0,342.0,1,350,0.0,350.0,350.0
107480.0,17,2,286,2,286,0.0,143.0,143.0,0,0,0.0,0.0,0.0
43470.0,6,10,2032,5,524,10569.75,252.0,104.8,5,1508,9648.5,1236.0,301.6
90034966.0,17,28,13364,28,13364,3334628.3703703703,501.0,477.2857142857143,0,0,0.0,0.0,0.0
153408.0,17,2,180,1,90,0.0,90.0,90.0,1,90,0.0,90.0,90.0
79889.0,6,14,4740,7,653,13193.0,249.0,93.28571428571428,7,4087,11865.666666666666,1514.0,583.8571428571429
198681.0,17,2,180,1,90,0.0,90.0,90.0,1,90,0.0,90.0,90.0
106625.0,17,2,286,2,286,0.0,143.0,143.0,0,0,0.0,0.0,0.0
2456.0,17,2,664,1,322,0.0,322.0,322.0,1,342,0.0,342.0,342.0
135133938.0,17,6,1206,6,1206,27026787.6,201.0,201.0,0,0,0.0,0.0,0.0
1050.0,17,4,438,2,148,0.0,74.0,74.0,2,290,0.0,147.0,145.0
122375511.0,6,241,27800,121,19658,1019795.925,374.0,162.46280991735537,120,8142,1004135.218487395,140.0,67.85
3574347.0,6,5,336,2,134,0.0,68.0,67.0,3,202,1525746.5,70.0,67.33333333333333
8617.0,6,10,2032,5,524,1916.0,252.0,104.8,5,1508,1593.25,1236.0,301.6
209598.0,17,2,180,1,90,0.0,90.0,90.0,1,90,0.0,90.0,90.0
90034223.0,17,28,13364,28,13364,3334600.851851852,501.0,477.2857142857143,0,0,0.0,0.0,0.0
299602.0,6,6,412,4,272,99867.33333333331,74.0,68.0,2,140,0.0,74.0,70.0
224870.0,6,3,426,2,280,0.0,214.0,140.0,1,146,0.0,146.0,146.0
203388.0,17,2,762,2,762,0.0,381.0,381.0,0,0,0.0,0.0,0.0
90257826.0,6,12,1832,8,1016,12893975.142857144,188.0,127.0,4,816,30028077.666666668,204.0,204.0
276637.0,17,2,180,1,90,0.0,90.0,90.0,1,90,0.0,90.0,90.0
237939.0,6,10,1221,6,636,47587.8,298.0,106.0,4,585,77507.66666666667,379.0,146.25
12186.0,17,4,344,2,150,0.0,75.0,75.0,2,194,0.0,103.0,97.0
108111596.0,17,5,955,5,955,27027899.0,191.0,191.0,0,0,0.0,0.0,0.0
27275931.0,17,5,1710,5,1710,6818982.75,342.0,342.0,0,0,0.0,0.0,0.0
309819.0,6,6,412,4,272,103273.0,74.0,68.0,2,140,0.0,74.0,70.0
42921.0,6,14,4740,7,653,6695.833333333333,249.0,93.28571428571428,7,4087,6868.333333333333,1514.0,583.8571428571429
90030379.0,17,28,13364,28,13364,3334458.4814814813,501.0,477.2857142857143,0,0,0.0,0.0,0.0
35888.0,6,14,4740,7,653,5836.333333333333,249.0,93.28571428571428,7,4087,5033.333333333333,1514.0,583.8571428571429
737.0,17,4,438,2,148,0.0,74.0,74.0,2,290,0.0,147.0,145.0
1026570.0,6,11,1134,6,558,205314.0,220.0,93.0,5,576,255976.5,304.0,115.2
308.0,17,2,174,1,79,0.0,79.0,79.0,1,95,0.0,95.0,95.0
90298016.0,6,16,1192,8,596,12893271.0,95.0,74.5,8,596,12898675.57142857,95.0,74.5
104575.0,6,2,132,1,66,0.0,66.0,66.0,1,66,0.0,66.0,66.0
206345.0,6,3,426,2,280,0.0,214.0,140.0,1,146,0.0,146.0,146.0
98875.0,17,6,9084,6,9084,19775.0,1514.0,1514.0,0,0,0.0,0.0,0.0
527427.0,17,6,2100,6,2100,105485.4,350.0,350.0,0,0,0.0,0.0,0.0
90258477.0,6,13,2036,8,1016,12894068.142857144,188.0,127.0,5,1020,22523472.25,204.0,204.0
107102.0,17,2,286,2,286,0.0,143.0,143.0,0,0,0.0,0.0,0.0
234977.0,6,3,337,2,214,0.0,160.0,107.0,1,123,0.0,123.0,123.0
100546568.0,17,12,778,6,389,19820814.0,174.0,64.83333333333333,6,389,20077287.8,174.0,64.83333333333333
90011307.0,17,28,13364,28,13364,3333752.111111111,501.0,477.2857142857143,0,0,0.0,0.0,0.0
48281.0,6,14,4740,7,653,7812.333333333333,249.0,93.28571428571428,7,4087,7055.166666666667,1514.0,583.8571428571429
148017.0,17,2,180,1,90,0.0,90.0,90.0,1,90,0.0,90.0,90.0
5798508.0,6,5,336,2,134,0.0,68.0,67.0,3,202,1524034.5,70.0,67.33333333333333
15063.0,6,14,4740,7,653,2232.5,249.0,93.28571428571428,7,4087,2331.5,1514.0,583.8571428571429
250194.00000000003,6,3,337,2,214,0.0,160.0,107.0,1,123,0.0,123.0,123.0
107613700.0,6,28,1860,14,966,8261374.538461538,123.0,69.0,14,894,8261374.538461538,123.0,63.85714285714285
120124515.0,6,14,2224,9,1204,15015564.375,188.0,133.77777777777777,5,1020,22523500.75,204.0,204.0
234079.0,6,3,337,2,214,0.0,160.0,107.0,1,123,0.0,123.0,123.0
352361.0,6,3,204,2,136,0.0,70.0,68.0,1,68,0.0,68.0,68.0
90757559.0,6,20,1851,11,1201,9071061.4,255.0,109.1818181818182,9,650,11344285.875,95.0,72.22222222222223
120511887.0,6,219,24802,110,17312,1105613.6422018348,284.0,157.38181818181818,109,7490,1106280.9351851852,140.0,68.71559633027523
4370.0,17,2,602,1,72,0.0,72.0,72.0,1,530,0.0,530.0,530.0
119591259.0,6,21,1585,10,745,13287917.666666666,95.0,74.5,11,840,11933072.0,95.0,76.36363636363636
196966.0,17,2,180,1,90,0.0,90.0,90.0,1,90,0.0,90.0,90.0
298370.0,6,6,412,4,272,99456.66666666669,74.0,68.0,2,140,0.0,74.0,70.0
413466.0,6,4,508,2,238,0.0,172.0,119.0,2,270,0.0,135.0,135.0
315146.0,17,4,1400,4,1400,105048.66666666669,350.0,350.0,0,0,0.0,0.0,0.0
2394.0,17,4,344,2,150,0.0,75.0,75.0,2,194,0.0,103.0,97.0
90528452.0,6,15,2444,8,1016,12932636.0,188.0,127.0,7,1428,15061073.0,204.0,204.0
103146382.0,17,14,864,7,432,17167819.833333332,174.0,61.71428571428572,7,432,17166853.5,174.0,61.71428571428572
90097379.0,6,11,1644,4,816,30032050.666666668,204.0,204.0,7,828,15015865.833333334,188.0,118.28571428571428
1180991.0,6,11,1134,6,558,236198.2,220.0,93.0,5,576,292900.75,304.0,115.2
250919.0,6,10,1221,6,636,50183.8,298.0,106.0,4,585,77882.0,379.0,146.25
2964924.0,6,4,1670,2,851,0.0,785.0,425.5,2,819,0.0,753.0,409.5
108099958.0,17,5,1005,5,1005,27024989.5,201.0,201.0,0,0,0.0,0.0,0.0
90200259.0,6,17,1287,8,596,12851860.57142857,95.0,74.5,9,691,11249454.375,95.0,76.77777777777777
22020.0,6,14,4740,7,653,3545.1666666666665,249.0,93.28571428571428,7,4087,3538.333333333333,1514.0,583.8571428571429
118515269.0,6,225,25410,113,7680,1058172.044642857,140.0,67.96460176991151,112,17730,1058359.3513513512,284.0,158.30357142857142
116017534.0,17,14,864,7,432,19334090.33333333,174.0,61.71428571428572,7,432,19333501.5,174.0,61.71428571428572
246061.0,6,3,337,2,214,0.0,160.0,107.0,1,123,0.0,123.0,123.0
2338.0,17,4,344,2,150,0.0,75.0,75.0,2,194,0.0,103.0,97.0
10921060.0,6,8,544,4,272,3592052.333333333,74.0,68.0,4,272,3591994.0,74.0,68.0
44984.0,6,14,4740,7,653,7288.333333333333,249.0,93.28571428571428,7,4087,7361.166666666667,1514.0,583.8571428571429
121675.0,6,3,337,2,214,0.0,160.0,107.0,1,123,0.0,123.0,123.0
29633.0,6,10,2032,5,524,6941.25,252.0,104.8,5,1508,4950.25,1236.0,301.6
31297.0,6,14,4740,7,653,5045.0,249.0,93.28571428571428,7,4087,5034.333333333333,1514.0,583.8571428571429
123524358.0,6,48,3168,24,1584,5043290.217391305,66.0,66.0,24,1584,5270059.217391305,66.0,66.0
231269.0,6,3,426,2,280,0.0,214.0,140.0,1,146,0.0,146.0,146.0
234259.0,17,6,1230,3,234,116946.5,78.0,78.0,3,996,116921.0,332.0,332.0
325005.0,6,10,1221,6,636,65001.0,298.0,106.0,4,585,107453.33333333331,379.0,146.25
307222.0,6,6,412,4,272,102407.33333333331,74.0,68.0,2,140,0.0,74.0,70.0
34103.0,6,2,145,2,145,0.0,91.0,72.5,0,0,0.0,0.0,0.0
103162.0,17,2,286,2,286,0.0,143.0,143.0,0,0,0.0,0.0,0.0
0.0,17,1,72,1,72,0.0,72.0,72.0,0,0,0.0,0.0,0.0
146027.0,6,3,337,2,214,0.0,160.0,107.0,1,123,0.0,123.0,123.0
98944389.0,6,215,24580,108,7350,924713.9158878505,140.0,68.05555555555556,107,17230,923578.3679245284,406.0,161.02803738317758
136132.0,6,2,132,1,66,0.0,66.0,66.0,1,66,0.0,66.0,66.0
307198.0,6,6,412,4,272,102399.33333333331,74.0,68.0,2,140,0.0,74.0,70.0
98294.0,6,14,4740,7,653,14776.5,249.0,93.28571428571428,7,4087,15822.833333333334,1514.0,583.8571428571429
34732.0,6,14,4740,7,653,5629.333333333333,249.0,93.28571428571428,7,4087,5648.0,1514.0,583.8571428571429
34512.0,6,14,4740,7,653,5592.166666666667,249.0,93.28571428571428,7,4087,4891.166666666667,1514.0,583.8571428571429
118253943.0,6,36,2596,18,1348,6956114.294117647,139.0,74.88888888888889,18,1248,6943398.588235294,123.0,69.33333333333333
99266.0,17,2,762,2,762,0.0,381.0,381.0,0,0,0.0,0.0,0.0
24003.0,6,2,145,2,145,0.0,91.0,72.5,0,0,0.0,0.0,0.0
26247.0,6,10,2032,5,524,6170.25,252.0,104.8,5,1508,6322.0,1236.0,301.6
133901.0,6,2,132,1,66,0.0,66.0,66.0,1,66,0.0,66.0,66.0
0.0,17,1,55,1,55,0.0,55.0,55.0,0,0,0.0,0.0,0.0
328862.0,6,6,412,4,272,109620.66666666669,74.0,68.0,2,140,0.0,74.0,70.0
310237.0,17,4,1400,4,1400,103412.33333333331,350.0,350.0,0,0,0.0,0.0,0.0
14635656.0,6,20,1607,10,975,1592647.6666666667,315.0,97.5,10,632,1592606.888888889,78.0,63.2
337.0,17,2,166,1,75,0.0,75.0,75.0,1,91,0.0,91.0,91.0
1302444.0,6,4,264,2,132,0.0,66.0,66.0,2,132,0.0,66.0,66.0
166661.0,17,2,180,1,90,0.0,90.0,90.0,1,90,0.0,90.0,90.0
115893894.0,6,48,3168,24,1584,5038864.956521739,66.0,66.0,24,1584,5025758.173913044,66.0,66.0
205779.0,17,2,180,1,90,0.0,90.0,90.0,1,90,0.0,90.0,90.0
10422098.0,6,6,412,3,206,5143029.5,74.0,68.66666666666667,3,206,5142914.0,74.0,68.66666666666667
108105484.0,17,5,955,5,955,27026371.0,191.0,191.0,0,0,0.0,0.0,0.0
250164.0,6,3,337,2,214,0.0,160.0,107.0,1,123,0.0,123.0,123.0
38251.0,6,10,1949,5,441,9224.5,169.0,88.2,5,1508,8994.25,1236.0,301.6
118205100.0,6,30,1974,15,1026,8427804.785714285,123.0,68.4,15,948,8427801.357142856,123.0,63.2
90283294.0,6,17,1287,9,691,11279807.5,95.0,76.77777777777777,8,596,12831842.57142857,95.0,74.5
311217.0,17,4,1400,4,1400,103739.0,350.0,350.0,0,0,0.0,0.0,0.0
121418.0,6,3,337,2,214,0.0,160.0,107.0,1,123,0.0,123.0,123.0
108108126.0,17,5,1005,5,1005,27027031.5,201.0,201.0,0,0,0.0,0.0,0.0
336.0,17,2,267,1,83,0.0,83.0,83.0,1,184,0.0,184.0,184.0
710598.0,6,2,132,1,66,0.0,66.0,66.0,1,66,0.0,66.0,66.0
20680.0,6,20,7606,11,978,2068.0,310.0,88.9090909090909,9,6628,2304.75,1514.0,736.4444444444445
143897.0,17,2,180,1,90,0.0,90.0,90.0,1,90,0.0,90.0,90.0
20662.0,6,10,2032,5,524,3609.25,252.0,104.8,5,1508,4605.75,1236.0,301.6
14226353.0,17,6,2052,6,2052,2845270.6,342.0,342.0,0,0,0.0,0.0,0.0
1308499.0,6,4,264,2,132,0.0,66.0,66.0,2,132,0.0,66.0,66.0
303258.0,6,6,412,4,272,101086.0,74.0,68.0,2,140,0.0,74.0,70.0
409357.0,6,4,508,2,238,0.0,172.0,119.0,2,270,0.0,135.0,135.0
331.0,17,2,208,1,72,0.0,72.0,72.0,1,136,0.0,136.0,136.0
218280.0,6,3,426,2,280,0.0,214.0,140.0,1,146,0.0,146.0,146.0
296844.0,17,2,180,1,90,0.0,90.0,90.0,1,90,0.0,90.0,90.0
245428.0,6,3,337,2,214,0.0,160.0,107.0,1,123,0.0,123.0,123.0
108103639.0,17,5,955,5,955,27025909.75,191.0,191.0,0,0,0.0,0.0,0.0
120028273.0,17,29,13785,29,13785,4286724.035714285,501.0,475.3448275862069,0,0,0.0,0.0,0.0
1302614.0,6,4,264,2,132,0.0,66.0,66.0,2,132,0.0,66.0,66.0
197267.0,17,2,180,1,90,0.0,90.0,90.0,1,90,0.0,90.0,90.0
34266.0,17,2,582,1,83,0.0,83.0,83.0,1,499,0.0,499.0,499.0
113404265.0,6,48,3168,24,1584,4930620.217391305,66.0,66.0,24,1584,4920349.826086956,66.0,66.0
242518.0,6,3,337,2,214,0.0,160.0,107.0,1,123,0.0,123.0,123.0
37877.0,6,10,2032,5,524,8545.75,252.0,104.8,5,1508,8790.25,1236.0,301.6
2799202.0,6,2,132,1,66,0.0,66.0,66.0,1,66,0.0,66.0,66.0
3256998.0,6,3,1604,2,851,0.0,785.0,425.5,1,753,0.0,753.0,753.0
105981.0,17,2,700,2,700,0.0,350.0,350.0,0,0,0.0,0.0,0.0
634787.0,17,2,473,1,78,0.0,78.0,78.0,1,395,0.0,395.0,395.0
120760808.0,6,35,2542,17,1194,6923477.75,123.0,70.23529411764706,18,1348,6516216.529411765,139.0,74.88888888888889
170849.0,6,3,337,2,214,0.0,160.0,107.0,1,123,0.0,123.0,123.0
303121.0,6,6,412,4,272,101040.33333333331,74.0,68.0,2,140,0.0,74.0,70.0
147944.0,17,2,180,1,90,0.0,90.0,90.0,1,90,0.0,90.0,90.0
2588420.0,6,2,132,1,66,0.0,66.0,66.0,1,66,0.0,66.0,66.0
299793.0,6,6,412,4,272,99931.0,74.0,68.0,2,140,0.0,74.0,70.0
1099341.0,6,13,1394,7,797,183223.5,253.0,113.85714285714286,6,597,217572.8,259.0,99.5
301736.0,17,2,246,1,76,0.0,76.0,76.0,1,170,0.0,170.0,170.0
117689373.0,6,23,1734,11,840,11768937.3,95.0,76.36363636363636,12,894,10675204.454545457,95.0,74.5
196939.0,17,2,180,1,90,0.0,90.0,90.0,1,90,0.0,90.0,90.0
73014.0,6,14,4740,7,653,11762.0,249.0,93.28571428571428,7,4087,12033.0,1514.0,583.8571428571429
135132200.0,17,6,1146,6,1146,27026440.0,191.0,191.0,0,0,0.0,0.0,0.0
297902.0,6,6,412,4,272,99300.66666666669,74.0,68.0,2,140,0.0,74.0,70.0
206226.0,6,3,426,2,280,0.0,214.0,140.0,1,146,0.0,146.0,146.0
2607142.0,6,25,7573,14,3735,200549.38461538465,1514.0,266.7857142857143,11,3838,235531.7,1514.0,348.90909090909093
90030149.0,17,28,13364,28,13364,3334449.962962963,501.0,477.2857142857143,0,0,0.0,0.0,0.0
444580.0,6,3,1777,1,826,0.0,826.0,826.0,2,951,0.0,885.0,475.5
208134.0,6,3,426,2,280,0.0,214.0,140.0,1,146,0.0,146.0,146.0
25335.0,6,10,2032,5,524,5943.75,252.0,104.8,5,1508,5709.5,1236.0,301.6
106427.0,17,2,286,2,286,0.0,143.0,143.0,0,0,0.0,0.0,0.0
118565.0,6,10,2032,5,524,28968.5,252.0,104.8,5,1508,13087.0,1236.0,301.6
284706.0,17,2,363,1,79,0.0,79.0,79.0,1,284,0.0,284.0,284.0
92713088.0,6,38,2508,19,1254,5135428.833333333,66.0,66.0,19,1254,5135437.444444444,66.0,66.0
1163107.0,6,13,3013,8,2385,166158.14285714287,1514.0,298.125,5,628,221884.5,331.0,125.6
121585.0,6,3,337,2,214,0.0,160.0,107.0,1,123,0.0,123.0,123.0
113183692.0,6,35,2542,18,1348,6645165.05882353,139.0,74.88888888888889,17,1194,7060485.25,123.0,70.23529411764706
106175.0,17,2,286,2,286,0.0,143.0,143.0,0,0,0.0,0.0,0.0
146752.0,6,3,337,2,214,0.0,160.0,107.0,1,123,0.0,123.0,123.0
297423.0,6,6,412,4,272,99141.0,74.0,68.0,2,140,0.0,74.0,70.0
95206598.0,17,11,735,6,389,19041319.6,174.0,64.83333333333333,5,346,18797222.25,174.0,69.2
135128113.0,17,6,1206,6,1206,27025622.6,201.0,201.0,0,0,0.0,0.0,0.0
0.0,6,1,66,1,66,0.0,66.0,66.0,0,0,0.0,0.0,0.0
10470163.0,6,7,478,4,272,3444391.333333333,74.0,68.0,3,206,5166474.0,74.0,68.66666666666667
233278.0,6,10,1221,6,636,46655.6,298.0,106.0,4,585,74630.33333333333,379.0,146.25
90947408.0,6,21,1585,11,840,9093514.8,95.0,76.36363636363636,10,745,10104557.0,95.0,74.5
118072.0,17,2,700,2,700,0.0,350.0,350.0,0,0,0.0,0.0,0.0
109256151.0,17,14,864,7,432,18167605.5,174.0,61.71428571428572,7,432,18166871.0,174.0,61.71428571428572
9119413.0,17,3,1034,2,684,0.0,342.0,342.0,1,350,0.0,350.0,350.0
1467.0,17,2,762,2,762,0.0,381.0,381.0,0,0,0.0,0.0,0.0
217615.0,6,3,426,2,280,0.0,214.0,140.0,1,146,0.0,146.0,146.0
20852.0,6,14,4740,7,653,3268.1666666666665,249.0,93.28571428571428,7,4087,3055.333333333333,1514.0,583.8571428571429
90036390.0,17,28,13364,28,13364,3334681.111111111,501.0,477.2857142857143,0,0,0.0,0.0,0.0
27762.0,6,11,1132,6,556,4676.6,218.0,92.66666666666669,5,576,6733.75,304.0,115.2
120029182.0,6,216,24424,108,17000,1119755.4112149533,284.0,157.40740740740742,108,7424,1119754.8971962617,140.0,68.74074074074075
2380.0,17,4,344,2,150,0.0,75.0,75.0,2,194,0.0,103.0,97.0
73530.0,6,10,2032,5,524,18146.0,252.0,104.8,5,1508,17720.5,1236.0,301.6
321858.0,17,4,1400,4,1400,107286.0,350.0,350.0,0,0,0.0,0.0,0.0
169317.0,17,2,414,1,88,0.0,88.0,88.0,1,326,0.0,326.0,326.0
224366.0,6,10,1221,6,636,44873.2,298.0,106.0,4,585,73308.0,379.0,146.25
120008011.0,6,18,1341,9,691,14999983.5,95.0,76.77777777777777,9,650,15000509.125,95.0,72.22222222222223
1029752.0,6,11,1134,6,558,205950.4,220.0,93.0,5,576,255471.5,304.0,115.2
210504.0,6,3,426,2,280,0.0,214.0,140.0,1,146,0.0,146.0,146.0
160141.0,17,4,1524,4,1524,53380.333333333336,381.0,381.0,0,0,0.0,0.0,0.0
21785.0,17,2,180,1,90,0.0,90.0,90.0,1,90,0.0,90.0,90.0
111034667.0,6,32,2220,16,1149,7387909.666666667,123.0,71.8125,16,1071,7387909.666666667,123.0,66.9375
307072.0,6,6,412,4,272,102357.33333333331,74.0,68.0,2,140,0.0,74.0,70.0
120013510.0,6,25,1883,12,894,10910319.090909092,95.0,74.5,13,989,9979337.5,95.0,76.07692307692308
5624516.0,6,4,270,2,134,0.0,68.0,67.0,2,136,0.0,70.0,68.0
135140658.0,17,6,1146,6,1146,27028131.6,191.0,191.0,0,0,0.0,0.0,0.0
2329.0,17,4,344,2,150,0.0,75.0,75.0,2,194,0.0,103.0,97.0
204406.0,17,2,359,1,75,0.0,75.0,75.0,1,284,0.0,284.0,284.0
206161.0,17,2,180,1,90,0.0,90.0,90.0,1,90,0.0,90.0,90.0
90019549.0,17,28,13364,28,13364,3334057.3703703703,501.0,477.2857142857143,0,0,0.0,0.0,0.0
122010786.0,17,15,907,8,475,17430112.285714287,174.0,59.375,7,432,17030534.833333332,174.0,61.71428571428572
90256158.0,6,12,1832,8,1016,12893736.857142856,188.0,127.0,4,816,30022666.666666668,204.0,204.0
129020.0,6,2,132,1,66,0.0,66.0,66.0,1,66,0.0,66.0,66.0
120164306.0,6,242,28216,121,8208,994444.275,140.0,67.83471074380165,121,20008,994454.9916666668,336.0,165.35537190082644
328.0,17,2,208,1,72,0.0,72.0,72.0,1,136,0.0,136.0,136.0
123524710.0,17,17,1386,9,780,15440588.75,174.0,86.66666666666667,8,606,16815749.14285714,174.0,75.75
90005444.0,17,28,13364,28,13364,3333534.962962963,501.0,477.2857142857143,0,0,0.0,0.0,0.0
102818.0,17,2,286,2,286,0.0,143.0,143.0,0,0,0.0,0.0,0.0
8215590.000000001,6,15,4814,8,727,1172443.7142857143,249.0,90.875,7,4087,12365.833333333334,1514.0,583.8571428571429
317.0,17,2,174,1,79,0.0,79.0,79.0,1,95,0.0,95.0,95.0
120122678.0,6,12,1832,8,1016,17137431.285714287,188.0,127.0,4,816,30031443.0,204.0,204.0
90287591.0,6,16,1192,8,596,12891093.857142856,95.0,74.5,8,596,12896930.714285716,95.0,74.5
236694.0,6,3,337,2,214,0.0,160.0,107.0,1,123,0.0,123.0,123.0
120305786.0,17,16,1343,8,606,16493159.142857144,174.0,75.75,8,737,16575397.285714284,174.0,92.125
205982.0,6,3,426,2,280,0.0,214.0,140.0,1,146,0.0,146.0,146.0
39196.0,6,14,4740,7,653,6404.833333333333,249.0,93.28571428571428,7,4087,6269.5,1514.0,583.8571428571429
29587202.0,6,26,7627,14,3735,178811.92307692306,1514.0,266.7857142857143,12,3892,2671055.909090909,1514.0,324.3333333333333
211270.0,6,10,1221,6,636,42254.0,298.0,106.0,4,585,69106.0,379.0,146.25
120122921.0,6,18,2760,10,1392,13346991.222222222,188.0,139.2,8,1368,12870269.0,204.0,171.0
228403.0,17,2,180,1,90,0.0,90.0,90.0,1,90,0.0,90.0,90.0
120020238.0,17,13,559,7,301,20003373.0,43.0,43.0,6,258,20000175.8,43.0,43.0
107627570.0,6,27,1800,14,894,8279043.846153846,123.0,63.85714285714285,13,906,8118826.583333333,123.0,69.6923076923077
502970.0,6,5,336,2,134,0.0,68.0,67.0,3,202,194307.5,70.0,67.33333333333333
242600.0,6,3,337,2,214,0.0,160.0,107.0,1,123,0.0,123.0,123.0
2783093.0,6,25,7573,14,3735,214084.0769230769,1514.0,266.7857142857143,11,3838,251124.9,1514.0,348.90909090909093
2373.0,17,2,762,2,762,0.0,381.0,381.0,0,0,0.0,0.0,0.0
2959.0,17,2,224,1,76,0.0,76.0,76.0,1,148,0.0,148.0,148.0
46633.0,6,14,4740,7,653,7511.833333333333,249.0,93.28571428571428,7,4087,7064.333333333333,1514.0,583.8571428571429
3625.0,17,2,762,2,762,0.0,381.0,381.0,0,0,0.0,0.0,0.0
309908.0,17,4,704,2,148,0.0,74.0,74.0,2,556,0.0,280.0,278.0
105318.0,17,2,700,2,700,0.0,350.0,350.0,0,0,0.0,0.0,0.0
2338.0,17,4,344,2,150,0.0,75.0,75.0,2,194,0.0,103.0,97.0
114945370.0,6,47,3102,23,1518,5143631.318181818,66.0,66.0,24,1584,4997613.043478261,66.0,66.0
119853752.0,17,35,16705,35,16705,3525110.3529411764,501.0,477.2857142857143,0,0,0.0,0.0,0.0
94540464.0,17,12,778,6,389,18800928.6,174.0,64.83333333333333,6,389,18800163.6,174.0,64.83333333333333
90291561.0,6,21,1585,11,840,9024364.3,95.0,76.36363636363636,10,745,10002438.888888888,95.0,74.5
128008998.0,17,15,907,8,475,18286999.71428572,174.0,59.375,7,432,18000185.333333332,174.0,61.71428571428572
4619.0,17,4,344,2,150,0.0,75.0,75.0,2,194,0.0,103.0,97.0
101782201.0,17,14,864,7,432,16667550.833333334,174.0,61.71428571428572,7,432,16833500.166666668,174.0,61.71428571428572
120151454.0,6,246,27754,123,8414,978062.3278688524,140.0,68.40650406504065,123,19340,978092.606557377,284.0,157.2357723577236
49134.0,6,14,4740,7,653,8028.666666666667,249.0,93.28571428571428,7,4087,8005.0,1514.0,583.8571428571429
178181.0,17,2,180,1,90,0.0,90.0,90.0,1,90,0.0,90.0,90.0
179.0,17,2,3028,2,3028,0.0,1514.0,1514.0,0,0,0.0,0.0,0.0
301900.0,6,6,412,4,272,100633.33333333331,74.0,68.0,2,140,0.0,74.0,70.0
41674.0,6,14,4740,7,653,4681.333333333333,249.0,93.28571428571428,7,4087,6763.833333333333,1514.0,583.8571428571429
102532.0,17,2,286,2,286,0.0,143.0,143.0,0,0,0.0,0.0,0.0
115751447.0,6,36,2596,18,1348,6808908.647058823,139.0,74.88888888888889,18,1248,6796185.176470588,123.0,69.33333333333333
245067.0,6,3,337,2,214,0.0,160.0,107.0,1,123,0.0,123.0,123.0
135135546.0,17,6,1206,6,1206,27027109.2,201.0,201.0,0,0,0.0,0.0,0.0
14905.0,17,2,180,1,90,0.0,90.0,90.0,1,90,0.0,90.0,90.0
352.0,17,2,267,1,83,0.0,83.0,83.0,1,184,0.0,184.0,184.0
228273.0,17,2,180,1,90,0.0,90.0,90.0,1,90,0.0,90.0,90.0
26977832.0,17,5,1710,5,1710,6744458.0,342.0,342.0,0,0,0.0,0.0,0.0
120006544.0,6,24,1829,13,1030,9999998.083333334,95.0,79.23076923076923,11,799,11973606.2,95.0,72.63636363636364
147967.0,17,2,180,1,90,0.0,90.0,90.0,1,90,0.0,90.0,90.0
2412.0,17,4,344,2,150,0.0,75.0,75.0,2,194,0.0,103.0,97.0
107122.0,17,2,286,2,286,0.0,143.0,143.0,0,0,0.0,0.0,0.0
921.0,17,4,6056,4,6056,307.0,1514.0,1514.0,0,0,0.0,0.0,0.0
2342.0,17,4,344,2,150,0.0,75.0,75.0,2,194,0.0,103.0,97.0
304775.0,6,6,412,4,272,101591.66666666669,74.0,68.0,2,140,0.0,74.0,70.0
6987.0,17,2,582,1,83,0.0,83.0,83.0,1,499,0.0,499.0,499.0
108103000.0,17,5,1005,5,1005,27025750.0,201.0,201.0,0,0,0.0,0.0,0.0
47913.0,6,14,4740,7,653,7540.833333333333,249.0,93.28571428571428,7,4087,7702.333333333333,1514.0,583.8571428571429
121521.0,6,3,337,2,214,0.0,160.0,107.0,1,123,0.0,123.0,123.0
768.0,17,4,438,2,148,0.0,74.0,74.0,2,290,0.0,147.0,145.0
92450724.0,17,12,778,6,389,18400653.4,174.0,64.83333333333333,6,389,18400163.4,174.0,64.83333333333333
243526.0,6,3,337,2,214,0.0,160.0,107.0,1,123,0.0,123.0,123.0
94081961.0,17,12,778,6,389,18816392.2,174.0,64.83333333333333,6,389,18673685.4,174.0,64.83333333333333
36801.0,6,14,4740,7,653,5933.333333333333,249.0,93.28571428571428,7,4087,5439.166666666667,1514.0,583.8571428571429
10925841.0,6,8,544,4,272,3596589.0,74.0,68.0,4,272,3596487.0,74.0,68.0
90257075.0,6,13,2036,8,1016,12893867.857142856,188.0,127.0,5,1020,22523144.75,204.0,204.0
120060719.0,17,29,13785,29,13785,4287882.821428572,501.0,475.3448275862069,0,0,0.0,0.0,0.0
51334.0,6,10,2032,5,524,12620.0,252.0,104.8,5,1508,10309.0,1236.0,301.6
207030.0,6,3,426,2,280,0.0,214.0,140.0,1,146,0.0,146.0,146.0
231992.0,6,3,337,2,214,0.0,160.0,107.0,1,123,0.0,123.0,123.0
2028.0,17,4,344,2,150,0.0,75.0,75.0,2,194,0.0,103.0,97.0
27823315.0,17,5,1710,5,1710,6955828.75,342.0,342.0,0,0,0.0,0.0,0.0
138573.0,17,4,344,2,150,0.0,75.0,75.0,2,194,0.0,103.0,97.0
120000035.0,6,28,3055,15,1601,8571431.07142857,427.0,106.73333333333332,13,1454,7707067.333333333,336.0,111.84615384615384
39773.0,6,10,2032,5,524,9186.75,252.0,104.8,5,1508,6207.25,1236.0,301.6
3015082.0,6,11,2106,6,598,602825.4,252.0,99.66666666666669,5,1508,3756.75,1236.0,301.6
162237.0,17,2,180,1,90,0.0,90.0,90.0,1,90,0.0,90.0,90.0
4373.0,17,2,598,1,72,0.0,72.0,72.0,1,526,0.0,526.0,526.0
221642.0,6,10,1221,6,636,44328.4,298.0,106.0,4,585,72869.0,379.0,146.25
32056.0,6,10,2032,5,524,6749.0,252.0,104.8,5,1508,7651.5,1236.0,301.6
27214.0,6,14,4740,7,653,3853.6666666666665,249.0,93.28571428571428,7,4087,4353.5,1514.0,583.8571428571429
50713.0,6,14,4740,7,653,8164.666666666667,249.0,93.28571428571428,7,4087,8226.833333333334,1514.0,583.8571428571429
36380.0,6,14,4740,7,653,5939.833333333333,249.0,93.28571428571428,7,4087,5554.0,1514.0,583.8571428571429
108678.0,17,2,286,2,286,0.0,143.0,143.0,0,0,0.0,0.0,0.0
90217041.0,6,16,1192,8,596,12853074.285714284,95.0,74.5,8,596,12857367.0,95.0,74.5
41459.0,6,14,4740,7,653,6380.5,249.0,93.28571428571428,7,4087,6362.666666666667,1514.0,583.8571428571429
46982.0,6,14,4740,7,653,7707.0,249.0,93.28571428571428,7,4087,7448.333333333333,1514.0,583.8571428571429
842498.0,6,9,1118,6,586,168499.6,248.0,97.66666666666669,3,532,283478.5,392.0,177.33333333333334
299080.0,6,6,412,4,272,99693.33333333331,74.0,68.0,2,140,0.0,74.0,70.0
5662.0,17,5,550,5,550,1415.5,110.0,110.0,0,0,0.0,0.0,0.0
147732.0,6,3,373,2,238,0.0,172.0,119.0,1,135,0.0,135.0,135.0
295.0,17,2,156,1,78,0.0,78.0,78.0,1,78,0.0,78.0,78.0
309303.0,6,6,412,4,272,103101.0,74.0,68.0,2,140,0.0,74.0,70.0
2075.0,17,4,344,2,150,0.0,75.0,75.0,2,194,0.0,103.0,97.0
38570.0,6,14,4740,7,653,6267.833333333333,249.0,93.28571428571428,7,4087,5482.0,1514.0,583.8571428571429
594486.0,17,2,224,1,76,0.0,76.0,76.0,1,148,0.0,148.0,148.0
315.0,17,2,174,1,79,0.0,79.0,79.0,1,95,0.0,95.0,95.0
53713.0,6,14,4740,7,653,6566.333333333333,249.0,93.28571428571428,7,4087,8710.166666666666,1514.0,583.8571428571429
40270.0,6,10,2032,5,524,9360.5,252.0,104.8,5,1508,9807.25,1236.0,301.6
219160.0,17,2,180,1,90,0.0,90.0,90.0,1,90,0.0,90.0,90.0
2306975.0,6,50,23782,26,19851,92279.0,1514.0,763.5,24,3931,90458.47826086955,1514.0,163.79166666666666
103243831.0,17,14,864,7,432,17166820.5,174.0,61.71428571428572,7,432,17167532.0,174.0,61.71428571428572
304100.0,17,4,704,2,148,0.0,74.0,74.0,2,556,0.0,280.0,278.0
843.0,17,4,438,2,148,0.0,74.0,74.0,2,290,0.0,147.0,145.0
228381.0,17,2,180,1,90,0.0,90.0,90.0,1,90,0.0,90.0,90.0
303918.0,6,6,412,4,272,101306.0,74.0,68.0,2,140,0.0,74.0,70.0
17321094.0,6,5,1736,2,819,0.0,753.0,409.5,3,917,8590733.5,785.0,305.6666666666667
49583.0,6,14,4740,7,653,6919.0,249.0,93.28571428571428,7,4087,8130.5,1514.0,583.8571428571429
82989377.0,17,13,4454,12,4104,6795541.818181818,342.0,342.0,1,350,0.0,350.0,350.0
143947.0,17,2,180,1,90,0.0,90.0,90.0,1,90,0.0,90.0,90.0
37785.0,6,14,4740,7,653,5766.0,249.0,93.28571428571428,7,4087,6086.333333333333,1514.0,583.8571428571429
107498.0,17,2,286,2,286,0.0,143.0,143.0,0,0,0.0,0.0,0.0
50940.0,17,2,180,1,90,0.0,90.0,90.0,1,90,0.0,90.0,90.0
121009942.0,6,35,2410,18,1285,7118231.882352941,139.0,71.38888888888889,17,1125,6925501.4375,123.0,66.17647058823529
376.0,17,2,152,1,76,0.0,76.0,76.0,1,76,0.0,76.0,76.0
305796.0,6,6,412,4,272,101932.0,74.0,68.0,2,140,0.0,74.0,70.0
2801239.0,6,2,132,1,66,0.0,66.0,66.0,1,66,0.0,66.0,66.0
343.0,17,2,267,1,83,0.0,83.0,83.0,1,184,0.0,184.0,184.0
854851.0,6,9,1269,6,798,170970.2,460.0,133.0,3,471,291145.5,331.0,157.0
2340.0,17,4,344,2,150,0.0,75.0,75.0,2,194,0.0,103.0,97.0
95406216.0,6,40,2640,20,1320,5021379.7894736845,66.0,66.0,20,1320,5006865.368421053,66.0,66.0
303133.0,6,2,132,1,66,0.0,66.0,66.0,1,66,0.0,66.0,66.0
90019181.0,17,28,13364,28,13364,3334043.7407407407,501.0,477.2857142857143,0,0,0.0,0.0,0.0
49411.0,6,14,4740,7,653,7757.166666666667,249.0,93.28571428571428,7,4087,7506.5,1514.0,583.8571428571429
19352.0,6,10,1065,5,534,4220.25,262.0,106.8,5,531,3486.5,259.0,106.2
147924.0,17,2,180,1,90,0.0,90.0,90.0,1,90,0.0,90.0,90.0
30778.0,6,14,4740,7,653,4428.0,249.0,93.28571428571428,7,4087,4190.333333333333,1514.0,583.8571428571429
2682647.0,6,3,1604,2,851,0.0,785.0,425.5,1,753,0.0,753.0,753.0
21979.0,17,2,582,1,83,0.0,83.0,83.0,1,499,0.0,499.0,499.0
86636.0,6,11,2098,6,590,16587.0,252.0,98.33333333333331,5,1508,19233.25,1236.0,301.6
4602071.0,6,5,336,2,134,0.0,68.0,67.0,3,202,1423774.0,70.0,67.33333333333333
757.0,17,4,438,2,148,0.0,74.0,74.0,2,290,0.0,147.0,145.0
90295084.0,6,16,1192,8,596,12892317.0,95.0,74.5,8,596,12898354.42857143,95.0,74.5
108104744.0,17,5,1005,5,1005,27026186.0,201.0,201.0,0,0,0.0,0.0,0.0
90256076.0,6,16,2368,9,1204,11282009.5,188.0,133.77777777777777,7,1164,15012805.0,204.0,166.28571428571428
109289.0,17,2,286,2,286,0.0,143.0,143.0,0,0,0.0,0.0,0.0
97655396.0,6,26,1746,13,906,8119962.833333333,123.0,69.6923076923077,13,840,8119963.25,123.0,64.61538461538461
34351.0,6,14,4740,7,653,4653.0,249.0,93.28571428571428,7,4087,5428.0,1514.0,583.8571428571429
135132655.0,17,6,1206,6,1206,27026531.0,201.0,201.0,0,0,0.0,0.0,0.0
3156019.0,6,3,204,2,136,0.0,70.0,68.0,1,68,0.0,68.0,68.0
316.0,17,2,174,1,79,0.0,79.0,79.0,1,95,0.0,95.0,95.0
120000024.0,6,17,1287,9,691,15000003.0,95.0,76.77777777777777,8,596,12898903.714285716,95.0,74.5
153485.0,17,2,180,1,90,0.0,90.0,90.0,1,90,0.0,90.0,90.0
200789.0,17,2,762,2,762,0.0,381.0,381.0,0,0,0.0,0.0,0.0
90023200.0,17,28,13364,28,13364,3334192.592592593,501.0,477.2857142857143,0,0,0.0,0.0,0.0
32679756.0,6,5,336,2,134,0.0,68.0,67.0,3,202,14950709.5,70.0,67.33333333333333
120000047.0,6,26,2019,15,1179,8571431.92857143,95.0,78.6,11,840,9187569.7,95.0,76.36363636363636
135134483.0,17,6,1206,6,1206,27026896.6,201.0,201.0,0,0,0.0,0.0,0.0
317689.0,17,4,1400,4,1400,105896.33333333331,350.0,350.0,0,0,0.0,0.0,0.0
175825.0,17,2,180,1,90,0.0,90.0,90.0,1,90,0.0,90.0,90.0
308090.0,6,6,412,4,272,102696.66666666669,74.0,68.0,2,140,0.0,74.0,70.0
204405.0,17,2,762,2,762,0.0,381.0,381.0,0,0,0.0,0.0,0.0
2021.0,17,4,344,2,150,0.0,75.0,75.0,2,194,0.0,103.0,97.0
5004808.0,17,4,534,2,166,0.0,83.0,83.0,2,368,0.0,184.0,184.0
189757.0,17,2,180,1,90,0.0,90.0,90.0,1,90,0.0,90.0,90.0
90213161.0,6,16,1192,8,596,12852697.714285716,95.0,74.5,8,596,12858272.42857143,95.0,74.5
102816.0,17,2,762,2,762,0.0,381.0,381.0,0,0,0.0,0.0,0.0
143943.0,17,2,180,1,90,0.0,90.0,90.0,1,90,0.0,90.0,90.0
34368.0,6,10,2032,5,524,8192.5,252.0,104.8,5,1508,7951.75,1236.0,301.6
108073021.0,17,5,1005,5,1005,27018255.25,201.0,201.0,0,0,0.0,0.0,0.0
120371376.0,6,211,23914,106,16688,1146394.0571428572,284.0,157.43396226415095,105,7226,1147450.8557692308,140.0,68.81904761904762
14793.0,6,10,2032,5,524,3135.75,252.0,104.8,5,1508,3317.25,1236.0,301.6
2418689.0,6,25,7573,14,3735,186053.0,1514.0,266.7857142857143,11,3838,214957.1,1514.0,348.90909090909093
390.0,17,2,174,1,79,0.0,79.0,79.0,1,95,0.0,95.0,95.0
307564.0,6,6,412,4,272,102521.33333333331,74.0,68.0,2,140,0.0,74.0,70.0
2022.0,17,4,344,2,150,0.0,75.0,75.0,2,194,0.0,103.0,97.0
120210977.0,6,18,1341,9,691,14999431.375,95.0,76.77777777777777,9,650,14999455.25,95.0,72.22222222222223
206925.0,6,4,492,2,280,0.0,214.0,140.0,2,212,0.0,146.0,106.0
120058974.0,17,28,13364,28,13364,4446628.666666667,501.0,477.2857142857143,0,0,0.0,0.0,0.0
113419486.0,6,45,2970,23,1518,5155431.181818182,66.0,66.0,22,1452,5217772.619047619,66.0,66.0
345.0,17,2,267,1,83,0.0,83.0,83.0,1,184,0.0,184.0,184.0
52360.0,6,14,4740,7,653,8130.833333333333,249.0,93.28571428571428,7,4087,8267.833333333334,1514.0,583.8571428571429
209657.0,17,2,180,1,90,0.0,90.0,90.0,1,90,0.0,90.0,90.0
102736.0,17,2,286,2,286,0.0,143.0,143.0,0,0,0.0,0.0,0.0
148097.0,17,2,180,1,90,0.0,90.0,90.0,1,90,0.0,90.0,90.0
296.0,17,2,191,1,73,0.0,73.0,73.0,1,118,0.0,118.0,118.0
1513828.0,6,20,6434,12,1921,137620.72727272726,620.0,160.08333333333334,8,4513,177529.0,1514.0,564.125
59441.0,6,14,4740,7,653,9702.833333333334,249.0,93.28571428571428,7,4087,9764.166666666666,1514.0,583.8571428571429
306773.0,6,6,412,4,272,102257.66666666669,74.0,68.0,2,140,0.0,74.0,70.0
68958.0,6,13,1479,7,882,11493.0,291.0,126.0,6,597,11068.2,259.0,99.5
121347.0,6,3,337,2,214,0.0,160.0,107.0,1,123,0.0,123.0,123.0
123091702.0,17,15,1169,7,563,17157329.0,174.0,80.42857142857143,8,606,17561827.0,174.0,75.75
120125177.0,6,14,2224,9,1204,15015647.125,188.0,133.77777777777777,5,1020,22590926.25,204.0,204.0
40027.0,6,11,2098,6,590,5638.4,252.0,98.33333333333331,5,1508,9272.5,1236.0,301.6
4333.0,17,2,634,1,82,0.0,82.0,82.0,1,552,0.0,552.0,552.0
4829.0,17,4,344,2,150,0.0,75.0,75.0,2,194,0.0,103.0,97.0
30539.0,6,14,4740,7,653,4879.166666666667,249.0,93.28571428571428,7,4087,4848.5,1514.0,583.8571428571429
1487.0,17,2,762,2,762,0.0,381.0,381.0,0,0,0.0,0.0,0.0
123775702.0,6,48,3168,24,1584,4949364.0,66.0,66.0,24,1584,5345501.217391305,66.0,66.0
298661.0,6,6,412,4,272,99553.66666666669,74.0,68.0,2,140,0.0,74.0,70.0
11042.0,6,10,1067,5,536,2493.75,264.0,107.2,5,531,2350.25,259.0,106.2
129683.0,6,2,132,1,66,0.0,66.0,66.0,1,66,0.0,66.0,66.0
26252.0,17,2,180,1,90,0.0,90.0,90.0,1,90,0.0,90.0,90.0
90025955.0,17,27,12943,27,12943,3462536.730769231,501.0,479.3703703703704,0,0,0.0,0.0,0.0
122114650.0,6,33,2280,17,1209,7632165.625,123.0,71.11764705882354,16,1071,7460902.133333334,123.0,66.9375
135123265.0,17,6,1146,6,1146,27024653.0,191.0,191.0,0,0,0.0,0.0,0.0
43225.0,6,14,4740,7,653,6911.5,249.0,93.28571428571428,7,4087,6641.166666666667,1514.0,583.8571428571429
184848.0,17,2,180,1,90,0.0,90.0,90.0,1,90,0.0,90.0,90.0
102884.0,17,2,286,2,286,0.0,143.0,143.0,0,0,0.0,0.0,0.0
111602457.0,6,221,25114,111,17558,1014567.7909090908,284.0,158.18018018018017,110,7556,1021410.8623853212,140.0,68.69090909090909
120086076.0,6,1041,223014,529,188482,227435.75,1514.0,356.29867674858224,512,34532,232987.35225048923,214.0,67.4453125
92384545.0,17,16,5472,16,5472,6158969.666666667,342.0,342.0,0,0,0.0,0.0,0.0
55622.0,6,10,2032,5,524,13332.5,252.0,104.8,5,1508,13648.0,1236.0,301.6
102298040.0,17,14,1126,7,563,17002535.833333332,174.0,80.42857142857143,7,563,17000152.833333332,174.0,80.42857142857143
362542.0,6,3,202,2,128,0.0,74.0,64.0,1,74,0.0,74.0,74.0
6711601.0,6,219,172393,117,160991,57858.629310344826,1510.0,1375.991452991453,102,11402,62550.0396039604,1510.0,111.7843137254902
23853.0,6,14,4740,7,653,3809.5,249.0,93.28571428571428,7,4087,3817.8333333333335,1514.0,583.8571428571429
24025839.0,17,3,1026,3,1026,12012919.5,342.0,342.0,0,0,0.0,0.0,0.0
90258069.0,6,13,1898,8,1016,12894009.857142856,188.0,127.0,5,882,22523922.75,204.0,176.4
0.0,17,1,90,1,90,0.0,90.0,90.0,0,0,0.0,0.0,0.0
135122779.0,17,6,1206,6,1206,27024555.8,201.0,201.0,0,0,0.0,0.0,0.0
285472.0,17,4,704,2,148,0.0,74.0,74.0,2,556,0.0,280.0,278.0
104810629.0,17,15,5130,15,5130,7486473.5,342.0,342.0,0,0,0.0,0.0,0.0
105617.0,17,2,700,2,700,0.0,350.0,350.0,0,0,0.0,0.0,0.0
80060.0,6,12,1320,7,789,13343.333333333334,253.0,112.71428571428572,5,531,19429.25,259.0,106.2
108105019.0,17,5,1005,5,1005,27026254.75,201.0,201.0,0,0,0.0,0.0,0.0
126559753.0,6,31,2113,16,1165,8437316.866666667,139.0,72.8125,15,948,8475303.07142857,123.0,63.2
30096.0,6,13,4412,6,409,5832.2,127.0,68.16666666666667,7,4003,4877.5,1514.0,571.8571428571429
100693988.0,17,12,778,6,389,20022501.2,174.0,64.83333333333333,6,389,20107009.0,174.0,64.83333333333333
16302190.0,17,6,2052,6,2052,3260438.0,342.0,342.0,0,0,0.0,0.0,0.0
143890.0,17,2,180,1,90,0.0,90.0,90.0,1,90,0.0,90.0,90.0
233298.0,6,3,337,2,214,0.0,160.0,107.0,1,123,0.0,123.0,123.0
5738.0,17,4,344,2,150,0.0,75.0,75.0,2,194,0.0,103.0,97.0
2230644.0,6,73,59698,31,2239,74354.8,215.0,72.2258064516129,42,57459,54174.48780487805,1514.0,1368.071428571429
5622336.0,6,5,336,2,134,0.0,68.0,67.0,3,202,1423760.0,70.0,67.33333333333333
145969.0,6,3,337,2,214,0.0,160.0,107.0,1,123,0.0,123.0,123.0
93784323.0,6,846,184974,414,27990,227019.4334140436,214.0,67.6086956521739,432,156984,217558.6334106729,1514.0,363.3888888888889
153372.0,17,2,180,1,90,0.0,90.0,90.0,1,90,0.0,90.0,90.0
319478.0,6,6,412,4,272,106492.66666666669,74.0,68.0,2,140,0.0,74.0,70.0
108102371.0,17,5,955,5,955,27025592.75,191.0,191.0,0,0,0.0,0.0,0.0
2294.0,17,4,344,2,150,0.0,75.0,75.0,2,194,0.0,103.0,97.0
336823.0,17,4,1400,4,1400,112274.33333333331,350.0,350.0,0,0,0.0,0.0,0.0
132179742.0,17,14,864,7,432,18833496.0,174.0,61.71428571428572,7,432,18834236.0,174.0,61.71428571428572
2095.0,17,2,664,1,322,0.0,322.0,322.0,1,342,0.0,342.0,342.0
105877.0,17,2,762,2,762,0.0,381.0,381.0,0,0,0.0,0.0,0.0
268904.0,17,4,1524,4,1524,89634.66666666667,381.0,381.0,0,0,0.0,0.0,0.0
105001.0,17,2,700,2,700,0.0,350.0,350.0,0,0,0.0,0.0,0.0
204641.0,17,2,762,2,762,0.0,381.0,381.0,0,0,0.0,0.0,0.0
313.0,17,2,174,1,79,0.0,79.0,79.0,1,95,0.0,95.0,95.0
3879.0,17,4,344,2,150,0.0,75.0,75.0,2,194,0.0,103.0,97.0
120129474.0,6,222,25068,111,7548,1084619.2545454546,140.0,68.0,111,17520,1085745.0545454544,284.0,157.83783783783784
10841760.0,6,7,478,3,206,5352574.5,74.0,68.66666666666667,4,272,3568321.6666666665,74.0,68.0
34192.0,6,14,4740,7,653,5392.333333333333,249.0,93.28571428571428,7,4087,3995.5,1514.0,583.8571428571429
301.0,17,2,168,1,76,0.0,76.0,76.0,1,92,0.0,92.0,92.0
44242.0,6,10,2032,5,524,10193.5,252.0,104.8,5,1508,10071.75,1236.0,301.6
90643283.0,6,15,2302,9,1204,11314485.375,188.0,133.77777777777777,6,1098,18095712.6,204.0,183.0
36616.0,6,14,4740,7,653,5839.333333333333,249.0,93.28571428571428,7,4087,5830.0,1514.0,583.8571428571429
42004.0,6,14,4740,7,653,6805.5,249.0,93.28571428571428,7,4087,6259.0,1514.0,583.8571428571429
135122497.0,17,6,1206,6,1206,27024499.4,201.0,201.0,0,0,0.0,0.0,0.0
90252948.0,6,13,2036,8,1016,12893278.285714284,188.0,127.0,5,1020,22522448.25,204.0,204.0
101044996.0,17,14,1126,7,563,16836096.833333332,174.0,80.42857142857143,7,563,16833477.333333332,174.0,80.42857142857143
120339088.0,6,293,34146,147,24202,824240.3287671233,464.0,164.63945578231292,146,9944,822713.0137931034,140.0,68.10958904109589
103466918.0,17,13,821,7,432,17217997.666666668,174.0,61.71428571428572,6,389,16718489.4,174.0,64.83333333333333
14565550.0,6,8,602,5,404,2693159.0,103.0,80.8,3,198,2046538.0,66.0,66.0
13221.0,6,11,1133,6,602,2413.8,264.0,100.33333333333331,5,531,3037.25,259.0,106.2
128917291.0,6,35,2394,18,1269,7583370.05882353,123.0,70.5,17,1125,7420514.5625,123.0,66.17647058823529
1565338.0,6,2,132,1,66,0.0,66.0,66.0,1,66,0.0,66.0,66.0
90045058.0,17,28,13364,28,13364,3335002.1481481483,501.0,477.2857142857143,0,0,0.0,0.0,0.0
1306889.0,6,4,264,2,132,0.0,66.0,66.0,2,132,0.0,66.0,66.0
102513.0,17,2,286,2,286,0.0,143.0,143.0,0,0,0.0,0.0,0.0
17358.0,6,10,2032,5,524,4037.75,252.0,104.8,5,1508,4076.25,1236.0,301.6
216457.0,17,2,180,1,90,0.0,90.0,90.0,1,90,0.0,90.0,90.0
2368.0,17,4,344,2,150,0.0,75.0,75.0,2,194,0.0,103.0,97.0
55396.0,6,14,4740,7,653,8969.666666666666,249.0,93.28571428571428,7,4087,8796.666666666666,1514.0,583.8571428571429
108105084.0,17,5,1005,5,1005,27026271.0,201.0,201.0,0,0,0.0,0.0,0.0
153389.0,17,2,180,1,90,0.0,90.0,90.0,1,90,0.0,90.0,90.0
311183.0,17,4,1400,4,1400,103727.66666666669,350.0,350.0,0,0,0.0,0.0,0.0
103009.0,17,2,286,2,286,0.0,143.0,143.0,0,0,0.0,0.0,0.0
303964.0,6,6,412,4,272,101321.33333333331,74.0,68.0,2,140,0.0,74.0,70.0
14257.0,6,10,1065,5,534,3212.25,262.0,106.8,5,531,3253.75,259.0,106.2
320228.0,17,4,1400,4,1400,106742.66666666669,350.0,350.0,0,0,0.0,0.0,0.0
296660.0,6,6,412,4,272,98886.66666666669,74.0,68.0,2,140,0.0,74.0,70.0
217972.0,6,3,426,2,280,0.0,214.0,140.0,1,146,0.0,146.0,146.0
1494.0,17,2,176,1,80,0.0,80.0,80.0,1,96,0.0,96.0,96.0
281050.0,17,2,180,1,90,0.0,90.0,90.0,1,90,0.0,90.0,90.0
4434.0,17,2,598,1,72,0.0,72.0,72.0,1,526,0.0,526.0,526.0
146205.0,6,3,337,2,214,0.0,160.0,107.0,1,123,0.0,123.0,123.0
105222208.0,6,220,24952,110,17470,963366.8073394496,300.0,158.8181818181818,110,7482,963366.7798165138,140.0,68.01818181818182
42744.0,6,14,4740,7,653,6681.0,249.0,93.28571428571428,7,4087,6650.0,1514.0,583.8571428571429
104497157.0,6,44,2904,22,1452,4976055.095238095,66.0,66.0,22,1452,4961720.142857143,66.0,66.0
108117590.0,17,5,1005,5,1005,27029397.5,201.0,201.0,0,0,0.0,0.0,0.0
78229.0,6,12,1320,6,723,15009.6,253.0,120.5,6,597,14969.0,259.0,99.5
9716.0,17,2,571,1,86,0.0,86.0,86.0,1,485,0.0,485.0,485.0
93154512.0,6,40,2640,20,1320,4902869.052631579,66.0,66.0,20,1320,4888380.894736842,66.0,66.0
2335.0,17,4,344,2,150,0.0,75.0,75.0,2,194,0.0,103.0,97.0
300.0,17,2,168,1,76,0.0,76.0,76.0,1,92,0.0,92.0,92.0
214588.0,6,12,1373,7,714,35764.666666666664,298.0,102.0,5,659,52570.75,379.0,131.8
2435.0,17,4,344,2,150,0.0,75.0,75.0,2,194,0.0,103.0,97.0
53168.0,17,2,180,1,90,0.0,90.0,90.0,1,90,0.0,90.0,90.0
135140026.0,17,6,1206,6,1206,27028005.2,201.0,201.0,0,0,0.0,0.0,0.0
55461.0,6,14,4740,7,653,8446.666666666666,249.0,93.28571428571428,7,4087,7080.833333333333,1514.0,583.8571428571429
90361584.0,6,14,2256,7,1428,15059715.333333334,204.0,204.0,7,828,15059877.833333334,188.0,118.28571428571428
358707.0,6,13,1386,7,789,59784.5,253.0,112.71428571428572,6,597,66957.4,259.0,99.5
119662294.0,6,226,25534,113,17780,1066491.7857142857,284.0,157.34513274336285,113,7754,1066491.75,140.0,68.61946902654867
17584.0,6,12,1393,6,796,3378.6,271.0,132.66666666666666,6,597,3365.2,259.0,99.5
0.0,17,1,90,1,90,0.0,90.0,90.0,0,0,0.0,0.0,0.0
2799813.0,6,2,132,1,66,0.0,66.0,66.0,1,66,0.0,66.0,66.0
3863.0,17,4,344,2,150,0.0,75.0,75.0,2,194,0.0,103.0,97.0
46974.0,6,12,1320,6,723,7986.8,253.0,120.5,6,597,8692.4,259.0,99.5
4786687.0,6,4,270,2,134,0.0,68.0,67.0,2,136,0.0,70.0,68.0
105529.0,17,2,286,2,286,0.0,143.0,143.0,0,0,0.0,0.0,0.0
103785090.0,6,50,4336,28,2389,3835902.3333333335,139.0,85.32142857142857,22,1947,4931870.666666667,123.0,88.5
90035162.0,17,28,13364,28,13364,3334635.6296296297,501.0,477.2857142857143,0,0,0.0,0.0,0.0
14677.0,6,10,2032,5,524,3402.75,252.0,104.8,5,1508,3393.0,1236.0,301.6
2310.0,17,4,344,2,150,0.0,75.0,75.0,2,194,0.0,103.0,97.0
228618.0,6,10,1221,6,636,45723.6,298.0,106.0,4,585,75364.66666666667,379.0,146.25
25968.0,6,14,4740,7,653,3358.333333333333,249.0,93.28571428571428,7,4087,3641.3333333333335,1514.0,583.8571428571429
3297795.0,17,3,1026,3,1026,1648897.5,342.0,342.0,0,0,0.0,0.0,0.0
267203.0,6,3,337,2,214,0.0,160.0,107.0,1,123,0.0,123.0,123.0
90228799.0,6,16,1192,8,596,12854217.42857143,95.0,74.5,8,596,12858960.57142857,95.0,74.5
32293.000000000004,6,14,4740,7,653,4512.166666666667,249.0,93.28571428571428,7,4087,5174.666666666667,1514.0,583.8571428571429
0.0,17,1,453,1,453,0.0,453.0,453.0,0,0,0.0,0.0,0.0
116000951.0,17,13,821,7,432,19333491.83333333,174.0,61.71428571428572,6,389,19200901.6,174.0,64.83333333333333
613147.0,6,3,198,2,132,0.0,66.0,66.0,1,66,0.0,66.0,66.0
90034041.0,17,28,13364,28,13364,3334594.111111111,501.0,477.2857142857143,0,0,0.0,0.0,0.0
1059876.0,6,13,1394,7,797,176646.0,253.0,113.85714285714286,6,597,210411.8,259.0,99.5
90222333.0,6,24,2149,11,799,8998516.4,95.0,72.63636363636364,13,1350,7501398.416666667,255.0,103.84615384615384
108734403.0,6,33,2428,17,1288,6782398.6875,139.0,75.76470588235294,16,1140,7234557.933333334,123.0,71.25
21467.0,6,10,2032,5,524,5083.0,252.0,104.8,5,1508,4943.25,1236.0,301.6
94029773.0,6,39,2574,20,1320,4948921.368421053,66.0,66.0,19,1254,5160015.611111111,66.0,66.0
116222433.0,6,48,3168,24,1584,5053149.260869565,66.0,66.0,24,1584,5039934.782608695,66.0,66.0
298728.0,6,6,412,4,272,99576.0,74.0,68.0,2,140,0.0,74.0,70.0
245338.0,6,3,337,2,214,0.0,160.0,107.0,1,123,0.0,123.0,123.0
578569.0,6,4,508,2,238,0.0,172.0,119.0,2,270,0.0,135.0,135.0
3001.0,17,4,625,2,163,0.0,89.0,81.5,2,462,0.0,245.0,231.0
108103313.0,17,5,1005,5,1005,27025828.25,201.0,201.0,0,0,0.0,0.0,0.0
90295279.0,6,19,1436,10,745,10028139.666666666,95.0,74.5,9,691,11286063.375,95.0,76.77777777777777
84.0,17,2,700,2,700,0.0,350.0,350.0,0,0,0.0,0.0,0.0
202247.0,17,4,6056,4,6056,67415.66666666667,1514.0,1514.0,0,0,0.0,0.0,0.0
137503.0,17,2,176,1,80,0.0,80.0,80.0,1,96,0.0,96.0,96.0
108115134.0,17,5,955,5,955,27028783.5,191.0,191.0,0,0,0.0,0.0,0.0
836425.0,6,9,1196,6,725,167285.0,387.0,120.83333333333331,3,471,281905.5,331.0,157.0
144973.0,17,2,180,1,70,0.0,70.0,70.0,1,110,0.0,110.0,110.0
20032.0,6,14,4740,7,653,2689.5,249.0,93.28571428571428,7,4087,3203.0,1514.0,583.8571428571429
13220.0,6,11,1132,6,556,2644.0,218.0,92.66666666666669,5,576,2494.5,304.0,115.2
151861.0,6,13,1386,7,789,25310.166666666668,253.0,112.71428571428572,6,597,29636.2,259.0,99.5
228247.0,17,2,180,1,90,0.0,90.0,90.0,1,90,0.0,90.0,90.0
146152.0,6,3,337,2,214,0.0,160.0,107.0,1,123,0.0,123.0,123.0
196841.0,17,2,180,1,90,0.0,90.0,90.0,1,90,0.0,90.0,90.0
205839.0,17,2,180,1,90,0.0,90.0,90.0,1,90,0.0,90.0,90.0
153465.0,17,2,180,1,90,0.0,90.0,90.0,1,90,0.0,90.0,90.0
34635.0,6,14,4740,7,653,5608.833333333333,249.0,93.28571428571428,7,4087,5475.333333333333,1514.0,583.8571428571429
19975.0,6,11,1133,6,602,3468.8,264.0,100.33333333333331,5,531,4619.5,259.0,106.2
155280.0,6,3,337,2,214,0.0,160.0,107.0,1,123,0.0,123.0,123.0
252652.0,6,3,337,2,214,0.0,160.0,107.0,1,123,0.0,123.0,123.0
242675.0,6,3,337,2,214,0.0,160.0,107.0,1,123,0.0,123.0,123.0
24392075.0,6,10,684,6,396,4878415.0,95.0,66.0,4,288,8060478.666666667,95.0,72.0
60123.0,6,10,2032,5,524,13449.5,252.0,104.8,5,1508,13922.5,1236.0,301.6
9563.0,17,2,539,1,86,0.0,86.0,86.0,1,453,0.0,453.0,453.0
281581.0,17,2,363,1,79,0.0,79.0,79.0,1,284,0.0,284.0,284.0
5622207.0,6,5,336,2,134,0.0,68.0,67.0,3,202,1526094.5,70.0,67.33333333333333
889.0,17,4,438,2,148,0.0,74.0,74.0,2,290,0.0,147.0,145.0
99264.0,17,2,762,2,762,0.0,381.0,381.0,0,0,0.0,0.0,0.0
10523465.0,6,7,478,4,272,3462110.0,74.0,68.0,3,206,5193061.0,74.0,68.66666666666667
120379770.0,6,184,20744,92,6368,1311248.6043956045,140.0,69.21739130434783,92,14376,1302503.010989011,284.0,156.2608695652174
467.0,17,2,762,2,762,0.0,381.0,381.0,0,0,0.0,0.0,0.0
37344.0,6,10,2032,5,524,9124.0,252.0,104.8,5,1508,3833.5,1236.0,301.6
18895.0,6,14,4740,7,653,3005.0,249.0,93.28571428571428,7,4087,3016.833333333333,1514.0,583.8571428571429
2325679.0,6,20,6935,11,1567,232567.9,408.0,142.45454545454547,9,5368,248097.5,1514.0,596.4444444444445
162312.0,17,2,180,1,90,0.0,90.0,90.0,1,90,0.0,90.0,90.0
108733526.0,6,34,2482,17,1288,6795845.375,139.0,75.76470588235294,17,1194,6782328.5625,123.0,70.23529411764706
218313.0,6,3,426,2,280,0.0,214.0,140.0,1,146,0.0,146.0,146.0
5818765.0,6,5,336,2,134,0.0,68.0,67.0,3,202,1526208.0,70.0,67.33333333333333
226926.0,17,2,180,1,90,0.0,90.0,90.0,1,90,0.0,90.0,90.0
40147.0,6,10,2032,5,524,9220.75,252.0,104.8,5,1508,9636.5,1236.0,301.6
4547.0,17,2,602,1,72,0.0,72.0,72.0,1,530,0.0,530.0,530.0
2795329.0,6,2,132,1,66,0.0,66.0,66.0,1,66,0.0,66.0,66.0
296.0,17,2,164,1,82,0.0,82.0,82.0,1,82,0.0,82.0,82.0
24966.0,6,14,4740,7,653,4042.8333333333335,249.0,93.28571428571428,7,4087,3692.0,1514.0,583.8571428571429
15256.0,6,10,2032,5,524,2648.75,252.0,104.8,5,1508,3361.25,1236.0,301.6
2442.0,17,4,344,2,150,0.0,75.0,75.0,2,194,0.0,103.0,97.0
135133083.0,17,6,1146,6,1146,27026616.6,191.0,191.0,0,0,0.0,0.0,0.0
1838089.0,6,23,6509,12,1529,167099.0,357.0,127.41666666666669,11,4980,152101.6,1510.0,452.7272727272728
99707585.0,6,248,29618,124,8406,810436.8455284553,140.0,67.79032258064517,124,21212,810475.4146341464,336.0,171.06451612903226
349.0,17,2,267,1,83,0.0,83.0,83.0,1,184,0.0,184.0,184.0
25027.0,6,14,4740,7,653,3905.6666666666665,249.0,93.28571428571428,7,4087,3686.1666666666665,1514.0,583.8571428571429
217083.0,6,3,426,2,280,0.0,214.0,140.0,1,146,0.0,146.0,146.0
51734531.0,6,8,2113,3,960,24536697.0,826.0,320.0,5,1153,12234090.5,885.0,230.6
128863093.0,6,35,2410,18,1285,7580181.94117647,139.0,71.38888888888889,17,1125,7416391.9375,123.0,66.17647058823529
118139661.0,6,47,3102,24,1584,5124543.304347826,66.0,66.0,23,1518,5135447.954545454,66.0,66.0
397391.0,17,3,1026,3,1026,198695.5,342.0,342.0,0,0,0.0,0.0,0.0
108111506.0,17,5,955,5,955,27027876.5,191.0,191.0,0,0,0.0,0.0,0.0
166240.0,17,2,414,1,88,0.0,88.0,88.0,1,326,0.0,326.0,326.0
120059.0,17,2,180,1,70,0.0,70.0,70.0,1,110,0.0,110.0,110.0
105922.0,17,2,286,2,286,0.0,143.0,143.0,0,0,0.0,0.0,0.0
304596.0,6,6,412,4,272,101532.0,74.0,68.0,2,140,0.0,74.0,70.0
90203862.0,6,16,1192,8,596,12850352.714285716,95.0,74.5,8,596,12855162.42857143,95.0,74.5
2108.0,17,4,344,2,150,0.0,75.0,75.0,2,194,0.0,103.0,97.0
693.0,17,2,762,2,762,0.0,381.0,381.0,0,0,0.0,0.0,0.0
1596.0,17,5,550,5,550,399.0,110.0,110.0,0,0,0.0,0.0,0.0
14993.0,17,4,344,2,150,0.0,75.0,75.0,2,194,0.0,103.0,97.0
50670.0,6,10,2032,5,524,10059.5,252.0,104.8,5,1508,11757.5,1236.0,301.6
2378.0,17,4,344,2,150,0.0,75.0,75.0,2,194,0.0,103.0,97.0
19491.0,6,10,2032,5,524,4445.0,252.0,104.8,5,1508,4292.75,1236.0,301.6
31664.0,6,14,4740,7,653,4651.0,249.0,93.28571428571428,7,4087,5089.333333333333,1514.0,583.8571428571429
9575.0,17,2,539,1,86,0.0,86.0,86.0,1,453,0.0,453.0,453.0
107325.0,17,2,286,2,286,0.0,143.0,143.0,0,0,0.0,0.0,0.0
838992.0,6,9,1118,6,586,167798.4,248.0,97.66666666666669,3,532,281572.5,392.0,177.33333333333334
241901.0,6,3,337,2,214,0.0,160.0,107.0,1,123,0.0,123.0,123.0
90304279.0,6,27,3070,13,1409,7521168.666666667,426.0,108.3846153846154,14,1661,6946130.923076923,332.0,118.64285714285714
228345.0,17,2,180,1,90,0.0,90.0,90.0,1,90,0.0,90.0,90.0
1033681.0,6,11,1134,6,558,206736.2,220.0,93.0,5,576,257055.75,304.0,115.2
0.0,17,1,90,1,90,0.0,90.0,90.0,0,0,0.0,0.0,0.0
2020979.0,17,4,525,2,150,0.0,75.0,75.0,2,375,0.0,284.0,187.5
218013.0,6,3,426,2,280,0.0,214.0,140.0,1,146,0.0,146.0,146.0
208298.0,17,2,762,2,762,0.0,381.0,381.0,0,0,0.0,0.0,0.0
300568.0,6,6,412,4,272,100189.33333333331,74.0,68.0,2,140,0.0,74.0,70.0
381756.0,6,12,1373,7,714,63626.0,298.0,102.0,5,659,93900.25,379.0,131.8
2530508.0,6,25,7573,14,3735,194654.4615384616,1514.0,266.7857142857143,11,3838,227209.7,1514.0,348.90909090909093
2465.0,17,4,344,2,150,0.0,75.0,75.0,2,194,0.0,103.0,97.0
298001.0,6,6,412,4,272,99333.66666666669,74.0,68.0,2,140,0.0,74.0,70.0
115001505.0,6,31,2166,16,1149,7653132.066666666,123.0,71.8125,15,1017,8199796.785714285,123.0,67.8
314858.0,17,4,1400,4,1400,104952.66666666669,350.0,350.0,0,0,0.0,0.0,0.0
34939.0,6,14,4740,7,653,5131.166666666667,249.0,93.28571428571428,7,4087,5480.0,1514.0,583.8571428571429
135134227.0,17,6,1206,6,1206,27026845.4,201.0,201.0,0,0,0.0,0.0,0.0
2355.0,17,4,344,2,150,0.0,75.0,75.0,2,194,0.0,103.0,97.0
100804608.0,17,12,778,6,389,20160921.6,174.0,64.83333333333333,6,389,20055750.2,174.0,64.83333333333333
125343.0,6,11,1132,6,556,24384.8,218.0,92.66666666666669,5,576,30906.5,304.0,115.2
115119119.0,17,16,1212,8,606,16431200.42857143,174.0,75.75,8,606,16428712.857142856,174.0,75.75
3556.0,17,2,414,1,88,0.0,88.0,88.0,1,326,0.0,326.0,326.0
92335078.0,17,14,1126,7,563,15334260.833333334,174.0,80.42857142857143,7,563,15333468.0,174.0,80.42857142857143
30822.0,6,14,4740,7,653,5003.0,249.0,93.28571428571428,7,4087,4834.5,1514.0,583.8571428571429
3181089.0,6,18,1495,9,921,358365.75,315.0,102.33333333333331,9,574,358324.875,78.0,63.77777777777778
14640102.0,6,19,1594,9,962,1790998.25,315.0,106.88888888888889,10,632,1591996.2222222222,78.0,63.2
90030537.0,17,28,13364,28,13364,3334464.333333333,501.0,477.2857142857143,0,0,0.0,0.0,0.0
104651593.0,6,44,2904,22,1452,4983409.19047619,66.0,66.0,22,1452,4968441.19047619,66.0,66.0
386.0,17,2,166,1,75,0.0,75.0,75.0,1,91,0.0,91.0,91.0
15048.0,6,10,1066,5,490,2689.5,218.0,98.0,5,576,3550.25,304.0,115.2
858.0,17,4,438,2,148,0.0,74.0,74.0,2,290,0.0,147.0,145.0
128400428.0,6,30,1974,15,948,8458252.142857144,123.0,63.2,15,1026,8458239.142857144,123.0,68.4
0.0,6,1,66,1,66,0.0,66.0,66.0,0,0,0.0,0.0,0.0
10469981.0,6,7,478,4,272,3444269.6666666665,74.0,68.0,3,206,5166277.0,74.0,68.66666666666667
146811.0,6,3,337,2,214,0.0,160.0,107.0,1,123,0.0,123.0,123.0
120124408.0,6,14,2240,6,1224,24024881.6,204.0,204.0,8,1016,17098216.285714287,188.0,127.0
321304.0,17,4,1400,4,1400,107101.33333333331,350.0,350.0,0,0,0.0,0.0,0.0
5620337.0,6,4,270,2,134,0.0,68.0,67.0,2,136,0.0,70.0,68.0
222512.0,6,10,1221,6,636,44502.4,298.0,106.0,4,585,72522.33333333333,379.0,146.25
99286801.0,17,14,1126,7,563,16334076.5,174.0,80.42857142857143,7,563,16333507.5,174.0,80.42857142857143
90305907.0,6,16,1192,8,596,12893504.42857143,95.0,74.5,8,596,12900510.285714284,95.0,74.5
2440942.0,6,3,204,2,136,0.0,70.0,68.0,1,68,0.0,68.0,68.0
120391640.0,6,241,27324,121,19108,1003263.6666666666,300.0,157.91735537190084,120,8216,1002843.848739496,140.0,68.46666666666667
135124834.0,17,6,1206,6,1206,27024966.8,201.0,201.0,0,0,0.0,0.0,0.0
453.0,17,2,160,1,80,0.0,80.0,80.0,1,80,0.0,80.0,80.0
115453971.0,6,48,3168,24,1584,5019737.869565218,66.0,66.0,24,1584,5006653.913043479,66.0,66.0
1997.0,17,4,344,2,150,0.0,75.0,75.0,2,194,0.0,103.0,97.0
524943.0,17,6,2100,6,2100,104988.6,350.0,350.0,0,0,0.0,0.0,0.0
859.0,17,5,550,5,550,214.75,110.0,110.0,0,0,0.0,0.0,0.0
303669.0,6,2,132,1,66,0.0,66.0,66.0,1,66,0.0,66.0,66.0
197021.0,17,2,180,1,90,0.0,90.0,90.0,1,90,0.0,90.0,90.0
209346.0,17,2,180,1,90,0.0,90.0,90.0,1,90,0.0,90.0,90.0
209539.0,17,2,180,1,90,0.0,90.0,90.0,1,90,0.0,90.0,90.0
2639794.0,6,3,1604,2,851,0.0,785.0,425.5,1,753,0.0,753.0,753.0
60523.0,6,10,2032,5,524,13888.0,252.0,104.8,5,1508,14507.75,1236.0,301.6
51513.0,6,13,1394,7,797,8585.5,253.0,113.85714285714286,6,597,8731.4,259.0,99.5
301615.0,6,6,412,4,272,100538.33333333331,74.0,68.0,2,140,0.0,74.0,70.0
112602347.0,6,48,3168,24,1584,4895754.217391305,66.0,66.0,24,1584,4889734.478260869,66.0,66.0
110321048.0,6,351,42980,176,31134,630405.9885714286,336.0,176.89772727272728,175,11846,628468.5057471264,140.0,67.69142857142857
10521551.0,6,7,478,4,272,3461543.6666666665,74.0,68.0,3,206,5192250.5,74.0,68.66666666666667
9981.0,17,2,571,1,86,0.0,86.0,86.0,1,485,0.0,485.0,485.0
17722.0,6,10,1067,5,536,3181.5,264.0,107.2,5,531,3168.25,259.0,106.2
155769.0,6,3,337,2,214,0.0,160.0,107.0,1,123,0.0,123.0,123.0
330.0,17,2,166,1,75,0.0,75.0,75.0,1,91,0.0,91.0,91.0
23184.0,6,14,4740,7,653,3308.5,249.0,93.28571428571428,7,4087,3726.6666666666665,1514.0,583.8571428571429
53321.0,6,12,1413,6,816,9915.0,291.0,136.0,6,597,9724.6,259.0,99.5
106836.0,17,2,286,2,286,0.0,143.0,143.0,0,0,0.0,0.0,0.0
77019.0,6,10,2032,5,524,18598.25,252.0,104.8,5,1508,15944.75,1236.0,301.6
33310.0,6,11,1132,6,556,6377.4,218.0,92.66666666666669,5,576,7847.0,304.0,115.2
217584.0,6,3,426,2,280,0.0,214.0,140.0,1,146,0.0,146.0,146.0
207132.0,17,2,762,2,762,0.0,381.0,381.0,0,0,0.0,0.0,0.0
1428723.0,6,19,7533,10,1403,158747.0,583.0,140.3,9,6130,146878.125,1484.0,681.1111111111111
312955.0,17,4,1400,4,1400,104318.33333333331,350.0,350.0,0,0,0.0,0.0,0.0
114748083.0,6,35,2526,18,1332,6737195.235294118,123.0,74.0,17,1194,7158268.625,123.0,70.23529411764706
758.0,17,2,762,2,762,0.0,381.0,381.0,0,0,0.0,0.0,0.0
307593.0,6,6,412,4,272,102531.0,74.0,68.0,2,140,0.0,74.0,70.0
121513180.0,6,31,2097,16,1149,8100878.666666667,123.0,71.8125,15,948,8482095.357142856,123.0,63.2
306656.0,6,6,412,4,272,102218.66666666669,74.0,68.0,2,140,0.0,74.0,70.0
58743950.0,17,9,3086,8,2736,5108868.142857143,342.0,342.0,1,350,0.0,350.0,350.0
298429.0,6,6,412,4,272,99476.33333333331,74.0,68.0,2,140,0.0,74.0,70.0
153445.0,17,2,180,1,90,0.0,90.0,90.0,1,90,0.0,90.0,90.0
102593.0,17,2,762,2,762,0.0,381.0,381.0,0,0,0.0,0.0,0.0
106040002.0,6,313,52876,157,10732,679743.6025641026,214.0,68.35668789808918,156,42144,677547.2967741935,1514.0,270.15384615384613
62385.0,6,14,4740,7,653,10269.333333333334,249.0,93.28571428571428,7,4087,9909.666666666666,1514.0,583.8571428571429
120232522.0,6,274,31492,137,9338,878074.2647058824,140.0,68.16058394160584,137,22154,878873.0514705882,336.0,161.7080291970803
297514.0,6,6,412,4,272,99171.33333333331,74.0,68.0,2,140,0.0,74.0,70.0
260663.0,6,10,1221,6,636,52132.6,298.0,106.0,4,585,81441.0,379.0,146.25
1772084.0,6,2,132,1,66,0.0,66.0,66.0,1,66,0.0,66.0,66.0
114268485.0,6,48,3168,24,1584,4968195.0,66.0,66.0,24,1584,4954944.913043479,66.0,66.0
90696579.0,6,22,1680,10,745,10077397.666666666,95.0,74.5,12,935,8221428.0,95.0,77.91666666666667
15994.000000000002,6,11,1133,6,602,3198.8,264.0,100.33333333333331,5,531,3314.0,259.0,106.2
108109187.0,17,5,1005,5,1005,27027296.75,201.0,201.0,0,0,0.0,0.0,0.0
3765422.0,6,17,3882,10,1060,388052.0,252.0,106.0,7,2822,146733.83333333334,1236.0,403.1428571428572
0.0,17,1,55,1,55,0.0,55.0,55.0,0,0,0.0,0.0,0.0
2432.0,17,4,344,2,150,0.0,75.0,75.0,2,194,0.0,103.0,97.0
2309.0,17,4,344,2,150,0.0,75.0,75.0,2,194,0.0,103.0,97.0
5618601.0,6,4,270,2,134,0.0,68.0,67.0,2,136,0.0,70.0,68.0
1772038.0,6,2,132,1,66,0.0,66.0,66.0,1,66,0.0,66.0,66.0
143920.0,17,2,180,1,90,0.0,90.0,90.0,1,90,0.0,90.0,90.0
9306.0,6,10,1067,5,536,2090.5,264.0,107.2,5,531,1975.5,259.0,106.2
3050813.0,6,3,204,2,136,0.0,70.0,68.0,1,68,0.0,68.0,68.0
108553.0,17,2,286,2,286,0.0,143.0,143.0,0,0,0.0,0.0,0.0
438136.0,6,3,1604,1,753,0.0,753.0,753.0,2,851,0.0,785.0,425.5
313518.0,6,6,412,4,272,104506.0,74.0,68.0,2,140,0.0,74.0,70.0
102162.0,17,2,286,2,286,0.0,143.0,143.0,0,0,0.0,0.0,0.0
120434737.0,6,235,26466,118,18522,1029356.7264957264,284.0,156.96610169491527,117,7944,1029290.3362068966,140.0,67.8974358974359
4230.0,17,2,614,1,72,0.0,72.0,72.0,1,542,0.0,542.0,542.0
308026.0,6,6,412,4,272,102675.33333333331,74.0,68.0,2,140,0.0,74.0,70.0
13612823.0,6,20,1607,10,975,1478875.888888889,315.0,97.5,10,632,1478169.888888889,78.0,63.2
152119.0,6,3,373,2,238,0.0,172.0,119.0,1,135,0.0,135.0,135.0
277264.0,17,2,363,1,79,0.0,79.0,79.0,1,284,0.0,284.0,284.0
1307967.0,6,4,264,2,132,0.0,66.0,66.0,2,132,0.0,66.0,66.0
94370491.0,17,12,778,6,389,18801457.6,174.0,64.83333333333333,6,389,18800089.2,174.0,64.83333333333333
27110678.0,17,5,1710,5,1710,6777669.5,342.0,342.0,0,0,0.0,0.0,0.0
44451.0,6,12,1320,7,789,7408.5,253.0,112.71428571428572,5,531,8734.0,259.0,106.2
128895115.0,6,35,2394,18,1269,7582065.588235294,123.0,70.5,17,1125,7418294.75,123.0,66.17647058823529
616029.0,6,10,1065,5,534,153457.0,262.0,106.8,5,531,153767.0,259.0,106.2
46584321.0,6,8,2113,3,960,22316404.5,826.0,320.0,5,1153,10952139.75,885.0,230.6
108112079.0,17,5,1005,5,1005,27028019.75,201.0,201.0,0,0,0.0,0.0,0.0
281060.0,17,2,363,1,79,0.0,79.0,79.0,1,284,0.0,284.0,284.0
143631.0,17,4,344,2,150,0.0,75.0,75.0,2,194,0.0,103.0,97.0
8379.0,17,4,823,2,163,0.0,89.0,81.5,2,660,0.0,443.0,330.0
4317.0,17,4,704,2,148,0.0,74.0,74.0,2,556,0.0,280.0,278.0
216629.0,6,3,426,2,280,0.0,214.0,140.0,1,146,0.0,146.0,146.0
2381.0,17,4,344,2,150,0.0,75.0,75.0,2,194,0.0,103.0,97.0
303397.0,6,6,412,4,272,101132.33333333331,74.0,68.0,2,140,0.0,74.0,70.0
26774.0,6,10,2032,5,524,5116.5,252.0,104.8,5,1508,5309.0,1236.0,301.6
135132860.0,17,6,1146,6,1146,27026572.0,191.0,191.0,0,0,0.0,0.0,0.0
102880214.0,6,42,2772,21,1386,5143998.25,66.0,66.0,21,1386,5143997.0,66.0,66.0
11931.0,6,13,1459,7,862,1904.1666666666667,271.0,123.14285714285714,6,597,2165.8,259.0,99.5
108108852.0,17,5,955,5,955,27027213.0,191.0,191.0,0,0,0.0,0.0,0.0
16551.0,6,10,2032,5,524,3844.75,252.0,104.8,5,1508,3693.0,1236.0,301.6
232295.0,6,3,337,2,214,0.0,160.0,107.0,1,123,0.0,123.0,123.0
295.0,17,2,156,1,78,0.0,78.0,78.0,1,78,0.0,78.0,78.0
950529.0,6,2,132,1,66,0.0,66.0,66.0,1,66,0.0,66.0,66.0
122307.0,6,3,373,2,238,0.0,172.0,119.0,1,135,0.0,135.0,135.0
120221553.0,6,216,24296,108,7424,1115893.38317757,140.0,68.74074074074075,108,16872,1116022.0093457943,284.0,156.22222222222223
17330.0,6,14,4740,7,653,2649.333333333333,249.0,93.28571428571428,7,4087,2751.6666666666665,1514.0,583.8571428571429
33093.0,6,10,2032,5,524,8008.0,252.0,104.8,5,1508,6093.5,1236.0,301.6
319317.0,6,6,412,4,272,106439.0,74.0,68.0,2,140,0.0,74.0,70.0
51275.0,6,14,4740,7,653,8427.5,249.0,93.28571428571428,7,4087,8186.666666666667,1514.0,583.8571428571429
321.0,17,2,174,1,79,0.0,79.0,79.0,1,95,0.0,95.0,95.0
4591911.0,6,5,336,2,134,0.0,68.0,67.0,3,202,1424314.5,70.0,67.33333333333333
206558.0,17,2,762,2,762,0.0,381.0,381.0,0,0,0.0,0.0,0.0
90305159.0,6,16,1192,8,596,12894648.0,95.0,74.5,8,596,12898987.57142857,95.0,74.5
143932.0,17,2,180,1,90,0.0,90.0,90.0,1,90,0.0,90.0,90.0
28525.0,6,11,2098,6,590,4221.2,252.0,98.33333333333331,5,1508,6965.25,1236.0,301.6
37454.0,6,10,2032,5,524,9153.75,252.0,104.8,5,1508,8638.75,1236.0,301.6
118886708.0,6,34,2350,17,1225,7416927.875,139.0,72.05882352941177,17,1125,7416927.375,123.0,66.17647058823529
28052.0,6,10,2032,5,524,6795.25,252.0,104.8,5,1508,6105.5,1236.0,301.6
899810.0,6,12,2710,7,743,149968.33333333334,339.0,106.14285714285714,5,1967,156826.5,1514.0,393.4
121699087.0,17,14,864,7,432,16958136.5,174.0,61.71428571428572,7,432,17001066.833333332,174.0,61.71428571428572
1321004.0,6,4,264,2,132,0.0,66.0,66.0,2,132,0.0,66.0,66.0
108103736.0,17,5,1005,5,1005,27025934.0,201.0,201.0,0,0,0.0,0.0,0.0
0.0,6,1,160,1,160,0.0,160.0,160.0,0,0,0.0,0.0,0.0
153533.0,17,2,180,1,90,0.0,90.0,90.0,1,90,0.0,90.0,90.0
23865.0,6,10,2032,5,524,4733.25,252.0,104.8,5,1508,5672.0,1236.0,301.6
506354.0,6,4,270,2,134,0.0,68.0,67.0,2,136,0.0,70.0,68.0
10473041.0,6,7,478,4,272,3445236.6666666665,74.0,68.0,3,206,5167783.0,74.0,68.66666666666667
12938530.0,17,20,7568,20,7568,680975.2631578947,394.0,378.4,0,0,0.0,0.0,0.0
154982.0,6,3,337,2,214,0.0,160.0,107.0,1,123,0.0,123.0,123.0
220552.0,6,3,426,2,280,0.0,214.0,140.0,1,146,0.0,146.0,146.0
122405869.0,17,14,864,7,432,17168568.666666668,174.0,61.71428571428572,7,432,17166837.166666668,174.0,61.71428571428572
1561333.0,6,2,132,1,66,0.0,66.0,66.0,1,66,0.0,66.0,66.0
504753.0,6,5,336,2,134,0.0,68.0,67.0,3,202,193566.5,70.0,67.33333333333333
84.0,17,2,762,2,762,0.0,381.0,381.0,0,0,0.0,0.0,0.0
242431.0,6,3,337,2,214,0.0,160.0,107.0,1,123,0.0,123.0,123.0
120005482.0,17,14,864,7,432,20000913.666666668,174.0,61.71428571428572,7,432,16666830.833333334,174.0,61.71428571428572
90301902.0,6,17,1287,9,691,11281574.625,95.0,76.77777777777777,8,596,12898753.0,95.0,74.5
121379.0,6,3,337,2,214,0.0,160.0,107.0,1,123,0.0,123.0,123.0
249362.0,6,3,337,2,214,0.0,160.0,107.0,1,123,0.0,123.0,123.0
120124511.0,6,17,2556,10,1392,13347167.888888888,188.0,139.2,7,1164,15020059.166666666,204.0,166.28571428571428
57687.0,6,10,2032,5,524,14201.25,252.0,104.8,5,1508,13135.75,1236.0,301.6
44916.0,6,14,4740,7,653,7346.5,249.0,93.28571428571428,7,4087,6671.166666666667,1514.0,583.8571428571429
55795.0,6,14,4740,7,653,9047.166666666666,249.0,93.28571428571428,7,4087,8413.0,1514.0,583.8571428571429
9150.0,17,2,539,1,86,0.0,86.0,86.0,1,453,0.0,453.0,453.0
254098.0,17,2,180,1,90,0.0,90.0,90.0,1,90,0.0,90.0,90.0
32731.000000000004,6,14,4740,7,653,5331.666666666667,249.0,93.28571428571428,7,4087,5245.166666666667,1514.0,583.8571428571429
217889.0,17,2,180,1,90,0.0,90.0,90.0,1,90,0.0,90.0,90.0
108087772.0,17,5,1005,5,1005,27021943.0,201.0,201.0,0,0,0.0,0.0,0.0
120022034.0,17,29,13785,29,13785,4286501.214285715,501.0,475.3448275862069,0,0,0.0,0.0,0.0
45936.0,6,14,4740,7,653,7486.666666666667,249.0,93.28571428571428,7,4087,7489.666666666667,1514.0,583.8571428571429
146515.0,6,3,337,2,214,0.0,160.0,107.0,1,123,0.0,123.0,123.0
153620.0,17,2,180,1,90,0.0,90.0,90.0,1,90,0.0,90.0,90.0
135126046.0,17,6,1206,6,1206,27025209.2,201.0,201.0,0,0,0.0,0.0,0.0
120120349.0,6,14,2240,8,1016,17136751.0,188.0,127.0,6,1224,18017927.4,204.0,204.0
28842.0,6,10,2032,5,524,6992.5,252.0,104.8,5,1508,7051.5,1236.0,301.6
198607.0,17,2,180,1,90,0.0,90.0,90.0,1,90,0.0,90.0,90.0
603719.0,6,4,508,2,238,0.0,172.0,119.0,2,270,0.0,135.0,135.0
90285169.0,6,17,1287,9,691,11280004.25,95.0,76.77777777777777,8,596,12895680.42857143,95.0,74.5
228105.0,17,2,180,1,90,0.0,90.0,90.0,1,90,0.0,90.0,90.0
2996832.0,6,12,2172,7,664,499324.5,252.0,94.85714285714286,5,1508,1958.25,1236.0,301.6
29658.0,6,14,4740,7,653,4802.666666666667,249.0,93.28571428571428,7,4087,4622.0,1514.0,583.8571428571429
300.0,17,2,156,1,78,0.0,78.0,78.0,1,78,0.0,78.0,78.0
238507.0,6,3,337,2,214,0.0,160.0,107.0,1,123,0.0,123.0,123.0
25036.0,6,10,2032,5,524,5407.0,252.0,104.8,5,1508,4871.5,1236.0,301.6
179232.0,17,4,704,2,148,0.0,74.0,74.0,2,556,0.0,280.0,278.0
108102267.0,17,5,1005,5,1005,27025566.75,201.0,201.0,0,0,0.0,0.0,0.0
313644.0,17,4,1400,4,1400,104548.0,350.0,350.0,0,0,0.0,0.0,0.0
2597611.0,6,2,132,1,66,0.0,66.0,66.0,1,66,0.0,66.0,66.0
101685613.0,6,29,2052,15,1089,7247834.0,123.0,72.6,14,963,7805362.076923077,123.0,68.78571428571429
38810.0,6,14,4740,7,653,6344.166666666667,249.0,93.28571428571428,7,4087,5897.333333333333,1514.0,583.8571428571429
146081.0,6,3,337,2,214,0.0,160.0,107.0,1,123,0.0,123.0,123.0
918158.0,6,10,1334,6,797,183631.6,459.0,132.83333333333334,4,537,214209.66666666663,331.0,134.25
153538.0,17,2,180,1,90,0.0,90.0,90.0,1,90,0.0,90.0,90.0
0.0,6,1,54,0,0,0.0,0.0,0.0,1,54,0.0,54.0,54.0
82805.0,6,14,4740,7,653,9997.833333333334,249.0,93.28571428571428,7,4087,12778.333333333334,1514.0,583.8571428571429
90239050.0,6,12,1832,8,1016,12891292.857142856,188.0,127.0,4,816,30024991.33333333,204.0,204.0
22449.0,17,2,582,1,83,0.0,83.0,83.0,1,499,0.0,499.0,499.0
119965563.0,17,35,16705,35,16705,3528398.911764706,501.0,477.2857142857143,0,0,0.0,0.0,0.0
0.0,17,1,55,1,55,0.0,55.0,55.0,0,0,0.0,0.0,0.0
300393.0,6,6,412,4,272,100131.0,74.0,68.0,2,140,0.0,74.0,70.0
281362.0,17,2,363,1,79,0.0,79.0,79.0,1,284,0.0,284.0,284.0
302289.0,6,6,412,4,272,100763.0,74.0,68.0,2,140,0.0,74.0,70.0
869332.0,6,9,1270,6,799,173866.4,461.0,133.16666666666666,3,471,296854.0,331.0,157.0
2339.0,17,4,344,2,150,0.0,75.0,75.0,2,194,0.0,103.0,97.0
120435428.0,6,227,25722,114,18042,1065800.2477876106,284.0,158.26315789473685,113,7680,1066104.044642857,140.0,67.96460176991151
90314933.0,6,16,1192,8,596,12895116.57142857,95.0,74.5,8,596,12901389.285714284,95.0,74.5
32097.0,6,10,2032,5,524,7705.5,252.0,104.8,5,1508,7266.25,1236.0,301.6
185253.0,17,2,180,1,90,0.0,90.0,90.0,1,90,0.0,90.0,90.0
34944.0,6,10,2032,5,524,8384.75,252.0,104.8,5,1508,8456.25,1236.0,301.6
221901.0,6,10,1221,6,636,44380.2,298.0,106.0,4,585,71336.33333333333,379.0,146.25
223613.0,6,4,492,2,280,0.0,214.0,140.0,2,212,0.0,146.0,106.0
311259.0,17,4,1400,4,1400,103753.0,350.0,350.0,0,0,0.0,0.0,0.0
114001239.0,17,13,821,7,432,19000206.5,174.0,61.71428571428572,6,389,18800852.4,174.0,64.83333333333333
125001201.0,17,15,1169,8,606,17857314.42857143,174.0,75.75,7,563,17501546.333333332,174.0,80.42857142857143
307534.0,6,6,412,4,272,102511.33333333331,74.0,68.0,2,140,0.0,74.0,70.0
204214.0,17,2,762,2,762,0.0,381.0,381.0,0,0,0.0,0.0,0.0
167642.0,17,2,414,1,88,0.0,88.0,88.0,1,326,0.0,326.0,326.0
32683796.0,6,5,336,2,134,0.0,68.0,67.0,3,202,14951715.5,70.0,67.33333333333333
90254428.0,6,12,1832,8,1016,12893489.714285716,188.0,127.0,4,816,30029932.666666668,204.0,204.0
19638.0,6,20,7606,11,978,1963.8,310.0,88.9090909090909,9,6628,2176.875,1514.0,736.4444444444445
304047.0,6,6,412,4,272,101349.0,74.0,68.0,2,140,0.0,74.0,70.0
193408.0,17,4,1400,4,1400,64469.333333333336,350.0,350.0,0,0,0.0,0.0,0.0
221573.0,6,12,1373,7,714,36928.833333333336,298.0,102.0,5,659,54566.5,379.0,131.8
4994058.0,17,4,849,2,166,0.0,83.0,83.0,2,683,0.0,499.0,341.5
309570.0,6,6,412,4,272,103190.0,74.0,68.0,2,140,0.0,74.0,70.0
90049868.0,17,27,12943,27,12943,3463456.461538461,501.0,479.3703703703704,0,0,0.0,0.0,0.0
218879.0,6,3,426,2,280,0.0,214.0,140.0,1,146,0.0,146.0,146.0
153428.0,17,2,180,1,90,0.0,90.0,90.0,1,90,0.0,90.0,90.0
120028646.0,17,28,13364,28,13364,4445505.407407408,501.0,477.2857142857143,0,0,0.0,0.0,0.0
93011484.0,6,38,2508,19,1254,5150437.444444444,66.0,66.0,19,1254,5150436.944444444,66.0,66.0
307012.0,6,6,412,4,272,102337.33333333331,74.0,68.0,2,140,0.0,74.0,70.0
120005571.0,17,15,1169,8,606,17143653.0,174.0,75.75,7,563,16666817.666666666,174.0,80.42857142857143
3006528.0,6,12,2172,7,664,500982.8333333333,252.0,94.85714285714286,5,1508,2005.75,1236.0,301.6
107186775.0,6,213,23918,107,7358,1011195.9905660376,140.0,68.76635514018692,106,16560,1018821.6857142856,284.0,156.2264150943396
300728.0,6,6,412,4,272,100242.66666666669,74.0,68.0,2,140,0.0,74.0,70.0
1032338.0,6,11,1134,6,558,206467.6,220.0,93.0,5,576,255469.25,304.0,115.2
30911.0,17,2,582,1,83,0.0,83.0,83.0,1,499,0.0,499.0,499.0
120054056.0,17,29,13785,29,13785,4287644.857142857,501.0,475.3448275862069,0,0,0.0,0.0,0.0
135136355.0,17,6,1146,6,1146,27027271.0,191.0,191.0,0,0,0.0,0.0,0.0
423185.0,6,3,1604,1,753,0.0,753.0,753.0,2,851,0.0,785.0,425.5
37114.0,6,14,4740,7,653,6030.833333333333,249.0,93.28571428571428,7,4087,5823.333333333333,1514.0,583.8571428571429
37286.0,6,14,4740,7,653,6102.5,249.0,93.28571428571428,7,4087,5267.833333333333,1514.0,583.8571428571429
2067.0,17,4,344,2,150,0.0,75.0,75.0,2,194,0.0,103.0,97.0
120281246.0,6,245,27560,123,19212,985911.8524590164,284.0,156.1951219512195,122,8348,985616.7603305784,140.0,68.42622950819673
109234.0,17,2,286,2,286,0.0,143.0,143.0,0,0,0.0,0.0,0.0
280967.0,17,2,363,1,79,0.0,79.0,79.0,1,284,0.0,284.0,284.0
6517.0,17,2,447,1,84,0.0,84.0,84.0,1,363,0.0,363.0,363.0
38057.0,6,14,4740,7,653,6217.5,249.0,93.28571428571428,7,4087,6187.5,1514.0,583.8571428571429
147927.0,17,2,180,1,90,0.0,90.0,90.0,1,90,0.0,90.0,90.0
120144125.0,6,220,24868,110,7556,1094681.3027522936,140.0,68.69090909090909,110,17312,1096221.376146789,284.0,157.38181818181818
10471049.0,6,7,478,4,272,3443165.6666666665,74.0,68.0,3,206,5164618.5,74.0,68.66666666666667
144063.0,17,2,180,1,90,0.0,90.0,90.0,1,90,0.0,90.0,90.0
135132841.0,17,6,1146,6,1146,27026568.2,191.0,191.0,0,0,0.0,0.0,0.0
108109069.0,17,5,1005,5,1005,27027267.25,201.0,201.0,0,0,0.0,0.0,0.0
826246.0,6,9,1118,6,586,165249.2,248.0,97.66666666666669,3,532,276782.5,392.0,177.33333333333334
58978348.0,17,9,3086,8,2736,5122344.285714285,342.0,342.0,1,350,0.0,350.0,350.0
285836.0,17,2,363,1,79,0.0,79.0,79.0,1,284,0.0,284.0,284.0
13306.0,6,10,2032,5,524,2169.75,252.0,104.8,5,1508,3058.0,1236.0,301.6
93058521.0,6,20,1531,10,745,10339835.666666666,95.0,74.5,10,786,10308214.555555556,95.0,78.6
2351687.0,6,19,6869,11,1567,235168.7,408.0,142.45454545454547,8,5302,273633.8571428572,1514.0,662.75
108095191.0,17,5,955,5,955,27023797.75,191.0,191.0,0,0,0.0,0.0,0.0
135124419.0,17,6,1206,6,1206,27024883.8,201.0,201.0,0,0,0.0,0.0,0.0
15803.000000000002,17,4,344,2,150,0.0,75.0,75.0,2,194,0.0,103.0,97.0
62622.0,6,14,4740,7,653,9105.5,249.0,93.28571428571428,7,4087,9210.0,1514.0,583.8571428571429
153475.0,17,2,180,1,90,0.0,90.0,90.0,1,90,0.0,90.0,90.0
2155.0,17,4,344,2,150,0.0,75.0,75.0,2,194,0.0,103.0,97.0
105316.0,17,2,286,2,286,0.0,143.0,143.0,0,0,0.0,0.0,0.0
112082.0,17,2,286,2,286,0.0,143.0,143.0,0,0,0.0,0.0,0.0
93261432.0,6,40,2640,20,1320,4908496.421052632,66.0,66.0,20,1320,4892161.421052632,66.0,66.0
120311909.0,6,221,25056,111,17574,1093744.6272727272,284.0,158.32432432432432,110,7482,1094282.880733945,140.0,68.01818181818182
108104140.0,17,5,955,5,955,27026035.0,191.0,191.0,0,0,0.0,0.0,0.0
123096803.0,17,15,1300,8,737,17585257.57142857,174.0,92.125,7,563,19678334.83333333,174.0,80.42857142857143
108107016.0,17,5,1005,5,1005,27026754.0,201.0,201.0,0,0,0.0,0.0,0.0
92865137.0,17,11,735,6,389,18541008.4,174.0,64.83333333333333,5,346,18330758.25,174.0,69.2
90025571.0,17,28,13364,28,13364,3334280.407407407,501.0,477.2857142857143,0,0,0.0,0.0,0.0
205912.0,17,2,180,1,90,0.0,90.0,90.0,1,90,0.0,90.0,90.0
90048164.0,17,28,13364,28,13364,3335117.185185185,501.0,477.2857142857143,0,0,0.0,0.0,0.0
18881.0,6,11,2098,6,590,3643.2,252.0,98.33333333333331,5,1508,4196.25,1236.0,301.6
118681189.0,6,33,2274,17,1125,7417574.3125,123.0,66.17647058823529,16,1149,7232006.466666667,123.0,71.8125
90258512.0,6,14,2240,8,1016,12894073.142857144,188.0,127.0,6,1224,18018890.6,204.0,204.0
74696.0,6,14,4740,7,653,11600.666666666666,249.0,93.28571428571428,7,4087,11636.166666666666,1514.0,583.8571428571429
33240.0,6,14,4740,7,653,5347.0,249.0,93.28571428571428,7,4087,5076.833333333333,1514.0,583.8571428571429
24885.0,6,14,4740,7,653,3980.3333333333335,249.0,93.28571428571428,7,4087,4008.5,1514.0,583.8571428571429
2800605.0,6,2,132,1,66,0.0,66.0,66.0,1,66,0.0,66.0,66.0
135134383.0,17,6,1146,6,1146,27026876.6,191.0,191.0,0,0,0.0,0.0,0.0
83664.0,6,14,4740,7,653,13203.166666666666,249.0,93.28571428571428,7,4087,12074.5,1514.0,583.8571428571429
2331.0,17,4,344,2,150,0.0,75.0,75.0,2,194,0.0,103.0,97.0
41146.0,6,14,4740,7,653,5953.666666666667,249.0,93.28571428571428,7,4087,6702.5,1514.0,583.8571428571429
964511.0,6,13,1420,7,789,160751.83333333334,253.0,112.71428571428572,6,631,191412.4,293.0,105.16666666666669
26460.0,6,10,2032,5,524,6381.25,252.0,104.8,5,1508,6352.25,1236.0,301.6
107494.0,17,2,286,2,286,0.0,143.0,143.0,0,0,0.0,0.0,0.0
120363093.0,6,229,25912,115,18092,1055816.605263158,284.0,157.3217391304348,114,7820,1056099.3628318585,140.0,68.59649122807018
45916.0,6,14,4740,7,653,7161.166666666667,249.0,93.28571428571428,7,4087,7513.166666666667,1514.0,583.8571428571429
113205997.0,17,14,864,7,432,18834204.33333333,174.0,61.71428571428572,7,432,18833504.5,174.0,61.71428571428572
9647.0,17,2,571,1,86,0.0,86.0,86.0,1,485,0.0,485.0,485.0
117342471.0,6,34,2350,17,1225,7320323.5,139.0,72.05882352941177,17,1125,7320398.75,123.0,66.17647058823529
102626.0,17,2,762,2,762,0.0,381.0,381.0,0,0,0.0,0.0,0.0
2026.0,17,4,344,2,150,0.0,75.0,75.0,2,194,0.0,103.0,97.0
144546.0,17,2,180,1,70,0.0,70.0,70.0,1,110,0.0,110.0,110.0
100330387.0,17,11,604,6,389,20066077.4,174.0,64.83333333333333,5,215,20001864.25,43.0,43.0
119006758.0,17,15,1169,8,606,17000965.42857143,174.0,75.75,7,563,16500137.333333334,174.0,80.42857142857143
90260138.0,6,13,2036,8,1016,12894305.42857143,188.0,127.0,5,1020,22523936.75,204.0,204.0
43863.0,6,10,2032,5,524,10718.25,252.0,104.8,5,1508,10506.25,1236.0,301.6
9225.0,17,2,498,1,80,0.0,80.0,80.0,1,418,0.0,418.0,418.0
122584706.0,6,35,2542,18,1348,7210865.05882353,139.0,74.88888888888889,17,1194,7023893.3125,123.0,70.23529411764706
90293135.0,6,16,1192,8,596,12892428.285714284,95.0,74.5,8,596,12898233.857142856,95.0,74.5
217933.0,6,3,426,2,280,0.0,214.0,140.0,1,146,0.0,146.0,146.0
2827529.0,6,3,204,2,136,0.0,70.0,68.0,1,68,0.0,68.0,68.0
326124.0,17,4,1400,4,1400,108708.0,350.0,350.0,0,0,0.0,0.0,0.0
353.0,17,2,174,1,79,0.0,79.0,79.0,1,95,0.0,95.0,95.0
92113680.0,6,38,2508,19,1254,5105434.611111111,66.0,66.0,19,1254,5105432.888888889,66.0,66.0
297786.0,6,6,412,4,272,99262.0,74.0,68.0,2,140,0.0,74.0,70.0
90256091.0,6,12,1832,8,1016,12893727.285714284,188.0,127.0,4,816,30030908.666666668,204.0,204.0
100041155.0,17,13,821,7,432,16666808.5,174.0,61.71428571428572,6,389,20001041.6,174.0,64.83333333333333
90218062.0,6,16,1192,8,596,12853345.285714284,95.0,74.5,8,596,12859044.142857144,95.0,74.5
118998.0,17,4,1400,4,1400,39666.0,350.0,350.0,0,0,0.0,0.0,0.0
308637.0,6,6,412,4,272,102879.0,74.0,68.0,2,140,0.0,74.0,70.0
90254850.0,6,14,2240,8,1016,12893550.0,188.0,127.0,6,1224,18018452.6,204.0,204.0
3296591.0,6,4,301,2,132,0.0,66.0,66.0,2,169,0.0,103.0,84.5
47232.0,6,14,4740,7,653,6816.833333333333,249.0,93.28571428571428,7,4087,7531.0,1514.0,583.8571428571429
1171497.0,6,13,3020,8,2392,167356.7142857143,1514.0,299.0,5,628,223986.0,331.0,125.6
121962.0,6,4,439,2,238,0.0,172.0,119.0,2,201,0.0,135.0,100.5
3033.0,17,2,224,1,76,0.0,76.0,76.0,1,148,0.0,148.0,148.0
291884.0,17,2,246,1,76,0.0,76.0,76.0,1,170,0.0,170.0,170.0
295.0,17,2,156,1,78,0.0,78.0,78.0,1,78,0.0,78.0,78.0
36392.0,6,14,4740,7,653,5342.166666666667,249.0,93.28571428571428,7,4087,5929.833333333333,1514.0,583.8571428571429
48889.0,6,13,1394,7,797,8148.166666666667,253.0,113.85714285714286,6,597,8597.0,259.0,99.5
303.0,17,2,156,1,78,0.0,78.0,78.0,1,78,0.0,78.0,78.0
341.0,17,2,160,1,80,0.0,80.0,80.0,1,80,0.0,80.0,80.0
459520.0,6,3,1604,1,753,0.0,753.0,753.0,2,851,0.0,785.0,425.5
51887.0,6,14,4740,7,653,8335.666666666666,249.0,93.28571428571428,7,4087,8356.0,1514.0,583.8571428571429
111367873.0,17,14,864,7,432,18500167.166666668,174.0,61.71428571428572,7,432,18501367.166666668,174.0,61.71428571428572
1180504.0,6,13,3017,8,2389,168643.42857142858,1514.0,298.625,5,628,226211.75,331.0,125.6
90257664.0,6,12,1832,8,1016,12893952.0,188.0,127.0,4,816,30030796.33333333,204.0,204.0
313411.0,17,4,1400,4,1400,104470.33333333331,350.0,350.0,0,0,0.0,0.0,0.0
228331.0,17,2,180,1,90,0.0,90.0,90.0,1,90,0.0,90.0,90.0
108105337.0,17,5,955,5,955,27026334.25,191.0,191.0,0,0,0.0,0.0,0.0
2060.0,17,4,344,2,150,0.0,75.0,75.0,2,194,0.0,103.0,97.0
9005752.0,17,2,160,2,160,0.0,80.0,80.0,0,0,0.0,0.0,0.0
170545.0,6,3,337,2,214,0.0,160.0,107.0,1,123,0.0,123.0,123.0
76050442.0,6,9,842,9,842,9506305.25,97.0,93.55555555555556,0,0,0.0,0.0,0.0
31519.0,6,10,2032,5,524,7225.25,252.0,104.8,5,1508,7613.25,1236.0,301.6
302279.0,6,6,412,4,272,100759.66666666669,74.0,68.0,2,140,0.0,74.0,70.0
90294714.0,6,23,1895,12,1096,8204223.818181818,256.0,91.33333333333331,11,799,8999622.2,95.0,72.63636363636364
146144.0,6,3,337,2,214,0.0,160.0,107.0,1,123,0.0,123.0,123.0
3683.0,17,4,344,2,150,0.0,75.0,75.0,2,194,0.0,103.0,97.0
105054428.0,6,195,22038,98,15402,1083035.3402061856,284.0,157.16326530612244,97,6636,1074015.90625,140.0,68.41237113402062
120001153.0,6,27,2956,14,1505,9230857.923076924,425.0,107.5,13,1451,9979340.666666666,336.0,111.6153846153846
52941.0,6,14,4740,7,653,8605.833333333334,249.0,93.28571428571428,7,4087,7993.0,1514.0,583.8571428571429
90041583.0,17,28,13364,28,13364,3334873.4444444445,501.0,477.2857142857143,0,0,0.0,0.0,0.0
90792792.0,6,19,1436,10,745,10082598.777777778,95.0,74.5,9,691,11347077.375,95.0,76.77777777777777
5793009.0,6,5,336,2,134,0.0,68.0,67.0,3,202,1522407.0,70.0,67.33333333333333
153440.0,17,2,180,1,90,0.0,90.0,90.0,1,90,0.0,90.0,90.0
242663.0,6,12,1373,7,714,40443.833333333336,298.0,102.0,5,659,59223.0,379.0,131.8
101005463.0,17,13,821,7,432,16834243.833333332,174.0,61.71428571428572,6,389,16200165.0,174.0,64.83333333333333
116067119.0,6,48,3168,24,1584,5046396.478260869,66.0,66.0,24,1584,5029249.217391305,66.0,66.0
138047.0,6,2,132,1,66,0.0,66.0,66.0,1,66,0.0,66.0,66.0
484.0,17,2,508,2,508,0.0,257.0,254.0,0,0,0.0,0.0,0.0
47758.0,6,14,4740,7,653,7786.333333333333,249.0,93.28571428571428,7,4087,7809.666666666667,1514.0,583.8571428571429
97893.0,17,2,700,2,700,0.0,350.0,350.0,0,0,0.0,0.0,0.0
5624616.0,6,4,270,2,134,0.0,68.0,67.0,2,136,0.0,70.0,68.0
118007068.0,17,15,1169,8,606,16858152.57142857,174.0,75.75,7,563,16333501.833333334,174.0,80.42857142857143
90054469.0,17,28,13364,28,13364,3335350.703703704,501.0,477.2857142857143,0,0,0.0,0.0,0.0
319758.0,17,4,1400,4,1400,106586.0,350.0,350.0,0,0,0.0,0.0,0.0
149709.0,17,2,180,1,90,0.0,90.0,90.0,1,90,0.0,90.0,90.0
120126971.0,6,474,59430,237,43492,508099.75,374.0,183.51054852320675,237,15938,508100.0338983051,140.0,67.24894514767932
41419.0,6,10,2032,5,524,10143.25,252.0,104.8,5,1508,9048.0,1236.0,301.6
273356.0,6,10,1221,6,636,54671.2,298.0,106.0,4,585,85750.66666666667,379.0,146.25
103669961.0,17,14,864,7,432,17278326.833333332,174.0,61.71428571428572,7,432,17164897.5,174.0,61.71428571428572
120117528.0,6,366,43414,183,12374,655529.5549450549,140.0,67.61748633879782,183,31040,655459.7197802198,284.0,169.61748633879782
126001089.0,17,15,907,8,475,18000155.57142857,174.0,59.375,7,432,17568593.333333332,174.0,61.71428571428572
43913.0,6,14,4740,7,653,6767.166666666667,249.0,93.28571428571428,7,4087,6718.166666666667,1514.0,583.8571428571429
197726.0,17,2,180,1,90,0.0,90.0,90.0,1,90,0.0,90.0,90.0
196968.0,17,2,180,1,90,0.0,90.0,90.0,1,90,0.0,90.0,90.0
228268.0,17,2,180,1,90,0.0,90.0,90.0,1,90,0.0,90.0,90.0
25369.0,6,14,4740,7,653,3894.5,249.0,93.28571428571428,7,4087,3812.6666666666665,1514.0,583.8571428571429
144962.0,17,2,180,1,70,0.0,70.0,70.0,1,110,0.0,110.0,110.0
83.0,17,2,762,2,762,0.0,381.0,381.0,0,0,0.0,0.0,0.0
29597.0,6,14,4740,7,653,4381.333333333333,249.0,93.28571428571428,7,4087,4708.166666666667,1514.0,583.8571428571429
440.0,17,2,508,2,508,0.0,257.0,254.0,0,0,0.0,0.0,0.0
39664.0,6,10,2032,5,524,9670.0,252.0,104.8,5,1508,7722.0,1236.0,301.6
298567.0,6,6,412,4,272,99522.33333333331,74.0,68.0,2,140,0.0,74.0,70.0
9689.0,6,10,1065,5,534,2209.5,262.0,106.8,5,531,2105.25,259.0,106.2
138985.0,6,2,132,1,66,0.0,66.0,66.0,1,66,0.0,66.0,66.0
122005806.0,17,15,1431,8,737,17429400.85714286,174.0,92.125,7,694,17002125.5,174.0,99.14285714285714
99514.0,17,2,762,2,762,0.0,381.0,381.0,0,0,0.0,0.0,0.0
24080872.0,17,5,1718,4,1368,755001.3333333334,342.0,342.0,1,350,0.0,350.0,350.0
304606.0,6,6,412,4,272,101535.33333333331,74.0,68.0,2,140,0.0,74.0,70.0
216928.0,6,10,1221,6,636,43385.6,298.0,106.0,4,585,70887.66666666667,379.0,146.25
218033.0,6,3,426,2,280,0.0,214.0,140.0,1,146,0.0,146.0,146.0
2192792.0,6,2,132,1,66,0.0,66.0,66.0,1,66,0.0,66.0,66.0
4310.0,17,2,598,1,72,0.0,72.0,72.0,1,526,0.0,526.0,526.0
41864.0,6,14,4740,7,653,5647.0,249.0,93.28571428571428,7,4087,6464.0,1514.0,583.8571428571429
5614759.0,6,4,270,2,134,0.0,68.0,67.0,2,136,0.0,70.0,68.0
211237.0,17,2,180,1,90,0.0,90.0,90.0,1,90,0.0,90.0,90.0
228293.0,17,2,180,1,90,0.0,90.0,90.0,1,90,0.0,90.0,90.0
235642.0,6,3,337,2,214,0.0,160.0,107.0,1,123,0.0,123.0,123.0
24661.0,6,10,2032,5,524,4625.25,252.0,104.8,5,1508,5706.25,1236.0,301.6
201589.0,17,2,762,2,762,0.0,381.0,381.0,0,0,0.0,0.0,0.0
207946.0,6,3,426,2,280,0.0,214.0,140.0,1,146,0.0,146.0,146.0
94051569.0,6,26,1762,13,922,7818759.75,139.0,70.92307692307692,13,840,7818758.416666667,123.0,64.61538461538461
0.0,6,1,172,1,172,0.0,172.0,172.0,0,0,0.0,0.0,0.0
90862064.0,6,391,62984,196,13306,465948.158974359,214.0,67.88775510204081,195,49678,464166.262886598,1514.0,254.7589743589744
1170133.0,6,13,3020,8,2392,167161.85714285713,1514.0,299.0,5,628,223614.0,331.0,125.6
120005515.0,6,16,1192,8,596,17143645.0,95.0,74.5,8,596,17106557.285714287,95.0,74.5
112801.0,17,2,286,2,286,0.0,143.0,143.0,0,0,0.0,0.0,0.0
35711.0,6,14,4740,7,653,5760.333333333333,249.0,93.28571428571428,7,4087,5058.666666666667,1514.0,583.8571428571429
19649.0,6,12,1393,6,796,3753.6,271.0,132.66666666666666,6,597,3690.8,259.0,99.5
335.0,17,2,166,1,75,0.0,75.0,75.0,1,91,0.0,91.0,91.0
120066966.0,17,28,13364,28,13364,4446924.666666667,501.0,477.2857142857143,0,0,0.0,0.0,0.0
19620.0,6,14,4740,7,653,3068.5,249.0,93.28571428571428,7,4087,2828.833333333333,1514.0,583.8571428571429
243453.0,6,3,337,2,214,0.0,160.0,107.0,1,123,0.0,123.0,123.0
16831.0,17,2,180,1,90,0.0,90.0,90.0,1,90,0.0,90.0,90.0
27702978.0,17,5,1710,5,1710,6925744.5,342.0,342.0,0,0,0.0,0.0,0.0
330.0,17,2,174,1,79,0.0,79.0,79.0,1,95,0.0,95.0,95.0
1239973.0,17,7,490,7,490,206662.16666666663,70.0,70.0,0,0,0.0,0.0,0.0
50332.0,6,14,4740,7,653,8252.5,249.0,93.28571428571428,7,4087,8000.666666666667,1514.0,583.8571428571429
24026266.0,17,3,1026,3,1026,12013133.0,342.0,342.0,0,0,0.0,0.0,0.0
120386144.0,6,318,36106,159,10790,756733.5443037974,140.0,67.86163522012579,159,25316,761879.1582278481,284.0,159.22012578616352
208619.0,6,3,426,2,280,0.0,214.0,140.0,1,146,0.0,146.0,146.0
149998816.0,17,35,16705,35,16705,4411729.882352941,501.0,477.2857142857143,0,0,0.0,0.0,0.0
93780951.0,6,174,19682,87,5890,1080881.558139535,140.0,67.70114942528735,87,13792,1080458.5697674418,284.0,158.5287356321839
108104958.0,17,5,955,5,955,27026239.5,191.0,191.0,0,0,0.0,0.0,0.0
11294.0,17,4,823,2,163,0.0,89.0,81.5,2,660,0.0,443.0,330.0
3175645.0,6,18,1495,9,921,358657.625,315.0,102.33333333333331,9,574,358697.625,78.0,63.77777777777778
33485.0,17,2,582,1,83,0.0,83.0,83.0,1,499,0.0,499.0,499.0
153416.0,17,2,180,1,90,0.0,90.0,90.0,1,90,0.0,90.0,90.0
20424.0,6,10,2032,5,524,4861.75,252.0,104.8,5,1508,3725.75,1236.0,301.6
206015.0,6,3,426,2,280,0.0,214.0,140.0,1,146,0.0,146.0,146.0
106809.0,17,2,700,2,700,0.0,350.0,350.0,0,0,0.0,0.0,0.0
220461.0,6,10,1221,6,636,44092.2,298.0,106.0,4,585,72514.0,379.0,146.25
100540805.0,17,12,516,6,258,20000169.8,43.0,43.0,6,258,20000982.6,43.0,43.0
127281.0,6,2,132,1,66,0.0,66.0,66.0,1,66,0.0,66.0,66.0
31456.0,6,2,145,2,145,0.0,91.0,72.5,0,0,0.0,0.0,0.0
318490.0,17,4,1400,4,1400,106163.33333333331,350.0,350.0,0,0,0.0,0.0,0.0
149911840.0,17,36,17126,36,17126,4283195.428571428,501.0,475.72222222222223,0,0,0.0,0.0,0.0
19082961.0,6,6,1981,4,1087,6360987.0,885.0,271.75,2,894,0.0,826.0,447.0
306699.0,6,6,412,4,272,102233.0,74.0,68.0,2,140,0.0,74.0,70.0
60787.0,6,14,4740,7,653,9588.333333333334,249.0,93.28571428571428,7,4087,9773.0,1514.0,583.8571428571429
197364.0,17,2,180,1,90,0.0,90.0,90.0,1,90,0.0,90.0,90.0
24185.0,6,14,4740,7,653,3514.0,249.0,93.28571428571428,7,4087,3550.5,1514.0,583.8571428571429
2388.0,17,4,344,2,150,0.0,75.0,75.0,2,194,0.0,103.0,97.0
39237.0,6,11,2098,6,590,7822.6,252.0,98.33333333333331,5,1508,4971.25,1236.0,301.6
53898.0,6,14,4740,7,653,8788.666666666666,249.0,93.28571428571428,7,4087,7270.0,1514.0,583.8571428571429
41993.0,6,14,4740,7,653,6857.666666666667,249.0,93.28571428571428,7,4087,5824.666666666667,1514.0,583.8571428571429
16975.0,17,2,180,1,90,0.0,90.0,90.0,1,90,0.0,90.0,90.0
124927774.0,6,36,2602,19,1408,6940431.888888889,139.0,74.10526315789474,17,1194,7171111.5625,123.0,70.23529411764706
206321.0,6,3,426,2,280,0.0,214.0,140.0,1,146,0.0,146.0,146.0
111395542.0,17,16,1212,8,606,15857310.714285716,174.0,75.75,8,606,15857425.714285716,174.0,75.75
57530.0,6,14,4740,7,653,8982.666666666666,249.0,93.28571428571428,7,4087,9349.5,1514.0,583.8571428571429
98442669.0,6,30,2122,15,1105,7016187.071428572,139.0,73.66666666666667,15,1017,7016208.142857143,123.0,67.8
71390.0,6,14,4740,7,653,11768.833333333334,249.0,93.28571428571428,7,4087,11056.166666666666,1514.0,583.8571428571429
218196.0,6,3,426,2,280,0.0,214.0,140.0,1,146,0.0,146.0,146.0
584038.0,6,3,198,2,132,0.0,66.0,66.0,1,66,0.0,66.0,66.0
135130898.0,17,6,1146,6,1146,27026179.6,191.0,191.0,0,0,0.0,0.0,0.0
120000107.0,6,17,1287,9,691,15000013.375,95.0,76.77777777777777,8,596,12898393.714285716,95.0,74.5
92299145.0,6,20,1544,10,840,10228497.666666666,153.0,84.0,10,704,10232586.111111112,95.0,70.4
92016288.0,6,38,2508,19,1254,5112001.722222222,66.0,66.0,19,1254,5112002.444444444,66.0,66.0
108109363.0,17,5,1005,5,1005,27027340.75,201.0,201.0,0,0,0.0,0.0,0.0
2984360.0,6,3,1604,1,753,0.0,753.0,753.0,2,851,0.0,785.0,425.5
104001154.0,17,13,821,7,432,17333525.666666668,174.0,61.71428571428572,6,389,16801613.2,174.0,64.83333333333333
205849.0,17,2,180,1,90,0.0,90.0,90.0,1,90,0.0,90.0,90.0
305297.0,6,6,412,4,272,101765.66666666669,74.0,68.0,2,140,0.0,74.0,70.0
848348.0,6,9,1196,6,725,169669.6,387.0,120.83333333333331,3,471,286195.0,331.0,157.0
107833640.0,6,28,1860,14,966,8278289.153846154,123.0,69.0,14,894,8278286.769230769,123.0,63.85714285714285
10480041.0,6,7,478,4,272,3446378.333333333,74.0,68.0,3,206,5169446.0,74.0,68.66666666666667
68454.0,6,14,4740,7,653,10885.5,249.0,93.28571428571428,7,4087,9545.833333333334,1514.0,583.8571428571429
90255749.0,6,13,2036,8,1016,12893678.42857143,188.0,127.0,5,1020,22522735.0,204.0,204.0
301767.0,6,6,412,4,272,100589.0,74.0,68.0,2,140,0.0,74.0,70.0
81.0,17,2,762,2,762,0.0,381.0,381.0,0,0,0.0,0.0,0.0
102912.0,17,2,286,2,286,0.0,143.0,143.0,0,0,0.0,0.0,0.0
104710.0,17,2,700,2,700,0.0,350.0,350.0,0,0,0.0,0.0,0.0
284961.0,17,2,363,1,79,0.0,79.0,79.0,1,284,0.0,284.0,284.0
61975138.0,6,9,1479,9,1479,7746892.25,172.0,164.33333333333334,0,0,0.0,0.0,0.0
2006.0,17,2,664,1,322,0.0,322.0,322.0,1,342,0.0,342.0,342.0
24851.0,6,10,2032,5,524,4570.75,252.0,104.8,5,1508,5881.25,1236.0,301.6
13323.0,6,11,2098,6,590,2525.8,252.0,98.33333333333331,5,1508,2872.5,1236.0,301.6
114573847.0,6,48,3168,24,1584,4981471.608695652,66.0,66.0,24,1584,4972075.043478261,66.0,66.0
797683.0,6,6,758,3,410,386121.0,172.0,136.66666666666666,3,348,283463.0,135.0,116.0
71608.0,17,2,620,1,75,0.0,75.0,75.0,1,545,0.0,545.0,545.0
2597709.0,6,2,132,1,66,0.0,66.0,66.0,1,66,0.0,66.0,66.0
116834.0,17,4,1400,4,1400,38944.66666666666,350.0,350.0,0,0,0.0,0.0,0.0
120126579.0,6,12,1832,8,1016,17137894.42857143,188.0,127.0,4,816,30032907.33333333,204.0,204.0
122010463.0,17,15,1169,8,606,17430066.14285714,174.0,75.75,7,563,17000217.833333332,174.0,80.42857142857143
319841.0,17,4,1400,4,1400,106613.66666666669,350.0,350.0,0,0,0.0,0.0,0.0
18243.0,6,10,2032,5,524,4333.75,252.0,104.8,5,1508,3665.5,1236.0,301.6
287196.0,17,4,704,2,148,0.0,74.0,74.0,2,556,0.0,280.0,278.0
97695.0,17,2,762,2,762,0.0,381.0,381.0,0,0,0.0,0.0,0.0
90259071.0,6,13,2036,8,1016,12894153.0,188.0,127.0,5,1020,22517572.5,204.0,204.0
90075119.0,17,28,13364,28,13364,3336115.5185185187,501.0,477.2857142857143,0,0,0.0,0.0,0.0
0.0,17,1,55,1,55,0.0,55.0,55.0,0,0,0.0,0.0,0.0
687.0,17,5,550,5,550,171.75,110.0,110.0,0,0,0.0,0.0,0.0
317000.0,6,6,412,4,272,105666.66666666669,74.0,68.0,2,140,0.0,74.0,70.0
299112.0,6,6,412,4,272,99704.0,74.0,68.0,2,140,0.0,74.0,70.0
2047.0,17,4,344,2,150,0.0,75.0,75.0,2,194,0.0,103.0,97.0
103132.0,17,2,762,2,762,0.0,381.0,381.0,0,0,0.0,0.0,0.0
30553.0,6,10,2032,5,524,5812.0,252.0,104.8,5,1508,7353.0,1236.0,301.6
252867.0,6,10,1221,6,636,50573.4,298.0,106.0,4,585,78390.66666666667,379.0,146.25
38573.0,6,14,4740,7,653,5834.0,249.0,93.28571428571428,7,4087,6289.0,1514.0,583.8571428571429
95727615.0,6,40,2640,20,1320,5038295.52631579,66.0,66.0,20,1320,5022002.052631579,66.0,66.0
122334459.0,6,37,2778,20,1515,6438655.736842105,123.0,75.75,17,1263,7008187.1875,123.0,74.29411764705883
5624921.0,6,5,336,2,134,0.0,68.0,67.0,3,202,1522500.5,70.0,67.33333333333333
308125.0,6,6,412,4,272,102708.33333333331,74.0,68.0,2,140,0.0,74.0,70.0
307393.0,6,6,412,4,272,102464.33333333331,74.0,68.0,2,140,0.0,74.0,70.0
1205614.0,17,7,490,7,490,200935.66666666663,70.0,70.0,0,0,0.0,0.0,0.0
106912.0,17,2,286,2,286,0.0,143.0,143.0,0,0,0.0,0.0,0.0
78880.0,6,14,4740,7,653,12822.5,249.0,93.28571428571428,7,4087,12574.166666666666,1514.0,583.8571428571429
549152.0,17,2,346,1,78,0.0,78.0,78.0,1,268,0.0,268.0,268.0
2016.0,17,4,344,2,150,0.0,75.0,75.0,2,194,0.0,103.0,97.0
3304.0,17,2,414,1,88,0.0,88.0,88.0,1,326,0.0,326.0,326.0
212497.0,6,10,1221,6,636,42499.4,298.0,106.0,4,585,69536.33333333333,379.0,146.25
1360625.0,6,4,276,2,128,0.0,74.0,64.0,2,148,0.0,74.0,74.0
242666.0,6,3,373,2,238,0.0,172.0,119.0,1,135,0.0,135.0,135.0
193121.0,17,2,180,1,90,0.0,90.0,90.0,1,90,0.0,90.0,90.0
108218714.0,6,189,21282,95,6504,1151262.914893617,140.0,68.46315789473684,94,14778,1152550.9247311829,284.0,157.2127659574468
146597.0,6,3,337,2,214,0.0,160.0,107.0,1,123,0.0,123.0,123.0
9286.0,6,11,2098,6,590,1805.4,252.0,98.33333333333331,5,1508,2028.5,1236.0,301.6
104024.0,17,2,700,2,700,0.0,350.0,350.0,0,0,0.0,0.0,0.0
37913.0,6,10,2032,5,524,8851.0,252.0,104.8,5,1508,8746.0,1236.0,301.6
214071.0,6,10,1221,6,636,42814.2,298.0,106.0,4,585,70476.66666666667,379.0,146.25
217800.0,17,2,762,2,762,0.0,381.0,381.0,0,0,0.0,0.0,0.0
878844.0,6,10,1336,6,799,175768.8,461.0,133.16666666666666,4,537,201051.66666666663,331.0,134.25
319.0,17,2,174,1,79,0.0,79.0,79.0,1,95,0.0,95.0,95.0
218714.0,17,2,180,1,90,0.0,90.0,90.0,1,90,0.0,90.0,90.0
321844.0,6,6,412,4,272,107281.33333333331,74.0,68.0,2,140,0.0,74.0,70.0
9892.0,17,2,582,1,83,0.0,83.0,83.0,1,499,0.0,499.0,499.0
1771631.0,6,2,132,1,66,0.0,66.0,66.0,1,66,0.0,66.0,66.0
10515544.0,6,7,478,4,272,3459561.333333333,74.0,68.0,3,206,5189241.5,74.0,68.66666666666667
266901.0,6,10,1221,6,636,53380.2,298.0,106.0,4,585,83546.66666666667,379.0,146.25
300914.0,6,6,412,4,272,100304.66666666669,74.0,68.0,2,140,0.0,74.0,70.0
26145.0,6,10,2032,5,524,6230.0,252.0,104.8,5,1508,6164.75,1236.0,301.6
47619142.0,6,8,2113,3,960,22801791.0,826.0,320.0,5,1153,11260912.75,885.0,230.6
16254.999999999998,6,10,1067,5,536,3623.25,264.0,107.2,5,531,3568.0,259.0,106.2
26512.0,6,14,4740,7,653,4267.333333333333,249.0,93.28571428571428,7,4087,4284.0,1514.0,583.8571428571429
502127.0,6,5,336,2,134,0.0,68.0,67.0,3,202,194017.5,70.0,67.33333333333333
132706197.0,17,16,1212,8,606,16143839.0,174.0,75.75,8,606,16142996.142857144,174.0,75.75
117301935.0,6,34,2350,17,1225,7317885.25,139.0,72.05882352941177,17,1125,7317881.9375,123.0,66.17647058823529
47840720.0,6,8,1940,3,887,22672040.5,753.0,295.6666666666667,5,1053,11263089.5,785.0,210.6
123582527.0,6,30,2037,15,948,8278082.5,123.0,63.2,15,1089,8417120.142857144,123.0,72.6
90521289.0,6,15,2444,8,1016,12931612.714285716,188.0,127.0,7,1428,15059604.333333334,204.0,204.0
48570.0,6,14,4740,7,653,7614.0,249.0,93.28571428571428,7,4087,7567.5,1514.0,583.8571428571429
217568.0,17,4,1524,4,1524,72522.66666666667,381.0,381.0,0,0,0.0,0.0,0.0
30829.0,6,10,2032,5,524,7226.0,252.0,104.8,5,1508,7463.0,1236.0,301.6
120072576.0,17,29,13785,29,13785,4288306.285714285,501.0,475.3448275862069,0,0,0.0,0.0,0.0
197115.0,17,2,180,1,90,0.0,90.0,90.0,1,90,0.0,90.0,90.0
217957.0,6,3,426,2,280,0.0,214.0,140.0,1,146,0.0,146.0,146.0
391576.0,6,10,1221,6,636,78315.2,298.0,106.0,4,585,129183.66666666669,379.0,146.25
28372.0,6,10,2032,5,524,6230.25,252.0,104.8,5,1508,6854.25,1236.0,301.6
302239.0,6,6,412,4,272,100746.33333333331,74.0,68.0,2,140,0.0,74.0,70.0
110980274.0,6,30,1974,15,1026,7911744.5,123.0,68.4,15,948,7911747.5,123.0,63.2
12820.0,6,11,1133,6,602,2299.2,264.0,100.33333333333331,5,531,2941.25,259.0,106.2
133119.0,6,2,132,1,66,0.0,66.0,66.0,1,66,0.0,66.0,66.0
1988.0,17,4,344,2,150,0.0,75.0,75.0,2,194,0.0,103.0,97.0
23522.0,17,2,582,1,83,0.0,83.0,83.0,1,499,0.0,499.0,499.0
105202.0,17,2,700,2,700,0.0,350.0,350.0,0,0,0.0,0.0,0.0
35347.0,6,14,4740,7,653,5330.166666666667,249.0,93.28571428571428,7,4087,3727.1666666666665,1514.0,583.8571428571429
25916.0,6,11,2098,6,590,5115.8,252.0,98.33333333333331,5,1508,4478.0,1236.0,301.6
18489.0,6,14,4740,7,653,2552.1666666666665,249.0,93.28571428571428,7,4087,2941.833333333333,1514.0,583.8571428571429
196840.0,17,2,180,1,90,0.0,90.0,90.0,1,90,0.0,90.0,90.0
2347.0,17,4,344,2,150,0.0,75.0,75.0,2,194,0.0,103.0,97.0
409.0,17,2,267,1,83,0.0,83.0,83.0,1,184,0.0,184.0,184.0
196952.0,17,2,180,1,90,0.0,90.0,90.0,1,90,0.0,90.0,90.0
218429.0,6,3,426,2,280,0.0,214.0,140.0,1,146,0.0,146.0,146.0
222663.0,17,2,180,1,90,0.0,90.0,90.0,1,90,0.0,90.0,90.0
61409933.0,17,29,12705,29,12705,2193211.8928571427,453.0,438.1034482758621,0,0,0.0,0.0,0.0
11334.0,6,11,1132,6,556,2127.2,218.0,92.66666666666669,5,576,2387.75,304.0,115.2
223865.0,17,2,371,1,81,0.0,81.0,81.0,1,290,0.0,290.0,290.0
5517405.0,6,5,336,2,134,0.0,68.0,67.0,3,202,1526275.5,70.0,67.33333333333333
327.0,17,2,174,1,79,0.0,79.0,79.0,1,95,0.0,95.0,95.0
503812.00000000006,6,5,336,2,134,0.0,68.0,67.0,3,202,192530.0,70.0,67.33333333333333
8351304.000000001,6,170,160586,52,3598,163751.0588235294,212.0,69.1923076923077,118,156988,71361.07692307692,1514.0,1330.406779661017
118243354.0,17,16,1474,8,737,16891907.714285713,174.0,92.125,8,737,16782079.42857143,174.0,92.125
241546.0,6,3,337,2,214,0.0,160.0,107.0,1,123,0.0,123.0,123.0
821.0,17,4,438,2,148,0.0,74.0,74.0,2,290,0.0,147.0,145.0
14407.0,6,14,4740,7,653,2134.1666666666665,249.0,93.28571428571428,7,4087,2218.1666666666665,1514.0,583.8571428571429
107826590.0,6,28,1860,14,966,8277759.692307692,123.0,69.0,14,894,8277762.846153846,123.0,63.85714285714285
0.0,6,1,54,0,0,0.0,0.0,0.0,1,54,0.0,54.0,54.0
2596186.0,6,2,132,1,66,0.0,66.0,66.0,1,66,0.0,66.0,66.0
216429.0,17,2,180,1,90,0.0,90.0,90.0,1,90,0.0,90.0,90.0
44106.0,6,14,4740,7,653,6373.5,249.0,93.28571428571428,7,4087,7057.166666666667,1514.0,583.8571428571429
2437.0,17,4,344,2,150,0.0,75.0,75.0,2,194,0.0,103.0,97.0
99000852.0,17,13,1083,7,563,16500142.0,174.0,80.42857142857143,6,520,15801335.4,174.0,86.66666666666667
778.0,17,4,438,2,148,0.0,74.0,74.0,2,290,0.0,147.0,145.0
35228.0,6,10,2032,5,524,8574.5,252.0,104.8,5,1508,7168.5,1236.0,301.6
144185.0,6,2,132,1,66,0.0,66.0,66.0,1,66,0.0,66.0,66.0
94892425.0,6,40,2640,20,1320,4994338.157894737,66.0,66.0,20,1320,4979837.947368421,66.0,66.0
27323.0,6,14,4740,7,653,4378.5,249.0,93.28571428571428,7,4087,4410.333333333333,1514.0,583.8571428571429
76579.0,6,10,2032,5,524,18880.5,252.0,104.8,5,1508,17547.75,1236.0,301.6
2007.0,17,4,344,2,150,0.0,75.0,75.0,2,194,0.0,103.0,97.0
3049455.0,6,3,204,1,68,0.0,68.0,68.0,2,136,0.0,70.0,68.0
138352.0,6,2,132,1,66,0.0,66.0,66.0,1,66,0.0,66.0,66.0
90525439.0,6,14,2240,8,1016,12932205.57142857,188.0,127.0,6,1224,18072253.2,204.0,204.0
90616439.0,6,27,1954,14,1045,6953890.923076923,139.0,74.64285714285714,13,909,7533382.666666667,123.0,69.92307692307692
153426.0,17,2,180,1,90,0.0,90.0,90.0,1,90,0.0,90.0,90.0
120242009.0,6,22,1639,11,840,11999913.8,95.0,76.36363636363636,11,799,11999973.7,95.0,72.63636363636364
2021603.0,17,4,525,2,150,0.0,75.0,75.0,2,375,0.0,284.0,187.5
217782.0,6,3,426,2,280,0.0,214.0,140.0,1,146,0.0,146.0,146.0
51107.0,17,2,180,1,90,0.0,90.0,90.0,1,90,0.0,90.0,90.0
61023.0,6,14,4740,7,653,9820.833333333334,249.0,93.28571428571428,7,4087,7922.666666666667,1514.0,583.8571428571429
25763.0,6,14,4740,7,653,3422.5,249.0,93.28571428571428,7,4087,4162.666666666667,1514.0,583.8571428571429
24474.0,6,14,4740,7,653,3805.8333333333335,249.0,93.28571428571428,7,4087,3945.8333333333335,1514.0,583.8571428571429
106305.0,17,2,286,2,286,0.0,143.0,143.0,0,0,0.0,0.0,0.0
760.0,17,4,438,2,148,0.0,74.0,74.0,2,290,0.0,147.0,145.0
493640.0,6,4,270,2,134,0.0,68.0,67.0,2,136,0.0,70.0,68.0
508774.0,6,5,336,2,134,0.0,68.0,67.0,3,202,193526.0,70.0,67.33333333333333
50684.0,17,2,180,1,90,0.0,90.0,90.0,1,90,0.0,90.0,90.0
120035778.0,17,28,13364,28,13364,4445769.555555556,501.0,477.2857142857143,0,0,0.0,0.0,0.0
123713.0,6,13,1394,7,797,20618.83333333333,253.0,113.85714285714286,6,597,22759.2,259.0,99.5
207155.0,6,3,426,2,280,0.0,214.0,140.0,1,146,0.0,146.0,146.0
237160.0,17,2,359,1,75,0.0,75.0,75.0,1,284,0.0,284.0,284.0
949496.0,6,13,1493,7,862,158047.16666666666,271.0,123.14285714285714,6,631,188770.2,293.0,105.16666666666669
317937.0,17,4,1400,4,1400,105979.0,350.0,350.0,0,0,0.0,0.0,0.0
23021.0,6,14,4740,7,653,3715.3333333333335,249.0,93.28571428571428,7,4087,3548.333333333333,1514.0,583.8571428571429
90032734.0,17,28,13364,28,13364,3334545.703703704,501.0,477.2857142857143,0,0,0.0,0.0,0.0
22019.0,6,11,1131,6,600,4054.6,262.0,100.0,5,531,4803.5,259.0,106.2
314778.0,17,4,1400,4,1400,104926.0,350.0,350.0,0,0,0.0,0.0,0.0
103623.0,17,2,286,2,286,0.0,143.0,143.0,0,0,0.0,0.0,0.0
207406.0,6,3,426,2,280,0.0,214.0,140.0,1,146,0.0,146.0,146.0
297996.0,6,6,412,4,272,99332.0,74.0,68.0,2,140,0.0,74.0,70.0
90023931.0,17,28,13364,28,13364,3334219.6666666665,501.0,477.2857142857143,0,0,0.0,0.0,0.0
23078642.0,6,197,55111,104,44676,224064.4854368932,581.0,429.5769230769231,93,10435,248591.1847826087,731.0,112.20430107526882
483.0,17,2,166,1,75,0.0,75.0,75.0,1,91,0.0,91.0,91.0
2321.0,17,4,344,2,150,0.0,75.0,75.0,2,194,0.0,103.0,97.0
43464.0,6,14,4740,7,653,7111.833333333333,249.0,93.28571428571428,7,4087,7101.5,1514.0,583.8571428571429
42262.0,6,14,4740,7,653,6923.5,249.0,93.28571428571428,7,4087,6740.666666666667,1514.0,583.8571428571429
402065.0,6,3,1604,2,851,0.0,785.0,425.5,1,753,0.0,753.0,753.0
788.0,17,4,438,2,148,0.0,74.0,74.0,2,290,0.0,147.0,145.0
742.0,17,4,438,2,148,0.0,74.0,74.0,2,290,0.0,147.0,145.0
31011.0,6,14,4740,7,653,3821.5,249.0,93.28571428571428,7,4087,4972.0,1514.0,583.8571428571429
303119.0,6,2,132,1,66,0.0,66.0,66.0,1,66,0.0,66.0,66.0
1169124.0,6,13,3018,8,2390,167017.7142857143,1514.0,298.75,5,628,223401.25,331.0,125.6
62657.00000000001,6,11,1131,6,600,12357.6,262.0,100.0,5,531,2813.25,259.0,106.2
0.0,17,1,55,1,55,0.0,55.0,55.0,0,0,0.0,0.0,0.0
104827081.0,17,15,5130,15,5130,7487648.642857143,342.0,342.0,0,0,0.0,0.0,0.0
17023.0,17,2,180,1,90,0.0,90.0,90.0,1,90,0.0,90.0,90.0
144982.0,17,2,180,1,70,0.0,70.0,70.0,1,110,0.0,110.0,110.0
27910.0,6,10,1065,5,534,5058.25,262.0,106.8,5,531,6395.5,259.0,106.2
115340217.0,6,48,3168,24,1584,5014792.043478261,66.0,66.0,24,1584,5000427.130434782,66.0,66.0
35812.0,6,10,2032,5,524,8521.0,252.0,104.8,5,1508,8134.75,1236.0,301.6
2340.0,17,4,344,2,150,0.0,75.0,75.0,2,194,0.0,103.0,97.0
111618923.0,6,35,2542,18,1348,6553105.705882353,139.0,74.88888888888889,17,1194,6962677.4375,123.0,70.23529411764706
858368.0,6,9,1096,6,625,171673.6,287.0,104.16666666666669,3,471,291317.0,331.0,157.0
196707.0,17,2,180,1,90,0.0,90.0,90.0,1,90,0.0,90.0,90.0
1163307.0,6,13,3010,8,2382,166186.7142857143,1514.0,297.75,5,628,221913.25,331.0,125.6
90260133.0,6,13,2036,8,1016,12894304.714285716,188.0,127.0,5,1020,22523435.0,204.0,204.0
90363289.0,6,36,2376,18,1188,5315487.588235294,66.0,66.0,18,1188,5302770.588235294,66.0,66.0
3058374.0,6,3,204,1,68,0.0,68.0,68.0,2,136,0.0,70.0,68.0
120123080.0,6,14,2240,6,1224,24024616.0,204.0,204.0,8,1016,17098267.57142857,188.0,127.0
147964.0,17,2,180,1,90,0.0,90.0,90.0,1,90,0.0,90.0,90.0
205850.0,17,2,180,1,90,0.0,90.0,90.0,1,90,0.0,90.0,90.0
103422329.0,6,44,2904,22,1452,4924872.80952381,66.0,66.0,22,1452,4914282.285714285,66.0,66.0
304405.0,6,6,412,4,272,101468.33333333331,74.0,68.0,2,140,0.0,74.0,70.0
42291.0,6,14,4740,7,653,6298.833333333333,249.0,93.28571428571428,7,4087,6529.0,1514.0,583.8571428571429
120462962.0,6,225,25500,113,17886,1075562.1607142857,284.0,158.28318584070797,112,7614,1075861.018018018,140.0,67.98214285714286
40854.0,6,14,4740,7,653,6626.166666666667,249.0,93.28571428571428,7,4087,6610.666666666667,1514.0,583.8571428571429
38721.0,6,14,4740,7,653,5080.666666666667,249.0,93.28571428571428,7,4087,5016.166666666667,1514.0,583.8571428571429
352488.0,17,4,6056,4,6056,117496.0,1514.0,1514.0,0,0,0.0,0.0,0.0
2309.0,17,4,344,2,150,0.0,75.0,75.0,2,194,0.0,103.0,97.0
162271.0,17,2,180,1,90,0.0,90.0,90.0,1,90,0.0,90.0,90.0
108339857.0,17,8,1818,6,1206,21667971.4,201.0,201.0,2,612,0.0,306.0,306.0
6884.0,17,2,239,1,82,0.0,82.0,82.0,1,157,0.0,157.0,157.0
90308472.0,6,16,1192,8,596,12893444.57142857,95.0,74.5,8,596,12900273.714285716,95.0,74.5
112464281.0,6,46,3036,23,1518,5111998.045454546,66.0,66.0,23,1518,5112001.409090909,66.0,66.0
79813.0,6,12,1328,6,731,13509.6,253.0,121.83333333333331,6,597,14238.4,259.0,99.5
4352.0,17,2,602,1,72,0.0,72.0,72.0,1,530,0.0,530.0,530.0
149786.0,17,2,414,1,88,0.0,88.0,88.0,1,326,0.0,326.0,326.0
29948.0,6,10,2032,5,524,7214.75,252.0,104.8,5,1508,7201.5,1236.0,301.6
5622870.0,6,4,270,2,134,0.0,68.0,67.0,2,136,0.0,70.0,68.0
216833.0,17,2,180,1,90,0.0,90.0,90.0,1,90,0.0,90.0,90.0
122975489.0,6,48,3168,24,1584,5070787.826086956,66.0,66.0,24,1584,5196300.695652174,66.0,66.0
396.0,17,2,410,1,78,0.0,78.0,78.0,1,332,0.0,332.0,332.0
344.0,17,2,267,1,83,0.0,83.0,83.0,1,184,0.0,184.0,184.0
109730490.0,6,28,1860,14,966,8424204.76923077,123.0,69.0,14,894,8424204.923076924,123.0,63.85714285714285
213680.0,17,2,414,1,88,0.0,88.0,88.0,1,326,0.0,326.0,326.0
217133.0,17,2,180,1,90,0.0,90.0,90.0,1,90,0.0,90.0,90.0
750801.0,6,2,132,1,66,0.0,66.0,66.0,1,66,0.0,66.0,66.0
235690.0,6,3,337,2,214,0.0,160.0,107.0,1,123,0.0,123.0,123.0
346.0,17,2,168,1,76,0.0,76.0,76.0,1,92,0.0,92.0,92.0
736616.0,6,11,1131,6,600,147035.6,262.0,100.0,5,531,183650.0,259.0,106.2
90369277.0,6,13,2052,6,1224,18073619.8,204.0,204.0,7,828,15016670.0,188.0,118.28571428571428
13610428.0,6,20,1607,10,975,1478640.6666666667,315.0,97.5,10,632,1478750.6666666667,78.0,63.2
146181.0,6,3,373,2,238,0.0,172.0,119.0,1,135,0.0,135.0,135.0
90534213.0,6,30,2392,16,1291,6035614.2,139.0,80.6875,14,1101,6947526.615384615,123.0,78.64285714285714
303332.0,6,3,202,2,128,0.0,74.0,64.0,1,74,0.0,74.0,74.0
2081.0,17,4,344,2,150,0.0,75.0,75.0,2,194,0.0,103.0,97.0
297527.0,6,6,412,4,272,99175.66666666669,74.0,68.0,2,140,0.0,74.0,70.0
0.0,17,1,381,1,381,0.0,381.0,381.0,0,0,0.0,0.0,0.0
80090.0,17,2,286,2,286,0.0,143.0,143.0,0,0,0.0,0.0,0.0
305842.0,6,6,412,4,272,101947.33333333331,74.0,68.0,2,140,0.0,74.0,70.0
55853.0,6,10,2032,5,524,12690.75,252.0,104.8,5,1508,11920.25,1236.0,301.6
216285.0,17,2,180,1,90,0.0,90.0,90.0,1,90,0.0,90.0,90.0
124001062.0,17,15,1169,8,606,17714437.42857143,174.0,75.75,7,563,17331117.333333332,174.0,80.42857142857143
111383929.0,6,211,23802,106,16576,1060799.3238095238,284.0,156.37735849056602,105,7226,1060920.8942307692,140.0,68.81904761904762
1023433.0,6,11,1134,6,558,204686.60000000003,220.0,93.0,5,576,255165.25,304.0,115.2
863299.0,6,9,1096,6,625,172659.8,287.0,104.16666666666669,3,471,293886.0,331.0,157.0
205866.0,17,2,180,1,90,0.0,90.0,90.0,1,90,0.0,90.0,90.0
25139.0,6,14,4740,7,653,3973.8333333333335,249.0,93.28571428571428,7,4087,3978.1666666666665,1514.0,583.8571428571429
4492.0,17,2,626,1,72,0.0,72.0,72.0,1,554,0.0,554.0,554.0
133701.0,17,2,286,2,286,0.0,143.0,143.0,0,0,0.0,0.0,0.0
102900.0,17,2,286,2,286,0.0,143.0,143.0,0,0,0.0,0.0,0.0
104919041.0,6,43,2838,22,1452,4996132.285714285,66.0,66.0,21,1386,5159997.0,66.0,66.0
305841.0,6,6,412,4,272,101947.0,74.0,68.0,2,140,0.0,74.0,70.0
3323534.0,6,172,142429,99,133309,33913.61224489796,1510.0,1346.5555555555557,73,9120,41910.80555555556,1510.0,124.93150684931508
247601.0,6,3,337,2,214,0.0,160.0,107.0,1,123,0.0,123.0,123.0
46449.0,6,14,4740,7,653,7095.833333333333,249.0,93.28571428571428,7,4087,5779.5,1514.0,583.8571428571429
120540195.0,6,231,26256,116,18444,1048175.6086956522,374.0,159.0,115,7812,1048266.5789473684,140.0,67.9304347826087
90094553.0,6,10,1440,7,828,15015758.833333334,188.0,118.28571428571428,3,612,30031262.5,204.0,204.0
307735.0,6,6,412,4,272,102578.33333333331,74.0,68.0,2,140,0.0,74.0,70.0
39905.0,6,14,4740,7,653,6525.0,249.0,93.28571428571428,7,4087,6160.166666666667,1514.0,583.8571428571429
17905.0,6,14,4740,7,653,2714.1666666666665,249.0,93.28571428571428,7,4087,2363.1666666666665,1514.0,583.8571428571429
253977.0,6,10,1221,6,636,50795.4,298.0,106.0,4,585,83642.33333333333,379.0,146.25
1319598.0,17,7,490,7,490,219933.0,70.0,70.0,0,0,0.0,0.0,0.0
31757.0,6,14,4740,7,653,5166.333333333333,249.0,93.28571428571428,7,4087,5143.333333333333,1514.0,583.8571428571429
124770983.0,6,30,1990,15,948,8198949.285714285,123.0,63.2,15,1042,8198966.142857143,139.0,69.46666666666667
146204.0,6,3,337,2,214,0.0,160.0,107.0,1,123,0.0,123.0,123.0
6539.0,17,4,344,2,150,0.0,75.0,75.0,2,194,0.0,103.0,97.0
103499.0,17,2,286,2,286,0.0,143.0,143.0,0,0,0.0,0.0,0.0
108106493.0,17,5,955,5,955,27026623.25,191.0,191.0,0,0,0.0,0.0,0.0
108109658.0,17,5,1005,5,1005,27027414.5,201.0,201.0,0,0,0.0,0.0,0.0
5623654.0,6,5,336,2,134,0.0,68.0,67.0,3,202,1415804.0,70.0,67.33333333333333
302366.0,6,2,132,1,66,0.0,66.0,66.0,1,66,0.0,66.0,66.0
233238.0,6,3,337,2,214,0.0,160.0,107.0,1,123,0.0,123.0,123.0
109248890.0,17,14,864,7,432,18167648.5,174.0,61.71428571428572,7,432,18166825.33333333,174.0,61.71428571428572
303107.0,6,6,412,4,272,101035.66666666669,74.0,68.0,2,140,0.0,74.0,70.0
512963.0,6,5,336,2,134,0.0,68.0,67.0,3,202,195036.5,70.0,67.33333333333333
2311.0,17,4,344,2,150,0.0,75.0,75.0,2,194,0.0,103.0,97.0
308908.0,6,6,412,4,272,102969.33333333331,74.0,68.0,2,140,0.0,74.0,70.0
108090312.0,17,5,1005,5,1005,27022578.0,201.0,201.0,0,0,0.0,0.0,0.0
223496.0,6,3,426,2,280,0.0,214.0,140.0,1,146,0.0,146.0,146.0
2332.0,17,4,344,2,150,0.0,75.0,75.0,2,194,0.0,103.0,97.0
308630.0,6,6,412,4,272,102876.66666666669,74.0,68.0,2,140,0.0,74.0,70.0
10873387.0,6,8,544,4,272,3578890.6666666665,74.0,68.0,4,272,3578815.0,74.0,68.0
27390447.0,17,5,1710,5,1710,6847611.75,342.0,342.0,0,0,0.0,0.0,0.0
46588973.0,6,8,1940,3,887,22145796.5,753.0,295.6666666666667,5,1053,11002753.75,785.0,210.6
113264833.0,6,46,3036,23,1518,5135895.2727272725,66.0,66.0,23,1518,5135891.0,66.0,66.0
216904.0,6,3,426,2,280,0.0,214.0,140.0,1,146,0.0,146.0,146.0
109251.0,17,2,286,2,286,0.0,143.0,143.0,0,0,0.0,0.0,0.0
115547261.0,6,226,25534,113,17780,1031671.9732142856,284.0,157.34513274336285,113,7754,1029609.5982142856,140.0,68.61946902654867
299807.0,6,6,412,4,272,99935.66666666669,74.0,68.0,2,140,0.0,74.0,70.0
257585.0,6,10,1221,6,636,51517.0,298.0,106.0,4,585,80315.66666666667,379.0,146.25
5590.0,17,2,180,1,90,0.0,90.0,90.0,1,90,0.0,90.0,90.0
295.0,17,2,156,1,78,0.0,78.0,78.0,1,78,0.0,78.0,78.0
146268.0,6,3,337,2,214,0.0,160.0,107.0,1,123,0.0,123.0,123.0
50817.0,6,10,2032,5,524,12403.0,252.0,104.8,5,1508,9639.0,1236.0,301.6
49477.0,6,14,4740,7,653,7984.666666666667,249.0,93.28571428571428,7,4087,7254.166666666667,1514.0,583.8571428571429
108105094.0,17,5,1005,5,1005,27026273.5,201.0,201.0,0,0,0.0,0.0,0.0
50905.0,17,2,180,1,90,0.0,90.0,90.0,1,90,0.0,90.0,90.0
436651.0,6,10,967,5,390,73110.25,162.0,78.0,5,577,73044.5,349.0,115.4
296.0,17,2,156,1,78,0.0,78.0,78.0,1,78,0.0,78.0,78.0
120299704.0,6,302,34808,151,10274,796558.4466666667,140.0,68.03973509933775,151,24534,799597.02,284.0,162.47682119205297
198315.0,17,4,6056,4,6056,66105.0,1514.0,1514.0,0,0,0.0,0.0,0.0
67950.0,6,14,4740,7,653,11200.333333333334,249.0,93.28571428571428,7,4087,9520.166666666666,1514.0,583.8571428571429
90951952.0,6,21,1585,11,840,9094633.0,95.0,76.36363636363636,10,745,10103984.0,95.0,74.5
108109692.0,17,5,955,5,955,27027423.0,191.0,191.0,0,0,0.0,0.0,0.0
217069.0,6,3,426,2,280,0.0,214.0,140.0,1,146,0.0,146.0,146.0
122181777.0,6,226,25656,113,7680,1064916.5892857143,140.0,67.96460176991151,113,17976,1075277.669642857,374.0,159.0796460176991
90292160.0,6,16,1192,8,596,12892343.857142856,95.0,74.5,8,596,12897270.42857143,95.0,74.5
834145.0,6,9,1118,6,586,166829.0,248.0,97.66666666666669,3,532,280774.5,392.0,177.33333333333334
90009607.0,17,28,13364,28,13364,3333689.1481481483,501.0,477.2857142857143,0,0,0.0,0.0,0.0
788.0,17,4,438,2,148,0.0,74.0,74.0,2,290,0.0,147.0,145.0
142608.0,6,2,132,1,66,0.0,66.0,66.0,1,66,0.0,66.0,66.0
91573.0,17,2,286,2,286,0.0,143.0,143.0,0,0,0.0,0.0,0.0
16784.0,6,11,1132,6,556,3356.8,218.0,92.66666666666669,5,576,2789.0,304.0,115.2
90528097.0,6,15,2168,8,1016,12932585.285714284,188.0,127.0,7,1152,15054669.166666666,204.0,164.57142857142858
1321880.0,6,4,264,2,132,0.0,66.0,66.0,2,132,0.0,66.0,66.0
290117.0,17,2,180,1,90,0.0,90.0,90.0,1,90,0.0,90.0,90.0
297494.0,6,6,412,4,272,99164.66666666669,74.0,68.0,2,140,0.0,74.0,70.0
1168.0,17,4,438,2,148,0.0,74.0,74.0,2,290,0.0,147.0,145.0
228225.0,17,2,180,1,90,0.0,90.0,90.0,1,90,0.0,90.0,90.0
1428347.0,17,16,1120,16,1120,95223.13333333332,70.0,70.0,0,0,0.0,0.0,0.0
55382.0,6,14,4740,7,653,8971.5,249.0,93.28571428571428,7,4087,8116.166666666667,1514.0,583.8571428571429
15154.0,6,10,2032,5,524,3509.75,252.0,104.8,5,1508,3511.0,1236.0,301.6
105005227.0,17,13,821,7,432,17500871.166666668,174.0,61.71428571428572,6,389,17000169.8,174.0,64.83333333333333
91691796.0,6,25,1924,14,1084,7048939.538461538,95.0,77.42857142857143,11,840,9140335.6,95.0,76.36363636363636
2125579.0,6,24,7544,12,2450,193234.45454545456,1034.0,204.16666666666663,12,5094,165415.45454545456,1510.0,424.5
40713.0,6,10,2032,5,524,9972.0,252.0,104.8,5,1508,9819.0,1236.0,301.6
120121614.0,6,13,2020,9,1204,15015201.75,188.0,133.77777777777777,4,816,30030719.666666668,204.0,204.0
120998567.0,17,15,907,8,475,17285509.57142857,174.0,59.375,7,432,16833540.5,174.0,61.71428571428572
234142.0,6,3,337,2,214,0.0,160.0,107.0,1,123,0.0,123.0,123.0
221647.0,6,3,426,2,280,0.0,214.0,140.0,1,146,0.0,146.0,146.0
91364931.0,6,28,1992,14,1029,7011469.538461538,123.0,73.5,14,963,7011472.538461538,123.0,68.78571428571429
817.0,17,4,438,2,148,0.0,74.0,74.0,2,290,0.0,147.0,145.0
211251.0,17,2,180,1,90,0.0,90.0,90.0,1,90,0.0,90.0,90.0
91772766.0,17,16,5472,16,5472,6118184.4,342.0,342.0,0,0,0.0,0.0,0.0
40986.0,6,2,132,1,66,0.0,66.0,66.0,1,66,0.0,66.0,66.0
303421.0,6,6,412,4,272,101140.33333333331,74.0,68.0,2,140,0.0,74.0,70.0
10475022.0,6,7,478,4,272,3446034.333333333,74.0,68.0,3,206,5168905.5,74.0,68.66666666666667
90049557.0,17,28,13364,28,13364,3335168.777777778,501.0,477.2857142857143,0,0,0.0,0.0,0.0
90322649.0,6,25,1692,13,906,7526887.416666667,123.0,69.6923076923077,12,786,7283822.0,123.0,65.5
2913984.0,6,3,1604,1,753,0.0,753.0,753.0,2,851,0.0,785.0,425.5
102473.0,17,2,762,2,762,0.0,381.0,381.0,0,0,0.0,0.0,0.0
222514.0,6,3,426,2,280,0.0,214.0,140.0,1,146,0.0,146.0,146.0
48634545.0,6,8,2113,3,960,22873752.0,826.0,320.0,5,1153,11464047.75,885.0,230.6
54524.0,6,13,1394,7,797,8292.833333333334,253.0,113.85714285714286,6,597,10001.6,259.0,99.5
3369797.0,6,18,1495,9,921,383820.125,315.0,102.33333333333331,9,574,383783.375,78.0,63.77777777777778
13776.0,6,10,1067,5,536,3123.25,264.0,107.2,5,531,3051.0,259.0,106.2
329.0,17,2,166,1,75,0.0,75.0,75.0,1,91,0.0,91.0,91.0
106183412.0,17,14,864,7,432,17667602.833333332,174.0,61.71428571428572,7,432,17666852.166666668,174.0,61.71428571428572
108108988.0,17,5,955,5,955,27027247.0,191.0,191.0,0,0,0.0,0.0,0.0
107570.0,6,14,4740,7,653,17370.5,249.0,93.28571428571428,7,4087,15904.0,1514.0,583.8571428571429
97.0,17,2,762,2,762,0.0,381.0,381.0,0,0,0.0,0.0,0.0
90023024.0,17,28,13364,28,13364,3334186.074074074,501.0,477.2857142857143,0,0,0.0,0.0,0.0
324300.0,17,4,1400,4,1400,108100.0,350.0,350.0,0,0,0.0,0.0,0.0
104834140.0,17,14,4788,14,4788,8064164.615384615,342.0,342.0,0,0,0.0,0.0,0.0
60491.0,6,14,4740,7,653,9932.5,249.0,93.28571428571428,7,4087,9652.5,1514.0,583.8571428571429
3156.0,17,2,224,1,76,0.0,76.0,76.0,1,148,0.0,148.0,148.0
37798.0,6,12,1413,7,882,6299.666666666667,291.0,126.0,5,531,7967.5,259.0,106.2
114530104.0,6,224,25184,112,17496,1029864.3243243244,284.0,156.21428571428572,112,7688,1029863.2432432432,140.0,68.64285714285714
322403.0,17,4,1400,4,1400,107467.66666666669,350.0,350.0,0,0,0.0,0.0,0.0
0.0,17,1,72,1,72,0.0,72.0,72.0,0,0,0.0,0.0,0.0
153482.0,17,2,180,1,90,0.0,90.0,90.0,1,90,0.0,90.0,90.0
3493.0,17,4,407,2,144,0.0,72.0,72.0,2,263,0.0,136.0,131.5
113520246.0,6,46,3036,23,1518,5159999.818181818,66.0,66.0,23,1518,5159999.818181818,66.0,66.0
2373603.0,6,49,23728,25,19797,98900.125,1514.0,791.88,24,3931,93427.30434782608,1514.0,163.79166666666666
201611.0,17,2,180,1,90,0.0,90.0,90.0,1,90,0.0,90.0,90.0
318.0,17,2,174,1,79,0.0,79.0,79.0,1,95,0.0,95.0,95.0
90254268.0,6,16,2368,9,1204,11281783.5,188.0,133.77777777777777,7,1164,15015425.333333334,204.0,166.28571428571428
67278.0,6,10,2032,5,524,16029.25,252.0,104.8,5,1508,12530.75,1236.0,301.6
212771.0,6,3,426,2,280,0.0,214.0,140.0,1,146,0.0,146.0,146.0
72179.0,6,14,4740,7,653,11631.833333333334,249.0,93.28571428571428,7,4087,11537.166666666666,1514.0,583.8571428571429
42242.0,6,14,4740,7,653,6877.0,249.0,93.28571428571428,7,4087,6829.833333333333,1514.0,583.8571428571429
108105802.0,17,5,1005,5,1005,27026450.5,201.0,201.0,0,0,0.0,0.0,0.0
33705121.0,6,5,336,2,134,0.0,68.0,67.0,3,202,15462100.5,70.0,67.33333333333333
113618984.0,6,46,3036,23,1518,5150442.636363637,66.0,66.0,23,1518,5150444.5,66.0,66.0
113826517.0,6,48,3168,24,1584,4948979.0,66.0,66.0,24,1584,4935650.652173913,66.0,66.0
43189.0,6,14,4740,7,653,6461.333333333333,249.0,93.28571428571428,7,4087,6753.666666666667,1514.0,583.8571428571429
105337.0,17,2,286,2,286,0.0,143.0,143.0,0,0,0.0,0.0,0.0
326.0,17,2,166,1,75,0.0,75.0,75.0,1,91,0.0,91.0,91.0
103305.0,17,2,286,2,286,0.0,143.0,143.0,0,0,0.0,0.0,0.0
146372.0,6,3,337,2,214,0.0,160.0,107.0,1,123,0.0,123.0,123.0
228557.0,6,3,426,2,280,0.0,214.0,140.0,1,146,0.0,146.0,146.0
3179335.0,6,18,1495,9,921,358424.5,315.0,102.33333333333331,9,574,358395.875,78.0,63.77777777777778
59228.0,6,14,4740,7,653,9485.5,249.0,93.28571428571428,7,4087,9358.0,1514.0,583.8571428571429
228468.0,17,2,180,1,90,0.0,90.0,90.0,1,90,0.0,90.0,90.0
92113721.0,6,38,2508,19,1254,5105434.0,66.0,66.0,19,1254,5105437.333333333,66.0,66.0
9243.0,17,4,823,2,163,0.0,89.0,81.5,2,660,0.0,443.0,330.0
90258384.0,6,14,2240,8,1016,12894054.857142856,188.0,127.0,6,1224,18018669.8,204.0,204.0
146295.0,6,3,337,2,214,0.0,160.0,107.0,1,123,0.0,123.0,123.0
207148.0,6,3,426,2,280,0.0,214.0,140.0,1,146,0.0,146.0,146.0
375891.0,6,12,1373,7,714,62648.5,298.0,102.0,5,659,92839.25,379.0,131.8
143990.0,17,2,180,1,90,0.0,90.0,90.0,1,90,0.0,90.0,90.0
108114620.0,17,5,1005,5,1005,27028655.0,201.0,201.0,0,0,0.0,0.0,0.0
107871818.0,6,44,2904,22,1452,5136753.238095238,66.0,66.0,22,1452,5122284.333333333,66.0,66.0
93178289.0,6,27,1938,14,1029,7167560.692307692,123.0,73.5,13,909,7746831.25,123.0,69.92307692307692
75091062.0,6,9,842,9,842,9386382.75,97.0,93.55555555555556,0,0,0.0,0.0,0.0
0.0,6,1,172,1,172,0.0,172.0,172.0,0,0,0.0,0.0,0.0
6754.0,17,2,582,1,83,0.0,83.0,83.0,1,499,0.0,499.0,499.0
315.0,17,2,174,1,79,0.0,79.0,79.0,1,95,0.0,95.0,95.0
47390.0,6,14,4740,7,653,7482.333333333333,249.0,93.28571428571428,7,4087,7582.333333333333,1514.0,583.8571428571429
13651865.0,6,19,1553,9,921,1667090.5,315.0,102.33333333333331,10,632,1481856.5555555555,78.0,63.2
123006845.0,17,15,907,8,475,17572406.42857143,174.0,59.375,7,432,17166865.5,174.0,61.71428571428572
64172.00000000001,6,14,4740,7,653,10047.166666666666,249.0,93.28571428571428,7,4087,10477.0,1514.0,583.8571428571429
131495.0,6,2,132,1,66,0.0,66.0,66.0,1,66,0.0,66.0,66.0
216429.0,17,2,331,1,75,0.0,75.0,75.0,1,256,0.0,256.0,256.0
37195.0,6,14,4740,7,653,5990.833333333333,249.0,93.28571428571428,7,4087,6028.833333333333,1514.0,583.8571428571429
120125984.0,6,14,2240,6,1224,24025196.8,204.0,204.0,8,1016,17137299.57142857,188.0,127.0
90221189.0,6,25,1924,11,840,8996693.1,95.0,76.36363636363636,14,1084,6923531.615384615,95.0,77.42857142857143
3370283.0,6,164,143809,102,135415,33369.13861386139,1510.0,1327.5980392156862,62,8394,50095.524590163935,1510.0,135.38709677419354
24614.0,6,10,2032,5,524,5865.5,252.0,104.8,5,1508,5869.25,1236.0,301.6
90296261.0,6,15,1097,8,596,12899465.857142856,95.0,74.5,7,501,14999268.5,95.0,71.57142857142857
235461.0,6,3,337,2,214,0.0,160.0,107.0,1,123,0.0,123.0,123.0
131889.0,17,4,1400,4,1400,43963.0,350.0,350.0,0,0,0.0,0.0,0.0
66106.0,6,14,4740,7,653,9617.666666666666,249.0,93.28571428571428,7,4087,5565.666666666667,1514.0,583.8571428571429
14962.0,6,11,2098,6,590,2879.4,252.0,98.33333333333331,5,1508,3490.5,1236.0,301.6
1680821.0,6,23,6509,12,1529,152801.9090909091,357.0,127.41666666666669,11,4980,137357.7,1510.0,452.7272727272728
108106833.0,17,5,1005,5,1005,27026708.25,201.0,201.0,0,0,0.0,0.0,0.0
108683844.0,6,32,2220,16,1149,7245589.6,123.0,71.8125,16,1071,7230748.933333334,123.0,66.9375
120008595.0,17,28,13364,28,13364,4444762.777777778,501.0,477.2857142857143,0,0,0.0,0.0,0.0
246352.0,6,3,337,2,214,0.0,160.0,107.0,1,123,0.0,123.0,123.0
100409353.0,17,12,516,6,258,20001305.6,43.0,43.0,6,258,20000161.4,43.0,43.0
113344196.0,6,46,3036,23,1518,5151996.636363637,66.0,66.0,23,1518,5151996.863636363,66.0,66.0
113309801.0,6,45,2970,23,1518,5150445.5,66.0,66.0,22,1452,4972157.952380952,66.0,66.0
47104.0,6,14,4740,7,653,7464.166666666667,249.0,93.28571428571428,7,4087,6814.666666666667,1514.0,583.8571428571429
136001134.0,17,15,907,8,475,19428733.42857143,174.0,59.375,7,432,19334506.5,174.0,61.71428571428572
3451515.0,6,230,177353,121,165856,28762.625,1510.0,1370.7107438016528,109,11497,29130.175925925927,1510.0,105.4770642201835
41396.0,6,14,4740,7,653,6540.833333333333,249.0,93.28571428571428,7,4087,6350.5,1514.0,583.8571428571429
309058.0,17,4,1400,4,1400,103019.33333333331,350.0,350.0,0,0,0.0,0.0,0.0
2390.0,17,4,344,2,150,0.0,75.0,75.0,2,194,0.0,103.0,97.0
90256811.0,6,13,2036,8,1016,12893830.142857144,188.0,127.0,5,1020,22523211.75,204.0,204.0
196903.0,17,2,180,1,90,0.0,90.0,90.0,1,90,0.0,90.0,90.0
10496050.0,6,7,478,4,272,3453275.0,74.0,68.0,3,206,5179830.0,74.0,68.66666666666667
111015526.0,6,32,2236,16,1165,7386659.0,139.0,72.8125,16,1071,7386658.466666667,123.0,66.9375
24520.0,17,2,582,1,83,0.0,83.0,83.0,1,499,0.0,499.0,499.0
2198442.0,6,23,7478,12,2450,199858.36363636365,1034.0,204.16666666666663,11,5028,187824.1,1510.0,457.09090909090907
21165.0,6,14,4740,7,653,2988.333333333333,249.0,93.28571428571428,7,4087,3391.833333333333,1514.0,583.8571428571429
233307.0,6,3,337,2,214,0.0,160.0,107.0,1,123,0.0,123.0,123.0
8532.0,6,10,2032,5,524,1887.0,252.0,104.8,5,1508,1832.5,1236.0,301.6
5624658.0,6,4,270,2,134,0.0,68.0,67.0,2,136,0.0,70.0,68.0
503283.00000000006,6,5,336,2,134,0.0,68.0,67.0,3,202,194240.5,70.0,67.33333333333333
135126577.0,17,6,1146,6,1146,27025315.4,191.0,191.0,0,0,0.0,0.0,0.0
297904.0,6,6,412,4,272,99301.33333333331,74.0,68.0,2,140,0.0,74.0,70.0
482498.0,17,2,363,1,79,0.0,79.0,79.0,1,284,0.0,284.0,284.0
120505210.0,6,457,59024,229,43680,528531.6228070175,480.0,190.74235807860265,228,15344,526337.9251101322,140.0,67.29824561403508
108101151.0,17,5,1005,5,1005,27025287.75,201.0,201.0,0,0,0.0,0.0,0.0
108100928.0,17,5,1005,5,1005,27025232.0,201.0,201.0,0,0,0.0,0.0,0.0
115428453.0,6,48,3168,24,1584,5018628.391304348,66.0,66.0,24,1584,5009232.0869565215,66.0,66.0
247709.0,6,3,373,2,238,0.0,172.0,119.0,1,135,0.0,135.0,135.0
426.0,17,2,410,1,78,0.0,78.0,78.0,1,332,0.0,332.0,332.0
135122809.0,17,6,1206,6,1206,27024561.8,201.0,201.0,0,0,0.0,0.0,0.0
32412.000000000004,6,14,4740,7,653,5012.833333333333,249.0,93.28571428571428,7,4087,4993.5,1514.0,583.8571428571429
96255314.0,17,12,778,6,389,19200793.2,174.0,64.83333333333333,6,389,19200191.2,174.0,64.83333333333333
108726230.0,6,32,2220,16,1149,7234038.066666666,123.0,71.8125,16,1071,7234032.733333333,123.0,66.9375
90303724.0,6,21,1585,11,840,9024712.6,95.0,76.36363636363636,10,745,10001087.666666666,95.0,74.5
108107188.0,17,5,1005,5,1005,27026797.0,201.0,201.0,0,0,0.0,0.0,0.0
104863313.0,17,14,4788,14,4788,8066408.692307692,342.0,342.0,0,0,0.0,0.0,0.0
66275.0,6,14,4740,7,653,10607.0,249.0,93.28571428571428,7,4087,9982.5,1514.0,583.8571428571429
108105044.0,17,5,955,5,955,27026261.0,191.0,191.0,0,0,0.0,0.0,0.0
25362.0,6,10,2032,5,524,6124.25,252.0,104.8,5,1508,4823.5,1236.0,301.6
99859752.0,17,12,778,6,389,19941121.4,174.0,64.83333333333333,6,389,19940169.4,174.0,64.83333333333333
2799742.0,6,2,132,1,66,0.0,66.0,66.0,1,66,0.0,66.0,66.0
252723.0,6,3,337,2,214,0.0,160.0,107.0,1,123,0.0,123.0,123.0
108106944.0,17,5,1005,5,1005,27026736.0,201.0,201.0,0,0,0.0,0.0,0.0
4086.0,17,4,704,2,148,0.0,74.0,74.0,2,556,0.0,280.0,278.0
146224.0,6,3,337,2,214,0.0,160.0,107.0,1,123,0.0,123.0,123.0
303182.0,6,2,132,1,66,0.0,66.0,66.0,1,66,0.0,66.0,66.0
346.0,17,2,250,1,93,0.0,93.0,93.0,1,157,0.0,157.0,157.0
345.0,17,2,267,1,83,0.0,83.0,83.0,1,184,0.0,184.0,184.0
215760.0,17,2,180,1,90,0.0,90.0,90.0,1,90,0.0,90.0,90.0
110493961.0,6,32,2236,16,1165,7351876.466666667,139.0,72.8125,16,1071,7351874.333333333,123.0,66.9375
34399.0,6,14,4740,7,653,5239.5,249.0,93.28571428571428,7,4087,5442.0,1514.0,583.8571428571429
220099.0,6,3,426,2,280,0.0,214.0,140.0,1,146,0.0,146.0,146.0
123839964.0,6,49,3234,25,1650,5159998.5,66.0,66.0,24,1584,4936997.173913044,66.0,66.0
244519.0,6,3,337,2,214,0.0,160.0,107.0,1,123,0.0,123.0,123.0
9640.0,17,2,539,1,86,0.0,86.0,86.0,1,453,0.0,453.0,453.0
243829.0,6,10,1221,6,636,48765.8,298.0,106.0,4,585,79624.0,379.0,146.25
103275.0,17,2,286,2,286,0.0,143.0,143.0,0,0,0.0,0.0,0.0
32231.000000000004,6,14,4740,7,653,5156.5,249.0,93.28571428571428,7,4087,5036.333333333333,1514.0,583.8571428571429
110957771.0,6,32,2236,16,1165,7382776.466666667,139.0,72.8125,16,1071,7382795.2,123.0,66.9375
120301724.0,6,47,3102,23,1518,5155443.454545454,66.0,66.0,24,1584,5216939.304347826,66.0,66.0
404289.0,6,4,508,2,238,0.0,172.0,119.0,2,270,0.0,135.0,135.0
351.0,17,2,267,1,83,0.0,83.0,83.0,1,184,0.0,184.0,184.0
239980.0,6,3,337,2,214,0.0,160.0,107.0,1,123,0.0,123.0,123.0
1321632.0,6,4,264,2,132,0.0,66.0,66.0,2,132,0.0,66.0,66.0
203286.0,17,2,762,2,762,0.0,381.0,381.0,0,0,0.0,0.0,0.0
207156.0,6,3,426,2,280,0.0,214.0,140.0,1,146,0.0,146.0,146.0
308391.0,17,2,180,1,90,0.0,90.0,90.0,1,90,0.0,90.0,90.0
108103606.0,17,5,955,5,955,27025901.5,191.0,191.0,0,0,0.0,0.0,0.0
102523.0,17,2,762,2,762,0.0,381.0,381.0,0,0,0.0,0.0,0.0
108089954.0,17,5,955,5,955,27022488.5,191.0,191.0,0,0,0.0,0.0,0.0
90027006.0,17,28,13364,28,13364,3334333.5555555555,501.0,477.2857142857143,0,0,0.0,0.0,0.0
9993.0,17,2,582,1,83,0.0,83.0,83.0,1,499,0.0,499.0,499.0
135513.0,6,3,337,2,214,0.0,160.0,107.0,1,123,0.0,123.0,123.0
91980174.0,6,186,20998,93,14638,997445.7282608696,284.0,157.3978494623656,93,6360,997445.6304347826,140.0,68.38709677419355
206333.0,6,3,426,2,280,0.0,214.0,140.0,1,146,0.0,146.0,146.0
143899.0,17,2,180,1,90,0.0,90.0,90.0,1,90,0.0,90.0,90.0
2850603.0,6,3,204,2,136,0.0,70.0,68.0,1,68,0.0,68.0,68.0
90261042.0,6,12,1832,8,1016,12894434.57142857,188.0,127.0,4,816,30032137.0,204.0,204.0
214711.0,6,12,1373,7,714,35785.166666666664,298.0,102.0,5,659,52884.75,379.0,131.8
38466.0,6,14,4740,7,653,6288.833333333333,249.0,93.28571428571428,7,4087,5583.666666666667,1514.0,583.8571428571429
125811040.0,6,54,11635,29,6018,3432170.285714286,1514.0,207.51724137931035,25,5617,5233595.75,1514.0,224.68
303629.0,6,2,132,1,66,0.0,66.0,66.0,1,66,0.0,66.0,66.0
139722.0,17,4,1400,4,1400,46574.0,350.0,350.0,0,0,0.0,0.0,0.0
90280658.0,6,12,1832,8,1016,12897236.857142856,188.0,127.0,4,816,30039293.33333333,204.0,204.0
208928.0,6,3,426,2,280,0.0,214.0,140.0,1,146,0.0,146.0,146.0
317089.0,17,4,622,4,622,105696.33333333331,163.0,155.5,0,0,0.0,0.0,0.0
153391.0,17,2,180,1,90,0.0,90.0,90.0,1,90,0.0,90.0,90.0
34522.0,6,14,4740,7,653,5142.5,249.0,93.28571428571428,7,4087,5602.166666666667,1514.0,583.8571428571429
220872.0,6,3,426,2,280,0.0,214.0,140.0,1,146,0.0,146.0,146.0
59567.0,6,14,4740,7,653,8937.166666666666,249.0,93.28571428571428,7,4087,7815.166666666667,1514.0,583.8571428571429
52621.0,6,10,2032,5,524,12660.25,252.0,104.8,5,1508,11734.5,1236.0,301.6
324.0,17,2,166,1,75,0.0,75.0,75.0,1,91,0.0,91.0,91.0
3049972.0,6,3,204,1,68,0.0,68.0,68.0,2,136,0.0,70.0,68.0
3111.0,17,2,224,1,76,0.0,76.0,76.0,1,148,0.0,148.0,148.0
120120653.0,6,13,2020,9,1204,15015081.625,188.0,133.77777777777777,4,816,30030047.33333333,204.0,204.0
322798.0,17,4,1400,4,1400,107599.33333333331,350.0,350.0,0,0,0.0,0.0,0.0
111922617.0,17,13,821,7,432,18500962.166666668,174.0,61.71428571428572,6,389,20107297.8,174.0,64.83333333333333
234061.0,6,10,1221,6,636,46812.2,298.0,106.0,4,585,77112.0,379.0,146.25
306519.0,6,6,412,4,272,102173.0,74.0,68.0,2,140,0.0,74.0,70.0
222148.0,6,3,426,2,280,0.0,214.0,140.0,1,146,0.0,146.0,146.0
2394.0,17,6,1230,3,234,725.5,78.0,78.0,3,996,976.5,332.0,332.0
303265.0,6,6,412,4,272,101088.33333333331,74.0,68.0,2,140,0.0,74.0,70.0
229942.0,17,2,180,1,90,0.0,90.0,90.0,1,90,0.0,90.0,90.0
297506.0,6,6,412,4,272,99168.66666666669,74.0,68.0,2,140,0.0,74.0,70.0
54954.0,6,14,4740,7,653,8925.0,249.0,93.28571428571428,7,4087,6936.5,1514.0,583.8571428571429
316548.0,17,4,1400,4,1400,105516.0,350.0,350.0,0,0,0.0,0.0,0.0
129001106.0,17,15,907,8,475,18428729.42857143,174.0,59.375,7,432,18168615.666666668,174.0,61.71428571428572
119919.0,17,2,180,1,70,0.0,70.0,70.0,1,110,0.0,110.0,110.0
2318.0,17,4,344,2,150,0.0,75.0,75.0,2,194,0.0,103.0,97.0
4377.0,17,2,180,1,90,0.0,90.0,90.0,1,90,0.0,90.0,90.0
108104757.0,17,5,1005,5,1005,27026189.25,201.0,201.0,0,0,0.0,0.0,0.0
123688790.0,6,49,3234,24,1584,4943314.739130435,66.0,66.0,25,1650,5153688.583333333,66.0,66.0
108110143.0,17,5,1005,5,1005,27027535.75,201.0,201.0,0,0,0.0,0.0,0.0
211684.0,6,3,426,2,280,0.0,214.0,140.0,1,146,0.0,146.0,146.0
2599.0,17,4,344,2,150,0.0,75.0,75.0,2,194,0.0,103.0,97.0
105224920.0,6,44,2904,22,1452,5010710.476190476,66.0,66.0,22,1452,4996379.333333333,66.0,66.0
119863801.0,6,652,81492,326,21812,368370.1538461539,140.0,66.9079754601227,326,59680,368715.76615384617,374.0,183.06748466257667
13541.0,17,2,582,1,83,0.0,83.0,83.0,1,499,0.0,499.0,499.0
247117.0,17,2,180,1,90,0.0,90.0,90.0,1,90,0.0,90.0,90.0
120072068.0,17,29,13785,29,13785,4288288.142857143,501.0,475.3448275862069,0,0,0.0,0.0,0.0
2302.0,17,4,344,2,150,0.0,75.0,75.0,2,194,0.0,103.0,97.0
1039230.0,6,11,1134,6,558,207846.0,220.0,93.0,5,576,258656.0,304.0,115.2
506901.00000000006,6,5,336,2,134,0.0,68.0,67.0,3,202,193981.0,70.0,67.33333333333333
90037921.0,17,27,12943,27,12943,3462996.961538461,501.0,479.3703703703704,0,0,0.0,0.0,0.0
207251.0,6,3,426,2,280,0.0,214.0,140.0,1,146,0.0,146.0,146.0
153487.0,17,2,180,1,90,0.0,90.0,90.0,1,90,0.0,90.0,90.0
302.0,17,2,174,1,79,0.0,79.0,79.0,1,95,0.0,95.0,95.0
111931372.0,6,500,79820,250,16796,448067.1325301205,214.0,67.184,250,63024,446179.7269076305,1514.0,252.096
108109881.0,17,5,955,5,955,27027470.25,191.0,191.0,0,0,0.0,0.0,0.0
90032631.0,17,28,13364,28,13364,3334541.888888889,501.0,477.2857142857143,0,0,0.0,0.0,0.0
90261094.0,6,14,2240,8,1016,12894442.0,188.0,127.0,6,1224,18019357.2,204.0,204.0
773.0,17,4,438,2,148,0.0,74.0,74.0,2,290,0.0,147.0,145.0
599638.0,17,3,551,2,156,0.0,78.0,78.0,1,395,0.0,395.0,395.0
319828.0,17,4,1400,4,1400,106609.33333333331,350.0,350.0,0,0,0.0,0.0,0.0
103301650.0,6,202,23118,101,16230,1030865.57,284.0,160.69306930693068,101,6888,1030746.53,140.0,68.1980198019802
43142.0,6,14,4740,7,653,7026.833333333333,249.0,93.28571428571428,7,4087,6987.166666666667,1514.0,583.8571428571429
52514.0,6,14,4740,7,653,8541.5,249.0,93.28571428571428,7,4087,6063.333333333333,1514.0,583.8571428571429
3058100.0,6,3,204,2,136,0.0,70.0,68.0,1,68,0.0,68.0,68.0
140031.0,6,2,132,1,66,0.0,66.0,66.0,1,66,0.0,66.0,66.0
441973.0,6,10,967,5,390,74503.0,162.0,78.0,5,577,74437.5,349.0,115.4
205004.0,17,2,762,2,762,0.0,381.0,381.0,0,0,0.0,0.0,0.0
415.0,17,2,410,1,78,0.0,78.0,78.0,1,332,0.0,332.0,332.0
84999.0,6,14,4740,7,653,13014.666666666666,249.0,93.28571428571428,7,4087,13468.0,1514.0,583.8571428571429
37331.0,6,10,2032,5,524,8295.0,252.0,104.8,5,1508,8891.25,1236.0,301.6
2303.0,17,4,344,2,150,0.0,75.0,75.0,2,194,0.0,103.0,97.0
24195.0,6,10,2032,5,524,5259.0,252.0,104.8,5,1508,5720.5,1236.0,301.6
1055676.0,6,11,1134,6,558,211135.2,220.0,93.0,5,576,261546.5,304.0,115.2
147924.0,17,2,180,1,90,0.0,90.0,90.0,1,90,0.0,90.0,90.0
26095.0,6,10,2032,5,524,6013.0,252.0,104.8,5,1508,6132.25,1236.0,301.6
90763463.0,6,19,1436,10,745,10080156.0,95.0,74.5,9,691,11345189.75,95.0,76.77777777777777
2494840.0,6,3,1777,2,951,0.0,885.0,475.5,1,826,0.0,826.0,826.0
146117.0,6,3,337,2,214,0.0,160.0,107.0,1,123,0.0,123.0,123.0
48480.0,6,10,2032,5,524,11891.5,252.0,104.8,5,1508,10271.5,1236.0,301.6
314429.0,17,4,1400,4,1400,104809.66666666669,350.0,350.0,0,0,0.0,0.0,0.0
44957.0,6,20,7606,11,978,4495.7,310.0,88.9090909090909,9,6628,5323.125,1514.0,736.4444444444445
120287560.0,6,231,26150,116,18264,1045978.7826086956,284.0,157.44827586206895,115,7886,1046034.254385965,140.0,68.57391304347826
205968.0,6,3,426,2,280,0.0,214.0,140.0,1,146,0.0,146.0,146.0
108111958.0,17,5,1005,5,1005,27027989.5,201.0,201.0,0,0,0.0,0.0,0.0
327006.0,6,6,412,4,272,109002.0,74.0,68.0,2,140,0.0,74.0,70.0
416.0,17,2,762,2,762,0.0,381.0,381.0,0,0,0.0,0.0,0.0
228237.0,17,2,180,1,90,0.0,90.0,90.0,1,90,0.0,90.0,90.0
90246233.0,6,15,2168,8,1016,12892319.0,188.0,127.0,7,1152,15013816.5,204.0,164.57142857142858
135449.0,6,14,4740,7,653,22428.5,249.0,93.28571428571428,7,4087,18884.0,1514.0,583.8571428571429
308784.0,6,6,412,4,272,102928.0,74.0,68.0,2,140,0.0,74.0,70.0
300123.0,6,6,412,4,272,100041.0,74.0,68.0,2,140,0.0,74.0,70.0
307477.0,6,6,412,4,272,102492.33333333331,74.0,68.0,2,140,0.0,74.0,70.0
2377846.0,6,49,23728,25,19797,99076.91666666669,1514.0,791.88,24,3931,93598.39130434782,1514.0,163.79166666666666
92766.0,6,13,1386,7,789,14314.0,253.0,112.71428571428572,6,597,15208.0,259.0,99.5
2055.0,17,2,180,1,90,0.0,90.0,90.0,1,90,0.0,90.0,90.0
359.0,17,2,267,1,83,0.0,83.0,83.0,1,184,0.0,184.0,184.0
146290.0,6,3,337,2,214,0.0,160.0,107.0,1,123,0.0,123.0,123.0
57213.0,6,14,4740,7,653,8925.833333333334,249.0,93.28571428571428,7,4087,8261.166666666666,1514.0,583.8571428571429
0.0,17,1,90,1,90,0.0,90.0,90.0,0,0,0.0,0.0,0.0
22152.0,17,2,180,1,90,0.0,90.0,90.0,1,90,0.0,90.0,90.0
205650.0,17,2,762,2,762,0.0,381.0,381.0,0,0,0.0,0.0,0.0
1309596.0,6,4,264,2,132,0.0,66.0,66.0,2,132,0.0,66.0,66.0
158345.0,6,3,337,2,214,0.0,160.0,107.0,1,123,0.0,123.0,123.0
112555720.0,6,209,23634,105,16548,1080297.5865384615,284.0,157.6,104,7086,1089142.844660194,140.0,68.13461538461539
117332922.0,6,48,3168,24,1584,5101431.391304348,66.0,66.0,24,1584,5092030.652173913,66.0,66.0
320288.0,17,4,1400,4,1400,106762.66666666669,350.0,350.0,0,0,0.0,0.0,0.0
90418629.0,17,12,778,6,389,18000174.8,174.0,64.83333333333333,6,389,18001288.0,174.0,64.83333333333333
90301146.0,6,17,1287,9,691,11281007.75,95.0,76.77777777777777,8,596,12899128.0,95.0,74.5
37134.0,6,14,4740,7,653,5990.5,249.0,93.28571428571428,7,4087,5521.333333333333,1514.0,583.8571428571429
120123645.0,6,14,2224,9,1204,15015455.625,188.0,133.77777777777777,5,1020,22523006.25,204.0,204.0
228534.0,17,2,180,1,90,0.0,90.0,90.0,1,90,0.0,90.0,90.0
216787.0,17,4,1524,4,1524,72262.33333333333,381.0,381.0,0,0,0.0,0.0,0.0
232402.0,6,3,337,2,214,0.0,160.0,107.0,1,123,0.0,123.0,123.0
90763313.0,6,17,1287,9,691,11339005.5,95.0,76.77777777777777,8,596,12965315.857142856,95.0,74.5
12933949.0,17,20,7552,20,7552,680734.1578947369,394.0,377.6,0,0,0.0,0.0,0.0
251204.0,6,3,337,2,214,0.0,160.0,107.0,1,123,0.0,123.0,123.0
100015029.0,17,12,778,6,389,20000874.6,174.0,64.83333333333333,6,389,20000164.4,174.0,64.83333333333333
41371.0,6,10,2032,5,524,10124.75,252.0,104.8,5,1508,9826.25,1236.0,301.6
204164.0,17,2,762,2,762,0.0,381.0,381.0,0,0,0.0,0.0,0.0
108113990.0,17,5,1005,5,1005,27028497.5,201.0,201.0,0,0,0.0,0.0,0.0
143945.0,17,2,180,1,90,0.0,90.0,90.0,1,90,0.0,90.0,90.0
25129.0,6,14,4740,7,653,3964.0,249.0,93.28571428571428,7,4087,3960.1666666666665,1514.0,583.8571428571429
2492.0,17,4,344,2,150,0.0,75.0,75.0,2,194,0.0,103.0,97.0
327.0,17,2,208,1,72,0.0,72.0,72.0,1,136,0.0,136.0,136.0
204413.0,17,2,762,2,762,0.0,381.0,381.0,0,0,0.0,0.0,0.0
3006011.0,6,12,2172,7,664,500917.0,252.0,94.85714285714286,5,1508,1919.75,1236.0,301.6
308611.0,6,6,412,4,272,102870.33333333331,74.0,68.0,2,140,0.0,74.0,70.0
1186947.0,6,13,3010,8,2382,169563.85714285713,1514.0,297.75,5,628,227931.75,331.0,125.6
90063841.0,17,28,13364,28,13364,3335697.814814815,501.0,477.2857142857143,0,0,0.0,0.0,0.0
341.0,17,2,160,1,80,0.0,80.0,80.0,1,80,0.0,80.0,80.0
313436.0,17,4,1400,4,1400,104478.66666666669,350.0,350.0,0,0,0.0,0.0,0.0
1854992.0,6,7,499,4,301,548155.6666666666,103.0,75.25,3,198,818712.0,66.0,66.0
421.0,17,2,166,1,75,0.0,75.0,75.0,1,91,0.0,91.0,91.0
95024887.0,6,189,21736,95,15310,1010903.0531914892,284.0,161.1578947368421,94,6426,1010438.1935483871,140.0,68.36170212765957
2417.0,17,4,344,2,150,0.0,75.0,75.0,2,194,0.0,103.0,97.0
232945.0,6,3,337,2,214,0.0,160.0,107.0,1,123,0.0,123.0,123.0
32433.0,6,14,4740,7,653,5293.5,249.0,93.28571428571428,7,4087,5265.666666666667,1514.0,583.8571428571429
31670.0,6,14,4740,7,653,4620.5,249.0,93.28571428571428,7,4087,5141.833333333333,1514.0,583.8571428571429
1303189.0,6,4,264,2,132,0.0,66.0,66.0,2,132,0.0,66.0,66.0
10453407.0,6,7,478,4,272,3439122.333333333,74.0,68.0,3,206,5158594.0,74.0,68.66666666666667
75135541.0,6,9,842,9,842,9391942.625,97.0,93.55555555555556,0,0,0.0,0.0,0.0
103773010.0,6,44,2904,22,1452,4941571.904761905,66.0,66.0,22,1452,4928603.238095238,66.0,66.0
226253.0,17,2,180,1,90,0.0,90.0,90.0,1,90,0.0,90.0,90.0
205525.0,6,12,1373,7,714,34254.166666666664,298.0,102.0,5,659,50591.0,379.0,131.8
47638.0,6,14,4740,7,653,7343.5,249.0,93.28571428571428,7,4087,7130.666666666667,1514.0,583.8571428571429
108104029.0,17,5,1005,5,1005,27026007.25,201.0,201.0,0,0,0.0,0.0,0.0
51433.0,6,20,7606,11,978,5143.3,310.0,88.9090909090909,9,6628,5895.75,1514.0,736.4444444444445
9358.0,17,2,539,1,86,0.0,86.0,86.0,1,453,0.0,453.0,453.0
68962.0,6,12,1362,6,731,13198.6,253.0,121.83333333333331,6,631,12282.8,293.0,105.16666666666669
356.0,17,2,214,1,75,0.0,75.0,75.0,1,139,0.0,139.0,139.0
10522283.0,6,7,478,4,272,3460380.333333333,74.0,68.0,3,206,5190483.5,74.0,68.66666666666667
205764.0,6,3,426,2,280,0.0,214.0,140.0,1,146,0.0,146.0,146.0
326723.0,6,3,202,2,128,0.0,74.0,64.0,1,74,0.0,74.0,74.0
0.0,17,1,90,1,90,0.0,90.0,90.0,0,0,0.0,0.0,0.0
91173059.0,17,11,735,6,389,18200877.6,174.0,64.83333333333333,5,346,18000197.0,174.0,69.2
90254774.0,6,14,2240,8,1016,12893539.142857144,188.0,127.0,6,1224,18017803.2,204.0,204.0
161139.0,6,2,128,1,74,0.0,74.0,74.0,1,54,0.0,54.0,54.0
95506045.0,6,26,1762,13,922,7940845.166666667,139.0,70.92307692307692,13,840,7940847.083333333,123.0,64.61538461538461
865918.0,6,9,1267,6,796,173183.6,458.0,132.66666666666666,3,471,295187.0,331.0,157.0
120312226.0,6,233,26372,117,18420,1037174.3620689656,284.0,157.43589743589743,116,7952,1037168.704347826,140.0,68.55172413793103
327.0,17,2,174,1,79,0.0,79.0,79.0,1,95,0.0,95.0,95.0
120019233.0,6,27,2073,15,1138,8572802.357142856,95.0,75.86666666666666,12,935,10869730.818181818,95.0,77.91666666666667
13992036.0,17,6,2052,6,2052,2798407.2,342.0,342.0,0,0,0.0,0.0,0.0
1211958.0,17,7,490,7,490,201993.0,70.0,70.0,0,0,0.0,0.0,0.0
1772433.0,6,2,132,1,66,0.0,66.0,66.0,1,66,0.0,66.0,66.0
104978032.0,17,15,5130,15,5130,7498430.857142857,342.0,342.0,0,0,0.0,0.0,0.0
4466.0,17,2,614,1,72,0.0,72.0,72.0,1,542,0.0,542.0,542.0
23537.0,6,10,2032,5,524,5640.75,252.0,104.8,5,1508,5077.25,1236.0,301.6
90093130.0,6,14,2256,7,1428,15015325.5,204.0,204.0,7,828,15015327.333333334,188.0,118.28571428571428
253411.0,6,3,373,2,238,0.0,172.0,119.0,1,135,0.0,135.0,135.0
2593711.0,6,2,132,1,66,0.0,66.0,66.0,1,66,0.0,66.0,66.0
27671.0,6,14,4740,7,653,4503.333333333333,249.0,93.28571428571428,7,4087,4443.5,1514.0,583.8571428571429
123328579.0,17,14,1126,7,563,17334703.5,174.0,80.42857142857143,7,563,17333494.666666668,174.0,80.42857142857143
4166.0,17,4,344,2,150,0.0,75.0,75.0,2,194,0.0,103.0,97.0
280612.0,17,2,363,1,79,0.0,79.0,79.0,1,284,0.0,284.0,284.0
211319.0,17,2,180,1,90,0.0,90.0,90.0,1,90,0.0,90.0,90.0
108103442.0,17,5,955,5,955,27025860.5,191.0,191.0,0,0,0.0,0.0,0.0
206664.0,17,2,180,1,90,0.0,90.0,90.0,1,90,0.0,90.0,90.0
18447.0,6,14,4740,7,653,2730.333333333333,249.0,93.28571428571428,7,4087,2935.0,1514.0,583.8571428571429
234210.0,6,3,337,2,214,0.0,160.0,107.0,1,123,0.0,123.0,123.0
2189.0,17,2,691,1,349,0.0,349.0,349.0,1,342,0.0,342.0,342.0
113643.0,17,2,286,2,286,0.0,143.0,143.0,0,0,0.0,0.0,0.0
96000977.0,17,13,1083,7,563,16000162.833333334,174.0,80.42857142857143,6,520,15201289.6,174.0,86.66666666666667
1957.0,17,4,344,2,150,0.0,75.0,75.0,2,194,0.0,103.0,97.0
114898088.0,6,30,1974,15,1026,8191586.857142857,123.0,68.4,15,948,8191580.357142857,123.0,63.2
287.0,17,2,164,1,82,0.0,82.0,82.0,1,82,0.0,82.0,82.0
42411.0,6,14,4740,7,653,6139.0,249.0,93.28571428571428,7,4087,5434.5,1514.0,583.8571428571429
284843.0,17,2,363,1,79,0.0,79.0,79.0,1,284,0.0,284.0,284.0
4947014.0,6,22,7083,13,1707,412251.1666666667,408.0,131.30769230769232,9,5376,575270.375,1514.0,597.3333333333334
117839263.0,6,48,3168,24,1584,5123446.217391305,66.0,66.0,24,1584,5109177.043478261,66.0,66.0
81.0,17,2,762,2,762,0.0,381.0,381.0,0,0,0.0,0.0,0.0
108713173.0,6,32,2236,16,1165,7247544.866666666,139.0,72.8125,16,1071,7233112.066666666,123.0,66.9375
146144.0,6,3,373,2,238,0.0,172.0,119.0,1,135,0.0,135.0,135.0
108105583.0,17,5,1005,5,1005,27026395.75,201.0,201.0,0,0,0.0,0.0,0.0
112464262.0,6,46,3036,23,1518,5112000.318181818,66.0,66.0,23,1518,5112000.136363637,66.0,66.0
123546878.0,17,14,864,7,432,17333514.0,174.0,61.71428571428572,7,432,17334238.5,174.0,61.71428571428572
311680.0,6,3,202,2,128,0.0,74.0,64.0,1,74,0.0,74.0,74.0
2271563.0,6,25,7065,13,2047,185030.0833333333,575.0,157.46153846153845,12,5018,178665.45454545456,1510.0,418.1666666666667
90095344.0,6,11,1644,4,816,30030997.33333333,204.0,204.0,7,828,15015494.333333334,188.0,118.28571428571428
237404.0,6,3,337,2,214,0.0,160.0,107.0,1,123,0.0,123.0,123.0
90739348.0,6,22,1680,12,894,8244526.454545454,95.0,74.5,10,786,10081460.555555556,95.0,78.6
17169.0,6,19,7540,11,978,1716.9,310.0,88.9090909090909,8,6562,2147.714285714286,1514.0,820.25
90262535.0,6,13,2036,8,1016,12894647.857142856,188.0,127.0,5,1020,22523932.75,204.0,204.0
2394.0,17,4,344,2,150,0.0,75.0,75.0,2,194,0.0,103.0,97.0
4627.0,17,2,614,1,72,0.0,72.0,72.0,1,542,0.0,542.0,542.0
321809.0,17,4,1400,4,1400,107269.66666666669,350.0,350.0,0,0,0.0,0.0,0.0
44037.0,6,14,4740,7,653,7177.166666666667,249.0,93.28571428571428,7,4087,6248.333333333333,1514.0,583.8571428571429
14422235.0,17,6,2052,6,2052,2884447.0,342.0,342.0,0,0,0.0,0.0,0.0
90256456.0,6,12,1832,8,1016,12893779.42857143,188.0,127.0,4,816,30028677.666666668,204.0,204.0
10440264.0,6,7,478,4,272,3434739.333333333,74.0,68.0,3,206,5152007.5,74.0,68.66666666666667
116545.0,6,18,6743,10,837,12949.444444444443,235.0,83.7,8,5906,14349.142857142857,1514.0,738.25
116816339.0,6,48,3168,24,1584,5078971.260869565,66.0,66.0,24,1584,5066993.521739131,66.0,66.0
33813.0,6,10,2032,5,524,8153.0,252.0,104.8,5,1508,8215.25,1236.0,301.6
100466.0,17,4,1400,4,1400,33488.666666666664,350.0,350.0,0,0,0.0,0.0,0.0
50940.0,6,14,4740,7,653,8203.833333333334,249.0,93.28571428571428,7,4087,7836.833333333333,1514.0,583.8571428571429
90254820.0,6,14,2240,8,1016,12893545.714285716,188.0,127.0,6,1224,18018401.4,204.0,204.0
312118.0,17,4,1400,4,1400,104039.33333333331,350.0,350.0,0,0,0.0,0.0,0.0
113520178.0,6,46,3036,23,1518,5159996.090909091,66.0,66.0,23,1518,5159996.409090909,66.0,66.0
146197.0,6,3,337,2,214,0.0,160.0,107.0,1,123,0.0,123.0,123.0
581770.0,17,4,629,3,234,202377.0,78.0,78.0,1,395,0.0,395.0,395.0
49679300.0,6,8,2113,3,960,23515007.5,826.0,320.0,5,1153,11724711.0,885.0,230.6
2802224.0,6,2,132,1,66,0.0,66.0,66.0,1,66,0.0,66.0,66.0
307667.0,17,4,1400,4,1400,102555.66666666669,350.0,350.0,0,0,0.0,0.0,0.0
303183.0,6,6,412,4,272,101061.0,74.0,68.0,2,140,0.0,74.0,70.0
220412.0,6,10,1221,6,636,44082.4,298.0,106.0,4,585,72100.33333333333,379.0,146.25
90255745.0,6,13,2036,8,1016,12893677.857142856,188.0,127.0,5,1020,22523117.25,204.0,204.0
1181765.0,6,11,1134,6,558,236353.0,220.0,93.0,5,576,291777.5,304.0,115.2
17681752.0,6,26,7627,14,3735,176343.15384615384,1514.0,266.7857142857143,12,3892,1588819.0909090908,1514.0,324.3333333333333
336.0,17,2,166,1,75,0.0,75.0,75.0,1,91,0.0,91.0,91.0
33490648.0,6,5,336,2,134,0.0,68.0,67.0,3,202,15442789.0,70.0,67.33333333333333
3143.0,17,2,224,1,76,0.0,76.0,76.0,1,148,0.0,148.0,148.0
10512935.0,6,7,478,4,272,3458784.0,74.0,68.0,3,206,5188058.0,74.0,68.66666666666667
106337.0,17,2,286,2,286,0.0,143.0,143.0,0,0,0.0,0.0,0.0
119922977.0,6,30,1974,15,1026,8550497.357142856,123.0,68.4,15,948,8550496.142857144,123.0,63.2
121553229.0,6,229,26054,114,7820,1051045.442477876,140.0,68.59649122807018,115,18234,1066225.6842105263,284.0,158.55652173913043
313786.0,17,4,1400,4,1400,104595.33333333331,350.0,350.0,0,0,0.0,0.0,0.0
298022.0,6,6,412,4,272,99340.66666666669,74.0,68.0,2,140,0.0,74.0,70.0
63107.0,6,14,4740,7,653,10159.5,249.0,93.28571428571428,7,4087,9764.5,1514.0,583.8571428571429
0.0,17,1,90,1,90,0.0,90.0,90.0,0,0,0.0,0.0,0.0
119575547.0,6,208,23568,104,16482,1158838.5533980583,284.0,158.48076923076923,104,7086,1158837.9417475727,140.0,68.13461538461539
120122764.0,6,17,2836,9,1204,15015345.5,188.0,133.77777777777777,8,1632,12915277.142857144,204.0,204.0
27522780.0,17,5,1710,5,1710,6880695.0,342.0,342.0,0,0,0.0,0.0,0.0
114271887.0,17,15,1169,8,606,16301684.857142856,174.0,75.75,7,563,18955304.0,174.0,80.42857142857143
29423.0,6,14,4740,7,653,4383.166666666667,249.0,93.28571428571428,7,4087,4376.5,1514.0,583.8571428571429
103850.0,17,2,700,2,700,0.0,350.0,350.0,0,0,0.0,0.0,0.0
357.0,17,2,267,1,83,0.0,83.0,83.0,1,184,0.0,184.0,184.0
300488.0,6,6,412,4,272,100162.66666666669,74.0,68.0,2,140,0.0,74.0,70.0
207113.0,6,3,426,2,280,0.0,214.0,140.0,1,146,0.0,146.0,146.0
90256753.0,6,12,1832,8,1016,12893821.857142856,188.0,127.0,4,816,30030123.0,204.0,204.0
0.0,6,1,66,1,66,0.0,66.0,66.0,0,0,0.0,0.0,0.0
29398.0,6,14,4740,7,653,4791.166666666667,249.0,93.28571428571428,7,4087,4589.0,1514.0,583.8571428571429
12241.0,6,10,1066,5,490,2608.75,218.0,98.0,5,576,2572.0,304.0,115.2
108107258.0,17,5,1005,5,1005,27026814.5,201.0,201.0,0,0,0.0,0.0,0.0
106947227.0,6,195,21936,98,6690,1102548.731958763,140.0,68.26530612244898,97,15246,1103961.65625,284.0,157.17525773195877
90282018.0,6,14,1043,7,542,15047003.0,95.0,77.42857142857143,7,501,14997525.0,95.0,71.57142857142857
6739.0,17,4,823,2,163,0.0,89.0,81.5,2,660,0.0,443.0,330.0
255574.00000000003,6,10,1221,6,636,51114.8,298.0,106.0,4,585,79314.66666666667,379.0,146.25
120011312.0,6,21,1585,11,840,12000000.0,95.0,76.36363636363636,10,745,13333391.555555556,95.0,74.5
79750.0,6,14,4740,7,653,12517.5,249.0,93.28571428571428,7,4087,13105.0,1514.0,583.8571428571429
103631.0,17,2,286,2,286,0.0,143.0,143.0,0,0,0.0,0.0,0.0
121153134.0,6,33,2434,18,1348,7126654.94117647,139.0,74.88888888888889,15,1086,7925172.928571428,123.0,72.4
6704.0,17,2,180,1,90,0.0,90.0,90.0,1,90,0.0,90.0,90.0
135137290.0,17,6,1146,6,1146,27027458.0,191.0,191.0,0,0,0.0,0.0,0.0
90430.0,17,2,762,2,762,0.0,381.0,381.0,0,0,0.0,0.0,0.0
306578.0,6,6,412,4,272,102192.66666666669,74.0,68.0,2,140,0.0,74.0,70.0
299155.0,6,6,412,4,272,99718.33333333331,74.0,68.0,2,140,0.0,74.0,70.0
90280622.0,6,13,2036,8,1016,12897231.714285716,188.0,127.0,5,1020,22523988.75,204.0,204.0
122358.0,6,3,373,2,238,0.0,172.0,119.0,1,135,0.0,135.0,135.0
119912030.0,17,35,16705,35,16705,3526824.411764706,501.0,477.2857142857143,0,0,0.0,0.0,0.0
9101.0,17,2,498,1,80,0.0,80.0,80.0,1,418,0.0,418.0,418.0
206170.0,17,2,762,2,762,0.0,381.0,381.0,0,0,0.0,0.0,0.0
33412.0,6,14,4740,7,653,5139.666666666667,249.0,93.28571428571428,7,4087,5187.833333333333,1514.0,583.8571428571429
207546.0,6,3,426,2,280,0.0,214.0,140.0,1,146,0.0,146.0,146.0
120384684.0,6,541,68078,271,49962,445869.2,480.0,184.36162361623616,270,18116,443722.38289962825,140.0,67.0962962962963
141693.0,17,4,571,2,148,0.0,74.0,74.0,2,423,0.0,280.0,211.5
847683.0,6,9,1196,6,725,169536.6,387.0,120.83333333333331,3,471,287502.5,331.0,157.0
146244.0,6,3,337,2,214,0.0,160.0,107.0,1,123,0.0,123.0,123.0
120161750.0,6,210,23774,105,7226,1147177.9903846155,140.0,68.81904761904762,105,16548,1147517.798076923,284.0,157.6
301918.0,6,3,202,2,128,0.0,74.0,64.0,1,74,0.0,74.0,74.0
10427351.0,6,7,478,4,272,3430244.6666666665,74.0,68.0,3,206,5145139.0,74.0,68.66666666666667
284427.0,17,2,180,1,90,0.0,90.0,90.0,1,90,0.0,90.0,90.0
27492.0,6,14,4740,7,653,4421.166666666667,249.0,93.28571428571428,7,4087,3658.5,1514.0,583.8571428571429
10212.0,6,11,1132,6,556,2042.4,218.0,92.66666666666669,5,576,2039.0,304.0,115.2
3630.0,17,2,414,1,88,0.0,88.0,88.0,1,326,0.0,326.0,326.0
96455838.0,6,29,2068,15,1105,6874286.285714285,139.0,73.66666666666667,14,963,7403079.923076923,123.0,68.78571428571429
45654.0,6,14,4740,7,653,7437.166666666667,249.0,93.28571428571428,7,4087,6320.666666666667,1514.0,583.8571428571429
5627987.0,6,5,336,2,134,0.0,68.0,67.0,3,202,1526289.0,70.0,67.33333333333333
9939.0,6,11,2098,6,590,1869.2,252.0,98.33333333333331,5,1508,1885.25,1236.0,301.6
321.0,17,2,174,1,79,0.0,79.0,79.0,1,95,0.0,95.0,95.0
120121993.0,6,274,32392,137,9338,878088.6470588235,140.0,68.16058394160584,137,23054,878053.5,284.0,168.27737226277372
95656418.0,17,14,4796,13,4446,6228061.25,342.0,342.0,1,350,0.0,350.0,350.0
207939.0,6,3,426,2,280,0.0,214.0,140.0,1,146,0.0,146.0,146.0
108707109.0,6,32,2236,16,1165,7247140.6,139.0,72.8125,16,1071,7232707.466666667,123.0,66.9375
120125410.0,6,14,2240,6,1224,24025082.0,204.0,204.0,8,1016,17137427.285714287,188.0,127.0
41870.0,6,14,4740,7,653,6800.166666666667,249.0,93.28571428571428,7,4087,6805.666666666667,1514.0,583.8571428571429
296.0,17,2,164,1,82,0.0,82.0,82.0,1,82,0.0,82.0,82.0
3120310.0,6,158,124392,88,115470,35865.63218390805,1510.0,1312.159090909091,70,8922,40710.89855072464,1510.0,127.45714285714286
0.0,6,1,54,0,0,0.0,0.0,0.0,1,54,0.0,54.0,54.0
113811622.0,6,47,3102,24,1584,4936500.217391305,66.0,66.0,23,1518,5135440.454545454,66.0,66.0
105494.0,17,2,286,2,286,0.0,143.0,143.0,0,0,0.0,0.0,0.0
25251996.0,6,19,6869,10,1501,2805777.333333333,408.0,150.1,9,5368,3105084.125,1514.0,596.4444444444445
206860.0,17,2,180,1,90,0.0,90.0,90.0,1,90,0.0,90.0,90.0
14645807.0,6,20,1648,10,1016,1592794.4444444445,315.0,101.6,10,632,1592763.111111111,78.0,63.2
37829.0,6,14,4740,7,653,6173.333333333333,249.0,93.28571428571428,7,4087,5715.5,1514.0,583.8571428571429
297314.0,6,6,412,4,272,99104.66666666669,74.0,68.0,2,140,0.0,74.0,70.0
34701.0,6,10,2032,5,524,8339.5,252.0,104.8,5,1508,5525.5,1236.0,301.6
2771077.0,6,2,132,1,66,0.0,66.0,66.0,1,66,0.0,66.0,66.0
74347.0,6,14,4740,7,653,11634.333333333334,249.0,93.28571428571428,7,4087,7821.833333333333,1514.0,583.8571428571429
1694325.0,6,8,565,4,301,564775.0,103.0,75.25,4,264,460839.6666666667,66.0,66.0
2037.0,17,4,344,2,150,0.0,75.0,75.0,2,194,0.0,103.0,97.0
3004397.0,6,11,2106,6,598,600671.8,252.0,99.66666666666669,5,1508,1790.25,1236.0,301.6
135129397.0,17,6,1146,6,1146,27025879.4,191.0,191.0,0,0,0.0,0.0,0.0
73827.0,6,14,4740,7,653,12136.333333333334,249.0,93.28571428571428,7,4087,10563.666666666666,1514.0,583.8571428571429
97605.0,17,2,762,2,762,0.0,381.0,381.0,0,0,0.0,0.0,0.0
120016872.0,17,29,13785,29,13785,4286316.857142857,501.0,475.3448275862069,0,0,0.0,0.0,0.0
107256.0,17,2,286,2,286,0.0,143.0,143.0,0,0,0.0,0.0,0.0
135132306.0,17,6,1146,6,1146,27026461.2,191.0,191.0,0,0,0.0,0.0,0.0
1235920.0,17,7,490,7,490,205986.66666666663,70.0,70.0,0,0,0.0,0.0,0.0
0.0,6,1,66,0,0,0.0,0.0,0.0,1,66,0.0,66.0,66.0
211121.0,6,10,1221,6,636,42224.2,298.0,106.0,4,585,68574.0,379.0,146.25
20507.0,6,11,1133,6,602,3348.0,264.0,100.33333333333331,5,531,4406.0,259.0,106.2
851271.0,6,9,1096,6,625,170254.2,287.0,104.16666666666669,3,471,289364.0,331.0,157.0
108123070.0,17,5,1005,5,1005,27030767.5,201.0,201.0,0,0,0.0,0.0,0.0
207996.0,6,10,1221,6,636,41599.2,298.0,106.0,4,585,68374.66666666667,379.0,146.25
49493.0,6,14,4740,7,653,8123.333333333333,249.0,93.28571428571428,7,4087,7627.833333333333,1514.0,583.8571428571429
204555.0,17,2,762,2,762,0.0,381.0,381.0,0,0,0.0,0.0,0.0
119119892.0,6,20,1449,11,799,11911989.2,95.0,72.63636363636364,9,650,14852158.25,95.0,72.22222222222223
90282520.0,6,16,1192,8,596,12891591.0,95.0,74.5,8,596,12897233.857142856,95.0,74.5
0.0,17,1,55,1,55,0.0,55.0,55.0,0,0,0.0,0.0,0.0
21866.0,6,2,145,2,145,0.0,91.0,72.5,0,0,0.0,0.0,0.0
506091.0,6,10,1221,6,636,101218.2,298.0,106.0,4,585,160894.33333333334,379.0,146.25
3333.0,17,4,344,2,150,0.0,75.0,75.0,2,194,0.0,103.0,97.0
99393763.0,6,41,3499,17,1539,6212110.1875,123.0,90.52941176470588,24,1960,4312064.260869565,139.0,81.66666666666667
5617940.0,6,5,336,2,134,0.0,68.0,67.0,3,202,1524820.5,70.0,67.33333333333333
0.0,17,1,44,1,44,0.0,44.0,44.0,0,0,0.0,0.0,0.0
45603.0,6,10,2032,5,524,9315.5,252.0,104.8,5,1508,10798.75,1236.0,301.6
1307985.0,17,7,490,7,490,217997.5,70.0,70.0,0,0,0.0,0.0,0.0
108109358.0,17,5,955,5,955,27027339.5,191.0,191.0,0,0,0.0,0.0,0.0
1487131.0,17,6,1230,3,234,743378.5,78.0,78.0,3,996,743363.0,332.0,332.0
44924.0,6,14,4740,7,653,7365.0,249.0,93.28571428571428,7,4087,6491.666666666667,1514.0,583.8571428571429
219888.0,6,4,492,2,280,0.0,214.0,140.0,2,212,0.0,146.0,106.0
22594.0,6,11,1132,6,556,4459.2,218.0,92.66666666666669,5,576,4931.25,304.0,115.2
228202.0,17,2,180,1,90,0.0,90.0,90.0,1,90,0.0,90.0,90.0
253943.0,6,10,1221,6,636,50788.6,298.0,106.0,4,585,78903.66666666667,379.0,146.25
303255.0,6,6,412,4,272,101085.0,74.0,68.0,2,140,0.0,74.0,70.0
6502.0,17,4,823,2,163,0.0,89.0,81.5,2,660,0.0,443.0,330.0
119667866.0,6,238,26946,119,18784,1012310.5508474576,336.0,157.84873949579833,119,8162,1012283.406779661,140.0,68.58823529411765
32939.0,6,14,4740,7,653,5084.0,249.0,93.28571428571428,7,4087,5298.333333333333,1514.0,583.8571428571429
312713.0,17,4,622,4,622,104237.66666666669,163.0,155.5,0,0,0.0,0.0,0.0
45242.0,6,10,2032,5,524,11076.25,252.0,104.8,5,1508,11017.5,1236.0,301.6
197020.0,17,2,180,1,90,0.0,90.0,90.0,1,90,0.0,90.0,90.0
102964.0,17,2,286,2,286,0.0,143.0,143.0,0,0,0.0,0.0,0.0
15054698.0,17,6,2718,6,2718,3010939.6,453.0,453.0,0,0,0.0,0.0,0.0
10422759.0,6,7,478,4,272,3428826.333333333,74.0,68.0,3,206,5143102.0,74.0,68.66666666666667
281681.0,17,2,363,1,79,0.0,79.0,79.0,1,284,0.0,284.0,284.0
1892.0,17,2,691,1,349,0.0,349.0,349.0,1,342,0.0,342.0,342.0
135134062.0,17,6,1146,6,1146,27026812.4,191.0,191.0,0,0,0.0,0.0,0.0
90059812.0,17,28,13364,28,13364,3335548.592592593,501.0,477.2857142857143,0,0,0.0,0.0,0.0
120227174.0,6,224,25328,112,7614,1075590.189189189,140.0,67.98214285714286,112,17714,1075747.162162162,284.0,158.16071428571428
1711562.0,6,23,6508,12,1529,155596.54545454544,357.0,127.41666666666669,11,4979,140990.3,1510.0,452.6363636363636
306501.0,6,3,202,2,128,0.0,74.0,64.0,1,74,0.0,74.0,74.0
127478929.0,6,39,2902,19,1371,6527393.611111111,123.0,72.15789473684211,20,1531,6304780.894736842,139.0,76.55
31384.000000000004,6,10,2032,5,524,7033.0,252.0,104.8,5,1508,6109.0,1236.0,301.6
22013.0,17,2,582,1,83,0.0,83.0,83.0,1,499,0.0,499.0,499.0
22576.0,6,14,4740,7,653,3425.1666666666665,249.0,93.28571428571428,7,4087,3358.5,1514.0,583.8571428571429
119977024.0,6,23,1734,12,894,10884701.363636363,95.0,74.5,11,840,11977214.9,95.0,76.36363636363636
105451696.0,6,32,2358,17,1272,6577920.75,123.0,74.82352941176471,15,1086,7517625.357142857,123.0,72.4
302571.0,6,6,412,4,272,100857.0,74.0,68.0,2,140,0.0,74.0,70.0
34421.0,6,14,4740,7,653,4875.333333333333,249.0,93.28571428571428,7,4087,5598.833333333333,1514.0,583.8571428571429
17543.0,6,10,2032,5,524,4136.5,252.0,104.8,5,1508,4207.0,1236.0,301.6
72005.0,6,10,2032,5,524,15165.25,252.0,104.8,5,1508,16763.0,1236.0,301.6
0.0,17,1,90,1,90,0.0,90.0,90.0,0,0,0.0,0.0,0.0
332.0,17,2,267,1,83,0.0,83.0,83.0,1,184,0.0,184.0,184.0
107742.0,6,13,1386,7,789,13718.666666666666,253.0,112.71428571428572,6,597,19546.8,259.0,99.5
135157501.0,17,6,1146,6,1146,27031500.2,191.0,191.0,0,0,0.0,0.0,0.0
1325538.0,6,4,264,2,132,0.0,66.0,66.0,2,132,0.0,66.0,66.0
206216.0,6,3,426,2,280,0.0,214.0,140.0,1,146,0.0,146.0,146.0
25166445.0,17,5,1718,4,1368,1166655.6666666667,342.0,342.0,1,350,0.0,350.0,350.0
303211.0,6,6,412,4,272,101070.33333333331,74.0,68.0,2,140,0.0,74.0,70.0
257657.00000000003,6,3,337,2,214,0.0,160.0,107.0,1,123,0.0,123.0,123.0
228293.0,17,2,180,1,90,0.0,90.0,90.0,1,90,0.0,90.0,90.0
248628.0,6,3,337,2,214,0.0,160.0,107.0,1,123,0.0,123.0,123.0
27341164.0,17,5,1710,5,1710,6835291.0,342.0,342.0,0,0,0.0,0.0,0.0
11169.0,17,4,823,2,163,0.0,89.0,81.5,2,660,0.0,443.0,330.0
123250556.0,6,49,3234,25,1650,5135439.833333333,66.0,66.0,24,1584,4954010.260869565,66.0,66.0
90020504.0,17,28,13364,28,13364,3334092.7407407407,501.0,477.2857142857143,0,0,0.0,0.0,0.0
135144575.0,17,6,1146,6,1146,27028915.0,191.0,191.0,0,0,0.0,0.0,0.0
33797.0,6,14,4740,7,653,5513.666666666667,249.0,93.28571428571428,7,4087,5471.333333333333,1514.0,583.8571428571429
210781.0,17,2,414,1,88,0.0,88.0,88.0,1,326,0.0,326.0,326.0
120008623.0,6,485,77512,240,16234,502085.96652719664,214.0,67.64166666666667,245,61278,488464.2131147541,1514.0,250.11428571428573
152135.0,17,4,6056,4,6056,50711.66666666666,1514.0,1514.0,0,0,0.0,0.0,0.0
100478578.0,17,12,778,6,389,20095715.6,174.0,64.83333333333333,6,389,19928188.6,174.0,64.83333333333333
135916.0,6,13,1386,7,789,22652.666666666668,253.0,112.71428571428572,6,597,24441.4,259.0,99.5
2102.0,17,4,344,2,150,0.0,75.0,75.0,2,194,0.0,103.0,97.0
171821.0,6,3,337,2,214,0.0,160.0,107.0,1,123,0.0,123.0,123.0
106756.0,17,4,1400,4,1400,35585.333333333336,350.0,350.0,0,0,0.0,0.0,0.0
44929.0,6,13,1386,7,789,6988.166666666667,253.0,112.71428571428572,6,597,8340.6,259.0,99.5
341.0,17,2,166,1,75,0.0,75.0,75.0,1,91,0.0,91.0,91.0
300024.0,6,6,412,4,272,100008.0,74.0,68.0,2,140,0.0,74.0,70.0
135132787.0,17,6,1206,6,1206,27026557.4,201.0,201.0,0,0,0.0,0.0,0.0
134106.0,6,11,1132,6,556,26447.4,218.0,92.66666666666669,5,576,32585.0,304.0,115.2
242229.0,6,3,337,2,214,0.0,160.0,107.0,1,123,0.0,123.0,123.0
90042022.0,17,28,13364,28,13364,3334889.703703704,501.0,477.2857142857143,0,0,0.0,0.0,0.0
57407.0,6,14,4740,7,653,8305.666666666666,249.0,93.28571428571428,7,4087,7344.666666666667,1514.0,583.8571428571429
1310723.0,6,4,264,2,132,0.0,66.0,66.0,2,132,0.0,66.0,66.0
0.0,17,1,381,1,381,0.0,381.0,381.0,0,0,0.0,0.0,0.0
30387.0,6,14,4740,7,653,4811.666666666667,249.0,93.28571428571428,7,4087,4186.0,1514.0,583.8571428571429
82.0,17,2,762,2,762,0.0,381.0,381.0,0,0,0.0,0.0,0.0
108109819.0,17,5,1005,5,1005,27027454.75,201.0,201.0,0,0,0.0,0.0,0.0
5822754.0,6,5,336,2,134,0.0,68.0,67.0,3,202,1525684.5,70.0,67.33333333333333
117471700.0,6,216,24424,108,17000,1095854.981308411,284.0,157.40740740740742,108,7424,1095855.046728972,140.0,68.74074074074075
298462.0,6,6,412,4,272,99487.33333333331,74.0,68.0,2,140,0.0,74.0,70.0
2445.0,17,4,344,2,150,0.0,75.0,75.0,2,194,0.0,103.0,97.0
121860.0,6,3,337,2,214,0.0,160.0,107.0,1,123,0.0,123.0,123.0
196843.0,17,2,180,1,90,0.0,90.0,90.0,1,90,0.0,90.0,90.0
205187.0,17,2,180,1,90,0.0,90.0,90.0,1,90,0.0,90.0,90.0
120077215.0,6,397,63690,199,50178,606450.5808080808,1514.0,252.15075376884425,198,13512,605967.8680203046,214.0,68.24242424242425
32517.0,6,10,2032,5,524,6408.5,252.0,104.8,5,1508,7841.5,1236.0,301.6
39890.0,6,14,4740,7,653,6524.166666666667,249.0,93.28571428571428,7,4087,6435.0,1514.0,583.8571428571429
90254437.0,6,13,2036,8,1016,12893491.0,188.0,127.0,5,1020,22523064.25,204.0,204.0
90256774.0,6,16,2423,9,1284,11282096.75,204.0,142.66666666666666,7,1139,15011008.0,199.0,162.71428571428572
680.0,17,2,762,2,762,0.0,381.0,381.0,0,0,0.0,0.0,0.0
279101.0,6,10,1221,6,636,55820.2,298.0,106.0,4,585,85525.33333333333,379.0,146.25
241858.0,6,3,337,2,214,0.0,160.0,107.0,1,123,0.0,123.0,123.0
174382.0,17,2,180,1,90,0.0,90.0,90.0,1,90,0.0,90.0,90.0
2350.0,17,4,344,2,150,0.0,75.0,75.0,2,194,0.0,103.0,97.0
335.0,17,2,160,1,80,0.0,80.0,80.0,1,80,0.0,80.0,80.0
107939.0,17,2,286,2,286,0.0,143.0,143.0,0,0,0.0,0.0,0.0
19040.0,17,2,582,1,83,0.0,83.0,83.0,1,499,0.0,499.0,499.0
104941667.0,17,15,5130,15,5130,7495833.357142857,342.0,342.0,0,0,0.0,0.0,0.0
302541.0,6,6,412,4,272,100847.0,74.0,68.0,2,140,0.0,74.0,70.0
351382.0,6,3,204,2,136,0.0,70.0,68.0,1,68,0.0,68.0,68.0
95.0,17,2,700,2,700,0.0,350.0,350.0,0,0,0.0,0.0,0.0
146027.0,6,3,337,2,214,0.0,160.0,107.0,1,123,0.0,123.0,123.0
224176.0,17,2,371,1,81,0.0,81.0,81.0,1,290,0.0,290.0,290.0
2439748.0,6,5,486,3,354,1111826.0,222.0,118.0,2,132,0.0,66.0,66.0
91455259.0,17,14,1126,7,563,15166797.166666666,174.0,80.42857142857143,7,563,15167867.166666666,174.0,80.42857142857143
65904.0,17,2,180,1,90,0.0,90.0,90.0,1,90,0.0,90.0,90.0
18882.0,6,11,1133,6,602,2954.4,264.0,100.33333333333331,5,531,4147.0,259.0,106.2
237735.0,17,2,180,1,90,0.0,90.0,90.0,1,90,0.0,90.0,90.0
297957.0,6,6,412,4,272,99319.0,74.0,68.0,2,140,0.0,74.0,70.0
11218.0,6,10,1065,5,534,2550.0,262.0,106.8,5,531,2018.75,259.0,106.2
33705503.0,6,5,336,2,134,0.0,68.0,67.0,3,202,15462353.5,70.0,67.33333333333333
167548.0,17,2,176,1,80,0.0,80.0,80.0,1,96,0.0,96.0,96.0
135127958.0,17,6,1146,6,1146,27025591.6,191.0,191.0,0,0,0.0,0.0,0.0
104936674.0,6,192,21648,96,6558,1095804.2315789473,140.0,68.3125,96,15090,1097374.2315789473,284.0,157.1875
49202.0,6,14,4740,7,653,7691.0,249.0,93.28571428571428,7,4087,7131.666666666667,1514.0,583.8571428571429
22791.0,6,10,2032,5,524,5482.25,252.0,104.8,5,1508,3882.75,1236.0,301.6
90257104.0,6,12,1832,8,1016,12893872.0,188.0,127.0,4,816,30026117.666666668,204.0,204.0
319.0,17,2,174,1,79,0.0,79.0,79.0,1,95,0.0,95.0,95.0
117664593.0,6,47,3102,24,1584,5106464.304347826,66.0,66.0,23,1518,5106339.7727272725,66.0,66.0
204674.0,17,2,762,2,762,0.0,381.0,381.0,0,0,0.0,0.0,0.0
90289199.0,6,16,1192,8,596,12898457.0,95.0,74.5,8,596,12856700.42857143,95.0,74.5
90037062.0,17,28,13364,28,13364,3334706.0,501.0,477.2857142857143,0,0,0.0,0.0,0.0
106412.0,17,2,286,2,286,0.0,143.0,143.0,0,0,0.0,0.0,0.0
110792708.0,6,29,1914,15,948,7913764.857142857,123.0,63.2,14,966,7737891.076923077,123.0,69.0
90510943.0,6,17,1287,10,745,10051108.222222222,95.0,74.5,7,542,10121089.666666666,95.0,77.42857142857143
90031668.0,17,28,13364,28,13364,3334506.222222222,501.0,477.2857142857143,0,0,0.0,0.0,0.0
108108174.0,17,5,955,5,955,27027043.5,191.0,191.0,0,0,0.0,0.0,0.0
2793.0,17,4,344,2,150,0.0,75.0,75.0,2,194,0.0,103.0,97.0
38697.0,6,10,2032,5,524,9400.0,252.0,104.8,5,1508,9032.25,1236.0,301.6
135136627.0,17,6,1206,6,1206,27027325.4,201.0,201.0,0,0,0.0,0.0,0.0
321231.0,6,3,202,2,128,0.0,74.0,64.0,1,74,0.0,74.0,74.0
304667.0,6,6,412,4,272,101555.66666666669,74.0,68.0,2,140,0.0,74.0,70.0
5574937.0,6,5,336,2,134,0.0,68.0,67.0,3,202,1518230.5,70.0,67.33333333333333
113733787.0,6,46,3036,23,1518,5155438.181818182,66.0,66.0,23,1518,5155444.227272728,66.0,66.0
10106.0,6,10,2032,5,524,2364.25,252.0,104.8,5,1508,2277.0,1236.0,301.6
90295554.0,6,15,1097,8,596,12899364.857142856,95.0,74.5,7,501,14998770.833333334,95.0,71.57142857142857
849452.0,6,9,1196,6,725,169890.4,387.0,120.83333333333331,3,471,286892.0,331.0,157.0
42049.0,6,14,4740,7,653,6826.666666666667,249.0,93.28571428571428,7,4087,5956.833333333333,1514.0,583.8571428571429
46727.0,6,10,2032,5,524,10282.0,252.0,104.8,5,1508,9608.25,1236.0,301.6
95252126.0,6,180,20422,90,14260,1067829.8764044945,374.0,158.44444444444446,90,6162,1067828.9550561798,140.0,68.46666666666667
4629315.0,6,5,1736,2,819,0.0,753.0,409.5,3,917,1549949.5,785.0,305.6666666666667
1307805.0,17,7,490,7,490,217967.5,70.0,70.0,0,0,0.0,0.0,0.0
90529414.0,6,14,2240,8,1016,12932773.42857143,188.0,127.0,6,1224,18072977.2,204.0,204.0
10458612.0,6,7,478,4,272,3441004.6666666665,74.0,68.0,3,206,5161413.5,74.0,68.66666666666667
148038.0,17,2,180,1,90,0.0,90.0,90.0,1,90,0.0,90.0,90.0
40008.0,6,10,2032,5,524,9788.25,252.0,104.8,5,1508,9571.0,1236.0,301.6
53562.0,6,14,4740,7,653,8509.333333333334,249.0,93.28571428571428,7,4087,8533.833333333334,1514.0,583.8571428571429
130282.0,17,2,180,1,70,0.0,70.0,70.0,1,110,0.0,110.0,110.0
60725.0,6,14,4740,7,653,9779.0,249.0,93.28571428571428,7,4087,7150.166666666667,1514.0,583.8571428571429
1184572.0,6,13,1386,7,789,197428.66666666663,253.0,112.71428571428572,6,597,233281.6,259.0,99.5
508887.0,6,5,336,2,134,0.0,68.0,67.0,3,202,192593.0,70.0,67.33333333333333
197167.0,17,2,180,1,90,0.0,90.0,90.0,1,90,0.0,90.0,90.0
120151978.0,6,248,27848,124,8480,970237.081300813,140.0,68.38709677419355,124,19368,970128.0569105692,284.0,156.19354838709677
4318.0,17,2,614,1,72,0.0,72.0,72.0,1,542,0.0,542.0,542.0
95000778.0,17,11,735,6,389,19000155.6,174.0,64.83333333333333,5,346,18751486.25,174.0,69.2
120375260.0,6,214,24202,107,7358,1127819.1698113207,140.0,68.76635514018692,107,16844,1127921.5849056605,284.0,157.42056074766356
108107943.0,17,5,1005,5,1005,27026985.75,201.0,201.0,0,0,0.0,0.0,0.0
92078105.0,6,14,2102,8,1016,13154015.0,188.0,127.0,6,1086,18382359.4,204.0,181.0
233045.0,6,3,337,2,214,0.0,160.0,107.0,1,123,0.0,123.0,123.0
9347.0,6,11,2098,6,590,1636.4,252.0,98.33333333333331,5,1508,1868.25,1236.0,301.6
2723493.0,6,3,1604,2,851,0.0,785.0,425.5,1,753,0.0,753.0,753.0
298819.0,6,6,412,4,272,99606.33333333331,74.0,68.0,2,140,0.0,74.0,70.0
2796241.0,6,2,132,1,66,0.0,66.0,66.0,1,66,0.0,66.0,66.0
42698.0,6,14,4740,7,653,6874.0,249.0,93.28571428571428,7,4087,6937.5,1514.0,583.8571428571429
41851.0,6,14,4740,7,653,6807.666666666667,249.0,93.28571428571428,7,4087,6653.0,1514.0,583.8571428571429
60384.0,6,14,4740,7,653,9928.833333333334,249.0,93.28571428571428,7,4087,9906.0,1514.0,583.8571428571429
10469160.0,6,7,478,4,272,3444546.0,74.0,68.0,3,206,5166697.5,74.0,68.66666666666667
0.0,6,1,66,1,66,0.0,66.0,66.0,0,0,0.0,0.0,0.0
135132883.0,17,6,1206,6,1206,27026576.6,201.0,201.0,0,0,0.0,0.0,0.0
1306953.0,6,4,264,2,132,0.0,66.0,66.0,2,132,0.0,66.0,66.0
222813.0,6,3,426,2,280,0.0,214.0,140.0,1,146,0.0,146.0,146.0
120002900.0,6,16,1192,8,596,17143271.42857143,95.0,74.5,8,596,17107849.285714287,95.0,74.5
2317.0,17,4,344,2,150,0.0,75.0,75.0,2,194,0.0,103.0,97.0
153414.0,17,2,180,1,90,0.0,90.0,90.0,1,90,0.0,90.0,90.0
3570694.0,6,5,336,2,134,0.0,68.0,67.0,3,202,1421307.5,70.0,67.33333333333333
57473.0,6,10,2032,5,524,14135.0,252.0,104.8,5,1508,14049.25,1236.0,301.6
105135512.0,17,14,1126,7,563,17427018.5,174.0,80.42857142857143,7,563,17495903.166666668,174.0,80.42857142857143
206113.0,6,3,426,2,280,0.0,214.0,140.0,1,146,0.0,146.0,146.0
137855.0,17,4,344,2,150,0.0,75.0,75.0,2,194,0.0,103.0,97.0
121007418.0,17,15,907,8,475,17286774.0,174.0,59.375,7,432,16833526.833333332,174.0,61.71428571428572
955.0,17,2,508,2,508,0.0,257.0,254.0,0,0,0.0,0.0,0.0
90940571.0,6,23,1734,13,989,7574061.0,95.0,76.07692307692308,10,745,10099158.777777778,95.0,74.5
73991.0,6,14,4740,7,653,12200.5,249.0,93.28571428571428,7,4087,8845.166666666666,1514.0,583.8571428571429
186013.0,17,2,180,1,90,0.0,90.0,90.0,1,90,0.0,90.0,90.0
108104722.0,17,5,955,5,955,27026180.5,191.0,191.0,0,0,0.0,0.0,0.0
117288301.0,6,21,1585,10,745,13032033.444444444,95.0,74.5,11,840,11703070.7,95.0,76.36363636363636
128044100.0,6,33,2280,17,1209,8002756.25,123.0,71.11764705882354,16,1071,7856103.733333333,123.0,66.9375
327.0,17,2,208,1,72,0.0,72.0,72.0,1,136,0.0,136.0,136.0
121326.0,6,3,337,2,214,0.0,160.0,107.0,1,123,0.0,123.0,123.0
103763.0,17,2,286,2,286,0.0,143.0,143.0,0,0,0.0,0.0,0.0
115185.0,17,2,762,2,762,0.0,381.0,381.0,0,0,0.0,0.0,0.0
108113295.0,17,5,1005,5,1005,27028323.75,201.0,201.0,0,0,0.0,0.0,0.0
123302073.0,6,48,3168,24,1584,5076035.217391305,66.0,66.0,24,1584,5220566.173913044,66.0,66.0
246351.0,6,3,337,2,214,0.0,160.0,107.0,1,123,0.0,123.0,123.0
41327.0,6,2,132,1,66,0.0,66.0,66.0,1,66,0.0,66.0,66.0
90013857.0,17,28,13364,28,13364,3333846.5555555555,501.0,477.2857142857143,0,0,0.0,0.0,0.0
0.0,17,1,350,1,350,0.0,350.0,350.0,0,0,0.0,0.0,0.0
35938.0,6,14,4740,7,653,5829.333333333333,249.0,93.28571428571428,7,4087,5802.666666666667,1514.0,583.8571428571429
298333.0,6,6,412,4,272,99444.33333333331,74.0,68.0,2,140,0.0,74.0,70.0
10485438.0,6,7,478,4,272,3449315.6666666665,74.0,68.0,3,206,5173888.0,74.0,68.66666666666667
135133076.0,17,6,1146,6,1146,27026615.2,191.0,191.0,0,0,0.0,0.0,0.0
135128390.0,17,6,1146,6,1146,27025678.0,191.0,191.0,0,0,0.0,0.0,0.0
3229396.0,6,15,2265,8,1145,461342.28571428574,579.0,143.125,7,1120,501683.8333333333,732.0,160.0
5005688.0,17,4,849,2,166,0.0,83.0,83.0,2,683,0.0,499.0,341.5
3783388.0,6,5,336,2,134,0.0,68.0,67.0,3,202,1526029.0,70.0,67.33333333333333
109019559.0,6,44,2904,22,1452,5191407.571428572,66.0,66.0,22,1452,5178290.142857143,66.0,66.0
108107345.0,17,5,955,5,955,27026836.25,191.0,191.0,0,0,0.0,0.0,0.0
42812.0,6,10,2032,5,524,9514.25,252.0,104.8,5,1508,6773.5,1236.0,301.6
2050.0,17,4,344,2,150,0.0,75.0,75.0,2,194,0.0,103.0,97.0
115304729.0,6,48,3168,24,1584,5013249.0869565215,66.0,66.0,24,1584,4999789.391304348,66.0,66.0
10863111.0,6,8,544,4,272,3575330.333333333,74.0,68.0,4,272,3575268.333333333,74.0,68.0
133008757.0,17,18,1560,10,823,14778750.777777778,174.0,82.3,8,737,16151381.714285716,174.0,92.125
100001064.0,17,11,473,6,258,20000212.8,43.0,43.0,5,215,20000763.25,43.0,43.0
1288058.0,17,7,490,7,490,214676.3333333333,70.0,70.0,0,0,0.0,0.0,0.0
108104496.0,17,5,955,5,955,27026124.0,191.0,191.0,0,0,0.0,0.0,0.0
49756.0,6,14,4740,7,653,8175.666666666667,249.0,93.28571428571428,7,4087,3430.0,1514.0,583.8571428571429
518193.0,6,12,1373,7,714,86365.5,298.0,102.0,5,659,125074.25,379.0,131.8
308699.0,6,6,412,4,272,102899.66666666669,74.0,68.0,2,140,0.0,74.0,70.0
90257527.0,6,13,2036,8,1016,12893932.42857143,188.0,127.0,5,1020,22522951.0,204.0,204.0
143947.0,17,2,180,1,90,0.0,90.0,90.0,1,90,0.0,90.0,90.0
228366.0,17,2,180,1,90,0.0,90.0,90.0,1,90,0.0,90.0,90.0
1570626.0,6,2,132,1,66,0.0,66.0,66.0,1,66,0.0,66.0,66.0
45036721.0,6,6,1808,4,987,15012240.333333334,785.0,246.75,2,821,0.0,753.0,410.5
138755.0,6,13,1386,7,789,23125.83333333333,253.0,112.71428571428572,6,597,24199.8,259.0,99.5
135128126.0,17,6,1146,6,1146,27025625.2,191.0,191.0,0,0,0.0,0.0,0.0
2020.0,17,4,344,2,150,0.0,75.0,75.0,2,194,0.0,103.0,97.0
100494.0,17,2,762,2,762,0.0,381.0,381.0,0,0,0.0,0.0,0.0
299126.0,6,6,412,4,272,99708.66666666669,74.0,68.0,2,140,0.0,74.0,70.0
24966.0,6,10,2032,5,524,4933.0,252.0,104.8,5,1508,5815.25,1236.0,301.6
93296.0,6,15,4806,8,719,12954.857142857143,249.0,89.875,7,4087,15386.166666666666,1514.0,583.8571428571429
308040.0,6,6,412,4,272,102680.0,74.0,68.0,2,140,0.0,74.0,70.0
635.0,17,2,762,2,762,0.0,381.0,381.0,0,0,0.0,0.0,0.0
22790.0,6,14,4740,7,653,3488.333333333333,249.0,93.28571428571428,7,4087,3660.1666666666665,1514.0,583.8571428571429
304093.0,6,6,412,4,272,101364.33333333331,74.0,68.0,2,140,0.0,74.0,70.0
45850.0,6,14,4740,7,653,6954.166666666667,249.0,93.28571428571428,7,4087,7217.0,1514.0,583.8571428571429
524361.0,17,6,2100,6,2100,104872.2,350.0,350.0,0,0,0.0,0.0,0.0
206538.0,6,3,426,2,280,0.0,214.0,140.0,1,146,0.0,146.0,146.0
233622.0,6,3,337,2,214,0.0,160.0,107.0,1,123,0.0,123.0,123.0
104246.0,17,2,286,2,286,0.0,143.0,143.0,0,0,0.0,0.0,0.0
162365.0,17,2,180,1,90,0.0,90.0,90.0,1,90,0.0,90.0,90.0
119107975.0,6,34,2334,17,1209,7430748.75,123.0,71.11764705882354,17,1125,7430748.3125,123.0,66.17647058823529
153333.0,6,11,1132,6,556,30356.8,218.0,92.66666666666669,5,576,37594.25,304.0,115.2
6711.0,17,2,582,1,83,0.0,83.0,83.0,1,499,0.0,499.0,499.0
138039.0,6,2,132,1,66,0.0,66.0,66.0,1,66,0.0,66.0,66.0
24744.0,6,10,2032,5,524,5956.0,252.0,104.8,5,1508,5357.25,1236.0,301.6
209400.0,17,2,180,1,90,0.0,90.0,90.0,1,90,0.0,90.0,90.0
111285171.0,17,14,864,7,432,18500214.0,174.0,61.71428571428572,7,432,18500943.666666668,174.0,61.71428571428572
25910.0,6,14,4740,7,653,4035.5,249.0,93.28571428571428,7,4087,4002.1666666666665,1514.0,583.8571428571429
20273.0,6,11,1133,6,602,3857.2,264.0,100.33333333333331,5,531,4436.5,259.0,106.2
219836.0,6,4,492,2,280,0.0,214.0,140.0,2,212,0.0,146.0,106.0
313587.0,6,6,412,4,272,104529.0,74.0,68.0,2,140,0.0,74.0,70.0
9179.0,17,2,498,1,80,0.0,80.0,80.0,1,418,0.0,418.0,418.0
108106132.0,17,5,955,5,955,27026533.0,191.0,191.0,0,0,0.0,0.0,0.0
98221357.0,6,29,2046,15,1017,7015781.785714285,123.0,67.8,14,1029,6963973.076923077,123.0,73.5
14645446.0,6,20,1646,10,1014,1592487.3333333333,315.0,101.4,10,632,1592468.111111111,78.0,63.2
295764.0,17,4,1524,4,1524,98588.0,381.0,381.0,0,0,0.0,0.0,0.0
219275.0,6,10,1221,6,636,43855.0,298.0,106.0,4,585,71773.0,379.0,146.25
147854.0,17,2,180,1,90,0.0,90.0,90.0,1,90,0.0,90.0,90.0
49537.0,6,10,2032,5,524,12159.5,252.0,104.8,5,1508,11814.0,1236.0,301.6
90044639.0,17,27,12943,27,12943,3463255.346153846,501.0,479.3703703703704,0,0,0.0,0.0,0.0
138714.0,6,2,132,1,66,0.0,66.0,66.0,1,66,0.0,66.0,66.0
2340.0,17,4,344,2,150,0.0,75.0,75.0,2,194,0.0,103.0,97.0
0.0,6,1,172,1,172,0.0,172.0,172.0,0,0,0.0,0.0,0.0
119477.0,6,11,1132,6,556,23714.6,218.0,92.66666666666669,5,576,29672.0,304.0,115.2
90012055.0,6,17,1530,8,596,12858865.0,95.0,74.5,9,934,11214445.5,342.0,103.77777777777776
10470046.0,6,7,478,4,272,3443066.333333333,74.0,68.0,3,206,5164495.5,74.0,68.66666666666667
2420676.0,6,49,23728,25,19797,100861.5,1514.0,791.88,24,3931,95368.30434782608,1514.0,163.79166666666666
90272197.0,6,13,2036,8,1016,12896028.142857144,188.0,127.0,5,1020,22526892.25,204.0,204.0
145307.0,17,2,180,1,90,0.0,90.0,90.0,1,90,0.0,90.0,90.0
227956.0,17,2,359,1,75,0.0,75.0,75.0,1,284,0.0,284.0,284.0
112209962.0,17,14,864,7,432,18668289.166666668,174.0,61.71428571428572,7,432,18666865.166666668,174.0,61.71428571428572
43308.0,6,14,4740,7,653,6281.5,249.0,93.28571428571428,7,4087,7021.0,1514.0,583.8571428571429
315.0,17,2,156,1,78,0.0,78.0,78.0,1,78,0.0,78.0,78.0
8721.0,17,4,823,2,163,0.0,89.0,81.5,2,660,0.0,443.0,330.0
301213.0,6,6,412,4,272,100404.33333333331,74.0,68.0,2,140,0.0,74.0,70.0
250133.0,6,10,1221,6,636,50026.6,298.0,106.0,4,585,78011.33333333333,379.0,146.25
120265782.0,6,260,29578,130,8876,925960.0775193798,140.0,68.27692307692308,130,20702,926030.7364341086,284.0,159.24615384615385
10464660.0,6,7,478,4,272,3442469.6666666665,74.0,68.0,3,206,5163591.0,74.0,68.66666666666667
32609.0,6,10,2032,5,524,7304.5,252.0,104.8,5,1508,7083.5,1236.0,301.6
9656.0,17,2,571,1,86,0.0,86.0,86.0,1,485,0.0,485.0,485.0
334978.0,17,2,346,1,78,0.0,78.0,78.0,1,268,0.0,268.0,268.0
134442.0,6,2,132,1,66,0.0,66.0,66.0,1,66,0.0,66.0,66.0
97343.0,17,2,762,2,762,0.0,381.0,381.0,0,0,0.0,0.0,0.0
148106.0,17,2,180,1,90,0.0,90.0,90.0,1,90,0.0,90.0,90.0
83797.0,6,11,2098,6,590,13980.4,252.0,98.33333333333331,5,1508,19059.25,1236.0,301.6
145731.0,6,3,337,2,214,0.0,160.0,107.0,1,123,0.0,123.0,123.0
270125.0,6,12,1373,7,714,45020.833333333336,298.0,102.0,5,659,63203.0,379.0,131.8
2029.0,17,4,344,2,150,0.0,75.0,75.0,2,194,0.0,103.0,97.0
324347.0,6,6,412,4,272,108115.66666666669,74.0,68.0,2,140,0.0,74.0,70.0
94301656.0,17,12,778,6,389,18799463.4,174.0,64.83333333333333,6,389,18800161.2,174.0,64.83333333333333
5626096.0,6,5,336,2,134,0.0,68.0,67.0,3,202,1524132.5,70.0,67.33333333333333
1399745.0,17,16,1120,16,1120,93316.33333333331,70.0,70.0,0,0,0.0,0.0,0.0
147997.0,17,2,180,1,90,0.0,90.0,90.0,1,90,0.0,90.0,90.0
90258126.0,6,12,1832,8,1016,12894018.0,188.0,127.0,4,816,30031463.33333333,204.0,204.0
265366.0,6,10,1221,6,636,53073.2,298.0,106.0,4,585,82662.0,379.0,146.25
153375.0,17,2,180,1,90,0.0,90.0,90.0,1,90,0.0,90.0,90.0
67275.0,6,10,2032,5,524,16530.25,252.0,104.8,5,1508,15242.75,1236.0,301.6
2390.0,17,4,344,2,150,0.0,75.0,75.0,2,194,0.0,103.0,97.0
217819.0,6,3,426,2,280,0.0,214.0,140.0,1,146,0.0,146.0,146.0
153549.0,17,2,180,1,90,0.0,90.0,90.0,1,90,0.0,90.0,90.0
2592493.0,6,2,132,1,66,0.0,66.0,66.0,1,66,0.0,66.0,66.0
15255.0,17,2,180,1,90,0.0,90.0,90.0,1,90,0.0,90.0,90.0
44407.0,6,14,4740,7,653,7148.666666666667,249.0,93.28571428571428,7,4087,6647.666666666667,1514.0,583.8571428571429
84582342.0,6,155,17400,78,5296,1098471.974025974,140.0,67.8974358974359,77,12104,1100757.855263158,284.0,157.19480519480518
204664.0,17,2,762,2,762,0.0,381.0,381.0,0,0,0.0,0.0,0.0
43467.0,6,10,2032,5,524,10207.5,252.0,104.8,5,1508,9739.25,1236.0,301.6
312734.0,17,2,180,1,90,0.0,90.0,90.0,1,90,0.0,90.0,90.0
284682.0,17,2,363,1,79,0.0,79.0,79.0,1,284,0.0,284.0,284.0
2505791.0,6,3,1604,2,851,0.0,785.0,425.5,1,753,0.0,753.0,753.0
135122770.0,17,6,1206,6,1206,27024554.0,201.0,201.0,0,0,0.0,0.0,0.0
98929.0,17,2,762,2,762,0.0,381.0,381.0,0,0,0.0,0.0,0.0
31301.000000000004,6,2,132,1,66,0.0,66.0,66.0,1,66,0.0,66.0,66.0
216737.0,17,4,6056,4,6056,72245.66666666667,1514.0,1514.0,0,0,0.0,0.0,0.0
197954.0,17,2,180,1,90,0.0,90.0,90.0,1,90,0.0,90.0,90.0
18611.0,6,12,1393,6,796,3532.2,271.0,132.66666666666666,6,597,3426.8,259.0,99.5
269522.0,6,10,1221,6,636,53904.4,298.0,106.0,4,585,84460.66666666667,379.0,146.25
35795.0,6,10,2032,5,524,8627.75,252.0,104.8,5,1508,8594.0,1236.0,301.6
102503.0,17,2,762,2,762,0.0,381.0,381.0,0,0,0.0,0.0,0.0
207332.0,17,2,180,1,90,0.0,90.0,90.0,1,90,0.0,90.0,90.0
120074473.0,17,28,13364,28,13364,4447202.703703703,501.0,477.2857142857143,0,0,0.0,0.0,0.0
162383.0,17,2,180,1,90,0.0,90.0,90.0,1,90,0.0,90.0,90.0
85071.0,6,14,4740,7,653,13725.833333333334,249.0,93.28571428571428,7,4087,13232.0,1514.0,583.8571428571429
2330.0,17,4,344,2,150,0.0,75.0,75.0,2,194,0.0,103.0,97.0
301958.0,6,6,412,4,272,100652.66666666669,74.0,68.0,2,140,0.0,74.0,70.0
33648.0,6,14,4740,7,653,5449.333333333333,249.0,93.28571428571428,7,4087,5187.833333333333,1514.0,583.8571428571429
153832.0,17,4,6056,4,6056,51277.333333333336,1514.0,1514.0,0,0,0.0,0.0,0.0
325186.0,6,6,412,4,272,108395.33333333331,74.0,68.0,2,140,0.0,74.0,70.0
5730196.0,6,90,92810,25,1817,238758.16666666663,213.0,72.68,65,90993,89411.078125,1514.0,1399.8923076923077
2452.0,17,4,344,2,150,0.0,75.0,75.0,2,194,0.0,103.0,97.0
357862.0,17,6,1230,3,234,178698.0,78.0,78.0,3,996,178722.5,332.0,332.0
13860174.0,17,6,2052,6,2052,2772034.8,342.0,342.0,0,0,0.0,0.0,0.0
228261.0,17,2,180,1,90,0.0,90.0,90.0,1,90,0.0,90.0,90.0
102234680.0,6,34,2620,18,1411,6013804.705882353,139.0,78.38888888888889,16,1209,6800528.533333333,123.0,75.5625
2091.0,17,4,344,2,150,0.0,75.0,75.0,2,194,0.0,103.0,97.0
40880.0,6,14,4740,7,653,6043.833333333333,249.0,93.28571428571428,7,4087,6316.833333333333,1514.0,583.8571428571429
121582.0,6,3,337,2,214,0.0,160.0,107.0,1,123,0.0,123.0,123.0
796.0,17,4,438,2,148,0.0,74.0,74.0,2,290,0.0,147.0,145.0
255556.0,6,3,337,2,214,0.0,160.0,107.0,1,123,0.0,123.0,123.0
431868.0,6,3,204,2,136,0.0,70.0,68.0,1,68,0.0,68.0,68.0
135136025.0,17,6,1206,6,1206,27027205.0,201.0,201.0,0,0,0.0,0.0,0.0
307104.0,6,6,412,4,272,102368.0,74.0,68.0,2,140,0.0,74.0,70.0
106361.0,17,2,762,2,762,0.0,381.0,381.0,0,0,0.0,0.0,0.0
102407631.0,17,14,864,7,432,16999214.5,174.0,61.71428571428572,7,432,17000173.5,174.0,61.71428571428572
33441.0,6,14,4740,7,653,4134.166666666667,249.0,93.28571428571428,7,4087,5100.666666666667,1514.0,583.8571428571429
135142796.0,17,6,1206,6,1206,27028559.2,201.0,201.0,0,0,0.0,0.0,0.0
52328.0,6,14,4740,7,653,8554.166666666666,249.0,93.28571428571428,7,4087,8573.5,1514.0,583.8571428571429
322.0,17,2,174,1,79,0.0,79.0,79.0,1,95,0.0,95.0,95.0
122378370.0,17,14,864,7,432,17167830.5,174.0,61.71428571428572,7,432,20006975.5,174.0,61.71428571428572
304116.0,6,3,202,2,128,0.0,74.0,64.0,1,74,0.0,74.0,74.0
361036.0,17,4,571,2,148,0.0,74.0,74.0,2,423,0.0,280.0,211.5
120379548.0,6,249,28148,125,19742,970802.8064516129,284.0,157.936,124,8406,970304.1463414634,140.0,67.79032258064517
2321.0,17,4,344,2,150,0.0,75.0,75.0,2,194,0.0,103.0,97.0
36982.0,6,10,2032,5,524,9013.5,252.0,104.8,5,1508,8670.0,1236.0,301.6
109332266.0,6,28,1860,14,966,8393575.76923077,123.0,69.0,14,894,8393580.384615384,123.0,63.85714285714285
146142.0,6,3,337,2,214,0.0,160.0,107.0,1,123,0.0,123.0,123.0
108102319.0,17,5,1005,5,1005,27025579.75,201.0,201.0,0,0,0.0,0.0,0.0
217257.0,17,2,239,1,82,0.0,82.0,82.0,1,157,0.0,157.0,157.0
232980.0,6,3,337,2,214,0.0,160.0,107.0,1,123,0.0,123.0,123.0
120123061.0,6,278,31576,139,9470,864545.7826086957,140.0,68.12949640287769,139,22106,864490.1449275363,284.0,159.0359712230216
117316205.0,6,31,2166,16,1149,7806689.6,123.0,71.8125,15,1017,8364301.5,123.0,67.8
216586.0,17,2,180,1,90,0.0,90.0,90.0,1,90,0.0,90.0,90.0
233188.0,6,3,337,2,214,0.0,160.0,107.0,1,123,0.0,123.0,123.0
143865.0,17,2,180,1,90,0.0,90.0,90.0,1,90,0.0,90.0,90.0
38513.0,6,14,4740,7,653,5132.5,249.0,93.28571428571428,7,4087,5661.166666666667,1514.0,583.8571428571429
328.0,17,2,168,1,76,0.0,76.0,76.0,1,92,0.0,92.0,92.0
120280657.0,6,220,24884,110,7482,1095998.119266055,140.0,68.01818181818182,110,17402,1095961.110091743,284.0,158.2
18548.0,6,14,4740,7,653,2982.833333333333,249.0,93.28571428571428,7,4087,2954.5,1514.0,583.8571428571429
285490.0,6,10,1221,6,636,57098.0,298.0,106.0,4,585,89681.33333333333,379.0,146.25
33844.0,6,14,4740,7,653,5515.833333333333,249.0,93.28571428571428,7,4087,5462.0,1514.0,583.8571428571429
308773.0,6,6,412,4,272,102924.33333333331,74.0,68.0,2,140,0.0,74.0,70.0
107796.0,17,2,286,2,286,0.0,143.0,143.0,0,0,0.0,0.0,0.0
2426861.0,6,25,7573,14,3735,186681.6153846153,1514.0,266.7857142857143,11,3838,215980.2,1514.0,348.90909090909093
315123.0,17,4,1400,4,1400,105041.0,350.0,350.0,0,0,0.0,0.0,0.0
27308684.0,17,5,1710,5,1710,6827171.0,342.0,342.0,0,0,0.0,0.0,0.0
135132930.0,17,6,1206,6,1206,27026586.0,201.0,201.0,0,0,0.0,0.0,0.0
120123811.0,6,17,2556,10,1392,13347090.111111112,188.0,139.2,7,1164,15011420.666666666,204.0,166.28571428571428
213799.0,6,10,1221,6,636,42759.8,298.0,106.0,4,585,69989.33333333333,379.0,146.25
115021883.0,6,48,3168,24,1584,5000951.434782608,66.0,66.0,24,1584,4987535.956521739,66.0,66.0
90058521.0,17,28,13364,28,13364,3335500.777777778,501.0,477.2857142857143,0,0,0.0,0.0,0.0
90289438.0,6,16,1192,8,596,12891274.857142856,95.0,74.5,8,596,12897803.57142857,95.0,74.5
45673936.0,6,5,1740,2,819,0.0,753.0,409.5,3,921,22315805.0,785.0,307.0
100744932.0,6,30,2260,16,1228,6701950.866666666,139.0,76.75,14,1032,7733015.692307692,123.0,73.71428571428571
113472320.0,6,46,3036,23,1518,5157820.090909091,66.0,66.0,23,1518,5157817.7727272725,66.0,66.0
314202.0,17,4,1400,4,1400,104734.0,350.0,350.0,0,0,0.0,0.0,0.0
2479.0,17,4,344,2,150,0.0,75.0,75.0,2,194,0.0,103.0,97.0
125848842.0,6,62,12110,31,6087,3224834.1,1514.0,196.3548387096774,31,6023,4187760.633333333,1514.0,194.29032258064515
2342.0,17,4,344,2,150,0.0,75.0,75.0,2,194,0.0,103.0,97.0
97876.0,6,14,4740,7,653,15119.333333333334,249.0,93.28571428571428,7,4087,16174.0,1514.0,583.8571428571429
35518.0,6,10,2032,5,524,8266.5,252.0,104.8,5,1508,8618.5,1236.0,301.6
35029.0,6,14,4740,7,653,4927.333333333333,249.0,93.28571428571428,7,4087,4987.833333333333,1514.0,583.8571428571429
299652.0,6,6,412,4,272,99884.0,74.0,68.0,2,140,0.0,74.0,70.0
310501.0,6,3,202,2,128,0.0,74.0,64.0,1,74,0.0,74.0,74.0
103813809.0,17,14,864,7,432,17167523.166666668,174.0,61.71428571428572,7,432,17166868.333333332,174.0,61.71428571428572
5630193.0,6,6,402,3,200,1541916.0,68.0,66.66666666666667,3,202,1422566.5,70.0,67.33333333333333
148028.0,6,3,337,2,214,0.0,160.0,107.0,1,123,0.0,123.0,123.0
10547574.0,6,7,478,4,272,3469326.333333333,74.0,68.0,3,206,5203866.0,74.0,68.66666666666667
90258345.0,6,12,1832,8,1016,12894049.285714284,188.0,127.0,4,816,30030805.666666668,204.0,204.0
1845.0,17,4,344,2,150,0.0,75.0,75.0,2,194,0.0,103.0,97.0
14860780.0,17,5,1710,5,1710,3715195.0,342.0,342.0,0,0,0.0,0.0,0.0
108005575.0,17,13,821,7,432,18000929.166666668,174.0,61.71428571428572,6,389,17800260.0,174.0,64.83333333333333
289980.0,17,2,180,1,90,0.0,90.0,90.0,1,90,0.0,90.0,90.0
855197.0,6,9,1269,6,798,171039.4,460.0,133.0,3,471,291395.5,331.0,157.0
2613258.0,6,2,132,1,66,0.0,66.0,66.0,1,66,0.0,66.0,66.0
1232393.0,6,20,6916,11,3099,123239.3,1514.0,281.72727272727275,9,3817,127011.25,1514.0,424.1111111111111
755269.0,6,2,132,1,66,0.0,66.0,66.0,1,66,0.0,66.0,66.0
115372853.0,6,211,23708,106,7304,1098789.0761904763,140.0,68.90566037735849,105,16404,1100273.875,284.0,156.22857142857143
3577.0,17,2,414,1,88,0.0,88.0,88.0,1,326,0.0,326.0,326.0
101855.0,17,2,762,2,762,0.0,381.0,381.0,0,0,0.0,0.0,0.0
228505.0,17,2,180,1,90,0.0,90.0,90.0,1,90,0.0,90.0,90.0
312165.0,17,4,1400,4,1400,104055.0,350.0,350.0,0,0,0.0,0.0,0.0
120440979.0,6,250,32062,136,24026,892155.4,1162.0,176.66176470588235,114,8036,1056623.3628318585,140.0,70.49122807017544
228284.0,17,2,180,1,90,0.0,90.0,90.0,1,90,0.0,90.0,90.0
100050881.0,17,14,864,7,432,16667279.5,174.0,61.71428571428572,7,432,16666802.666666666,174.0,61.71428571428572
130378.0,6,10,1066,5,490,31944.5,218.0,98.0,5,576,31970.5,304.0,115.2
249783.0,6,3,337,2,214,0.0,160.0,107.0,1,123,0.0,123.0,123.0
243001.0,6,3,337,2,214,0.0,160.0,107.0,1,123,0.0,123.0,123.0
43265.0,6,11,2098,6,590,8653.0,252.0,98.33333333333331,5,1508,8822.5,1236.0,301.6
811.0,17,4,438,2,148,0.0,74.0,74.0,2,290,0.0,147.0,145.0
108101997.0,17,5,955,5,955,27025499.25,191.0,191.0,0,0,0.0,0.0,0.0
2914548.0,6,2,132,1,66,0.0,66.0,66.0,1,66,0.0,66.0,66.0
90533489.0,6,13,2036,8,1016,12933355.57142857,188.0,127.0,5,1020,22591896.75,204.0,204.0
263498.0,6,10,1221,6,636,52699.6,298.0,106.0,4,585,82378.0,379.0,146.25
118024420.0,6,32,2236,16,1165,7868294.666666667,139.0,72.8125,16,1071,7854634.333333333,123.0,66.9375
17119.0,6,10,2032,5,524,3981.75,252.0,104.8,5,1508,3483.25,1236.0,301.6
6649.0,17,4,823,2,163,0.0,89.0,81.5,2,660,0.0,443.0,330.0
107517.0,17,2,286,2,286,0.0,143.0,143.0,0,0,0.0,0.0,0.0
120027788.0,17,28,13364,28,13364,4445473.62962963,501.0,477.2857142857143,0,0,0.0,0.0,0.0
213486.0,6,3,426,2,280,0.0,214.0,140.0,1,146,0.0,146.0,146.0
228241.0,17,2,180,1,90,0.0,90.0,90.0,1,90,0.0,90.0,90.0
114363473.0,6,33,2274,17,1125,7147691.75,123.0,66.17647058823529,16,1149,6958543.066666666,123.0,71.8125
350.0,17,2,160,1,80,0.0,80.0,80.0,1,80,0.0,80.0,80.0
316290.0,17,4,1400,4,1400,105430.0,350.0,350.0,0,0,0.0,0.0,0.0
206201.0,6,3,426,2,280,0.0,214.0,140.0,1,146,0.0,146.0,146.0
2799588.0,6,2,132,1,66,0.0,66.0,66.0,1,66,0.0,66.0,66.0
16830.0,17,2,180,1,90,0.0,90.0,90.0,1,90,0.0,90.0,90.0
120054452.0,6,223,25246,112,17624,1081571.6396396395,284.0,157.35714285714286,111,7622,1085209.3636363635,140.0,68.66666666666667
105427.0,17,2,286,2,286,0.0,143.0,143.0,0,0,0.0,0.0,0.0
2662461.0,6,3,1602,2,850,0.0,784.0,425.0,1,752,0.0,752.0,752.0
298051.0,6,6,412,4,272,99350.33333333331,74.0,68.0,2,140,0.0,74.0,70.0
108108682.0,17,5,955,5,955,27027170.5,191.0,191.0,0,0,0.0,0.0,0.0
226476.0,6,10,1221,6,636,45295.2,298.0,106.0,4,585,74206.0,379.0,146.25
90045580.0,17,28,13364,28,13364,3335021.4814814813,501.0,477.2857142857143,0,0,0.0,0.0,0.0
120220166.0,6,290,32818,145,9866,831567.9652777778,140.0,68.04137931034482,145,22952,829233.4791666666,284.0,158.2896551724138
135123449.0,17,6,1206,6,1206,27024689.8,201.0,201.0,0,0,0.0,0.0,0.0
143855.0,17,2,180,1,90,0.0,90.0,90.0,1,90,0.0,90.0,90.0
90045275.0,17,28,13364,28,13364,3335010.185185185,501.0,477.2857142857143,0,0,0.0,0.0,0.0
106888776.0,6,30,2106,15,1089,7634912.571428572,123.0,72.6,15,1017,7619464.0,123.0,67.8
6972.0,17,2,582,1,83,0.0,83.0,83.0,1,499,0.0,499.0,499.0
90300775.0,6,21,1585,11,840,9025613.5,95.0,76.36363636363636,10,745,9950282.888888888,95.0,74.5
16403.0,17,4,344,2,150,0.0,75.0,75.0,2,194,0.0,103.0,97.0
90059504.0,17,28,13364,28,13364,3335537.185185185,501.0,477.2857142857143,0,0,0.0,0.0,0.0
31212.0,6,14,4740,7,653,4981.666666666667,249.0,93.28571428571428,7,4087,4979.666666666667,1514.0,583.8571428571429
121003.0,6,3,337,2,214,0.0,160.0,107.0,1,123,0.0,123.0,123.0
119422134.0,6,225,25394,113,7754,1066269.0535714286,140.0,68.61946902654867,112,17640,1066670.1081081082,284.0,157.5
26552.0,6,14,4740,7,653,3942.0,249.0,93.28571428571428,7,4087,4285.666666666667,1514.0,583.8571428571429
46655.0,6,10,2032,5,524,10326.25,252.0,104.8,5,1508,9429.0,1236.0,301.6
12009717.0,6,9,643,5,379,2978502.0,103.0,75.8,4,264,2730307.0,66.0,66.0
113687197.0,17,14,864,7,432,18833590.33333333,174.0,61.71428571428572,7,432,18834275.5,174.0,61.71428571428572
2023465.0,17,4,525,2,150,0.0,75.0,75.0,2,375,0.0,284.0,187.5
165939.0,17,2,180,1,90,0.0,90.0,90.0,1,90,0.0,90.0,90.0
765.0,17,4,438,2,148,0.0,74.0,74.0,2,290,0.0,147.0,145.0
322562.0,6,6,412,4,272,107520.66666666669,74.0,68.0,2,140,0.0,74.0,70.0
308035.0,6,6,412,4,272,102678.33333333331,74.0,68.0,2,140,0.0,74.0,70.0
228517.0,17,2,180,1,90,0.0,90.0,90.0,1,90,0.0,90.0,90.0
90094965.0,6,22,1807,10,913,9986624.222222222,222.0,91.3,12,894,8170878.727272727,95.0,74.5
108105438.0,17,5,1005,5,1005,27026359.5,201.0,201.0,0,0,0.0,0.0,0.0
120376101.0,6,31,2245,15,1017,8048976.928571428,123.0,67.8,16,1228,7359389.0,139.0,76.75
339.0,17,2,267,1,83,0.0,83.0,83.0,1,184,0.0,184.0,184.0
29343.0,6,14,4740,7,653,4603.833333333333,249.0,93.28571428571428,7,4087,4716.0,1514.0,583.8571428571429
103777.0,17,2,700,2,700,0.0,350.0,350.0,0,0,0.0,0.0,0.0
45461.0,6,14,4740,7,653,7405.833333333333,249.0,93.28571428571428,7,4087,6213.833333333333,1514.0,583.8571428571429
363512.0,17,2,363,1,75,0.0,75.0,75.0,1,288,0.0,288.0,288.0
14610.0,6,10,2032,5,524,3441.0,252.0,104.8,5,1508,3292.75,1236.0,301.6
207815.0,6,3,426,2,280,0.0,214.0,140.0,1,146,0.0,146.0,146.0
302382.0,6,2,132,1,66,0.0,66.0,66.0,1,66,0.0,66.0,66.0
2006.0,17,4,344,2,150,0.0,75.0,75.0,2,194,0.0,103.0,97.0
90256062.0,6,12,1832,8,1016,12893723.142857144,188.0,127.0,4,816,30030454.33333333,204.0,204.0
5629496.0,6,5,336,2,134,0.0,68.0,67.0,3,202,1424361.0,70.0,67.33333333333333
135129742.0,17,6,1146,6,1146,27025948.4,191.0,191.0,0,0,0.0,0.0,0.0
120125382.0,6,15,2428,9,1204,15015672.75,188.0,133.77777777777777,6,1224,18073542.8,204.0,204.0
151174.0,6,3,337,2,214,0.0,160.0,107.0,1,123,0.0,123.0,123.0
83.0,17,2,762,2,762,0.0,381.0,381.0,0,0,0.0,0.0,0.0
90985392.0,6,217,26688,109,19326,842457.3333333334,336.0,177.30275229357798,108,7362,821385.5700934579,140.0,68.16666666666667
108109207.0,17,5,1005,5,1005,27027301.75,201.0,201.0,0,0,0.0,0.0,0.0
90643197.0,6,18,2650,9,1216,11330399.625,188.0,135.11111111111111,9,1434,11296754.75,204.0,159.33333333333334
316748.0,17,4,1400,4,1400,105582.66666666669,350.0,350.0,0,0,0.0,0.0,0.0
775.0,17,4,438,2,148,0.0,74.0,74.0,2,290,0.0,147.0,145.0
2080210.0,6,24,7544,12,2450,189110.0,1034.0,204.16666666666663,12,5094,161954.18181818182,1510.0,424.5
8066.999999999999,17,4,344,2,150,0.0,75.0,75.0,2,194,0.0,103.0,97.0
90241388.0,6,15,1138,8,596,12891626.857142856,95.0,74.5,7,542,15004498.5,95.0,77.42857142857143
310797.0,17,4,1400,4,1400,103599.0,350.0,350.0,0,0,0.0,0.0,0.0
106007962.0,17,13,821,7,432,17667993.666666668,174.0,61.71428571428572,6,389,17200164.8,174.0,64.83333333333333
90259334.0,6,12,1832,8,1016,12894190.57142857,188.0,127.0,4,816,30031587.33333333,204.0,204.0
215422.0,6,10,1221,6,636,43084.4,298.0,106.0,4,585,70575.66666666667,379.0,146.25
16836.0,17,2,180,1,90,0.0,90.0,90.0,1,90,0.0,90.0,90.0
28883.0,6,10,2032,5,524,6263.5,252.0,104.8,5,1508,6909.75,1236.0,301.6
3160.0,17,2,224,1,76,0.0,76.0,76.0,1,148,0.0,148.0,148.0
58901224.0,17,9,3086,8,2736,5144748.714285715,342.0,342.0,1,350,0.0,350.0,350.0
90055877.0,17,28,13364,28,13364,3335402.851851852,501.0,477.2857142857143,0,0,0.0,0.0,0.0
365.0,17,2,267,1,83,0.0,83.0,83.0,1,184,0.0,184.0,184.0
1278762.0,6,2,132,1,66,0.0,66.0,66.0,1,66,0.0,66.0,66.0
876358.0,6,10,1333,6,796,175271.6,458.0,132.66666666666666,4,537,200265.0,331.0,134.25
8845.0,17,2,684,2,684,0.0,342.0,342.0,0,0,0.0,0.0,0.0
90284207.0,6,16,1192,8,596,12891326.142857144,95.0,74.5,8,596,12896597.0,95.0,74.5
120104988.0,6,17,2489,9,1284,14993114.5,204.0,142.66666666666666,8,1205,12866885.57142857,199.0,150.625
46295.0,6,10,2032,5,524,10181.5,252.0,104.8,5,1508,8835.5,1236.0,301.6
48474.0,6,14,4740,7,653,7955.333333333333,249.0,93.28571428571428,7,4087,7494.833333333333,1514.0,583.8571428571429
509971.0,6,5,336,2,134,0.0,68.0,67.0,3,202,194042.5,70.0,67.33333333333333
48088.0,6,10,2032,5,524,11792.0,252.0,104.8,5,1508,10006.75,1236.0,301.6
90033852.0,17,28,13364,28,13364,3334587.111111111,501.0,477.2857142857143,0,0,0.0,0.0,0.0
510309.0,6,5,336,2,134,0.0,68.0,67.0,3,202,194449.5,70.0,67.33333333333333
10889874.0,6,7,478,3,206,5376769.0,74.0,68.66666666666667,4,272,3584427.333333333,74.0,68.0
90260381.0,6,13,1898,8,1016,12894340.142857144,188.0,127.0,5,882,22523972.5,204.0,176.4
549749.0,6,3,236,3,236,274874.5,91.0,78.66666666666667,0,0,0.0,0.0,0.0
908.0,17,2,762,2,762,0.0,381.0,381.0,0,0,0.0,0.0,0.0
115779108.0,6,26,2105,14,1043,8906085.23076923,95.0,74.5,12,1062,10502557.0,222.0,88.5
31192.0,6,14,4740,7,653,5059.333333333333,249.0,93.28571428571428,7,4087,4744.166666666667,1514.0,583.8571428571429
725.0,17,2,762,2,762,0.0,381.0,381.0,0,0,0.0,0.0,0.0
331.0,17,2,208,1,72,0.0,72.0,72.0,1,136,0.0,136.0,136.0
19999.0,6,14,4740,7,653,2923.1666666666665,249.0,93.28571428571428,7,4087,2346.833333333333,1514.0,583.8571428571429
16916.0,17,2,180,1,90,0.0,90.0,90.0,1,90,0.0,90.0,90.0
108102967.0,17,5,1005,5,1005,27025741.75,201.0,201.0,0,0,0.0,0.0,0.0
106947.0,17,2,286,2,286,0.0,143.0,143.0,0,0,0.0,0.0,0.0
209654.0,6,3,426,2,280,0.0,214.0,140.0,1,146,0.0,146.0,146.0
120008182.0,6,23,1785,12,1027,10909834.727272728,154.0,85.58333333333333,11,758,9000599.1,95.0,68.9090909090909
58843957.0,17,9,3086,8,2736,5108726.428571428,342.0,342.0,1,350,0.0,350.0,350.0
41988352.0,6,4,1670,3,917,20994176.0,785.0,305.6666666666667,1,753,0.0,753.0,753.0
90294280.0,6,20,1531,11,840,9025169.3,95.0,76.36363636363636,9,691,11164253.25,95.0,76.77777777777777
37747.0,6,14,4740,7,653,6126.333333333333,249.0,93.28571428571428,7,4087,6033.0,1514.0,583.8571428571429
196862.0,17,2,180,1,90,0.0,90.0,90.0,1,90,0.0,90.0,90.0
39947.0,6,14,4740,7,653,6315.166666666667,249.0,93.28571428571428,7,4087,5341.833333333333,1514.0,583.8571428571429
120123710.0,6,17,2556,10,1392,13347078.888888888,188.0,139.2,7,1164,15015138.0,204.0,166.28571428571428
37701.0,6,14,4740,7,653,5582.666666666667,249.0,93.28571428571428,7,4087,6091.333333333333,1514.0,583.8571428571429
120015628.0,17,28,13364,28,13364,4445023.259259259,501.0,477.2857142857143,0,0,0.0,0.0,0.0
236890.0,6,3,373,2,238,0.0,172.0,119.0,1,135,0.0,135.0,135.0
146023.0,6,3,337,2,214,0.0,160.0,107.0,1,123,0.0,123.0,123.0
104307801.0,6,28,1860,14,966,8007084.153846154,123.0,69.0,14,894,8007082.153846154,123.0,63.85714285714285
115011731.0,6,37,2788,19,1471,6389540.611111111,139.0,77.42105263157895,18,1317,6752675.0,123.0,73.16666666666667
207558.0,6,3,426,2,280,0.0,214.0,140.0,1,146,0.0,146.0,146.0
304702.0,6,6,412,4,272,101567.33333333331,74.0,68.0,2,140,0.0,74.0,70.0
320.0,17,2,174,1,79,0.0,79.0,79.0,1,95,0.0,95.0,95.0
105308948.0,6,515,65302,258,17250,409762.44357976655,140.0,66.86046511627907,257,48052,410455.71484375,554.0,186.9727626459144
206717.0,6,3,426,2,280,0.0,214.0,140.0,1,146,0.0,146.0,146.0
217298.0,6,3,426,2,280,0.0,214.0,140.0,1,146,0.0,146.0,146.0
0.0,6,1,66,1,66,0.0,66.0,66.0,0,0,0.0,0.0,0.0
2337.0,17,4,344,2,150,0.0,75.0,75.0,2,194,0.0,103.0,97.0
297084.0,6,6,412,4,272,99028.0,74.0,68.0,2,140,0.0,74.0,70.0
4277105.0,6,84,80086,28,2009,158411.2962962963,207.0,71.75,56,78077,77620.87272727273,1514.0,1394.232142857143
11691.0,17,2,582,1,83,0.0,83.0,83.0,1,499,0.0,499.0,499.0
25556.0,6,10,2032,5,524,5541.0,252.0,104.8,5,1508,5994.0,1236.0,301.6
307664.0,6,7,478,4,272,102554.66666666669,74.0,68.0,3,206,79709.0,74.0,68.66666666666667
90083040.0,6,12,1848,7,828,15013840.0,188.0,118.28571428571428,5,1020,15015121.25,204.0,204.0
54890.0,6,14,4740,7,653,8991.5,249.0,93.28571428571428,7,4087,9005.833333333334,1514.0,583.8571428571429
147903.0,17,2,180,1,90,0.0,90.0,90.0,1,90,0.0,90.0,90.0
135145536.0,17,6,1206,6,1206,27029107.2,201.0,201.0,0,0,0.0,0.0,0.0
514142.0,6,3,1604,2,851,0.0,785.0,425.5,1,753,0.0,753.0,753.0
32220017.0,6,26,7627,14,3735,198860.0,1514.0,266.7857142857143,12,3892,2909519.090909091,1514.0,324.3333333333333
120322158.0,6,231,26224,116,18338,1046279.6347826088,284.0,158.08620689655172,115,7886,1046479.2192982456,140.0,68.57391304347826
2308.0,17,4,344,2,150,0.0,75.0,75.0,2,194,0.0,103.0,97.0
246100.0,6,3,337,2,214,0.0,160.0,107.0,1,123,0.0,123.0,123.0
29233.0,6,14,4740,7,653,3884.1666666666665,249.0,93.28571428571428,7,4087,4169.166666666667,1514.0,583.8571428571429
38464.0,6,10,2032,5,524,8125.5,252.0,104.8,5,1508,8616.5,1236.0,301.6
0.0,6,1,66,1,66,0.0,66.0,66.0,0,0,0.0,0.0,0.0
120128430.0,6,14,2224,9,1204,15016053.75,188.0,133.77777777777777,5,1020,22523236.75,204.0,204.0
228216.0,6,3,426,2,280,0.0,214.0,140.0,1,146,0.0,146.0,146.0
121456.0,6,3,337,2,214,0.0,160.0,107.0,1,123,0.0,123.0,123.0
1398950.0,17,16,1120,16,1120,93263.33333333331,70.0,70.0,0,0,0.0,0.0,0.0
24585.0,17,4,823,2,163,0.0,89.0,81.5,2,660,0.0,443.0,330.0
2798256.0,6,2,132,1,66,0.0,66.0,66.0,1,66,0.0,66.0,66.0
146173.0,17,4,571,2,148,0.0,74.0,74.0,2,423,0.0,276.0,211.5
59058.0,6,10,2032,5,524,14550.5,252.0,104.8,5,1508,11354.75,1236.0,301.6
298443.0,6,6,412,4,272,99481.0,74.0,68.0,2,140,0.0,74.0,70.0
98178749.0,17,12,778,6,389,19601007.2,174.0,64.83333333333333,6,389,19600203.4,174.0,64.83333333333333
15075.0,6,10,1067,5,536,3030.5,264.0,107.2,5,531,3154.75,259.0,106.2
379.0,17,2,267,1,83,0.0,83.0,83.0,1,184,0.0,184.0,184.0
3376574.0,6,154,123311,88,114653,38790.68965517241,1510.0,1302.875,66,8658,47100.32307692308,1510.0,131.1818181818182
115541.0,17,2,762,2,762,0.0,381.0,381.0,0,0,0.0,0.0,0.0
108110181.0,17,5,955,5,955,27027545.25,191.0,191.0,0,0,0.0,0.0,0.0
138627.0,6,2,132,1,66,0.0,66.0,66.0,1,66,0.0,66.0,66.0
207980.0,17,2,762,2,762,0.0,381.0,381.0,0,0,0.0,0.0,0.0
111164865.0,6,217,24522,109,7416,1029304.3055555556,140.0,68.03669724770643,108,17106,1029231.2523364486,284.0,158.38888888888889
120020709.0,17,29,13785,29,13785,4286453.892857143,501.0,475.3448275862069,0,0,0.0,0.0,0.0
304662.0,6,6,412,4,272,101554.0,74.0,68.0,2,140,0.0,74.0,70.0
2799040.0,6,2,132,1,66,0.0,66.0,66.0,1,66,0.0,66.0,66.0
135132876.0,17,6,1206,6,1206,27026575.2,201.0,201.0,0,0,0.0,0.0,0.0
90299000.0,6,17,1287,9,691,11281799.25,95.0,76.77777777777777,8,596,12899437.714285716,95.0,74.5
135141833.0,17,6,1146,6,1146,27028366.6,191.0,191.0,0,0,0.0,0.0,0.0
0.0,17,1,90,1,90,0.0,90.0,90.0,0,0,0.0,0.0,0.0
218743.0,6,14,4740,7,653,30384.0,249.0,93.28571428571428,7,4087,27133.166666666668,1514.0,583.8571428571429
46826.0,6,13,1386,7,789,7804.333333333333,253.0,112.71428571428572,6,597,8487.0,259.0,99.5
5005717.0,17,4,849,2,166,0.0,83.0,83.0,2,683,0.0,499.0,341.5
102651.0,17,2,286,2,286,0.0,143.0,143.0,0,0,0.0,0.0,0.0
196899.0,17,4,1400,4,1400,65633.0,350.0,350.0,0,0,0.0,0.0,0.0
313357.0,17,2,210,1,86,0.0,86.0,86.0,1,124,0.0,124.0,124.0
119526005.0,6,24,1788,12,894,10844180.090909092,95.0,74.5,12,894,10847366.181818182,95.0,74.5
120180361.0,6,222,25450,111,17828,1090592.018181818,374.0,160.61261261261262,111,7622,1090592.2272727273,140.0,68.66666666666667
233521.0,6,3,337,2,214,0.0,160.0,107.0,1,123,0.0,123.0,123.0
309065.0,17,4,704,2,148,0.0,74.0,74.0,2,556,0.0,280.0,278.0
978.0,17,4,438,2,148,0.0,74.0,74.0,2,290,0.0,147.0,145.0
135318.0,6,3,337,2,214,0.0,160.0,107.0,1,123,0.0,123.0,123.0
607049.0,17,2,335,1,88,0.0,88.0,88.0,1,247,0.0,247.0,247.0
33351.0,6,14,4740,7,653,5074.833333333333,249.0,93.28571428571428,7,4087,5331.166666666667,1514.0,583.8571428571429
205727.0,6,3,426,2,280,0.0,214.0,140.0,1,146,0.0,146.0,146.0
2250.0,17,2,508,2,508,0.0,257.0,254.0,0,0,0.0,0.0,0.0
37632.0,6,10,2032,5,524,8336.25,252.0,104.8,5,1508,8581.5,1236.0,301.6
101860643.0,17,13,1083,7,563,16976773.833333332,174.0,80.42857142857143,6,520,16412298.2,174.0,86.66666666666667
144116.0,17,2,180,1,90,0.0,90.0,90.0,1,90,0.0,90.0,90.0
16593.0,6,13,1459,7,862,2765.5,271.0,123.14285714285714,6,597,2527.4,259.0,99.5
15024222.0,17,6,2718,6,2718,3004844.4,453.0,453.0,0,0,0.0,0.0,0.0
91381072.0,6,24,1829,13,989,7614881.666666667,95.0,76.07692307692308,11,840,9137482.1,95.0,76.36363636363636
96076184.0,17,12,778,6,389,19202255.4,174.0,64.83333333333333,6,389,19200226.2,174.0,64.83333333333333
108104976.0,17,5,1005,5,1005,27026244.0,201.0,201.0,0,0,0.0,0.0,0.0
146169.0,6,3,337,2,214,0.0,160.0,107.0,1,123,0.0,123.0,123.0
320930.0,17,4,1400,4,1400,106976.66666666669,350.0,350.0,0,0,0.0,0.0,0.0
10483220.0,6,7,478,4,272,3448874.333333333,74.0,68.0,3,206,5173120.5,74.0,68.66666666666667
575486.0,6,4,508,2,238,0.0,172.0,119.0,2,270,0.0,135.0,135.0
135126528.0,17,6,1206,6,1206,27025305.6,201.0,201.0,0,0,0.0,0.0,0.0
322687.0,17,4,1400,4,1400,107562.33333333331,350.0,350.0,0,0,0.0,0.0,0.0
259938.0,6,10,1221,6,636,51987.6,298.0,106.0,4,585,79690.66666666667,379.0,146.25
327.0,17,2,174,1,79,0.0,79.0,79.0,1,95,0.0,95.0,95.0
300702.0,6,6,412,4,272,100234.0,74.0,68.0,2,140,0.0,74.0,70.0
147968.0,17,2,180,1,90,0.0,90.0,90.0,1,90,0.0,90.0,90.0
237058.0,17,2,359,1,75,0.0,75.0,75.0,1,284,0.0,284.0,284.0
42982.0,6,14,4740,7,653,7040.0,249.0,93.28571428571428,7,4087,6814.666666666667,1514.0,583.8571428571429
17467.0,6,13,1459,7,862,1985.6666666666667,271.0,123.14285714285714,6,597,3335.8,259.0,99.5
4609.0,17,2,762,2,762,0.0,381.0,381.0,0,0,0.0,0.0,0.0
103201.0,17,2,700,2,700,0.0,350.0,350.0,0,0,0.0,0.0,0.0
233939.0,6,3,373,2,238,0.0,172.0,119.0,1,135,0.0,135.0,135.0
11793596.0,6,5,1736,2,819,0.0,753.0,409.5,3,917,5826425.5,785.0,305.6666666666667
91876347.0,6,257,29554,129,20884,717783.9609375,284.0,161.89147286821705,128,8670,721794.2047244095,140.0,67.734375
77948.0,6,14,4740,7,653,12080.0,249.0,93.28571428571428,7,4087,12853.0,1514.0,583.8571428571429
379330.0,6,10,1221,6,636,75866.0,298.0,106.0,4,585,124737.66666666669,379.0,146.25
232865.0,6,3,373,2,238,0.0,172.0,119.0,1,135,0.0,135.0,135.0
107996.0,17,2,700,2,700,0.0,350.0,350.0,0,0,0.0,0.0,0.0
153448.0,17,2,180,1,90,0.0,90.0,90.0,1,90,0.0,90.0,90.0
108102393.0,17,5,955,5,955,27025598.25,191.0,191.0,0,0,0.0,0.0,0.0
239129.0,17,2,180,1,70,0.0,70.0,70.0,1,110,0.0,110.0,110.0
120158448.0,6,260,30362,130,8876,925137.992248062,140.0,68.27692307692308,130,21486,925093.2403100776,300.0,165.27692307692308
109641.0,6,15,4806,8,719,15558.857142857143,249.0,89.875,7,4087,17750.833333333332,1514.0,583.8571428571429
7514.0,17,4,344,2,150,0.0,75.0,75.0,2,194,0.0,103.0,97.0
10461744.0,6,6,412,3,206,5162517.0,74.0,68.66666666666667,3,206,5162373.0,74.0,68.66666666666667
103231955.0,6,32,2236,16,1165,6867745.666666667,139.0,72.8125,16,1071,6867743.666666667,123.0,66.9375
26140.0,6,12,1413,7,882,4356.666666666667,291.0,126.0,5,531,5847.25,259.0,106.2
307832.0,6,6,412,4,272,102610.66666666669,74.0,68.0,2,140,0.0,74.0,70.0
139001095.0,17,16,1212,9,649,17375136.875,174.0,72.11111111111111,7,563,16673882.0,174.0,80.42857142857143
9991.0,17,2,582,1,83,0.0,83.0,83.0,1,499,0.0,499.0,499.0
90255635.0,6,12,1832,8,1016,12893662.142857144,188.0,127.0,4,816,30030560.33333333,204.0,204.0
32681468.000000004,6,5,336,2,134,0.0,68.0,67.0,3,202,15052963.0,70.0,67.33333333333333
36537.0,6,14,4740,7,653,5187.333333333333,249.0,93.28571428571428,7,4087,4208.5,1514.0,583.8571428571429
108106814.0,17,5,1005,5,1005,27026703.5,201.0,201.0,0,0,0.0,0.0,0.0
2417.0,17,4,344,2,150,0.0,75.0,75.0,2,194,0.0,103.0,97.0
107640294.0,6,833,184128,425,156460,253868.6179245283,1514.0,368.1411764705882,408,27668,263910.53562653565,214.0,67.81372549019608
120102490.0,6,214,24292,107,7358,1125272.6320754718,140.0,68.76635514018692,107,16934,1125423.716981132,284.0,158.26168224299064
321040.0,17,4,1400,4,1400,107013.33333333331,350.0,350.0,0,0,0.0,0.0,0.0
36612.0,6,12,1320,6,723,6793.2,253.0,120.5,6,597,5730.4,259.0,99.5
66100.0,6,14,4740,7,653,10683.333333333334,249.0,93.28571428571428,7,4087,10751.333333333334,1514.0,583.8571428571429
30399.0,6,14,4740,7,653,4629.0,249.0,93.28571428571428,7,4087,4768.5,1514.0,583.8571428571429
108111649.0,17,5,1005,5,1005,27027912.25,201.0,201.0,0,0,0.0,0.0,0.0
47597580.0,6,8,1940,3,887,22490792.5,753.0,295.6666666666667,5,1053,11208010.75,785.0,210.6
90096454.0,6,13,2052,6,1224,18018782.6,204.0,204.0,7,828,15013211.333333334,188.0,118.28571428571428
1680032.0,17,18,1260,18,1260,98825.41176470587,70.0,70.0,0,0,0.0,0.0,0.0
3108946.0,6,20,6935,11,1567,310894.6,408.0,142.45454545454547,9,5368,340435.625,1514.0,596.4444444444445
3022940.0,6,162,129446,92,120524,33219.12087912088,1510.0,1310.0434782608695,70,8922,39324.11594202898,1510.0,127.45714285714286
90919519.0,6,21,1585,11,840,9091203.4,95.0,76.36363636363636,10,745,10100800.666666666,95.0,74.5
121377981.0,6,37,2719,19,1471,6743221.166666667,139.0,77.42105263157895,18,1248,6567106.176470588,123.0,69.33333333333333
207284.0,6,3,426,2,280,0.0,214.0,140.0,1,146,0.0,146.0,146.0
10472090.0,6,7,478,4,272,3445183.0,74.0,68.0,3,206,5167639.5,74.0,68.66666666666667
120053055.0,17,29,13785,29,13785,4287609.107142857,501.0,475.3448275862069,0,0,0.0,0.0,0.0
99378209.0,17,12,778,6,389,19800148.0,174.0,64.83333333333333,6,389,19800922.4,174.0,64.83333333333333
35333068.0,6,5,336,2,134,0.0,68.0,67.0,3,202,16264991.0,70.0,67.33333333333333
217824.0,6,3,426,2,280,0.0,214.0,140.0,1,146,0.0,146.0,146.0
216024.0,17,2,180,1,90,0.0,90.0,90.0,1,90,0.0,90.0,90.0
283805.0,17,2,363,1,79,0.0,79.0,79.0,1,284,0.0,284.0,284.0
2592615.0,6,2,132,1,66,0.0,66.0,66.0,1,66,0.0,66.0,66.0
90255431.0,6,14,2240,8,1016,12893633.0,188.0,127.0,6,1224,18018369.4,204.0,204.0
90295887.0,6,16,1192,8,596,12893024.714285716,95.0,74.5,8,596,12898380.42857143,95.0,74.5
207253.0,6,3,426,2,280,0.0,214.0,140.0,1,146,0.0,146.0,146.0
2348.0,17,4,344,2,150,0.0,75.0,75.0,2,194,0.0,103.0,97.0
120413103.0,6,219,24818,110,17328,1104707.3669724772,284.0,157.52727272727273,109,7490,1095742.8703703703,140.0,68.71559633027523
33706175.0,6,5,336,2,134,0.0,68.0,67.0,3,202,16782889.0,70.0,67.33333333333333
26749.0,6,13,1386,7,789,4458.166666666667,253.0,112.71428571428572,6,597,3814.0,259.0,99.5
205929.0,6,3,426,2,280,0.0,214.0,140.0,1,146,0.0,146.0,146.0
115398885.0,6,47,3102,23,1518,5199267.090909091,66.0,66.0,24,1584,5017331.304347826,66.0,66.0
97267.0,6,2,132,1,66,0.0,66.0,66.0,1,66,0.0,66.0,66.0
302690.0,6,6,412,4,272,100896.66666666669,74.0,68.0,2,140,0.0,74.0,70.0
228247.0,17,2,180,1,90,0.0,90.0,90.0,1,90,0.0,90.0,90.0
108096963.0,17,5,1005,5,1005,27024240.75,201.0,201.0,0,0,0.0,0.0,0.0
2147409.0,17,4,1368,4,1368,715803.0,342.0,342.0,0,0,0.0,0.0,0.0
411.0,17,2,410,1,78,0.0,78.0,78.0,1,332,0.0,332.0,332.0
90293839.0,6,19,1436,10,745,10027586.777777778,95.0,74.5,9,691,11285992.75,95.0,76.77777777777777
90094139.0,6,11,1644,4,816,30031003.33333333,204.0,204.0,7,828,15015293.833333334,188.0,118.28571428571428
120136216.0,6,228,25772,114,7746,1046719.4336283186,140.0,67.94736842105263,114,18026,1047661.4778761062,284.0,158.12280701754386
49153.0,6,14,4740,7,653,7564.666666666667,249.0,93.28571428571428,7,4087,7258.0,1514.0,583.8571428571429
27099200.0,17,5,1710,5,1710,6774800.0,342.0,342.0,0,0,0.0,0.0,0.0
32883.0,6,10,2032,5,524,7852.5,252.0,104.8,5,1508,7998.5,1236.0,301.6
127922247.0,6,35,2473,18,1348,7524838.05882353,139.0,74.88888888888889,17,1125,7416996.9375,123.0,66.17647058823529
204713.0,17,2,762,2,762,0.0,381.0,381.0,0,0,0.0,0.0,0.0
94255069.0,6,170,19206,85,13374,1119524.0476190476,284.0,157.34117647058824,85,5832,1119523.5,140.0,68.61176470588235
189358.0,17,2,180,1,90,0.0,90.0,90.0,1,90,0.0,90.0,90.0
96127.0,17,2,762,2,762,0.0,381.0,381.0,0,0,0.0,0.0,0.0
24810.0,6,10,2032,5,524,5968.0,252.0,104.8,5,1508,5940.75,1236.0,301.6
299770.0,6,6,412,4,272,99923.33333333331,74.0,68.0,2,140,0.0,74.0,70.0
316380.0,17,4,1400,4,1400,105460.0,350.0,350.0,0,0,0.0,0.0,0.0
242593.0,6,3,337,2,214,0.0,160.0,107.0,1,123,0.0,123.0,123.0
213741.0,6,10,1221,6,636,42748.2,298.0,106.0,4,585,70067.66666666667,379.0,146.25
1157698.0,6,13,3010,8,2382,165385.42857142858,1514.0,297.75,5,628,221245.75,331.0,125.6
16829.0,6,10,2032,5,524,3978.75,252.0,104.8,5,1508,3834.0,1236.0,301.6
178151.0,17,2,180,1,90,0.0,90.0,90.0,1,90,0.0,90.0,90.0
217825.0,6,3,426,2,280,0.0,214.0,140.0,1,146,0.0,146.0,146.0
9465.0,17,2,582,1,83,0.0,83.0,83.0,1,499,0.0,499.0,499.0
2511.0,17,4,344,2,150,0.0,75.0,75.0,2,194,0.0,103.0,97.0
236804.0,6,3,337,2,214,0.0,160.0,107.0,1,123,0.0,123.0,123.0
90530268.0,6,14,2102,8,1016,12932895.42857143,188.0,127.0,6,1086,18073863.2,204.0,181.0
328.0,17,2,250,1,93,0.0,93.0,93.0,1,157,0.0,157.0,157.0
5023582.0,6,11,1139,6,608,1004524.8,262.0,101.33333333333331,5,531,2723.25,259.0,106.2
10444796.0,6,7,478,4,272,3436073.0,74.0,68.0,3,206,5154000.5,74.0,68.66666666666667
216830.0,6,3,426,2,280,0.0,214.0,140.0,1,146,0.0,146.0,146.0
2414.0,17,4,344,2,150,0.0,75.0,75.0,2,194,0.0,103.0,97.0
536334.0,17,6,2100,6,2100,107266.8,350.0,350.0,0,0,0.0,0.0,0.0
5625310.0,6,5,336,2,134,0.0,68.0,67.0,3,202,1425846.0,70.0,67.33333333333333
90257082.0,6,12,1832,8,1016,12893868.857142856,188.0,127.0,4,816,30031428.0,204.0,204.0
2396.0,17,4,344,2,150,0.0,75.0,75.0,2,194,0.0,103.0,97.0
827.0,17,4,438,2,148,0.0,74.0,74.0,2,290,0.0,147.0,145.0
219452.0,6,10,1221,6,636,43890.4,298.0,106.0,4,585,71789.0,379.0,146.25
90257340.0,6,13,2036,8,1016,12893905.714285716,188.0,127.0,5,1020,22523708.5,204.0,204.0
121387.0,6,3,337,2,214,0.0,160.0,107.0,1,123,0.0,123.0,123.0
332.0,17,2,152,1,76,0.0,76.0,76.0,1,76,0.0,76.0,76.0
120125692.0,6,13,2020,9,1204,15015711.5,188.0,133.77777777777777,4,816,30031710.33333333,204.0,204.0
33703.0,6,14,4740,7,653,5434.333333333333,249.0,93.28571428571428,7,4087,5313.666666666667,1514.0,583.8571428571429
30726857.0,6,11,840,6,447,6137187.0,95.0,74.5,5,393,7680378.5,95.0,78.6
113545532.0,6,254,28906,127,20302,899436.6746031746,284.0,159.85826771653544,127,8604,899437.1111111111,140.0,67.74803149606299
28876.0,6,14,4740,7,653,4461.5,249.0,93.28571428571428,7,4087,4402.0,1514.0,583.8571428571429
2126.0,17,2,664,1,322,0.0,322.0,322.0,1,342,0.0,342.0,342.0
10533754.0,6,7,478,4,272,3464075.0,74.0,68.0,3,206,5195970.0,74.0,68.66666666666667
116596505.0,6,48,3168,24,1584,5069413.260869565,66.0,66.0,24,1584,5055952.739130435,66.0,66.0
144514.0,17,4,1524,4,1524,48171.333333333336,381.0,381.0,0,0,0.0,0.0,0.0
43922.0,6,12,1328,7,797,7320.333333333333,253.0,113.85714285714286,5,531,8700.75,259.0,106.2
110110177.0,17,13,821,7,432,18351696.166666668,174.0,61.71428571428572,6,389,18114746.6,174.0,64.83333333333333
218638.0,6,10,1221,6,636,43727.6,298.0,106.0,4,585,71794.0,379.0,146.25
120073601.0,17,29,13785,29,13785,4288342.892857143,501.0,475.3448275862069,0,0,0.0,0.0,0.0
301.0,17,2,174,1,79,0.0,79.0,79.0,1,95,0.0,95.0,95.0
16143.000000000002,6,10,2032,5,524,3142.5,252.0,104.8,5,1508,3713.25,1236.0,301.6
114971257.0,6,35,2542,18,1348,6750318.176470588,139.0,74.88888888888889,17,1194,7172213.25,123.0,70.23529411764706
97605209.0,6,26,1746,13,906,8115780.916666667,123.0,69.6923076923077,13,840,8115793.5,123.0,64.61538461538461
47842.0,6,14,4740,7,653,7488.5,249.0,93.28571428571428,7,4087,7617.0,1514.0,583.8571428571429
209631.0,17,2,180,1,90,0.0,90.0,90.0,1,90,0.0,90.0,90.0
16417708.000000002,6,24,7569,13,2049,1368142.3333333333,408.0,157.6153846153846,11,5520,1229221.5,1514.0,501.8181818181818
33732.0,6,13,1479,7,882,5622.0,291.0,126.0,6,597,5632.6,259.0,99.5
146714.0,6,3,337,2,214,0.0,160.0,107.0,1,123,0.0,123.0,123.0
227046.0,6,10,1221,6,636,45409.2,298.0,106.0,4,585,73709.66666666667,379.0,146.25
122975566.0,6,48,3168,24,1584,5063108.0869565215,66.0,66.0,24,1584,5203980.826086956,66.0,66.0
132687014.0,17,15,907,7,432,18833496.83333333,174.0,61.71428571428572,8,475,18858580.0,174.0,59.375
97011481.0,6,171,19362,86,13530,1141311.5411764707,284.0,157.32558139534885,85,5832,1142595.4285714286,140.0,68.61176470588235
90448754.0,6,322,38688,161,10848,565212.925,140.0,67.37888198757764,161,27840,560125.9625,284.0,172.91925465838509
27370.0,6,11,2098,6,590,4961.8,252.0,98.33333333333331,5,1508,6088.5,1236.0,301.6
439464.0,17,2,363,1,79,0.0,79.0,79.0,1,284,0.0,284.0,284.0
106931.0,17,2,286,2,286,0.0,143.0,143.0,0,0,0.0,0.0,0.0
19059.0,17,3,1026,3,1026,9529.5,342.0,342.0,0,0,0.0,0.0,0.0
48254.0,6,10,2032,5,524,11802.0,252.0,104.8,5,1508,11773.75,1236.0,301.6
206163.0,6,3,426,2,280,0.0,214.0,140.0,1,146,0.0,146.0,146.0
252895.0,6,6,386,4,247,84298.33333333333,85.0,61.75,2,139,0.0,85.0,69.5
108104767.0,17,5,955,5,955,27026191.75,191.0,191.0,0,0,0.0,0.0,0.0
217051.0,6,3,426,2,280,0.0,214.0,140.0,1,146,0.0,146.0,146.0
153472.0,17,2,180,1,90,0.0,90.0,90.0,1,90,0.0,90.0,90.0
89832829.0,6,19,1334,9,640,11227940.25,95.0,71.11111111111111,10,694,9980071.666666666,95.0,69.4
52945.0,6,14,4740,7,653,7814.0,249.0,93.28571428571428,7,4087,8497.666666666666,1514.0,583.8571428571429
153446.0,17,2,180,1,90,0.0,90.0,90.0,1,90,0.0,90.0,90.0
216621.0,6,3,426,2,280,0.0,214.0,140.0,1,146,0.0,146.0,146.0
321885.0,6,6,412,4,272,107295.0,74.0,68.0,2,140,0.0,74.0,70.0
374.0,17,2,267,1,83,0.0,83.0,83.0,1,184,0.0,184.0,184.0
1022029.0,6,11,1134,6,558,204405.8,220.0,93.0,5,576,254603.75,304.0,115.2
317011.0,17,2,176,1,80,0.0,80.0,80.0,1,96,0.0,96.0,96.0
123250440.0,6,49,3234,25,1650,5135435.0,66.0,66.0,24,1584,5021736.782608695,66.0,66.0
35850.0,6,10,2032,5,524,8575.25,252.0,104.8,5,1508,8720.75,1236.0,301.6
5628451.0,6,5,336,2,134,0.0,68.0,67.0,3,202,1524369.5,70.0,67.33333333333333
107211.0,17,2,286,2,286,0.0,143.0,143.0,0,0,0.0,0.0,0.0
106762964.0,6,30,2106,15,1089,7610495.0,123.0,72.6,15,1017,7610493.714285715,123.0,67.8
110992784.0,6,31,2182,16,1165,7385131.066666666,139.0,72.8125,15,1017,7912642.571428572,123.0,67.8
247693.0,6,3,337,2,214,0.0,160.0,107.0,1,123,0.0,123.0,123.0
318.0,17,2,174,1,79,0.0,79.0,79.0,1,95,0.0,95.0,95.0
21996.0,6,14,4740,7,653,3519.0,249.0,93.28571428571428,7,4087,3434.1666666666665,1514.0,583.8571428571429
206635.0,6,3,426,2,280,0.0,214.0,140.0,1,146,0.0,146.0,146.0
153423.0,17,2,180,1,90,0.0,90.0,90.0,1,90,0.0,90.0,90.0
216415.0,17,2,180,1,90,0.0,90.0,90.0,1,90,0.0,90.0,90.0
310741.0,17,4,1400,4,1400,103580.33333333331,350.0,350.0,0,0,0.0,0.0,0.0
47099.0,6,10,2032,5,524,11166.5,252.0,104.8,5,1508,10933.25,1236.0,301.6
48724.0,6,14,4740,7,653,7996.666666666667,249.0,93.28571428571428,7,4087,7979.0,1514.0,583.8571428571429
31137.0,6,14,4740,7,653,4610.333333333333,249.0,93.28571428571428,7,4087,5010.0,1514.0,583.8571428571429
438.0,17,2,166,1,75,0.0,75.0,75.0,1,91,0.0,91.0,91.0
103236089.0,6,43,2838,22,1452,4915992.523809524,66.0,66.0,21,1386,5161483.6,66.0,66.0
13658.0,6,10,1066,5,490,2354.75,218.0,98.0,5,576,3227.25,304.0,115.2
922.0,17,5,550,5,550,230.5,110.0,110.0,0,0,0.0,0.0,0.0
205870.0,17,2,180,1,90,0.0,90.0,90.0,1,90,0.0,90.0,90.0
187271.0,17,2,180,1,90,0.0,90.0,90.0,1,90,0.0,90.0,90.0
232868.0,6,3,337,2,214,0.0,160.0,107.0,1,123,0.0,123.0,123.0
90011041.0,17,28,13364,28,13364,3333742.25925926,501.0,477.2857142857143,0,0,0.0,0.0,0.0
121284.0,6,3,337,2,214,0.0,160.0,107.0,1,123,0.0,123.0,123.0
2767679.0,6,2,132,1,66,0.0,66.0,66.0,1,66,0.0,66.0,66.0
57689.0,6,14,4740,7,653,8206.0,249.0,93.28571428571428,7,4087,9279.666666666666,1514.0,583.8571428571429
241413.0,6,3,373,2,238,0.0,172.0,119.0,1,135,0.0,135.0,135.0
90531717.0,6,14,2102,8,1016,12933102.42857143,188.0,127.0,6,1086,18074148.0,204.0,181.0
107318435.0,6,32,2236,16,1165,7140173.933333334,139.0,72.8125,16,1071,7140172.4,123.0,66.9375
306292.0,6,6,412,4,272,102097.33333333331,74.0,68.0,2,140,0.0,74.0,70.0
3006250.0,6,12,2172,7,664,500951.1666666667,252.0,94.85714285714286,5,1508,2687.75,1236.0,301.6
249874.0,6,3,337,2,214,0.0,160.0,107.0,1,123,0.0,123.0,123.0
2440.0,17,4,344,2,150,0.0,75.0,75.0,2,194,0.0,103.0,97.0
100759.0,17,2,286,2,286,0.0,143.0,143.0,0,0,0.0,0.0,0.0
90264019.0,6,13,2036,8,1016,12894859.857142856,188.0,127.0,5,1020,22525433.75,204.0,204.0
104999469.0,17,15,5130,15,5130,7499962.071428572,342.0,342.0,0,0,0.0,0.0,0.0
10525286.0,6,7,478,4,272,3461321.0,74.0,68.0,3,206,5191872.5,74.0,68.66666666666667
297664.0,6,6,412,4,272,99221.33333333331,74.0,68.0,2,140,0.0,74.0,70.0
31709225.0,17,3,264,3,264,15854612.5,88.0,88.0,0,0,0.0,0.0,0.0
345267.0,6,13,1386,7,789,57544.5,253.0,112.71428571428572,6,597,67899.2,259.0,99.5
44996.0,6,14,4740,7,653,7246.333333333333,249.0,93.28571428571428,7,4087,5861.0,1514.0,583.8571428571429
121935.0,6,3,373,2,238,0.0,172.0,119.0,1,135,0.0,135.0,135.0
2266460.0,6,3,1604,2,851,0.0,785.0,425.5,1,753,0.0,753.0,753.0
25318.0,6,10,2032,5,524,5761.0,252.0,104.8,5,1508,6070.5,1236.0,301.6
90295387.0,6,16,1192,8,596,12893613.857142856,95.0,74.5,8,596,12898346.142857144,95.0,74.5
348.0,17,2,267,1,83,0.0,83.0,83.0,1,184,0.0,184.0,184.0
39886.0,6,14,4740,7,653,6484.666666666667,249.0,93.28571428571428,7,4087,6202.833333333333,1514.0,583.8571428571429
2796035.0,6,2,132,1,66,0.0,66.0,66.0,1,66,0.0,66.0,66.0
44249.0,6,10,1065,5,534,10658.75,262.0,106.8,5,531,10551.0,259.0,106.2
53667.0,6,12,1447,6,816,9921.2,291.0,136.0,6,631,10188.2,293.0,105.16666666666669
78487.0,6,13,1386,7,789,13081.166666666666,253.0,112.71428571428572,6,597,14981.4,259.0,99.5
90059786.0,17,28,13364,28,13364,3335547.6296296297,501.0,477.2857142857143,0,0,0.0,0.0,0.0
97714.0,17,2,762,2,762,0.0,381.0,381.0,0,0,0.0,0.0,0.0
2435.0,17,4,344,2,150,0.0,75.0,75.0,2,194,0.0,103.0,97.0
316.0,17,2,174,1,79,0.0,79.0,79.0,1,95,0.0,95.0,95.0
35121.0,6,10,2032,5,524,8154.75,252.0,104.8,5,1508,7690.0,1236.0,301.6
143886.0,17,2,180,1,90,0.0,90.0,90.0,1,90,0.0,90.0,90.0
305209.0,17,4,704,2,148,0.0,74.0,74.0,2,556,0.0,280.0,278.0
217804.0,6,3,426,2,280,0.0,214.0,140.0,1,146,0.0,146.0,146.0
30169.0,6,14,4740,7,653,4879.166666666667,249.0,93.28571428571428,7,4087,4247.833333333333,1514.0,583.8571428571429
34571.0,6,14,4740,7,653,5632.0,249.0,93.28571428571428,7,4087,4955.0,1514.0,583.8571428571429
122975405.0,6,48,3168,24,1584,5091127.478260869,66.0,66.0,24,1584,5175968.217391305,66.0,66.0
60645.0,6,14,4740,7,653,8732.666666666666,249.0,93.28571428571428,7,4087,8718.333333333334,1514.0,583.8571428571429
259252.0,6,3,337,2,214,0.0,160.0,107.0,1,123,0.0,123.0,123.0
90749872.0,6,22,1680,12,894,8245446.454545454,95.0,74.5,10,786,10081262.555555556,95.0,78.6
11532743.0,17,4,1368,4,1368,3844247.6666666665,342.0,342.0,0,0,0.0,0.0,0.0
2054.0,17,4,344,2,150,0.0,75.0,75.0,2,194,0.0,103.0,97.0
17222.0,17,2,180,1,90,0.0,90.0,90.0,1,90,0.0,90.0,90.0
13908.0,6,13,1459,7,862,2244.0,271.0,123.14285714285714,6,597,2606.0,259.0,99.5
197666.0,17,2,180,1,90,0.0,90.0,90.0,1,90,0.0,90.0,90.0
30573.0,6,14,4740,7,653,4914.0,249.0,93.28571428571428,7,4087,4639.666666666667,1514.0,583.8571428571429
315800.0,17,4,1400,4,1400,105266.66666666669,350.0,350.0,0,0,0.0,0.0,0.0
3989064.0,6,200,163703,113,153659,35616.642857142855,1510.0,1359.8141592920354,87,10044,42834.33720930233,1510.0,115.44827586206895
103956.0,17,2,762,2,762,0.0,381.0,381.0,0,0,0.0,0.0,0.0
122530372.0,6,49,3234,25,1650,5105432.166666667,66.0,66.0,24,1584,4890765.739130435,66.0,66.0
107084.0,17,2,286,2,286,0.0,143.0,143.0,0,0,0.0,0.0,0.0
108611069.0,6,30,2106,15,1089,7742518.142857143,123.0,72.6,15,1017,7742519.357142857,123.0,67.8
120000178.0,6,17,1287,9,691,15000022.25,95.0,76.77777777777777,8,596,12897967.714285716,95.0,74.5
120004231.0,6,24,2151,13,1393,9999999.166666666,256.0,107.15384615384616,11,758,11924107.2,95.0,68.9090909090909
1025413.0,6,11,1134,6,558,205082.60000000003,220.0,93.0,5,576,255633.25,304.0,115.2
361.0,17,2,267,1,83,0.0,83.0,83.0,1,184,0.0,184.0,184.0
198459.0,17,2,180,1,90,0.0,90.0,90.0,1,90,0.0,90.0,90.0
79340.0,6,10,2032,5,524,19408.25,252.0,104.8,5,1508,18789.5,1236.0,301.6
100793339.0,6,30,2106,15,1089,7184115.285714285,123.0,72.6,15,1017,7184115.642857143,123.0,67.8
311950.0,6,6,412,4,272,103983.33333333331,74.0,68.0,2,140,0.0,74.0,70.0
122210883.0,6,32,2226,17,1209,7638180.1875,123.0,71.11764705882354,15,1017,8000714.714285715,123.0,67.8
2337.0,17,4,344,2,150,0.0,75.0,75.0,2,194,0.0,103.0,97.0
1029794.0,6,11,1134,6,558,205958.8,220.0,93.0,5,576,256577.0,304.0,115.2
113435346.0,6,252,29388,126,20776,905761.04,284.0,164.88888888888889,126,8612,905761.216,140.0,68.34920634920636
90058.0,17,4,1400,4,1400,30019.33333333333,350.0,350.0,0,0,0.0,0.0,0.0
123001123.0,17,15,907,8,475,17571589.0,174.0,59.375,7,432,17177923.833333332,174.0,61.71428571428572
147955.0,17,2,180,1,90,0.0,90.0,90.0,1,90,0.0,90.0,90.0
4464.0,17,2,180,1,90,0.0,90.0,90.0,1,90,0.0,90.0,90.0
0.0,17,1,90,1,90,0.0,90.0,90.0,0,0,0.0,0.0,0.0
18615.0,6,10,2032,5,524,4279.75,252.0,104.8,5,1508,3760.25,1236.0,301.6
250576.00000000003,6,3,337,2,214,0.0,160.0,107.0,1,123,0.0,123.0,123.0
108111365.0,17,5,1005,5,1005,27027841.25,201.0,201.0,0,0,0.0,0.0,0.0
146708.0,6,3,373,2,238,0.0,172.0,119.0,1,135,0.0,135.0,135.0
90286964.0,6,18,1468,9,650,11279885.375,95.0,72.22222222222223,9,818,11284620.625,222.0,90.88888888888889
173061.0,17,2,180,1,90,0.0,90.0,90.0,1,90,0.0,90.0,90.0
162326.0,17,2,180,1,90,0.0,90.0,90.0,1,90,0.0,90.0,90.0
1451.0,17,2,762,2,762,0.0,381.0,381.0,0,0,0.0,0.0,0.0
90090484.0,6,11,1644,7,828,15015080.666666666,188.0,118.28571428571428,4,816,20020134.0,204.0,204.0
14642226.0,6,20,1648,10,1016,1593071.0,315.0,101.6,10,632,1593042.3333333333,78.0,63.2
285510.0,17,2,363,1,79,0.0,79.0,79.0,1,284,0.0,284.0,284.0
308499.0,6,6,412,4,272,102833.0,74.0,68.0,2,140,0.0,74.0,70.0
90255336.0,6,14,2240,8,1016,12893619.42857143,188.0,127.0,6,1224,18018094.4,204.0,204.0
453650.0,6,6,758,3,410,186235.0,172.0,136.66666666666666,3,348,166861.0,135.0,116.0
330941.0,6,6,412,4,272,110313.66666666669,74.0,68.0,2,140,0.0,74.0,70.0
217861.0,6,3,426,2,280,0.0,214.0,140.0,1,146,0.0,146.0,146.0
36409.0,6,13,1479,7,882,6068.166666666667,291.0,126.0,6,597,6392.6,259.0,99.5
14112.0,6,14,4740,7,653,2237.333333333333,249.0,93.28571428571428,7,4087,2142.1666666666665,1514.0,583.8571428571429
120002392.0,6,21,1585,12,894,10909308.363636363,95.0,74.5,9,691,14967848.375,95.0,76.77777777777777
122911.0,6,3,337,2,214,0.0,160.0,107.0,1,123,0.0,123.0,123.0
153406.0,17,2,180,1,90,0.0,90.0,90.0,1,90,0.0,90.0,90.0
14000.0,6,10,1067,5,536,2777.5,264.0,107.2,5,531,3303.25,259.0,106.2
60889556.0,6,5,1736,2,819,0.0,753.0,409.5,3,917,30444778.0,785.0,305.6666666666667
25083.0,6,10,2032,5,524,6035.75,252.0,104.8,5,1508,5621.5,1236.0,301.6
13237.0,6,14,4740,7,653,1999.8333333333333,249.0,93.28571428571428,7,4087,2072.833333333333,1514.0,583.8571428571429
135146891.0,17,6,1146,6,1146,27029378.2,191.0,191.0,0,0,0.0,0.0,0.0
1063188.0,6,3,1604,2,851,0.0,785.0,425.5,1,753,0.0,753.0,753.0
12818882.0,6,5,1736,2,819,0.0,753.0,409.5,3,917,6339390.0,785.0,305.6666666666667
38331.0,6,10,2032,5,524,9272.25,252.0,104.8,5,1508,8473.0,1236.0,301.6
90045635.0,17,28,13364,28,13364,3335023.5185185187,501.0,477.2857142857143,0,0,0.0,0.0,0.0
248743.0,6,3,337,2,214,0.0,160.0,107.0,1,123,0.0,123.0,123.0
117818831.0,6,48,3168,24,1584,5122557.869565218,66.0,66.0,24,1584,5113160.260869565,66.0,66.0
2370582.0,6,32,10926,18,3951,139446.0,1514.0,219.5,14,6975,162088.76923076922,1514.0,498.2142857142857
102290148.0,6,196,22272,98,15582,1052319.3402061856,284.0,159.0,98,6690,1052319.4639175255,140.0,68.26530612244898
9593.0,17,4,823,2,163,0.0,89.0,81.5,2,660,0.0,443.0,330.0
20734.0,6,14,4740,7,653,3346.6666666666665,249.0,93.28571428571428,7,4087,3300.5,1514.0,583.8571428571429
106425.0,17,2,286,2,286,0.0,143.0,143.0,0,0,0.0,0.0,0.0
49677.0,6,14,4740,7,653,8148.166666666667,249.0,93.28571428571428,7,4087,7119.0,1514.0,583.8571428571429
90303186.0,6,14,2102,8,1016,12900455.142857144,188.0,127.0,6,1086,18028492.0,204.0,181.0
125802.0,6,3,202,1,66,0.0,66.0,66.0,2,136,0.0,70.0,68.0
305910.0,6,3,202,2,128,0.0,74.0,64.0,1,74,0.0,74.0,74.0
110577.0,17,2,286,2,286,0.0,143.0,143.0,0,0,0.0,0.0,0.0
163863.0,6,13,1479,7,882,25507.666666666668,291.0,126.0,6,597,29415.4,259.0,99.5
54022.0,6,14,4740,7,653,8524.833333333334,249.0,93.28571428571428,7,4087,8757.166666666666,1514.0,583.8571428571429
279056.0,6,10,1221,6,636,55811.2,298.0,106.0,4,585,89665.33333333333,379.0,146.25
146130.0,6,3,373,2,238,0.0,172.0,119.0,1,135,0.0,135.0,135.0
98976.0,17,2,762,2,762,0.0,381.0,381.0,0,0,0.0,0.0,0.0
135130886.0,17,6,1146,6,1146,27026177.2,191.0,191.0,0,0,0.0,0.0,0.0
13696595.0,17,6,2052,6,2052,2739319.0,342.0,342.0,0,0,0.0,0.0,0.0
223879.0,17,2,180,1,90,0.0,90.0,90.0,1,90,0.0,90.0,90.0
199856.0,17,2,180,1,90,0.0,90.0,90.0,1,90,0.0,90.0,90.0
156675.0,6,3,337,2,214,0.0,160.0,107.0,1,123,0.0,123.0,123.0
107090.0,17,2,700,2,700,0.0,350.0,350.0,0,0,0.0,0.0,0.0
219305.0,6,10,1221,6,636,43861.0,298.0,106.0,4,585,71343.33333333333,379.0,146.25
125001203.0,17,15,1169,8,606,17857314.714285713,174.0,75.75,7,563,17502364.333333332,174.0,80.42857142857143
129001158.0,17,15,907,8,475,18428736.85714286,174.0,59.375,7,432,18167699.666666668,174.0,61.71428571428572
307.0,17,2,174,1,79,0.0,79.0,79.0,1,95,0.0,95.0,95.0
42430.0,6,10,2032,5,524,10373.0,252.0,104.8,5,1508,9973.0,1236.0,301.6
320346.0,17,4,1400,4,1400,106782.0,350.0,350.0,0,0,0.0,0.0,0.0
311113.0,17,4,1400,4,1400,103704.33333333331,350.0,350.0,0,0,0.0,0.0,0.0
59020.0,6,14,4740,7,653,9387.5,249.0,93.28571428571428,7,4087,8496.666666666666,1514.0,583.8571428571429
343.0,17,2,168,1,76,0.0,76.0,76.0,1,92,0.0,92.0,92.0
0.0,6,1,54,0,0,0.0,0.0,0.0,1,54,0.0,54.0,54.0
90258878.0,6,13,1898,8,1016,12894125.42857143,188.0,127.0,5,882,22524398.5,204.0,176.4
1235.0,17,4,438,2,148,0.0,74.0,74.0,2,290,0.0,147.0,145.0
322584.0,17,4,622,4,622,107528.0,163.0,155.5,0,0,0.0,0.0,0.0
20202.0,17,4,823,2,163,0.0,89.0,81.5,2,660,0.0,443.0,330.0
213570.0,17,2,180,1,90,0.0,90.0,90.0,1,90,0.0,90.0,90.0
72064.0,6,14,4740,7,653,11323.833333333334,249.0,93.28571428571428,7,4087,11176.833333333334,1514.0,583.8571428571429
2174750.0,6,19,6869,11,1567,217475.0,408.0,142.45454545454547,8,5302,248654.7142857143,1514.0,662.75
30187.0,6,14,4740,7,653,4909.166666666667,249.0,93.28571428571428,7,4087,4512.333333333333,1514.0,583.8571428571429
47912.0,6,14,4740,7,653,7419.0,249.0,93.28571428571428,7,4087,5869.166666666667,1514.0,583.8571428571429
90257151.0,6,13,2036,8,1016,12893878.714285716,188.0,127.0,5,1020,22523002.5,204.0,204.0
0.0,17,1,44,1,44,0.0,44.0,44.0,0,0,0.0,0.0,0.0
120030882.0,6,226,25550,113,7754,1065411.5892857143,140.0,68.61946902654867,113,17796,1065467.5982142857,284.0,157.4867256637168
4640.0,17,2,398,1,88,0.0,88.0,88.0,1,310,0.0,310.0,310.0
1094009.0,6,13,1479,7,882,182334.8333333333,291.0,126.0,6,597,217563.4,259.0,99.5
9592.0,17,2,571,1,86,0.0,86.0,86.0,1,485,0.0,485.0,485.0
108104977.0,17,5,1005,5,1005,27026244.25,201.0,201.0,0,0,0.0,0.0,0.0
92879809.0,6,37,2442,19,1254,5159989.388888889,66.0,66.0,18,1188,5231371.05882353,66.0,66.0
144127.0,17,2,180,1,90,0.0,90.0,90.0,1,90,0.0,90.0,90.0
121271.0,6,3,337,2,214,0.0,160.0,107.0,1,123,0.0,123.0,123.0
2353.0,17,4,344,2,150,0.0,75.0,75.0,2,194,0.0,103.0,97.0
8871.0,17,2,582,1,83,0.0,83.0,83.0,1,499,0.0,499.0,499.0
307072.0,17,2,238,1,74,0.0,74.0,74.0,1,164,0.0,164.0,164.0
41681.0,6,2,132,1,66,0.0,66.0,66.0,1,66,0.0,66.0,66.0
855083.0,6,9,1096,6,625,171016.6,287.0,104.16666666666669,3,471,291120.0,331.0,157.0
2605587.0,6,2,132,1,66,0.0,66.0,66.0,1,66,0.0,66.0,66.0
108100765.0,17,5,955,5,955,27025191.25,191.0,191.0,0,0,0.0,0.0,0.0
304626.0,6,6,412,4,272,101542.0,74.0,68.0,2,140,0.0,74.0,70.0
233253.0,6,3,373,2,238,0.0,172.0,119.0,1,135,0.0,135.0,135.0
2373.0,17,4,344,2,150,0.0,75.0,75.0,2,194,0.0,103.0,97.0
64144.00000000001,6,11,2098,6,590,12323.0,252.0,98.33333333333331,5,1508,11565.75,1236.0,301.6
35520711.0,6,5,336,2,134,0.0,68.0,67.0,3,202,17719753.5,70.0,67.33333333333333
90224371.0,6,14,2240,8,1016,12889195.857142856,188.0,127.0,6,1224,18012292.0,204.0,204.0
206288.0,17,2,762,2,762,0.0,381.0,381.0,0,0,0.0,0.0,0.0
90528188.0,6,14,2240,8,1016,12932598.285714284,188.0,127.0,6,1224,18073404.8,204.0,204.0
6364.0,17,4,823,2,163,0.0,89.0,81.5,2,660,0.0,443.0,330.0
349.0,17,2,267,1,83,0.0,83.0,83.0,1,184,0.0,184.0,184.0
47117.0,6,10,2032,5,524,10615.0,252.0,104.8,5,1508,10672.25,1236.0,301.6
91634114.0,6,194,22500,97,15876,952280.1979166666,284.0,163.6701030927835,97,6624,952279.9791666666,140.0,68.28865979381443
107719.0,17,2,286,2,286,0.0,143.0,143.0,0,0,0.0,0.0,0.0
108106536.0,17,5,955,5,955,27026634.0,191.0,191.0,0,0,0.0,0.0,0.0
2787434.0,6,2,132,1,66,0.0,66.0,66.0,1,66,0.0,66.0,66.0
108105008.0,17,5,955,5,955,27026252.0,191.0,191.0,0,0,0.0,0.0,0.0
55521.0,6,14,4740,7,653,8956.166666666666,249.0,93.28571428571428,7,4087,7906.666666666667,1514.0,583.8571428571429
103078.0,17,2,286,2,286,0.0,143.0,143.0,0,0,0.0,0.0,0.0
2047.0,17,4,344,2,150,0.0,75.0,75.0,2,194,0.0,103.0,97.0
326.0,17,2,174,1,79,0.0,79.0,79.0,1,95,0.0,95.0,95.0
102945.0,17,2,700,2,700,0.0,350.0,350.0,0,0,0.0,0.0,0.0
2524.0,17,4,344,2,150,0.0,75.0,75.0,2,194,0.0,103.0,97.0
130093.0,6,2,132,1,66,0.0,66.0,66.0,1,66,0.0,66.0,66.0
29908.0,17,2,180,1,90,0.0,90.0,90.0,1,90,0.0,90.0,90.0
2859.0,17,2,224,1,76,0.0,76.0,76.0,1,148,0.0,148.0,148.0
2595580.0,6,2,132,1,66,0.0,66.0,66.0,1,66,0.0,66.0,66.0
43067.0,6,14,4740,7,653,6245.833333333333,249.0,93.28571428571428,7,4087,6295.666666666667,1514.0,583.8571428571429
120182175.0,6,204,22980,102,7028,1181904.7821782178,140.0,68.90196078431373,102,15952,1181810.4653465347,284.0,156.3921568627451
516886.0,6,5,336,2,134,0.0,68.0,67.0,3,202,192268.0,70.0,67.33333333333333
117157781.0,17,13,821,7,432,19499811.666666668,174.0,61.71428571428572,6,389,19449411.0,174.0,64.83333333333333
333.0,17,2,166,1,75,0.0,75.0,75.0,1,91,0.0,91.0,91.0
746605.0,6,2,132,1,66,0.0,66.0,66.0,1,66,0.0,66.0,66.0
67500.0,6,14,4740,7,653,10808.5,249.0,93.28571428571428,7,4087,9058.666666666666,1514.0,583.8571428571429
46475.0,6,14,4740,7,653,7625.666666666667,249.0,93.28571428571428,7,4087,7576.5,1514.0,583.8571428571429
539191.0,17,6,2100,6,2100,107838.2,350.0,350.0,0,0,0.0,0.0,0.0
123918646.0,6,30,2037,15,948,8304996.0,123.0,63.2,15,1089,8137940.714285715,123.0,72.6
306.0,17,2,174,1,79,0.0,79.0,79.0,1,95,0.0,95.0,95.0
56083.0,6,14,4740,7,653,9226.666666666666,249.0,93.28571428571428,7,4087,9112.0,1514.0,583.8571428571429
40689.0,6,14,4740,7,653,6294.833333333333,249.0,93.28571428571428,7,4087,5970.166666666667,1514.0,583.8571428571429
302411.0,6,2,132,1,66,0.0,66.0,66.0,1,66,0.0,66.0,66.0
108429503.0,17,14,864,7,432,18000187.833333332,174.0,61.71428571428572,7,432,18001485.833333332,174.0,61.71428571428572
108103120.0,17,5,955,5,955,27025780.0,191.0,191.0,0,0,0.0,0.0,0.0
90281828.0,6,21,1585,11,840,9023707.9,95.0,76.36363636363636,10,745,10000264.222222222,95.0,74.5
108127340.0,17,5,1005,5,1005,27031835.0,201.0,201.0,0,0,0.0,0.0,0.0
12252.0,6,13,1459,7,862,1933.1666666666667,271.0,123.14285714285714,6,597,2173.6,259.0,99.5
6719.0,17,2,447,1,84,0.0,84.0,84.0,1,363,0.0,363.0,363.0
113520186.0,6,47,3102,24,1584,4935649.347826087,66.0,66.0,23,1518,5159997.2727272725,66.0,66.0
108107552.0,17,5,955,5,955,27026888.0,191.0,191.0,0,0,0.0,0.0,0.0
320549.0,17,4,1400,4,1400,106849.66666666669,350.0,350.0,0,0,0.0,0.0,0.0
282929.0,17,2,180,1,90,0.0,90.0,90.0,1,90,0.0,90.0,90.0
121786325.0,17,14,864,7,432,17002153.666666668,174.0,61.71428571428572,7,432,20009131.0,174.0,61.71428571428572
354.0,17,2,267,1,83,0.0,83.0,83.0,1,184,0.0,184.0,184.0
103519.0,17,2,286,2,286,0.0,143.0,143.0,0,0,0.0,0.0,0.0
209620.0,17,2,180,1,90,0.0,90.0,90.0,1,90,0.0,90.0,90.0
28698.0,6,14,4740,7,653,4234.5,249.0,93.28571428571428,7,4087,4567.666666666667,1514.0,583.8571428571429
315016.0,17,4,1400,4,1400,105005.33333333331,350.0,350.0,0,0,0.0,0.0,0.0
48070.0,6,14,4740,7,653,7651.0,249.0,93.28571428571428,7,4087,7670.166666666667,1514.0,583.8571428571429
2332.0,17,4,344,2,150,0.0,75.0,75.0,2,194,0.0,103.0,97.0
113184771.0,6,291,34842,146,9858,780584.6275862069,140.0,67.52054794520548,145,24984,778910.8263888889,284.0,172.30344827586208
0.0,17,1,55,1,55,0.0,55.0,55.0,0,0,0.0,0.0,0.0
36680.0,6,14,4740,7,653,5941.5,249.0,93.28571428571428,7,4087,5731.333333333333,1514.0,583.8571428571429
13707.0,6,11,2098,6,590,2069.2,252.0,98.33333333333331,5,1508,3084.5,1236.0,301.6
245976.0,6,3,337,2,214,0.0,160.0,107.0,1,123,0.0,123.0,123.0
119966148.0,6,23,1734,12,894,10882790.454545457,95.0,74.5,11,840,11975040.7,95.0,76.36363636363636
121555.0,6,3,337,2,214,0.0,160.0,107.0,1,123,0.0,123.0,123.0
17744.0,6,11,1131,6,600,2650.4,262.0,100.0,5,531,4217.25,259.0,106.2
90032328.0,17,28,13364,28,13364,3334530.6666666665,501.0,477.2857142857143,0,0,0.0,0.0,0.0
24020735.0,17,3,1026,3,1026,12010367.499999998,342.0,342.0,0,0,0.0,0.0,0.0
112921.0,17,4,1400,4,1400,37640.333333333336,350.0,350.0,0,0,0.0,0.0,0.0
307.0,17,2,166,1,75,0.0,75.0,75.0,1,91,0.0,91.0,91.0
76204.0,6,10,2032,5,524,14316.75,252.0,104.8,5,1508,18766.25,1236.0,301.6
41109.0,6,14,4740,7,653,6724.333333333333,249.0,93.28571428571428,7,4087,6372.5,1514.0,583.8571428571429
2321.0,17,4,344,2,150,0.0,75.0,75.0,2,194,0.0,103.0,97.0
184.0,17,2,700,2,700,0.0,350.0,350.0,0,0,0.0,0.0,0.0
153413.0,17,2,180,1,90,0.0,90.0,90.0,1,90,0.0,90.0,90.0
299063.0,6,6,412,4,272,99687.66666666669,74.0,68.0,2,140,0.0,74.0,70.0
236155.0,6,3,337,2,214,0.0,160.0,107.0,1,123,0.0,123.0,123.0
205674.0,17,2,180,1,90,0.0,90.0,90.0,1,90,0.0,90.0,90.0
137238.0,17,2,176,1,80,0.0,80.0,80.0,1,96,0.0,96.0,96.0
303413.0,6,6,412,4,272,101137.66666666669,74.0,68.0,2,140,0.0,74.0,70.0
9764.0,17,2,582,1,83,0.0,83.0,83.0,1,499,0.0,499.0,499.0
48262.0,6,14,4740,7,653,6781.833333333333,249.0,93.28571428571428,7,4087,7903.0,1514.0,583.8571428571429
106052012.0,17,14,864,7,432,17666862.333333332,174.0,61.71428571428572,7,432,17668089.5,174.0,61.71428571428572
5935522.0,6,4,270,2,134,0.0,68.0,67.0,2,136,0.0,70.0,68.0
11706.0,6,10,2032,5,524,2564.75,252.0,104.8,5,1508,2675.0,1236.0,301.6
273191.0,6,10,1221,6,636,54638.2,298.0,106.0,4,585,85395.0,379.0,146.25
341.0,17,2,267,1,83,0.0,83.0,83.0,1,184,0.0,184.0,184.0
171503.0,17,2,180,1,90,0.0,90.0,90.0,1,90,0.0,90.0,90.0
362.0,17,2,267,1,83,0.0,83.0,83.0,1,184,0.0,184.0,184.0
90006113.0,17,28,13364,28,13364,3333559.7407407407,501.0,477.2857142857143,0,0,0.0,0.0,0.0
124778387.0,17,15,1169,8,606,17825483.85714286,174.0,75.75,7,563,17585488.5,174.0,80.42857142857143
101480.0,17,2,762,2,762,0.0,381.0,381.0,0,0,0.0,0.0,0.0
108095784.0,17,5,1005,5,1005,27023946.0,201.0,201.0,0,0,0.0,0.0,0.0
90743057.0,6,25,1924,14,1084,6976779.923076923,95.0,77.42857142857143,11,840,9047178.1,95.0,76.36363636363636
306308.0,17,2,238,1,74,0.0,74.0,74.0,1,164,0.0,164.0,164.0
120001057.0,17,15,1169,8,606,17143008.14285714,174.0,75.75,7,563,16667649.666666666,174.0,80.42857142857143
313312.0,17,4,1400,4,1400,104437.33333333331,350.0,350.0,0,0,0.0,0.0,0.0
507869.0,6,5,336,2,134,0.0,68.0,67.0,3,202,192272.5,70.0,67.33333333333333
363346.0,6,10,967,5,390,60996.75,162.0,78.0,5,577,60916.5,349.0,115.4
20319.0,6,14,4740,7,653,3276.833333333333,249.0,93.28571428571428,7,4087,3203.0,1514.0,583.8571428571429
90203949.0,6,16,1192,8,596,12851647.0,95.0,74.5,8,596,12856918.285714284,95.0,74.5
108106500.0,17,5,955,5,955,27026625.0,191.0,191.0,0,0,0.0,0.0,0.0
36053.0,6,12,1413,7,882,6008.833333333333,291.0,126.0,5,531,6576.5,259.0,106.2
196887.0,17,2,180,1,90,0.0,90.0,90.0,1,90,0.0,90.0,90.0
832.0,17,4,438,2,148,0.0,74.0,74.0,2,290,0.0,147.0,145.0
16303.999999999998,17,2,582,1,83,0.0,83.0,83.0,1,499,0.0,499.0,499.0
49365.0,6,13,1394,7,797,7434.333333333333,253.0,113.85714285714286,6,597,9024.8,259.0,99.5
120478014.0,6,219,24802,110,17312,1105302.880733945,284.0,157.38181818181818,109,7490,1105715.3796296297,140.0,68.71559633027523
0.0,17,1,381,1,381,0.0,381.0,381.0,0,0,0.0,0.0,0.0
0.0,17,1,44,1,44,0.0,44.0,44.0,0,0,0.0,0.0,0.0
93690.0,17,2,762,2,762,0.0,381.0,381.0,0,0,0.0,0.0,0.0
149072.0,17,2,414,1,88,0.0,88.0,88.0,1,326,0.0,326.0,326.0
113028.0,17,4,1400,4,1400,37676.0,350.0,350.0,0,0,0.0,0.0,0.0
108107830.0,17,5,955,5,955,27026957.5,191.0,191.0,0,0,0.0,0.0,0.0
838.0,17,4,438,2,148,0.0,74.0,74.0,2,290,0.0,147.0,145.0
235562.0,6,3,373,2,238,0.0,172.0,119.0,1,135,0.0,135.0,135.0
2580285.0,6,2,132,1,66,0.0,66.0,66.0,1,66,0.0,66.0,66.0
64319.0,6,14,4740,7,653,10587.166666666666,249.0,93.28571428571428,7,4087,10139.166666666666,1514.0,583.8571428571429
2454.0,17,4,344,2,150,0.0,75.0,75.0,2,194,0.0,103.0,97.0
120421956.0,6,227,25690,114,17936,1065681.0265486725,284.0,157.33333333333334,113,7754,1065870.2857142857,140.0,68.61946902654867
120122116.0,6,14,2224,9,1204,15015264.5,188.0,133.77777777777777,5,1020,22523165.5,204.0,204.0
110146959.0,6,30,1990,15,1042,7852210.857142857,139.0,69.46666666666667,15,948,7852208.357142857,123.0,63.2
0.0,6,1,160,1,160,0.0,160.0,160.0,0,0,0.0,0.0,0.0
120124053.0,6,14,2224,9,1204,15015506.625,188.0,133.77777777777777,5,1020,22523623.5,204.0,204.0
21876.0,17,2,582,1,83,0.0,83.0,83.0,1,499,0.0,499.0,499.0
96381140.0,17,14,1126,7,563,16001228.5,174.0,80.42857142857143,7,563,16000128.5,174.0,80.42857142857143
304243.0,6,6,412,4,272,101414.33333333331,74.0,68.0,2,140,0.0,74.0,70.0
118514646.0,6,216,24424,108,17000,1105603.140186916,284.0,157.40740740740742,108,7424,1105602.859813084,140.0,68.74074074074075
372440.0,6,10,1221,6,636,74488.0,298.0,106.0,4,585,123052.66666666669,379.0,146.25
2315.0,17,4,344,2,150,0.0,75.0,75.0,2,194,0.0,103.0,97.0
254010.0,6,3,337,2,214,0.0,160.0,107.0,1,123,0.0,123.0,123.0
112131667.0,6,35,2542,18,1348,6583243.588235294,139.0,74.88888888888889,17,1194,6994732.3125,123.0,70.23529411764706
135128805.0,17,6,1146,6,1146,27025761.0,191.0,191.0,0,0,0.0,0.0,0.0
102841.0,17,2,286,2,286,0.0,143.0,143.0,0,0,0.0,0.0,0.0
167893.0,6,3,337,2,214,0.0,160.0,107.0,1,123,0.0,123.0,123.0
27002.0,6,14,4740,7,653,4139.333333333333,249.0,93.28571428571428,7,4087,4356.666666666667,1514.0,583.8571428571429
106680.0,17,2,286,2,286,0.0,143.0,143.0,0,0,0.0,0.0,0.0
50822.0,17,2,180,1,90,0.0,90.0,90.0,1,90,0.0,90.0,90.0
90018216.0,17,28,13364,28,13364,3334008.0,501.0,477.2857142857143,0,0,0.0,0.0,0.0
42887.0,6,14,4740,7,653,6428.5,249.0,93.28571428571428,7,4087,6990.666666666667,1514.0,583.8571428571429
1752.0,17,2,762,2,762,0.0,381.0,381.0,0,0,0.0,0.0,0.0
98169504.0,6,18,1505,9,855,12270221.375,259.0,95.0,9,650,12269860.5,95.0,72.22222222222223
2426.0,17,4,344,2,150,0.0,75.0,75.0,2,194,0.0,103.0,97.0
292.0,17,2,156,1,78,0.0,78.0,78.0,1,78,0.0,78.0,78.0
435466.0,17,2,363,1,75,0.0,75.0,75.0,1,288,0.0,288.0,288.0
120784650.0,6,638,78392,319,21276,377240.5283018868,140.0,66.69592476489028,319,57116,379758.25471698114,464.0,179.04702194357367
219300.0,17,4,1524,4,1524,73100.0,381.0,381.0,0,0,0.0,0.0,0.0
238778.0,6,6,386,4,247,79592.66666666667,85.0,61.75,2,139,0.0,85.0,69.5
13547.0,6,12,1393,6,796,2576.8,271.0,132.66666666666666,6,597,2459.0,259.0,99.5
196373.0,17,2,180,1,90,0.0,90.0,90.0,1,90,0.0,90.0,90.0
107834.0,17,2,286,2,286,0.0,143.0,143.0,0,0,0.0,0.0,0.0
186460.0,17,2,604,1,75,0.0,75.0,75.0,1,529,0.0,529.0,529.0
120395843.0,6,209,23740,105,16654,1157652.3365384615,300.0,158.6095238095238,104,7086,1149797.0582524273,140.0,68.13461538461539
119897.0,6,10,1065,5,534,29763.25,262.0,106.8,5,531,2887.5,259.0,106.2
90757930.0,6,18,1341,9,691,11344741.25,95.0,76.77777777777777,9,650,11307507.75,95.0,72.22222222222223
134801.0,6,2,132,1,66,0.0,66.0,66.0,1,66,0.0,66.0,66.0
101559.0,17,2,286,2,286,0.0,143.0,143.0,0,0,0.0,0.0,0.0
61368.0,6,12,1320,6,723,11458.8,253.0,120.5,6,597,10750.6,259.0,99.5
37256.0,6,14,4740,7,653,6032.5,249.0,93.28571428571428,7,4087,5708.5,1514.0,583.8571428571429
102196.0,17,2,286,2,286,0.0,143.0,143.0,0,0,0.0,0.0,0.0
22864.0,6,10,2032,5,524,5429.25,252.0,104.8,5,1508,5489.0,1236.0,301.6
135137435.0,17,6,1206,6,1206,27027487.0,201.0,201.0,0,0,0.0,0.0,0.0
6001.0,17,2,363,1,79,0.0,79.0,79.0,1,284,0.0,284.0,284.0
90012999.0,17,28,13364,28,13364,3333814.777777778,501.0,477.2857142857143,0,0,0.0,0.0,0.0
143574.0,6,2,132,1,66,0.0,66.0,66.0,1,66,0.0,66.0,66.0
35151.0,6,14,4740,7,653,5126.666666666667,249.0,93.28571428571428,7,4087,5338.0,1514.0,583.8571428571429
108818467.0,6,32,2236,16,1165,7240217.066666666,139.0,72.8125,16,1071,7240211.2,123.0,66.9375
216748.0,17,2,180,1,90,0.0,90.0,90.0,1,90,0.0,90.0,90.0
108102223.0,17,5,1005,5,1005,27025555.75,201.0,201.0,0,0,0.0,0.0,0.0
122323.0,6,3,337,2,214,0.0,160.0,107.0,1,123,0.0,123.0,123.0
312694.0,6,3,1777,2,951,0.0,885.0,475.5,1,826,0.0,826.0,826.0
26821.0,6,10,2032,5,524,6497.25,252.0,104.8,5,1508,6330.25,1236.0,301.6
878.0,17,4,438,2,148,0.0,74.0,74.0,2,290,0.0,147.0,145.0
103085158.0,6,34,2482,17,1288,6429330.1875,139.0,75.76470588235294,17,1194,6429333.5,123.0,70.23529411764706
2114185.0,6,4,492,2,280,0.0,214.0,140.0,2,212,0.0,146.0,106.0
27306074.0,17,5,1710,5,1710,6826518.5,342.0,342.0,0,0,0.0,0.0,0.0
302061.0,6,6,412,4,272,100687.0,74.0,68.0,2,140,0.0,74.0,70.0
120274406.0,6,218,25022,109,7416,1086734.2685185184,140.0,68.03669724770643,109,17606,1107200.6296296297,284.0,161.52293577981652
497056.0,6,5,336,2,134,0.0,68.0,67.0,3,202,192597.0,70.0,67.33333333333333
20909.0,6,14,4740,7,653,2670.1666666666665,249.0,93.28571428571428,7,4087,3252.333333333333,1514.0,583.8571428571429
56234.0,6,10,2032,5,524,13612.25,252.0,104.8,5,1508,13018.75,1236.0,301.6
302475.0,6,2,132,1,66,0.0,66.0,66.0,1,66,0.0,66.0,66.0
307035.0,17,2,246,1,76,0.0,76.0,76.0,1,170,0.0,170.0,170.0
310962.0,17,4,1400,4,1400,103654.0,350.0,350.0,0,0,0.0,0.0,0.0
10474593.0,6,7,478,4,272,3446236.6666666665,74.0,68.0,3,206,5169219.0,74.0,68.66666666666667
49233.0,6,10,2032,5,524,11788.75,252.0,104.8,5,1508,11898.75,1236.0,301.6
90258198.0,6,13,2036,8,1016,12894028.285714284,188.0,127.0,5,1020,22523369.25,204.0,204.0
237431.0,6,3,373,2,238,0.0,172.0,119.0,1,135,0.0,135.0,135.0
236617.0,6,3,337,2,214,0.0,160.0,107.0,1,123,0.0,123.0,123.0
2518.0,17,4,344,2,150,0.0,75.0,75.0,2,194,0.0,103.0,97.0
24659.0,6,10,2032,5,524,5311.25,252.0,104.8,5,1508,5934.0,1236.0,301.6
299092.0,6,6,412,4,272,99697.33333333331,74.0,68.0,2,140,0.0,74.0,70.0
105073.0,17,2,700,2,700,0.0,350.0,350.0,0,0,0.0,0.0,0.0
12630.0,6,13,1459,7,862,1881.8333333333333,271.0,123.14285714285714,6,597,2288.0,259.0,99.5
57553.0,6,14,4740,7,653,8989.0,249.0,93.28571428571428,7,4087,8239.333333333334,1514.0,583.8571428571429
120456412.0,6,249,28122,125,19630,971422.6774193548,284.0,157.04,124,8492,970888.6178861788,140.0,68.48387096774194
303927.0,6,6,412,4,272,101309.0,74.0,68.0,2,140,0.0,74.0,70.0
16471.0,6,10,2032,5,524,3891.75,252.0,104.8,5,1508,3871.25,1236.0,301.6
111883967.0,6,30,1974,15,1026,7976294.142857143,123.0,68.4,15,948,7976296.214285715,123.0,63.2
90052714.0,17,28,13364,28,13364,3335285.703703704,501.0,477.2857142857143,0,0,0.0,0.0,0.0
217040.0,6,3,426,2,280,0.0,214.0,140.0,1,146,0.0,146.0,146.0
2417.0,17,2,762,2,762,0.0,381.0,381.0,0,0,0.0,0.0,0.0
2440.0,17,4,344,2,150,0.0,75.0,75.0,2,194,0.0,103.0,97.0
104174650.0,17,14,864,7,432,17335544.333333332,174.0,61.71428571428572,7,432,17333502.333333332,174.0,61.71428571428572
191256.0,17,2,180,1,90,0.0,90.0,90.0,1,90,0.0,90.0,90.0
120012284.0,6,31,2182,16,1165,8000818.933333334,139.0,72.8125,15,1017,7843596.0,123.0,67.8
1298273.0,6,4,264,2,132,0.0,66.0,66.0,2,132,0.0,66.0,66.0
62970.0,6,14,4740,7,653,9775.5,249.0,93.28571428571428,7,4087,9075.833333333334,1514.0,583.8571428571429
31143.0,6,10,2032,5,524,7542.5,252.0,104.8,5,1508,7374.25,1236.0,301.6
218051.0,6,3,426,2,280,0.0,214.0,140.0,1,146,0.0,146.0,146.0
90018716.0,17,28,13364,28,13364,3334026.5185185187,501.0,477.2857142857143,0,0,0.0,0.0,0.0
246125.0,6,3,337,2,214,0.0,160.0,107.0,1,123,0.0,123.0,123.0
2268.0,17,4,344,2,150,0.0,75.0,75.0,2,194,0.0,103.0,97.0
121192.0,6,3,373,2,238,0.0,172.0,119.0,1,135,0.0,135.0,135.0
284875.0,17,2,363,1,79,0.0,79.0,79.0,1,284,0.0,284.0,284.0
90025394.0,17,27,12943,27,12943,3462515.153846154,501.0,479.3703703703704,0,0,0.0,0.0,0.0
108102033.0,17,5,1005,5,1005,27025508.25,201.0,201.0,0,0,0.0,0.0,0.0
110125548.0,6,207,23268,104,7160,1069180.077669903,140.0,68.84615384615384,103,16108,1069614.950980392,284.0,156.38834951456312
319953.0,17,4,704,2,148,0.0,74.0,74.0,2,556,0.0,280.0,278.0
31484.0,6,12,1320,6,723,5600.6,253.0,120.5,6,597,5962.4,259.0,99.5
2332.0,17,4,344,2,150,0.0,75.0,75.0,2,194,0.0,103.0,97.0
190633.0,17,2,180,1,90,0.0,90.0,90.0,1,90,0.0,90.0,90.0
120248224.0,6,224,25184,112,7688,1068612.009009009,140.0,68.64285714285714,112,17496,1077108.3603603605,284.0,156.21428571428572
218657.0,6,3,426,2,280,0.0,214.0,140.0,1,146,0.0,146.0,146.0
2829140.0,6,2,132,1,66,0.0,66.0,66.0,1,66,0.0,66.0,66.0
153503.0,17,2,180,1,90,0.0,90.0,90.0,1,90,0.0,90.0,90.0
299442.0,6,6,412,4,272,99814.0,74.0,68.0,2,140,0.0,74.0,70.0
20392.0,6,14,4740,7,653,2855.833333333333,249.0,93.28571428571428,7,4087,3259.0,1514.0,583.8571428571429
437629.0,6,11,1021,6,444,58783.0,162.0,74.0,5,577,73289.75,349.0,115.4
3005888.0,6,163,130316,92,121328,33031.73626373626,1510.0,1318.7826086956522,71,8988,38546.485714285714,1510.0,126.59154929577464
207243.0,17,2,762,2,762,0.0,381.0,381.0,0,0,0.0,0.0,0.0
16656.0,17,2,180,1,90,0.0,90.0,90.0,1,90,0.0,90.0,90.0
90259115.0,6,13,2036,8,1016,12894159.285714284,188.0,127.0,5,1020,22523384.25,204.0,204.0
250.0,17,2,700,2,700,0.0,350.0,350.0,0,0,0.0,0.0,0.0
50159.0,6,14,4740,7,653,7782.833333333333,249.0,93.28571428571428,7,4087,6886.5,1514.0,583.8571428571429
196990.0,17,2,180,1,90,0.0,90.0,90.0,1,90,0.0,90.0,90.0
302922.0,6,6,412,4,272,100974.0,74.0,68.0,2,140,0.0,74.0,70.0
17448969.0,6,23,8609,13,1719,1454080.75,408.0,132.23076923076923,10,6890,1479894.5555555555,1514.0,689.0
14801.0,17,2,582,1,83,0.0,83.0,83.0,1,499,0.0,499.0,499.0
0.0,17,1,179,1,179,0.0,179.0,179.0,0,0,0.0,0.0,0.0
232382.0,6,3,337,2,214,0.0,160.0,107.0,1,123,0.0,123.0,123.0
324.0,17,2,208,1,72,0.0,72.0,72.0,1,136,0.0,136.0,136.0
924666.0,6,12,1447,6,816,182751.6,291.0,136.0,6,631,184568.6,293.0,105.16666666666669
40144.0,6,10,2032,5,524,9797.75,252.0,104.8,5,1508,9505.25,1236.0,301.6
207130.0,6,3,426,2,280,0.0,214.0,140.0,1,146,0.0,146.0,146.0
93175579.0,6,527,101858,260,17604,359751.2702702703,214.0,67.70769230769231,267,84254,349388.0187969925,1514.0,315.5580524344569
90096699.0,6,11,1644,7,828,15016116.5,188.0,118.28571428571428,4,816,20021377.33333333,204.0,204.0
121339.0,6,3,337,2,214,0.0,160.0,107.0,1,123,0.0,123.0,123.0
21784.0,6,10,1067,5,536,5248.25,264.0,107.2,5,531,4731.0,259.0,106.2
333.0,17,2,166,1,75,0.0,75.0,75.0,1,91,0.0,91.0,91.0
108108291.0,17,5,955,5,955,27027072.75,191.0,191.0,0,0,0.0,0.0,0.0
212897.0,6,10,1221,6,636,42579.4,298.0,106.0,4,585,69656.66666666667,379.0,146.25
15049919.0,17,6,2718,6,2718,3009983.8,453.0,453.0,0,0,0.0,0.0,0.0
34910026.0,17,128,8418,64,4209,547564.619047619,106.0,65.765625,64,4209,553529.0476190476,106.0,65.765625
42679.0,6,10,2032,5,524,10449.5,252.0,104.8,5,1508,10016.0,1236.0,301.6
17878.0,6,10,1065,5,534,3532.75,262.0,106.8,5,531,3329.0,259.0,106.2
0.0,17,1,381,1,381,0.0,381.0,381.0,0,0,0.0,0.0,0.0
2349.0,17,4,344,2,150,0.0,75.0,75.0,2,194,0.0,103.0,97.0
9704.0,17,2,582,1,83,0.0,83.0,83.0,1,499,0.0,499.0,499.0
5006761.0,17,4,629,2,156,0.0,78.0,78.0,2,473,0.0,268.0,236.5
107591.0,17,4,1400,4,1400,35863.666666666664,350.0,350.0,0,0,0.0,0.0,0.0
0.0,6,1,66,1,66,0.0,66.0,66.0,0,0,0.0,0.0,0.0
1416766.0,17,6,1230,3,234,708191.0,78.0,78.0,3,996,708168.0,332.0,332.0
303506.0,6,6,412,4,272,101168.66666666669,74.0,68.0,2,140,0.0,74.0,70.0
21329.0,6,14,4740,7,653,3439.1666666666665,249.0,93.28571428571428,7,4087,3056.0,1514.0,583.8571428571429
91442649.0,6,22,1680,12,935,8311726.454545454,95.0,77.91666666666667,10,745,10158721.555555556,95.0,74.5
13577.0,6,11,1132,6,556,2582.2,218.0,92.66666666666669,5,576,3093.75,304.0,115.2
6907.0,17,2,582,1,83,0.0,83.0,83.0,1,499,0.0,499.0,499.0
90260194.0,6,13,2036,8,1016,12894313.42857143,188.0,127.0,5,1020,22523425.5,204.0,204.0
10350.0,17,2,582,1,83,0.0,83.0,83.0,1,499,0.0,499.0,499.0
294314.0,17,2,246,1,76,0.0,76.0,76.0,1,170,0.0,170.0,170.0
228182.0,17,2,180,1,90,0.0,90.0,90.0,1,90,0.0,90.0,90.0
247266.0,6,3,337,2,214,0.0,160.0,107.0,1,123,0.0,123.0,123.0
41553.0,6,14,4740,7,653,6803.0,249.0,93.28571428571428,7,4087,5585.333333333333,1514.0,583.8571428571429
2802164.0,6,2,132,1,66,0.0,66.0,66.0,1,66,0.0,66.0,66.0
5631331.0,6,5,336,2,134,0.0,68.0,67.0,3,202,1423232.5,70.0,67.33333333333333
5430.0,17,4,344,2,150,0.0,75.0,75.0,2,194,0.0,103.0,97.0
30106.0,6,10,2032,5,524,7297.0,252.0,104.8,5,1508,6336.0,1236.0,301.6
197244.0,17,2,180,1,90,0.0,90.0,90.0,1,90,0.0,90.0,90.0
90094297.0,6,11,1644,7,828,15015716.166666666,188.0,118.28571428571428,4,816,20020963.0,204.0,204.0
83.0,17,2,762,2,762,0.0,381.0,381.0,0,0,0.0,0.0,0.0
305409.0,6,6,412,4,272,101803.0,74.0,68.0,2,140,0.0,74.0,70.0
120073822.0,17,29,13785,29,13785,4288350.785714285,501.0,475.3448275862069,0,0,0.0,0.0,0.0
90035707.0,17,28,13364,28,13364,3334655.814814815,501.0,477.2857142857143,0,0,0.0,0.0,0.0
20401.0,6,14,4740,7,653,3092.1666666666665,249.0,93.28571428571428,7,4087,3005.5,1514.0,583.8571428571429
220652.0,17,2,180,1,90,0.0,90.0,90.0,1,90,0.0,90.0,90.0
100299924.0,17,12,778,6,389,19949850.4,174.0,64.83333333333333,6,389,20027954.8,174.0,64.83333333333333
1021918.0,6,11,1134,6,558,204383.6,220.0,93.0,5,576,255022.5,304.0,115.2
160173.0,17,2,180,1,90,0.0,90.0,90.0,1,90,0.0,90.0,90.0
120124022.0,6,15,2473,7,1393,20020670.33333333,199.0,199.0,8,1080,17084037.85714286,204.0,135.0
308.0,17,2,174,1,79,0.0,79.0,79.0,1,95,0.0,95.0,95.0
204126.0,17,2,180,1,90,0.0,90.0,90.0,1,90,0.0,90.0,90.0
114857209.0,6,48,3168,24,1584,4993791.695652174,66.0,66.0,24,1584,4984391.652173913,66.0,66.0
120000054.0,6,23,1901,13,989,10000004.5,95.0,76.07692307692308,10,912,10191025.777777778,221.0,91.2
2375.0,17,4,344,2,150,0.0,75.0,75.0,2,194,0.0,103.0,97.0
56586.0,6,14,4740,7,653,8379.833333333334,249.0,93.28571428571428,7,4087,9230.666666666666,1514.0,583.8571428571429
309854.0,17,4,1400,4,1400,103284.66666666669,350.0,350.0,0,0,0.0,0.0,0.0
38832.0,6,14,4740,7,653,6142.666666666667,249.0,93.28571428571428,7,4087,6011.166666666667,1514.0,583.8571428571429
28981.0,17,2,180,1,90,0.0,90.0,90.0,1,90,0.0,90.0,90.0
53125.0,6,10,2032,5,524,11992.5,252.0,104.8,5,1508,12144.75,1236.0,301.6
4374.0,17,2,614,1,72,0.0,72.0,72.0,1,542,0.0,542.0,542.0
108106120.0,17,5,955,5,955,27026530.0,191.0,191.0,0,0,0.0,0.0,0.0
95118961.0,6,186,20982,93,14622,1032977.0652173914,284.0,157.2258064516129,93,6360,1031561.2065217393,140.0,68.38709677419355
216431.0,17,2,180,1,90,0.0,90.0,90.0,1,90,0.0,90.0,90.0
104079481.0,17,14,864,7,432,17334419.666666668,174.0,61.71428571428572,7,432,17333483.0,174.0,61.71428571428572
243190.0,6,3,337,2,214,0.0,160.0,107.0,1,123,0.0,123.0,123.0
14755.0,6,12,1393,6,796,2808.0,271.0,132.66666666666666,6,597,2789.2,259.0,99.5
21978.0,17,2,180,1,90,0.0,90.0,90.0,1,90,0.0,90.0,90.0
416.0,17,2,762,2,762,0.0,381.0,381.0,0,0,0.0,0.0,0.0
3555281.0,6,25,7573,14,3735,273483.1538461539,1514.0,266.7857142857143,11,3838,329009.5,1514.0,348.90909090909093
15323.0,6,13,1459,7,862,2399.333333333333,271.0,123.14285714285714,6,597,2868.0,259.0,99.5
108106885.0,17,5,1005,5,1005,27026721.25,201.0,201.0,0,0,0.0,0.0,0.0
0.0,17,1,44,1,44,0.0,44.0,44.0,0,0,0.0,0.0,0.0
111877.0,17,4,1400,4,1400,37292.333333333336,350.0,350.0,0,0,0.0,0.0,0.0
46989.0,6,10,2032,5,524,11468.75,252.0,104.8,5,1508,11365.75,1236.0,301.6
103124.0,17,2,286,2,286,0.0,143.0,143.0,0,0,0.0,0.0,0.0
49132.0,6,13,1479,7,882,7825.833333333333,291.0,126.0,6,597,9346.4,259.0,99.5
887.0,17,4,438,2,148,0.0,74.0,74.0,2,290,0.0,147.0,145.0
220803.0,17,2,414,1,88,0.0,88.0,88.0,1,326,0.0,326.0,326.0
15090.0,17,2,180,1,90,0.0,90.0,90.0,1,90,0.0,90.0,90.0
247101.0,17,2,180,1,90,0.0,90.0,90.0,1,90,0.0,90.0,90.0
307732.0,6,6,412,4,272,102577.33333333331,74.0,68.0,2,140,0.0,74.0,70.0
149785102.0,17,36,17126,36,17126,4279574.342857143,501.0,475.72222222222223,0,0,0.0,0.0,0.0
92493448.0,6,50,14761,28,4405,3425683.25925926,486.0,157.32142857142858,22,10356,4396716.19047619,1514.0,470.7272727272728
43033.0,6,14,4740,7,653,6225.666666666667,249.0,93.28571428571428,7,4087,6022.333333333333,1514.0,583.8571428571429
139001410.0,17,17,1255,9,649,17375176.25,174.0,72.11111111111111,8,606,17001409.0,174.0,75.75
15661.999999999998,6,10,2032,5,524,3574.25,252.0,104.8,5,1508,3640.75,1236.0,301.6
2494692.0,6,3,204,2,136,0.0,70.0,68.0,1,68,0.0,68.0,68.0
228493.0,17,2,180,1,90,0.0,90.0,90.0,1,90,0.0,90.0,90.0
153432.0,17,2,180,1,90,0.0,90.0,90.0,1,90,0.0,90.0,90.0
135134171.0,17,6,1146,6,1146,27026834.2,191.0,191.0,0,0,0.0,0.0,0.0
51796.0,6,14,4740,7,653,8373.5,249.0,93.28571428571428,7,4087,8370.0,1514.0,583.8571428571429
5005152.0,17,4,849,2,166,0.0,83.0,83.0,2,683,0.0,499.0,341.5
25422.0,17,4,344,2,150,0.0,75.0,75.0,2,194,0.0,103.0,97.0
67330.0,6,12,1413,7,882,11221.666666666666,291.0,126.0,5,531,15435.5,259.0,106.2
12642.0,6,10,1065,5,534,2864.75,262.0,106.8,5,531,2947.0,259.0,106.2
201139.0,17,4,6056,4,6056,67046.33333333333,1514.0,1514.0,0,0,0.0,0.0,0.0
504557.00000000006,6,5,336,2,134,0.0,68.0,67.0,3,202,193810.5,70.0,67.33333333333333
315847.0,17,4,1400,4,1400,105282.33333333331,350.0,350.0,0,0,0.0,0.0,0.0
1188362.0,6,13,3010,8,2382,169766.0,1514.0,297.75,5,628,228942.75,331.0,125.6
300972.0,17,4,622,4,622,100324.0,163.0,155.5,0,0,0.0,0.0,0.0
250850.00000000003,17,4,6056,4,6056,83616.66666666667,1514.0,1514.0,0,0,0.0,0.0,0.0
120046705.0,17,28,13364,28,13364,4446174.259259259,501.0,477.2857142857143,0,0,0.0,0.0,0.0
321722.0,6,6,412,4,272,107240.66666666669,74.0,68.0,2,140,0.0,74.0,70.0
31265.0,6,14,4740,7,653,5094.333333333333,249.0,93.28571428571428,7,4087,4374.0,1514.0,583.8571428571429
110987298.0,6,30,1974,15,1026,7912257.357142857,123.0,68.4,15,948,7912258.357142857,123.0,63.2
318159.0,17,4,1400,4,1400,106053.0,350.0,350.0,0,0,0.0,0.0,0.0
79377.0,6,14,4740,7,653,13100.166666666666,249.0,93.28571428571428,7,4087,13008.5,1514.0,583.8571428571429
2393.0,17,4,344,2,150,0.0,75.0,75.0,2,194,0.0,103.0,97.0
26085.0,6,14,4740,7,653,4162.5,249.0,93.28571428571428,7,4087,4209.333333333333,1514.0,583.8571428571429
90266519.0,6,13,2036,8,1016,12895217.0,188.0,127.0,5,1020,22523792.0,204.0,204.0
209319.0,17,2,180,1,90,0.0,90.0,90.0,1,90,0.0,90.0,90.0
90047888.0,17,28,13364,28,13364,3335106.962962963,501.0,477.2857142857143,0,0,0.0,0.0,0.0
120178712.0,6,240,27088,120,8216,1002967.1848739496,140.0,68.46666666666667,120,18872,1003044.4201680672,284.0,157.26666666666668
219408.0,6,3,426,2,280,0.0,214.0,140.0,1,146,0.0,146.0,146.0
1224303.0,17,7,490,7,490,204050.5,70.0,70.0,0,0,0.0,0.0,0.0
120042239.0,17,28,13364,28,13364,4446008.851851852,501.0,477.2857142857143,0,0,0.0,0.0,0.0
216905.0,6,3,426,2,280,0.0,214.0,140.0,1,146,0.0,146.0,146.0
2403.0,17,4,344,2,150,0.0,75.0,75.0,2,194,0.0,103.0,97.0
246468.0,6,3,337,2,214,0.0,160.0,107.0,1,123,0.0,123.0,123.0
1027357.0,6,11,1134,6,558,205471.4,220.0,93.0,5,576,256004.5,304.0,115.2
2324.0,17,4,344,2,150,0.0,75.0,75.0,2,194,0.0,103.0,97.0
31577.0,6,14,4740,7,653,5143.666666666667,249.0,93.28571428571428,7,4087,4616.0,1514.0,583.8571428571429
69981.0,17,2,180,1,90,0.0,90.0,90.0,1,90,0.0,90.0,90.0
16080.0,6,14,4740,7,653,2559.333333333333,249.0,93.28571428571428,7,4087,2542.5,1514.0,583.8571428571429
57765.0,6,10,2032,5,524,13938.5,252.0,104.8,5,1508,13756.25,1236.0,301.6
146113.0,6,3,337,2,214,0.0,160.0,107.0,1,123,0.0,123.0,123.0
104711644.0,17,14,864,7,432,17334096.5,174.0,61.71428571428572,7,432,17333521.333333332,174.0,61.71428571428572
5109.0,17,2,180,1,90,0.0,90.0,90.0,1,90,0.0,90.0,90.0
92860360.0,6,171,19362,86,13530,1092474.8235294118,284.0,157.32558139534885,85,5832,1094501.8452380951,140.0,68.61176470588235
114543.0,17,2,286,2,286,0.0,143.0,143.0,0,0,0.0,0.0,0.0
339.0,17,2,283,1,78,0.0,78.0,78.0,1,205,0.0,205.0,205.0
39217307.0,6,26,7627,14,3735,188875.6153846153,1514.0,266.7857142857143,12,3892,3546556.8181818184,1514.0,324.3333333333333
288563.0,17,2,180,1,90,0.0,90.0,90.0,1,90,0.0,90.0,90.0
40168.0,6,10,2032,5,524,8450.0,252.0,104.8,5,1508,9759.75,1236.0,301.6
949125.0,17,2,582,1,83,0.0,83.0,83.0,1,499,0.0,499.0,499.0
199648.0,17,2,762,2,762,0.0,381.0,381.0,0,0,0.0,0.0,0.0
5619534.0,6,5,336,2,134,0.0,68.0,67.0,3,202,1423290.5,70.0,67.33333333333333
1441.0,17,2,762,2,762,0.0,381.0,381.0,0,0,0.0,0.0,0.0
3324.0,17,2,359,1,75,0.0,75.0,75.0,1,284,0.0,284.0,284.0
329966.0,6,6,412,4,272,109988.66666666669,74.0,68.0,2,140,0.0,74.0,70.0
62948620.0,17,11,3770,10,3420,4576000.111111111,342.0,342.0,1,350,0.0,350.0,350.0
10471519.0,6,7,478,4,272,3443818.333333333,74.0,68.0,3,206,5161873.0,74.0,68.66666666666667
32111.0,6,14,4740,7,653,5056.833333333333,249.0,93.28571428571428,7,4087,5213.166666666667,1514.0,583.8571428571429
100000866.0,17,13,1083,7,563,16666811.0,174.0,80.42857142857143,6,520,16200665.2,174.0,86.66666666666667
2802483.0,6,2,132,1,66,0.0,66.0,66.0,1,66,0.0,66.0,66.0
2111.0,17,4,344,2,150,0.0,75.0,75.0,2,194,0.0,103.0,97.0
1303110.0,6,4,264,2,132,0.0,66.0,66.0,2,132,0.0,66.0,66.0
249981.0,17,4,6056,4,6056,83327.0,1514.0,1514.0,0,0,0.0,0.0,0.0
115787117.0,6,217,24480,109,17118,1072102.9351851852,284.0,157.045871559633,108,7362,1078888.6074766356,140.0,68.16666666666667
314.0,17,2,174,1,79,0.0,79.0,79.0,1,95,0.0,95.0,95.0
421.0,17,2,410,1,78,0.0,78.0,78.0,1,332,0.0,332.0,332.0
107074.0,17,2,286,2,286,0.0,143.0,143.0,0,0,0.0,0.0,0.0
236264.0,6,4,439,2,238,0.0,172.0,119.0,2,201,0.0,135.0,100.5
90263412.0,6,12,1832,8,1016,12894773.142857144,188.0,127.0,4,816,30032793.666666668,204.0,204.0
2339.0,17,4,344,2,150,0.0,75.0,75.0,2,194,0.0,103.0,97.0
215221.0,17,2,180,1,90,0.0,90.0,90.0,1,90,0.0,90.0,90.0
13525926.0,6,20,1607,10,975,1466893.4444444445,315.0,97.5,10,632,1467839.2222222222,78.0,63.2
20212.0,6,10,2032,5,524,4818.75,252.0,104.8,5,1508,4792.0,1236.0,301.6
90016400.0,6,15,1097,8,596,12859485.714285716,95.0,74.5,7,501,14952924.333333334,95.0,71.57142857142857
209506.0,17,2,180,1,90,0.0,90.0,90.0,1,90,0.0,90.0,90.0
1772761.0,6,2,132,1,66,0.0,66.0,66.0,1,66,0.0,66.0,66.0
44853.0,6,14,4740,7,653,7361.833333333333,249.0,93.28571428571428,7,4087,6489.333333333333,1514.0,583.8571428571429
9481.0,17,2,539,1,86,0.0,86.0,86.0,1,453,0.0,453.0,453.0
232305.0,6,3,337,2,214,0.0,160.0,107.0,1,123,0.0,123.0,123.0
45032.0,6,10,2032,5,524,9343.0,252.0,104.8,5,1508,10037.0,1236.0,301.6
27226.0,6,14,4740,7,653,4409.666666666667,249.0,93.28571428571428,7,4087,4400.666666666667,1514.0,583.8571428571429
2145764.0,6,2,132,1,66,0.0,66.0,66.0,1,66,0.0,66.0,66.0
1357.0,17,5,550,5,550,339.25,110.0,110.0,0,0,0.0,0.0,0.0
30882.0,6,10,2032,5,524,5919.25,252.0,104.8,5,1508,6800.5,1236.0,301.6
1238966.0,17,2,876,2,876,0.0,438.0,438.0,0,0,0.0,0.0,0.0
2034236.0,6,18,6803,10,1501,226026.22222222225,408.0,150.1,8,5302,229155.57142857145,1514.0,662.75
311648.0,6,6,412,4,272,103882.66666666669,74.0,68.0,2,140,0.0,74.0,70.0
98690.0,17,2,762,2,762,0.0,381.0,381.0,0,0,0.0,0.0,0.0
92808941.0,17,12,778,6,389,18529837.4,174.0,64.83333333333333,6,389,18528621.0,174.0,64.83333333333333
26236820.0,6,26,7627,14,3735,184043.6153846153,1514.0,266.7857142857143,12,3892,2365597.272727273,1514.0,324.3333333333333
103258952.0,17,14,864,7,432,17167418.5,174.0,61.71428571428572,7,432,17166845.5,174.0,61.71428571428572
438.0,17,2,508,2,508,0.0,257.0,254.0,0,0,0.0,0.0,0.0
5624293.0,6,5,336,2,134,0.0,68.0,67.0,3,202,1524756.0,70.0,67.33333333333333
34280.0,6,14,4740,7,653,5170.833333333333,249.0,93.28571428571428,7,4087,5182.166666666667,1514.0,583.8571428571429
209516.0,17,2,180,1,90,0.0,90.0,90.0,1,90,0.0,90.0,90.0
45747.0,6,14,4740,7,653,6865.5,249.0,93.28571428571428,7,4087,6704.333333333333,1514.0,583.8571428571429
310252.0,6,6,412,4,272,103417.33333333331,74.0,68.0,2,140,0.0,74.0,70.0
258275.0,6,3,337,2,214,0.0,160.0,107.0,1,123,0.0,123.0,123.0
108106391.0,17,5,955,5,955,27026597.75,191.0,191.0,0,0,0.0,0.0,0.0
102210.0,17,2,762,2,762,0.0,381.0,381.0,0,0,0.0,0.0,0.0
218526.0,6,4,492,2,280,0.0,214.0,140.0,2,212,0.0,146.0,106.0
0.0,6,1,66,1,66,0.0,66.0,66.0,0,0,0.0,0.0,0.0
146118.0,6,3,337,2,214,0.0,160.0,107.0,1,123,0.0,123.0,123.0
21524.0,6,11,2098,6,590,2973.4,252.0,98.33333333333331,5,1508,4924.25,1236.0,301.6
219814.0,6,10,1221,6,636,43962.8,298.0,106.0,4,585,71363.33333333333,379.0,146.25
121386.0,6,3,373,2,238,0.0,172.0,119.0,1,135,0.0,135.0,135.0
114098749.0,6,38,2710,19,1408,6326835.444444444,139.0,74.10526315789474,19,1302,6326832.5,123.0,68.52631578947368
2692868.0,6,2,132,1,66,0.0,66.0,66.0,1,66,0.0,66.0,66.0
18498.0,6,11,2098,6,590,3143.6,252.0,98.33333333333331,5,1508,4216.0,1236.0,301.6
90526039.0,6,15,2444,8,1016,12932291.285714284,188.0,127.0,7,1428,15060454.166666666,204.0,204.0
855230.0,6,9,1196,6,725,171046.0,387.0,120.83333333333331,3,471,289816.5,331.0,157.0
120120427.0,6,38,2986,21,1654,6006021.35,139.0,78.76190476190476,17,1332,6869924.875,123.0,78.3529411764706
31229168.0,6,26,7627,14,3735,205408.6153846153,1514.0,266.7857142857143,12,3892,2820294.272727273,1514.0,324.3333333333333
283087.0,17,4,571,2,148,0.0,74.0,74.0,2,423,0.0,280.0,211.5
465553.0,6,3,204,2,136,0.0,70.0,68.0,1,68,0.0,68.0,68.0
1771147.0,6,2,132,1,66,0.0,66.0,66.0,1,66,0.0,66.0,66.0
209350.0,17,2,180,1,90,0.0,90.0,90.0,1,90,0.0,90.0,90.0
324713.0,6,6,412,4,272,108237.66666666669,74.0,68.0,2,140,0.0,74.0,70.0
217404.0,6,3,426,2,280,0.0,214.0,140.0,1,146,0.0,146.0,146.0
2424.0,17,4,344,2,150,0.0,75.0,75.0,2,194,0.0,103.0,97.0
90258522.0,6,12,1832,8,1016,12894074.57142857,188.0,127.0,4,816,30030659.666666668,204.0,204.0
355.0,17,2,267,1,83,0.0,83.0,83.0,1,184,0.0,184.0,184.0
9346.0,6,10,1067,5,536,2171.0,264.0,107.2,5,531,2082.25,259.0,106.2
34668.0,6,10,2032,5,524,7398.25,252.0,104.8,5,1508,7012.0,1236.0,301.6
1335149.0,6,10,1221,6,636,267029.8,298.0,106.0,4,585,443633.3333333333,379.0,146.25
5821703.0,6,5,336,2,134,0.0,68.0,67.0,3,202,1524355.0,70.0,67.33333333333333
45645.0,6,14,4740,7,653,7479.166666666667,249.0,93.28571428571428,7,4087,7365.5,1514.0,583.8571428571429
787.0,17,4,438,2,148,0.0,74.0,74.0,2,290,0.0,147.0,145.0
16741.0,6,13,1459,7,862,2738.333333333333,271.0,123.14285714285714,6,597,3013.2,259.0,99.5
108105545.0,17,5,955,5,955,27026386.25,191.0,191.0,0,0,0.0,0.0,0.0
97057781.0,6,160,18096,80,12594,1225853.5189873418,284.0,157.425,80,5502,1225854.5443037974,140.0,68.775
119802.0,17,2,180,1,70,0.0,70.0,70.0,1,110,0.0,110.0,110.0
69261.0,6,14,4740,7,653,11319.666666666666,249.0,93.28571428571428,7,4087,7311.0,1514.0,583.8571428571429
40204.0,6,10,2032,5,524,9106.5,252.0,104.8,5,1508,8096.75,1236.0,301.6
2409.0,17,4,344,2,150,0.0,75.0,75.0,2,194,0.0,103.0,97.0
295039.0,17,2,371,1,81,0.0,81.0,81.0,1,290,0.0,290.0,290.0
2364.0,17,4,344,2,150,0.0,75.0,75.0,2,194,0.0,103.0,97.0
156421.0,17,2,180,1,90,0.0,90.0,90.0,1,90,0.0,90.0,90.0
4282.0,17,2,762,2,762,0.0,381.0,381.0,0,0,0.0,0.0,0.0
3350115.0,6,3,1602,2,850,0.0,784.0,425.0,1,752,0.0,752.0,752.0
120122609.0,6,13,2036,5,1020,30030652.25,204.0,204.0,8,1016,17137193.14285714,188.0,127.0
16708.0,6,10,2032,5,524,2786.5,252.0,104.8,5,1508,3834.5,1236.0,301.6
20135.0,6,14,4740,7,653,2407.6666666666665,249.0,93.28571428571428,7,4087,3220.1666666666665,1514.0,583.8571428571429
255275.0,6,10,1221,6,636,51055.0,298.0,106.0,4,585,83987.33333333333,379.0,146.25
108100328.0,17,5,955,5,955,27025082.0,191.0,191.0,0,0,0.0,0.0,0.0
0.0,17,1,44,1,44,0.0,44.0,44.0,0,0,0.0,0.0,0.0
90020953.0,17,28,13364,28,13364,3334109.3703703703,501.0,477.2857142857143,0,0,0.0,0.0,0.0
44366.0,6,10,2032,5,524,10505.0,252.0,104.8,5,1508,10608.25,1236.0,301.6
196720.0,17,2,180,1,90,0.0,90.0,90.0,1,90,0.0,90.0,90.0
90261798.0,6,13,2036,8,1016,12894542.57142857,188.0,127.0,5,1020,22523625.25,204.0,204.0
3618.0,17,2,414,1,88,0.0,88.0,88.0,1,326,0.0,326.0,326.0
90258230.0,6,12,1832,8,1016,12894032.857142856,188.0,127.0,4,816,30030854.666666668,204.0,204.0
11203195.0,17,4,1368,4,1368,3734398.3333333335,342.0,342.0,0,0,0.0,0.0,0.0
19080.0,6,13,1459,7,862,3180.0,271.0,123.14285714285714,6,597,3359.6,259.0,99.5
124137454.0,6,33,2296,17,1225,7758590.875,139.0,72.05882352941177,16,1071,7595750.466666667,123.0,66.9375
695997.0,6,10,1124,6,608,139199.4,222.0,101.33333333333331,4,516,147099.0,206.0,129.0
97128399.0,6,40,2640,20,1320,5112021.0,66.0,66.0,20,1320,5100637.0,66.0,66.0
975931.0,6,12,1354,7,789,162655.16666666666,253.0,112.71428571428572,5,565,243112.75,293.0,113.0
15051134.0,6,5,370,5,370,3762783.5,74.0,74.0,0,0,0.0,0.0,0.0
264308.0,6,10,1221,6,636,52861.6,298.0,106.0,4,585,82599.66666666667,379.0,146.25
154142.0,17,2,180,1,90,0.0,90.0,90.0,1,90,0.0,90.0,90.0
103841225.0,6,44,2904,22,1452,4944820.238095238,66.0,66.0,22,1452,4929851.714285715,66.0,66.0
317.0,17,2,174,1,79,0.0,79.0,79.0,1,95,0.0,95.0,95.0
961123.0,6,12,1447,6,816,184352.6,291.0,136.0,6,631,190447.8,293.0,105.16666666666669
90290148.0,6,15,1097,8,596,12898592.57142857,95.0,74.5,7,501,14996865.5,95.0,71.57142857142857
10539283.0,6,7,478,4,272,3467324.6666666665,74.0,68.0,3,206,5200903.5,74.0,68.66666666666667
29193.0,6,14,4740,7,653,2805.0,249.0,93.28571428571428,7,4087,4670.833333333333,1514.0,583.8571428571429
1448537.0,6,7,499,3,198,716339.0,66.0,66.0,4,301,421991.3333333333,103.0,75.25
52275.0,6,14,4740,7,653,8342.333333333334,249.0,93.28571428571428,7,4087,7876.166666666667,1514.0,583.8571428571429
0.0,17,1,44,1,44,0.0,44.0,44.0,0,0,0.0,0.0,0.0
2057.0,17,4,344,2,150,0.0,75.0,75.0,2,194,0.0,103.0,97.0
14811.0,17,2,180,1,90,0.0,90.0,90.0,1,90,0.0,90.0,90.0
5624855.0,6,5,336,2,134,0.0,68.0,67.0,3,202,1420859.5,70.0,67.33333333333333
1790910.0,6,23,6509,12,1529,162810.0,357.0,127.41666666666669,11,4980,145077.2,1510.0,452.7272727272728
105280.0,6,2,132,1,66,0.0,66.0,66.0,1,66,0.0,66.0,66.0
575511.0,6,4,508,2,238,0.0,172.0,119.0,2,270,0.0,135.0,135.0
325.0,17,2,174,1,79,0.0,79.0,79.0,1,95,0.0,95.0,95.0
4596257.0,6,5,336,2,134,0.0,68.0,67.0,3,202,1526948.0,70.0,67.33333333333333
213235.0,6,3,426,2,280,0.0,214.0,140.0,1,146,0.0,146.0,146.0
120041614.0,17,29,13785,29,13785,4287200.5,501.0,475.3448275862069,0,0,0.0,0.0,0.0
312249.0,17,4,1400,4,1400,104083.0,350.0,350.0,0,0,0.0,0.0,0.0
89374496.0,17,14,4788,14,4788,6874961.230769231,342.0,342.0,0,0,0.0,0.0,0.0
49970.0,6,10,2032,5,524,12178.5,252.0,104.8,5,1508,12052.0,1236.0,301.6
153410.0,17,2,180,1,90,0.0,90.0,90.0,1,90,0.0,90.0,90.0
8387840.000000001,17,3,1034,2,684,0.0,342.0,342.0,1,350,0.0,350.0,350.0
90250039.0,6,13,2036,8,1016,12892862.714285716,188.0,127.0,5,1020,22515966.5,204.0,204.0
12656.0,17,2,582,1,83,0.0,83.0,83.0,1,499,0.0,499.0,499.0
232417.0,6,3,337,2,214,0.0,160.0,107.0,1,123,0.0,123.0,123.0
18763.0,6,10,2032,5,524,3734.25,252.0,104.8,5,1508,4416.75,1236.0,301.6
1167.0,17,2,762,2,762,0.0,381.0,381.0,0,0,0.0,0.0,0.0
308090.0,6,6,412,4,272,102696.66666666669,74.0,68.0,2,140,0.0,74.0,70.0
37550.0,6,14,4740,7,653,6098.333333333333,249.0,93.28571428571428,7,4087,6071.833333333333,1514.0,583.8571428571429
302333.0,6,6,412,4,272,100777.66666666669,74.0,68.0,2,140,0.0,74.0,70.0
113334103.0,6,33,2280,17,1209,7069882.4375,123.0,71.11764705882354,16,1071,7541207.933333334,123.0,66.9375
205142.0,17,2,762,2,762,0.0,381.0,381.0,0,0,0.0,0.0,0.0
122314406.0,6,48,3168,24,1584,4971834.217391305,66.0,66.0,24,1584,5235910.130434782,66.0,66.0
273604.0,17,4,1400,4,1400,91201.33333333331,350.0,350.0,0,0,0.0,0.0,0.0
58700351.0,17,9,3086,8,2736,5108844.857142857,342.0,342.0,1,350,0.0,350.0,350.0
43948.0,6,14,4740,7,653,6427.0,249.0,93.28571428571428,7,4087,6941.5,1514.0,583.8571428571429
65398.0,6,10,2032,5,524,16058.75,252.0,104.8,5,1508,13202.5,1236.0,301.6
306108.0,6,6,412,4,272,102036.0,74.0,68.0,2,140,0.0,74.0,70.0
303604.0,6,2,132,1,66,0.0,66.0,66.0,1,66,0.0,66.0,66.0
96985086.0,6,40,2640,20,1320,5104478.210526316,66.0,66.0,20,1320,5089988.210526316,66.0,66.0
29004.0,6,14,4740,7,653,4551.833333333333,249.0,93.28571428571428,7,4087,4016.1666666666665,1514.0,583.8571428571429
5616262.0,6,4,270,2,134,0.0,68.0,67.0,2,136,0.0,70.0,68.0
100104.0,17,2,762,2,762,0.0,381.0,381.0,0,0,0.0,0.0,0.0
2601810.0,6,2,132,1,66,0.0,66.0,66.0,1,66,0.0,66.0,66.0
308758.0,6,6,412,4,272,102919.33333333331,74.0,68.0,2,140,0.0,74.0,70.0
2800861.0,6,2,132,1,66,0.0,66.0,66.0,1,66,0.0,66.0,66.0
103413.0,17,2,286,2,286,0.0,143.0,143.0,0,0,0.0,0.0,0.0
108106718.0,17,5,1005,5,1005,27026679.5,201.0,201.0,0,0,0.0,0.0,0.0
75044446.0,6,9,842,9,842,9380555.75,97.0,93.55555555555556,0,0,0.0,0.0,0.0
16449.0,6,11,2098,6,590,3171.2,252.0,98.33333333333331,5,1508,3714.75,1236.0,301.6
294605.0,6,12,1373,7,714,49100.833333333336,298.0,102.0,5,659,69600.25,379.0,131.8
233626.0,6,3,337,2,214,0.0,160.0,107.0,1,123,0.0,123.0,123.0
2321.0,17,4,344,2,150,0.0,75.0,75.0,2,194,0.0,103.0,97.0
120117336.0,6,14,2240,8,1016,17136424.42857143,188.0,127.0,6,1224,18017962.2,204.0,204.0
90030345.0,17,28,13364,28,13364,3334457.222222222,501.0,477.2857142857143,0,0,0.0,0.0,0.0
195529.0,17,4,6056,4,6056,65176.333333333336,1514.0,1514.0,0,0,0.0,0.0,0.0
246121.0,6,3,337,2,214,0.0,160.0,107.0,1,123,0.0,123.0,123.0
18495.0,6,10,2032,5,524,4402.0,252.0,104.8,5,1508,4180.75,1236.0,301.6
40822.0,6,14,4740,7,653,5865.166666666667,249.0,93.28571428571428,7,4087,6134.833333333333,1514.0,583.8571428571429
1474898.0,17,16,1120,16,1120,98326.53333333334,70.0,70.0,0,0,0.0,0.0,0.0
146861.0,6,3,373,2,238,0.0,172.0,119.0,1,135,0.0,135.0,135.0
135132407.0,17,6,1206,6,1206,27026481.4,201.0,201.0,0,0,0.0,0.0,0.0
17153.0,6,10,1067,5,536,3678.5,264.0,107.2,5,531,3508.75,259.0,106.2
51728146.0,6,8,2113,3,960,24537842.0,826.0,320.0,5,1153,12288182.25,885.0,230.6
363.0,17,2,267,1,83,0.0,83.0,83.0,1,184,0.0,184.0,184.0
2458.0,17,4,344,2,150,0.0,75.0,75.0,2,194,0.0,103.0,97.0
10449173.0,6,7,478,4,272,3437602.0,74.0,68.0,3,206,5156288.0,74.0,68.66666666666667
135047.0,6,14,4740,7,653,22388.5,249.0,93.28571428571428,7,4087,20401.83333333333,1514.0,583.8571428571429
10515648.0,6,7,478,4,272,3459870.0,74.0,68.0,3,206,5189655.5,74.0,68.66666666666667
213733.0,17,2,180,1,90,0.0,90.0,90.0,1,90,0.0,90.0,90.0
121395355.0,6,295,33974,148,23976,825818.7414965987,284.0,162.0,147,9998,817382.0890410959,140.0,68.01360544217687
135130489.0,17,6,1146,6,1146,27026097.8,191.0,191.0,0,0,0.0,0.0,0.0
111066.0,17,2,286,2,286,0.0,143.0,143.0,0,0,0.0,0.0,0.0
34517.0,6,10,2032,5,524,8064.25,252.0,104.8,5,1508,8068.5,1236.0,301.6
102001306.0,17,13,821,7,432,17000217.666666668,174.0,61.71428571428572,6,389,16401280.6,174.0,64.83333333333333
126001187.0,17,15,907,8,475,18000169.57142857,174.0,59.375,7,432,17668209.5,174.0,61.71428571428572
233531.0,6,3,337,2,214,0.0,160.0,107.0,1,123,0.0,123.0,123.0
90258475.0,6,12,1832,8,1016,12894067.857142856,188.0,127.0,4,816,30032067.33333333,204.0,204.0
143907.0,17,2,180,1,90,0.0,90.0,90.0,1,90,0.0,90.0,90.0
284775.0,17,2,363,1,79,0.0,79.0,79.0,1,284,0.0,284.0,284.0
220231.0,6,3,426,2,280,0.0,214.0,140.0,1,146,0.0,146.0,146.0
321.0,17,2,174,1,79,0.0,79.0,79.0,1,95,0.0,95.0,95.0
56684.0,6,10,2032,5,524,13516.0,252.0,104.8,5,1508,13133.0,1236.0,301.6
278011.0,17,2,363,1,79,0.0,79.0,79.0,1,284,0.0,284.0,284.0
43029.0,6,14,4740,7,653,7040.666666666667,249.0,93.28571428571428,7,4087,6842.333333333333,1514.0,583.8571428571429
104599428.0,6,28,1860,14,966,8029502.923076923,123.0,69.0,14,894,8029511.307692308,123.0,63.85714285714285
2036.0,17,4,344,2,150,0.0,75.0,75.0,2,194,0.0,103.0,97.0
143302.0,17,4,344,2,150,0.0,75.0,75.0,2,194,0.0,103.0,97.0
210102.0,17,2,359,1,75,0.0,75.0,75.0,1,284,0.0,284.0,284.0
80655.0,6,15,4806,8,719,11417.142857142857,249.0,89.875,7,4087,13263.5,1514.0,583.8571428571429
108095559.0,17,5,1005,5,1005,27023889.75,201.0,201.0,0,0,0.0,0.0,0.0
46053.0,6,14,4740,7,653,7490.333333333333,249.0,93.28571428571428,7,4087,7486.333333333333,1514.0,583.8571428571429
121350081.0,6,227,25706,114,18026,1073894.5221238935,284.0,158.12280701754386,113,7680,1066047.2232142857,140.0,67.96460176991151
5005710.0,17,4,534,2,166,0.0,83.0,83.0,2,368,0.0,184.0,184.0
1176728.0,6,13,3019,8,2391,168104.0,1514.0,298.875,5,628,225283.75,331.0,125.6
208079.0,6,10,1221,6,636,41615.8,298.0,106.0,4,585,68532.33333333333,379.0,146.25
191949.0,17,2,762,2,762,0.0,381.0,381.0,0,0,0.0,0.0,0.0
90903365.0,6,252,29044,126,8464,727141.496,140.0,67.17460317460318,126,20580,720755.936,284.0,163.33333333333334
855.0,17,4,438,2,148,0.0,74.0,74.0,2,290,0.0,147.0,145.0
90030598.0,17,28,13364,28,13364,3334466.592592593,501.0,477.2857142857143,0,0,0.0,0.0,0.0
324.0,17,2,174,1,79,0.0,79.0,79.0,1,95,0.0,95.0,95.0
199225.0,17,2,180,1,90,0.0,90.0,90.0,1,90,0.0,90.0,90.0
48272.0,6,14,4740,7,653,7922.333333333333,249.0,93.28571428571428,7,4087,7752.0,1514.0,583.8571428571429
113610541.0,6,46,3036,23,1518,5150435.7727272725,66.0,66.0,23,1518,5150434.863636363,66.0,66.0
82942673.0,17,13,4454,12,4104,6794824.181818182,342.0,342.0,1,350,0.0,350.0,350.0
9181.0,17,2,582,1,83,0.0,83.0,83.0,1,499,0.0,499.0,499.0
135130517.0,17,6,1146,6,1146,27026103.4,191.0,191.0,0,0,0.0,0.0,0.0
108095791.0,17,5,955,5,955,27023947.75,191.0,191.0,0,0,0.0,0.0,0.0
90010177.0,17,27,12943,27,12943,3461929.8846153845,501.0,479.3703703703704,0,0,0.0,0.0,0.0
28839.0,6,14,4740,7,653,4592.833333333333,249.0,93.28571428571428,7,4087,4467.5,1514.0,583.8571428571429
108868460.0,17,14,864,7,432,18118114.166666668,174.0,61.71428571428572,7,432,18064092.0,174.0,61.71428571428572
2359.0,17,4,344,2,150,0.0,75.0,75.0,2,194,0.0,103.0,97.0
37256.0,6,14,4740,7,653,5877.666666666667,249.0,93.28571428571428,7,4087,5496.5,1514.0,583.8571428571429
90299236.0,6,16,1192,8,596,12893884.0,95.0,74.5,8,596,12898386.857142856,95.0,74.5
1471947.0,17,16,1120,16,1120,98129.8,70.0,70.0,0,0,0.0,0.0,0.0
100715.0,17,2,762,2,762,0.0,381.0,381.0,0,0,0.0,0.0,0.0
168732.0,17,4,1524,4,1524,56244.0,381.0,381.0,0,0,0.0,0.0,0.0
322169.0,17,4,1400,4,1400,107389.66666666669,350.0,350.0,0,0,0.0,0.0,0.0
10469321.0,6,7,478,4,272,3444008.6666666665,74.0,68.0,3,206,5165863.5,74.0,68.66666666666667
301670.0,6,6,412,4,272,100556.66666666669,74.0,68.0,2,140,0.0,74.0,70.0
135134877.0,17,6,1206,6,1206,27026975.4,201.0,201.0,0,0,0.0,0.0,0.0
43220.0,6,10,2032,5,524,10560.75,252.0,104.8,5,1508,10166.25,1236.0,301.6
120121291.0,6,12,1832,8,1016,17136985.14285714,188.0,127.0,4,816,30031411.33333333,204.0,204.0
1448139.0,6,7,499,3,198,716405.0,66.0,66.0,4,301,455859.3333333333,103.0,75.25
2280389.0,6,24,7544,13,2516,190032.41666666663,1034.0,193.53846153846155,11,5028,196232.8,1510.0,457.09090909090907
5624278.0,6,5,336,2,134,0.0,68.0,67.0,3,202,1522913.5,70.0,67.33333333333333
108101518.0,17,5,1005,5,1005,27025379.5,201.0,201.0,0,0,0.0,0.0,0.0
42273.0,6,2,132,1,66,0.0,66.0,66.0,1,66,0.0,66.0,66.0
2798412.0,6,2,132,1,66,0.0,66.0,66.0,1,66,0.0,66.0,66.0
155381.0,6,3,337,2,214,0.0,160.0,107.0,1,123,0.0,123.0,123.0
206021.0,6,3,426,2,280,0.0,214.0,140.0,1,146,0.0,146.0,146.0
284333.0,17,2,363,1,79,0.0,79.0,79.0,1,284,0.0,284.0,284.0
33677.0,6,14,4740,7,653,5067.0,249.0,93.28571428571428,7,4087,5144.833333333333,1514.0,583.8571428571429
113309573.0,6,45,2970,23,1518,5150435.136363637,66.0,66.0,22,1452,5229382.476190476,66.0,66.0
106701543.0,6,474,57330,237,15876,449136.2711864407,140.0,66.9873417721519,237,41454,452104.67372881353,480.0,174.91139240506328
40950.0,6,11,2098,6,590,7530.4,252.0,98.33333333333331,5,1508,7667.75,1236.0,301.6
208238.0,6,3,426,2,280,0.0,214.0,140.0,1,146,0.0,146.0,146.0
90205134.0,6,19,1436,9,691,11246047.625,95.0,76.77777777777777,10,745,9999963.222222222,95.0,74.5
135139377.0,17,6,1206,6,1206,27027875.4,201.0,201.0,0,0,0.0,0.0,0.0
201603.0,17,4,6056,4,6056,67201.0,1514.0,1514.0,0,0,0.0,0.0,0.0
213685.0,17,2,180,1,90,0.0,90.0,90.0,1,90,0.0,90.0,90.0
108132825.0,17,5,955,5,955,27033206.25,191.0,191.0,0,0,0.0,0.0,0.0
213682.0,17,2,180,1,90,0.0,90.0,90.0,1,90,0.0,90.0,90.0
117354159.0,6,34,2334,17,1209,7320852.8125,123.0,71.11764705882354,17,1125,7320851.625,123.0,66.17647058823529
6468162.0,6,25,7611,13,2516,539013.5,1034.0,193.53846153846155,12,5095,558552.7272727273,1510.0,424.5833333333333
10482100.0,6,6,412,3,206,5173190.0,74.0,68.66666666666667,3,206,5173082.5,74.0,68.66666666666667
90741145.0,6,22,1680,12,935,8245523.818181818,95.0,77.91666666666667,10,745,10041055.333333334,95.0,74.5
2980.0,17,4,344,2,150,0.0,75.0,75.0,2,194,0.0,103.0,97.0
29505.0,6,10,2032,5,524,6369.0,252.0,104.8,5,1508,6734.75,1236.0,301.6
108108017.0,17,5,1005,5,1005,27027004.25,201.0,201.0,0,0,0.0,0.0,0.0
122975106.0,6,48,3168,24,1584,5025431.217391305,66.0,66.0,24,1584,5241642.869565218,66.0,66.0
108106456.0,17,5,955,5,955,27026614.0,191.0,191.0,0,0,0.0,0.0,0.0
20364.0,6,20,7606,11,978,2036.4,310.0,88.9090909090909,9,6628,2108.5,1514.0,736.4444444444445
3174205.0,6,18,1577,9,1003,358285.0,315.0,111.44444444444444,9,574,358250.5,78.0,63.77777777777778
2516647.0,6,3,1604,2,851,0.0,785.0,425.5,1,753,0.0,753.0,753.0
146161.0,6,3,337,2,214,0.0,160.0,107.0,1,123,0.0,123.0,123.0
322094.0,6,12,1373,7,714,53682.333333333336,298.0,102.0,5,659,76493.5,379.0,131.8
146215.0,6,3,337,2,214,0.0,160.0,107.0,1,123,0.0,123.0,123.0
34629.0,6,14,4740,7,653,5627.666666666667,249.0,93.28571428571428,7,4087,5356.0,1514.0,583.8571428571429
23749.0,6,14,4740,7,653,3837.1666666666665,249.0,93.28571428571428,7,4087,3605.3333333333335,1514.0,583.8571428571429
171666.0,17,2,180,1,90,0.0,90.0,90.0,1,90,0.0,90.0,90.0
104001022.0,17,13,821,7,432,17333503.666666668,174.0,61.71428571428572,6,389,17000736.2,174.0,64.83333333333333
103423043.0,6,42,2772,21,1386,5155443.5,66.0,66.0,21,1386,5155440.6,66.0,66.0
94076447.0,17,12,778,6,389,18800181.2,174.0,64.83333333333333,6,389,18800860.8,174.0,64.83333333333333
104119679.0,17,14,1126,7,563,17326794.333333332,174.0,80.42857142857143,7,563,17326795.833333332,174.0,80.42857142857143
241800.0,6,3,337,2,214,0.0,160.0,107.0,1,123,0.0,123.0,123.0
102543112.0,6,28,1860,14,966,7872162.230769231,123.0,69.0,14,894,7872162.692307692,123.0,63.85714285714285
14073421.0,17,5,1710,5,1710,3518355.25,342.0,342.0,0,0,0.0,0.0,0.0
2370.0,17,4,344,2,150,0.0,75.0,75.0,2,194,0.0,103.0,97.0
512653.0,6,3,1604,2,851,0.0,785.0,425.5,1,753,0.0,753.0,753.0
73331.0,6,14,4740,7,653,12088.333333333334,249.0,93.28571428571428,7,4087,11991.0,1514.0,583.8571428571429
837922.0,6,9,1118,6,586,167584.4,248.0,97.66666666666669,3,532,282648.0,392.0,177.33333333333334
90017695.0,17,28,13364,28,13364,3333988.703703704,501.0,477.2857142857143,0,0,0.0,0.0,0.0
40173.0,6,10,2032,5,524,9245.25,252.0,104.8,5,1508,8983.5,1236.0,301.6
2367.0,17,4,344,2,150,0.0,75.0,75.0,2,194,0.0,103.0,97.0
90295963.0,6,16,1192,8,596,12893290.57142857,95.0,74.5,8,596,12898362.42857143,95.0,74.5
115177665.0,6,32,2236,16,1165,7664131.8,139.0,72.8125,16,1071,7664119.733333333,123.0,66.9375
149314.0,17,2,414,1,88,0.0,88.0,88.0,1,326,0.0,326.0,326.0
10879747.0,6,8,544,4,272,3581217.333333333,74.0,68.0,4,272,3581147.6666666665,74.0,68.0
114115411.0,6,31,2166,16,1149,7593293.6,123.0,71.8125,15,1017,8135671.857142857,123.0,67.8
2931.0,17,2,224,1,76,0.0,76.0,76.0,1,148,0.0,148.0,148.0
120122166.0,6,14,2240,8,1016,17137062.0,188.0,127.0,6,1224,18018455.6,204.0,204.0
63421.00000000001,6,14,4740,7,653,10185.666666666666,249.0,93.28571428571428,7,4087,6533.666666666667,1514.0,583.8571428571429
104554845.0,6,25,2803,12,1358,9501182.090909092,427.0,113.16666666666669,13,1445,8712130.75,330.0,111.15384615384616
255185.0,6,3,337,2,214,0.0,160.0,107.0,1,123,0.0,123.0,123.0
108111853.0,17,5,1005,5,1005,27027963.25,201.0,201.0,0,0,0.0,0.0,0.0
100897.0,17,2,762,2,762,0.0,381.0,381.0,0,0,0.0,0.0,0.0
43525.0,6,14,4740,7,653,6959.333333333333,249.0,93.28571428571428,7,4087,4493.5,1514.0,583.8571428571429
49169.0,6,14,4740,7,653,7254.166666666667,249.0,93.28571428571428,7,4087,7906.833333333333,1514.0,583.8571428571429
153491.0,17,2,180,1,90,0.0,90.0,90.0,1,90,0.0,90.0,90.0
5628923.0,6,4,270,2,134,0.0,68.0,67.0,2,136,0.0,70.0,68.0
327.0,17,2,208,1,72,0.0,72.0,72.0,1,136,0.0,136.0,136.0
104477963.0,6,34,2620,18,1411,6133072.05882353,139.0,78.38888888888889,16,1209,6950818.133333334,123.0,75.5625
146861.0,6,3,373,2,238,0.0,172.0,119.0,1,135,0.0,135.0,135.0
90021914.0,17,28,13364,28,13364,3334144.962962963,501.0,477.2857142857143,0,0,0.0,0.0,0.0
135863724.0,17,14,864,7,432,19334875.5,174.0,61.71428571428572,7,432,19333528.83333333,174.0,61.71428571428572
61198.0,6,14,4740,7,653,9878.333333333334,249.0,93.28571428571428,7,4087,9458.5,1514.0,583.8571428571429
320585.0,17,4,1400,4,1400,106861.66666666669,350.0,350.0,0,0,0.0,0.0,0.0
10461014.0,6,7,478,4,272,3441582.333333333,74.0,68.0,3,206,5162284.5,74.0,68.66666666666667
309736.0,6,6,412,4,272,103245.33333333331,74.0,68.0,2,140,0.0,74.0,70.0
2654662.0,6,3,1604,1,753,0.0,753.0,753.0,2,851,0.0,785.0,425.5
108108587.0,17,5,1005,5,1005,27027146.75,201.0,201.0,0,0,0.0,0.0,0.0
349807.0,6,4,508,2,238,0.0,172.0,119.0,2,270,0.0,135.0,135.0
144700.0,17,2,180,1,70,0.0,70.0,70.0,1,110,0.0,110.0,110.0
10466341.0,6,7,478,4,272,3441537.333333333,74.0,68.0,3,206,5162173.0,74.0,68.66666666666667
495841.0,6,5,336,2,134,0.0,68.0,67.0,3,202,193493.5,70.0,67.33333333333333
107621.0,17,2,286,2,286,0.0,143.0,143.0,0,0,0.0,0.0,0.0
46380.0,6,10,2032,5,524,10321.75,252.0,104.8,5,1508,10336.5,1236.0,301.6
90026246.0,17,28,13364,28,13364,3334305.407407407,501.0,477.2857142857143,0,0,0.0,0.0,0.0
90006578.0,17,28,13364,28,13364,3333576.962962963,501.0,477.2857142857143,0,0,0.0,0.0,0.0
2793796.0,6,2,132,1,66,0.0,66.0,66.0,1,66,0.0,66.0,66.0
15576.0,6,10,2032,5,524,3610.5,252.0,104.8,5,1508,3499.25,1236.0,301.6
143875.0,17,2,180,1,90,0.0,90.0,90.0,1,90,0.0,90.0,90.0
2837901.0,6,11,2106,6,598,567332.2,252.0,99.66666666666669,5,1508,2338.25,1236.0,301.6
10482243.0,6,7,478,4,272,3448711.6666666665,74.0,68.0,3,206,5172965.0,74.0,68.66666666666667
14649096.0,6,19,1553,9,921,1791844.75,315.0,102.33333333333331,10,632,1592512.7777777778,78.0,63.2
2141547.0,6,25,7610,13,2516,178462.25,1034.0,193.53846153846155,12,5094,166083.81818181818,1510.0,424.5
2083524.0,6,25,7610,13,2516,173627.0,1034.0,193.53846153846155,12,5094,161830.81818181818,1510.0,424.5
204894.0,17,2,762,2,762,0.0,381.0,381.0,0,0,0.0,0.0,0.0
247837.0,6,3,337,2,214,0.0,160.0,107.0,1,123,0.0,123.0,123.0
107033.0,17,2,286,2,286,0.0,143.0,143.0,0,0,0.0,0.0,0.0
108119448.0,17,5,955,5,955,27029862.0,191.0,191.0,0,0,0.0,0.0,0.0
90035071.0,17,27,12943,27,12943,3462887.346153846,501.0,479.3703703703704,0,0,0.0,0.0,0.0
71480410.0,6,26,1876,13,938,5956700.833333333,95.0,72.15384615384616,13,938,5935832.666666667,95.0,72.15384615384616
23223.0,6,10,2032,5,524,5430.0,252.0,104.8,5,1508,5515.25,1236.0,301.6
24979.0,6,10,2032,5,524,5938.25,252.0,104.8,5,1508,6011.0,1236.0,301.6
3103338.0,6,20,6935,11,1567,310333.8,408.0,142.45454545454547,9,5368,334702.125,1514.0,596.4444444444445
103418.0,17,2,286,2,286,0.0,143.0,143.0,0,0,0.0,0.0,0.0
108109021.0,17,5,955,5,955,27027255.25,191.0,191.0,0,0,0.0,0.0,0.0
120079124.0,6,228,25628,114,7820,1055386.814159292,140.0,68.59649122807018,114,17808,1055496.6548672563,284.0,156.21052631578948
90753750.0,6,24,1829,13,989,7559436.75,95.0,76.07692307692308,11,840,8999835.3,95.0,76.36363636363636
2347.0,17,4,344,2,150,0.0,75.0,75.0,2,194,0.0,103.0,97.0
90258599.0,6,14,2102,8,1016,12894085.57142857,188.0,127.0,6,1086,18019331.6,204.0,181.0
11864.0,6,11,2098,6,590,1964.8,252.0,98.33333333333331,5,1508,2415.5,1236.0,301.6
0.0,17,1,453,1,453,0.0,453.0,453.0,0,0,0.0,0.0,0.0
1984.0,17,4,344,2,150,0.0,75.0,75.0,2,194,0.0,103.0,97.0
93581501.0,17,11,735,6,389,18716300.2,174.0,64.83333333333333,5,346,18365793.25,174.0,69.2
91829157.0,6,22,1680,10,786,10203239.666666666,95.0,78.6,12,894,8325580.818181818,95.0,74.5
146961.0,17,4,571,2,148,0.0,74.0,74.0,2,423,0.0,276.0,211.5
108999.0,17,2,286,2,286,0.0,143.0,143.0,0,0,0.0,0.0,0.0
1507453.0,6,7,499,4,301,440502.6666666667,103.0,75.25,3,198,715988.0,66.0,66.0
50180.0,6,14,4740,7,653,7989.666666666667,249.0,93.28571428571428,7,4087,5713.0,1514.0,583.8571428571429
120068226.0,17,29,13785,29,13785,4288150.928571428,501.0,475.3448275862069,0,0,0.0,0.0,0.0
302804.0,6,6,412,4,272,100934.66666666669,74.0,68.0,2,140,0.0,74.0,70.0
201469.0,17,4,6056,4,6056,67156.33333333333,1514.0,1514.0,0,0,0.0,0.0,0.0
304985.0,17,4,704,2,148,0.0,74.0,74.0,2,556,0.0,280.0,278.0
246507.0,6,3,337,2,214,0.0,160.0,107.0,1,123,0.0,123.0,123.0
36077.0,6,14,4740,7,653,5813.0,249.0,93.28571428571428,7,4087,5876.666666666667,1514.0,583.8571428571429
121491.0,6,3,337,2,214,0.0,160.0,107.0,1,123,0.0,123.0,123.0
336.0,17,2,166,1,75,0.0,75.0,75.0,1,91,0.0,91.0,91.0
107137684.0,6,44,2904,22,1452,5101794.476190476,66.0,66.0,22,1452,5087261.904761905,66.0,66.0
110078601.0,6,28,1860,14,966,8450981.615384616,123.0,69.0,14,894,8450986.923076924,123.0,63.85714285714285
217165.0,6,3,426,2,280,0.0,214.0,140.0,1,146,0.0,146.0,146.0
146313.0,6,3,337,2,214,0.0,160.0,107.0,1,123,0.0,123.0,123.0
90054183.0,17,28,13364,28,13364,3335340.111111111,501.0,477.2857142857143,0,0,0.0,0.0,0.0
215607.0,17,2,180,1,90,0.0,90.0,90.0,1,90,0.0,90.0,90.0
106327179.0,17,14,864,7,432,17667433.333333332,174.0,61.71428571428572,7,432,17666842.333333332,174.0,61.71428571428572
30449603.0,6,29,9249,16,3843,178288.53333333333,1514.0,240.1875,13,5406,2520310.4166666665,1514.0,415.84615384615387
16424267.0,6,28,9301,15,2193,1173161.9285714286,408.0,146.2,13,7108,1024488.1666666666,1514.0,546.7692307692307
121473.0,6,3,337,2,214,0.0,160.0,107.0,1,123,0.0,123.0,123.0
218196.0,6,3,426,2,280,0.0,214.0,140.0,1,146,0.0,146.0,146.0
216071.0,6,3,426,2,280,0.0,214.0,140.0,1,146,0.0,146.0,146.0
204981.0,17,2,762,2,762,0.0,381.0,381.0,0,0,0.0,0.0,0.0
1207953.0,17,7,490,7,490,201325.5,70.0,70.0,0,0,0.0,0.0,0.0
90264177.0,6,12,1832,8,1016,12894882.42857143,188.0,127.0,4,816,30034123.666666668,204.0,204.0
108127043.0,17,5,955,5,955,27031760.75,191.0,191.0,0,0,0.0,0.0,0.0
270469.0,6,3,337,2,214,0.0,160.0,107.0,1,123,0.0,123.0,123.0
317815.0,6,6,412,4,272,105938.33333333331,74.0,68.0,2,140,0.0,74.0,70.0
156430.0,17,2,180,1,90,0.0,90.0,90.0,1,90,0.0,90.0,90.0
51993.0,6,10,1065,5,534,10570.5,262.0,106.8,5,531,10782.5,259.0,106.2
135132700.0,17,6,1146,6,1146,27026540.0,191.0,191.0,0,0,0.0,0.0,0.0
231049.0,6,3,426,2,280,0.0,214.0,140.0,1,146,0.0,146.0,146.0
35589.0,6,14,4740,7,653,5605.833333333333,249.0,93.28571428571428,7,4087,5613.833333333333,1514.0,583.8571428571429
120264811.0,6,218,24534,109,7416,1106090.490740741,140.0,68.03669724770643,109,17118,1105987.0833333333,284.0,157.045871559633
90663431.0,6,15,2302,9,1204,11316309.0,188.0,133.77777777777777,6,1098,18099904.8,204.0,183.0
0.0,17,1,55,1,55,0.0,55.0,55.0,0,0,0.0,0.0,0.0
51135.0,17,2,180,1,90,0.0,90.0,90.0,1,90,0.0,90.0,90.0
27808.0,6,14,4740,7,653,4509.833333333333,249.0,93.28571428571428,7,4087,4496.833333333333,1514.0,583.8571428571429
0.0,17,1,342,1,342,0.0,342.0,342.0,0,0,0.0,0.0,0.0
90529266.0,6,14,2240,8,1016,12932752.285714284,188.0,127.0,6,1224,18072867.0,204.0,204.0
120201354.0,6,220,24900,110,7482,1095183.7155963304,140.0,68.01818181818182,110,17418,1095189.3211009174,284.0,158.34545454545454
28327.0,6,20,7606,11,978,2832.7,310.0,88.9090909090909,9,6628,3196.125,1514.0,736.4444444444445
115007453.0,17,15,1169,8,606,16429636.142857144,174.0,75.75,7,563,15833494.666666666,174.0,80.42857142857143
709214.0,6,5,336,2,134,0.0,68.0,67.0,3,202,196301.0,70.0,67.33333333333333
115538535.0,6,30,1974,15,1026,8237322.857142857,123.0,68.4,15,948,8237326.071428572,123.0,63.2
30721.0,6,10,2032,5,524,6417.0,252.0,104.8,5,1508,7203.5,1236.0,301.6
0.0,6,1,66,1,66,0.0,66.0,66.0,0,0,0.0,0.0,0.0
99949541.0,6,183,20742,92,6294,1098346.6043956045,140.0,68.41304347826087,91,14448,1100350.3444444444,300.0,158.76923076923077
255845.0,6,3,337,2,214,0.0,160.0,107.0,1,123,0.0,123.0,123.0
308949.0,6,6,412,4,272,102983.0,74.0,68.0,2,140,0.0,74.0,70.0
850421.0,6,9,1118,6,586,170084.2,248.0,97.66666666666669,3,532,287284.0,392.0,177.33333333333334
20172.0,6,10,2032,5,524,4731.0,252.0,104.8,5,1508,4480.75,1236.0,301.6
107846.0,17,2,286,2,286,0.0,143.0,143.0,0,0,0.0,0.0,0.0
10429791.0,6,6,412,3,206,5146786.5,74.0,68.66666666666667,3,206,5146639.5,74.0,68.66666666666667
120052943.0,17,28,13364,28,13364,4446405.296296297,501.0,477.2857142857143,0,0,0.0,0.0,0.0
103909697.0,6,44,2904,22,1452,4948080.80952381,66.0,66.0,22,1452,4933340.142857143,66.0,66.0
90273643.0,6,13,2036,8,1016,12896234.714285716,188.0,127.0,5,1020,22517812.25,204.0,204.0
7661.0,17,4,344,2,150,0.0,75.0,75.0,2,194,0.0,103.0,97.0
153385.0,17,2,180,1,90,0.0,90.0,90.0,1,90,0.0,90.0,90.0
2593407.0,6,2,132,1,66,0.0,66.0,66.0,1,66,0.0,66.0,66.0
120125589.0,6,14,2224,9,1204,15015698.625,188.0,133.77777777777777,5,1020,22523313.0,204.0,204.0
110841190.0,6,33,2412,17,1272,6914076.5625,123.0,74.82352941176471,16,1140,7375012.933333334,123.0,71.25
2870082.0,6,2,132,1,66,0.0,66.0,66.0,1,66,0.0,66.0,66.0
2447.0,17,4,344,2,150,0.0,75.0,75.0,2,194,0.0,103.0,97.0
42959.0,6,11,2098,6,590,8029.2,252.0,98.33333333333331,5,1508,10487.75,1236.0,301.6
59124.0,6,13,1394,7,797,9458.666666666666,253.0,113.85714285714286,6,597,10087.2,259.0,99.5
284423.0,17,2,363,1,79,0.0,79.0,79.0,1,284,0.0,284.0,284.0
306.0,17,2,156,1,78,0.0,78.0,78.0,1,78,0.0,78.0,78.0
153387.0,17,2,180,1,90,0.0,90.0,90.0,1,90,0.0,90.0,90.0
5005756.0,17,4,849,2,166,0.0,83.0,83.0,2,683,0.0,499.0,341.5
323.0,17,2,174,1,79,0.0,79.0,79.0,1,95,0.0,95.0,95.0
1164614.0,6,13,3020,8,2392,166373.42857142858,1514.0,299.0,5,628,222263.25,331.0,125.6
20528.0,17,2,582,1,83,0.0,83.0,83.0,1,499,0.0,499.0,499.0
53257.0,6,14,4740,7,653,7711.666666666667,249.0,93.28571428571428,7,4087,8734.333333333334,1514.0,583.8571428571429
140779.0,6,11,1132,6,556,28088.6,218.0,92.66666666666669,5,576,34983.0,304.0,115.2
205790.0,17,2,180,1,90,0.0,90.0,90.0,1,90,0.0,90.0,90.0
98509796.0,6,30,2106,15,1089,7036414.0,123.0,72.6,15,1017,7020978.0,123.0,67.8
90032676.0,17,28,13364,28,13364,3334543.5555555555,501.0,477.2857142857143,0,0,0.0,0.0,0.0
793168.0,6,10,1221,6,636,158633.6,298.0,106.0,4,585,263551.3333333333,379.0,146.25
168639.0,17,4,571,2,148,0.0,74.0,74.0,2,423,0.0,276.0,211.5
148184.0,6,3,337,2,214,0.0,160.0,107.0,1,123,0.0,123.0,123.0
233018.0,6,3,337,2,214,0.0,160.0,107.0,1,123,0.0,123.0,123.0
16800.0,17,2,180,1,90,0.0,90.0,90.0,1,90,0.0,90.0,90.0
2307.0,17,4,344,2,150,0.0,75.0,75.0,2,194,0.0,103.0,97.0
2372.0,17,4,344,2,150,0.0,75.0,75.0,2,194,0.0,103.0,97.0
301087.0,6,6,412,4,272,100362.33333333331,74.0,68.0,2,140,0.0,74.0,70.0
2183744.0,6,19,6869,11,1567,218374.4,408.0,142.45454545454547,8,5302,248822.4285714285,1514.0,662.75
121001137.0,17,15,907,8,475,17285876.714285713,174.0,59.375,7,432,16834294.833333332,174.0,61.71428571428572
120189.0,17,2,180,1,70,0.0,70.0,70.0,1,110,0.0,110.0,110.0
335191.0,6,6,412,4,272,111730.33333333331,74.0,68.0,2,140,0.0,74.0,70.0
96311.0,6,14,4740,7,653,14988.0,249.0,93.28571428571428,7,4087,14815.5,1514.0,583.8571428571429
5005669.0,17,2,150,2,150,0.0,75.0,75.0,0,0,0.0,0.0,0.0
47712.0,6,10,2032,5,524,11680.5,252.0,104.8,5,1508,11646.75,1236.0,301.6
905217.0,17,6,1230,3,234,452422.0,78.0,78.0,3,996,452377.5,332.0,332.0
102419434.0,17,14,864,7,432,17001489.0,174.0,61.71428571428572,7,432,17000174.5,174.0,61.71428571428572
246116.0,6,3,337,2,214,0.0,160.0,107.0,1,123,0.0,123.0,123.0
120054772.0,17,29,13785,29,13785,4287670.428571428,501.0,475.3448275862069,0,0,0.0,0.0,0.0
1303540.0,6,4,264,2,132,0.0,66.0,66.0,2,132,0.0,66.0,66.0
296.0,17,2,156,1,78,0.0,78.0,78.0,1,78,0.0,78.0,78.0
283662.0,17,2,363,1,79,0.0,79.0,79.0,1,284,0.0,284.0,284.0
10470797.0,6,7,478,4,272,3443357.333333333,74.0,68.0,3,206,5164918.0,74.0,68.66666666666667
206241.0,6,3,426,2,280,0.0,214.0,140.0,1,146,0.0,146.0,146.0
457.0,17,2,166,1,75,0.0,75.0,75.0,1,91,0.0,91.0,91.0
105629.0,17,2,700,2,700,0.0,350.0,350.0,0,0,0.0,0.0,0.0
9624.0,17,2,582,1,83,0.0,83.0,83.0,1,499,0.0,499.0,499.0
135139336.0,17,6,1206,6,1206,27027867.2,201.0,201.0,0,0,0.0,0.0,0.0
94411137.0,17,12,778,6,389,18800158.6,174.0,64.83333333333333,6,389,18801257.8,174.0,64.83333333333333
108106951.0,17,5,1005,5,1005,27026737.75,201.0,201.0,0,0,0.0,0.0,0.0
24907.0,6,14,4740,7,653,3993.5,249.0,93.28571428571428,7,4087,3827.3333333333335,1514.0,583.8571428571429
90258687.0,6,12,1832,8,1016,12894098.142857144,188.0,127.0,4,816,30030617.0,204.0,204.0
11017.0,17,4,823,2,163,0.0,89.0,81.5,2,660,0.0,443.0,330.0
102977.0,17,2,286,2,286,0.0,143.0,143.0,0,0,0.0,0.0,0.0
34891.0,6,14,4740,7,653,5189.333333333333,249.0,93.28571428571428,7,4087,5677.166666666667,1514.0,583.8571428571429
209659.0,17,2,180,1,90,0.0,90.0,90.0,1,90,0.0,90.0,90.0
10442243.0,6,7,478,4,272,3434094.333333333,74.0,68.0,3,206,5151021.0,74.0,68.66666666666667
12787.0,6,10,1065,5,534,2631.25,262.0,106.8,5,531,2849.5,259.0,106.2
135133496.0,17,6,1146,6,1146,27026699.2,191.0,191.0,0,0,0.0,0.0,0.0
14637414.0,6,20,1648,10,1016,1592689.2222222222,315.0,101.6,10,632,1592661.4444444445,78.0,63.2
72371.0,6,14,4740,7,653,10098.0,249.0,93.28571428571428,7,4087,11658.0,1514.0,583.8571428571429
312452.0,6,6,412,4,272,104150.66666666669,74.0,68.0,2,140,0.0,74.0,70.0
303693.0,6,2,132,1,66,0.0,66.0,66.0,1,66,0.0,66.0,66.0
318546.0,17,4,1400,4,1400,106182.0,350.0,350.0,0,0,0.0,0.0,0.0
975.0,17,5,550,5,550,243.75,110.0,110.0,0,0,0.0,0.0,0.0
2793957.0,6,2,132,1,66,0.0,66.0,66.0,1,66,0.0,66.0,66.0
24114.0,6,10,2032,5,524,5179.0,252.0,104.8,5,1508,5114.25,1236.0,301.6
5007505.0,17,4,629,2,156,0.0,78.0,78.0,2,473,0.0,268.0,236.5
103050.0,17,2,286,2,286,0.0,143.0,143.0,0,0,0.0,0.0,0.0
235163.0,6,3,373,2,238,0.0,172.0,119.0,1,135,0.0,135.0,135.0
48169.0,6,2,132,1,66,0.0,66.0,66.0,1,66,0.0,66.0,66.0
148018.0,17,2,180,1,90,0.0,90.0,90.0,1,90,0.0,90.0,90.0
37596552.0,6,5,336,2,134,0.0,68.0,67.0,3,202,18729932.0,70.0,67.33333333333333
90257719.0,6,13,2036,8,1016,12893959.857142856,188.0,127.0,5,1020,22523484.5,204.0,204.0
108127957.0,17,5,1005,5,1005,27031989.25,201.0,201.0,0,0,0.0,0.0,0.0
120188939.0,6,234,26528,117,7944,1020172.3620689656,140.0,67.8974358974359,117,18584,1033658.8103448276,284.0,158.83760683760684
25737.0,6,14,4740,7,653,4116.166666666667,249.0,93.28571428571428,7,4087,4143.0,1514.0,583.8571428571429
2795069.0,6,2,132,1,66,0.0,66.0,66.0,1,66,0.0,66.0,66.0
10281.0,17,2,224,1,76,0.0,76.0,76.0,1,148,0.0,148.0,148.0
2580.0,17,4,344,2,150,0.0,75.0,75.0,2,194,0.0,103.0,97.0
114378258.0,6,210,23646,105,16494,1097714.6346153845,284.0,157.0857142857143,105,7152,1097720.173076923,140.0,68.11428571428571
33841.0,6,14,4740,7,653,4235.833333333333,249.0,93.28571428571428,7,4087,4599.666666666667,1514.0,583.8571428571429
177102.0,6,3,337,2,214,0.0,160.0,107.0,1,123,0.0,123.0,123.0
5625635.0,6,5,336,2,134,0.0,68.0,67.0,3,202,1513631.5,70.0,67.33333333333333
319946.0,17,4,1400,4,1400,106648.66666666669,350.0,350.0,0,0,0.0,0.0,0.0
155130.0,6,3,337,2,214,0.0,160.0,107.0,1,123,0.0,123.0,123.0
90256714.0,6,13,2036,8,1016,12893816.285714284,188.0,127.0,5,1020,22522979.0,204.0,204.0
6462.0,17,4,823,2,163,0.0,89.0,81.5,2,660,0.0,443.0,330.0
9008188.0,17,2,160,2,160,0.0,80.0,80.0,0,0,0.0,0.0,0.0
37025.0,6,10,2032,5,524,9039.5,252.0,104.8,5,1508,8381.75,1236.0,301.6
315222.0,17,4,1400,4,1400,105074.0,350.0,350.0,0,0,0.0,0.0,0.0
120265445.0,6,202,22992,101,6962,1195467.38,140.0,68.93069306930693,101,16030,1194291.54,300.0,158.7128712871287
95451874.0,6,40,2640,20,1320,5023782.842105263,66.0,66.0,20,1320,5007236.842105263,66.0,66.0
99609.0,17,2,762,2,762,0.0,381.0,381.0,0,0,0.0,0.0,0.0
233508.0,6,3,337,2,214,0.0,160.0,107.0,1,123,0.0,123.0,123.0
19575.0,6,10,2032,5,524,3495.25,252.0,104.8,5,1508,4541.5,1236.0,301.6
2300.0,17,4,344,2,150,0.0,75.0,75.0,2,194,0.0,103.0,97.0
33839.0,6,10,2032,5,524,6660.75,252.0,104.8,5,1508,7885.75,1236.0,301.6
0.0,17,1,381,1,381,0.0,381.0,381.0,0,0,0.0,0.0,0.0
2310.0,17,4,344,2,150,0.0,75.0,75.0,2,194,0.0,103.0,97.0
305717.0,6,6,412,4,272,101905.66666666669,74.0,68.0,2,140,0.0,74.0,70.0
174413.0,6,3,337,2,214,0.0,160.0,107.0,1,123,0.0,123.0,123.0
992702.0,6,12,1447,6,816,197764.2,291.0,136.0,6,631,197438.0,293.0,105.16666666666669
2372.0,17,4,344,2,150,0.0,75.0,75.0,2,194,0.0,103.0,97.0
74161857.0,6,9,842,9,842,9270232.125,97.0,93.55555555555556,0,0,0.0,0.0,0.0
146956.0,6,3,373,2,238,0.0,172.0,119.0,1,135,0.0,135.0,135.0
15326.0,6,10,2032,5,524,3605.0,252.0,104.8,5,1508,3371.0,1236.0,301.6
46969.0,6,10,2032,5,524,11477.75,252.0,104.8,5,1508,10856.0,1236.0,301.6
19743.0,6,14,4740,7,653,3096.833333333333,249.0,93.28571428571428,7,4087,3151.5,1514.0,583.8571428571429
98619236.0,6,30,2106,15,1089,7029579.857142857,123.0,72.6,15,1017,7029577.071428572,123.0,67.8
17867.0,6,14,4740,7,653,2755.5,249.0,93.28571428571428,7,4087,2845.1666666666665,1514.0,583.8571428571429
135128937.0,17,6,1146,6,1146,27025787.4,191.0,191.0,0,0,0.0,0.0,0.0
121345.0,6,3,337,2,214,0.0,160.0,107.0,1,123,0.0,123.0,123.0
919.0,17,5,550,5,550,229.75,110.0,110.0,0,0,0.0,0.0,0.0
2410.0,17,4,344,2,150,0.0,75.0,75.0,2,194,0.0,103.0,97.0
2433.0,17,4,344,2,150,0.0,75.0,75.0,2,194,0.0,103.0,97.0
813575.0,6,6,758,3,410,294527.5,172.0,136.66666666666666,3,348,287009.5,135.0,116.0
100004513.0,17,12,778,6,389,20000902.6,174.0,64.83333333333333,6,389,16000135.0,174.0,64.83333333333333
104502764.0,17,14,1126,7,563,17417127.333333332,174.0,80.42857142857143,7,563,17388806.333333332,174.0,80.42857142857143
2476.0,17,4,344,2,150,0.0,75.0,75.0,2,194,0.0,103.0,97.0
119676.0,17,2,180,1,70,0.0,70.0,70.0,1,110,0.0,110.0,110.0
2794807.0,6,3,1604,2,851,0.0,785.0,425.5,1,753,0.0,753.0,753.0
315421.0,17,4,1400,4,1400,105140.33333333331,350.0,350.0,0,0,0.0,0.0,0.0
101871.0,17,2,762,2,762,0.0,381.0,381.0,0,0,0.0,0.0,0.0
206743.0,6,3,426,2,280,0.0,214.0,140.0,1,146,0.0,146.0,146.0
22156.0,17,2,180,1,90,0.0,90.0,90.0,1,90,0.0,90.0,90.0
135131504.0,17,6,1146,6,1146,27026300.8,191.0,191.0,0,0,0.0,0.0,0.0
12497.0,6,10,2032,5,524,2227.25,252.0,104.8,5,1508,2836.25,1236.0,301.6
123250531.0,6,49,3234,25,1650,5135438.791666667,66.0,66.0,24,1584,5166543.782608695,66.0,66.0
90300685.0,6,17,1287,9,691,11281169.75,95.0,76.77777777777777,8,596,12898613.285714284,95.0,74.5
47605871.0,6,7,2047,3,960,22571690.0,826.0,320.0,4,1087,14944576.0,885.0,271.75
12200.0,6,10,1067,5,536,2848.0,264.0,107.2,5,531,2166.75,259.0,106.2
72649.0,6,14,4740,7,653,11060.833333333334,249.0,93.28571428571428,7,4087,11594.666666666666,1514.0,583.8571428571429
102512.0,17,2,286,2,286,0.0,143.0,143.0,0,0,0.0,0.0,0.0
103299955.0,17,14,864,7,432,17167647.666666668,174.0,61.71428571428572,7,432,17166834.0,174.0,61.71428571428572
4237.0,17,2,598,1,72,0.0,72.0,72.0,1,526,0.0,526.0,526.0
310316.0,17,4,1400,4,1400,103438.66666666669,350.0,350.0,0,0,0.0,0.0,0.0
9348.0,17,2,571,1,86,0.0,86.0,86.0,1,485,0.0,485.0,485.0
38907.0,6,14,4740,7,653,5697.333333333333,249.0,93.28571428571428,7,4087,6347.0,1514.0,583.8571428571429
90310330.0,6,21,1585,11,799,9025749.2,95.0,72.63636363636364,10,786,10033817.333333334,95.0,78.6
48024.0,6,10,2032,5,524,11338.0,252.0,104.8,5,1508,10293.25,1236.0,301.6
108105798.0,17,5,955,5,955,27026449.5,191.0,191.0,0,0,0.0,0.0,0.0
977711.0,6,13,1428,7,797,162564.66666666666,253.0,113.85714285714286,6,631,193423.4,293.0,105.16666666666669
345.0,17,2,160,1,80,0.0,80.0,80.0,1,80,0.0,80.0,80.0
2607152.0,6,2,132,1,66,0.0,66.0,66.0,1,66,0.0,66.0,66.0
46529.0,6,14,4740,7,653,7289.833333333333,249.0,93.28571428571428,7,4087,7013.5,1514.0,583.8571428571429
25598.0,6,10,1066,5,490,4337.5,218.0,98.0,5,576,4374.5,304.0,115.2
422675.0,6,3,1604,2,851,0.0,785.0,425.5,1,753,0.0,753.0,753.0
114635810.0,6,30,2122,15,1017,8188272.142857143,123.0,67.8,15,1105,7460470.142857143,139.0,73.66666666666667
53931.0,6,13,1394,7,797,8988.5,253.0,113.85714285714286,6,597,9247.6,259.0,99.5
21840002.0,6,9,589,5,342,5460000.5,95.0,68.4,4,247,7198806.333333333,85.0,61.75
319843.0,17,4,1400,4,1400,106614.33333333331,350.0,350.0,0,0,0.0,0.0,0.0
232846.0,6,3,337,2,214,0.0,160.0,107.0,1,123,0.0,123.0,123.0
90256869.0,6,13,2036,8,1016,12893838.42857143,188.0,127.0,5,1020,22523130.5,204.0,204.0
63743.99999999999,6,14,4740,7,653,9666.333333333334,249.0,93.28571428571428,7,4087,10217.333333333334,1514.0,583.8571428571429
12993.0,6,11,1132,6,556,2536.0,218.0,92.66666666666669,5,576,3034.0,304.0,115.2
315101.0,17,4,1400,4,1400,105033.66666666669,350.0,350.0,0,0,0.0,0.0,0.0
135987.0,6,13,1386,7,789,22664.5,253.0,112.71428571428572,6,597,25769.2,259.0,99.5
120006256.0,6,16,1192,8,596,17143750.85714286,95.0,74.5,8,596,17106095.85714286,95.0,74.5
414416.0,6,10,1221,6,636,82883.2,298.0,106.0,4,585,137074.0,379.0,146.25
9705.0,17,2,582,1,83,0.0,83.0,83.0,1,499,0.0,499.0,499.0
875755.0,6,9,1268,6,797,175151.0,459.0,132.83333333333334,3,471,299985.5,331.0,157.0
742.0,17,4,438,2,148,0.0,74.0,74.0,2,290,0.0,147.0,145.0
1178788.0,6,13,3020,8,2392,168398.2857142857,1514.0,299.0,5,628,225790.25,331.0,125.6
1798639.0,6,4,492,2,280,0.0,214.0,140.0,2,212,0.0,146.0,106.0
336535.0,6,6,412,4,272,112178.33333333331,74.0,68.0,2,140,0.0,74.0,70.0
119957590.0,6,24,1829,12,894,10883385.181818182,95.0,74.5,12,935,10886535.545454543,95.0,77.91666666666667
1052493.0,6,13,1386,7,789,175415.5,253.0,112.71428571428572,6,597,209180.6,259.0,99.5
676.0,17,4,438,2,148,0.0,74.0,74.0,2,290,0.0,147.0,145.0
585551.0,6,3,1604,1,753,0.0,753.0,753.0,2,851,0.0,785.0,425.5
4492451.0,6,155,122652,86,113798,52852.36470588236,1510.0,1323.2325581395348,69,8854,61510.41176470588,1510.0,128.31884057971016
242370.0,6,3,337,2,214,0.0,160.0,107.0,1,123,0.0,123.0,123.0
339.0,17,2,174,1,79,0.0,79.0,79.0,1,95,0.0,95.0,95.0
2393.0,17,4,344,2,150,0.0,75.0,75.0,2,194,0.0,103.0,97.0
143949.0,17,2,180,1,90,0.0,90.0,90.0,1,90,0.0,90.0,90.0
41465.0,6,14,4740,7,653,6443.166666666667,249.0,93.28571428571428,7,4087,6633.166666666667,1514.0,583.8571428571429
33433.0,6,10,2032,5,524,6794.5,252.0,104.8,5,1508,7650.25,1236.0,301.6
1419863.0,17,16,1120,16,1120,94657.53333333334,70.0,70.0,0,0,0.0,0.0,0.0
5618533.0,17,4,692,2,156,0.0,78.0,78.0,2,536,0.0,268.0,268.0
13633247.0,6,20,1648,10,1016,1480470.0,315.0,101.6,10,632,1480445.0,78.0,63.2
2383.0,17,4,344,2,150,0.0,75.0,75.0,2,194,0.0,103.0,97.0
216618.0,17,2,180,1,90,0.0,90.0,90.0,1,90,0.0,90.0,90.0
103388.0,17,2,286,2,286,0.0,143.0,143.0,0,0,0.0,0.0,0.0
698095.0,6,10,1124,6,608,139619.0,222.0,101.33333333333331,4,516,148055.33333333334,206.0,129.0
97722.0,6,14,4740,7,653,16166.833333333334,249.0,93.28571428571428,7,4087,14510.833333333334,1514.0,583.8571428571429
266076.0,6,10,1221,6,636,53215.2,298.0,106.0,4,585,83270.33333333333,379.0,146.25
139855.0,6,2,132,1,66,0.0,66.0,66.0,1,66,0.0,66.0,66.0
144017.0,17,2,180,1,90,0.0,90.0,90.0,1,90,0.0,90.0,90.0
241169.0,6,3,373,2,238,0.0,172.0,119.0,1,135,0.0,135.0,135.0
90274493.0,6,16,2368,9,1204,11284311.625,188.0,133.77777777777777,7,1164,15018796.833333334,204.0,166.28571428571428
300907.0,6,6,412,4,272,100302.33333333331,74.0,68.0,2,140,0.0,74.0,70.0
119612406.0,6,220,24868,110,17312,1095387.8348623854,284.0,157.38181818181818,110,7556,1095387.1559633028,140.0,68.69090909090909
27999.0,6,14,4740,7,653,3867.6666666666665,249.0,93.28571428571428,7,4087,4262.333333333333,1514.0,583.8571428571429
186038.0,17,2,180,1,90,0.0,90.0,90.0,1,90,0.0,90.0,90.0
1997.0,17,4,344,2,150,0.0,75.0,75.0,2,194,0.0,103.0,97.0
406484.0,17,2,359,1,75,0.0,75.0,75.0,1,284,0.0,284.0,284.0
255528.0,6,3,337,2,214,0.0,160.0,107.0,1,123,0.0,123.0,123.0
14646275.0,6,20,1648,10,1016,1592442.7777777778,315.0,101.6,10,632,1592416.3333333333,78.0,63.2
130824.0,6,2,132,1,66,0.0,66.0,66.0,1,66,0.0,66.0,66.0
2358.0,17,4,344,2,150,0.0,75.0,75.0,2,194,0.0,103.0,97.0
146153.0,6,3,337,2,214,0.0,160.0,107.0,1,123,0.0,123.0,123.0
149965412.0,17,36,17126,36,17126,4284726.057142857,501.0,475.72222222222223,0,0,0.0,0.0,0.0
254313.0,6,3,337,2,214,0.0,160.0,107.0,1,123,0.0,123.0,123.0
303188.0,6,3,202,2,128,0.0,74.0,64.0,1,74,0.0,74.0,74.0
847279.0,6,9,1096,6,625,169455.8,287.0,104.16666666666669,3,471,287365.0,331.0,157.0
856048.0,6,9,1267,6,796,171209.6,458.0,132.66666666666666,3,471,290461.5,331.0,157.0
26973.0,6,10,2032,5,524,6144.25,252.0,104.8,5,1508,5688.25,1236.0,301.6
205692.0,17,2,180,1,90,0.0,90.0,90.0,1,90,0.0,90.0,90.0
104941.0,17,2,762,2,762,0.0,381.0,381.0,0,0,0.0,0.0,0.0
304.0,17,2,164,1,82,0.0,82.0,82.0,1,82,0.0,82.0,82.0
20756.0,6,10,2032,5,524,4861.25,252.0,104.8,5,1508,4537.75,1236.0,301.6
18458.0,6,14,4740,7,653,2849.1666666666665,249.0,93.28571428571428,7,4087,2884.5,1514.0,583.8571428571429
105283117.0,17,14,864,7,432,17501121.166666668,174.0,61.71428571428572,7,432,17500160.333333332,174.0,61.71428571428572
2594914.0,6,2,132,1,66,0.0,66.0,66.0,1,66,0.0,66.0,66.0
106984.0,17,2,286,2,286,0.0,143.0,143.0,0,0,0.0,0.0,0.0
924.0,17,2,166,1,75,0.0,75.0,75.0,1,91,0.0,91.0,91.0
35633.0,6,10,2032,5,524,7516.0,252.0,104.8,5,1508,7610.5,1236.0,301.6
317836.0,17,4,1400,4,1400,105945.33333333331,350.0,350.0,0,0,0.0,0.0,0.0
245346.0,6,3,337,2,214,0.0,160.0,107.0,1,123,0.0,123.0,123.0
36197.0,6,2,145,2,145,0.0,91.0,72.5,0,0,0.0,0.0,0.0
123250623.0,6,49,3234,25,1650,5135442.625,66.0,66.0,24,1584,5061856.565217392,66.0,66.0
10421261.0,6,7,478,4,272,3428069.0,74.0,68.0,3,206,5141971.5,74.0,68.66666666666667
153440.0,17,2,180,1,90,0.0,90.0,90.0,1,90,0.0,90.0,90.0
320476.0,6,6,412,4,272,106825.33333333331,74.0,68.0,2,140,0.0,74.0,70.0
112249153.0,6,203,22968,102,6954,1111377.7524752475,140.0,68.17647058823529,101,16014,1112213.78,284.0,158.55445544554456
90260163.0,6,13,2036,8,1016,12894309.0,188.0,127.0,5,1020,22523675.0,204.0,204.0
15521.0,6,10,1065,5,534,3460.25,262.0,106.8,5,531,3087.75,259.0,106.2
110971412.0,6,34,2482,17,1288,6922231.375,139.0,75.76470588235294,17,1194,6922230.0625,123.0,70.23529411764706
135167425.0,17,6,1146,6,1146,27033485.0,191.0,191.0,0,0,0.0,0.0,0.0
197459.0,17,2,180,1,90,0.0,90.0,90.0,1,90,0.0,90.0,90.0
0.0,6,1,66,1,66,0.0,66.0,66.0,0,0,0.0,0.0,0.0
2032.0,17,4,344,2,150,0.0,75.0,75.0,2,194,0.0,103.0,97.0
62990.00000000001,6,14,4740,7,653,10372.833333333334,249.0,93.28571428571428,7,4087,8975.166666666666,1514.0,583.8571428571429
241127.0,6,3,337,2,214,0.0,160.0,107.0,1,123,0.0,123.0,123.0
1173459.0,6,11,1134,6,558,234691.8,220.0,93.0,5,576,292689.0,304.0,115.2
864.0,17,4,438,2,148,0.0,74.0,74.0,2,290,0.0,147.0,145.0
3007365.0,6,12,2172,7,664,501116.3333333333,252.0,94.85714285714286,5,1508,1742.75,1236.0,301.6
22987.0,6,14,4740,7,653,2652.6666666666665,249.0,93.28571428571428,7,4087,3640.1666666666665,1514.0,583.8571428571429
830.0,17,4,438,2,148,0.0,74.0,74.0,2,290,0.0,147.0,145.0
207802.0,17,2,762,2,762,0.0,381.0,381.0,0,0,0.0,0.0,0.0
153384.0,17,2,180,1,90,0.0,90.0,90.0,1,90,0.0,90.0,90.0
207271.0,6,3,426,2,280,0.0,214.0,140.0,1,146,0.0,146.0,146.0
24995.0,6,14,4740,7,653,4044.1666666666665,249.0,93.28571428571428,7,4087,4030.1666666666665,1514.0,583.8571428571429
56578.0,6,14,4740,7,653,9296.0,249.0,93.28571428571428,7,4087,9076.333333333334,1514.0,583.8571428571429
137001598.0,17,17,1255,9,649,17125199.75,174.0,72.11111111111111,8,606,16693027.0,174.0,75.75
0.0,6,1,160,1,160,0.0,160.0,160.0,0,0,0.0,0.0,0.0
317208.0,17,4,1400,4,1400,105736.0,350.0,350.0,0,0,0.0,0.0,0.0
0.0,17,1,55,1,55,0.0,55.0,55.0,0,0,0.0,0.0,0.0
34487.0,6,14,4740,7,653,4164.0,249.0,93.28571428571428,7,4087,5616.666666666667,1514.0,583.8571428571429
108111881.0,17,5,955,5,955,27027970.25,191.0,191.0,0,0,0.0,0.0,0.0
247154.0,17,2,180,1,90,0.0,90.0,90.0,1,90,0.0,90.0,90.0
104623.0,17,2,762,2,762,0.0,381.0,381.0,0,0,0.0,0.0,0.0
205829.0,17,2,180,1,90,0.0,90.0,90.0,1,90,0.0,90.0,90.0
258405.0,6,3,337,2,214,0.0,160.0,107.0,1,123,0.0,123.0,123.0
209370.0,17,2,180,1,90,0.0,90.0,90.0,1,90,0.0,90.0,90.0
32680694.000000004,6,5,336,2,134,0.0,68.0,67.0,3,202,15047815.5,70.0,67.33333333333333
153467.0,17,2,180,1,90,0.0,90.0,90.0,1,90,0.0,90.0,90.0
90258130.0,6,13,2036,8,1016,12894018.57142857,188.0,127.0,5,1020,22523213.5,204.0,204.0
4406.0,17,2,602,1,72,0.0,72.0,72.0,1,530,0.0,530.0,530.0
440629.0,6,3,1604,2,851,0.0,785.0,425.5,1,753,0.0,753.0,753.0
601890.0,17,2,473,1,78,0.0,78.0,78.0,1,395,0.0,395.0,395.0
86817.0,6,13,1479,7,882,14469.5,291.0,126.0,6,597,16020.6,259.0,99.5
37445.0,6,14,4740,7,653,5827.666666666667,249.0,93.28571428571428,7,4087,5157.0,1514.0,583.8571428571429
109844691.0,6,32,2236,16,1165,7308577.066666666,139.0,72.8125,16,1071,7308576.6,123.0,66.9375
1156188.0,6,13,3010,8,2382,165169.7142857143,1514.0,297.75,5,628,220927.25,331.0,125.6
110717842.0,6,32,2236,16,1165,7366796.4,139.0,72.8125,16,1071,7366799.266666667,123.0,66.9375
108240604.0,6,32,2220,16,1149,7201659.0,123.0,71.8125,16,1071,7201659.133333334,123.0,66.9375
122445784.0,17,14,864,7,432,17160108.333333332,174.0,61.71428571428572,7,432,17168118.0,174.0,61.71428571428572
299824.0,6,6,412,4,272,99941.33333333331,74.0,68.0,2,140,0.0,74.0,70.0
2390.0,17,4,344,2,150,0.0,75.0,75.0,2,194,0.0,103.0,97.0
272198.0,6,3,337,2,214,0.0,160.0,107.0,1,123,0.0,123.0,123.0
228421.0,17,2,180,1,90,0.0,90.0,90.0,1,90,0.0,90.0,90.0
315337.0,17,4,1400,4,1400,105112.33333333331,350.0,350.0,0,0,0.0,0.0,0.0
148035.0,17,2,180,1,90,0.0,90.0,90.0,1,90,0.0,90.0,90.0
90258215.0,6,12,1832,8,1016,12894030.714285716,188.0,127.0,4,816,30026084.33333333,204.0,204.0
27499984.0,17,5,1710,5,1710,6874996.0,342.0,342.0,0,0,0.0,0.0,0.0
2254.0,17,4,344,2,150,0.0,75.0,75.0,2,194,0.0,103.0,97.0
114572997.0,6,48,3168,24,1584,4981434.652173913,66.0,66.0,24,1584,4968334.782608695,66.0,66.0
135148.0,6,12,1362,6,731,26184.0,253.0,121.83333333333331,6,631,26403.2,293.0,105.16666666666669
90258303.0,6,12,1832,8,1016,12894043.285714284,188.0,127.0,4,816,30030991.0,204.0,204.0
27881.0,6,14,4740,7,653,4358.166666666667,249.0,93.28571428571428,7,4087,4503.833333333333,1514.0,583.8571428571429
115299879.0,6,629,114738,317,93702,364873.0348101266,1514.0,295.58990536277605,312,21036,367422.1768488746,214.0,67.42307692307692
39419.0,6,10,2032,5,524,7369.25,252.0,104.8,5,1508,7782.25,1236.0,301.6
2414.0,17,4,344,2,150,0.0,75.0,75.0,2,194,0.0,103.0,97.0
315541.0,17,4,1400,4,1400,105180.33333333331,350.0,350.0,0,0,0.0,0.0,0.0
2596084.0,6,2,132,1,66,0.0,66.0,66.0,1,66,0.0,66.0,66.0
92244769.0,17,16,5472,16,5472,6149651.266666667,342.0,342.0,0,0,0.0,0.0,0.0
181256.0,17,2,180,1,90,0.0,90.0,90.0,1,90,0.0,90.0,90.0
24016285.0,17,3,1034,2,684,0.0,342.0,342.0,1,350,0.0,350.0,350.0
108104128.0,17,5,955,5,955,27026032.0,191.0,191.0,0,0,0.0,0.0,0.0
107685.0,17,6,1230,3,234,53661.0,78.0,78.0,3,996,53612.5,332.0,332.0
5624335.0,6,5,336,2,134,0.0,68.0,67.0,3,202,1522469.5,70.0,67.33333333333333
1036362.0,6,11,1134,6,558,207272.4,220.0,93.0,5,576,258039.75,304.0,115.2
108106123.0,17,5,955,5,955,27026530.75,191.0,191.0,0,0,0.0,0.0,0.0
197762.0,17,2,180,1,90,0.0,90.0,90.0,1,90,0.0,90.0,90.0
153469.0,17,2,180,1,90,0.0,90.0,90.0,1,90,0.0,90.0,90.0
6750.0,17,2,582,1,83,0.0,83.0,83.0,1,499,0.0,499.0,499.0
247772.0,17,4,1400,4,1400,82590.66666666667,350.0,350.0,0,0,0.0,0.0,0.0
140528.0,6,2,132,1,66,0.0,66.0,66.0,1,66,0.0,66.0,66.0
93458.0,6,14,4740,7,653,15450.166666666666,249.0,93.28571428571428,7,4087,15222.833333333334,1514.0,583.8571428571429
91737404.0,6,25,1924,14,1084,7052789.230769231,95.0,77.42857142857143,11,840,9144465.0,95.0,76.36363636363636
92261738.0,17,16,5472,16,5472,6150782.533333333,342.0,342.0,0,0,0.0,0.0,0.0
135127445.0,17,6,1146,6,1146,27025489.0,191.0,191.0,0,0,0.0,0.0,0.0
339.0,17,2,267,1,83,0.0,83.0,83.0,1,184,0.0,184.0,184.0
101842.0,17,2,286,2,286,0.0,143.0,143.0,0,0,0.0,0.0,0.0
303673.0,6,2,132,1,66,0.0,66.0,66.0,1,66,0.0,66.0,66.0
5616219.0,6,5,336,2,134,0.0,68.0,67.0,3,202,1420513.5,70.0,67.33333333333333
87661.0,6,14,4740,7,653,14242.5,249.0,93.28571428571428,7,4087,14431.0,1514.0,583.8571428571429
31903.0,6,14,4740,7,653,5190.666666666667,249.0,93.28571428571428,7,4087,5175.5,1514.0,583.8571428571429
135115565.0,17,6,1206,6,1206,27023113.0,201.0,201.0,0,0,0.0,0.0,0.0
2791882.0,6,2,132,1,66,0.0,66.0,66.0,1,66,0.0,66.0,66.0
221022.0,6,10,1221,6,636,44204.4,298.0,106.0,4,585,72692.66666666667,379.0,146.25
153440.0,17,2,180,1,90,0.0,90.0,90.0,1,90,0.0,90.0,90.0
33791.0,6,10,2032,5,524,8230.5,252.0,104.8,5,1508,8087.25,1236.0,301.6
207877.0,17,4,1400,4,1400,69292.33333333333,350.0,350.0,0,0,0.0,0.0,0.0
2803458.0,6,2,132,1,66,0.0,66.0,66.0,1,66,0.0,66.0,66.0
90027186.0,17,28,13364,28,13364,3334340.222222222,501.0,477.2857142857143,0,0,0.0,0.0,0.0
2061.0,17,4,344,2,150,0.0,75.0,75.0,2,194,0.0,103.0,97.0
0.0,6,1,66,1,66,0.0,66.0,66.0,0,0,0.0,0.0,0.0
296203.0,17,2,180,1,90,0.0,90.0,90.0,1,90,0.0,90.0,90.0
108104985.0,17,5,955,5,955,27026246.25,191.0,191.0,0,0,0.0,0.0,0.0
64268.00000000001,6,14,4740,7,653,9858.5,249.0,93.28571428571428,7,4087,8777.666666666666,1514.0,583.8571428571429
336.0,17,2,166,1,75,0.0,75.0,75.0,1,91,0.0,91.0,91.0
90531485.0,6,13,2036,8,1016,12933069.285714284,188.0,127.0,5,1020,22592594.75,204.0,204.0
17483.0,6,10,1067,5,536,3936.75,264.0,107.2,5,531,4002.5,259.0,106.2
307183.0,6,6,412,4,272,102394.33333333331,74.0,68.0,2,140,0.0,74.0,70.0
234263.0,6,3,337,2,214,0.0,160.0,107.0,1,123,0.0,123.0,123.0
62969.0,6,14,4740,7,653,10083.833333333334,249.0,93.28571428571428,7,4087,9787.833333333334,1514.0,583.8571428571429
108541835.0,6,32,2368,16,1140,7236122.333333333,123.0,71.25,16,1228,6708985.2,139.0,76.75
4263.0,17,2,602,1,72,0.0,72.0,72.0,1,530,0.0,530.0,530.0
322145.0,17,4,1400,4,1400,107381.66666666669,350.0,350.0,0,0,0.0,0.0,0.0
5642375.0,6,5,336,2,134,0.0,68.0,67.0,3,202,1533973.5,70.0,67.33333333333333
140805.0,6,2,132,1,66,0.0,66.0,66.0,1,66,0.0,66.0,66.0
41464.0,6,14,4740,7,653,6743.166666666667,249.0,93.28571428571428,7,4087,6771.5,1514.0,583.8571428571429
708.0,17,2,762,2,762,0.0,381.0,381.0,0,0,0.0,0.0,0.0
305248.0,6,6,412,4,272,101749.33333333331,74.0,68.0,2,140,0.0,74.0,70.0
2162050.0,6,19,6869,10,1501,240227.7777777777,408.0,150.1,9,5368,226790.625,1514.0,596.4444444444445
1173113.0,6,13,3020,8,2392,167587.57142857142,1514.0,299.0,5,628,224381.25,331.0,125.6
1032039.0,6,11,1134,6,558,206407.8,220.0,93.0,5,576,256550.75,304.0,115.2
143810.0,17,2,180,1,90,0.0,90.0,90.0,1,90,0.0,90.0,90.0
120301207.0,17,14,864,7,432,16833509.666666668,174.0,61.71428571428572,7,432,16835029.166666668,174.0,61.71428571428572
1716850.0,6,22,6443,11,1463,171685.0,357.0,133.0,11,4980,140506.5,1510.0,452.7272727272728
214907.0,6,10,1221,6,636,42981.4,298.0,106.0,4,585,70316.66666666667,379.0,146.25
16807.0,6,10,2032,5,524,3206.25,252.0,104.8,5,1508,3363.0,1236.0,301.6
14642407.0,6,20,1607,10,975,1592455.2222222222,315.0,97.5,10,632,1592429.5555555555,78.0,63.2
332334.0,17,4,704,2,148,0.0,74.0,74.0,2,556,0.0,280.0,278.0
4967796.0,17,4,849,2,166,0.0,83.0,83.0,2,683,0.0,499.0,341.5
119155158.0,17,16,1474,8,737,16999149.85714286,174.0,92.125,8,737,16999172.714285713,174.0,92.125
51723.0,6,11,1131,6,600,10092.4,262.0,100.0,5,531,7380.5,259.0,106.2
118500602.0,6,300,35632,150,25510,793861.6644295302,336.0,170.06666666666666,150,10122,793862.2147651006,140.0,67.48
4392.0,17,4,344,2,150,0.0,75.0,75.0,2,194,0.0,103.0,97.0
104000961.0,17,13,821,7,432,17333493.5,174.0,61.71428571428572,6,389,16801082.8,174.0,64.83333333333333
30585.0,6,14,4740,7,653,4228.333333333333,249.0,93.28571428571428,7,4087,4869.166666666667,1514.0,583.8571428571429
2301.0,17,4,344,2,150,0.0,75.0,75.0,2,194,0.0,103.0,97.0
708.0,17,4,438,2,148,0.0,74.0,74.0,2,290,0.0,147.0,145.0
21122222.0,17,3,1034,2,684,0.0,342.0,342.0,1,350,0.0,350.0,350.0
58868.0,6,14,4740,7,653,9497.666666666666,249.0,93.28571428571428,7,4087,9241.333333333334,1514.0,583.8571428571429
144033.0,17,2,180,1,90,0.0,90.0,90.0,1,90,0.0,90.0,90.0
102893.0,17,2,286,2,286,0.0,143.0,143.0,0,0,0.0,0.0,0.0
22432.0,6,10,2032,5,524,4609.75,252.0,104.8,5,1508,4657.25,1236.0,301.6
205835.0,17,2,180,1,90,0.0,90.0,90.0,1,90,0.0,90.0,90.0
2284.0,17,4,344,2,150,0.0,75.0,75.0,2,194,0.0,103.0,97.0
28492.0,6,14,4740,7,653,4637.333333333333,249.0,93.28571428571428,7,4087,4021.3333333333335,1514.0,583.8571428571429
122842.0,6,3,337,2,214,0.0,160.0,107.0,1,123,0.0,123.0,123.0
90252628.0,6,13,2036,8,1016,12893232.57142857,188.0,127.0,5,1020,22520192.0,204.0,204.0
305579.0,6,6,412,4,272,101859.66666666669,74.0,68.0,2,140,0.0,74.0,70.0
122504398.0,17,15,1038,8,606,17500628.285714287,174.0,75.75,7,432,18000164.0,174.0,61.71428571428572
298866.0,6,6,412,4,272,99622.0,74.0,68.0,2,140,0.0,74.0,70.0
120032088.0,17,28,13364,28,13364,4445632.888888889,501.0,477.2857142857143,0,0,0.0,0.0,0.0
322.0,17,2,174,1,79,0.0,79.0,79.0,1,95,0.0,95.0,95.0
12475.0,6,13,1459,7,862,2032.0,271.0,123.14285714285714,6,597,2235.6,259.0,99.5
119522565.0,17,35,16705,35,16705,3515369.5588235296,501.0,477.2857142857143,0,0,0.0,0.0,0.0
21905.0,6,10,2032,5,524,5082.75,252.0,104.8,5,1508,5135.0,1236.0,301.6
2326.0,17,2,664,1,322,0.0,322.0,322.0,1,342,0.0,342.0,342.0
22899.0,6,11,2098,6,590,4195.0,252.0,98.33333333333331,5,1508,5475.25,1236.0,301.6
235597.0,6,3,337,2,214,0.0,160.0,107.0,1,123,0.0,123.0,123.0
318312.0,17,4,1400,4,1400,106104.0,350.0,350.0,0,0,0.0,0.0,0.0
1023088.0,6,11,1134,6,558,204617.6,220.0,93.0,5,576,255204.5,304.0,115.2
310647.0,6,6,412,4,272,103549.0,74.0,68.0,2,140,0.0,74.0,70.0
56951.0,6,14,4740,7,653,8694.5,249.0,93.28571428571428,7,4087,9099.833333333334,1514.0,583.8571428571429
113895299.0,6,48,3168,24,1584,4951969.521739131,66.0,66.0,24,1584,4938295.304347826,66.0,66.0
206071.0,6,3,426,2,280,0.0,214.0,140.0,1,146,0.0,146.0,146.0
211535.0,6,3,426,2,280,0.0,214.0,140.0,1,146,0.0,146.0,146.0
2977302.0,6,155,123012,87,114222,34619.79069767442,1510.0,1312.896551724138,68,8790,39849.49253731343,1510.0,129.26470588235293
135131988.0,17,6,1206,6,1206,27026397.6,201.0,201.0,0,0,0.0,0.0,0.0
43983.0,6,10,2032,5,524,10629.25,252.0,104.8,5,1508,10582.0,1236.0,301.6
135137464.0,17,6,1146,6,1146,27027492.8,191.0,191.0,0,0,0.0,0.0,0.0
135130438.0,17,6,1146,6,1146,27026087.6,191.0,191.0,0,0,0.0,0.0,0.0
90255582.0,6,12,1832,8,1016,12893654.57142857,188.0,127.0,4,816,30030884.666666668,204.0,204.0
90756749.0,6,21,1747,10,745,10084083.222222222,95.0,74.5,11,1002,9046981.7,257.0,91.0909090909091
10470058.0,6,7,478,4,272,3444426.0,74.0,68.0,3,206,5166552.5,74.0,68.66666666666667
167277.0,17,2,180,1,90,0.0,90.0,90.0,1,90,0.0,90.0,90.0
249866.0,6,10,1221,6,636,49973.2,298.0,106.0,4,585,77190.0,379.0,146.25
135125162.0,17,6,1206,6,1206,27025032.4,201.0,201.0,0,0,0.0,0.0,0.0
2394.0,17,4,344,2,150,0.0,75.0,75.0,2,194,0.0,103.0,97.0
326.0,17,2,166,1,75,0.0,75.0,75.0,1,91,0.0,91.0,91.0
120380869.0,6,241,27260,121,19044,1003173.9083333332,284.0,157.38842975206612,120,8216,1002901.4453781513,140.0,68.46666666666667
27781.0,6,14,4740,7,653,4235.5,249.0,93.28571428571428,7,4087,4447.0,1514.0,583.8571428571429
297093.0,6,6,412,4,272,99031.0,74.0,68.0,2,140,0.0,74.0,70.0
38820.0,6,10,2032,5,524,9458.25,252.0,104.8,5,1508,9042.25,1236.0,301.6
245527.0,6,3,337,2,214,0.0,160.0,107.0,1,123,0.0,123.0,123.0
104123.0,17,2,286,2,286,0.0,143.0,143.0,0,0,0.0,0.0,0.0
113254714.0,6,46,3036,23,1518,5135436.954545454,66.0,66.0,23,1518,5135434.2727272725,66.0,66.0
348.0,17,2,160,1,80,0.0,80.0,80.0,1,80,0.0,80.0,80.0
107092595.0,17,14,1126,7,563,17335312.166666668,174.0,80.42857142857143,7,563,17822263.833333332,174.0,80.42857142857143
10470045.0,6,7,478,4,272,3444766.6666666665,74.0,68.0,3,206,5167041.0,74.0,68.66666666666667
258444.0,6,10,1221,6,636,51688.8,298.0,106.0,4,585,80601.66666666667,379.0,146.25
90267703.0,6,14,1964,8,1016,12895386.142857144,188.0,127.0,6,948,18013778.4,204.0,158.0
311888.0,17,4,1400,4,1400,103962.66666666669,350.0,350.0,0,0,0.0,0.0,0.0
97448.0,17,2,286,2,286,0.0,143.0,143.0,0,0,0.0,0.0,0.0
690.0,17,4,438,2,148,0.0,74.0,74.0,2,290,0.0,147.0,145.0
5836090.0,6,5,336,2,134,0.0,68.0,67.0,3,202,1526512.0,70.0,67.33333333333333
120122763.0,6,15,2444,7,1428,20020460.5,204.0,204.0,8,1016,17098112.57142857,188.0,127.0
2089.0,17,4,344,2,150,0.0,75.0,75.0,2,194,0.0,103.0,97.0
1028113.0,6,11,1134,6,558,205622.6,220.0,93.0,5,576,256261.5,304.0,115.2
133349.0,17,2,700,2,700,0.0,350.0,350.0,0,0,0.0,0.0,0.0
19667.0,6,14,4740,7,653,2940.0,249.0,93.28571428571428,7,4087,3141.0,1514.0,583.8571428571429
90294276.0,6,25,2814,12,1357,8204492.181818182,427.0,113.08333333333331,13,1457,7523474.25,361.0,112.07692307692308
2979745.0,6,4,270,2,134,0.0,68.0,67.0,2,136,0.0,70.0,68.0
18361.0,6,10,2032,5,524,3962.0,252.0,104.8,5,1508,4045.25,1236.0,301.6
98629.0,17,2,286,2,286,0.0,143.0,143.0,0,0,0.0,0.0,0.0
232998.0,6,3,337,2,214,0.0,160.0,107.0,1,123,0.0,123.0,123.0
21809.0,6,20,7606,11,978,2141.6,310.0,88.9090909090909,9,6628,2541.75,1514.0,736.4444444444445
5768.0,17,2,245,1,85,0.0,85.0,85.0,1,160,0.0,160.0,160.0
90037805.0,17,28,13364,28,13364,3334733.5185185187,501.0,477.2857142857143,0,0,0.0,0.0,0.0
135134823.0,17,6,1206,6,1206,27026964.6,201.0,201.0,0,0,0.0,0.0,0.0
21840.0,6,20,7606,11,978,2184.0,310.0,88.9090909090909,9,6628,2584.75,1514.0,736.4444444444445
2801302.0,6,2,132,1,66,0.0,66.0,66.0,1,66,0.0,66.0,66.0
206806.0,6,3,426,2,280,0.0,214.0,140.0,1,146,0.0,146.0,146.0
233517.0,6,3,337,2,214,0.0,160.0,107.0,1,123,0.0,123.0,123.0
111806970.0,6,36,2596,18,1348,6563718.529411765,139.0,74.88888888888889,18,1248,6564170.352941177,123.0,69.33333333333333
850511.0,6,9,1118,6,586,170102.2,248.0,97.66666666666669,3,532,287294.5,392.0,177.33333333333334
162372.0,17,2,180,1,90,0.0,90.0,90.0,1,90,0.0,90.0,90.0
0.0,6,1,66,1,66,0.0,66.0,66.0,0,0,0.0,0.0,0.0
864292.0,6,10,1334,6,797,172858.4,459.0,132.83333333333334,4,537,197208.0,331.0,134.25
98784134.0,6,30,2122,15,1105,7040580.285714285,139.0,73.66666666666667,15,1017,7040580.571428572,123.0,67.8
147964.0,17,2,180,1,90,0.0,90.0,90.0,1,90,0.0,90.0,90.0
1301557.0,6,4,264,2,132,0.0,66.0,66.0,2,132,0.0,66.0,66.0
238955.0,6,12,1373,7,714,39825.833333333336,298.0,102.0,5,659,58379.25,379.0,131.8
36782.0,6,14,4740,7,653,6015.166666666667,249.0,93.28571428571428,7,4087,5998.333333333333,1514.0,583.8571428571429
120631.0,6,3,337,2,214,0.0,160.0,107.0,1,123,0.0,123.0,123.0
108112353.0,17,5,1005,5,1005,27028088.25,201.0,201.0,0,0,0.0,0.0,0.0
90006567.0,17,28,13364,28,13364,3333576.5555555555,501.0,477.2857142857143,0,0,0.0,0.0,0.0
47682.0,6,10,2032,5,524,11687.25,252.0,104.8,5,1508,11625.0,1236.0,301.6
146722.0,6,3,373,2,238,0.0,172.0,119.0,1,135,0.0,135.0,135.0
206904.0,6,10,1221,6,636,41380.8,298.0,106.0,4,585,67955.66666666667,379.0,146.25
2128761.0,6,24,7544,13,2516,177396.75,1034.0,193.53846153846155,11,5028,181727.2,1510.0,457.09090909090907
28304527.0,6,26,7627,14,3735,182944.38461538465,1514.0,266.7857142857143,12,3892,2553519.636363636,1514.0,324.3333333333333
106885954.0,6,32,2236,16,1165,7111338.4,139.0,72.8125,16,1071,7111342.266666667,123.0,66.9375
144.0,17,2,150,2,150,0.0,75.0,75.0,0,0,0.0,0.0,0.0
101614.0,6,2,132,1,66,0.0,66.0,66.0,1,66,0.0,66.0,66.0
63516.0,6,10,2032,5,524,14836.0,252.0,104.8,5,1508,13903.25,1236.0,301.6
316473.0,17,4,1400,4,1400,105491.0,350.0,350.0,0,0,0.0,0.0,0.0
135133593.0,17,6,1146,6,1146,27026718.6,191.0,191.0,0,0,0.0,0.0,0.0
104221535.0,6,30,2106,15,1089,7444395.357142857,123.0,72.6,15,1017,7428945.214285715,123.0,67.8
117382976.0,6,47,3102,24,1584,5103595.043478261,66.0,66.0,23,1518,5144013.5,66.0,66.0
135146453.0,17,6,1206,6,1206,27029290.6,201.0,201.0,0,0,0.0,0.0,0.0
4305.0,17,2,598,1,72,0.0,72.0,72.0,1,526,0.0,526.0,526.0
507796.0,6,5,336,2,134,0.0,68.0,67.0,3,202,193128.5,70.0,67.33333333333333
302379.0,6,2,132,1,66,0.0,66.0,66.0,1,66,0.0,66.0,66.0
90070183.0,17,28,13364,28,13364,3335932.703703704,501.0,477.2857142857143,0,0,0.0,0.0,0.0
4295.0,17,2,626,1,72,0.0,72.0,72.0,1,554,0.0,554.0,554.0
196849.0,17,2,180,1,90,0.0,90.0,90.0,1,90,0.0,90.0,90.0
232285.0,6,3,337,2,214,0.0,160.0,107.0,1,123,0.0,123.0,123.0
90256605.0,6,13,2036,8,1016,12893800.714285716,188.0,127.0,5,1020,22522781.0,204.0,204.0
3196.0,17,2,224,1,76,0.0,76.0,76.0,1,148,0.0,148.0,148.0
1187113.0,6,13,3010,8,2382,169587.57142857142,1514.0,297.75,5,628,227978.0,331.0,125.6
121509.0,6,3,337,2,214,0.0,160.0,107.0,1,123,0.0,123.0,123.0
90043668.0,17,28,13364,28,13364,3334950.6666666665,501.0,477.2857142857143,0,0,0.0,0.0,0.0
32543101.0,6,26,7627,14,3735,213568.3076923077,1514.0,266.7857142857143,12,3892,2938819.5454545454,1514.0,324.3333333333333
120383428.0,6,226,25496,113,7754,1049098.375,140.0,68.61946902654867,113,17742,1074392.1517857143,284.0,157.00884955752213
90257809.0,6,14,2240,8,1016,12893972.714285716,188.0,127.0,6,1224,18018847.6,204.0,204.0
122222.0,6,3,373,2,238,0.0,172.0,119.0,1,135,0.0,135.0,135.0
56504.0,6,10,2032,5,524,13890.75,252.0,104.8,5,1508,12555.0,1236.0,301.6
153542.0,17,2,180,1,90,0.0,90.0,90.0,1,90,0.0,90.0,90.0
90755232.0,6,28,3375,15,1929,6479145.071428572,425.0,128.6,13,1446,7561841.0,332.0,111.23076923076924
220406.0,6,3,426,2,280,0.0,214.0,140.0,1,146,0.0,146.0,146.0
206683.0,17,2,180,1,90,0.0,90.0,90.0,1,90,0.0,90.0,90.0
143897.0,17,2,180,1,90,0.0,90.0,90.0,1,90,0.0,90.0,90.0
141345.0,6,2,132,1,66,0.0,66.0,66.0,1,66,0.0,66.0,66.0
209613.0,17,2,180,1,90,0.0,90.0,90.0,1,90,0.0,90.0,90.0
45323.0,6,14,4740,7,653,7427.333333333333,249.0,93.28571428571428,7,4087,7383.0,1514.0,583.8571428571429
90256857.0,6,13,2036,8,1016,12893836.714285716,188.0,127.0,5,1020,22523716.0,204.0,204.0
301804.0,6,3,202,2,128,0.0,74.0,64.0,1,74,0.0,74.0,74.0
311272.0,17,2,180,1,90,0.0,90.0,90.0,1,90,0.0,90.0,90.0
2849386.0,6,3,204,1,68,0.0,68.0,68.0,2,136,0.0,70.0,68.0
90527330.0,6,13,2036,8,1016,12932475.714285716,188.0,127.0,5,1020,22590889.25,204.0,204.0
3010.0,17,4,625,2,163,0.0,89.0,81.5,2,462,0.0,245.0,231.0
228384.0,17,2,180,1,90,0.0,90.0,90.0,1,90,0.0,90.0,90.0
1897.0,17,2,762,2,762,0.0,381.0,381.0,0,0,0.0,0.0,0.0
108564351.0,6,45,2970,23,1518,4919962.7727272725,66.0,66.0,22,1452,5154083.571428572,66.0,66.0
6764.0,17,2,582,1,83,0.0,83.0,83.0,1,499,0.0,499.0,499.0
247089.0,17,2,180,1,90,0.0,90.0,90.0,1,90,0.0,90.0,90.0
299906.0,6,6,412,4,272,99968.66666666669,74.0,68.0,2,140,0.0,74.0,70.0
120126502.0,6,14,2240,6,1224,24025300.4,204.0,204.0,8,1016,17137437.14285714,188.0,127.0
2796268.0,6,2,132,1,66,0.0,66.0,66.0,1,66,0.0,66.0,66.0
120834372.0,6,33,2296,17,1225,7552148.25,139.0,72.05882352941177,16,1071,7375604.533333333,123.0,66.9375
5001107.0,17,4,534,2,166,0.0,83.0,83.0,2,368,0.0,184.0,184.0
90027365.0,17,27,12943,27,12943,3462590.961538461,501.0,479.3703703703704,0,0,0.0,0.0,0.0
119533491.0,6,232,26088,116,18210,1037551.0869565216,284.0,156.98275862068965,116,7878,1037551.6347826088,140.0,67.91379310344827
14821.0,6,11,1133,6,602,2579.6,264.0,100.33333333333331,5,531,2952.25,259.0,106.2
118064934.0,6,32,2236,16,1165,7870995.6,139.0,72.8125,16,1071,7856576.2,123.0,66.9375
27653.0,6,10,2032,5,524,6682.75,252.0,104.8,5,1508,6500.5,1236.0,301.6
210253.0,6,3,426,2,280,0.0,214.0,140.0,1,146,0.0,146.0,146.0
2027.0,17,4,344,2,150,0.0,75.0,75.0,2,194,0.0,103.0,97.0
60529.0,6,10,2032,5,524,14901.75,252.0,104.8,5,1508,12738.5,1236.0,301.6
55971.0,6,14,4740,7,653,8678.0,249.0,93.28571428571428,7,4087,9189.666666666666,1514.0,583.8571428571429
1773.0,17,2,664,1,322,0.0,322.0,322.0,1,342,0.0,342.0,342.0
38087.0,6,10,2032,5,524,8039.75,252.0,104.8,5,1508,9140.0,1236.0,301.6
2170.0,17,4,344,2,150,0.0,75.0,75.0,2,194,0.0,103.0,97.0
135128587.0,17,6,1206,6,1206,27025717.4,201.0,201.0,0,0,0.0,0.0,0.0
153544.0,17,2,180,1,90,0.0,90.0,90.0,1,90,0.0,90.0,90.0
21677.0,6,10,2032,5,524,4991.0,252.0,104.8,5,1508,4054.5,1236.0,301.6
204703.0,17,2,180,1,90,0.0,90.0,90.0,1,90,0.0,90.0,90.0
201018.0,17,2,762,2,762,0.0,381.0,381.0,0,0,0.0,0.0,0.0
90041908.0,17,28,13364,28,13364,3334885.4814814813,501.0,477.2857142857143,0,0,0.0,0.0,0.0
15126.0,6,10,2032,5,524,3628.0,252.0,104.8,5,1508,3448.5,1236.0,301.6
99.0,17,2,762,2,762,0.0,381.0,381.0,0,0,0.0,0.0,0.0
108112329.0,17,5,955,5,955,27028082.25,191.0,191.0,0,0,0.0,0.0,0.0
28953.0,6,10,2032,5,524,6999.5,252.0,104.8,5,1508,6825.0,1236.0,301.6
267504.0,17,4,1524,4,1524,89168.0,381.0,381.0,0,0,0.0,0.0,0.0
97212.0,6,10,2032,5,524,24079.25,252.0,104.8,5,1508,23461.5,1236.0,301.6
90041400.0,17,28,13364,28,13364,3334866.6666666665,501.0,477.2857142857143,0,0,0.0,0.0,0.0
41471.0,6,14,4740,7,653,6715.0,249.0,93.28571428571428,7,4087,5811.5,1514.0,583.8571428571429
79414064.0,6,17,1185,9,640,9926758.0,95.0,71.11111111111111,8,545,11308376.142857144,95.0,68.125
304842.0,17,2,616,1,75,0.0,75.0,75.0,1,541,0.0,541.0,541.0
2377.0,17,4,344,2,150,0.0,75.0,75.0,2,194,0.0,103.0,97.0
45025336.0,17,9,3086,8,2736,5134991.714285715,342.0,342.0,1,350,0.0,350.0,350.0
120105407.0,6,25,1924,12,935,10900028.090909092,95.0,77.91666666666667,13,989,9988894.0,95.0,76.07692307692308
111224366.0,6,211,23712,106,7218,1059279.6761904762,140.0,68.09433962264151,105,16494,1059494.9134615385,284.0,157.0857142857143
17858.0,6,14,4740,7,653,2821.5,249.0,93.28571428571428,7,4087,2326.1666666666665,1514.0,583.8571428571429
777.0,17,4,438,2,148,0.0,74.0,74.0,2,290,0.0,147.0,145.0
16818.0,6,14,4740,7,653,2641.1666666666665,249.0,93.28571428571428,7,4087,2601.6666666666665,1514.0,583.8571428571429
207069.0,6,3,426,2,280,0.0,214.0,140.0,1,146,0.0,146.0,146.0
217908.0,6,3,426,2,280,0.0,214.0,140.0,1,146,0.0,146.0,146.0
39393.0,6,10,2032,5,524,9622.0,252.0,104.8,5,1508,8922.5,1236.0,301.6
208547.0,6,3,426,2,280,0.0,214.0,140.0,1,146,0.0,146.0,146.0
188329.0,6,11,1131,6,600,37352.6,262.0,100.0,5,531,5383.5,259.0,106.2
39862.0,6,13,1479,7,882,6366.0,291.0,126.0,6,597,6491.6,259.0,99.5
344.0,17,2,267,1,83,0.0,83.0,83.0,1,184,0.0,184.0,184.0
113051458.0,6,31,2166,16,1149,7522349.8,123.0,71.8125,15,1017,8059659.285714285,123.0,67.8
2420.0,17,4,344,2,150,0.0,75.0,75.0,2,194,0.0,103.0,97.0
283045.0,17,2,363,1,79,0.0,79.0,79.0,1,284,0.0,284.0,284.0
156846.0,6,3,337,2,214,0.0,160.0,107.0,1,123,0.0,123.0,123.0
7340.0,17,2,582,1,83,0.0,83.0,83.0,1,499,0.0,499.0,499.0
312840.0,6,5,337,3,174,156420.0,66.0,58.0,2,163,0.0,97.0,81.5
135135640.0,17,6,1206,6,1206,27027128.0,201.0,201.0,0,0,0.0,0.0,0.0
213162.0,17,2,180,1,90,0.0,90.0,90.0,1,90,0.0,90.0,90.0
2705494.0,6,33,10980,18,3951,159146.70588235295,1514.0,219.5,15,7029,174298.0,1514.0,468.6
45704.0,6,14,4740,7,653,7150.833333333333,249.0,93.28571428571428,7,4087,5641.333333333333,1514.0,583.8571428571429
107086313.0,6,211,23712,106,7292,1019869.6476190476,140.0,68.79245283018868,105,16420,1019717.4230769232,284.0,156.38095238095238
107340.0,17,2,286,2,286,0.0,143.0,143.0,0,0,0.0,0.0,0.0
3907577.0,6,157,123253,87,114332,45436.94186046512,1510.0,1314.16091954023,70,8921,52128.840579710144,1510.0,127.44285714285714
19842843.0,6,17,1742,9,962,2453462.375,222.0,106.88888888888889,8,780,2803918.0,206.0,97.5
305799.0,6,6,412,4,272,101933.0,74.0,68.0,2,140,0.0,74.0,70.0
228578.0,17,2,180,1,90,0.0,90.0,90.0,1,90,0.0,90.0,90.0
34564.0,6,14,4740,7,653,5539.0,249.0,93.28571428571428,7,4087,5152.833333333333,1514.0,583.8571428571429
308016.0,6,6,412,4,272,102672.0,74.0,68.0,2,140,0.0,74.0,70.0
206564.0,17,2,180,1,90,0.0,90.0,90.0,1,90,0.0,90.0,90.0
301.0,17,2,174,1,79,0.0,79.0,79.0,1,95,0.0,95.0,95.0
33054.0,6,13,1479,7,882,5509.0,291.0,126.0,6,597,5501.8,259.0,99.5
93750933.0,6,40,2640,20,1320,4934259.631578947,66.0,66.0,20,1320,4918015.105263158,66.0,66.0
101109648.0,17,14,1126,7,563,16851608.0,174.0,80.42857142857143,7,563,16788912.666666668,174.0,80.42857142857143
1281108.0,17,7,490,7,490,213518.0,70.0,70.0,0,0,0.0,0.0,0.0
1317212.0,6,4,264,2,132,0.0,66.0,66.0,2,132,0.0,66.0,66.0
35469.0,6,14,4740,7,653,4845.0,249.0,93.28571428571428,7,4087,5773.5,1514.0,583.8571428571429
241323.0,6,3,337,2,214,0.0,160.0,107.0,1,123,0.0,123.0,123.0
39826.0,6,14,4740,7,653,6042.166666666667,249.0,93.28571428571428,7,4087,6327.333333333333,1514.0,583.8571428571429
111077543.0,17,14,864,7,432,18500159.5,174.0,61.71428571428572,7,432,18500709.33333333,174.0,61.71428571428572
6702.0,17,2,582,1,83,0.0,83.0,83.0,1,499,0.0,499.0,499.0
237973.0,6,13,1386,7,789,39662.16666666666,253.0,112.71428571428572,6,597,46512.6,259.0,99.5
2382135.0,6,47,23596,24,19731,103571.08695652174,1514.0,822.125,23,3865,98132.81818181818,1514.0,168.04347826086956
2156.0,17,4,344,2,150,0.0,75.0,75.0,2,194,0.0,103.0,97.0
90756480.0,6,19,1436,10,745,10079106.0,95.0,74.5,9,691,11343620.875,95.0,76.77777777777777
32709.000000000004,6,10,2032,5,524,7369.25,252.0,104.8,5,1508,6127.5,1236.0,301.6
123839803.0,6,48,3168,24,1584,4994013.478260869,66.0,66.0,24,1584,5307952.304347826,66.0,66.0
302655.0,6,6,412,4,272,100885.0,74.0,68.0,2,140,0.0,74.0,70.0
2471.0,17,4,344,2,150,0.0,75.0,75.0,2,194,0.0,103.0,97.0
204898.0,17,2,762,2,762,0.0,381.0,381.0,0,0,0.0,0.0,0.0
135132350.0,17,6,1206,6,1206,27026470.0,201.0,201.0,0,0,0.0,0.0,0.0
2343.0,17,4,344,2,150,0.0,75.0,75.0,2,194,0.0,103.0,97.0
29391.0,6,10,2032,5,524,4981.0,252.0,104.8,5,1508,6752.0,1236.0,301.6
219701.0,6,3,426,2,280,0.0,214.0,140.0,1,146,0.0,146.0,146.0
82766.0,6,10,2032,5,524,15548.5,252.0,104.8,5,1508,18419.5,1236.0,301.6
120118121.0,6,15,2428,9,1204,15014765.125,188.0,133.77777777777777,6,1224,18018171.8,204.0,204.0
99934.0,17,2,762,2,762,0.0,381.0,381.0,0,0,0.0,0.0,0.0
107175436.0,6,201,22602,101,6888,1071754.36,140.0,68.1980198019802,100,15714,1051309.616161616,284.0,157.14
38612.0,6,10,2032,5,524,8320.0,252.0,104.8,5,1508,8328.0,1236.0,301.6
2388.0,17,4,344,2,150,0.0,75.0,75.0,2,194,0.0,103.0,97.0
312332.0,6,6,412,4,272,104110.66666666669,74.0,68.0,2,140,0.0,74.0,70.0
135233.0,6,13,1394,7,797,22538.83333333333,253.0,113.85714285714286,6,597,20418.2,259.0,99.5
123455741.0,6,48,3168,24,1584,5028968.0,66.0,66.0,24,1584,5238995.869565218,66.0,66.0
3831691.0,6,28,8465,15,4743,273692.21428571426,1514.0,316.2,13,3722,292619.5833333333,1514.0,286.3076923076923
54404.0,6,14,4740,7,653,7758.5,249.0,93.28571428571428,7,4087,8897.833333333334,1514.0,583.8571428571429
36223.0,6,14,4740,7,653,5246.0,249.0,93.28571428571428,7,4087,5554.666666666667,1514.0,583.8571428571429
120255010.0,6,232,26210,116,7878,1038508.6086956522,140.0,67.91379310344827,116,18332,1045623.7652173912,300.0,158.0344827586207
346.0,17,2,250,1,93,0.0,93.0,93.0,1,157,0.0,157.0,157.0
303431.0,6,6,412,4,272,101143.66666666669,74.0,68.0,2,140,0.0,74.0,70.0
120012801.0,6,21,1585,11,840,11999989.8,95.0,76.36363636363636,10,745,13334134.333333334,95.0,74.5
132387.0,6,2,132,1,66,0.0,66.0,66.0,1,66,0.0,66.0,66.0
46418.0,6,14,4740,7,653,7232.833333333333,249.0,93.28571428571428,7,4087,6942.0,1514.0,583.8571428571429
891478.0,6,12,2709,7,743,148579.66666666666,339.0,106.14285714285714,5,1966,154761.0,1514.0,393.2
860072.0,6,10,1335,6,798,172014.4,460.0,133.0,4,537,195823.3333333333,331.0,134.25
298.0,17,2,164,1,82,0.0,82.0,82.0,1,82,0.0,82.0,82.0
205849.0,17,2,180,1,90,0.0,90.0,90.0,1,90,0.0,90.0,90.0
509.0,17,2,160,1,80,0.0,80.0,80.0,1,80,0.0,80.0,80.0
4362.0,17,2,602,1,72,0.0,72.0,72.0,1,530,0.0,530.0,530.0
143950.0,17,2,180,1,90,0.0,90.0,90.0,1,90,0.0,90.0,90.0
0.0,6,1,54,0,0,0.0,0.0,0.0,1,54,0.0,54.0,54.0
303647.0,6,2,132,1,66,0.0,66.0,66.0,1,66,0.0,66.0,66.0
32666.0,6,14,4740,7,653,5042.666666666667,249.0,93.28571428571428,7,4087,5152.666666666667,1514.0,583.8571428571429
2376.0,17,4,344,2,150,0.0,75.0,75.0,2,194,0.0,103.0,97.0
108108427.0,17,5,1005,5,1005,27027106.75,201.0,201.0,0,0,0.0,0.0,0.0
144034.0,17,2,180,1,90,0.0,90.0,90.0,1,90,0.0,90.0,90.0
6088.0,17,2,447,1,84,0.0,84.0,84.0,1,363,0.0,363.0,363.0
58591.0,6,14,4740,7,653,9277.666666666666,249.0,93.28571428571428,7,4087,9362.333333333334,1514.0,583.8571428571429
217506.0,6,3,426,2,280,0.0,214.0,140.0,1,146,0.0,146.0,146.0
5621546.0,6,4,270,2,134,0.0,68.0,67.0,2,136,0.0,70.0,68.0
82985.0,6,14,4740,7,653,13614.0,249.0,93.28571428571428,7,4087,7593.333333333333,1514.0,583.8571428571429
922.0,17,5,550,5,550,230.5,110.0,110.0,0,0,0.0,0.0,0.0
307414.0,6,6,412,4,272,102471.33333333331,74.0,68.0,2,140,0.0,74.0,70.0
33052.0,6,10,2032,5,524,7835.5,252.0,104.8,5,1508,6612.75,1236.0,301.6
20961.0,6,10,2032,5,524,4829.0,252.0,104.8,5,1508,4318.5,1236.0,301.6
28468.0,6,10,2032,5,524,6169.25,252.0,104.8,5,1508,6429.75,1236.0,301.6
120038042.0,6,21,1585,11,840,11999423.3,95.0,76.36363636363636,10,745,13310501.0,95.0,74.5
120010381.0,6,17,1246,9,650,15001297.625,95.0,72.22222222222223,8,596,17108680.85714286,95.0,74.5
205863.0,17,2,180,1,90,0.0,90.0,90.0,1,90,0.0,90.0,90.0
38013.0,6,10,2032,5,524,7410.25,252.0,104.8,5,1508,9199.5,1236.0,301.6
112389684.0,17,16,1474,8,737,16032852.0,174.0,92.125,8,737,16048612.714285716,174.0,92.125
1036987.0,6,11,1134,6,558,207397.4,220.0,93.0,5,576,258344.75,304.0,115.2
2377.0,17,4,344,2,150,0.0,75.0,75.0,2,194,0.0,103.0,97.0
271414.0,6,10,1221,6,636,54282.8,298.0,106.0,4,585,84119.0,379.0,146.25
7294.0,17,2,582,1,83,0.0,83.0,83.0,1,499,0.0,499.0,499.0
246931.0,6,3,337,2,214,0.0,160.0,107.0,1,123,0.0,123.0,123.0
205740.0,17,2,180,1,90,0.0,90.0,90.0,1,90,0.0,90.0,90.0
23803.0,6,20,7606,11,978,2380.3,310.0,88.9090909090909,9,6628,2700.375,1514.0,736.4444444444445
322300.0,17,4,704,2,148,0.0,74.0,74.0,2,556,0.0,280.0,278.0
61363.0,6,14,4740,7,653,9994.166666666666,249.0,93.28571428571428,7,4087,8868.5,1514.0,583.8571428571429
200087.0,17,4,6056,4,6056,66695.66666666667,1514.0,1514.0,0,0,0.0,0.0,0.0
90040506.0,17,28,13364,28,13364,3334833.5555555555,501.0,477.2857142857143,0,0,0.0,0.0,0.0
281464.0,17,2,363,1,79,0.0,79.0,79.0,1,284,0.0,284.0,284.0
298524.0,6,6,412,4,272,99508.0,74.0,68.0,2,140,0.0,74.0,70.0
146146.0,6,3,337,2,214,0.0,160.0,107.0,1,123,0.0,123.0,123.0
234151.0,6,3,373,2,238,0.0,172.0,119.0,1,135,0.0,135.0,135.0
32456.0,6,14,4740,7,653,4783.333333333333,249.0,93.28571428571428,7,4087,5264.166666666667,1514.0,583.8571428571429
2598874.0,6,2,132,1,66,0.0,66.0,66.0,1,66,0.0,66.0,66.0
50475.0,6,12,1320,7,789,8412.5,253.0,112.71428571428572,5,531,9678.5,259.0,106.2
237428.0,17,2,180,1,90,0.0,90.0,90.0,1,90,0.0,90.0,90.0
138008375.0,17,17,1255,9,649,17251046.875,174.0,72.11111111111111,8,606,16812062.14285714,174.0,75.75
5626595.0,6,5,336,2,134,0.0,68.0,67.0,3,202,1519220.0,70.0,67.33333333333333
18889.0,6,14,4740,7,653,2946.833333333333,249.0,93.28571428571428,7,4087,3010.1666666666665,1514.0,583.8571428571429
4192.0,17,2,614,1,72,0.0,72.0,72.0,1,542,0.0,542.0,542.0
39217.0,6,14,4740,7,653,5894.833333333333,249.0,93.28571428571428,7,4087,6000.166666666667,1514.0,583.8571428571429
64336.00000000001,6,10,2032,5,524,15423.0,252.0,104.8,5,1508,15192.5,1236.0,301.6
108108110.0,17,5,955,5,955,27027027.5,191.0,191.0,0,0,0.0,0.0,0.0
477.0,17,2,166,1,75,0.0,75.0,75.0,1,91,0.0,91.0,91.0
60944.0,6,10,2032,5,524,14964.25,252.0,104.8,5,1508,14638.5,1236.0,301.6
33580.0,6,13,1479,7,882,5522.666666666667,291.0,126.0,6,597,6298.2,259.0,99.5
144627.0,17,2,180,1,70,0.0,70.0,70.0,1,110,0.0,110.0,110.0
119096519.0,6,24,1788,13,989,9920555.083333334,95.0,76.07692307692308,11,799,11905138.5,95.0,72.63636363636364
246172.0,6,3,337,2,214,0.0,160.0,107.0,1,123,0.0,123.0,123.0
120189699.0,6,220,24900,110,7482,1095068.6788990826,140.0,68.01818181818182,110,17418,1095243.1009174313,284.0,158.34545454545454
206200.0,6,3,426,2,280,0.0,214.0,140.0,1,146,0.0,146.0,146.0
37286.0,6,11,2098,6,590,7275.6,252.0,98.33333333333331,5,1508,9058.5,1236.0,301.6
124045.0,17,2,286,2,286,0.0,143.0,143.0,0,0,0.0,0.0,0.0
90257963.0,6,12,1832,8,1016,12893994.714285716,188.0,127.0,4,816,30031382.33333333,204.0,204.0
251306.0,6,3,337,2,214,0.0,160.0,107.0,1,123,0.0,123.0,123.0
61388.0,6,14,4740,7,653,10105.833333333334,249.0,93.28571428571428,7,4087,9901.833333333334,1514.0,583.8571428571429
207323.0,6,3,426,2,280,0.0,214.0,140.0,1,146,0.0,146.0,146.0
108105727.0,17,5,1005,5,1005,27026431.75,201.0,201.0,0,0,0.0,0.0,0.0
196932.0,17,2,180,1,90,0.0,90.0,90.0,1,90,0.0,90.0,90.0
307614.0,6,6,412,4,272,102538.0,74.0,68.0,2,140,0.0,74.0,70.0
301136.0,6,6,412,4,272,100378.66666666669,74.0,68.0,2,140,0.0,74.0,70.0
303845.0,6,6,412,4,272,101281.66666666669,74.0,68.0,2,140,0.0,74.0,70.0
2426.0,17,4,344,2,150,0.0,75.0,75.0,2,194,0.0,103.0,97.0
119108961.0,6,20,1490,10,745,13234329.0,95.0,74.5,10,745,13206622.777777778,95.0,74.5
60078.0,6,10,2032,5,524,14806.5,252.0,104.8,5,1508,14847.75,1236.0,301.6
108114802.0,17,5,1005,5,1005,27028700.5,201.0,201.0,0,0,0.0,0.0,0.0
2591766.0,6,2,132,1,66,0.0,66.0,66.0,1,66,0.0,66.0,66.0
111204318.0,6,32,2220,16,1149,7399243.8,123.0,71.8125,16,1071,7399242.333333333,123.0,66.9375
304.0,17,2,168,1,76,0.0,76.0,76.0,1,92,0.0,92.0,92.0
218024.0,6,3,426,2,280,0.0,214.0,140.0,1,146,0.0,146.0,146.0
317092.0,17,4,1400,4,1400,105697.33333333331,350.0,350.0,0,0,0.0,0.0,0.0
41993.0,6,14,4740,7,653,6872.5,249.0,93.28571428571428,7,4087,6252.0,1514.0,583.8571428571429
304.0,17,2,174,1,79,0.0,79.0,79.0,1,95,0.0,95.0,95.0
210247.0,6,3,426,2,280,0.0,214.0,140.0,1,146,0.0,146.0,146.0
147106.0,6,2,132,1,66,0.0,66.0,66.0,1,66,0.0,66.0,66.0
16594.0,6,13,1459,7,862,2683.333333333333,271.0,123.14285714285714,6,597,2409.0,259.0,99.5
47354.0,6,14,4740,7,653,7772.333333333333,249.0,93.28571428571428,7,4087,7546.833333333333,1514.0,583.8571428571429
120285.0,17,2,180,1,70,0.0,70.0,70.0,1,110,0.0,110.0,110.0
227657.0,6,3,426,2,280,0.0,214.0,140.0,1,146,0.0,146.0,146.0
169124.0,17,2,414,1,88,0.0,88.0,88.0,1,326,0.0,326.0,326.0
16656.0,6,14,4740,7,653,2523.1666666666665,249.0,93.28571428571428,7,4087,2642.333333333333,1514.0,583.8571428571429
2803889.0,6,2,132,1,66,0.0,66.0,66.0,1,66,0.0,66.0,66.0
2450.0,17,4,344,2,150,0.0,75.0,75.0,2,194,0.0,103.0,97.0
10215.0,6,10,2032,5,524,2141.5,252.0,104.8,5,1508,2316.0,1236.0,301.6
207148.0,6,3,426,2,280,0.0,214.0,140.0,1,146,0.0,146.0,146.0
472280.0,6,3,204,2,136,0.0,70.0,68.0,1,68,0.0,68.0,68.0
10453042.0,6,6,412,3,206,5158850.5,74.0,68.66666666666667,3,206,5158763.0,74.0,68.66666666666667
323071.0,17,4,1400,4,1400,107690.33333333331,350.0,350.0,0,0,0.0,0.0,0.0
90057250.0,17,28,13364,28,13364,3335453.703703704,501.0,477.2857142857143,0,0,0.0,0.0,0.0
123828.0,6,3,337,2,214,0.0,160.0,107.0,1,123,0.0,123.0,123.0
2052.0,17,4,344,2,150,0.0,75.0,75.0,2,194,0.0,103.0,97.0
298642.0,6,2,132,1,66,0.0,66.0,66.0,1,66,0.0,66.0,66.0
203110.0,17,2,180,1,90,0.0,90.0,90.0,1,90,0.0,90.0,90.0
2783271.0,6,2,132,1,66,0.0,66.0,66.0,1,66,0.0,66.0,66.0
1955483.0,17,6,1230,3,234,977550.0,78.0,78.0,3,996,977537.0,332.0,332.0
207762.0,17,2,762,2,762,0.0,381.0,381.0,0,0,0.0,0.0,0.0
135122977.0,17,6,1146,6,1146,27024595.4,191.0,191.0,0,0,0.0,0.0,0.0
233216.0,17,2,180,1,90,0.0,90.0,90.0,1,90,0.0,90.0,90.0
197148.0,17,2,180,1,90,0.0,90.0,90.0,1,90,0.0,90.0,90.0
369707.0,6,3,1604,2,851,0.0,785.0,425.5,1,753,0.0,753.0,753.0
1156552.0,6,13,3011,8,2383,165221.7142857143,1514.0,297.875,5,628,221037.0,331.0,125.6
90041490.0,17,28,13364,28,13364,3334870.0,501.0,477.2857142857143,0,0,0.0,0.0,0.0
94946029.0,6,28,1992,14,1029,7303540.692307692,123.0,73.5,14,963,7286890.923076923,123.0,68.78571428571429
27354.0,6,14,4740,7,653,4433.833333333333,249.0,93.28571428571428,7,4087,4032.3333333333335,1514.0,583.8571428571429
43712555.0,6,5,1911,2,894,0.0,826.0,447.0,3,1017,20480037.0,885.0,339.0
48371.0,6,14,4740,7,653,6362.166666666667,249.0,93.28571428571428,7,4087,7612.166666666667,1514.0,583.8571428571429
66136.0,17,2,180,1,90,0.0,90.0,90.0,1,90,0.0,90.0,90.0
205259.0,17,4,6056,4,6056,68419.66666666667,1514.0,1514.0,0,0,0.0,0.0,0.0
886744.0,6,12,2709,7,742,147790.66666666666,338.0,106.0,5,1967,153529.75,1514.0,393.4
150283.0,6,14,4740,7,653,24341.666666666668,249.0,93.28571428571428,7,4087,24908.166666666668,1514.0,583.8571428571429
334932.0,17,2,180,1,90,0.0,90.0,90.0,1,90,0.0,90.0,90.0
119722969.0,6,23,1734,11,840,9001914.5,95.0,76.36363636363636,12,894,10867475.636363637,95.0,74.5
197012.0,17,2,180,1,90,0.0,90.0,90.0,1,90,0.0,90.0,90.0
207290.0,6,3,426,2,280,0.0,214.0,140.0,1,146,0.0,146.0,146.0
39249.0,6,11,2098,6,590,7735.4,252.0,98.33333333333331,5,1508,8349.5,1236.0,301.6
2798633.0,6,2,132,1,66,0.0,66.0,66.0,1,66,0.0,66.0,66.0
144010.0,17,2,180,1,90,0.0,90.0,90.0,1,90,0.0,90.0,90.0
1792883.0,6,14,4740,7,653,298326.6666666667,249.0,93.28571428571428,7,4087,298636.3333333333,1514.0,583.8571428571429
438117.0,6,11,1021,6,444,58828.6,162.0,74.0,5,577,73361.5,349.0,115.4
90932707.0,17,13,1083,7,563,15155451.166666666,174.0,80.42857142857143,6,520,16982097.2,174.0,86.66666666666667
10523153.0,6,7,478,4,272,3460805.333333333,74.0,68.0,3,206,5191050.5,74.0,68.66666666666667
45561.0,6,10,2032,5,524,10851.0,252.0,104.8,5,1508,11011.25,1236.0,301.6
120984138.0,17,14,864,7,432,19883819.33333333,174.0,61.71428571428572,7,432,20137536.5,174.0,61.71428571428572
2348.0,17,4,344,2,150,0.0,75.0,75.0,2,194,0.0,103.0,97.0
120263428.0,6,17,1287,9,691,15032928.5,95.0,76.77777777777777,8,596,17105309.0,95.0,74.5
146164.0,6,3,337,2,214,0.0,160.0,107.0,1,123,0.0,123.0,123.0
213655.0,17,2,180,1,90,0.0,90.0,90.0,1,90,0.0,90.0,90.0
303612.0,6,2,132,1,66,0.0,66.0,66.0,1,66,0.0,66.0,66.0
120000030.0,6,25,1924,14,1084,9230771.538461538,95.0,77.42857142857143,11,840,9142247.5,95.0,76.36363636363636
247090.0,6,3,373,2,238,0.0,172.0,119.0,1,135,0.0,135.0,135.0
153484.0,17,2,180,1,90,0.0,90.0,90.0,1,90,0.0,90.0,90.0
14635556.0,6,20,1689,10,1057,1592387.7777777778,315.0,105.7,10,632,1592367.2222222222,78.0,63.2
103036.0,17,2,286,2,286,0.0,143.0,143.0,0,0,0.0,0.0,0.0
22978.0,6,2,145,2,145,0.0,91.0,72.5,0,0,0.0,0.0,0.0
92065906.0,6,172,19444,86,13546,1080596.6470588236,284.0,157.51162790697674,86,5898,1080596.4,140.0,68.5813953488372
63346.0,6,12,1413,6,816,12034.8,291.0,136.0,6,597,11487.0,259.0,99.5
148.0,17,2,158,2,158,0.0,79.0,79.0,0,0,0.0,0.0,0.0
153427.0,17,2,180,1,90,0.0,90.0,90.0,1,90,0.0,90.0,90.0
90043189.0,17,28,13364,28,13364,3334932.925925926,501.0,477.2857142857143,0,0,0.0,0.0,0.0
51060.0,17,2,180,1,90,0.0,90.0,90.0,1,90,0.0,90.0,90.0
310397.0,17,4,1400,4,1400,103465.66666666669,350.0,350.0,0,0,0.0,0.0,0.0
1154046.0,6,13,3005,8,2377,164863.7142857143,1514.0,297.125,5,628,220305.5,331.0,125.6
2378.0,17,4,344,2,150,0.0,75.0,75.0,2,194,0.0,103.0,97.0
1648791.0,6,7,499,4,301,543025.3333333334,103.0,75.25,3,198,716942.5,66.0,66.0
96773.0,17,2,286,2,286,0.0,143.0,143.0,0,0,0.0,0.0,0.0
108099659.0,17,5,955,5,955,27024914.75,191.0,191.0,0,0,0.0,0.0,0.0
298713.0,6,6,412,4,272,99571.0,74.0,68.0,2,140,0.0,74.0,70.0
117979197.0,6,263,30528,132,21660,900604.5572519084,284.0,164.0909090909091,131,8868,902389.9153846154,140.0,67.69465648854961
299246.0,6,6,412,4,272,99748.66666666669,74.0,68.0,2,140,0.0,74.0,70.0
1239974.0,17,7,490,7,490,206662.3333333333,70.0,70.0,0,0,0.0,0.0,0.0
147447.0,6,3,373,2,238,0.0,172.0,119.0,1,135,0.0,135.0,135.0
166177.0,17,4,1524,4,1524,55392.333333333336,381.0,381.0,0,0,0.0,0.0,0.0
5725398.0,6,4,270,2,134,0.0,68.0,67.0,2,136,0.0,70.0,68.0
249896.0,6,3,337,2,214,0.0,160.0,107.0,1,123,0.0,123.0,123.0
90022870.0,17,28,13364,28,13364,3334180.3703703703,501.0,477.2857142857143,0,0,0.0,0.0,0.0
79992.0,6,11,2098,6,590,15868.8,252.0,98.33333333333331,5,1508,18713.75,1236.0,301.6
5615436.0,6,5,336,2,134,0.0,68.0,67.0,3,202,1524016.5,70.0,67.33333333333333
39887.0,6,14,4740,7,653,6215.5,249.0,93.28571428571428,7,4087,6013.666666666667,1514.0,583.8571428571429
135132150.0,17,6,1206,6,1206,27026430.0,201.0,201.0,0,0,0.0,0.0,0.0
1246568.0,6,7,499,3,198,614040.5,66.0,66.0,4,301,401008.0,103.0,75.25
2428.0,17,4,344,2,150,0.0,75.0,75.0,2,194,0.0,103.0,97.0
58263.0,6,12,1320,7,789,9710.5,253.0,112.71428571428572,5,531,12077.25,259.0,106.2
2447.0,17,4,344,2,150,0.0,75.0,75.0,2,194,0.0,103.0,97.0
46743.0,6,14,4740,7,653,7105.666666666667,249.0,93.28571428571428,7,4087,7580.0,1514.0,583.8571428571429
251687.0,6,3,337,2,214,0.0,160.0,107.0,1,123,0.0,123.0,123.0
19717.0,6,14,4740,7,653,2939.5,249.0,93.28571428571428,7,4087,3151.333333333333,1514.0,583.8571428571429
123730561.0,6,49,3234,25,1650,5155440.041666667,66.0,66.0,24,1584,4997564.608695652,66.0,66.0
93477627.0,6,26,2019,14,1084,7186935.0,95.0,77.42857142857143,12,935,8496684.727272727,95.0,77.91666666666667
299827.0,6,6,412,4,272,99942.33333333331,74.0,68.0,2,140,0.0,74.0,70.0
233407.0,6,3,337,2,214,0.0,160.0,107.0,1,123,0.0,123.0,123.0
80252.0,6,12,1320,6,723,14875.4,253.0,120.5,6,597,15765.0,259.0,99.5
101833.0,17,2,286,2,286,0.0,143.0,143.0,0,0,0.0,0.0,0.0
323132.0,17,4,1400,4,1400,107710.66666666669,350.0,350.0,0,0,0.0,0.0,0.0
9622.0,17,2,582,1,83,0.0,83.0,83.0,1,499,0.0,499.0,499.0
196884.0,17,2,180,1,90,0.0,90.0,90.0,1,90,0.0,90.0,90.0
24026830.0,17,3,1026,3,1026,12013415.0,342.0,342.0,0,0,0.0,0.0,0.0
207637.0,17,2,762,2,762,0.0,381.0,381.0,0,0,0.0,0.0,0.0
246356.0,6,3,337,2,214,0.0,160.0,107.0,1,123,0.0,123.0,123.0
143276.0,17,4,344,2,150,0.0,75.0,75.0,2,194,0.0,103.0,97.0
113168130.0,6,46,3036,23,1518,5143994.045454546,66.0,66.0,23,1518,5143994.909090909,66.0,66.0
146423.0,6,3,337,2,214,0.0,160.0,107.0,1,123,0.0,123.0,123.0
310453.0,17,4,1400,4,1400,103484.33333333331,350.0,350.0,0,0,0.0,0.0,0.0
3202217.0,6,14,4740,7,653,533527.8333333334,249.0,93.28571428571428,7,4087,533482.1666666666,1514.0,583.8571428571429
90018122.0,17,28,13364,28,13364,3334004.5185185187,501.0,477.2857142857143,0,0,0.0,0.0,0.0
21287.0,6,10,2032,5,524,4943.25,252.0,104.8,5,1508,4690.0,1236.0,301.6
513553.00000000006,6,5,336,2,134,0.0,68.0,67.0,3,202,194122.0,70.0,67.33333333333333
102739019.0,17,16,1474,8,737,14677002.714285716,174.0,92.125,8,737,14629042.285714284,174.0,92.125
148534.0,6,3,373,2,238,0.0,172.0,119.0,1,135,0.0,135.0,135.0
80.0,17,2,700,2,700,0.0,350.0,350.0,0,0,0.0,0.0,0.0
10498401.0,6,6,412,3,206,5180497.0,74.0,68.66666666666667,3,206,5180379.5,74.0,68.66666666666667
204785.0,17,2,762,2,762,0.0,381.0,381.0,0,0,0.0,0.0,0.0
61760.0,6,14,4740,7,653,10168.5,249.0,93.28571428571428,7,4087,9817.666666666666,1514.0,583.8571428571429
106040604.0,17,14,864,7,432,17667892.166666668,174.0,61.71428571428572,7,432,17666855.666666668,174.0,61.71428571428572
103142163.0,17,14,1126,7,563,17190360.5,174.0,80.42857142857143,7,563,17050488.166666668,174.0,80.42857142857143
54616.0,6,10,2032,5,524,13347.75,252.0,104.8,5,1508,11950.5,1236.0,301.6
4367.0,17,2,614,1,72,0.0,72.0,72.0,1,542,0.0,542.0,542.0
60564.0,6,14,4740,7,653,9022.0,249.0,93.28571428571428,7,4087,9683.333333333334,1514.0,583.8571428571429
220595.0,17,2,414,1,88,0.0,88.0,88.0,1,326,0.0,326.0,326.0
29276.0,6,10,2032,5,524,6576.5,252.0,104.8,5,1508,7080.75,1236.0,301.6
157042.0,6,3,337,2,214,0.0,160.0,107.0,1,123,0.0,123.0,123.0
108104186.0,17,5,955,5,955,27026046.5,191.0,191.0,0,0,0.0,0.0,0.0
4269.0,17,2,614,1,72,0.0,72.0,72.0,1,542,0.0,542.0,542.0
14917.0,17,2,180,1,90,0.0,90.0,90.0,1,90,0.0,90.0,90.0
300977.0,6,6,412,4,272,100325.66666666669,74.0,68.0,2,140,0.0,74.0,70.0
338.0,17,2,267,1,83,0.0,83.0,83.0,1,184,0.0,184.0,184.0
90067980.0,17,28,13364,28,13364,3335851.111111111,501.0,477.2857142857143,0,0,0.0,0.0,0.0
81999.0,6,14,4740,7,653,12220.666666666666,249.0,93.28571428571428,7,4087,12968.0,1514.0,583.8571428571429
108095122.0,17,5,1005,5,1005,27023780.5,201.0,201.0,0,0,0.0,0.0,0.0
120000040.0,6,17,1287,9,691,15000005.0,95.0,76.77777777777777,8,596,12896141.857142856,95.0,74.5
3091458.0,6,160,127044,89,118056,35130.204545454544,1510.0,1326.4719101123596,71,8988,39747.5,1510.0,126.59154929577464
206032.0,6,3,426,2,280,0.0,214.0,140.0,1,146,0.0,146.0,146.0
106559.0,17,2,700,2,700,0.0,350.0,350.0,0,0,0.0,0.0,0.0
114484388.0,6,48,3168,24,1584,4977582.0869565215,66.0,66.0,24,1584,4965737.0869565215,66.0,66.0
145145.0,17,2,180,1,70,0.0,70.0,70.0,1,110,0.0,110.0,110.0
2393.0,17,4,344,2,150,0.0,75.0,75.0,2,194,0.0,103.0,97.0
90736687.0,6,19,1436,10,745,10077181.333333334,95.0,74.5,9,691,11341068.625,95.0,76.77777777777777
196877.0,17,2,180,1,90,0.0,90.0,90.0,1,90,0.0,90.0,90.0
135188659.0,17,6,1146,6,1146,27037731.8,191.0,191.0,0,0,0.0,0.0,0.0
10555374.0,6,7,478,4,272,3472955.333333333,74.0,68.0,3,206,5209342.5,74.0,68.66666666666667
29490.0,6,10,2032,5,524,7132.0,252.0,104.8,5,1508,6599.5,1236.0,301.6
206031.0,6,3,426,2,280,0.0,214.0,140.0,1,146,0.0,146.0,146.0
46034.0,6,14,4740,7,653,7547.166666666667,249.0,93.28571428571428,7,4087,6290.833333333333,1514.0,583.8571428571429
113254657.0,6,46,3036,23,1518,5135435.2727272725,66.0,66.0,23,1518,5135428.5,66.0,66.0
90053698.0,17,28,13364,28,13364,3335322.1481481483,501.0,477.2857142857143,0,0,0.0,0.0,0.0
303277.0,6,6,412,4,272,101092.33333333331,74.0,68.0,2,140,0.0,74.0,70.0
207056.0,6,3,426,2,280,0.0,214.0,140.0,1,146,0.0,146.0,146.0
178186.0,17,2,180,1,90,0.0,90.0,90.0,1,90,0.0,90.0,90.0
25749.0,17,2,582,1,83,0.0,83.0,83.0,1,499,0.0,499.0,499.0
205920.0,17,2,180,1,90,0.0,90.0,90.0,1,90,0.0,90.0,90.0
2405.0,17,4,344,2,150,0.0,75.0,75.0,2,194,0.0,103.0,97.0
251505.0,6,3,337,2,214,0.0,160.0,107.0,1,123,0.0,123.0,123.0
100500576.0,17,13,821,7,432,16666800.0,174.0,61.71428571428572,6,389,20000824.4,174.0,64.83333333333333
2250.0,17,2,174,1,79,0.0,79.0,79.0,1,95,0.0,95.0,95.0
217479.0,6,3,426,2,280,0.0,214.0,140.0,1,146,0.0,146.0,146.0
108107707.0,17,5,1005,5,1005,27026926.75,201.0,201.0,0,0,0.0,0.0,0.0
135135465.0,17,6,1146,6,1146,27027093.0,191.0,191.0,0,0,0.0,0.0,0.0
2877278.0,6,12,2172,7,664,479546.3333333333,252.0,94.85714285714286,5,1508,1997.0,1236.0,301.6
1053687.0,6,3,1604,1,753,0.0,753.0,753.0,2,851,0.0,785.0,425.5
327.0,17,2,166,1,75,0.0,75.0,75.0,1,91,0.0,91.0,91.0
56599.0,6,10,2032,5,524,13760.25,252.0,104.8,5,1508,11879.5,1236.0,301.6
228115.0,17,2,180,1,90,0.0,90.0,90.0,1,90,0.0,90.0,90.0
3154.0,17,2,224,1,76,0.0,76.0,76.0,1,148,0.0,148.0,148.0
135133638.0,17,6,1206,6,1206,27026727.6,201.0,201.0,0,0,0.0,0.0,0.0
5622690.0,6,5,336,2,134,0.0,68.0,67.0,3,202,1418311.0,70.0,67.33333333333333
38686.0,6,10,2032,5,524,9449.5,252.0,104.8,5,1508,9441.75,1236.0,301.6
90091232.0,6,10,1440,7,828,15015205.333333334,188.0,118.28571428571428,3,612,30030574.5,204.0,204.0
307256.0,6,6,412,4,272,102418.66666666669,74.0,68.0,2,140,0.0,74.0,70.0
90010732.0,17,27,12943,27,12943,3461951.230769231,501.0,479.3703703703704,0,0,0.0,0.0,0.0
90292768.0,6,16,1192,8,596,12892407.714285716,95.0,74.5,8,596,12897141.857142856,95.0,74.5
147927.0,17,2,180,1,90,0.0,90.0,90.0,1,90,0.0,90.0,90.0
219457.0,6,3,426,2,280,0.0,214.0,140.0,1,146,0.0,146.0,146.0
104135.0,17,2,286,2,286,0.0,143.0,143.0,0,0,0.0,0.0,0.0
216386.0,17,2,180,1,90,0.0,90.0,90.0,1,90,0.0,90.0,90.0
90105494.0,6,11,1644,4,816,30031881.33333333,204.0,204.0,7,828,15017283.5,188.0,118.28571428571428
39516.0,6,14,4740,7,653,6375.5,249.0,93.28571428571428,7,4087,6354.666666666667,1514.0,583.8571428571429
332.0,17,2,166,1,75,0.0,75.0,75.0,1,91,0.0,91.0,91.0
135135248.0,17,6,1206,6,1206,27027049.6,201.0,201.0,0,0,0.0,0.0,0.0
116581278.0,6,38,2826,19,1455,6464754.444444444,123.0,76.57894736842105,19,1371,6464751.777777778,123.0,72.15789473684211
112830302.0,6,32,2236,16,1165,7522020.133333334,139.0,72.8125,16,1071,7507604.933333334,123.0,66.9375
0.0,6,1,60,1,60,0.0,60.0,60.0,0,0,0.0,0.0,0.0
100864071.0,17,12,778,6,389,19983284.0,174.0,64.83333333333333,6,389,20140792.6,174.0,64.83333333333333
90914226.0,6,21,1585,11,840,9091092.6,95.0,76.36363636363636,10,745,10101118.111111112,95.0,74.5
120126371.0,6,15,2428,9,1204,15015796.375,188.0,133.77777777777777,6,1224,18021878.8,204.0,204.0
309.0,17,2,208,1,72,0.0,72.0,72.0,1,136,0.0,136.0,136.0
322465.0,17,4,1400,4,1400,107488.33333333331,350.0,350.0,0,0,0.0,0.0,0.0
54286.0,6,14,4740,7,653,8797.166666666666,249.0,93.28571428571428,7,4087,8678.666666666666,1514.0,583.8571428571429
300287.0,6,6,412,4,272,100095.66666666669,74.0,68.0,2,140,0.0,74.0,70.0
228121.0,17,2,180,1,90,0.0,90.0,90.0,1,90,0.0,90.0,90.0
306906.0,6,6,412,4,272,102302.0,74.0,68.0,2,140,0.0,74.0,70.0
14046.0,6,10,1065,5,534,3154.0,262.0,106.8,5,531,3163.0,259.0,106.2
312761.0,17,4,622,4,622,104253.66666666669,163.0,155.5,0,0,0.0,0.0,0.0
84759.0,6,11,2098,6,590,15941.8,252.0,98.33333333333331,5,1508,20597.75,1236.0,301.6
37244.0,6,10,2032,5,524,8320.75,252.0,104.8,5,1508,8810.0,1236.0,301.6
108105120.0,17,5,1005,5,1005,27026280.0,201.0,201.0,0,0,0.0,0.0,0.0
95994928.0,6,274,32550,137,23286,704261.5220588235,464.0,169.97080291970804,137,9264,704262.4852941176,140.0,67.62043795620438
721.0,17,4,438,2,148,0.0,74.0,74.0,2,290,0.0,147.0,145.0
298087.0,6,6,412,4,272,99362.33333333331,74.0,68.0,2,140,0.0,74.0,70.0
10101.0,17,4,823,2,163,0.0,89.0,81.5,2,660,0.0,443.0,330.0
157787.0,17,2,180,1,90,0.0,90.0,90.0,1,90,0.0,90.0,90.0
10842515.0,6,8,544,4,272,3568748.0,74.0,68.0,4,272,3568674.333333333,74.0,68.0
209269.0,6,3,426,2,280,0.0,214.0,140.0,1,146,0.0,146.0,146.0
10511.0,17,4,823,2,163,0.0,89.0,81.5,2,660,0.0,443.0,330.0
112535444.0,6,46,3036,23,1518,5105435.863636363,66.0,66.0,23,1518,5105435.7727272725,66.0,66.0
10517219.0,6,7,478,4,272,3458671.0,74.0,68.0,3,206,5187901.0,74.0,68.66666666666667
38153.0,6,14,4740,7,653,6165.333333333333,249.0,93.28571428571428,7,4087,5712.5,1514.0,583.8571428571429
316601.0,17,4,1400,4,1400,105533.66666666669,350.0,350.0,0,0,0.0,0.0,0.0
130539.0,6,3,337,2,214,0.0,160.0,107.0,1,123,0.0,123.0,123.0
302377.0,6,2,132,1,66,0.0,66.0,66.0,1,66,0.0,66.0,66.0
838411.0,6,9,1118,6,586,167682.2,248.0,97.66666666666669,3,532,282883.0,392.0,177.33333333333334
120130245.0,6,16,2368,9,1204,14995132.125,188.0,133.77777777777777,7,1164,15014585.0,204.0,166.28571428571428
53111.0,6,14,4740,7,653,8738.333333333334,249.0,93.28571428571428,7,4087,7705.333333333333,1514.0,583.8571428571429
120132411.0,6,228,25756,114,7820,1055944.1769911505,140.0,68.59649122807018,114,17936,1058710.07079646,284.0,157.33333333333334
219059.0,6,3,426,2,280,0.0,214.0,140.0,1,146,0.0,146.0,146.0
833.0,17,4,438,2,148,0.0,74.0,74.0,2,290,0.0,147.0,145.0
90089654.0,6,12,1848,7,828,15014942.333333334,188.0,118.28571428571428,5,1020,15015702.0,204.0,204.0
28814.0,6,14,4740,7,653,3440.833333333333,249.0,93.28571428571428,7,4087,4661.666666666667,1514.0,583.8571428571429
120121901.0,6,224,25328,112,7614,1074769.8918918918,140.0,67.98214285714286,112,17714,1074975.3153153153,284.0,158.16071428571428
114186231.0,6,48,3168,24,1584,4964618.739130435,66.0,66.0,24,1584,4952641.478260869,66.0,66.0
98885277.0,6,153,17274,77,5304,1301122.0657894737,140.0,68.88311688311688,76,11970,1304547.12,284.0,157.5
135488.0,6,2,132,1,66,0.0,66.0,66.0,1,66,0.0,66.0,66.0
20181.0,17,2,582,1,83,0.0,83.0,83.0,1,499,0.0,499.0,499.0
1801.0,17,2,176,1,80,0.0,80.0,80.0,1,96,0.0,96.0,96.0
90741709.0,6,19,1436,10,745,10077244.111111112,95.0,74.5,9,691,11342261.875,95.0,76.77777777777777
42714.0,6,13,1479,7,882,6975.833333333333,291.0,126.0,6,597,7658.8,259.0,99.5
90044058.0,6,516,65802,258,48552,349564.9649805448,374.0,188.1860465116279,258,17250,349565.2451361868,140.0,66.86046511627907
0.0,17,1,90,1,90,0.0,90.0,90.0,0,0,0.0,0.0,0.0
306729.0,6,6,412,4,272,102243.0,74.0,68.0,2,140,0.0,74.0,70.0
98192.0,6,2,132,1,66,0.0,66.0,66.0,1,66,0.0,66.0,66.0
320.0,17,2,174,1,79,0.0,79.0,79.0,1,95,0.0,95.0,95.0
116821612.0,6,48,3168,24,1584,5079200.521739131,66.0,66.0,24,1584,5065991.217391305,66.0,66.0
315308.0,17,4,1400,4,1400,105102.66666666669,350.0,350.0,0,0,0.0,0.0,0.0
341.0,17,2,216,1,84,0.0,84.0,84.0,1,132,0.0,132.0,132.0
486874.0,6,10,1221,6,636,97374.8,298.0,106.0,4,585,156789.0,379.0,146.25
6001881.0,17,3,1359,3,1359,3000940.5,453.0,453.0,0,0,0.0,0.0,0.0
33261.0,6,14,4740,7,653,4617.666666666667,249.0,93.28571428571428,7,4087,5371.5,1514.0,583.8571428571429
1314524.0,6,4,264,2,132,0.0,66.0,66.0,2,132,0.0,66.0,66.0
153408.0,17,2,180,1,90,0.0,90.0,90.0,1,90,0.0,90.0,90.0
312538.0,17,4,1400,4,1400,104179.33333333331,350.0,350.0,0,0,0.0,0.0,0.0
199445.0,17,4,6056,4,6056,66481.66666666667,1514.0,1514.0,0,0,0.0,0.0,0.0
108102703.0,17,5,1005,5,1005,27025675.75,201.0,201.0,0,0,0.0,0.0,0.0
145086.0,17,2,180,1,70,0.0,70.0,70.0,1,110,0.0,110.0,110.0
120737242.0,6,226,25422,114,17808,1068471.168141593,284.0,156.21052631578948,112,7614,1074938.7117117117,140.0,67.98214285714286
108105140.0,17,5,955,5,955,27026285.0,191.0,191.0,0,0,0.0,0.0,0.0
300497.0,6,6,412,4,272,100165.66666666669,74.0,68.0,2,140,0.0,74.0,70.0
153410.0,17,2,180,1,90,0.0,90.0,90.0,1,90,0.0,90.0,90.0
302383.0,6,6,412,4,272,100794.33333333331,74.0,68.0,2,140,0.0,74.0,70.0
1574229.0,6,7,499,3,198,716967.0,66.0,66.0,4,301,472421.6666666667,103.0,75.25
90284855.0,6,14,1043,7,542,15047475.833333334,95.0,77.42857142857143,7,501,14997556.333333334,95.0,71.57142857142857
128074.0,6,2,132,1,66,0.0,66.0,66.0,1,66,0.0,66.0,66.0
198783.0,17,2,180,1,90,0.0,90.0,90.0,1,90,0.0,90.0,90.0
103487.0,17,2,286,2,286,0.0,143.0,143.0,0,0,0.0,0.0,0.0
120050555.0,17,28,13364,28,13364,4446316.851851852,501.0,477.2857142857143,0,0,0.0,0.0,0.0
304500.0,6,11,1114,6,549,60206.6,211.0,91.5,5,565,74683.25,293.0,113.0
152159.0,17,2,414,1,88,0.0,88.0,88.0,1,326,0.0,326.0,326.0
135146477.0,17,6,1146,6,1146,27029295.4,191.0,191.0,0,0,0.0,0.0,0.0
120036598.0,17,28,13364,28,13364,4445799.925925926,501.0,477.2857142857143,0,0,0.0,0.0,0.0
162322.0,17,2,180,1,90,0.0,90.0,90.0,1,90,0.0,90.0,90.0
211668.0,6,12,1373,7,714,35278.0,298.0,102.0,5,659,51981.75,379.0,131.8
141899.0,17,2,176,1,80,0.0,80.0,80.0,1,96,0.0,96.0,96.0
35337.0,6,14,4740,7,653,5724.166666666667,249.0,93.28571428571428,7,4087,4590.166666666667,1514.0,583.8571428571429
2832921.0,6,2,132,1,66,0.0,66.0,66.0,1,66,0.0,66.0,66.0
62111.0,6,13,1386,7,789,10351.833333333334,253.0,112.71428571428572,6,597,9819.8,259.0,99.5
97588.0,6,14,4740,7,653,16078.666666666666,249.0,93.28571428571428,7,4087,15127.5,1514.0,583.8571428571429
10498046.0,6,7,478,4,272,3453843.0,74.0,68.0,3,206,5180629.0,74.0,68.66666666666667
315929.0,17,4,1400,4,1400,105309.66666666669,350.0,350.0,0,0,0.0,0.0,0.0
166846.0,17,2,180,1,90,0.0,90.0,90.0,1,90,0.0,90.0,90.0
169426.0,6,11,1132,6,556,32952.2,218.0,92.66666666666669,5,576,42151.0,304.0,115.2
109580445.0,17,14,864,7,432,18236785.0,174.0,61.71428571428572,7,432,18191423.83333333,174.0,61.71428571428572
90260528.0,6,13,2036,8,1016,12894361.142857144,188.0,127.0,5,1020,22524498.5,204.0,204.0
2825196.0,6,12,2172,7,664,470666.8333333333,252.0,94.85714285714286,5,1508,1861.75,1236.0,301.6
355.0,17,2,160,1,80,0.0,80.0,80.0,1,80,0.0,80.0,80.0
327.0,17,2,160,1,80,0.0,80.0,80.0,1,80,0.0,80.0,80.0
511683.0,6,4,270,2,134,0.0,68.0,67.0,2,136,0.0,70.0,68.0
19594.0,6,14,4740,7,653,3062.6666666666665,249.0,93.28571428571428,7,4087,3133.1666666666665,1514.0,583.8571428571429
145331.0,17,2,180,1,70,0.0,70.0,70.0,1,110,0.0,110.0,110.0
2896100.0,6,12,2172,7,664,482560.5,252.0,94.85714285714286,5,1508,3203.5,1236.0,301.6
23008178.0,17,3,1034,2,684,0.0,342.0,342.0,1,350,0.0,350.0,350.0
449.0,17,2,267,1,83,0.0,83.0,83.0,1,184,0.0,184.0,184.0
107737367.0,6,44,2904,22,1452,5130350.80952381,66.0,66.0,22,1452,5115592.0,66.0,66.0
27751118.0,17,5,1710,5,1710,6937779.5,342.0,342.0,0,0,0.0,0.0,0.0
2051.0,17,4,344,2,150,0.0,75.0,75.0,2,194,0.0,103.0,97.0
302391.0,6,2,132,1,66,0.0,66.0,66.0,1,66,0.0,66.0,66.0
90529223.0,6,17,2572,9,1204,11316152.875,188.0,133.77777777777777,8,1368,12909629.0,204.0,171.0
120039274.0,6,47,3102,23,1518,5144012.0,66.0,66.0,24,1584,5219087.869565218,66.0,66.0
201862.0,17,2,180,1,90,0.0,90.0,90.0,1,90,0.0,90.0,90.0
106155252.0,17,14,864,7,432,17668840.166666668,174.0,61.71428571428572,7,432,17666833.833333332,174.0,61.71428571428572
30720.0,6,14,4740,7,653,4683.833333333333,249.0,93.28571428571428,7,4087,4982.0,1514.0,583.8571428571429
225089.0,6,13,1386,7,789,37514.833333333336,253.0,112.71428571428572,6,597,43455.0,259.0,99.5
325.0,17,2,166,1,75,0.0,75.0,75.0,1,91,0.0,91.0,91.0
366349.0,6,11,1021,6,444,49437.8,162.0,74.0,5,577,61714.5,349.0,115.4
102579871.0,6,43,2838,22,1452,4884743.904761905,66.0,66.0,21,1386,5111997.2,66.0,66.0
90037066.0,17,28,13364,28,13364,3334706.1481481483,501.0,477.2857142857143,0,0,0.0,0.0,0.0
117954020.0,6,212,23880,106,16650,1121321.6857142858,284.0,157.0754716981132,106,7230,1121319.857142857,140.0,68.20754716981132
42927.0,6,14,4740,7,653,7028.166666666667,249.0,93.28571428571428,7,4087,6139.666666666667,1514.0,583.8571428571429
113369833.0,6,48,3168,24,1584,4929123.173913044,66.0,66.0,24,1584,4919725.652173913,66.0,66.0
10121.0,17,2,582,1,83,0.0,83.0,83.0,1,499,0.0,499.0,499.0
251141.0,6,3,337,2,214,0.0,160.0,107.0,1,123,0.0,123.0,123.0
2593955.0,6,2,132,1,66,0.0,66.0,66.0,1,66,0.0,66.0,66.0
43793.0,6,14,4740,7,653,7172.833333333333,249.0,93.28571428571428,7,4087,6899.0,1514.0,583.8571428571429
98342197.0,6,29,2046,15,1017,7024442.642857143,123.0,67.8,14,1029,6779973.0,123.0,73.5
153446.0,17,2,180,1,90,0.0,90.0,90.0,1,90,0.0,90.0,90.0
104952.0,17,2,700,2,700,0.0,350.0,350.0,0,0,0.0,0.0,0.0
209528.0,17,2,180,1,90,0.0,90.0,90.0,1,90,0.0,90.0,90.0
10868169.0,6,8,544,4,272,3577136.6666666665,74.0,68.0,4,272,3577085.6666666665,74.0,68.0
120123551.0,6,14,2224,9,1204,15015443.875,188.0,133.77777777777777,5,1020,22524447.75,204.0,204.0
40751.0,6,14,4740,7,653,4495.5,249.0,93.28571428571428,7,4087,5879.0,1514.0,583.8571428571429
966696.0,17,10,3776,10,3776,107410.66666666669,394.0,377.6,0,0,0.0,0.0,0.0
37794.0,6,14,4740,7,653,6022.333333333333,249.0,93.28571428571428,7,4087,6075.333333333333,1514.0,583.8571428571429
4422.0,17,2,614,1,72,0.0,72.0,72.0,1,542,0.0,542.0,542.0
10417927.0,6,6,412,3,206,5141114.0,74.0,68.66666666666667,3,206,5140988.0,74.0,68.66666666666667
3004778.0,6,12,2172,7,664,500419.3333333333,252.0,94.85714285714286,5,1508,2192.25,1236.0,301.6
52461.0,6,14,4740,7,653,8269.5,249.0,93.28571428571428,7,4087,8368.0,1514.0,583.8571428571429
322.0,17,2,174,1,79,0.0,79.0,79.0,1,95,0.0,95.0,95.0
120276605.0,6,19,1477,10,786,13333329.444444444,95.0,78.6,9,691,15033466.875,95.0,76.77777777777777
143448.0,6,2,132,1,66,0.0,66.0,66.0,1,66,0.0,66.0,66.0
26621999.0,17,5,1718,4,1368,940137.3333333334,342.0,342.0,1,350,0.0,350.0,350.0
116439257.0,6,34,2334,17,1209,7263953.3125,123.0,71.11764705882354,17,1125,7263952.6875,123.0,66.17647058823529
116468496.0,6,232,26072,116,18120,1010898.6869565216,284.0,156.20689655172413,116,7952,1010897.6782608696,140.0,68.55172413793103
16381.0,6,11,1133,6,602,2065.2,264.0,100.33333333333331,5,531,3856.0,259.0,106.2
90030145.0,17,28,13364,28,13364,3334449.814814815,501.0,477.2857142857143,0,0,0.0,0.0,0.0
212680.0,17,2,180,1,90,0.0,90.0,90.0,1,90,0.0,90.0,90.0
135141217.0,17,6,1146,6,1146,27028243.4,191.0,191.0,0,0,0.0,0.0,0.0
1320794.0,6,4,264,2,132,0.0,66.0,66.0,2,132,0.0,66.0,66.0
2038.0,17,4,344,2,150,0.0,75.0,75.0,2,194,0.0,103.0,97.0
160192.0,17,2,180,1,90,0.0,90.0,90.0,1,90,0.0,90.0,90.0
90255196.0,6,12,1832,8,1016,12893599.42857143,188.0,127.0,4,816,30029351.666666668,204.0,204.0
1350292.0,17,16,1120,16,1120,90019.46666666666,70.0,70.0,0,0,0.0,0.0,0.0
2357.0,17,4,344,2,150,0.0,75.0,75.0,2,194,0.0,103.0,97.0
36838.0,6,10,2032,5,524,8478.5,252.0,104.8,5,1508,8627.5,1236.0,301.6
206684.0,17,2,180,1,90,0.0,90.0,90.0,1,90,0.0,90.0,90.0
2319.0,17,4,344,2,150,0.0,75.0,75.0,2,194,0.0,103.0,97.0
786.0,17,4,438,2,148,0.0,74.0,74.0,2,290,0.0,147.0,145.0
90290731.0,6,16,1192,8,596,12892826.0,95.0,74.5,8,596,12897141.0,95.0,74.5
103263.0,17,2,286,2,286,0.0,143.0,143.0,0,0,0.0,0.0,0.0
217864.0,6,3,426,2,280,0.0,214.0,140.0,1,146,0.0,146.0,146.0
120737917.0,6,47,3102,23,1518,5144006.954545454,66.0,66.0,24,1584,5249463.304347826,66.0,66.0
3073.0,17,2,224,1,76,0.0,76.0,76.0,1,148,0.0,148.0,148.0
3013039.0,6,11,2106,6,598,602369.2,252.0,99.66666666666669,5,1508,2787.5,1236.0,301.6
162214.0,17,2,180,1,90,0.0,90.0,90.0,1,90,0.0,90.0,90.0
52373.0,6,14,4740,7,653,8567.0,249.0,93.28571428571428,7,4087,7621.833333333333,1514.0,583.8571428571429
1303713.0,17,7,490,7,490,217285.5,70.0,70.0,0,0,0.0,0.0,0.0
321714.0,17,4,1400,4,1400,107238.0,350.0,350.0,0,0,0.0,0.0,0.0
250523.0,6,10,1221,6,636,50104.6,298.0,106.0,4,585,77702.0,379.0,146.25
235687.0,6,3,337,2,214,0.0,160.0,107.0,1,123,0.0,123.0,123.0
10620.0,6,10,1066,5,490,2417.0,218.0,98.0,5,576,2435.0,304.0,115.2
153387.0,17,2,180,1,90,0.0,90.0,90.0,1,90,0.0,90.0,90.0
103009100.0,17,13,821,7,432,17168183.333333332,174.0,61.71428571428572,6,389,19846926.2,174.0,64.83333333333333
321.0,17,2,174,1,79,0.0,79.0,79.0,1,95,0.0,95.0,95.0
26919943.0,17,5,1718,4,1368,969040.3333333334,342.0,342.0,1,350,0.0,350.0,350.0
120148226.0,6,220,24884,110,7556,1094502.3486238532,140.0,68.69090909090909,110,17328,1094618.3394495412,284.0,157.52727272727273
400554.0,6,3,1604,2,851,0.0,785.0,425.5,1,753,0.0,753.0,753.0
37380.0,6,14,4740,7,653,6054.833333333333,249.0,93.28571428571428,7,4087,6086.833333333333,1514.0,583.8571428571429
1306948.0,6,4,264,2,132,0.0,66.0,66.0,2,132,0.0,66.0,66.0
2708161.0,6,32,10926,18,3951,159303.58823529413,1514.0,219.5,14,6975,188325.84615384616,1514.0,498.2142857142857
135136320.0,17,6,1206,6,1206,27027264.0,201.0,201.0,0,0,0.0,0.0,0.0
240477.0,6,3,337,2,214,0.0,160.0,107.0,1,123,0.0,123.0,123.0
49900.0,6,14,4740,7,653,8130.333333333333,249.0,93.28571428571428,7,4087,6773.5,1514.0,583.8571428571429
299908.0,6,6,412,4,272,99969.33333333331,74.0,68.0,2,140,0.0,74.0,70.0
503940.00000000006,6,4,270,2,134,0.0,68.0,67.0,2,136,0.0,70.0,68.0
205881.0,6,3,426,2,280,0.0,214.0,140.0,1,146,0.0,146.0,146.0
120957053.0,6,34,2472,18,1332,7115120.764705882,123.0,74.0,16,1140,7384505.666666667,123.0,71.25
121168.0,6,3,337,2,214,0.0,160.0,107.0,1,123,0.0,123.0,123.0
228394.0,17,2,180,1,90,0.0,90.0,90.0,1,90,0.0,90.0,90.0
1307115.0,6,4,264,2,132,0.0,66.0,66.0,2,132,0.0,66.0,66.0
1856051.0,6,2,132,1,66,0.0,66.0,66.0,1,66,0.0,66.0,66.0
57041.0,6,14,4740,7,653,8775.0,249.0,93.28571428571428,7,4087,7337.333333333333,1514.0,583.8571428571429
132739.0,6,2,132,1,66,0.0,66.0,66.0,1,66,0.0,66.0,66.0
120028601.0,17,29,13785,29,13785,4286735.75,501.0,475.3448275862069,0,0,0.0,0.0,0.0
116000947.0,17,15,1169,8,606,16571563.857142856,174.0,75.75,7,563,17462831.333333332,174.0,80.42857142857143
228350.0,17,2,180,1,90,0.0,90.0,90.0,1,90,0.0,90.0,90.0
123416412.0,6,48,3168,24,1584,5056023.739130435,66.0,66.0,24,1584,5245551.739130435,66.0,66.0
63097.0,6,14,4740,7,653,10000.166666666666,249.0,93.28571428571428,7,4087,8069.5,1514.0,583.8571428571429
283140.0,17,2,180,1,90,0.0,90.0,90.0,1,90,0.0,90.0,90.0
1808836.0,17,2,876,2,876,0.0,438.0,438.0,0,0,0.0,0.0,0.0
39274.0,6,10,2032,5,524,9586.25,252.0,104.8,5,1508,9564.5,1236.0,301.6
2433.0,17,4,344,2,150,0.0,75.0,75.0,2,194,0.0,103.0,97.0
27553.0,6,10,2032,5,524,6330.25,252.0,104.8,5,1508,6008.5,1236.0,301.6
90002819.0,6,15,1097,8,596,12857545.57142857,95.0,74.5,7,501,14949439.166666666,95.0,71.57142857142857
269673.0,17,4,1400,4,1400,89891.0,350.0,350.0,0,0,0.0,0.0,0.0
5623851.0,6,5,336,2,134,0.0,68.0,67.0,3,202,1526875.5,70.0,67.33333333333333
404694.0,6,4,508,2,238,0.0,172.0,119.0,2,270,0.0,135.0,135.0
146217.0,6,3,337,2,214,0.0,160.0,107.0,1,123,0.0,123.0,123.0
1158056.0,6,13,3010,8,2382,165436.57142857142,1514.0,297.75,5,628,221342.0,331.0,125.6
90035414.0,17,28,13364,28,13364,3334644.962962963,501.0,477.2857142857143,0,0,0.0,0.0,0.0
2068.0,17,4,344,2,150,0.0,75.0,75.0,2,194,0.0,103.0,97.0
103528.0,17,2,700,2,700,0.0,350.0,350.0,0,0,0.0,0.0,0.0
4998942.0,17,4,849,2,166,0.0,83.0,83.0,2,683,0.0,499.0,341.5
153365.0,17,2,180,1,90,0.0,90.0,90.0,1,90,0.0,90.0,90.0
2364.0,17,4,344,2,150,0.0,75.0,75.0,2,194,0.0,103.0,97.0
118005719.0,17,15,1169,8,606,16857959.85714286,174.0,75.75,7,563,17503818.333333332,174.0,80.42857142857143
207805.0,6,3,426,2,280,0.0,214.0,140.0,1,146,0.0,146.0,146.0
10473521.0,6,7,478,4,272,3445993.6666666665,74.0,68.0,3,206,5168881.0,74.0,68.66666666666667
95100532.0,6,168,19090,84,13324,1143195.9277108433,374.0,158.61904761904762,84,5766,1143196.3253012048,140.0,68.64285714285714
52737.0,6,14,4740,7,653,7255.666666666667,249.0,93.28571428571428,7,4087,7991.666666666667,1514.0,583.8571428571429
10009.0,17,2,571,1,86,0.0,86.0,86.0,1,485,0.0,485.0,485.0
2153622.0,6,19,6869,10,1501,239291.3333333333,408.0,150.1,9,5368,226571.0,1514.0,596.4444444444445
306106.0,6,3,202,2,128,0.0,74.0,64.0,1,74,0.0,74.0,74.0
1231931.0,17,7,490,7,490,205321.8333333333,70.0,70.0,0,0,0.0,0.0,0.0
101273847.0,17,14,864,7,432,16833506.5,174.0,61.71428571428572,7,432,16834252.5,174.0,61.71428571428572
48893.0,6,14,4740,7,653,7814.333333333333,249.0,93.28571428571428,7,4087,7782.333333333333,1514.0,583.8571428571429
90259097.0,6,12,1832,8,1016,12894156.714285716,188.0,127.0,4,816,30029479.33333333,204.0,204.0
119521871.0,6,232,26216,116,18338,1037536.5739130436,284.0,158.08620689655172,116,7878,1037536.4695652174,140.0,67.91379310344827
197352.0,17,2,180,1,90,0.0,90.0,90.0,1,90,0.0,90.0,90.0
120011558.0,6,22,1680,12,894,10910141.636363637,95.0,74.5,10,786,13284260.888888888,95.0,78.6
77427.0,6,14,4740,7,653,12100.666666666666,249.0,93.28571428571428,7,4087,12748.0,1514.0,583.8571428571429
146000.0,6,3,337,2,214,0.0,160.0,107.0,1,123,0.0,123.0,123.0
135127623.0,17,6,1146,6,1146,27025524.6,191.0,191.0,0,0,0.0,0.0,0.0
102696872.0,6,36,3126,21,1764,5123529.3,123.0,84.0,15,1362,7320087.0,123.0,90.8
228607.0,17,2,180,1,90,0.0,90.0,90.0,1,90,0.0,90.0,90.0
47251.0,6,10,2032,5,524,11547.5,252.0,104.8,5,1508,11382.75,1236.0,301.6
972494.0,6,13,1428,7,797,161703.66666666666,253.0,113.85714285714286,6,631,194075.2,293.0,105.16666666666669
108110747.0,17,5,955,5,955,27027686.75,191.0,191.0,0,0,0.0,0.0,0.0
15855264.0,6,24,9017,12,1983,1441387.6363636365,408.0,165.25,12,7034,1066940.7272727273,1514.0,586.1666666666666
161498.0,6,13,1386,7,789,26916.33333333333,253.0,112.71428571428572,6,597,31424.0,259.0,99.5
59459.0,6,10,2032,5,524,11160.75,252.0,104.8,5,1508,14491.25,1236.0,301.6
107843124.0,6,28,1860,14,966,8295624.923076923,123.0,69.0,14,894,8278976.153846154,123.0,63.85714285714285
21432.0,17,2,582,1,83,0.0,83.0,83.0,1,499,0.0,499.0,499.0
28658.0,6,14,4740,7,653,4526.333333333333,249.0,93.28571428571428,7,4087,4570.833333333333,1514.0,583.8571428571429
304140.0,6,6,412,4,272,101380.0,74.0,68.0,2,140,0.0,74.0,70.0
123610561.0,6,49,3234,25,1650,5150440.041666667,66.0,66.0,24,1584,5033332.652173913,66.0,66.0
123416607.0,6,48,3168,24,1584,5002769.826086956,66.0,66.0,24,1584,5298813.391304348,66.0,66.0
10526712.0,6,7,478,4,272,3463461.333333333,74.0,68.0,3,206,5195102.5,74.0,68.66666666666667
25918.0,6,14,4740,7,653,3693.1666666666665,249.0,93.28571428571428,7,4087,4018.1666666666665,1514.0,583.8571428571429
307101.0,6,6,412,4,272,102367.0,74.0,68.0,2,140,0.0,74.0,70.0
119722142.0,6,732,93490,366,24452,328001.1506849315,140.0,66.80874316939891,366,69038,327959.5232876712,464.0,188.62841530054644
218097.0,6,3,426,2,280,0.0,214.0,140.0,1,146,0.0,146.0,146.0
303708.0,6,2,132,1,66,0.0,66.0,66.0,1,66,0.0,66.0,66.0
90258767.0,6,13,2036,8,1016,12894109.57142857,188.0,127.0,5,1020,22523629.25,204.0,204.0
857411.0,6,9,1270,6,799,171482.2,461.0,133.16666666666666,3,471,292443.0,331.0,157.0
120051194.0,17,28,13364,28,13364,4446340.518518519,501.0,477.2857142857143,0,0,0.0,0.0,0.0
208890.0,6,3,426,2,280,0.0,214.0,140.0,1,146,0.0,146.0,146.0
218052.0,6,3,426,2,280,0.0,214.0,140.0,1,146,0.0,146.0,146.0
62641.0,6,14,4740,7,653,10329.5,249.0,93.28571428571428,7,4087,8127.666666666667,1514.0,583.8571428571429
216750.0,6,3,426,2,280,0.0,214.0,140.0,1,146,0.0,146.0,146.0
23433.0,6,10,2032,5,524,5646.5,252.0,104.8,5,1508,5590.5,1236.0,301.6
122687699.0,6,48,3168,24,1584,4976129.217391305,66.0,66.0,24,1584,5232189.739130435,66.0,66.0
2002784.0,17,4,525,2,150,0.0,75.0,75.0,2,375,0.0,284.0,187.5
108107798.0,17,5,955,5,955,27026949.5,191.0,191.0,0,0,0.0,0.0,0.0
59916.0,6,14,4740,7,653,9784.5,249.0,93.28571428571428,7,4087,9781.166666666666,1514.0,583.8571428571429
94199189.0,6,29,2068,15,1105,6713100.642857143,139.0,73.66666666666667,14,963,7229482.615384615,123.0,68.78571428571429
281414.0,17,2,363,1,79,0.0,79.0,79.0,1,284,0.0,284.0,284.0
90259125.0,6,13,2036,8,1016,12894160.714285716,188.0,127.0,5,1020,22523733.75,204.0,204.0
0.0,17,1,381,1,381,0.0,381.0,381.0,0,0,0.0,0.0,0.0
137085.0,6,2,132,1,66,0.0,66.0,66.0,1,66,0.0,66.0,66.0
120156782.0,6,16,2230,9,1204,14994872.5,188.0,133.77777777777777,7,1026,15021375.5,204.0,146.57142857142858
283889.0,17,2,363,1,79,0.0,79.0,79.0,1,284,0.0,284.0,284.0
135130925.0,17,6,1206,6,1206,27026185.0,201.0,201.0,0,0,0.0,0.0,0.0
30482.0,6,14,4740,7,653,4595.5,249.0,93.28571428571428,7,4087,4829.666666666667,1514.0,583.8571428571429
241762.0,6,3,337,2,214,0.0,160.0,107.0,1,123,0.0,123.0,123.0
2813943.0,6,2,132,1,66,0.0,66.0,66.0,1,66,0.0,66.0,66.0
103921.0,17,2,286,2,286,0.0,143.0,143.0,0,0,0.0,0.0,0.0
201523.0,17,4,6056,4,6056,67174.33333333333,1514.0,1514.0,0,0,0.0,0.0,0.0
0.0,17,1,44,1,44,0.0,44.0,44.0,0,0,0.0,0.0,0.0
90293771.0,6,16,1192,8,596,12892746.714285716,95.0,74.5,8,596,12897695.142857144,95.0,74.5
143945.0,17,2,180,1,90,0.0,90.0,90.0,1,90,0.0,90.0,90.0
261996.0,6,10,1221,6,636,52399.2,298.0,106.0,4,585,79678.0,379.0,146.25
2795277.0,6,2,132,1,66,0.0,66.0,66.0,1,66,0.0,66.0,66.0
103306971.0,6,643,89640,322,68232,321828.57009345794,480.0,211.9006211180124,321,21408,322108.85625,140.0,66.69158878504673
90050478.0,17,28,13364,28,13364,3335202.888888889,501.0,477.2857142857143,0,0,0.0,0.0,0.0
2340.0,17,4,344,2,150,0.0,75.0,75.0,2,194,0.0,103.0,97.0
135131430.0,17,6,1146,6,1146,27026286.0,191.0,191.0,0,0,0.0,0.0,0.0
653246.0,6,4,508,2,238,0.0,172.0,119.0,2,270,0.0,135.0,135.0
34481.0,6,14,4740,7,653,4756.5,249.0,93.28571428571428,7,4087,5554.666666666667,1514.0,583.8571428571429
4237.0,17,2,598,1,72,0.0,72.0,72.0,1,526,0.0,526.0,526.0
216402.0,17,2,180,1,90,0.0,90.0,90.0,1,90,0.0,90.0,90.0
3173970.0,6,18,1536,9,962,358388.125,315.0,106.88888888888889,9,574,358361.0,78.0,63.77777777777778
153405.0,17,2,180,1,90,0.0,90.0,90.0,1,90,0.0,90.0,90.0
11223.0,6,10,2032,5,524,2459.25,252.0,104.8,5,1508,2451.25,1236.0,301.6
207672.0,6,10,1221,6,636,41534.4,298.0,106.0,4,585,67956.33333333333,379.0,146.25
126788283.0,17,14,864,7,432,17834317.666666668,174.0,61.71428571428572,7,432,17833499.0,174.0,61.71428571428572
7440.0,17,2,582,1,83,0.0,83.0,83.0,1,499,0.0,499.0,499.0
253899.0,17,4,6056,4,6056,84633.0,1514.0,1514.0,0,0,0.0,0.0,0.0
246212.0,6,3,337,2,214,0.0,160.0,107.0,1,123,0.0,123.0,123.0
305722.0,6,6,412,4,272,101907.33333333331,74.0,68.0,2,140,0.0,74.0,70.0
1399941.0,17,16,1120,16,1120,93329.4,70.0,70.0,0,0,0.0,0.0,0.0
0.0,17,1,72,1,72,0.0,72.0,72.0,0,0,0.0,0.0,0.0
16823.0,17,2,180,1,90,0.0,90.0,90.0,1,90,0.0,90.0,90.0
90070453.0,17,27,12943,27,12943,3464248.1923076925,501.0,479.3703703703704,0,0,0.0,0.0,0.0
10509104.0,6,7,478,4,272,3457694.333333333,74.0,68.0,3,206,5186451.5,74.0,68.66666666666667
113624385.0,6,47,3102,23,1518,5160000.090909091,66.0,66.0,24,1584,4940180.043478261,66.0,66.0
49263.0,6,10,2032,5,524,11780.75,252.0,104.8,5,1508,11942.5,1236.0,301.6
118235977.0,6,35,2526,18,1332,6955057.470588235,123.0,74.0,17,1194,7376243.125,123.0,70.23529411764706
56236.0,6,14,4740,7,653,9216.166666666666,249.0,93.28571428571428,7,4087,7299.0,1514.0,583.8571428571429
196947.0,17,2,180,1,90,0.0,90.0,90.0,1,90,0.0,90.0,90.0
2422.0,17,4,344,2,150,0.0,75.0,75.0,2,194,0.0,103.0,97.0
105839581.0,6,178,20078,89,6170,1193311.806818182,140.0,69.32584269662921,89,13908,1195873.6363636365,284.0,156.26966292134833
50744.0,17,2,180,1,90,0.0,90.0,90.0,1,90,0.0,90.0,90.0
90300433.0,6,16,1192,8,596,12893545.142857144,95.0,74.5,8,596,12899031.857142856,95.0,74.5
31994.0,6,14,4740,7,653,5191.166666666667,249.0,93.28571428571428,7,4087,5179.0,1514.0,583.8571428571429
103144415.0,17,14,1126,7,563,17166850.166666668,174.0,80.42857142857143,7,563,17167421.5,174.0,80.42857142857143
446750.0,17,4,360,2,140,0.0,70.0,70.0,2,220,0.0,110.0,110.0
36116.0,6,10,2032,5,524,7429.25,252.0,104.8,5,1508,8644.25,1236.0,301.6
302.0,17,2,164,1,82,0.0,82.0,82.0,1,82,0.0,82.0,82.0
90307415.0,6,16,1192,8,596,12893773.57142857,95.0,74.5,8,596,12900545.714285716,95.0,74.5
196990.0,17,2,180,1,90,0.0,90.0,90.0,1,90,0.0,90.0,90.0
91982611.0,6,29,2062,15,1017,6570153.785714285,123.0,67.8,14,1045,6307485.153846154,139.0,74.64285714285714
103951.0,17,2,762,2,762,0.0,381.0,381.0,0,0,0.0,0.0,0.0
35654.0,6,10,2032,5,524,8664.75,252.0,104.8,5,1508,8636.5,1236.0,301.6
153504.0,17,2,180,1,90,0.0,90.0,90.0,1,90,0.0,90.0,90.0
205335.0,6,3,337,2,214,0.0,160.0,107.0,1,123,0.0,123.0,123.0
98488779.0,6,30,2106,15,1089,7034912.785714285,123.0,72.6,15,1017,7019478.214285715,123.0,67.8
10464763.0,6,7,478,4,272,3442786.333333333,74.0,68.0,3,206,5164049.0,74.0,68.66666666666667
34723594.0,6,5,336,2,134,0.0,68.0,67.0,3,202,17291624.0,70.0,67.33333333333333
326020.0,17,4,1400,4,1400,108673.33333333331,350.0,350.0,0,0,0.0,0.0,0.0
38783.0,6,14,4740,7,653,6343.166666666667,249.0,93.28571428571428,7,4087,6118.5,1514.0,583.8571428571429
33824.0,6,14,4740,7,653,5481.166666666667,249.0,93.28571428571428,7,4087,5335.0,1514.0,583.8571428571429
103234.0,17,2,286,2,286,0.0,143.0,143.0,0,0,0.0,0.0,0.0
91530954.0,17,14,1126,7,563,15167524.166666666,174.0,80.42857142857143,7,563,15166826.166666666,174.0,80.42857142857143
93920862.0,6,40,2640,20,1320,4943203.263157895,66.0,66.0,20,1320,4925938.421052632,66.0,66.0
149685.0,17,2,180,1,70,0.0,70.0,70.0,1,110,0.0,110.0,110.0
322350.0,6,6,412,4,272,107450.0,74.0,68.0,2,140,0.0,74.0,70.0
705769.0,6,2,132,1,66,0.0,66.0,66.0,1,66,0.0,66.0,66.0
363.0,17,2,160,1,80,0.0,80.0,80.0,1,80,0.0,80.0,80.0
146163.0,6,3,337,2,214,0.0,160.0,107.0,1,123,0.0,123.0,123.0
305493.0,6,6,412,4,272,101831.0,74.0,68.0,2,140,0.0,74.0,70.0
108818974.0,6,33,2428,17,1288,6787684.625,139.0,75.76470588235294,16,1140,7240192.8,123.0,71.25
98789318.0,6,40,2640,20,1320,5199437.7894736845,66.0,66.0,20,1320,5183145.421052632,66.0,66.0
48056.0,6,14,4740,7,653,7155.833333333333,249.0,93.28571428571428,7,4087,7830.5,1514.0,583.8571428571429
298021.0,6,6,412,4,272,99340.33333333331,74.0,68.0,2,140,0.0,74.0,70.0
123778377.0,6,51,4183,27,2266,4760706.807692308,139.0,83.92592592592592,24,1917,5035030.565217392,123.0,79.875
10875.0,17,4,438,2,148,0.0,74.0,74.0,2,290,0.0,147.0,145.0
90303905.0,6,16,1192,8,596,12894036.285714284,95.0,74.5,8,596,12898842.142857144,95.0,74.5
247720.0,17,4,6056,4,6056,82573.33333333333,1514.0,1514.0,0,0,0.0,0.0,0.0
14828.0,17,2,180,1,90,0.0,90.0,90.0,1,90,0.0,90.0,90.0
28701.0,6,10,2032,5,524,6208.5,252.0,104.8,5,1508,6754.0,1236.0,301.6
28363.0,6,14,4740,7,653,4549.833333333333,249.0,93.28571428571428,7,4087,4102.333333333333,1514.0,583.8571428571429
118375880.0,17,14,864,7,432,19666818.33333333,174.0,61.71428571428572,7,432,19667785.0,174.0,61.71428571428572
232280.0,6,3,337,2,214,0.0,160.0,107.0,1,123,0.0,123.0,123.0
232127.0,6,3,337,2,214,0.0,160.0,107.0,1,123,0.0,123.0,123.0
266036.0,6,10,1221,6,636,53207.2,298.0,106.0,4,585,83286.66666666667,379.0,146.25
2357.0,17,4,344,2,150,0.0,75.0,75.0,2,194,0.0,103.0,97.0
35938.0,6,10,2032,5,524,8733.75,252.0,104.8,5,1508,8738.5,1236.0,301.6
74910.0,6,14,4740,7,653,12281.666666666666,249.0,93.28571428571428,7,4087,11664.0,1514.0,583.8571428571429
1301888.0,6,4,264,2,132,0.0,66.0,66.0,2,132,0.0,66.0,66.0
135138289.0,17,6,1146,6,1146,27027657.8,191.0,191.0,0,0,0.0,0.0,0.0
65338.99999999999,6,14,4740,7,653,10764.666666666666,249.0,93.28571428571428,7,4087,10689.5,1514.0,583.8571428571429
302071.0,6,6,412,4,272,100690.33333333331,74.0,68.0,2,140,0.0,74.0,70.0
4797624.0,6,5,336,2,134,0.0,68.0,67.0,3,202,1525483.5,70.0,67.33333333333333
209587.0,17,2,180,1,90,0.0,90.0,90.0,1,90,0.0,90.0,90.0
88547.0,6,10,1066,5,490,21661.0,218.0,98.0,5,576,21927.25,304.0,115.2
44643.0,6,14,4740,7,653,7070.333333333333,249.0,93.28571428571428,7,4087,5549.0,1514.0,583.8571428571429
166395.0,17,2,414,1,88,0.0,88.0,88.0,1,326,0.0,326.0,326.0
208091.0,17,2,614,1,72,0.0,72.0,72.0,1,542,0.0,542.0,542.0
1305944.0,6,4,264,2,132,0.0,66.0,66.0,2,132,0.0,66.0,66.0
103858.0,17,2,286,2,286,0.0,143.0,143.0,0,0,0.0,0.0,0.0
1254959.0,6,7,499,4,301,401379.6666666667,103.0,75.25,3,198,618606.5,66.0,66.0
107306.0,17,2,700,2,700,0.0,350.0,350.0,0,0,0.0,0.0,0.0
228554.0,17,2,180,1,90,0.0,90.0,90.0,1,90,0.0,90.0,90.0
207152.0,6,3,426,2,280,0.0,214.0,140.0,1,146,0.0,146.0,146.0
3067944.0,6,3,204,1,68,0.0,68.0,68.0,2,136,0.0,70.0,68.0
120047357.0,17,29,13785,29,13785,4287405.607142857,501.0,475.3448275862069,0,0,0.0,0.0,0.0
42986.0,6,14,4740,7,653,6954.5,249.0,93.28571428571428,7,4087,6415.0,1514.0,583.8571428571429
155968.0,6,3,337,2,214,0.0,160.0,107.0,1,123,0.0,123.0,123.0
91022098.0,17,12,778,6,389,18201602.0,174.0,64.83333333333333,6,389,18200171.8,174.0,64.83333333333333
13754312.0,17,6,2052,6,2052,2750862.4,342.0,342.0,0,0,0.0,0.0,0.0
279663.0,17,2,180,1,90,0.0,90.0,90.0,1,90,0.0,90.0,90.0
120005426.0,6,21,1585,11,840,11999939.5,95.0,76.36363636363636,10,745,13332830.222222222,95.0,74.5
120000959.0,17,14,864,8,475,17142994.14285714,174.0,59.375,6,389,20000940.4,174.0,64.83333333333333
15237.0,17,2,180,1,90,0.0,90.0,90.0,1,90,0.0,90.0,90.0
302436.0,6,6,412,4,272,100812.0,74.0,68.0,2,140,0.0,74.0,70.0
113437793.0,6,38,2980,18,1386,6672811.352941177,123.0,77.0,20,1594,5432993.631578947,139.0,79.7
123996988.0,17,15,907,8,475,17713855.42857143,174.0,59.375,7,432,17333501.0,174.0,61.71428571428572
119856582.0,6,14,2102,5,1020,29963524.0,204.0,204.0,9,1082,14981917.375,188.0,120.22222222222224
13880.0,6,14,4740,7,653,2099.1666666666665,249.0,93.28571428571428,7,4087,2155.333333333333,1514.0,583.8571428571429
890962.0,6,10,1335,6,798,178192.4,460.0,133.0,4,537,205030.3333333333,331.0,134.25
217036.0,17,2,180,1,90,0.0,90.0,90.0,1,90,0.0,90.0,90.0
135125048.0,17,6,1146,6,1146,27025009.6,191.0,191.0,0,0,0.0,0.0,0.0
218478.0,6,3,426,2,280,0.0,214.0,140.0,1,146,0.0,146.0,146.0
120288468.0,6,296,33732,148,10064,812690.4897959183,140.0,68.0,148,23668,812679.7551020408,284.0,159.9189189189189
119233.0,17,4,1524,4,1524,39744.333333333336,381.0,381.0,0,0,0.0,0.0,0.0
197478.0,17,2,180,1,90,0.0,90.0,90.0,1,90,0.0,90.0,90.0
144059.0,17,2,180,1,90,0.0,90.0,90.0,1,90,0.0,90.0,90.0
28293.0,6,14,4740,7,653,4551.333333333333,249.0,93.28571428571428,7,4087,4480.833333333333,1514.0,583.8571428571429
135136162.0,17,6,1206,6,1206,27027232.4,201.0,201.0,0,0,0.0,0.0,0.0
305623.0,6,3,202,2,128,0.0,74.0,64.0,1,74,0.0,74.0,74.0
587755.0,6,4,508,2,238,0.0,172.0,119.0,2,270,0.0,135.0,135.0
0.0,6,1,54,0,0,0.0,0.0,0.0,1,54,0.0,54.0,54.0
138001.0,17,2,192,1,88,0.0,88.0,88.0,1,104,0.0,104.0,104.0
219402.0,6,3,426,2,280,0.0,214.0,140.0,1,146,0.0,146.0,146.0
90055918.0,17,28,13364,28,13364,3335404.3703703703,501.0,477.2857142857143,0,0,0.0,0.0,0.0
90258845.0,6,12,1832,8,1016,12894120.714285716,188.0,127.0,4,816,30030663.0,204.0,204.0
2289.0,17,4,344,2,150,0.0,75.0,75.0,2,194,0.0,103.0,97.0
123839469.0,6,49,3234,25,1650,5159977.875,66.0,66.0,24,1584,5126841.347826087,66.0,66.0
100205.0,17,2,762,2,762,0.0,381.0,381.0,0,0,0.0,0.0,0.0
1030158.0,6,11,1134,6,558,206031.60000000003,220.0,93.0,5,576,256420.75,304.0,115.2
120113216.0,6,230,25978,115,7886,1046323.6578947369,140.0,68.57391304347826,115,18092,1046450.7894736842,284.0,157.3217391304348
90303050.0,6,16,1192,8,596,12894274.42857143,95.0,74.5,8,596,12899454.857142856,95.0,74.5
169828.0,17,2,180,1,90,0.0,90.0,90.0,1,90,0.0,90.0,90.0
139677.0,6,2,132,1,66,0.0,66.0,66.0,1,66,0.0,66.0,66.0
100490118.0,17,13,821,7,432,16748353.0,174.0,61.71428571428572,6,389,19974576.0,174.0,64.83333333333333
395052.0,6,3,204,2,136,0.0,70.0,68.0,1,68,0.0,68.0,68.0
90305383.0,6,16,1192,8,596,12893751.0,95.0,74.5,8,596,12899356.42857143,95.0,74.5
504125.00000000006,6,5,336,2,134,0.0,68.0,67.0,3,202,193570.0,70.0,67.33333333333333
3101943.0,6,3,204,2,134,0.0,68.0,67.0,1,70,0.0,70.0,70.0
147032.0,6,3,373,2,238,0.0,172.0,119.0,1,135,0.0,135.0,135.0
503.0,17,2,508,2,508,0.0,257.0,254.0,0,0,0.0,0.0,0.0
355.0,17,2,267,1,83,0.0,83.0,83.0,1,184,0.0,184.0,184.0
1039078.0,6,11,1134,6,558,207815.6,220.0,93.0,5,576,257693.0,304.0,115.2
198898.0,17,2,180,1,90,0.0,90.0,90.0,1,90,0.0,90.0,90.0
120048372.0,17,29,13785,29,13785,4287441.857142857,501.0,475.3448275862069,0,0,0.0,0.0,0.0
1911.0,17,4,344,2,150,0.0,75.0,75.0,2,194,0.0,103.0,97.0
228689.0,17,2,180,1,90,0.0,90.0,90.0,1,90,0.0,90.0,90.0
245799.0,6,3,337,2,214,0.0,160.0,107.0,1,123,0.0,123.0,123.0
197021.0,17,2,180,1,90,0.0,90.0,90.0,1,90,0.0,90.0,90.0
90297480.0,6,16,1192,8,596,12893469.42857143,95.0,74.5,8,596,12897805.57142857,95.0,74.5
30632839.0,6,5,336,2,134,0.0,68.0,67.0,3,202,15244352.0,70.0,67.33333333333333
120052684.0,17,28,13364,28,13364,4446395.703703703,501.0,477.2857142857143,0,0,0.0,0.0,0.0
12536.0,17,2,684,2,684,0.0,342.0,342.0,0,0,0.0,0.0,0.0
1321027.0,17,7,490,7,490,220171.16666666663,70.0,70.0,0,0,0.0,0.0,0.0
265693.0,6,10,1221,6,636,53138.6,298.0,106.0,4,585,83145.0,379.0,146.25
553.0,17,2,508,2,508,0.0,257.0,254.0,0,0,0.0,0.0,0.0
37711.0,6,14,4740,7,653,5130.5,249.0,93.28571428571428,7,4087,6088.666666666667,1514.0,583.8571428571429
2466.0,17,4,344,2,150,0.0,75.0,75.0,2,194,0.0,103.0,97.0
4454.0,17,2,602,1,72,0.0,72.0,72.0,1,530,0.0,530.0,530.0
108107195.0,17,5,1005,5,1005,27026798.75,201.0,201.0,0,0,0.0,0.0,0.0
162326.0,17,2,180,1,90,0.0,90.0,90.0,1,90,0.0,90.0,90.0
135126657.0,17,6,1206,6,1206,27025331.4,201.0,201.0,0,0,0.0,0.0,0.0
1506124.0,6,20,6434,12,1921,136920.36363636365,620.0,160.08333333333334,8,4513,175997.85714285713,1514.0,564.125
107005873.0,17,13,821,7,432,17834312.166666668,174.0,61.71428571428572,6,389,17400159.8,174.0,64.83333333333333
267230.0,6,4,492,2,280,0.0,214.0,140.0,2,212,0.0,146.0,106.0
114463677.0,6,48,3168,24,1584,4976681.608695652,66.0,66.0,24,1584,4964702.391304348,66.0,66.0
110287314.0,6,33,2428,17,1288,6892957.125,139.0,75.76470588235294,16,1140,7338053.8,123.0,71.25
108110046.0,17,5,1005,5,1005,27027511.5,201.0,201.0,0,0,0.0,0.0,0.0
90306864.0,6,16,2372,8,1016,12900980.57142857,188.0,127.0,8,1356,12877695.0,204.0,169.5
62377.0,6,10,2032,5,524,15308.25,252.0,104.8,5,1508,14721.5,1236.0,301.6
96072527.0,17,14,1126,7,563,15985456.333333334,174.0,80.42857142857143,7,563,15974695.333333334,174.0,80.42857142857143
2803472.0,6,2,132,1,66,0.0,66.0,66.0,1,66,0.0,66.0,66.0
143059.0,6,2,132,1,66,0.0,66.0,66.0,1,66,0.0,66.0,66.0
1506.0,17,2,762,2,762,0.0,381.0,381.0,0,0,0.0,0.0,0.0
39805.0,6,10,2032,5,524,9243.5,252.0,104.8,5,1508,6606.75,1236.0,301.6
2589521.0,6,2,132,1,66,0.0,66.0,66.0,1,66,0.0,66.0,66.0
305885.0,17,2,180,1,90,0.0,90.0,90.0,1,90,0.0,90.0,90.0
621550.0,17,2,335,1,88,0.0,88.0,88.0,1,247,0.0,247.0,247.0
783.0,17,2,762,2,762,0.0,381.0,381.0,0,0,0.0,0.0,0.0
29970.0,6,10,2032,5,524,7254.25,252.0,104.8,5,1508,6760.75,1236.0,301.6
119339869.0,6,22,1639,12,894,10844793.181818182,95.0,74.5,10,745,13233921.0,95.0,74.5
28198.0,6,14,4740,7,653,4555.0,249.0,93.28571428571428,7,4087,3081.1666666666665,1514.0,583.8571428571429
120540.0,6,3,337,2,214,0.0,160.0,107.0,1,123,0.0,123.0,123.0
1873.0,17,2,180,1,90,0.0,90.0,90.0,1,90,0.0,90.0,90.0
1991.0,17,4,344,2,150,0.0,75.0,75.0,2,194,0.0,103.0,97.0
237672.0,6,11,1132,6,556,46374.0,218.0,92.66666666666669,5,576,55534.5,304.0,115.2
120011791.0,17,29,13785,29,13785,4286135.392857143,501.0,475.3448275862069,0,0,0.0,0.0,0.0
46059.0,6,10,2032,5,524,10262.0,252.0,104.8,5,1508,10931.0,1236.0,301.6
238064.0,17,2,180,1,90,0.0,90.0,90.0,1,90,0.0,90.0,90.0
0.0,6,1,66,1,66,0.0,66.0,66.0,0,0,0.0,0.0,0.0
340725.0,6,2,132,1,66,0.0,66.0,66.0,1,66,0.0,66.0,66.0
10460431.0,6,7,478,4,272,3441103.6666666665,74.0,68.0,3,206,5161550.0,74.0,68.66666666666667
207878.0,6,3,426,2,280,0.0,214.0,140.0,1,146,0.0,146.0,146.0
144750.0,17,2,180,1,70,0.0,70.0,70.0,1,110,0.0,110.0,110.0
90256683.0,6,13,2036,8,1016,12893811.857142856,188.0,127.0,5,1020,22523399.25,204.0,204.0
509113.00000000006,6,5,336,2,134,0.0,68.0,67.0,3,202,193146.0,70.0,67.33333333333333
251496.0,6,10,1221,6,636,50299.2,298.0,106.0,4,585,82488.33333333333,379.0,146.25
884678.0,6,10,1336,6,799,176935.6,461.0,133.16666666666666,4,537,203173.66666666663,331.0,134.25
90306519.0,6,16,1192,8,596,12894130.57142857,95.0,74.5,8,596,12899995.0,95.0,74.5
135132627.0,17,6,1206,6,1206,27026525.4,201.0,201.0,0,0,0.0,0.0,0.0
119784583.0,6,48,3168,24,1584,5208025.347826087,66.0,66.0,24,1584,5193797.869565218,66.0,66.0
7989.0,17,2,582,1,83,0.0,83.0,83.0,1,499,0.0,499.0,499.0
59896.0,6,14,4740,7,653,9673.166666666666,249.0,93.28571428571428,7,4087,7869.0,1514.0,583.8571428571429
56318.0,6,14,4740,7,653,9262.5,249.0,93.28571428571428,7,4087,8589.833333333334,1514.0,583.8571428571429
103357.0,17,2,286,2,286,0.0,143.0,143.0,0,0,0.0,0.0,0.0
5623105.0,6,5,336,2,134,0.0,68.0,67.0,3,202,1525147.5,70.0,67.33333333333333
29786.0,6,10,2032,5,524,6827.0,252.0,104.8,5,1508,6144.0,1236.0,301.6
143958.0,17,2,180,1,90,0.0,90.0,90.0,1,90,0.0,90.0,90.0
108741732.0,6,32,2220,16,1149,7235043.0,123.0,71.8125,16,1071,7235047.666666667,123.0,66.9375
298320.0,6,6,412,4,272,99440.0,74.0,68.0,2,140,0.0,74.0,70.0
153403.0,17,2,180,1,90,0.0,90.0,90.0,1,90,0.0,90.0,90.0
26143.0,6,14,4740,7,653,4233.833333333333,249.0,93.28571428571428,7,4087,4218.0,1514.0,583.8571428571429
108105249.0,17,5,1005,5,1005,27026312.25,201.0,201.0,0,0,0.0,0.0,0.0
41117.0,6,2,132,1,66,0.0,66.0,66.0,1,66,0.0,66.0,66.0
108103832.0,17,5,955,5,955,27025958.0,191.0,191.0,0,0,0.0,0.0,0.0
28952.0,6,10,2032,5,524,5856.5,252.0,104.8,5,1508,6895.5,1236.0,301.6
263082.0,6,10,1221,6,636,52616.4,298.0,106.0,4,585,81927.33333333333,379.0,146.25
2400638.0,6,3,1777,2,951,0.0,885.0,475.5,1,826,0.0,826.0,826.0
31810.0,6,14,4740,7,653,4988.333333333333,249.0,93.28571428571428,7,4087,5161.333333333333,1514.0,583.8571428571429
49189.0,6,14,4740,7,653,6584.0,249.0,93.28571428571428,7,4087,8015.0,1514.0,583.8571428571429
22963965.0,17,3,1034,2,684,0.0,342.0,342.0,1,350,0.0,350.0,350.0
119030648.0,17,15,1169,8,606,17004378.285714287,174.0,75.75,7,563,16496500.333333334,174.0,80.42857142857143
36728.0,6,14,4740,7,653,5935.833333333333,249.0,93.28571428571428,7,4087,5788.333333333333,1514.0,583.8571428571429
24185.0,6,14,4740,7,653,3631.3333333333335,249.0,93.28571428571428,7,4087,3886.3333333333335,1514.0,583.8571428571429
1524003.0,17,6,1230,3,234,761826.0,78.0,78.0,3,996,761793.0,332.0,332.0
75316.0,6,10,2032,5,524,17155.0,252.0,104.8,5,1508,17000.0,1236.0,301.6
426000.0,6,3,1604,2,851,0.0,785.0,425.5,1,753,0.0,753.0,753.0
90058698.0,17,27,12943,27,12943,3463796.076923077,501.0,479.3703703703704,0,0,0.0,0.0,0.0
238375.0,6,3,337,2,214,0.0,160.0,107.0,1,123,0.0,123.0,123.0
2785816.0,17,2,876,2,876,0.0,438.0,438.0,0,0,0.0,0.0,0.0
135132577.0,17,6,1146,6,1146,27026515.4,191.0,191.0,0,0,0.0,0.0,0.0
159290.0,6,10,1066,5,490,39255.75,218.0,98.0,5,576,39461.5,304.0,115.2
53542.0,6,14,4740,7,653,8120.166666666667,249.0,93.28571428571428,7,4087,7861.333333333333,1514.0,583.8571428571429
196940.0,17,2,180,1,90,0.0,90.0,90.0,1,90,0.0,90.0,90.0
242043.0,6,3,337,2,214,0.0,160.0,107.0,1,123,0.0,123.0,123.0
9324.0,17,2,539,1,86,0.0,86.0,86.0,1,453,0.0,453.0,453.0
38773.0,6,14,4740,7,653,5706.5,249.0,93.28571428571428,7,4087,6286.333333333333,1514.0,583.8571428571429
1976.0,17,4,344,2,150,0.0,75.0,75.0,2,194,0.0,103.0,97.0
31546.0,6,14,4740,7,653,5138.833333333333,249.0,93.28571428571428,7,4087,5065.5,1514.0,583.8571428571429
145146.0,17,2,180,1,70,0.0,70.0,70.0,1,110,0.0,110.0,110.0
9920.0,6,10,1067,5,536,2315.75,264.0,107.2,5,531,2200.75,259.0,106.2
2588202.0,6,2,132,1,66,0.0,66.0,66.0,1,66,0.0,66.0,66.0
90055078.0,17,28,13364,28,13364,3335373.25925926,501.0,477.2857142857143,0,0,0.0,0.0,0.0
298581.0,6,6,412,4,272,99527.0,74.0,68.0,2,140,0.0,74.0,70.0
58531.0,6,14,4740,7,653,8900.833333333334,249.0,93.28571428571428,7,4087,9572.833333333334,1514.0,583.8571428571429
9973.0,17,2,582,1,83,0.0,83.0,83.0,1,499,0.0,499.0,499.0
11827.0,17,4,823,2,163,0.0,89.0,81.5,2,660,0.0,443.0,330.0
10502056.0,6,7,478,4,272,3455010.333333333,74.0,68.0,3,206,5182423.5,74.0,68.66666666666667
1309224.0,6,4,264,2,132,0.0,66.0,66.0,2,132,0.0,66.0,66.0
99310.0,17,2,762,2,762,0.0,381.0,381.0,0,0,0.0,0.0,0.0
120107967.0,6,15,2444,7,1428,20017994.5,204.0,204.0,8,1016,17096656.57142857,188.0,127.0
38068.0,6,10,2032,5,524,9277.5,252.0,104.8,5,1508,9266.25,1236.0,301.6
4772.0,17,2,762,2,762,0.0,381.0,381.0,0,0,0.0,0.0,0.0
207575.0,6,3,426,2,280,0.0,214.0,140.0,1,146,0.0,146.0,146.0
105135.0,17,2,700,2,700,0.0,350.0,350.0,0,0,0.0,0.0,0.0
2354.0,17,4,344,2,150,0.0,75.0,75.0,2,194,0.0,103.0,97.0
2525.0,17,4,344,2,150,0.0,75.0,75.0,2,194,0.0,103.0,97.0
163734.0,6,2,132,1,66,0.0,66.0,66.0,1,66,0.0,66.0,66.0
2566791.0,6,3,1777,2,951,0.0,885.0,475.5,1,826,0.0,826.0,826.0
97975606.0,6,25,1686,13,840,8164633.833333333,123.0,64.61538461538461,12,846,7979230.454545454,123.0,70.5
90058318.0,17,28,13364,28,13364,3335493.25925926,501.0,477.2857142857143,0,0,0.0,0.0,0.0
90370286.0,6,14,2256,7,1428,15061527.833333334,204.0,204.0,7,828,15013666.166666666,188.0,118.28571428571428
276311.0,17,2,180,1,90,0.0,90.0,90.0,1,90,0.0,90.0,90.0
108103002.0,17,5,1005,5,1005,27025750.5,201.0,201.0,0,0,0.0,0.0,0.0
10225.0,17,3,1143,3,1143,5112.5,381.0,381.0,0,0,0.0,0.0,0.0
206126.0,6,3,426,2,280,0.0,214.0,140.0,1,146,0.0,146.0,146.0
120002047.0,6,17,1287,9,691,15000255.875,95.0,76.77777777777777,8,596,12858046.42857143,95.0,74.5
148011.0,17,2,180,1,90,0.0,90.0,90.0,1,90,0.0,90.0,90.0
90005407.0,17,28,13364,28,13364,3333533.592592593,501.0,477.2857142857143,0,0,0.0,0.0,0.0
2089.0,17,4,344,2,150,0.0,75.0,75.0,2,194,0.0,103.0,97.0
2686899.0,6,32,10926,18,3951,158052.88235294115,1514.0,219.5,14,6975,185936.3076923077,1514.0,498.2142857142857
2604225.0,6,3,1604,1,753,0.0,753.0,753.0,2,851,0.0,785.0,425.5
183929.0,17,2,180,1,90,0.0,90.0,90.0,1,90,0.0,90.0,90.0
298715.0,6,6,412,4,272,99571.66666666669,74.0,68.0,2,140,0.0,74.0,70.0
90016092.0,17,28,13364,28,13364,3333929.333333333,501.0,477.2857142857143,0,0,0.0,0.0,0.0
90259205.0,6,12,1832,8,1016,12894172.142857144,188.0,127.0,4,816,30031024.33333333,204.0,204.0
2071735.0,6,19,6869,10,1501,230192.7777777777,408.0,150.1,9,5368,208093.5,1514.0,596.4444444444445
144033.0,17,2,180,1,90,0.0,90.0,90.0,1,90,0.0,90.0,90.0
35404.0,6,10,2032,5,524,8549.25,252.0,104.8,5,1508,7159.0,1236.0,301.6
105883918.0,6,32,2220,16,1149,7058927.866666666,123.0,71.8125,16,1071,7044497.266666667,123.0,66.9375
333.0,17,2,166,1,75,0.0,75.0,75.0,1,91,0.0,91.0,91.0
855177.0,6,9,1196,6,725,171035.4,387.0,120.83333333333331,3,471,289582.0,331.0,157.0
37548.0,6,14,4740,7,653,6080.166666666667,249.0,93.28571428571428,7,4087,5709.5,1514.0,583.8571428571429
242486.0,6,3,373,2,238,0.0,172.0,119.0,1,135,0.0,135.0,135.0
51024.0,17,2,180,1,90,0.0,90.0,90.0,1,90,0.0,90.0,90.0
108120312.0,17,5,1005,5,1005,27030078.0,201.0,201.0,0,0,0.0,0.0,0.0
97251544.0,17,14,1126,7,563,16166839.0,174.0,80.42857142857143,7,563,16165262.833333334,174.0,80.42857142857143
873.0,17,4,438,2,148,0.0,74.0,74.0,2,290,0.0,147.0,145.0
1618379.0,17,5,961,3,234,809004.0,78.0,78.0,2,727,0.0,395.0,363.5
284469.0,17,2,363,1,79,0.0,79.0,79.0,1,284,0.0,284.0,284.0
56661.0,6,10,2032,5,524,10904.75,252.0,104.8,5,1508,13732.25,1236.0,301.6
10478085.0,6,7,478,4,272,3447346.333333333,74.0,68.0,3,206,5170880.0,74.0,68.66666666666667
2354718.0,6,49,23728,25,19797,98113.25,1514.0,791.88,24,3931,92680.34782608696,1514.0,163.79166666666666
19535.0,6,11,1132,6,556,3340.4,218.0,92.66666666666669,5,576,4600.5,304.0,115.2
107736178.0,6,33,2428,17,1288,6720690.5625,139.0,75.76470588235294,16,1140,7168734.266666667,123.0,71.25
10244.0,6,10,1067,5,536,2310.5,264.0,107.2,5,531,2241.25,259.0,106.2
2804341.0,6,2,132,1,66,0.0,66.0,66.0,1,66,0.0,66.0,66.0
702950.0,6,5,336,2,134,0.0,68.0,67.0,3,202,196665.0,70.0,67.33333333333333
1737986.0,6,23,6509,12,1529,157998.72727272726,357.0,127.41666666666669,11,4980,143013.1,1510.0,452.7272727272728
90298832.0,6,16,1192,8,596,12891402.42857143,95.0,74.5,8,596,12898948.714285716,95.0,74.5
304718.0,6,6,412,4,272,101572.66666666669,74.0,68.0,2,140,0.0,74.0,70.0
10532860.0,6,7,478,4,272,3465297.6666666665,74.0,68.0,3,206,5197845.5,74.0,68.66666666666667
43058.0,6,14,4740,7,653,7009.0,249.0,93.28571428571428,7,4087,5947.5,1514.0,583.8571428571429
155704.0,6,3,337,2,214,0.0,160.0,107.0,1,123,0.0,123.0,123.0
793.0,17,4,438,2,148,0.0,74.0,74.0,2,290,0.0,147.0,145.0
146075.0,6,3,337,2,214,0.0,160.0,107.0,1,123,0.0,123.0,123.0
94491.0,6,11,1133,6,602,17302.2,264.0,100.33333333333331,5,531,12497.75,259.0,106.2
1897.0,17,2,176,1,80,0.0,80.0,80.0,1,96,0.0,96.0,96.0
321469.0,17,4,1400,4,1400,107156.33333333331,350.0,350.0,0,0,0.0,0.0,0.0
108106911.0,17,5,1005,5,1005,27026727.75,201.0,201.0,0,0,0.0,0.0,0.0
2050151.0,17,4,820,2,156,0.0,78.0,78.0,2,664,0.0,332.0,332.0
309382.0,6,6,412,4,272,103127.33333333331,74.0,68.0,2,140,0.0,74.0,70.0
3879353.0,6,5,336,2,134,0.0,68.0,67.0,3,202,1526005.5,70.0,67.33333333333333
228405.0,17,2,180,1,90,0.0,90.0,90.0,1,90,0.0,90.0,90.0
90290326.0,6,18,1382,10,786,10027580.555555556,95.0,78.6,8,596,12830239.285714284,95.0,74.5
103909368.0,17,14,864,7,432,17318228.0,174.0,61.71428571428572,7,432,17288995.166666668,174.0,61.71428571428572
0.0,17,1,143,1,143,0.0,143.0,143.0,0,0,0.0,0.0,0.0
336118.0,17,4,704,2,148,0.0,74.0,74.0,2,556,0.0,280.0,278.0
82414.0,6,14,4740,7,653,13603.833333333334,249.0,93.28571428571428,7,4087,12562.833333333334,1514.0,583.8571428571429
121358.0,6,3,337,2,214,0.0,160.0,107.0,1,123,0.0,123.0,123.0
104018334.0,6,44,2904,22,1452,4953254.0,66.0,66.0,22,1452,4940121.047619048,66.0,66.0
24326.0,6,10,2032,5,524,5690.0,252.0,104.8,5,1508,5138.25,1236.0,301.6
3346.0,17,4,571,2,148,0.0,74.0,74.0,2,423,0.0,280.0,211.5
108268130.0,6,201,22708,101,6888,1082681.3,140.0,68.1980198019802,100,15820,1083148.2727272727,390.0,158.2
100957105.0,6,32,2374,17,1288,6296367.3125,139.0,75.76470588235294,15,1086,7195847.928571428,123.0,72.4
209621.0,6,10,1221,6,636,41924.2,298.0,106.0,4,585,68346.0,379.0,146.25
31719.0,6,14,4740,7,653,5127.666666666667,249.0,93.28571428571428,7,4087,5054.833333333333,1514.0,583.8571428571429
33126.0,6,14,4740,7,653,5411.833333333333,249.0,93.28571428571428,7,4087,5317.5,1514.0,583.8571428571429
35647.0,6,14,4740,7,653,4290.166666666667,249.0,93.28571428571428,7,4087,5753.166666666667,1514.0,583.8571428571429
120067767.0,17,28,13364,28,13364,4446954.333333333,501.0,477.2857142857143,0,0,0.0,0.0,0.0
135132524.0,17,6,1206,6,1206,27026504.8,201.0,201.0,0,0,0.0,0.0,0.0
45244.0,6,10,2032,5,524,9276.75,252.0,104.8,5,1508,11029.25,1236.0,301.6
315644.0,17,4,1400,4,1400,105214.66666666669,350.0,350.0,0,0,0.0,0.0,0.0
1040857.0,6,11,1134,6,558,208171.4,220.0,93.0,5,576,258784.25,304.0,115.2
14682.0,6,14,4740,7,653,2335.1666666666665,249.0,93.28571428571428,7,4087,2309.6666666666665,1514.0,583.8571428571429
318.0,17,2,174,1,79,0.0,79.0,79.0,1,95,0.0,95.0,95.0
109271150.0,6,32,2236,16,1165,7270346.733333333,139.0,72.8125,16,1071,7270084.2,123.0,66.9375
2385.0,17,4,344,2,150,0.0,75.0,75.0,2,194,0.0,103.0,97.0
10357.0,6,10,1065,5,534,1967.25,262.0,106.8,5,531,2376.0,259.0,106.2
183850.0,17,2,180,1,90,0.0,90.0,90.0,1,90,0.0,90.0,90.0
1183616.0,6,13,3017,8,2389,169088.0,1514.0,298.625,5,628,226979.75,331.0,125.6
53587.0,6,14,4740,7,653,8405.5,249.0,93.28571428571428,7,4087,8792.666666666666,1514.0,583.8571428571429
1168659.0,6,13,3014,8,2386,166951.2857142857,1514.0,298.25,5,628,223243.0,331.0,125.6
108102701.0,17,5,1005,5,1005,27025675.25,201.0,201.0,0,0,0.0,0.0,0.0
147991.0,17,2,180,1,90,0.0,90.0,90.0,1,90,0.0,90.0,90.0
90094957.0,6,12,1848,5,1020,22523166.0,204.0,204.0,7,828,14970630.5,188.0,118.28571428571428
31682.000000000004,6,14,4740,7,653,4040.0,249.0,93.28571428571428,7,4087,5149.166666666667,1514.0,583.8571428571429
120124475.0,6,13,2036,8,1016,17136432.14285714,188.0,127.0,5,1020,22523571.25,204.0,204.0
106361170.0,6,43,2838,22,1452,5054537.142857143,66.0,66.0,21,1386,5105435.65,66.0,66.0
504829.0,6,4,270,2,134,0.0,68.0,67.0,2,136,0.0,70.0,68.0
2796931.0,6,2,132,1,66,0.0,66.0,66.0,1,66,0.0,66.0,66.0
311072.0,6,3,202,2,128,0.0,74.0,64.0,1,74,0.0,74.0,74.0
5625787.0,6,4,270,2,134,0.0,68.0,67.0,2,136,0.0,70.0,68.0
14733.0,6,10,2032,5,524,3423.0,252.0,104.8,5,1508,3358.5,1236.0,301.6
129031.0,6,2,132,1,66,0.0,66.0,66.0,1,66,0.0,66.0,66.0
138003.0,17,4,344,2,150,0.0,75.0,75.0,2,194,0.0,103.0,97.0
65353.99999999999,6,14,4740,7,653,10579.666666666666,249.0,93.28571428571428,7,4087,10716.666666666666,1514.0,583.8571428571429
120002429.0,6,24,1829,13,1030,9999991.916666666,95.0,79.23076923076923,11,799,11999937.2,95.0,72.63636363636364
186693.0,6,11,1131,6,600,37064.2,262.0,100.0,5,531,3129.75,259.0,106.2
109368564.0,6,206,23330,103,16310,1070235.8333333333,284.0,158.3495145631068,103,7020,1070236.156862745,140.0,68.15533980582525
90532472.0,6,14,2240,8,1016,12933210.285714284,188.0,127.0,6,1224,18069980.2,204.0,204.0
196884.0,17,2,180,1,90,0.0,90.0,90.0,1,90,0.0,90.0,90.0
14695919.0,6,19,1635,9,1003,1797681.375,315.0,111.44444444444444,10,632,1597914.5555555555,78.0,63.2
2401.0,17,4,344,2,150,0.0,75.0,75.0,2,194,0.0,103.0,97.0
119500470.0,6,252,28886,126,20348,954272.2,284.0,161.4920634920635,126,8538,954270.112,140.0,67.76190476190476
382802.0,6,3,202,2,128,0.0,74.0,64.0,1,74,0.0,74.0,74.0
5619278.0,6,4,270,2,134,0.0,68.0,67.0,2,136,0.0,70.0,68.0
15133.0,17,2,539,1,86,0.0,86.0,86.0,1,453,0.0,453.0,453.0
112516317.0,6,206,23202,103,16182,1100992.137254902,284.0,157.10679611650485,103,7020,1100991.931372549,140.0,68.15533980582525
2367.0,17,4,344,2,150,0.0,75.0,75.0,2,194,0.0,103.0,97.0
2022985.0,17,4,525,2,150,0.0,75.0,75.0,2,375,0.0,284.0,187.5
285533.0,17,4,704,2,148,0.0,74.0,74.0,2,556,0.0,280.0,278.0
196889.0,17,2,180,1,90,0.0,90.0,90.0,1,90,0.0,90.0,90.0
144311.0,6,2,132,1,66,0.0,66.0,66.0,1,66,0.0,66.0,66.0
120355090.0,6,362,42986,181,12242,664113.8166666667,140.0,67.6353591160221,181,30744,664042.1,480.0,169.85635359116023
2397.0,17,4,344,2,150,0.0,75.0,75.0,2,194,0.0,103.0,97.0
58031.0,6,10,2032,5,524,14041.25,252.0,104.8,5,1508,13586.5,1236.0,301.6
52768.0,6,14,4740,7,653,8558.833333333334,249.0,93.28571428571428,7,4087,7431.333333333333,1514.0,583.8571428571429
245613.0,6,3,337,2,214,0.0,160.0,107.0,1,123,0.0,123.0,123.0
205573.0,17,2,762,2,762,0.0,381.0,381.0,0,0,0.0,0.0,0.0
206473.0,6,3,426,2,280,0.0,214.0,140.0,1,146,0.0,146.0,146.0
4639.0,17,2,598,1,72,0.0,72.0,72.0,1,526,0.0,526.0,526.0
161501.0,17,4,1524,4,1524,53833.66666666666,381.0,381.0,0,0,0.0,0.0,0.0
2112.0,17,4,344,2,150,0.0,75.0,75.0,2,194,0.0,103.0,97.0
144802.0,17,2,180,1,70,0.0,70.0,70.0,1,110,0.0,110.0,110.0
29762.0,6,14,4740,7,653,4842.833333333333,249.0,93.28571428571428,7,4087,4821.5,1514.0,583.8571428571429
338.0,17,2,168,1,76,0.0,76.0,76.0,1,92,0.0,92.0,92.0
809.0,17,4,438,2,148,0.0,74.0,74.0,2,290,0.0,147.0,145.0
22239.0,6,10,1949,5,441,5328.25,169.0,88.2,5,1508,4974.5,1236.0,301.6
117043590.0,6,48,3168,24,1584,5088851.739130435,66.0,66.0,24,1584,5079454.434782608,66.0,66.0
108103083.0,17,5,1005,5,1005,27025770.75,201.0,201.0,0,0,0.0,0.0,0.0
21312.0,6,14,4740,7,653,3332.1666666666665,249.0,93.28571428571428,7,4087,3417.0,1514.0,583.8571428571429
99775301.0,17,14,1126,7,563,16602586.166666666,174.0,80.42857142857143,7,563,16405613.833333334,174.0,80.42857142857143
209655.0,17,2,180,1,90,0.0,90.0,90.0,1,90,0.0,90.0,90.0
120042789.0,6,28,3010,14,1505,9230763.384615384,425.0,107.5,14,1505,9229263.384615384,358.0,107.5
834.0,17,4,438,2,148,0.0,74.0,74.0,2,290,0.0,147.0,145.0
321719.0,17,4,1400,4,1400,107239.66666666669,350.0,350.0,0,0,0.0,0.0,0.0
2214.0,17,4,344,2,150,0.0,75.0,75.0,2,194,0.0,103.0,97.0
4322.0,17,4,344,2,150,0.0,75.0,75.0,2,194,0.0,103.0,97.0
91877803.0,17,16,5472,16,5472,6125186.866666666,342.0,342.0,0,0,0.0,0.0,0.0
1221978.0,17,2,876,2,876,0.0,438.0,438.0,0,0,0.0,0.0,0.0
90326589.0,6,19,1436,10,745,10026665.333333334,95.0,74.5,9,691,11287247.0,95.0,76.77777777777777
108114388.0,17,5,955,5,955,27028597.0,191.0,191.0,0,0,0.0,0.0,0.0
218042.0,6,3,426,2,280,0.0,214.0,140.0,1,146,0.0,146.0,146.0
35898.0,6,14,4740,7,653,5862.333333333333,249.0,93.28571428571428,7,4087,4714.666666666667,1514.0,583.8571428571429
120121018.0,6,13,2020,9,1204,15015127.25,188.0,133.77777777777777,4,816,30031270.33333333,204.0,204.0
106886188.0,6,44,2904,22,1452,5089818.476190476,66.0,66.0,22,1452,5074844.523809524,66.0,66.0
2609376.0,6,2,132,1,66,0.0,66.0,66.0,1,66,0.0,66.0,66.0
101866.0,17,2,286,2,286,0.0,143.0,143.0,0,0,0.0,0.0,0.0
122102980.0,6,31,2182,15,1017,8008418.428571428,123.0,67.8,16,1165,7474511.066666666,139.0,72.8125
116795715.0,6,48,3168,24,1584,5078074.565217392,66.0,66.0,24,1584,5064971.956521739,66.0,66.0
249506.0,6,3,337,2,214,0.0,160.0,107.0,1,123,0.0,123.0,123.0
2795761.0,6,2,132,1,66,0.0,66.0,66.0,1,66,0.0,66.0,66.0
17456.0,6,10,1067,5,536,4195.75,264.0,107.2,5,531,3916.5,259.0,106.2
57243.0,6,14,4740,7,653,8991.833333333334,249.0,93.28571428571428,7,4087,8080.166666666667,1514.0,583.8571428571429
27135.0,6,10,2032,5,524,6419.75,252.0,104.8,5,1508,6399.75,1236.0,301.6
2021787.0,17,4,525,2,150,0.0,75.0,75.0,2,375,0.0,284.0,187.5
43909.0,6,14,4740,7,653,6714.0,249.0,93.28571428571428,7,4087,6908.833333333333,1514.0,583.8571428571429
17393.0,6,10,1810,5,358,3863.0,130.0,71.6,5,1452,4067.25,1224.0,290.4
434.0,17,2,410,1,78,0.0,78.0,78.0,1,332,0.0,332.0,332.0
49738.0,6,14,4740,7,653,8116.666666666667,249.0,93.28571428571428,7,4087,7854.333333333333,1514.0,583.8571428571429
14648205.0,6,20,1607,10,975,1593014.6666666667,315.0,97.5,10,632,1592982.0,78.0,63.2
197023.0,17,2,180,1,90,0.0,90.0,90.0,1,90,0.0,90.0,90.0
14075375.0,17,6,2052,6,2052,2815075.0,342.0,342.0,0,0,0.0,0.0,0.0
149910.0,17,2,180,1,90,0.0,90.0,90.0,1,90,0.0,90.0,90.0
214536.0,17,4,1524,4,1524,71512.0,381.0,381.0,0,0,0.0,0.0,0.0
153462.0,17,2,180,1,90,0.0,90.0,90.0,1,90,0.0,90.0,90.0
119113479.0,6,25,1883,14,1084,9159418.153846154,95.0,77.42857142857143,11,799,11906386.3,95.0,72.63636363636364
74724.0,6,14,4740,7,653,12183.666666666666,249.0,93.28571428571428,7,4087,12258.0,1514.0,583.8571428571429
199863.0,17,4,6056,4,6056,66621.0,1514.0,1514.0,0,0,0.0,0.0,0.0
3450916.0,17,3,1026,3,1026,1725458.0,342.0,342.0,0,0,0.0,0.0,0.0
90216200.0,6,16,1192,8,596,12853923.42857143,95.0,74.5,8,596,12858707.285714284,95.0,74.5
90022139.0,17,28,13364,28,13364,3334153.296296296,501.0,477.2857142857143,0,0,0.0,0.0,0.0
211528.0,6,3,426,2,280,0.0,214.0,140.0,1,146,0.0,146.0,146.0
123839698.0,6,48,3168,24,1584,4976425.869565218,66.0,66.0,24,1584,5320976.260869565,66.0,66.0
153406.0,17,2,180,1,90,0.0,90.0,90.0,1,90,0.0,90.0,90.0
14115293.0,6,29,9249,16,3843,179899.86666666667,1514.0,240.1875,13,5406,1158223.25,1514.0,415.84615384615387
25667.0,6,10,1065,5,534,4965.25,262.0,106.8,5,531,4881.75,259.0,106.2
0.0,17,1,72,1,72,0.0,72.0,72.0,0,0,0.0,0.0,0.0
24064.0,6,14,4740,7,653,3852.8333333333335,249.0,93.28571428571428,7,4087,3818.0,1514.0,583.8571428571429
102202254.0,6,29,2052,15,1089,7284750.5,123.0,72.6,14,963,7844543.846153846,123.0,68.78571428571429
214880.0,17,4,1524,4,1524,71626.66666666667,381.0,381.0,0,0,0.0,0.0,0.0
90302103.0,6,17,1287,9,691,11282157.375,95.0,76.77777777777777,8,596,12832393.57142857,95.0,74.5
99453120.0,17,12,778,6,389,19858661.6,174.0,64.83333333333333,6,389,19692509.8,174.0,64.83333333333333
120417277.0,6,321,37310,161,26528,752607.98125,464.0,164.77018633540374,160,10782,750750.9685534592,140.0,67.3875
46783866.0,6,8,1940,3,887,22178133.0,753.0,295.6666666666667,5,1053,11003094.5,785.0,210.6
2300.0,17,4,344,2,150,0.0,75.0,75.0,2,194,0.0,103.0,97.0
365431.0,6,11,1021,6,444,49189.6,162.0,74.0,5,577,61398.25,349.0,115.4
90311521.0,6,27,1954,14,1045,6929958.153846154,139.0,74.64285714285714,13,909,7507956.0,123.0,69.92307692307692
109342635.0,6,28,1860,14,966,8394367.846153846,123.0,69.0,14,894,8394369.538461538,123.0,63.85714285714285
8954.0,17,4,823,2,163,0.0,89.0,81.5,2,660,0.0,443.0,330.0
108110979.0,17,5,955,5,955,27027744.75,191.0,191.0,0,0,0.0,0.0,0.0
90259508.0,6,13,2036,8,1016,12894215.42857143,188.0,127.0,5,1020,22523782.0,204.0,204.0
2170463.0,6,3,204,2,136,0.0,70.0,68.0,1,68,0.0,68.0,68.0
2470.0,17,4,344,2,150,0.0,75.0,75.0,2,194,0.0,103.0,97.0
362865.0,6,11,1021,6,444,48695.6,162.0,74.0,5,577,60801.75,349.0,115.4
5464.0,17,4,344,2,150,0.0,75.0,75.0,2,194,0.0,103.0,97.0
202233.0,17,2,762,2,762,0.0,381.0,381.0,0,0,0.0,0.0,0.0
209371.0,17,2,180,1,90,0.0,90.0,90.0,1,90,0.0,90.0,90.0
701.0,17,4,438,2,148,0.0,74.0,74.0,2,290,0.0,147.0,145.0
143902.0,17,2,180,1,90,0.0,90.0,90.0,1,90,0.0,90.0,90.0
113689540.0,6,48,3168,24,1584,4943023.478260869,66.0,66.0,24,1584,4933626.826086956,66.0,66.0
0.0,17,1,136,1,136,0.0,136.0,136.0,0,0,0.0,0.0,0.0
102659.0,17,2,286,2,286,0.0,143.0,143.0,0,0,0.0,0.0,0.0
2017.0,17,4,344,2,150,0.0,75.0,75.0,2,194,0.0,103.0,97.0
113745095.0,6,48,3168,24,1584,4945438.913043479,66.0,66.0,24,1584,4935653.260869565,66.0,66.0
197750.0,17,4,6056,4,6056,65916.66666666667,1514.0,1514.0,0,0,0.0,0.0,0.0
408829.0,6,3,1604,2,851,0.0,785.0,425.5,1,753,0.0,753.0,753.0
9263.0,17,2,582,1,83,0.0,83.0,83.0,1,499,0.0,499.0,499.0
1757.0,17,6,1230,3,234,576.0,78.0,78.0,3,996,674.5,332.0,332.0
90529360.0,6,14,2240,8,1016,12932765.714285716,188.0,127.0,6,1224,18072846.8,204.0,204.0
307388.0,17,4,1400,4,1400,102462.66666666669,350.0,350.0,0,0,0.0,0.0,0.0
102563214.0,17,14,864,7,432,17000131.5,174.0,61.71428571428572,7,432,17000971.5,174.0,61.71428571428572
206727.0,6,3,426,2,280,0.0,214.0,140.0,1,146,0.0,146.0,146.0
240454.0,6,10,1221,6,636,48090.8,298.0,106.0,4,585,78970.0,379.0,146.25
123455612.0,6,48,3168,24,1584,5140904.217391305,66.0,66.0,24,1584,5126917.0869565215,66.0,66.0
3273007.0,6,3,204,1,68,0.0,68.0,68.0,2,136,0.0,70.0,68.0
109141470.0,6,199,22396,100,6822,1102439.0909090908,140.0,68.22,99,15574,1082922.295918367,284.0,157.31313131313132
5001935.0,17,4,849,2,166,0.0,83.0,83.0,2,683,0.0,499.0,341.5
59473.0,6,14,4740,7,653,9787.666666666666,249.0,93.28571428571428,7,4087,9083.666666666666,1514.0,583.8571428571429
32147.000000000004,6,14,4740,7,653,4936.333333333333,249.0,93.28571428571428,7,4087,5027.333333333333,1514.0,583.8571428571429
307.0,17,2,156,1,78,0.0,78.0,78.0,1,78,0.0,78.0,78.0
2319.0,17,4,344,2,150,0.0,75.0,75.0,2,194,0.0,103.0,97.0
34493.0,6,14,4740,7,653,5615.5,249.0,93.28571428571428,7,4087,4482.5,1514.0,583.8571428571429
1307336.0,6,4,264,2,132,0.0,66.0,66.0,2,132,0.0,66.0,66.0
310.0,17,2,174,1,79,0.0,79.0,79.0,1,95,0.0,95.0,95.0
68207.0,6,14,4740,7,653,11198.833333333334,249.0,93.28571428571428,7,4087,9452.0,1514.0,583.8571428571429
135136645.0,17,6,1206,6,1206,27027329.0,201.0,201.0,0,0,0.0,0.0,0.0
207513.0,6,3,426,2,280,0.0,214.0,140.0,1,146,0.0,146.0,146.0
107134054.0,6,24,1990,13,1191,8926981.666666666,256.0,91.6153846153846,11,799,10684349.1,95.0,72.63636363636364
692.0,17,2,762,2,762,0.0,381.0,381.0,0,0,0.0,0.0,0.0
218412.0,6,3,426,2,280,0.0,214.0,140.0,1,146,0.0,146.0,146.0
1027558.0,6,20,6434,12,1921,93414.36363636365,620.0,160.08333333333334,8,4513,118252.42857142857,1514.0,564.125
315758.0,6,6,412,4,272,105252.66666666669,74.0,68.0,2,140,0.0,74.0,70.0
262587.0,17,4,1524,4,1524,87529.0,381.0,381.0,0,0,0.0,0.0,0.0
41060.0,6,10,2032,5,524,9981.0,252.0,104.8,5,1508,9012.5,1236.0,301.6
53603.0,6,14,4740,7,653,8811.166666666666,249.0,93.28571428571428,7,4087,8352.0,1514.0,583.8571428571429
177.0,17,2,158,2,158,0.0,79.0,79.0,0,0,0.0,0.0,0.0
55108.0,6,12,1328,6,731,9417.8,253.0,121.83333333333331,6,597,9929.2,259.0,99.5
205889.0,17,2,180,1,90,0.0,90.0,90.0,1,90,0.0,90.0,90.0
135136347.0,17,6,1146,6,1146,27027269.4,191.0,191.0,0,0,0.0,0.0,0.0
294.0,17,2,156,1,78,0.0,78.0,78.0,1,78,0.0,78.0,78.0
296.0,17,2,156,1,78,0.0,78.0,78.0,1,78,0.0,78.0,78.0
90031122.0,17,28,13364,28,13364,3334486.0,501.0,477.2857142857143,0,0,0.0,0.0,0.0
335.0,17,2,166,1,75,0.0,75.0,75.0,1,91,0.0,91.0,91.0
90015750.0,17,27,12943,27,12943,3462144.230769231,501.0,479.3703703703704,0,0,0.0,0.0,0.0
205715.0,17,2,180,1,90,0.0,90.0,90.0,1,90,0.0,90.0,90.0
15186.0,6,13,1459,7,862,2398.1666666666665,271.0,123.14285714285714,6,597,2598.6,259.0,99.5
205851.0,17,2,762,2,762,0.0,381.0,381.0,0,0,0.0,0.0,0.0
101050334.0,17,14,864,7,432,16833499.5,174.0,61.71428571428572,7,432,16834318.5,174.0,61.71428571428572
171605.0,17,2,180,1,90,0.0,90.0,90.0,1,90,0.0,90.0,90.0
125837764.0,6,55,11681,29,5971,3433598.6071428573,1514.0,205.896551724138,26,5710,5024901.12,1514.0,219.6153846153846
120052252.0,17,28,13364,28,13364,4446379.703703703,501.0,477.2857142857143,0,0,0.0,0.0,0.0
90288582.0,6,21,1585,11,840,9024502.9,95.0,76.36363636363636,10,745,10000147.111111112,95.0,74.5
140279.0,6,2,132,1,66,0.0,66.0,66.0,1,66,0.0,66.0,66.0
306574.0,17,4,1400,4,1400,102191.33333333331,350.0,350.0,0,0,0.0,0.0,0.0
586.0,17,2,762,2,762,0.0,381.0,381.0,0,0,0.0,0.0,0.0
69497.0,17,2,620,1,75,0.0,75.0,75.0,1,545,0.0,545.0,545.0
108136526.0,17,5,955,5,955,27034131.5,191.0,191.0,0,0,0.0,0.0,0.0
47341.0,6,14,4740,7,653,7367.833333333333,249.0,93.28571428571428,7,4087,4617.666666666667,1514.0,583.8571428571429
2065694.0,6,4,492,2,280,0.0,214.0,140.0,2,212,0.0,146.0,106.0
148614.0,17,2,414,1,88,0.0,88.0,88.0,1,326,0.0,326.0,326.0
120457033.0,6,19,1477,11,881,12045703.3,95.0,80.0909090909091,8,596,17105606.285714287,95.0,74.5
117063.0,17,4,1400,4,1400,39021.0,350.0,350.0,0,0,0.0,0.0,0.0
118708523.0,6,34,2466,17,1194,7419255.625,123.0,70.23529411764706,17,1272,6795183.625,123.0,74.82352941176471
120122743.0,6,15,2428,9,1204,15015342.875,188.0,133.77777777777777,6,1224,18018327.6,204.0,204.0
120134225.0,6,214,24254,107,7358,1125243.0377358492,140.0,68.76635514018692,107,16896,1116832.858490566,336.0,157.90654205607476
68548.0,6,14,4740,7,653,11302.666666666666,249.0,93.28571428571428,7,4087,10918.166666666666,1514.0,583.8571428571429
120401288.0,6,225,25574,113,17886,1075011.5,374.0,158.28318584070797,112,7688,1075461.5855855856,140.0,68.64285714285714
44099187.0,6,8,1307,8,1307,6299883.857142857,172.0,163.375,0,0,0.0,0.0,0.0
90261101.0,6,14,1964,8,1016,12894443.0,188.0,127.0,6,948,18011702.2,204.0,158.0
90289615.0,6,14,1043,7,542,15048269.166666666,95.0,77.42857142857143,7,501,14998349.166666666,95.0,71.57142857142857
41835.0,6,14,4740,7,653,6465.166666666667,249.0,93.28571428571428,7,4087,6038.666666666667,1514.0,583.8571428571429
4153.0,17,2,598,1,72,0.0,72.0,72.0,1,526,0.0,526.0,526.0
108103361.0,17,5,1005,5,1005,27025840.25,201.0,201.0,0,0,0.0,0.0,0.0
5281.0,17,2,180,1,90,0.0,90.0,90.0,1,90,0.0,90.0,90.0
146529.0,6,2,132,1,66,0.0,66.0,66.0,1,66,0.0,66.0,66.0
4136.0,17,2,582,1,83,0.0,83.0,83.0,1,499,0.0,499.0,499.0
122188.0,6,3,373,2,238,0.0,172.0,119.0,1,135,0.0,135.0,135.0
90293234.0,6,25,2808,12,1354,8204238.454545454,426.0,112.83333333333331,13,1454,7524082.75,358.0,111.84615384615384
16289.000000000002,6,10,1067,5,536,3858.5,264.0,107.2,5,531,3639.25,259.0,106.2
894276.0,6,10,1333,6,796,178855.2,458.0,132.66666666666666,4,537,206103.0,331.0,134.25
221063.0,6,3,426,2,280,0.0,214.0,140.0,1,146,0.0,146.0,146.0
249156.0,6,12,1373,7,714,41526.0,298.0,102.0,5,659,61272.25,379.0,131.8
2198236.0,6,25,7610,14,2582,169095.07692307694,1034.0,184.42857142857144,11,5028,188708.5,1510.0,457.09090909090907
90251452.0,6,12,1832,8,1016,12893064.57142857,188.0,127.0,4,816,30026049.0,204.0,204.0
1021429.0,6,11,1134,6,558,204285.8,220.0,93.0,5,576,254764.25,304.0,115.2
11677.0,6,11,2098,6,590,2121.4,252.0,98.33333333333331,5,1508,2305.0,1236.0,301.6
90053529.0,17,28,13364,28,13364,3335315.888888889,501.0,477.2857142857143,0,0,0.0,0.0,0.0
14990.0,17,2,180,1,90,0.0,90.0,90.0,1,90,0.0,90.0,90.0
38592.0,6,11,2098,6,590,7718.4,252.0,98.33333333333331,5,1508,5777.0,1236.0,301.6
1781.0,17,4,344,2,150,0.0,75.0,75.0,2,194,0.0,103.0,97.0
110221.0,17,2,286,2,286,0.0,143.0,143.0,0,0,0.0,0.0,0.0
308997.0,6,6,412,4,272,102999.0,74.0,68.0,2,140,0.0,74.0,70.0
17301.0,17,2,180,1,90,0.0,90.0,90.0,1,90,0.0,90.0,90.0
51168.0,6,14,4740,7,653,7624.166666666667,249.0,93.28571428571428,7,4087,7515.333333333333,1514.0,583.8571428571429
2383.0,17,4,344,2,150,0.0,75.0,75.0,2,194,0.0,103.0,97.0
105944.0,17,2,286,2,286,0.0,143.0,143.0,0,0,0.0,0.0,0.0
65873.0,17,2,180,1,90,0.0,90.0,90.0,1,90,0.0,90.0,90.0
98239415.0,6,195,22116,98,6690,1012777.474226804,140.0,68.26530612244898,97,15426,1019657.6354166666,336.0,159.03092783505156
90520852.0,6,13,2036,8,1016,12931550.285714284,188.0,127.0,5,1020,22589015.75,204.0,204.0
135140966.0,17,6,1146,6,1146,27028193.2,191.0,191.0,0,0,0.0,0.0,0.0
314940.0,17,4,1400,4,1400,104980.0,350.0,350.0,0,0,0.0,0.0,0.0
155462.0,6,3,337,2,214,0.0,160.0,107.0,1,123,0.0,123.0,123.0
299001.0,6,6,412,4,272,99667.0,74.0,68.0,2,140,0.0,74.0,70.0
330.0,17,2,174,1,79,0.0,79.0,79.0,1,95,0.0,95.0,95.0
5827839.0,6,5,336,2,134,0.0,68.0,67.0,3,202,1525286.0,70.0,67.33333333333333
108107832.0,17,5,1005,5,1005,27026958.0,201.0,201.0,0,0,0.0,0.0,0.0
232479.0,6,3,337,2,214,0.0,160.0,107.0,1,123,0.0,123.0,123.0
108106545.0,17,5,955,5,955,27026636.25,191.0,191.0,0,0,0.0,0.0,0.0
395566.0,6,3,204,2,136,0.0,70.0,68.0,1,68,0.0,68.0,68.0
1178076.0,6,13,1386,7,789,196346.0,253.0,112.71428571428572,6,597,232131.2,259.0,99.5
10306.0,6,10,1067,5,536,2315.5,264.0,107.2,5,531,2363.75,259.0,106.2
99139973.0,17,12,778,6,389,19801228.2,174.0,64.83333333333333,6,389,19800160.6,174.0,64.83333333333333
20632.0,6,14,4740,7,653,3259.333333333333,249.0,93.28571428571428,7,4087,3299.1666666666665,1514.0,583.8571428571429
2123289.0,6,25,7610,13,2516,176940.75,1034.0,193.53846153846155,12,5094,165115.9090909091,1510.0,424.5
228195.0,17,2,180,1,90,0.0,90.0,90.0,1,90,0.0,90.0,90.0
50623.0,6,14,4740,7,653,8309.833333333334,249.0,93.28571428571428,7,4087,7245.666666666667,1514.0,583.8571428571429
18468.0,6,20,7606,11,978,1846.8,310.0,88.9090909090909,9,6628,2022.0,1514.0,736.4444444444445
124028759.0,6,48,3168,24,1584,5012990.217391305,66.0,66.0,24,1584,5301304.217391305,66.0,66.0
2022952.0,17,4,525,2,150,0.0,75.0,75.0,2,375,0.0,284.0,187.5
303658.0,6,2,132,1,66,0.0,66.0,66.0,1,66,0.0,66.0,66.0
203864.0,17,2,762,2,762,0.0,381.0,381.0,0,0,0.0,0.0,0.0
238524.0,6,3,337,2,214,0.0,160.0,107.0,1,123,0.0,123.0,123.0
33819.0,6,14,4740,7,653,5529.5,249.0,93.28571428571428,7,4087,4356.166666666667,1514.0,583.8571428571429
1148221.0,6,13,3000,8,2372,164031.57142857142,1514.0,296.5,5,628,218895.25,331.0,125.6
94744305.0,17,12,778,6,389,18916672.8,174.0,64.83333333333333,6,389,18861579.2,174.0,64.83333333333333
9684.0,17,2,582,1,83,0.0,83.0,83.0,1,499,0.0,499.0,499.0
102692161.0,6,31,2182,16,1165,6831749.666666667,139.0,72.8125,15,1017,7319734.571428572,123.0,67.8
10517061.0,6,7,478,4,272,3460344.0,74.0,68.0,3,206,5190378.0,74.0,68.66666666666667
302593.0,6,6,412,4,272,100864.33333333331,74.0,68.0,2,140,0.0,74.0,70.0
104393.0,17,2,286,2,286,0.0,143.0,143.0,0,0,0.0,0.0,0.0
108991160.0,6,32,2236,16,1165,7251692.066666666,139.0,72.8125,16,1071,7251691.066666666,123.0,66.9375
868816.0,6,9,1269,6,798,173763.2,460.0,133.0,3,471,296594.0,331.0,157.0
233975.0,6,3,337,2,214,0.0,160.0,107.0,1,123,0.0,123.0,123.0
108111244.0,17,5,955,5,955,27027811.0,191.0,191.0,0,0,0.0,0.0,0.0
108109996.0,17,5,955,5,955,27027499.0,191.0,191.0,0,0,0.0,0.0,0.0
17156.0,6,11,1133,6,602,3287.4,264.0,100.33333333333331,5,531,3842.0,259.0,106.2
88403.0,6,14,4740,7,653,14549.833333333334,249.0,93.28571428571428,7,4087,11009.666666666666,1514.0,583.8571428571429
103196.0,17,2,286,2,286,0.0,143.0,143.0,0,0,0.0,0.0,0.0
122978521.0,6,48,3168,24,1584,5126334.956521739,66.0,66.0,24,1584,5140814.956521739,66.0,66.0
140398.0,6,10,1949,5,441,34714.0,169.0,88.2,5,1508,34726.0,1236.0,301.6
109718.0,17,2,286,2,286,0.0,143.0,143.0,0,0,0.0,0.0,0.0
162209.0,17,2,180,1,90,0.0,90.0,90.0,1,90,0.0,90.0,90.0
41236.0,6,14,4740,7,653,5843.333333333333,249.0,93.28571428571428,7,4087,6091.333333333333,1514.0,583.8571428571429
123610506.0,6,49,3234,25,1650,5150437.75,66.0,66.0,24,1584,5080704.391304348,66.0,66.0
22564.0,6,10,2032,5,524,5100.25,252.0,104.8,5,1508,4591.5,1236.0,301.6
5728080.0,6,4,270,2,134,0.0,68.0,67.0,2,136,0.0,70.0,68.0
105367.0,17,2,286,2,286,0.0,143.0,143.0,0,0,0.0,0.0,0.0
232661.0,6,3,337,2,214,0.0,160.0,107.0,1,123,0.0,123.0,123.0
822.0,17,5,550,5,550,205.5,110.0,110.0,0,0,0.0,0.0,0.0
5823965.0,6,5,336,2,134,0.0,68.0,67.0,3,202,1525618.5,70.0,67.33333333333333
120070298.0,6,773,132878,385,25928,312683.0677083333,214.0,67.34545454545454,388,106950,309672.8217054264,1514.0,275.6443298969072
2335.0,17,4,344,2,150,0.0,75.0,75.0,2,194,0.0,103.0,97.0
470.0,17,2,166,1,75,0.0,75.0,75.0,1,91,0.0,91.0,91.0
107927452.0,6,29,2068,15,1105,7693729.214285715,139.0,73.66666666666667,14,963,8285402.538461538,123.0,68.78571428571429
356058.0,6,6,412,4,272,118686.0,74.0,68.0,2,140,0.0,74.0,70.0
26275.0,6,10,2032,5,524,4056.5,252.0,104.8,5,1508,6068.5,1236.0,301.6
228628.0,17,2,180,1,90,0.0,90.0,90.0,1,90,0.0,90.0,90.0
316789.0,17,4,1400,4,1400,105596.33333333331,350.0,350.0,0,0,0.0,0.0,0.0
207962.0,6,3,426,2,280,0.0,214.0,140.0,1,146,0.0,146.0,146.0
226322.0,6,3,426,2,280,0.0,214.0,140.0,1,146,0.0,146.0,146.0
153393.0,17,2,180,1,90,0.0,90.0,90.0,1,90,0.0,90.0,90.0
209516.0,17,2,180,1,90,0.0,90.0,90.0,1,90,0.0,90.0,90.0
228798.0,17,2,180,1,90,0.0,90.0,90.0,1,90,0.0,90.0,90.0
21816.0,17,2,180,1,90,0.0,90.0,90.0,1,90,0.0,90.0,90.0
28122.0,6,14,4740,7,653,3370.1666666666665,249.0,93.28571428571428,7,4087,4549.166666666667,1514.0,583.8571428571429
32066.0,6,10,2032,5,524,7775.5,252.0,104.8,5,1508,7327.75,1236.0,301.6
34146.0,6,14,4740,7,653,5308.833333333333,249.0,93.28571428571428,7,4087,5555.666666666667,1514.0,583.8571428571429
1128267.0,6,13,1386,7,789,188044.5,253.0,112.71428571428572,6,597,223041.2,259.0,99.5
840.0,17,4,438,2,148,0.0,74.0,74.0,2,290,0.0,147.0,145.0
2326.0,17,4,344,2,150,0.0,75.0,75.0,2,194,0.0,103.0,97.0
319882.0,17,4,1400,4,1400,106627.33333333331,350.0,350.0,0,0,0.0,0.0,0.0
16699.0,17,2,180,1,90,0.0,90.0,90.0,1,90,0.0,90.0,90.0
2796678.0,6,2,132,1,66,0.0,66.0,66.0,1,66,0.0,66.0,66.0
1993.0,17,2,180,1,90,0.0,90.0,90.0,1,90,0.0,90.0,90.0
206187.0,6,3,426,2,280,0.0,214.0,140.0,1,146,0.0,146.0,146.0
27490474.0,17,5,1710,5,1710,6872618.5,342.0,342.0,0,0,0.0,0.0,0.0
135135932.0,17,6,1146,6,1146,27027186.4,191.0,191.0,0,0,0.0,0.0,0.0
90304959.0,6,16,1192,8,596,12893165.42857143,95.0,74.5,8,596,12899447.857142856,95.0,74.5
103671656.0,6,30,2122,15,1105,7389697.0,139.0,73.66666666666667,15,1017,7389701.071428572,123.0,67.8
9209.0,6,11,2041,6,533,1653.6,195.0,88.83333333333333,5,1508,2017.75,1236.0,301.6
147921.0,17,2,180,1,90,0.0,90.0,90.0,1,90,0.0,90.0,90.0
851.0,17,4,438,2,148,0.0,74.0,74.0,2,290,0.0,147.0,145.0
994477.0,6,12,1354,6,723,196917.0,253.0,120.5,6,631,198063.0,293.0,105.16666666666669
4373.0,17,2,610,1,72,0.0,72.0,72.0,1,538,0.0,538.0,538.0
281349.0,17,2,363,1,79,0.0,79.0,79.0,1,284,0.0,284.0,284.0
77600.0,6,10,2032,5,524,18974.75,252.0,104.8,5,1508,19123.75,1236.0,301.6
90292915.0,6,17,1287,9,691,11280630.25,95.0,76.77777777777777,8,596,12898325.57142857,95.0,74.5
2202192.0,6,64,53193,26,1874,88087.68,204.0,72.07692307692308,38,51319,59393.45945945946,1514.0,1350.5
307.0,17,2,168,1,76,0.0,76.0,76.0,1,92,0.0,92.0,92.0
40327.0,6,14,4740,7,653,6458.333333333333,249.0,93.28571428571428,7,4087,6538.833333333333,1514.0,583.8571428571429
98000629.0,17,13,1083,7,563,16333438.166666666,174.0,80.42857142857143,6,520,15600124.6,174.0,86.66666666666667
335328.0,6,6,412,4,272,111776.0,74.0,68.0,2,140,0.0,74.0,70.0
296064.0,6,6,412,4,272,98688.0,74.0,68.0,2,140,0.0,74.0,70.0
143893.0,17,2,180,1,90,0.0,90.0,90.0,1,90,0.0,90.0,90.0
113868738.0,6,48,3168,24,1584,4948603.956521739,66.0,66.0,24,1584,4944980.0869565215,66.0,66.0
153476.0,17,2,180,1,90,0.0,90.0,90.0,1,90,0.0,90.0,90.0
121410171.0,6,263,29770,132,20902,926795.1984732824,374.0,158.34848484848484,131,8868,917930.5307692308,140.0,67.69465648854961
90563178.0,6,14,2102,8,1016,12937596.857142856,188.0,127.0,6,1086,18080442.4,204.0,181.0
109353280.0,6,31,2182,16,1165,7275839.666666667,139.0,72.8125,15,1017,7795543.071428572,123.0,67.8
106156575.0,6,44,2904,22,1452,5055075.0,66.0,66.0,22,1452,5040101.238095238,66.0,66.0
39486.0,6,14,4740,7,653,6333.5,249.0,93.28571428571428,7,4087,6435.5,1514.0,583.8571428571429
14470.0,6,13,1459,7,862,2298.5,271.0,123.14285714285714,6,597,2735.8,259.0,99.5
26229.0,6,14,4740,7,653,4245.666666666667,249.0,93.28571428571428,7,4087,4026.8333333333335,1514.0,583.8571428571429
117133325.0,6,48,3168,24,1584,5092753.260869565,66.0,66.0,24,1584,5079333.695652174,66.0,66.0
100249649.0,17,12,778,6,389,20049929.8,174.0,64.83333333333333,6,389,19981091.8,174.0,64.83333333333333
877967.0,6,12,2715,7,743,146327.83333333334,339.0,106.14285714285714,5,1972,150540.5,1514.0,394.4
216237.0,6,10,1221,6,636,43247.4,298.0,106.0,4,585,71081.66666666667,379.0,146.25
112252119.0,17,14,864,7,432,18667495.83333333,174.0,61.71428571428572,7,432,18666830.166666668,174.0,61.71428571428572
303993.0,6,6,412,4,272,101331.0,74.0,68.0,2,140,0.0,74.0,70.0
234463.0,6,3,373,2,238,0.0,172.0,119.0,1,135,0.0,135.0,135.0
210595.0,17,2,414,1,88,0.0,88.0,88.0,1,326,0.0,326.0,326.0
1351158.0,6,2,132,1,66,0.0,66.0,66.0,1,66,0.0,66.0,66.0
123359970.0,6,48,3168,25,1650,5139998.75,66.0,66.0,23,1518,5135451.181818182,66.0,66.0
130679.0,6,3,337,2,214,0.0,160.0,107.0,1,123,0.0,123.0,123.0
13423400.0,6,24,7569,12,1983,1220309.0909090908,408.0,165.25,12,5586,908847.0909090908,1514.0,465.5
347.0,17,2,248,1,84,0.0,84.0,84.0,1,164,0.0,164.0,164.0
373.0,17,2,166,1,75,0.0,75.0,75.0,1,91,0.0,91.0,91.0
303574.0,6,6,412,4,272,101191.33333333331,74.0,68.0,2,140,0.0,74.0,70.0
135136767.0,17,6,1206,6,1206,27027353.4,201.0,201.0,0,0,0.0,0.0,0.0
57950.0,6,10,2032,5,524,14257.25,252.0,104.8,5,1508,13465.5,1236.0,301.6
2305.0,17,4,344,2,150,0.0,75.0,75.0,2,194,0.0,103.0,97.0
135133866.0,17,6,1206,6,1206,27026773.2,201.0,201.0,0,0,0.0,0.0,0.0
196847.0,17,2,180,1,90,0.0,90.0,90.0,1,90,0.0,90.0,90.0
47675.0,6,10,2032,5,524,11498.0,252.0,104.8,5,1508,11184.0,1236.0,301.6
344388.0,6,6,412,4,272,114796.0,74.0,68.0,2,140,0.0,74.0,70.0
118044938.0,6,30,1974,15,1026,8416366.57142857,123.0,68.4,15,948,8416372.5,123.0,63.2
146140.0,6,3,337,2,214,0.0,160.0,107.0,1,123,0.0,123.0,123.0
103831.0,17,2,286,2,286,0.0,143.0,143.0,0,0,0.0,0.0,0.0
202017.0,17,4,6056,4,6056,67339.0,1514.0,1514.0,0,0,0.0,0.0,0.0
206121.0,6,3,426,2,280,0.0,214.0,140.0,1,146,0.0,146.0,146.0
1531.0,17,4,820,2,156,0.0,78.0,78.0,2,664,0.0,332.0,332.0
120130175.0,6,14,2224,9,1204,15016271.875,188.0,133.77777777777777,5,1020,22590258.25,204.0,204.0
112158357.0,6,34,2350,17,1225,6997119.6875,139.0,72.05882352941177,17,1125,6997119.125,123.0,66.17647058823529
10542421.0,6,7,478,4,272,3467058.6666666665,74.0,68.0,3,206,5200514.0,74.0,68.66666666666667
5770.0,17,2,180,1,90,0.0,90.0,90.0,1,90,0.0,90.0,90.0
119942127.0,17,35,16705,35,16705,3527709.617647059,501.0,477.2857142857143,0,0,0.0,0.0,0.0
143968.0,17,2,180,1,90,0.0,90.0,90.0,1,90,0.0,90.0,90.0
308771.0,6,6,412,4,272,102923.66666666669,74.0,68.0,2,140,0.0,74.0,70.0
196872.0,17,2,180,1,90,0.0,90.0,90.0,1,90,0.0,90.0,90.0
120053856.0,17,29,13785,29,13785,4287637.714285715,501.0,475.3448275862069,0,0,0.0,0.0,0.0
90257080.0,6,13,2036,8,1016,12893868.57142857,188.0,127.0,5,1020,22523217.0,204.0,204.0
134175.0,6,2,132,1,66,0.0,66.0,66.0,1,66,0.0,66.0,66.0
161162.0,17,2,180,1,90,0.0,90.0,90.0,1,90,0.0,90.0,90.0
90023317.0,17,28,13364,28,13364,3334196.925925926,501.0,477.2857142857143,0,0,0.0,0.0,0.0
50797.0,17,2,180,1,90,0.0,90.0,90.0,1,90,0.0,90.0,90.0
104159165.0,17,14,1126,7,563,17334493.166666668,174.0,80.42857142857143,7,563,17333558.333333332,174.0,80.42857142857143
13018.0,6,10,1067,5,536,2516.75,264.0,107.2,5,531,2940.0,259.0,106.2
90032782.0,17,28,13364,28,13364,3334547.4814814813,501.0,477.2857142857143,0,0,0.0,0.0,0.0
256859.0,6,3,337,2,214,0.0,160.0,107.0,1,123,0.0,123.0,123.0
0.0,17,1,44,1,44,0.0,44.0,44.0,0,0,0.0,0.0,0.0
108104076.0,17,5,1005,5,1005,27026019.0,201.0,201.0,0,0,0.0,0.0,0.0
90262503.0,6,13,2036,8,1016,12894643.285714284,188.0,127.0,5,1020,22524598.0,204.0,204.0
35200.0,6,10,2032,5,524,8578.5,252.0,104.8,5,1508,6934.25,1236.0,301.6
102415.0,17,2,286,2,286,0.0,143.0,143.0,0,0,0.0,0.0,0.0
48622.0,6,14,4740,7,653,7824.166666666667,249.0,93.28571428571428,7,4087,7945.0,1514.0,583.8571428571429
136829.0,6,2,132,1,66,0.0,66.0,66.0,1,66,0.0,66.0,66.0
861483.0,6,9,1096,6,625,172296.6,287.0,104.16666666666669,3,471,294501.5,331.0,157.0
115938733.0,6,48,3168,24,1584,5040814.478260869,66.0,66.0,24,1584,5027151.173913044,66.0,66.0
49395280.0,6,28,7701,15,1942,3528234.285714286,408.0,129.46666666666667,13,5759,3992083.4166666665,1514.0,443.0
88123.0,6,14,4740,7,653,10515.5,249.0,93.28571428571428,7,4087,14545.0,1514.0,583.8571428571429
284604.0,17,2,363,1,79,0.0,79.0,79.0,1,284,0.0,284.0,284.0
335.0,17,2,267,1,83,0.0,83.0,83.0,1,184,0.0,184.0,184.0
115007155.0,17,13,821,7,432,19167859.166666668,174.0,61.71428571428572,6,389,20026368.2,174.0,64.83333333333333
196906.0,17,2,180,1,90,0.0,90.0,90.0,1,90,0.0,90.0,90.0
129040.0,17,4,1400,4,1400,43013.333333333336,350.0,350.0,0,0,0.0,0.0,0.0
23675.0,6,10,2032,5,524,5672.0,252.0,104.8,5,1508,5655.25,1236.0,301.6
246391.0,6,3,337,2,214,0.0,160.0,107.0,1,123,0.0,123.0,123.0
204828.0,17,2,762,2,762,0.0,381.0,381.0,0,0,0.0,0.0,0.0
119959.0,17,2,180,1,70,0.0,70.0,70.0,1,110,0.0,110.0,110.0
112196380.0,6,32,2220,16,1149,7465372.066666666,123.0,71.8125,16,1071,7465370.866666666,123.0,66.9375
5622984.0,6,4,270,2,134,0.0,68.0,67.0,2,136,0.0,70.0,68.0
3505613.0,6,7,923,4,753,1096302.3333333333,571.0,188.25,3,170,1645089.0,62.0,56.66666666666666
98134.0,17,2,762,2,762,0.0,381.0,381.0,0,0,0.0,0.0,0.0
35406.0,6,14,4740,7,653,5616.166666666667,249.0,93.28571428571428,7,4087,5619.666666666667,1514.0,583.8571428571429
26992.0,6,14,4740,7,653,3987.6666666666665,249.0,93.28571428571428,7,4087,4237.5,1514.0,583.8571428571429
107259.0,17,2,286,2,286,0.0,143.0,143.0,0,0,0.0,0.0,0.0
135127464.0,17,6,1206,6,1206,27025492.8,201.0,201.0,0,0,0.0,0.0,0.0
120164136.0,6,20,1490,10,745,13327661.111111112,95.0,74.5,10,745,10103200.333333334,95.0,74.5
90258151.0,6,12,1832,8,1016,12894021.57142857,188.0,127.0,4,816,30031209.0,204.0,204.0
253.00000000000003,17,4,6056,4,6056,84.33333333333333,1514.0,1514.0,0,0,0.0,0.0,0.0
228402.0,17,2,180,1,90,0.0,90.0,90.0,1,90,0.0,90.0,90.0
108111283.0,17,5,955,5,955,27027820.75,191.0,191.0,0,0,0.0,0.0,0.0
233254.0,6,3,337,2,214,0.0,160.0,107.0,1,123,0.0,123.0,123.0
108116634.0,17,5,1005,5,1005,27029158.5,201.0,201.0,0,0,0.0,0.0,0.0
217415.0,6,3,426,2,280,0.0,214.0,140.0,1,146,0.0,146.0,146.0
135134122.0,17,6,1146,6,1146,27026824.4,191.0,191.0,0,0,0.0,0.0,0.0
109300545.0,6,44,2904,22,1452,5204787.857142857,66.0,66.0,22,1452,5189892.333333333,66.0,66.0
15288389.0,17,6,2052,6,2052,3057677.8,342.0,342.0,0,0,0.0,0.0,0.0
2061.0,17,4,344,2,150,0.0,75.0,75.0,2,194,0.0,103.0,97.0
61573.0,6,2,145,2,145,0.0,91.0,72.5,0,0,0.0,0.0,0.0
56394.0,6,10,1065,5,534,12289.25,262.0,106.8,5,531,10410.75,259.0,106.2
4144.0,17,2,598,1,72,0.0,72.0,72.0,1,526,0.0,526.0,526.0
148489.0,17,2,414,1,88,0.0,88.0,88.0,1,326,0.0,326.0,326.0
120231.0,17,2,180,1,70,0.0,70.0,70.0,1,110,0.0,110.0,110.0
3589.0,17,4,344,2,150,0.0,75.0,75.0,2,194,0.0,103.0,97.0
503674.0,6,3,204,2,136,0.0,70.0,68.0,1,68,0.0,68.0,68.0
14635517.0,6,20,1646,10,1014,1592692.5555555555,315.0,101.4,10,632,1592663.5555555555,78.0,63.2
55584.0,6,10,2032,5,524,13203.75,252.0,104.8,5,1508,13481.25,1236.0,301.6
119634341.0,17,35,16705,35,16705,3518657.088235294,501.0,477.2857142857143,0,0,0.0,0.0,0.0
108103325.0,17,5,1005,5,1005,27025831.25,201.0,201.0,0,0,0.0,0.0,0.0
296.0,17,2,164,1,82,0.0,82.0,82.0,1,82,0.0,82.0,82.0
90228685.0,6,27,2073,12,935,8179739.181818182,95.0,77.91666666666667,15,1138,6429531.642857143,95.0,75.86666666666666
4379.0,17,2,602,1,72,0.0,72.0,72.0,1,530,0.0,530.0,530.0
314.0,17,2,174,1,79,0.0,79.0,79.0,1,95,0.0,95.0,95.0
320413.0,6,6,412,4,272,106804.33333333331,74.0,68.0,2,140,0.0,74.0,70.0
2052.0,17,4,344,2,150,0.0,75.0,75.0,2,194,0.0,103.0,97.0
90532053.0,6,13,2036,8,1016,12933150.42857143,188.0,127.0,5,1020,22589340.25,204.0,204.0
13994.0,6,10,1065,5,534,2966.5,262.0,106.8,5,531,2517.25,259.0,106.2
95825117.0,17,14,4796,13,4446,6229464.75,342.0,342.0,1,350,0.0,350.0,350.0
275045.0,6,10,1221,6,636,55009.0,298.0,106.0,4,585,85295.33333333333,379.0,146.25
120126509.0,6,13,2036,5,1020,30031627.25,204.0,204.0,8,1016,17137122.714285713,188.0,127.0
120000069.0,6,17,1287,9,691,15000008.625,95.0,76.77777777777777,8,596,12897819.714285716,95.0,74.5
316032.0,17,4,1400,4,1400,105344.0,350.0,350.0,0,0,0.0,0.0,0.0
120131978.0,6,12,1832,8,1016,17138912.57142857,188.0,127.0,4,816,30033726.33333333,204.0,204.0
90254631.0,6,12,1832,8,1016,12893518.714285716,188.0,127.0,4,816,30031032.666666668,204.0,204.0
0.0,17,1,99,1,99,0.0,99.0,99.0,0,0,0.0,0.0,0.0
10507372.0,6,7,478,4,272,3456776.0,74.0,68.0,3,206,5185075.5,74.0,68.66666666666667
103533.0,17,2,286,2,286,0.0,143.0,143.0,0,0,0.0,0.0,0.0
515179.00000000006,6,5,336,2,134,0.0,68.0,67.0,3,202,194661.0,70.0,67.33333333333333
99375.0,17,2,762,2,762,0.0,381.0,381.0,0,0,0.0,0.0,0.0
104315610.0,17,14,864,7,432,17333517.333333332,174.0,61.71428571428572,7,432,17336511.5,174.0,61.71428571428572
150018761.0,17,36,17126,36,17126,4286250.314285714,501.0,475.72222222222223,0,0,0.0,0.0,0.0
119614585.0,6,230,26518,115,18632,1047352.1315789474,336.0,162.01739130434785,115,7886,1047357.3596491228,140.0,68.57391304347826
217685.0,6,3,426,2,280,0.0,214.0,140.0,1,146,0.0,146.0,146.0
96707686.0,6,26,1746,13,906,8040998.416666667,123.0,69.6923076923077,13,840,8040998.833333333,123.0,64.61538461538461
118997401.0,6,216,24424,108,7424,1112125.2429906542,140.0,68.74074074074075,108,17000,1109956.046728972,284.0,157.40740740740742
2364.0,17,4,344,2,150,0.0,75.0,75.0,2,194,0.0,103.0,97.0
146831.0,6,3,337,2,214,0.0,160.0,107.0,1,123,0.0,123.0,123.0
27750704.0,17,5,1710,5,1710,6937676.0,342.0,342.0,0,0,0.0,0.0,0.0
129259294.0,17,14,995,7,432,19833497.5,174.0,61.71428571428572,7,563,18498998.0,174.0,80.42857142857143
2031.0,17,4,344,2,150,0.0,75.0,75.0,2,194,0.0,103.0,97.0
123455591.0,6,48,3168,24,1584,5046948.347826087,66.0,66.0,24,1584,5220872.173913044,66.0,66.0
3390468.0,6,7,923,4,753,1061739.0,571.0,188.25,3,170,1592676.0,62.0,56.66666666666666
3151950.0,6,3,204,1,68,0.0,68.0,68.0,2,136,0.0,70.0,68.0
42436.0,6,14,4740,7,653,6737.333333333333,249.0,93.28571428571428,7,4087,6834.833333333333,1514.0,583.8571428571429
99721.0,6,10,2032,5,524,24256.5,252.0,104.8,5,1508,21894.5,1236.0,301.6
108107106.0,17,5,955,5,955,27026776.5,191.0,191.0,0,0,0.0,0.0,0.0
90037034.0,17,28,13364,28,13364,3334704.962962963,501.0,477.2857142857143,0,0,0.0,0.0,0.0
108109072.0,17,5,955,5,955,27027268.0,191.0,191.0,0,0,0.0,0.0,0.0
209520.0,17,2,180,1,90,0.0,90.0,90.0,1,90,0.0,90.0,90.0
1127955.0,17,6,1230,3,234,563792.5,78.0,78.0,3,996,563770.0,332.0,332.0
14960.0,6,10,1949,5,441,3506.5,169.0,88.2,5,1508,3451.0,1236.0,301.6
250300.00000000003,6,3,337,2,214,0.0,160.0,107.0,1,123,0.0,123.0,123.0
306346.0,6,6,412,4,272,102115.33333333331,74.0,68.0,2,140,0.0,74.0,70.0
3006246.0,6,12,2172,7,664,500808.3333333333,252.0,94.85714285714286,5,1508,1970.25,1236.0,301.6
75037988.0,6,9,842,9,842,9379748.5,97.0,93.55555555555556,0,0,0.0,0.0,0.0
564.0,17,2,508,2,508,0.0,257.0,254.0,0,0,0.0,0.0,0.0
1169523.0,6,13,3012,8,2384,167074.7142857143,1514.0,298.0,5,628,224213.25,331.0,125.6
3296070.0,6,197,159573,110,149529,30239.174311926607,1510.0,1359.3545454545454,87,10044,34782.03488372093,1510.0,115.44827586206895
2362.0,17,4,344,2,150,0.0,75.0,75.0,2,194,0.0,103.0,97.0
811.0,17,4,438,2,148,0.0,74.0,74.0,2,290,0.0,147.0,145.0
120125400.0,6,16,2632,9,1204,15015675.0,188.0,133.77777777777777,7,1428,15061711.833333334,204.0,204.0
207870.0,6,3,426,2,280,0.0,214.0,140.0,1,146,0.0,146.0,146.0
196936.0,17,2,180,1,90,0.0,90.0,90.0,1,90,0.0,90.0,90.0
108106503.0,17,5,955,5,955,27026625.75,191.0,191.0,0,0,0.0,0.0,0.0
78161.0,6,14,4740,7,653,10049.0,249.0,93.28571428571428,7,4087,10477.5,1514.0,583.8571428571429
117302255.0,6,219,24818,110,17328,1076167.4770642202,284.0,157.52727272727273,109,7490,1076510.6574074074,140.0,68.71559633027523
197005.0,17,2,180,1,90,0.0,90.0,90.0,1,90,0.0,90.0,90.0
120417237.0,6,247,28080,124,19740,979001.9268292685,300.0,159.19354838709677,123,8340,978528.713114754,140.0,67.8048780487805
90289155.0,6,16,1192,8,596,12892293.142857144,95.0,74.5,8,596,12896793.0,95.0,74.5
319511.0,17,2,604,1,75,0.0,75.0,75.0,1,529,0.0,529.0,529.0
74915.0,6,14,4740,7,653,12096.166666666666,249.0,93.28571428571428,7,4087,11727.166666666666,1514.0,583.8571428571429
2518.0,17,4,344,2,150,0.0,75.0,75.0,2,194,0.0,103.0,97.0
110507914.0,17,14,864,7,432,18334264.666666668,174.0,61.71428571428572,7,432,18333492.5,174.0,61.71428571428572
338.0,17,2,267,1,83,0.0,83.0,83.0,1,184,0.0,184.0,184.0
90706299.0,6,21,1585,10,745,10078477.666666666,95.0,74.5,11,840,9044568.6,95.0,76.36363636363636
110956895.0,6,383,45954,192,33052,580926.1518324608,374.0,172.14583333333334,191,12902,580350.2263157895,140.0,67.54973821989529
216745.0,17,2,180,1,90,0.0,90.0,90.0,1,90,0.0,90.0,90.0
107394802.0,6,30,2106,15,1089,7655642.0,123.0,72.6,15,1017,7655643.928571428,123.0,67.8
216245.0,17,2,180,1,90,0.0,90.0,90.0,1,90,0.0,90.0,90.0
216449.0,17,2,180,1,90,0.0,90.0,90.0,1,90,0.0,90.0,90.0
2864.0,17,4,344,2,150,0.0,75.0,75.0,2,194,0.0,103.0,97.0
206042.0,17,2,180,1,90,0.0,90.0,90.0,1,90,0.0,90.0,90.0
303948.0,6,6,412,4,272,101316.0,74.0,68.0,2,140,0.0,74.0,70.0
24019.0,6,14,4740,7,653,3823.6666666666665,249.0,93.28571428571428,7,4087,3868.3333333333335,1514.0,583.8571428571429
107689339.0,6,31,2166,16,1149,7164888.066666666,123.0,71.8125,15,1017,7676654.071428572,123.0,67.8
1050483.0,6,13,1386,7,789,175080.5,253.0,112.71428571428572,6,597,208301.0,259.0,99.5
237230.0,17,4,1524,4,1524,79076.66666666667,381.0,381.0,0,0,0.0,0.0,0.0
25183790.0,17,5,1718,4,1368,1730186.3333333333,342.0,342.0,1,350,0.0,350.0,350.0
153442.0,17,2,180,1,90,0.0,90.0,90.0,1,90,0.0,90.0,90.0
57725.0,6,12,1320,6,723,11153.0,253.0,120.5,6,597,10713.2,259.0,99.5
233049.0,6,3,337,2,214,0.0,160.0,107.0,1,123,0.0,123.0,123.0
2310.0,17,4,344,2,150,0.0,75.0,75.0,2,194,0.0,103.0,97.0
322184.0,17,4,1400,4,1400,107394.66666666669,350.0,350.0,0,0,0.0,0.0,0.0
4427.0,17,2,626,1,72,0.0,72.0,72.0,1,554,0.0,554.0,554.0
130253.0,6,11,2098,6,590,23813.0,252.0,98.33333333333331,5,1508,32012.75,1236.0,301.6
135138257.0,17,6,1206,6,1206,27027651.4,201.0,201.0,0,0,0.0,0.0,0.0
206372.0,17,2,762,2,762,0.0,381.0,381.0,0,0,0.0,0.0,0.0
299943.0,6,6,412,4,272,99981.0,74.0,68.0,2,140,0.0,74.0,70.0
250606.0,6,3,337,2,214,0.0,160.0,107.0,1,123,0.0,123.0,123.0
107319.0,17,2,286,2,286,0.0,143.0,143.0,0,0,0.0,0.0,0.0
120713.0,6,3,337,2,214,0.0,160.0,107.0,1,123,0.0,123.0,123.0
90993993.0,6,21,1585,11,840,9094565.1,95.0,76.36363636363636,10,745,10109524.111111112,95.0,74.5
504345.00000000006,6,5,336,2,134,0.0,68.0,67.0,3,202,195668.0,70.0,67.33333333333333
13788.0,6,11,1131,6,600,2674.0,262.0,100.0,5,531,2664.0,259.0,106.2
135139525.0,17,6,1206,6,1206,27027905.0,201.0,201.0,0,0,0.0,0.0,0.0
146243.0,6,3,337,2,214,0.0,160.0,107.0,1,123,0.0,123.0,123.0
1329.0,6,2,128,1,74,0.0,74.0,74.0,1,54,0.0,54.0,54.0
38018.0,6,14,4740,7,653,6183.5,249.0,93.28571428571428,7,4087,6167.666666666667,1514.0,583.8571428571429
153576.0,17,2,180,1,90,0.0,90.0,90.0,1,90,0.0,90.0,90.0
92520490.0,6,178,20094,89,6096,1042006.5227272728,140.0,68.49438202247191,89,13998,1043284.5340909092,284.0,157.2808988764045
96317491.0,17,12,778,6,389,19201602.2,174.0,64.83333333333333,6,389,19200163.4,174.0,64.83333333333333
1307032.0,6,4,264,2,132,0.0,66.0,66.0,2,132,0.0,66.0,66.0
148704.0,17,2,414,1,88,0.0,88.0,88.0,1,326,0.0,326.0,326.0
24327.0,6,12,1413,7,882,4054.5,291.0,126.0,5,531,4831.5,259.0,106.2
451.0,17,2,166,1,75,0.0,75.0,75.0,1,91,0.0,91.0,91.0
153453.0,17,2,180,1,90,0.0,90.0,90.0,1,90,0.0,90.0,90.0
20774480.0,6,22,1739,11,1029,2047561.0,315.0,93.54545454545456,11,710,2047539.6,78.0,64.54545454545455
108103311.0,17,5,955,5,955,27025827.75,191.0,191.0,0,0,0.0,0.0,0.0
110817785.0,6,31,2176,16,1071,7387852.333333333,123.0,66.9375,15,1105,7186882.285714285,139.0,73.66666666666667
123840026.0,6,49,3234,25,1650,5160001.083333333,66.0,66.0,24,1584,5156927.260869565,66.0,66.0
108183.0,17,2,286,2,286,0.0,143.0,143.0,0,0,0.0,0.0,0.0
250286.0,17,4,6056,4,6056,83428.66666666667,1514.0,1514.0,0,0,0.0,0.0,0.0
119820360.0,17,35,16705,35,16705,3524128.2352941176,501.0,477.2857142857143,0,0,0.0,0.0,0.0
310712.0,6,6,412,4,272,103570.66666666669,74.0,68.0,2,140,0.0,74.0,70.0
17014.0,6,14,4740,7,653,2514.333333333333,249.0,93.28571428571428,7,4087,2301.833333333333,1514.0,583.8571428571429
42652.0,6,14,4740,7,653,6984.833333333333,249.0,93.28571428571428,7,4087,6927.166666666667,1514.0,583.8571428571429
238133.0,17,2,180,1,90,0.0,90.0,90.0,1,90,0.0,90.0,90.0
2356.0,17,4,344,2,150,0.0,75.0,75.0,2,194,0.0,103.0,97.0
91015982.0,6,162,18346,81,12840,1135011.025,284.0,158.5185185185185,81,5506,1135011.075,140.0,67.9753086419753
228430.0,17,2,180,1,90,0.0,90.0,90.0,1,90,0.0,90.0,90.0
48700.0,6,14,4740,7,653,6789.5,249.0,93.28571428571428,7,4087,7683.833333333333,1514.0,583.8571428571429
106861050.0,6,32,2236,16,1165,7109671.933333334,139.0,72.8125,16,1071,7109674.8,123.0,66.9375
352.0,17,2,267,1,83,0.0,83.0,83.0,1,184,0.0,184.0,184.0
4457.0,17,2,626,1,72,0.0,72.0,72.0,1,554,0.0,554.0,554.0
153455.0,17,2,180,1,90,0.0,90.0,90.0,1,90,0.0,90.0,90.0
5007853.0,17,4,849,2,166,0.0,83.0,83.0,2,683,0.0,499.0,341.5
2337.0,17,4,344,2,150,0.0,75.0,75.0,2,194,0.0,103.0,97.0
257724.0,6,3,337,2,214,0.0,160.0,107.0,1,123,0.0,123.0,123.0
212643.0,17,2,762,2,762,0.0,381.0,381.0,0,0,0.0,0.0,0.0
1022106.0,6,11,1134,6,558,204421.2,220.0,93.0,5,576,255068.0,304.0,115.2
216396.0,17,2,180,1,90,0.0,90.0,90.0,1,90,0.0,90.0,90.0
90061929.0,17,28,13364,28,13364,3335627.0,501.0,477.2857142857143,0,0,0.0,0.0,0.0
27106314.0,17,5,1710,5,1710,6776578.5,342.0,342.0,0,0,0.0,0.0,0.0
132831.0,6,3,337,2,214,0.0,160.0,107.0,1,123,0.0,123.0,123.0
205082.0,17,2,762,2,762,0.0,381.0,381.0,0,0,0.0,0.0,0.0
90529840.0,6,14,2240,8,1016,12932834.285714284,188.0,127.0,6,1224,18072811.8,204.0,204.0
1350071.0,17,16,1120,16,1120,90004.73333333334,70.0,70.0,0,0,0.0,0.0,0.0
826543.0,6,9,1118,6,586,165308.6,248.0,97.66666666666669,3,532,276947.5,392.0,177.33333333333334
148829.0,6,3,373,2,238,0.0,172.0,119.0,1,135,0.0,135.0,135.0
5626757.0,6,5,336,2,134,0.0,68.0,67.0,3,202,1526351.0,70.0,67.33333333333333
135128205.0,17,6,1146,6,1146,27025641.0,191.0,191.0,0,0,0.0,0.0,0.0
12681.0,6,12,1393,6,796,2404.6,271.0,132.66666666666666,6,597,2376.4,259.0,99.5
209605.0,17,2,180,1,90,0.0,90.0,90.0,1,90,0.0,90.0,90.0
228185.0,17,2,180,1,90,0.0,90.0,90.0,1,90,0.0,90.0,90.0
2380.0,17,4,344,2,150,0.0,75.0,75.0,2,194,0.0,103.0,97.0
6625.0,17,4,823,2,163,0.0,89.0,81.5,2,660,0.0,443.0,330.0
9844.0,17,2,582,1,83,0.0,83.0,83.0,1,499,0.0,499.0,499.0
217850.0,6,3,426,2,280,0.0,214.0,140.0,1,146,0.0,146.0,146.0
90300658.0,6,16,1192,8,596,12893650.714285716,95.0,74.5,8,596,12899453.57142857,95.0,74.5
419145.0,6,3,1604,1,753,0.0,753.0,753.0,2,851,0.0,785.0,425.5
2743540.0,6,30,9358,17,3897,171471.25,1514.0,229.23529411764707,13,5461,206503.0833333333,1514.0,420.0769230769231
52170.0,6,12,1320,6,723,9331.4,253.0,120.5,6,597,9601.4,259.0,99.5
869.0,17,5,550,5,550,217.25,110.0,110.0,0,0,0.0,0.0,0.0
109493700.0,6,2272,1957424,713,47058,153783.28651685393,66.0,66.0,1559,1910366,70270.65468549423,1514.0,1225.3790891597178
120000035.0,6,21,1626,12,935,10909094.090909092,95.0,77.91666666666667,9,691,11225451.375,95.0,76.77777777777777
90040277.0,17,27,12943,27,12943,3463087.576923077,501.0,479.3703703703704,0,0,0.0,0.0,0.0
32727.0,6,14,4740,7,653,5274.333333333333,249.0,93.28571428571428,7,4087,5150.0,1514.0,583.8571428571429
119320503.0,6,271,31024,136,21818,883855.5777777778,284.0,160.4264705882353,135,9206,885636.9253731343,140.0,68.19259259259259
320910.0,17,4,1400,4,1400,106970.0,350.0,350.0,0,0,0.0,0.0,0.0
277938.0,17,6,1230,3,234,138782.0,78.0,78.0,3,996,138750.0,332.0,332.0
294.0,17,2,156,1,78,0.0,78.0,78.0,1,78,0.0,78.0,78.0
97635.0,17,2,762,2,762,0.0,381.0,381.0,0,0,0.0,0.0,0.0
0.0,17,1,90,1,90,0.0,90.0,90.0,0,0,0.0,0.0,0.0
104480.0,17,2,700,2,700,0.0,350.0,350.0,0,0,0.0,0.0,0.0
111579616.0,6,32,2220,16,1149,7424259.866666666,123.0,71.8125,16,1071,7424262.4,123.0,66.9375
108099168.0,17,5,1005,5,1005,27024792.0,201.0,201.0,0,0,0.0,0.0,0.0
133012306.0,17,17,1255,9,649,16626538.25,174.0,72.11111111111111,8,606,16192353.42857143,174.0,75.75
2530.0,17,4,344,2,150,0.0,75.0,75.0,2,194,0.0,103.0,97.0
232574.0,6,3,337,2,214,0.0,160.0,107.0,1,123,0.0,123.0,123.0
295731.0,6,12,1373,7,714,49288.5,298.0,102.0,5,659,71798.0,379.0,131.8
90258653.0,6,16,2368,9,1204,11282331.625,188.0,133.77777777777777,7,1164,15015589.333333334,204.0,166.28571428571428
302564.0,6,6,412,4,272,100854.66666666669,74.0,68.0,2,140,0.0,74.0,70.0
1613889.0,6,8,602,5,404,379703.75,103.0,80.8,3,198,201548.0,66.0,66.0
696689.0,6,10,1124,6,608,139337.8,222.0,101.33333333333331,4,516,146839.0,206.0,129.0
135129533.0,17,6,1206,6,1206,27025906.6,201.0,201.0,0,0,0.0,0.0,0.0
120000034.0,6,18,1382,10,786,13333337.111111112,95.0,78.6,8,596,12896706.42857143,95.0,74.5
153412.0,17,2,180,1,90,0.0,90.0,90.0,1,90,0.0,90.0,90.0
41111.0,6,14,4740,7,653,6508.833333333333,249.0,93.28571428571428,7,4087,6122.0,1514.0,583.8571428571429
346.0,17,2,160,1,80,0.0,80.0,80.0,1,80,0.0,80.0,80.0
5625600.0,6,4,270,2,134,0.0,68.0,67.0,2,136,0.0,70.0,68.0
322.0,17,2,208,1,72,0.0,72.0,72.0,1,136,0.0,136.0,136.0
25382.0,6,10,2032,5,524,5471.75,252.0,104.8,5,1508,5768.0,1236.0,301.6
108101078.0,17,5,955,5,955,27025269.5,191.0,191.0,0,0,0.0,0.0,0.0
14236080.0,17,6,2052,6,2052,2847216.0,342.0,342.0,0,0,0.0,0.0,0.0
108188284.0,6,217,24452,109,17028,1001743.3703703705,284.0,156.22018348623854,108,7424,1001533.906542056,140.0,68.74074074074075
437659.0,6,11,1021,6,444,58768.6,162.0,74.0,5,577,73280.5,349.0,115.4
112535565.0,6,46,3036,23,1518,5105440.090909091,66.0,66.0,23,1518,5105439.636363637,66.0,66.0
23021954.0,17,3,1034,2,684,0.0,342.0,342.0,1,350,0.0,350.0,350.0
25007.0,6,10,2032,5,524,5551.0,252.0,104.8,5,1508,5378.5,1236.0,301.6
121196.0,6,3,373,2,238,0.0,172.0,119.0,1,135,0.0,135.0,135.0
2421.0,17,4,344,2,150,0.0,75.0,75.0,2,194,0.0,103.0,97.0
300871.0,6,6,412,4,272,100290.33333333331,74.0,68.0,2,140,0.0,74.0,70.0
304971.0,6,6,412,4,272,101657.0,74.0,68.0,2,140,0.0,74.0,70.0
110716504.0,6,29,1930,15,948,7908321.714285715,123.0,63.2,14,982,7731997.846153846,139.0,70.14285714285714
906.0,17,5,550,5,550,226.5,110.0,110.0,0,0,0.0,0.0,0.0
246636.0,6,3,337,2,214,0.0,160.0,107.0,1,123,0.0,123.0,123.0
63949.00000000001,6,14,4740,7,653,10119.666666666666,249.0,93.28571428571428,7,4087,8606.333333333334,1514.0,583.8571428571429
126560754.0,17,14,864,7,432,17833495.0,174.0,61.71428571428572,7,432,17834279.166666668,174.0,61.71428571428572
294.0,17,2,156,1,78,0.0,78.0,78.0,1,78,0.0,78.0,78.0
2070.0,17,4,344,2,150,0.0,75.0,75.0,2,194,0.0,103.0,97.0
232504.0,6,4,492,2,280,0.0,214.0,140.0,2,212,0.0,146.0,106.0
1024826.0,6,11,1134,6,558,204965.2,220.0,93.0,5,576,254353.5,304.0,115.2
209544.0,6,3,426,2,280,0.0,214.0,140.0,1,146,0.0,146.0,146.0
261185.0,6,4,492,2,280,0.0,214.0,140.0,2,212,0.0,146.0,106.0
280842.0,17,2,363,1,79,0.0,79.0,79.0,1,284,0.0,284.0,284.0
144438.0,17,2,180,1,90,0.0,90.0,90.0,1,90,0.0,90.0,90.0
23840.0,6,14,4740,7,653,3847.0,249.0,93.28571428571428,7,4087,3760.8333333333335,1514.0,583.8571428571429
8912.0,17,2,507,1,86,0.0,86.0,86.0,1,421,0.0,421.0,421.0
2925151.0,6,136,119225,83,111882,31969.414634146346,1510.0,1347.9759036144578,53,7343,50412.557692307695,1510.0,138.54716981132074
10459633.0,6,6,412,3,206,5162018.5,74.0,68.66666666666667,3,206,5161904.5,74.0,68.66666666666667
108585.0,17,2,286,2,286,0.0,143.0,143.0,0,0,0.0,0.0,0.0
508297.0,6,5,336,2,134,0.0,68.0,67.0,3,202,194032.5,70.0,67.33333333333333
118013471.0,6,48,3168,24,1584,5131020.478260869,66.0,66.0,24,1584,5117970.826086956,66.0,66.0
312404.0,6,3,202,2,128,0.0,74.0,64.0,1,74,0.0,74.0,74.0
24740126.0,17,5,1718,4,1368,931398.3333333334,342.0,342.0,1,350,0.0,350.0,350.0
146106.0,6,3,337,2,214,0.0,160.0,107.0,1,123,0.0,123.0,123.0
108112548.0,17,5,955,5,955,27028137.0,191.0,191.0,0,0,0.0,0.0,0.0
28515.0,6,14,4740,7,653,4634.666666666667,249.0,93.28571428571428,7,4087,4346.0,1514.0,583.8571428571429
2327.0,17,4,344,2,150,0.0,75.0,75.0,2,194,0.0,103.0,97.0
27076.0,6,14,4740,7,653,4390.5,249.0,93.28571428571428,7,4087,4304.0,1514.0,583.8571428571429
228201.0,17,2,180,1,90,0.0,90.0,90.0,1,90,0.0,90.0,90.0
2326.0,17,4,344,2,150,0.0,75.0,75.0,2,194,0.0,103.0,97.0
35961.0,6,10,2032,5,524,7463.25,252.0,104.8,5,1508,7956.5,1236.0,301.6
34067.0,6,14,4740,7,653,4462.0,249.0,93.28571428571428,7,4087,5545.333333333333,1514.0,583.8571428571429
35820.0,6,10,1065,5,534,8596.5,262.0,106.8,5,531,8579.0,259.0,106.2
202121.0,17,2,614,1,72,0.0,72.0,72.0,1,542,0.0,542.0,542.0
22849.0,6,14,4740,7,653,3435.1666666666665,249.0,93.28571428571428,7,4087,3589.6666666666665,1514.0,583.8571428571429
3190558.0,6,7,923,4,753,994882.0,571.0,188.25,3,170,1492666.0,62.0,56.66666666666666
120021890.0,17,28,13364,28,13364,4445255.185185186,501.0,477.2857142857143,0,0,0.0,0.0,0.0
108109197.0,17,5,1005,5,1005,27027299.25,201.0,201.0,0,0,0.0,0.0,0.0
2332.0,17,4,344,2,150,0.0,75.0,75.0,2,194,0.0,103.0,97.0
307015.0,6,6,412,4,272,102338.33333333331,74.0,68.0,2,140,0.0,74.0,70.0
90296618.0,6,21,1585,11,840,9025215.3,95.0,76.36363636363636,10,745,10001287.333333334,95.0,74.5
1175336.0,6,11,1134,6,558,235067.2,220.0,93.0,5,576,293007.25,304.0,115.2
90039114.0,17,28,13364,28,13364,3334782.0,501.0,477.2857142857143,0,0,0.0,0.0,0.0
117299.0,6,13,1459,7,862,19396.666666666668,271.0,123.14285714285714,6,597,23039.8,259.0,99.5
495654.0,6,5,336,2,134,0.0,68.0,67.0,3,202,194380.0,70.0,67.33333333333333
209833.0,6,3,426,2,280,0.0,214.0,140.0,1,146,0.0,146.0,146.0
1246801.0,6,7,499,4,301,396753.0,103.0,75.25,3,198,613917.5,66.0,66.0
206315.0,6,3,426,2,280,0.0,214.0,140.0,1,146,0.0,146.0,146.0
66989.0,6,12,1320,7,789,11164.833333333334,253.0,112.71428571428572,5,531,15220.75,259.0,106.2
14665.0,6,11,2098,6,590,2682.8,252.0,98.33333333333331,5,1508,3297.25,1236.0,301.6
41060.0,6,14,4740,7,653,6722.0,249.0,93.28571428571428,7,4087,4045.5,1514.0,583.8571428571429
516128.00000000006,6,3,204,1,68,0.0,68.0,68.0,2,136,0.0,70.0,68.0
2412.0,17,4,344,2,150,0.0,75.0,75.0,2,194,0.0,103.0,97.0
2323.0,17,4,344,2,150,0.0,75.0,75.0,2,194,0.0,103.0,97.0
208678.0,6,4,492,2,280,0.0,214.0,140.0,2,212,0.0,146.0,106.0
209517.0,17,2,180,1,90,0.0,90.0,90.0,1,90,0.0,90.0,90.0
1175071.0,6,13,1386,7,789,195845.16666666663,253.0,112.71428571428572,6,597,233114.8,259.0,99.5
119599151.0,6,235,26556,118,8084,1022214.9658119658,140.0,68.50847457627118,117,18472,1029010.75,284.0,157.8803418803419
370.0,17,2,166,1,75,0.0,75.0,75.0,1,91,0.0,91.0,91.0
135137695.0,17,6,1206,6,1206,27027539.0,201.0,201.0,0,0,0.0,0.0,0.0
108107383.0,17,5,955,5,955,27026845.75,191.0,191.0,0,0,0.0,0.0,0.0
30421185.0,6,5,336,2,134,0.0,68.0,67.0,3,202,15143977.0,70.0,67.33333333333333
120012022.0,6,23,1734,12,935,10909081.454545457,95.0,77.91666666666667,11,799,11997389.8,95.0,72.63636363636364
113253598.0,6,36,2596,18,1348,6661976.352941177,139.0,74.88888888888889,18,1248,6649183.588235294,123.0,69.33333333333333
321953.0,17,4,1400,4,1400,107317.66666666669,350.0,350.0,0,0,0.0,0.0,0.0
37683.0,6,14,4740,7,653,6118.833333333333,249.0,93.28571428571428,7,4087,5974.333333333333,1514.0,583.8571428571429
121305.0,6,3,337,2,214,0.0,160.0,107.0,1,123,0.0,123.0,123.0
197074.0,17,2,180,1,90,0.0,90.0,90.0,1,90,0.0,90.0,90.0
120067482.0,17,28,13364,28,13364,4446943.777777778,501.0,477.2857142857143,0,0,0.0,0.0,0.0
61524.0,6,14,4740,7,653,9608.166666666666,249.0,93.28571428571428,7,4087,9942.333333333334,1514.0,583.8571428571429
135131715.0,17,6,1146,6,1146,27026343.0,191.0,191.0,0,0,0.0,0.0,0.0
69508.0,17,2,620,1,75,0.0,75.0,75.0,1,545,0.0,545.0,545.0
25643.0,6,10,2032,5,524,5191.5,252.0,104.8,5,1508,5735.5,1236.0,301.6
197126.0,17,2,180,1,90,0.0,90.0,90.0,1,90,0.0,90.0,90.0
484830.0,6,12,1373,7,714,80805.0,298.0,102.0,5,659,117161.75,379.0,131.8
3393.0,17,2,224,1,76,0.0,76.0,76.0,1,148,0.0,148.0,148.0
35893.0,6,2,132,1,66,0.0,66.0,66.0,1,66,0.0,66.0,66.0
39291.0,6,13,1386,7,789,6548.5,253.0,112.71428571428572,6,597,6879.6,259.0,99.5
298094.0,6,6,412,4,272,99364.66666666669,74.0,68.0,2,140,0.0,74.0,70.0
34591.0,6,14,4740,7,653,4661.666666666667,249.0,93.28571428571428,7,4087,5624.0,1514.0,583.8571428571429
0.0,6,1,172,1,172,0.0,172.0,172.0,0,0,0.0,0.0,0.0
31227.0,6,14,4740,7,653,3678.8333333333335,249.0,93.28571428571428,7,4087,5016.5,1514.0,583.8571428571429
90934041.0,6,24,1829,11,840,9093404.1,95.0,76.36363636363636,13,989,7558029.416666667,95.0,76.07692307692308
97981063.0,17,11,735,6,389,19596212.6,174.0,64.83333333333333,5,346,19836181.25,174.0,69.2
95933482.0,6,40,2640,20,1320,5049130.631578947,66.0,66.0,20,1320,5032580.47368421,66.0,66.0
1891.0,17,2,192,1,88,0.0,88.0,88.0,1,104,0.0,104.0,104.0
1245592.0,6,7,499,3,198,612876.5,66.0,66.0,4,301,411569.3333333333,103.0,75.25
280080.0,17,2,180,1,90,0.0,90.0,90.0,1,90,0.0,90.0,90.0
818.0,17,4,438,2,148,0.0,74.0,74.0,2,290,0.0,147.0,145.0
103716.0,17,2,286,2,286,0.0,143.0,143.0,0,0,0.0,0.0,0.0
423.0,17,2,410,1,78,0.0,78.0,78.0,1,332,0.0,332.0,332.0
348751.0,6,3,1604,1,753,0.0,753.0,753.0,2,851,0.0,785.0,425.5
106911.0,17,2,286,2,286,0.0,143.0,143.0,0,0,0.0,0.0,0.0
228527.0,17,2,180,1,90,0.0,90.0,90.0,1,90,0.0,90.0,90.0
120121188.0,6,16,2356,9,1204,15015148.5,188.0,133.77777777777777,7,1152,15016584.5,204.0,164.57142857142858
495527.0,6,4,270,2,134,0.0,68.0,67.0,2,136,0.0,70.0,68.0
206170.0,6,3,426,2,280,0.0,214.0,140.0,1,146,0.0,146.0,146.0
379.0,17,2,168,1,84,0.0,84.0,84.0,1,84,0.0,84.0,84.0
100815197.0,6,28,1860,14,966,7738398.846153846,123.0,69.0,14,894,7738397.846153846,123.0,63.85714285714285
97732.0,6,32,19396,17,1289,6108.25,225.0,75.82352941176471,15,18107,6166.928571428572,1514.0,1207.1333333333334
51729294.0,17,4,360,2,180,0.0,90.0,90.0,2,180,0.0,90.0,90.0
93178147.0,17,16,5472,16,5472,6211876.466666667,342.0,342.0,0,0,0.0,0.0,0.0
143846.0,17,2,180,1,90,0.0,90.0,90.0,1,90,0.0,90.0,90.0
298271.0,6,6,412,4,272,99423.66666666669,74.0,68.0,2,140,0.0,74.0,70.0
126631724.0,6,37,2640,19,1392,7035095.777777778,123.0,73.26315789473684,18,1248,6848708.764705882,123.0,69.33333333333333
106204004.0,17,14,864,7,432,17667688.0,174.0,61.71428571428572,7,432,17666825.333333332,174.0,61.71428571428572
108113324.0,17,5,1005,5,1005,27028331.0,201.0,201.0,0,0,0.0,0.0,0.0
28047.0,6,11,1132,6,556,5537.0,218.0,92.66666666666669,5,576,6024.25,304.0,115.2
249944.0,17,4,6056,4,6056,83314.66666666667,1514.0,1514.0,0,0,0.0,0.0,0.0
120237788.0,6,208,23642,104,7160,1149434.7572815537,140.0,68.84615384615384,104,16482,1159367.932038835,390.0,158.48076923076923
9661.0,17,2,582,1,83,0.0,83.0,83.0,1,499,0.0,499.0,499.0
103647.0,17,2,286,2,286,0.0,143.0,143.0,0,0,0.0,0.0,0.0
366513.0,17,2,363,1,75,0.0,75.0,75.0,1,288,0.0,288.0,288.0
51162.0,17,2,180,1,90,0.0,90.0,90.0,1,90,0.0,90.0,90.0
6105.0,17,2,447,1,84,0.0,84.0,84.0,1,363,0.0,363.0,363.0
32937.0,6,14,4740,7,653,4122.5,249.0,93.28571428571428,7,4087,5342.666666666667,1514.0,583.8571428571429
196880.0,17,2,180,1,90,0.0,90.0,90.0,1,90,0.0,90.0,90.0
3180.0,17,2,224,1,76,0.0,76.0,76.0,1,148,0.0,148.0,148.0
25910.0,6,10,2032,5,524,6242.0,252.0,104.8,5,1508,6214.25,1236.0,301.6
90658686.0,17,12,778,6,389,18099959.0,174.0,64.83333333333333,6,389,18129913.8,174.0,64.83333333333333
108105052.0,17,5,955,5,955,27026263.0,191.0,191.0,0,0,0.0,0.0,0.0
108509406.0,17,14,864,7,432,18001336.833333332,174.0,61.71428571428572,7,432,18000199.0,174.0,61.71428571428572
206538.0,17,2,180,1,90,0.0,90.0,90.0,1,90,0.0,90.0,90.0
26684.0,6,14,4740,7,653,3900.1666666666665,249.0,93.28571428571428,7,4087,4306.833333333333,1514.0,583.8571428571429
115143516.0,6,48,3168,24,1584,5006239.826086956,66.0,66.0,24,1584,4996839.173913044,66.0,66.0
240839.0,6,3,337,2,214,0.0,160.0,107.0,1,123,0.0,123.0,123.0
508970.00000000006,6,5,336,2,134,0.0,68.0,67.0,3,202,193604.5,70.0,67.33333333333333
306142.0,6,3,202,2,128,0.0,74.0,64.0,1,74,0.0,74.0,74.0
1287992.0,17,7,490,7,490,214665.3333333333,70.0,70.0,0,0,0.0,0.0,0.0
12162.0,17,4,823,2,163,0.0,89.0,81.5,2,660,0.0,443.0,330.0
9312720.0,17,3,1034,2,684,0.0,342.0,342.0,1,350,0.0,350.0,350.0
327.0,17,2,208,1,72,0.0,72.0,72.0,1,136,0.0,136.0,136.0
215145.0,6,10,1221,6,636,43029.0,298.0,106.0,4,585,70640.33333333333,379.0,146.25
90059204.0,17,28,13364,28,13364,3335526.074074074,501.0,477.2857142857143,0,0,0.0,0.0,0.0
117005670.0,17,13,821,7,432,19500945.0,174.0,61.71428571428572,6,389,19400220.8,174.0,64.83333333333333
42919.0,6,14,4740,7,653,7031.5,249.0,93.28571428571428,7,4087,4774.666666666667,1514.0,583.8571428571429
5005548.0,17,4,849,2,166,0.0,83.0,83.0,2,683,0.0,499.0,341.5
120025120.0,17,29,13785,29,13785,4286611.428571428,501.0,475.3448275862069,0,0,0.0,0.0,0.0
2297.0,17,4,344,2,150,0.0,75.0,75.0,2,194,0.0,103.0,97.0
102472.0,17,2,762,2,762,0.0,381.0,381.0,0,0,0.0,0.0,0.0
90251174.0,6,13,2036,8,1016,12893024.857142856,188.0,127.0,5,1020,22520169.25,204.0,204.0
246785.0,6,3,337,2,214,0.0,160.0,107.0,1,123,0.0,123.0,123.0
39667.0,6,14,4740,7,653,6390.666666666667,249.0,93.28571428571428,7,4087,6471.666666666667,1514.0,583.8571428571429
104281.0,17,2,286,2,286,0.0,143.0,143.0,0,0,0.0,0.0,0.0
107245.0,6,13,1386,7,789,17874.166666666668,253.0,112.71428571428572,6,597,20645.2,259.0,99.5
35547.0,6,14,4740,7,653,3589.6666666666665,249.0,93.28571428571428,7,4087,5693.666666666667,1514.0,583.8571428571429
218047.0,6,3,426,2,280,0.0,214.0,140.0,1,146,0.0,146.0,146.0
205823.0,17,2,180,1,90,0.0,90.0,90.0,1,90,0.0,90.0,90.0
29514.0,6,10,2032,5,524,5607.5,252.0,104.8,5,1508,7114.25,1236.0,301.6
0.0,17,1,55,1,55,0.0,55.0,55.0,0,0,0.0,0.0,0.0
394146.0,6,3,1604,1,753,0.0,753.0,753.0,2,851,0.0,785.0,425.5
144932.0,17,2,180,1,70,0.0,70.0,70.0,1,110,0.0,110.0,110.0
314243.0,6,3,1604,1,753,0.0,753.0,753.0,2,851,0.0,785.0,425.5
101596.0,17,2,286,2,286,0.0,143.0,143.0,0,0,0.0,0.0,0.0
148429.0,17,2,414,1,88,0.0,88.0,88.0,1,326,0.0,326.0,326.0
120056162.0,17,29,13785,29,13785,4287720.071428572,501.0,475.3448275862069,0,0,0.0,0.0,0.0
2427.0,17,4,344,2,150,0.0,75.0,75.0,2,194,0.0,103.0,97.0
1749442.0,6,2,132,1,66,0.0,66.0,66.0,1,66,0.0,66.0,66.0
22131917.0,17,3,1034,2,684,0.0,342.0,342.0,1,350,0.0,350.0,350.0
361912.0,6,11,1021,6,444,48640.0,162.0,74.0,5,577,60540.5,349.0,115.4
1238703.0,17,7,490,7,490,206450.5,70.0,70.0,0,0,0.0,0.0,0.0
332.0,17,2,164,1,82,0.0,82.0,82.0,1,82,0.0,82.0,82.0
120268687.0,6,216,24530,108,7350,1116352.925233645,140.0,68.05555555555556,108,17180,1116436.0654205608,284.0,159.07407407407408
186748.0,6,10,1066,5,490,44681.5,218.0,98.0,5,576,46482.75,304.0,115.2
102210380.0,17,14,864,7,432,16835705.333333332,174.0,61.71428571428572,7,432,17000158.5,174.0,61.71428571428572
1084.0,17,4,438,2,148,0.0,74.0,74.0,2,290,0.0,147.0,145.0
38615046.0,6,5,336,2,134,0.0,68.0,67.0,3,202,19238325.0,70.0,67.33333333333333
120315884.0,6,233,26478,117,18600,1037205.8965517242,374.0,158.97435897435898,116,7878,1038155.8869565218,140.0,67.91379310344827
912.0,17,5,550,5,550,228.0,110.0,110.0,0,0,0.0,0.0,0.0
63560.00000000001,6,10,2032,5,524,15641.75,252.0,104.8,5,1508,15636.5,1236.0,301.6
46737.0,6,14,4740,7,653,6800.666666666667,249.0,93.28571428571428,7,4087,7507.5,1514.0,583.8571428571429
4597.0,17,2,180,1,90,0.0,90.0,90.0,1,90,0.0,90.0,90.0
1153304.0,6,13,3010,8,2382,164757.7142857143,1514.0,297.75,5,628,220180.75,331.0,125.6
113715522.0,6,48,3168,24,1584,4944153.130434782,66.0,66.0,24,1584,4932349.043478261,66.0,66.0
309887.0,17,2,346,1,78,0.0,78.0,78.0,1,268,0.0,268.0,268.0
19837.0,6,14,4740,7,653,3014.6666666666665,249.0,93.28571428571428,7,4087,3089.333333333333,1514.0,583.8571428571429
2015301.0,17,4,525,2,150,0.0,75.0,75.0,2,375,0.0,284.0,187.5
5620024.0,6,5,336,2,134,0.0,68.0,67.0,3,202,1525383.0,70.0,67.33333333333333
100796627.0,6,30,2106,15,1089,7183593.142857143,123.0,72.6,15,1017,7183593.571428572,123.0,67.8
23583.0,6,11,2098,6,590,4695.6,252.0,98.33333333333331,5,1508,4987.5,1236.0,301.6
298620.0,6,6,412,4,272,99540.0,74.0,68.0,2,140,0.0,74.0,70.0
146169.0,6,3,337,2,214,0.0,160.0,107.0,1,123,0.0,123.0,123.0
54770.0,6,10,2032,5,524,12412.75,252.0,104.8,5,1508,13098.75,1236.0,301.6
315839.0,6,6,412,4,272,105279.66666666669,74.0,68.0,2,140,0.0,74.0,70.0
19902.0,17,2,582,1,83,0.0,83.0,83.0,1,499,0.0,499.0,499.0
112464304.0,6,46,3036,23,1518,5111997.954545454,66.0,66.0,23,1518,5112002.5,66.0,66.0
34393.0,6,14,4740,7,653,4490.833333333333,249.0,93.28571428571428,7,4087,5388.166666666667,1514.0,583.8571428571429
120020652.0,17,28,13364,28,13364,4445209.333333333,501.0,477.2857142857143,0,0,0.0,0.0,0.0
108748.0,17,2,286,2,286,0.0,143.0,143.0,0,0,0.0,0.0,0.0
66538.0,6,14,4740,7,653,10914.833333333334,249.0,93.28571428571428,7,4087,10604.5,1514.0,583.8571428571429
121194377.0,17,14,995,7,432,18333507.666666668,174.0,61.71428571428572,7,563,18677620.0,174.0,80.42857142857143
103466.0,17,2,286,2,286,0.0,143.0,143.0,0,0,0.0,0.0,0.0
2252.0,17,4,344,2,150,0.0,75.0,75.0,2,194,0.0,103.0,97.0
108098714.0,17,5,1005,5,1005,27024678.5,201.0,201.0,0,0,0.0,0.0,0.0
95006285.0,6,184,20776,92,14556,1041660.912087912,284.0,158.2173913043478,92,6220,1041660.7032967032,140.0,67.6086956521739
2352.0,17,4,344,2,150,0.0,75.0,75.0,2,194,0.0,103.0,97.0
32563.0,6,11,1133,6,602,6002.8,264.0,100.33333333333331,5,531,6682.5,259.0,106.2
61116.0,6,14,4740,7,653,9687.5,249.0,93.28571428571428,7,4087,8579.5,1514.0,583.8571428571429
111104070.0,17,16,1474,8,737,15849136.0,174.0,92.125,8,737,15849138.142857144,174.0,92.125
48063.0,6,10,2032,5,524,11778.5,252.0,104.8,5,1508,11464.75,1236.0,301.6
11741930.0,6,8,602,3,198,4601712.5,66.0,66.0,5,404,1728741.0,103.0,80.8
2349.0,17,4,344,2,150,0.0,75.0,75.0,2,194,0.0,103.0,97.0
901636.0,6,12,2710,7,743,150272.66666666666,339.0,106.14285714285714,5,1967,156493.75,1514.0,393.4
90053618.0,17,28,13364,28,13364,3335319.185185185,501.0,477.2857142857143,0,0,0.0,0.0,0.0
52977.0,6,14,4740,7,653,8387.833333333334,249.0,93.28571428571428,7,4087,8638.666666666666,1514.0,583.8571428571429
117134437.0,6,35,2542,18,1348,6890261.0,139.0,74.88888888888889,17,1194,7307355.5,123.0,70.23529411764706
321488.0,17,4,1400,4,1400,107162.66666666669,350.0,350.0,0,0,0.0,0.0,0.0
143950.0,17,2,180,1,90,0.0,90.0,90.0,1,90,0.0,90.0,90.0
108815.0,17,2,286,2,286,0.0,143.0,143.0,0,0,0.0,0.0,0.0
334.0,17,2,166,1,75,0.0,75.0,75.0,1,91,0.0,91.0,91.0
135136693.0,17,6,1206,6,1206,27027338.6,201.0,201.0,0,0,0.0,0.0,0.0
99000896.0,17,11,735,6,389,19800179.2,174.0,64.83333333333333,5,346,19750968.0,174.0,69.2
26165.0,6,13,1479,7,882,4360.833333333333,291.0,126.0,6,597,4408.8,259.0,99.5
83871.0,6,10,2032,5,524,20672.25,252.0,104.8,5,1508,18166.75,1236.0,301.6
6925.0,17,2,582,1,83,0.0,83.0,83.0,1,499,0.0,499.0,499.0
336.0,17,2,191,1,73,0.0,73.0,73.0,1,118,0.0,118.0,118.0
223255.0,6,10,1221,6,636,44651.0,298.0,106.0,4,585,73183.33333333333,379.0,146.25
31227.0,6,14,4740,7,653,4630.5,249.0,93.28571428571428,7,4087,5065.666666666667,1514.0,583.8571428571429
45293.0,6,10,2032,5,524,9863.5,252.0,104.8,5,1508,8663.5,1236.0,301.6
100162867.0,17,14,864,7,432,16667756.833333334,174.0,61.71428571428572,7,432,16666806.5,174.0,61.71428571428572
90295786.0,6,16,1192,8,596,12893674.142857144,95.0,74.5,8,596,12898039.857142856,95.0,74.5
2406.0,17,4,344,2,150,0.0,75.0,75.0,2,194,0.0,103.0,97.0
5618799.0,6,5,336,2,134,0.0,68.0,67.0,3,202,1423974.0,70.0,67.33333333333333
153464.0,17,2,180,1,90,0.0,90.0,90.0,1,90,0.0,90.0,90.0
90529918.0,6,13,2036,8,1016,12932845.42857143,188.0,127.0,5,1020,22590796.75,204.0,204.0
0.0,6,1,66,1,66,0.0,66.0,66.0,0,0,0.0,0.0,0.0
2848161.0,6,3,204,2,136,0.0,70.0,68.0,1,68,0.0,68.0,68.0
146177.0,6,3,337,2,214,0.0,160.0,107.0,1,123,0.0,123.0,123.0
38761.0,6,14,4740,7,653,5331.833333333333,249.0,93.28571428571428,7,4087,6113.833333333333,1514.0,583.8571428571429
250911.0,6,10,1221,6,636,50182.2,298.0,106.0,4,585,78225.33333333333,379.0,146.25
14860.0,17,2,180,1,90,0.0,90.0,90.0,1,90,0.0,90.0,90.0
135145248.0,17,6,1206,6,1206,27029049.6,201.0,201.0,0,0,0.0,0.0,0.0
206283.0,6,3,426,2,280,0.0,214.0,140.0,1,146,0.0,146.0,146.0
115897752.0,6,48,3168,24,1584,5039032.695652174,66.0,66.0,24,1584,5027059.304347826,66.0,66.0
342.0,17,2,174,1,79,0.0,79.0,79.0,1,95,0.0,95.0,95.0
107840954.0,6,28,1860,14,966,8278841.769230769,123.0,69.0,14,894,8278840.769230769,123.0,63.85714285714285
190921.0,17,2,180,1,90,0.0,90.0,90.0,1,90,0.0,90.0,90.0
135128852.0,17,6,1146,6,1146,27025770.4,191.0,191.0,0,0,0.0,0.0,0.0
206917.0,17,2,180,1,90,0.0,90.0,90.0,1,90,0.0,90.0,90.0
122445.0,6,3,373,2,238,0.0,172.0,119.0,1,135,0.0,135.0,135.0
124001104.0,17,15,1169,8,606,17714443.42857143,174.0,75.75,7,563,17333942.5,174.0,80.42857142857143
90036731.0,17,28,13364,28,13364,3334693.7407407407,501.0,477.2857142857143,0,0,0.0,0.0,0.0
119183430.0,6,260,29684,130,8802,917543.3255813952,140.0,67.70769230769231,130,20882,917384.7906976744,284.0,160.63076923076923
135141028.0,17,6,1146,6,1146,27028205.6,191.0,191.0,0,0,0.0,0.0,0.0
2323.0,17,4,344,2,150,0.0,75.0,75.0,2,194,0.0,103.0,97.0
43400.0,6,13,1386,7,789,7233.333333333333,253.0,112.71428571428572,6,597,6803.4,259.0,99.5
0.0,17,1,55,1,55,0.0,55.0,55.0,0,0,0.0,0.0,0.0
2339.0,17,4,344,2,150,0.0,75.0,75.0,2,194,0.0,103.0,97.0
8000.0,6,10,2032,5,524,1783.25,252.0,104.8,5,1508,1740.25,1236.0,301.6
199457.0,17,4,6056,4,6056,66485.66666666667,1514.0,1514.0,0,0,0.0,0.0,0.0
118942954.0,6,212,23852,106,16560,1132790.0380952382,284.0,156.2264150943396,106,7292,1130683.3523809523,140.0,68.79245283018868
45203.0,6,14,4740,7,653,6687.333333333333,249.0,93.28571428571428,7,4087,6913.666666666667,1514.0,583.8571428571429
53571083.0,6,8,2113,3,960,25539594.5,826.0,320.0,5,1153,12748868.0,885.0,230.6
1315787.0,6,4,264,2,132,0.0,66.0,66.0,2,132,0.0,66.0,66.0
111790.0,6,14,4740,7,653,15909.166666666666,249.0,93.28571428571428,7,4087,12346.833333333334,1514.0,583.8571428571429
40475.0,6,11,2098,6,590,7964.4,252.0,98.33333333333331,5,1508,6598.0,1236.0,301.6
248133.0,6,3,337,2,214,0.0,160.0,107.0,1,123,0.0,123.0,123.0
1779.0,17,2,176,1,80,0.0,80.0,80.0,1,96,0.0,96.0,96.0
0.0,17,1,136,1,136,0.0,136.0,136.0,0,0,0.0,0.0,0.0
112095823.0,6,34,2350,17,1225,6992502.8125,139.0,72.05882352941177,17,1125,6992503.5,123.0,66.17647058823529
81438.0,6,14,4740,7,653,13446.833333333334,249.0,93.28571428571428,7,4087,13368.333333333334,1514.0,583.8571428571429
47246.0,6,14,4740,7,653,7746.833333333333,249.0,93.28571428571428,7,4087,7126.666666666667,1514.0,583.8571428571429
120001036.0,17,14,864,8,475,17143005.14285714,174.0,59.375,6,389,20001178.0,174.0,64.83333333333333
90304851.0,6,16,1192,8,596,12893644.0,95.0,74.5,8,596,12899538.714285716,95.0,74.5
432.0,17,2,508,2,508,0.0,257.0,254.0,0,0,0.0,0.0,0.0
1348341.0,17,16,1120,16,1120,89889.4,70.0,70.0,0,0,0.0,0.0,0.0
120377504.0,6,209,23580,105,16420,1157476.0,284.0,156.38095238095238,104,7160,1159714.427184466,140.0,68.84615384615384
216685.0,6,3,426,2,280,0.0,214.0,140.0,1,146,0.0,146.0,146.0
90021235.0,17,28,13364,28,13364,3334119.814814815,501.0,477.2857142857143,0,0,0.0,0.0,0.0
146211.0,6,10,1066,5,490,35696.5,218.0,98.0,5,576,36351.25,304.0,115.2
440.0,17,2,508,2,508,0.0,257.0,254.0,0,0,0.0,0.0,0.0
1475741.0,17,16,1120,16,1120,98382.73333333334,70.0,70.0,0,0,0.0,0.0,0.0
2067113.0,6,2,132,1,66,0.0,66.0,66.0,1,66,0.0,66.0,66.0
308757.0,17,4,1400,4,1400,102919.0,350.0,350.0,0,0,0.0,0.0,0.0
204053.0,17,2,762,2,762,0.0,381.0,381.0,0,0,0.0,0.0,0.0
109926.0,17,2,286,2,286,0.0,143.0,143.0,0,0,0.0,0.0,0.0
2990712.0,6,5,336,2,134,0.0,68.0,67.0,3,202,156037.0,70.0,67.33333333333333
3314990.0,6,5,336,2,134,0.0,68.0,67.0,3,202,1424158.0,70.0,67.33333333333333
120365361.0,6,237,26800,119,18716,1020045.4322033898,284.0,157.27731092436974,118,8084,1019835.1196581196,140.0,68.50847457627118
143862.0,17,2,180,1,90,0.0,90.0,90.0,1,90,0.0,90.0,90.0
316749.0,17,4,1400,4,1400,105583.0,350.0,350.0,0,0,0.0,0.0,0.0
3326.0,17,2,762,2,762,0.0,381.0,381.0,0,0,0.0,0.0,0.0
77588.0,6,14,4740,7,653,12472.5,249.0,93.28571428571428,7,4087,12762.833333333334,1514.0,583.8571428571429
155774.0,6,3,337,2,214,0.0,160.0,107.0,1,123,0.0,123.0,123.0
21457.0,6,10,2032,5,524,5147.0,252.0,104.8,5,1508,5090.5,1236.0,301.6
135127639.0,17,6,1206,6,1206,27025527.8,201.0,201.0,0,0,0.0,0.0,0.0
135135240.0,17,6,1146,6,1146,27027048.0,191.0,191.0,0,0,0.0,0.0,0.0
12246.0,17,4,823,2,163,0.0,89.0,81.5,2,660,0.0,443.0,330.0
3174589.0,6,18,1495,9,921,358448.375,315.0,102.33333333333331,9,574,358431.125,78.0,63.77777777777778
303383.0,6,6,412,4,272,101127.66666666669,74.0,68.0,2,140,0.0,74.0,70.0
2332.0,17,4,344,2,150,0.0,75.0,75.0,2,194,0.0,103.0,97.0
311656.0,6,6,412,4,272,103885.33333333331,74.0,68.0,2,140,0.0,74.0,70.0
107235.0,17,2,286,2,286,0.0,143.0,143.0,0,0,0.0,0.0,0.0
77841.0,6,14,4740,7,653,12342.666666666666,249.0,93.28571428571428,7,4087,12821.0,1514.0,583.8571428571429
2885371.0,6,2,132,1,66,0.0,66.0,66.0,1,66,0.0,66.0,66.0
23614.0,6,14,4740,7,653,3722.1666666666665,249.0,93.28571428571428,7,4087,3327.333333333333,1514.0,583.8571428571429
90011140.0,17,28,13364,28,13364,3333745.925925926,501.0,477.2857142857143,0,0,0.0,0.0,0.0
117937043.0,6,240,27464,120,19322,989260.2352941176,284.0,161.01666666666668,120,8142,989260.5294117648,140.0,67.85
10868744.0,6,8,544,4,272,3577457.6666666665,74.0,68.0,4,272,3577372.6666666665,74.0,68.0
3171532.0,6,18,1536,9,962,358750.875,315.0,106.88888888888889,9,574,358722.125,78.0,63.77777777777778
35055.0,6,14,4740,7,653,5523.5,249.0,93.28571428571428,7,4087,5696.5,1514.0,583.8571428571429
164425.0,17,2,414,1,88,0.0,88.0,88.0,1,326,0.0,326.0,326.0
27444740.0,17,5,1710,5,1710,6861185.0,342.0,342.0,0,0,0.0,0.0,0.0
120000024.0,6,22,1680,12,935,10909093.090909092,95.0,77.91666666666667,10,745,9999625.444444444,95.0,74.5
1302530.0,6,4,264,2,132,0.0,66.0,66.0,2,132,0.0,66.0,66.0
215372.0,17,2,180,1,90,0.0,90.0,90.0,1,90,0.0,90.0,90.0
209425.0,17,2,180,1,90,0.0,90.0,90.0,1,90,0.0,90.0,90.0
197726.0,17,2,180,1,90,0.0,90.0,90.0,1,90,0.0,90.0,90.0
14262.0,17,4,1024,2,163,0.0,89.0,81.5,2,861,0.0,443.0,430.5
0.0,6,1,214,1,214,0.0,214.0,214.0,0,0,0.0,0.0,0.0
2599225.0,6,2,132,1,66,0.0,66.0,66.0,1,66,0.0,66.0,66.0
509042.0,6,3,1604,2,851,0.0,785.0,425.5,1,753,0.0,753.0,753.0
27457395.0,17,5,1710,5,1710,6864348.75,342.0,342.0,0,0,0.0,0.0,0.0
153498.0,17,2,180,1,90,0.0,90.0,90.0,1,90,0.0,90.0,90.0
24375.0,6,10,2032,5,524,4797.25,252.0,104.8,5,1508,5643.25,1236.0,301.6
14641812.0,6,20,1689,10,1057,1593202.5555555555,315.0,105.7,10,632,1593174.5555555555,78.0,63.2
90739440.0,6,17,1287,9,691,11337325.5,95.0,76.77777777777777,8,596,12962471.285714284,95.0,74.5
306309.0,6,6,412,4,272,102103.0,74.0,68.0,2,140,0.0,74.0,70.0
95821.0,17,2,762,2,762,0.0,381.0,381.0,0,0,0.0,0.0,0.0
146027.0,6,3,373,2,238,0.0,172.0,119.0,1,135,0.0,135.0,135.0
2440.0,17,4,344,2,150,0.0,75.0,75.0,2,194,0.0,103.0,97.0
16350452.0,17,6,2052,6,2052,3270090.4,342.0,342.0,0,0,0.0,0.0,0.0
90058329.0,17,27,12943,27,12943,3463781.8846153845,501.0,479.3703703703704,0,0,0.0,0.0,0.0
111532935.0,6,36,2580,18,1332,6548035.647058823,123.0,74.0,18,1248,6548068.823529412,123.0,69.33333333333333
867751.0,6,9,1267,6,796,173550.2,458.0,132.66666666666666,3,471,296270.5,331.0,157.0
100902292.0,17,14,1126,7,563,16790562.666666668,174.0,80.42857142857143,7,563,16550511.0,174.0,80.42857142857143
302829.0,6,6,412,4,272,100943.0,74.0,68.0,2,140,0.0,74.0,70.0
90095336.0,6,11,1644,4,816,30031063.33333333,204.0,204.0,7,828,15015688.833333334,188.0,118.28571428571428
39489.0,6,14,4740,7,653,6470.333333333333,249.0,93.28571428571428,7,4087,5648.333333333333,1514.0,583.8571428571429
146453.0,6,3,337,2,214,0.0,160.0,107.0,1,123,0.0,123.0,123.0
115128394.0,17,14,864,7,432,19166836.83333333,174.0,61.71428571428572,7,432,19169909.33333333,174.0,61.71428571428572
14296305.0,17,6,2052,6,2052,2859261.0,342.0,342.0,0,0,0.0,0.0,0.0
2806559.0,6,2,132,1,66,0.0,66.0,66.0,1,66,0.0,66.0,66.0
2781376.0,6,2,132,1,66,0.0,66.0,66.0,1,66,0.0,66.0,66.0
1171887.0,6,13,3000,8,2372,167412.42857142858,1514.0,296.5,5,628,224854.25,331.0,125.6
116467426.0,17,15,1169,8,606,16638203.714285716,174.0,75.75,7,563,16999210.5,174.0,80.42857142857143
14664548.0,6,20,1605,10,973,1591724.6666666667,315.0,97.3,10,632,1592480.111111111,78.0,63.2
155475.0,6,13,1386,7,789,25912.5,253.0,112.71428571428572,6,597,29588.2,259.0,99.5
119471112.0,17,35,16705,35,16705,3513856.2352941176,501.0,477.2857142857143,0,0,0.0,0.0,0.0
108103263.0,17,5,955,5,955,27025815.75,191.0,191.0,0,0,0.0,0.0,0.0
2332.0,17,4,344,2,150,0.0,75.0,75.0,2,194,0.0,103.0,97.0
104794915.0,17,14,4788,14,4788,8061147.307692308,342.0,342.0,0,0,0.0,0.0,0.0
216434.0,17,2,180,1,90,0.0,90.0,90.0,1,90,0.0,90.0,90.0
797163.0,17,6,1230,3,234,398402.0,78.0,78.0,3,996,398375.0,332.0,332.0
257306.0,6,3,337,2,214,0.0,160.0,107.0,1,123,0.0,123.0,123.0
2702713.0,6,3,1604,2,851,0.0,785.0,425.5,1,753,0.0,753.0,753.0
10516967.0,6,7,478,4,272,3460201.0,74.0,68.0,3,206,5190189.0,74.0,68.66666666666667
48046.0,6,14,4740,7,653,7510.833333333333,249.0,93.28571428571428,7,4087,6918.333333333333,1514.0,583.8571428571429
120900018.0,17,14,864,7,432,16829810.166666668,174.0,61.71428571428572,7,432,16833531.833333332,174.0,61.71428571428572
23256.0,6,10,2032,5,524,4899.25,252.0,104.8,5,1508,5552.5,1236.0,301.6
32136.0,6,10,2032,5,524,7740.0,252.0,104.8,5,1508,7498.0,1236.0,301.6
90007341.0,6,19,1436,10,786,10000815.666666666,95.0,78.6,9,650,11214328.875,95.0,72.22222222222223
120062263.0,17,28,13364,28,13364,4446750.481481481,501.0,477.2857142857143,0,0,0.0,0.0,0.0
96109018.0,6,58,12217,30,6480,3314104.068965517,1514.0,216.0,28,5737,3550308.1481481483,1514.0,204.8928571428572
117755262.0,6,32,2374,17,1288,7346205.0625,139.0,75.76470588235294,15,1086,8395661.214285715,123.0,72.4
97859429.0,6,187,21170,94,6426,1052251.9247311829,140.0,68.36170212765957,93,14744,1052429.391304348,284.0,158.53763440860214
108110148.0,17,5,1005,5,1005,27027537.0,201.0,201.0,0,0,0.0,0.0,0.0
3098.0,17,2,224,1,76,0.0,76.0,76.0,1,148,0.0,148.0,148.0
314808.0,17,4,1400,4,1400,104936.0,350.0,350.0,0,0,0.0,0.0,0.0
2384.0,17,4,344,2,150,0.0,75.0,75.0,2,194,0.0,103.0,97.0
119588110.0,17,13,690,7,432,19931351.666666668,174.0,61.71428571428572,6,258,20000604.0,43.0,43.0
90005909.0,17,28,13364,28,13364,3333552.185185185,501.0,477.2857142857143,0,0,0.0,0.0,0.0
332.0,17,2,166,1,75,0.0,75.0,75.0,1,91,0.0,91.0,91.0
0.0,17,1,453,1,453,0.0,453.0,453.0,0,0,0.0,0.0,0.0
10516505.0,6,7,478,4,272,3460091.6666666665,74.0,68.0,3,206,5190003.0,74.0,68.66666666666667
922.0,17,4,438,2,148,0.0,74.0,74.0,2,290,0.0,147.0,145.0
291.0,17,2,156,1,78,0.0,78.0,78.0,1,78,0.0,78.0,78.0
197038.0,17,2,180,1,90,0.0,90.0,90.0,1,90,0.0,90.0,90.0
27217988.0,17,5,1710,5,1710,6804497.0,342.0,342.0,0,0,0.0,0.0,0.0
237190.0,6,3,337,2,214,0.0,160.0,107.0,1,123,0.0,123.0,123.0
59711.0,6,14,4740,7,653,9658.5,249.0,93.28571428571428,7,4087,9568.666666666666,1514.0,583.8571428571429
196937.0,17,2,180,1,90,0.0,90.0,90.0,1,90,0.0,90.0,90.0
146054.0,6,3,337,2,214,0.0,160.0,107.0,1,123,0.0,123.0,123.0
2324.0,17,4,344,2,150,0.0,75.0,75.0,2,194,0.0,103.0,97.0
59540.0,6,14,4740,7,653,9524.666666666666,249.0,93.28571428571428,7,4087,9252.333333333334,1514.0,583.8571428571429
55598.0,6,14,4740,7,653,8472.0,249.0,93.28571428571428,7,4087,9077.166666666666,1514.0,583.8571428571429
2930.0,17,4,344,2,150,0.0,75.0,75.0,2,194,0.0,103.0,97.0
228375.0,17,2,180,1,90,0.0,90.0,90.0,1,90,0.0,90.0,90.0
51037.0,17,2,180,1,90,0.0,90.0,90.0,1,90,0.0,90.0,90.0
97902003.0,6,30,2106,15,1089,6993000.214285715,123.0,72.6,15,1017,6977538.428571428,123.0,67.8
90741919.0,6,19,1436,9,691,11342739.875,95.0,76.77777777777777,10,745,10050033.888888888,95.0,74.5
20439.0,6,10,1065,5,534,3928.75,262.0,106.8,5,531,4529.5,259.0,106.2
98246.0,17,2,286,2,286,0.0,143.0,143.0,0,0,0.0,0.0,0.0
296602.0,17,2,363,1,79,0.0,79.0,79.0,1,284,0.0,284.0,284.0
97502.0,17,4,1400,4,1400,32500.666666666668,350.0,350.0,0,0,0.0,0.0,0.0
28095.0,6,10,2032,5,524,6748.5,252.0,104.8,5,1508,5759.75,1236.0,301.6
228431.0,17,2,180,1,90,0.0,90.0,90.0,1,90,0.0,90.0,90.0
103434.0,17,2,286,2,286,0.0,143.0,143.0,0,0,0.0,0.0,0.0
5828154.0,6,5,336,2,134,0.0,68.0,67.0,3,202,1525560.0,70.0,67.33333333333333
10533.0,6,11,2098,6,590,1930.2,252.0,98.33333333333331,5,1508,2059.0,1236.0,301.6
48084.0,6,14,4740,7,653,7080.0,249.0,93.28571428571428,7,4087,7529.833333333333,1514.0,583.8571428571429
200845.0,17,2,762,2,762,0.0,381.0,381.0,0,0,0.0,0.0,0.0
96849779.0,6,181,20382,91,6228,1076108.6555555556,140.0,68.43956043956044,90,14154,1076528.595505618,284.0,157.26666666666668
90290059.0,6,21,1585,11,840,9024754.9,95.0,76.36363636363636,10,745,9950931.888888888,95.0,74.5
154079.0,17,2,180,1,90,0.0,90.0,90.0,1,90,0.0,90.0,90.0
31350.000000000004,6,14,4740,7,653,5088.166666666667,249.0,93.28571428571428,7,4087,4541.833333333333,1514.0,583.8571428571429
91194.0,6,14,4740,7,653,14017.166666666666,249.0,93.28571428571428,7,4087,15061.0,1514.0,583.8571428571429
2802723.0,6,2,132,1,66,0.0,66.0,66.0,1,66,0.0,66.0,66.0
1000018.0,17,4,820,2,156,0.0,78.0,78.0,2,664,0.0,332.0,332.0
27829.0,6,14,4740,7,653,4481.333333333333,249.0,93.28571428571428,7,4087,3207.833333333333,1514.0,583.8571428571429
135129213.0,17,6,1146,6,1146,27025842.6,191.0,191.0,0,0,0.0,0.0,0.0
90319822.0,6,16,1192,8,596,12896479.857142856,95.0,74.5,8,596,12902213.285714284,95.0,74.5
293995.0,17,2,180,1,90,0.0,90.0,90.0,1,90,0.0,90.0,90.0
120125391.0,6,13,2020,9,1204,15015673.875,188.0,133.77777777777777,4,816,30032142.0,204.0,204.0
48937.0,6,14,4740,7,653,8019.0,249.0,93.28571428571428,7,4087,7000.666666666667,1514.0,583.8571428571429
109282.0,17,2,286,2,286,0.0,143.0,143.0,0,0,0.0,0.0,0.0
29670.0,6,14,4740,7,653,4824.666666666667,249.0,93.28571428571428,7,4087,4691.5,1514.0,583.8571428571429
504838.0,6,5,336,2,134,0.0,68.0,67.0,3,202,193478.5,70.0,67.33333333333333
44599.0,6,10,2032,5,524,10930.25,252.0,104.8,5,1508,10415.0,1236.0,301.6
121650.0,6,3,337,2,214,0.0,160.0,107.0,1,123,0.0,123.0,123.0
1024385.0,6,13,1420,7,789,169741.66666666666,253.0,112.71428571428572,6,631,203928.0,293.0,105.16666666666669
209445.0,17,2,180,1,90,0.0,90.0,90.0,1,90,0.0,90.0,90.0
411231.0,17,2,210,1,86,0.0,86.0,86.0,1,124,0.0,124.0,124.0
2879795.0,6,12,2172,7,664,479786.3333333333,252.0,94.85714285714286,5,1508,2243.0,1236.0,301.6
1306923.0,6,4,264,2,132,0.0,66.0,66.0,2,132,0.0,66.0,66.0
20319.0,17,2,582,1,83,0.0,83.0,83.0,1,499,0.0,499.0,499.0
271171.0,6,10,1221,6,636,54234.2,298.0,106.0,4,585,84665.0,379.0,146.25
150338.0,6,3,337,2,214,0.0,160.0,107.0,1,123,0.0,123.0,123.0
209522.0,17,2,180,1,90,0.0,90.0,90.0,1,90,0.0,90.0,90.0
47300.0,6,10,2032,5,524,11471.0,252.0,104.8,5,1508,8986.5,1236.0,301.6
410122.0,6,3,204,2,136,0.0,70.0,68.0,1,68,0.0,68.0,68.0
94535030.0,17,12,778,6,389,18800161.8,174.0,64.83333333333333,6,389,18799869.4,174.0,64.83333333333333
503.0,17,2,508,2,508,0.0,257.0,254.0,0,0,0.0,0.0,0.0
33641493.0,6,27,8493,15,1839,2402963.785714286,408.0,122.6,12,6654,2726452.909090909,1514.0,554.5
108106784.0,17,5,1005,5,1005,27026696.0,201.0,201.0,0,0,0.0,0.0,0.0
207086.0,6,3,426,2,280,0.0,214.0,140.0,1,146,0.0,146.0,146.0
107853831.0,6,28,1860,14,966,8296448.538461538,123.0,69.0,14,894,8279809.230769231,123.0,63.85714285714285
218974.0,17,2,180,1,90,0.0,90.0,90.0,1,90,0.0,90.0,90.0
196849.0,17,2,180,1,90,0.0,90.0,90.0,1,90,0.0,90.0,90.0
167469.0,17,4,571,2,148,0.0,74.0,74.0,2,423,0.0,276.0,211.5
90091605.0,6,10,1440,7,828,15015267.5,188.0,118.28571428571428,3,612,30029764.0,204.0,204.0
41439.0,6,10,2032,5,524,10110.25,252.0,104.8,5,1508,7920.0,1236.0,301.6
127556880.0,6,35,2473,18,1348,7503345.882352941,139.0,74.88888888888889,17,1125,7478243.9375,123.0,66.17647058823529
28397.0,6,10,2032,5,524,6726.25,252.0,104.8,5,1508,6263.5,1236.0,301.6
103578091.0,6,42,2772,21,1386,5162439.85,66.0,66.0,21,1386,5162545.8,66.0,66.0
2300.0,17,4,344,2,150,0.0,75.0,75.0,2,194,0.0,103.0,97.0
223547.0,6,3,426,2,280,0.0,214.0,140.0,1,146,0.0,146.0,146.0
75557.0,6,14,4740,7,653,11794.833333333334,249.0,93.28571428571428,7,4087,11692.833333333334,1514.0,583.8571428571429
143955.0,17,2,180,1,90,0.0,90.0,90.0,1,90,0.0,90.0,90.0
123003292.0,17,15,907,8,475,17571898.85714286,174.0,59.375,7,432,17166832.5,174.0,61.71428571428572
39197.0,6,14,4740,7,653,6235.166666666667,249.0,93.28571428571428,7,4087,6377.833333333333,1514.0,583.8571428571429
206199.0,6,3,426,2,280,0.0,214.0,140.0,1,146,0.0,146.0,146.0
2201.0,17,2,762,2,762,0.0,381.0,381.0,0,0,0.0,0.0,0.0
302418.0,6,2,132,1,66,0.0,66.0,66.0,1,66,0.0,66.0,66.0
120049861.0,17,28,13364,28,13364,4446291.148148148,501.0,477.2857142857143,0,0,0.0,0.0,0.0
90038171.0,17,27,12943,27,12943,3463006.576923077,501.0,479.3703703703704,0,0,0.0,0.0,0.0
259313.00000000003,6,10,1221,6,636,51862.6,298.0,106.0,4,585,79559.33333333333,379.0,146.25
205937.0,17,2,180,1,90,0.0,90.0,90.0,1,90,0.0,90.0,90.0
153486.0,17,2,180,1,90,0.0,90.0,90.0,1,90,0.0,90.0,90.0
120020091.0,17,28,13364,28,13364,4445188.555555556,501.0,477.2857142857143,0,0,0.0,0.0,0.0
90219565.0,6,16,1192,8,596,12853959.0,95.0,74.5,8,596,12859254.142857144,95.0,74.5
42118.0,6,14,4740,7,653,6855.0,249.0,93.28571428571428,7,4087,6879.5,1514.0,583.8571428571429
2795395.0,6,2,132,1,66,0.0,66.0,66.0,1,66,0.0,66.0,66.0
104883480.0,17,15,5130,15,5130,7491677.142857143,342.0,342.0,0,0,0.0,0.0,0.0
2709841.0,6,28,9195,16,3843,180656.06666666668,1514.0,240.1875,12,5352,222543.8181818181,1514.0,446.0
98771.0,17,2,762,2,762,0.0,381.0,381.0,0,0,0.0,0.0,0.0
116817563.0,6,32,2220,16,1149,7787837.533333333,123.0,71.8125,16,1071,7773423.733333333,123.0,66.9375
1029564.0,6,11,1134,6,558,205912.8,220.0,93.0,5,576,256502.25,304.0,115.2
1168817.0,6,13,3010,8,2382,166973.85714285713,1514.0,297.75,5,628,224071.5,331.0,125.6
308751.0,6,6,412,4,272,102917.0,74.0,68.0,2,140,0.0,74.0,70.0
33565.0,6,14,4740,7,653,4646.333333333333,249.0,93.28571428571428,7,4087,4683.5,1514.0,583.8571428571429
90092345.0,6,10,1440,7,828,15015390.833333334,188.0,118.28571428571428,3,612,30030841.0,204.0,204.0
802.0,17,4,438,2,148,0.0,74.0,74.0,2,290,0.0,147.0,145.0
2307.0,17,4,344,2,150,0.0,75.0,75.0,2,194,0.0,103.0,97.0
1321476.0,6,4,264,2,132,0.0,66.0,66.0,2,132,0.0,66.0,66.0
145393.0,17,2,180,1,70,0.0,70.0,70.0,1,110,0.0,110.0,110.0
113618912.0,6,46,3036,23,1518,5150437.045454546,66.0,66.0,23,1518,5150438.136363637,66.0,66.0
315186.0,17,4,1400,4,1400,105062.0,350.0,350.0,0,0,0.0,0.0,0.0
420496.0,6,3,1604,1,753,0.0,753.0,753.0,2,851,0.0,785.0,425.5
493668.0,6,4,270,2,134,0.0,68.0,67.0,2,136,0.0,70.0,68.0
162228.0,17,2,180,1,90,0.0,90.0,90.0,1,90,0.0,90.0,90.0
2310.0,17,4,344,2,150,0.0,75.0,75.0,2,194,0.0,103.0,97.0
1524.0,17,2,762,2,762,0.0,381.0,381.0,0,0,0.0,0.0,0.0
148030.0,17,2,180,1,90,0.0,90.0,90.0,1,90,0.0,90.0,90.0
27672000.0,17,5,1710,5,1710,6918000.0,342.0,342.0,0,0,0.0,0.0,0.0
310742.0,17,4,1400,4,1400,103580.66666666669,350.0,350.0,0,0,0.0,0.0,0.0
101929.0,17,2,762,2,762,0.0,381.0,381.0,0,0,0.0,0.0,0.0
2590748.0,6,2,132,1,66,0.0,66.0,66.0,1,66,0.0,66.0,66.0
817.0,17,4,438,2,148,0.0,74.0,74.0,2,290,0.0,147.0,145.0
135127973.0,17,6,1146,6,1146,27025594.6,191.0,191.0,0,0,0.0,0.0,0.0
162209.0,17,2,180,1,90,0.0,90.0,90.0,1,90,0.0,90.0,90.0
719587.0,6,5,336,2,134,0.0,68.0,67.0,3,202,299756.5,70.0,67.33333333333333
120109094.0,6,13,2020,9,1204,15013636.75,188.0,133.77777777777777,4,816,30026439.0,204.0,204.0
20505.0,17,2,582,1,83,0.0,83.0,83.0,1,499,0.0,499.0,499.0
110093113.0,6,28,1860,14,966,8452935.0,123.0,69.0,14,894,8452933.153846154,123.0,63.85714285714285
253573.0,17,4,1524,4,1524,84524.33333333333,381.0,381.0,0,0,0.0,0.0,0.0
348.0,17,2,168,1,84,0.0,84.0,84.0,1,84,0.0,84.0,84.0
206181.0,17,2,359,1,75,0.0,75.0,75.0,1,284,0.0,284.0,284.0
254788.0,6,3,354,2,288,0.0,222.0,144.0,1,66,0.0,66.0,66.0
583489.0,6,4,508,2,238,0.0,172.0,119.0,2,270,0.0,135.0,135.0
120120319.0,6,13,2020,9,1204,15015039.875,188.0,133.77777777777777,4,816,30031241.666666668,204.0,204.0
1634432.0,6,20,6434,12,1921,148584.72727272726,620.0,160.08333333333334,8,4513,190000.4285714285,1514.0,564.125
120481093.0,6,229,25816,115,18070,1056851.6929824562,284.0,157.1304347826087,114,7746,1057051.1327433628,140.0,67.94736842105263
312931.0,17,4,1400,4,1400,104310.33333333331,350.0,350.0,0,0,0.0,0.0,0.0
120122402.0,6,14,2224,9,1204,15015300.25,188.0,133.77777777777777,5,1020,22524042.0,204.0,204.0
2423.0,17,4,344,2,150,0.0,75.0,75.0,2,194,0.0,103.0,97.0
41249.0,6,14,4740,7,653,6669.833333333333,249.0,93.28571428571428,7,4087,6729.166666666667,1514.0,583.8571428571429
120268832.0,6,234,26438,117,7944,1029683.8448275862,140.0,67.8974358974359,117,18494,1029652.0603448276,284.0,158.06837606837607
805.0,17,4,438,2,148,0.0,74.0,74.0,2,290,0.0,147.0,145.0
246094.0,6,3,337,2,214,0.0,160.0,107.0,1,123,0.0,123.0,123.0
144011.0,17,2,180,1,90,0.0,90.0,90.0,1,90,0.0,90.0,90.0
120443958.0,6,1014,222978,517,189362,233418.52325581395,1514.0,366.2707930367505,497,33616,241216.0866935484,214.0,67.63782696177063
14130874.0,17,6,2052,6,2052,2826174.8,342.0,342.0,0,0,0.0,0.0,0.0
90023008.0,17,28,13364,28,13364,3334185.4814814813,501.0,477.2857142857143,0,0,0.0,0.0,0.0
19520.0,6,14,4740,7,653,3110.6666666666665,249.0,93.28571428571428,7,4087,2990.5,1514.0,583.8571428571429
333.0,17,2,166,1,75,0.0,75.0,75.0,1,91,0.0,91.0,91.0
297486.0,17,2,246,1,76,0.0,76.0,76.0,1,170,0.0,170.0,170.0
120235388.0,6,18,1341,9,691,14999946.125,95.0,76.77777777777777,9,650,14999980.125,95.0,72.22222222222223
144205.0,17,2,180,1,90,0.0,90.0,90.0,1,90,0.0,90.0,90.0
108102371.0,17,5,1005,5,1005,27025592.75,201.0,201.0,0,0,0.0,0.0,0.0
232824.0,6,3,337,2,214,0.0,160.0,107.0,1,123,0.0,123.0,123.0
121559.0,6,3,337,2,214,0.0,160.0,107.0,1,123,0.0,123.0,123.0
28744.0,6,14,4740,7,653,4665.833333333333,249.0,93.28571428571428,7,4087,4655.5,1514.0,583.8571428571429
102414.0,17,2,286,2,286,0.0,143.0,143.0,0,0,0.0,0.0,0.0
120042122.0,17,29,13785,29,13785,4287218.642857143,501.0,475.3448275862069,0,0,0.0,0.0,0.0
1166.0,17,2,762,2,762,0.0,381.0,381.0,0,0,0.0,0.0,0.0
108119799.0,17,5,955,5,955,27029949.75,191.0,191.0,0,0,0.0,0.0,0.0
2982707.0,6,3,1604,1,753,0.0,753.0,753.0,2,851,0.0,785.0,425.5
57700.0,6,14,4740,7,653,8160.333333333333,249.0,93.28571428571428,7,4087,8945.0,1514.0,583.8571428571429
48129.0,6,14,4740,7,653,6394.333333333333,249.0,93.28571428571428,7,4087,7280.333333333333,1514.0,583.8571428571429
3173384.0,6,18,1536,9,962,358473.75,315.0,106.88888888888889,9,574,358440.625,78.0,63.77777777777778
311658.0,17,6,1230,3,234,155639.5,78.0,78.0,3,996,155621.0,332.0,332.0
153404.0,17,2,180,1,90,0.0,90.0,90.0,1,90,0.0,90.0,90.0
143960.0,17,2,180,1,90,0.0,90.0,90.0,1,90,0.0,90.0,90.0
9076140.0,17,8,3624,8,3624,1296591.4285714286,453.0,453.0,0,0,0.0,0.0,0.0
108178.0,6,10,1065,5,534,26657.5,262.0,106.8,5,531,2392.0,259.0,106.2
296.0,17,2,156,1,78,0.0,78.0,78.0,1,78,0.0,78.0,78.0
90293337.0,6,16,1192,8,596,12893172.285714284,95.0,74.5,8,596,12897863.142857144,95.0,74.5
52562.0,6,14,4740,7,653,8608.666666666666,249.0,93.28571428571428,7,4087,8442.833333333334,1514.0,583.8571428571429
2493.0,17,4,344,2,150,0.0,75.0,75.0,2,194,0.0,103.0,97.0
117670526.0,17,16,1212,8,606,16714893.0,174.0,75.75,8,606,16714422.42857143,174.0,75.75
35808.0,6,14,4740,7,653,5753.333333333333,249.0,93.28571428571428,7,4087,5613.666666666667,1514.0,583.8571428571429
108103747.0,17,5,955,5,955,27025936.75,191.0,191.0,0,0,0.0,0.0,0.0
2421.0,17,4,344,2,150,0.0,75.0,75.0,2,194,0.0,103.0,97.0
143842.0,17,2,180,1,90,0.0,90.0,90.0,1,90,0.0,90.0,90.0
3106.0,17,2,224,1,76,0.0,76.0,76.0,1,148,0.0,148.0,148.0
24697.0,6,14,4740,7,653,3386.6666666666665,249.0,93.28571428571428,7,4087,3903.1666666666665,1514.0,583.8571428571429
101059656.0,6,188,21310,94,14884,1084349.7311827955,374.0,158.3404255319149,94,6426,1084346.311827957,140.0,68.36170212765957
120038900.0,17,29,13785,29,13785,4287103.571428572,501.0,475.3448275862069,0,0,0.0,0.0,0.0
198985.0,6,14,4740,7,653,28802.166666666668,249.0,93.28571428571428,7,4087,23417.33333333333,1514.0,583.8571428571429
10467540.0,6,7,478,4,272,3443699.0,74.0,68.0,3,206,5165466.0,74.0,68.66666666666667
135146945.0,17,6,1146,6,1146,27029389.0,191.0,191.0,0,0,0.0,0.0,0.0
41781.0,6,14,4740,7,653,6840.0,249.0,93.28571428571428,7,4087,6642.833333333333,1514.0,583.8571428571429
250266.0,6,3,337,2,214,0.0,160.0,107.0,1,123,0.0,123.0,123.0
1455708.0,6,4,492,2,280,0.0,214.0,140.0,2,212,0.0,146.0,106.0
244957.0,6,3,337,2,214,0.0,160.0,107.0,1,123,0.0,123.0,123.0
49511.0,6,14,4740,7,653,8101.333333333333,249.0,93.28571428571428,7,4087,8093.166666666667,1514.0,583.8571428571429
14028.0,6,14,4740,7,653,2228.833333333333,249.0,93.28571428571428,7,4087,2143.1666666666665,1514.0,583.8571428571429
105845000.0,6,28,1860,14,966,8125323.615384615,123.0,69.0,14,894,8125316.692307692,123.0,63.85714285714285
858.0,17,4,438,2,148,0.0,74.0,74.0,2,290,0.0,147.0,145.0
22014.0,6,14,4740,7,653,3484.6666666666665,249.0,93.28571428571428,7,4087,3291.5,1514.0,583.8571428571429
461777.0,6,10,1221,6,636,92355.4,298.0,106.0,4,585,146870.66666666666,379.0,146.25
4254.0,17,2,598,1,72,0.0,72.0,72.0,1,526,0.0,526.0,526.0
16891.0,17,2,180,1,90,0.0,90.0,90.0,1,90,0.0,90.0,90.0
266893.0,6,3,337,2,214,0.0,160.0,107.0,1,123,0.0,123.0,123.0
103043.0,17,2,286,2,286,0.0,143.0,143.0,0,0,0.0,0.0,0.0
31448.0,6,14,4740,7,653,4879.166666666667,249.0,93.28571428571428,7,4087,5055.0,1514.0,583.8571428571429
108105998.0,17,5,1005,5,1005,27026499.5,201.0,201.0,0,0,0.0,0.0,0.0
61153.0,6,10,2032,5,524,14595.25,252.0,104.8,5,1508,15014.0,1236.0,301.6
247357.0,17,2,180,1,90,0.0,90.0,90.0,1,90,0.0,90.0,90.0
27866.0,6,14,4740,7,653,3616.3333333333335,249.0,93.28571428571428,7,4087,4491.333333333333,1514.0,583.8571428571429
153556.0,17,2,180,1,90,0.0,90.0,90.0,1,90,0.0,90.0,90.0
1185519.0,6,13,3020,8,2392,169359.85714285713,1514.0,299.0,5,628,228235.25,331.0,125.6
16810.0,17,2,180,1,90,0.0,90.0,90.0,1,90,0.0,90.0,90.0
494126.0,6,5,336,2,134,0.0,68.0,67.0,3,202,194737.5,70.0,67.33333333333333
61942.0,6,14,4740,7,653,9478.5,249.0,93.28571428571428,7,4087,8406.333333333334,1514.0,583.8571428571429
206105.0,17,2,180,1,90,0.0,90.0,90.0,1,90,0.0,90.0,90.0
120121435.0,6,15,2444,7,1428,20020239.166666668,204.0,204.0,8,1016,17097662.285714287,188.0,127.0
40437403.0,6,26,7627,14,3735,200218.2307692308,1514.0,266.7857142857143,12,3892,3657504.454545455,1514.0,324.3333333333333
14088.0,6,13,1459,7,862,2092.5,271.0,123.14285714285714,6,597,2609.2,259.0,99.5
72053.0,6,13,1386,7,789,10358.0,253.0,112.71428571428572,6,597,13413.2,259.0,99.5
17190.0,6,10,2032,5,524,4023.25,252.0,104.8,5,1508,4020.0,1236.0,301.6
35787.0,6,14,4740,7,653,5848.5,249.0,93.28571428571428,7,4087,4386.166666666667,1514.0,583.8571428571429
115109170.0,6,48,3168,24,1584,5004746.521739131,66.0,66.0,24,1584,4991488.478260869,66.0,66.0
190889.0,17,2,180,1,90,0.0,90.0,90.0,1,90,0.0,90.0,90.0
592.0,17,2,508,2,508,0.0,257.0,254.0,0,0,0.0,0.0,0.0
145537.0,6,3,337,2,214,0.0,160.0,107.0,1,123,0.0,123.0,123.0
15786.000000000002,6,14,4740,7,653,2522.5,249.0,93.28571428571428,7,4087,2488.333333333333,1514.0,583.8571428571429
137752613.0,17,14,864,7,432,19666853.33333333,174.0,61.71428571428572,7,432,20060670.666666668,174.0,61.71428571428572
119531191.0,6,384,61812,192,48770,624690.7696335078,1514.0,254.01041666666663,192,13042,624690.1780104712,214.0,67.92708333333333
246219.0,6,3,337,2,214,0.0,160.0,107.0,1,123,0.0,123.0,123.0
30410.0,6,11,2098,6,590,5963.4,252.0,98.33333333333331,5,1508,6960.5,1236.0,301.6
10463107.0,6,7,478,4,272,3442011.333333333,74.0,68.0,3,206,5162887.5,74.0,68.66666666666667
103199468.0,6,44,2904,22,1452,4914260.380952381,66.0,66.0,22,1452,4901142.666666667,66.0,66.0
100715407.0,17,12,516,6,258,20000178.4,43.0,43.0,6,258,20001648.4,43.0,43.0
10431040.0,6,6,412,3,206,5147163.5,74.0,68.66666666666667,3,206,5147060.0,74.0,68.66666666666667
639.0,17,2,762,2,762,0.0,381.0,381.0,0,0,0.0,0.0,0.0
34730618.0,6,5,336,2,134,0.0,68.0,67.0,3,202,17295749.0,70.0,67.33333333333333
367.0,17,2,267,1,83,0.0,83.0,83.0,1,184,0.0,184.0,184.0
135129039.0,17,6,1206,6,1206,27025807.8,201.0,201.0,0,0,0.0,0.0,0.0
121752.0,6,3,337,2,214,0.0,160.0,107.0,1,123,0.0,123.0,123.0
24913.0,6,14,4740,7,653,3979.3333333333335,249.0,93.28571428571428,7,4087,4008.0,1514.0,583.8571428571429
822.0,17,2,508,2,508,0.0,257.0,254.0,0,0,0.0,0.0,0.0
12576.0,17,4,823,2,163,0.0,89.0,81.5,2,660,0.0,443.0,330.0
464.0,17,2,267,1,83,0.0,83.0,83.0,1,184,0.0,184.0,184.0
135132819.0,17,6,1206,6,1206,27026563.8,201.0,201.0,0,0,0.0,0.0,0.0
66331.0,6,14,4740,7,653,10403.666666666666,249.0,93.28571428571428,7,4087,10699.0,1514.0,583.8571428571429
219105.0,6,3,426,2,280,0.0,214.0,140.0,1,146,0.0,146.0,146.0
114506238.0,6,48,3168,24,1584,4978532.0869565215,66.0,66.0,24,1584,4966658.347826087,66.0,66.0
317810.0,17,4,1400,4,1400,105936.66666666669,350.0,350.0,0,0,0.0,0.0,0.0
90525618.0,6,13,2036,8,1016,12932231.142857144,188.0,127.0,5,1020,22590584.5,204.0,204.0
303158.0,6,2,132,1,66,0.0,66.0,66.0,1,66,0.0,66.0,66.0
63830.0,6,14,4740,7,653,10529.666666666666,249.0,93.28571428571428,7,4087,9032.5,1514.0,583.8571428571429
285386.0,6,10,1221,6,636,57077.2,298.0,106.0,4,585,81882.33333333333,379.0,146.25
1488883.0,17,16,1120,16,1120,99258.86666666668,70.0,70.0,0,0,0.0,0.0,0.0
122314599.0,6,48,3168,24,1584,4917128.521739131,66.0,66.0,24,1584,5290626.869565218,66.0,66.0
25827.0,6,14,4740,7,653,2703.833333333333,249.0,93.28571428571428,7,4087,4164.0,1514.0,583.8571428571429
2601008.0,6,2,132,1,66,0.0,66.0,66.0,1,66,0.0,66.0,66.0
246416.0,6,3,337,2,214,0.0,160.0,107.0,1,123,0.0,123.0,123.0
56188.0,6,14,4740,7,653,8637.666666666666,249.0,93.28571428571428,7,4087,8866.833333333334,1514.0,583.8571428571429
120284031.0,6,16,1233,8,637,17183433.0,95.0,79.625,8,596,17106284.57142857,95.0,74.5
90291911.0,6,16,1192,8,596,12891651.57142857,95.0,74.5,8,596,12898206.714285716,95.0,74.5
15692.000000000002,6,2,145,2,145,0.0,91.0,72.5,0,0,0.0,0.0,0.0
138103.0,6,2,132,1,66,0.0,66.0,66.0,1,66,0.0,66.0,66.0
146069.0,6,3,337,2,214,0.0,160.0,107.0,1,123,0.0,123.0,123.0
0.0,6,1,66,1,66,0.0,66.0,66.0,0,0,0.0,0.0,0.0
143830.0,17,2,180,1,90,0.0,90.0,90.0,1,90,0.0,90.0,90.0
81.0,17,2,762,2,762,0.0,381.0,381.0,0,0,0.0,0.0,0.0
14631698.0,6,20,1607,10,975,1592496.6666666667,315.0,97.5,10,632,1592467.3333333333,78.0,63.2
11641.0,17,2,570,1,81,0.0,81.0,81.0,1,489,0.0,489.0,489.0
305753.0,6,6,412,4,272,101917.66666666669,74.0,68.0,2,140,0.0,74.0,70.0
206524.0,6,3,426,2,280,0.0,214.0,140.0,1,146,0.0,146.0,146.0
312.0,17,2,156,1,78,0.0,78.0,78.0,1,78,0.0,78.0,78.0
64800.0,6,14,4740,7,653,10277.333333333334,249.0,93.28571428571428,7,4087,10619.5,1514.0,583.8571428571429
114959541.0,6,31,2166,16,1149,7649580.0,123.0,71.8125,15,1017,8195978.285714285,123.0,67.8
90259397.0,6,13,2036,8,1016,12894199.57142857,188.0,127.0,5,1020,22523402.75,204.0,204.0
23072043.0,17,3,1034,2,684,0.0,342.0,342.0,1,350,0.0,350.0,350.0
14649099.0,6,19,1635,9,1003,1791503.625,315.0,111.44444444444444,10,632,1592438.6666666667,78.0,63.2
90055570.0,17,28,13364,28,13364,3335391.4814814813,501.0,477.2857142857143,0,0,0.0,0.0,0.0
111007623.0,6,34,2350,17,1225,6924474.9375,139.0,72.05882352941177,17,1125,6924474.8125,123.0,66.17647058823529
1258594.0,6,11,1134,6,558,251718.8,220.0,93.0,5,576,313943.25,304.0,115.2
2930686.0,6,11,2106,6,598,585960.0,252.0,99.66666666666669,5,1508,1806.75,1236.0,301.6
800.0,17,2,762,2,762,0.0,381.0,381.0,0,0,0.0,0.0,0.0
92308949.0,6,257,30528,129,8736,720865.140625,140.0,67.72093023255815,128,21792,726686.6377952755,374.0,170.25
2312.0,17,4,344,2,150,0.0,75.0,75.0,2,194,0.0,103.0,97.0
90035269.0,17,28,13364,28,13364,3334639.592592593,501.0,477.2857142857143,0,0,0.0,0.0,0.0
16261.999999999998,6,11,1132,6,556,2512.6,218.0,92.66666666666669,5,576,3721.0,304.0,115.2
137134.0,17,2,176,1,80,0.0,80.0,80.0,1,96,0.0,96.0,96.0
14677936.0,6,20,1607,10,975,1592964.2222222222,315.0,97.5,10,632,1593924.3333333333,78.0,63.2
43608.0,6,14,4740,7,653,7102.833333333333,249.0,93.28571428571428,7,4087,6760.833333333333,1514.0,583.8571428571429
106364779.0,6,204,22980,102,16026,1050986.5148514851,284.0,157.11764705882354,102,6954,1050986.2277227722,140.0,68.17647058823529
232324.0,6,3,337,2,214,0.0,160.0,107.0,1,123,0.0,123.0,123.0
120127608.0,6,1006,209320,512,175828,235083.38160469668,1514.0,343.4140625,494,33492,241801.6369168357,214.0,67.79757085020243
83778.0,6,14,4740,7,653,13838.166666666666,249.0,93.28571428571428,7,4087,13731.166666666666,1514.0,583.8571428571429
238808.0,6,10,1221,6,636,47761.6,298.0,106.0,4,585,78737.0,379.0,146.25
96625.0,6,10,1065,5,534,21965.0,262.0,106.8,5,531,22384.75,259.0,106.2
232181.0,6,3,337,2,214,0.0,160.0,107.0,1,123,0.0,123.0,123.0
5417639.0,6,35,8936,18,4915,318684.64705882355,1514.0,273.05555555555554,17,4021,269587.0625,1514.0,236.52941176470588
90095260.0,6,11,1644,4,816,30031391.33333333,204.0,204.0,7,828,15015478.833333334,188.0,118.28571428571428
305623.0,6,6,412,4,272,101874.33333333331,74.0,68.0,2,140,0.0,74.0,70.0
328235.0,6,6,412,4,272,109411.66666666669,74.0,68.0,2,140,0.0,74.0,70.0
108692.0,17,2,286,2,286,0.0,143.0,143.0,0,0,0.0,0.0,0.0
107833653.0,6,28,1860,14,966,8278308.846153846,123.0,69.0,14,894,8278305.538461538,123.0,63.85714285714285
14645804.0,6,19,1553,9,921,1791956.5,315.0,102.33333333333331,10,632,1592823.0,78.0,63.2
204752.0,17,2,762,2,762,0.0,381.0,381.0,0,0,0.0,0.0,0.0
50966.0,17,2,180,1,90,0.0,90.0,90.0,1,90,0.0,90.0,90.0
90096786.0,6,13,2052,6,1224,18018870.2,204.0,204.0,7,828,14970065.166666666,188.0,118.28571428571428
120164471.0,6,230,25866,115,7886,1046883.3421052631,140.0,68.57391304347826,115,17980,1046898.947368421,284.0,156.34782608695653
153366.0,17,2,180,1,90,0.0,90.0,90.0,1,90,0.0,90.0,90.0
1302781.0,6,4,264,2,132,0.0,66.0,66.0,2,132,0.0,66.0,66.0
103636.0,17,2,762,2,762,0.0,381.0,381.0,0,0,0.0,0.0,0.0
90260467.0,6,15,2444,8,1016,12894352.42857143,188.0,127.0,7,1428,15015877.833333334,204.0,204.0
260096.0,6,10,1221,6,636,52019.2,298.0,106.0,4,585,75088.66666666667,379.0,146.25
2842688.0,6,5,336,3,202,1421344.0,70.0,67.33333333333333,2,134,0.0,68.0,67.0
90260218.0,6,13,2036,8,1016,12894316.857142856,188.0,127.0,5,1020,22523893.25,204.0,204.0
90060222.0,17,27,12943,27,12943,3463854.6923076925,501.0,479.3703703703704,0,0,0.0,0.0,0.0
13041.0,6,10,2032,5,524,2949.5,252.0,104.8,5,1508,3014.0,1236.0,301.6
849505.0,6,9,1196,6,725,169901.0,387.0,120.83333333333331,3,471,288362.0,331.0,157.0
105844.0,17,2,700,2,700,0.0,350.0,350.0,0,0,0.0,0.0,0.0
117634686.0,6,34,2403,17,1194,7352167.875,123.0,70.23529411764706,17,1209,7338649.4375,123.0,71.11764705882354
90253973.0,6,12,1832,8,1016,12893424.714285716,188.0,127.0,4,816,30029511.33333333,204.0,204.0
22166.0,17,4,823,2,163,0.0,89.0,81.5,2,660,0.0,443.0,330.0
317274.0,17,4,1400,4,1400,105758.0,350.0,350.0,0,0,0.0,0.0,0.0
108684138.0,6,32,2220,16,1149,7245609.2,123.0,71.8125,16,1071,7231228.933333334,123.0,66.9375
299393.0,17,2,634,1,82,0.0,82.0,82.0,1,552,0.0,552.0,552.0
99925433.0,6,26,1746,13,906,8309011.166666667,123.0,69.6923076923077,13,840,8309132.166666667,123.0,64.61538461538461
31015.0,6,14,4740,7,653,5033.833333333333,249.0,93.28571428571428,7,4087,5033.0,1514.0,583.8571428571429
90539654.0,6,14,2240,8,1016,12934236.285714284,188.0,127.0,6,1224,18075292.4,204.0,204.0
2333.0,17,4,344,2,150,0.0,75.0,75.0,2,194,0.0,103.0,97.0
209511.0,17,2,180,1,90,0.0,90.0,90.0,1,90,0.0,90.0,90.0
120032565.0,17,28,13364,28,13364,4445650.555555556,501.0,477.2857142857143,0,0,0.0,0.0,0.0
35170.0,6,14,4740,7,653,5703.666666666667,249.0,93.28571428571428,7,4087,5636.666666666667,1514.0,583.8571428571429
0.0,17,1,55,1,55,0.0,55.0,55.0,0,0,0.0,0.0,0.0
1778591.0,6,2,132,1,66,0.0,66.0,66.0,1,66,0.0,66.0,66.0
217046.0,6,3,426,2,280,0.0,214.0,140.0,1,146,0.0,146.0,146.0
2328.0,17,4,344,2,150,0.0,75.0,75.0,2,194,0.0,103.0,97.0
517089.0,6,3,204,1,68,0.0,68.0,68.0,2,136,0.0,70.0,68.0
243558.0,6,3,337,2,214,0.0,160.0,107.0,1,123,0.0,123.0,123.0
29364.0,6,14,4740,7,653,3977.1666666666665,249.0,93.28571428571428,7,4087,3948.8333333333335,1514.0,583.8571428571429
206460.0,17,2,180,1,90,0.0,90.0,90.0,1,90,0.0,90.0,90.0
29152.0,6,10,2032,5,524,6593.5,252.0,104.8,5,1508,6853.75,1236.0,301.6
592057.0,17,2,346,1,78,0.0,78.0,78.0,1,268,0.0,268.0,268.0
135131086.0,17,6,1206,6,1206,27026217.2,201.0,201.0,0,0,0.0,0.0,0.0
228500.0,17,2,180,1,90,0.0,90.0,90.0,1,90,0.0,90.0,90.0
304525.0,6,6,412,4,272,101508.33333333331,74.0,68.0,2,140,0.0,74.0,70.0
239293.0,17,2,180,1,90,0.0,90.0,90.0,1,90,0.0,90.0,90.0
478839.0,17,2,363,1,79,0.0,79.0,79.0,1,284,0.0,284.0,284.0
264850.0,6,3,337,2,214,0.0,160.0,107.0,1,123,0.0,123.0,123.0
146342.0,6,2,132,1,66,0.0,66.0,66.0,1,66,0.0,66.0,66.0
20112.0,6,20,7606,11,978,2011.2,310.0,88.9090909090909,9,6628,2133.5,1514.0,736.4444444444445
148953.0,17,2,414,1,88,0.0,88.0,88.0,1,326,0.0,326.0,326.0
108099764.0,17,5,1005,5,1005,27024941.0,201.0,201.0,0,0,0.0,0.0,0.0
848818.0,6,9,1196,6,725,169763.6,387.0,120.83333333333331,3,471,288032.5,331.0,157.0
307229.0,6,6,412,4,272,102409.66666666669,74.0,68.0,2,140,0.0,74.0,70.0
228549.0,17,2,180,1,90,0.0,90.0,90.0,1,90,0.0,90.0,90.0
123416512.0,6,48,3168,24,1584,5082249.652173913,66.0,66.0,24,1584,5219319.652173913,66.0,66.0
120000021.0,6,17,1287,9,691,15000002.625,95.0,76.77777777777777,8,596,12896565.285714284,95.0,74.5
90304752.0,6,16,1192,8,596,12894010.714285716,95.0,74.5,8,596,12900075.0,95.0,74.5
116333282.0,6,47,3102,24,1584,5057957.521739131,66.0,66.0,23,1518,5168021.7727272725,66.0,66.0
234569.0,6,3,373,2,238,0.0,172.0,119.0,1,135,0.0,135.0,135.0
1192256.0,6,13,3007,8,2379,170322.2857142857,1514.0,297.375,5,628,229187.0,331.0,125.6
230651.0,17,2,180,1,90,0.0,90.0,90.0,1,90,0.0,90.0,90.0
343622.0,17,2,333,1,87,0.0,87.0,87.0,1,246,0.0,246.0,246.0
27479568.0,17,5,1710,5,1710,6869892.0,342.0,342.0,0,0,0.0,0.0,0.0
143958.0,17,2,180,1,90,0.0,90.0,90.0,1,90,0.0,90.0,90.0
90053953.0,17,27,12943,27,12943,3463613.576923077,501.0,479.3703703703704,0,0,0.0,0.0,0.0
122170099.0,6,234,26422,117,8018,1028132.474137931,140.0,68.52991452991454,117,18404,1046021.2155172414,284.0,157.2991452991453
880666.0,6,12,2709,7,742,146777.66666666666,338.0,106.0,5,1967,152019.5,1514.0,393.4
10474334.0,6,7,478,4,272,3445770.6666666665,74.0,68.0,3,206,5168567.5,74.0,68.66666666666667
102784.0,17,2,286,2,286,0.0,143.0,143.0,0,0,0.0,0.0,0.0
108110088.0,17,5,955,5,955,27027522.0,191.0,191.0,0,0,0.0,0.0,0.0
2715176.0,6,25,7573,14,3735,208859.6923076923,1514.0,266.7857142857143,11,3838,245289.0,1514.0,348.90909090909093
98632453.0,6,212,24318,106,7218,932611.4095238096,140.0,68.09433962264151,106,17100,931612.4095238096,284.0,161.32075471698113
370446.0,6,11,1021,6,444,50282.2,162.0,74.0,5,577,62766.75,349.0,115.4
45482.0,6,14,4740,7,653,7415.666666666667,249.0,93.28571428571428,7,4087,6740.333333333333,1514.0,583.8571428571429
146789.0,6,3,373,2,238,0.0,172.0,119.0,1,135,0.0,135.0,135.0
10451453.0,6,7,478,4,272,3438579.333333333,74.0,68.0,3,206,5157776.5,74.0,68.66666666666667
91430567.0,6,24,1829,13,989,7618401.166666667,95.0,76.07692307692308,11,840,9141758.8,95.0,76.36363636363636
747411.0,6,2,132,1,66,0.0,66.0,66.0,1,66,0.0,66.0,66.0
207048.0,6,3,426,2,280,0.0,214.0,140.0,1,146,0.0,146.0,146.0
90095010.0,6,12,1848,5,1020,22523182.75,204.0,204.0,7,828,14970814.5,188.0,118.28571428571428
2424.0,17,4,344,2,150,0.0,75.0,75.0,2,194,0.0,103.0,97.0
2315.0,17,4,344,2,150,0.0,75.0,75.0,2,194,0.0,103.0,97.0
90297063.0,6,19,1436,10,745,10028138.111111112,95.0,74.5,9,691,11286646.625,95.0,76.77777777777777
96209981.0,6,160,18202,80,12700,1215122.9240506329,374.0,158.75,80,5502,1215122.3164556962,140.0,68.775
207240.0,6,3,426,2,280,0.0,214.0,140.0,1,146,0.0,146.0,146.0
10746.0,6,10,1065,5,534,2199.75,262.0,106.8,5,531,2339.75,259.0,106.2
90261348.0,6,12,1832,8,1016,12894478.285714284,188.0,127.0,4,816,30031212.33333333,204.0,204.0
300656.0,6,6,412,4,272,100218.66666666669,74.0,68.0,2,140,0.0,74.0,70.0
9909.0,17,2,582,1,83,0.0,83.0,83.0,1,499,0.0,499.0,499.0
60668.0,6,14,4740,7,653,9652.833333333334,249.0,93.28571428571428,7,4087,9004.0,1514.0,583.8571428571429
110972953.0,6,30,1974,15,1026,7911231.714285715,123.0,68.4,15,948,7911220.0,123.0,63.2
1305872.0,6,4,264,2,132,0.0,66.0,66.0,2,132,0.0,66.0,66.0
90536605.0,6,13,2036,8,1016,12933800.714285716,188.0,127.0,5,1020,22591960.5,204.0,204.0
214754.0,6,10,1221,6,636,42950.8,298.0,106.0,4,585,70731.0,379.0,146.25
207167.0,6,3,426,2,280,0.0,214.0,140.0,1,146,0.0,146.0,146.0
120000219.0,6,19,1562,10,745,13333357.666666666,95.0,74.5,9,817,13993645.625,221.0,90.77777777777776
27079095.0,17,5,1710,5,1710,6769773.75,342.0,342.0,0,0,0.0,0.0,0.0
221077.0,17,2,414,1,88,0.0,88.0,88.0,1,326,0.0,326.0,326.0
224839.0,17,2,180,1,90,0.0,90.0,90.0,1,90,0.0,90.0,90.0
24384.0,6,10,2032,5,524,5885.5,252.0,104.8,5,1508,5262.5,1236.0,301.6
158386.0,6,11,1132,6,556,30799.2,218.0,92.66666666666669,5,576,39171.5,304.0,115.2
2464.0,17,4,344,2,150,0.0,75.0,75.0,2,194,0.0,103.0,97.0
144915.0,17,2,180,1,70,0.0,70.0,70.0,1,110,0.0,110.0,110.0
252379.00000000003,6,3,337,2,214,0.0,160.0,107.0,1,123,0.0,123.0,123.0
113456271.0,6,46,3036,23,1518,5157092.045454546,66.0,66.0,23,1518,5157092.136363637,66.0,66.0
90054505.0,17,28,13364,28,13364,3335352.037037037,501.0,477.2857142857143,0,0,0.0,0.0,0.0
135136117.0,17,6,1146,6,1146,27027223.4,191.0,191.0,0,0,0.0,0.0,0.0
209487.0,17,2,180,1,90,0.0,90.0,90.0,1,90,0.0,90.0,90.0
2800355.0,6,2,132,1,66,0.0,66.0,66.0,1,66,0.0,66.0,66.0
123648070.0,6,49,3234,25,1650,5152002.916666667,66.0,66.0,24,1584,4947804.782608695,66.0,66.0
20674.0,17,2,582,1,83,0.0,83.0,83.0,1,499,0.0,499.0,499.0
5022586.0,17,4,1164,2,166,0.0,83.0,83.0,2,998,0.0,499.0,499.0
108106388.0,17,5,1005,5,1005,27026597.0,201.0,201.0,0,0,0.0,0.0,0.0
304276.0,6,6,412,4,272,101425.33333333331,74.0,68.0,2,140,0.0,74.0,70.0
107239.0,17,2,286,2,286,0.0,143.0,143.0,0,0,0.0,0.0,0.0
209493.0,17,2,762,2,762,0.0,381.0,381.0,0,0,0.0,0.0,0.0
240144.0,6,3,337,2,214,0.0,160.0,107.0,1,123,0.0,123.0,123.0
2817389.0,6,2,132,1,66,0.0,66.0,66.0,1,66,0.0,66.0,66.0
5831421.0,6,5,336,2,134,0.0,68.0,67.0,3,202,1526091.0,70.0,67.33333333333333
91488337.0,6,497,105042,246,16680,373421.7836734694,214.0,67.8048780487805,251,88362,359115.18,1514.0,352.0398406374502
251717.00000000003,17,4,6056,4,6056,83905.66666666667,1514.0,1514.0,0,0,0.0,0.0,0.0
232094.0,6,3,337,2,214,0.0,160.0,107.0,1,123,0.0,123.0,123.0
1825738.0,6,22,6442,12,1529,165976.18181818182,357.0,127.41666666666669,10,4913,167176.88888888888,1510.0,491.3
233835.0,6,3,373,2,238,0.0,172.0,119.0,1,135,0.0,135.0,135.0
28021.0,6,12,1393,6,796,4893.8,271.0,132.66666666666666,6,597,3055.0,259.0,99.5
1310149.0,6,4,264,2,132,0.0,66.0,66.0,2,132,0.0,66.0,66.0
197110.0,17,2,180,1,90,0.0,90.0,90.0,1,90,0.0,90.0,90.0
108102370.0,17,5,955,5,955,27025592.5,191.0,191.0,0,0,0.0,0.0,0.0
90098839.0,6,11,1644,7,828,15016473.166666666,188.0,118.28571428571428,4,816,20023117.33333333,204.0,204.0
103333.0,17,2,180,1,90,0.0,90.0,90.0,1,90,0.0,90.0,90.0
1314099.0,6,4,264,2,132,0.0,66.0,66.0,2,132,0.0,66.0,66.0
135045.0,6,3,337,2,214,0.0,160.0,107.0,1,123,0.0,123.0,123.0
277036.0,6,10,1221,6,636,55407.2,298.0,106.0,4,585,86831.66666666667,379.0,146.25
108109321.0,17,5,1005,5,1005,27027330.25,201.0,201.0,0,0,0.0,0.0,0.0
40670.0,6,14,4740,7,653,5877.0,249.0,93.28571428571428,7,4087,6538.166666666667,1514.0,583.8571428571429
17594.0,6,20,7606,11,978,1759.4,310.0,88.9090909090909,9,6628,1924.5,1514.0,736.4444444444445
95884.0,17,2,762,2,762,0.0,381.0,381.0,0,0,0.0,0.0,0.0
120116169.0,6,13,2036,8,1016,17136648.42857143,188.0,127.0,5,1020,22523244.25,204.0,204.0
90243275.0,6,13,2036,8,1016,12891896.42857143,188.0,127.0,5,1020,22519096.75,204.0,204.0
155165.0,6,3,337,2,214,0.0,160.0,107.0,1,123,0.0,123.0,123.0
440768.0,6,10,967,5,390,74129.25,162.0,78.0,5,577,74066.0,349.0,115.4
302138.0,6,6,412,4,272,100712.66666666669,74.0,68.0,2,140,0.0,74.0,70.0
113646119.0,6,34,2350,17,1225,7089396.875,139.0,72.05882352941177,17,1125,7089403.9375,123.0,66.17647058823529
402.0,17,2,267,1,83,0.0,83.0,83.0,1,184,0.0,184.0,184.0
22663.0,6,14,4740,7,653,3248.0,249.0,93.28571428571428,7,4087,3645.8333333333335,1514.0,583.8571428571429
2422.0,17,4,344,2,150,0.0,75.0,75.0,2,194,0.0,103.0,97.0
784943.0,6,14,4740,7,653,130320.5,249.0,93.28571428571428,7,4087,129682.83333333331,1514.0,583.8571428571429
830039.0,6,12,1354,6,723,165210.0,253.0,120.5,6,631,165511.8,293.0,105.16666666666669
42209748.0,17,133,8680,65,4247,651376.109375,106.0,65.33846153846154,68,4433,629928.8805970149,106.0,65.19117647058823
25610.0,6,14,4740,7,653,3719.6666666666665,249.0,93.28571428571428,7,4087,4134.333333333333,1514.0,583.8571428571429
90093165.0,6,11,1766,7,950,15015527.5,188.0,135.71428571428572,4,816,20105807.0,204.0,204.0
153456.0,17,2,180,1,90,0.0,90.0,90.0,1,90,0.0,90.0,90.0
300807.0,6,6,412,4,272,100269.0,74.0,68.0,2,140,0.0,74.0,70.0
113520536.0,6,46,3036,23,1518,5160013.0,66.0,66.0,23,1518,5160012.7727272725,66.0,66.0
206431.0,6,3,426,2,280,0.0,214.0,140.0,1,146,0.0,146.0,146.0
27095.0,6,14,4740,7,653,4229.666666666667,249.0,93.28571428571428,7,4087,4061.1666666666665,1514.0,583.8571428571429
121001185.0,17,15,907,8,475,17285883.57142857,174.0,59.375,7,432,16834705.0,174.0,61.71428571428572
38249.0,6,14,4740,7,653,6172.333333333333,249.0,93.28571428571428,7,4087,6101.5,1514.0,583.8571428571429
18893.0,6,14,4740,7,653,2949.333333333333,249.0,93.28571428571428,7,4087,3001.833333333333,1514.0,583.8571428571429
65658.0,6,14,4740,7,653,10782.166666666666,249.0,93.28571428571428,7,4087,10615.5,1514.0,583.8571428571429
147977.0,17,2,180,1,90,0.0,90.0,90.0,1,90,0.0,90.0,90.0
236897.0,17,2,180,1,90,0.0,90.0,90.0,1,90,0.0,90.0,90.0
120122043.0,6,15,2444,8,1016,17137395.285714287,188.0,127.0,7,1428,15015552.5,204.0,204.0
123630551.0,6,49,3234,25,1650,5151272.958333333,66.0,66.0,24,1584,4954889.304347826,66.0,66.0
208749.0,6,10,1221,6,636,41749.8,298.0,106.0,4,585,68437.33333333333,379.0,146.25
284260.0,17,2,363,1,79,0.0,79.0,79.0,1,284,0.0,284.0,284.0
522751.0,6,5,367,3,235,261375.50000000003,103.0,78.33333333333333,2,132,0.0,66.0,66.0
13720.0,6,14,4740,7,653,2032.6666666666667,249.0,93.28571428571428,7,4087,2148.833333333333,1514.0,583.8571428571429
33258.0,6,14,4740,7,653,5420.5,249.0,93.28571428571428,7,4087,5402.833333333333,1514.0,583.8571428571429
2487.0,17,4,344,2,150,0.0,75.0,75.0,2,194,0.0,103.0,97.0
108112166.0,17,5,955,5,955,27028041.5,191.0,191.0,0,0,0.0,0.0,0.0
147332.0,6,3,373,2,238,0.0,172.0,119.0,1,135,0.0,135.0,135.0
106318.0,17,2,700,2,700,0.0,350.0,350.0,0,0,0.0,0.0,0.0
108116224.0,17,5,1005,5,1005,27029056.0,201.0,201.0,0,0,0.0,0.0,0.0
112223177.0,17,14,864,7,432,18668093.0,174.0,61.71428571428572,7,432,18666835.33333333,174.0,61.71428571428572
90762657.0,6,17,1287,9,691,11339864.25,95.0,76.77777777777777,8,596,12965849.285714284,95.0,74.5
19425.0,6,14,4740,7,653,2525.0,249.0,93.28571428571428,7,4087,3059.0,1514.0,583.8571428571429
303.0,17,2,168,1,76,0.0,76.0,76.0,1,92,0.0,92.0,92.0
120132470.0,6,13,2075,5,995,30033117.5,199.0,199.0,8,1080,17137187.714285713,204.0,135.0
31897.0,6,10,2032,5,524,7501.5,252.0,104.8,5,1508,7527.5,1236.0,301.6
90018483.0,17,28,13364,28,13364,3334017.888888889,501.0,477.2857142857143,0,0,0.0,0.0,0.0
108109717.0,17,5,955,5,955,27027429.25,191.0,191.0,0,0,0.0,0.0,0.0
135126058.0,17,6,1146,6,1146,27025211.6,191.0,191.0,0,0,0.0,0.0,0.0
407132.0,6,3,204,2,136,0.0,70.0,68.0,1,68,0.0,68.0,68.0
108097814.0,17,5,955,5,955,27024453.5,191.0,191.0,0,0,0.0,0.0,0.0
239283.0,6,3,337,2,214,0.0,160.0,107.0,1,123,0.0,123.0,123.0
1055700.0,6,3,1604,1,753,0.0,753.0,753.0,2,851,0.0,785.0,425.5
2383.0,17,4,344,2,150,0.0,75.0,75.0,2,194,0.0,103.0,97.0
857329.0,6,9,1096,6,625,171465.8,287.0,104.16666666666669,3,471,290880.5,331.0,157.0
328.0,17,2,166,1,75,0.0,75.0,75.0,1,91,0.0,91.0,91.0
239410.0,17,2,180,1,90,0.0,90.0,90.0,1,90,0.0,90.0,90.0
90927214.0,6,21,1585,11,840,9092444.3,95.0,76.36363636363636,10,745,10101325.111111112,95.0,74.5
94174008.0,6,40,2640,20,1320,4956526.736842105,66.0,66.0,20,1320,4940726.157894737,66.0,66.0
8979.0,17,2,539,1,86,0.0,86.0,86.0,1,453,0.0,453.0,453.0
108947.0,17,2,286,2,286,0.0,143.0,143.0,0,0,0.0,0.0,0.0
103233556.0,6,28,1860,14,966,7924452.230769231,123.0,69.0,14,894,7924451.076923077,123.0,63.85714285714285
6348.0,17,2,239,1,82,0.0,82.0,82.0,1,157,0.0,157.0,157.0
178869.0,6,3,337,2,214,0.0,160.0,107.0,1,123,0.0,123.0,123.0
122068.0,6,3,337,2,214,0.0,160.0,107.0,1,123,0.0,123.0,123.0
741229.0,6,6,758,3,410,346252.0,172.0,136.66666666666666,3,348,254926.5,135.0,116.0
759.0,17,4,438,2,148,0.0,74.0,74.0,2,290,0.0,147.0,145.0
29159.0,6,14,4740,7,653,4012.8333333333335,249.0,93.28571428571428,7,4087,4721.166666666667,1514.0,583.8571428571429
90904819.0,6,29,2068,15,1105,6477783.642857143,139.0,73.66666666666667,14,963,6976075.384615385,123.0,68.78571428571429
146395.0,6,3,337,2,214,0.0,160.0,107.0,1,123,0.0,123.0,123.0
122525.0,6,3,373,2,238,0.0,172.0,119.0,1,135,0.0,135.0,135.0
21817784.0,6,22,1719,11,1029,2150265.8,315.0,93.54545454545456,11,690,2150232.8,78.0,62.72727272727273
214541.0,6,4,492,2,280,0.0,214.0,140.0,2,212,0.0,146.0,106.0
90534456.0,6,14,2240,8,1016,12933493.714285716,188.0,127.0,6,1224,18073678.8,204.0,204.0
319.0,17,2,174,1,79,0.0,79.0,79.0,1,95,0.0,95.0,95.0
4413.0,17,4,344,2,150,0.0,75.0,75.0,2,194,0.0,103.0,97.0
135134702.0,17,6,1206,6,1206,27026940.4,201.0,201.0,0,0,0.0,0.0,0.0
2013132.0,6,18,6803,10,1501,223681.3333333333,408.0,150.1,8,5302,226029.2857142857,1514.0,662.75
1316.0,17,2,762,2,762,0.0,381.0,381.0,0,0,0.0,0.0,0.0
149274.0,6,14,4740,7,653,24344.166666666668,249.0,93.28571428571428,7,4087,16627.833333333332,1514.0,583.8571428571429
197861.0,17,2,762,2,762,0.0,381.0,381.0,0,0,0.0,0.0,0.0
153476.0,17,2,180,1,90,0.0,90.0,90.0,1,90,0.0,90.0,90.0
314.0,17,2,166,1,75,0.0,75.0,75.0,1,91,0.0,91.0,91.0
313510.0,17,4,1400,4,1400,104503.33333333331,350.0,350.0,0,0,0.0,0.0,0.0
3631450.0,6,146,120885,85,112558,43231.54761904762,1510.0,1324.2117647058824,61,8327,55438.75,1510.0,136.50819672131146
20354.0,17,2,582,1,83,0.0,83.0,83.0,1,499,0.0,499.0,499.0
206140.0,6,3,426,2,280,0.0,214.0,140.0,1,146,0.0,146.0,146.0
624145.0,17,2,473,1,78,0.0,78.0,78.0,1,395,0.0,395.0,395.0
399.0,17,2,267,1,83,0.0,83.0,83.0,1,184,0.0,184.0,184.0
1035538.0,6,11,1134,6,558,207107.6,220.0,93.0,5,576,257634.25,304.0,115.2
107260.0,17,2,286,2,286,0.0,143.0,143.0,0,0,0.0,0.0,0.0
135136892.0,17,6,1146,6,1146,27027378.4,191.0,191.0,0,0,0.0,0.0,0.0
1019413.0,6,11,1134,6,558,203882.6,220.0,93.0,5,576,253740.5,304.0,115.2
3010274.0,6,11,2106,6,598,601840.0,252.0,99.66666666666669,5,1508,2993.5,1236.0,301.6
52741.0,6,11,2098,6,590,9467.4,252.0,98.33333333333331,5,1508,12425.0,1236.0,301.6
84363.0,6,10,2032,5,524,20857.5,252.0,104.8,5,1508,19257.75,1236.0,301.6
518158.0,6,5,336,2,134,0.0,68.0,67.0,3,202,193115.5,70.0,67.33333333333333
297733.0,6,6,412,4,272,99244.33333333331,74.0,68.0,2,140,0.0,74.0,70.0
146269.0,6,3,337,2,214,0.0,160.0,107.0,1,123,0.0,123.0,123.0
45591.0,6,14,4740,7,653,7250.333333333333,249.0,93.28571428571428,7,4087,6633.833333333333,1514.0,583.8571428571429
107845228.0,6,28,1860,14,966,8295786.769230769,123.0,69.0,14,894,8279163.230769231,123.0,63.85714285714285
17818.0,6,10,2032,5,524,4228.75,252.0,104.8,5,1508,4215.0,1236.0,301.6
309.0,17,2,174,1,79,0.0,79.0,79.0,1,95,0.0,95.0,95.0
285249.0,6,12,1373,7,714,47541.5,298.0,102.0,5,659,67259.5,379.0,131.8
29787.0,6,14,4740,7,653,4833.833333333333,249.0,93.28571428571428,7,4087,4795.833333333333,1514.0,583.8571428571429
90645572.0,6,15,2302,9,1204,11317015.875,188.0,133.77777777777777,6,1098,18096399.8,204.0,183.0
196977.0,17,2,180,1,90,0.0,90.0,90.0,1,90,0.0,90.0,90.0
90031502.0,17,28,13364,28,13364,3334500.074074074,501.0,477.2857142857143,0,0,0.0,0.0,0.0
315555.0,17,4,1400,4,1400,105185.0,350.0,350.0,0,0,0.0,0.0,0.0
312889.0,17,4,1400,4,1400,104296.33333333331,350.0,350.0,0,0,0.0,0.0,0.0
1313581.0,6,4,264,2,132,0.0,66.0,66.0,2,132,0.0,66.0,66.0
155596.0,6,3,337,2,214,0.0,160.0,107.0,1,123,0.0,123.0,123.0
221722.0,6,3,426,2,280,0.0,214.0,140.0,1,146,0.0,146.0,146.0
105263664.0,17,15,1431,8,737,15014964.857142856,174.0,92.125,7,694,17517448.5,174.0,99.14285714285714
126606262.0,6,32,2220,16,1071,7774717.4,123.0,66.9375,16,1149,7774705.2,123.0,71.8125
27412026.0,17,5,1710,5,1710,6853006.5,342.0,342.0,0,0,0.0,0.0,0.0
99941526.0,6,31,2314,16,1228,6648379.133333334,139.0,76.75,15,1086,7123265.071428572,123.0,72.4
123776023.0,6,49,3234,25,1650,5157334.291666667,66.0,66.0,24,1584,5187734.521739131,66.0,66.0
110001077.0,17,13,821,7,432,18333512.83333333,174.0,61.71428571428572,6,389,18000912.0,174.0,64.83333333333333
118017284.0,6,19,1395,10,745,13108302.777777778,95.0,74.5,9,650,14745758.25,95.0,72.22222222222223
107775.0,17,2,286,2,286,0.0,143.0,143.0,0,0,0.0,0.0,0.0
296994.0,17,2,180,1,90,0.0,90.0,90.0,1,90,0.0,90.0,90.0
146281.0,6,3,337,2,214,0.0,160.0,107.0,1,123,0.0,123.0,123.0
0.0,6,1,66,1,66,0.0,66.0,66.0,0,0,0.0,0.0,0.0
2421.0,17,4,344,2,150,0.0,75.0,75.0,2,194,0.0,103.0,97.0
248069.0,6,4,439,2,238,0.0,172.0,119.0,2,201,0.0,135.0,100.5
58743048.0,17,9,3086,8,2736,5109714.428571428,342.0,342.0,1,350,0.0,350.0,350.0
93552577.0,6,40,2640,20,1320,4923819.842105263,66.0,66.0,20,1320,4907579.947368421,66.0,66.0
92116.0,6,14,4740,7,653,14955.5,249.0,93.28571428571428,7,4087,14725.333333333334,1514.0,583.8571428571429
909197.0,6,12,2709,7,742,151532.83333333334,338.0,106.0,5,1967,159180.5,1514.0,393.4
147981.0,17,2,180,1,90,0.0,90.0,90.0,1,90,0.0,90.0,90.0
40910.0,6,14,4740,7,653,6210.666666666667,249.0,93.28571428571428,7,4087,6469.666666666667,1514.0,583.8571428571429
3154924.0,6,7,923,4,753,982917.0,571.0,188.25,3,170,1475133.5,62.0,56.66666666666666
218462.0,6,10,1221,6,636,43692.4,298.0,106.0,4,585,71702.66666666667,379.0,146.25
125491546.0,6,31,2097,16,1149,8366103.066666666,123.0,71.8125,15,948,8399101.785714285,123.0,63.2
0.0,17,1,55,1,55,0.0,55.0,55.0,0,0,0.0,0.0,0.0
701.0,17,4,438,2,148,0.0,74.0,74.0,2,290,0.0,147.0,145.0
4274.0,17,2,598,1,72,0.0,72.0,72.0,1,526,0.0,526.0,526.0
218197.0,6,3,426,2,280,0.0,214.0,140.0,1,146,0.0,146.0,146.0
122228.0,6,3,373,2,238,0.0,172.0,119.0,1,135,0.0,135.0,135.0
284879.0,17,2,363,1,79,0.0,79.0,79.0,1,284,0.0,284.0,284.0
245791.0,6,3,337,2,214,0.0,160.0,107.0,1,123,0.0,123.0,123.0
22741.0,6,14,4740,7,653,3659.0,249.0,93.28571428571428,7,4087,3658.1666666666665,1514.0,583.8571428571429
2387.0,17,4,344,2,150,0.0,75.0,75.0,2,194,0.0,103.0,97.0
343.0,17,2,267,1,83,0.0,83.0,83.0,1,184,0.0,184.0,184.0
5005661.0,17,4,849,2,166,0.0,83.0,83.0,2,683,0.0,499.0,341.5
3359939.0,6,132,95172,69,86713,49410.867647058825,1510.0,1256.7101449275362,63,8459,49130.1129032258,1510.0,134.2698412698413
114959041.0,6,34,2488,18,1348,6749601.94117647,139.0,74.88888888888889,16,1140,7649551.466666667,123.0,71.25
837119.0,6,9,1096,6,625,167423.8,287.0,104.16666666666669,3,471,282299.5,331.0,157.0
3184917.0,6,18,1536,9,962,358117.625,315.0,106.88888888888889,9,574,358325.375,78.0,63.77777777777778
137778847.0,6,24,1956,12,1062,12525349.727272728,222.0,88.5,12,894,9795023.090909092,95.0,74.5
30916.0,6,10,2032,5,524,7515.75,252.0,104.8,5,1508,7243.75,1236.0,301.6
14286.0,6,10,2032,5,524,3344.5,252.0,104.8,5,1508,3284.0,1236.0,301.6
114081760.0,6,48,3168,24,1584,4960076.521739131,66.0,66.0,24,1584,4946398.043478261,66.0,66.0
2309.0,17,4,344,2,150,0.0,75.0,75.0,2,194,0.0,103.0,97.0
46624.0,6,14,4740,7,653,7645.333333333333,249.0,93.28571428571428,7,4087,6640.666666666667,1514.0,583.8571428571429
207345.0,6,3,426,2,280,0.0,214.0,140.0,1,146,0.0,146.0,146.0
90228617.0,6,21,1585,10,745,9998387.888888888,95.0,74.5,11,840,9002328.8,95.0,76.36363636363636
24945.0,6,14,4740,7,653,3903.5,249.0,93.28571428571428,7,4087,3954.8333333333335,1514.0,583.8571428571429
306976.0,6,6,412,4,272,102325.33333333331,74.0,68.0,2,140,0.0,74.0,70.0
5610850.0,6,4,270,2,134,0.0,68.0,67.0,2,136,0.0,70.0,68.0
353.0,17,2,160,1,80,0.0,80.0,80.0,1,80,0.0,80.0,80.0
1251279.0,17,6,1230,3,234,625450.0,78.0,78.0,3,996,625437.0,332.0,332.0
22267.0,6,2,145,2,145,0.0,91.0,72.5,0,0,0.0,0.0,0.0
80330.0,6,14,4740,7,653,13257.166666666666,249.0,93.28571428571428,7,4087,13175.5,1514.0,583.8571428571429
320064.0,17,4,1400,4,1400,106688.0,350.0,350.0,0,0,0.0,0.0,0.0
2374.0,17,4,344,2,150,0.0,75.0,75.0,2,194,0.0,103.0,97.0
207473.0,6,3,426,2,280,0.0,214.0,140.0,1,146,0.0,146.0,146.0
235223.0,6,3,373,2,238,0.0,172.0,119.0,1,135,0.0,135.0,135.0
575365.0,6,14,4740,7,653,94451.16666666669,249.0,93.28571428571428,7,4087,94487.5,1514.0,583.8571428571429
135149361.0,17,6,1206,6,1206,27029872.2,201.0,201.0,0,0,0.0,0.0,0.0
9566.0,17,2,582,1,83,0.0,83.0,83.0,1,499,0.0,499.0,499.0
103401.0,17,2,286,2,286,0.0,143.0,143.0,0,0,0.0,0.0,0.0
114571945.0,6,214,24234,107,16950,1078836.5,284.0,158.41121495327104,107,7284,1078837.3113207547,140.0,68.07476635514018
503870.00000000006,6,5,336,2,134,0.0,68.0,67.0,3,202,193317.0,70.0,67.33333333333333
495.0,17,2,508,2,508,0.0,257.0,254.0,0,0,0.0,0.0,0.0
118866476.0,6,36,2580,18,1332,6992145.647058823,123.0,74.0,18,1248,6979424.05882353,123.0,69.33333333333333
112535536.0,6,46,3036,23,1518,5105437.954545454,66.0,66.0,23,1518,5105439.454545454,66.0,66.0
114245230.0,6,48,3168,24,1584,4967183.913043479,66.0,66.0,24,1584,4953012.217391305,66.0,66.0
123757347.0,6,35,2473,18,1348,7279843.94117647,139.0,74.88888888888889,17,1125,7422259.375,123.0,66.17647058823529
144360.0,17,4,344,2,150,0.0,75.0,75.0,2,194,0.0,103.0,97.0
12495.0,6,14,4740,7,653,1931.3333333333333,249.0,93.28571428571428,7,4087,1945.0,1514.0,583.8571428571429
90027287.0,17,28,13364,28,13364,3334343.962962963,501.0,477.2857142857143,0,0,0.0,0.0,0.0
121265.0,6,3,337,2,214,0.0,160.0,107.0,1,123,0.0,123.0,123.0
108105134.0,17,5,1005,5,1005,27026283.5,201.0,201.0,0,0,0.0,0.0,0.0
302474.0,6,2,132,1,66,0.0,66.0,66.0,1,66,0.0,66.0,66.0
97856805.0,6,193,21730,97,6624,1019341.71875,140.0,68.28865979381443,96,15106,1020284.1894736842,284.0,157.35416666666666
309692.0,17,4,704,2,148,0.0,74.0,74.0,2,556,0.0,280.0,278.0
125995.0,6,2,132,1,66,0.0,66.0,66.0,1,66,0.0,66.0,66.0
505051.0,6,5,336,2,134,0.0,68.0,67.0,3,202,193375.0,70.0,67.33333333333333
205755.0,17,2,180,1,90,0.0,90.0,90.0,1,90,0.0,90.0,90.0
151921.0,17,2,414,1,88,0.0,88.0,88.0,1,326,0.0,326.0,326.0
121355440.0,6,227,25690,114,17936,1073941.9469026548,284.0,157.33333333333334,113,7754,1065156.0714285714,140.0,68.61946902654867
9141.0,17,2,582,1,83,0.0,83.0,83.0,1,499,0.0,499.0,499.0
44666.0,6,14,4740,7,653,7323.666666666667,249.0,93.28571428571428,7,4087,6655.333333333333,1514.0,583.8571428571429
147939.0,6,3,337,2,214,0.0,160.0,107.0,1,123,0.0,123.0,123.0
1026882.0,6,11,1134,6,558,205376.4,220.0,93.0,5,576,255103.0,304.0,115.2
96536679.0,17,12,778,6,389,18995010.4,174.0,64.83333333333333,6,389,19000169.4,174.0,64.83333333333333
199507.0,17,4,6056,4,6056,66502.33333333333,1514.0,1514.0,0,0,0.0,0.0,0.0
135129532.0,17,6,1206,6,1206,27025906.4,201.0,201.0,0,0,0.0,0.0,0.0
39469.0,6,10,2032,5,524,9156.75,252.0,104.8,5,1508,4842.25,1236.0,301.6
135134750.0,17,6,1146,6,1146,27026950.0,191.0,191.0,0,0,0.0,0.0,0.0
120001438.0,6,12408,10257665,4549,246606,26385.540457343886,66.0,54.21103539239393,7859,10011059,15265.236446933062,1514.0,1273.83369385418
108106928.0,17,5,955,5,955,27026732.0,191.0,191.0,0,0,0.0,0.0,0.0
135129187.0,17,6,1206,6,1206,27025837.4,201.0,201.0,0,0,0.0,0.0,0.0
1025640.0,6,20,6434,12,1921,93240.0,620.0,160.08333333333334,8,4513,117933.57142857143,1514.0,564.125
208694.0,6,10,1221,6,636,41738.8,298.0,106.0,4,585,68460.0,379.0,146.25
20228.0,6,10,2032,5,524,4834.25,252.0,104.8,5,1508,4769.0,1236.0,301.6
90258065.0,6,12,1832,8,1016,12894009.285714284,188.0,127.0,4,816,30030113.0,204.0,204.0
525430.0,6,3,1604,1,753,0.0,753.0,753.0,2,851,0.0,785.0,425.5
112480006.0,6,45,2970,23,1518,5112727.545454546,66.0,66.0,22,1452,5121742.0,66.0,66.0
90299000.0,6,16,1192,8,596,12893041.714285716,95.0,74.5,8,596,12899522.0,95.0,74.5
121650554.0,6,33,2296,17,1225,7603159.625,139.0,72.05882352941177,16,1071,7429810.933333334,123.0,66.9375
153443.0,17,2,180,1,90,0.0,90.0,90.0,1,90,0.0,90.0,90.0
294144.0,17,2,180,1,90,0.0,90.0,90.0,1,90,0.0,90.0,90.0
239788.0,6,3,337,2,214,0.0,160.0,107.0,1,123,0.0,123.0,123.0
2114.0,17,4,344,2,150,0.0,75.0,75.0,2,194,0.0,103.0,97.0
108104379.0,17,5,1005,5,1005,27026094.75,201.0,201.0,0,0,0.0,0.0,0.0
153457.0,17,2,180,1,90,0.0,90.0,90.0,1,90,0.0,90.0,90.0
90900892.0,17,16,5472,16,5472,6060059.466666667,342.0,342.0,0,0,0.0,0.0,0.0
247084.0,17,2,180,1,90,0.0,90.0,90.0,1,90,0.0,90.0,90.0
90290320.0,6,16,1192,8,596,12891591.57142857,95.0,74.5,8,596,12897275.42857143,95.0,74.5
29512.0,6,14,4740,7,653,4230.5,249.0,93.28571428571428,7,4087,4716.333333333333,1514.0,583.8571428571429
4731.0,17,2,180,1,90,0.0,90.0,90.0,1,90,0.0,90.0,90.0
92886767.0,6,193,21676,96,6558,969240.5157894735,140.0,68.3125,97,15118,967443.8541666666,284.0,155.8556701030928
108110029.0,17,5,955,5,955,27027507.25,191.0,191.0,0,0,0.0,0.0,0.0
21628.0,6,10,2032,5,524,5207.25,252.0,104.8,5,1508,5130.5,1236.0,301.6
219702.0,6,3,426,2,280,0.0,214.0,140.0,1,146,0.0,146.0,146.0
304314.0,6,6,412,4,272,101438.0,74.0,68.0,2,140,0.0,74.0,70.0
742.0,17,4,438,2,148,0.0,74.0,74.0,2,290,0.0,147.0,145.0
20086.0,17,2,582,1,83,0.0,83.0,83.0,1,499,0.0,499.0,499.0
1308736.0,6,4,264,2,132,0.0,66.0,66.0,2,132,0.0,66.0,66.0
107474.0,17,2,762,2,762,0.0,381.0,381.0,0,0,0.0,0.0,0.0
205949.0,17,2,180,1,90,0.0,90.0,90.0,1,90,0.0,90.0,90.0
123706.0,6,10,2032,5,524,30702.25,252.0,104.8,5,1508,30033.5,1236.0,301.6
171601.0,17,2,180,1,90,0.0,90.0,90.0,1,90,0.0,90.0,90.0
102515442.0,17,14,864,7,432,17001047.333333332,174.0,61.71428571428572,7,432,17000165.5,174.0,61.71428571428572
110984784.0,6,32,2220,16,1149,7384595.266666667,123.0,71.8125,16,1071,7384589.733333333,123.0,66.9375
44497.0,6,14,4740,7,653,7033.5,249.0,93.28571428571428,7,4087,6489.333333333333,1514.0,583.8571428571429
321370.0,17,4,1400,4,1400,107123.33333333331,350.0,350.0,0,0,0.0,0.0,0.0
90066652.0,17,28,13364,28,13364,3335801.925925926,501.0,477.2857142857143,0,0,0.0,0.0,0.0
872423.0,6,12,2710,7,743,145403.83333333334,339.0,106.14285714285714,5,1967,149988.75,1514.0,393.4
228274.0,17,2,180,1,90,0.0,90.0,90.0,1,90,0.0,90.0,90.0
103416.0,17,2,286,2,286,0.0,143.0,143.0,0,0,0.0,0.0,0.0
216452.0,6,3,426,2,280,0.0,214.0,140.0,1,146,0.0,146.0,146.0
205371.0,17,2,180,1,90,0.0,90.0,90.0,1,90,0.0,90.0,90.0
90041416.0,17,28,13364,28,13364,3334867.25925926,501.0,477.2857142857143,0,0,0.0,0.0,0.0
4463.0,17,2,626,1,72,0.0,72.0,72.0,1,554,0.0,554.0,554.0
20617.0,6,14,4740,7,653,3267.1666666666665,249.0,93.28571428571428,7,4087,3305.5,1514.0,583.8571428571429
6076179.0,6,5,336,2,134,0.0,68.0,67.0,3,202,1525076.0,70.0,67.33333333333333
6263.0,17,4,438,2,148,0.0,74.0,74.0,2,290,0.0,147.0,145.0
237921.0,17,2,180,1,90,0.0,90.0,90.0,1,90,0.0,90.0,90.0
96161.0,17,2,762,2,762,0.0,381.0,381.0,0,0,0.0,0.0,0.0
115025001.0,6,48,3168,24,1584,5001087.0,66.0,66.0,24,1584,4986766.521739131,66.0,66.0
224676.0,17,2,180,1,90,0.0,90.0,90.0,1,90,0.0,90.0,90.0
96578926.0,6,385,50830,193,37936,503015.2395833333,406.0,196.559585492228,192,12894,504426.6910994764,140.0,67.15625
90283603.0,6,15,1097,8,596,12897657.57142857,95.0,74.5,7,501,14998760.0,95.0,71.57142857142857
108105728.0,17,5,1005,5,1005,27026432.0,201.0,201.0,0,0,0.0,0.0,0.0
2423.0,17,4,344,2,150,0.0,75.0,75.0,2,194,0.0,103.0,97.0
232892.0,6,3,337,2,214,0.0,160.0,107.0,1,123,0.0,123.0,123.0
308605.0,6,6,412,4,272,102868.33333333331,74.0,68.0,2,140,0.0,74.0,70.0
143942.0,17,2,180,1,90,0.0,90.0,90.0,1,90,0.0,90.0,90.0
44141.0,6,14,4740,7,653,5776.333333333333,249.0,93.28571428571428,7,4087,7151.833333333333,1514.0,583.8571428571429
135145627.0,17,6,1146,6,1146,27029125.4,191.0,191.0,0,0,0.0,0.0,0.0
42593.0,6,14,4740,7,653,4954.833333333333,249.0,93.28571428571428,7,4087,6525.166666666667,1514.0,583.8571428571429
216336.0,17,2,180,1,90,0.0,90.0,90.0,1,90,0.0,90.0,90.0
142647.0,6,13,1386,7,789,23774.5,253.0,112.71428571428572,6,597,26824.8,259.0,99.5
108108735.0,17,5,1005,5,1005,27027183.75,201.0,201.0,0,0,0.0,0.0,0.0
135136321.0,17,6,1206,6,1206,27027264.2,201.0,201.0,0,0,0.0,0.0,0.0
27616322.0,17,5,1710,5,1710,6904080.5,342.0,342.0,0,0,0.0,0.0,0.0
39054.0,6,14,4740,7,653,6205.833333333333,249.0,93.28571428571428,7,4087,6301.333333333333,1514.0,583.8571428571429
90047132.0,6,470,92944,239,77316,377444.3025210084,1514.0,323.4979079497908,231,15628,390572.9826086956,214.0,67.65367965367966
350.0,17,2,267,1,83,0.0,83.0,83.0,1,184,0.0,184.0,184.0
321195.0,6,3,1604,2,851,0.0,785.0,425.5,1,753,0.0,753.0,753.0
108105260.0,17,5,1005,5,1005,27026315.0,201.0,201.0,0,0,0.0,0.0,0.0
108134102.0,17,5,1005,5,1005,27033525.5,201.0,201.0,0,0,0.0,0.0,0.0
206504.0,6,3,426,2,280,0.0,214.0,140.0,1,146,0.0,146.0,146.0
108111765.0,17,5,955,5,955,27027941.25,191.0,191.0,0,0,0.0,0.0,0.0
90670952.0,6,21,1585,10,745,10074550.222222222,95.0,74.5,11,840,9042553.2,95.0,76.36363636363636
2795930.0,6,2,132,1,66,0.0,66.0,66.0,1,66,0.0,66.0,66.0
109522254.0,6,30,2122,15,1105,7823018.142857143,139.0,73.66666666666667,15,1017,7807576.214285715,123.0,67.8
250376.0,6,3,337,2,214,0.0,160.0,107.0,1,123,0.0,123.0,123.0
103993.0,17,2,700,2,700,0.0,350.0,350.0,0,0,0.0,0.0,0.0
47855.0,6,14,4740,7,653,7462.333333333333,249.0,93.28571428571428,7,4087,7775.666666666667,1514.0,583.8571428571429
107026.0,17,2,286,2,286,0.0,143.0,143.0,0,0,0.0,0.0,0.0
10450604.0,6,7,478,4,272,3436552.333333333,74.0,68.0,3,206,5154714.5,74.0,68.66666666666667
120125108.0,6,14,2224,9,1204,15015638.5,188.0,133.77777777777777,5,1020,22524235.75,204.0,204.0
62961.0,6,14,4740,7,653,6461.5,249.0,93.28571428571428,7,4087,10355.166666666666,1514.0,583.8571428571429
96090640.0,17,14,1126,7,563,16000136.5,174.0,80.42857142857143,7,563,16000758.166666666,174.0,80.42857142857143
90258165.0,6,13,2036,8,1016,12894023.57142857,188.0,127.0,5,1020,22522920.0,204.0,204.0
23567656.0,6,26,7627,14,3735,203923.0769230769,1514.0,266.7857142857143,12,3892,2123809.636363636,1514.0,324.3333333333333
919.0,17,5,550,5,550,229.75,110.0,110.0,0,0,0.0,0.0,0.0
5621605.0,6,5,336,2,134,0.0,68.0,67.0,3,202,1522798.5,70.0,67.33333333333333
20764.0,6,11,1133,6,602,3994.2,264.0,100.33333333333331,5,531,4385.25,259.0,106.2
2751440.0,6,2,134,1,68,0.0,68.0,68.0,1,66,0.0,66.0,66.0
100856.0,17,2,700,2,700,0.0,350.0,350.0,0,0,0.0,0.0,0.0
9529.0,17,2,582,1,83,0.0,83.0,83.0,1,499,0.0,499.0,499.0
325853.0,17,4,622,4,622,108617.66666666669,163.0,155.5,0,0,0.0,0.0,0.0
120064.0,17,2,180,1,70,0.0,70.0,70.0,1,110,0.0,110.0,110.0
42906.0,6,12,1320,6,723,7407.0,253.0,120.5,6,597,7687.2,259.0,99.5
840542.0,6,9,1118,6,586,168108.4,248.0,97.66666666666669,3,532,282530.0,392.0,177.33333333333334
110712.0,17,4,1400,4,1400,36904.0,350.0,350.0,0,0,0.0,0.0,0.0
226873.0,6,13,1386,7,789,37812.16666666666,253.0,112.71428571428572,6,597,43057.6,259.0,99.5
205984.0,6,3,426,2,280,0.0,214.0,140.0,1,146,0.0,146.0,146.0
53766.0,6,14,4740,7,653,8329.166666666666,249.0,93.28571428571428,7,4087,8386.333333333334,1514.0,583.8571428571429
307135.0,6,6,412,4,272,102378.33333333331,74.0,68.0,2,140,0.0,74.0,70.0
103299.0,17,2,286,2,286,0.0,143.0,143.0,0,0,0.0,0.0,0.0
85800.0,6,12,1427,6,796,16358.8,271.0,132.66666666666666,6,631,15780.6,293.0,105.16666666666669
63590.99999999999,6,14,4740,7,653,10413.5,249.0,93.28571428571428,7,4087,9775.5,1514.0,583.8571428571429
489965.0,6,3,1604,2,851,0.0,785.0,425.5,1,753,0.0,753.0,753.0
2006050.0,6,24,6999,13,2047,167170.83333333334,575.0,157.46153846153845,11,4952,170008.0,1510.0,450.1818181818182
121244.0,6,3,337,2,214,0.0,160.0,107.0,1,123,0.0,123.0,123.0
135133000.0,17,6,1146,6,1146,27026600.0,191.0,191.0,0,0,0.0,0.0,0.0
121343389.0,6,241,27222,121,19006,1011194.9083333332,284.0,157.07438016528926,120,8216,1002871.6890756304,140.0,68.46666666666667
146081.0,6,3,337,2,214,0.0,160.0,107.0,1,123,0.0,123.0,123.0
308172.0,6,6,412,4,272,102724.0,74.0,68.0,2,140,0.0,74.0,70.0
5627433.0,6,5,336,2,134,0.0,68.0,67.0,3,202,1420121.5,70.0,67.33333333333333
40375.0,6,14,4740,7,653,6304.833333333333,249.0,93.28571428571428,7,4087,6265.166666666667,1514.0,583.8571428571429
3445246.0,6,7,923,4,753,1076133.3333333333,571.0,188.25,3,170,1614529.5,62.0,56.66666666666666
2172689.0,6,19,6869,10,1501,241409.88888888888,408.0,150.1,9,5368,228315.25,1514.0,596.4444444444445
120537702.0,17,14,1126,7,563,16833516.166666668,174.0,80.42857142857143,7,563,16834195.0,174.0,80.42857142857143
216651.0,6,3,426,2,280,0.0,214.0,140.0,1,146,0.0,146.0,146.0
205748.0,6,3,426,2,280,0.0,214.0,140.0,1,146,0.0,146.0,146.0
29127.0,6,10,2032,5,524,5221.0,252.0,104.8,5,1508,7010.0,1236.0,301.6
298615.0,6,6,412,4,272,99538.33333333331,74.0,68.0,2,140,0.0,74.0,70.0
14637667.0,6,21,1661,11,1029,1432750.9,315.0,93.54545454545456,10,632,1591926.6666666667,78.0,63.2
147369.0,6,3,337,2,214,0.0,160.0,107.0,1,123,0.0,123.0,123.0
256377.00000000003,6,3,337,2,214,0.0,160.0,107.0,1,123,0.0,123.0,123.0
207051.0,6,3,426,2,280,0.0,214.0,140.0,1,146,0.0,146.0,146.0
45427.0,6,14,4740,7,653,7397.333333333333,249.0,93.28571428571428,7,4087,4481.833333333333,1514.0,583.8571428571429
843274.0,6,9,1118,6,586,168654.8,248.0,97.66666666666669,3,532,283500.0,392.0,177.33333333333334
2028.0,17,4,344,2,150,0.0,75.0,75.0,2,194,0.0,103.0,97.0
120126931.0,6,13,2020,9,1204,15015866.375,188.0,133.77777777777777,4,816,30029281.666666668,204.0,204.0
54939.0,6,14,4740,7,653,8542.833333333334,249.0,93.28571428571428,7,4087,8768.333333333334,1514.0,583.8571428571429
228281.0,17,2,180,1,90,0.0,90.0,90.0,1,90,0.0,90.0,90.0
2245.0,17,4,344,2,150,0.0,75.0,75.0,2,194,0.0,103.0,97.0
2796996.0,6,2,132,1,66,0.0,66.0,66.0,1,66,0.0,66.0,66.0
91139117.0,6,26,2019,11,840,9089750.5,95.0,76.36363636363636,15,1179,6495271.857142857,95.0,78.6
217774.0,6,3,426,2,280,0.0,214.0,140.0,1,146,0.0,146.0,146.0
102706.0,17,2,762,2,762,0.0,381.0,381.0,0,0,0.0,0.0,0.0
14662.0,6,14,4740,7,653,2334.5,249.0,93.28571428571428,7,4087,2218.833333333333,1514.0,583.8571428571429
41104.0,6,14,4740,7,653,4632.333333333333,249.0,93.28571428571428,7,4087,6713.0,1514.0,583.8571428571429
209584.0,17,2,180,1,90,0.0,90.0,90.0,1,90,0.0,90.0,90.0
44202.0,6,14,4740,7,653,7216.0,249.0,93.28571428571428,7,4087,7015.666666666667,1514.0,583.8571428571429
162417.0,17,2,180,1,90,0.0,90.0,90.0,1,90,0.0,90.0,90.0
47371.0,6,14,4740,7,653,7724.833333333333,249.0,93.28571428571428,7,4087,7583.0,1514.0,583.8571428571429
90003299.0,17,28,13364,28,13364,3333455.5185185187,501.0,477.2857142857143,0,0,0.0,0.0,0.0
117390307.0,6,30,1974,15,1026,8369591.571428572,123.0,68.4,15,948,8369591.428571428,123.0,63.2
71300.0,6,14,4740,7,653,11575.833333333334,249.0,93.28571428571428,7,4087,11705.166666666666,1514.0,583.8571428571429
213570.0,17,4,1400,4,1400,71190.0,350.0,350.0,0,0,0.0,0.0,0.0
13999900.0,17,6,2052,6,2052,2799980.0,342.0,342.0,0,0,0.0,0.0,0.0
216543.0,17,2,180,1,90,0.0,90.0,90.0,1,90,0.0,90.0,90.0
90254426.0,6,12,1832,8,1016,12893489.42857143,188.0,127.0,4,816,30030777.33333333,204.0,204.0
120008695.0,6,26,1978,14,1084,9230769.0,95.0,77.42857142857143,12,894,10886201.181818182,95.0,74.5
37666.0,6,10,1065,5,534,9090.5,262.0,106.8,5,531,7934.5,259.0,106.2
90319651.0,6,27,2073,15,1138,6447385.214285715,95.0,75.86666666666666,12,935,8184715.181818182,95.0,77.91666666666667
0.0,6,1,66,1,66,0.0,66.0,66.0,0,0,0.0,0.0,0.0
207804.0,6,3,426,2,280,0.0,214.0,140.0,1,146,0.0,146.0,146.0
233475.0,6,3,337,2,214,0.0,160.0,107.0,1,123,0.0,123.0,123.0
144114.0,17,2,180,1,90,0.0,90.0,90.0,1,90,0.0,90.0,90.0
26368617.0,17,5,1718,4,1368,860148.6666666666,342.0,342.0,1,350,0.0,350.0,350.0
857189.0,6,9,1268,6,797,171437.8,459.0,132.83333333333334,3,471,290493.5,331.0,157.0
2589476.0,6,2,132,1,66,0.0,66.0,66.0,1,66,0.0,66.0,66.0
51167.0,17,2,180,1,90,0.0,90.0,90.0,1,90,0.0,90.0,90.0
869473.0,6,10,1335,6,798,173894.6,460.0,133.0,4,537,197934.3333333333,331.0,134.25
50824.0,17,2,180,1,90,0.0,90.0,90.0,1,90,0.0,90.0,90.0
105586.0,17,2,700,2,700,0.0,350.0,350.0,0,0,0.0,0.0,0.0
108728408.0,6,36,2734,19,1471,6040467.111111111,139.0,77.42105263157895,17,1263,6781995.9375,123.0,74.29411764705883
196949.0,17,2,180,1,90,0.0,90.0,90.0,1,90,0.0,90.0,90.0
90048380.0,17,27,12943,27,12943,3463399.230769231,501.0,479.3703703703704,0,0,0.0,0.0,0.0
312994.0,6,6,412,4,272,104331.33333333331,74.0,68.0,2,140,0.0,74.0,70.0
2602567.0,6,2,132,1,66,0.0,66.0,66.0,1,66,0.0,66.0,66.0
123839963.0,6,49,3234,25,1650,5159998.458333333,66.0,66.0,24,1584,4975067.608695652,66.0,66.0
42908.0,6,10,2032,5,524,10501.75,252.0,104.8,5,1508,10149.5,1236.0,301.6
1900759.0,6,23,6507,12,1529,172796.27272727274,357.0,127.41666666666669,11,4978,159362.4,1510.0,452.54545454545456
90037771.0,17,27,12943,27,12943,3462991.1923076925,501.0,479.3703703703704,0,0,0.0,0.0,0.0
2901457.0,6,5,718,2,280,0.0,214.0,140.0,3,438,1346877.5,146.0,146.0
2432.0,17,4,344,2,150,0.0,75.0,75.0,2,194,0.0,103.0,97.0
135128043.0,17,6,1146,6,1146,27025608.6,191.0,191.0,0,0,0.0,0.0,0.0
320320.0,6,6,412,4,272,106773.33333333331,74.0,68.0,2,140,0.0,74.0,70.0
282224.0,6,10,1221,6,636,56444.8,298.0,106.0,4,585,88540.33333333333,379.0,146.25
135136697.0,17,6,1206,6,1206,27027339.4,201.0,201.0,0,0,0.0,0.0,0.0
2367.0,17,4,344,2,150,0.0,75.0,75.0,2,194,0.0,103.0,97.0
4360.0,17,2,180,1,90,0.0,90.0,90.0,1,90,0.0,90.0,90.0
120053541.0,17,29,13785,29,13785,4287626.464285715,501.0,475.3448275862069,0,0,0.0,0.0,0.0
56334.0,6,14,4740,7,653,8955.0,249.0,93.28571428571428,7,4087,7806.833333333333,1514.0,583.8571428571429
90686091.0,6,15,2302,9,1204,11316391.375,188.0,133.77777777777777,6,1098,18099336.8,204.0,183.0
32152.0,6,10,2032,5,524,7310.75,252.0,104.8,5,1508,7489.5,1236.0,301.6
297676.0,6,6,412,4,272,99225.33333333331,74.0,68.0,2,140,0.0,74.0,70.0
89239254.0,17,14,4788,14,4788,6864558.0,342.0,342.0,0,0,0.0,0.0,0.0
23154.0,17,2,239,1,82,0.0,82.0,82.0,1,157,0.0,157.0,157.0
33594.0,6,14,4740,7,653,5325.333333333333,249.0,93.28571428571428,7,4087,5205.333333333333,1514.0,583.8571428571429
135130795.0,17,6,1146,6,1146,27026159.0,191.0,191.0,0,0,0.0,0.0,0.0
48835.0,6,14,4740,7,653,8030.833333333333,249.0,93.28571428571428,7,4087,6453.0,1514.0,583.8571428571429
242895.0,6,3,373,2,238,0.0,172.0,119.0,1,135,0.0,135.0,135.0
32682851.0,6,5,336,2,134,0.0,68.0,67.0,3,202,16273826.5,70.0,67.33333333333333
68796.0,6,14,4740,7,653,9307.333333333334,249.0,93.28571428571428,7,4087,10808.166666666666,1514.0,583.8571428571429
90254456.0,6,14,2240,8,1016,12893493.714285716,188.0,127.0,6,1224,18018476.8,204.0,204.0
135231.0,6,15,4806,8,719,18375.42857142857,249.0,89.875,7,4087,21888.0,1514.0,583.8571428571429
0.0,17,1,44,1,44,0.0,44.0,44.0,0,0,0.0,0.0,0.0
155373.0,6,3,337,2,214,0.0,160.0,107.0,1,123,0.0,123.0,123.0
249342.0,17,4,6056,4,6056,83114.0,1514.0,1514.0,0,0,0.0,0.0,0.0
103790.0,17,2,286,2,286,0.0,143.0,143.0,0,0,0.0,0.0,0.0
16785.0,17,2,180,1,90,0.0,90.0,90.0,1,90,0.0,90.0,90.0
45793.0,6,10,2032,5,524,11242.0,252.0,104.8,5,1508,10333.5,1236.0,301.6
116173917.0,6,31,2160,16,1071,7744927.8,123.0,66.9375,15,1089,7733312.0,123.0,72.6
90258029.0,6,12,1832,8,1016,12894004.142857144,188.0,127.0,4,816,30031072.33333333,204.0,204.0
22699.0,6,14,4740,7,653,3660.3333333333335,249.0,93.28571428571428,7,4087,3639.3333333333335,1514.0,583.8571428571429
52397.0,6,14,4740,7,653,7930.666666666667,249.0,93.28571428571428,7,4087,8592.166666666666,1514.0,583.8571428571429
320308.0,17,4,1400,4,1400,106769.33333333331,350.0,350.0,0,0,0.0,0.0,0.0
38913.0,6,10,2032,5,524,9481.0,252.0,104.8,5,1508,9023.25,1236.0,301.6
284774.0,17,2,363,1,79,0.0,79.0,79.0,1,284,0.0,284.0,284.0
39324.0,6,10,2032,5,524,9260.5,252.0,104.8,5,1508,6732.75,1236.0,301.6
114324.0,6,14,4740,7,653,18898.666666666668,249.0,93.28571428571428,7,4087,17432.666666666668,1514.0,583.8571428571429
115525158.0,17,14,864,7,432,19167682.0,174.0,61.71428571428572,7,432,19166828.166666668,174.0,61.71428571428572
3564.0,17,2,346,1,78,0.0,78.0,78.0,1,268,0.0,268.0,268.0
120138411.0,6,976,164786,490,132192,245241.5746421268,1514.0,269.7795918367347,486,32594,247264.0515463917,214.0,67.06584362139918
120052607.0,17,29,13785,29,13785,4287593.107142857,501.0,475.3448275862069,0,0,0.0,0.0,0.0
90255751.0,6,13,2036,8,1016,12893678.714285716,188.0,127.0,5,1020,22522722.5,204.0,204.0
46079.0,6,14,4740,7,653,7498.0,249.0,93.28571428571428,7,4087,7303.333333333333,1514.0,583.8571428571429
233235.0,6,3,337,2,214,0.0,160.0,107.0,1,123,0.0,123.0,123.0
21062240.0,17,3,1034,2,684,0.0,342.0,342.0,1,350,0.0,350.0,350.0
147925.0,17,2,180,1,90,0.0,90.0,90.0,1,90,0.0,90.0,90.0
13987.0,6,11,2098,6,590,2797.4,252.0,98.33333333333331,5,1508,3025.25,1236.0,301.6
2040.0,17,4,344,2,150,0.0,75.0,75.0,2,194,0.0,103.0,97.0
217735.0,6,3,426,2,280,0.0,214.0,140.0,1,146,0.0,146.0,146.0
90044088.0,17,28,13364,28,13364,3334966.222222222,501.0,477.2857142857143,0,0,0.0,0.0,0.0
91899561.0,6,29,2052,15,1089,6564254.357142857,123.0,72.6,14,963,6284513.923076923,123.0,68.78571428571429
29614.0,6,10,2032,5,524,7107.75,252.0,104.8,5,1508,7170.75,1236.0,301.6
135137124.0,17,6,1206,6,1206,27027424.8,201.0,201.0,0,0,0.0,0.0,0.0
251290.0,6,3,373,2,238,0.0,172.0,119.0,1,135,0.0,135.0,135.0
316423.0,17,4,1400,4,1400,105474.33333333331,350.0,350.0,0,0,0.0,0.0,0.0
135132895.0,17,6,1146,6,1146,27026579.0,191.0,191.0,0,0,0.0,0.0,0.0
318.0,17,2,168,1,76,0.0,76.0,76.0,1,92,0.0,92.0,92.0
120057349.0,6,564,87288,281,18990,428776.2464285714,214.0,67.58007117437722,283,68298,424924.7056737589,1514.0,241.3356890459364
61620.0,6,14,4740,7,653,9914.333333333334,249.0,93.28571428571428,7,4087,9391.833333333334,1514.0,583.8571428571429
575944.0,6,4,508,2,238,0.0,172.0,119.0,2,270,0.0,135.0,135.0
117200371.0,6,48,3168,24,1584,5095668.304347826,66.0,66.0,24,1584,5083817.478260869,66.0,66.0
10467861.0,6,7,478,4,272,3443760.0,74.0,68.0,3,206,5165544.0,74.0,68.66666666666667
217885.0,6,3,426,2,280,0.0,214.0,140.0,1,146,0.0,146.0,146.0
25791.0,6,10,2032,5,524,6187.5,252.0,104.8,5,1508,6221.75,1236.0,301.6
19949.0,6,14,4740,7,653,3162.0,249.0,93.28571428571428,7,4087,3097.1666666666665,1514.0,583.8571428571429
29189.0,6,10,2032,5,524,7035.0,252.0,104.8,5,1508,6708.75,1236.0,301.6
135135960.0,17,6,1206,6,1206,27027192.0,201.0,201.0,0,0,0.0,0.0,0.0
2327.0,17,4,344,2,150,0.0,75.0,75.0,2,194,0.0,103.0,97.0
39272.0,6,20,8486,11,888,3927.2,220.0,80.72727272727273,9,7598,4504.625,1514.0,844.2222222222222
2910932.0,6,2,132,1,66,0.0,66.0,66.0,1,66,0.0,66.0,66.0
29733.0,6,14,4740,7,653,4497.666666666667,249.0,93.28571428571428,7,4087,4823.833333333333,1514.0,583.8571428571429
112493941.0,6,31,2097,16,1071,7499596.066666666,123.0,66.9375,15,1026,8019796.214285715,123.0,68.4
135136357.0,17,6,1146,6,1146,27027271.4,191.0,191.0,0,0,0.0,0.0,0.0
65881.0,17,2,180,1,90,0.0,90.0,90.0,1,90,0.0,90.0,90.0
119337273.0,17,34,16284,34,16284,3616281.0,501.0,478.9411764705882,0,0,0.0,0.0,0.0
35177.0,6,10,2032,5,524,8092.5,252.0,104.8,5,1508,8010.5,1236.0,301.6
39175.0,6,14,4740,7,653,6086.166666666667,249.0,93.28571428571428,7,4087,6295.666666666667,1514.0,583.8571428571429
1049753.0,6,13,1394,7,797,174958.83333333334,253.0,113.85714285714286,6,597,207788.2,259.0,99.5
51252.0,6,13,1479,7,882,8382.333333333334,291.0,126.0,6,597,8478.0,259.0,99.5
6991509.0,6,197,156538,109,146176,64736.194444444445,1510.0,1341.0642201834862,88,10362,75936.41379310345,1510.0,117.75
93757295.0,6,39,2574,20,1320,4923227.0,66.0,66.0,19,1254,5105444.388888889,66.0,66.0
61984.0,6,14,4740,7,653,10181.333333333334,249.0,93.28571428571428,7,4087,8381.0,1514.0,583.8571428571429
48840.0,6,14,4740,7,653,7149.333333333333,249.0,93.28571428571428,7,4087,7999.666666666667,1514.0,583.8571428571429
149753257.0,6,18,2622,11,1458,14975325.7,188.0,132.54545454545453,7,1164,19975306.83333333,204.0,166.28571428571428
101005745.0,17,13,1083,7,563,16834290.833333332,174.0,80.42857142857143,6,520,16954024.0,174.0,86.66666666666667
98724190.0,17,14,1126,7,563,16427209.333333334,174.0,80.42857142857143,7,563,16362075.333333334,174.0,80.42857142857143
108104087.0,17,5,1005,5,1005,27026021.75,201.0,201.0,0,0,0.0,0.0,0.0
2591324.0,6,51,23848,26,19851,103652.96,1514.0,763.5,25,3997,98926.45833333331,1514.0,159.88
3486414.0,6,163,126192,88,116940,40073.72413793104,1510.0,1328.8636363636365,75,9252,43061.98648648649,1510.0,123.36
3015398.0,6,11,2106,6,598,602825.6,252.0,99.66666666666669,5,1508,4069.5,1236.0,301.6
29876.0,6,10,2032,5,524,6942.25,252.0,104.8,5,1508,6896.75,1236.0,301.6
323954.0,6,6,412,4,272,107984.66666666669,74.0,68.0,2,140,0.0,74.0,70.0
303716.0,6,2,132,1,66,0.0,66.0,66.0,1,66,0.0,66.0,66.0
375.0,17,2,762,2,762,0.0,381.0,381.0,0,0,0.0,0.0,0.0
108102788.0,17,5,955,5,955,27025697.0,191.0,191.0,0,0,0.0,0.0,0.0
232742.0,6,3,337,2,214,0.0,160.0,107.0,1,123,0.0,123.0,123.0
90024932.0,17,28,13364,28,13364,3334256.7407407407,501.0,477.2857142857143,0,0,0.0,0.0,0.0
76589.0,6,14,4740,7,653,12642.5,249.0,93.28571428571428,7,4087,12219.333333333334,1514.0,583.8571428571429
120051570.0,17,29,13785,29,13785,4287556.071428572,501.0,475.3448275862069,0,0,0.0,0.0,0.0
27378382.0,17,5,1710,5,1710,6844595.5,342.0,342.0,0,0,0.0,0.0,0.0
3011203.0,6,12,2172,7,664,501485.0,252.0,94.85714285714286,5,1508,3251.5,1236.0,301.6
354308.0,6,4,508,2,238,0.0,172.0,119.0,2,270,0.0,135.0,135.0
228379.0,17,2,180,1,90,0.0,90.0,90.0,1,90,0.0,90.0,90.0
90027254.0,17,28,13364,28,13364,3334342.7407407407,501.0,477.2857142857143,0,0,0.0,0.0,0.0
135122288.0,17,6,1146,6,1146,27024457.6,191.0,191.0,0,0,0.0,0.0,0.0
120000221.0,6,20,1531,11,840,12000022.1,95.0,76.36363636363636,9,691,11339571.625,95.0,76.77777777777777
153430.0,17,2,180,1,90,0.0,90.0,90.0,1,90,0.0,90.0,90.0
2398.0,17,4,344,2,150,0.0,75.0,75.0,2,194,0.0,103.0,97.0
202602.0,17,8,12112,8,12112,28943.14285714286,1514.0,1514.0,0,0,0.0,0.0,0.0
228272.0,17,2,180,1,90,0.0,90.0,90.0,1,90,0.0,90.0,90.0
99554156.0,17,12,778,6,389,19893539.6,174.0,64.83333333333333,6,389,19879051.4,174.0,64.83333333333333
340.0,17,2,166,1,83,0.0,83.0,83.0,1,83,0.0,83.0,83.0
97721838.0,6,203,22930,102,6954,967542.9504950496,140.0,68.17647058823529,101,15976,974930.84,284.0,158.17821782178217
312634.0,17,4,1400,4,1400,104211.33333333331,350.0,350.0,0,0,0.0,0.0,0.0
309268.0,6,6,412,4,272,103089.33333333331,74.0,68.0,2,140,0.0,74.0,70.0
90752057.0,6,17,1287,9,691,11338044.875,95.0,76.77777777777777,8,596,12963030.285714284,95.0,74.5
177504.0,17,2,180,1,90,0.0,90.0,90.0,1,90,0.0,90.0,90.0
99632.0,17,2,762,2,762,0.0,381.0,381.0,0,0,0.0,0.0,0.0
90045732.0,17,27,12943,27,12943,3463297.3846153845,501.0,479.3703703703704,0,0,0.0,0.0,0.0
14649261.0,6,20,1607,10,975,1592900.4444444445,315.0,97.5,10,632,1592877.5555555555,78.0,63.2
130077167.0,17,14,995,7,432,18500202.33333333,174.0,61.71428571428572,7,563,19998139.166666668,174.0,80.42857142857143
338.0,17,2,166,1,75,0.0,75.0,75.0,1,91,0.0,91.0,91.0
206497.0,17,2,762,2,762,0.0,381.0,381.0,0,0,0.0,0.0,0.0
2405.0,17,4,344,2,150,0.0,75.0,75.0,2,194,0.0,103.0,97.0
333.0,17,2,160,1,80,0.0,80.0,80.0,1,80,0.0,80.0,80.0
31848.0,6,14,4740,7,653,4711.0,249.0,93.28571428571428,7,4087,4762.166666666667,1514.0,583.8571428571429
34144.0,6,10,2032,5,524,8322.75,252.0,104.8,5,1508,7945.0,1236.0,301.6
591018.0,17,3,551,2,156,0.0,78.0,78.0,1,395,0.0,395.0,395.0
316511.0,17,4,1400,4,1400,105503.66666666669,350.0,350.0,0,0,0.0,0.0,0.0
197986.0,17,4,6056,4,6056,65995.33333333333,1514.0,1514.0,0,0,0.0,0.0,0.0
47710329.0,6,7,1872,3,886,22601764.0,752.0,295.3333333333333,4,986,15046405.666666666,784.0,246.5
295426.0,6,10,1221,6,636,59085.2,298.0,106.0,4,585,93085.66666666669,379.0,146.25
216561.0,6,3,426,2,280,0.0,214.0,140.0,1,146,0.0,146.0,146.0
112341495.0,6,32,2358,17,1272,7007838.6875,123.0,74.82352941176471,15,1086,8008960.071428572,123.0,72.4
110399945.0,6,34,2334,17,1209,6886485.3125,123.0,71.11764705882354,17,1125,6886494.375,123.0,66.17647058823529
135137713.0,17,6,1206,6,1206,27027542.6,201.0,201.0,0,0,0.0,0.0,0.0
36998.0,6,11,2098,6,590,5526.2,252.0,98.33333333333331,5,1508,7082.75,1236.0,301.6
8316.0,17,2,762,2,762,0.0,381.0,381.0,0,0,0.0,0.0,0.0
121411.0,6,3,337,2,214,0.0,160.0,107.0,1,123,0.0,123.0,123.0
50851.0,6,14,4740,7,653,8246.0,249.0,93.28571428571428,7,4087,7578.833333333333,1514.0,583.8571428571429
111802615.0,6,35,2542,18,1348,6563929.764705882,139.0,74.88888888888889,17,1194,6974171.125,123.0,70.23529411764706
236034.0,6,3,337,2,214,0.0,160.0,107.0,1,123,0.0,123.0,123.0
212803.0,6,10,1221,6,636,42560.6,298.0,106.0,4,585,69710.33333333333,379.0,146.25
838.0,17,5,550,5,550,209.5,110.0,110.0,0,0,0.0,0.0,0.0
105999.0,17,2,700,2,700,0.0,350.0,350.0,0,0,0.0,0.0,0.0
62410.0,6,14,4740,7,653,9156.666666666666,249.0,93.28571428571428,7,4087,10232.0,1514.0,583.8571428571429
57536.0,6,12,1320,6,723,10623.6,253.0,120.5,6,597,9002.8,259.0,99.5
2798540.0,6,2,132,1,66,0.0,66.0,66.0,1,66,0.0,66.0,66.0
354.0,17,2,250,1,93,0.0,93.0,93.0,1,157,0.0,157.0,157.0
92113799.0,6,38,2508,19,1254,5105434.833333333,66.0,66.0,19,1254,5105438.277777778,66.0,66.0
119799597.0,6,25,1883,12,894,10890872.454545457,95.0,74.5,13,989,9964434.0,95.0,76.07692307692308
2716.0,17,4,344,2,150,0.0,75.0,75.0,2,194,0.0,103.0,97.0
11829.0,6,13,1459,7,862,1811.1666666666667,271.0,123.14285714285714,6,597,2099.6,259.0,99.5
26053.0,6,10,2032,5,524,5811.0,252.0,104.8,5,1508,6129.25,1236.0,301.6
336.0,17,2,168,1,76,0.0,76.0,76.0,1,92,0.0,92.0,92.0
115710149.0,6,51,4926,32,2865,3732585.4516129033,123.0,89.53125,19,2061,6416255.111111111,123.0,108.47368421052632
108106476.0,17,5,955,5,955,27026619.0,191.0,191.0,0,0,0.0,0.0,0.0
105074403.0,6,44,2904,22,1452,5003543.0,66.0,66.0,22,1452,4988649.238095238,66.0,66.0
146150.0,6,3,337,2,214,0.0,160.0,107.0,1,123,0.0,123.0,123.0
27765.0,6,14,4740,7,653,4366.166666666667,249.0,93.28571428571428,7,4087,4469.5,1514.0,583.8571428571429
16760.0,6,14,4740,7,653,2681.333333333333,249.0,93.28571428571428,7,4087,2652.1666666666665,1514.0,583.8571428571429
94591198.0,6,40,2640,20,1320,4978484.105263158,66.0,66.0,20,1320,4957784.947368421,66.0,66.0
314240.0,17,4,1400,4,1400,104746.66666666669,350.0,350.0,0,0,0.0,0.0,0.0
146083.0,6,3,337,2,214,0.0,160.0,107.0,1,123,0.0,123.0,123.0
99333.0,6,2,132,1,66,0.0,66.0,66.0,1,66,0.0,66.0,66.0
442.0,17,2,508,2,508,0.0,257.0,254.0,0,0,0.0,0.0,0.0
724803.0,6,10,1221,6,636,144960.6,298.0,106.0,4,585,239315.0,379.0,146.25
357.0,17,2,267,1,83,0.0,83.0,83.0,1,184,0.0,184.0,184.0
57286.0,6,10,2032,5,524,14102.75,252.0,104.8,5,1508,13885.5,1236.0,301.6
302462.0,6,6,412,4,272,100820.66666666669,74.0,68.0,2,140,0.0,74.0,70.0
2401.0,17,4,344,2,150,0.0,75.0,75.0,2,194,0.0,103.0,97.0
290.0,17,2,156,1,78,0.0,78.0,78.0,1,78,0.0,78.0,78.0
90293019.0,17,12,778,6,389,18000164.8,174.0,64.83333333333333,6,389,18000429.0,174.0,64.83333333333333
90041407.0,17,28,13364,28,13364,3334866.925925926,501.0,477.2857142857143,0,0,0.0,0.0,0.0
18827324.0,17,3,1034,2,684,0.0,342.0,342.0,1,350,0.0,350.0,350.0
116401337.0,6,48,3168,24,1584,5060927.695652174,66.0,66.0,24,1584,5047504.826086956,66.0,66.0
316241.0,17,4,1400,4,1400,105413.66666666669,350.0,350.0,0,0,0.0,0.0,0.0
3704.0,17,4,344,2,150,0.0,75.0,75.0,2,194,0.0,103.0,97.0
31655.000000000004,6,10,2032,5,524,7258.25,252.0,104.8,5,1508,7660.5,1236.0,301.6
2797563.0,6,2,132,1,66,0.0,66.0,66.0,1,66,0.0,66.0,66.0
284669.0,17,2,363,1,79,0.0,79.0,79.0,1,284,0.0,284.0,284.0
160191.0,17,2,180,1,90,0.0,90.0,90.0,1,90,0.0,90.0,90.0
503283.00000000006,6,5,336,2,134,0.0,68.0,67.0,3,202,195530.5,70.0,67.33333333333333
0.0,17,1,99,1,99,0.0,99.0,99.0,0,0,0.0,0.0,0.0
7081635.0,6,5,1736,2,819,0.0,753.0,409.5,3,917,3470990.0,785.0,305.6666666666667
105411.0,17,2,700,2,700,0.0,350.0,350.0,0,0,0.0,0.0,0.0
16081.999999999998,6,10,1067,5,536,3515.0,264.0,107.2,5,531,3820.0,259.0,106.2
152987.0,6,3,337,2,214,0.0,160.0,107.0,1,123,0.0,123.0,123.0
43834.0,6,14,4740,7,653,6137.666666666667,249.0,93.28571428571428,7,4087,7167.666666666667,1514.0,583.8571428571429
210217.0,6,3,426,2,280,0.0,214.0,140.0,1,146,0.0,146.0,146.0
45865.0,6,14,4740,7,653,7518.166666666667,249.0,93.28571428571428,7,4087,6769.833333333333,1514.0,583.8571428571429
120509503.0,6,229,25912,115,18092,1057100.903508772,284.0,157.3217391304348,114,7820,1057251.2477876106,140.0,68.59649122807018
118412757.0,6,34,2334,17,1209,7400797.3125,123.0,71.11764705882354,17,1125,7387268.8125,123.0,66.17647058823529
120006053.0,6,24,1829,13,989,9999993.833333334,95.0,76.07692307692308,11,840,11999764.0,95.0,76.36363636363636
145151.0,17,2,180,1,70,0.0,70.0,70.0,1,110,0.0,110.0,110.0
306955.0,6,6,412,4,272,102318.33333333331,74.0,68.0,2,140,0.0,74.0,70.0
108104695.0,17,5,1005,5,1005,27026173.75,201.0,201.0,0,0,0.0,0.0,0.0
296.0,17,2,168,1,76,0.0,76.0,76.0,1,92,0.0,92.0,92.0
92081864.0,17,16,5472,16,5472,6138790.933333334,342.0,342.0,0,0,0.0,0.0,0.0
146288.0,17,2,363,1,75,0.0,75.0,75.0,1,288,0.0,288.0,288.0
50775.0,17,2,180,1,90,0.0,90.0,90.0,1,90,0.0,90.0,90.0
135136918.0,17,6,1206,6,1206,27027383.6,201.0,201.0,0,0,0.0,0.0,0.0
108111194.0,17,5,1005,5,1005,27027798.5,201.0,201.0,0,0,0.0,0.0,0.0
104086.0,17,2,286,2,286,0.0,143.0,143.0,0,0,0.0,0.0,0.0
10425572.0,6,6,412,3,206,5144585.0,74.0,68.66666666666667,3,206,5144489.5,74.0,68.66666666666667
90527454.0,6,13,2036,8,1016,12932493.42857143,188.0,127.0,5,1020,22590259.75,204.0,204.0
2587476.0,6,2,132,1,66,0.0,66.0,66.0,1,66,0.0,66.0,66.0
2333.0,17,4,344,2,150,0.0,75.0,75.0,2,194,0.0,103.0,97.0
217699.0,6,3,426,2,280,0.0,214.0,140.0,1,146,0.0,146.0,146.0
861.0,17,4,438,2,148,0.0,74.0,74.0,2,290,0.0,147.0,145.0
299634.0,6,6,412,4,272,99878.0,74.0,68.0,2,140,0.0,74.0,70.0
98326.0,17,2,762,2,762,0.0,381.0,381.0,0,0,0.0,0.0,0.0
3146667.0,6,9,589,5,342,786666.75,95.0,68.4,4,247,965031.3333333334,85.0,61.75
90300928.0,6,21,1585,11,840,9025002.2,95.0,76.36363636363636,10,745,10003072.111111112,95.0,74.5
837038.0,6,9,1118,6,586,167407.6,248.0,97.66666666666669,3,532,280774.5,392.0,177.33333333333334
0.0,6,1,214,1,214,0.0,214.0,214.0,0,0,0.0,0.0,0.0
119519208.0,6,214,24218,107,16934,1125496.5094339622,284.0,158.26168224299064,107,7284,1125496.952830189,140.0,68.07476635514018
314156.0,17,4,1400,4,1400,104718.66666666669,350.0,350.0,0,0,0.0,0.0,0.0
1302525.0,6,4,264,2,132,0.0,66.0,66.0,2,132,0.0,66.0,66.0
90320287.0,6,16,1192,8,596,12895794.142857144,95.0,74.5,8,596,12901614.0,95.0,74.5
94157199.0,17,12,778,6,389,18800175.6,174.0,64.83333333333333,6,389,18801097.4,174.0,64.83333333333333
108691234.0,6,32,2220,16,1149,7231679.933333334,123.0,71.8125,16,1071,7231683.333333333,123.0,66.9375
107277042.0,6,212,24176,106,16958,1019634.761904762,284.0,159.9811320754717,106,7218,1019625.2666666668,140.0,68.09433962264151
271919.0,17,4,1400,4,1400,90639.66666666669,350.0,350.0,0,0,0.0,0.0,0.0
0.0,6,1,66,1,66,0.0,66.0,66.0,0,0,0.0,0.0,0.0
173110.0,6,3,337,2,214,0.0,160.0,107.0,1,123,0.0,123.0,123.0
480.0,17,2,508,2,508,0.0,257.0,254.0,0,0,0.0,0.0,0.0
135131576.0,17,6,1206,6,1206,27026315.2,201.0,201.0,0,0,0.0,0.0,0.0
38622058.0,6,5,336,2,134,0.0,68.0,67.0,3,202,18009843.5,70.0,67.33333333333333
404.0,17,2,410,1,78,0.0,78.0,78.0,1,332,0.0,332.0,332.0
711.0,17,4,438,2,148,0.0,74.0,74.0,2,290,0.0,147.0,145.0
255478.0,6,3,337,2,214,0.0,160.0,107.0,1,123,0.0,123.0,123.0
22010.0,6,10,2032,5,524,4501.25,252.0,104.8,5,1508,5209.0,1236.0,301.6
53898.0,6,14,4740,7,653,8645.0,249.0,93.28571428571428,7,4087,8504.5,1514.0,583.8571428571429
2292.0,17,4,344,2,150,0.0,75.0,75.0,2,194,0.0,103.0,97.0
15947.0,17,4,344,2,150,0.0,75.0,75.0,2,194,0.0,103.0,97.0
216934.0,6,3,426,2,280,0.0,214.0,140.0,1,146,0.0,146.0,146.0
127631072.0,6,31,2034,16,1086,8508738.133333333,123.0,67.875,15,948,8387893.785714285,123.0,63.2
17148.0,6,14,4740,7,653,2643.1666666666665,249.0,93.28571428571428,7,4087,2664.333333333333,1514.0,583.8571428571429
870488.0,6,9,1270,6,799,174097.6,461.0,133.16666666666666,3,471,297440.5,331.0,157.0
87824.0,6,14,4740,7,653,14514.0,249.0,93.28571428571428,7,4087,14401.333333333334,1514.0,583.8571428571429
2898425.0,6,2,132,1,66,0.0,66.0,66.0,1,66,0.0,66.0,66.0
90061529.0,17,28,13364,28,13364,3335612.185185185,501.0,477.2857142857143,0,0,0.0,0.0,0.0
135141683.0,17,6,1206,6,1206,27028336.6,201.0,201.0,0,0,0.0,0.0,0.0
300.0,17,2,174,1,79,0.0,79.0,79.0,1,95,0.0,95.0,95.0
307701.0,6,6,412,4,272,102567.0,74.0,68.0,2,140,0.0,74.0,70.0
1972.0,17,4,344,2,150,0.0,75.0,75.0,2,194,0.0,103.0,97.0
306404.0,6,6,412,4,272,102134.66666666669,74.0,68.0,2,140,0.0,74.0,70.0
121238.0,6,3,337,2,214,0.0,160.0,107.0,1,123,0.0,123.0,123.0
90648170.0,6,15,2302,9,1204,11316471.5,188.0,133.77777777777777,6,1098,18097146.8,204.0,183.0
120023497.0,6,19,1596,10,745,13335944.111111112,95.0,74.5,9,851,11253823.0,255.0,94.55555555555556
38779.0,6,14,4740,7,653,5261.333333333333,249.0,93.28571428571428,7,4087,5300.166666666667,1514.0,583.8571428571429
2049.0,17,4,344,2,150,0.0,75.0,75.0,2,194,0.0,103.0,97.0
209584.0,17,2,180,1,90,0.0,90.0,90.0,1,90,0.0,90.0,90.0
30654.0,6,14,4740,7,653,4591.166666666667,249.0,93.28571428571428,7,4087,4965.166666666667,1514.0,583.8571428571429
2348.0,17,4,344,2,150,0.0,75.0,75.0,2,194,0.0,103.0,97.0
135137182.0,17,6,1146,6,1146,27027436.4,191.0,191.0,0,0,0.0,0.0,0.0
108110832.0,17,5,1005,5,1005,27027708.0,201.0,201.0,0,0,0.0,0.0,0.0
14418.0,6,11,2098,6,590,2731.8,252.0,98.33333333333331,5,1508,2638.5,1236.0,301.6
119873135.0,6,14,2102,5,1020,29967702.5,204.0,204.0,9,1082,14983994.125,188.0,120.22222222222224
112319534.0,6,45,2970,23,1518,5105433.363636363,66.0,66.0,22,1452,5174157.380952381,66.0,66.0
42985.0,6,14,4740,7,653,7048.833333333333,249.0,93.28571428571428,7,4087,6655.0,1514.0,583.8571428571429
37017407.0,6,7,1874,3,887,18436366.0,753.0,295.6666666666667,4,987,12292186.0,785.0,246.75
32681355.000000004,6,5,336,2,134,0.0,68.0,67.0,3,202,15052902.5,70.0,67.33333333333333
9019.0,17,4,823,2,163,0.0,89.0,81.5,2,660,0.0,443.0,330.0
332.0,17,2,166,1,75,0.0,75.0,75.0,1,91,0.0,91.0,91.0
90295491.0,6,16,1192,8,596,12892610.714285716,95.0,74.5,8,596,12896138.714285716,95.0,74.5
2140.0,17,4,344,2,150,0.0,75.0,75.0,2,194,0.0,103.0,97.0
49900.0,6,13,1386,7,789,7791.833333333333,253.0,112.71428571428572,6,597,8368.2,259.0,99.5
125471946.0,17,14,864,7,432,17666827.166666668,174.0,61.71428571428572,7,432,19959006.33333333,174.0,61.71428571428572
301677.0,6,6,412,4,272,100559.0,74.0,68.0,2,140,0.0,74.0,70.0
90523287.0,6,13,2036,8,1016,12931898.142857144,188.0,127.0,5,1020,22589852.5,204.0,204.0
25042.0,6,14,4740,7,653,4047.0,249.0,93.28571428571428,7,4087,4038.5,1514.0,583.8571428571429
59244.0,6,14,4740,7,653,7929.833333333333,249.0,93.28571428571428,7,4087,9659.666666666666,1514.0,583.8571428571429
307192.0,6,6,412,4,272,102397.33333333331,74.0,68.0,2,140,0.0,74.0,70.0
201883.0,17,4,6056,4,6056,67294.33333333333,1514.0,1514.0,0,0,0.0,0.0,0.0
3629016.0,6,5,1736,2,819,0.0,753.0,409.5,3,917,1742466.5,785.0,305.6666666666667
275047.0,17,4,1524,4,1524,91682.33333333331,381.0,381.0,0,0,0.0,0.0,0.0
14086328.0,6,21,7017,12,1641,1280575.2727272727,408.0,136.75,9,5376,1119455.75,1514.0,597.3333333333334
103998.0,17,2,286,2,286,0.0,143.0,143.0,0,0,0.0,0.0,0.0
91757351.0,6,189,21360,95,14934,976142.0319148937,284.0,157.2,94,6426,976768.0860215054,140.0,68.36170212765957
2409.0,17,4,344,2,150,0.0,75.0,75.0,2,194,0.0,103.0,97.0
44527.0,6,14,4740,7,653,7264.166666666667,249.0,93.28571428571428,7,4087,7202.0,1514.0,583.8571428571429
90529393.0,6,14,2240,8,1016,12932770.42857143,188.0,127.0,6,1224,18072514.0,204.0,204.0
2376.0,17,4,344,2,150,0.0,75.0,75.0,2,194,0.0,103.0,97.0
108110219.0,17,5,1005,5,1005,27027554.75,201.0,201.0,0,0,0.0,0.0,0.0
120028144.0,17,28,13364,28,13364,4445486.814814814,501.0,477.2857142857143,0,0,0.0,0.0,0.0
10173231.0,6,7,499,4,301,3219623.0,103.0,75.25,3,198,4591248.0,66.0,66.0
1026625.0,6,11,1134,6,558,205325.0,220.0,93.0,5,576,255963.0,304.0,115.2
18486.0,6,2,145,2,145,0.0,91.0,72.5,0,0,0.0,0.0,0.0
2098.0,17,4,344,2,150,0.0,75.0,75.0,2,194,0.0,103.0,97.0
314405.0,17,4,1400,4,1400,104801.66666666669,350.0,350.0,0,0,0.0,0.0,0.0
304586.0,6,6,412,4,272,101528.66666666669,74.0,68.0,2,140,0.0,74.0,70.0
205843.0,17,2,180,1,90,0.0,90.0,90.0,1,90,0.0,90.0,90.0
13669.0,6,13,1459,7,862,2088.1666666666665,271.0,123.14285714285714,6,597,2572.0,259.0,99.5
119329966.0,6,33,2274,17,1125,7458122.875,123.0,66.17647058823529,16,1149,7275209.533333333,123.0,71.8125
35122.0,6,10,2032,5,524,8549.0,252.0,104.8,5,1508,8342.5,1236.0,301.6
107344.0,17,2,286,2,286,0.0,143.0,143.0,0,0,0.0,0.0,0.0
90261496.0,6,12,1832,8,1016,12894499.42857143,188.0,127.0,4,816,30031947.33333333,204.0,204.0
30935.0,6,13,1479,7,882,5155.833333333333,291.0,126.0,6,597,4822.2,259.0,99.5
4954.0,17,2,180,1,90,0.0,90.0,90.0,1,90,0.0,90.0,90.0
30316.0,6,14,4740,7,653,4906.0,249.0,93.28571428571428,7,4087,4611.333333333333,1514.0,583.8571428571429
115961697.0,6,33,2290,17,1125,7247606.0625,123.0,66.17647058823529,16,1165,7050732.866666666,139.0,72.8125
2343.0,17,4,344,2,150,0.0,75.0,75.0,2,194,0.0,103.0,97.0
90020529.0,17,28,13364,28,13364,3334093.6666666665,501.0,477.2857142857143,0,0,0.0,0.0,0.0
108107666.0,17,5,955,5,955,27026916.5,191.0,191.0,0,0,0.0,0.0,0.0
235918.0,6,3,337,2,214,0.0,160.0,107.0,1,123,0.0,123.0,123.0
120235665.0,6,19,1436,9,691,14999475.375,95.0,76.77777777777777,10,745,13333331.666666666,95.0,74.5
314590.0,17,4,1400,4,1400,104863.33333333331,350.0,350.0,0,0,0.0,0.0,0.0
90059472.0,17,28,13364,28,13364,3335536.0,501.0,477.2857142857143,0,0,0.0,0.0,0.0
25163.0,6,14,4740,7,653,3907.6666666666665,249.0,93.28571428571428,7,4087,3934.5,1514.0,583.8571428571429
216797.0,6,3,426,2,280,0.0,214.0,140.0,1,146,0.0,146.0,146.0
108093777.0,17,5,1005,5,1005,27023444.25,201.0,201.0,0,0,0.0,0.0,0.0
251116.0,17,4,6056,4,6056,83705.33333333333,1514.0,1514.0,0,0,0.0,0.0,0.0
120060679.0,17,28,13364,28,13364,4446691.814814814,501.0,477.2857142857143,0,0,0.0,0.0,0.0
62293.0,6,14,4740,7,653,10261.5,249.0,93.28571428571428,7,4087,9381.333333333334,1514.0,583.8571428571429
117583872.0,6,210,23774,105,16622,1128545.125,284.0,158.3047619047619,105,7152,1128545.6634615385,140.0,68.11428571428571
10462271.0,6,7,478,4,272,3441859.6666666665,74.0,68.0,3,206,5162659.0,74.0,68.66666666666667
196822.0,17,2,180,1,90,0.0,90.0,90.0,1,90,0.0,90.0,90.0
90548440.0,6,16,2648,8,1016,12935491.42857143,188.0,127.0,8,1632,12911239.0,204.0,204.0
2588225.0,6,2,132,1,66,0.0,66.0,66.0,1,66,0.0,66.0,66.0
90755723.0,6,22,1680,12,894,8246829.545454546,95.0,74.5,10,786,10083621.444444444,95.0,78.6
305831.0,6,6,412,4,272,101943.66666666669,74.0,68.0,2,140,0.0,74.0,70.0
31078563.0,6,7,1874,4,987,10316840.0,785.0,246.75,3,887,15470664.5,753.0,295.6666666666667
228557.0,17,2,180,1,90,0.0,90.0,90.0,1,90,0.0,90.0,90.0
104343926.0,17,14,4788,14,4788,8026455.846153846,342.0,342.0,0,0,0.0,0.0,0.0
108107870.0,17,5,1005,5,1005,27026967.5,201.0,201.0,0,0,0.0,0.0,0.0
108103988.0,17,5,955,5,955,27025997.0,191.0,191.0,0,0,0.0,0.0,0.0
20080.0,6,14,4740,7,653,3191.5,249.0,93.28571428571428,7,4087,3207.1666666666665,1514.0,583.8571428571429
90036522.0,17,28,13364,28,13364,3334686.0,501.0,477.2857142857143,0,0,0.0,0.0,0.0
29225.0,6,14,4740,7,653,4678.5,249.0,93.28571428571428,7,4087,4730.5,1514.0,583.8571428571429
0.0,6,1,172,1,172,0.0,172.0,172.0,0,0,0.0,0.0,0.0
90306506.0,6,16,1192,8,596,12894172.857142856,95.0,74.5,8,596,12899921.857142856,95.0,74.5
33417.0,6,10,2032,5,524,6899.75,252.0,104.8,5,1508,8102.5,1236.0,301.6
72708.0,6,14,4740,7,653,11195.333333333334,249.0,93.28571428571428,7,4087,11868.333333333334,1514.0,583.8571428571429
13894794.0,17,6,2052,6,2052,2778958.8,342.0,342.0,0,0,0.0,0.0,0.0
135129536.0,17,6,1206,6,1206,27025907.2,201.0,201.0,0,0,0.0,0.0,0.0
741076.0,6,2,132,1,66,0.0,66.0,66.0,1,66,0.0,66.0,66.0
96102374.0,6,58,12294,29,6504,3432227.6428571427,1514.0,224.27586206896552,29,5790,3423323.3928571427,1514.0,199.6551724137931
53566979.0,6,8,2113,3,960,25538133.0,826.0,320.0,5,1153,12748987.5,885.0,230.6
26654.0,6,14,4740,7,653,3990.3333333333335,249.0,93.28571428571428,7,4087,4167.166666666667,1514.0,583.8571428571429
322.0,17,2,174,1,79,0.0,79.0,79.0,1,95,0.0,95.0,95.0
108116003.0,17,5,1005,5,1005,27029000.75,201.0,201.0,0,0,0.0,0.0,0.0
115824097.0,6,46,3976,26,2206,4632963.88,139.0,84.84615384615384,20,1770,6084630.947368421,123.0,88.5
104398928.0,6,32,2236,16,1165,6959928.533333333,139.0,72.8125,16,1071,6945510.266666667,123.0,66.9375
55192.0,6,14,4740,7,653,9076.0,249.0,93.28571428571428,7,4087,8258.0,1514.0,583.8571428571429
2597854.0,6,2,132,1,66,0.0,66.0,66.0,1,66,0.0,66.0,66.0
342.0,17,2,166,1,75,0.0,75.0,75.0,1,91,0.0,91.0,91.0
228611.0,17,2,180,1,90,0.0,90.0,90.0,1,90,0.0,90.0,90.0
207486.0,17,2,762,2,762,0.0,381.0,381.0,0,0,0.0,0.0,0.0
513935.00000000006,6,3,1604,2,851,0.0,785.0,425.5,1,753,0.0,753.0,753.0
314357.0,6,6,412,4,272,104785.66666666669,74.0,68.0,2,140,0.0,74.0,70.0
831428.0,6,9,1118,6,586,166285.6,248.0,97.66666666666669,3,532,279340.0,392.0,177.33333333333334
0.0,6,1,66,1,66,0.0,66.0,66.0,0,0,0.0,0.0,0.0
43359.0,6,14,4740,7,653,6334.5,249.0,93.28571428571428,7,4087,7000.5,1514.0,583.8571428571429
15578.0,6,10,1066,5,490,3040.25,218.0,98.0,5,576,3628.5,304.0,115.2
108105126.0,17,5,955,5,955,27026281.5,191.0,191.0,0,0,0.0,0.0,0.0
334.0,17,2,267,1,83,0.0,83.0,83.0,1,184,0.0,184.0,184.0
108106761.0,17,5,955,5,955,27026690.25,191.0,191.0,0,0,0.0,0.0,0.0
11225.0,6,11,1132,6,556,2050.8,218.0,92.66666666666669,5,576,2483.5,304.0,115.2
15350.0,17,4,344,2,150,0.0,75.0,75.0,2,194,0.0,103.0,97.0
1975.0,17,4,344,2,150,0.0,75.0,75.0,2,194,0.0,103.0,97.0
110768290.0,6,32,2236,16,1165,7370149.466666667,139.0,72.8125,16,1071,7370151.6,123.0,66.9375
120255828.0,6,216,24424,108,7424,1116192.5607476635,140.0,68.74074074074075,108,17000,1116100.2429906542,284.0,157.40740740740742
2015.0,17,4,344,2,150,0.0,75.0,75.0,2,194,0.0,103.0,97.0
197357.0,17,2,180,1,90,0.0,90.0,90.0,1,90,0.0,90.0,90.0
10475290.0,6,7,478,4,272,3444704.333333333,74.0,68.0,3,206,5166937.5,74.0,68.66666666666667
351122.0,6,6,412,4,272,117040.66666666669,74.0,68.0,2,140,0.0,74.0,70.0
129012674.0,17,15,907,8,475,18430382.0,174.0,59.375,7,432,18166850.166666668,174.0,61.71428571428572
118063308.0,6,35,2542,18,1348,6944900.470588235,139.0,74.88888888888889,17,1194,7365443.4375,123.0,70.23529411764706
2495.0,17,4,344,2,150,0.0,75.0,75.0,2,194,0.0,103.0,97.0
51324.0,6,14,4740,7,653,7892.166666666667,249.0,93.28571428571428,7,4087,7978.833333333333,1514.0,583.8571428571429
232355.0,6,3,337,2,214,0.0,160.0,107.0,1,123,0.0,123.0,123.0
27709997.0,17,5,1710,5,1710,6927499.25,342.0,342.0,0,0,0.0,0.0,0.0
245546.0,6,3,337,2,214,0.0,160.0,107.0,1,123,0.0,123.0,123.0
90211590.0,6,19,1436,9,691,11245846.375,95.0,76.77777777777777,10,745,10000679.333333334,95.0,74.5
43135.0,6,14,4740,7,653,7036.5,249.0,93.28571428571428,7,4087,6048.5,1514.0,583.8571428571429
313940.0,17,4,622,4,622,104646.66666666669,163.0,155.5,0,0,0.0,0.0,0.0
103380.0,17,2,286,2,286,0.0,143.0,143.0,0,0,0.0,0.0,0.0
49169.0,6,14,4740,7,653,8069.166666666667,249.0,93.28571428571428,7,4087,7997.166666666667,1514.0,583.8571428571429
2073244.0,6,24,7544,12,2450,188476.7272727273,1034.0,204.16666666666663,12,5094,160464.63636363635,1510.0,424.5
215465.0,17,2,180,1,90,0.0,90.0,90.0,1,90,0.0,90.0,90.0
48178.0,6,10,2032,5,524,11490.25,252.0,104.8,5,1508,10559.75,1236.0,301.6
408.0,17,2,762,2,762,0.0,381.0,381.0,0,0,0.0,0.0,0.0
2317.0,17,4,344,2,150,0.0,75.0,75.0,2,194,0.0,103.0,97.0
217515.0,6,3,426,2,280,0.0,214.0,140.0,1,146,0.0,146.0,146.0
90046708.0,17,28,13364,28,13364,3335063.25925926,501.0,477.2857142857143,0,0,0.0,0.0,0.0
1028962.0,6,11,1134,6,558,205792.4,220.0,93.0,5,576,255822.0,304.0,115.2
299281.0,6,6,412,4,272,99760.33333333331,74.0,68.0,2,140,0.0,74.0,70.0
102151.0,17,2,286,2,286,0.0,143.0,143.0,0,0,0.0,0.0,0.0
10778.0,6,10,2032,5,524,2477.75,252.0,104.8,5,1508,2456.5,1236.0,301.6
28833.0,6,13,4416,6,409,5584.8,127.0,68.16666666666667,7,4007,3913.8333333333335,1514.0,572.4285714285714
300402.0,6,6,412,4,272,100134.0,74.0,68.0,2,140,0.0,74.0,70.0
111485.0,17,4,1400,4,1400,37161.66666666666,350.0,350.0,0,0,0.0,0.0,0.0
90062025.0,17,28,13364,28,13364,3335630.5555555555,501.0,477.2857142857143,0,0,0.0,0.0,0.0
2401.0,17,4,344,2,150,0.0,75.0,75.0,2,194,0.0,103.0,97.0
220665.0,6,10,1221,6,636,44133.0,298.0,106.0,4,585,71219.0,379.0,146.25
143991.0,17,2,180,1,90,0.0,90.0,90.0,1,90,0.0,90.0,90.0
3177894.0,6,15,2265,8,1145,453984.8571428572,579.0,143.125,7,1120,494945.5,732.0,160.0
315464.0,6,3,202,2,128,0.0,74.0,64.0,1,74,0.0,74.0,74.0
165340.0,6,3,337,2,214,0.0,160.0,107.0,1,123,0.0,123.0,123.0
901.0,17,4,438,2,148,0.0,74.0,74.0,2,290,0.0,147.0,145.0
1076.0,17,2,762,2,762,0.0,381.0,381.0,0,0,0.0,0.0,0.0
304196.0,6,6,412,4,272,101398.66666666669,74.0,68.0,2,140,0.0,74.0,70.0
148.0,17,2,158,2,158,0.0,79.0,79.0,0,0,0.0,0.0,0.0
206048.0,6,3,426,2,280,0.0,214.0,140.0,1,146,0.0,146.0,146.0
12721.0,17,4,823,2,163,0.0,89.0,81.5,2,660,0.0,443.0,330.0
206201.0,6,3,426,2,280,0.0,214.0,140.0,1,146,0.0,146.0,146.0
359.0,17,2,267,1,83,0.0,83.0,83.0,1,184,0.0,184.0,184.0
153467.0,17,2,180,1,90,0.0,90.0,90.0,1,90,0.0,90.0,90.0
948.0,17,4,438,2,148,0.0,74.0,74.0,2,290,0.0,147.0,145.0
2634869.0,6,3,1604,2,851,0.0,785.0,425.5,1,753,0.0,753.0,753.0
90591323.0,6,27,1954,14,1045,6951958.0,139.0,74.64285714285714,13,909,7531290.5,123.0,69.92307692307692
460.0,17,2,208,1,72,0.0,72.0,72.0,1,136,0.0,136.0,136.0
119375463.0,6,291,33096,146,9858,823279.0551724138,140.0,67.52054794520548,145,23238,821742.0902777778,374.0,160.26206896551724
2594479.0,6,2,132,1,66,0.0,66.0,66.0,1,66,0.0,66.0,66.0
1450362.0,6,7,499,4,301,430425.3333333333,103.0,75.25,3,198,716727.5,66.0,66.0
11665.0,6,11,2098,6,590,2187.0,252.0,98.33333333333331,5,1508,2650.25,1236.0,301.6
111792.0,17,4,1400,4,1400,37264.0,350.0,350.0,0,0,0.0,0.0,0.0
3079.0,17,2,224,1,76,0.0,76.0,76.0,1,148,0.0,148.0,148.0
120441600.0,6,355,41714,178,29736,680461.0169491526,284.0,167.0561797752809,177,11978,678400.9602272727,140.0,67.67231638418079
6765.0,17,2,582,1,83,0.0,83.0,83.0,1,499,0.0,499.0,499.0
309014.0,17,4,1400,4,1400,103004.66666666669,350.0,350.0,0,0,0.0,0.0,0.0
114490380.0,6,48,3168,24,1584,4977842.608695652,66.0,66.0,24,1584,4968446.782608695,66.0,66.0
14748.0,6,14,4740,7,653,2295.833333333333,249.0,93.28571428571428,7,4087,2310.833333333333,1514.0,583.8571428571429
1672.0,17,4,438,2,148,0.0,74.0,74.0,2,290,0.0,147.0,145.0
137337.0,6,2,132,1,66,0.0,66.0,66.0,1,66,0.0,66.0,66.0
95716303.0,17,14,4796,13,4446,6227915.583333333,342.0,342.0,1,350,0.0,350.0,350.0
217982.0,6,3,426,2,280,0.0,214.0,140.0,1,146,0.0,146.0,146.0
149465046.0,17,35,16705,35,16705,4396030.764705882,501.0,477.2857142857143,0,0,0.0,0.0,0.0
854265.0,6,9,1096,6,625,170853.0,287.0,104.16666666666669,3,471,289455.0,331.0,157.0
119662971.0,17,35,16705,35,16705,3519499.147058824,501.0,477.2857142857143,0,0,0.0,0.0,0.0
90258778.0,6,16,2368,9,1204,11282347.25,188.0,133.77777777777777,7,1164,15015464.5,204.0,166.28571428571428
17844.0,6,14,4740,7,653,2789.6666666666665,249.0,93.28571428571428,7,4087,2839.1666666666665,1514.0,583.8571428571429
197081.0,17,2,180,1,90,0.0,90.0,90.0,1,90,0.0,90.0,90.0
254832.0,6,3,373,2,238,0.0,172.0,119.0,1,135,0.0,135.0,135.0
218249.0,6,3,426,2,280,0.0,214.0,140.0,1,146,0.0,146.0,146.0
9197.0,17,4,823,2,163,0.0,89.0,81.5,2,660,0.0,443.0,330.0
103091.0,17,2,286,2,286,0.0,143.0,143.0,0,0,0.0,0.0,0.0
260230.00000000003,6,12,1373,7,714,43371.66666666666,298.0,102.0,5,659,60737.5,379.0,131.8
8399933.0,17,4,1376,3,1026,879099.0,342.0,342.0,1,350,0.0,350.0,350.0
135141341.0,17,6,1206,6,1206,27028268.2,201.0,201.0,0,0,0.0,0.0,0.0
2870.0,17,2,508,2,508,0.0,257.0,254.0,0,0,0.0,0.0,0.0
107377547.0,6,196,22220,98,15530,1104767.412371134,284.0,158.46938775510205,98,6690,1104768.0103092785,140.0,68.26530612244898
115005098.0,17,14,864,7,432,19001637.0,174.0,61.71428571428572,7,432,19000179.5,174.0,61.71428571428572
143921.0,17,2,180,1,90,0.0,90.0,90.0,1,90,0.0,90.0,90.0
2367.0,17,4,344,2,150,0.0,75.0,75.0,2,194,0.0,103.0,97.0
108101260.0,17,5,955,5,955,27025315.0,191.0,191.0,0,0,0.0,0.0,0.0
301856.0,6,6,412,4,272,100618.66666666669,74.0,68.0,2,140,0.0,74.0,70.0
90204428.0,6,24,1888,11,940,8996494.5,154.0,85.45454545454545,13,948,7499912.666666667,95.0,72.92307692307692
11615.0,6,10,2032,5,524,2546.75,252.0,104.8,5,1508,2314.25,1236.0,301.6
108105613.0,17,5,1005,5,1005,27026403.25,201.0,201.0,0,0,0.0,0.0,0.0
103813.0,17,2,286,2,286,0.0,143.0,143.0,0,0,0.0,0.0,0.0
90049927.0,17,28,13364,28,13364,3335182.4814814813,501.0,477.2857142857143,0,0,0.0,0.0,0.0
1804.0,17,2,176,1,80,0.0,80.0,80.0,1,96,0.0,96.0,96.0
0.0,6,1,172,1,172,0.0,172.0,172.0,0,0,0.0,0.0,0.0
13502.0,6,14,4740,7,653,1931.1666666666667,249.0,93.28571428571428,7,4087,2112.5,1514.0,583.8571428571429
120341.0,17,2,180,1,70,0.0,70.0,70.0,1,110,0.0,110.0,110.0
10984.0,6,10,1065,5,534,2477.0,262.0,106.8,5,531,2420.0,259.0,106.2
120175516.0,6,234,26422,117,8018,1029783.1034482758,140.0,68.52991452991454,117,18404,1029970.1120689656,284.0,157.2991452991453
90259603.0,6,13,2036,8,1016,12894229.0,188.0,127.0,5,1020,22523439.0,204.0,204.0
302493.0,6,6,412,4,272,100831.0,74.0,68.0,2,140,0.0,74.0,70.0
90695210.0,6,18,1382,10,745,10077245.555555556,95.0,74.5,8,637,12926134.142857144,95.0,79.625
108097255.0,17,5,1005,5,1005,27024313.75,201.0,201.0,0,0,0.0,0.0,0.0
120000519.0,6,22,1695,12,991,10909138.090909092,155.0,82.58333333333333,10,704,13303743.111111112,95.0,70.4
105631.0,17,3,1143,3,1143,52815.5,381.0,381.0,0,0,0.0,0.0,0.0
2177244.0,6,25,2756,13,1528,181437.0,253.0,117.53846153846152,12,1228,196713.0909090909,293.0,102.33333333333331
337556.0,17,2,180,1,90,0.0,90.0,90.0,1,90,0.0,90.0,90.0
512513.0,6,3,204,2,136,0.0,70.0,68.0,1,68,0.0,68.0,68.0
216740.0,17,2,180,1,90,0.0,90.0,90.0,1,90,0.0,90.0,90.0
109908.0,17,2,286,2,286,0.0,143.0,143.0,0,0,0.0,0.0,0.0
322663.0,6,3,202,2,128,0.0,74.0,64.0,1,74,0.0,74.0,74.0
371532.0,17,6,1230,3,234,185589.5,78.0,78.0,3,996,185564.5,332.0,332.0
232898.0,6,3,337,2,214,0.0,160.0,107.0,1,123,0.0,123.0,123.0
511826.0,6,5,336,2,134,0.0,68.0,67.0,3,202,196881.5,70.0,67.33333333333333
303098.0,6,2,132,1,66,0.0,66.0,66.0,1,66,0.0,66.0,66.0
113480.0,6,14,4740,7,653,16496.5,249.0,93.28571428571428,7,4087,16595.833333333332,1514.0,583.8571428571429
103662572.0,6,44,2904,22,1452,4936312.952380952,66.0,66.0,22,1452,4921611.904761905,66.0,66.0
248568.0,6,3,337,2,214,0.0,160.0,107.0,1,123,0.0,123.0,123.0
305478.0,6,6,412,4,272,101826.0,74.0,68.0,2,140,0.0,74.0,70.0
47087.0,6,11,2098,6,590,7535.0,252.0,98.33333333333331,5,1508,11097.75,1236.0,301.6
108104110.0,17,5,1005,5,1005,27026027.5,201.0,201.0,0,0,0.0,0.0,0.0
777.0,17,4,438,2,148,0.0,74.0,74.0,2,290,0.0,147.0,145.0
121909.0,6,3,373,2,238,0.0,172.0,119.0,1,135,0.0,135.0,135.0
3006970.0,6,11,2106,6,598,601199.6,252.0,99.66666666666669,5,1508,2199.25,1236.0,301.6
319.0,17,2,174,1,79,0.0,79.0,79.0,1,95,0.0,95.0,95.0
56321.0,6,14,4740,7,653,9266.666666666666,249.0,93.28571428571428,7,4087,9152.666666666666,1514.0,583.8571428571429
120048128.0,17,28,13364,28,13364,4446226.962962963,501.0,477.2857142857143,0,0,0.0,0.0,0.0
25058.0,6,11,1133,6,602,4581.2,264.0,100.33333333333331,5,531,5792.5,259.0,106.2
27974.0,6,12,1393,6,796,5465.0,271.0,132.66666666666666,6,597,5211.0,259.0,99.5
32683404.000000004,6,5,336,2,134,0.0,68.0,67.0,3,202,14952799.0,70.0,67.33333333333333
2381.0,17,2,762,2,762,0.0,381.0,381.0,0,0,0.0,0.0,0.0
192034.0,6,2,132,1,66,0.0,66.0,66.0,1,66,0.0,66.0,66.0
13604864.0,6,20,1607,10,975,1478308.6666666667,315.0,97.5,10,632,1478286.7777777778,78.0,63.2
281715.0,17,2,180,1,90,0.0,90.0,90.0,1,90,0.0,90.0,90.0
120066380.0,17,28,13364,28,13364,4446902.962962963,501.0,477.2857142857143,0,0,0.0,0.0,0.0
2344.0,17,4,344,2,150,0.0,75.0,75.0,2,194,0.0,103.0,97.0
207359.0,6,3,426,2,280,0.0,214.0,140.0,1,146,0.0,146.0,146.0
108102482.0,17,5,1005,5,1005,27025620.5,201.0,201.0,0,0,0.0,0.0,0.0
108108539.0,17,5,955,5,955,27027134.75,191.0,191.0,0,0,0.0,0.0,0.0
46551.0,6,10,2032,5,524,11289.5,252.0,104.8,5,1508,10420.5,1236.0,301.6
104323308.0,6,31,2182,16,1165,6941179.533333333,139.0,72.8125,15,1017,7436975.357142857,123.0,67.8
121349.0,6,3,337,2,214,0.0,160.0,107.0,1,123,0.0,123.0,123.0
70531.0,6,14,4740,7,653,11043.833333333334,249.0,93.28571428571428,7,4087,11619.5,1514.0,583.8571428571429
93214987.0,6,182,20554,91,14326,1033329.6555555556,284.0,157.42857142857142,91,6228,1033330.0222222222,140.0,68.43956043956044
305800.0,17,4,704,2,148,0.0,74.0,74.0,2,556,0.0,280.0,278.0
339697.0,17,2,498,1,80,0.0,80.0,80.0,1,418,0.0,418.0,418.0
338187.0,17,4,704,2,148,0.0,74.0,74.0,2,556,0.0,280.0,278.0
50875.0,6,10,2032,5,524,12505.75,252.0,104.8,5,1508,10585.25,1236.0,301.6
90059527.0,17,28,13364,28,13364,3335538.037037037,501.0,477.2857142857143,0,0,0.0,0.0,0.0
2586700.0,6,2,132,1,66,0.0,66.0,66.0,1,66,0.0,66.0,66.0
10468494.0,6,7,478,4,272,3443833.6666666665,74.0,68.0,3,206,5165658.5,74.0,68.66666666666667
129049459.0,17,14,995,7,563,18160426.33333333,174.0,80.42857142857143,7,432,18167789.33333333,174.0,61.71428571428572
2796528.0,6,2,132,1,66,0.0,66.0,66.0,1,66,0.0,66.0,66.0
99407210.0,17,12,778,6,389,19800788.4,174.0,64.83333333333333,6,389,19800061.4,174.0,64.83333333333333
26429.0,6,14,4740,7,653,3860.3333333333335,249.0,93.28571428571428,7,4087,4155.0,1514.0,583.8571428571429
100867778.0,17,12,516,6,258,20000506.8,43.0,43.0,6,258,20000172.8,43.0,43.0
220677.0,6,12,1373,7,714,36779.5,298.0,102.0,5,659,54186.0,379.0,131.8
2303.0,17,4,344,2,150,0.0,75.0,75.0,2,194,0.0,103.0,97.0
19489.0,6,14,4740,7,653,2940.6666666666665,249.0,93.28571428571428,7,4087,3109.6666666666665,1514.0,583.8571428571429
8122021.999999999,17,4,1376,3,1026,29328.0,342.0,342.0,1,350,0.0,350.0,350.0
206152.0,6,3,426,2,280,0.0,214.0,140.0,1,146,0.0,146.0,146.0
8992125.0,17,3,1034,2,684,0.0,342.0,342.0,1,350,0.0,350.0,350.0
29579.0,6,14,4740,7,653,4006.5,249.0,93.28571428571428,7,4087,4431.666666666667,1514.0,583.8571428571429
18217.0,6,14,4740,7,653,2406.0,249.0,93.28571428571428,7,4087,2800.0,1514.0,583.8571428571429
3232792.0,6,22,6440,12,1529,293890.1818181818,357.0,127.41666666666669,10,4911,322371.44444444444,1510.0,491.1
415306.0,6,3,1604,2,851,0.0,785.0,425.5,1,753,0.0,753.0,753.0
9748.0,17,2,582,1,83,0.0,83.0,83.0,1,499,0.0,499.0,499.0
39599.0,6,14,4740,7,653,6293.833333333333,249.0,93.28571428571428,7,4087,5435.833333333333,1514.0,583.8571428571429
262271.0,17,4,1524,4,1524,87423.66666666667,381.0,381.0,0,0,0.0,0.0,0.0
27335575.0,17,5,1710,5,1710,6833893.75,342.0,342.0,0,0,0.0,0.0,0.0
26700.0,6,14,4740,7,653,4337.0,249.0,93.28571428571428,7,4087,4315.833333333333,1514.0,583.8571428571429
90050185.0,17,27,12943,27,12943,3463468.653846154,501.0,479.3703703703704,0,0,0.0,0.0,0.0
165841.0,17,2,180,1,90,0.0,90.0,90.0,1,90,0.0,90.0,90.0
2805023.0,6,2,132,1,66,0.0,66.0,66.0,1,66,0.0,66.0,66.0
16774.0,17,2,180,1,90,0.0,90.0,90.0,1,90,0.0,90.0,90.0
233167.0,6,3,337,2,214,0.0,160.0,107.0,1,123,0.0,123.0,123.0
209593.0,17,2,180,1,90,0.0,90.0,90.0,1,90,0.0,90.0,90.0
36638.0,6,11,2098,6,590,7211.4,252.0,98.33333333333331,5,1508,8595.0,1236.0,301.6
1426047.0,6,4,1843,2,951,0.0,885.0,475.5,2,892,0.0,826.0,446.0
50757.0,6,10,2032,5,524,12463.75,252.0,104.8,5,1508,11214.75,1236.0,301.6
104584452.0,6,44,2904,22,1452,4980212.0,66.0,66.0,22,1452,4965239.476190476,66.0,66.0
41732.0,6,2,145,2,145,0.0,91.0,72.5,0,0,0.0,0.0,0.0
1987.0,17,4,344,2,150,0.0,75.0,75.0,2,194,0.0,103.0,97.0
90924146.0,6,21,1585,11,840,9091482.5,95.0,76.36363636363636,10,745,10101677.888888888,95.0,74.5
97843.0,17,2,762,2,762,0.0,381.0,381.0,0,0,0.0,0.0,0.0
339828.0,6,3,1604,2,851,0.0,785.0,425.5,1,753,0.0,753.0,753.0
9129844.0,6,12,1920,12,1920,829985.8181818182,160.0,160.0,0,0,0.0,0.0,0.0
121782211.0,6,33,2296,17,1225,7611388.1875,139.0,72.05882352941177,16,1071,7438810.2,123.0,66.9375
114552770.0,6,48,3168,24,1584,4980555.217391305,66.0,66.0,24,1584,4971155.739130435,66.0,66.0
110007660.0,6,32,2220,16,1149,7319453.266666667,123.0,71.8125,16,1071,7319453.866666666,123.0,66.9375
228615.0,17,2,180,1,90,0.0,90.0,90.0,1,90,0.0,90.0,90.0
65449.99999999999,6,14,4740,7,653,10781.333333333334,249.0,93.28571428571428,7,4087,10719.333333333334,1514.0,583.8571428571429
3031893.0,6,176,144346,100,135028,30625.18181818182,1510.0,1350.28,76,9318,36207.94666666666,1510.0,122.60526315789474
22111119.0,17,3,1034,2,684,0.0,342.0,342.0,1,350,0.0,350.0,350.0
29284.0,6,19,7540,11,978,2928.4,310.0,88.9090909090909,8,6562,3391.285714285714,1514.0,820.25
4998364.0,17,4,849,2,166,0.0,83.0,83.0,2,683,0.0,499.0,341.5
97421921.0,6,25,1686,13,840,8118460.083333333,123.0,64.61538461538461,12,846,7948732.272727272,123.0,70.5
1174938.0,6,13,3003,8,2375,167848.2857142857,1514.0,296.875,5,628,224816.5,331.0,125.6
1031198.0,6,11,1134,6,558,206239.6,220.0,93.0,5,576,256800.25,304.0,115.2
37201.0,6,14,4740,7,653,6078.666666666667,249.0,93.28571428571428,7,4087,5857.5,1514.0,583.8571428571429
24220.0,6,14,4740,7,653,3790.8333333333335,249.0,93.28571428571428,7,4087,3901.8333333333335,1514.0,583.8571428571429
4283.0,17,2,614,1,72,0.0,72.0,72.0,1,542,0.0,542.0,542.0
5624070.0,6,5,336,2,134,0.0,68.0,67.0,3,202,1524096.5,70.0,67.33333333333333
365867.0,6,3,1604,2,851,0.0,785.0,425.5,1,753,0.0,753.0,753.0
233816.0,6,3,337,2,214,0.0,160.0,107.0,1,123,0.0,123.0,123.0
54527.0,6,14,4740,7,653,8892.333333333334,249.0,93.28571428571428,7,4087,7286.0,1514.0,583.8571428571429
162335.0,17,2,180,1,90,0.0,90.0,90.0,1,90,0.0,90.0,90.0
309661.0,17,2,180,1,90,0.0,90.0,90.0,1,90,0.0,90.0,90.0
24465.0,6,10,2032,5,524,5897.5,252.0,104.8,5,1508,5898.75,1236.0,301.6
135135869.0,17,6,1146,6,1146,27027173.8,191.0,191.0,0,0,0.0,0.0,0.0
871206.0,6,10,1333,6,796,174241.2,458.0,132.66666666666666,4,537,199519.66666666663,331.0,134.25
29879.0,6,14,4740,7,653,4855.833333333333,249.0,93.28571428571428,7,4087,4799.166666666667,1514.0,583.8571428571429
115974242.0,6,48,3168,24,1584,5042358.347826087,66.0,66.0,24,1584,5030511.304347826,66.0,66.0
90290082.0,6,21,1585,11,840,9024375.4,95.0,76.36363636363636,10,745,10000276.111111112,95.0,74.5
246310.0,6,3,337,2,214,0.0,160.0,107.0,1,123,0.0,123.0,123.0
101557.0,17,2,762,2,762,0.0,381.0,381.0,0,0,0.0,0.0,0.0
107007687.0,17,13,821,7,432,17834614.5,174.0,61.71428571428572,6,389,17400166.0,174.0,64.83333333333333
9648.0,17,2,571,1,86,0.0,86.0,86.0,1,485,0.0,485.0,485.0
303119.0,6,2,132,1,66,0.0,66.0,66.0,1,66,0.0,66.0,66.0
143866.0,17,2,180,1,90,0.0,90.0,90.0,1,90,0.0,90.0,90.0
34900.0,6,14,4740,7,653,5635.833333333333,249.0,93.28571428571428,7,4087,5676.5,1514.0,583.8571428571429
72478.0,6,10,2032,5,524,17886.5,252.0,104.8,5,1508,7346.75,1236.0,301.6
6393.0,17,4,344,2,150,0.0,75.0,75.0,2,194,0.0,103.0,97.0
95856521.0,17,14,4796,13,4446,6228627.833333333,342.0,342.0,1,350,0.0,350.0,350.0
166573.0,17,2,180,1,90,0.0,90.0,90.0,1,90,0.0,90.0,90.0
323731.0,17,4,1400,4,1400,107910.33333333331,350.0,350.0,0,0,0.0,0.0,0.0
90287274.0,6,16,1192,8,596,12890909.42857143,95.0,74.5,8,596,12897817.285714284,95.0,74.5
52358.0,6,14,4740,7,653,8562.666666666666,249.0,93.28571428571428,7,4087,7717.166666666667,1514.0,583.8571428571429
2619.0,17,4,344,2,150,0.0,75.0,75.0,2,194,0.0,103.0,97.0
109861632.0,6,35,2812,19,1534,6091432.055555556,139.0,80.73684210526316,16,1278,7309719.6,123.0,79.875
118765769.0,17,21,5844,9,1171,14750798.25,506.0,130.11111111111111,12,4673,10767697.727272728,1214.0,389.4166666666667
19853.0,17,2,582,1,83,0.0,83.0,83.0,1,499,0.0,499.0,499.0
242263.0,6,3,337,1,123,0.0,123.0,123.0,2,214,0.0,160.0,107.0
49643133.0,6,8,1307,8,1307,7091876.142857143,172.0,163.375,0,0,0.0,0.0,0.0
156763.0,17,2,180,1,90,0.0,90.0,90.0,1,90,0.0,90.0,90.0
2448422.0,6,25,7573,14,3735,188340.15384615384,1514.0,266.7857142857143,11,3838,218936.0,1514.0,348.90909090909093
120124251.0,6,15,2444,7,1428,20020708.5,204.0,204.0,8,1016,17136873.42857143,188.0,127.0
49486.0,6,10,2032,5,524,12146.75,252.0,104.8,5,1508,10791.25,1236.0,301.6
108095361.0,17,5,1005,5,1005,27023840.25,201.0,201.0,0,0,0.0,0.0,0.0
90298119.0,6,19,1436,10,745,10026719.555555556,95.0,74.5,9,691,11286046.125,95.0,76.77777777777777
90021184.0,17,28,13364,28,13364,3334117.925925926,501.0,477.2857142857143,0,0,0.0,0.0,0.0
129012.0,6,2,132,1,66,0.0,66.0,66.0,1,66,0.0,66.0,66.0
108109690.0,17,5,1005,5,1005,27027422.5,201.0,201.0,0,0,0.0,0.0,0.0
32487.000000000004,6,10,2032,5,524,7363.0,252.0,104.8,5,1508,7714.25,1236.0,301.6
116007115.0,6,35,2542,18,1348,6811849.235294118,139.0,74.88888888888889,17,1194,7237623.0,123.0,70.23529411764706
100415437.0,17,12,516,6,258,20001852.6,43.0,43.0,6,258,20000156.2,43.0,43.0
32784.0,6,14,4740,7,653,5273.5,249.0,93.28571428571428,7,4087,5328.666666666667,1514.0,583.8571428571429
11577.0,6,13,1459,7,862,1794.5,271.0,123.14285714285714,6,597,2137.0,259.0,99.5
98076580.0,17,12,778,6,389,19601436.2,174.0,64.83333333333333,6,389,19600156.2,174.0,64.83333333333333
29618.0,6,14,4740,7,653,4774.166666666667,249.0,93.28571428571428,7,4087,4607.833333333333,1514.0,583.8571428571429
14638765.0,6,20,1648,10,1016,1592543.111111111,315.0,101.6,10,632,1592508.888888889,78.0,63.2
251506.0,17,4,6056,4,6056,83835.33333333333,1514.0,1514.0,0,0,0.0,0.0,0.0
2052.0,17,4,344,2,150,0.0,75.0,75.0,2,194,0.0,103.0,97.0
36207.0,6,14,4740,7,653,5909.833333333333,249.0,93.28571428571428,7,4087,5896.333333333333,1514.0,583.8571428571429
30579.0,6,14,4740,7,653,4872.333333333333,249.0,93.28571428571428,7,4087,4586.0,1514.0,583.8571428571429
43452.0,6,14,4740,7,653,6268.666666666667,249.0,93.28571428571428,7,4087,6311.333333333333,1514.0,583.8571428571429
596554.0,6,3,198,2,132,0.0,66.0,66.0,1,66,0.0,66.0,66.0
126001548.0,17,15,907,8,475,18000221.14285714,174.0,59.375,7,432,17667515.833333332,174.0,61.71428571428572
309006.0,6,6,412,4,272,103002.0,74.0,68.0,2,140,0.0,74.0,70.0
102741.0,17,2,286,2,286,0.0,143.0,143.0,0,0,0.0,0.0,0.0
119333761.0,6,293,34990,147,9924,817354.5273972603,140.0,67.51020408163265,146,25066,815878.5448275862,284.0,171.68493150684932
30042.0,6,14,4740,7,653,4795.833333333333,249.0,93.28571428571428,7,4087,4173.833333333333,1514.0,583.8571428571429
2391941.0,6,25,7589,14,3751,183995.4615384616,1514.0,267.92857142857144,11,3838,212897.4,1514.0,348.90909090909093
79155.0,6,14,4740,7,653,12882.666666666666,249.0,93.28571428571428,7,4087,12985.833333333334,1514.0,583.8571428571429
90016360.0,17,28,13364,28,13364,3333939.25925926,501.0,477.2857142857143,0,0,0.0,0.0,0.0
239488.0,6,12,1373,7,714,39914.66666666666,298.0,102.0,5,659,58162.5,379.0,131.8
120014126.0,6,17,1287,9,691,15001765.75,95.0,76.77777777777777,8,596,12858112.714285716,95.0,74.5
39451.0,17,4,823,2,163,0.0,89.0,81.5,2,660,0.0,443.0,330.0
349.0,17,2,250,1,93,0.0,93.0,93.0,1,157,0.0,157.0,157.0
46446.0,6,10,2032,5,524,11355.5,252.0,104.8,5,1508,9309.75,1236.0,301.6
135131025.0,17,6,1146,6,1146,27026205.0,191.0,191.0,0,0,0.0,0.0,0.0
196866.0,17,2,180,1,90,0.0,90.0,90.0,1,90,0.0,90.0,90.0
307837.0,6,6,412,4,272,102612.33333333331,74.0,68.0,2,140,0.0,74.0,70.0
108102842.0,17,5,1005,5,1005,27025710.5,201.0,201.0,0,0,0.0,0.0,0.0
2545409.0,6,25,7589,14,3751,195800.6923076923,1514.0,267.92857142857144,11,3838,228284.3,1514.0,348.90909090909093
245627.0,6,3,337,2,214,0.0,160.0,107.0,1,123,0.0,123.0,123.0
117001241.0,17,15,1169,8,606,16714463.0,174.0,75.75,7,563,17428772.333333332,174.0,80.42857142857143
75113110.0,6,9,842,9,842,9389138.75,97.0,93.55555555555556,0,0,0.0,0.0,0.0
13336.0,6,14,4740,7,653,2018.0,249.0,93.28571428571428,7,4087,2086.333333333333,1514.0,583.8571428571429
2598117.0,6,2,132,1,66,0.0,66.0,66.0,1,66,0.0,66.0,66.0
2056436.0,6,25,7065,13,2047,171369.66666666666,575.0,157.46153846153845,12,5018,159183.63636363635,1510.0,418.1666666666667
2689698.0,6,3,204,2,136,0.0,70.0,68.0,1,68,0.0,68.0,68.0
3127748.0,6,3,204,2,136,0.0,70.0,68.0,1,68,0.0,68.0,68.0
90257041.0,6,13,2036,8,1016,12893863.0,188.0,127.0,5,1020,22523233.25,204.0,204.0
135125368.0,17,6,1206,6,1206,27025073.6,201.0,201.0,0,0,0.0,0.0,0.0
148362.0,17,2,414,1,88,0.0,88.0,88.0,1,326,0.0,326.0,326.0
307.0,17,2,166,1,75,0.0,75.0,75.0,1,91,0.0,91.0,91.0
47998.0,6,14,4740,7,653,7876.333333333333,249.0,93.28571428571428,7,4087,6390.833333333333,1514.0,583.8571428571429
2709218.0,6,3,1777,2,951,0.0,885.0,475.5,1,826,0.0,826.0,826.0
119007457.0,17,14,864,7,432,19834576.166666668,174.0,61.71428571428572,7,432,19666830.5,174.0,61.71428571428572
305505.0,6,6,412,4,272,101835.0,74.0,68.0,2,140,0.0,74.0,70.0
90098584.0,6,10,1440,7,828,15016430.666666666,188.0,118.28571428571428,3,612,30033462.5,204.0,204.0
122805421.0,6,36,2602,19,1408,6822523.388888889,139.0,74.10526315789474,17,1194,7037808.125,123.0,70.23529411764706
15661.000000000002,6,14,4740,7,653,2317.0,249.0,93.28571428571428,7,4087,2474.833333333333,1514.0,583.8571428571429
228434.0,17,2,180,1,90,0.0,90.0,90.0,1,90,0.0,90.0,90.0
119662420.0,6,222,24974,111,17340,1085883.181818182,284.0,156.21621621621622,111,7634,1085883.8,140.0,68.77477477477477
45987.0,6,14,4740,7,653,7100.0,249.0,93.28571428571428,7,4087,7248.5,1514.0,583.8571428571429
2071.0,17,4,344,2,150,0.0,75.0,75.0,2,194,0.0,103.0,97.0
14637617.0,6,20,1607,10,975,1592754.2222222222,315.0,97.5,10,632,1592727.2222222222,78.0,63.2
120052685.0,17,29,13785,29,13785,4287595.892857143,501.0,475.3448275862069,0,0,0.0,0.0,0.0
2333.0,17,4,344,2,150,0.0,75.0,75.0,2,194,0.0,103.0,97.0
22178.0,6,10,2032,5,524,5186.0,252.0,104.8,5,1508,5201.5,1236.0,301.6
90307866.0,6,15,2074,8,1080,12901123.714285716,204.0,135.0,7,994,15024398.5,199.0,142.0
135141675.0,17,6,1146,6,1146,27028335.0,191.0,191.0,0,0,0.0,0.0,0.0
108109039.0,17,5,1005,5,1005,27027259.75,201.0,201.0,0,0,0.0,0.0,0.0
121435.0,6,3,337,2,214,0.0,160.0,107.0,1,123,0.0,123.0,123.0
841778.0,6,9,1118,6,586,168355.6,248.0,97.66666666666669,3,532,283207.5,392.0,177.33333333333334
196805.0,17,2,180,1,90,0.0,90.0,90.0,1,90,0.0,90.0,90.0
30778.0,6,12,1413,7,882,5129.666666666667,291.0,126.0,5,531,6873.75,259.0,106.2
1306417.0,6,4,264,2,132,0.0,66.0,66.0,2,132,0.0,66.0,66.0
0.0,6,1,66,1,66,0.0,66.0,66.0,0,0,0.0,0.0,0.0
120120871.0,6,13,2036,8,1016,17136855.14285714,188.0,127.0,5,1020,22523453.5,204.0,204.0
144454.0,6,2,132,1,66,0.0,66.0,66.0,1,66,0.0,66.0,66.0
21068.0,6,2,145,2,145,0.0,91.0,72.5,0,0,0.0,0.0,0.0
16945.0,17,2,180,1,90,0.0,90.0,90.0,1,90,0.0,90.0,90.0
28464.0,6,10,2032,5,524,6594.0,252.0,104.8,5,1508,6498.75,1236.0,301.6
296393.0,6,6,412,4,272,98797.66666666669,74.0,68.0,2,140,0.0,74.0,70.0
298.0,17,2,164,1,82,0.0,82.0,82.0,1,82,0.0,82.0,82.0
213622.0,17,2,180,1,90,0.0,90.0,90.0,1,90,0.0,90.0,90.0
10528.0,6,10,1067,5,536,2465.25,264.0,107.2,5,531,2434.0,259.0,106.2
20459.0,6,10,2032,5,524,4322.0,252.0,104.8,5,1508,4884.5,1236.0,301.6
1864707.0,6,5,336,2,134,0.0,68.0,67.0,3,202,158113.5,70.0,67.33333333333333
90031991.0,17,27,12943,27,12943,3462768.8846153845,501.0,479.3703703703704,0,0,0.0,0.0,0.0
34135.0,6,14,4740,7,653,5568.0,249.0,93.28571428571428,7,4087,5549.5,1514.0,583.8571428571429
146451.0,6,2,132,1,66,0.0,66.0,66.0,1,66,0.0,66.0,66.0
21277.0,6,14,4740,7,653,3372.333333333333,249.0,93.28571428571428,7,4087,3411.5,1514.0,583.8571428571429
38634.0,6,14,4740,7,653,5347.0,249.0,93.28571428571428,7,4087,6272.5,1514.0,583.8571428571429
100597118.0,17,12,516,6,258,20001416.6,43.0,43.0,6,258,20000174.2,43.0,43.0
10509331.0,6,7,478,4,272,3457396.0,74.0,68.0,3,206,5185972.0,74.0,68.66666666666667
303630.0,6,2,132,1,66,0.0,66.0,66.0,1,66,0.0,66.0,66.0
396082.0,6,2,132,1,66,0.0,66.0,66.0,1,66,0.0,66.0,66.0
3349.0,17,2,414,1,88,0.0,88.0,88.0,1,326,0.0,326.0,326.0
2071.0,17,4,344,2,150,0.0,75.0,75.0,2,194,0.0,103.0,97.0
90369835.0,6,13,2052,6,1224,18073728.2,204.0,204.0,7,828,15061400.166666666,188.0,118.28571428571428
52884.0,6,14,4740,7,653,8685.333333333334,249.0,93.28571428571428,7,4087,8675.833333333334,1514.0,583.8571428571429
403263.0,6,4,508,2,238,0.0,172.0,119.0,2,270,0.0,135.0,135.0
135134672.0,17,6,1146,6,1146,27026934.4,191.0,191.0,0,0,0.0,0.0,0.0
135132544.0,17,6,1206,6,1206,27026508.8,201.0,201.0,0,0,0.0,0.0,0.0
103145.0,17,2,286,2,286,0.0,143.0,143.0,0,0,0.0,0.0,0.0
52354.0,6,14,4740,7,653,8600.166666666666,249.0,93.28571428571428,7,4087,8580.166666666666,1514.0,583.8571428571429
50921.0,17,2,180,1,90,0.0,90.0,90.0,1,90,0.0,90.0,90.0
171572.0,17,2,180,1,90,0.0,90.0,90.0,1,90,0.0,90.0,90.0
324.0,17,2,174,1,79,0.0,79.0,79.0,1,95,0.0,95.0,95.0
557142.0,17,2,346,1,78,0.0,78.0,78.0,1,268,0.0,268.0,268.0
15990.999999999998,6,14,4740,7,653,2376.1666666666665,249.0,93.28571428571428,7,4087,2300.1666666666665,1514.0,583.8571428571429
165912.0,17,2,180,1,90,0.0,90.0,90.0,1,90,0.0,90.0,90.0
5624867.0,6,5,336,2,134,0.0,68.0,67.0,3,202,1419893.0,70.0,67.33333333333333
255319.00000000003,6,10,1221,6,636,51063.8,298.0,106.0,4,585,79372.33333333333,379.0,146.25
310.0,17,2,174,1,79,0.0,79.0,79.0,1,95,0.0,95.0,95.0
3175474.0,6,18,1495,9,921,359308.5,315.0,102.33333333333331,9,574,359236.875,78.0,63.77777777777778
342.0,17,2,166,1,75,0.0,75.0,75.0,1,91,0.0,91.0,91.0
530556.0,6,6,758,3,410,245930.0,172.0,136.66666666666666,3,348,192892.5,135.0,116.0
6497.0,17,2,582,1,83,0.0,83.0,83.0,1,499,0.0,499.0,499.0
106683.0,17,2,286,2,286,0.0,143.0,143.0,0,0,0.0,0.0,0.0
69483.0,6,14,4740,7,653,11418.833333333334,249.0,93.28571428571428,7,4087,11410.0,1514.0,583.8571428571429
135142403.0,17,6,1206,6,1206,27028480.6,201.0,201.0,0,0,0.0,0.0,0.0
204452.0,17,2,762,2,762,0.0,381.0,381.0,0,0,0.0,0.0,0.0
90259261.0,6,15,2444,8,1016,12894180.142857144,188.0,127.0,7,1428,15015712.666666666,204.0,204.0
0.0,17,1,381,1,381,0.0,381.0,381.0,0,0,0.0,0.0,0.0
1545.0,17,2,762,2,762,0.0,381.0,381.0,0,0,0.0,0.0,0.0
348.0,17,2,160,1,80,0.0,80.0,80.0,1,80,0.0,80.0,80.0
147185.0,6,3,337,2,214,0.0,160.0,107.0,1,123,0.0,123.0,123.0
311385.0,17,4,1400,4,1400,103795.0,350.0,350.0,0,0,0.0,0.0,0.0
39024.0,6,14,4740,7,653,5712.0,249.0,93.28571428571428,7,4087,6215.5,1514.0,583.8571428571429
306151.0,6,6,412,4,272,102050.33333333331,74.0,68.0,2,140,0.0,74.0,70.0
115086039.0,17,16,1212,8,606,16428715.285714284,174.0,75.75,8,606,16428710.714285716,174.0,75.75
10497115.0,6,7,478,4,272,3452147.333333333,74.0,68.0,3,206,5178125.0,74.0,68.66666666666667
309899.0,17,4,1400,4,1400,103299.66666666669,350.0,350.0,0,0,0.0,0.0,0.0
2334.0,17,4,344,2,150,0.0,75.0,75.0,2,194,0.0,103.0,97.0
108117334.0,17,5,1005,5,1005,27029333.5,201.0,201.0,0,0,0.0,0.0,0.0
114650397.0,6,47,3102,23,1518,5144119.227272728,66.0,66.0,24,1584,4984788.739130435,66.0,66.0
143810.0,17,2,180,1,90,0.0,90.0,90.0,1,90,0.0,90.0,90.0
436.0,17,2,267,1,83,0.0,83.0,83.0,1,184,0.0,184.0,184.0
228335.0,17,2,180,1,90,0.0,90.0,90.0,1,90,0.0,90.0,90.0
13609444.0,6,20,1607,10,975,1478916.111111111,315.0,97.5,10,632,1478889.5555555555,78.0,63.2
95780480.0,17,11,735,6,389,19124074.4,174.0,64.83333333333333,5,346,19014189.0,174.0,69.2
27102.0,6,14,4740,7,653,4054.0,249.0,93.28571428571428,7,4087,4007.0,1514.0,583.8571428571429
108206.0,17,2,286,2,286,0.0,143.0,143.0,0,0,0.0,0.0,0.0
302311.0,6,6,412,4,272,100770.33333333331,74.0,68.0,2,140,0.0,74.0,70.0
246405.0,6,3,337,2,214,0.0,160.0,107.0,1,123,0.0,123.0,123.0
204521.0,17,2,762,2,762,0.0,381.0,381.0,0,0,0.0,0.0,0.0
2339.0,17,4,344,2,150,0.0,75.0,75.0,2,194,0.0,103.0,97.0
345.0,17,2,267,1,83,0.0,83.0,83.0,1,184,0.0,184.0,184.0
90067926.0,17,28,13364,28,13364,3335849.111111111,501.0,477.2857142857143,0,0,0.0,0.0,0.0
33186.0,6,10,2032,5,524,7063.75,252.0,104.8,5,1508,7718.75,1236.0,301.6
284008.0,17,2,414,1,88,0.0,88.0,88.0,1,326,0.0,326.0,326.0
15632.0,6,10,2032,5,524,3292.5,252.0,104.8,5,1508,3194.5,1236.0,301.6
120008075.0,6,23,1734,12,935,10909012.0,95.0,77.91666666666667,11,799,11972960.4,95.0,72.63636363636364
200820.0,17,2,180,1,90,0.0,90.0,90.0,1,90,0.0,90.0,90.0
303633.0,6,2,132,1,66,0.0,66.0,66.0,1,66,0.0,66.0,66.0
2596969.0,6,2,132,1,66,0.0,66.0,66.0,1,66,0.0,66.0,66.0
2454.0,17,4,344,2,150,0.0,75.0,75.0,2,194,0.0,103.0,97.0
296.0,17,2,174,1,79,0.0,79.0,79.0,1,95,0.0,95.0,95.0
208110.0,17,4,6056,4,6056,69370.0,1514.0,1514.0,0,0,0.0,0.0,0.0
35039.0,6,14,4740,7,653,5659.0,249.0,93.28571428571428,7,4087,5140.833333333333,1514.0,583.8571428571429
3318089.0,6,130,99033,72,90903,46733.64788732395,1510.0,1262.5416666666667,58,8130,52661.22807017544,1510.0,140.17241379310346
217924.0,6,3,426,2,280,0.0,214.0,140.0,1,146,0.0,146.0,146.0
3833.0,17,2,224,1,76,0.0,76.0,76.0,1,148,0.0,148.0,148.0
109436984.0,6,356,43934,178,31890,617132.0734463277,336.0,179.1573033707865,178,12044,617132.1920903955,140.0,67.66292134831461
317776.0,17,4,1400,4,1400,105925.33333333331,350.0,350.0,0,0,0.0,0.0,0.0
0.0,17,1,453,1,453,0.0,453.0,453.0,0,0,0.0,0.0,0.0
1443212.0,6,4,276,2,128,0.0,74.0,64.0,2,148,0.0,74.0,74.0
246286.0,6,3,337,2,214,0.0,160.0,107.0,1,123,0.0,123.0,123.0
2028.0,17,4,344,2,150,0.0,75.0,75.0,2,194,0.0,103.0,97.0
256057.0,6,3,337,2,214,0.0,160.0,107.0,1,123,0.0,123.0,123.0
142.0,17,2,700,2,700,0.0,350.0,350.0,0,0,0.0,0.0,0.0
102847.0,17,2,286,2,286,0.0,143.0,143.0,0,0,0.0,0.0,0.0
115297719.0,6,215,24156,108,7350,1077548.7757009345,140.0,68.05555555555556,107,16806,1077933.5377358492,284.0,157.06542056074767
702199.0,17,6,1230,3,234,350908.5,78.0,78.0,3,996,350894.5,332.0,332.0
510844.0,6,4,270,2,134,0.0,68.0,67.0,2,136,0.0,70.0,68.0
553832.0,17,2,346,1,78,0.0,78.0,78.0,1,268,0.0,268.0,268.0
307.0,17,2,168,1,76,0.0,76.0,76.0,1,92,0.0,92.0,92.0
1030987.0,6,13,1386,7,789,171831.16666666666,253.0,112.71428571428572,6,597,204835.8,259.0,99.5
102984019.0,6,42,2772,21,1386,5135435.85,66.0,66.0,21,1386,5135438.5,66.0,66.0
102868.0,17,2,286,2,286,0.0,143.0,143.0,0,0,0.0,0.0,0.0
14464.0,17,2,156,1,78,0.0,78.0,78.0,1,78,0.0,78.0,78.0
104920155.0,6,30,2106,15,1089,7494296.785714285,123.0,72.6,15,1017,7478858.142857143,123.0,67.8
110759.0,17,4,1400,4,1400,36919.66666666666,350.0,350.0,0,0,0.0,0.0,0.0
892803.0,6,13,1420,7,789,147796.66666666666,253.0,112.71428571428572,6,631,177746.6,293.0,105.16666666666669
120085003.0,6,238,26754,119,8150,1010695.2881355932,140.0,68.4873949579832,119,18604,1011807.9237288137,284.0,156.3361344537815
232381.0,6,3,337,2,214,0.0,160.0,107.0,1,123,0.0,123.0,123.0
242187.0,6,3,337,2,214,0.0,160.0,107.0,1,123,0.0,123.0,123.0
2029.0,17,4,344,2,150,0.0,75.0,75.0,2,194,0.0,103.0,97.0
119488341.0,6,224,25344,112,17730,1074532.7297297297,284.0,158.30357142857142,112,7614,1074533.0900900902,140.0,67.98214285714286
240602.0,6,3,337,2,214,0.0,160.0,107.0,1,123,0.0,123.0,123.0
15963.999999999998,6,10,2032,5,524,3742.25,252.0,104.8,5,1508,3432.25,1236.0,301.6
302431.0,6,6,412,4,272,100810.33333333331,74.0,68.0,2,140,0.0,74.0,70.0
34409.0,6,14,4740,7,653,5085.333333333333,249.0,93.28571428571428,7,4087,5595.333333333333,1514.0,583.8571428571429
304177.0,17,2,238,1,74,0.0,74.0,74.0,1,164,0.0,164.0,164.0
867292.0,6,9,1270,6,799,173458.4,461.0,133.16666666666666,3,471,295717.0,331.0,157.0
90297142.0,6,16,1192,8,596,12892931.57142857,95.0,74.5,8,596,12898413.714285716,95.0,74.5
2771582.0,6,3,202,1,66,0.0,66.0,66.0,2,136,0.0,70.0,68.0
148199.0,17,2,180,1,90,0.0,90.0,90.0,1,90,0.0,90.0,90.0
112116897.0,6,211,23728,106,7218,1067779.9714285715,140.0,68.09433962264151,105,16510,1068204.4134615385,284.0,157.23809523809524
139433.0,6,2,132,1,66,0.0,66.0,66.0,1,66,0.0,66.0,66.0
109873852.0,6,35,2674,18,1411,6463167.764705882,139.0,78.38888888888889,17,1263,6853598.75,123.0,74.29411764705883
108107788.0,17,5,1005,5,1005,27026947.0,201.0,201.0,0,0,0.0,0.0,0.0
106249.0,17,2,286,2,286,0.0,143.0,143.0,0,0,0.0,0.0,0.0
108103932.0,17,5,1005,5,1005,27025983.0,201.0,201.0,0,0,0.0,0.0,0.0
1021105.0,6,11,1134,6,558,204221.0,220.0,93.0,5,576,254479.0,304.0,115.2
252512.0,17,4,6056,4,6056,84170.66666666666,1514.0,1514.0,0,0,0.0,0.0,0.0
118735091.0,6,35,2536,18,1248,6984417.117647059,123.0,69.33333333333333,17,1288,6923270.4375,139.0,75.76470588235294
110880974.0,6,33,2428,17,1288,6916578.5625,139.0,75.76470588235294,16,1140,7377684.666666667,123.0,71.25
298149.0,6,6,412,4,272,99383.0,74.0,68.0,2,140,0.0,74.0,70.0
90578733.0,6,15,2444,8,1016,12939819.0,188.0,127.0,7,1428,15060831.166666666,204.0,204.0
47585.0,6,14,4740,7,653,7426.666666666667,249.0,93.28571428571428,7,4087,7372.333333333333,1514.0,583.8571428571429
437070.0,6,11,1021,6,444,58631.8,162.0,74.0,5,577,73207.0,349.0,115.4
2112.0,17,4,344,2,150,0.0,75.0,75.0,2,194,0.0,103.0,97.0
90045596.0,17,27,12943,27,12943,3463292.153846154,501.0,479.3703703703704,0,0,0.0,0.0,0.0
481456.0,6,3,1604,1,753,0.0,753.0,753.0,2,851,0.0,785.0,425.5
358.0,17,2,267,1,83,0.0,83.0,83.0,1,184,0.0,184.0,184.0
25888.0,6,14,4740,7,653,3815.3333333333335,249.0,93.28571428571428,7,4087,3648.1666666666665,1514.0,583.8571428571429
102573410.0,17,14,864,7,432,17000164.5,174.0,61.71428571428572,7,432,17000840.5,174.0,61.71428571428572
350.0,17,2,267,1,83,0.0,83.0,83.0,1,184,0.0,184.0,184.0
113442255.0,6,29,1914,15,948,8103018.214285715,123.0,63.2,14,966,7941633.692307692,123.0,69.0
243633.0,6,3,337,2,214,0.0,160.0,107.0,1,123,0.0,123.0,123.0
235817.0,6,3,337,2,214,0.0,160.0,107.0,1,123,0.0,123.0,123.0
287180.0,17,2,359,1,75,0.0,75.0,75.0,1,284,0.0,284.0,284.0
214080.0,17,2,876,2,876,0.0,438.0,438.0,0,0,0.0,0.0,0.0
301596.0,6,6,412,4,272,100532.0,74.0,68.0,2,140,0.0,74.0,70.0
16865.0,17,2,180,1,90,0.0,90.0,90.0,1,90,0.0,90.0,90.0
261454.00000000003,17,2,180,1,70,0.0,70.0,70.0,1,110,0.0,110.0,110.0
155826.0,6,3,337,2,214,0.0,160.0,107.0,1,123,0.0,123.0,123.0
135815.0,6,2,132,1,66,0.0,66.0,66.0,1,66,0.0,66.0,66.0
3362016.0,6,7,923,4,753,1048461.6666666666,571.0,188.25,3,170,1573304.5,62.0,56.66666666666666
26303.0,6,14,4740,7,653,3993.6666666666665,249.0,93.28571428571428,7,4087,4239.5,1514.0,583.8571428571429
108107580.0,17,5,1005,5,1005,27026895.0,201.0,201.0,0,0,0.0,0.0,0.0
21078.0,6,14,4740,7,653,3041.6666666666665,249.0,93.28571428571428,7,4087,3373.6666666666665,1514.0,583.8571428571429
118603746.0,6,254,28620,127,19942,939592.4761904762,284.0,157.0236220472441,127,8678,939592.6746031746,140.0,68.33070866141732
90254940.0,6,13,2036,8,1016,12893562.857142856,188.0,127.0,5,1020,22522227.25,204.0,204.0
0.0,17,1,438,1,438,0.0,438.0,438.0,0,0,0.0,0.0,0.0
38806.0,6,10,2032,5,524,9371.5,252.0,104.8,5,1508,8768.5,1236.0,301.6
0.0,6,1,66,1,66,0.0,66.0,66.0,0,0,0.0,0.0,0.0
304713.0,6,6,412,4,272,101571.0,74.0,68.0,2,140,0.0,74.0,70.0
101566.0,17,2,286,2,286,0.0,143.0,143.0,0,0,0.0,0.0,0.0
879054.0,6,12,2710,7,743,146509.0,339.0,106.14285714285714,5,1967,151611.0,1514.0,393.4
135123429.0,17,6,1146,6,1146,27024685.8,191.0,191.0,0,0,0.0,0.0,0.0
207378.0,17,2,180,1,90,0.0,90.0,90.0,1,90,0.0,90.0,90.0
2923.0,17,4,438,2,148,0.0,74.0,74.0,2,290,0.0,147.0,145.0
44749.0,6,14,4740,7,653,7334.333333333333,249.0,93.28571428571428,7,4087,6888.333333333333,1514.0,583.8571428571429
133007207.0,17,15,907,8,475,19001029.57142857,174.0,59.375,7,432,18833502.33333333,174.0,61.71428571428572
50923.0,6,14,4740,7,653,7259.166666666667,249.0,93.28571428571428,7,4087,8310.333333333334,1514.0,583.8571428571429
107789.0,17,2,286,2,286,0.0,143.0,143.0,0,0,0.0,0.0,0.0
159608.0,6,3,337,2,214,0.0,160.0,107.0,1,123,0.0,123.0,123.0
93022360.0,6,38,2508,19,1254,5167895.0,66.0,66.0,19,1254,5167895.5,66.0,66.0
2598279.0,6,2,132,1,66,0.0,66.0,66.0,1,66,0.0,66.0,66.0
94032406.0,17,12,778,6,389,18804043.4,174.0,64.83333333333333,6,389,18800165.4,174.0,64.83333333333333
108103433.0,17,5,1005,5,1005,27025858.25,201.0,201.0,0,0,0.0,0.0,0.0
135132002.0,17,6,1206,6,1206,27026400.4,201.0,201.0,0,0,0.0,0.0,0.0
166694.0,17,2,180,1,90,0.0,90.0,90.0,1,90,0.0,90.0,90.0
2797317.0,6,2,132,1,66,0.0,66.0,66.0,1,66,0.0,66.0,66.0
203308.0,17,4,6056,4,6056,67769.33333333333,1514.0,1514.0,0,0,0.0,0.0,0.0
15551.0,6,10,1066,5,490,2990.75,218.0,98.0,5,576,3694.5,304.0,115.2
90761509.0,6,19,1436,10,745,10080077.555555556,95.0,74.5,9,691,11343557.75,95.0,76.77777777777777
298367.0,6,6,412,4,272,99455.66666666669,74.0,68.0,2,140,0.0,74.0,70.0
104065504.0,6,227,25822,114,18142,920933.663716814,300.0,159.140350877193,113,7680,919921.6160714284,140.0,67.96460176991151
90054182.0,17,28,13364,28,13364,3335340.074074074,501.0,477.2857142857143,0,0,0.0,0.0,0.0
31065.0,6,14,4740,7,653,5052.5,249.0,93.28571428571428,7,4087,4623.333333333333,1514.0,583.8571428571429
106794.0,17,2,286,2,286,0.0,143.0,143.0,0,0,0.0,0.0,0.0
14356.0,17,2,180,1,90,0.0,90.0,90.0,1,90,0.0,90.0,90.0
40942485.0,6,4,270,3,202,20471242.5,70.0,67.33333333333333,1,68,0.0,68.0,68.0
1306966.0,6,4,264,2,132,0.0,66.0,66.0,2,132,0.0,66.0,66.0
234655.0,17,2,180,1,90,0.0,90.0,90.0,1,90,0.0,90.0,90.0
120006067.0,6,17,1287,9,691,15000758.375,95.0,76.77777777777777,8,596,12858032.57142857,95.0,74.5
198366.0,17,2,180,1,90,0.0,90.0,90.0,1,90,0.0,90.0,90.0
103914.0,17,4,1400,4,1400,34638.0,350.0,350.0,0,0,0.0,0.0,0.0
5829902.0,6,5,336,2,134,0.0,68.0,67.0,3,202,1526559.0,70.0,67.33333333333333
2783464.0,6,3,1777,1,826,0.0,826.0,826.0,2,951,0.0,885.0,475.5
90022106.0,17,28,13364,28,13364,3334152.074074074,501.0,477.2857142857143,0,0,0.0,0.0,0.0
198283.0,17,2,180,1,90,0.0,90.0,90.0,1,90,0.0,90.0,90.0
840142.0,6,9,1096,6,625,168028.4,287.0,104.16666666666669,3,471,282539.5,331.0,157.0
24996.0,6,11,2098,6,590,3487.0,252.0,98.33333333333331,5,1508,5887.0,1236.0,301.6
438903.0,6,11,1021,6,444,58994.8,162.0,74.0,5,577,73551.75,349.0,115.4
2208.0,17,4,438,2,148,0.0,74.0,74.0,2,290,0.0,147.0,145.0
1321001.0,17,7,490,7,490,220166.8333333333,70.0,70.0,0,0,0.0,0.0,0.0
299863.0,6,6,412,4,272,99954.33333333331,74.0,68.0,2,140,0.0,74.0,70.0
218277.0,17,2,180,1,90,0.0,90.0,90.0,1,90,0.0,90.0,90.0
308149.0,6,6,412,4,272,102716.33333333331,74.0,68.0,2,140,0.0,74.0,70.0
100240213.0,17,12,516,6,258,20002706.8,43.0,43.0,6,258,20000227.8,43.0,43.0
315.0,17,2,208,1,72,0.0,72.0,72.0,1,136,0.0,136.0,136.0
120164298.0,6,230,25978,115,7886,1046867.1140350878,140.0,68.57391304347826,115,18092,1046503.1315789474,284.0,157.3217391304348
9922.0,17,2,582,1,83,0.0,83.0,83.0,1,499,0.0,499.0,499.0
212634.0,6,10,1221,6,636,42526.8,298.0,106.0,4,585,69817.0,379.0,146.25
90285570.0,6,16,1192,8,596,12891837.714285716,95.0,74.5,8,596,12896075.857142856,95.0,74.5
1970.0,17,4,344,2,150,0.0,75.0,75.0,2,194,0.0,103.0,97.0
155541.0,6,3,337,2,214,0.0,160.0,107.0,1,123,0.0,123.0,123.0
2391.0,17,2,762,2,762,0.0,381.0,381.0,0,0,0.0,0.0,0.0
72331.0,6,14,4740,7,653,8474.833333333334,249.0,93.28571428571428,7,4087,11088.5,1514.0,583.8571428571429
266579.0,6,12,1373,7,714,44429.833333333336,298.0,102.0,5,659,65829.5,379.0,131.8
204428.0,17,2,762,2,762,0.0,381.0,381.0,0,0,0.0,0.0,0.0
18403.0,6,13,1459,7,862,2852.0,271.0,123.14285714285714,6,597,3474.6,259.0,99.5
220720.0,6,10,1221,6,636,44144.0,298.0,106.0,4,585,72396.0,379.0,146.25
303103.0,6,2,132,1,66,0.0,66.0,66.0,1,66,0.0,66.0,66.0
347170.0,6,5,337,2,163,0.0,97.0,81.5,3,174,173585.0,66.0,58.0
112618.0,17,2,286,2,286,0.0,143.0,143.0,0,0,0.0,0.0,0.0
108102944.0,17,5,1005,5,1005,27025736.0,201.0,201.0,0,0,0.0,0.0,0.0
102153.0,17,2,762,2,762,0.0,381.0,381.0,0,0,0.0,0.0,0.0
216967.0,6,3,426,2,280,0.0,214.0,140.0,1,146,0.0,146.0,146.0
28900.0,6,10,2032,5,524,6994.25,252.0,104.8,5,1508,5011.0,1236.0,301.6
206438.0,6,3,426,2,280,0.0,214.0,140.0,1,146,0.0,146.0,146.0
101803.0,17,2,762,2,762,0.0,381.0,381.0,0,0,0.0,0.0,0.0
2470.0,17,4,344,2,150,0.0,75.0,75.0,2,194,0.0,103.0,97.0
90259872.0,6,12,1832,8,1016,12894267.42857143,188.0,127.0,4,816,30031434.666666668,204.0,204.0
32563.0,6,10,2032,5,524,6856.0,252.0,104.8,5,1508,7495.0,1236.0,301.6
42262.0,6,14,4740,7,653,6838.5,249.0,93.28571428571428,7,4087,6220.666666666667,1514.0,583.8571428571429
42184.0,6,12,1320,6,723,8023.4,253.0,120.5,6,597,7661.0,259.0,99.5
27364.0,6,10,2032,5,524,6516.25,252.0,104.8,5,1508,5772.75,1236.0,301.6
1144.0,17,2,250,1,93,0.0,93.0,93.0,1,157,0.0,157.0,157.0
2432.0,17,4,344,2,150,0.0,75.0,75.0,2,194,0.0,103.0,97.0
120110891.0,6,226,25656,113,7680,1055955.919642857,140.0,67.96460176991151,113,17976,1066208.4464285714,374.0,159.0796460176991
103372.0,17,2,286,2,286,0.0,143.0,143.0,0,0,0.0,0.0,0.0
1159290.0,6,13,3010,8,2382,165612.85714285713,1514.0,297.75,5,628,220886.25,331.0,125.6
37702029.0,17,9,3078,9,3078,4712753.625,342.0,342.0,0,0,0.0,0.0,0.0
156126.0,6,3,337,2,214,0.0,160.0,107.0,1,123,0.0,123.0,123.0
213752.0,17,2,180,1,90,0.0,90.0,90.0,1,90,0.0,90.0,90.0
124509693.0,17,15,1169,7,563,17500157.0,174.0,80.42857142857143,8,606,17715112.285714287,174.0,75.75
447806.0,17,4,360,2,140,0.0,70.0,70.0,2,220,0.0,110.0,110.0
216333.0,17,2,180,1,90,0.0,90.0,90.0,1,90,0.0,90.0,90.0
316914.0,17,4,1400,4,1400,105638.0,350.0,350.0,0,0,0.0,0.0,0.0
849374.0,6,9,1096,6,625,169874.8,287.0,104.16666666666669,3,471,286681.0,331.0,157.0
231638.0,6,3,337,2,214,0.0,160.0,107.0,1,123,0.0,123.0,123.0
135132583.0,17,6,1146,6,1146,27026516.6,191.0,191.0,0,0,0.0,0.0,0.0
29249.0,6,11,2098,6,590,5204.0,252.0,98.33333333333331,5,1508,4662.0,1236.0,301.6
284643.0,17,2,363,1,79,0.0,79.0,79.0,1,284,0.0,284.0,284.0
3780935.0,6,5,336,2,134,0.0,68.0,67.0,3,202,1527433.0,70.0,67.33333333333333
120129166.0,6,14,2224,9,1204,15016145.75,188.0,133.77777777777777,5,1020,22523332.0,204.0,204.0
17654.0,6,10,2032,5,524,3746.75,252.0,104.8,5,1508,3845.25,1236.0,301.6
107457.0,17,2,286,2,286,0.0,143.0,143.0,0,0,0.0,0.0,0.0
90214343.0,6,17,1287,8,596,12853206.57142857,95.0,74.5,9,691,11251128.25,95.0,76.77777777777777
315.0,17,2,174,1,79,0.0,79.0,79.0,1,95,0.0,95.0,95.0
47606809.0,6,8,1940,3,887,22371511.0,753.0,295.6666666666667,5,1053,11259057.5,785.0,210.6
302386.0,6,2,132,1,66,0.0,66.0,66.0,1,66,0.0,66.0,66.0
46939.0,6,14,4740,7,653,7664.166666666667,249.0,93.28571428571428,7,4087,6640.5,1514.0,583.8571428571429
307430.0,6,6,412,4,272,102476.66666666669,74.0,68.0,2,140,0.0,74.0,70.0
206393.0,6,3,426,2,280,0.0,214.0,140.0,1,146,0.0,146.0,146.0
413.0,17,2,410,1,78,0.0,78.0,78.0,1,332,0.0,332.0,332.0
216357.0,17,2,180,1,90,0.0,90.0,90.0,1,90,0.0,90.0,90.0
2637739.0,6,3,204,2,136,0.0,70.0,68.0,1,68,0.0,68.0,68.0
117001174.0,17,13,821,7,432,19500195.666666668,174.0,61.71428571428572,6,389,19404189.8,174.0,64.83333333333333
115413892.0,6,31,2160,16,1071,7694259.466666667,123.0,66.9375,15,1089,7679519.571428572,123.0,72.6
100209768.0,17,12,778,6,389,20001399.8,174.0,64.83333333333333,6,389,20000177.0,174.0,64.83333333333333
297.0,17,2,156,1,78,0.0,78.0,78.0,1,78,0.0,78.0,78.0
14646990.0,6,20,1607,10,975,1593243.2222222222,315.0,97.5,10,632,1593215.0,78.0,63.2
14727.0,6,10,2032,5,524,3431.0,252.0,104.8,5,1508,3266.0,1236.0,301.6
1153323.0,6,13,3020,8,2392,164760.42857142858,1514.0,299.0,5,628,220172.25,331.0,125.6
529444.0,6,11,1287,6,636,105888.8,298.0,106.0,5,651,131684.75,379.0,130.2
298141.0,6,6,412,4,272,99380.33333333331,74.0,68.0,2,140,0.0,74.0,70.0
35099.0,6,14,4740,7,653,5274.0,249.0,93.28571428571428,7,4087,4940.166666666667,1514.0,583.8571428571429
28330.0,6,14,4740,7,653,4221.833333333333,249.0,93.28571428571428,7,4087,4338.0,1514.0,583.8571428571429
119861145.0,17,35,16705,35,16705,3525327.794117647,501.0,477.2857142857143,0,0,0.0,0.0,0.0
21822.0,17,2,582,1,83,0.0,83.0,83.0,1,499,0.0,499.0,499.0
120506261.0,6,216,24440,109,17156,1115798.712962963,284.0,157.39449541284404,107,7284,1116716.3207547169,140.0,68.07476635514018
3485054.0,6,7,923,4,753,1089644.3333333333,571.0,188.25,3,170,1633647.5,62.0,56.66666666666666
146073.0,6,3,337,2,214,0.0,160.0,107.0,1,123,0.0,123.0,123.0
13621353.0,6,20,1607,10,975,1479019.111111111,315.0,97.5,10,632,1478989.2222222222,78.0,63.2
15994287.0,17,6,2052,6,2052,3198857.4,342.0,342.0,0,0,0.0,0.0,0.0
121219471.0,6,36,2602,19,1408,6734415.055555556,139.0,74.10526315789474,17,1194,6938635.0625,123.0,70.23529411764706
105008874.0,17,14,864,7,432,17501479.0,174.0,61.71428571428572,7,432,17333494.833333332,174.0,61.71428571428572
613296.0,17,4,820,2,156,0.0,78.0,78.0,2,664,0.0,332.0,332.0
108102461.0,17,5,955,5,955,27025615.25,191.0,191.0,0,0,0.0,0.0,0.0
51175.0,6,14,4740,7,653,7169.166666666667,249.0,93.28571428571428,7,4087,8031.166666666667,1514.0,583.8571428571429
46794255.0,6,8,1940,3,887,22142342.0,753.0,295.6666666666667,5,1053,11003175.0,785.0,210.6
1094919.0,6,13,1386,7,789,182486.5,253.0,112.71428571428572,6,597,215460.2,259.0,99.5
125823594.0,6,60,12393,30,6505,3314930.6896551726,1514.0,216.8333333333333,30,5888,4331285.724137931,1514.0,196.26666666666668
12323664.0,6,26,7584,14,1983,947974.153846154,408.0,141.64285714285714,12,5601,743678.0909090909,1514.0,466.75
153436.0,17,2,180,1,90,0.0,90.0,90.0,1,90,0.0,90.0,90.0
37942.0,6,14,4740,7,653,5843.833333333333,249.0,93.28571428571428,7,4087,5744.5,1514.0,583.8571428571429
2997421.0,6,12,2172,7,664,499479.6666666667,252.0,94.85714285714286,5,1508,1661.75,1236.0,301.6
228150.0,17,2,180,1,90,0.0,90.0,90.0,1,90,0.0,90.0,90.0
837.0,17,4,438,2,148,0.0,74.0,74.0,2,290,0.0,147.0,145.0
75139901.0,6,9,842,9,842,9392487.625,97.0,93.55555555555556,0,0,0.0,0.0,0.0
293831.0,17,2,246,1,76,0.0,76.0,76.0,1,170,0.0,170.0,170.0
242231.0,6,3,337,2,214,0.0,160.0,107.0,1,123,0.0,123.0,123.0
3826.0,17,4,344,2,150,0.0,75.0,75.0,2,194,0.0,103.0,97.0
1035064.0,6,11,1131,6,600,206801.2,262.0,100.0,5,531,258555.75,259.0,106.2
297475.0,6,6,412,4,272,99158.33333333331,74.0,68.0,2,140,0.0,74.0,70.0
2393.0,17,4,344,2,150,0.0,75.0,75.0,2,194,0.0,103.0,97.0
207205.0,6,3,426,2,280,0.0,214.0,140.0,1,146,0.0,146.0,146.0
1026301.0,6,11,1134,6,558,205260.2,220.0,93.0,5,576,255618.75,304.0,115.2
107440841.0,6,32,2374,17,1288,6702270.75,139.0,75.76470588235294,15,1086,7659731.071428572,123.0,72.4
99926.0,17,2,762,2,762,0.0,381.0,381.0,0,0,0.0,0.0,0.0
26855.0,6,14,4740,7,653,3718.0,249.0,93.28571428571428,7,4087,4114.833333333333,1514.0,583.8571428571429
90297234.0,6,16,1192,8,596,12892613.857142856,95.0,74.5,8,596,12898367.857142856,95.0,74.5
4580.0,17,2,180,1,90,0.0,90.0,90.0,1,90,0.0,90.0,90.0
99732.0,6,15,4806,8,719,13829.714285714286,249.0,89.875,7,4087,16230.166666666666,1514.0,583.8571428571429
322189.0,17,4,1400,4,1400,107396.33333333331,350.0,350.0,0,0,0.0,0.0,0.0
5754797.0,6,5,336,2,134,0.0,68.0,67.0,3,202,1525588.5,70.0,67.33333333333333
38141.0,6,11,2098,6,590,7180.0,252.0,98.33333333333331,5,1508,8956.5,1236.0,301.6
233161.0,6,3,337,2,214,0.0,160.0,107.0,1,123,0.0,123.0,123.0
1917858.0,6,20,7599,11,1469,191785.8,583.0,133.54545454545453,9,6130,206521.0,1484.0,681.1111111111111
1015.0,17,2,267,1,83,0.0,83.0,83.0,1,184,0.0,184.0,184.0
2021862.0,17,4,525,2,150,0.0,75.0,75.0,2,375,0.0,284.0,187.5
1180245.0,6,13,3017,8,2389,168606.42857142858,1514.0,298.625,5,628,226858.25,331.0,125.6
509090.00000000006,6,5,336,2,134,0.0,68.0,67.0,3,202,193144.0,70.0,67.33333333333333
135129324.0,17,6,1146,6,1146,27025864.8,191.0,191.0,0,0,0.0,0.0,0.0
32935.0,6,10,2032,5,524,5604.0,252.0,104.8,5,1508,7974.75,1236.0,301.6
120190905.0,6,240,27088,120,8216,1002920.3529411764,140.0,68.46666666666667,120,18872,1003172.6974789916,284.0,157.26666666666668
2600088.0,6,3,1777,2,951,0.0,885.0,475.5,1,826,0.0,826.0,826.0
322.0,17,2,174,1,79,0.0,79.0,79.0,1,95,0.0,95.0,95.0
888104.0,17,2,246,1,76,0.0,76.0,76.0,1,170,0.0,170.0,170.0
18671.0,6,2,145,2,145,0.0,91.0,72.5,0,0,0.0,0.0,0.0
108107027.0,17,5,1005,5,1005,27026756.75,201.0,201.0,0,0,0.0,0.0,0.0
5624050.0,6,4,270,2,134,0.0,68.0,67.0,2,136,0.0,70.0,68.0
1840657.0,6,4,492,2,280,0.0,214.0,140.0,2,212,0.0,146.0,106.0
121344.0,6,3,337,2,214,0.0,160.0,107.0,1,123,0.0,123.0,123.0
41715.0,6,10,2032,5,524,10169.25,252.0,104.8,5,1508,9995.75,1236.0,301.6
21994.0,6,14,4740,7,653,3545.833333333333,249.0,93.28571428571428,7,4087,3531.333333333333,1514.0,583.8571428571429
893931.0,6,12,2708,7,742,148988.5,338.0,106.0,5,1966,154564.0,1514.0,393.2
135135814.0,17,6,1146,6,1146,27027162.8,191.0,191.0,0,0,0.0,0.0,0.0
10513830.0,6,7,478,4,272,3458961.6666666665,74.0,68.0,3,206,5188310.5,74.0,68.66666666666667
120143492.0,6,234,26454,117,7944,1028628.0689655172,140.0,67.8974358974359,117,18510,1028521.7672413794,284.0,158.2051282051282
10421213.0,6,6,412,3,206,5142206.0,74.0,68.66666666666667,3,206,5142086.5,74.0,68.66666666666667
10425158.0,6,7,478,4,272,3429514.333333333,74.0,68.0,3,206,5144144.5,74.0,68.66666666666667
307452.0,6,6,412,4,272,102484.0,74.0,68.0,2,140,0.0,74.0,70.0
14649544.0,6,20,1648,10,1016,1592663.4444444445,315.0,101.6,10,632,1592633.888888889,78.0,63.2
138358.0,6,15,4806,8,719,19032.0,249.0,89.875,7,4087,22731.33333333333,1514.0,583.8571428571429
106043370.0,6,44,2904,22,1452,5049684.285714285,66.0,66.0,22,1452,5034714.666666667,66.0,66.0
0.0,17,1,179,1,179,0.0,179.0,179.0,0,0,0.0,0.0,0.0
103739.0,17,2,286,2,286,0.0,143.0,143.0,0,0,0.0,0.0,0.0
196875.0,17,2,180,1,90,0.0,90.0,90.0,1,90,0.0,90.0,90.0
33227.0,6,14,4740,7,653,5429.5,249.0,93.28571428571428,7,4087,5193.833333333333,1514.0,583.8571428571429
232066.0,6,3,337,2,214,0.0,160.0,107.0,1,123,0.0,123.0,123.0
120404390.0,6,227,25770,114,18016,1065525.575221239,300.0,158.03508771929825,113,7754,1065773.8035714286,140.0,68.61946902654867
205981.0,6,3,426,2,280,0.0,214.0,140.0,1,146,0.0,146.0,146.0
205716.0,17,2,180,1,90,0.0,90.0,90.0,1,90,0.0,90.0,90.0
761151.0,6,11,1131,6,600,151401.2,262.0,100.0,5,531,189466.0,259.0,106.2
113000966.0,17,13,821,7,432,18833494.33333333,174.0,61.71428571428572,6,389,18601067.2,174.0,64.83333333333333
99979478.0,17,12,778,6,389,19938623.4,174.0,64.83333333333333,6,389,19963703.0,174.0,64.83333333333333
206621.0,6,3,426,2,280,0.0,214.0,140.0,1,146,0.0,146.0,146.0
135135458.0,17,6,1206,6,1206,27027091.6,201.0,201.0,0,0,0.0,0.0,0.0
4990.0,17,4,344,2,150,0.0,75.0,75.0,2,194,0.0,103.0,97.0
106243.0,17,2,286,2,286,0.0,143.0,143.0,0,0,0.0,0.0,0.0
54697.0,6,14,4740,7,653,8991.0,249.0,93.28571428571428,7,4087,8978.333333333334,1514.0,583.8571428571429
1515.0,17,2,176,1,80,0.0,80.0,80.0,1,96,0.0,96.0,96.0
27416.0,6,14,4740,7,653,4451.666666666667,249.0,93.28571428571428,7,4087,4430.666666666667,1514.0,583.8571428571429
217573.0,17,2,180,1,90,0.0,90.0,90.0,1,90,0.0,90.0,90.0
120194559.0,6,234,26454,117,7944,1029066.301724138,140.0,67.8974358974359,117,18510,1020147.9827586206,284.0,158.2051282051282
7037.0,17,2,582,1,83,0.0,83.0,83.0,1,499,0.0,499.0,499.0
0.0,17,1,55,1,55,0.0,55.0,55.0,0,0,0.0,0.0,0.0
304511.0,17,4,704,2,148,0.0,74.0,74.0,2,556,0.0,280.0,278.0
308065.0,6,6,412,4,272,102688.33333333331,74.0,68.0,2,140,0.0,74.0,70.0
42895.0,6,14,4740,7,653,5445.666666666667,249.0,93.28571428571428,7,4087,7010.666666666667,1514.0,583.8571428571429
217805.0,6,3,426,2,280,0.0,214.0,140.0,1,146,0.0,146.0,146.0
2084.0,17,4,344,2,150,0.0,75.0,75.0,2,194,0.0,103.0,97.0
90044311.0,17,27,12943,27,12943,3463242.730769231,501.0,479.3703703703704,0,0,0.0,0.0,0.0
20936584.0,17,3,1034,2,684,0.0,342.0,342.0,1,350,0.0,350.0,350.0
1355.0,17,4,438,2,148,0.0,74.0,74.0,2,290,0.0,147.0,145.0
118909998.0,6,34,2334,17,1209,7431874.875,123.0,71.11764705882354,17,1125,7418395.25,123.0,66.17647058823529
2802209.0,6,2,132,1,66,0.0,66.0,66.0,1,66,0.0,66.0,66.0
90768602.0,6,20,1531,11,840,9071754.0,95.0,76.36363636363636,9,691,11345247.625,95.0,76.77777777777777
46371.0,6,14,4740,7,653,7461.833333333333,249.0,93.28571428571428,7,4087,7155.833333333333,1514.0,583.8571428571429
306657.0,6,6,412,4,272,102219.0,74.0,68.0,2,140,0.0,74.0,70.0
100322685.0,17,12,516,6,258,20000144.8,43.0,43.0,6,258,20001021.4,43.0,43.0
97099.0,17,2,762,2,762,0.0,381.0,381.0,0,0,0.0,0.0,0.0
43439.0,6,14,4740,7,653,6674.0,249.0,93.28571428571428,7,4087,6690.166666666667,1514.0,583.8571428571429
138373.0,6,3,214,2,140,0.0,74.0,70.0,1,74,0.0,74.0,74.0
29531.0,6,14,4740,7,653,4813.333333333333,249.0,93.28571428571428,7,4087,4415.666666666667,1514.0,583.8571428571429
1885.0,17,2,176,1,80,0.0,80.0,80.0,1,96,0.0,96.0,96.0
3080036.0,6,3,204,1,68,0.0,68.0,68.0,2,136,0.0,70.0,68.0
85818.0,6,10,1065,5,534,21152.75,262.0,106.8,5,531,18789.5,259.0,106.2
135126919.0,17,6,1146,6,1146,27025383.8,191.0,191.0,0,0,0.0,0.0,0.0
213587.0,17,2,180,1,90,0.0,90.0,90.0,1,90,0.0,90.0,90.0
202043.0,17,2,180,1,90,0.0,90.0,90.0,1,90,0.0,90.0,90.0
4461.0,17,2,618,1,72,0.0,72.0,72.0,1,546,0.0,546.0,546.0
10610.0,6,10,2032,5,524,2409.75,252.0,104.8,5,1508,2357.0,1236.0,301.6
146929.0,6,3,373,2,238,0.0,172.0,119.0,1,135,0.0,135.0,135.0
113164799.0,6,46,3036,23,1518,5143842.0,66.0,66.0,23,1518,5143842.2727272725,66.0,66.0
226044.0,6,12,1373,7,714,37674.0,298.0,102.0,5,659,55393.5,379.0,131.8
1015274.0,6,11,1134,6,558,203054.8,220.0,93.0,5,576,253348.25,304.0,115.2
205639.0,6,10,1221,6,636,41127.8,298.0,106.0,4,585,67377.66666666667,379.0,146.25
280978.0,17,2,414,1,88,0.0,88.0,88.0,1,326,0.0,326.0,326.0
64316.0,6,14,4740,7,653,10084.0,249.0,93.28571428571428,7,4087,10432.666666666666,1514.0,583.8571428571429
51640.0,6,14,4740,7,653,7909.0,249.0,93.28571428571428,7,4087,6373.833333333333,1514.0,583.8571428571429
148185.0,6,3,373,2,238,0.0,172.0,119.0,1,135,0.0,135.0,135.0
90471979.0,6,20,1490,11,840,9043138.6,95.0,76.36363636363636,9,650,11303687.0,95.0,72.22222222222223
69936.0,6,10,2032,5,524,17286.0,252.0,104.8,5,1508,17149.0,1236.0,301.6
111248907.0,17,15,1169,7,563,18514993.5,174.0,80.42857142857143,8,606,15870339.857142856,174.0,75.75
217214.0,17,2,180,1,90,0.0,90.0,90.0,1,90,0.0,90.0,90.0
10134.0,17,4,823,2,163,0.0,89.0,81.5,2,660,0.0,443.0,330.0
302993.0,6,10,1221,6,636,60598.6,298.0,106.0,4,585,95100.33333333331,379.0,146.25
90025285.0,17,28,13364,28,13364,3334269.814814815,501.0,477.2857142857143,0,0,0.0,0.0,0.0
147938.0,17,2,180,1,90,0.0,90.0,90.0,1,90,0.0,90.0,90.0
17159.0,6,11,1132,6,556,2756.8,218.0,92.66666666666669,5,576,3466.5,304.0,115.2
14442666.0,6,20,1607,10,975,1570129.111111111,315.0,97.5,10,632,1570092.5555555555,78.0,63.2
2815798.0,17,2,876,2,876,0.0,438.0,438.0,0,0,0.0,0.0,0.0
108102193.0,17,5,955,5,955,27025548.25,191.0,191.0,0,0,0.0,0.0,0.0
146515.0,6,3,337,2,214,0.0,160.0,107.0,1,123,0.0,123.0,123.0
2692545.0,6,4,1670,2,819,0.0,753.0,409.5,2,851,0.0,785.0,425.5
2973380.0,6,3,1777,2,951,0.0,885.0,475.5,1,826,0.0,826.0,826.0
114279736.0,6,48,3168,24,1584,4968684.173913044,66.0,66.0,24,1584,4955253.782608695,66.0,66.0
121003634.0,6,36,2602,19,1408,6722424.111111111,139.0,74.10526315789474,17,1194,6925729.75,123.0,70.23529411764706
448651.0,6,10,1221,6,636,89730.2,298.0,106.0,4,585,148712.66666666666,379.0,146.25
212210.0,17,4,1400,4,1400,70736.66666666667,350.0,350.0,0,0,0.0,0.0,0.0
5568.0,17,2,762,2,762,0.0,381.0,381.0,0,0,0.0,0.0,0.0
20920653.0,17,3,1034,2,684,0.0,342.0,342.0,1,350,0.0,350.0,350.0
108107852.0,17,5,1005,5,1005,27026963.0,201.0,201.0,0,0,0.0,0.0,0.0
98415.0,17,2,762,2,762,0.0,381.0,381.0,0,0,0.0,0.0,0.0
104074614.0,6,44,2904,22,1452,4955934.0,66.0,66.0,22,1452,4940291.904761905,66.0,66.0
233151.0,6,3,337,2,214,0.0,160.0,107.0,1,123,0.0,123.0,123.0
90683168.0,6,21,1585,10,745,10075907.555555556,95.0,74.5,11,840,9043376.8,95.0,76.36363636363636
144926.0,6,2,132,1,66,0.0,66.0,66.0,1,66,0.0,66.0,66.0
135133220.0,17,6,1206,6,1206,27026644.0,201.0,201.0,0,0,0.0,0.0,0.0
22084.0,6,10,2032,5,524,5237.5,252.0,104.8,5,1508,5172.25,1236.0,301.6
35170.0,6,14,4740,7,653,5735.0,249.0,93.28571428571428,7,4087,5700.333333333333,1514.0,583.8571428571429
90256642.0,6,12,1832,8,1016,12893806.0,188.0,127.0,4,816,30030420.33333333,204.0,204.0
153407.0,17,2,180,1,90,0.0,90.0,90.0,1,90,0.0,90.0,90.0
14528867.0,17,6,2052,6,2052,2905773.4,342.0,342.0,0,0,0.0,0.0,0.0
29758.0,6,14,4740,7,653,4737.166666666667,249.0,93.28571428571428,7,4087,4637.166666666667,1514.0,583.8571428571429
121227.0,6,3,337,2,214,0.0,160.0,107.0,1,123,0.0,123.0,123.0
2285.0,17,4,344,2,150,0.0,75.0,75.0,2,194,0.0,103.0,97.0
323454.0,17,4,1400,4,1400,107818.0,350.0,350.0,0,0,0.0,0.0,0.0
213638.0,17,2,180,1,90,0.0,90.0,90.0,1,90,0.0,90.0,90.0
153426.0,17,2,180,1,90,0.0,90.0,90.0,1,90,0.0,90.0,90.0
90057215.0,17,27,12943,27,12943,3463739.0384615385,501.0,479.3703703703704,0,0,0.0,0.0,0.0
194611.0,17,4,1524,4,1524,64870.333333333336,381.0,381.0,0,0,0.0,0.0,0.0
302378.0,6,2,132,1,66,0.0,66.0,66.0,1,66,0.0,66.0,66.0
135109345.0,17,6,1146,6,1146,27021869.0,191.0,191.0,0,0,0.0,0.0,0.0
321046.0,17,4,1400,4,1400,107015.33333333331,350.0,350.0,0,0,0.0,0.0,0.0
101399.0,17,2,286,2,286,0.0,143.0,143.0,0,0,0.0,0.0,0.0
124414201.0,17,17,1386,8,606,17079034.42857143,174.0,75.75,9,780,15456701.625,174.0,86.66666666666667
113309762.0,6,45,2970,23,1518,5150443.727272728,66.0,66.0,22,1452,4990457.952380952,66.0,66.0
913.0,17,5,550,5,550,228.25,110.0,110.0,0,0,0.0,0.0,0.0
90047025.0,17,28,13364,28,13364,3335075.0,501.0,477.2857142857143,0,0,0.0,0.0,0.0
1303262.0,6,4,264,2,132,0.0,66.0,66.0,2,132,0.0,66.0,66.0
1324711.0,6,4,264,2,132,0.0,66.0,66.0,2,132,0.0,66.0,66.0
108107846.0,17,5,1005,5,1005,27026961.5,201.0,201.0,0,0,0.0,0.0,0.0
108106902.0,17,5,955,5,955,27026725.5,191.0,191.0,0,0,0.0,0.0,0.0
2409.0,17,4,344,2,150,0.0,75.0,75.0,2,194,0.0,103.0,97.0
56288030.0,17,9,3086,8,2736,5179291.0,342.0,342.0,1,350,0.0,350.0,350.0
108097482.0,17,5,1005,5,1005,27024370.5,201.0,201.0,0,0,0.0,0.0,0.0
233455.0,6,3,373,2,238,0.0,172.0,119.0,1,135,0.0,135.0,135.0
17828.0,17,2,582,1,83,0.0,83.0,83.0,1,499,0.0,499.0,499.0
39850603.0,6,5,336,2,134,0.0,68.0,67.0,3,202,19856489.5,70.0,67.33333333333333
232603.0,6,3,337,2,214,0.0,160.0,107.0,1,123,0.0,123.0,123.0
4391.0,17,2,598,1,72,0.0,72.0,72.0,1,526,0.0,526.0,526.0
121446.0,6,3,337,2,214,0.0,160.0,107.0,1,123,0.0,123.0,123.0
502845.0,6,5,336,2,134,0.0,68.0,67.0,3,202,192129.5,70.0,67.33333333333333
53505.0,6,14,4740,7,653,8787.666666666666,249.0,93.28571428571428,7,4087,8619.166666666666,1514.0,583.8571428571429
108696053.0,6,33,2428,17,1288,6780015.9375,139.0,75.76470588235294,16,1140,7232014.333333333,123.0,71.25
94082199.0,6,168,18984,84,13218,1133520.469879518,284.0,157.35714285714286,84,5766,1130851.4337349397,140.0,68.64285714285714
21164.0,6,2,145,2,145,0.0,91.0,72.5,0,0,0.0,0.0,0.0
251901.0,17,4,1524,4,1524,83967.0,381.0,381.0,0,0,0.0,0.0,0.0
462436.0,6,10,1221,6,636,92487.2,298.0,106.0,4,585,148736.33333333334,379.0,146.25
873280.0,6,9,1268,6,797,174656.0,459.0,132.83333333333334,3,471,298709.0,331.0,157.0
153448.0,17,2,180,1,90,0.0,90.0,90.0,1,90,0.0,90.0,90.0
111353333.0,6,238,27130,119,19054,941849.754237288,284.0,160.11764705882354,119,8076,941849.6694915254,140.0,67.8655462184874
36268.0,6,14,4740,7,653,5697.666666666667,249.0,93.28571428571428,7,4087,5887.5,1514.0,583.8571428571429
161940.0,6,3,337,2,214,0.0,160.0,107.0,1,123,0.0,123.0,123.0
105413.0,17,2,700,2,700,0.0,350.0,350.0,0,0,0.0,0.0,0.0
207345.0,6,3,426,2,280,0.0,214.0,140.0,1,146,0.0,146.0,146.0
857483.0,6,9,1269,6,798,171496.6,460.0,133.0,3,471,292490.5,331.0,157.0
90734030.0,6,20,1650,10,745,10081558.888888888,95.0,74.5,10,905,10049997.444444444,255.0,90.5
127527.0,17,4,1400,4,1400,42509.0,350.0,350.0,0,0,0.0,0.0,0.0
2419.0,17,4,344,2,150,0.0,75.0,75.0,2,194,0.0,103.0,97.0
209679.0,17,2,414,1,88,0.0,88.0,88.0,1,326,0.0,326.0,326.0
1313089.0,6,4,264,2,132,0.0,66.0,66.0,2,132,0.0,66.0,66.0
93039923.0,17,16,5472,16,5472,6202661.533333333,342.0,342.0,0,0,0.0,0.0,0.0
40639.0,6,14,4740,7,653,6232.5,249.0,93.28571428571428,7,4087,6636.666666666667,1514.0,583.8571428571429
1497.0,17,2,762,2,762,0.0,381.0,381.0,0,0,0.0,0.0,0.0
1698300.0,17,18,1260,18,1260,99900.0,70.0,70.0,0,0,0.0,0.0,0.0
0.0,6,1,66,1,66,0.0,66.0,66.0,0,0,0.0,0.0,0.0
146127.0,6,3,337,2,214,0.0,160.0,107.0,1,123,0.0,123.0,123.0
0.0,17,1,80,1,80,0.0,80.0,80.0,0,0,0.0,0.0,0.0
135128465.0,17,6,1206,6,1206,27025693.0,201.0,201.0,0,0,0.0,0.0,0.0
90260175.0,6,13,2036,8,1016,12894310.714285716,188.0,127.0,5,1020,22523351.75,204.0,204.0
122370.0,6,3,373,2,238,0.0,172.0,119.0,1,135,0.0,135.0,135.0
120377149.0,6,221,24896,111,17340,1094337.7181818185,284.0,156.21621621621622,110,7556,1094990.4220183487,140.0,68.69090909090909
10827.0,6,10,1065,5,534,2465.5,262.0,106.8,5,531,2488.75,259.0,106.2
44782.0,6,11,2098,6,590,6330.2,252.0,98.33333333333331,5,1508,9327.25,1236.0,301.6
34299.0,6,10,2032,5,524,5232.0,252.0,104.8,5,1508,7775.5,1236.0,301.6
32127.000000000004,6,14,4740,7,653,5228.333333333333,249.0,93.28571428571428,7,4087,5216.5,1514.0,583.8571428571429
5005497.0,17,4,849,2,166,0.0,83.0,83.0,2,683,0.0,499.0,341.5
120125041.0,6,13,2020,9,1204,15015630.125,188.0,133.77777777777777,4,816,30031506.0,204.0,204.0
224334.0,6,3,426,2,280,0.0,214.0,140.0,1,146,0.0,146.0,146.0
319.0,17,2,174,1,79,0.0,79.0,79.0,1,95,0.0,95.0,95.0
120052585.0,17,29,13785,29,13785,4287592.321428572,501.0,475.3448275862069,0,0,0.0,0.0,0.0
197116.0,17,2,180,1,90,0.0,90.0,90.0,1,90,0.0,90.0,90.0
10466811.0,6,7,478,4,272,3442188.6666666665,74.0,68.0,3,206,5163152.0,74.0,68.66666666666667
90023239.0,17,28,13364,28,13364,3334194.037037037,501.0,477.2857142857143,0,0,0.0,0.0,0.0
2044629.0,17,6,1039,4,312,681413.0,78.0,78.0,2,727,0.0,395.0,363.5
116744219.0,6,32,2220,16,1149,7768569.133333334,123.0,71.8125,16,1071,7768569.466666667,123.0,66.9375
90965312.0,6,26,1978,15,1138,6494051.071428572,95.0,75.86666666666666,11,840,9072369.2,95.0,76.36363636363636
144774.0,17,2,180,1,70,0.0,70.0,70.0,1,110,0.0,110.0,110.0
204802.0,17,2,762,2,762,0.0,381.0,381.0,0,0,0.0,0.0,0.0
9748.0,17,4,823,2,163,0.0,89.0,81.5,2,660,0.0,443.0,330.0
197173.0,17,2,180,1,90,0.0,90.0,90.0,1,90,0.0,90.0,90.0
135134176.0,17,6,1146,6,1146,27026835.2,191.0,191.0,0,0,0.0,0.0,0.0
120046819.0,6,47,3102,23,1518,5160001.7727272725,66.0,66.0,24,1584,5219412.695652174,66.0,66.0
198676.0,17,2,180,1,90,0.0,90.0,90.0,1,90,0.0,90.0,90.0
120702734.0,6,55,4677,32,2676,3893636.580645161,123.0,83.625,23,2001,5353891.454545454,123.0,87.0
39782.0,6,14,4740,7,653,6456.333333333333,249.0,93.28571428571428,7,4087,6412.166666666667,1514.0,583.8571428571429
43005.0,6,14,4740,7,653,6651.666666666667,249.0,93.28571428571428,7,4087,7030.5,1514.0,583.8571428571429
122455.0,6,3,337,2,214,0.0,160.0,107.0,1,123,0.0,123.0,123.0
91632057.0,6,27,3000,14,1545,7044971.769230769,426.0,110.35714285714286,13,1455,7635306.083333333,361.0,111.92307692307692
2319.0,17,4,344,2,150,0.0,75.0,75.0,2,194,0.0,103.0,97.0
27257866.0,17,5,1710,5,1710,6814466.5,342.0,342.0,0,0,0.0,0.0,0.0
90253786.0,6,14,2240,8,1016,12893398.0,188.0,127.0,6,1224,18018118.2,204.0,204.0
90254898.0,6,13,2036,8,1016,12893556.857142856,188.0,127.0,5,1020,22522034.75,204.0,204.0
143928.0,17,2,180,1,90,0.0,90.0,90.0,1,90,0.0,90.0,90.0
70485.0,17,4,833,2,154,0.0,77.0,77.0,2,679,0.0,547.0,339.5
15477.0,6,14,4740,7,653,2417.1666666666665,249.0,93.28571428571428,7,4087,2444.1666666666665,1514.0,583.8571428571429
119001272.0,17,15,1169,8,606,17000181.714285713,174.0,75.75,7,563,16500389.333333334,174.0,80.42857142857143
253051.00000000003,17,4,6056,4,6056,84350.33333333334,1514.0,1514.0,0,0,0.0,0.0,0.0
105039048.0,17,14,864,7,432,17502423.333333332,174.0,61.71428571428572,7,432,17500165.333333332,174.0,61.71428571428572
55612.0,6,12,1413,7,882,9268.666666666666,291.0,126.0,5,531,11326.5,259.0,106.2
97793.0,17,2,762,2,762,0.0,381.0,381.0,0,0,0.0,0.0,0.0
108108354.0,17,5,1005,5,1005,27027088.5,201.0,201.0,0,0,0.0,0.0,0.0
1971.0,17,4,344,2,150,0.0,75.0,75.0,2,194,0.0,103.0,97.0
368119.0,17,6,2100,6,2100,73623.8,350.0,350.0,0,0,0.0,0.0,0.0
135130519.0,17,6,1206,6,1206,27026103.8,201.0,201.0,0,0,0.0,0.0,0.0
321.0,17,2,156,1,78,0.0,78.0,78.0,1,78,0.0,78.0,78.0
80202.0,6,4,301,2,132,0.0,66.0,66.0,2,169,0.0,103.0,84.5
32744.000000000004,6,10,2032,5,524,7926.25,252.0,104.8,5,1508,7473.25,1236.0,301.6
209263.0,6,12,1373,7,714,34877.166666666664,298.0,102.0,5,659,51542.75,379.0,131.8
124861.0,17,2,762,2,762,0.0,381.0,381.0,0,0,0.0,0.0,0.0
843.0,17,4,438,2,148,0.0,74.0,74.0,2,290,0.0,147.0,145.0
91709766.0,6,28,2168,16,1233,6110869.2,95.0,77.0625,12,935,8267590.545454546,95.0,77.91666666666667
10515015.0,6,7,478,4,272,3457831.333333333,74.0,68.0,3,206,5186643.0,74.0,68.66666666666667
304012.0,6,6,412,4,272,101337.33333333331,74.0,68.0,2,140,0.0,74.0,70.0
1920.0,17,2,664,1,322,0.0,322.0,322.0,1,342,0.0,342.0,342.0
69958.0,6,13,1479,7,882,11659.666666666666,291.0,126.0,6,597,9504.2,259.0,99.5
294984.0,17,2,180,1,90,0.0,90.0,90.0,1,90,0.0,90.0,90.0
1168151.0,6,13,3000,8,2372,166878.7142857143,1514.0,296.5,5,628,223138.0,331.0,125.6
246865.0,6,12,1373,7,714,41144.16666666666,298.0,102.0,5,659,60744.0,379.0,131.8
322220.0,17,4,1400,4,1400,107406.66666666669,350.0,350.0,0,0,0.0,0.0,0.0
211480.0,17,4,1400,4,1400,70493.33333333333,350.0,350.0,0,0,0.0,0.0,0.0
228180.0,17,2,180,1,90,0.0,90.0,90.0,1,90,0.0,90.0,90.0
61160.0,6,14,4740,7,653,9954.166666666666,249.0,93.28571428571428,7,4087,9976.833333333334,1514.0,583.8571428571429
102402.0,17,2,286,2,286,0.0,143.0,143.0,0,0,0.0,0.0,0.0
304914.0,6,6,412,4,272,101638.0,74.0,68.0,2,140,0.0,74.0,70.0
5874.0,17,4,823,2,163,0.0,89.0,81.5,2,660,0.0,443.0,330.0
90215171.0,6,25,1924,11,840,8997358.6,95.0,76.36363636363636,14,1084,6923825.615384615,95.0,77.42857142857143
148001.0,17,2,180,1,90,0.0,90.0,90.0,1,90,0.0,90.0,90.0
38696.0,6,10,2032,5,524,9277.5,252.0,104.8,5,1508,8725.75,1236.0,301.6
81848.0,6,14,4740,7,653,13476.0,249.0,93.28571428571428,7,4087,13174.333333333334,1514.0,583.8571428571429
9004753.0,6,11,2106,6,598,1800806.8,252.0,99.66666666666669,5,1508,1619.5,1236.0,301.6
322646.0,17,4,1400,4,1400,107548.66666666669,350.0,350.0,0,0,0.0,0.0,0.0
3879776.0,6,5,336,2,134,0.0,68.0,67.0,3,202,1577251.0,70.0,67.33333333333333
222450.0,6,12,1373,7,714,37075.0,298.0,102.0,5,659,54803.25,379.0,131.8
239920.0,17,2,180,1,90,0.0,90.0,90.0,1,90,0.0,90.0,90.0
104587.0,17,2,700,2,700,0.0,350.0,350.0,0,0,0.0,0.0,0.0
1476300.0,17,16,1120,16,1120,98420.0,70.0,70.0,0,0,0.0,0.0,0.0
30630.0,6,14,4740,7,653,4958.333333333333,249.0,93.28571428571428,7,4087,4929.833333333333,1514.0,583.8571428571429
10818.0,6,10,2032,5,524,2334.25,252.0,104.8,5,1508,2401.25,1236.0,301.6
3322.0,17,2,180,1,90,0.0,90.0,90.0,1,90,0.0,90.0,90.0
144998.0,17,2,180,1,70,0.0,70.0,70.0,1,110,0.0,110.0,110.0
51179.0,17,2,180,1,90,0.0,90.0,90.0,1,90,0.0,90.0,90.0
100347676.0,17,12,778,6,389,20069535.2,174.0,64.83333333333333,6,389,19891599.6,174.0,64.83333333333333
2345.0,17,4,344,2,150,0.0,75.0,75.0,2,194,0.0,103.0,97.0
90017814.0,17,28,13364,28,13364,3333993.111111111,501.0,477.2857142857143,0,0,0.0,0.0,0.0
204688.0,17,2,762,2,762,0.0,381.0,381.0,0,0,0.0,0.0,0.0
249980.0,6,3,337,2,214,0.0,160.0,107.0,1,123,0.0,123.0,123.0
1899.0,17,2,691,1,349,0.0,349.0,349.0,1,342,0.0,342.0,342.0
366896.0,6,10,1221,6,636,73379.2,298.0,106.0,4,585,121003.33333333331,379.0,146.25
106946.0,17,2,286,2,286,0.0,143.0,143.0,0,0,0.0,0.0,0.0
0.0,6,1,66,1,66,0.0,66.0,66.0,0,0,0.0,0.0,0.0
135138686.0,17,6,1146,6,1146,27027737.2,191.0,191.0,0,0,0.0,0.0,0.0
118119645.0,6,47,3102,23,1518,5160178.2727272725,66.0,66.0,24,1584,5135625.695652174,66.0,66.0
5828033.0,6,5,336,2,134,0.0,68.0,67.0,3,202,1527069.5,70.0,67.33333333333333
143012.0,6,2,132,1,66,0.0,66.0,66.0,1,66,0.0,66.0,66.0
40969.0,6,14,4740,7,653,6487.166666666667,249.0,93.28571428571428,7,4087,6425.0,1514.0,583.8571428571429
228535.0,17,2,180,1,90,0.0,90.0,90.0,1,90,0.0,90.0,90.0
153452.0,17,2,180,1,90,0.0,90.0,90.0,1,90,0.0,90.0,90.0
44874.0,6,14,4740,7,653,7365.333333333333,249.0,93.28571428571428,7,4087,7338.5,1514.0,583.8571428571429
35016.0,6,14,4740,7,653,5660.0,249.0,93.28571428571428,7,4087,5675.0,1514.0,583.8571428571429
228475.0,17,2,180,1,90,0.0,90.0,90.0,1,90,0.0,90.0,90.0
239920.0,17,2,180,1,90,0.0,90.0,90.0,1,90,0.0,90.0,90.0
73616.0,6,14,4740,7,653,11783.833333333334,249.0,93.28571428571428,7,4087,11987.166666666666,1514.0,583.8571428571429
25896.0,6,14,4740,7,653,4191.833333333333,249.0,93.28571428571428,7,4087,4177.666666666667,1514.0,583.8571428571429
120046175.0,17,29,13785,29,13785,4287363.392857143,501.0,475.3448275862069,0,0,0.0,0.0,0.0
213555.0,17,2,180,1,90,0.0,90.0,90.0,1,90,0.0,90.0,90.0
116624604.0,6,278,31566,139,22096,843546.1376811594,300.0,158.9640287769784,139,9470,843546.0,140.0,68.12949640287769
34407.0,6,10,2032,5,524,8356.25,252.0,104.8,5,1508,7003.5,1236.0,301.6
97371597.0,17,12,778,6,389,19400818.4,174.0,64.83333333333333,6,389,19400155.4,174.0,64.83333333333333
127001080.0,17,15,1169,8,606,18143011.42857143,174.0,75.75,7,563,17744193.5,174.0,80.42857142857143
0.0,6,1,66,1,66,0.0,66.0,66.0,0,0,0.0,0.0,0.0
108109540.0,17,5,1005,5,1005,27027385.0,201.0,201.0,0,0,0.0,0.0,0.0
24444.0,6,10,2032,5,524,5871.0,252.0,104.8,5,1508,5547.75,1236.0,301.6
70336.0,6,14,4740,7,653,11551.0,249.0,93.28571428571428,7,4087,9961.666666666666,1514.0,583.8571428571429
153608.0,17,2,180,1,90,0.0,90.0,90.0,1,90,0.0,90.0,90.0
10506250.0,6,7,478,4,272,3456379.6666666665,74.0,68.0,3,206,5184437.5,74.0,68.66666666666667
1155850.0,6,13,3010,8,2382,165121.42857142858,1514.0,297.75,5,628,220798.5,331.0,125.6
90041575.0,17,28,13364,28,13364,3334873.1481481483,501.0,477.2857142857143,0,0,0.0,0.0,0.0
119576324.0,6,33,2428,16,1140,7971754.933333334,123.0,71.25,17,1288,6835975.5625,139.0,75.76470588235294
206122.0,6,3,426,2,280,0.0,214.0,140.0,1,146,0.0,146.0,146.0
1043813.0,6,13,1386,7,789,173968.8333333333,253.0,112.71428571428572,6,597,206985.6,259.0,99.5
108113654.0,17,5,1005,5,1005,27028413.5,201.0,201.0,0,0,0.0,0.0,0.0
1733126.0,6,22,6443,12,1529,157556.9090909091,357.0,127.41666666666669,10,4914,158691.55555555556,1510.0,491.4
135139862.0,17,6,1146,6,1146,27027972.4,191.0,191.0,0,0,0.0,0.0,0.0
284680.0,17,4,1524,4,1524,94893.33333333331,381.0,381.0,0,0,0.0,0.0,0.0
32995.0,6,14,4740,7,653,4671.666666666667,249.0,93.28571428571428,7,4087,5222.333333333333,1514.0,583.8571428571429
67051979.0,17,4,1812,4,1812,22350659.666666668,453.0,453.0,0,0,0.0,0.0,0.0
25460.0,6,10,2032,5,524,6128.0,252.0,104.8,5,1508,5838.75,1236.0,301.6
90520720.0,6,15,2444,8,1016,12931531.42857143,188.0,127.0,7,1428,15054814.5,204.0,204.0
209615.0,17,2,180,1,90,0.0,90.0,90.0,1,90,0.0,90.0,90.0
1570515.0,6,2,132,1,66,0.0,66.0,66.0,1,66,0.0,66.0,66.0
196992.0,17,2,180,1,90,0.0,90.0,90.0,1,90,0.0,90.0,90.0
120124120.0,6,13,2020,9,1204,15015515.0,188.0,133.77777777777777,4,816,30030458.666666668,204.0,204.0
2933686.0,6,4,264,4,264,977895.3333333334,66.0,66.0,0,0,0.0,0.0,0.0
8274497.999999999,17,3,1034,2,684,0.0,342.0,342.0,1,350,0.0,350.0,350.0
377.0,17,2,166,1,75,0.0,75.0,75.0,1,91,0.0,91.0,91.0
2506.0,17,4,344,2,150,0.0,75.0,75.0,2,194,0.0,103.0,97.0
3427818.0,6,182,150834,106,141516,32444.819047619047,1510.0,1335.0566037735848,76,9318,41665.66666666666,1510.0,122.60526315789474
120064846.0,17,29,13785,29,13785,4288030.214285715,501.0,475.3448275862069,0,0,0.0,0.0,0.0
90255126.0,6,13,1898,8,1016,12893589.42857143,188.0,127.0,5,882,22523443.75,204.0,176.4
298198.0,6,6,412,4,272,99399.33333333331,74.0,68.0,2,140,0.0,74.0,70.0
1431646.0,6,7,499,4,301,452690.3333333333,103.0,75.25,3,198,612805.5,66.0,66.0
197080.0,17,2,180,1,90,0.0,90.0,90.0,1,90,0.0,90.0,90.0
120004723.0,6,24,1829,13,989,10000393.583333334,95.0,76.07692307692308,11,840,11974836.2,95.0,76.36363636363636
303609.0,6,2,132,1,66,0.0,66.0,66.0,1,66,0.0,66.0,66.0
107166.0,17,2,286,2,286,0.0,143.0,143.0,0,0,0.0,0.0,0.0
3346231.0,6,152,130822,93,122626,36372.07608695652,1510.0,1318.5591397849462,59,8196,52362.879310344826,1510.0,138.91525423728814
65731.0,6,14,4740,7,653,10384.0,249.0,93.28571428571428,7,4087,10257.5,1514.0,583.8571428571429
16671.0,6,10,2032,5,524,3852.75,252.0,104.8,5,1508,3219.75,1236.0,301.6
126502118.0,17,15,907,7,432,17834952.5,174.0,61.71428571428572,8,475,18000160.57142857,174.0,59.375
0.0,6,1,66,1,66,0.0,66.0,66.0,0,0,0.0,0.0,0.0
14309.0,6,10,2032,5,524,3349.5,252.0,104.8,5,1508,3187.5,1236.0,301.6
119797806.0,17,35,16705,35,16705,3523464.882352941,501.0,477.2857142857143,0,0,0.0,0.0,0.0
120035441.0,17,28,13364,28,13364,4445757.074074074,501.0,477.2857142857143,0,0,0.0,0.0,0.0
21365.0,6,14,4740,7,653,3357.333333333333,249.0,93.28571428571428,7,4087,3369.333333333333,1514.0,583.8571428571429
1312066.0,17,7,490,7,490,218677.66666666663,70.0,70.0,0,0,0.0,0.0,0.0
120120518.0,6,14,2224,9,1204,15015064.75,188.0,133.77777777777777,5,1020,22522842.0,204.0,204.0
120141112.0,6,226,25534,113,7754,1065269.3482142857,140.0,68.61946902654867,113,17780,1066449.9910714286,284.0,157.34513274336285
503373.0,6,5,336,2,134,0.0,68.0,67.0,3,202,189931.0,70.0,67.33333333333333
90217367.0,6,16,1192,8,596,12852075.285714284,95.0,74.5,8,596,12857425.142857144,95.0,74.5
223485.0,6,10,1221,6,636,44697.0,298.0,106.0,4,585,73353.0,379.0,146.25
146073.0,6,3,337,2,214,0.0,160.0,107.0,1,123,0.0,123.0,123.0
119867533.0,6,17,2434,10,1270,13318614.777777778,188.0,127.0,7,1164,19975466.33333333,204.0,166.28571428571428
98469889.0,6,31,2314,16,1228,6564659.266666667,139.0,76.75,15,1086,7018107.142857143,123.0,72.4
120053156.0,17,28,13364,28,13364,4446413.185185186,501.0,477.2857142857143,0,0,0.0,0.0,0.0
51795.0,6,10,2032,5,524,12578.0,252.0,104.8,5,1508,6955.5,1236.0,301.6
108111827.0,17,5,1005,5,1005,27027956.75,201.0,201.0,0,0,0.0,0.0,0.0
310903.0,6,3,202,2,128,0.0,74.0,64.0,1,74,0.0,74.0,74.0
209583.0,17,2,180,1,90,0.0,90.0,90.0,1,90,0.0,90.0,90.0
322802.0,6,3,202,2,128,0.0,74.0,64.0,1,74,0.0,74.0,74.0
5923.0,17,2,180,1,90,0.0,90.0,90.0,1,90,0.0,90.0,90.0
153414.0,17,2,180,1,90,0.0,90.0,90.0,1,90,0.0,90.0,90.0
90098184.0,6,12,1848,5,1020,22523414.0,204.0,204.0,7,828,15015806.0,188.0,118.28571428571428
259783.0,17,4,1400,4,1400,86594.33333333333,350.0,350.0,0,0,0.0,0.0,0.0
610452.0,6,4,508,2,238,0.0,172.0,119.0,2,270,0.0,135.0,135.0
95892483.0,6,187,21244,94,6426,1031101.9677419356,140.0,68.36170212765957,93,14818,1030963.6739130436,336.0,159.33333333333334
4499.0,17,2,180,1,90,0.0,90.0,90.0,1,90,0.0,90.0,90.0
255977.0,6,3,337,2,214,0.0,160.0,107.0,1,123,0.0,123.0,123.0
47538.0,6,12,1320,7,789,7923.0,253.0,112.71428571428572,5,531,10005.0,259.0,106.2
106027384.0,6,35,2812,19,1534,5890410.222222222,139.0,80.73684210526316,16,1278,7053361.6,123.0,79.875
42288.0,6,14,4740,7,653,6619.666666666667,249.0,93.28571428571428,7,4087,6793.666666666667,1514.0,583.8571428571429
18008605.0,6,26,7627,14,3735,177820.61538461538,1514.0,266.7857142857143,12,3892,1618457.9090909092,1514.0,324.3333333333333
26359.0,6,10,2032,5,524,6357.25,252.0,104.8,5,1508,6308.0,1236.0,301.6
203992.0,17,2,762,2,762,0.0,381.0,381.0,0,0,0.0,0.0,0.0
138266.0,6,2,132,1,66,0.0,66.0,66.0,1,66,0.0,66.0,66.0
24645.0,6,10,2032,5,524,5920.5,252.0,104.8,5,1508,5379.0,1236.0,301.6
475940.0,6,3,1604,1,753,0.0,753.0,753.0,2,851,0.0,785.0,425.5
213716.0,17,2,180,1,90,0.0,90.0,90.0,1,90,0.0,90.0,90.0
113699494.0,6,30,1974,15,1026,8105974.5,123.0,68.4,15,948,8105964.214285715,123.0,63.2
43519.0,6,14,4740,7,653,6761.833333333333,249.0,93.28571428571428,7,4087,6609.333333333333,1514.0,583.8571428571429
117206111.0,6,33,2428,17,1288,7325381.9375,139.0,75.76470588235294,16,1140,7799322.933333334,123.0,71.25
5855.0,17,2,180,1,90,0.0,90.0,90.0,1,90,0.0,90.0,90.0
5931207.0,6,5,336,3,202,1424048.5,70.0,67.33333333333333,2,134,0.0,68.0,67.0
256274.0,6,3,337,2,214,0.0,160.0,107.0,1,123,0.0,123.0,123.0
100843.0,17,2,762,2,762,0.0,381.0,381.0,0,0,0.0,0.0,0.0
270330.0,6,10,1221,6,636,54066.0,298.0,106.0,4,585,84436.33333333333,379.0,146.25
17459.0,6,14,4740,7,653,2799.333333333333,249.0,93.28571428571428,7,4087,2251.833333333333,1514.0,583.8571428571429
119580207.0,17,34,16284,34,16284,3623642.636363636,501.0,478.9411764705882,0,0,0.0,0.0,0.0
120062714.0,17,29,13785,29,13785,4287954.071428572,501.0,475.3448275862069,0,0,0.0,0.0,0.0
852405.0,6,9,1270,6,799,170481.0,461.0,133.16666666666666,3,471,288611.0,331.0,157.0
105402.0,17,2,700,2,700,0.0,350.0,350.0,0,0,0.0,0.0,0.0
291650.0,17,2,246,1,76,0.0,76.0,76.0,1,170,0.0,170.0,170.0
4440.0,17,2,614,1,72,0.0,72.0,72.0,1,542,0.0,542.0,542.0
24721.0,17,2,180,1,90,0.0,90.0,90.0,1,90,0.0,90.0,90.0
196779.0,17,2,180,1,90,0.0,90.0,90.0,1,90,0.0,90.0,90.0
10501593.0,6,7,478,4,272,3453675.333333333,74.0,68.0,3,206,5180385.0,74.0,68.66666666666667
313312.0,6,3,202,2,128,0.0,74.0,64.0,1,74,0.0,74.0,74.0
407446.0,6,4,508,2,238,0.0,172.0,119.0,2,270,0.0,135.0,135.0
506066.0,6,5,336,2,134,0.0,68.0,67.0,3,202,196279.0,70.0,67.33333333333333
105501802.0,6,44,2904,22,1452,5023895.333333333,66.0,66.0,22,1452,5010781.428571428,66.0,66.0
310805.0,6,6,412,4,272,103601.66666666669,74.0,68.0,2,140,0.0,74.0,70.0
107475604.0,6,29,1983,15,1017,7676828.857142857,123.0,67.8,14,966,8250642.923076923,123.0,69.0
2597438.0,6,2,132,1,66,0.0,66.0,66.0,1,66,0.0,66.0,66.0
315792.0,6,6,412,4,272,105264.0,74.0,68.0,2,140,0.0,74.0,70.0
4804571.0,6,5,336,2,134,0.0,68.0,67.0,3,202,1523084.0,70.0,67.33333333333333
10954.0,17,2,684,2,684,0.0,342.0,342.0,0,0,0.0,0.0,0.0
108116283.0,17,5,1005,5,1005,27029070.75,201.0,201.0,0,0,0.0,0.0,0.0
108107083.0,17,5,1005,5,1005,27026770.75,201.0,201.0,0,0,0.0,0.0,0.0
9833.0,17,2,582,1,83,0.0,83.0,83.0,1,499,0.0,499.0,499.0
105690485.0,6,32,2236,16,1165,7031641.866666666,139.0,72.8125,16,1071,7031655.266666667,123.0,66.9375
271146.0,6,10,1221,6,636,54229.2,298.0,106.0,4,585,84150.0,379.0,146.25
107103784.0,6,199,22380,100,6896,1081856.404040404,140.0,68.96,99,15484,1082359.448979592,284.0,156.40404040404042
19661.0,17,4,823,2,163,0.0,89.0,81.5,2,660,0.0,443.0,330.0
117332654.0,17,14,864,7,432,19500186.5,174.0,61.71428571428572,7,432,19501058.666666668,174.0,61.71428571428572
232350.0,6,3,337,2,214,0.0,160.0,107.0,1,123,0.0,123.0,123.0
0.0,6,1,66,1,66,0.0,66.0,66.0,0,0,0.0,0.0,0.0
82979876.0,17,14,4796,13,4446,6234936.833333333,342.0,342.0,1,350,0.0,350.0,350.0
32984.0,6,14,4740,7,653,5387.333333333333,249.0,93.28571428571428,7,4087,4566.0,1514.0,583.8571428571429
4170.0,17,4,344,2,150,0.0,75.0,75.0,2,194,0.0,103.0,97.0
220584.0,6,3,426,2,280,0.0,214.0,140.0,1,146,0.0,146.0,146.0
1303050.0,6,4,264,2,132,0.0,66.0,66.0,2,132,0.0,66.0,66.0
120396647.0,6,213,24164,107,16934,1135817.424528302,284.0,158.26168224299064,106,7230,1126813.238095238,140.0,68.20754716981132
105462051.0,17,14,1126,7,563,17499934.166666668,174.0,80.42857142857143,7,563,17550517.666666668,174.0,80.42857142857143
9462.0,6,10,1067,5,536,2122.5,264.0,107.2,5,531,2108.25,259.0,106.2
362782.0,6,11,1021,6,444,48749.6,162.0,74.0,5,577,60854.25,349.0,115.4
364236.0,6,11,1021,6,444,49081.2,162.0,74.0,5,577,61145.25,349.0,115.4
318477.0,17,4,1400,4,1400,106159.0,350.0,350.0,0,0,0.0,0.0,0.0
46901.0,6,10,2032,5,524,10786.75,252.0,104.8,5,1508,7482.75,1236.0,301.6
1229883.0,6,20,6916,11,3099,122988.3,1514.0,281.72727272727275,9,3817,127785.75,1514.0,424.1111111111111
107611.0,17,2,286,2,286,0.0,143.0,143.0,0,0,0.0,0.0,0.0
205825.0,17,2,180,1,90,0.0,90.0,90.0,1,90,0.0,90.0,90.0
220062.0,6,3,426,2,280,0.0,214.0,140.0,1,146,0.0,146.0,146.0
24200.0,6,10,2032,5,524,4594.25,252.0,104.8,5,1508,5461.75,1236.0,301.6
1123611.0,6,13,3010,8,2382,160515.85714285713,1514.0,297.75,5,628,212088.75,331.0,125.6
14506.0,6,14,4740,7,653,2116.0,249.0,93.28571428571428,7,4087,2278.5,1514.0,583.8571428571429
100780124.0,6,29,2068,15,1105,7183166.5,139.0,73.66666666666667,14,963,7735715.076923077,123.0,68.78571428571429
312.0,17,2,168,1,76,0.0,76.0,76.0,1,92,0.0,92.0,92.0
95510988.0,6,40,2640,20,1320,5026894.105263158,66.0,66.0,20,1320,5012557.736842105,66.0,66.0
43847.0,6,14,4740,7,653,7179.833333333333,249.0,93.28571428571428,7,4087,7126.166666666667,1514.0,583.8571428571429
9118.0,6,10,2032,5,524,2052.25,252.0,104.8,5,1508,1921.0,1236.0,301.6
106579619.0,6,44,2904,22,1452,5075219.952380952,66.0,66.0,22,1452,5060249.285714285,66.0,66.0
311618.0,6,6,412,4,272,103872.66666666669,74.0,68.0,2,140,0.0,74.0,70.0
228287.0,17,2,180,1,90,0.0,90.0,90.0,1,90,0.0,90.0,90.0
146955.0,6,3,373,2,238,0.0,172.0,119.0,1,135,0.0,135.0,135.0
301182.0,6,6,412,4,272,100394.0,74.0,68.0,2,140,0.0,74.0,70.0
1301517.0,6,4,264,2,132,0.0,66.0,66.0,2,132,0.0,66.0,66.0
324.0,17,2,174,1,79,0.0,79.0,79.0,1,95,0.0,95.0,95.0
120309849.0,6,229,25912,115,18092,1055349.5526315789,284.0,157.3217391304348,114,7820,1055522.8495575222,140.0,68.59649122807018
30106.0,6,14,4740,7,653,4272.666666666667,249.0,93.28571428571428,7,4087,4874.0,1514.0,583.8571428571429
48219.0,6,14,4740,7,653,7888.0,249.0,93.28571428571428,7,4087,7199.833333333333,1514.0,583.8571428571429
228279.0,17,2,180,1,90,0.0,90.0,90.0,1,90,0.0,90.0,90.0
49655099.0,6,8,1940,3,887,23838376.5,753.0,295.6666666666667,5,1053,11717445.75,785.0,210.6
11745.0,6,11,1132,6,556,2349.0,218.0,92.66666666666669,5,576,2549.25,304.0,115.2
52210.0,6,14,4740,7,653,6840.833333333333,249.0,93.28571428571428,7,4087,7455.333333333333,1514.0,583.8571428571429
13179.0,17,2,180,1,90,0.0,90.0,90.0,1,90,0.0,90.0,90.0
364133.0,6,11,1021,6,444,48953.2,162.0,74.0,5,577,61116.0,349.0,115.4
122986380.0,17,14,864,7,432,17173973.833333332,174.0,61.71428571428572,7,432,17166833.666666668,174.0,61.71428571428572
54922.0,6,14,4740,7,653,8924.833333333334,249.0,93.28571428571428,7,4087,8059.5,1514.0,583.8571428571429
37205.0,6,10,2032,5,524,8983.5,252.0,104.8,5,1508,7903.0,1236.0,301.6
656.0,17,2,762,2,762,0.0,381.0,381.0,0,0,0.0,0.0,0.0
121696.0,17,4,1524,4,1524,40565.333333333336,381.0,381.0,0,0,0.0,0.0,0.0
103196980.0,17,14,864,7,432,17168395.5,174.0,61.71428571428572,7,432,17166819.0,174.0,61.71428571428572
50563.0,6,10,2032,5,524,12284.25,252.0,104.8,5,1508,11183.5,1236.0,301.6
2363.0,17,4,344,2,150,0.0,75.0,75.0,2,194,0.0,103.0,97.0
37793353.0,6,5,336,2,134,0.0,68.0,67.0,3,202,18832934.0,70.0,67.33333333333333
305024.0,6,6,412,4,272,101674.66666666669,74.0,68.0,2,140,0.0,74.0,70.0
864080.0,6,9,1096,6,625,172816.0,287.0,104.16666666666669,3,471,294197.0,331.0,157.0
116205248.0,6,48,3168,24,1584,5052402.0869565215,66.0,66.0,24,1584,5043004.217391305,66.0,66.0
37177.0,6,10,2032,5,524,8883.0,252.0,104.8,5,1508,8171.25,1236.0,301.6
300.0,17,2,156,1,78,0.0,78.0,78.0,1,78,0.0,78.0,78.0
155213.0,6,3,337,2,214,0.0,160.0,107.0,1,123,0.0,123.0,123.0
52312.0,6,11,2098,6,590,10010.8,252.0,98.33333333333331,5,1508,12504.75,1236.0,301.6
108303665.0,6,31,2166,16,1149,7220244.333333333,123.0,71.8125,15,1017,7720531.571428572,123.0,67.8
91526981.0,6,342,45864,171,11508,533642.3470588236,140.0,67.29824561403508,171,34356,528162.1882352941,570.0,200.9122807017544
0.0,17,1,55,1,55,0.0,55.0,55.0,0,0,0.0,0.0,0.0
18629.0,6,20,7606,11,978,1862.9,310.0,88.9090909090909,9,6628,2030.5,1514.0,736.4444444444445
54399.0,6,14,4740,7,653,8743.0,249.0,93.28571428571428,7,4087,7889.833333333333,1514.0,583.8571428571429
323254.0,17,4,1400,4,1400,107751.33333333331,350.0,350.0,0,0,0.0,0.0,0.0
107828.0,17,2,286,2,286,0.0,143.0,143.0,0,0,0.0,0.0,0.0
105005974.0,17,14,864,7,432,17500995.666666668,174.0,61.71428571428572,7,432,17333492.833333332,174.0,61.71428571428572
2993239.0,17,3,1026,3,1026,1496619.5,342.0,342.0,0,0,0.0,0.0,0.0
298087.0,6,6,412,4,272,99362.33333333331,74.0,68.0,2,140,0.0,74.0,70.0
120120763.0,6,13,2036,5,1020,30030190.75,204.0,204.0,8,1016,17136509.85714286,188.0,127.0
119506.0,6,2,132,1,66,0.0,66.0,66.0,1,66,0.0,66.0,66.0
196968.0,17,2,180,1,90,0.0,90.0,90.0,1,90,0.0,90.0,90.0
126333044.0,6,33,2343,16,1071,7909579.066666666,123.0,66.9375,17,1272,7551154.375,123.0,74.82352941176471
153442.0,17,2,180,1,90,0.0,90.0,90.0,1,90,0.0,90.0,90.0
299082.0,6,6,412,4,272,99694.0,74.0,68.0,2,140,0.0,74.0,70.0
5004526.0,17,4,849,2,166,0.0,83.0,83.0,2,683,0.0,499.0,341.5
181298.0,17,2,180,1,90,0.0,90.0,90.0,1,90,0.0,90.0,90.0
39951.0,6,14,4740,7,653,5688.833333333333,249.0,93.28571428571428,7,4087,6437.166666666667,1514.0,583.8571428571429
108115235.0,17,5,955,5,955,27028808.75,191.0,191.0,0,0,0.0,0.0,0.0
110780750.0,6,31,2314,15,1086,7912910.714285715,123.0,72.4,16,1228,6705336.666666667,139.0,76.75
120353770.0,6,233,26372,117,18420,1037532.5,284.0,157.43589743589743,116,7952,1037565.4608695653,140.0,68.55172413793103
107506.0,17,2,286,2,286,0.0,143.0,143.0,0,0,0.0,0.0,0.0
13885.0,6,14,4740,7,653,2083.333333333333,249.0,93.28571428571428,7,4087,2176.5,1514.0,583.8571428571429
145991.0,6,3,337,2,214,0.0,160.0,107.0,1,123,0.0,123.0,123.0
91715416.0,6,22,1680,12,894,8332067.545454546,95.0,74.5,10,786,10189356.222222222,95.0,78.6
19913.0,6,11,2098,6,590,3273.2,252.0,98.33333333333331,5,1508,4677.75,1236.0,301.6
92880299.0,6,39,2574,19,1254,5159994.444444444,66.0,66.0,20,1320,4888410.52631579,66.0,66.0
43261.0,6,14,4740,7,653,7085.333333333333,249.0,93.28571428571428,7,4087,6825.666666666667,1514.0,583.8571428571429
749169.0,6,11,1131,6,600,149481.4,262.0,100.0,5,531,186576.25,259.0,106.2
20512.0,6,2,145,2,145,0.0,91.0,72.5,0,0,0.0,0.0,0.0
116001112.0,17,15,1169,8,606,16571587.42857143,174.0,75.75,7,563,16000131.0,174.0,80.42857142857143
90309738.0,6,16,1192,8,596,12894735.0,95.0,74.5,8,596,12900477.142857144,95.0,74.5
4728.0,17,2,180,1,90,0.0,90.0,90.0,1,90,0.0,90.0,90.0
143928.0,17,2,180,1,90,0.0,90.0,90.0,1,90,0.0,90.0,90.0
98306.0,17,2,762,2,762,0.0,381.0,381.0,0,0,0.0,0.0,0.0
216582.0,6,3,426,2,280,0.0,214.0,140.0,1,146,0.0,146.0,146.0
21024874.0,17,3,1034,2,684,0.0,342.0,342.0,1,350,0.0,350.0,350.0
90037476.0,17,28,13364,28,13364,3334721.333333333,501.0,477.2857142857143,0,0,0.0,0.0,0.0
108106982.0,17,5,955,5,955,27026745.5,191.0,191.0,0,0,0.0,0.0,0.0
165872.0,17,2,180,1,90,0.0,90.0,90.0,1,90,0.0,90.0,90.0
501411.00000000006,6,5,336,2,134,0.0,68.0,67.0,3,202,195257.0,70.0,67.33333333333333
96848407.0,17,14,4796,13,4446,6228827.333333333,342.0,342.0,1,350,0.0,350.0,350.0
3432.0,17,4,344,2,150,0.0,75.0,75.0,2,194,0.0,103.0,97.0
234794.0,6,3,337,2,214,0.0,160.0,107.0,1,123,0.0,123.0,123.0
160199.0,17,2,180,1,90,0.0,90.0,90.0,1,90,0.0,90.0,90.0
128835076.0,6,35,2394,18,1269,7578533.882352941,123.0,70.5,17,1125,7415378.875,123.0,66.17647058823529
48032.0,6,14,4740,7,653,7891.833333333333,249.0,93.28571428571428,7,4087,5945.5,1514.0,583.8571428571429
53437.0,6,14,4740,7,653,7585.166666666667,249.0,93.28571428571428,7,4087,8718.166666666666,1514.0,583.8571428571429
5623636.0,6,5,336,2,134,0.0,68.0,67.0,3,202,1421771.5,70.0,67.33333333333333
12284.0,17,4,823,2,163,0.0,89.0,81.5,2,660,0.0,443.0,330.0
171871.0,17,2,180,1,90,0.0,90.0,90.0,1,90,0.0,90.0,90.0
190808.0,17,2,180,1,90,0.0,90.0,90.0,1,90,0.0,90.0,90.0
349.0,17,2,267,1,83,0.0,83.0,83.0,1,184,0.0,184.0,184.0
28753.0,6,14,4683,7,596,4622.666666666667,192.0,85.14285714285714,7,4087,4593.166666666667,1514.0,583.8571428571429
241818.0,6,3,337,2,214,0.0,160.0,107.0,1,123,0.0,123.0,123.0
301193.0,6,6,412,4,272,100397.66666666669,74.0,68.0,2,140,0.0,74.0,70.0
209793.0,6,3,426,2,280,0.0,214.0,140.0,1,146,0.0,146.0,146.0
165727.0,17,4,1524,4,1524,55242.333333333336,381.0,381.0,0,0,0.0,0.0,0.0
119819938.0,17,34,16284,34,16284,3630907.212121212,501.0,478.9411764705882,0,0,0.0,0.0,0.0
120361343.0,6,447,55690,224,40676,539736.9641255605,464.0,181.5892857142857,223,15014,537463.4414414414,140.0,67.32735426008969
318491.0,17,4,1400,4,1400,106163.66666666669,350.0,350.0,0,0,0.0,0.0,0.0
207789.0,6,3,426,2,280,0.0,214.0,140.0,1,146,0.0,146.0,146.0
115306964.0,6,48,3168,24,1584,5013346.260869565,66.0,66.0,24,1584,5000262.043478261,66.0,66.0
59453.0,6,14,4740,7,653,9239.5,249.0,93.28571428571428,7,4087,9188.166666666666,1514.0,583.8571428571429
14338669.0,17,6,2052,6,2052,2867733.8,342.0,342.0,0,0,0.0,0.0,0.0
108892978.0,6,278,32656,139,9470,789079.5507246377,140.0,68.12949640287769,139,23186,787322.4710144928,284.0,166.80575539568346
43356.0,6,14,4740,7,653,7015.166666666667,249.0,93.28571428571428,7,4087,7082.666666666667,1514.0,583.8571428571429
1283902.0,17,7,490,7,490,213983.66666666663,70.0,70.0,0,0,0.0,0.0,0.0
324198.0,17,4,1400,4,1400,108066.0,350.0,350.0,0,0,0.0,0.0,0.0
37726.0,6,10,2032,5,524,9212.25,252.0,104.8,5,1508,8537.0,1236.0,301.6
108103815.0,17,5,1005,5,1005,27025953.75,201.0,201.0,0,0,0.0,0.0,0.0
101472.0,17,2,286,2,286,0.0,143.0,143.0,0,0,0.0,0.0,0.0
9363.0,17,2,582,1,83,0.0,83.0,83.0,1,499,0.0,499.0,499.0
3049035.0,6,3,204,1,68,0.0,68.0,68.0,2,136,0.0,70.0,68.0
3014779.0,6,11,2106,6,598,601203.2,252.0,99.66666666666669,5,1508,3758.75,1236.0,301.6
2402.0,17,4,344,2,150,0.0,75.0,75.0,2,194,0.0,103.0,97.0
44418.0,6,10,2032,5,524,10530.0,252.0,104.8,5,1508,9983.0,1236.0,301.6
16797.0,6,11,1133,6,602,3359.4,264.0,100.33333333333331,5,531,2326.25,259.0,106.2
226.0,17,2,700,2,700,0.0,350.0,350.0,0,0,0.0,0.0,0.0
90095718.0,6,12,1848,5,1020,22523355.0,204.0,204.0,7,828,14970473.666666666,188.0,118.28571428571428
20483.0,17,2,582,1,83,0.0,83.0,83.0,1,499,0.0,499.0,499.0
44575.0,6,10,2032,5,524,10834.25,252.0,104.8,5,1508,10036.0,1236.0,301.6
318126.0,17,4,1400,4,1400,106042.0,350.0,350.0,0,0,0.0,0.0,0.0
7010.0,17,4,823,2,163,0.0,89.0,81.5,2,660,0.0,443.0,330.0
108928.0,17,2,286,2,286,0.0,143.0,143.0,0,0,0.0,0.0,0.0
307844.0,6,12,1373,7,714,51307.333333333336,298.0,102.0,5,659,76099.0,379.0,131.8
6882.0,17,2,582,1,83,0.0,83.0,83.0,1,499,0.0,499.0,499.0
516200.0,6,3,202,1,66,0.0,66.0,66.0,2,136,0.0,70.0,68.0
106372493.0,6,44,2904,22,1452,5065356.80952381,66.0,66.0,22,1452,5050387.571428572,66.0,66.0
118920237.0,6,38,2848,20,1531,6248140.052631579,139.0,76.55,18,1317,6983213.764705882,123.0,73.16666666666667
20211.0,6,14,4740,7,653,3167.6666666666665,249.0,93.28571428571428,7,4087,2991.833333333333,1514.0,583.8571428571429
121945.0,17,2,180,1,70,0.0,70.0,70.0,1,110,0.0,110.0,110.0
34408.0,6,10,2032,5,524,8368.25,252.0,104.8,5,1508,8328.5,1236.0,301.6
42773.0,6,10,2032,5,524,9870.0,252.0,104.8,5,1508,8300.25,1236.0,301.6
27256.0,6,11,2098,6,590,5061.2,252.0,98.33333333333331,5,1508,6393.25,1236.0,301.6
16767.0,6,20,7606,11,978,1676.7,310.0,88.9090909090909,9,6628,1798.5,1514.0,736.4444444444445
108102686.0,17,5,1005,5,1005,27025671.5,201.0,201.0,0,0,0.0,0.0,0.0
402452.0,6,4,508,2,238,0.0,172.0,119.0,2,270,0.0,135.0,135.0
308963.0,6,3,202,2,128,0.0,74.0,64.0,1,74,0.0,74.0,74.0
197096.0,17,2,180,1,90,0.0,90.0,90.0,1,90,0.0,90.0,90.0
947.0,17,4,438,2,148,0.0,74.0,74.0,2,290,0.0,147.0,145.0
120343147.0,6,223,25262,112,17640,1084172.4954954954,284.0,157.5,111,7622,1085700.790909091,140.0,68.66666666666667
207060.0,6,3,426,2,280,0.0,214.0,140.0,1,146,0.0,146.0,146.0
40877.0,6,14,4740,7,653,6586.5,249.0,93.28571428571428,7,4087,5336.5,1514.0,583.8571428571429
205287.0,17,2,762,2,762,0.0,381.0,381.0,0,0,0.0,0.0,0.0
120005669.0,6,18,1341,9,691,14999993.125,95.0,76.77777777777777,9,650,15000533.625,95.0,72.22222222222223
319552.0,17,4,704,2,148,0.0,74.0,74.0,2,556,0.0,280.0,278.0
120139202.0,6,216,24328,108,7350,1095674.7009345794,140.0,68.05555555555556,108,16978,1105447.9158878506,284.0,157.2037037037037
370.0,17,2,762,2,762,0.0,381.0,381.0,0,0,0.0,0.0,0.0
45775.0,6,14,4740,7,653,6669.0,249.0,93.28571428571428,7,4087,5954.166666666667,1514.0,583.8571428571429
90294708.0,6,16,1192,8,596,12891944.857142856,95.0,74.5,8,596,12898226.285714284,95.0,74.5
90038228.0,17,28,13364,28,13364,3334749.185185185,501.0,477.2857142857143,0,0,0.0,0.0,0.0
22253.0,6,14,4740,7,653,3588.5,249.0,93.28571428571428,7,4087,3482.6666666666665,1514.0,583.8571428571429
90048016.0,17,27,12943,27,12943,3463385.230769231,501.0,479.3703703703704,0,0,0.0,0.0,0.0
46050.0,6,14,4740,7,653,6951.5,249.0,93.28571428571428,7,4087,5877.833333333333,1514.0,583.8571428571429
25910.0,6,10,2032,5,524,6169.0,252.0,104.8,5,1508,6151.25,1236.0,301.6
120016959.0,17,28,13364,28,13364,4445072.555555556,501.0,477.2857142857143,0,0,0.0,0.0,0.0
101961939.0,17,13,1083,7,563,16993656.5,174.0,80.42857142857143,6,520,16508522.0,174.0,86.66666666666667
217797.0,6,3,426,2,280,0.0,214.0,140.0,1,146,0.0,146.0,146.0
26869.0,6,10,2032,5,524,6270.75,252.0,104.8,5,1508,6202.0,1236.0,301.6
0.0,17,1,44,1,44,0.0,44.0,44.0,0,0,0.0,0.0,0.0
120520906.0,6,249,28508,125,20102,971942.7903225806,284.0,160.816,124,8406,971452.048780488,140.0,67.79032258064517
142133.0,6,2,132,1,66,0.0,66.0,66.0,1,66,0.0,66.0,66.0
113255057.0,6,46,3036,23,1518,5135431.909090909,66.0,66.0,23,1518,5135444.090909091,66.0,66.0
10502772.0,6,7,478,4,272,3453996.333333333,74.0,68.0,3,206,5180893.5,74.0,68.66666666666667
233011.0,6,3,337,2,214,0.0,160.0,107.0,1,123,0.0,123.0,123.0
135136051.0,17,6,1206,6,1206,27027210.2,201.0,201.0,0,0,0.0,0.0,0.0
2936193.0,6,3,204,2,136,0.0,70.0,68.0,1,68,0.0,68.0,68.0
18249.0,6,11,1131,6,600,3318.0,262.0,100.0,5,531,3782.25,259.0,106.2
36385.0,6,13,1479,7,882,5827.666666666667,291.0,126.0,6,597,6195.0,259.0,99.5
120044187.0,17,28,13364,28,13364,4446081.0,501.0,477.2857142857143,0,0,0.0,0.0,0.0
317.0,17,2,174,1,79,0.0,79.0,79.0,1,95,0.0,95.0,95.0
123309555.0,6,48,3168,24,1584,5104224.739130435,66.0,66.0,24,1584,5185743.782608695,66.0,66.0
118432277.0,6,48,3168,24,1584,5149229.434782608,66.0,66.0,24,1584,5139840.260869565,66.0,66.0
2422.0,17,4,344,2,150,0.0,75.0,75.0,2,194,0.0,103.0,97.0
1035.0,17,4,438,2,148,0.0,74.0,74.0,2,290,0.0,147.0,145.0
303680.0,6,2,132,1,66,0.0,66.0,66.0,1,66,0.0,66.0,66.0
56188.0,6,14,4740,7,653,8614.166666666666,249.0,93.28571428571428,7,4087,9229.0,1514.0,583.8571428571429
44827.0,6,11,2098,6,590,8441.8,252.0,98.33333333333331,5,1508,10781.25,1236.0,301.6
171607.0,17,2,180,1,90,0.0,90.0,90.0,1,90,0.0,90.0,90.0
27782.0,6,14,4740,7,653,4421.0,249.0,93.28571428571428,7,4087,2337.5,1514.0,583.8571428571429
120122889.0,6,15,2428,9,1204,15015361.125,188.0,133.77777777777777,6,1224,18072602.0,204.0,204.0
108118055.0,17,5,1005,5,1005,27029513.75,201.0,201.0,0,0,0.0,0.0,0.0
4240.0,17,2,598,1,72,0.0,72.0,72.0,1,526,0.0,526.0,526.0
90300530.0,6,19,1436,10,745,10028294.555555556,95.0,74.5,9,691,11286828.125,95.0,76.77777777777777
4267.0,17,2,614,1,72,0.0,72.0,72.0,1,542,0.0,542.0,542.0
0.0,6,1,66,1,66,0.0,66.0,66.0,0,0,0.0,0.0,0.0
45397.0,6,10,2032,5,524,11116.25,252.0,104.8,5,1508,10032.75,1236.0,301.6
52818.0,6,14,4740,7,653,8678.833333333334,249.0,93.28571428571428,7,4087,7517.0,1514.0,583.8571428571429
546611.0,6,2,132,1,66,0.0,66.0,66.0,1,66,0.0,66.0,66.0
21307.0,6,14,4740,7,653,3424.1666666666665,249.0,93.28571428571428,7,4087,3135.833333333333,1514.0,583.8571428571429
90059180.0,17,28,13364,28,13364,3335525.185185185,501.0,477.2857142857143,0,0,0.0,0.0,0.0
104718039.0,17,14,864,7,432,17333541.166666668,174.0,61.71428571428572,7,432,17334532.166666668,174.0,61.71428571428572
135131603.0,17,6,1146,6,1146,27026320.6,191.0,191.0,0,0,0.0,0.0,0.0
36152.0,6,14,4740,7,653,5900.333333333333,249.0,93.28571428571428,7,4087,5684.833333333333,1514.0,583.8571428571429
299409.0,6,6,412,4,272,99803.0,74.0,68.0,2,140,0.0,74.0,70.0
2414.0,17,4,344,2,150,0.0,75.0,75.0,2,194,0.0,103.0,97.0
237215.0,6,10,1221,6,636,47443.0,298.0,106.0,4,585,77913.0,379.0,146.25
122001156.0,17,15,907,8,475,17428736.57142857,174.0,59.375,7,432,17000647.0,174.0,61.71428571428572
5274.0,17,2,762,2,762,0.0,381.0,381.0,0,0,0.0,0.0,0.0
217419.0,6,3,426,2,280,0.0,214.0,140.0,1,146,0.0,146.0,146.0
87174.0,6,14,4740,7,653,14350.5,249.0,93.28571428571428,7,4087,13796.166666666666,1514.0,583.8571428571429
1230.0,17,2,684,2,684,0.0,342.0,342.0,0,0,0.0,0.0,0.0
10523090.0,6,7,478,4,272,3462261.0,74.0,68.0,3,206,5193278.5,74.0,68.66666666666667
323.0,17,2,160,1,80,0.0,80.0,80.0,1,80,0.0,80.0,80.0
243182.0,6,3,337,2,214,0.0,160.0,107.0,1,123,0.0,123.0,123.0
92710070.0,6,38,2508,19,1254,5135435.333333333,66.0,66.0,19,1254,5135433.722222222,66.0,66.0
187828.0,17,4,6056,4,6056,62609.333333333336,1514.0,1514.0,0,0,0.0,0.0,0.0
90090847.0,6,11,1644,7,828,15015141.166666666,188.0,118.28571428571428,4,816,20020531.0,204.0,204.0
100877736.0,17,14,1126,7,563,16786331.166666668,174.0,80.42857142857143,7,563,16783431.833333332,174.0,80.42857142857143
216238.0,17,2,180,1,90,0.0,90.0,90.0,1,90,0.0,90.0,90.0
27444127.0,17,5,1710,5,1710,6861031.75,342.0,342.0,0,0,0.0,0.0,0.0
115895934.0,6,36,2596,18,1348,6817407.882352941,139.0,74.88888888888889,18,1248,6805359.176470588,123.0,69.33333333333333
298033.0,6,6,412,4,272,99344.33333333331,74.0,68.0,2,140,0.0,74.0,70.0
47595.0,6,14,4740,7,653,7809.833333333333,249.0,93.28571428571428,7,4087,5529.5,1514.0,583.8571428571429
24710.0,6,11,2098,6,590,3955.8,252.0,98.33333333333331,5,1508,5609.0,1236.0,301.6
45039742.0,17,10,3428,9,3078,4728896.625,342.0,342.0,1,350,0.0,350.0,350.0
246321.0,6,3,373,2,238,0.0,172.0,119.0,1,135,0.0,135.0,135.0
130788.0,6,3,337,2,214,0.0,160.0,107.0,1,123,0.0,123.0,123.0
101361.0,17,2,286,2,286,0.0,143.0,143.0,0,0,0.0,0.0,0.0
2496.0,17,4,344,2,150,0.0,75.0,75.0,2,194,0.0,103.0,97.0
200037.0,17,2,180,1,90,0.0,90.0,90.0,1,90,0.0,90.0,90.0
148036.0,17,2,180,1,90,0.0,90.0,90.0,1,90,0.0,90.0,90.0
2083.0,17,4,344,2,150,0.0,75.0,75.0,2,194,0.0,103.0,97.0
3103.0,17,4,625,2,163,0.0,89.0,81.5,2,462,0.0,245.0,231.0
108107197.0,17,5,955,5,955,27026799.25,191.0,191.0,0,0,0.0,0.0,0.0
206245.0,6,3,426,2,280,0.0,214.0,140.0,1,146,0.0,146.0,146.0
307185.0,6,10,1221,6,636,61437.0,298.0,106.0,4,585,93419.66666666669,379.0,146.25
233196.0,6,3,337,2,214,0.0,160.0,107.0,1,123,0.0,123.0,123.0
234715.0,6,3,337,2,214,0.0,160.0,107.0,1,123,0.0,123.0,123.0
860804.0,6,9,1196,6,725,172160.8,387.0,120.83333333333331,3,471,292523.0,331.0,157.0
119511408.0,6,225,25484,113,17796,1067066.142857143,284.0,157.4867256637168,112,7688,1067346.9279279278,140.0,68.64285714285714
496453.0,6,4,270,2,134,0.0,68.0,67.0,2,136,0.0,70.0,68.0
51537.0,17,2,180,1,90,0.0,90.0,90.0,1,90,0.0,90.0,90.0
506347.0,6,3,1604,2,851,0.0,785.0,425.5,1,753,0.0,753.0,753.0
250216.0,17,4,6056,4,6056,83405.33333333333,1514.0,1514.0,0,0,0.0,0.0,0.0
129001463.0,17,15,907,8,475,18428780.42857143,174.0,59.375,7,432,18167693.5,174.0,61.71428571428572
90285554.0,6,13,2036,8,1016,12897936.285714284,188.0,127.0,5,1020,22529910.75,204.0,204.0
90093884.0,6,10,1440,7,828,15015647.333333334,188.0,118.28571428571428,3,612,30031598.0,204.0,204.0
97807522.0,17,14,1126,7,563,16167566.0,174.0,80.42857142857143,7,563,16166798.0,174.0,80.42857142857143
315.0,17,2,174,1,79,0.0,79.0,79.0,1,95,0.0,95.0,95.0
90044776.0,17,28,13364,28,13364,3334991.703703704,501.0,477.2857142857143,0,0,0.0,0.0,0.0
102983969.0,6,44,2904,22,1452,4901739.619047619,66.0,66.0,22,1452,4901315.952380952,66.0,66.0
90259497.0,6,12,1832,8,1016,12894213.857142856,188.0,127.0,4,816,30029630.33333333,204.0,204.0
300.0,17,2,156,1,78,0.0,78.0,78.0,1,78,0.0,78.0,78.0
90045100.0,17,28,13364,28,13364,3335003.703703704,501.0,477.2857142857143,0,0,0.0,0.0,0.0
309361.0,6,6,412,4,272,103120.33333333331,74.0,68.0,2,140,0.0,74.0,70.0
25655.0,6,14,4740,7,653,4156.666666666667,249.0,93.28571428571428,7,4087,4134.833333333333,1514.0,583.8571428571429
302722.0,6,6,412,4,272,100907.33333333331,74.0,68.0,2,140,0.0,74.0,70.0
90525756.0,6,14,2240,8,1016,12932250.857142856,188.0,127.0,6,1224,18072321.4,204.0,204.0
93950112.0,6,196,22092,98,15402,966337.5154639176,284.0,157.16326530612244,98,6690,966336.7216494846,140.0,68.26530612244898
284537.0,17,2,363,1,79,0.0,79.0,79.0,1,284,0.0,284.0,284.0
183539.0,17,2,224,1,76,0.0,76.0,76.0,1,148,0.0,148.0,148.0
228293.0,17,2,180,1,90,0.0,90.0,90.0,1,90,0.0,90.0,90.0
2591077.0,6,2,132,1,66,0.0,66.0,66.0,1,66,0.0,66.0,66.0
135128649.0,17,6,1146,6,1146,27025729.8,191.0,191.0,0,0,0.0,0.0,0.0
1163678.0,6,13,3011,8,2383,166239.7142857143,1514.0,297.875,5,628,222121.25,331.0,125.6
2507381.0,6,3,1604,2,851,0.0,785.0,425.5,1,753,0.0,753.0,753.0
312000.0,6,3,202,2,128,0.0,74.0,64.0,1,74,0.0,74.0,74.0
41785.0,6,14,4740,7,653,6742.833333333333,249.0,93.28571428571428,7,4087,6227.833333333333,1514.0,583.8571428571429
3569157.0,6,5,336,2,134,0.0,68.0,67.0,3,202,1525917.0,70.0,67.33333333333333
112032555.0,17,12,778,7,432,18666832.5,174.0,61.71428571428572,5,346,27999935.5,174.0,69.2
2599315.0,6,2,132,1,66,0.0,66.0,66.0,1,66,0.0,66.0,66.0
234785.0,6,3,337,2,214,0.0,160.0,107.0,1,123,0.0,123.0,123.0
304241.0,6,6,412,4,272,101413.66666666669,74.0,68.0,2,140,0.0,74.0,70.0
157888.0,17,2,180,1,90,0.0,90.0,90.0,1,90,0.0,90.0,90.0
108126.0,17,2,286,2,286,0.0,143.0,143.0,0,0,0.0,0.0,0.0
25821.0,6,14,4740,7,653,3066.0,249.0,93.28571428571428,7,4087,4079.5,1514.0,583.8571428571429
295357.0,6,4,492,2,280,0.0,214.0,140.0,2,212,0.0,146.0,106.0
1997.0,17,2,180,1,90,0.0,90.0,90.0,1,90,0.0,90.0,90.0
118053149.0,6,30,1974,15,1026,8416947.0,123.0,68.4,15,948,8416949.285714285,123.0,63.2
302018.0,6,6,412,4,272,100672.66666666669,74.0,68.0,2,140,0.0,74.0,70.0
329.0,17,2,166,1,75,0.0,75.0,75.0,1,91,0.0,91.0,91.0
125937.0,6,2,132,1,66,0.0,66.0,66.0,1,66,0.0,66.0,66.0
248206.0,6,3,337,2,214,0.0,160.0,107.0,1,123,0.0,123.0,123.0
14661315.0,6,20,1648,10,1016,1594672.7777777778,315.0,101.6,10,632,1594644.111111111,78.0,63.2
107491.0,17,2,286,2,286,0.0,143.0,143.0,0,0,0.0,0.0,0.0
58754.0,6,10,2032,5,524,14287.75,252.0,104.8,5,1508,14319.0,1236.0,301.6
68531.0,6,14,4740,7,653,10050.666666666666,249.0,93.28571428571428,7,4087,10118.0,1514.0,583.8571428571429
540152.0,17,6,2100,6,2100,108030.4,350.0,350.0,0,0,0.0,0.0,0.0
90029402.0,17,28,13364,28,13364,3334422.296296296,501.0,477.2857142857143,0,0,0.0,0.0,0.0
9897.0,6,10,1066,5,490,2274.0,218.0,98.0,5,576,2197.75,304.0,115.2
317665.0,6,6,412,4,272,105888.33333333331,74.0,68.0,2,140,0.0,74.0,70.0
5829086.0,6,4,270,2,134,0.0,68.0,67.0,2,136,0.0,70.0,68.0
217267.0,6,12,1373,7,714,36211.16666666666,298.0,102.0,5,659,53418.25,379.0,131.8
207526.0,6,3,426,2,280,0.0,214.0,140.0,1,146,0.0,146.0,146.0
121452478.0,6,32,2242,17,1225,7590779.875,139.0,72.05882352941177,15,1017,7946552.142857143,123.0,67.8
213691.0,17,2,180,1,90,0.0,90.0,90.0,1,90,0.0,90.0,90.0
319541.0,17,4,1400,4,1400,106513.66666666669,350.0,350.0,0,0,0.0,0.0,0.0
308991.0,6,3,202,2,128,0.0,74.0,64.0,1,74,0.0,74.0,74.0
20707.0,6,10,2032,5,524,4935.25,252.0,104.8,5,1508,4905.5,1236.0,301.6
1048651.0,6,11,2023,6,515,209409.6,169.0,85.83333333333333,5,1508,2730.75,1236.0,301.6
117411579.0,6,231,26414,116,7952,1020927.1565217392,140.0,68.55172413793103,115,18462,1022784.1754385964,300.0,160.5391304347826
312274.0,17,4,1400,4,1400,104091.33333333331,350.0,350.0,0,0,0.0,0.0,0.0
296.0,17,2,156,1,78,0.0,78.0,78.0,1,78,0.0,78.0,78.0
14636107.0,6,20,1607,10,975,1592264.0,315.0,97.5,10,632,1592241.6666666667,78.0,63.2
206002.0,6,3,426,2,280,0.0,214.0,140.0,1,146,0.0,146.0,146.0
98262784.0,6,29,2062,15,1017,7018739.428571428,123.0,67.8,14,1045,7458660.307692308,139.0,74.64285714285714
120121750.0,6,17,2572,8,1368,17160250.0,204.0,171.0,9,1204,14994552.875,188.0,133.77777777777777
45749.0,6,14,4740,7,653,6943.666666666667,249.0,93.28571428571428,7,4087,7487.0,1514.0,583.8571428571429
261381.0,6,10,1221,6,636,52276.2,298.0,106.0,4,585,80608.33333333333,379.0,146.25
281127.0,17,2,180,1,90,0.0,90.0,90.0,1,90,0.0,90.0,90.0
141158.0,17,4,704,2,148,0.0,74.0,74.0,2,556,0.0,280.0,278.0
90045268.0,17,28,13364,28,13364,3335009.925925926,501.0,477.2857142857143,0,0,0.0,0.0,0.0
152300.0,17,2,414,1,88,0.0,88.0,88.0,1,326,0.0,326.0,326.0
0.0,17,1,90,1,90,0.0,90.0,90.0,0,0,0.0,0.0,0.0
1317765.0,6,4,264,2,132,0.0,66.0,66.0,2,132,0.0,66.0,66.0
167250.0,6,11,1132,6,556,33370.4,218.0,92.66666666666669,5,576,41206.0,304.0,115.2
2428.0,17,4,344,2,150,0.0,75.0,75.0,2,194,0.0,103.0,97.0
26409.0,6,14,4740,7,653,4141.666666666667,249.0,93.28571428571428,7,4087,3691.5,1514.0,583.8571428571429
252351.0,6,3,337,2,214,0.0,160.0,107.0,1,123,0.0,123.0,123.0
2943543.0,6,3,1777,1,826,0.0,826.0,826.0,2,951,0.0,885.0,475.5
153455.0,17,2,180,1,90,0.0,90.0,90.0,1,90,0.0,90.0,90.0
207291.0,6,3,426,2,280,0.0,214.0,140.0,1,146,0.0,146.0,146.0
33518.0,6,14,4740,7,653,5333.5,249.0,93.28571428571428,7,4087,5454.0,1514.0,583.8571428571429
2358.0,17,4,344,2,150,0.0,75.0,75.0,2,194,0.0,103.0,97.0
155136.0,6,3,337,2,214,0.0,160.0,107.0,1,123,0.0,123.0,123.0
206839.0,6,3,426,2,280,0.0,214.0,140.0,1,146,0.0,146.0,146.0
2394.0,17,4,344,2,150,0.0,75.0,75.0,2,194,0.0,103.0,97.0
220851.0,17,2,414,1,88,0.0,88.0,88.0,1,326,0.0,326.0,326.0
433959.0,17,2,176,1,80,0.0,80.0,80.0,1,96,0.0,96.0,96.0
10483617.0,6,7,478,4,272,3447276.333333333,74.0,68.0,3,206,5170793.5,74.0,68.66666666666667
43004.0,6,14,4740,7,653,6941.666666666667,249.0,93.28571428571428,7,4087,6598.166666666667,1514.0,583.8571428571429
108108846.0,17,5,955,5,955,27027211.5,191.0,191.0,0,0,0.0,0.0,0.0
135129824.0,17,6,1146,6,1146,27025964.8,191.0,191.0,0,0,0.0,0.0,0.0
135133001.0,17,6,1206,6,1206,27026600.2,201.0,201.0,0,0,0.0,0.0,0.0
19267.0,6,10,2032,5,524,4426.25,252.0,104.8,5,1508,4002.5,1236.0,301.6
103243.0,17,2,286,2,286,0.0,143.0,143.0,0,0,0.0,0.0,0.0
217526.0,6,3,426,2,280,0.0,214.0,140.0,1,146,0.0,146.0,146.0
115225719.0,6,48,3168,24,1584,5009813.869565218,66.0,66.0,24,1584,4997973.478260869,66.0,66.0
95371912.0,17,12,778,6,389,19042597.8,174.0,64.83333333333333,6,389,19048461.2,174.0,64.83333333333333
4598930.0,6,5,336,2,134,0.0,68.0,67.0,3,202,1423653.0,70.0,67.33333333333333
120154637.0,6,210,23790,105,7152,1147441.701923077,140.0,68.11428571428571,105,16638,1147296.0096153845,284.0,158.45714285714286
143252.0,6,2,132,1,66,0.0,66.0,66.0,1,66,0.0,66.0,66.0
9616.0,17,2,571,1,86,0.0,86.0,86.0,1,485,0.0,485.0,485.0
2123288.0,6,24,6934,13,1996,176940.66666666666,477.0,153.53846153846155,11,4938,181580.3,1510.0,448.9090909090909
76976.0,6,14,4740,7,653,11899.5,249.0,93.28571428571428,7,4087,11030.5,1514.0,583.8571428571429
2335.0,17,4,344,2,150,0.0,75.0,75.0,2,194,0.0,103.0,97.0
50830.0,17,2,180,1,90,0.0,90.0,90.0,1,90,0.0,90.0,90.0
39769.0,6,14,4740,7,653,6497.5,249.0,93.28571428571428,7,4087,5897.666666666667,1514.0,583.8571428571429
298291.0,6,6,412,4,272,99430.33333333331,74.0,68.0,2,140,0.0,74.0,70.0
16768.0,6,14,4740,7,653,2453.0,249.0,93.28571428571428,7,4087,2658.6666666666665,1514.0,583.8571428571429
10466879.0,6,7,478,4,272,3443220.0,74.0,68.0,3,206,5164692.5,74.0,68.66666666666667
282108.0,17,2,180,1,90,0.0,90.0,90.0,1,90,0.0,90.0,90.0
50210.0,6,12,1328,7,797,8368.333333333334,253.0,113.85714285714286,5,531,10728.5,259.0,106.2
223054.0,17,2,180,1,90,0.0,90.0,90.0,1,90,0.0,90.0,90.0
323582.0,6,6,412,4,272,107860.66666666669,74.0,68.0,2,140,0.0,74.0,70.0
104071.0,17,2,286,2,286,0.0,143.0,143.0,0,0,0.0,0.0,0.0
1021722.0,6,11,1134,6,558,204344.4,220.0,93.0,5,576,254154.5,304.0,115.2
96714034.0,6,69,13910,34,7208,2930728.303030303,1514.0,212.0,35,6702,2836857.794117647,1514.0,191.4857142857143
367382.0,6,10,967,5,390,62035.5,162.0,78.0,5,577,61972.0,349.0,115.4
107435.0,17,2,286,2,286,0.0,143.0,143.0,0,0,0.0,0.0,0.0
242996.0,6,3,337,2,214,0.0,160.0,107.0,1,123,0.0,123.0,123.0
240114.0,6,3,337,2,214,0.0,160.0,107.0,1,123,0.0,123.0,123.0
108105173.0,17,5,1005,5,1005,27026293.25,201.0,201.0,0,0,0.0,0.0,0.0
221597.0,6,3,426,2,280,0.0,214.0,140.0,1,146,0.0,146.0,146.0
2019.0,17,4,344,2,150,0.0,75.0,75.0,2,194,0.0,103.0,97.0
53942.0,6,14,4740,7,653,8493.333333333334,249.0,93.28571428571428,7,4087,6444.666666666667,1514.0,583.8571428571429
219338.0,6,3,426,2,280,0.0,214.0,140.0,1,146,0.0,146.0,146.0
135132203.0,17,6,1206,6,1206,27026440.6,201.0,201.0,0,0,0.0,0.0,0.0
27838.0,6,11,1133,6,602,5058.0,264.0,100.33333333333331,5,531,6131.25,259.0,106.2
38243.0,6,14,4740,7,653,6079.0,249.0,93.28571428571428,7,4087,6238.5,1514.0,583.8571428571429
27523.0,6,14,4740,7,653,4309.833333333333,249.0,93.28571428571428,7,4087,4398.166666666667,1514.0,583.8571428571429
54988.0,6,10,2032,5,524,12933.75,252.0,104.8,5,1508,11819.75,1236.0,301.6
26800900.0,17,5,1710,5,1710,6700225.0,342.0,342.0,0,0,0.0,0.0,0.0
325.0,17,2,166,1,75,0.0,75.0,75.0,1,91,0.0,91.0,91.0
46318.0,6,14,4740,7,653,7390.166666666667,249.0,93.28571428571428,7,4087,7500.666666666667,1514.0,583.8571428571429
297406.0,6,6,412,4,272,99135.33333333331,74.0,68.0,2,140,0.0,74.0,70.0
4410.0,17,2,180,1,90,0.0,90.0,90.0,1,90,0.0,90.0,90.0
4550.0,17,2,598,1,72,0.0,72.0,72.0,1,526,0.0,526.0,526.0
3006722.0,6,12,2172,7,664,501120.3333333333,252.0,94.85714285714286,5,1508,1847.25,1236.0,301.6
224770.0,6,13,1386,7,789,37461.66666666666,253.0,112.71428571428572,6,597,43671.8,259.0,99.5
0.0,17,1,381,1,381,0.0,381.0,381.0,0,0,0.0,0.0,0.0
135132825.0,17,6,1206,6,1206,27026565.0,201.0,201.0,0,0,0.0,0.0,0.0
18967.0,6,14,4740,7,653,2781.833333333333,249.0,93.28571428571428,7,4087,3026.0,1514.0,583.8571428571429
320434.0,17,4,1400,4,1400,106811.33333333331,350.0,350.0,0,0,0.0,0.0,0.0
108102793.0,17,5,955,5,955,27025698.25,191.0,191.0,0,0,0.0,0.0,0.0
120045012.0,17,28,13364,28,13364,4446111.555555556,501.0,477.2857142857143,0,0,0.0,0.0,0.0
110040.0,17,4,1400,4,1400,36680.0,350.0,350.0,0,0,0.0,0.0,0.0
299609.0,6,6,412,4,272,99869.66666666669,74.0,68.0,2,140,0.0,74.0,70.0
155672.0,6,3,337,2,214,0.0,160.0,107.0,1,123,0.0,123.0,123.0
146101.0,6,3,337,2,214,0.0,160.0,107.0,1,123,0.0,123.0,123.0
122314582.0,6,48,3168,24,1584,5178412.217391305,66.0,66.0,24,1584,5029342.608695652,66.0,66.0
312148.0,6,3,202,2,128,0.0,74.0,64.0,1,74,0.0,74.0,74.0
113963049.0,6,48,3168,24,1584,4954915.173913044,66.0,66.0,24,1584,4945514.521739131,66.0,66.0
49696.0,6,11,2098,6,590,9718.0,252.0,98.33333333333331,5,1508,11945.0,1236.0,301.6
104400.0,17,2,762,2,762,0.0,381.0,381.0,0,0,0.0,0.0,0.0
1027241.0,6,11,1134,6,558,205448.2,220.0,93.0,5,576,255948.5,304.0,115.2
108107822.0,17,5,1005,5,1005,27026955.5,201.0,201.0,0,0,0.0,0.0,0.0
302452.0,6,6,412,4,272,100817.33333333331,74.0,68.0,2,140,0.0,74.0,70.0
125866791.0,17,14,864,7,432,17666835.833333332,174.0,61.71428571428572,7,432,19952805.166666668,174.0,61.71428571428572
95894290.0,6,25,2009,12,1061,8695952.181818182,221.0,88.41666666666667,13,948,7970898.916666667,95.0,72.92307692307692
3012218.0,6,11,2106,6,598,602255.4,252.0,99.66666666666669,5,1508,3495.75,1236.0,301.6
6714.0,17,2,582,1,83,0.0,83.0,83.0,1,499,0.0,499.0,499.0
111666904.0,17,14,864,7,432,18500217.83333333,174.0,61.71428571428572,7,432,18500995.5,174.0,61.71428571428572
101321.0,6,12,1320,6,723,13143.8,253.0,120.5,6,597,18951.4,259.0,99.5
303091.0,6,6,412,4,272,101030.33333333331,74.0,68.0,2,140,0.0,74.0,70.0
764.0,17,4,438,2,148,0.0,74.0,74.0,2,290,0.0,147.0,145.0
307181.0,6,6,412,4,272,102393.66666666669,74.0,68.0,2,140,0.0,74.0,70.0
90028313.0,17,28,13364,28,13364,3334381.962962963,501.0,477.2857142857143,0,0,0.0,0.0,0.0
90592189.0,17,12,778,6,389,18000160.2,174.0,64.83333333333333,6,389,18001029.6,174.0,64.83333333333333
37557.0,6,14,4740,7,653,5921.0,249.0,93.28571428571428,7,4087,5363.5,1514.0,583.8571428571429
237465.0,6,3,337,2,214,0.0,160.0,107.0,1,123,0.0,123.0,123.0
33718.0,6,10,2032,5,524,8212.5,252.0,104.8,5,1508,8169.25,1236.0,301.6
90056977.0,17,28,13364,28,13364,3335443.592592593,501.0,477.2857142857143,0,0,0.0,0.0,0.0
76552411.0,6,9,842,9,842,9569051.375,97.0,93.55555555555556,0,0,0.0,0.0,0.0
297953.0,6,6,412,4,272,99317.66666666669,74.0,68.0,2,140,0.0,74.0,70.0
311209.0,17,2,246,1,76,0.0,76.0,76.0,1,170,0.0,170.0,170.0
1770921.0,6,2,132,1,66,0.0,66.0,66.0,1,66,0.0,66.0,66.0
120072739.0,17,29,13785,29,13785,4288312.107142857,501.0,475.3448275862069,0,0,0.0,0.0,0.0
31998.0,6,10,2032,5,524,4622.5,252.0,104.8,5,1508,7712.75,1236.0,301.6
90053892.0,17,28,13364,28,13364,3335329.333333333,501.0,477.2857142857143,0,0,0.0,0.0,0.0
196928.0,17,2,180,1,90,0.0,90.0,90.0,1,90,0.0,90.0,90.0
90255759.0,6,13,2036,8,1016,12893679.857142856,188.0,127.0,5,1020,22523273.75,204.0,204.0
2791996.0,6,2,132,1,66,0.0,66.0,66.0,1,66,0.0,66.0,66.0
207128.0,6,3,426,2,280,0.0,214.0,140.0,1,146,0.0,146.0,146.0
337.0,17,2,166,1,75,0.0,75.0,75.0,1,91,0.0,91.0,91.0
137177.0,6,2,132,1,66,0.0,66.0,66.0,1,66,0.0,66.0,66.0
90045668.0,17,28,13364,28,13364,3335024.7407407407,501.0,477.2857142857143,0,0,0.0,0.0,0.0
204608.0,17,2,762,2,762,0.0,381.0,381.0,0,0,0.0,0.0,0.0
107858379.0,6,28,1860,14,966,8296798.384615385,123.0,69.0,14,894,8280149.307692308,123.0,63.85714285714285
90258127.0,6,12,1832,8,1016,12894018.142857144,188.0,127.0,4,816,30031053.33333333,204.0,204.0
204902.0,17,2,762,2,762,0.0,381.0,381.0,0,0,0.0,0.0,0.0
3170404.0,6,18,1536,9,962,358114.875,315.0,106.88888888888889,9,574,358076.25,78.0,63.77777777777778
158101.0,6,10,1066,5,490,39061.25,218.0,98.0,5,576,39303.5,304.0,115.2
34771686.0,6,5,336,2,134,0.0,68.0,67.0,3,202,15987425.5,70.0,67.33333333333333
90032164.0,17,28,13364,28,13364,3334524.592592593,501.0,477.2857142857143,0,0,0.0,0.0,0.0
120068950.0,17,28,13364,28,13364,4446998.148148148,501.0,477.2857142857143,0,0,0.0,0.0,0.0
303956.0,6,6,412,4,272,101318.66666666669,74.0,68.0,2,140,0.0,74.0,70.0
222002.0,6,10,1221,6,636,44400.4,298.0,106.0,4,585,70893.33333333333,379.0,146.25
44774.0,6,14,4740,7,653,4761.833333333333,249.0,93.28571428571428,7,4087,6941.0,1514.0,583.8571428571429
27323.0,6,14,4740,7,653,3826.0,249.0,93.28571428571428,7,4087,4197.666666666667,1514.0,583.8571428571429
495108.0,6,5,336,2,134,0.0,68.0,67.0,3,202,191725.5,70.0,67.33333333333333
22940.0,6,14,4740,7,653,3677.3333333333335,249.0,93.28571428571428,7,4087,3690.3333333333335,1514.0,583.8571428571429
90255400.0,6,13,2036,8,1016,12893628.57142857,188.0,127.0,5,1020,22519851.25,204.0,204.0
10196.0,17,2,458,1,85,0.0,85.0,85.0,1,373,0.0,373.0,373.0
2359.0,17,4,344,2,150,0.0,75.0,75.0,2,194,0.0,103.0,97.0
27424182.0,17,5,1710,5,1710,6856045.5,342.0,342.0,0,0,0.0,0.0,0.0
15666995.0,6,5,1736,2,819,0.0,753.0,409.5,3,917,7771202.5,785.0,305.6666666666667
108113772.0,17,5,955,5,955,27028443.0,191.0,191.0,0,0,0.0,0.0,0.0
204067.0,17,2,762,2,762,0.0,381.0,381.0,0,0,0.0,0.0,0.0
311967.0,17,4,1400,4,1400,103989.0,350.0,350.0,0,0,0.0,0.0,0.0
164584.0,6,10,2032,5,524,40677.25,252.0,104.8,5,1508,2199.75,1236.0,301.6
118733646.0,6,33,2274,17,1125,7420852.875,123.0,66.17647058823529,16,1149,7384807.466666667,123.0,71.8125
2071.0,17,2,664,1,322,0.0,322.0,322.0,1,342,0.0,342.0,342.0
525777.0,17,6,2100,6,2100,105155.4,350.0,350.0,0,0,0.0,0.0,0.0
299637.0,17,4,6056,4,6056,99879.0,1514.0,1514.0,0,0,0.0,0.0,0.0
122975211.0,6,48,3168,24,1584,4962931.347826087,66.0,66.0,24,1584,5304151.0869565215,66.0,66.0
120002774.0,6,18,1341,9,691,14999987.5,95.0,76.77777777777777,9,650,14998519.875,95.0,72.22222222222223
154551.0,17,2,432,1,86,0.0,86.0,86.0,1,346,0.0,346.0,346.0
0.0,17,1,55,1,55,0.0,55.0,55.0,0,0,0.0,0.0,0.0
3285457.0,6,3,1777,2,951,0.0,885.0,475.5,1,826,0.0,826.0,826.0
760.0,17,4,438,2,148,0.0,74.0,74.0,2,290,0.0,147.0,145.0
94130456.0,6,168,18984,84,13218,1131638.939759036,284.0,157.35714285714286,84,5766,1131638.5060240964,140.0,68.64285714285714
302.0,17,2,164,1,82,0.0,82.0,82.0,1,82,0.0,82.0,82.0
2128.0,17,4,344,2,150,0.0,75.0,75.0,2,194,0.0,103.0,97.0
306652.0,6,6,412,4,272,102217.33333333331,74.0,68.0,2,140,0.0,74.0,70.0
37728.0,6,11,1131,6,600,6592.6,262.0,100.0,5,531,3176.0,259.0,106.2
146656.0,6,3,337,2,214,0.0,160.0,107.0,1,123,0.0,123.0,123.0
153601.0,17,2,180,1,90,0.0,90.0,90.0,1,90,0.0,90.0,90.0
7070696.0,6,5,1736,2,819,0.0,753.0,409.5,3,917,3468888.0,785.0,305.6666666666667
123455321.0,6,48,3168,24,1584,5038457.0869565215,66.0,66.0,24,1584,5229361.652173913,66.0,66.0
108107986.0,17,5,1005,5,1005,27026996.5,201.0,201.0,0,0,0.0,0.0,0.0
153514.0,17,2,180,1,90,0.0,90.0,90.0,1,90,0.0,90.0,90.0
120126029.0,6,13,2036,8,1016,17137514.0,188.0,127.0,5,1020,22524044.5,204.0,204.0
118097863.0,6,48,3168,24,1584,5134689.695652174,66.0,66.0,24,1584,5121426.826086956,66.0,66.0
2791774.0,6,2,132,1,66,0.0,66.0,66.0,1,66,0.0,66.0,66.0
90750921.0,6,19,1436,10,745,10078272.666666666,95.0,74.5,9,691,11342714.25,95.0,76.77777777777777
886449.0,6,12,2711,7,743,147741.5,339.0,106.14285714285714,5,1968,153466.0,1514.0,393.6
137549.0,6,2,132,1,66,0.0,66.0,66.0,1,66,0.0,66.0,66.0
879.0,17,4,820,2,156,0.0,78.0,78.0,2,664,0.0,332.0,332.0
265833.0,6,10,1221,6,636,53166.6,298.0,106.0,4,585,87195.33333333333,379.0,146.25
217808.0,6,3,426,2,280,0.0,214.0,140.0,1,146,0.0,146.0,146.0
2430626.0,6,3,1604,1,753,0.0,753.0,753.0,2,851,0.0,785.0,425.5
17756.0,6,14,4740,7,653,2807.5,249.0,93.28571428571428,7,4087,2796.0,1514.0,583.8571428571429
348.0,17,2,267,1,83,0.0,83.0,83.0,1,184,0.0,184.0,184.0
162328.0,17,2,180,1,90,0.0,90.0,90.0,1,90,0.0,90.0,90.0
108101993.0,17,5,1005,5,1005,27025498.25,201.0,201.0,0,0,0.0,0.0,0.0
120926341.0,6,22,1721,9,691,11421381.375,95.0,76.77777777777777,13,1030,10057500.0,95.0,79.23076923076923
276731.0,17,2,180,1,90,0.0,90.0,90.0,1,90,0.0,90.0,90.0
114274871.0,6,48,3168,24,1584,4968472.652173913,66.0,66.0,24,1584,4954801.347826087,66.0,66.0
260402.00000000003,6,10,1221,6,636,52080.4,298.0,106.0,4,585,79645.0,379.0,146.25
14937.0,17,2,180,1,90,0.0,90.0,90.0,1,90,0.0,90.0,90.0
9093.0,17,2,507,1,86,0.0,86.0,86.0,1,421,0.0,421.0,421.0
99882158.0,6,182,20628,91,6228,1100833.4,140.0,68.43956043956044,91,14400,1100572.9,284.0,158.24175824175825
105419937.0,6,43,2838,22,1452,5019984.952380952,66.0,66.0,21,1386,5160000.15,66.0,66.0
232292.0,6,3,337,2,214,0.0,160.0,107.0,1,123,0.0,123.0,123.0
2375913.0,6,3,204,2,136,0.0,70.0,68.0,1,68,0.0,68.0,68.0
104006.0,17,2,286,2,286,0.0,143.0,143.0,0,0,0.0,0.0,0.0
2008.0,17,4,344,2,150,0.0,75.0,75.0,2,194,0.0,103.0,97.0
217542.0,6,3,426,2,280,0.0,214.0,140.0,1,146,0.0,146.0,146.0
58999.0,6,13,1386,7,789,8953.333333333334,253.0,112.71428571428572,6,597,10112.4,259.0,99.5
45589.0,6,14,4740,7,653,7447.666666666667,249.0,93.28571428571428,7,4087,6985.166666666667,1514.0,583.8571428571429
238894.0,6,3,373,2,238,0.0,172.0,119.0,1,135,0.0,135.0,135.0
113770991.0,6,48,3168,24,1584,4946564.826086956,66.0,66.0,24,1584,4935650.521739131,66.0,66.0
90291428.0,6,21,1585,11,840,9024387.8,95.0,76.36363636363636,10,745,10000636.111111112,95.0,74.5
6728.0,17,2,582,1,83,0.0,83.0,83.0,1,499,0.0,499.0,499.0
57615.0,6,14,4740,7,653,9481.0,249.0,93.28571428571428,7,4087,9455.166666666666,1514.0,583.8571428571429
108104224.0,17,5,955,5,955,27026056.0,191.0,191.0,0,0,0.0,0.0,0.0
26834.0,6,14,4740,7,653,4291.5,249.0,93.28571428571428,7,4087,4336.666666666667,1514.0,583.8571428571429
1999.0,17,4,344,2,150,0.0,75.0,75.0,2,194,0.0,103.0,97.0
90256688.0,6,12,1832,8,1016,12893812.57142857,188.0,127.0,4,816,30029138.33333333,204.0,204.0
60214.0,6,10,2032,5,524,14455.25,252.0,104.8,5,1508,14520.0,1236.0,301.6
303480.0,6,6,412,4,272,101160.0,74.0,68.0,2,140,0.0,74.0,70.0
10531093.0,6,7,478,4,272,3464704.333333333,74.0,68.0,3,206,5196929.0,74.0,68.66666666666667
234157.0,6,3,337,2,214,0.0,160.0,107.0,1,123,0.0,123.0,123.0
2276394.0,6,25,7573,14,3735,175107.23076923078,1514.0,266.7857142857143,11,3838,202567.8,1514.0,348.90909090909093
90253992.0,6,12,1832,8,1016,12893427.42857143,188.0,127.0,4,816,30029151.33333333,204.0,204.0
1026153.0,6,11,1134,6,558,205230.6,220.0,93.0,5,576,254734.25,304.0,115.2
90214907.0,6,19,1436,9,691,11245608.125,95.0,76.77777777777777,10,745,9999928.666666666,95.0,74.5
39159.0,6,14,4740,7,653,5706.0,249.0,93.28571428571428,7,4087,6347.666666666667,1514.0,583.8571428571429
208552.0,6,4,492,2,280,0.0,214.0,140.0,2,212,0.0,146.0,106.0
28999.0,6,11,1133,6,602,5159.8,264.0,100.33333333333331,5,531,6611.75,259.0,106.2
27456.0,6,10,2032,5,524,6641.25,252.0,104.8,5,1508,6222.5,1236.0,301.6
2445126.0,6,3,1604,2,851,0.0,785.0,425.5,1,753,0.0,753.0,753.0
547836.0,6,2,132,1,66,0.0,66.0,66.0,1,66,0.0,66.0,66.0
1178372.0,6,13,3010,8,2382,168338.85714285713,1514.0,297.75,5,628,225692.5,331.0,125.6
92113690.0,6,38,2508,19,1254,5105434.333333333,66.0,66.0,19,1254,5105432.5,66.0,66.0
48264.0,6,13,1386,7,789,6293.166666666667,253.0,112.71428571428572,6,597,8872.4,259.0,99.5
50997.0,17,2,180,1,90,0.0,90.0,90.0,1,90,0.0,90.0,90.0
481.0,17,2,166,1,75,0.0,75.0,75.0,1,91,0.0,91.0,91.0
9414.0,17,2,539,1,86,0.0,86.0,86.0,1,453,0.0,453.0,453.0
181384.0,17,2,180,1,90,0.0,90.0,90.0,1,90,0.0,90.0,90.0
133203254.0,17,16,1212,8,606,16285714.857142856,174.0,75.75,8,606,18151556.14285714,174.0,75.75
240086.0,6,12,1373,7,714,40014.333333333336,298.0,102.0,5,659,58930.75,379.0,131.8
113520195.0,6,46,3036,23,1518,5159997.636363637,66.0,66.0,23,1518,5159997.7727272725,66.0,66.0
5002559.0,17,2,150,2,150,0.0,75.0,75.0,0,0,0.0,0.0,0.0
109283649.0,6,38,3118,21,1717,5453395.3,139.0,81.76190476190476,17,1401,6816744.875,123.0,82.41176470588235
108104881.0,17,5,955,5,955,27026220.25,191.0,191.0,0,0,0.0,0.0,0.0
90265396.0,6,12,1832,8,1016,12895056.57142857,188.0,127.0,4,816,30032703.666666668,204.0,204.0
245984.0,6,3,373,2,238,0.0,172.0,119.0,1,135,0.0,135.0,135.0
22913.0,6,14,4740,7,653,3322.1666666666665,249.0,93.28571428571428,7,4087,3680.0,1514.0,583.8571428571429
1639.0,17,2,762,2,762,0.0,381.0,381.0,0,0,0.0,0.0,0.0
15900.000000000002,6,10,2032,5,524,3748.25,252.0,104.8,5,1508,3699.0,1236.0,301.6
16325.0,6,14,4740,7,653,2495.5,249.0,93.28571428571428,7,4087,2536.333333333333,1514.0,583.8571428571429
299348.0,6,6,412,4,272,99782.66666666669,74.0,68.0,2,140,0.0,74.0,70.0
403042.0,6,4,508,2,238,0.0,172.0,119.0,2,270,0.0,135.0,135.0
121313.0,6,3,337,2,214,0.0,160.0,107.0,1,123,0.0,123.0,123.0
96007683.0,17,11,735,6,389,19201536.6,174.0,64.83333333333333,5,346,19000152.75,174.0,69.2
100421.0,17,2,762,2,762,0.0,381.0,381.0,0,0,0.0,0.0,0.0
2319.0,17,4,344,2,150,0.0,75.0,75.0,2,194,0.0,103.0,97.0
153534.0,17,2,180,1,90,0.0,90.0,90.0,1,90,0.0,90.0,90.0
298188.0,17,2,180,1,90,0.0,90.0,90.0,1,90,0.0,90.0,90.0
120124118.0,6,15,2444,7,1428,20020686.33333333,204.0,204.0,8,1016,17098807.42857143,188.0,127.0
312713.0,17,4,1400,4,1400,104237.66666666669,350.0,350.0,0,0,0.0,0.0,0.0
116491453.0,6,232,26174,116,18210,1011098.3913043478,284.0,156.98275862068965,116,7964,1011097.9652173911,140.0,68.65517241379311
121489.0,6,3,337,2,214,0.0,160.0,107.0,1,123,0.0,123.0,123.0
120164240.0,6,276,31766,138,9404,871093.7445255475,140.0,68.14492753623189,138,22362,871040.8832116788,284.0,162.04347826086956
63936.00000000001,6,10,2032,5,524,15727.5,252.0,104.8,5,1508,14886.0,1236.0,301.6
297662.0,6,6,412,4,272,99220.66666666669,74.0,68.0,2,140,0.0,74.0,70.0
24255.0,6,14,4740,7,653,3926.5,249.0,93.28571428571428,7,4087,3899.1666666666665,1514.0,583.8571428571429
336.0,17,2,166,1,75,0.0,75.0,75.0,1,91,0.0,91.0,91.0
2714473.0,6,25,6657,13,1603,226206.0833333333,357.0,123.3076923076923,12,5054,219256.45454545456,1510.0,421.1666666666667
298314.0,6,6,412,4,272,99438.0,74.0,68.0,2,140,0.0,74.0,70.0
106555.0,17,2,286,2,286,0.0,143.0,143.0,0,0,0.0,0.0,0.0
108107113.0,17,5,1005,5,1005,27026778.25,201.0,201.0,0,0,0.0,0.0,0.0
2324.0,17,4,344,2,150,0.0,75.0,75.0,2,194,0.0,103.0,97.0
146151.0,6,3,337,2,214,0.0,160.0,107.0,1,123,0.0,123.0,123.0
216567.0,17,2,180,1,90,0.0,90.0,90.0,1,90,0.0,90.0,90.0
37291.0,6,14,4740,7,653,3804.5,249.0,93.28571428571428,7,4087,5564.0,1514.0,583.8571428571429
3282.0,17,4,344,2,150,0.0,75.0,75.0,2,194,0.0,103.0,97.0
306551.0,6,6,412,4,272,102183.66666666669,74.0,68.0,2,140,0.0,74.0,70.0
16888.0,17,2,180,1,90,0.0,90.0,90.0,1,90,0.0,90.0,90.0
1091290.0,6,13,1386,7,789,181881.66666666663,253.0,112.71428571428572,6,597,216972.8,259.0,99.5
228219.0,17,2,180,1,90,0.0,90.0,90.0,1,90,0.0,90.0,90.0
47817189.0,6,8,2113,3,960,22853344.0,826.0,320.0,5,1153,11258288.5,885.0,230.6
135137866.0,17,6,1206,6,1206,27027573.2,201.0,201.0,0,0,0.0,0.0,0.0
153377.0,17,2,180,1,90,0.0,90.0,90.0,1,90,0.0,90.0,90.0
105284539.0,6,425,68994,213,14428,496625.18396226416,214.0,67.73708920187794,212,54566,497889.63981042657,1514.0,257.3867924528302
228225.0,17,2,180,1,90,0.0,90.0,90.0,1,90,0.0,90.0,90.0
703.0,17,4,438,2,148,0.0,74.0,74.0,2,290,0.0,147.0,145.0
120462142.0,6,203,23042,102,16080,1192694.475247525,284.0,157.64705882352942,101,6962,1194569.12,140.0,68.93069306930693
103109.0,17,2,286,2,286,0.0,143.0,143.0,0,0,0.0,0.0,0.0
306704.0,6,6,412,4,272,102234.66666666669,74.0,68.0,2,140,0.0,74.0,70.0
19777.0,6,14,4740,7,653,3072.6666666666665,249.0,93.28571428571428,7,4087,3160.833333333333,1514.0,583.8571428571429
90805897.0,6,173,19494,87,5964,1055882.523255814,140.0,68.55172413793103,86,13530,1056145.0352941176,284.0,157.32558139534885
4274.0,17,2,602,1,72,0.0,72.0,72.0,1,530,0.0,530.0,530.0
2813553.0,6,3,1604,1,753,0.0,753.0,753.0,2,851,0.0,785.0,425.5
205450.0,6,10,1221,6,636,41090.0,298.0,106.0,4,585,67170.0,379.0,146.25
11252.0,6,12,1393,6,796,2073.6,271.0,132.66666666666666,6,597,2026.2,259.0,99.5
2321.0,17,4,344,2,150,0.0,75.0,75.0,2,194,0.0,103.0,97.0
2791742.0,6,2,132,1,66,0.0,66.0,66.0,1,66,0.0,66.0,66.0
104027.0,17,2,286,2,286,0.0,143.0,143.0,0,0,0.0,0.0,0.0
570.0,17,2,508,2,508,0.0,257.0,254.0,0,0,0.0,0.0,0.0
108112460.0,17,5,955,5,955,27028115.0,191.0,191.0,0,0,0.0,0.0,0.0
317232.0,17,4,1400,4,1400,105744.0,350.0,350.0,0,0,0.0,0.0,0.0
97021722.0,17,12,778,6,389,19400197.8,174.0,64.83333333333333,6,389,19400391.0,174.0,64.83333333333333
90647991.0,6,28,1992,14,1029,6972922.384615385,123.0,73.5,14,963,6957159.923076923,123.0,68.78571428571429
51234.0,17,2,180,1,90,0.0,90.0,90.0,1,90,0.0,90.0,90.0
114411691.0,6,218,24518,109,17028,1057375.3148148148,284.0,156.22018348623854,109,7490,1057375.5277777778,140.0,68.71559633027523
23369.0,6,14,4740,7,653,3499.0,249.0,93.28571428571428,7,4087,3698.8333333333335,1514.0,583.8571428571429
2176.0,17,4,438,2,148,0.0,74.0,74.0,2,290,0.0,147.0,145.0
108046.0,17,2,286,2,286,0.0,143.0,143.0,0,0,0.0,0.0,0.0
2069.0,17,4,344,2,150,0.0,75.0,75.0,2,194,0.0,103.0,97.0
113711755.0,6,47,3102,24,1584,4943989.347826087,66.0,66.0,23,1518,5160839.045454546,66.0,66.0
66658.0,6,12,1447,6,816,12471.0,291.0,136.0,6,631,12191.8,293.0,105.16666666666669
2056.0,17,4,344,2,150,0.0,75.0,75.0,2,194,0.0,103.0,97.0
101193806.0,6,204,22996,102,16042,999787.3465346536,284.0,157.27450980392155,102,6954,999787.3168316832,140.0,68.17647058823529
20549.0,6,11,1133,6,602,3853.4,264.0,100.33333333333331,5,531,4636.5,259.0,106.2
103267.0,17,2,286,2,286,0.0,143.0,143.0,0,0,0.0,0.0,0.0
137744.0,6,2,132,1,66,0.0,66.0,66.0,1,66,0.0,66.0,66.0
191227.0,17,2,180,1,90,0.0,90.0,90.0,1,90,0.0,90.0,90.0
101154004.0,6,194,21886,97,15262,1051446.9166666667,284.0,157.340206185567,97,6624,1051445.8333333333,140.0,68.28865979381443
157355.0,6,3,337,2,214,0.0,160.0,107.0,1,123,0.0,123.0,123.0
27887.0,6,10,2032,5,524,5708.0,252.0,104.8,5,1508,6649.0,1236.0,301.6
123455930.0,6,49,3234,25,1650,5143997.083333333,66.0,66.0,24,1584,4952437.913043479,66.0,66.0
16564.0,6,10,2032,5,524,3871.75,252.0,104.8,5,1508,3570.5,1236.0,301.6
232513.0,6,3,337,2,214,0.0,160.0,107.0,1,123,0.0,123.0,123.0
340.0,17,2,250,1,93,0.0,93.0,93.0,1,157,0.0,157.0,157.0
108956.0,17,2,286,2,286,0.0,143.0,143.0,0,0,0.0,0.0,0.0
110137700.0,6,32,2236,16,1165,7328112.466666667,139.0,72.8125,16,1071,7328112.933333334,123.0,66.9375
310770.0,17,4,1400,4,1400,103590.0,350.0,350.0,0,0,0.0,0.0,0.0
112427009.0,6,30,1974,15,1026,8015087.142857143,123.0,68.4,15,948,8015083.857142857,123.0,63.2
22737.0,6,10,2032,5,524,3678.75,252.0,104.8,5,1508,5043.75,1236.0,301.6
35561.0,6,14,4740,7,653,5803.333333333333,249.0,93.28571428571428,7,4087,5788.5,1514.0,583.8571428571429
408.0,17,2,410,1,78,0.0,78.0,78.0,1,332,0.0,332.0,332.0
119853038.0,6,15,2306,6,1224,23970148.4,204.0,204.0,9,1082,14981491.75,188.0,120.22222222222224
94026703.0,6,30,2122,15,1105,6700785.785714285,139.0,73.66666666666667,15,1017,6700787.285714285,123.0,67.8
28877088.0,17,8,3624,8,3624,4125298.285714286,453.0,453.0,0,0,0.0,0.0,0.0
15047723.0,17,6,2718,6,2718,3009544.6,453.0,453.0,0,0,0.0,0.0,0.0
113074946.0,6,34,2482,17,1288,7053694.1875,139.0,75.76470588235294,17,1194,7053677.8125,123.0,70.23529411764706
15164.0,6,13,1459,7,862,2413.833333333333,271.0,123.14285714285714,6,597,2764.4,259.0,99.5
2875700.0,6,11,2106,6,598,574529.6,252.0,99.66666666666669,5,1508,2540.75,1236.0,301.6
90288953.0,6,16,1192,8,596,12892600.57142857,95.0,74.5,8,596,12897647.142857144,95.0,74.5
228341.0,17,2,180,1,90,0.0,90.0,90.0,1,90,0.0,90.0,90.0
303106.0,6,2,132,1,66,0.0,66.0,66.0,1,66,0.0,66.0,66.0
293363.0,17,2,180,1,90,0.0,90.0,90.0,1,90,0.0,90.0,90.0
39540.0,6,14,4740,7,653,6376.833333333333,249.0,93.28571428571428,7,4087,6432.666666666667,1514.0,583.8571428571429
135125865.0,17,6,1206,6,1206,27025173.0,201.0,201.0,0,0,0.0,0.0,0.0
3444602.0,17,3,1026,3,1026,1722301.0,342.0,342.0,0,0,0.0,0.0,0.0
5881.0,17,4,344,2,150,0.0,75.0,75.0,2,194,0.0,103.0,97.0
316427.0,17,4,1400,4,1400,105475.66666666669,350.0,350.0,0,0,0.0,0.0,0.0
30445.0,6,14,4740,7,653,4920.0,249.0,93.28571428571428,7,4087,4938.333333333333,1514.0,583.8571428571429
2327.0,17,4,344,2,150,0.0,75.0,75.0,2,194,0.0,103.0,97.0
54553.0,6,10,2032,5,524,13398.75,252.0,104.8,5,1508,13066.25,1236.0,301.6
135133081.0,17,6,1146,6,1146,27026616.2,191.0,191.0,0,0,0.0,0.0,0.0
108104806.0,17,5,955,5,955,27026201.5,191.0,191.0,0,0,0.0,0.0,0.0
135130447.0,17,6,1206,6,1206,27026089.4,201.0,201.0,0,0,0.0,0.0,0.0
3197867.0,6,7,923,4,753,993264.3333333334,571.0,188.25,3,170,1490862.0,62.0,56.66666666666666
63551.0,6,14,4740,7,653,10463.166666666666,249.0,93.28571428571428,7,4087,10159.666666666666,1514.0,583.8571428571429
0.0,17,1,381,1,381,0.0,381.0,381.0,0,0,0.0,0.0,0.0
121293.0,6,3,337,2,214,0.0,160.0,107.0,1,123,0.0,123.0,123.0
3254.0,17,2,224,1,76,0.0,76.0,76.0,1,148,0.0,148.0,148.0
339.0,17,2,166,1,75,0.0,75.0,75.0,1,91,0.0,91.0,91.0
135138462.0,17,6,1146,6,1146,27027692.4,191.0,191.0,0,0,0.0,0.0,0.0
104532.0,6,10,2032,5,524,23071.25,252.0,104.8,5,1508,25731.75,1236.0,301.6
108106717.0,17,5,1005,5,1005,27026679.25,201.0,201.0,0,0,0.0,0.0,0.0
234131.0,6,3,373,2,238,0.0,172.0,119.0,1,135,0.0,135.0,135.0
90009061.0,17,28,13364,28,13364,3333668.925925926,501.0,477.2857142857143,0,0,0.0,0.0,0.0
135145956.0,17,6,1146,6,1146,27029191.2,191.0,191.0,0,0,0.0,0.0,0.0
3178356.0,6,18,1495,9,921,358351.5,315.0,102.33333333333331,9,574,358320.125,78.0,63.77777777777778
100762759.0,17,12,516,6,258,20001525.2,43.0,43.0,6,258,20000174.8,43.0,43.0
259262.0,6,3,337,2,214,0.0,160.0,107.0,1,123,0.0,123.0,123.0
2797409.0,6,2,132,1,66,0.0,66.0,66.0,1,66,0.0,66.0,66.0
158886.0,6,3,337,2,214,0.0,160.0,107.0,1,123,0.0,123.0,123.0
17430.0,6,14,4740,7,653,2545.6666666666665,249.0,93.28571428571428,7,4087,2732.0,1514.0,583.8571428571429
317.0,17,2,160,1,80,0.0,80.0,80.0,1,80,0.0,80.0,80.0
3055104.0,6,4,270,3,202,1527552.0,70.0,67.33333333333333,1,68,0.0,68.0,68.0
70182.0,6,13,1386,7,789,11697.0,253.0,112.71428571428572,6,597,13457.0,259.0,99.5
3179269.0,6,18,1495,9,921,358363.125,315.0,102.33333333333331,9,574,358333.375,78.0,63.77777777777778
117483796.0,6,215,24284,108,7424,1097979.401869159,140.0,68.74074074074075,107,16860,1098679.1886792453,284.0,157.57009345794393
326.0,17,2,208,1,72,0.0,72.0,72.0,1,136,0.0,136.0,136.0
1850122.0,6,15,3143,9,2449,231265.25,1514.0,272.1111111111111,6,694,314861.6,331.0,115.66666666666669
10507529.0,6,7,478,4,272,3457332.0,74.0,68.0,3,206,5185899.5,74.0,68.66666666666667
2390.0,17,4,344,2,150,0.0,75.0,75.0,2,194,0.0,103.0,97.0
144916.0,17,2,180,1,70,0.0,70.0,70.0,1,110,0.0,110.0,110.0
111208429.0,6,603,82016,302,20154,369463.21926910296,140.0,66.73509933774834,301,61862,369942.7966666667,570.0,205.5215946843853
287456.0,6,12,1373,7,714,47909.333333333336,298.0,102.0,5,659,67525.0,379.0,131.8
95295275.0,6,26,1746,13,906,7924187.25,123.0,69.6923076923077,13,840,7924182.416666667,123.0,64.61538461538461
216980.0,6,3,426,2,280,0.0,214.0,140.0,1,146,0.0,146.0,146.0
115548469.0,6,48,3168,24,1584,5023846.478260869,66.0,66.0,24,1584,5010178.304347826,66.0,66.0
40001.0,6,14,4740,7,653,5642.333333333333,249.0,93.28571428571428,7,4087,6249.666666666667,1514.0,583.8571428571429
2801101.0,6,2,132,1,66,0.0,66.0,66.0,1,66,0.0,66.0,66.0
0.0,6,1,66,1,66,0.0,66.0,66.0,0,0,0.0,0.0,0.0
153522.0,17,2,180,1,90,0.0,90.0,90.0,1,90,0.0,90.0,90.0
120051867.0,17,28,13364,28,13364,4446365.444444444,501.0,477.2857142857143,0,0,0.0,0.0,0.0
281302.0,17,2,363,1,79,0.0,79.0,79.0,1,284,0.0,284.0,284.0
109202544.0,6,34,2466,17,1272,6811678.1875,123.0,74.82352941176471,17,1194,6811677.5625,123.0,70.23529411764706
90274268.0,6,12,1832,8,1016,12896324.0,188.0,127.0,4,816,30037351.33333333,204.0,204.0
3983.000000000001,17,2,762,2,762,0.0,381.0,381.0,0,0,0.0,0.0,0.0
324992.0,6,6,412,4,272,108330.66666666669,74.0,68.0,2,140,0.0,74.0,70.0
28381.0,6,10,2032,5,524,6858.5,252.0,104.8,5,1508,6373.0,1236.0,301.6
120845.0,6,3,337,2,214,0.0,160.0,107.0,1,123,0.0,123.0,123.0
1082.0,17,4,438,2,148,0.0,74.0,74.0,2,290,0.0,147.0,145.0
184812.0,17,2,180,1,90,0.0,90.0,90.0,1,90,0.0,90.0,90.0
18056.0,6,10,2032,5,524,4263.5,252.0,104.8,5,1508,4008.0,1236.0,301.6
108105420.0,17,5,1005,5,1005,27026355.0,201.0,201.0,0,0,0.0,0.0,0.0
103973.0,17,2,286,2,286,0.0,143.0,143.0,0,0,0.0,0.0,0.0
119443713.0,6,240,27178,120,18962,1001920.6974789916,284.0,158.01666666666668,120,8216,1001920.2100840335,140.0,68.46666666666667
108109620.0,17,5,1005,5,1005,27027405.0,201.0,201.0,0,0,0.0,0.0,0.0
146247.0,6,3,337,2,214,0.0,160.0,107.0,1,123,0.0,123.0,123.0
895060.0,6,12,2708,7,742,149176.66666666666,338.0,106.0,5,1966,155499.25,1514.0,393.2
866156.0,6,9,1096,6,625,173231.2,287.0,104.16666666666669,3,471,295094.0,331.0,157.0
120125727.0,6,13,2020,9,1204,15015715.875,188.0,133.77777777777777,4,816,30031529.666666668,204.0,204.0
108924.0,17,2,286,2,286,0.0,143.0,143.0,0,0,0.0,0.0,0.0
300982.0,6,6,412,4,272,100327.33333333331,74.0,68.0,2,140,0.0,74.0,70.0
94393264.0,6,39,2574,20,1320,4968051.210526316,66.0,66.0,19,1254,5112000.222222222,66.0,66.0
107202922.0,17,14,864,7,432,17833514.5,174.0,61.71428571428572,7,432,17833501.333333332,174.0,61.71428571428572
81.0,17,2,762,2,762,0.0,381.0,381.0,0,0,0.0,0.0,0.0
146982.0,6,3,373,2,238,0.0,172.0,119.0,1,135,0.0,135.0,135.0
106746479.0,6,35,2542,18,1348,6279204.647058823,139.0,74.88888888888889,17,1194,6658146.875,123.0,70.23529411764706
228308.0,17,2,180,1,90,0.0,90.0,90.0,1,90,0.0,90.0,90.0
120106452.0,6,272,31322,136,9272,883600.0074074074,140.0,68.17647058823529,136,22050,883651.9481481481,336.0,162.13235294117646
143023.0,6,2,132,1,66,0.0,66.0,66.0,1,66,0.0,66.0,66.0
120014579.0,17,12,647,7,432,20002429.83333333,174.0,61.71428571428572,5,215,20000869.0,43.0,43.0
104316.0,17,2,700,2,700,0.0,350.0,350.0,0,0,0.0,0.0,0.0
63831.0,6,10,2032,5,524,15223.0,252.0,104.8,5,1508,9521.75,1236.0,301.6
2781274.0,6,2,132,1,66,0.0,66.0,66.0,1,66,0.0,66.0,66.0
303788.0,6,6,412,4,272,101262.66666666669,74.0,68.0,2,140,0.0,74.0,70.0
167205.0,17,4,571,2,148,0.0,74.0,74.0,2,423,0.0,280.0,211.5
103338.0,17,2,286,2,286,0.0,143.0,143.0,0,0,0.0,0.0,0.0
212277.0,6,10,1221,6,636,42455.4,298.0,106.0,4,585,69122.33333333333,379.0,146.25
308675.0,17,4,1400,4,1400,102891.66666666669,350.0,350.0,0,0,0.0,0.0,0.0
56136.0,6,13,1479,7,882,9213.5,291.0,126.0,6,597,10139.8,259.0,99.5
776.0,17,4,438,2,148,0.0,74.0,74.0,2,290,0.0,147.0,145.0
90042513.0,17,28,13364,28,13364,3334907.888888889,501.0,477.2857142857143,0,0,0.0,0.0,0.0
30499.0,6,10,2032,5,524,7399.75,252.0,104.8,5,1508,7381.5,1236.0,301.6
831653.0,6,11,1132,6,556,165417.2,218.0,92.66666666666669,5,576,207587.25,304.0,115.2
13940039.0,6,20,1646,10,1014,1514681.0,315.0,101.4,10,632,1514630.0,78.0,63.2
14920.0,17,2,180,1,90,0.0,90.0,90.0,1,90,0.0,90.0,90.0
143963.0,17,2,180,1,90,0.0,90.0,90.0,1,90,0.0,90.0,90.0
135131493.0,17,6,1206,6,1206,27026298.6,201.0,201.0,0,0,0.0,0.0,0.0
34604.0,6,14,4740,7,653,5642.5,249.0,93.28571428571428,7,4087,5398.0,1514.0,583.8571428571429
44247.0,6,10,2032,5,524,10030.0,252.0,104.8,5,1508,9623.25,1236.0,301.6
103186.0,17,2,286,2,286,0.0,143.0,143.0,0,0,0.0,0.0,0.0
108102956.0,17,5,955,5,955,27025739.0,191.0,191.0,0,0,0.0,0.0,0.0
153443.0,17,2,180,1,90,0.0,90.0,90.0,1,90,0.0,90.0,90.0
64067.0,6,14,4740,7,653,9832.0,249.0,93.28571428571428,7,4087,9230.5,1514.0,583.8571428571429
49869.0,6,14,4740,7,653,7644.333333333333,249.0,93.28571428571428,7,4087,8128.5,1514.0,583.8571428571429
633500.0,6,4,508,2,238,0.0,172.0,119.0,2,270,0.0,135.0,135.0
319507.0,17,4,1400,4,1400,106502.33333333331,350.0,350.0,0,0,0.0,0.0,0.0
31195.0,6,12,1413,7,882,5199.166666666667,291.0,126.0,5,531,5732.75,259.0,106.2
234838.0,6,13,1386,7,789,39139.66666666666,253.0,112.71428571428572,6,597,44937.8,259.0,99.5
214150.0,17,4,6056,4,6056,71383.33333333333,1514.0,1514.0,0,0,0.0,0.0,0.0
3179246.0,6,18,1495,9,921,358363.875,315.0,102.33333333333331,9,574,358338.0,78.0,63.77777777777778
26916593.0,17,5,1710,5,1710,6729148.25,342.0,342.0,0,0,0.0,0.0,0.0
0.0,17,1,179,1,179,0.0,179.0,179.0,0,0,0.0,0.0,0.0
31337.0,6,10,2032,5,524,6202.75,252.0,104.8,5,1508,7334.5,1236.0,301.6
108108584.0,17,5,1005,5,1005,27027146.0,201.0,201.0,0,0,0.0,0.0,0.0
216469.0,17,2,180,1,90,0.0,90.0,90.0,1,90,0.0,90.0,90.0
40483.0,6,14,4740,7,653,6319.666666666667,249.0,93.28571428571428,7,4087,5700.333333333333,1514.0,583.8571428571429
121665592.0,6,33,2343,17,1272,7604099.5,123.0,74.82352941176471,16,1071,7583994.2,123.0,66.9375
309027.0,6,6,412,4,272,103009.0,74.0,68.0,2,140,0.0,74.0,70.0
120035097.0,17,29,13785,29,13785,4286967.75,501.0,475.3448275862069,0,0,0.0,0.0,0.0
0.0,17,1,381,1,381,0.0,381.0,381.0,0,0,0.0,0.0,0.0
232779.0,6,2,132,1,66,0.0,66.0,66.0,1,66,0.0,66.0,66.0
285180.0,6,10,1221,6,636,57036.0,298.0,106.0,4,585,89314.33333333333,379.0,146.25
872424.0,6,9,1118,6,586,174484.8,248.0,97.66666666666669,3,532,299929.0,392.0,177.33333333333334
154506.0,17,2,180,1,90,0.0,90.0,90.0,1,90,0.0,90.0,90.0
232990.0,6,3,337,2,214,0.0,160.0,107.0,1,123,0.0,123.0,123.0
90298383.0,6,21,1585,11,840,9024111.1,95.0,76.36363636363636,10,745,10002133.333333334,95.0,74.5
135128037.0,17,6,1146,6,1146,27025607.4,191.0,191.0,0,0,0.0,0.0,0.0
228439.0,17,2,180,1,90,0.0,90.0,90.0,1,90,0.0,90.0,90.0
146307.0,6,3,337,2,214,0.0,160.0,107.0,1,123,0.0,123.0,123.0
117105579.0,17,14,864,7,432,19500160.666666668,174.0,61.71428571428572,7,432,19501697.166666668,174.0,61.71428571428572
232096.0,6,3,337,2,214,0.0,160.0,107.0,1,123,0.0,123.0,123.0
120124730.0,6,15,2444,7,1428,20020788.33333333,204.0,204.0,8,1016,17137139.0,188.0,127.0
135139274.0,17,6,1146,6,1146,27027854.8,191.0,191.0,0,0,0.0,0.0,0.0
146700.0,6,3,373,2,238,0.0,172.0,119.0,1,135,0.0,135.0,135.0
1178264.0,6,13,3010,8,2382,168323.42857142858,1514.0,297.75,5,628,225663.0,331.0,125.6
123416365.0,6,48,3168,24,1584,4940127.913043479,66.0,66.0,24,1584,5361443.826086956,66.0,66.0
216408.0,17,2,180,1,90,0.0,90.0,90.0,1,90,0.0,90.0,90.0
2423.0,17,4,344,2,150,0.0,75.0,75.0,2,194,0.0,103.0,97.0
108110641.0,17,5,955,5,955,27027660.25,191.0,191.0,0,0,0.0,0.0,0.0
22943.0,6,11,2098,6,590,4169.6,252.0,98.33333333333331,5,1508,4180.5,1236.0,301.6
114920711.0,6,47,3102,24,1584,4996541.434782608,66.0,66.0,23,1518,5159899.318181818,66.0,66.0
101030.0,17,2,762,2,762,0.0,381.0,381.0,0,0,0.0,0.0,0.0
30888.0,6,10,2032,5,524,7442.25,252.0,104.8,5,1508,5406.25,1236.0,301.6
24254722.0,17,18,8154,18,8154,1426748.3529411764,453.0,453.0,0,0,0.0,0.0,0.0
90528886.0,6,15,2444,8,1016,12932698.0,188.0,127.0,7,1428,15061087.666666666,204.0,204.0
2602735.0,6,2,132,1,66,0.0,66.0,66.0,1,66,0.0,66.0,66.0
108008842.0,17,13,821,7,432,18001473.666666668,174.0,61.71428571428572,6,389,17600160.0,174.0,64.83333333333333
123610678.0,6,49,3234,25,1650,5150444.916666667,66.0,66.0,24,1584,4956831.0869565215,66.0,66.0
2426.0,17,4,344,2,150,0.0,75.0,75.0,2,194,0.0,103.0,97.0
924718.0,6,12,2718,7,743,154119.66666666666,339.0,106.14285714285714,5,1975,163046.0,1514.0,395.0
2114.0,17,6,1230,3,234,750.5,78.0,78.0,3,996,850.0,332.0,332.0
2275206.0,6,49,23728,25,19797,94800.25,1514.0,791.88,24,3931,89666.47826086957,1514.0,163.79166666666666
10479248.0,6,7,478,4,272,3445984.333333333,74.0,68.0,3,206,5168915.5,74.0,68.66666666666667
303726.0,6,2,138,1,68,0.0,68.0,68.0,1,70,0.0,70.0,70.0
307072.0,6,6,412,4,272,102357.33333333331,74.0,68.0,2,140,0.0,74.0,70.0
208205.0,17,2,762,2,762,0.0,381.0,381.0,0,0,0.0,0.0,0.0
90036458.0,17,28,13364,28,13364,3334683.6296296297,501.0,477.2857142857143,0,0,0.0,0.0,0.0
210455.0,6,3,426,2,280,0.0,214.0,140.0,1,146,0.0,146.0,146.0
1155557.0,6,13,3012,8,2384,165079.57142857142,1514.0,298.0,5,628,220752.75,331.0,125.6
90085954.0,17,28,13364,28,13364,3336516.814814815,501.0,477.2857142857143,0,0,0.0,0.0,0.0
364975.0,6,10,1221,6,636,72995.0,298.0,106.0,4,585,120151.33333333331,379.0,146.25
284632.0,17,2,363,1,79,0.0,79.0,79.0,1,284,0.0,284.0,284.0
206596.0,6,3,426,2,280,0.0,214.0,140.0,1,146,0.0,146.0,146.0
197023.0,17,4,6056,4,6056,65674.33333333333,1514.0,1514.0,0,0,0.0,0.0,0.0
24779.0,6,14,4740,7,653,4009.8333333333335,249.0,93.28571428571428,7,4087,3511.5,1514.0,583.8571428571429
107944.0,17,2,700,2,700,0.0,350.0,350.0,0,0,0.0,0.0,0.0
284862.0,17,2,363,1,79,0.0,79.0,79.0,1,284,0.0,284.0,284.0
62540.0,6,14,4740,7,653,10155.0,249.0,93.28571428571428,7,4087,10281.333333333334,1514.0,583.8571428571429
90256139.0,6,13,2036,8,1016,12893734.142857144,188.0,127.0,5,1020,22523011.5,204.0,204.0
90048543.0,17,27,12943,27,12943,3463405.5,501.0,479.3703703703704,0,0,0.0,0.0,0.0
5005952.0,17,4,849,2,166,0.0,83.0,83.0,2,683,0.0,499.0,341.5
47102.0,6,14,4740,7,653,7330.666666666667,249.0,93.28571428571428,7,4087,7272.166666666667,1514.0,583.8571428571429
90295739.0,6,14,1043,7,542,15049289.833333334,95.0,77.42857142857143,7,501,15000559.5,95.0,71.57142857142857
11650247.0,6,4,1670,3,917,5825123.5,785.0,305.6666666666667,1,753,0.0,753.0,753.0
305528.0,6,6,412,4,272,101842.66666666669,74.0,68.0,2,140,0.0,74.0,70.0
301284.0,6,3,202,2,128,0.0,74.0,64.0,1,74,0.0,74.0,74.0
206292.0,6,3,426,2,280,0.0,214.0,140.0,1,146,0.0,146.0,146.0
322501.0,17,4,1400,4,1400,107500.33333333331,350.0,350.0,0,0,0.0,0.0,0.0
121246104.0,6,216,24328,108,7350,1116844.1588785048,140.0,68.05555555555556,108,16978,1125538.859813084,284.0,157.2037037037037
108029.0,17,2,286,2,286,0.0,143.0,143.0,0,0,0.0,0.0,0.0
107868.0,17,2,700,2,700,0.0,350.0,350.0,0,0,0.0,0.0,0.0
10873439.0,6,8,544,4,272,3578877.333333333,74.0,68.0,4,272,3578793.0,74.0,68.0
3010530.0,6,12,2172,7,664,501592.5,252.0,94.85714285714286,5,1508,2122.5,1236.0,301.6
235535.0,6,3,337,2,214,0.0,160.0,107.0,1,123,0.0,123.0,123.0
3005424.0,6,11,2106,6,598,600899.0,252.0,99.66666666666669,5,1508,1917.0,1236.0,301.6
115745806.0,6,36,2734,19,1471,6430322.555555556,139.0,77.42105263157895,17,1263,7219938.75,123.0,74.29411764705883
1169174.0,6,13,3014,8,2386,167024.85714285713,1514.0,298.25,5,628,224169.75,331.0,125.6
120000021.0,6,20,1531,11,840,12000002.1,95.0,76.36363636363636,9,691,11341196.125,95.0,76.77777777777777
90364900.0,6,13,2052,7,828,15060816.666666666,188.0,118.28571428571428,6,1224,12067900.4,204.0,204.0
16918.0,6,11,1133,6,602,3383.6,264.0,100.33333333333331,5,531,2259.5,259.0,106.2
90756481.0,6,34,3495,18,1802,5335790.705882353,424.0,100.11111111111111,16,1693,6030997.2,335.0,105.8125
135131496.0,17,6,1146,6,1146,27026299.2,191.0,191.0,0,0,0.0,0.0,0.0
525.0,17,2,508,2,508,0.0,257.0,254.0,0,0,0.0,0.0,0.0
40723.0,6,10,2032,5,524,9946.25,252.0,104.8,5,1508,9704.0,1236.0,301.6
108109506.0,17,5,1005,5,1005,27027376.5,201.0,201.0,0,0,0.0,0.0,0.0
107419364.0,17,14,864,7,432,17834967.666666668,174.0,61.71428571428572,7,432,17833520.333333332,174.0,61.71428571428572
153462.0,17,2,180,1,90,0.0,90.0,90.0,1,90,0.0,90.0,90.0
108044.0,17,2,286,2,286,0.0,143.0,143.0,0,0,0.0,0.0,0.0
241840.0,6,3,337,2,214,0.0,160.0,107.0,1,123,0.0,123.0,123.0
119753950.0,6,34,2350,17,1225,7471141.625,139.0,72.05882352941177,17,1125,7471141.5625,123.0,66.17647058823529
20629.0,6,11,1132,6,556,3465.0,218.0,92.66666666666669,5,576,4173.75,304.0,115.2
30415.0,6,14,4740,7,653,4948.0,249.0,93.28571428571428,7,4087,4930.0,1514.0,583.8571428571429
35143.0,6,10,2032,5,524,8558.5,252.0,104.8,5,1508,8253.25,1236.0,301.6
90290798.0,6,16,1192,8,596,12891706.42857143,95.0,74.5,8,596,12898348.285714284,95.0,74.5
217896.0,6,3,426,2,280,0.0,214.0,140.0,1,146,0.0,146.0,146.0
108099020.0,17,5,955,5,955,27024755.0,191.0,191.0,0,0,0.0,0.0,0.0
143144.0,17,4,344,2,150,0.0,75.0,75.0,2,194,0.0,103.0,97.0
112538561.0,6,34,2334,17,1209,7020169.875,123.0,71.11764705882354,17,1125,7020065.1875,123.0,66.17647058823529
868814.0,6,9,1196,6,725,173762.8,387.0,120.83333333333331,3,471,296570.0,331.0,157.0
324251.0,6,6,412,4,272,108083.66666666669,74.0,68.0,2,140,0.0,74.0,70.0
293560.0,17,2,246,1,76,0.0,76.0,76.0,1,170,0.0,170.0,170.0
120242111.0,6,216,24452,108,7362,1117195.140186916,140.0,68.16666666666667,108,17090,1116173.831775701,284.0,158.24074074074073
120118055.0,6,241,27260,121,8208,1000983.7916666666,140.0,67.83471074380165,120,19052,1001631.0588235294,284.0,158.76666666666668
98814152.0,6,329,43338,165,11112,602525.3170731707,140.0,67.34545454545454,164,32226,604787.7975460123,336.0,196.5
120000042.0,6,20,1531,11,840,12000004.2,95.0,76.36363636363636,9,691,11344134.375,95.0,76.77777777777777
216486.0,6,10,1221,6,636,43297.2,298.0,106.0,4,585,71290.0,379.0,146.25
10530684.0,6,7,478,4,272,3464621.6666666665,74.0,68.0,3,206,5196831.5,74.0,68.66666666666667
90004039.0,17,28,13364,28,13364,3333482.925925926,501.0,477.2857142857143,0,0,0.0,0.0,0.0
90065279.0,17,27,12943,27,12943,3464049.1923076925,501.0,479.3703703703704,0,0,0.0,0.0,0.0
206126.0,6,3,426,2,280,0.0,214.0,140.0,1,146,0.0,146.0,146.0
90302321.0,6,16,1192,8,596,12892785.857142856,95.0,74.5,8,596,12899342.142857144,95.0,74.5
135131725.0,17,6,1206,6,1206,27026345.0,201.0,201.0,0,0,0.0,0.0,0.0
96875516.0,6,181,20488,91,6228,1076394.6222222222,140.0,68.43956043956044,90,14260,1076941.3370786516,374.0,158.44444444444446
153644.0,17,2,180,1,90,0.0,90.0,90.0,1,90,0.0,90.0,90.0
0.0,17,1,289,1,289,0.0,289.0,289.0,0,0,0.0,0.0,0.0
90022297.0,17,28,13364,28,13364,3334159.1481481483,501.0,477.2857142857143,0,0,0.0,0.0,0.0
216376.0,17,2,180,1,90,0.0,90.0,90.0,1,90,0.0,90.0,90.0
75826.0,6,14,4740,7,653,9058.666666666666,249.0,93.28571428571428,7,4087,11968.166666666666,1514.0,583.8571428571429
308239.0,6,6,412,4,272,102746.33333333331,74.0,68.0,2,140,0.0,74.0,70.0
307481.0,6,6,412,4,272,102493.66666666669,74.0,68.0,2,140,0.0,74.0,70.0
104928607.0,6,44,2904,22,1452,4996600.333333333,66.0,66.0,22,1452,4981355.333333333,66.0,66.0
108106082.0,17,5,955,5,955,27026520.5,191.0,191.0,0,0,0.0,0.0,0.0
2019867.0,17,4,525,2,150,0.0,75.0,75.0,2,375,0.0,284.0,187.5
153424.0,17,2,180,1,90,0.0,90.0,90.0,1,90,0.0,90.0,90.0
365.0,17,2,160,1,80,0.0,80.0,80.0,1,80,0.0,80.0,80.0
299338.0,6,6,412,4,272,99779.33333333331,74.0,68.0,2,140,0.0,74.0,70.0
301.0,17,2,164,1,82,0.0,82.0,82.0,1,82,0.0,82.0,82.0
142409.0,6,2,132,1,66,0.0,66.0,66.0,1,66,0.0,66.0,66.0
108108618.0,17,5,1005,5,1005,27027154.5,201.0,201.0,0,0,0.0,0.0,0.0
0.0,17,1,55,1,55,0.0,55.0,55.0,0,0,0.0,0.0,0.0
120060.0,17,2,180,1,70,0.0,70.0,70.0,1,110,0.0,110.0,110.0
77248.0,6,12,1328,6,731,12516.2,253.0,121.83333333333331,6,597,14181.4,259.0,99.5
702.0,17,2,762,2,762,0.0,381.0,381.0,0,0,0.0,0.0,0.0
105683681.0,6,44,2904,22,1452,5032556.238095238,66.0,66.0,22,1452,5017578.047619048,66.0,66.0
45242.0,6,14,4740,7,653,6295.666666666667,249.0,93.28571428571428,7,4087,6791.833333333333,1514.0,583.8571428571429
219275.0,6,3,426,2,280,0.0,214.0,140.0,1,146,0.0,146.0,146.0
115278579.0,6,219,24584,110,7556,1057601.6422018348,140.0,68.69090909090909,109,17028,1057887.537037037,284.0,156.22018348623854
135137864.0,17,6,1146,6,1146,27027572.8,191.0,191.0,0,0,0.0,0.0,0.0
363756.0,6,4,508,2,238,0.0,172.0,119.0,2,270,0.0,135.0,135.0
302393.0,6,2,132,1,66,0.0,66.0,66.0,1,66,0.0,66.0,66.0
29484.0,6,14,4740,7,653,4048.6666666666665,249.0,93.28571428571428,7,4087,4337.833333333333,1514.0,583.8571428571429
83639.0,6,14,4740,7,653,13770.5,249.0,93.28571428571428,7,4087,13212.0,1514.0,583.8571428571429
303362.0,17,4,1524,4,1524,101120.66666666669,381.0,381.0,0,0,0.0,0.0,0.0
5395.0,17,4,344,2,150,0.0,75.0,75.0,2,194,0.0,103.0,97.0
67758.0,6,14,4740,7,653,11072.333333333334,249.0,93.28571428571428,7,4087,11151.5,1514.0,583.8571428571429
46749.0,6,14,4740,7,653,7622.666666666667,249.0,93.28571428571428,7,4087,7654.833333333333,1514.0,583.8571428571429
101519463.0,17,14,1126,7,563,16667800.333333334,174.0,80.42857142857143,7,563,16833476.5,174.0,80.42857142857143
40915.0,6,14,4740,7,653,6694.833333333333,249.0,93.28571428571428,7,4087,6526.666666666667,1514.0,583.8571428571429
4405.0,17,2,614,1,72,0.0,72.0,72.0,1,542,0.0,542.0,542.0
309464.0,17,4,1400,4,1400,103154.66666666669,350.0,350.0,0,0,0.0,0.0,0.0
120123828.0,6,13,2036,5,1020,30030957.0,204.0,204.0,8,1016,17137023.14285714,188.0,127.0
2301.0,17,4,344,2,150,0.0,75.0,75.0,2,194,0.0,103.0,97.0
294674.0,17,2,180,1,90,0.0,90.0,90.0,1,90,0.0,90.0,90.0
1035015.0,6,11,1134,6,558,207003.0,220.0,93.0,5,576,257304.75,304.0,115.2
104829672.0,17,15,5130,15,5130,7487833.714285715,342.0,342.0,0,0,0.0,0.0,0.0
146064.0,6,3,337,2,214,0.0,160.0,107.0,1,123,0.0,123.0,123.0
90093404.0,6,10,1440,7,828,15015567.333333334,188.0,118.28571428571428,3,612,30030880.5,204.0,204.0
272282.0,6,10,1221,6,636,54456.4,298.0,106.0,4,585,85364.66666666667,379.0,146.25
209411.0,17,2,180,1,90,0.0,90.0,90.0,1,90,0.0,90.0,90.0
2179040.0,6,18,6803,10,1501,242115.5555555556,408.0,150.1,8,5302,248582.2857142857,1514.0,662.75
150003574.0,17,36,17126,36,17126,4285816.4,501.0,475.72222222222223,0,0,0.0,0.0,0.0
9306.0,17,2,582,1,83,0.0,83.0,83.0,1,499,0.0,499.0,499.0
108104447.0,17,5,1005,5,1005,27026111.75,201.0,201.0,0,0,0.0,0.0,0.0
105639.0,17,2,700,2,700,0.0,350.0,350.0,0,0,0.0,0.0,0.0
246883.0,6,3,373,2,238,0.0,172.0,119.0,1,135,0.0,135.0,135.0
208744.0,17,4,6056,4,6056,69581.33333333333,1514.0,1514.0,0,0,0.0,0.0,0.0
121164.0,6,3,337,2,214,0.0,160.0,107.0,1,123,0.0,123.0,123.0
120007879.0,6,21,1585,11,840,12000787.9,95.0,76.36363636363636,10,745,13305317.444444444,95.0,74.5
144886.0,17,2,180,1,90,0.0,90.0,90.0,1,90,0.0,90.0,90.0
306919.0,6,6,412,4,272,102306.33333333331,74.0,68.0,2,140,0.0,74.0,70.0
33298711.0,6,26,7643,14,3751,202672.4615384616,1514.0,267.92857142857144,12,3892,3007533.909090909,1514.0,324.3333333333333
235259.0,6,3,337,2,214,0.0,160.0,107.0,1,123,0.0,123.0,123.0
848.0,17,4,438,2,148,0.0,74.0,74.0,2,290,0.0,147.0,145.0
25076211.0,6,140,31127,72,23842,353186.07042253524,566.0,331.1388888888889,68,7285,369981.1940298508,898.0,107.13235294117646
146057.0,6,3,337,2,214,0.0,160.0,107.0,1,123,0.0,123.0,123.0
90299298.0,6,16,1192,8,596,12893784.42857143,95.0,74.5,8,596,12898820.714285716,95.0,74.5
354.0,17,2,248,1,84,0.0,84.0,84.0,1,164,0.0,164.0,164.0
2389.0,17,4,344,2,150,0.0,75.0,75.0,2,194,0.0,103.0,97.0
247524.0,6,4,439,2,238,0.0,172.0,119.0,2,201,0.0,135.0,100.5
120451931.0,6,221,24908,111,17340,1095017.5545454544,284.0,156.21621621621622,110,7568,1095509.990825688,140.0,68.8
116711472.0,6,30,1974,15,1026,8321929.714285715,123.0,68.4,15,948,8321924.428571428,123.0,63.2
217925.0,6,3,426,2,280,0.0,214.0,140.0,1,146,0.0,146.0,146.0
234676.0,6,3,337,2,214,0.0,160.0,107.0,1,123,0.0,123.0,123.0
252747.0,6,3,337,2,214,0.0,160.0,107.0,1,123,0.0,123.0,123.0
12589065.0,6,20,1648,10,1016,1365140.888888889,315.0,101.6,10,632,1365110.6666666667,78.0,63.2
15723.999999999998,17,2,180,1,90,0.0,90.0,90.0,1,90,0.0,90.0,90.0
90095230.0,6,12,1848,5,1020,22523219.75,204.0,204.0,7,828,15015448.0,188.0,118.28571428571428
122519589.0,17,14,864,7,432,17166834.333333332,174.0,61.71428571428572,7,432,17167431.333333332,174.0,61.71428571428572
143854.0,17,2,180,1,90,0.0,90.0,90.0,1,90,0.0,90.0,90.0
58868.0,6,14,4740,7,653,9693.333333333334,249.0,93.28571428571428,7,4087,9669.666666666666,1514.0,583.8571428571429
116189768.0,17,16,1212,8,606,16571581.714285716,174.0,75.75,8,606,16572238.714285716,174.0,75.75
122792517.0,6,31,2097,16,1149,8186167.8,123.0,71.8125,15,948,8206018.642857143,123.0,63.2
2549.0,17,4,344,2,150,0.0,75.0,75.0,2,194,0.0,103.0,97.0
2439.0,17,4,344,2,150,0.0,75.0,75.0,2,194,0.0,103.0,97.0
90325520.0,6,14,1043,7,542,15054253.333333334,95.0,77.42857142857143,7,501,15004301.0,95.0,71.57142857142857
2798475.0,6,2,132,1,66,0.0,66.0,66.0,1,66,0.0,66.0,66.0
5623055.0,6,4,270,2,134,0.0,68.0,67.0,2,136,0.0,70.0,68.0
2773.0,17,4,344,2,150,0.0,75.0,75.0,2,194,0.0,103.0,97.0
1187168.0,6,13,3010,8,2382,169595.42857142858,1514.0,297.75,5,628,227885.75,331.0,125.6
239142.0,17,2,180,1,90,0.0,90.0,90.0,1,90,0.0,90.0,90.0
2315.0,17,2,762,2,762,0.0,381.0,381.0,0,0,0.0,0.0,0.0
197458.0,17,2,180,1,90,0.0,90.0,90.0,1,90,0.0,90.0,90.0
120201029.0,6,23,1949,12,1191,10908668.727272728,223.0,99.25,11,758,11995762.0,95.0,68.9090909090909
120023048.0,17,28,13364,28,13364,4445298.074074074,501.0,477.2857142857143,0,0,0.0,0.0,0.0
53789.0,6,14,4740,7,653,8803.0,249.0,93.28571428571428,7,4087,8390.833333333334,1514.0,583.8571428571429
333.0,17,2,166,1,75,0.0,75.0,75.0,1,91,0.0,91.0,91.0
90012476.0,17,28,13364,28,13364,3333795.407407407,501.0,477.2857142857143,0,0,0.0,0.0,0.0
111703571.0,6,32,2220,16,1149,7431810.066666666,123.0,71.8125,16,1071,7431814.666666667,123.0,66.9375
26119.0,6,14,4740,7,653,4086.6666666666665,249.0,93.28571428571428,7,4087,4155.333333333333,1514.0,583.8571428571429
19520.0,6,11,2098,6,590,3904.0,252.0,98.33333333333331,5,1508,4477.25,1236.0,301.6
10864076.0,6,8,544,4,272,3576047.333333333,74.0,68.0,4,272,3575976.333333333,74.0,68.0
90053300.0,17,27,12943,27,12943,3463588.461538461,501.0,479.3703703703704,0,0,0.0,0.0,0.0
325.0,17,2,208,1,72,0.0,72.0,72.0,1,136,0.0,136.0,136.0
99866.0,17,2,762,2,762,0.0,381.0,381.0,0,0,0.0,0.0,0.0
216629.0,6,3,426,2,280,0.0,214.0,140.0,1,146,0.0,146.0,146.0
249983.0,6,3,337,2,214,0.0,160.0,107.0,1,123,0.0,123.0,123.0
5621357.0,6,4,270,2,134,0.0,68.0,67.0,2,136,0.0,70.0,68.0
3959020.0,6,144,119551,86,111422,46576.705882352944,1510.0,1295.6046511627908,58,8129,64118.491228070176,1510.0,140.1551724137931
573.0,17,2,508,2,508,0.0,257.0,254.0,0,0,0.0,0.0,0.0
123610457.0,6,49,3234,25,1650,5150435.708333333,66.0,66.0,24,1584,4937567.826086956,66.0,66.0
196964.0,17,2,180,1,90,0.0,90.0,90.0,1,90,0.0,90.0,90.0
90281428.0,6,16,1192,8,596,12891175.142857144,95.0,74.5,8,596,12896063.0,95.0,74.5
120127637.0,6,13,2036,8,1016,17137847.42857143,188.0,127.0,5,1020,22524461.75,204.0,204.0
361.0,17,2,160,1,80,0.0,80.0,80.0,1,80,0.0,80.0,80.0
20114.0,17,2,582,1,83,0.0,83.0,83.0,1,499,0.0,499.0,499.0
46108.0,6,14,4740,7,653,7198.0,249.0,93.28571428571428,7,4087,6758.0,1514.0,583.8571428571429
117321204.0,6,219,24898,110,7482,1076341.3211009174,140.0,68.01818181818182,109,17416,1076848.0740740742,390.0,159.77981651376146
300372.0,17,2,363,1,79,0.0,79.0,79.0,1,284,0.0,284.0,284.0
299671.0,6,6,412,4,272,99890.33333333331,74.0,68.0,2,140,0.0,74.0,70.0
117179209.0,6,48,3168,24,1584,5094748.217391305,66.0,66.0,24,1584,5081081.260869565,66.0,66.0
299241.0,6,6,412,4,272,99747.0,74.0,68.0,2,140,0.0,74.0,70.0
34580.0,6,14,4740,7,653,5094.666666666667,249.0,93.28571428571428,7,4087,5623.5,1514.0,583.8571428571429
71609750.0,6,9,842,9,842,8951218.75,97.0,93.55555555555556,0,0,0.0,0.0,0.0
104945.0,17,2,700,2,700,0.0,350.0,350.0,0,0,0.0,0.0,0.0
10458859.0,6,7,478,4,272,3438867.6666666665,74.0,68.0,3,206,5158176.0,74.0,68.66666666666667
120051570.0,17,29,13785,29,13785,4287556.071428572,501.0,475.3448275862069,0,0,0.0,0.0,0.0
120056862.0,17,29,13785,29,13785,4287745.071428572,501.0,475.3448275862069,0,0,0.0,0.0,0.0
235061.0,6,4,439,2,238,0.0,172.0,119.0,2,201,0.0,135.0,100.5
242426.0,6,3,337,2,214,0.0,160.0,107.0,1,123,0.0,123.0,123.0
5624539.0,6,5,336,2,134,0.0,68.0,67.0,3,202,1421488.5,70.0,67.33333333333333
241992.0,6,3,337,2,214,0.0,160.0,107.0,1,123,0.0,123.0,123.0
135151626.0,17,6,1206,6,1206,27030325.2,201.0,201.0,0,0,0.0,0.0,0.0
135138863.0,17,6,1206,6,1206,27027772.6,201.0,201.0,0,0,0.0,0.0,0.0
1303166.0,6,4,264,2,132,0.0,66.0,66.0,2,132,0.0,66.0,66.0
20772.0,6,10,2032,5,524,4769.5,252.0,104.8,5,1508,4470.0,1236.0,301.6
148349.0,6,3,337,2,214,0.0,160.0,107.0,1,123,0.0,123.0,123.0
307139.0,6,6,412,4,272,102379.66666666669,74.0,68.0,2,140,0.0,74.0,70.0
108679614.0,6,33,2412,17,1272,6778991.75,123.0,74.82352941176471,16,1140,7230928.133333334,123.0,71.25
307642.0,6,6,412,4,272,102547.33333333331,74.0,68.0,2,140,0.0,74.0,70.0
29172.0,6,14,4740,7,653,4743.333333333333,249.0,93.28571428571428,7,4087,4723.333333333333,1514.0,583.8571428571429
23326.0,6,14,4740,7,653,3667.8333333333335,249.0,93.28571428571428,7,4087,3751.5,1514.0,583.8571428571429
103527.0,17,2,286,2,286,0.0,143.0,143.0,0,0,0.0,0.0,0.0
121338.0,6,3,337,2,214,0.0,160.0,107.0,1,123,0.0,123.0,123.0
174911.0,6,12,1447,6,816,33660.6,291.0,136.0,6,631,34302.6,293.0,105.16666666666669
142706.0,6,10,1066,5,490,34945.0,218.0,98.0,5,576,35239.75,304.0,115.2
36873.0,6,10,1066,5,490,6532.5,218.0,98.0,5,576,8187.5,304.0,115.2
121361649.0,6,322,38170,161,10922,747687.63125,140.0,67.83850931677019,161,27248,758500.78125,284.0,169.24223602484471
216542.0,17,2,180,1,90,0.0,90.0,90.0,1,90,0.0,90.0,90.0
123302157.0,6,48,3168,24,1584,5017731.913043479,66.0,66.0,24,1584,5278873.0,66.0,66.0
19507.0,6,20,7606,11,978,1950.7,310.0,88.9090909090909,9,6628,2000.25,1514.0,736.4444444444445
33707098.0,6,5,336,2,134,0.0,68.0,67.0,3,202,15460298.0,70.0,67.33333333333333
107230.0,17,2,286,2,286,0.0,143.0,143.0,0,0,0.0,0.0,0.0
1193948.0,17,6,1230,3,234,596796.0,78.0,78.0,3,996,596761.5,332.0,332.0
109257939.0,6,32,2220,16,1149,7269516.2,123.0,71.8125,16,1071,7269513.733333333,123.0,66.9375
0.0,6,1,66,1,66,0.0,66.0,66.0,0,0,0.0,0.0,0.0
299.0,17,2,174,1,79,0.0,79.0,79.0,1,95,0.0,95.0,95.0
44648.0,6,14,4740,7,653,7164.333333333333,249.0,93.28571428571428,7,4087,7223.166666666667,1514.0,583.8571428571429
209686.0,17,2,180,1,90,0.0,90.0,90.0,1,90,0.0,90.0,90.0
115621921.0,6,669,141428,341,119188,339431.1617647059,1514.0,349.524926686217,328,22240,352925.52905198775,214.0,67.8048780487805
2049.0,17,4,344,2,150,0.0,75.0,75.0,2,194,0.0,103.0,97.0
288.0,17,2,156,1,78,0.0,78.0,78.0,1,78,0.0,78.0,78.0
19766.0,6,2,145,2,145,0.0,91.0,72.5,0,0,0.0,0.0,0.0
20550.0,17,3,1026,3,1026,10275.0,342.0,342.0,0,0,0.0,0.0,0.0
105487970.0,17,14,1126,7,563,17572489.333333332,174.0,80.42857142857143,7,563,17554645.833333332,174.0,80.42857142857143
296481.0,17,2,363,1,79,0.0,79.0,79.0,1,284,0.0,284.0,284.0
40826.0,6,14,4740,7,653,6004.166666666667,249.0,93.28571428571428,7,4087,6610.833333333333,1514.0,583.8571428571429
217756.0,6,3,426,2,280,0.0,214.0,140.0,1,146,0.0,146.0,146.0
56330.0,6,13,4519,6,512,8168.2,230.0,85.33333333333333,7,4007,8894.0,1514.0,572.4285714285714
106169760.0,17,14,864,7,432,17668099.166666668,174.0,61.71428571428572,7,432,17666831.333333332,174.0,61.71428571428572
2793486.0,6,2,132,1,66,0.0,66.0,66.0,1,66,0.0,66.0,66.0
19240.0,6,10,2032,5,524,4562.5,252.0,104.8,5,1508,4085.75,1236.0,301.6
1019666.0,6,11,1134,6,558,203933.2,220.0,93.0,5,576,254338.5,304.0,115.2
284057.0,17,4,704,2,148,0.0,74.0,74.0,2,556,0.0,280.0,278.0
90277219.0,6,18,1341,9,691,11284652.375,95.0,76.77777777777777,9,650,11249920.125,95.0,72.22222222222223
80060.0,6,14,4740,7,653,13218.166666666666,249.0,93.28571428571428,7,4087,13151.833333333334,1514.0,583.8571428571429
297619.0,6,6,412,4,272,99206.33333333331,74.0,68.0,2,140,0.0,74.0,70.0
3242004.0,6,3,1777,2,951,0.0,885.0,475.5,1,826,0.0,826.0,826.0
227961.0,6,13,1386,7,789,37993.5,253.0,112.71428571428572,6,597,42870.2,259.0,99.5
103547.0,17,4,1400,4,1400,34515.666666666664,350.0,350.0,0,0,0.0,0.0,0.0
16187.0,6,14,4740,7,653,2433.0,249.0,93.28571428571428,7,4087,2553.333333333333,1514.0,583.8571428571429
2802162.0,6,2,132,1,66,0.0,66.0,66.0,1,66,0.0,66.0,66.0
5619870.0,6,4,270,2,134,0.0,68.0,67.0,2,136,0.0,70.0,68.0
1180404.0,6,13,1386,7,789,196734.0,253.0,112.71428571428572,6,597,234038.2,259.0,99.5
233030.0,6,3,337,2,214,0.0,160.0,107.0,1,123,0.0,123.0,123.0
156366.0,17,2,180,1,90,0.0,90.0,90.0,1,90,0.0,90.0,90.0
2601971.0,6,2,132,1,66,0.0,66.0,66.0,1,66,0.0,66.0,66.0
112001052.0,17,15,1169,8,606,16000150.285714284,174.0,75.75,7,563,17497609.0,174.0,80.42857142857143
92918874.0,17,12,778,6,389,18400819.0,174.0,64.83333333333333,6,389,18400161.8,174.0,64.83333333333333
48429.0,6,14,4740,7,653,7797.5,249.0,93.28571428571428,7,4087,6925.333333333333,1514.0,583.8571428571429
298578.0,6,6,412,4,272,99526.0,74.0,68.0,2,140,0.0,74.0,70.0
729.0,17,4,438,2,148,0.0,74.0,74.0,2,290,0.0,147.0,145.0
53960.0,6,14,4740,7,653,6889.333333333333,249.0,93.28571428571428,7,4087,8610.666666666666,1514.0,583.8571428571429
46002.0,6,14,4740,7,653,7537.166666666667,249.0,93.28571428571428,7,4087,6959.166666666667,1514.0,583.8571428571429
208273.0,6,3,426,2,280,0.0,214.0,140.0,1,146,0.0,146.0,146.0
1670027.0,17,2,876,2,876,0.0,438.0,438.0,0,0,0.0,0.0,0.0
1018692.0,6,11,1134,6,558,203738.4,220.0,93.0,5,576,254181.5,304.0,115.2
216879.0,6,3,426,2,280,0.0,214.0,140.0,1,146,0.0,146.0,146.0
65922.0,6,14,4740,7,653,10877.166666666666,249.0,93.28571428571428,7,4087,10771.333333333334,1514.0,583.8571428571429
82.0,17,2,762,2,762,0.0,381.0,381.0,0,0,0.0,0.0,0.0
109334645.0,6,46,3844,26,2143,4373385.8,139.0,82.42307692307692,20,1701,5743077.736842105,123.0,85.05
323928.0,17,4,1400,4,1400,107976.0,350.0,350.0,0,0,0.0,0.0,0.0
209619.0,17,2,180,1,90,0.0,90.0,90.0,1,90,0.0,90.0,90.0
96322.0,17,2,286,2,286,0.0,143.0,143.0,0,0,0.0,0.0,0.0
105087838.0,6,233,26334,117,7944,905929.6379310344,140.0,67.8974358974359,116,18390,896644.5652173914,284.0,158.5344827586207
178134.0,17,2,180,1,90,0.0,90.0,90.0,1,90,0.0,90.0,90.0
210296.0,17,2,414,1,88,0.0,88.0,88.0,1,326,0.0,326.0,326.0
62335.0,6,14,4740,7,653,10211.0,249.0,93.28571428571428,7,4087,8125.833333333333,1514.0,583.8571428571429
109246027.0,17,14,864,7,432,18167671.5,174.0,61.71428571428572,7,432,18166830.166666668,174.0,61.71428571428572
25887.0,6,14,4740,7,653,4176.333333333333,249.0,93.28571428571428,7,4087,4174.666666666667,1514.0,583.8571428571429
57336.0,6,10,2032,5,524,12100.25,252.0,104.8,5,1508,10183.25,1236.0,301.6
117392259.0,6,34,2334,17,1209,7323517.1875,123.0,71.11764705882354,17,1125,7323518.5625,123.0,66.17647058823529
50701.0,6,12,1320,6,723,9098.8,253.0,120.5,6,597,8952.4,259.0,99.5
246739.0,6,3,373,2,238,0.0,172.0,119.0,1,135,0.0,135.0,135.0
90953324.0,6,21,1585,11,840,9094731.3,95.0,76.36363636363636,10,745,10104601.666666666,95.0,74.5
29537.0,6,14,4740,7,653,3580.0,249.0,93.28571428571428,7,4087,4609.166666666667,1514.0,583.8571428571429
32526.0,6,14,4740,7,653,5027.166666666667,249.0,93.28571428571428,7,4087,4418.0,1514.0,583.8571428571429
41286.0,6,14,4740,7,653,6756.833333333333,249.0,93.28571428571428,7,4087,5819.833333333333,1514.0,583.8571428571429
233662.0,6,3,337,2,214,0.0,160.0,107.0,1,123,0.0,123.0,123.0
104414.0,17,2,286,2,286,0.0,143.0,143.0,0,0,0.0,0.0,0.0
318.0,17,2,174,1,79,0.0,79.0,79.0,1,95,0.0,95.0,95.0
53669.0,6,14,4740,7,653,8631.833333333334,249.0,93.28571428571428,7,4087,8354.166666666666,1514.0,583.8571428571429
228199.0,17,2,180,1,90,0.0,90.0,90.0,1,90,0.0,90.0,90.0
113251775.0,6,46,3036,23,1518,5135436.318181818,66.0,66.0,23,1518,5135434.363636363,66.0,66.0
122040.0,6,3,337,2,214,0.0,160.0,107.0,1,123,0.0,123.0,123.0
108107070.0,17,5,955,5,955,27026767.5,191.0,191.0,0,0,0.0,0.0,0.0
120388118.0,6,243,27530,122,19248,994943.1239669422,300.0,157.7704918032787,121,8282,985967.7833333332,140.0,68.44628099173553
135126110.0,17,6,1206,6,1206,27025222.0,201.0,201.0,0,0,0.0,0.0,0.0
128809.0,17,4,1524,4,1524,42936.333333333336,381.0,381.0,0,0,0.0,0.0,0.0
3300979.0,6,3,1604,2,851,0.0,785.0,425.5,1,753,0.0,753.0,753.0
120026436.0,17,28,13364,28,13364,4445423.555555556,501.0,477.2857142857143,0,0,0.0,0.0,0.0
166517.0,17,2,180,1,90,0.0,90.0,90.0,1,90,0.0,90.0,90.0
4328.0,17,2,602,1,72,0.0,72.0,72.0,1,530,0.0,530.0,530.0
90026745.0,17,28,13364,28,13364,3334323.888888889,501.0,477.2857142857143,0,0,0.0,0.0,0.0
4438.0,17,2,602,1,72,0.0,72.0,72.0,1,530,0.0,530.0,530.0
228305.0,17,2,180,1,90,0.0,90.0,90.0,1,90,0.0,90.0,90.0
219095.0,6,3,426,2,280,0.0,214.0,140.0,1,146,0.0,146.0,146.0
2333.0,17,4,344,2,150,0.0,75.0,75.0,2,194,0.0,103.0,97.0
106460.0,17,2,762,2,762,0.0,381.0,381.0,0,0,0.0,0.0,0.0
10514189.0,6,7,478,4,272,3459463.333333333,74.0,68.0,3,206,5189085.5,74.0,68.66666666666667
1501350.0,6,4,276,2,128,0.0,74.0,64.0,2,148,0.0,74.0,74.0
307635.0,6,6,412,4,272,102545.0,74.0,68.0,2,140,0.0,74.0,70.0
320.0,17,2,174,1,79,0.0,79.0,79.0,1,95,0.0,95.0,95.0
4643.0,17,2,598,1,72,0.0,72.0,72.0,1,526,0.0,526.0,526.0
10433413.0,6,6,412,3,206,5148109.5,74.0,68.66666666666667,3,206,5147993.0,74.0,68.66666666666667
144783.0,17,2,180,1,70,0.0,70.0,70.0,1,110,0.0,110.0,110.0
2576113.0,6,2,132,1,66,0.0,66.0,66.0,1,66,0.0,66.0,66.0
120121674.0,6,13,2036,8,1016,17136965.57142857,188.0,127.0,5,1020,22523105.0,204.0,204.0
34973.0,6,14,4740,7,653,5453.833333333333,249.0,93.28571428571428,7,4087,5656.333333333333,1514.0,583.8571428571429
108106349.0,17,5,955,5,955,27026587.25,191.0,191.0,0,0,0.0,0.0,0.0
1001372.0,6,4,492,2,280,0.0,214.0,140.0,2,212,0.0,146.0,106.0
10423858.0,6,7,478,4,272,3429226.333333333,74.0,68.0,3,206,5143740.5,74.0,68.66666666666667
0.0,6,1,66,1,66,0.0,66.0,66.0,0,0,0.0,0.0,0.0
273085.0,6,10,1221,6,636,54617.0,298.0,106.0,4,585,85458.0,379.0,146.25
1019547.0,6,11,1134,6,558,203909.4,220.0,93.0,5,576,254168.25,304.0,115.2
35531.0,6,14,4740,7,653,5500.5,249.0,93.28571428571428,7,4087,5282.5,1514.0,583.8571428571429
135130715.0,17,6,1206,6,1206,27026143.0,201.0,201.0,0,0,0.0,0.0,0.0
92438349.0,6,37,2442,19,1254,5135463.833333333,66.0,66.0,18,1188,5124126.0,66.0,66.0
57332.0,6,14,4740,7,653,9425.166666666666,249.0,93.28571428571428,7,4087,8116.333333333333,1514.0,583.8571428571429
299499.0,17,4,1524,4,1524,99833.0,381.0,381.0,0,0,0.0,0.0,0.0
99427.0,17,2,762,2,762,0.0,381.0,381.0,0,0,0.0,0.0,0.0
44915.0,6,14,4740,7,653,5903.333333333333,249.0,93.28571428571428,7,4087,6790.833333333333,1514.0,583.8571428571429
307518.0,6,6,412,4,272,102506.0,74.0,68.0,2,140,0.0,74.0,70.0
443192.0,6,11,1021,6,444,59784.4,162.0,74.0,5,577,74658.25,349.0,115.4
90032714.0,17,28,13364,28,13364,3334544.962962963,501.0,477.2857142857143,0,0,0.0,0.0,0.0
18639.0,6,14,4740,7,653,2997.0,249.0,93.28571428571428,7,4087,2968.1666666666665,1514.0,583.8571428571429
91000829.0,17,12,778,6,389,18200165.8,174.0,64.83333333333333,6,389,17999984.0,174.0,64.83333333333333
237529.0,17,2,180,1,90,0.0,90.0,90.0,1,90,0.0,90.0,90.0
10433968.0,6,6,412,3,206,5146325.5,74.0,68.66666666666667,3,206,5145926.5,74.0,68.66666666666667
298042.0,6,6,412,4,272,99347.33333333331,74.0,68.0,2,140,0.0,74.0,70.0
10887288.0,6,8,544,4,272,3576020.0,74.0,68.0,4,272,3583520.0,74.0,68.0
147998.0,17,2,180,1,90,0.0,90.0,90.0,1,90,0.0,90.0,90.0
113978412.0,6,48,3168,24,1584,4955583.130434782,66.0,66.0,24,1584,4941987.521739131,66.0,66.0
307354.0,6,3,202,2,128,0.0,74.0,64.0,1,74,0.0,74.0,74.0
15272.0,6,10,2032,5,524,3495.0,252.0,104.8,5,1508,2717.5,1236.0,301.6
90255322.0,6,12,1832,8,1016,12893617.42857143,188.0,127.0,4,816,30029206.0,204.0,204.0
135128939.0,17,6,1146,6,1146,27025787.8,191.0,191.0,0,0,0.0,0.0,0.0
39222.0,6,14,4740,7,653,5776.166666666667,249.0,93.28571428571428,7,4087,5734.666666666667,1514.0,583.8571428571429
326524.0,17,4,1400,4,1400,108841.33333333331,350.0,350.0,0,0,0.0,0.0,0.0
103047.0,17,2,286,2,286,0.0,143.0,143.0,0,0,0.0,0.0,0.0
250532.0,6,3,337,2,214,0.0,160.0,107.0,1,123,0.0,123.0,123.0
13336.0,17,2,582,1,83,0.0,83.0,83.0,1,499,0.0,499.0,499.0
2692921.0,6,2,132,1,66,0.0,66.0,66.0,1,66,0.0,66.0,66.0
104477.0,17,2,286,2,286,0.0,143.0,143.0,0,0,0.0,0.0,0.0
146093.0,6,3,337,2,214,0.0,160.0,107.0,1,123,0.0,123.0,123.0
216458.0,17,2,180,1,90,0.0,90.0,90.0,1,90,0.0,90.0,90.0
14939.0,6,11,2098,6,590,2823.0,252.0,98.33333333333331,5,1508,3172.0,1236.0,301.6
102044099.0,17,14,1126,7,563,17000155.333333332,174.0,80.42857142857143,7,563,17000997.833333332,174.0,80.42857142857143
93055803.0,6,40,2640,20,1320,4897673.842105263,66.0,66.0,20,1320,4883339.0,66.0,66.0
103045.0,17,2,286,2,286,0.0,143.0,143.0,0,0,0.0,0.0,0.0
31484.0,6,10,2032,5,524,7570.75,252.0,104.8,5,1508,7472.0,1236.0,301.6
1974.0,17,2,508,2,508,0.0,257.0,254.0,0,0,0.0,0.0,0.0
144067.0,17,4,704,2,148,0.0,74.0,74.0,2,556,0.0,280.0,278.0
302764.0,6,6,412,4,272,100921.33333333331,74.0,68.0,2,140,0.0,74.0,70.0
317705.0,17,4,1400,4,1400,105901.66666666669,350.0,350.0,0,0,0.0,0.0,0.0
210013.0,6,3,426,2,280,0.0,214.0,140.0,1,146,0.0,146.0,146.0
216826.0,6,3,426,2,280,0.0,214.0,140.0,1,146,0.0,146.0,146.0
1031813.0,6,11,1134,6,558,206362.6,220.0,93.0,5,576,256608.0,304.0,115.2
27031027.0,17,2,402,2,402,0.0,201.0,201.0,0,0,0.0,0.0,0.0
207563.0,6,3,426,2,280,0.0,214.0,140.0,1,146,0.0,146.0,146.0
120351732.0,6,239,27022,120,18872,1011359.0924369748,284.0,157.26666666666668,119,8150,1011125.9491525424,140.0,68.4873949579832
2319.0,17,4,344,2,150,0.0,75.0,75.0,2,194,0.0,103.0,97.0
108105578.0,17,5,1005,5,1005,27026394.5,201.0,201.0,0,0,0.0,0.0,0.0
448439.0,6,6,758,3,410,186856.0,172.0,136.66666666666666,3,348,164569.0,135.0,116.0
10471059.0,6,6,412,3,206,5167180.0,74.0,68.66666666666667,3,206,5167094.0,74.0,68.66666666666667
216421.0,17,2,180,1,90,0.0,90.0,90.0,1,90,0.0,90.0,90.0
135136310.0,17,6,1146,6,1146,27027262.0,191.0,191.0,0,0,0.0,0.0,0.0
135130374.0,17,6,1146,6,1146,27026074.8,191.0,191.0,0,0,0.0,0.0,0.0
40376.0,6,14,4740,7,653,6551.833333333333,249.0,93.28571428571428,7,4087,6192.833333333333,1514.0,583.8571428571429
1308346.0,6,4,264,2,132,0.0,66.0,66.0,2,132,0.0,66.0,66.0
112535462.0,6,46,3036,23,1518,5105437.227272728,66.0,66.0,23,1518,5105435.681818182,66.0,66.0
34271.0,6,14,4740,7,653,4865.833333333333,249.0,93.28571428571428,7,4087,5539.0,1514.0,583.8571428571429
14598.0,6,14,4740,7,653,2250.1666666666665,249.0,93.28571428571428,7,4087,2294.6666666666665,1514.0,583.8571428571429
852907.0,6,9,1096,6,625,170581.4,287.0,104.16666666666669,3,471,290183.0,331.0,157.0
98364908.0,6,27,1885,14,963,7566531.384615385,123.0,68.78571428571429,13,922,8179870.166666667,139.0,70.92307692307692
25351.0,6,10,2032,5,524,5751.5,252.0,104.8,5,1508,6047.75,1236.0,301.6
90530015.0,6,13,2036,8,1016,12932859.285714284,188.0,127.0,5,1020,22590512.25,204.0,204.0
2592764.0,6,2,132,1,66,0.0,66.0,66.0,1,66,0.0,66.0,66.0
12186.0,6,10,1066,5,490,2876.5,218.0,98.0,5,576,2754.0,304.0,115.2
108108902.0,17,5,955,5,955,27027225.5,191.0,191.0,0,0,0.0,0.0,0.0
96124153.0,6,58,12159,29,6366,3433005.464285714,1514.0,219.51724137931035,29,5793,3423548.714285714,1514.0,199.7586206896552
20418.0,17,2,582,1,83,0.0,83.0,83.0,1,499,0.0,499.0,499.0
113520341.0,6,46,3036,23,1518,5160003.863636363,66.0,66.0,23,1518,5160003.045454546,66.0,66.0
27254.0,6,14,4740,7,653,4431.5,249.0,93.28571428571428,7,4087,2927.6666666666665,1514.0,583.8571428571429
90047368.0,17,27,12943,27,12943,3463360.3076923075,501.0,479.3703703703704,0,0,0.0,0.0,0.0
42783.0,6,14,4740,7,653,6771.666666666667,249.0,93.28571428571428,7,4087,6699.5,1514.0,583.8571428571429
233080.0,6,3,337,2,214,0.0,160.0,107.0,1,123,0.0,123.0,123.0
30919284.0,6,4,270,3,202,15459642.0,70.0,67.33333333333333,1,68,0.0,68.0,68.0
1723865.0,6,22,6442,12,1529,156715.0,357.0,127.41666666666669,10,4913,157651.66666666666,1510.0,491.3
90014245.0,17,28,13364,28,13364,3333860.925925926,501.0,477.2857142857143,0,0,0.0,0.0,0.0
21755.0,17,4,823,2,163,0.0,89.0,81.5,2,660,0.0,443.0,330.0
113804.0,17,4,1400,4,1400,37934.66666666666,350.0,350.0,0,0,0.0,0.0,0.0
752770.0,6,2,132,1,66,0.0,66.0,66.0,1,66,0.0,66.0,66.0
147864.0,17,2,180,1,90,0.0,90.0,90.0,1,90,0.0,90.0,90.0
10472357.0,6,7,478,4,272,3443502.0,74.0,68.0,3,206,5165147.5,74.0,68.66666666666667
50309.0,6,14,4740,7,653,7900.0,249.0,93.28571428571428,7,4087,7870.666666666667,1514.0,583.8571428571429
26849125.0,17,5,1718,4,1368,979778.6666666666,342.0,342.0,1,350,0.0,350.0,350.0
791.0,17,4,438,2,148,0.0,74.0,74.0,2,290,0.0,147.0,145.0
2426.0,17,4,344,2,150,0.0,75.0,75.0,2,194,0.0,103.0,97.0
246008.0,6,3,337,2,214,0.0,160.0,107.0,1,123,0.0,123.0,123.0
305780.0,6,6,412,4,272,101926.66666666669,74.0,68.0,2,140,0.0,74.0,70.0
153413.0,17,2,180,1,90,0.0,90.0,90.0,1,90,0.0,90.0,90.0
274517.0,17,4,823,2,163,0.0,89.0,81.5,2,660,0.0,443.0,330.0
153449.0,17,2,180,1,90,0.0,90.0,90.0,1,90,0.0,90.0,90.0
311379.0,6,3,202,2,128,0.0,74.0,64.0,1,74,0.0,74.0,74.0
2058444.0,6,23,7478,11,2384,205844.4,1034.0,216.72727272727272,12,5094,158937.72727272726,1510.0,424.5
1303532.0,6,4,264,2,132,0.0,66.0,66.0,2,132,0.0,66.0,66.0
250405.0,17,4,6056,4,6056,83468.33333333333,1514.0,1514.0,0,0,0.0,0.0,0.0
90255535.0,6,12,1832,8,1016,12893647.857142856,188.0,127.0,4,816,30030894.0,204.0,204.0
231784.0,17,2,180,1,90,0.0,90.0,90.0,1,90,0.0,90.0,90.0
143981.0,17,2,180,1,90,0.0,90.0,90.0,1,90,0.0,90.0,90.0
205879.0,17,2,180,1,90,0.0,90.0,90.0,1,90,0.0,90.0,90.0
0.0,17,1,44,1,44,0.0,44.0,44.0,0,0,0.0,0.0,0.0
146185.0,6,3,337,2,214,0.0,160.0,107.0,1,123,0.0,123.0,123.0
135135075.0,17,6,1146,6,1146,27027015.0,191.0,191.0,0,0,0.0,0.0,0.0
237700.0,6,3,337,2,214,0.0,160.0,107.0,1,123,0.0,123.0,123.0
90028310.0,6,16,1233,8,596,8606923.714285715,95.0,74.5,8,637,12860077.0,95.0,79.625
284635.0,17,2,363,1,79,0.0,79.0,79.0,1,284,0.0,284.0,284.0
4269.0,17,2,610,1,72,0.0,72.0,72.0,1,538,0.0,538.0,538.0
108098215.0,17,5,1005,5,1005,27024553.75,201.0,201.0,0,0,0.0,0.0,0.0
103342.0,17,2,286,2,286,0.0,143.0,143.0,0,0,0.0,0.0,0.0
856.0,17,5,550,5,550,214.0,110.0,110.0,0,0,0.0,0.0,0.0
108103660.0,17,5,955,5,955,27025915.0,191.0,191.0,0,0,0.0,0.0,0.0
0.0,17,1,84,1,84,0.0,84.0,84.0,0,0,0.0,0.0,0.0
499093.0,6,5,336,2,134,0.0,68.0,67.0,3,202,190384.0,70.0,67.33333333333333
60710.0,6,14,4740,7,653,10009.833333333334,249.0,93.28571428571428,7,4087,7984.166666666667,1514.0,583.8571428571429
269472.0,6,12,1373,7,714,44912.0,298.0,102.0,5,659,62821.25,379.0,131.8
107310.0,17,2,762,2,762,0.0,381.0,381.0,0,0,0.0,0.0,0.0
34450.0,6,14,4740,7,653,5619.5,249.0,93.28571428571428,7,4087,5538.333333333333,1514.0,583.8571428571429
25031.0,6,14,4740,7,653,3999.0,249.0,93.28571428571428,7,4087,3925.1666666666665,1514.0,583.8571428571429
1627.0,17,2,762,2,762,0.0,381.0,381.0,0,0,0.0,0.0,0.0
155877.0,17,2,180,1,90,0.0,90.0,90.0,1,90,0.0,90.0,90.0
208321.0,6,12,1373,7,714,34720.166666666664,298.0,102.0,5,659,50846.25,379.0,131.8
50596.0,6,14,4740,7,653,7280.666666666667,249.0,93.28571428571428,7,4087,5991.666666666667,1514.0,583.8571428571429
29522.0,6,14,4740,7,653,4238.0,249.0,93.28571428571428,7,4087,4515.833333333333,1514.0,583.8571428571429
120124461.0,6,13,2020,9,1204,15015557.625,188.0,133.77777777777777,4,816,30030982.33333333,204.0,204.0
144542.0,6,2,132,1,66,0.0,66.0,66.0,1,66,0.0,66.0,66.0
253676.0,17,4,6056,4,6056,84558.66666666667,1514.0,1514.0,0,0,0.0,0.0,0.0
121905005.0,17,14,864,7,432,17058624.833333332,174.0,61.71428571428572,7,432,17001022.833333332,174.0,61.71428571428572
131008245.0,17,17,1255,9,649,16376030.625,174.0,72.11111111111111,8,606,15865966.714285716,174.0,75.75
336.0,17,2,166,1,75,0.0,75.0,75.0,1,91,0.0,91.0,91.0
44584.0,6,14,4740,7,653,6706.833333333333,249.0,93.28571428571428,7,4087,6705.833333333333,1514.0,583.8571428571429
10326.0,17,2,582,1,83,0.0,83.0,83.0,1,499,0.0,499.0,499.0
145014.0,17,2,180,1,70,0.0,70.0,70.0,1,110,0.0,110.0,110.0
207111.0,6,3,426,2,280,0.0,214.0,140.0,1,146,0.0,146.0,146.0
48968.0,6,11,2098,6,590,9477.8,252.0,98.33333333333331,5,1508,11786.25,1236.0,301.6
500305.0,6,3,204,2,136,0.0,70.0,68.0,1,68,0.0,68.0,68.0
103326.0,17,2,286,2,286,0.0,143.0,143.0,0,0,0.0,0.0,0.0
102240240.0,6,42,2772,21,1386,5111999.5,66.0,66.0,21,1386,5111997.4,66.0,66.0
120078662.0,17,29,13785,29,13785,4288523.642857143,501.0,475.3448275862069,0,0,0.0,0.0,0.0
106232130.0,6,44,2904,22,1452,5058672.857142857,66.0,66.0,22,1452,5048382.238095238,66.0,66.0
845.0,17,4,438,2,148,0.0,74.0,74.0,2,290,0.0,147.0,145.0
107919514.0,6,32,2236,16,1165,7180250.533333333,139.0,72.8125,16,1071,7180248.333333333,123.0,66.9375
109726888.0,6,44,2904,22,1452,5225089.904761905,66.0,66.0,22,1452,5206179.952380952,66.0,66.0
10511939.0,6,7,478,4,272,3458455.6666666665,74.0,68.0,3,206,5187600.5,74.0,68.66666666666667
884697.0,6,10,1336,6,799,176939.4,461.0,133.16666666666666,4,537,203006.0,331.0,134.25
135130942.0,17,6,1146,6,1146,27026188.4,191.0,191.0,0,0,0.0,0.0,0.0
27566.0,6,14,4740,7,653,4434.166666666667,249.0,93.28571428571428,7,4087,4457.833333333333,1514.0,583.8571428571429
209840.0,17,2,762,2,762,0.0,381.0,381.0,0,0,0.0,0.0,0.0
217988.0,6,3,426,2,280,0.0,214.0,140.0,1,146,0.0,146.0,146.0
153367.0,17,2,180,1,90,0.0,90.0,90.0,1,90,0.0,90.0,90.0
51258.0,6,10,2032,5,524,10265.75,252.0,104.8,5,1508,10421.5,1236.0,301.6
135130984.0,17,6,1206,6,1206,27026196.8,201.0,201.0,0,0,0.0,0.0,0.0
792.0,17,4,438,2,148,0.0,74.0,74.0,2,290,0.0,147.0,145.0
476242.0,6,5,336,2,134,0.0,68.0,67.0,3,202,194020.5,70.0,67.33333333333333
135131196.0,17,6,1146,6,1146,27026239.2,191.0,191.0,0,0,0.0,0.0,0.0
21190.0,6,2,145,2,145,0.0,91.0,72.5,0,0,0.0,0.0,0.0
2588.0,17,4,344,2,150,0.0,75.0,75.0,2,194,0.0,103.0,97.0
111570439.0,6,38,2842,19,1471,6186373.166666667,139.0,77.42105263157895,19,1371,6186365.277777778,123.0,72.15789473684211
102398.0,17,2,286,2,286,0.0,143.0,143.0,0,0,0.0,0.0,0.0
34233.0,6,14,4740,7,653,4169.166666666667,249.0,93.28571428571428,7,4087,5119.5,1514.0,583.8571428571429
314676.0,17,4,1400,4,1400,104892.0,350.0,350.0,0,0,0.0,0.0,0.0
26614.0,17,2,582,1,83,0.0,83.0,83.0,1,499,0.0,499.0,499.0
340959.0,6,6,412,4,272,113653.0,74.0,68.0,2,140,0.0,74.0,70.0
66874.0,6,14,4740,7,653,9853.833333333334,249.0,93.28571428571428,7,4087,10110.0,1514.0,583.8571428571429
103363.0,17,2,286,2,286,0.0,143.0,143.0,0,0,0.0,0.0,0.0
209509.0,17,2,180,1,90,0.0,90.0,90.0,1,90,0.0,90.0,90.0
135128904.0,17,6,1206,6,1206,27025780.8,201.0,201.0,0,0,0.0,0.0,0.0
108104691.0,17,5,1005,5,1005,27026172.75,201.0,201.0,0,0,0.0,0.0,0.0
5625875.0,6,4,270,2,134,0.0,68.0,67.0,2,136,0.0,70.0,68.0
860722.0,6,11,2643,7,743,143453.66666666666,339.0,106.14285714285714,4,1900,196041.66666666663,1514.0,475.0
121618782.0,6,32,2236,16,1071,7595367.266666667,123.0,66.9375,16,1165,8107753.2,139.0,72.8125
242361.0,6,3,337,2,214,0.0,160.0,107.0,1,123,0.0,123.0,123.0
234308.0,6,3,373,2,238,0.0,172.0,119.0,1,135,0.0,135.0,135.0
1050294.0,6,20,6434,12,1921,95481.27272727272,620.0,160.08333333333334,8,4513,123698.42857142857,1514.0,564.125
209504.0,17,2,762,2,762,0.0,381.0,381.0,0,0,0.0,0.0,0.0
217446.0,6,3,426,2,280,0.0,214.0,140.0,1,146,0.0,146.0,146.0
108107915.0,17,5,1005,5,1005,27026978.75,201.0,201.0,0,0,0.0,0.0,0.0
37553.0,6,10,2032,5,524,9148.75,252.0,104.8,5,1508,8905.5,1236.0,301.6
90529482.0,6,14,2240,8,1016,12932783.142857144,188.0,127.0,6,1224,18073070.6,204.0,204.0
90511308.0,6,14,2240,8,1016,12930186.857142856,188.0,127.0,6,1224,18069914.0,204.0,204.0
95040363.0,6,38,3250,21,1780,4752018.15,139.0,84.76190476190476,17,1470,5926514.8125,123.0,86.47058823529412
34512.0,6,14,4740,7,653,4979.833333333333,249.0,93.28571428571428,7,4087,5454.666666666667,1514.0,583.8571428571429
864236.0,6,9,1269,6,798,172847.2,460.0,133.0,3,471,294308.0,331.0,157.0
29801.0,6,14,4740,7,653,4765.833333333333,249.0,93.28571428571428,7,4087,4394.5,1514.0,583.8571428571429
104300462.0,17,14,1126,7,563,17356920.0,174.0,80.42857142857143,7,563,17383217.5,174.0,80.42857142857143
317.0,17,2,191,1,73,0.0,73.0,73.0,1,118,0.0,118.0,118.0
328.0,17,2,166,1,75,0.0,75.0,75.0,1,91,0.0,91.0,91.0
10870043.0,6,8,544,4,272,3577920.6666666665,74.0,68.0,4,272,3577830.333333333,74.0,68.0
208141.0,6,4,492,2,280,0.0,214.0,140.0,2,212,0.0,146.0,106.0
29404.0,6,14,4740,7,653,4301.333333333333,249.0,93.28571428571428,7,4087,4707.0,1514.0,583.8571428571429
55681.0,6,14,4740,7,653,8806.166666666666,249.0,93.28571428571428,7,4087,8609.0,1514.0,583.8571428571429
3052340.0,6,4,270,3,202,1526170.0,70.0,67.33333333333333,1,68,0.0,68.0,68.0
3169229.0,6,18,1495,9,921,358214.625,315.0,102.33333333333331,9,574,358186.875,78.0,63.77777777777778
148024.0,17,2,180,1,90,0.0,90.0,90.0,1,90,0.0,90.0,90.0
149736.0,17,2,180,1,90,0.0,90.0,90.0,1,90,0.0,90.0,90.0
118909077.0,6,34,2334,17,1209,7418231.6875,123.0,71.11764705882354,17,1125,7418309.75,123.0,66.17647058823529
100742.0,17,2,762,2,762,0.0,381.0,381.0,0,0,0.0,0.0,0.0
2321.0,17,4,344,2,150,0.0,75.0,75.0,2,194,0.0,103.0,97.0
94809338.0,17,12,778,6,389,18800873.0,174.0,64.83333333333333,6,389,18800170.8,174.0,64.83333333333333
51935.0,6,10,2032,5,524,12322.5,252.0,104.8,5,1508,9324.0,1236.0,301.6
90039839.0,17,28,13364,28,13364,3334808.851851852,501.0,477.2857142857143,0,0,0.0,0.0,0.0
95224031.0,6,40,2640,20,1320,5011791.105263158,66.0,66.0,20,1320,4995346.631578947,66.0,66.0
33423.0,6,14,4740,7,653,5232.166666666667,249.0,93.28571428571428,7,4087,4904.666666666667,1514.0,583.8571428571429
90289580.0,6,16,1192,8,596,12892322.57142857,95.0,74.5,8,596,12897667.57142857,95.0,74.5
90259291.0,6,12,1832,8,1016,12894184.42857143,188.0,127.0,4,816,30031521.33333333,204.0,204.0
108105020.0,17,5,1005,5,1005,27026255.0,201.0,201.0,0,0,0.0,0.0,0.0
109352.0,17,2,286,2,286,0.0,143.0,143.0,0,0,0.0,0.0,0.0
287.0,17,2,156,1,78,0.0,78.0,78.0,1,78,0.0,78.0,78.0
854291.0,6,9,1268,6,797,170858.2,459.0,132.83333333333334,3,471,289194.5,331.0,157.0
27185.0,6,10,2032,5,524,6553.25,252.0,104.8,5,1508,6020.75,1236.0,301.6
143856.0,17,2,180,1,90,0.0,90.0,90.0,1,90,0.0,90.0,90.0
20181.0,17,4,823,2,163,0.0,89.0,81.5,2,660,0.0,443.0,330.0
315522.0,17,4,1400,4,1400,105174.0,350.0,350.0,0,0,0.0,0.0,0.0
123679693.0,6,48,3168,24,1584,4935789.130434782,66.0,66.0,24,1584,5355009.608695652,66.0,66.0
121546937.0,6,47,3102,23,1518,5144001.818181818,66.0,66.0,24,1584,5284638.0869565215,66.0,66.0
71704.0,6,14,4740,7,653,9378.333333333334,249.0,93.28571428571428,7,4087,11623.166666666666,1514.0,583.8571428571429
90935191.0,6,19,1436,9,691,11366898.875,95.0,76.77777777777777,10,745,10075236.333333334,95.0,74.5
157223.0,6,3,337,2,214,0.0,160.0,107.0,1,123,0.0,123.0,123.0
117263326.0,6,221,24934,111,7622,1066030.2363636363,140.0,68.66666666666667,110,17312,1069242.5596330275,284.0,157.38181818181818
144629.0,6,2,132,1,66,0.0,66.0,66.0,1,66,0.0,66.0,66.0
58702939.0,17,9,3086,8,2736,5107734.571428572,342.0,342.0,1,350,0.0,350.0,350.0
734677.0,6,11,1021,6,444,98323.4,162.0,74.0,5,577,122713.75,349.0,115.4
100786759.0,6,28,1860,14,966,7736240.461538462,123.0,69.0,14,894,7736239.230769231,123.0,63.85714285714285
153488.0,17,2,180,1,90,0.0,90.0,90.0,1,90,0.0,90.0,90.0
10516218.0,6,7,478,4,272,3458899.333333333,74.0,68.0,3,206,5156773.5,74.0,68.66666666666667
90000671.0,17,11,735,6,389,18000134.2,174.0,64.83333333333333,5,346,19840503.75,174.0,69.2
2365.0,17,4,344,2,150,0.0,75.0,75.0,2,194,0.0,103.0,97.0
2141534.0,6,19,6869,11,1567,214153.4,408.0,142.45454545454547,8,5302,238251.2857142857,1514.0,662.75
284554.0,17,2,363,1,79,0.0,79.0,79.0,1,284,0.0,284.0,284.0
102354.0,17,2,286,2,286,0.0,143.0,143.0,0,0,0.0,0.0,0.0
153504.0,17,2,180,1,90,0.0,90.0,90.0,1,90,0.0,90.0,90.0
15066016.0,17,6,2718,6,2718,3013203.2,453.0,453.0,0,0,0.0,0.0,0.0
149494338.0,6,22,1680,10,745,13311319.555555556,95.0,74.5,12,935,13570805.545454543,95.0,77.91666666666667
26729.0,6,10,2032,5,524,6006.75,252.0,104.8,5,1508,6400.75,1236.0,301.6
90531819.0,6,14,2240,8,1016,12933117.0,188.0,127.0,6,1224,18073741.0,204.0,204.0
310500.0,6,6,412,4,272,103500.0,74.0,68.0,2,140,0.0,74.0,70.0
149802.0,6,11,1132,6,556,29454.6,218.0,92.66666666666669,5,576,36635.25,304.0,115.2
120358723.0,6,221,25040,111,17558,1094170.209090909,284.0,158.18018018018017,110,7482,1094731.8623853212,140.0,68.01818181818182
30361.0,6,14,4740,7,653,4769.5,249.0,93.28571428571428,7,4087,4871.666666666667,1514.0,583.8571428571429
15659.0,6,10,2032,5,524,3088.25,252.0,104.8,5,1508,3348.25,1236.0,301.6
2472.0,17,4,344,2,150,0.0,75.0,75.0,2,194,0.0,103.0,97.0
281611.0,17,2,363,1,79,0.0,79.0,79.0,1,284,0.0,284.0,284.0
355719.0,6,4,508,2,238,0.0,172.0,119.0,2,270,0.0,135.0,135.0
19192.0,6,10,1067,5,536,2652.5,264.0,107.2,5,531,3942.0,259.0,106.2
19960.0,6,14,4740,7,653,2799.0,249.0,93.28571428571428,7,4087,3185.1666666666665,1514.0,583.8571428571429
6725.0,17,2,582,1,83,0.0,83.0,83.0,1,499,0.0,499.0,499.0
216634.0,6,3,426,2,280,0.0,214.0,140.0,1,146,0.0,146.0,146.0
93542007.0,6,216,24492,108,7350,869942.0093457944,140.0,68.05555555555556,108,17142,866567.4579439253,284.0,158.72222222222223
312143.0,17,4,1400,4,1400,104047.66666666669,350.0,350.0,0,0,0.0,0.0,0.0
354.0,17,2,267,1,83,0.0,83.0,83.0,1,184,0.0,184.0,184.0
45702.0,6,14,4740,7,653,7326.0,249.0,93.28571428571428,7,4087,6823.5,1514.0,583.8571428571429
2103683.0,6,19,6869,11,1567,210368.3,408.0,142.45454545454547,8,5302,238012.7142857143,1514.0,662.75
48037.0,6,10,2032,5,524,11789.5,252.0,104.8,5,1508,10481.25,1236.0,301.6
27918.0,6,10,2032,5,524,6462.75,252.0,104.8,5,1508,6708.0,1236.0,301.6
120583144.0,6,245,28238,123,19964,988386.4262295082,284.0,162.3089430894309,122,8274,987737.2561983472,140.0,67.81967213114754
246205.0,6,3,337,2,214,0.0,160.0,107.0,1,123,0.0,123.0,123.0
74604475.0,6,9,842,9,842,9325559.375,97.0,93.55555555555556,0,0,0.0,0.0,0.0
2453598.0,6,3,204,2,136,0.0,70.0,68.0,1,68,0.0,68.0,68.0
10465721.0,6,7,478,4,272,3443083.6666666665,74.0,68.0,3,206,5164567.0,74.0,68.66666666666667
45428.0,6,10,2032,5,524,11136.75,252.0,104.8,5,1508,11140.5,1236.0,301.6
119063716.0,6,34,2350,17,1225,7428697.4375,139.0,72.05882352941177,17,1125,7428697.75,123.0,66.17647058823529
9376.0,17,2,582,1,83,0.0,83.0,83.0,1,499,0.0,499.0,499.0
27033660.0,17,5,1710,5,1710,6758415.0,342.0,342.0,0,0,0.0,0.0,0.0
1310140.0,6,4,264,2,132,0.0,66.0,66.0,2,132,0.0,66.0,66.0
496.0,17,2,508,2,508,0.0,257.0,254.0,0,0,0.0,0.0,0.0
2910296.0,6,2,132,1,66,0.0,66.0,66.0,1,66,0.0,66.0,66.0
1255.0,17,4,438,2,148,0.0,74.0,74.0,2,290,0.0,147.0,145.0
108111786.0,17,5,1005,5,1005,27027946.5,201.0,201.0,0,0,0.0,0.0,0.0
209648.0,17,2,180,1,90,0.0,90.0,90.0,1,90,0.0,90.0,90.0
114012.0,17,4,1400,4,1400,38004.0,350.0,350.0,0,0,0.0,0.0,0.0
298704.0,6,7,478,4,272,99568.0,74.0,68.0,3,206,73302.5,74.0,68.66666666666667
103554.0,17,2,286,2,286,0.0,143.0,143.0,0,0,0.0,0.0,0.0
51463.0,6,14,4740,7,653,8455.166666666666,249.0,93.28571428571428,7,4087,8118.833333333333,1514.0,583.8571428571429
216202.0,17,2,180,1,90,0.0,90.0,90.0,1,90,0.0,90.0,90.0
4714.0,17,2,180,1,90,0.0,90.0,90.0,1,90,0.0,90.0,90.0
103145.0,17,2,286,2,286,0.0,143.0,143.0,0,0,0.0,0.0,0.0
120103752.0,6,763,114608,381,25590,314512.85789473687,214.0,67.16535433070867,382,89018,315151.20734908135,1514.0,233.03141361256544
135148801.0,17,6,1206,6,1206,27029760.2,201.0,201.0,0,0,0.0,0.0,0.0
2785902.0,6,4,256,2,120,0.0,66.0,60.0,2,136,0.0,70.0,68.0
14556.0,6,2,145,2,145,0.0,91.0,72.5,0,0,0.0,0.0,0.0
2344.0,17,4,344,2,150,0.0,75.0,75.0,2,194,0.0,103.0,97.0
108403.0,17,2,286,2,286,0.0,143.0,143.0,0,0,0.0,0.0,0.0
242559.0,6,3,337,2,214,0.0,160.0,107.0,1,123,0.0,123.0,123.0
135131889.0,17,6,1206,6,1206,27026377.8,201.0,201.0,0,0,0.0,0.0,0.0
41033.0,6,14,4740,7,653,6101.5,249.0,93.28571428571428,7,4087,6695.0,1514.0,583.8571428571429
5835548.0,6,5,336,2,134,0.0,68.0,67.0,3,202,1523258.0,70.0,67.33333333333333
299394.0,6,6,412,4,272,99798.0,74.0,68.0,2,140,0.0,74.0,70.0
1302112.0,6,4,264,2,132,0.0,66.0,66.0,2,132,0.0,66.0,66.0
10459782.0,6,7,478,4,272,3441308.333333333,74.0,68.0,3,206,5161830.0,74.0,68.66666666666667
135127628.0,17,6,1146,6,1146,27025525.6,191.0,191.0,0,0,0.0,0.0,0.0
124551098.0,17,14,864,7,432,17500161.833333332,174.0,61.71428571428572,7,432,17501395.666666668,174.0,61.71428571428572
143840.0,17,2,180,1,90,0.0,90.0,90.0,1,90,0.0,90.0,90.0
101088634.0,17,13,821,7,432,16667551.666666666,174.0,61.71428571428572,6,389,20000160.8,174.0,64.83333333333333
115663816.0,6,47,3102,24,1584,5028849.260869565,66.0,66.0,23,1518,5143998.7727272725,66.0,66.0
123730531.0,6,49,3234,25,1650,5155438.791666667,66.0,66.0,24,1584,5004963.434782608,66.0,66.0
119739276.0,6,366,41900,183,29526,656725.4230769231,284.0,161.34426229508196,183,12374,656725.7417582418,140.0,67.61748633879782
2347.0,17,4,344,2,150,0.0,75.0,75.0,2,194,0.0,103.0,97.0
108107608.0,17,5,955,5,955,27026902.0,191.0,191.0,0,0,0.0,0.0,0.0
5828788.0,6,5,336,2,134,0.0,68.0,67.0,3,202,1525833.0,70.0,67.33333333333333
90026237.0,17,28,13364,28,13364,3334305.074074074,501.0,477.2857142857143,0,0,0.0,0.0,0.0
2797592.0,6,2,132,1,66,0.0,66.0,66.0,1,66,0.0,66.0,66.0
171612.0,17,2,180,1,90,0.0,90.0,90.0,1,90,0.0,90.0,90.0
1824831.0,6,20,7599,11,1469,182483.1,583.0,133.54545454545453,9,6130,195456.5,1484.0,681.1111111111111
3005038.0,6,12,2172,7,664,500668.5,252.0,94.85714285714286,5,1508,1910.25,1236.0,301.6
103252.0,17,2,286,2,286,0.0,143.0,143.0,0,0,0.0,0.0,0.0
280527.0,17,4,571,2,148,0.0,74.0,74.0,2,423,0.0,280.0,211.5
97941440.0,6,183,20600,92,6368,1076279.5604395603,140.0,69.21739130434783,91,14232,1076659.411111111,284.0,156.3956043956044
303089.0,6,6,412,4,272,101029.66666666669,74.0,68.0,2,140,0.0,74.0,70.0
339731.0,17,4,704,2,148,0.0,74.0,74.0,2,556,0.0,280.0,278.0
313545.0,17,4,1400,4,1400,104515.0,350.0,350.0,0,0,0.0,0.0,0.0
302236.0,17,4,1524,4,1524,100745.33333333331,381.0,381.0,0,0,0.0,0.0,0.0
0.0,17,1,99,1,99,0.0,99.0,99.0,0,0,0.0,0.0,0.0
108106890.0,17,5,1005,5,1005,27026722.5,201.0,201.0,0,0,0.0,0.0,0.0
90035149.0,17,27,12943,27,12943,3462890.346153846,501.0,479.3703703703704,0,0,0.0,0.0,0.0
280195.0,17,2,363,1,79,0.0,79.0,79.0,1,284,0.0,284.0,284.0
301451.0,6,6,412,4,272,100483.66666666669,74.0,68.0,2,140,0.0,74.0,70.0
28575.0,6,14,4740,7,653,3294.833333333333,249.0,93.28571428571428,7,4087,4615.166666666667,1514.0,583.8571428571429
192658.0,17,2,180,1,90,0.0,90.0,90.0,1,90,0.0,90.0,90.0
75704.0,6,14,4740,7,653,11293.333333333334,249.0,93.28571428571428,7,4087,11766.666666666666,1514.0,583.8571428571429
119592626.0,6,218,24518,109,17028,1105346.6759259258,284.0,156.22018348623854,109,7490,1105346.4814814816,140.0,68.71559633027523
20522.0,17,2,582,1,83,0.0,83.0,83.0,1,499,0.0,499.0,499.0
8080.0,17,2,582,1,83,0.0,83.0,83.0,1,499,0.0,499.0,499.0
101091041.0,17,14,864,7,432,16848506.833333332,174.0,61.71428571428572,7,432,16741934.833333334,174.0,61.71428571428572
101257.0,17,2,762,2,762,0.0,381.0,381.0,0,0,0.0,0.0,0.0
5616365.0,6,5,336,2,134,0.0,68.0,67.0,3,202,1563644.0,70.0,67.33333333333333
1765125.0,6,2,132,1,66,0.0,66.0,66.0,1,66,0.0,66.0,66.0
9203.0,17,4,823,2,163,0.0,89.0,81.5,2,660,0.0,443.0,330.0
10516990.0,6,7,478,4,272,3460243.0,74.0,68.0,3,206,5190237.5,74.0,68.66666666666667
101893.0,17,2,762,2,762,0.0,381.0,381.0,0,0,0.0,0.0,0.0
207648.0,6,3,426,2,280,0.0,214.0,140.0,1,146,0.0,146.0,146.0
120038742.0,17,28,13364,28,13364,4445879.333333333,501.0,477.2857142857143,0,0,0.0,0.0,0.0
16499.0,6,11,1133,6,602,2878.6,264.0,100.33333333333331,5,531,3305.0,259.0,106.2
35113.0,6,2,145,2,145,0.0,91.0,72.5,0,0,0.0,0.0,0.0
36460.0,6,13,1386,7,789,5711.833333333333,253.0,112.71428571428572,6,597,6556.0,259.0,99.5
208112.0,6,3,426,2,280,0.0,214.0,140.0,1,146,0.0,146.0,146.0
102108665.0,6,41,2706,21,1386,5105433.25,66.0,66.0,20,1320,5210822.7894736845,66.0,66.0
4537.0,17,2,602,1,72,0.0,72.0,72.0,1,530,0.0,530.0,530.0
238160.0,6,3,337,2,214,0.0,160.0,107.0,1,123,0.0,123.0,123.0
102683.0,17,2,762,2,762,0.0,381.0,381.0,0,0,0.0,0.0,0.0
100550983.0,17,12,778,6,389,20000883.4,174.0,64.83333333333333,6,389,20000182.8,174.0,64.83333333333333
3168325.0,6,18,1577,9,1003,358200.0,315.0,111.44444444444444,9,574,358173.875,78.0,63.77777777777778
9067.0,17,2,539,1,86,0.0,86.0,86.0,1,453,0.0,453.0,453.0
215385.0,17,2,180,1,90,0.0,90.0,90.0,1,90,0.0,90.0,90.0
17906.0,6,10,2032,5,524,3590.75,252.0,104.8,5,1508,4163.0,1236.0,301.6
196807.0,17,2,180,1,90,0.0,90.0,90.0,1,90,0.0,90.0,90.0
390768.0,6,3,204,1,68,0.0,68.0,68.0,2,136,0.0,70.0,68.0
33079.0,6,10,2032,5,524,6253.25,252.0,104.8,5,1508,7642.25,1236.0,301.6
218.0,17,2,158,2,158,0.0,79.0,79.0,0,0,0.0,0.0,0.0
234029.0,6,3,373,2,238,0.0,172.0,119.0,1,135,0.0,135.0,135.0
32065.000000000004,6,12,1413,7,882,5344.166666666667,291.0,126.0,5,531,6777.25,259.0,106.2
97326304.0,6,172,19632,86,13722,1142484.2117647058,300.0,159.5581395348837,86,5910,1142484.482352941,140.0,68.72093023255815
3004987.0,6,12,2172,7,664,500731.6666666667,252.0,94.85714285714286,5,1508,1772.25,1236.0,301.6
798.0,17,5,550,5,550,199.5,110.0,110.0,0,0,0.0,0.0,0.0
140301.0,6,2,132,1,66,0.0,66.0,66.0,1,66,0.0,66.0,66.0
2780684.0,6,2,132,1,66,0.0,66.0,66.0,1,66,0.0,66.0,66.0
10461761.0,6,6,412,3,206,5162860.5,74.0,68.66666666666667,3,206,5162763.0,74.0,68.66666666666667
153375.0,17,2,180,1,90,0.0,90.0,90.0,1,90,0.0,90.0,90.0
1302429.0,6,4,264,2,132,0.0,66.0,66.0,2,132,0.0,66.0,66.0
90027471.0,17,28,13364,28,13364,3334350.777777778,501.0,477.2857142857143,0,0,0.0,0.0,0.0
2336.0,17,4,344,2,150,0.0,75.0,75.0,2,194,0.0,103.0,97.0
41197.0,6,10,2032,5,524,9575.75,252.0,104.8,5,1508,9926.25,1236.0,301.6
323938.0,6,5,337,2,163,0.0,97.0,81.5,3,174,161969.0,66.0,58.0
1027082.0,6,11,1134,6,558,205416.4,220.0,93.0,5,576,255413.0,304.0,115.2
316009.0,17,4,1400,4,1400,105336.33333333331,350.0,350.0,0,0,0.0,0.0,0.0
318.0,17,2,174,1,79,0.0,79.0,79.0,1,95,0.0,95.0,95.0
298414.0,6,6,412,4,272,99471.33333333331,74.0,68.0,2,140,0.0,74.0,70.0
381963.0,17,2,363,1,75,0.0,75.0,75.0,1,288,0.0,288.0,288.0
10426982.0,6,7,478,4,272,3429926.333333333,74.0,68.0,3,206,5144783.0,74.0,68.66666666666667
107374.0,17,2,286,2,286,0.0,143.0,143.0,0,0,0.0,0.0,0.0
121303.0,6,3,337,2,214,0.0,160.0,107.0,1,123,0.0,123.0,123.0
20083.0,17,2,582,1,83,0.0,83.0,83.0,1,499,0.0,499.0,499.0
143956.0,17,2,180,1,90,0.0,90.0,90.0,1,90,0.0,90.0,90.0
59169.0,6,14,4740,7,653,9045.833333333334,249.0,93.28571428571428,7,4087,9361.0,1514.0,583.8571428571429
200385.0,17,4,6056,4,6056,66795.0,1514.0,1514.0,0,0,0.0,0.0,0.0
90023794.0,17,28,13364,28,13364,3334214.592592593,501.0,477.2857142857143,0,0,0.0,0.0,0.0
147024.0,6,3,373,2,238,0.0,172.0,119.0,1,135,0.0,135.0,135.0
146376.0,6,3,337,2,214,0.0,160.0,107.0,1,123,0.0,123.0,123.0
114322090.0,6,217,24378,109,7416,1058537.8703703703,140.0,68.03669724770643,108,16962,1066359.6355140186,284.0,157.05555555555554
9826.0,17,4,823,2,163,0.0,89.0,81.5,2,660,0.0,443.0,330.0
2376.0,17,4,344,2,150,0.0,75.0,75.0,2,194,0.0,103.0,97.0
1307046.0,6,4,264,2,132,0.0,66.0,66.0,2,132,0.0,66.0,66.0
31585.000000000004,6,14,4740,7,653,4939.666666666667,249.0,93.28571428571428,7,4087,5046.333333333333,1514.0,583.8571428571429
143903.0,17,2,180,1,90,0.0,90.0,90.0,1,90,0.0,90.0,90.0
312207.0,17,4,1400,4,1400,104069.0,350.0,350.0,0,0,0.0,0.0,0.0
128950293.0,17,14,864,7,432,18166864.0,174.0,61.71428571428572,7,432,18167613.5,174.0,61.71428571428572
101470759.0,17,14,1126,7,563,16833947.5,174.0,80.42857142857143,7,563,16833500.5,174.0,80.42857142857143
4476.0,17,2,614,1,72,0.0,72.0,72.0,1,542,0.0,542.0,542.0
236434.0,6,10,1221,6,636,47286.8,298.0,106.0,4,585,76517.33333333333,379.0,146.25
111173378.0,6,241,27530,121,8208,926444.8166666668,140.0,67.83471074380165,120,19322,930083.3109243696,284.0,161.01666666666668
1164651.0,6,13,3003,8,2375,166378.7142857143,1514.0,296.875,5,628,222194.25,331.0,125.6
1446.0,17,5,550,5,550,361.5,110.0,110.0,0,0,0.0,0.0,0.0
35972.0,6,14,4740,7,653,5139.5,249.0,93.28571428571428,7,4087,5736.333333333333,1514.0,583.8571428571429
2009.0,17,4,344,2,150,0.0,75.0,75.0,2,194,0.0,103.0,97.0
90230099.0,6,16,1192,8,596,12853826.714285716,95.0,74.5,8,596,12859274.142857144,95.0,74.5
358.0,17,2,174,1,79,0.0,79.0,79.0,1,95,0.0,95.0,95.0
90018629.0,17,28,13364,28,13364,3334023.296296296,501.0,477.2857142857143,0,0,0.0,0.0,0.0
117537893.0,6,224,25312,112,17624,1056961.6036036036,284.0,157.35714285714286,112,7688,1056961.7207207207,140.0,68.64285714285714
46850.0,6,14,4740,7,653,7685.833333333333,249.0,93.28571428571428,7,4087,7031.5,1514.0,583.8571428571429
293907.0,6,3,337,2,214,0.0,160.0,107.0,1,123,0.0,123.0,123.0
108108964.0,17,5,955,5,955,27027241.0,191.0,191.0,0,0,0.0,0.0,0.0
39625.0,6,14,4740,7,653,6439.5,249.0,93.28571428571428,7,4087,6081.0,1514.0,583.8571428571429
218242.0,17,2,180,1,90,0.0,90.0,90.0,1,90,0.0,90.0,90.0
1454.0,6,2,177,1,123,0.0,123.0,123.0,1,54,0.0,54.0,54.0
91902018.0,17,16,5472,16,5472,6126801.2,342.0,342.0,0,0,0.0,0.0,0.0
14707949.0,6,38,13384,23,9052,668543.1363636364,1514.0,393.5652173913044,15,4332,1028524.5714285716,1514.0,288.8
6325.0,17,4,344,2,150,0.0,75.0,75.0,2,194,0.0,103.0,97.0
228234.0,17,2,180,1,90,0.0,90.0,90.0,1,90,0.0,90.0,90.0
45724577.0,17,6,540,3,270,22790357.5,90.0,90.0,3,270,22790294.0,90.0,90.0
205654.0,17,2,180,1,90,0.0,90.0,90.0,1,90,0.0,90.0,90.0
310420.0,17,4,1400,4,1400,103473.33333333331,350.0,350.0,0,0,0.0,0.0,0.0
103656.0,17,2,286,2,286,0.0,143.0,143.0,0,0,0.0,0.0,0.0
494521.0,6,5,336,2,134,0.0,68.0,67.0,3,202,195295.5,70.0,67.33333333333333
2429.0,17,4,344,2,150,0.0,75.0,75.0,2,194,0.0,103.0,97.0
9496.0,17,2,539,1,86,0.0,86.0,86.0,1,453,0.0,453.0,453.0
38841.0,6,11,1132,6,556,7387.6,218.0,92.66666666666669,5,576,2539.5,304.0,115.2
31770.0,6,14,4740,7,653,5111.666666666667,249.0,93.28571428571428,7,4087,4837.0,1514.0,583.8571428571429
143912.0,17,2,180,1,90,0.0,90.0,90.0,1,90,0.0,90.0,90.0
4588.0,17,2,618,1,72,0.0,72.0,72.0,1,546,0.0,546.0,546.0
90861543.0,6,21,1585,10,786,10095727.0,95.0,78.6,11,799,9056999.4,95.0,72.63636363636364
201838.0,17,4,6056,4,6056,67279.33333333333,1514.0,1514.0,0,0,0.0,0.0,0.0
162394.0,17,2,180,1,90,0.0,90.0,90.0,1,90,0.0,90.0,90.0
4476.0,17,2,602,1,72,0.0,72.0,72.0,1,530,0.0,530.0,530.0
0.0,17,1,44,1,44,0.0,44.0,44.0,0,0,0.0,0.0,0.0
121436531.0,17,14,864,7,432,17000164.5,174.0,61.71428571428572,7,432,17001423.666666668,174.0,61.71428571428572
1970.0,17,2,508,2,508,0.0,257.0,254.0,0,0,0.0,0.0,0.0
23237.0,6,10,2032,5,524,4795.0,252.0,104.8,5,1508,5179.75,1236.0,301.6
3159.0,17,2,224,1,76,0.0,76.0,76.0,1,148,0.0,148.0,148.0
77731.0,6,10,2032,5,524,19029.75,252.0,104.8,5,1508,18725.25,1236.0,301.6
120125181.0,6,14,2240,6,1224,24025036.2,204.0,204.0,8,1016,17098402.85714286,188.0,127.0
35329.0,6,14,4740,7,653,4695.666666666667,249.0,93.28571428571428,7,4087,4774.666666666667,1514.0,583.8571428571429
143223.0,6,2,132,1,66,0.0,66.0,66.0,1,66,0.0,66.0,66.0
2651797.0,6,25,7573,14,3735,203984.38461538465,1514.0,266.7857142857143,11,3838,239485.0,1514.0,348.90909090909093
228364.0,17,2,180,1,90,0.0,90.0,90.0,1,90,0.0,90.0,90.0
2590706.0,6,2,132,1,66,0.0,66.0,66.0,1,66,0.0,66.0,66.0
28581.0,6,14,4740,7,653,3356.0,249.0,93.28571428571428,7,4087,4344.0,1514.0,583.8571428571429
196902.0,17,2,180,1,90,0.0,90.0,90.0,1,90,0.0,90.0,90.0
207057.0,17,4,6056,4,6056,69019.0,1514.0,1514.0,0,0,0.0,0.0,0.0
1303362.0,6,4,264,2,132,0.0,66.0,66.0,2,132,0.0,66.0,66.0
263217.0,6,3,337,2,214,0.0,160.0,107.0,1,123,0.0,123.0,123.0
30816.0,6,14,4740,7,653,5005.666666666667,249.0,93.28571428571428,7,4087,4954.5,1514.0,583.8571428571429
216372.0,17,2,180,1,90,0.0,90.0,90.0,1,90,0.0,90.0,90.0
100297923.0,17,12,778,6,389,19979851.2,174.0,64.83333333333333,6,389,20027813.2,174.0,64.83333333333333
307091.0,6,6,412,4,272,102363.66666666669,74.0,68.0,2,140,0.0,74.0,70.0
299401.0,17,4,1400,4,1400,99800.33333333331,350.0,350.0,0,0,0.0,0.0,0.0
864234.0,6,10,1262,6,725,172846.8,387.0,120.83333333333331,4,537,197179.0,331.0,134.25
15044781.0,17,6,2718,6,2718,3008956.2,453.0,453.0,0,0,0.0,0.0,0.0
41734.0,6,10,2032,5,524,10031.25,252.0,104.8,5,1508,9709.5,1236.0,301.6
108106259.0,17,5,955,5,955,27026564.75,191.0,191.0,0,0,0.0,0.0,0.0
450.0,17,2,508,2,508,0.0,257.0,254.0,0,0,0.0,0.0,0.0
32681482.000000004,6,5,336,2,134,0.0,68.0,67.0,3,202,14950333.5,70.0,67.33333333333333
108220150.0,6,199,22380,100,6896,1093132.8282828282,140.0,68.96,99,15484,1095359.3469387756,284.0,156.40404040404042
3005360.0,6,12,2172,7,664,500831.5,252.0,94.85714285714286,5,1508,2039.25,1236.0,301.6
329.0,17,2,160,1,80,0.0,80.0,80.0,1,80,0.0,80.0,80.0
233197.0,6,3,337,2,214,0.0,160.0,107.0,1,123,0.0,123.0,123.0
16399.0,6,20,7606,11,978,1639.9,310.0,88.9090909090909,9,6628,1702.875,1514.0,736.4444444444445
1178002.0,6,13,3010,8,2382,168286.0,1514.0,297.75,5,628,225684.0,331.0,125.6
175531.0,6,10,2032,5,524,41248.5,252.0,104.8,5,1508,38877.0,1236.0,301.6
1977.0,17,4,344,2,150,0.0,75.0,75.0,2,194,0.0,103.0,97.0
330.0,17,2,166,1,75,0.0,75.0,75.0,1,91,0.0,91.0,91.0
90010292.0,6,18,1341,10,745,10001143.555555556,95.0,74.5,8,596,12788200.0,95.0,74.5
4352.0,17,4,344,2,150,0.0,75.0,75.0,2,194,0.0,103.0,97.0
3354649.0,6,7,923,4,753,1049401.3333333333,571.0,188.25,3,170,1574426.0,62.0,56.66666666666666
24085.0,6,10,2032,5,524,5810.5,252.0,104.8,5,1508,5630.25,1236.0,301.6
217632.0,17,2,180,1,90,0.0,90.0,90.0,1,90,0.0,90.0,90.0
216200.0,6,12,1373,7,714,36033.333333333336,298.0,102.0,5,659,53015.0,379.0,131.8
1405937.0,17,7,490,7,490,234322.8333333333,70.0,70.0,0,0,0.0,0.0,0.0
362874.0,6,11,1021,6,444,48898.8,162.0,74.0,5,577,60724.5,349.0,115.4
32819.0,6,10,2032,5,524,7991.25,252.0,104.8,5,1508,7965.75,1236.0,301.6
213232.0,6,10,1221,6,636,42646.4,298.0,106.0,4,585,69343.0,379.0,146.25
104906.0,17,2,286,2,286,0.0,143.0,143.0,0,0,0.0,0.0,0.0
4178.0,17,2,610,1,72,0.0,72.0,72.0,1,538,0.0,538.0,538.0
151408.0,17,2,180,1,90,0.0,90.0,90.0,1,90,0.0,90.0,90.0
90087235.0,6,15,2180,7,1164,15014146.166666666,204.0,166.28571428571428,8,1016,12869266.142857144,188.0,127.0
214265.0,6,10,1221,6,636,42853.0,298.0,106.0,4,585,68823.66666666667,379.0,146.25
252214.0,6,3,373,2,238,0.0,172.0,119.0,1,135,0.0,135.0,135.0
27107243.0,17,5,1710,5,1710,6776810.75,342.0,342.0,0,0,0.0,0.0,0.0
873040.0,6,9,1096,6,625,174608.0,287.0,104.16666666666669,3,471,298687.0,331.0,157.0
263050.0,6,3,373,2,238,0.0,172.0,119.0,1,135,0.0,135.0,135.0
108109130.0,17,5,1005,5,1005,27027282.5,201.0,201.0,0,0,0.0,0.0,0.0
104075.0,17,2,700,2,700,0.0,350.0,350.0,0,0,0.0,0.0,0.0
146198.0,6,3,337,2,214,0.0,160.0,107.0,1,123,0.0,123.0,123.0
90008217.0,17,27,12943,27,12943,3461854.5,501.0,479.3703703703704,0,0,0.0,0.0,0.0
16891.0,17,2,180,1,90,0.0,90.0,90.0,1,90,0.0,90.0,90.0
94375114.0,6,32,2628,18,1458,5551477.294117647,123.0,81.0,14,1170,7242982.0,123.0,83.57142857142857
72420.0,17,2,876,2,876,0.0,438.0,438.0,0,0,0.0,0.0,0.0
2948643.0,6,8,977,5,807,688378.0,571.0,161.4,3,170,1366144.0,62.0,56.66666666666666
204834.0,17,2,762,2,762,0.0,381.0,381.0,0,0,0.0,0.0,0.0
300360.0,6,6,412,4,272,100120.0,74.0,68.0,2,140,0.0,74.0,70.0
298175.0,6,6,412,4,272,99391.66666666669,74.0,68.0,2,140,0.0,74.0,70.0
240010.0,6,3,337,2,214,0.0,160.0,107.0,1,123,0.0,123.0,123.0
1022784.0,6,12,1354,6,723,203985.6,253.0,120.5,6,631,204241.8,293.0,105.16666666666669
747823.0,6,2,132,1,66,0.0,66.0,66.0,1,66,0.0,66.0,66.0
2014.0,17,4,344,2,150,0.0,75.0,75.0,2,194,0.0,103.0,97.0
116367250.0,6,48,3168,24,1584,5059445.652173913,66.0,66.0,24,1584,5045774.565217392,66.0,66.0
90776680.0,6,20,1531,11,840,9073043.9,95.0,76.36363636363636,9,691,11346144.0,95.0,76.77777777777777
99077868.0,17,12,778,6,389,19815573.6,174.0,64.83333333333333,6,389,19751325.6,174.0,64.83333333333333
10469084.0,6,7,478,4,272,3443972.0,74.0,68.0,3,206,5165850.5,74.0,68.66666666666667
39426.0,6,14,4740,7,653,6297.166666666667,249.0,93.28571428571428,7,4087,6387.0,1514.0,583.8571428571429
349559.0,17,2,582,1,83,0.0,83.0,83.0,1,499,0.0,499.0,499.0
3131.0,17,4,344,2,150,0.0,75.0,75.0,2,194,0.0,103.0,97.0
108092897.0,17,5,1005,5,1005,27023224.25,201.0,201.0,0,0,0.0,0.0,0.0
90273565.0,6,12,1832,8,1016,12896223.57142857,188.0,127.0,4,816,30036180.33333333,204.0,204.0
90329772.0,6,21,1585,11,840,9025545.3,95.0,76.36363636363636,10,745,10003781.444444444,95.0,74.5
288127.0,6,22,11516,12,954,26193.36363636364,220.0,79.5,10,10562,31577.11111111111,1514.0,1056.2
307397.0,6,6,412,4,272,102465.66666666669,74.0,68.0,2,140,0.0,74.0,70.0
2784148.0,6,2,132,1,66,0.0,66.0,66.0,1,66,0.0,66.0,66.0
9690.0,17,2,582,1,83,0.0,83.0,83.0,1,499,0.0,499.0,499.0
45121.0,6,14,4740,7,653,7035.833333333333,249.0,93.28571428571428,7,4087,7329.0,1514.0,583.8571428571429
105164347.0,6,28,1860,14,966,8072972.230769231,123.0,69.0,14,894,8072971.923076923,123.0,63.85714285714285
135135113.0,17,6,1146,6,1146,27027022.6,191.0,191.0,0,0,0.0,0.0,0.0
27471.0,6,10,2032,5,524,6645.25,252.0,104.8,5,1508,5983.5,1236.0,301.6
228311.0,17,2,180,1,90,0.0,90.0,90.0,1,90,0.0,90.0,90.0
196820.0,17,2,180,1,90,0.0,90.0,90.0,1,90,0.0,90.0,90.0
10471999.0,6,7,478,4,272,3443785.0,74.0,68.0,3,206,5165572.5,74.0,68.66666666666667
119844079.0,17,35,16705,35,16705,3524825.8529411764,501.0,477.2857142857143,0,0,0.0,0.0,0.0
25345.0,6,20,7606,11,978,2534.5,310.0,88.9090909090909,9,6628,2602.875,1514.0,736.4444444444445
135134553.0,17,6,1146,6,1146,27026910.6,191.0,191.0,0,0,0.0,0.0,0.0
209680.0,17,2,180,1,90,0.0,90.0,90.0,1,90,0.0,90.0,90.0
10920337.0,6,8,544,4,272,3594586.0,74.0,68.0,4,272,3594522.6666666665,74.0,68.0
206385.0,6,3,426,2,280,0.0,214.0,140.0,1,146,0.0,146.0,146.0
120003916.0,6,22,1878,11,799,11999987.2,95.0,72.63636363636364,11,1079,11999181.1,338.0,98.0909090909091
275297.0,17,2,238,1,74,0.0,74.0,74.0,1,164,0.0,164.0,164.0
206765.0,6,3,426,2,280,0.0,214.0,140.0,1,146,0.0,146.0,146.0
2024.0,17,4,344,2,150,0.0,75.0,75.0,2,194,0.0,103.0,97.0
14707.0,6,14,4740,7,653,2125.0,249.0,93.28571428571428,7,4087,2309.333333333333,1514.0,583.8571428571429
79.0,17,2,762,2,762,0.0,381.0,381.0,0,0,0.0,0.0,0.0
297685.0,6,6,412,4,272,99228.33333333331,74.0,68.0,2,140,0.0,74.0,70.0
209747.0,6,3,426,2,280,0.0,214.0,140.0,1,146,0.0,146.0,146.0
216281.0,17,2,180,1,90,0.0,90.0,90.0,1,90,0.0,90.0,90.0
217842.0,6,3,426,2,280,0.0,214.0,140.0,1,146,0.0,146.0,146.0
21764.0,6,14,4740,7,653,2683.6666666666665,249.0,93.28571428571428,7,4087,3403.5,1514.0,583.8571428571429
316731.0,17,4,704,2,148,0.0,74.0,74.0,2,556,0.0,280.0,278.0
286381.0,17,2,363,1,79,0.0,79.0,79.0,1,284,0.0,284.0,284.0
2346064.0,6,25,7573,14,3735,180466.4615384616,1514.0,266.7857142857143,11,3838,208006.9,1514.0,348.90909090909093
28166.0,6,14,4740,7,653,3975.1666666666665,249.0,93.28571428571428,7,4087,4435.666666666667,1514.0,583.8571428571429
120171783.0,6,401,49298,201,35802,600858.915,390.0,178.11940298507463,200,13496,599856.6834170854,140.0,67.48
0.0,17,1,453,1,453,0.0,453.0,453.0,0,0,0.0,0.0,0.0
206091.0,6,3,426,2,280,0.0,214.0,140.0,1,146,0.0,146.0,146.0
80.0,17,2,762,2,762,0.0,381.0,381.0,0,0,0.0,0.0,0.0
205796.0,17,2,180,1,90,0.0,90.0,90.0,1,90,0.0,90.0,90.0
108108832.0,17,5,1005,5,1005,27027208.0,201.0,201.0,0,0,0.0,0.0,0.0
94216642.0,6,28,1876,14,982,7230814.692307692,139.0,70.14285714285714,14,894,7230816.846153846,123.0,63.85714285714285
108108592.0,17,5,955,5,955,27027148.0,191.0,191.0,0,0,0.0,0.0,0.0
233205.0,6,3,337,2,214,0.0,160.0,107.0,1,123,0.0,123.0,123.0
46509.0,6,14,4740,7,653,7621.666666666667,249.0,93.28571428571428,7,4087,6790.5,1514.0,583.8571428571429
104311918.0,17,14,864,7,432,17333990.0,174.0,61.71428571428572,7,432,17333502.166666668,174.0,61.71428571428572
90068413.0,17,28,13364,28,13364,3335867.1481481483,501.0,477.2857142857143,0,0,0.0,0.0,0.0
15161.0,17,2,180,1,90,0.0,90.0,90.0,1,90,0.0,90.0,90.0
120152720.0,6,218,24678,109,7416,1105987.6296296297,140.0,68.03669724770643,109,17262,1111748.4074074074,284.0,158.36697247706422
277377.0,17,4,1400,4,1400,92459.0,350.0,350.0,0,0,0.0,0.0,0.0
90260066.0,6,13,2036,8,1016,12894295.142857144,188.0,127.0,5,1020,22523727.5,204.0,204.0
347010.0,6,3,204,2,136,0.0,70.0,68.0,1,68,0.0,68.0,68.0
119462284.0,6,329,37732,165,26612,728428.5609756098,284.0,161.28484848484848,164,11120,731517.5889570552,140.0,67.8048780487805
120318626.0,6,554,70768,277,18578,432954.09420289856,140.0,67.06859205776173,277,52190,435022.30797101447,336.0,188.4115523465704
58067.0,6,10,2032,5,524,13694.75,252.0,104.8,5,1508,13785.5,1236.0,301.6
19071.0,6,11,2098,6,590,3277.8,252.0,98.33333333333331,5,1508,4531.25,1236.0,301.6
135132890.0,17,6,1146,6,1146,27026578.0,191.0,191.0,0,0,0.0,0.0,0.0
95481304.0,17,15,5138,14,4788,5731611.461538462,342.0,342.0,1,350,0.0,350.0,350.0
90256512.0,6,12,1832,8,1016,12893787.42857143,188.0,127.0,4,816,30030526.666666668,204.0,204.0
70208.0,6,14,4740,7,653,11443.0,249.0,93.28571428571428,7,4087,10158.833333333334,1514.0,583.8571428571429
2574706.0,6,28,9195,16,3843,171647.06666666668,1514.0,240.1875,12,5352,210819.54545454544,1514.0,446.0
196745.0,17,2,180,1,90,0.0,90.0,90.0,1,90,0.0,90.0,90.0
69472.0,6,14,4740,7,653,9252.333333333334,249.0,93.28571428571428,7,4087,10757.666666666666,1514.0,583.8571428571429
243454.0,17,4,1400,4,1400,81151.33333333333,350.0,350.0,0,0,0.0,0.0,0.0
108876702.0,6,44,2904,22,1452,5184604.857142857,66.0,66.0,22,1452,5171628.142857143,66.0,66.0
73856.0,6,11,2098,6,590,14508.4,252.0,98.33333333333331,5,1508,18136.75,1236.0,301.6
212354.0,6,10,1221,6,636,42470.8,298.0,106.0,4,585,69289.33333333333,379.0,146.25
216372.0,6,12,1373,7,714,36062.0,298.0,102.0,5,659,53137.75,379.0,131.8
17316.0,6,14,4740,7,653,2735.333333333333,249.0,93.28571428571428,7,4087,2748.333333333333,1514.0,583.8571428571429
59741.0,6,14,4740,7,653,8569.333333333334,249.0,93.28571428571428,7,4087,9697.0,1514.0,583.8571428571429
123305602.0,6,48,3168,24,1584,5141977.478260869,66.0,66.0,24,1584,5154774.782608695,66.0,66.0
1304463.0,6,4,264,2,132,0.0,66.0,66.0,2,132,0.0,66.0,66.0
108114629.0,17,5,1005,5,1005,27028657.25,201.0,201.0,0,0,0.0,0.0,0.0
122301.0,6,3,337,2,214,0.0,160.0,107.0,1,123,0.0,123.0,123.0
316445.0,17,4,1400,4,1400,105481.66666666669,350.0,350.0,0,0,0.0,0.0,0.0
92880075.0,6,38,2508,19,1254,5159990.111111111,66.0,66.0,19,1254,5159989.833333333,66.0,66.0
2332.0,17,4,344,2,150,0.0,75.0,75.0,2,194,0.0,103.0,97.0
143991.0,17,2,180,1,90,0.0,90.0,90.0,1,90,0.0,90.0,90.0
48278.0,6,10,2032,5,524,11852.75,252.0,104.8,5,1508,9591.5,1236.0,301.6
317507.0,17,4,1400,4,1400,105835.66666666669,350.0,350.0,0,0,0.0,0.0,0.0
135094886.0,17,6,1146,6,1146,27018977.2,191.0,191.0,0,0,0.0,0.0,0.0
90017099.0,17,28,13364,28,13364,3333966.6296296297,501.0,477.2857142857143,0,0,0.0,0.0,0.0
0.0,6,1,66,1,66,0.0,66.0,66.0,0,0,0.0,0.0,0.0
2468.0,17,4,344,2,150,0.0,75.0,75.0,2,194,0.0,103.0,97.0
90295750.0,6,16,2368,9,1204,11286968.75,188.0,133.77777777777777,7,1164,15021843.0,204.0,166.28571428571428
217904.0,17,2,180,1,90,0.0,90.0,90.0,1,90,0.0,90.0,90.0
78904.0,6,12,1320,6,723,15404.2,253.0,120.5,6,597,12627.6,259.0,99.5
108104582.0,17,5,955,5,955,27026145.5,191.0,191.0,0,0,0.0,0.0,0.0
120207748.0,6,228,25756,114,7820,1056509.7610619469,140.0,68.59649122807018,114,17936,1056466.7522123894,284.0,157.33333333333334
33889.0,6,12,1320,6,723,6436.4,253.0,120.5,6,597,5063.0,259.0,99.5
297968.0,6,6,412,4,272,99322.66666666669,74.0,68.0,2,140,0.0,74.0,70.0
143934.0,17,2,180,1,90,0.0,90.0,90.0,1,90,0.0,90.0,90.0
4791.0,17,4,344,2,150,0.0,75.0,75.0,2,194,0.0,103.0,97.0
10457654.0,6,7,478,4,272,3440396.333333333,74.0,68.0,3,206,5160508.0,74.0,68.66666666666667
213610.0,17,2,180,1,90,0.0,90.0,90.0,1,90,0.0,90.0,90.0
147088.0,6,3,373,2,238,0.0,172.0,119.0,1,135,0.0,135.0,135.0
4636.0,17,2,614,1,72,0.0,72.0,72.0,1,542,0.0,542.0,542.0
300000.0,6,6,412,4,272,100000.0,74.0,68.0,2,140,0.0,74.0,70.0
306.0,17,2,168,1,76,0.0,76.0,76.0,1,92,0.0,92.0,92.0
9305.0,6,10,1975,5,467,2097.75,195.0,93.4,5,1508,2039.0,1236.0,301.6
14648230.0,6,20,1607,10,975,1593517.0,315.0,97.5,10,632,1593485.0,78.0,63.2
107223.0,17,2,286,2,286,0.0,143.0,143.0,0,0,0.0,0.0,0.0
857029.0,6,9,1268,6,797,171405.8,459.0,132.83333333333334,3,471,290824.5,331.0,157.0
24465.0,6,10,2032,5,524,5905.25,252.0,104.8,5,1508,5357.25,1236.0,301.6
308485.0,6,6,412,4,272,102828.33333333331,74.0,68.0,2,140,0.0,74.0,70.0
0.0,6,1,172,1,172,0.0,172.0,172.0,0,0,0.0,0.0,0.0
50776.0,17,2,180,1,90,0.0,90.0,90.0,1,90,0.0,90.0,90.0
5628429.0,6,5,336,2,134,0.0,68.0,67.0,3,202,1527452.5,70.0,67.33333333333333
209493.0,17,2,180,1,90,0.0,90.0,90.0,1,90,0.0,90.0,90.0
103989.0,17,2,286,2,286,0.0,143.0,143.0,0,0,0.0,0.0,0.0
90286629.0,6,19,1436,10,745,10026108.333333334,95.0,74.5,9,691,11284495.0,95.0,76.77777777777777
120171250.0,6,805,122808,405,96038,296920.2103960396,1514.0,237.13086419753083,400,26770,300641.35839599,214.0,66.925
96971438.0,6,27,1954,14,1045,7459341.384615385,139.0,74.64285714285714,13,909,7230932.416666667,123.0,69.92307692307692
331.0,17,2,160,1,80,0.0,80.0,80.0,1,80,0.0,80.0,80.0
296.0,17,2,156,1,78,0.0,78.0,78.0,1,78,0.0,78.0,78.0
33889.0,17,2,582,1,83,0.0,83.0,83.0,1,499,0.0,499.0,499.0
207092.0,6,3,426,2,280,0.0,214.0,140.0,1,146,0.0,146.0,146.0
282444.0,17,2,180,1,90,0.0,90.0,90.0,1,90,0.0,90.0,90.0
120124102.0,6,14,2224,9,1204,15015512.75,188.0,133.77777777777777,5,1020,22523070.0,204.0,204.0
120009518.0,6,18,1341,9,691,14999993.375,95.0,76.77777777777777,9,650,14999544.875,95.0,72.22222222222223
354954.0,6,5,336,2,134,0.0,68.0,67.0,3,202,158282.0,70.0,67.33333333333333
206558.0,6,3,426,2,280,0.0,214.0,140.0,1,146,0.0,146.0,146.0
120105735.0,6,13,2020,9,1204,15013216.875,188.0,133.77777777777777,4,816,30023563.666666668,204.0,204.0
130568.0,6,12,1328,6,731,24659.4,253.0,121.83333333333331,6,597,25654.2,259.0,99.5
330.0,17,2,166,1,75,0.0,75.0,75.0,1,91,0.0,91.0,91.0
102503023.0,17,14,864,7,432,17000951.0,174.0,61.71428571428572,7,432,17000162.333333332,174.0,61.71428571428572
141387.0,17,4,704,2,148,0.0,74.0,74.0,2,556,0.0,280.0,278.0
104383.0,17,2,286,2,286,0.0,143.0,143.0,0,0,0.0,0.0,0.0
3065758.0,6,163,124357,88,114765,35238.597701149425,1510.0,1304.1477272727273,75,9592,37206.89189189189,1510.0,127.89333333333332
2797616.0,6,2,132,1,66,0.0,66.0,66.0,1,66,0.0,66.0,66.0
291415.0,17,2,246,1,76,0.0,76.0,76.0,1,170,0.0,170.0,170.0
50808.0,6,14,4740,7,653,7754.333333333333,249.0,93.28571428571428,7,4087,8332.0,1514.0,583.8571428571429
220801.0,6,3,426,2,280,0.0,214.0,140.0,1,146,0.0,146.0,146.0
371.0,17,2,267,1,83,0.0,83.0,83.0,1,184,0.0,184.0,184.0
16219.0,6,10,2032,5,524,3812.5,252.0,104.8,5,1508,3481.5,1236.0,301.6
117490802.0,6,224,25216,112,17602,1056536.4684684684,284.0,157.16071428571428,112,7614,1056536.4774774774,140.0,67.98214285714286
113219391.0,6,201,22894,101,6962,1132193.91,140.0,68.93069306930693,100,15932,1133196.2222222222,336.0,159.32
33387.0,6,11,2098,6,590,6376.6,252.0,98.33333333333331,5,1508,6348.5,1236.0,301.6
302412.0,6,2,132,1,66,0.0,66.0,66.0,1,66,0.0,66.0,66.0
308614.0,6,3,202,2,128,0.0,74.0,64.0,1,74,0.0,74.0,74.0
326362.0,6,5,367,2,132,0.0,66.0,66.0,3,235,163181.0,103.0,78.33333333333333
0.0,17,1,55,1,55,0.0,55.0,55.0,0,0,0.0,0.0,0.0
3004257.0,6,12,2172,7,664,500521.6666666667,252.0,94.85714285714286,5,1508,2086.5,1236.0,301.6
232855.0,6,3,337,2,214,0.0,160.0,107.0,1,123,0.0,123.0,123.0
2482.0,17,2,762,2,762,0.0,381.0,381.0,0,0,0.0,0.0,0.0
49696.0,6,14,4740,7,653,8161.0,249.0,93.28571428571428,7,4087,8015.0,1514.0,583.8571428571429
47821.0,6,10,2032,5,524,11667.75,252.0,104.8,5,1508,9952.0,1236.0,301.6
123839597.0,6,48,3168,24,1584,5055718.0869565215,66.0,66.0,24,1584,5241714.0869565215,66.0,66.0
90939070.0,6,21,1585,11,840,9093671.5,95.0,76.36363636363636,10,745,10102579.666666666,95.0,74.5
55812.0,6,14,4740,7,653,9180.166666666666,249.0,93.28571428571428,7,4087,9074.666666666666,1514.0,583.8571428571429
90017402.0,17,28,13364,28,13364,3333977.851851852,501.0,477.2857142857143,0,0,0.0,0.0,0.0
881049.0,6,10,1335,6,798,176209.8,460.0,133.0,4,537,201785.66666666663,331.0,134.25
10480583.0,6,7,478,4,272,3446300.333333333,74.0,68.0,3,206,5169197.0,74.0,68.66666666666667
135139944.0,17,6,1146,6,1146,27027988.8,191.0,191.0,0,0,0.0,0.0,0.0
47767.0,6,14,4740,7,653,7792.5,249.0,93.28571428571428,7,4087,7596.333333333333,1514.0,583.8571428571429
146103.0,6,3,337,2,214,0.0,160.0,107.0,1,123,0.0,123.0,123.0
146118.0,6,3,337,2,214,0.0,160.0,107.0,1,123,0.0,123.0,123.0
233424.0,6,3,337,2,214,0.0,160.0,107.0,1,123,0.0,123.0,123.0
121191487.0,6,220,24884,110,7556,1095824.4770642202,140.0,68.69090909090909,110,17328,1105352.1651376146,284.0,157.52727272727273
99989.0,17,3,1143,3,1143,49994.5,381.0,381.0,0,0,0.0,0.0,0.0
2020103.0,17,4,525,2,150,0.0,75.0,75.0,2,375,0.0,284.0,187.5
28103.0,6,10,2032,5,524,6806.25,252.0,104.8,5,1508,6099.0,1236.0,301.6
98439964.0,6,30,2106,15,1089,7031426.0,123.0,72.6,15,1017,7015979.0,123.0,67.8
90296375.0,6,16,1192,8,596,12893766.57142857,95.0,74.5,8,596,12897483.714285716,95.0,74.5
135132976.0,17,6,1146,6,1146,27026595.2,191.0,191.0,0,0,0.0,0.0,0.0
110379.0,17,4,1400,4,1400,36793.0,350.0,350.0,0,0,0.0,0.0,0.0
2220.0,17,4,344,2,150,0.0,75.0,75.0,2,194,0.0,103.0,97.0
90009336.0,17,28,13364,28,13364,3333679.111111111,501.0,477.2857142857143,0,0,0.0,0.0,0.0
120249419.0,6,222,25106,111,7548,1086812.1545454543,140.0,68.0,111,17558,1085682.8636363635,284.0,158.18018018018017
87744.0,6,14,4740,7,653,13003.5,249.0,93.28571428571428,7,4087,13791.166666666666,1514.0,583.8571428571429
56214.0,6,14,4740,7,653,8477.666666666666,249.0,93.28571428571428,7,4087,9209.666666666666,1514.0,583.8571428571429
312282.0,6,6,412,4,272,104094.0,74.0,68.0,2,140,0.0,74.0,70.0
115297052.0,17,14,864,7,432,19168191.666666668,174.0,61.71428571428572,7,432,19166830.166666668,174.0,61.71428571428572
43144.0,6,10,2032,5,524,8084.0,252.0,104.8,5,1508,10435.5,1236.0,301.6
143969.0,17,2,180,1,90,0.0,90.0,90.0,1,90,0.0,90.0,90.0
19740.0,6,10,2032,5,524,4056.25,252.0,104.8,5,1508,4681.0,1236.0,301.6
139904.0,6,2,132,1,66,0.0,66.0,66.0,1,66,0.0,66.0,66.0
239252.0,17,2,180,1,90,0.0,90.0,90.0,1,90,0.0,90.0,90.0
13071.0,6,10,1067,5,536,3105.0,264.0,107.2,5,531,2819.75,259.0,106.2
421986.0,6,10,1221,6,636,84397.2,298.0,106.0,4,585,139741.33333333334,379.0,146.25
250628.00000000003,6,3,373,2,238,0.0,172.0,119.0,1,135,0.0,135.0,135.0
281295.0,17,2,363,1,79,0.0,79.0,79.0,1,284,0.0,284.0,284.0
74279.0,6,10,2032,5,524,17214.75,252.0,104.8,5,1508,18066.5,1236.0,301.6
372.0,17,2,174,1,79,0.0,79.0,79.0,1,95,0.0,95.0,95.0
199079.0,17,2,180,1,90,0.0,90.0,90.0,1,90,0.0,90.0,90.0
247153.0,17,2,180,1,90,0.0,90.0,90.0,1,90,0.0,90.0,90.0
196909.0,17,2,180,1,90,0.0,90.0,90.0,1,90,0.0,90.0,90.0
36105.0,6,10,2032,5,524,8797.0,252.0,104.8,5,1508,8071.75,1236.0,301.6
104918.0,17,2,286,2,286,0.0,143.0,143.0,0,0,0.0,0.0,0.0
49145.0,6,14,4740,7,653,8056.0,249.0,93.28571428571428,7,4087,7644.666666666667,1514.0,583.8571428571429
90042556.0,17,27,12943,27,12943,3463175.230769231,501.0,479.3703703703704,0,0,0.0,0.0,0.0
296.0,17,2,156,1,78,0.0,78.0,78.0,1,78,0.0,78.0,78.0
501810.0,6,5,336,2,134,0.0,68.0,67.0,3,202,189639.5,70.0,67.33333333333333
4525.0,17,2,224,1,76,0.0,76.0,76.0,1,148,0.0,148.0,148.0
2694506.0,6,25,7573,14,3735,207269.6923076923,1514.0,266.7857142857143,11,3838,243837.5,1514.0,348.90909090909093
219591.0,6,3,426,2,280,0.0,214.0,140.0,1,146,0.0,146.0,146.0
103173.0,17,2,286,2,286,0.0,143.0,143.0,0,0,0.0,0.0,0.0
173364.0,17,4,704,2,148,0.0,74.0,74.0,2,556,0.0,280.0,278.0
37922.0,6,10,2032,5,524,9059.5,252.0,104.8,5,1508,8906.75,1236.0,301.6
98925608.0,6,395,52714,198,13302,502160.4467005076,140.0,67.18181818181819,197,39412,499385.5969387755,464.0,200.0609137055837
102998.0,17,2,286,2,286,0.0,143.0,143.0,0,0,0.0,0.0,0.0
2382.0,17,4,344,2,150,0.0,75.0,75.0,2,194,0.0,103.0,97.0
23245.0,6,10,2032,5,524,4845.5,252.0,104.8,5,1508,5252.0,1236.0,301.6
690.0,17,4,438,2,148,0.0,74.0,74.0,2,290,0.0,147.0,145.0
205904.0,17,2,180,1,90,0.0,90.0,90.0,1,90,0.0,90.0,90.0
316787.0,17,4,1400,4,1400,105595.66666666669,350.0,350.0,0,0,0.0,0.0,0.0
14732.0,6,14,4740,7,653,2345.1666666666665,249.0,93.28571428571428,7,4087,2266.333333333333,1514.0,583.8571428571429
35599.0,6,2,145,2,145,0.0,91.0,72.5,0,0,0.0,0.0,0.0
584224.0,6,4,508,2,238,0.0,172.0,119.0,2,270,0.0,135.0,135.0
35723.0,6,14,4740,7,653,5810.333333333333,249.0,93.28571428571428,7,4087,5064.5,1514.0,583.8571428571429
113520423.0,6,46,3036,23,1518,5160004.090909091,66.0,66.0,23,1518,5160006.545454546,66.0,66.0
198169.0,17,2,180,1,90,0.0,90.0,90.0,1,90,0.0,90.0,90.0
506772.0,6,4,270,2,134,0.0,68.0,67.0,2,136,0.0,70.0,68.0
27104875.0,17,5,1710,5,1710,6776218.75,342.0,342.0,0,0,0.0,0.0,0.0
2484.0,17,4,344,2,150,0.0,75.0,75.0,2,194,0.0,103.0,97.0
120207.0,6,13,1513,7,882,18233.0,291.0,126.0,6,631,23225.0,293.0,105.16666666666669
21599047.0,6,6,1981,4,1087,7199682.333333333,885.0,271.75,2,894,0.0,826.0,447.0
228046.0,17,2,180,1,90,0.0,90.0,90.0,1,90,0.0,90.0,90.0
225686.0,17,2,180,1,90,0.0,90.0,90.0,1,90,0.0,90.0,90.0
120142680.0,6,220,24740,110,7556,1085184.495412844,140.0,68.69090909090909,110,17184,1085328.266055046,284.0,156.21818181818182
115599964.0,6,48,3168,24,1584,5026085.391304348,66.0,66.0,24,1584,5014094.608695652,66.0,66.0
119303273.0,6,273,31404,137,9338,877229.9485294118,140.0,68.16058394160584,136,22066,876129.2444444444,336.0,162.25
2346.0,17,4,344,2,150,0.0,75.0,75.0,2,194,0.0,103.0,97.0
205993.0,17,2,180,1,90,0.0,90.0,90.0,1,90,0.0,90.0,90.0
20999.0,6,14,4740,7,653,2869.833333333333,249.0,93.28571428571428,7,4087,3366.333333333333,1514.0,583.8571428571429
1891.0,17,4,344,2,150,0.0,75.0,75.0,2,194,0.0,103.0,97.0
107198866.0,6,43,2838,22,1452,5104696.142857143,66.0,66.0,21,1386,5168042.2,66.0,66.0
3006421.0,6,12,2172,7,664,500530.8333333333,252.0,94.85714285714286,5,1508,2361.5,1236.0,301.6
253104.0,6,3,337,2,214,0.0,160.0,107.0,1,123,0.0,123.0,123.0
717664.0,6,2,132,1,66,0.0,66.0,66.0,1,66,0.0,66.0,66.0
108101117.0,17,5,1005,5,1005,27025279.25,201.0,201.0,0,0,0.0,0.0,0.0
10518898.0,6,7,478,4,272,3460854.0,74.0,68.0,3,206,5191172.5,74.0,68.66666666666667
89197936.0,6,19,1393,10,794,9910881.777777778,154.0,79.4,9,599,11117728.375,95.0,66.55555555555556
156477.0,6,3,337,2,214,0.0,160.0,107.0,1,123,0.0,123.0,123.0
22127.0,6,10,2032,5,524,4332.25,252.0,104.8,5,1508,5259.75,1236.0,301.6
203195.0,17,2,180,1,90,0.0,90.0,90.0,1,90,0.0,90.0,90.0
113519398.0,6,46,3036,23,1518,5159960.954545454,66.0,66.0,23,1518,5159960.590909091,66.0,66.0
120606.0,6,3,373,2,238,0.0,172.0,119.0,1,135,0.0,135.0,135.0
90210855.0,6,21,1788,9,650,11246824.875,95.0,72.22222222222223,12,1138,8182298.454545454,257.0,94.83333333333331
5638.0,17,4,823,2,163,0.0,89.0,81.5,2,660,0.0,443.0,330.0
19301.0,6,14,4740,7,653,3093.0,249.0,93.28571428571428,7,4087,3079.0,1514.0,583.8571428571429
119954062.0,6,32,2220,16,1071,7996937.466666667,123.0,66.9375,16,1149,7316826.333333333,123.0,71.8125
104771.0,17,2,700,2,700,0.0,350.0,350.0,0,0,0.0,0.0,0.0
307170.0,6,6,412,4,272,102390.0,74.0,68.0,2,140,0.0,74.0,70.0
3050247.0,6,3,204,1,68,0.0,68.0,68.0,2,136,0.0,70.0,68.0
135130700.0,17,6,1146,6,1146,27026140.0,191.0,191.0,0,0,0.0,0.0,0.0
46923.0,6,10,2032,5,524,11511.25,252.0,104.8,5,1508,11174.0,1236.0,301.6
35283.0,6,10,2032,5,524,7599.75,252.0,104.8,5,1508,7825.25,1236.0,301.6
153492.0,17,2,180,1,90,0.0,90.0,90.0,1,90,0.0,90.0,90.0
125811876.0,6,60,12354,30,6464,3314083.103448276,1514.0,215.46666666666667,30,5890,4331279.034482759,1514.0,196.3333333333333
2045.0,17,4,344,2,150,0.0,75.0,75.0,2,194,0.0,103.0,97.0
3051673.0,6,3,204,1,68,0.0,68.0,68.0,2,136,0.0,70.0,68.0
2789600.0,6,2,132,1,66,0.0,66.0,66.0,1,66,0.0,66.0,66.0
2295.0,17,4,344,2,150,0.0,75.0,75.0,2,194,0.0,103.0,97.0
36821.0,6,13,1386,7,789,5760.666666666667,253.0,112.71428571428572,6,597,6769.6,259.0,99.5
10459221.0,6,6,412,3,206,5159656.5,74.0,68.66666666666667,3,206,5159534.0,74.0,68.66666666666667
324.0,17,2,208,1,72,0.0,72.0,72.0,1,136,0.0,136.0,136.0
207154.0,6,3,426,2,280,0.0,214.0,140.0,1,146,0.0,146.0,146.0
6929.0,17,2,582,1,83,0.0,83.0,83.0,1,499,0.0,499.0,499.0
107140.0,17,2,286,2,286,0.0,143.0,143.0,0,0,0.0,0.0,0.0
14617.0,17,4,344,2,150,0.0,75.0,75.0,2,194,0.0,103.0,97.0
55142.0,6,14,4740,7,653,8911.333333333334,249.0,93.28571428571428,7,4087,8801.166666666666,1514.0,583.8571428571429
147223.0,6,3,373,2,238,0.0,172.0,119.0,1,135,0.0,135.0,135.0
88061.0,6,14,4740,7,653,14121.833333333334,249.0,93.28571428571428,7,4087,14467.833333333334,1514.0,583.8571428571429
10480516.0,6,7,478,4,272,3447901.6666666665,74.0,68.0,3,206,5171759.5,74.0,68.66666666666667
107215.0,17,2,286,2,286,0.0,143.0,143.0,0,0,0.0,0.0,0.0
206061.0,6,3,426,2,280,0.0,214.0,140.0,1,146,0.0,146.0,146.0
37906.0,6,14,4740,7,653,6198.5,249.0,93.28571428571428,7,4087,4958.833333333333,1514.0,583.8571428571429
15318.0,6,14,4740,7,653,2367.333333333333,249.0,93.28571428571428,7,4087,2303.0,1514.0,583.8571428571429
90749823.0,6,19,1436,9,691,11343727.875,95.0,76.77777777777777,10,745,10050014.111111112,95.0,74.5
146313.0,6,3,337,2,214,0.0,160.0,107.0,1,123,0.0,123.0,123.0
10482112.0,6,7,478,4,272,3446825.0,74.0,68.0,3,206,5170106.5,74.0,68.66666666666667
1060266.0,6,13,1386,7,789,176711.0,253.0,112.71428571428572,6,597,208104.6,259.0,99.5
104069757.0,6,201,22708,101,6888,1040697.57,140.0,68.1980198019802,100,15820,1040697.7575757576,300.0,158.2
0.0,17,1,72,1,72,0.0,72.0,72.0,0,0,0.0,0.0,0.0
115018128.0,17,15,1431,8,737,16408456.142857144,174.0,92.125,7,694,16834442.166666668,174.0,99.14285714285714
1019288.0,6,11,1134,6,558,203857.6,220.0,93.0,5,576,254400.25,304.0,115.2
347.0,17,2,166,1,75,0.0,75.0,75.0,1,91,0.0,91.0,91.0
204154.0,17,2,762,2,762,0.0,381.0,381.0,0,0,0.0,0.0,0.0
1305974.0,6,4,264,2,132,0.0,66.0,66.0,2,132,0.0,66.0,66.0
143937.0,17,2,180,1,90,0.0,90.0,90.0,1,90,0.0,90.0,90.0
296.0,17,2,156,1,78,0.0,78.0,78.0,1,78,0.0,78.0,78.0
144061.0,17,2,180,1,90,0.0,90.0,90.0,1,90,0.0,90.0,90.0
2409242.0,6,3,1777,2,951,0.0,885.0,475.5,1,826,0.0,826.0,826.0
1813441.0,6,2,132,1,66,0.0,66.0,66.0,1,66,0.0,66.0,66.0
40366.0,6,10,2032,5,524,9740.25,252.0,104.8,5,1508,9798.5,1236.0,301.6
240100.0,6,3,337,2,214,0.0,160.0,107.0,1,123,0.0,123.0,123.0
2323.0,17,4,344,2,150,0.0,75.0,75.0,2,194,0.0,103.0,97.0
102191979.0,6,32,2220,16,1149,6812798.6,123.0,71.8125,16,1071,6798389.266666667,123.0,66.9375
112166412.0,17,16,1474,8,737,16001065.714285716,174.0,92.125,8,737,16001070.0,174.0,92.125
90045067.0,17,28,13364,28,13364,3335002.4814814813,501.0,477.2857142857143,0,0,0.0,0.0,0.0
281570.0,17,2,363,1,79,0.0,79.0,79.0,1,284,0.0,284.0,284.0
125862660.0,6,59,11869,29,5983,3435229.785714286,1514.0,206.31034482758625,30,5886,4332660.862068965,1514.0,196.2
2463941.0,6,25,7573,14,3735,189533.92307692303,1514.0,266.7857142857143,11,3838,221538.3,1514.0,348.90909090909093
9900.0,6,11,2098,6,590,1812.2,252.0,98.33333333333331,5,1508,1900.25,1236.0,301.6
411.0,17,2,410,1,78,0.0,78.0,78.0,1,332,0.0,332.0,332.0
3202.0,17,2,224,1,76,0.0,76.0,76.0,1,148,0.0,148.0,148.0
574031.0,6,4,508,2,238,0.0,172.0,119.0,2,270,0.0,135.0,135.0
32208.0,6,2,145,2,145,0.0,91.0,72.5,0,0,0.0,0.0,0.0
311804.0,17,4,1400,4,1400,103934.66666666669,350.0,350.0,0,0,0.0,0.0,0.0
10481346.0,6,7,478,4,272,3448409.6666666665,74.0,68.0,3,206,5172496.0,74.0,68.66666666666667
143901.0,17,2,180,1,90,0.0,90.0,90.0,1,90,0.0,90.0,90.0
47779.0,6,10,2032,5,524,11627.0,252.0,104.8,5,1508,8104.5,1236.0,301.6
119675.0,17,2,180,1,70,0.0,70.0,70.0,1,110,0.0,110.0,110.0
1824719.0,6,4,276,2,128,0.0,74.0,64.0,2,148,0.0,74.0,74.0
90216421.0,6,21,1585,10,745,9996507.666666666,95.0,74.5,11,840,9000079.1,95.0,76.36363636363636
29924443.0,6,11,738,5,342,7478928.5,95.0,68.4,6,396,5984372.8,95.0,66.0
91319034.0,6,25,1686,13,840,7609919.5,123.0,64.61538461538461,12,846,7374285.909090909,123.0,70.5
313955.0,6,6,412,4,272,104651.66666666669,74.0,68.0,2,140,0.0,74.0,70.0
74159417.0,6,9,842,9,842,9269927.125,97.0,93.55555555555556,0,0,0.0,0.0,0.0
317583.0,17,4,1400,4,1400,105861.0,350.0,350.0,0,0,0.0,0.0,0.0
88083.0,6,14,4740,7,653,12468.166666666666,249.0,93.28571428571428,7,4087,14263.0,1514.0,583.8571428571429
17110.0,6,11,2098,6,590,3275.2,252.0,98.33333333333331,5,1508,3929.5,1236.0,301.6
205864.0,17,2,762,2,762,0.0,381.0,381.0,0,0,0.0,0.0,0.0
196939.0,17,2,180,1,90,0.0,90.0,90.0,1,90,0.0,90.0,90.0
308141.0,6,6,412,4,272,102713.66666666669,74.0,68.0,2,140,0.0,74.0,70.0
307290.0,6,7,478,4,272,102430.0,74.0,68.0,3,206,77355.0,74.0,68.66666666666667
253.00000000000003,17,3,1050,3,1050,126.5,350.0,350.0,0,0,0.0,0.0,0.0
210370.0,6,10,1221,6,636,42074.0,298.0,106.0,4,585,68926.33333333333,379.0,146.25
46362.0,6,10,2032,5,524,11342.75,252.0,104.8,5,1508,11324.5,1236.0,301.6
25503.0,6,14,4740,7,653,3730.6666666666665,249.0,93.28571428571428,7,4087,4055.6666666666665,1514.0,583.8571428571429
322411.0,17,4,1400,4,1400,107470.33333333331,350.0,350.0,0,0,0.0,0.0,0.0
122048.0,6,3,373,2,238,0.0,172.0,119.0,1,135,0.0,135.0,135.0
46115.0,6,14,4740,7,653,7536.0,249.0,93.28571428571428,7,4087,7544.0,1514.0,583.8571428571429
14636132.0,6,20,1689,10,1057,1593000.111111111,315.0,105.7,10,632,1592967.0,78.0,63.2
116560284.0,6,48,3168,24,1584,5067838.434782608,66.0,66.0,24,1584,5054728.391304348,66.0,66.0
148073.0,17,2,180,1,90,0.0,90.0,90.0,1,90,0.0,90.0,90.0
90257252.0,6,13,2036,8,1016,12893893.142857144,188.0,127.0,5,1020,22523477.25,204.0,204.0
10515460.0,6,7,478,4,272,3459704.333333333,74.0,68.0,3,206,5186736.0,74.0,68.66666666666667
103528.0,17,2,286,2,286,0.0,143.0,143.0,0,0,0.0,0.0,0.0
106129505.0,17,14,864,7,432,17668561.833333332,174.0,61.71428571428572,7,432,17666828.833333332,174.0,61.71428571428572
117727160.0,6,48,3168,24,1584,5118572.173913044,66.0,66.0,24,1584,5109174.043478261,66.0,66.0
90549304.0,6,14,2240,8,1016,12935614.857142856,188.0,127.0,6,1224,18077593.0,204.0,204.0
93036313.0,6,38,2508,19,1254,5151550.833333333,66.0,66.0,19,1254,5151408.055555556,66.0,66.0
29901.0,6,10,2032,5,524,6717.75,252.0,104.8,5,1508,6896.5,1236.0,301.6
319907.0,6,6,412,4,272,106635.66666666669,74.0,68.0,2,140,0.0,74.0,70.0
50738.0,17,2,180,1,90,0.0,90.0,90.0,1,90,0.0,90.0,90.0
2202.0,17,4,438,2,148,0.0,74.0,74.0,2,290,0.0,147.0,145.0
143980.0,17,2,180,1,90,0.0,90.0,90.0,1,90,0.0,90.0,90.0
308668.0,6,6,412,4,272,102889.33333333331,74.0,68.0,2,140,0.0,74.0,70.0
146709.0,6,3,373,2,238,0.0,172.0,119.0,1,135,0.0,135.0,135.0
135133187.0,17,6,1146,6,1146,27026637.4,191.0,191.0,0,0,0.0,0.0,0.0
218439.0,6,4,492,2,280,0.0,214.0,140.0,2,212,0.0,146.0,106.0
48722.0,6,10,2032,5,524,11945.5,252.0,104.8,5,1508,9999.0,1236.0,301.6
313366.0,17,4,1400,4,1400,104455.33333333331,350.0,350.0,0,0,0.0,0.0,0.0
207040.0,6,3,426,2,280,0.0,214.0,140.0,1,146,0.0,146.0,146.0
24482.0,6,14,4740,7,653,2248.333333333333,249.0,93.28571428571428,7,4087,3944.8333333333335,1514.0,583.8571428571429
206695.0,6,3,426,2,280,0.0,214.0,140.0,1,146,0.0,146.0,146.0
277982.0,17,4,1400,4,1400,92660.66666666669,350.0,350.0,0,0,0.0,0.0,0.0
196825.0,17,2,180,1,90,0.0,90.0,90.0,1,90,0.0,90.0,90.0
29220.0,6,14,4740,7,653,4683.0,249.0,93.28571428571428,7,4087,4533.5,1514.0,583.8571428571429
120096379.0,6,226,25550,113,7680,1064860.75,140.0,67.96460176991151,113,17870,1064831.5535714286,284.0,158.141592920354
2360.0,17,4,344,2,150,0.0,75.0,75.0,2,194,0.0,103.0,97.0
3083141.0,6,12,2172,7,664,513718.3333333333,252.0,94.85714285714286,5,1508,4621.25,1236.0,301.6
90049235.0,17,28,13364,28,13364,3335156.851851852,501.0,477.2857142857143,0,0,0.0,0.0,0.0
147939.0,17,2,180,1,90,0.0,90.0,90.0,1,90,0.0,90.0,90.0
90262191.0,6,13,2036,8,1016,12894598.714285716,188.0,127.0,5,1020,22523934.75,204.0,204.0
250419.0,6,3,337,2,214,0.0,160.0,107.0,1,123,0.0,123.0,123.0
14735.0,6,11,2098,6,590,2456.0,252.0,98.33333333333331,5,1508,3415.25,1236.0,301.6
14502852.0,17,6,2052,6,2052,2900570.4,342.0,342.0,0,0,0.0,0.0,0.0
2111009.0,6,24,7544,12,2450,191909.9090909091,1034.0,204.16666666666663,12,5094,163173.27272727274,1510.0,424.5
2347.0,17,4,344,2,150,0.0,75.0,75.0,2,194,0.0,103.0,97.0
3308104.0,6,3,1604,1,753,0.0,753.0,753.0,2,851,0.0,785.0,425.5
34709.0,6,14,4740,7,653,5665.166666666667,249.0,93.28571428571428,7,4087,5618.5,1514.0,583.8571428571429
276215.0,6,10,1221,6,636,55243.0,298.0,106.0,4,585,86683.33333333333,379.0,146.25
107069883.0,6,239,27376,120,8142,899746.9159663866,140.0,67.85,119,19234,898521.6355932204,284.0,161.63025210084032
216399.0,17,2,180,1,90,0.0,90.0,90.0,1,90,0.0,90.0,90.0
188803.0,6,2,132,1,66,0.0,66.0,66.0,1,66,0.0,66.0,66.0
216402.0,17,2,180,1,90,0.0,90.0,90.0,1,90,0.0,90.0,90.0
103022.0,17,2,286,2,286,0.0,143.0,143.0,0,0,0.0,0.0,0.0
310.0,17,2,156,1,78,0.0,78.0,78.0,1,78,0.0,78.0,78.0
27859.0,6,10,2032,5,524,6513.25,252.0,104.8,5,1508,6703.75,1236.0,301.6
21949.0,17,2,582,1,83,0.0,83.0,83.0,1,499,0.0,499.0,499.0
2695993.0,6,2,132,1,66,0.0,66.0,66.0,1,66,0.0,66.0,66.0
135129610.0,17,6,1206,6,1206,27025922.0,201.0,201.0,0,0,0.0,0.0,0.0
90017698.0,17,28,13364,28,13364,3333988.814814815,501.0,477.2857142857143,0,0,0.0,0.0,0.0
1949904.0,17,8,1640,4,312,649831.6666666666,78.0,78.0,4,1328,649831.3333333334,332.0,332.0
2397.0,17,4,344,2,150,0.0,75.0,75.0,2,194,0.0,103.0,97.0
298560.0,6,6,412,4,272,99520.0,74.0,68.0,2,140,0.0,74.0,70.0
0.0,17,1,179,1,179,0.0,179.0,179.0,0,0,0.0,0.0,0.0
119401182.0,6,20,1490,11,840,11934889.1,95.0,76.36363636363636,9,650,14924406.875,95.0,72.22222222222223
103293.0,17,2,286,2,286,0.0,143.0,143.0,0,0,0.0,0.0,0.0
1567054.0,6,2,132,1,66,0.0,66.0,66.0,1,66,0.0,66.0,66.0
10466427.0,6,7,478,4,272,3443470.6666666665,74.0,68.0,3,206,5165097.0,74.0,68.66666666666667
277666.0,6,10,1221,6,636,55533.2,298.0,106.0,4,585,87115.33333333333,379.0,146.25
72104.0,17,2,180,1,90,0.0,90.0,90.0,1,90,0.0,90.0,90.0
120294390.0,6,229,25928,115,18182,1055213.9473684211,284.0,158.10434782608695,114,7746,1055283.646017699,140.0,67.94736842105263
6791.0,17,2,231,1,78,0.0,78.0,78.0,1,153,0.0,153.0,153.0
1061836.0,6,10,1221,6,636,212367.2,298.0,106.0,4,585,352699.3333333333,379.0,146.25
11918.0,6,10,1067,5,536,2816.75,264.0,107.2,5,531,2203.5,259.0,106.2
143942.0,17,2,180,1,90,0.0,90.0,90.0,1,90,0.0,90.0,90.0
208112.0,17,2,180,1,90,0.0,90.0,90.0,1,90,0.0,90.0,90.0
108107553.0,17,5,1005,5,1005,27026888.25,201.0,201.0,0,0,0.0,0.0,0.0
143950.0,17,2,180,1,90,0.0,90.0,90.0,1,90,0.0,90.0,90.0
120152582.0,6,242,27198,121,8208,997251.275,140.0,67.83471074380165,121,18990,994488.175,284.0,156.94214876033058
765.0,17,4,438,2,148,0.0,74.0,74.0,2,290,0.0,147.0,145.0
38089.0,6,10,2032,5,524,7076.0,252.0,104.8,5,1508,9169.0,1236.0,301.6
51345.0,6,14,4740,7,653,7419.666666666667,249.0,93.28571428571428,7,4087,7782.0,1514.0,583.8571428571429
99503887.0,17,12,778,6,389,19868992.2,174.0,64.83333333333333,6,389,19808699.6,174.0,64.83333333333333
219025.0,6,3,426,2,280,0.0,214.0,140.0,1,146,0.0,146.0,146.0
31402.0,6,14,4740,7,653,5065.833333333333,249.0,93.28571428571428,7,4087,4894.166666666667,1514.0,583.8571428571429
14973.0,17,2,180,1,90,0.0,90.0,90.0,1,90,0.0,90.0,90.0
505883.0,6,4,270,2,134,0.0,68.0,67.0,2,136,0.0,70.0,68.0
887094.0,6,10,1336,6,799,177418.8,461.0,133.16666666666666,4,537,203734.3333333333,331.0,134.25
120124158.0,6,12,1832,8,1016,17137551.14285714,188.0,127.0,4,816,30031028.0,204.0,204.0
107362.0,17,2,286,2,286,0.0,143.0,143.0,0,0,0.0,0.0,0.0
24750.0,6,10,2032,5,524,5455.5,252.0,104.8,5,1508,5557.75,1236.0,301.6
5623394.0,6,4,270,2,134,0.0,68.0,67.0,2,136,0.0,70.0,68.0
33742.0,6,14,4740,7,653,5446.666666666667,249.0,93.28571428571428,7,4087,4549.333333333333,1514.0,583.8571428571429
90011550.0,17,27,12943,27,12943,3461982.6923076925,501.0,479.3703703703704,0,0,0.0,0.0,0.0
27384.0,6,14,4740,7,653,4357.666666666667,249.0,93.28571428571428,7,4087,4227.5,1514.0,583.8571428571429
108106009.0,17,5,955,5,955,27026502.25,191.0,191.0,0,0,0.0,0.0,0.0
225895.0,6,3,426,2,280,0.0,214.0,140.0,1,146,0.0,146.0,146.0
24160.0,6,14,4740,7,653,3906.8333333333335,249.0,93.28571428571428,7,4087,3889.8333333333335,1514.0,583.8571428571429
120059085.0,17,29,13785,29,13785,4287824.464285715,501.0,475.3448275862069,0,0,0.0,0.0,0.0
438321.0,6,10,967,5,390,73459.25,162.0,78.0,5,577,73476.75,349.0,115.4
916.0,17,5,550,5,550,229.0,110.0,110.0,0,0,0.0,0.0,0.0
122134.0,6,3,373,2,238,0.0,172.0,119.0,1,135,0.0,135.0,135.0
6744.0,17,2,582,1,83,0.0,83.0,83.0,1,499,0.0,499.0,499.0
2341.0,17,4,344,2,150,0.0,75.0,75.0,2,194,0.0,103.0,97.0
2875105.0,6,4,270,2,134,0.0,68.0,67.0,2,136,0.0,70.0,68.0
1514.0,17,2,762,2,762,0.0,381.0,381.0,0,0,0.0,0.0,0.0
123730531.0,6,49,3234,25,1650,5155438.791666667,66.0,66.0,24,1584,4943071.695652174,66.0,66.0
90534825.0,6,14,2240,8,1016,12933546.42857143,188.0,127.0,6,1224,18072517.2,204.0,204.0
21822.0,17,2,582,1,83,0.0,83.0,83.0,1,499,0.0,499.0,499.0
5413.0,17,4,344,2,150,0.0,75.0,75.0,2,194,0.0,103.0,97.0
107677.0,17,2,286,2,286,0.0,143.0,143.0,0,0,0.0,0.0,0.0
219663.0,17,2,180,1,90,0.0,90.0,90.0,1,90,0.0,90.0,90.0
258162.0,6,3,337,2,214,0.0,160.0,107.0,1,123,0.0,123.0,123.0
90298849.0,6,21,1585,11,840,9025304.0,95.0,76.36363636363636,10,745,10002571.777777778,95.0,74.5
42548.0,6,10,2032,5,524,9367.25,252.0,104.8,5,1508,10383.0,1236.0,301.6
114992042.0,6,47,3102,24,1584,4999639.521739131,66.0,66.0,23,1518,5143999.181818182,66.0,66.0
27289401.0,17,5,1710,5,1710,6822350.25,342.0,342.0,0,0,0.0,0.0,0.0
90306119.0,6,17,1287,9,691,11282043.625,95.0,76.77777777777777,8,596,12899570.857142856,95.0,74.5
135126732.0,17,6,1146,6,1146,27025346.4,191.0,191.0,0,0,0.0,0.0,0.0
61896.0,6,14,4740,7,653,9564.333333333334,249.0,93.28571428571428,7,4087,10176.5,1514.0,583.8571428571429
217273.0,6,12,1373,7,714,36212.16666666666,298.0,102.0,5,659,53315.0,379.0,131.8
117652216.0,6,214,24202,107,16844,1107897.0377358492,284.0,157.42056074766356,107,7358,1107897.20754717,140.0,68.76635514018692
22050.0,6,10,1065,5,534,5011.5,262.0,106.8,5,531,4841.25,259.0,106.2
5077.0,17,4,344,2,150,0.0,75.0,75.0,2,194,0.0,103.0,97.0
173308.0,17,4,1400,4,1400,57769.333333333336,350.0,350.0,0,0,0.0,0.0,0.0
47859.0,6,14,4740,7,653,7663.833333333333,249.0,93.28571428571428,7,4087,7779.333333333333,1514.0,583.8571428571429
282777.0,6,10,1221,6,636,56555.4,298.0,106.0,4,585,88849.33333333333,379.0,146.25
120186858.0,6,222,25122,111,7548,1085116.0363636364,140.0,68.0,111,17574,1085281.290909091,284.0,158.32432432432432
127009123.0,17,15,907,8,475,18144160.42857143,174.0,59.375,7,432,17833525.666666668,174.0,61.71428571428572
116562741.0,6,278,32544,139,23074,843098.1739130435,284.0,166.0,139,9470,843098.2101449275,140.0,68.12949640287769
300.0,17,2,168,1,76,0.0,76.0,76.0,1,92,0.0,92.0,92.0
10415.0,17,4,823,2,163,0.0,89.0,81.5,2,660,0.0,443.0,330.0
4458.0,17,2,598,1,72,0.0,72.0,72.0,1,526,0.0,526.0,526.0
302422.0,6,6,412,4,272,100807.33333333331,74.0,68.0,2,140,0.0,74.0,70.0
17767.0,6,14,4740,7,653,2851.1666666666665,249.0,93.28571428571428,7,4087,2310.0,1514.0,583.8571428571429
381143.0,6,6,412,4,272,127047.66666666669,74.0,68.0,2,140,0.0,74.0,70.0
135119572.0,17,6,1206,6,1206,27023914.4,201.0,201.0,0,0,0.0,0.0,0.0
96119322.0,6,64,15371,33,6179,3003728.8125,1514.0,187.24242424242425,31,9192,3195662.8,1514.0,296.51612903225805
952.0,17,4,438,2,148,0.0,74.0,74.0,2,290,0.0,147.0,145.0
2394.0,17,4,344,2,150,0.0,75.0,75.0,2,194,0.0,103.0,97.0
512132.00000000006,6,5,336,2,134,0.0,68.0,67.0,3,202,194034.0,70.0,67.33333333333333
122870.0,6,13,1513,7,882,20326.0,291.0,126.0,6,631,23966.0,293.0,105.16666666666669
221859.0,6,3,426,2,280,0.0,214.0,140.0,1,146,0.0,146.0,146.0
120181945.0,6,210,23630,105,7226,1147677.076923077,140.0,68.81904761904762,105,16404,1147791.3557692308,284.0,156.22857142857143
83016.0,6,14,4740,7,653,13712.333333333334,249.0,93.28571428571428,7,4087,12808.0,1514.0,583.8571428571429
16803.0,6,11,1132,6,556,3099.2,218.0,92.66666666666669,5,576,3992.75,304.0,115.2
22247.0,6,14,4740,7,653,2929.833333333333,249.0,93.28571428571428,7,4087,3417.0,1514.0,583.8571428571429
90257801.0,6,14,1964,8,1016,12893971.57142857,188.0,127.0,6,948,18018741.8,204.0,158.0
99182021.0,6,178,20094,89,13998,1124624.056818182,284.0,157.2808988764045,89,6096,1124623.8409090908,140.0,68.49438202247191
242066.0,6,3,337,2,214,0.0,160.0,107.0,1,123,0.0,123.0,123.0
17168.0,6,11,2098,6,590,2216.8,252.0,98.33333333333331,5,1508,4015.5,1236.0,301.6
232723.0,6,3,337,2,214,0.0,160.0,107.0,1,123,0.0,123.0,123.0
4607081.0,6,20,1607,10,975,477828.5555555556,315.0,97.5,10,632,477806.8888888889,78.0,63.2
506839.00000000006,6,5,336,2,134,0.0,68.0,67.0,3,202,194462.0,70.0,67.33333333333333
209366.0,17,2,180,1,90,0.0,90.0,90.0,1,90,0.0,90.0,90.0
294287.0,17,4,1400,4,1400,98095.66666666669,350.0,350.0,0,0,0.0,0.0,0.0
103053.0,17,2,286,2,286,0.0,143.0,143.0,0,0,0.0,0.0,0.0
19005.0,6,14,4740,7,653,2509.833333333333,249.0,93.28571428571428,7,4087,3002.6666666666665,1514.0,583.8571428571429
319779.0,17,4,1400,4,1400,106593.0,350.0,350.0,0,0,0.0,0.0,0.0
199839.0,17,2,180,1,90,0.0,90.0,90.0,1,90,0.0,90.0,90.0
238051.0,6,3,373,2,238,0.0,172.0,119.0,1,135,0.0,135.0,135.0
145842.0,6,3,337,2,214,0.0,160.0,107.0,1,123,0.0,123.0,123.0
2040.0,17,4,344,2,150,0.0,75.0,75.0,2,194,0.0,103.0,97.0
47548.0,6,14,4740,7,653,7718.833333333333,249.0,93.28571428571428,7,4087,7477.833333333333,1514.0,583.8571428571429
111503403.0,6,32,2220,16,1149,7433560.2,123.0,71.8125,16,1071,7419130.6,123.0,66.9375
40274.0,6,14,4740,7,653,6123.833333333333,249.0,93.28571428571428,7,4087,6580.166666666667,1514.0,583.8571428571429
209042.0,6,10,1221,6,636,41808.4,298.0,106.0,4,585,68540.66666666667,379.0,146.25
121223.0,6,3,337,2,214,0.0,160.0,107.0,1,123,0.0,123.0,123.0
24858.0,6,10,2032,5,524,4788.0,252.0,104.8,5,1508,5125.75,1236.0,301.6
104364685.0,17,14,1126,7,563,17333490.666666668,174.0,80.42857142857143,7,563,17334594.833333332,174.0,80.42857142857143
1030623.0,6,11,1134,6,558,206124.6,220.0,93.0,5,576,255909.75,304.0,115.2
7000.0,17,2,582,1,83,0.0,83.0,83.0,1,499,0.0,499.0,499.0
108321.0,17,2,286,2,286,0.0,143.0,143.0,0,0,0.0,0.0,0.0
325.0,17,2,174,1,79,0.0,79.0,79.0,1,95,0.0,95.0,95.0
117617842.0,6,224,25184,112,17496,1057681.8288288289,284.0,156.21428571428572,112,7688,1057681.4864864864,140.0,68.64285714285714
205880.0,6,3,426,2,280,0.0,214.0,140.0,1,146,0.0,146.0,146.0
98637388.0,17,14,1126,7,563,16333471.5,174.0,80.42857142857143,7,563,16335390.833333334,174.0,80.42857142857143
815.0,17,4,438,2,148,0.0,74.0,74.0,2,290,0.0,147.0,145.0
106504.0,17,2,286,2,286,0.0,143.0,143.0,0,0,0.0,0.0,0.0
2016.0,17,4,344,2,150,0.0,75.0,75.0,2,194,0.0,103.0,97.0
23059.0,6,14,4740,7,653,3389.0,249.0,93.28571428571428,7,4087,3646.3333333333335,1514.0,583.8571428571429
90285062.0,6,22,1639,12,894,8203598.090909091,95.0,74.5,10,745,10031087.555555556,95.0,74.5
112535565.0,6,46,3036,23,1518,5105437.681818182,66.0,66.0,23,1518,5105439.227272728,66.0,66.0
452378.0,6,3,204,2,136,0.0,70.0,68.0,1,68,0.0,68.0,68.0
297.0,17,2,156,1,78,0.0,78.0,78.0,1,78,0.0,78.0,78.0
28800.0,6,10,2032,5,524,6267.5,252.0,104.8,5,1508,6620.0,1236.0,301.6
1043049.0,6,11,1134,6,558,208609.8,220.0,93.0,5,576,258150.25,304.0,115.2
90944047.0,6,19,1436,9,691,11368005.875,95.0,76.77777777777777,10,745,10075840.222222222,95.0,74.5
135124305.0,17,6,1146,6,1146,27024861.0,191.0,191.0,0,0,0.0,0.0,0.0
108099707.0,17,5,1005,5,1005,27024926.75,201.0,201.0,0,0,0.0,0.0,0.0
2459.0,17,4,344,2,150,0.0,75.0,75.0,2,194,0.0,103.0,97.0
9595.0,17,4,823,2,163,0.0,89.0,81.5,2,660,0.0,443.0,330.0
10975.0,6,10,1066,5,490,2348.5,218.0,98.0,5,576,2547.0,304.0,115.2
27195224.0,17,5,1710,5,1710,6798806.0,342.0,342.0,0,0,0.0,0.0,0.0
264066.0,6,10,1221,6,636,52813.2,298.0,106.0,4,585,82552.0,379.0,146.25
5005560.0,17,4,849,2,166,0.0,83.0,83.0,2,683,0.0,499.0,341.5
113520102.0,6,46,3036,23,1518,5159991.7727272725,66.0,66.0,23,1518,5159993.318181818,66.0,66.0
120065766.0,17,28,13364,28,13364,4446880.222222222,501.0,477.2857142857143,0,0,0.0,0.0,0.0
412.0,17,2,410,1,78,0.0,78.0,78.0,1,332,0.0,332.0,332.0
146187.0,6,3,337,2,214,0.0,160.0,107.0,1,123,0.0,123.0,123.0
320590.0,6,6,412,4,272,106863.33333333331,74.0,68.0,2,140,0.0,74.0,70.0
27633620.0,17,5,1710,5,1710,6908405.0,342.0,342.0,0,0,0.0,0.0,0.0
146375.0,6,3,337,2,214,0.0,160.0,107.0,1,123,0.0,123.0,123.0
56847.0,6,14,4740,7,653,9346.666666666666,249.0,93.28571428571428,7,4087,9327.666666666666,1514.0,583.8571428571429
118139038.0,6,915,177716,451,30358,262531.1955555556,214.0,67.31263858093126,464,147358,254653.28941684664,1514.0,317.5818965517241
120351792.0,6,233,26446,117,18494,1037515.448275862,284.0,158.06837606837607,116,7952,1038237.591304348,140.0,68.55172413793103
10465137.0,6,7,478,4,272,3441191.0,74.0,68.0,3,206,5161676.5,74.0,68.66666666666667
2604088.0,6,25,7573,14,3735,200314.4615384616,1514.0,266.7857142857143,11,3838,235446.5,1514.0,348.90909090909093
105363030.0,17,14,864,7,432,17500163.666666668,174.0,61.71428571428572,7,432,17500837.5,174.0,61.71428571428572
1997.0,17,4,344,2,150,0.0,75.0,75.0,2,194,0.0,103.0,97.0
90093394.0,6,10,1440,7,828,15015565.666666666,188.0,118.28571428571428,3,612,30030333.0,204.0,204.0
118697866.0,6,214,24202,107,16844,1117760.4622641508,284.0,157.42056074766356,107,7358,1117761.1037735848,140.0,68.76635514018692
4992176.0,17,4,849,2,166,0.0,83.0,83.0,2,683,0.0,499.0,341.5
302223.0,6,6,412,4,272,100741.0,74.0,68.0,2,140,0.0,74.0,70.0
216699.0,17,2,180,1,90,0.0,90.0,90.0,1,90,0.0,90.0,90.0
213712.0,17,2,180,1,90,0.0,90.0,90.0,1,90,0.0,90.0,90.0
107092393.0,17,14,864,7,432,17822245.5,174.0,61.71428571428572,7,432,17838703.0,174.0,61.71428571428572
1299959.0,17,7,490,7,490,216659.8333333333,70.0,70.0,0,0,0.0,0.0,0.0
121400.0,6,3,337,2,214,0.0,160.0,107.0,1,123,0.0,123.0,123.0
306613.0,6,6,412,4,272,102204.33333333331,74.0,68.0,2,140,0.0,74.0,70.0
301255.0,6,6,412,4,272,100418.33333333331,74.0,68.0,2,140,0.0,74.0,70.0
333.0,17,2,166,1,75,0.0,75.0,75.0,1,91,0.0,91.0,91.0
135133020.0,17,6,1206,6,1206,27026604.0,201.0,201.0,0,0,0.0,0.0,0.0
33354.0,6,14,4740,7,653,5450.666666666667,249.0,93.28571428571428,7,4087,4986.166666666667,1514.0,583.8571428571429
90789505.0,6,19,1436,10,745,10079855.0,95.0,74.5,9,691,11347123.5,95.0,76.77777777777777
121161756.0,6,208,23568,104,7086,1158393.495145631,140.0,68.13461538461539,104,16482,1158190.3203883497,284.0,158.48076923076923
135129755.0,17,6,1146,6,1146,27025951.0,191.0,191.0,0,0,0.0,0.0,0.0
18036.0,6,10,2032,5,524,4291.75,252.0,104.8,5,1508,4220.25,1236.0,301.6
304.0,17,2,174,1,79,0.0,79.0,79.0,1,95,0.0,95.0,95.0
30589.0,6,13,4412,6,409,5975.2,127.0,68.16666666666667,7,4003,4820.5,1514.0,571.8571428571429
90368465.0,6,12,1848,7,828,15061410.833333334,188.0,118.28571428571428,5,1020,15084212.0,204.0,204.0
113332835.0,6,48,3168,24,1584,4927514.565217392,66.0,66.0,24,1584,4920332.913043479,66.0,66.0
102323.0,17,2,286,2,286,0.0,143.0,143.0,0,0,0.0,0.0,0.0
2305.0,17,4,344,2,150,0.0,75.0,75.0,2,194,0.0,103.0,97.0
135131795.0,17,6,1146,6,1146,27026359.0,191.0,191.0,0,0,0.0,0.0,0.0
120071326.0,6,665,123910,337,101744,356715.0744047619,1514.0,301.91097922848667,328,22166,366530.2966360856,214.0,67.57926829268293
2798628.0,6,2,132,1,66,0.0,66.0,66.0,1,66,0.0,66.0,66.0
107519.0,17,2,286,2,286,0.0,143.0,143.0,0,0,0.0,0.0,0.0
209524.0,17,2,180,1,90,0.0,90.0,90.0,1,90,0.0,90.0,90.0
45043.0,6,14,4740,7,653,7036.166666666667,249.0,93.28571428571428,7,4087,6708.833333333333,1514.0,583.8571428571429
11047022.0,6,7,499,3,198,4095657.0,66.0,66.0,4,301,3316843.333333333,103.0,75.25
207107.0,6,3,426,2,280,0.0,214.0,140.0,1,146,0.0,146.0,146.0
9982.0,6,10,1066,5,490,2230.25,218.0,98.0,5,576,2072.0,304.0,115.2
217864.0,6,3,426,2,280,0.0,214.0,140.0,1,146,0.0,146.0,146.0
143855.0,17,2,180,1,90,0.0,90.0,90.0,1,90,0.0,90.0,90.0
3009922.0,6,11,2106,6,598,601789.8,252.0,99.66666666666669,5,1508,2410.25,1236.0,301.6
63677.0,6,14,4740,7,653,10045.666666666666,249.0,93.28571428571428,7,4087,9667.833333333334,1514.0,583.8571428571429
499564.0,6,4,270,2,134,0.0,68.0,67.0,2,136,0.0,70.0,68.0
29205.0,6,14,4740,7,653,3794.8333333333335,249.0,93.28571428571428,7,4087,4730.5,1514.0,583.8571428571429
3442.0,17,2,359,1,75,0.0,75.0,75.0,1,284,0.0,284.0,284.0
23467388.0,6,5,1909,2,892,0.0,826.0,446.0,3,1017,11663651.0,885.0,339.0
153494.0,17,2,180,1,90,0.0,90.0,90.0,1,90,0.0,90.0,90.0
113654654.0,6,48,3168,24,1584,4941506.695652174,66.0,66.0,24,1584,4935654.217391305,66.0,66.0
301.0,17,2,156,1,78,0.0,78.0,78.0,1,78,0.0,78.0,78.0
90035728.0,17,28,13364,28,13364,3334656.592592593,501.0,477.2857142857143,0,0,0.0,0.0,0.0
298105.0,6,6,412,4,272,99368.33333333331,74.0,68.0,2,140,0.0,74.0,70.0
1603470.0,6,2,132,1,66,0.0,66.0,66.0,1,66,0.0,66.0,66.0
10454771.0,6,7,478,4,272,3439410.333333333,74.0,68.0,3,206,5158976.0,74.0,68.66666666666667
6047252.0,17,5,1710,5,1710,1511813.0,342.0,342.0,0,0,0.0,0.0,0.0
120285370.0,6,253,28682,127,20070,954645.7936507936,284.0,158.03149606299212,126,8612,954037.4,140.0,68.34920634920636
722.0,17,4,438,2,148,0.0,74.0,74.0,2,290,0.0,147.0,145.0
1319.0,17,2,762,2,762,0.0,381.0,381.0,0,0,0.0,0.0,0.0
309903.0,6,6,412,4,272,103301.0,74.0,68.0,2,140,0.0,74.0,70.0
0.0,17,1,350,1,350,0.0,350.0,350.0,0,0,0.0,0.0,0.0
10424250.0,6,7,478,4,272,3429568.0,74.0,68.0,3,206,5144215.5,74.0,68.66666666666667
1302563.0,6,4,264,2,132,0.0,66.0,66.0,2,132,0.0,66.0,66.0
231896.0,6,3,373,2,238,0.0,172.0,119.0,1,135,0.0,135.0,135.0
69102.0,17,4,823,2,163,0.0,89.0,81.5,2,660,0.0,443.0,330.0
129004013.0,17,15,907,8,475,18429144.71428572,174.0,59.375,7,432,18166850.0,174.0,61.71428571428572
93012712.0,6,38,2508,19,1254,5150436.777777778,66.0,66.0,19,1254,5150441.611111111,66.0,66.0
196907.0,17,2,180,1,90,0.0,90.0,90.0,1,90,0.0,90.0,90.0
2284.0,17,4,344,2,150,0.0,75.0,75.0,2,194,0.0,103.0,97.0
143911.0,17,2,180,1,90,0.0,90.0,90.0,1,90,0.0,90.0,90.0
1197922.0,6,13,3009,8,2381,171131.7142857143,1514.0,297.625,5,628,230465.0,331.0,125.6
46911.0,6,10,2032,5,524,11255.0,252.0,104.8,5,1508,11093.5,1236.0,301.6
20264.0,6,14,4740,7,653,3005.833333333333,249.0,93.28571428571428,7,4087,3185.333333333333,1514.0,583.8571428571429
213113.0,6,3,426,2,280,0.0,214.0,140.0,1,146,0.0,146.0,146.0
90270827.0,6,15,2444,8,1016,12895832.42857143,188.0,127.0,7,1428,15014182.666666666,204.0,204.0
206078.0,6,3,426,2,280,0.0,214.0,140.0,1,146,0.0,146.0,146.0
35019.0,6,14,4740,7,653,5143.166666666667,249.0,93.28571428571428,7,4087,5700.666666666667,1514.0,583.8571428571429
90647254.0,6,15,2302,9,1204,11316498.625,188.0,133.77777777777777,6,1098,18096745.2,204.0,183.0
276642.0,17,4,1400,4,1400,92214.0,350.0,350.0,0,0,0.0,0.0,0.0
49088.0,6,10,2032,5,524,11419.0,252.0,104.8,5,1508,9363.0,1236.0,301.6
50241.0,6,10,2032,5,524,11203.75,252.0,104.8,5,1508,11991.0,1236.0,301.6
7416.0,17,3,1026,3,1026,3708.0,342.0,342.0,0,0,0.0,0.0,0.0
102857.0,17,2,286,2,286,0.0,143.0,143.0,0,0,0.0,0.0,0.0
284521.0,17,4,704,2,148,0.0,74.0,74.0,2,556,0.0,280.0,278.0
111431840.0,17,14,864,7,432,18501119.666666668,174.0,61.71428571428572,7,432,18500173.166666668,174.0,61.71428571428572
320.0,17,2,168,1,76,0.0,76.0,76.0,1,92,0.0,92.0,92.0
143825.0,17,2,180,1,90,0.0,90.0,90.0,1,90,0.0,90.0,90.0
2290.0,17,4,344,2,150,0.0,75.0,75.0,2,194,0.0,103.0,97.0
55830.0,6,10,2032,5,524,12458.25,252.0,104.8,5,1508,12120.25,1236.0,301.6
17730.0,6,14,4679,7,596,2828.6666666666665,192.0,85.14285714285714,7,4083,2599.0,1514.0,583.2857142857143
121384.0,6,3,337,2,214,0.0,160.0,107.0,1,123,0.0,123.0,123.0
1355977.0,17,16,1120,16,1120,90398.46666666666,70.0,70.0,0,0,0.0,0.0,0.0
4490.0,17,2,614,1,72,0.0,72.0,72.0,1,542,0.0,542.0,542.0
64832.0,6,14,4740,7,653,10543.666666666666,249.0,93.28571428571428,7,4087,10663.0,1514.0,583.8571428571429
90257166.0,6,12,1832,8,1016,12893880.857142856,188.0,127.0,4,816,30030578.0,204.0,204.0
235846.0,6,3,337,2,214,0.0,160.0,107.0,1,123,0.0,123.0,123.0
11482.0,17,2,267,1,83,0.0,83.0,83.0,1,184,0.0,184.0,184.0
302413.0,6,2,132,1,66,0.0,66.0,66.0,1,66,0.0,66.0,66.0
121499.0,6,3,337,2,214,0.0,160.0,107.0,1,123,0.0,123.0,123.0
219167.0,6,3,426,2,280,0.0,214.0,140.0,1,146,0.0,146.0,146.0
419.0,17,2,174,1,79,0.0,79.0,79.0,1,95,0.0,95.0,95.0
141946.0,6,2,132,1,66,0.0,66.0,66.0,1,66,0.0,66.0,66.0
829.0,17,4,438,2,148,0.0,74.0,74.0,2,290,0.0,147.0,145.0
1766.0,17,2,691,1,349,0.0,349.0,349.0,1,342,0.0,342.0,342.0
6113.0,17,2,447,1,84,0.0,84.0,84.0,1,363,0.0,363.0,363.0
90025768.0,17,28,13364,28,13364,3334287.703703704,501.0,477.2857142857143,0,0,0.0,0.0,0.0
112959.0,17,2,286,2,286,0.0,143.0,143.0,0,0,0.0,0.0,0.0
120091234.0,17,28,13364,28,13364,4447823.481481481,501.0,477.2857142857143,0,0,0.0,0.0,0.0
16681026.0,6,20,1611,9,921,2047166.75,315.0,102.33333333333331,11,690,1637701.6,78.0,62.72727272727273
320378.0,6,6,412,4,272,106792.66666666669,74.0,68.0,2,140,0.0,74.0,70.0
298656.0,17,2,180,1,90,0.0,90.0,90.0,1,90,0.0,90.0,90.0
2339.0,17,4,344,2,150,0.0,75.0,75.0,2,194,0.0,103.0,97.0
229605.0,17,2,371,1,81,0.0,81.0,81.0,1,290,0.0,290.0,290.0
216412.0,17,2,180,1,90,0.0,90.0,90.0,1,90,0.0,90.0,90.0
2485925.0,6,3,1604,2,851,0.0,785.0,425.5,1,753,0.0,753.0,753.0
205685.0,17,2,180,1,90,0.0,90.0,90.0,1,90,0.0,90.0,90.0
312580.0,17,4,1400,4,1400,104193.33333333331,350.0,350.0,0,0,0.0,0.0,0.0
123609614.0,17,14,864,7,432,17336361.0,174.0,61.71428571428572,7,432,17334279.166666668,174.0,61.71428571428572
123610475.0,6,49,3234,25,1650,5150436.458333333,66.0,66.0,24,1584,5109077.739130435,66.0,66.0
109012195.0,6,33,2359,17,1194,6813262.1875,123.0,70.23529411764706,16,1165,7252957.533333333,139.0,72.8125
51334.0,6,10,2032,5,524,12261.5,252.0,104.8,5,1508,11977.5,1236.0,301.6
108109809.0,17,5,955,5,955,27027452.25,191.0,191.0,0,0,0.0,0.0,0.0
405220.0,6,4,508,2,238,0.0,172.0,119.0,2,270,0.0,135.0,135.0
50099.0,6,10,2032,5,524,12258.25,252.0,104.8,5,1508,11844.0,1236.0,301.6
814.0,17,4,438,2,148,0.0,74.0,74.0,2,290,0.0,147.0,145.0
2509423.0,6,3,1604,2,851,0.0,785.0,425.5,1,753,0.0,753.0,753.0
120306877.0,6,223,25118,112,17496,1083845.7387387387,284.0,156.21428571428572,111,7622,1084177.2818181815,140.0,68.66666666666667
29870707.0,6,4,270,3,202,14935353.5,70.0,67.33333333333333,1,68,0.0,68.0,68.0
27558.0,6,14,4740,7,653,4427.833333333333,249.0,93.28571428571428,7,4087,3949.5,1514.0,583.8571428571429
146080.0,6,3,337,2,214,0.0,160.0,107.0,1,123,0.0,123.0,123.0
303867.0,17,4,822,2,144,0.0,72.0,72.0,2,678,0.0,542.0,339.0
15475.0,6,11,2098,6,590,3018.2,252.0,98.33333333333331,5,1508,3482.75,1236.0,301.6
90024238.0,17,27,12943,27,12943,3462470.6923076925,501.0,479.3703703703704,0,0,0.0,0.0,0.0
135113564.0,17,6,1206,6,1206,27022712.8,201.0,201.0,0,0,0.0,0.0,0.0
50146.0,6,10,2032,5,524,12309.75,252.0,104.8,5,1508,12140.25,1236.0,301.6
120124744.0,6,14,2224,9,1204,15015593.0,188.0,133.77777777777777,5,1020,22592020.0,204.0,204.0
2447.0,17,4,344,2,150,0.0,75.0,75.0,2,194,0.0,103.0,97.0
832.0,17,4,438,2,148,0.0,74.0,74.0,2,290,0.0,147.0,145.0
246303.0,6,3,337,2,214,0.0,160.0,107.0,1,123,0.0,123.0,123.0
90035432.0,17,28,13364,28,13364,3334645.6296296297,501.0,477.2857142857143,0,0,0.0,0.0,0.0
281807.0,17,2,365,1,80,0.0,80.0,80.0,1,285,0.0,285.0,285.0
118281600.0,6,24,1989,13,1190,9855850.0,255.0,91.53846153846152,11,799,11827330.9,95.0,72.63636363636364
92819537.0,6,181,20472,91,14310,1031328.1888888888,284.0,157.25274725274724,90,6162,1031298.3146067417,140.0,68.46666666666667
44880.0,6,14,4740,7,653,7240.833333333333,249.0,93.28571428571428,7,4087,7292.5,1514.0,583.8571428571429
291890.0,17,2,614,1,72,0.0,72.0,72.0,1,542,0.0,542.0,542.0
228505.0,17,2,180,1,90,0.0,90.0,90.0,1,90,0.0,90.0,90.0
206481.0,6,3,426,2,280,0.0,214.0,140.0,1,146,0.0,146.0,146.0
934660.0,17,10,3784,10,3784,103851.11111111112,394.0,378.4,0,0,0.0,0.0,0.0
0.0,6,1,97,1,97,0.0,97.0,97.0,0,0,0.0,0.0,0.0
209554.0,17,2,180,1,90,0.0,90.0,90.0,1,90,0.0,90.0,90.0
160857.0,6,11,1132,6,556,31454.0,218.0,92.66666666666669,5,576,40016.0,304.0,115.2
50772.0,17,2,180,1,90,0.0,90.0,90.0,1,90,0.0,90.0,90.0
603889.0,6,3,198,2,132,0.0,66.0,66.0,1,66,0.0,66.0,66.0
217115.0,6,3,426,2,280,0.0,214.0,140.0,1,146,0.0,146.0,146.0
2196909.0,17,3,1026,3,1026,1098454.5,342.0,342.0,0,0,0.0,0.0,0.0
120129190.0,6,227,25780,114,7820,1063090.1769911505,140.0,68.59649122807018,113,17960,1063463.5625,284.0,158.93805309734512
305621.0,6,6,412,4,272,101873.66666666669,74.0,68.0,2,140,0.0,74.0,70.0
856851.0,6,9,1267,6,796,171370.2,458.0,132.66666666666666,3,471,290838.5,331.0,157.0
120309356.0,6,18,1382,9,691,14999210.0,95.0,76.77777777777777,9,691,15035133.125,95.0,76.77777777777777
153430.0,17,2,180,1,90,0.0,90.0,90.0,1,90,0.0,90.0,90.0
237432.0,17,2,180,1,90,0.0,90.0,90.0,1,90,0.0,90.0,90.0
72817.0,6,14,4740,7,653,11965.333333333334,249.0,93.28571428571428,7,4087,10126.0,1514.0,583.8571428571429
297284.0,6,6,412,4,272,99094.66666666669,74.0,68.0,2,140,0.0,74.0,70.0
122001121.0,17,15,1169,8,606,17428731.57142857,174.0,75.75,7,563,17001136.5,174.0,80.42857142857143
3031268.0,6,3,1604,1,753,0.0,753.0,753.0,2,851,0.0,785.0,425.5
2371.0,17,4,344,2,150,0.0,75.0,75.0,2,194,0.0,103.0,97.0
866008.0,6,9,1096,6,625,173201.6,287.0,104.16666666666669,3,471,295388.0,331.0,157.0
26882.0,6,10,2032,5,524,6486.75,252.0,104.8,5,1508,5935.75,1236.0,301.6
90258843.0,6,13,2036,8,1016,12894120.42857143,188.0,127.0,5,1020,22522781.5,204.0,204.0
118918936.0,17,16,1212,8,606,16965547.285714287,174.0,75.75,8,606,16771504.42857143,174.0,75.75
108104015.0,17,5,1005,5,1005,27026003.75,201.0,201.0,0,0,0.0,0.0,0.0
1042212.0,6,13,1386,7,789,173702.0,253.0,112.71428571428572,6,597,205712.4,259.0,99.5
209725.0,17,4,6056,4,6056,69908.33333333333,1514.0,1514.0,0,0,0.0,0.0,0.0
2592640.0,6,2,132,1,66,0.0,66.0,66.0,1,66,0.0,66.0,66.0
153425.0,17,2,180,1,90,0.0,90.0,90.0,1,90,0.0,90.0,90.0
148004.0,17,2,180,1,90,0.0,90.0,90.0,1,90,0.0,90.0,90.0
308366.0,6,6,412,4,272,102788.66666666669,74.0,68.0,2,140,0.0,74.0,70.0
43773.0,6,14,4740,7,653,6534.5,249.0,93.28571428571428,7,4087,6245.833333333333,1514.0,583.8571428571429
119761197.0,6,27,2243,14,1002,9212399.76923077,95.0,71.57142857142857,13,1241,9962298.583333334,221.0,95.46153846153848
97327.0,17,2,286,2,286,0.0,143.0,143.0,0,0,0.0,0.0,0.0
2792559.0,6,2,132,1,66,0.0,66.0,66.0,1,66,0.0,66.0,66.0
2096.0,17,4,344,2,150,0.0,75.0,75.0,2,194,0.0,103.0,97.0
2655.0,17,2,762,2,762,0.0,381.0,381.0,0,0,0.0,0.0,0.0
9338.0,17,2,582,1,83,0.0,83.0,83.0,1,499,0.0,499.0,499.0
44859.0,6,14,4740,7,653,7309.166666666667,249.0,93.28571428571428,7,4087,7193.166666666667,1514.0,583.8571428571429
56146.0,6,14,4740,7,653,9230.666666666666,249.0,93.28571428571428,7,4087,9076.166666666666,1514.0,583.8571428571429
304658.0,17,4,1400,4,1400,101552.66666666669,350.0,350.0,0,0,0.0,0.0,0.0
47162.0,6,14,4740,7,653,7482.5,249.0,93.28571428571428,7,4087,7510.5,1514.0,583.8571428571429
90257701.0,6,12,1832,8,1016,12893957.285714284,188.0,127.0,4,816,30031955.0,204.0,204.0
233816.0,6,3,337,2,214,0.0,160.0,107.0,1,123,0.0,123.0,123.0
120183602.0,6,222,25106,111,7548,1085158.7636363637,140.0,68.0,111,17558,1085222.9181818182,284.0,158.18018018018017
108105091.0,17,5,1005,5,1005,27026272.75,201.0,201.0,0,0,0.0,0.0,0.0
153466.0,17,2,180,1,90,0.0,90.0,90.0,1,90,0.0,90.0,90.0
232410.0,6,3,337,2,214,0.0,160.0,107.0,1,123,0.0,123.0,123.0
25147.0,6,14,4740,7,653,3992.6666666666665,249.0,93.28571428571428,7,4087,4057.0,1514.0,583.8571428571429
102732489.0,6,29,2052,15,1089,7322603.642857143,123.0,72.6,14,963,7885883.076923077,123.0,68.78571428571429
99121089.0,17,14,1126,7,563,16500119.166666666,174.0,80.42857142857143,7,563,16501380.0,174.0,80.42857142857143
112827232.0,6,48,3168,24,1584,4905531.826086956,66.0,66.0,24,1584,4896130.652173913,66.0,66.0
103603.0,17,2,286,2,286,0.0,143.0,143.0,0,0,0.0,0.0,0.0
121318.0,6,3,337,2,214,0.0,160.0,107.0,1,123,0.0,123.0,123.0
38257.0,6,14,4740,7,653,6211.5,249.0,93.28571428571428,7,4087,6106.666666666667,1514.0,583.8571428571429
1471983.0,17,16,1120,16,1120,98132.2,70.0,70.0,0,0,0.0,0.0,0.0
196940.0,17,2,180,1,90,0.0,90.0,90.0,1,90,0.0,90.0,90.0
532230.0,6,5,336,2,134,0.0,68.0,67.0,3,202,193062.5,70.0,67.33333333333333
10884.0,6,10,1067,5,536,2146.0,264.0,107.2,5,531,2526.0,259.0,106.2
120123033.0,6,13,2020,9,1204,15015379.125,188.0,133.77777777777777,4,816,30031130.0,204.0,204.0
207143.0,17,3,1143,3,1143,103571.5,381.0,381.0,0,0,0.0,0.0,0.0
135131883.0,17,6,1146,6,1146,27026376.6,191.0,191.0,0,0,0.0,0.0,0.0
1321549.0,6,4,264,2,132,0.0,66.0,66.0,2,132,0.0,66.0,66.0
212503.0,6,3,426,2,280,0.0,214.0,140.0,1,146,0.0,146.0,146.0
40528.0,6,14,4740,7,653,5569.666666666667,249.0,93.28571428571428,7,4087,5983.333333333333,1514.0,583.8571428571429
90019852.0,17,28,13364,28,13364,3334068.592592593,501.0,477.2857142857143,0,0,0.0,0.0,0.0
228759.0,17,2,180,1,90,0.0,90.0,90.0,1,90,0.0,90.0,90.0
120119478.0,6,288,32506,144,9800,834247.3846153846,140.0,68.05555555555556,144,22706,834243.8811188812,284.0,157.68055555555554
81939.0,6,14,4740,7,653,13225.833333333334,249.0,93.28571428571428,7,4087,13489.833333333334,1514.0,583.8571428571429
100892098.0,17,16,5480,15,5130,5637185.357142857,342.0,342.0,1,350,0.0,350.0,350.0
3005661.0,6,12,2172,7,664,500830.0,252.0,94.85714285714286,5,1508,2041.25,1236.0,301.6
135129193.0,17,6,1206,6,1206,27025838.6,201.0,201.0,0,0,0.0,0.0,0.0
104401265.0,6,28,1860,14,966,8014278.461538462,123.0,69.0,14,894,8014277.846153846,123.0,63.85714285714285
153405.0,17,2,180,1,90,0.0,90.0,90.0,1,90,0.0,90.0,90.0
29509.0,6,14,4740,7,653,4791.333333333333,249.0,93.28571428571428,7,4087,4768.5,1514.0,583.8571428571429
31082.0,6,14,4740,7,653,4474.833333333333,249.0,93.28571428571428,7,4087,4426.666666666667,1514.0,583.8571428571429
10492.0,17,2,582,1,83,0.0,83.0,83.0,1,499,0.0,499.0,499.0
249936.0,17,4,6056,4,6056,83312.0,1514.0,1514.0,0,0,0.0,0.0,0.0
120125822.0,6,13,2036,8,1016,17136625.285714287,188.0,127.0,5,1020,22524997.5,204.0,204.0
90291003.0,6,16,1192,8,596,12891887.714285716,95.0,74.5,8,596,12897109.142857144,95.0,74.5
2422026.0,6,25,7573,14,3735,186309.6923076923,1514.0,266.7857142857143,11,3838,215097.0,1514.0,348.90909090909093
2362.0,17,4,344,2,150,0.0,75.0,75.0,2,194,0.0,103.0,97.0
54401.0,6,14,4740,7,653,8419.166666666666,249.0,93.28571428571428,7,4087,8226.666666666666,1514.0,583.8571428571429
242769.0,6,3,337,2,214,0.0,160.0,107.0,1,123,0.0,123.0,123.0
111039260.0,6,31,2166,16,1149,7388228.866666666,123.0,71.8125,15,1017,7915958.214285715,123.0,67.8
90060200.0,17,27,12943,27,12943,3463853.846153846,501.0,479.3703703703704,0,0,0.0,0.0,0.0
43719.0,6,10,2032,5,524,10638.75,252.0,104.8,5,1508,9043.5,1236.0,301.6
311779.0,6,6,412,4,272,103926.33333333331,74.0,68.0,2,140,0.0,74.0,70.0
205775.0,17,4,6056,4,6056,68591.66666666667,1514.0,1514.0,0,0,0.0,0.0,0.0
39930.0,6,10,2032,5,524,9753.0,252.0,104.8,5,1508,8143.5,1236.0,301.6
142239.0,6,2,132,1,66,0.0,66.0,66.0,1,66,0.0,66.0,66.0
33307572.0,6,26,7627,14,3735,204840.92307692303,1514.0,266.7857142857143,12,3892,3008311.272727273,1514.0,324.3333333333333
108107484.0,17,5,1005,5,1005,27026871.0,201.0,201.0,0,0,0.0,0.0,0.0
310259.0,17,4,1400,4,1400,103419.66666666669,350.0,350.0,0,0,0.0,0.0,0.0
104890446.0,17,15,5130,15,5130,7492174.714285715,342.0,342.0,0,0,0.0,0.0,0.0
2309.0,17,4,344,2,150,0.0,75.0,75.0,2,194,0.0,103.0,97.0
298209.0,6,6,412,4,272,99403.0,74.0,68.0,2,140,0.0,74.0,70.0
90194764.0,6,34,3875,16,1698,5998581.533333333,337.0,106.125,18,2177,5292867.470588235,427.0,120.94444444444444
30727.0,6,14,4740,7,653,4968.833333333333,249.0,93.28571428571428,7,4087,4638.666666666667,1514.0,583.8571428571429
90039377.0,17,28,13364,28,13364,3334791.7407407407,501.0,477.2857142857143,0,0,0.0,0.0,0.0
163311.0,6,11,2098,6,590,31117.2,252.0,98.33333333333331,5,1508,37338.5,1236.0,301.6
314.0,17,2,174,1,79,0.0,79.0,79.0,1,95,0.0,95.0,95.0
41424.0,6,10,2032,5,524,10119.75,252.0,104.8,5,1508,9111.0,1236.0,301.6
2353.0,17,4,344,2,150,0.0,75.0,75.0,2,194,0.0,103.0,97.0
200159.0,17,2,762,2,762,0.0,381.0,381.0,0,0,0.0,0.0,0.0
104072.0,17,2,286,2,286,0.0,143.0,143.0,0,0,0.0,0.0,0.0
252621.0,6,10,1221,6,636,50524.2,298.0,106.0,4,585,77576.0,379.0,146.25
16226.0,6,14,4740,7,653,2278.333333333333,249.0,93.28571428571428,7,4087,2515.0,1514.0,583.8571428571429
135131627.0,17,6,1206,6,1206,27026325.4,201.0,201.0,0,0,0.0,0.0,0.0
226787.0,6,4,492,2,280,0.0,214.0,140.0,2,212,0.0,146.0,106.0
90030922.0,17,28,13364,28,13364,3334478.592592593,501.0,477.2857142857143,0,0,0.0,0.0,0.0
49485.0,6,10,2032,5,524,11017.25,252.0,104.8,5,1508,10766.0,1236.0,301.6
108101919.0,17,5,955,5,955,27025479.75,191.0,191.0,0,0,0.0,0.0,0.0
0.0,17,1,381,1,381,0.0,381.0,381.0,0,0,0.0,0.0,0.0
0.0,17,1,55,1,55,0.0,55.0,55.0,0,0,0.0,0.0,0.0
36470.0,6,14,4740,7,653,5960.333333333333,249.0,93.28571428571428,7,4087,5800.666666666667,1514.0,583.8571428571429
107831858.0,6,28,1860,14,966,8294758.307692308,123.0,69.0,14,894,8278100.461538462,123.0,63.85714285714285
53541.0,6,14,4740,7,653,8509.166666666666,249.0,93.28571428571428,7,4087,7930.833333333333,1514.0,583.8571428571429
107709132.0,6,44,2904,22,1452,5129006.285714285,66.0,66.0,22,1452,4981616.238095238,66.0,66.0
147030.0,6,3,373,2,238,0.0,172.0,119.0,1,135,0.0,135.0,135.0
10513517.0,6,7,478,4,272,3458799.0,74.0,68.0,3,206,5182970.0,74.0,68.66666666666667
90020198.0,17,28,13364,28,13364,3334081.407407407,501.0,477.2857142857143,0,0,0.0,0.0,0.0
105080852.0,17,14,864,7,432,17500896.833333332,174.0,61.71428571428572,7,432,17500158.0,174.0,61.71428571428572
20445.0,6,14,4740,7,653,3026.333333333333,249.0,93.28571428571428,7,4087,3215.833333333333,1514.0,583.8571428571429
90014925.0,17,28,13364,28,13364,3333886.111111111,501.0,477.2857142857143,0,0,0.0,0.0,0.0
317021.0,17,4,1400,4,1400,105673.66666666669,350.0,350.0,0,0,0.0,0.0,0.0
107029.0,17,2,286,2,286,0.0,143.0,143.0,0,0,0.0,0.0,0.0
66758.0,6,14,4740,7,653,10949.833333333334,249.0,93.28571428571428,7,4087,9157.833333333334,1514.0,583.8571428571429
90279610.0,6,14,2240,8,1016,12897087.142857144,188.0,127.0,6,1224,18023419.6,204.0,204.0
467425.0,6,3,1604,1,753,0.0,753.0,753.0,2,851,0.0,785.0,425.5
108107893.0,17,5,955,5,955,27026973.25,191.0,191.0,0,0,0.0,0.0,0.0
90293151.0,6,16,1192,8,596,12892892.142857144,95.0,74.5,8,596,12898369.42857143,95.0,74.5
112464262.0,6,46,3036,23,1518,5111998.090909091,66.0,66.0,23,1518,5111999.954545454,66.0,66.0
39833.0,6,14,4740,7,653,6192.833333333333,249.0,93.28571428571428,7,4087,6325.333333333333,1514.0,583.8571428571429
120003792.0,6,18,1341,9,691,14999988.25,95.0,76.77777777777777,9,650,14999927.375,95.0,72.22222222222223
25217.0,6,20,7606,11,978,2521.7,310.0,88.9090909090909,9,6628,2663.875,1514.0,736.4444444444445
153097.0,6,3,337,2,214,0.0,160.0,107.0,1,123,0.0,123.0,123.0
115449180.0,6,56,4926,31,2679,3848306.0,123.0,86.41935483870968,25,2247,4801753.458333333,123.0,89.88
90045871.0,17,28,13364,28,13364,3335032.25925926,501.0,477.2857142857143,0,0,0.0,0.0,0.0
419.0,17,2,410,1,78,0.0,78.0,78.0,1,332,0.0,332.0,332.0
9887.0,17,2,571,1,86,0.0,86.0,86.0,1,485,0.0,485.0,485.0
2593215.0,6,2,132,1,66,0.0,66.0,66.0,1,66,0.0,66.0,66.0
234258.0,6,3,373,2,238,0.0,172.0,119.0,1,135,0.0,135.0,135.0
126157064.0,17,14,864,7,432,17833515.0,174.0,61.71428571428572,7,432,17836988.333333332,174.0,61.71428571428572
104033.0,17,2,286,2,286,0.0,143.0,143.0,0,0,0.0,0.0,0.0
90038125.0,17,28,13364,28,13364,3334745.3703703703,501.0,477.2857142857143,0,0,0.0,0.0,0.0
134667.0,6,2,132,1,66,0.0,66.0,66.0,1,66,0.0,66.0,66.0
2793607.0,6,2,132,1,66,0.0,66.0,66.0,1,66,0.0,66.0,66.0
108106495.0,17,5,1005,5,1005,27026623.75,201.0,201.0,0,0,0.0,0.0,0.0
755265.0,6,11,1190,6,608,151053.0,222.0,101.33333333333331,5,582,124645.25,206.0,116.4
34372.0,6,10,2032,5,524,8313.0,252.0,104.8,5,1508,8078.25,1236.0,301.6
149571.0,6,3,373,2,238,0.0,172.0,119.0,1,135,0.0,135.0,135.0
282.0,17,2,174,1,79,0.0,79.0,79.0,1,95,0.0,95.0,95.0
3014649.0,6,3,1604,1,753,0.0,753.0,753.0,2,851,0.0,785.0,425.5
20487.0,6,14,4740,7,653,3261.333333333333,249.0,93.28571428571428,7,4087,3222.5,1514.0,583.8571428571429
147049.0,6,3,337,2,214,0.0,160.0,107.0,1,123,0.0,123.0,123.0
303183.0,6,2,132,1,66,0.0,66.0,66.0,1,66,0.0,66.0,66.0
90296759.0,6,17,1287,9,691,11280925.125,95.0,76.77777777777777,8,596,12766559.285714284,95.0,74.5
248034.0,6,3,337,2,214,0.0,160.0,107.0,1,123,0.0,123.0,123.0
10473758.0,6,7,478,4,272,3445672.333333333,74.0,68.0,3,206,5168441.5,74.0,68.66666666666667
17602.0,17,2,582,1,83,0.0,83.0,83.0,1,499,0.0,499.0,499.0
90751818.0,6,22,1680,12,894,8245872.181818182,95.0,74.5,10,786,10082160.666666666,95.0,78.6
216350.0,17,2,180,1,90,0.0,90.0,90.0,1,90,0.0,90.0,90.0
749.0,17,2,762,2,762,0.0,381.0,381.0,0,0,0.0,0.0,0.0
233179.0,6,3,373,2,238,0.0,172.0,119.0,1,135,0.0,135.0,135.0
108111901.0,17,5,955,5,955,27027975.25,191.0,191.0,0,0,0.0,0.0,0.0
81.0,17,2,762,2,762,0.0,381.0,381.0,0,0,0.0,0.0,0.0
377.0,17,2,174,1,79,0.0,79.0,79.0,1,95,0.0,95.0,95.0
104003.0,17,2,286,2,286,0.0,143.0,143.0,0,0,0.0,0.0,0.0
326757.0,6,10,1221,6,636,65351.4,298.0,106.0,4,585,103526.33333333331,379.0,146.25
112134648.0,17,14,864,7,432,18666876.83333333,174.0,61.71428571428572,7,432,18668109.166666668,174.0,61.71428571428572
634797.0,17,2,346,1,78,0.0,78.0,78.0,1,268,0.0,268.0,268.0
621811.0,17,2,333,1,87,0.0,87.0,87.0,1,246,0.0,246.0,246.0
204456.0,17,2,180,1,90,0.0,90.0,90.0,1,90,0.0,90.0,90.0
108100585.0,17,5,955,5,955,27025146.25,191.0,191.0,0,0,0.0,0.0,0.0
135134620.0,17,6,1206,6,1206,27026924.0,201.0,201.0,0,0,0.0,0.0,0.0
32160.0,6,14,4740,7,653,4223.333333333333,249.0,93.28571428571428,7,4087,4971.5,1514.0,583.8571428571429
431.0,17,2,410,1,78,0.0,78.0,78.0,1,332,0.0,332.0,332.0
25272.0,6,14,4740,7,653,3725.5,249.0,93.28571428571428,7,4087,3879.0,1514.0,583.8571428571429
265428.0,6,10,1221,6,636,53085.6,298.0,106.0,4,585,87632.0,379.0,146.25
306929.0,6,3,202,2,128,0.0,74.0,64.0,1,74,0.0,74.0,74.0
153519.0,17,2,180,1,90,0.0,90.0,90.0,1,90,0.0,90.0,90.0
107415.0,17,2,286,2,286,0.0,143.0,143.0,0,0,0.0,0.0,0.0
246043.0,6,3,337,2,214,0.0,160.0,107.0,1,123,0.0,123.0,123.0
27706.0,6,10,2032,5,524,6467.0,252.0,104.8,5,1508,6631.25,1236.0,301.6
1061149.0,6,3,1604,1,753,0.0,753.0,753.0,2,851,0.0,785.0,425.5
108316536.0,6,512,63066,256,17118,424653.16078431375,140.0,66.8671875,256,45948,424668.6156862745,300.0,179.484375
130345.0,6,3,337,2,214,0.0,160.0,107.0,1,123,0.0,123.0,123.0
845757.0,6,9,1267,6,796,169151.4,458.0,132.66666666666666,3,471,286614.5,331.0,157.0
2799807.0,6,2,132,1,66,0.0,66.0,66.0,1,66,0.0,66.0,66.0
10467477.0,6,7,478,4,272,3443792.333333333,74.0,68.0,3,206,5165570.0,74.0,68.66666666666667
120115727.0,6,13,2020,9,1204,15014465.875,188.0,133.77777777777777,4,816,30028049.0,204.0,204.0
163369.0,6,10,2032,5,524,40607.0,252.0,104.8,5,1508,25037.25,1236.0,301.6
108109403.0,17,5,1005,5,1005,27027350.75,201.0,201.0,0,0,0.0,0.0,0.0
108106530.0,17,5,1005,5,1005,27026632.5,201.0,201.0,0,0,0.0,0.0,0.0
118946430.0,6,36,2596,18,1348,6984142.764705882,139.0,74.88888888888889,18,1248,6984142.352941177,123.0,69.33333333333333
0.0,6,1,54,0,0,0.0,0.0,0.0,1,54,0.0,54.0,54.0
20201.0,17,2,498,1,80,0.0,80.0,80.0,1,418,0.0,418.0,418.0
307185.0,6,6,412,4,272,102395.0,74.0,68.0,2,140,0.0,74.0,70.0
90256081.0,6,14,2240,8,1016,12893725.857142856,188.0,127.0,6,1224,18019004.0,204.0,204.0
33609.0,6,10,1065,5,534,6784.75,262.0,106.8,5,531,7915.5,259.0,106.2
90031919.0,17,27,12943,27,12943,3462766.1153846155,501.0,479.3703703703704,0,0,0.0,0.0,0.0
1089642.0,6,13,1386,7,789,181607.0,253.0,112.71428571428572,6,597,215131.6,259.0,99.5
98646497.0,6,30,2106,15,1089,7046178.357142857,123.0,72.6,15,1017,7030742.214285715,123.0,67.8
135131679.0,17,6,1206,6,1206,27026335.8,201.0,201.0,0,0,0.0,0.0,0.0
257884.0,6,3,337,2,214,0.0,160.0,107.0,1,123,0.0,123.0,123.0
99396472.0,17,14,1126,7,563,16501046.5,174.0,80.42857142857143,7,563,16500156.833333334,174.0,80.42857142857143
35353.0,6,10,2032,5,524,8574.0,252.0,104.8,5,1508,8007.75,1236.0,301.6
156998.0,6,3,337,2,214,0.0,160.0,107.0,1,123,0.0,123.0,123.0
117333043.0,6,207,23392,104,7172,1139155.7572815537,140.0,68.96153846153847,103,16220,1140199.0098039217,284.0,157.4757281553398
15509.0,6,14,4740,7,653,2391.833333333333,249.0,93.28571428571428,7,4087,2381.0,1514.0,583.8571428571429
2002417.0,17,4,525,2,150,0.0,75.0,75.0,2,375,0.0,284.0,187.5
211543.0,6,3,426,2,280,0.0,214.0,140.0,1,146,0.0,146.0,146.0
47528.0,6,14,4740,7,653,7389.0,249.0,93.28571428571428,7,4087,5629.333333333333,1514.0,583.8571428571429
153437.0,17,2,180,1,90,0.0,90.0,90.0,1,90,0.0,90.0,90.0
304350.0,6,3,202,2,128,0.0,74.0,64.0,1,74,0.0,74.0,74.0
46495.0,6,14,4740,7,653,7074.5,249.0,93.28571428571428,7,4087,7036.0,1514.0,583.8571428571429
3007238.0,6,11,2106,6,598,601150.8,252.0,99.66666666666669,5,1508,1875.25,1236.0,301.6
118310163.0,6,48,3168,24,1584,5143920.130434782,66.0,66.0,24,1584,4956800.043478261,66.0,66.0
4194.0,17,2,598,1,72,0.0,72.0,72.0,1,526,0.0,526.0,526.0
93523969.0,6,43,3808,25,2146,3896832.0416666665,139.0,85.84,18,1662,5489242.05882353,123.0,92.33333333333331
108106481.0,17,5,955,5,955,27026620.25,191.0,191.0,0,0,0.0,0.0,0.0
108109235.0,17,5,955,5,955,27027308.75,191.0,191.0,0,0,0.0,0.0,0.0
8990.0,17,2,684,2,684,0.0,342.0,342.0,0,0,0.0,0.0,0.0
10456352.0,6,6,412,3,206,5160306.5,74.0,68.66666666666667,3,206,5160184.0,74.0,68.66666666666667
891215.0,6,12,2718,7,743,148535.83333333334,339.0,106.14285714285714,5,1975,153911.5,1514.0,395.0
33139.0,6,14,4740,7,653,5083.333333333333,249.0,93.28571428571428,7,4087,5299.666666666667,1514.0,583.8571428571429
117755677.0,6,48,3168,24,1584,5119812.043478261,66.0,66.0,24,1584,5106544.565217392,66.0,66.0
108124779.0,17,5,1005,5,1005,27031194.75,201.0,201.0,0,0,0.0,0.0,0.0
20379.0,6,14,4740,7,653,3241.5,249.0,93.28571428571428,7,4087,3067.5,1514.0,583.8571428571429
90253290.0,6,13,2036,8,1016,12893327.142857144,188.0,127.0,5,1020,22522020.5,204.0,204.0
46431.0,6,10,2032,5,524,10989.75,252.0,104.8,5,1508,8994.25,1236.0,301.6
160507.0,6,3,337,2,214,0.0,160.0,107.0,1,123,0.0,123.0,123.0
1043743.0,6,11,1134,6,558,208748.6,220.0,93.0,5,576,259099.5,304.0,115.2
121421982.0,17,14,864,7,432,17000175.666666668,174.0,61.71428571428572,7,432,17000883.833333332,174.0,61.71428571428572
142122.0,17,4,571,2,148,0.0,74.0,74.0,2,423,0.0,280.0,211.5
216691.0,17,2,180,1,90,0.0,90.0,90.0,1,90,0.0,90.0,90.0
108106056.0,17,5,955,5,955,27026514.0,191.0,191.0,0,0,0.0,0.0,0.0
353.0,17,2,267,1,83,0.0,83.0,83.0,1,184,0.0,184.0,184.0
120322319.0,6,219,24818,110,17328,1103874.486238532,284.0,157.52727272727273,109,7490,1094836.7685185184,140.0,68.71559633027523
121073589.0,6,33,2359,17,1288,7567099.3125,139.0,75.76470588235294,16,1071,7713994.066666666,123.0,66.9375
306556.0,6,6,412,4,272,102185.33333333331,74.0,68.0,2,140,0.0,74.0,70.0
502032.00000000006,6,5,336,2,134,0.0,68.0,67.0,3,202,192152.5,70.0,67.33333333333333
13628133.0,6,20,1607,10,975,1479547.3333333333,315.0,97.5,10,632,1479517.111111111,78.0,63.2
21921.0,6,13,4515,6,512,4238.2,230.0,85.33333333333333,7,4003,3487.5,1514.0,571.8571428571429
4524.0,17,2,614,1,72,0.0,72.0,72.0,1,542,0.0,542.0,542.0
891.0,17,5,550,5,550,222.75,110.0,110.0,0,0,0.0,0.0,0.0
3047561.0,6,5,336,3,202,1523780.5,70.0,67.33333333333333,2,134,0.0,68.0,67.0
90938033.0,6,21,1585,11,840,9093350.3,95.0,76.36363636363636,10,745,10103654.777777778,95.0,74.5
220961.0,17,2,180,1,90,0.0,90.0,90.0,1,90,0.0,90.0,90.0
90101327.0,6,10,1440,7,828,15016887.833333334,188.0,118.28571428571428,3,612,30037533.5,204.0,204.0
5631754.0,6,5,336,2,134,0.0,68.0,67.0,3,202,1528022.5,70.0,67.33333333333333
153555.0,17,2,180,1,90,0.0,90.0,90.0,1,90,0.0,90.0,90.0
49411.0,17,3,1143,3,1143,24705.5,381.0,381.0,0,0,0.0,0.0,0.0
3007070.0,6,11,2106,6,598,601126.2,252.0,99.66666666666669,5,1508,1827.0,1236.0,301.6
296604.0,6,6,412,4,272,98868.0,74.0,68.0,2,140,0.0,74.0,70.0
48238.0,6,14,4740,7,653,7596.5,249.0,93.28571428571428,7,4087,7231.166666666667,1514.0,583.8571428571429
33576.0,6,10,2032,5,524,8142.0,252.0,104.8,5,1508,7834.0,1236.0,301.6
301573.0,6,6,412,4,272,100524.33333333331,74.0,68.0,2,140,0.0,74.0,70.0
45123.0,6,14,4740,7,653,7181.0,249.0,93.28571428571428,7,4087,6953.833333333333,1514.0,583.8571428571429
243842.0,6,3,337,2,214,0.0,160.0,107.0,1,123,0.0,123.0,123.0
51275.0,17,2,180,1,90,0.0,90.0,90.0,1,90,0.0,90.0,90.0
218002.0,6,4,492,2,280,0.0,214.0,140.0,2,212,0.0,146.0,106.0
35718.0,6,2,145,2,145,0.0,91.0,72.5,0,0,0.0,0.0,0.0
0.0,6,1,66,1,66,0.0,66.0,66.0,0,0,0.0,0.0,0.0
204920.0,17,2,762,2,762,0.0,381.0,381.0,0,0,0.0,0.0,0.0
91026295.0,17,12,778,6,389,18200786.2,174.0,64.83333333333333,6,389,18200224.4,174.0,64.83333333333333
228385.0,17,2,180,1,90,0.0,90.0,90.0,1,90,0.0,90.0,90.0
90055937.0,17,28,13364,28,13364,3335405.074074074,501.0,477.2857142857143,0,0,0.0,0.0,0.0
306243.0,6,6,412,4,272,102081.0,74.0,68.0,2,140,0.0,74.0,70.0
318.0,17,2,174,1,79,0.0,79.0,79.0,1,95,0.0,95.0,95.0
21487.0,17,2,582,1,83,0.0,83.0,83.0,1,499,0.0,499.0,499.0
3173138.0,6,18,1495,9,921,358261.5,315.0,102.33333333333331,9,574,358288.125,78.0,63.77777777777778
106002.0,17,2,286,2,286,0.0,143.0,143.0,0,0,0.0,0.0,0.0
2292.0,17,4,344,2,150,0.0,75.0,75.0,2,194,0.0,103.0,97.0
37741.0,6,14,4740,7,653,6077.666666666667,249.0,93.28571428571428,7,4087,5278.0,1514.0,583.8571428571429
135129301.0,17,6,1206,6,1206,27025860.2,201.0,201.0,0,0,0.0,0.0,0.0
1019353.0,6,11,1134,6,558,203870.6,220.0,93.0,5,576,254286.25,304.0,115.2
51026.0,17,2,180,1,90,0.0,90.0,90.0,1,90,0.0,90.0,90.0
877831.0,6,12,2718,7,743,146305.16666666666,339.0,106.14285714285714,5,1975,150555.5,1514.0,395.0
29482.0,6,14,4740,7,653,4740.166666666667,249.0,93.28571428571428,7,4087,4781.666666666667,1514.0,583.8571428571429
31670.0,6,14,4740,7,653,4722.833333333333,249.0,93.28571428571428,7,4087,4359.333333333333,1514.0,583.8571428571429
886.0,17,4,438,2,148,0.0,74.0,74.0,2,290,0.0,147.0,145.0
114757597.0,6,34,2334,17,1209,7158860.0625,123.0,71.11764705882354,17,1125,7158860.0625,123.0,66.17647058823529
120126660.0,6,14,2224,9,1204,15015832.5,188.0,133.77777777777777,5,1020,22524369.25,204.0,204.0
113747630.0,6,38,2842,19,1471,6307321.055555556,139.0,77.42105263157895,19,1371,6307318.444444444,123.0,72.15789473684211
2044.0,17,2,180,1,90,0.0,90.0,90.0,1,90,0.0,90.0,90.0
282020.0,6,10,1221,6,636,56404.0,298.0,106.0,4,585,88572.33333333333,379.0,146.25
207190.0,6,3,426,2,280,0.0,214.0,140.0,1,146,0.0,146.0,146.0
10512434.0,6,7,478,4,272,3458825.0,74.0,68.0,3,206,5188122.5,74.0,68.66666666666667
113869.0,17,4,1400,4,1400,37956.333333333336,350.0,350.0,0,0,0.0,0.0,0.0
358.0,17,2,160,1,80,0.0,80.0,80.0,1,80,0.0,80.0,80.0
36044.0,6,12,1320,6,723,5952.0,253.0,120.5,6,597,5835.6,259.0,99.5
2431.0,17,4,344,2,150,0.0,75.0,75.0,2,194,0.0,103.0,97.0
115662498.0,6,48,3168,24,1584,5028804.260869565,66.0,66.0,24,1584,5019407.304347826,66.0,66.0
28690.0,17,2,582,1,83,0.0,83.0,83.0,1,499,0.0,499.0,499.0
532.0,17,2,180,1,82,0.0,82.0,82.0,1,98,0.0,98.0,98.0
135143958.0,17,6,1206,6,1206,27028791.6,201.0,201.0,0,0,0.0,0.0,0.0
2045.0,17,4,344,2,150,0.0,75.0,75.0,2,194,0.0,103.0,97.0
39676.0,6,14,4740,7,653,6487.5,249.0,93.28571428571428,7,4087,6256.833333333333,1514.0,583.8571428571429
2440.0,17,4,344,2,150,0.0,75.0,75.0,2,194,0.0,103.0,97.0
0.0,17,1,381,1,381,0.0,381.0,381.0,0,0,0.0,0.0,0.0
123456212.0,6,49,3234,25,1650,5144008.833333333,66.0,66.0,24,1584,4958525.217391305,66.0,66.0
135129444.0,17,6,1206,6,1206,27025888.8,201.0,201.0,0,0,0.0,0.0,0.0
153623.0,17,2,180,1,90,0.0,90.0,90.0,1,90,0.0,90.0,90.0
786.0,17,4,438,2,148,0.0,74.0,74.0,2,290,0.0,147.0,145.0
2591574.0,6,2,132,1,66,0.0,66.0,66.0,1,66,0.0,66.0,66.0
44010772.0,6,6,1808,4,987,14670257.333333334,785.0,246.75,2,821,0.0,753.0,410.5
107424.0,17,2,286,2,286,0.0,143.0,143.0,0,0,0.0,0.0,0.0
626.0,17,2,762,2,762,0.0,381.0,381.0,0,0,0.0,0.0,0.0
90334914.0,6,16,1192,8,596,12870513.42857143,95.0,74.5,8,596,12875755.285714284,95.0,74.5
103971.0,17,2,286,2,286,0.0,143.0,143.0,0,0,0.0,0.0,0.0
12983.0,6,12,1393,6,796,2457.2,271.0,132.66666666666666,6,597,2326.4,259.0,99.5
4308.0,17,4,344,2,150,0.0,75.0,75.0,2,194,0.0,103.0,97.0
2351408.0,6,49,23728,25,19797,97975.33333333331,1514.0,791.88,24,3931,92564.43478260867,1514.0,163.79166666666666
101320446.0,17,14,1126,7,563,16834751.166666668,174.0,80.42857142857143,7,563,16833488.166666668,174.0,80.42857142857143
90783836.0,6,181,20488,91,14400,1008709.2888888888,284.0,158.24175824175825,90,6088,1008321.5168539326,140.0,67.64444444444445
120057134.0,17,28,13364,28,13364,4446560.518518519,501.0,477.2857142857143,0,0,0.0,0.0,0.0
14979.0,17,2,180,1,90,0.0,90.0,90.0,1,90,0.0,90.0,90.0
90307061.0,6,19,1436,10,745,10028423.666666666,95.0,74.5,9,691,11287491.75,95.0,76.77777777777777
109544724.0,17,13,821,7,432,18001264.0,174.0,61.71428571428572,6,389,18000160.8,174.0,64.83333333333333
25862.0,6,10,2032,5,524,6129.75,252.0,104.8,5,1508,6189.25,1236.0,301.6
120139296.0,6,13,2020,9,1204,15017412.0,188.0,133.77777777777777,4,816,30031781.666666668,204.0,204.0
9691.0,6,10,2032,5,524,2177.5,252.0,104.8,5,1508,1726.0,1236.0,301.6
2807061.0,6,2,132,1,66,0.0,66.0,66.0,1,66,0.0,66.0,66.0
5622046.0,6,4,270,2,134,0.0,68.0,67.0,2,136,0.0,70.0,68.0
51675.0,6,14,4740,7,653,7564.166666666667,249.0,93.28571428571428,7,4087,6728.833333333333,1514.0,583.8571428571429
107850448.0,6,28,1860,14,966,8279512.615384615,123.0,69.0,14,894,8279556.692307692,123.0,63.85714285714285
38879.0,6,10,2032,5,524,5946.0,252.0,104.8,5,1508,8836.25,1236.0,301.6
90255032.0,6,13,2036,8,1016,12893576.0,188.0,127.0,5,1020,22523200.5,204.0,204.0
36648.0,6,14,4740,7,653,5990.0,249.0,93.28571428571428,7,4087,5694.5,1514.0,583.8571428571429
53044.0,6,14,4740,7,653,8717.0,249.0,93.28571428571428,7,4087,8236.166666666666,1514.0,583.8571428571429
120123427.0,6,14,2240,6,1224,24024685.4,204.0,204.0,8,1016,17136853.714285713,188.0,127.0
306237.0,6,6,412,4,272,102079.0,74.0,68.0,2,140,0.0,74.0,70.0
90068293.0,17,28,13364,28,13364,3335862.703703704,501.0,477.2857142857143,0,0,0.0,0.0,0.0
14635707.0,6,20,1607,10,975,1592421.2222222222,315.0,97.5,10,632,1592386.888888889,78.0,63.2
39216.0,6,14,4740,7,653,5581.666666666667,249.0,93.28571428571428,7,4087,6087.333333333333,1514.0,583.8571428571429
153452.0,17,2,180,1,90,0.0,90.0,90.0,1,90,0.0,90.0,90.0
100303.0,17,2,762,2,762,0.0,381.0,381.0,0,0,0.0,0.0,0.0
305008.0,6,6,412,4,272,101669.33333333331,74.0,68.0,2,140,0.0,74.0,70.0
16905.0,6,10,2032,5,524,3785.0,252.0,104.8,5,1508,4059.75,1236.0,301.6
245524.0,6,3,337,2,214,0.0,160.0,107.0,1,123,0.0,123.0,123.0
2465.0,17,4,344,2,150,0.0,75.0,75.0,2,194,0.0,103.0,97.0
850504.0,6,9,1268,6,797,170100.8,459.0,132.83333333333334,3,471,288897.5,331.0,157.0
102740038.0,6,44,2904,22,1452,4892382.761904762,66.0,66.0,22,1452,4882086.428571428,66.0,66.0
59208.0,6,14,4740,7,653,9690.5,249.0,93.28571428571428,7,4087,9557.5,1514.0,583.8571428571429
0.0,6,1,54,0,0,0.0,0.0,0.0,1,54,0.0,54.0,54.0
128861557.0,6,35,2394,18,1269,7580091.588235294,123.0,70.5,17,1125,7416330.25,123.0,66.17647058823529
135120077.0,17,6,1206,6,1206,27024015.4,201.0,201.0,0,0,0.0,0.0,0.0
90529253.0,6,15,2444,8,1016,12932750.42857143,188.0,127.0,7,1428,15060736.833333334,204.0,204.0
16271.0,17,2,582,1,83,0.0,83.0,83.0,1,499,0.0,499.0,499.0
197091.0,17,2,180,1,90,0.0,90.0,90.0,1,90,0.0,90.0,90.0
107209997.0,17,14,1126,7,563,17841648.5,174.0,80.42857142857143,7,563,17841651.5,174.0,80.42857142857143
320075.0,17,4,1400,4,1400,106691.66666666669,350.0,350.0,0,0,0.0,0.0,0.0
788.0,17,5,550,5,550,197.0,110.0,110.0,0,0,0.0,0.0,0.0
90283346.0,6,16,2368,9,1204,11285418.25,188.0,133.77777777777777,7,1164,15019371.666666666,204.0,166.28571428571428
2610.0,17,4,344,2,150,0.0,75.0,75.0,2,194,0.0,103.0,97.0
118921716.0,6,34,2334,17,1209,7419117.0625,123.0,71.11764705882354,17,1125,7419113.8125,123.0,66.17647058823529
61406.0,6,12,1328,7,797,10234.333333333334,253.0,113.85714285714286,5,531,8611.25,259.0,106.2
865.0,17,4,438,2,148,0.0,74.0,74.0,2,290,0.0,147.0,145.0
39312.0,6,10,2032,5,524,9596.0,252.0,104.8,5,1508,9668.5,1236.0,301.6
217837.0,6,3,426,2,280,0.0,214.0,140.0,1,146,0.0,146.0,146.0
228522.0,17,2,180,1,90,0.0,90.0,90.0,1,90,0.0,90.0,90.0
9986.0,6,11,1132,6,556,1826.0,218.0,92.66666666666669,5,576,2299.0,304.0,115.2
57763678.0,6,14,982,6,437,11551177.8,95.0,72.83333333333333,8,545,8250572.0,95.0,68.125
50905.0,17,2,180,1,90,0.0,90.0,90.0,1,90,0.0,90.0,90.0
135130387.0,17,6,1206,6,1206,27026077.4,201.0,201.0,0,0,0.0,0.0,0.0
227404.0,6,3,426,2,280,0.0,214.0,140.0,1,146,0.0,146.0,146.0
46705.0,6,14,4740,7,653,7221.833333333333,249.0,93.28571428571428,7,4087,6510.333333333333,1514.0,583.8571428571429
141210.0,6,2,132,1,66,0.0,66.0,66.0,1,66,0.0,66.0,66.0
25982.0,6,14,4740,7,653,3825.0,249.0,93.28571428571428,7,4087,4195.5,1514.0,583.8571428571429
43509.0,6,14,4740,7,653,7139.5,249.0,93.28571428571428,7,4087,7109.166666666667,1514.0,583.8571428571429
51157.0,6,14,4740,7,653,7886.666666666667,249.0,93.28571428571428,7,4087,7091.0,1514.0,583.8571428571429
33263.0,6,11,2098,6,590,6652.6,252.0,98.33333333333331,5,1508,6736.0,1236.0,301.6
323148.0,17,4,1400,4,1400,107716.0,350.0,350.0,0,0,0.0,0.0,0.0
10426147.0,6,6,412,3,206,5143023.5,74.0,68.66666666666667,3,206,5142941.5,74.0,68.66666666666667
108101885.0,17,5,955,5,955,27025471.25,191.0,191.0,0,0,0.0,0.0,0.0
27156.0,6,10,2032,5,524,3418.5,252.0,104.8,5,1508,6154.0,1236.0,301.6
90278.0,6,20,8915,11,877,9027.8,209.0,79.72727272727273,9,8038,10600.625,1514.0,893.1111111111111
13378.0,6,14,4740,7,653,2046.3333333333333,249.0,93.28571428571428,7,4087,2095.5,1514.0,583.8571428571429
508542.00000000006,6,5,336,2,134,0.0,68.0,67.0,3,202,194634.0,70.0,67.33333333333333
74137.0,6,14,4740,7,653,11805.166666666666,249.0,93.28571428571428,7,4087,12119.833333333334,1514.0,583.8571428571429
108112234.0,17,5,1005,5,1005,27028058.5,201.0,201.0,0,0,0.0,0.0,0.0
272858.0,6,10,1221,6,636,54571.6,298.0,106.0,4,585,85574.33333333333,379.0,146.25
108109228.0,17,5,1005,5,1005,27027307.0,201.0,201.0,0,0,0.0,0.0,0.0
119549383.0,6,40,3094,21,1654,5977469.15,139.0,78.76190476190476,19,1440,6629036.0,123.0,75.78947368421052
1296924.0,6,4,264,2,132,0.0,66.0,66.0,2,132,0.0,66.0,66.0
153542.0,17,2,180,1,90,0.0,90.0,90.0,1,90,0.0,90.0,90.0
118512329.0,6,453,56298,227,15204,524390.8362831859,140.0,66.97797356828194,226,41094,522101.7333333333,336.0,181.83185840707964
895.0,17,5,550,5,550,223.75,110.0,110.0,0,0,0.0,0.0,0.0
1306975.0,6,4,264,2,132,0.0,66.0,66.0,2,132,0.0,66.0,66.0
32541.0,6,14,4740,7,653,5043.0,249.0,93.28571428571428,7,4087,5058.333333333333,1514.0,583.8571428571429
26689.0,6,14,4740,7,653,4131.666666666667,249.0,93.28571428571428,7,4087,4232.333333333333,1514.0,583.8571428571429
0.0,6,1,66,1,66,0.0,66.0,66.0,0,0,0.0,0.0,0.0
2116861.0,6,19,6869,10,1501,235206.7777777777,408.0,150.1,9,5368,221760.875,1514.0,596.4444444444445
90535.0,6,10,2032,5,524,22296.25,252.0,104.8,5,1508,19587.25,1236.0,301.6
97854682.0,6,313,38994,157,28476,627273.6025641026,284.0,181.375796178344,156,10518,624624.1806451613,140.0,67.42307692307692
246158.0,6,3,337,2,214,0.0,160.0,107.0,1,123,0.0,123.0,123.0
7689101.0,6,5,1734,2,818,0.0,752.0,409.0,3,916,2447718.5,784.0,305.3333333333333
38524.0,6,10,2032,5,524,9067.0,252.0,104.8,5,1508,7473.0,1236.0,301.6
10476705.0,6,6,412,3,206,5169980.5,74.0,68.66666666666667,3,206,5169892.5,74.0,68.66666666666667
108105701.0,17,5,1005,5,1005,27026425.25,201.0,201.0,0,0,0.0,0.0,0.0
113168403.0,6,46,3036,23,1518,5144005.909090909,66.0,66.0,23,1518,5144007.136363637,66.0,66.0
30138.0,6,10,2032,5,524,6804.75,252.0,104.8,5,1508,6323.5,1236.0,301.6
146654.0,6,3,373,2,238,0.0,172.0,119.0,1,135,0.0,135.0,135.0
112630.0,17,4,1400,4,1400,37543.333333333336,350.0,350.0,0,0,0.0,0.0,0.0
161158.0,6,2,128,1,74,0.0,74.0,74.0,1,54,0.0,54.0,54.0
90010724.0,17,27,12943,27,12943,3461950.923076923,501.0,479.3703703703704,0,0,0.0,0.0,0.0
121395474.0,6,227,25718,114,18026,1074296.2300884956,284.0,158.12280701754386,113,7692,1066307.955357143,140.0,68.070796460177
135127211.0,17,6,1206,6,1206,27025442.2,201.0,201.0,0,0,0.0,0.0,0.0
2589903.0,6,3,1777,2,951,0.0,885.0,475.5,1,826,0.0,826.0,826.0
335668.0,6,3,1604,1,753,0.0,753.0,753.0,2,851,0.0,785.0,425.5
135602.0,17,4,6056,4,6056,45200.66666666666,1514.0,1514.0,0,0,0.0,0.0,0.0
297.0,17,2,156,1,78,0.0,78.0,78.0,1,78,0.0,78.0,78.0
2735759.0,17,32,2240,32,2240,88250.29032258065,70.0,70.0,0,0,0.0,0.0,0.0
95646968.0,17,14,4796,13,4446,6225113.583333333,342.0,342.0,1,350,0.0,350.0,350.0
14468.0,6,11,1133,6,602,2893.6,264.0,100.33333333333331,5,531,2465.25,259.0,106.2
216409.0,17,2,180,1,90,0.0,90.0,90.0,1,90,0.0,90.0,90.0
135124649.0,17,6,1206,6,1206,27024929.8,201.0,201.0,0,0,0.0,0.0,0.0
321585.0,17,4,1400,4,1400,107195.0,350.0,350.0,0,0,0.0,0.0,0.0
75042823.0,6,9,842,9,842,9380352.875,97.0,93.55555555555556,0,0,0.0,0.0,0.0
599505.0,17,2,346,1,78,0.0,78.0,78.0,1,268,0.0,268.0,268.0
121958.0,6,3,373,2,238,0.0,172.0,119.0,1,135,0.0,135.0,135.0
2595063.0,6,2,132,1,66,0.0,66.0,66.0,1,66,0.0,66.0,66.0
9897.0,17,2,571,1,86,0.0,86.0,86.0,1,485,0.0,485.0,485.0
108108832.0,17,5,1005,5,1005,27027208.0,201.0,201.0,0,0,0.0,0.0,0.0
21627.0,17,2,582,1,83,0.0,83.0,83.0,1,499,0.0,499.0,499.0
240182.0,6,3,373,2,238,0.0,172.0,119.0,1,135,0.0,135.0,135.0
236422.0,6,3,337,2,214,0.0,160.0,107.0,1,123,0.0,123.0,123.0
135133748.0,17,6,1146,6,1146,27026749.6,191.0,191.0,0,0,0.0,0.0,0.0
205901.0,17,2,180,1,90,0.0,90.0,90.0,1,90,0.0,90.0,90.0
24786204.0,17,5,1718,4,1368,979907.6666666666,342.0,342.0,1,350,0.0,350.0,350.0
108105866.0,17,5,955,5,955,27026466.5,191.0,191.0,0,0,0.0,0.0,0.0
2595061.0,6,2,132,1,66,0.0,66.0,66.0,1,66,0.0,66.0,66.0
212331.0,6,3,426,2,280,0.0,214.0,140.0,1,146,0.0,146.0,146.0
2401.0,17,4,344,2,150,0.0,75.0,75.0,2,194,0.0,103.0,97.0
302376.0,6,2,132,1,66,0.0,66.0,66.0,1,66,0.0,66.0,66.0
90258224.0,6,12,1832,8,1016,12894032.0,188.0,127.0,4,816,30029988.33333333,204.0,204.0
211117.0,17,2,604,1,75,0.0,75.0,75.0,1,529,0.0,529.0,529.0
204633.0,17,2,762,2,762,0.0,381.0,381.0,0,0,0.0,0.0,0.0
40038.0,6,14,4740,7,653,6507.833333333333,249.0,93.28571428571428,7,4087,6347.0,1514.0,583.8571428571429
108101386.0,17,5,1005,5,1005,27025346.5,201.0,201.0,0,0,0.0,0.0,0.0
106668.0,17,2,700,2,700,0.0,350.0,350.0,0,0,0.0,0.0,0.0
247577.0,17,4,6056,4,6056,82525.66666666667,1514.0,1514.0,0,0,0.0,0.0,0.0
281477.0,17,2,363,1,79,0.0,79.0,79.0,1,284,0.0,284.0,284.0
14335772.0,6,20,1607,10,975,1558584.111111111,315.0,97.5,10,632,1558119.4444444445,78.0,63.2
247248.0,6,3,337,2,214,0.0,160.0,107.0,1,123,0.0,123.0,123.0
2449041.0,6,3,204,2,136,0.0,70.0,68.0,1,68,0.0,68.0,68.0
2072.0,17,4,344,2,150,0.0,75.0,75.0,2,194,0.0,103.0,97.0
0.0,17,1,179,1,179,0.0,179.0,179.0,0,0,0.0,0.0,0.0
90958076.0,6,21,1585,11,840,9094504.7,95.0,76.36363636363636,10,745,10105585.888888888,95.0,74.5
46960.0,6,13,1479,7,882,7826.666666666667,291.0,126.0,6,597,7614.8,259.0,99.5
108839.0,17,4,1400,4,1400,36279.66666666666,350.0,350.0,0,0,0.0,0.0,0.0
91152606.0,6,23,1775,10,745,10101093.666666666,95.0,74.5,13,1030,7578939.166666667,95.0,79.23076923076923
189214.0,17,2,180,1,90,0.0,90.0,90.0,1,90,0.0,90.0,90.0
29596243.0,6,26,7627,14,3735,180491.7692307692,1514.0,266.7857142857143,12,3892,2670981.636363636,1514.0,324.3333333333333
155463.0,6,3,337,2,214,0.0,160.0,107.0,1,123,0.0,123.0,123.0
70022.0,6,14,4740,7,653,6782.0,249.0,93.28571428571428,7,4087,11098.833333333334,1514.0,583.8571428571429
112464243.0,6,46,3036,23,1518,5111999.2727272725,66.0,66.0,23,1518,5111995.136363637,66.0,66.0
28683.0,6,10,2032,5,524,6115.75,252.0,104.8,5,1508,6530.5,1236.0,301.6
40678.0,6,14,4740,7,653,6151.166666666667,249.0,93.28571428571428,7,4087,6516.833333333333,1514.0,583.8571428571429
40415.0,6,10,2032,5,524,9879.0,252.0,104.8,5,1508,9528.5,1236.0,301.6
1605420.0,6,7,499,4,301,500327.6666666667,103.0,75.25,3,198,716446.0,66.0,66.0
67754.0,6,10,2032,5,524,12001.75,252.0,104.8,5,1508,15322.75,1236.0,301.6
167182.0,6,11,1132,6,556,32272.0,218.0,92.66666666666669,5,576,41536.5,304.0,115.2
2333.0,17,4,344,2,150,0.0,75.0,75.0,2,194,0.0,103.0,97.0
97763802.0,6,240,27426,120,8142,815537.5462184874,140.0,67.85,120,19284,805939.537815126,284.0,160.7
106271.0,17,2,286,2,286,0.0,143.0,143.0,0,0,0.0,0.0,0.0
90035225.0,17,28,13364,28,13364,3334637.962962963,501.0,477.2857142857143,0,0,0.0,0.0,0.0
129975744.0,17,14,864,7,432,18333499.83333333,174.0,61.71428571428572,7,432,18334766.0,174.0,61.71428571428572
310590.0,17,4,704,2,148,0.0,74.0,74.0,2,556,0.0,280.0,278.0
135137507.0,17,6,1146,6,1146,27027501.4,191.0,191.0,0,0,0.0,0.0,0.0
90254651.0,6,14,2240,8,1016,12893521.57142857,188.0,127.0,6,1224,18014893.8,204.0,204.0
502790.0,6,5,336,2,134,0.0,68.0,67.0,3,202,192029.0,70.0,67.33333333333333
307360.0,17,4,704,2,148,0.0,74.0,74.0,2,556,0.0,280.0,278.0
2334.0,17,4,344,2,150,0.0,75.0,75.0,2,194,0.0,103.0,97.0
160229.0,6,3,337,2,214,0.0,160.0,107.0,1,123,0.0,123.0,123.0
216375.0,17,2,180,1,90,0.0,90.0,90.0,1,90,0.0,90.0,90.0
90092078.0,6,11,1644,4,816,30029905.666666668,204.0,204.0,7,828,15014939.833333334,188.0,118.28571428571428
102006715.0,17,13,821,7,432,17001119.166666668,174.0,61.71428571428572,6,389,20015696.6,174.0,64.83333333333333
48360.0,6,14,4740,7,653,7935.833333333333,249.0,93.28571428571428,7,4087,7408.0,1514.0,583.8571428571429
92797882.0,6,37,2442,19,1254,5155437.888888889,66.0,66.0,18,1188,5129739.529411765,66.0,66.0
120045603.0,17,29,13785,29,13785,4287342.964285715,501.0,475.3448275862069,0,0,0.0,0.0,0.0
226949.0,17,4,1400,4,1400,75649.66666666667,350.0,350.0,0,0,0.0,0.0,0.0
146809.0,6,3,337,2,214,0.0,160.0,107.0,1,123,0.0,123.0,123.0
26410.0,6,14,4740,7,653,3766.1666666666665,249.0,93.28571428571428,7,4087,4267.333333333333,1514.0,583.8571428571429
1306923.0,6,4,264,2,132,0.0,66.0,66.0,2,132,0.0,66.0,66.0
300946.0,6,6,412,4,272,100315.33333333331,74.0,68.0,2,140,0.0,74.0,70.0
90568169.0,6,14,2240,8,1016,12938309.857142856,188.0,127.0,6,1224,18080621.4,204.0,204.0
21865.0,17,2,180,1,90,0.0,90.0,90.0,1,90,0.0,90.0,90.0
144.0,17,2,700,2,700,0.0,350.0,350.0,0,0,0.0,0.0,0.0
117685.0,6,10,2032,5,524,28093.0,252.0,104.8,5,1508,28688.25,1236.0,301.6
2733404.0,6,25,7573,14,3735,210261.84615384616,1514.0,266.7857142857143,11,3838,247073.8,1514.0,348.90909090909093
128971204.0,6,35,2394,18,1269,7586541.411764706,123.0,70.5,17,1125,7423599.5625,123.0,66.17647058823529
292750.0,6,12,1373,7,714,48791.66666666666,298.0,102.0,5,659,68863.0,379.0,131.8
112535487.0,6,48,3168,24,1584,4891588.173913044,66.0,66.0,24,1584,4891009.347826087,66.0,66.0
90034863.0,17,27,12943,27,12943,3462879.346153846,501.0,479.3703703703704,0,0,0.0,0.0,0.0
137001180.0,17,15,907,8,475,19571597.14285714,174.0,59.375,7,432,19503600.666666668,174.0,61.71428571428572
41192.0,6,14,4740,7,653,6737.833333333333,249.0,93.28571428571428,7,4087,6485.0,1514.0,583.8571428571429
107834036.0,6,27,1800,14,894,8294925.846153846,123.0,63.85714285714285,13,906,8136095.416666667,123.0,69.6923076923077
98513831.0,6,29,2200,14,1032,7577987.0,123.0,73.71428571428571,15,1168,6307791.642857143,139.0,77.86666666666666
1306980.0,6,4,264,2,132,0.0,66.0,66.0,2,132,0.0,66.0,66.0
149568499.0,6,20,1490,11,840,14956849.9,95.0,76.36363636363636,9,650,14942498.875,95.0,72.22222222222223
108105052.0,17,5,1005,5,1005,27026263.0,201.0,201.0,0,0,0.0,0.0,0.0
284484.0,17,2,363,1,79,0.0,79.0,79.0,1,284,0.0,284.0,284.0
102615.0,17,2,286,2,286,0.0,143.0,143.0,0,0,0.0,0.0,0.0
108104196.0,17,5,1005,5,1005,27026049.0,201.0,201.0,0,0,0.0,0.0,0.0
45601.0,6,10,1066,5,490,9082.5,218.0,98.0,5,576,10992.5,304.0,115.2
1016411.0,6,10,1262,6,725,203282.2,387.0,120.83333333333331,4,537,246895.3333333333,331.0,134.25
281808.0,17,2,363,1,79,0.0,79.0,79.0,1,284,0.0,284.0,284.0
940563.0,6,12,1447,6,816,187286.2,291.0,136.0,6,631,186780.2,293.0,105.16666666666669
199932.0,17,4,6056,4,6056,66644.0,1514.0,1514.0,0,0,0.0,0.0,0.0
42785.0,6,14,4740,7,653,6962.333333333333,249.0,93.28571428571428,7,4087,6861.333333333333,1514.0,583.8571428571429
90095377.0,6,13,1776,6,948,18018298.0,204.0,158.0,7,828,15015521.0,188.0,118.28571428571428
48076.0,6,14,4740,7,653,7023.166666666667,249.0,93.28571428571428,7,4087,7466.0,1514.0,583.8571428571429
116577505.0,6,47,3102,24,1584,5068576.173913044,66.0,66.0,23,1518,5144000.318181818,66.0,66.0
110137786.0,6,27,1806,14,966,8455539.923076924,123.0,69.0,13,840,9159114.166666666,123.0,64.61538461538461
120144657.0,6,230,25914,115,7886,1046724.149122807,140.0,68.57391304347826,115,18028,1046754.4210526316,300.0,156.76521739130436
119414019.0,6,187,21282,94,14922,1284021.7096774194,284.0,158.74468085106383,93,6360,1286571.9239130437,140.0,68.38709677419355
90776530.0,6,15,1138,7,542,15129421.666666666,95.0,77.42857142857143,8,596,12922685.285714284,95.0,74.5
206021.0,6,3,426,2,280,0.0,214.0,140.0,1,146,0.0,146.0,146.0
241785.0,6,3,373,2,238,0.0,172.0,119.0,1,135,0.0,135.0,135.0
130030.0,6,3,337,2,214,0.0,160.0,107.0,1,123,0.0,123.0,123.0
120034003.0,17,28,13364,28,13364,4445703.814814814,501.0,477.2857142857143,0,0,0.0,0.0,0.0
2860385.0,6,12,2172,7,664,476637.5,252.0,94.85714285714286,5,1508,1834.25,1236.0,301.6
305907.0,6,3,202,2,128,0.0,74.0,64.0,1,74,0.0,74.0,74.0
62751.0,6,14,4740,7,653,10022.166666666666,249.0,93.28571428571428,7,4087,10314.333333333334,1514.0,583.8571428571429
50504.0,6,14,4740,7,653,7911.833333333333,249.0,93.28571428571428,7,4087,7507.0,1514.0,583.8571428571429
228521.0,17,2,180,1,90,0.0,90.0,90.0,1,90,0.0,90.0,90.0
0.0,6,1,66,1,66,0.0,66.0,66.0,0,0,0.0,0.0,0.0
90013463.0,17,28,13364,28,13364,3333831.962962963,501.0,477.2857142857143,0,0,0.0,0.0,0.0
137108.0,6,2,132,1,66,0.0,66.0,66.0,1,66,0.0,66.0,66.0
1504.0,17,2,762,2,762,0.0,381.0,381.0,0,0,0.0,0.0,0.0
108106387.0,17,5,955,5,955,27026596.75,191.0,191.0,0,0,0.0,0.0,0.0
135135586.0,17,6,1146,6,1146,27027117.2,191.0,191.0,0,0,0.0,0.0,0.0
27012.0,6,14,4740,7,653,3779.1666666666665,249.0,93.28571428571428,7,4087,4261.833333333333,1514.0,583.8571428571429
148264.0,6,3,337,2,214,0.0,160.0,107.0,1,123,0.0,123.0,123.0
316726.0,17,4,1400,4,1400,105575.33333333331,350.0,350.0,0,0,0.0,0.0,0.0
120323179.0,17,14,864,7,432,20053863.166666668,174.0,61.71428571428572,7,432,19906924.83333333,174.0,61.71428571428572
24467.0,6,10,2032,5,524,5621.5,252.0,104.8,5,1508,5554.5,1236.0,301.6
216813.0,6,3,426,2,280,0.0,214.0,140.0,1,146,0.0,146.0,146.0
178671.0,17,2,180,1,90,0.0,90.0,90.0,1,90,0.0,90.0,90.0
503535.0,6,5,336,2,134,0.0,68.0,67.0,3,202,193349.5,70.0,67.33333333333333
50230.0,6,14,4740,7,653,8261.666666666666,249.0,93.28571428571428,7,4087,7568.0,1514.0,583.8571428571429
3466.0,17,4,571,2,148,0.0,74.0,74.0,2,423,0.0,280.0,211.5
135135345.0,17,6,1146,6,1146,27027069.0,191.0,191.0,0,0,0.0,0.0,0.0
205905.0,17,2,180,1,90,0.0,90.0,90.0,1,90,0.0,90.0,90.0
135129743.0,17,6,1206,6,1206,27025948.6,201.0,201.0,0,0,0.0,0.0,0.0
108109202.0,17,5,1005,5,1005,27027300.5,201.0,201.0,0,0,0.0,0.0,0.0
135132822.0,17,6,1146,6,1146,27026564.4,191.0,191.0,0,0,0.0,0.0,0.0
111419942.0,6,200,22648,100,15752,1123280.616161616,284.0,157.52,100,6896,1123280.707070707,140.0,68.96
30277.0,6,14,4740,7,653,4335.833333333333,249.0,93.28571428571428,7,4087,4819.166666666667,1514.0,583.8571428571429
4484.0,17,2,610,1,72,0.0,72.0,72.0,1,538,0.0,538.0,538.0
216500.0,17,2,180,1,90,0.0,90.0,90.0,1,90,0.0,90.0,90.0
125694654.0,17,14,864,7,432,17666853.833333332,174.0,61.71428571428572,7,432,17667596.666666668,174.0,61.71428571428572
199438.0,17,2,180,1,90,0.0,90.0,90.0,1,90,0.0,90.0,90.0
161141.0,6,2,128,1,74,0.0,74.0,74.0,1,54,0.0,54.0,54.0
32588.0,6,14,4740,7,653,5314.5,249.0,93.28571428571428,7,4087,5128.5,1514.0,583.8571428571429
3125009.0,6,19,1549,10,975,313726.5555555556,315.0,97.5,9,574,352887.0,78.0,63.77777777777778
299531.0,6,6,412,4,272,99843.66666666669,74.0,68.0,2,140,0.0,74.0,70.0
491348.0,6,3,204,1,68,0.0,68.0,68.0,2,136,0.0,70.0,68.0
44949.0,6,10,2032,5,524,10992.5,252.0,104.8,5,1508,10455.25,1236.0,301.6
5004406.0,17,4,849,2,166,0.0,83.0,83.0,2,683,0.0,499.0,341.5
47450.0,6,10,2032,5,524,10278.0,252.0,104.8,5,1508,10312.0,1236.0,301.6
304589.0,6,6,412,4,272,101529.66666666669,74.0,68.0,2,140,0.0,74.0,70.0
90011280.0,17,28,13364,28,13364,3333751.111111111,501.0,477.2857142857143,0,0,0.0,0.0,0.0
90281822.0,6,16,1192,8,596,12890887.285714284,95.0,74.5,8,596,12894862.0,95.0,74.5
219393.0,6,3,426,2,280,0.0,214.0,140.0,1,146,0.0,146.0,146.0
92880042.0,6,37,2442,19,1254,5160002.333333333,66.0,66.0,18,1188,5241262.647058823,66.0,66.0
118882187.0,6,34,2350,17,1225,7417326.875,139.0,72.05882352941177,17,1125,7417327.375,123.0,66.17647058823529
53201.0,6,14,4740,7,653,8736.0,249.0,93.28571428571428,7,4087,8217.333333333334,1514.0,583.8571428571429
206271.0,6,3,426,2,280,0.0,214.0,140.0,1,146,0.0,146.0,146.0
201310.0,17,4,6056,4,6056,67103.33333333333,1514.0,1514.0,0,0,0.0,0.0,0.0
311605.0,17,4,1400,4,1400,103868.33333333331,350.0,350.0,0,0,0.0,0.0,0.0
216398.0,17,2,180,1,90,0.0,90.0,90.0,1,90,0.0,90.0,90.0
530303.0,6,2,145,2,145,0.0,91.0,72.5,0,0,0.0,0.0,0.0
115010096.0,6,48,3168,24,1584,5000438.956521739,66.0,66.0,24,1584,4988446.0869565215,66.0,66.0
38873.0,6,10,2032,5,524,8754.25,252.0,104.8,5,1508,9438.0,1236.0,301.6
29313.0,6,10,2032,5,524,7096.25,252.0,104.8,5,1508,6808.25,1236.0,301.6
135135146.0,17,6,1206,6,1206,27027029.2,201.0,201.0,0,0,0.0,0.0,0.0
29564.0,6,11,2098,6,590,5075.2,252.0,98.33333333333331,5,1508,5733.5,1236.0,301.6
0.0,17,1,342,1,342,0.0,342.0,342.0,0,0,0.0,0.0,0.0
153407.0,17,2,180,1,90,0.0,90.0,90.0,1,90,0.0,90.0,90.0
232866.0,6,3,373,2,238,0.0,172.0,119.0,1,135,0.0,135.0,135.0
153372.0,17,2,180,1,90,0.0,90.0,90.0,1,90,0.0,90.0,90.0
143989.0,17,2,180,1,90,0.0,90.0,90.0,1,90,0.0,90.0,90.0
0.0,17,1,90,1,90,0.0,90.0,90.0,0,0,0.0,0.0,0.0
108101405.0,17,5,1005,5,1005,27025351.25,201.0,201.0,0,0,0.0,0.0,0.0
297.0,17,2,164,1,82,0.0,82.0,82.0,1,82,0.0,82.0,82.0
2388.0,17,4,344,2,150,0.0,75.0,75.0,2,194,0.0,103.0,97.0
208688.0,6,10,1221,6,636,41737.6,298.0,106.0,4,585,68167.0,379.0,146.25
120136788.0,6,2460,2133936,768,50688,156334.29856584093,66.0,66.0,1692,2083248,70579.14961561207,1514.0,1231.2340425531916
63193.0,6,14,4740,7,653,10321.833333333334,249.0,93.28571428571428,7,4087,10334.5,1514.0,583.8571428571429
124011309.0,17,15,1169,8,606,17715901.285714287,174.0,75.75,7,563,17333537.666666668,174.0,80.42857142857143
118754047.0,6,38,2842,19,1371,6597447.055555556,123.0,72.15789473684211,19,1471,6031418.5,139.0,77.42105263157895
35188153.0,6,7,1874,3,887,17515255.0,753.0,295.6666666666667,4,987,11682771.333333334,785.0,246.75
419.0,17,2,410,1,78,0.0,78.0,78.0,1,332,0.0,332.0,332.0
33305.0,6,14,4740,7,653,5392.5,249.0,93.28571428571428,7,4087,4951.5,1514.0,583.8571428571429
27217902.0,17,5,1718,4,1368,1778016.0,342.0,342.0,1,350,0.0,350.0,350.0
2992294.0,6,167,125864,88,116348,34394.183908045976,1510.0,1322.1363636363635,79,9516,34461.3717948718,1510.0,120.45569620253164
6889.0,17,2,582,1,83,0.0,83.0,83.0,1,499,0.0,499.0,499.0
241085.0,6,3,337,2,214,0.0,160.0,107.0,1,123,0.0,123.0,123.0
114834844.0,6,32,2220,16,1149,7641278.4,123.0,71.8125,16,1071,7641278.466666667,123.0,66.9375
148516.0,17,2,398,1,88,0.0,88.0,88.0,1,310,0.0,310.0,310.0
51042.0,17,2,180,1,90,0.0,90.0,90.0,1,90,0.0,90.0,90.0
39270268.0,6,26,7627,14,3735,203956.6923076923,1514.0,266.7857142857143,12,3892,3551336.909090909,1514.0,324.3333333333333
233227.0,6,3,337,2,214,0.0,160.0,107.0,1,123,0.0,123.0,123.0
121178.0,6,3,373,2,238,0.0,172.0,119.0,1,135,0.0,135.0,135.0
14816.0,6,14,4740,7,653,2221.333333333333,249.0,93.28571428571428,7,4087,2336.333333333333,1514.0,583.8571428571429
235947.0,6,3,337,2,214,0.0,160.0,107.0,1,123,0.0,123.0,123.0
2342.0,17,4,344,2,150,0.0,75.0,75.0,2,194,0.0,103.0,97.0
310396.0,6,6,412,4,272,103465.33333333331,74.0,68.0,2,140,0.0,74.0,70.0
1733963.0,17,3,1026,3,1026,866981.5,342.0,342.0,0,0,0.0,0.0,0.0
135137767.0,17,6,1206,6,1206,27027553.4,201.0,201.0,0,0,0.0,0.0,0.0
10475170.0,6,7,478,4,272,3446346.333333333,74.0,68.0,3,206,5169419.5,74.0,68.66666666666667
147958.0,17,2,180,1,90,0.0,90.0,90.0,1,90,0.0,90.0,90.0
1296284.0,6,4,264,2,132,0.0,66.0,66.0,2,132,0.0,66.0,66.0
93776453.0,6,26,1762,13,922,7796717.166666667,139.0,70.92307692307692,13,840,7796714.333333333,123.0,64.61538461538461
153473.0,17,2,180,1,90,0.0,90.0,90.0,1,90,0.0,90.0,90.0
2806224.0,6,2,132,1,66,0.0,66.0,66.0,1,66,0.0,66.0,66.0
120000079.0,17,31,14767,31,14767,4000002.633333333,501.0,476.35483870967744,0,0,0.0,0.0,0.0
107508241.0,6,29,2052,15,1089,7663746.285714285,123.0,72.6,14,963,8253269.615384615,123.0,68.78571428571429
82.0,17,2,762,2,762,0.0,381.0,381.0,0,0,0.0,0.0,0.0
2871.0,17,5,550,5,550,717.75,110.0,110.0,0,0,0.0,0.0,0.0
217884.0,6,3,426,2,280,0.0,214.0,140.0,1,146,0.0,146.0,146.0
90231029.0,6,19,1436,9,691,11247101.875,95.0,76.77777777777777,10,745,10001722.555555556,95.0,74.5
111715892.0,6,30,1974,15,1026,7964281.071428572,123.0,68.4,15,948,7964281.0,123.0,63.2
15174.0,6,14,4740,7,653,2351.6666666666665,249.0,93.28571428571428,7,4087,2395.6666666666665,1514.0,583.8571428571429
10134.0,17,2,571,1,86,0.0,86.0,86.0,1,485,0.0,485.0,485.0
10501994.0,6,7,478,4,272,3453430.333333333,74.0,68.0,3,206,5180044.0,74.0,68.66666666666667
93818206.0,6,39,2574,20,1320,4937786.894736842,66.0,66.0,19,1254,5160002.055555556,66.0,66.0
217499.0,6,3,426,2,280,0.0,214.0,140.0,1,146,0.0,146.0,146.0
108108620.0,17,5,1005,5,1005,27027155.0,201.0,201.0,0,0,0.0,0.0,0.0
90256852.0,6,14,2240,8,1016,12893836.0,188.0,127.0,6,1224,18018206.4,204.0,204.0
135126616.0,17,6,1206,6,1206,27025323.2,201.0,201.0,0,0,0.0,0.0,0.0
108113850.0,17,5,955,5,955,27028462.5,191.0,191.0,0,0,0.0,0.0,0.0
451167.0,6,3,1604,1,753,0.0,753.0,753.0,2,851,0.0,785.0,425.5
311326.0,17,4,1400,4,1400,103775.33333333331,350.0,350.0,0,0,0.0,0.0,0.0
49314.0,6,14,4740,7,653,7283.166666666667,249.0,93.28571428571428,7,4087,7097.166666666667,1514.0,583.8571428571429
123422143.0,6,48,3168,24,1584,4931514.869565218,66.0,66.0,24,1584,5366168.521739131,66.0,66.0
355.0,17,2,267,1,83,0.0,83.0,83.0,1,184,0.0,184.0,184.0
2067.0,17,4,344,2,150,0.0,75.0,75.0,2,194,0.0,103.0,97.0
18965.0,6,10,2032,5,524,4507.5,252.0,104.8,5,1508,4498.0,1236.0,301.6
12146.0,6,13,1459,7,862,1858.5,271.0,123.14285714285714,6,597,2187.8,259.0,99.5
90028228.0,17,28,13364,28,13364,3334378.814814815,501.0,477.2857142857143,0,0,0.0,0.0,0.0
108350.0,17,2,286,2,286,0.0,143.0,143.0,0,0,0.0,0.0,0.0
133741255.0,17,15,1169,8,606,19105893.57142857,174.0,75.75,7,563,19005565.166666668,174.0,80.42857142857143
108136579.0,17,5,1005,5,1005,27034144.75,201.0,201.0,0,0,0.0,0.0,0.0
3578532.0,6,5,336,3,202,1526315.5,70.0,67.33333333333333,2,134,0.0,68.0,67.0
2405.0,17,4,344,2,150,0.0,75.0,75.0,2,194,0.0,103.0,97.0
1169060.0,6,13,3010,8,2382,167008.57142857142,1514.0,297.75,5,628,224131.25,331.0,125.6
96462242.0,17,12,778,6,389,19200816.2,174.0,64.83333333333333,6,389,19200210.4,174.0,64.83333333333333
292.0,17,3,1050,3,1050,146.0,350.0,350.0,0,0,0.0,0.0,0.0
308945.0,6,6,412,4,272,102981.66666666669,74.0,68.0,2,140,0.0,74.0,70.0
320.0,17,2,166,1,75,0.0,75.0,75.0,1,91,0.0,91.0,91.0
121005862.0,17,15,907,8,475,17286551.714285713,174.0,59.375,7,432,16833528.666666668,174.0,61.71428571428572
302166.0,6,6,412,4,272,100722.0,74.0,68.0,2,140,0.0,74.0,70.0
99887.0,17,2,762,2,762,0.0,381.0,381.0,0,0,0.0,0.0,0.0
144582.0,6,2,132,1,66,0.0,66.0,66.0,1,66,0.0,66.0,66.0
331.0,17,2,166,1,75,0.0,75.0,75.0,1,91,0.0,91.0,91.0
245377.0,6,3,337,2,214,0.0,160.0,107.0,1,123,0.0,123.0,123.0
146780.0,17,4,704,2,148,0.0,74.0,74.0,2,556,0.0,280.0,278.0
114110297.0,6,35,2526,18,1332,6712370.411764706,123.0,74.0,17,1194,7119087.1875,123.0,70.23529411764706
112535419.0,6,46,3036,23,1518,5105432.954545454,66.0,66.0,23,1518,5105431.2727272725,66.0,66.0
213823.0,17,2,414,1,88,0.0,88.0,88.0,1,326,0.0,326.0,326.0
90259508.0,6,13,2036,8,1016,12894215.42857143,188.0,127.0,5,1020,22522265.75,204.0,204.0
28410.0,6,14,4740,7,653,4624.5,249.0,93.28571428571428,7,4087,4492.166666666667,1514.0,583.8571428571429
197556.0,17,2,180,1,90,0.0,90.0,90.0,1,90,0.0,90.0,90.0
46938.0,6,14,4740,7,653,7353.166666666667,249.0,93.28571428571428,7,4087,5208.833333333333,1514.0,583.8571428571429
308838.0,6,6,412,4,272,102946.0,74.0,68.0,2,140,0.0,74.0,70.0
48916.0,6,14,4740,7,653,7805.333333333333,249.0,93.28571428571428,7,4087,7208.833333333333,1514.0,583.8571428571429
200154.0,17,4,6056,4,6056,66718.0,1514.0,1514.0,0,0,0.0,0.0,0.0
120118478.0,17,16,1212,8,606,17136953.42857143,174.0,75.75,8,606,17090396.0,174.0,75.75
19579.0,6,14,4740,7,653,2827.5,249.0,93.28571428571428,7,4087,3120.833333333333,1514.0,583.8571428571429
309597.0,6,3,202,2,128,0.0,74.0,64.0,1,74,0.0,74.0,74.0
233888.0,6,4,439,2,238,0.0,172.0,119.0,2,201,0.0,135.0,100.5
216414.0,17,2,180,1,90,0.0,90.0,90.0,1,90,0.0,90.0,90.0
239839.0,6,4,439,2,238,0.0,172.0,119.0,2,201,0.0,135.0,100.5
44736.0,6,12,1320,6,723,8588.6,253.0,120.5,6,597,5318.6,259.0,99.5
108470659.0,6,31,2176,16,1071,7231347.533333333,123.0,66.9375,15,1105,7034731.857142857,139.0,73.66666666666667
107649.0,6,2,132,1,66,0.0,66.0,66.0,1,66,0.0,66.0,66.0
1319898.0,17,7,490,7,490,219983.0,70.0,70.0,0,0,0.0,0.0,0.0
206832.0,6,3,426,2,280,0.0,214.0,140.0,1,146,0.0,146.0,146.0
859081.0,6,9,1268,6,797,171816.2,459.0,132.83333333333334,3,471,293203.0,331.0,157.0
108110314.0,17,5,955,5,955,27027578.5,191.0,191.0,0,0,0.0,0.0,0.0
107321.0,17,2,286,2,286,0.0,143.0,143.0,0,0,0.0,0.0,0.0
90284196.0,6,21,1585,11,840,9024078.7,95.0,76.36363636363636,10,745,9845701.111111112,95.0,74.5
90057819.0,17,28,13364,28,13364,3335474.777777778,501.0,477.2857142857143,0,0,0.0,0.0,0.0
108106237.0,17,5,955,5,955,27026559.25,191.0,191.0,0,0,0.0,0.0,0.0
196966.0,17,2,180,1,90,0.0,90.0,90.0,1,90,0.0,90.0,90.0
119412384.0,6,205,23248,103,16220,1170709.6470588236,284.0,157.4757281553398,102,7028,1164502.603960396,140.0,68.90196078431373
242720.0,6,3,337,2,214,0.0,160.0,107.0,1,123,0.0,123.0,123.0
317022.0,17,4,1400,4,1400,105674.0,350.0,350.0,0,0,0.0,0.0,0.0
153466.0,17,2,180,1,90,0.0,90.0,90.0,1,90,0.0,90.0,90.0
9422.0,17,2,582,1,83,0.0,83.0,83.0,1,499,0.0,499.0,499.0
104008877.0,6,44,2904,22,1452,4952803.666666667,66.0,66.0,22,1452,4938057.904761905,66.0,66.0
0.0,17,1,72,1,72,0.0,72.0,72.0,0,0,0.0,0.0,0.0
10523071.0,6,7,478,4,272,3462267.6666666665,74.0,68.0,3,206,5193306.0,74.0,68.66666666666667
97558430.0,6,26,1746,13,906,8129869.166666667,123.0,69.6923076923077,13,840,8112799.0,123.0,64.61538461538461
1033366.0,6,11,1134,6,558,206673.2,220.0,93.0,5,576,256962.25,304.0,115.2
109706091.0,6,32,2236,16,1165,7300102.8,139.0,72.8125,16,1071,7300099.266666667,123.0,66.9375
90060669.0,17,28,13364,28,13364,3335580.333333333,501.0,477.2857142857143,0,0,0.0,0.0,0.0
2382.0,17,4,344,2,150,0.0,75.0,75.0,2,194,0.0,103.0,97.0
123761.0,6,3,337,2,214,0.0,160.0,107.0,1,123,0.0,123.0,123.0
312071.0,6,3,204,1,68,0.0,68.0,68.0,2,136,0.0,70.0,68.0
16667.0,6,10,2032,5,524,3961.25,252.0,104.8,5,1508,3903.0,1236.0,301.6
102880250.0,6,42,2772,21,1386,5143998.55,66.0,66.0,21,1386,5143999.85,66.0,66.0
4332.0,17,2,598,1,72,0.0,72.0,72.0,1,526,0.0,526.0,526.0
196969.0,17,2,180,1,90,0.0,90.0,90.0,1,90,0.0,90.0,90.0
108114584.0,17,5,1005,5,1005,27028646.0,201.0,201.0,0,0,0.0,0.0,0.0
481336.0,6,3,204,2,136,0.0,70.0,68.0,1,68,0.0,68.0,68.0
2094887.0,6,24,7544,12,2450,190444.2727272728,1034.0,204.16666666666663,12,5094,161619.0,1510.0,424.5
33040.0,6,14,4740,7,653,5197.0,249.0,93.28571428571428,7,4087,4811.5,1514.0,583.8571428571429
262241.0,6,10,1221,6,636,52448.2,298.0,106.0,4,585,82039.33333333333,379.0,146.25
90257239.0,6,12,1832,8,1016,12893891.285714284,188.0,127.0,4,816,30031066.666666668,204.0,204.0
105122687.0,17,15,5130,15,5130,7508763.357142857,342.0,342.0,0,0,0.0,0.0,0.0
304.0,17,2,174,1,79,0.0,79.0,79.0,1,95,0.0,95.0,95.0
209558.0,17,2,180,1,90,0.0,90.0,90.0,1,90,0.0,90.0,90.0
32779.0,6,14,4740,7,653,5332.5,249.0,93.28571428571428,7,4087,4928.0,1514.0,583.8571428571429
135128068.0,17,6,1146,6,1146,27025613.6,191.0,191.0,0,0,0.0,0.0,0.0
314.0,17,2,174,1,79,0.0,79.0,79.0,1,95,0.0,95.0,95.0
127329.0,6,14,4740,7,653,20234.33333333333,249.0,93.28571428571428,7,4087,19541.33333333333,1514.0,583.8571428571429
1314717.0,6,4,264,2,132,0.0,66.0,66.0,2,132,0.0,66.0,66.0
90046148.0,17,27,12943,27,12943,3463313.3846153845,501.0,479.3703703703704,0,0,0.0,0.0,0.0
32840.0,6,10,2032,5,524,7972.5,252.0,104.8,5,1508,7835.25,1236.0,301.6
1163032.0,6,13,3009,8,2381,166147.42857142858,1514.0,297.625,5,628,221827.25,331.0,125.6
2314043.0,6,32,10926,18,3951,136120.17647058822,1514.0,219.5,14,6975,158638.6923076923,1514.0,498.2142857142857
624160.0,17,2,762,2,762,0.0,381.0,381.0,0,0,0.0,0.0,0.0
108108802.0,17,5,955,5,955,27027200.5,191.0,191.0,0,0,0.0,0.0,0.0
104556520.0,17,14,4788,14,4788,8042809.230769231,342.0,342.0,0,0,0.0,0.0,0.0
117754493.0,6,297,34354,149,10056,795638.4662162162,140.0,67.48993288590604,148,24298,799539.0680272109,284.0,164.17567567567568
90260325.0,6,12,1832,8,1016,12894332.142857144,188.0,127.0,4,816,30031786.33333333,204.0,204.0
120016478.0,17,29,13785,29,13785,4286302.785714285,501.0,475.3448275862069,0,0,0.0,0.0,0.0
43792.0,6,14,4740,7,653,7176.5,249.0,93.28571428571428,7,4087,5755.0,1514.0,583.8571428571429
1314982.0,6,4,264,2,132,0.0,66.0,66.0,2,132,0.0,66.0,66.0
2340.0,17,4,344,2,150,0.0,75.0,75.0,2,194,0.0,103.0,97.0
103732.0,17,2,286,2,286,0.0,143.0,143.0,0,0,0.0,0.0,0.0
120125668.0,6,16,2632,9,1204,15015708.5,188.0,133.77777777777777,7,1428,15060787.5,204.0,204.0
298.0,17,2,156,1,78,0.0,78.0,78.0,1,78,0.0,78.0,78.0
14651849.0,6,20,1646,10,1014,1591235.4444444445,315.0,101.4,10,632,1590703.888888889,78.0,63.2
26620.0,6,14,4740,7,653,4084.0,249.0,93.28571428571428,7,4087,3745.0,1514.0,583.8571428571429
107297.0,17,2,286,2,286,0.0,143.0,143.0,0,0,0.0,0.0,0.0
125785616.0,6,49,11818,25,6255,4003395.75,1514.0,250.2,24,5563,5460002.521739131,1514.0,231.79166666666663
143871.0,17,2,180,1,90,0.0,90.0,90.0,1,90,0.0,90.0,90.0
120007107.0,17,15,907,8,475,17143872.42857143,174.0,59.375,7,432,16666807.833333334,174.0,61.71428571428572
7183.0,17,2,582,1,83,0.0,83.0,83.0,1,499,0.0,499.0,499.0
46612.0,6,14,4740,7,653,7561.166666666667,249.0,93.28571428571428,7,4087,7432.5,1514.0,583.8571428571429
51041.0,6,14,4740,7,653,8382.666666666666,249.0,93.28571428571428,7,4087,7011.333333333333,1514.0,583.8571428571429
196953.0,17,2,180,1,90,0.0,90.0,90.0,1,90,0.0,90.0,90.0
135123439.0,17,6,1206,6,1206,27024687.8,201.0,201.0,0,0,0.0,0.0,0.0
90529339.0,6,13,2036,8,1016,12932762.714285716,188.0,127.0,5,1020,22591114.75,204.0,204.0
304765.0,6,6,412,4,272,101588.33333333331,74.0,68.0,2,140,0.0,74.0,70.0
146700.0,6,2,132,1,66,0.0,66.0,66.0,1,66,0.0,66.0,66.0
840993.0,6,9,1118,6,586,168198.6,248.0,97.66666666666669,3,532,282684.5,392.0,177.33333333333334
77595.0,6,14,4740,7,653,10927.0,249.0,93.28571428571428,7,4087,12716.0,1514.0,583.8571428571429
130713.0,6,13,1394,7,797,21785.5,253.0,113.85714285714286,6,597,25363.4,259.0,99.5
149597.0,17,2,180,1,90,0.0,90.0,90.0,1,90,0.0,90.0,90.0
34603.0,6,14,4740,7,653,5645.5,249.0,93.28571428571428,7,4087,4543.5,1514.0,583.8571428571429
106126538.0,6,29,2068,15,1105,7580467.0,139.0,73.66666666666667,14,963,8146929.153846154,123.0,68.78571428571429
108104769.0,17,5,955,5,955,27026192.25,191.0,191.0,0,0,0.0,0.0,0.0
25738.0,6,14,4740,7,653,3751.6666666666665,249.0,93.28571428571428,7,4087,4147.5,1514.0,583.8571428571429
112560047.0,6,32,2236,16,1165,7489606.4,139.0,72.8125,16,1071,7489611.933333334,123.0,66.9375
209054.0,6,3,426,2,280,0.0,214.0,140.0,1,146,0.0,146.0,146.0
5627149.0,6,4,270,2,136,0.0,70.0,68.0,2,134,0.0,68.0,67.0
71100.0,6,14,4740,7,653,11637.166666666666,249.0,93.28571428571428,7,4087,10899.333333333334,1514.0,583.8571428571429
7926.000000000001,17,4,823,2,163,0.0,89.0,81.5,2,660,0.0,443.0,330.0
233712.0,6,3,337,2,214,0.0,160.0,107.0,1,123,0.0,123.0,123.0
13337.0,6,12,1393,6,796,2434.6,271.0,132.66666666666666,6,597,2372.0,259.0,99.5
875824.0,6,10,1333,6,796,175164.8,458.0,132.66666666666666,4,537,201134.66666666663,331.0,134.25
108109444.0,17,5,1005,5,1005,27027361.0,201.0,201.0,0,0,0.0,0.0,0.0
228338.0,17,2,180,1,90,0.0,90.0,90.0,1,90,0.0,90.0,90.0
5752.0,17,2,180,1,90,0.0,90.0,90.0,1,90,0.0,90.0,90.0
0.0,6,1,54,0,0,0.0,0.0,0.0,1,54,0.0,54.0,54.0
8089.000000000001,17,4,344,2,150,0.0,75.0,75.0,2,194,0.0,103.0,97.0
17022.0,6,10,2032,5,524,3992.25,252.0,104.8,5,1508,3745.25,1236.0,301.6
1178722.0,6,13,3002,8,2374,168388.85714285713,1514.0,296.75,5,628,225722.5,331.0,125.6
117719316.0,6,34,2334,17,1209,7343960.125,123.0,71.11764705882354,17,1125,7343967.875,123.0,66.17647058823529
25817.0,6,10,2032,5,524,5701.25,252.0,104.8,5,1508,5832.75,1236.0,301.6
124001025.0,17,15,907,8,475,17714432.14285714,174.0,59.375,7,432,17334240.666666668,174.0,61.71428571428572
14635846.0,6,20,1607,10,975,1592006.6666666667,315.0,97.5,10,632,1591517.888888889,78.0,63.2
110066897.0,6,33,2412,17,1272,6865662.6875,123.0,74.82352941176471,16,1140,7323392.666666667,123.0,71.25
111534193.0,6,31,2160,16,1071,7435612.866666666,123.0,66.9375,15,1089,7237709.142857143,123.0,72.6
2304.0,17,4,344,2,150,0.0,75.0,75.0,2,194,0.0,103.0,97.0
18527.0,6,10,2032,5,524,4383.5,252.0,104.8,5,1508,4231.0,1236.0,301.6
104073.0,17,2,286,2,286,0.0,143.0,143.0,0,0,0.0,0.0,0.0
135133058.0,17,6,1146,6,1146,27026611.6,191.0,191.0,0,0,0.0,0.0,0.0
130912.0,6,2,132,1,66,0.0,66.0,66.0,1,66,0.0,66.0,66.0
317590.0,17,4,1400,4,1400,105863.33333333331,350.0,350.0,0,0,0.0,0.0,0.0
105270913.0,17,14,4788,14,4788,8097762.538461538,342.0,342.0,0,0,0.0,0.0,0.0
1779739.0,6,2,132,1,66,0.0,66.0,66.0,1,66,0.0,66.0,66.0
232680.0,6,3,337,2,214,0.0,160.0,107.0,1,123,0.0,123.0,123.0
120091940.0,6,218,24662,109,7416,1104725.388888889,140.0,68.03669724770643,109,17246,1104374.9444444445,284.0,158.22018348623854
10443230.0,6,6,412,3,206,5153522.0,74.0,68.66666666666667,3,206,5153413.0,74.0,68.66666666666667
70049.0,6,14,4740,7,653,11173.833333333334,249.0,93.28571428571428,7,4087,10355.0,1514.0,583.8571428571429
310612.0,6,6,412,4,272,103537.33333333331,74.0,68.0,2,140,0.0,74.0,70.0
108105009.0,17,5,955,5,955,27026252.25,191.0,191.0,0,0,0.0,0.0,0.0
2795591.0,6,2,132,1,66,0.0,66.0,66.0,1,66,0.0,66.0,66.0
205880.0,17,2,180,1,90,0.0,90.0,90.0,1,90,0.0,90.0,90.0
33855.0,6,10,2032,5,524,8261.75,252.0,104.8,5,1508,8203.0,1236.0,301.6
215473.0,6,3,426,2,280,0.0,214.0,140.0,1,146,0.0,146.0,146.0
216623.0,17,2,180,1,90,0.0,90.0,90.0,1,90,0.0,90.0,90.0
4144.0,17,4,344,2,150,0.0,75.0,75.0,2,194,0.0,103.0,97.0
120125251.0,6,13,2036,5,1020,30031312.75,204.0,204.0,8,1016,17135680.85714286,188.0,127.0
150610.0,6,3,337,2,214,0.0,160.0,107.0,1,123,0.0,123.0,123.0
1092113.0,6,13,1386,7,789,182018.8333333333,253.0,112.71428571428572,6,597,214658.4,259.0,99.5
0.0,17,1,90,1,90,0.0,90.0,90.0,0,0,0.0,0.0,0.0
9382.0,17,2,571,1,86,0.0,86.0,86.0,1,485,0.0,485.0,485.0
35893.0,6,14,4740,7,653,5592.5,249.0,93.28571428571428,7,4087,5844.0,1514.0,583.8571428571429
10486188.0,6,7,478,4,272,3449819.6666666665,74.0,68.0,3,206,5174620.0,74.0,68.66666666666667
303102.0,6,2,132,1,66,0.0,66.0,66.0,1,66,0.0,66.0,66.0
0.0,17,1,201,1,201,0.0,201.0,201.0,0,0,0.0,0.0,0.0
2800090.0,6,3,1604,1,753,0.0,753.0,753.0,2,851,0.0,785.0,425.5
27438.0,6,10,2032,5,524,6626.25,252.0,104.8,5,1508,6614.5,1236.0,301.6
2350.0,17,4,344,2,150,0.0,75.0,75.0,2,194,0.0,103.0,97.0
99113.0,17,2,762,2,762,0.0,381.0,381.0,0,0,0.0,0.0,0.0
10418242.0,6,6,412,3,206,5140967.0,74.0,68.66666666666667,3,206,5140870.5,74.0,68.66666666666667
210166.0,17,2,414,1,88,0.0,88.0,88.0,1,326,0.0,326.0,326.0
255415.0,6,3,337,2,214,0.0,160.0,107.0,1,123,0.0,123.0,123.0
314477.0,6,6,412,4,272,104825.66666666669,74.0,68.0,2,140,0.0,74.0,70.0
197037.0,17,2,180,1,90,0.0,90.0,90.0,1,90,0.0,90.0,90.0
2522084.0,6,51,23848,26,19851,100883.36,1514.0,763.5,25,3997,96452.16666666669,1514.0,159.88
72587.0,6,14,4740,7,653,11331.333333333334,249.0,93.28571428571428,7,4087,11143.166666666666,1514.0,583.8571428571429
53870.0,6,10,2032,5,524,12813.25,252.0,104.8,5,1508,13235.75,1236.0,301.6
2922577.0,6,11,2106,6,598,583840.0,252.0,99.66666666666669,5,1508,2457.0,1236.0,301.6
219134.0,6,3,426,2,280,0.0,214.0,140.0,1,146,0.0,146.0,146.0
108103954.0,17,5,1005,5,1005,27025988.5,201.0,201.0,0,0,0.0,0.0,0.0
761397.0,6,14,4740,7,653,126763.33333333331,249.0,93.28571428571428,7,4087,126500.16666666669,1514.0,583.8571428571429
2353.0,17,4,344,2,150,0.0,75.0,75.0,2,194,0.0,103.0,97.0
35629.0,6,14,4740,7,653,5749.833333333333,249.0,93.28571428571428,7,4087,5623.166666666667,1514.0,583.8571428571429
309775.0,6,6,412,4,272,103258.33333333331,74.0,68.0,2,140,0.0,74.0,70.0
153431.0,17,2,180,1,90,0.0,90.0,90.0,1,90,0.0,90.0,90.0
2636739.0,6,28,9211,16,3859,175782.6,1514.0,241.1875,12,5352,215445.0909090909,1514.0,446.0
1719961.0,6,20,7599,11,1469,171996.1,583.0,133.54545454545453,9,6130,182833.625,1484.0,681.1111111111111
135133771.0,17,6,1146,6,1146,27026754.2,191.0,191.0,0,0,0.0,0.0,0.0
5000193.0,17,4,376,2,152,0.0,76.0,76.0,2,224,0.0,148.0,112.0
102240282.0,6,42,2772,21,1386,5112001.15,66.0,66.0,21,1386,5112000.6,66.0,66.0
5831931.0,6,5,1909,2,892,0.0,826.0,446.0,3,1017,2475812.0,885.0,339.0
300707.0,6,6,412,4,272,100235.66666666669,74.0,68.0,2,140,0.0,74.0,70.0
90584296.0,6,18,2555,9,1284,11323037.0,204.0,142.66666666666666,9,1271,11302782.125,199.0,141.22222222222223
53079.0,6,11,1131,6,600,9890.6,262.0,100.0,5,531,10743.0,259.0,106.2
33943.0,6,14,4740,7,653,5199.333333333333,249.0,93.28571428571428,7,4087,5518.166666666667,1514.0,583.8571428571429
35600.0,6,14,4740,7,653,5038.166666666667,249.0,93.28571428571428,7,4087,5792.166666666667,1514.0,583.8571428571429
120068244.0,17,29,13785,29,13785,4288151.571428572,501.0,475.3448275862069,0,0,0.0,0.0,0.0
9277.0,17,2,539,1,86,0.0,86.0,86.0,1,453,0.0,453.0,453.0
298203.0,6,6,412,4,272,99401.0,74.0,68.0,2,140,0.0,74.0,70.0
23938.0,6,14,4740,7,653,3522.833333333333,249.0,93.28571428571428,7,4087,3538.0,1514.0,583.8571428571429
7332.0,17,2,582,1,83,0.0,83.0,83.0,1,499,0.0,499.0,499.0
41554.0,6,14,4740,7,653,6805.0,249.0,93.28571428571428,7,4087,6251.166666666667,1514.0,583.8571428571429
216503.0,17,2,180,1,90,0.0,90.0,90.0,1,90,0.0,90.0,90.0
36704.0,6,14,4740,7,653,6010.166666666667,249.0,93.28571428571428,7,4087,5244.666666666667,1514.0,583.8571428571429
123469870.0,6,31,2034,16,1086,8231324.666666667,123.0,67.875,15,948,8090669.0,123.0,63.2
92872773.0,17,11,735,6,389,18574554.6,174.0,64.83333333333333,5,346,18290583.25,174.0,69.2
352.0,17,2,267,1,83,0.0,83.0,83.0,1,184,0.0,184.0,184.0
955265.0,6,10,1334,6,797,191053.0,459.0,132.83333333333334,4,537,226683.66666666663,331.0,134.25
2432.0,17,4,344,2,150,0.0,75.0,75.0,2,194,0.0,103.0,97.0
1310101.0,6,4,264,2,132,0.0,66.0,66.0,2,132,0.0,66.0,66.0
200551.0,17,2,180,1,90,0.0,90.0,90.0,1,90,0.0,90.0,90.0
218032.0,6,3,426,2,280,0.0,214.0,140.0,1,146,0.0,146.0,146.0
63652.0,6,14,4740,7,653,10393.0,249.0,93.28571428571428,7,4087,9897.833333333334,1514.0,583.8571428571429
238492.0,17,4,1524,4,1524,79497.33333333333,381.0,381.0,0,0,0.0,0.0,0.0
135137718.0,17,6,1206,6,1206,27027543.6,201.0,201.0,0,0,0.0,0.0,0.0
39657.0,6,11,2098,6,590,7086.2,252.0,98.33333333333331,5,1508,8614.75,1236.0,301.6
90009208.0,17,27,12943,27,12943,3461892.6153846155,501.0,479.3703703703704,0,0,0.0,0.0,0.0
47602.0,6,14,4740,7,653,7761.166666666667,249.0,93.28571428571428,7,4087,6428.833333333333,1514.0,583.8571428571429
108106272.0,17,5,955,5,955,27026568.0,191.0,191.0,0,0,0.0,0.0,0.0
117455933.0,6,39,3024,21,1638,5862004.6,123.0,78.0,18,1386,6896473.94117647,123.0,77.0
232454.0,6,3,337,2,214,0.0,160.0,107.0,1,123,0.0,123.0,123.0
42567.0,6,10,2032,5,524,10096.75,252.0,104.8,5,1508,8949.25,1236.0,301.6
2453.0,17,4,344,2,150,0.0,75.0,75.0,2,194,0.0,103.0,97.0
9050.0,17,4,823,2,163,0.0,89.0,81.5,2,660,0.0,443.0,330.0
144757.0,17,2,180,1,70,0.0,70.0,70.0,1,110,0.0,110.0,110.0
2598171.0,6,2,132,1,66,0.0,66.0,66.0,1,66,0.0,66.0,66.0
41178.0,6,14,4740,7,653,6642.166666666667,249.0,93.28571428571428,7,4087,6034.0,1514.0,583.8571428571429
90261772.0,6,12,1832,8,1016,12894538.857142856,188.0,127.0,4,816,30032309.666666668,204.0,204.0
196858.0,17,2,180,1,90,0.0,90.0,90.0,1,90,0.0,90.0,90.0
107394.0,17,2,286,2,286,0.0,143.0,143.0,0,0,0.0,0.0,0.0
108109958.0,17,5,1005,5,1005,27027489.5,201.0,201.0,0,0,0.0,0.0,0.0
2020843.0,17,4,525,2,150,0.0,75.0,75.0,2,375,0.0,284.0,187.5
90025832.0,17,28,13364,28,13364,3334290.074074074,501.0,477.2857142857143,0,0,0.0,0.0,0.0
349.0,17,2,267,1,83,0.0,83.0,83.0,1,184,0.0,184.0,184.0
90045961.0,17,28,13364,28,13364,3335035.592592593,501.0,477.2857142857143,0,0,0.0,0.0,0.0
29392.0,6,14,4740,7,653,4091.6666666666665,249.0,93.28571428571428,7,4087,4756.333333333333,1514.0,583.8571428571429
2842595.0,6,3,204,2,136,0.0,70.0,68.0,1,68,0.0,68.0,68.0
135135972.0,17,6,1146,6,1146,27027194.4,191.0,191.0,0,0,0.0,0.0,0.0
90258276.0,6,13,2036,8,1016,12894039.42857143,188.0,127.0,5,1020,22523954.25,204.0,204.0
108096447.0,17,5,1005,5,1005,27024111.75,201.0,201.0,0,0,0.0,0.0,0.0
968965.0,6,20,6434,12,1921,88087.72727272728,620.0,160.08333333333334,8,4513,116101.14285714286,1514.0,564.125
51353.0,6,14,4740,7,653,8388.833333333334,249.0,93.28571428571428,7,4087,6130.5,1514.0,583.8571428571429
32608.0,6,14,4740,7,653,4479.833333333333,249.0,93.28571428571428,7,4087,5253.166666666667,1514.0,583.8571428571429
25070.0,6,13,1386,7,789,3836.6666666666665,253.0,112.71428571428572,6,597,3839.2,259.0,99.5
205529.0,17,2,762,2,762,0.0,381.0,381.0,0,0,0.0,0.0,0.0
135129355.0,17,6,1206,6,1206,27025871.0,201.0,201.0,0,0,0.0,0.0,0.0
33450.0,6,11,2098,6,590,5630.4,252.0,98.33333333333331,5,1508,6110.25,1236.0,301.6
144170.0,17,2,180,1,90,0.0,90.0,90.0,1,90,0.0,90.0,90.0
22958.0,6,14,4740,7,653,3471.0,249.0,93.28571428571428,7,4087,3537.6666666666665,1514.0,583.8571428571429
840.0,17,4,438,2,148,0.0,74.0,74.0,2,290,0.0,147.0,145.0
120126977.0,6,14,2224,9,1204,15015872.125,188.0,133.77777777777777,5,1020,22522813.5,204.0,204.0
2778379.0,6,5,336,3,202,1389189.5,70.0,67.33333333333333,2,134,0.0,68.0,67.0
3857.0,17,2,762,2,762,0.0,381.0,381.0,0,0,0.0,0.0,0.0
90064903.0,17,28,13364,28,13364,3335737.1481481483,501.0,477.2857142857143,0,0,0.0,0.0,0.0
5254.0,17,2,762,2,762,0.0,381.0,381.0,0,0,0.0,0.0,0.0
9155.0,17,4,823,2,163,0.0,89.0,81.5,2,660,0.0,443.0,330.0
328257.0,6,6,412,4,272,109419.0,74.0,68.0,2,140,0.0,74.0,70.0
101001295.0,17,13,1083,7,563,16833549.166666668,174.0,80.42857142857143,6,520,17007319.6,174.0,86.66666666666667
104350337.0,6,28,1876,14,982,8010332.153846154,139.0,70.14285714285714,14,894,8010333.615384615,123.0,63.85714285714285
209500.0,17,2,180,1,90,0.0,90.0,90.0,1,90,0.0,90.0,90.0
120368723.0,6,239,27128,120,18978,1011501.8739495798,374.0,158.15,119,8150,1003516.1016949152,140.0,68.4873949579832
113456150.0,6,46,3036,23,1518,5157086.090909091,66.0,66.0,23,1518,5157086.0,66.0,66.0
36794.0,6,10,2032,5,524,8877.25,252.0,104.8,5,1508,8896.5,1236.0,301.6
101218918.0,6,197,22158,99,15468,1030649.9387755102,284.0,156.24242424242425,98,6690,1040008.793814433,140.0,68.26530612244898
412.0,17,2,166,1,75,0.0,75.0,75.0,1,91,0.0,91.0,91.0
48734.0,6,14,4740,7,653,7468.666666666667,249.0,93.28571428571428,7,4087,7986.666666666667,1514.0,583.8571428571429
27723.0,6,13,4416,6,409,5397.8,127.0,68.16666666666667,7,4007,4430.166666666667,1514.0,572.4285714285714
14639804.0,6,19,1553,9,921,1792255.5,315.0,102.33333333333331,10,632,1593084.6666666667,78.0,63.2
303392.0,6,6,412,4,272,101130.66666666669,74.0,68.0,2,140,0.0,74.0,70.0
107328.0,17,2,286,2,286,0.0,143.0,143.0,0,0,0.0,0.0,0.0
2398.0,17,4,344,2,150,0.0,75.0,75.0,2,194,0.0,103.0,97.0
108104844.0,17,5,955,5,955,27026211.0,191.0,191.0,0,0,0.0,0.0,0.0
303163.0,6,6,412,4,272,101054.33333333331,74.0,68.0,2,140,0.0,74.0,70.0
331536.0,6,6,412,4,272,110512.0,74.0,68.0,2,140,0.0,74.0,70.0
595105.0,6,4,508,2,238,0.0,172.0,119.0,2,270,0.0,135.0,135.0
61152659.0,6,6,674,4,428,20384219.666666668,160.0,107.0,2,246,0.0,123.0,123.0
219825.0,6,2,132,1,66,0.0,66.0,66.0,1,66,0.0,66.0,66.0
2798549.0,6,2,132,1,66,0.0,66.0,66.0,1,66,0.0,66.0,66.0
126451370.0,6,33,2434,18,1348,7438315.882352941,139.0,74.88888888888889,15,1086,8303464.642857143,123.0,72.4
0.0,17,1,453,1,453,0.0,453.0,453.0,0,0,0.0,0.0,0.0
119455295.0,17,35,16705,35,16705,3513391.029411765,501.0,477.2857142857143,0,0,0.0,0.0,0.0
236192.0,6,3,337,2,214,0.0,160.0,107.0,1,123,0.0,123.0,123.0
202803.0,17,2,180,1,90,0.0,90.0,90.0,1,90,0.0,90.0,90.0
119181276.0,6,509,69016,255,51956,469217.6220472441,426.0,203.7490196078432,254,17060,468434.2015810277,140.0,67.16535433070867
378.0,17,2,208,1,72,0.0,72.0,72.0,1,136,0.0,136.0,136.0
15087296.0,17,6,2718,6,2718,3017459.2,453.0,453.0,0,0,0.0,0.0,0.0
222347.0,6,10,1221,6,636,44469.4,298.0,106.0,4,585,71525.66666666667,379.0,146.25
318973.0,6,3,202,2,128,0.0,74.0,64.0,1,74,0.0,74.0,74.0
2638235.0,6,3,204,2,136,0.0,70.0,68.0,1,68,0.0,68.0,68.0
90052023.0,17,28,13364,28,13364,3335260.111111111,501.0,477.2857142857143,0,0,0.0,0.0,0.0
90215548.0,6,21,1585,10,745,9995907.444444444,95.0,74.5,11,840,9000008.2,95.0,76.36363636363636
120041139.0,6,19,1395,10,745,13332439.222222222,95.0,74.5,9,650,14998953.125,95.0,72.22222222222223
298079.0,6,6,412,4,272,99359.66666666669,74.0,68.0,2,140,0.0,74.0,70.0
256980.0,6,10,1221,6,636,51396.0,298.0,106.0,4,585,80144.0,379.0,146.25
156511.0,6,10,1066,5,490,38328.0,218.0,98.0,5,576,31423.0,304.0,115.2
108097479.0,17,5,955,5,955,27024369.75,191.0,191.0,0,0,0.0,0.0,0.0
120394358.0,6,207,23448,104,16354,1168877.2621359224,374.0,157.25,103,7094,1139716.0784313723,140.0,68.87378640776699
98755070.0,17,12,778,6,389,19600810.4,174.0,64.83333333333333,6,389,19600152.8,174.0,64.83333333333333
360.0,17,2,166,1,75,0.0,75.0,75.0,1,91,0.0,91.0,91.0
63627.0,6,14,4740,7,653,10342.666666666666,249.0,93.28571428571428,7,4087,8470.0,1514.0,583.8571428571429
20038.0,17,2,582,1,83,0.0,83.0,83.0,1,499,0.0,499.0,499.0
6161.0,17,2,180,1,90,0.0,90.0,90.0,1,90,0.0,90.0,90.0
16993.0,17,2,582,1,83,0.0,83.0,83.0,1,499,0.0,499.0,499.0
297705.0,6,7,478,4,272,99235.0,74.0,68.0,3,206,72898.0,74.0,68.66666666666667
120019961.0,17,29,13785,29,13785,4286427.178571428,501.0,475.3448275862069,0,0,0.0,0.0,0.0
228286.0,17,2,180,1,90,0.0,90.0,90.0,1,90,0.0,90.0,90.0
10924087.0,6,8,544,4,272,3595128.6666666665,74.0,68.0,4,272,3595067.0,74.0,68.0
10437264.0,6,6,412,3,206,5148788.0,74.0,68.66666666666667,3,206,5148690.0,74.0,68.66666666666667
307704.0,6,6,412,4,272,102568.0,74.0,68.0,2,140,0.0,74.0,70.0
105144.0,17,2,762,2,762,0.0,381.0,381.0,0,0,0.0,0.0,0.0
120312785.0,6,231,26268,116,18444,1046198.1304347826,374.0,159.0,115,7824,1046146.6578947369,140.0,68.03478260869565
47609231.0,6,7,1874,3,887,22790093.5,753.0,295.6666666666667,4,987,14944425.333333334,785.0,246.75
1040080.0,6,13,1386,7,789,173346.66666666666,253.0,112.71428571428572,6,597,205910.0,259.0,99.5
303182.0,6,2,132,1,66,0.0,66.0,66.0,1,66,0.0,66.0,66.0
76973.0,6,14,4740,7,653,11711.166666666666,249.0,93.28571428571428,7,4087,12181.0,1514.0,583.8571428571429
233821.0,6,3,373,2,238,0.0,172.0,119.0,1,135,0.0,135.0,135.0
5630964.0,6,5,336,2,134,0.0,68.0,67.0,3,202,1523410.5,70.0,67.33333333333333
516836.0,6,3,1604,2,851,0.0,785.0,425.5,1,753,0.0,753.0,753.0
120434139.0,6,225,25468,113,17780,1075304.8125,284.0,157.34513274336285,112,7688,1075617.7567567567,140.0,68.64285714285714
53246.0,6,14,4740,7,653,8752.166666666666,249.0,93.28571428571428,7,4087,7607.666666666667,1514.0,583.8571428571429
228517.0,17,2,180,1,90,0.0,90.0,90.0,1,90,0.0,90.0,90.0
708.0,17,4,438,2,148,0.0,74.0,74.0,2,290,0.0,147.0,145.0
2327.0,17,4,344,2,150,0.0,75.0,75.0,2,194,0.0,103.0,97.0
867091.0,17,6,1230,3,234,433359.5,78.0,78.0,3,996,433326.5,332.0,332.0
147983.0,17,2,180,1,90,0.0,90.0,90.0,1,90,0.0,90.0,90.0
3911.000000000001,17,2,538,1,81,0.0,81.0,81.0,1,457,0.0,457.0,457.0
90091473.0,6,10,1440,7,828,15015245.5,188.0,118.28571428571428,3,612,30045291.5,204.0,204.0
2299.0,17,4,344,2,150,0.0,75.0,75.0,2,194,0.0,103.0,97.0
14782.0,6,10,2032,5,524,3464.75,252.0,104.8,5,1508,2867.0,1236.0,301.6
102144.0,17,2,286,2,286,0.0,143.0,143.0,0,0,0.0,0.0,0.0
298865.0,6,6,412,4,272,99621.66666666669,74.0,68.0,2,140,0.0,74.0,70.0
95896142.0,6,249,29672,125,21266,773355.9838709678,300.0,170.128,124,8406,771294.5447154471,140.0,67.79032258064517
228125.0,17,2,180,1,90,0.0,90.0,90.0,1,90,0.0,90.0,90.0
50091.0,6,14,4740,7,653,7114.333333333333,249.0,93.28571428571428,7,4087,8189.333333333333,1514.0,583.8571428571429
209814.0,6,10,1221,6,636,41962.8,298.0,106.0,4,585,69064.66666666667,379.0,146.25
125849688.0,6,38,2716,20,1468,6623667.7894736845,139.0,73.4,18,1248,6803522.176470588,123.0,69.33333333333333
46829.0,6,13,1386,7,789,7534.0,253.0,112.71428571428572,6,597,9125.4,259.0,99.5
2350.0,17,4,344,2,150,0.0,75.0,75.0,2,194,0.0,103.0,97.0
90009645.0,6,19,1436,10,786,10001071.666666666,95.0,78.6,9,650,11214505.125,95.0,72.22222222222223
2050.0,17,4,344,2,150,0.0,75.0,75.0,2,194,0.0,103.0,97.0
233304.0,6,3,373,2,238,0.0,172.0,119.0,1,135,0.0,135.0,135.0
2027473.0,6,2,132,1,66,0.0,66.0,66.0,1,66,0.0,66.0,66.0
135131206.0,17,6,1146,6,1146,27026241.2,191.0,191.0,0,0,0.0,0.0,0.0
120049852.0,17,28,13364,28,13364,4446290.814814814,501.0,477.2857142857143,0,0,0.0,0.0,0.0
308258.0,6,6,412,4,272,102752.66666666669,74.0,68.0,2,140,0.0,74.0,70.0
2597586.0,6,2,132,1,66,0.0,66.0,66.0,1,66,0.0,66.0,66.0
90259279.0,6,13,2036,8,1016,12894182.714285716,188.0,127.0,5,1020,22522741.5,204.0,204.0
1258.0,17,2,508,2,508,0.0,257.0,254.0,0,0,0.0,0.0,0.0
310309.0,17,4,622,4,622,103436.33333333331,163.0,155.5,0,0,0.0,0.0,0.0
13933.0,6,11,1132,6,556,2440.4,218.0,92.66666666666669,5,576,3139.0,304.0,115.2
1134305.0,6,13,1386,7,789,189050.8333333333,253.0,112.71428571428572,6,597,225869.4,259.0,99.5
300391.0,6,6,412,4,272,100130.33333333331,74.0,68.0,2,140,0.0,74.0,70.0
90311127.0,6,19,1436,10,745,10029724.0,95.0,74.5,9,691,11287395.375,95.0,76.77777777777777
300.0,17,2,164,1,82,0.0,82.0,82.0,1,82,0.0,82.0,82.0
108108081.0,17,5,1005,5,1005,27027020.25,201.0,201.0,0,0,0.0,0.0,0.0
305518.0,6,7,478,4,272,101839.33333333331,74.0,68.0,3,206,77173.5,74.0,68.66666666666667
304187.0,17,4,704,2,148,0.0,74.0,74.0,2,556,0.0,280.0,278.0
6829.0,17,2,582,1,83,0.0,83.0,83.0,1,499,0.0,499.0,499.0
299555.0,6,6,412,4,272,99851.66666666669,74.0,68.0,2,140,0.0,74.0,70.0
219120.0,17,2,180,1,90,0.0,90.0,90.0,1,90,0.0,90.0,90.0
2278.0,17,4,344,2,150,0.0,75.0,75.0,2,194,0.0,103.0,97.0
304.0,17,2,156,1,78,0.0,78.0,78.0,1,78,0.0,78.0,78.0
32710835.000000004,6,5,336,2,134,0.0,68.0,67.0,3,202,16282950.5,70.0,67.33333333333333
307198.0,6,6,412,4,272,102399.33333333331,74.0,68.0,2,140,0.0,74.0,70.0
2425.0,17,4,344,2,150,0.0,75.0,75.0,2,194,0.0,103.0,97.0
254491.00000000003,6,3,337,2,214,0.0,160.0,107.0,1,123,0.0,123.0,123.0
10442046.0,6,7,478,4,272,3433758.333333333,74.0,68.0,3,206,5150519.0,74.0,68.66666666666667
39682.0,6,14,4740,7,653,6466.166666666667,249.0,93.28571428571428,7,4087,6277.166666666667,1514.0,583.8571428571429
90256225.0,6,14,2240,8,1016,12893746.42857143,188.0,127.0,6,1224,18018624.4,204.0,204.0
386937.0,6,3,202,2,128,0.0,74.0,64.0,1,74,0.0,74.0,74.0
135130753.0,17,6,1146,6,1146,27026150.6,191.0,191.0,0,0,0.0,0.0,0.0
103891.0,17,2,286,2,286,0.0,143.0,143.0,0,0,0.0,0.0,0.0
301626.0,17,2,246,1,76,0.0,76.0,76.0,1,170,0.0,170.0,170.0
90272439.0,6,20,1616,10,912,10030271.0,221.0,91.2,10,704,9997702.777777778,95.0,70.4
2998942.0,6,3,1777,2,951,0.0,885.0,475.5,1,826,0.0,826.0,826.0
108108755.0,17,5,1005,5,1005,27027188.75,201.0,201.0,0,0,0.0,0.0,0.0
122077.0,6,14,4740,7,653,20034.33333333333,249.0,93.28571428571428,7,4087,17517.166666666668,1514.0,583.8571428571429
297.0,17,2,156,1,78,0.0,78.0,78.0,1,78,0.0,78.0,78.0
324975.0,17,4,1400,4,1400,108325.0,350.0,350.0,0,0,0.0,0.0,0.0
786.0,17,4,438,2,148,0.0,74.0,74.0,2,290,0.0,147.0,145.0
0.0,17,1,55,1,55,0.0,55.0,55.0,0,0,0.0,0.0,0.0
84.0,17,2,762,2,762,0.0,381.0,381.0,0,0,0.0,0.0,0.0
266188.0,17,4,1400,4,1400,88729.33333333333,350.0,350.0,0,0,0.0,0.0,0.0
42177.0,6,10,2032,5,524,9831.25,252.0,104.8,5,1508,8406.75,1236.0,301.6
9380.0,17,2,582,1,83,0.0,83.0,83.0,1,499,0.0,499.0,499.0
301274.0,6,6,412,4,272,100424.66666666669,74.0,68.0,2,140,0.0,74.0,70.0
9809.0,17,2,582,1,83,0.0,83.0,83.0,1,499,0.0,499.0,499.0
309105.0,6,6,412,4,272,103035.0,74.0,68.0,2,140,0.0,74.0,70.0
209516.0,17,2,180,1,90,0.0,90.0,90.0,1,90,0.0,90.0,90.0
112310075.0,17,14,864,7,432,18666833.5,174.0,61.71428571428572,7,432,18667860.666666668,174.0,61.71428571428572
92077071.0,17,16,5472,16,5472,6138471.4,342.0,342.0,0,0,0.0,0.0,0.0
9478.0,17,2,582,1,83,0.0,83.0,83.0,1,499,0.0,499.0,499.0
487.0,17,2,174,1,79,0.0,79.0,79.0,1,95,0.0,95.0,95.0
212114.0,17,2,762,2,762,0.0,381.0,381.0,0,0,0.0,0.0,0.0
113618147.0,6,46,3036,23,1518,5150433.954545454,66.0,66.0,23,1518,5150440.727272728,66.0,66.0
14646774.0,6,20,1607,10,975,1593336.7777777778,315.0,97.5,10,632,1593318.4444444445,78.0,63.2
42538.0,6,10,2032,5,524,10426.75,252.0,104.8,5,1508,10052.75,1236.0,301.6
27970.0,6,14,4740,7,653,4138.5,249.0,93.28571428571428,7,4087,4376.5,1514.0,583.8571428571429
104700863.0,6,43,2838,22,1452,4972635.238095238,66.0,66.0,21,1386,5135450.15,66.0,66.0
120031828.0,17,29,13785,29,13785,4286851.0,501.0,475.3448275862069,0,0,0.0,0.0,0.0
31150.0,6,10,1065,5,534,5210.5,262.0,106.8,5,531,6931.25,259.0,106.2
153773.0,17,2,180,1,90,0.0,90.0,90.0,1,90,0.0,90.0,90.0
104526.0,17,2,286,2,286,0.0,143.0,143.0,0,0,0.0,0.0,0.0
209495.0,17,2,180,1,90,0.0,90.0,90.0,1,90,0.0,90.0,90.0
325.0,17,2,166,1,75,0.0,75.0,75.0,1,91,0.0,91.0,91.0
70680.0,6,12,1328,7,797,11780.0,253.0,113.85714285714286,5,531,13456.0,259.0,106.2
120538463.0,6,203,23026,102,16064,1193450.128712871,284.0,157.49019607843138,101,6962,1195014.69,140.0,68.93069306930693
183131.0,6,14,4740,7,653,26684.83333333333,249.0,93.28571428571428,7,4087,28939.33333333333,1514.0,583.8571428571429
0.0,6,1,54,1,54,0.0,54.0,54.0,0,0,0.0,0.0,0.0
90288265.0,6,16,1192,8,596,12892121.857142856,95.0,74.5,8,596,12897835.142857144,95.0,74.5
122530532.0,6,49,3234,25,1650,5105438.833333333,66.0,66.0,24,1584,4914740.0869565215,66.0,66.0
97634541.0,6,26,1746,13,906,8136211.75,123.0,69.6923076923077,13,840,8118194.25,123.0,64.61538461538461
62024.0,6,14,4740,7,653,9652.333333333334,249.0,93.28571428571428,7,4087,9725.333333333334,1514.0,583.8571428571429
0.0,6,1,66,1,66,0.0,66.0,66.0,0,0,0.0,0.0,0.0
312538.0,17,4,1400,4,1400,104179.33333333331,350.0,350.0,0,0,0.0,0.0,0.0
308149.0,6,6,412,4,272,102716.33333333331,74.0,68.0,2,140,0.0,74.0,70.0
0.0,6,1,66,1,66,0.0,66.0,66.0,0,0,0.0,0.0,0.0
216619.0,6,3,426,2,280,0.0,214.0,140.0,1,146,0.0,146.0,146.0
90538204.0,6,15,2444,8,1016,12934029.142857144,188.0,127.0,7,1428,15061768.333333334,204.0,204.0
889919.0,6,12,2717,7,742,148319.83333333334,338.0,106.0,5,1975,154287.0,1514.0,395.0
105818716.0,6,43,2838,22,1452,5038974.142857143,66.0,66.0,21,1386,5143994.7,66.0,66.0
865.0,17,4,438,2,148,0.0,74.0,74.0,2,290,0.0,147.0,145.0
216995.0,6,3,426,2,280,0.0,214.0,140.0,1,146,0.0,146.0,146.0
3581030.0,6,5,336,2,134,0.0,68.0,67.0,3,202,1424175.0,70.0,67.33333333333333
90259144.0,6,16,2368,9,1204,11282393.0,188.0,133.77777777777777,7,1164,15011444.166666666,204.0,166.28571428571428
308690.0,6,6,412,4,272,102896.66666666669,74.0,68.0,2,140,0.0,74.0,70.0
141180.0,6,2,132,1,66,0.0,66.0,66.0,1,66,0.0,66.0,66.0
24452887.0,17,5,1718,4,1368,781441.3333333334,342.0,342.0,1,350,0.0,350.0,350.0
121349.0,6,3,337,2,214,0.0,160.0,107.0,1,123,0.0,123.0,123.0
20301.0,17,3,1026,3,1026,10150.5,342.0,342.0,0,0,0.0,0.0,0.0
315999.0,17,4,1400,4,1400,105333.0,350.0,350.0,0,0,0.0,0.0,0.0
107759.0,17,2,762,2,762,0.0,381.0,381.0,0,0,0.0,0.0,0.0
5823454.0,6,5,336,2,134,0.0,68.0,67.0,3,202,1525863.5,70.0,67.33333333333333
217534.0,6,3,426,2,280,0.0,214.0,140.0,1,146,0.0,146.0,146.0
108113982.0,17,5,1005,5,1005,27028495.5,201.0,201.0,0,0,0.0,0.0,0.0
28867.0,6,14,4740,7,653,4641.666666666667,249.0,93.28571428571428,7,4087,4673.0,1514.0,583.8571428571429
204551.0,17,2,762,2,762,0.0,381.0,381.0,0,0,0.0,0.0,0.0
284015.0,17,2,363,1,79,0.0,79.0,79.0,1,284,0.0,284.0,284.0
108106686.0,17,5,955,5,955,27026671.5,191.0,191.0,0,0,0.0,0.0,0.0
156141.0,6,3,337,2,214,0.0,160.0,107.0,1,123,0.0,123.0,123.0
171635.0,17,2,180,1,90,0.0,90.0,90.0,1,90,0.0,90.0,90.0
27044815.0,17,5,1710,5,1710,6761203.75,342.0,342.0,0,0,0.0,0.0,0.0
120102407.0,6,926,191234,458,30894,262806.1422319475,214.0,67.45414847161572,468,160340,256697.4710920771,1514.0,342.6068376068376
359.0,17,2,267,1,83,0.0,83.0,83.0,1,184,0.0,184.0,184.0
51905.0,6,14,4740,7,653,8485.666666666666,249.0,93.28571428571428,7,4087,8269.666666666666,1514.0,583.8571428571429
108273.0,6,14,4740,7,653,17865.666666666668,249.0,93.28571428571428,7,4087,17533.333333333332,1514.0,583.8571428571429
1521.0,17,2,176,1,80,0.0,80.0,80.0,1,96,0.0,96.0,96.0
7032.0,17,2,582,1,83,0.0,83.0,83.0,1,499,0.0,499.0,499.0
347.0,17,2,166,1,75,0.0,75.0,75.0,1,91,0.0,91.0,91.0
107045.0,17,2,700,2,700,0.0,350.0,350.0,0,0,0.0,0.0,0.0
246249.0,6,3,198,2,132,0.0,66.0,66.0,1,66,0.0,66.0,66.0
226565.0,6,12,1373,7,714,37760.833333333336,298.0,102.0,5,659,54682.0,379.0,131.8
196913.0,17,2,180,1,90,0.0,90.0,90.0,1,90,0.0,90.0,90.0
71912.0,6,14,4740,7,653,10888.0,249.0,93.28571428571428,7,4087,11740.666666666666,1514.0,583.8571428571429
161150.0,6,2,128,1,74,0.0,74.0,74.0,1,54,0.0,54.0,54.0
120132099.0,6,12,1832,8,1016,17138642.42857143,188.0,127.0,4,816,30034558.666666668,204.0,204.0
144019.0,17,2,180,1,90,0.0,90.0,90.0,1,90,0.0,90.0,90.0
2432.0,17,4,344,2,150,0.0,75.0,75.0,2,194,0.0,103.0,97.0
45145.0,6,10,2032,5,524,9908.0,252.0,104.8,5,1508,11005.5,1236.0,301.6
345.0,17,2,267,1,83,0.0,83.0,83.0,1,184,0.0,184.0,184.0
13742.0,6,12,1393,6,796,2500.0,271.0,132.66666666666666,6,597,2488.0,259.0,99.5
2403.0,17,4,344,2,150,0.0,75.0,75.0,2,194,0.0,103.0,97.0
119957227.0,6,13,2036,5,1020,22522500.25,204.0,204.0,8,1016,17094372.285714287,188.0,127.0
318874.0,6,6,412,4,272,106291.33333333331,74.0,68.0,2,140,0.0,74.0,70.0
100137515.0,17,12,516,6,258,20000788.6,43.0,43.0,6,258,20000172.0,43.0,43.0
768.0,17,4,438,2,148,0.0,74.0,74.0,2,290,0.0,147.0,145.0
42082776.0,6,8,1307,8,1307,6011825.142857143,172.0,163.375,0,0,0.0,0.0,0.0
120082164.0,6,222,25010,111,7622,1066444.181818182,140.0,68.66666666666667,111,17388,1084218.1272727272,300.0,156.64864864864865
53709.0,6,14,4740,7,653,8794.333333333334,249.0,93.28571428571428,7,4087,8366.0,1514.0,583.8571428571429
3775265.0,6,5,336,2,134,0.0,68.0,67.0,3,202,1525402.0,70.0,67.33333333333333
94646622.0,6,22,1800,11,840,9094254.9,95.0,76.36363636363636,11,960,9464355.6,215.0,87.27272727272727
23044.0,6,10,2032,5,524,5314.0,252.0,104.8,5,1508,4981.75,1236.0,301.6
0.0,17,1,72,1,72,0.0,72.0,72.0,0,0,0.0,0.0,0.0
9335978.0,6,33,8878,17,4676,583498.625,1514.0,275.05882352941177,16,4202,601811.1333333333,1514.0,262.625
2039884.0,6,2,132,1,66,0.0,66.0,66.0,1,66,0.0,66.0,66.0
98156300.0,6,218,25630,109,18214,906861.3796296295,374.0,167.10091743119267,109,7416,906861.1851851852,140.0,68.03669724770643
438991.0,6,11,1021,6,444,58906.8,162.0,74.0,5,577,73559.5,349.0,115.4
2781732.0,6,2,132,1,66,0.0,66.0,66.0,1,66,0.0,66.0,66.0
153467.0,17,2,180,1,90,0.0,90.0,90.0,1,90,0.0,90.0,90.0
108106692.0,17,5,1005,5,1005,27026673.0,201.0,201.0,0,0,0.0,0.0,0.0
62200451.0,17,11,3770,10,3420,4562633.444444444,342.0,342.0,1,350,0.0,350.0,350.0
10457484.0,6,7,478,4,272,3440175.333333333,74.0,68.0,3,206,5160143.0,74.0,68.66666666666667
108109373.0,17,5,1005,5,1005,27027343.25,201.0,201.0,0,0,0.0,0.0,0.0
233078.0,6,3,337,2,214,0.0,160.0,107.0,1,123,0.0,123.0,123.0
1314737.0,6,4,264,2,132,0.0,66.0,66.0,2,132,0.0,66.0,66.0
233670.0,6,3,337,2,214,0.0,160.0,107.0,1,123,0.0,123.0,123.0
90033703.0,17,28,13364,28,13364,3334581.592592593,501.0,477.2857142857143,0,0,0.0,0.0,0.0
215455.0,17,2,180,1,90,0.0,90.0,90.0,1,90,0.0,90.0,90.0
2288.0,17,4,344,2,150,0.0,75.0,75.0,2,194,0.0,103.0,97.0
135122057.0,17,6,1146,6,1146,27024411.4,191.0,191.0,0,0,0.0,0.0,0.0
106659795.0,17,14,864,7,432,17666830.0,174.0,61.71428571428572,7,432,17667985.833333332,174.0,61.71428571428572
113682025.0,6,437,58938,219,44328,520488.2018348624,480.0,202.4109589041096,218,14610,522888.8571428572,140.0,67.01834862385321
5823843.0,6,5,336,2,134,0.0,68.0,67.0,3,202,1525585.0,70.0,67.33333333333333
135120148.0,17,6,1206,6,1206,27024029.6,201.0,201.0,0,0,0.0,0.0,0.0
22005.0,6,14,4740,7,653,3190.0,249.0,93.28571428571428,7,4087,2811.0,1514.0,583.8571428571429
109174.0,6,14,4740,7,653,18047.5,249.0,93.28571428571428,7,4087,18033.166666666668,1514.0,583.8571428571429
120125581.0,6,14,2240,6,1224,24025116.2,204.0,204.0,8,1016,17137346.14285714,188.0,127.0
10458048.0,6,6,412,3,206,5161243.0,74.0,68.66666666666667,3,206,5160974.0,74.0,68.66666666666667
83918.0,6,14,4740,7,653,13043.833333333334,249.0,93.28571428571428,7,4087,13394.5,1514.0,583.8571428571429
19112.0,6,13,1459,7,862,2925.5,271.0,123.14285714285714,6,597,3580.4,259.0,99.5
228223.0,17,2,180,1,90,0.0,90.0,90.0,1,90,0.0,90.0,90.0
49788.0,6,14,4740,7,653,8189.333333333333,249.0,93.28571428571428,7,4087,5776.5,1514.0,583.8571428571429
284197.0,17,2,363,1,79,0.0,79.0,79.0,1,284,0.0,284.0,284.0
20225.0,17,2,582,1,83,0.0,83.0,83.0,1,499,0.0,499.0,499.0
153382.0,17,2,180,1,90,0.0,90.0,90.0,1,90,0.0,90.0,90.0
135128593.0,17,6,1206,6,1206,27025718.6,201.0,201.0,0,0,0.0,0.0,0.0
2458621.0,6,2,132,1,66,0.0,66.0,66.0,1,66,0.0,66.0,66.0
241953.0,6,3,337,2,214,0.0,160.0,107.0,1,123,0.0,123.0,123.0
307426.0,6,3,202,2,128,0.0,74.0,64.0,1,74,0.0,74.0,74.0
45902.0,6,14,4740,7,653,7403.5,249.0,93.28571428571428,7,4087,5816.333333333333,1514.0,583.8571428571429
302463.0,6,2,132,1,66,0.0,66.0,66.0,1,66,0.0,66.0,66.0
53376.0,6,14,4740,7,653,8728.333333333334,249.0,93.28571428571428,7,4087,8688.166666666666,1514.0,583.8571428571429
135131590.0,17,6,1146,6,1146,27026318.0,191.0,191.0,0,0,0.0,0.0,0.0
90302380.0,6,23,1861,12,894,8204714.636363637,95.0,74.5,11,967,9000299.4,222.0,87.9090909090909
121801.0,6,3,337,2,214,0.0,160.0,107.0,1,123,0.0,123.0,123.0
92935691.0,6,29,2068,15,1105,6622821.142857143,139.0,73.66666666666667,14,963,7132260.923076923,123.0,68.78571428571429
98427.0,17,2,762,2,762,0.0,381.0,381.0,0,0,0.0,0.0,0.0
135143650.0,17,6,1146,6,1146,27028730.0,191.0,191.0,0,0,0.0,0.0,0.0
4491.0,17,4,797,2,144,0.0,72.0,72.0,2,653,0.0,526.0,326.5
298099.0,6,6,412,4,272,99366.33333333331,74.0,68.0,2,140,0.0,74.0,70.0
324728.0,17,4,1400,4,1400,108242.66666666669,350.0,350.0,0,0,0.0,0.0,0.0
119634110.0,6,222,25090,111,17468,1085627.0545454544,284.0,157.36936936936937,111,7622,1085626.7454545454,140.0,68.66666666666667
207204.0,6,3,426,2,280,0.0,214.0,140.0,1,146,0.0,146.0,146.0
104951546.0,17,13,952,7,563,17491924.333333332,174.0,80.42857142857143,6,389,16953478.0,174.0,64.83333333333333
120032554.0,17,28,13364,28,13364,4445650.148148148,501.0,477.2857142857143,0,0,0.0,0.0,0.0
735379.0,6,14,4740,7,653,122385.16666666669,249.0,93.28571428571428,7,4087,122091.66666666669,1514.0,583.8571428571429
1672128.0,6,2,132,1,66,0.0,66.0,66.0,1,66,0.0,66.0,66.0
120766306.0,17,14,1126,7,563,16834679.333333332,174.0,80.42857142857143,7,563,16833493.166666668,174.0,80.42857142857143
9859.0,17,2,582,1,83,0.0,83.0,83.0,1,499,0.0,499.0,499.0
44462.0,6,14,4740,7,653,7279.166666666667,249.0,93.28571428571428,7,4087,7121.0,1514.0,583.8571428571429
90011180.0,17,28,13364,28,13364,3333747.407407407,501.0,477.2857142857143,0,0,0.0,0.0,0.0
196958.0,17,2,180,1,90,0.0,90.0,90.0,1,90,0.0,90.0,90.0
119769992.0,6,29,2181,16,1192,7984666.133333334,95.0,74.5,13,989,9959662.166666666,95.0,76.07692307692308
155446.0,17,4,6056,4,6056,51815.333333333336,1514.0,1514.0,0,0,0.0,0.0,0.0
107496.0,17,2,286,2,286,0.0,143.0,143.0,0,0,0.0,0.0,0.0
107389.0,17,2,286,2,286,0.0,143.0,143.0,0,0,0.0,0.0,0.0
23163.0,6,10,2032,5,524,5563.75,252.0,104.8,5,1508,5621.0,1236.0,301.6
228151.0,17,2,180,1,90,0.0,90.0,90.0,1,90,0.0,90.0,90.0
90579706.0,6,16,2372,8,1016,12939958.0,188.0,127.0,8,1356,12915283.714285716,204.0,169.5
135120044.0,17,6,1146,6,1146,27024008.8,191.0,191.0,0,0,0.0,0.0,0.0
49595.0,6,14,4740,7,653,7560.333333333333,249.0,93.28571428571428,7,4087,7251.333333333333,1514.0,583.8571428571429
151090.0,17,2,414,1,88,0.0,88.0,88.0,1,326,0.0,326.0,326.0
32947.0,6,14,4740,7,653,5381.5,249.0,93.28571428571428,7,4087,5351.5,1514.0,583.8571428571429
117285403.0,6,209,23686,105,16526,1127744.2596153845,284.0,157.3904761904762,104,7160,1128651.6019417476,140.0,68.84615384615384
312303.0,17,4,622,4,622,104101.0,163.0,155.5,0,0,0.0,0.0,0.0
325619.0,6,6,412,4,272,108539.66666666669,74.0,68.0,2,140,0.0,74.0,70.0
147071.0,6,3,373,2,238,0.0,172.0,119.0,1,135,0.0,135.0,135.0
16240.000000000002,6,14,4740,7,653,2543.0,249.0,93.28571428571428,7,4087,2567.833333333333,1514.0,583.8571428571429
108107935.0,17,5,955,5,955,27026983.75,191.0,191.0,0,0,0.0,0.0,0.0
8890582.0,17,4,1376,3,1026,836863.0,342.0,342.0,1,350,0.0,350.0,350.0
108104514.0,17,5,955,5,955,27026128.5,191.0,191.0,0,0,0.0,0.0,0.0
107337.0,17,2,286,2,286,0.0,143.0,143.0,0,0,0.0,0.0,0.0
58272.0,6,10,2032,5,524,12424.75,252.0,104.8,5,1508,13906.5,1236.0,301.6
97098094.0,6,186,20982,93,14622,1053190.3695652173,284.0,157.2258064516129,93,6360,1053191.1195652173,140.0,68.38709677419355
56424.0,6,14,4740,7,653,7682.833333333333,249.0,93.28571428571428,7,4087,9224.5,1514.0,583.8571428571429
93857979.0,6,267,31052,134,9078,705699.090225564,140.0,67.74626865671642,133,21974,704122.7121212122,300.0,165.21804511278197
90527539.0,6,14,2240,8,1016,12932505.57142857,188.0,127.0,6,1224,18073185.8,204.0,204.0
103218920.0,17,14,1126,7,563,17176472.0,174.0,80.42857142857143,7,563,17176471.166666668,174.0,80.42857142857143
171963.0,17,2,180,1,90,0.0,90.0,90.0,1,90,0.0,90.0,90.0
114472435.0,6,210,23774,105,16622,1098613.8846153845,284.0,158.3047619047619,105,7152,1098556.7692307692,140.0,68.11428571428571
216250.0,17,2,180,1,90,0.0,90.0,90.0,1,90,0.0,90.0,90.0
3650808.0,6,201,167357,116,157445,31746.15652173913,1510.0,1357.2844827586207,85,9912,39750.19047619047,1510.0,116.61176470588236
146986.0,6,3,373,2,238,0.0,172.0,119.0,1,135,0.0,135.0,135.0
121357.0,6,3,337,2,214,0.0,160.0,107.0,1,123,0.0,123.0,123.0
24370.0,6,10,2032,5,524,5345.25,252.0,104.8,5,1508,5506.25,1236.0,301.6
10027.0,6,11,2098,6,590,1808.8,252.0,98.33333333333331,5,1508,2236.75,1236.0,301.6
2590042.0,6,2,132,1,66,0.0,66.0,66.0,1,66,0.0,66.0,66.0
812.0,17,4,438,2,148,0.0,74.0,74.0,2,290,0.0,147.0,145.0
11337.0,6,11,1133,6,602,2267.4,264.0,100.33333333333331,5,531,2348.5,259.0,106.2
305.0,17,2,164,1,82,0.0,82.0,82.0,1,82,0.0,82.0,82.0
113625623.0,6,34,2350,17,1225,7088114.625,139.0,72.05882352941177,17,1125,7088111.1875,123.0,66.17647058823529
155355.0,6,3,337,2,214,0.0,160.0,107.0,1,123,0.0,123.0,123.0
108103487.0,17,5,955,5,955,27025871.75,191.0,191.0,0,0,0.0,0.0,0.0
135135019.0,17,6,1146,6,1146,27027003.8,191.0,191.0,0,0,0.0,0.0,0.0
284969.0,17,4,704,2,148,0.0,74.0,74.0,2,556,0.0,280.0,278.0
65112.0,6,14,4740,7,653,10739.0,249.0,93.28571428571428,7,4087,10649.5,1514.0,583.8571428571429
1318484.0,6,4,264,2,132,0.0,66.0,66.0,2,132,0.0,66.0,66.0
32755.0,6,13,1479,7,882,5459.166666666667,291.0,126.0,6,597,5861.2,259.0,99.5
21466.0,6,10,2032,5,524,5119.0,252.0,104.8,5,1508,4739.5,1236.0,301.6
13661.0,6,11,2098,6,590,2597.0,252.0,98.33333333333331,5,1508,3024.5,1236.0,301.6
3050613.0,6,3,204,2,136,0.0,70.0,68.0,1,68,0.0,68.0,68.0
120121801.0,6,13,2020,9,1204,15015225.125,188.0,133.77777777777777,4,816,30032376.33333333,204.0,204.0
252497.00000000003,6,3,337,2,214,0.0,160.0,107.0,1,123,0.0,123.0,123.0
344.0,17,2,166,1,83,0.0,83.0,83.0,1,83,0.0,83.0,83.0
326.0,17,2,160,1,80,0.0,80.0,80.0,1,80,0.0,80.0,80.0
116792271.0,6,48,3168,24,1584,5077924.826086956,66.0,66.0,24,1584,5064262.869565218,66.0,66.0
264318.0,6,10,1221,6,636,52863.6,298.0,106.0,4,585,82027.33333333333,379.0,146.25
113889307.0,6,48,3168,24,1584,4951709.0,66.0,66.0,24,1584,4938249.260869565,66.0,66.0
847155.0,6,9,1118,6,586,169431.0,248.0,97.66666666666669,3,532,285752.0,392.0,177.33333333333334
243862.0,6,3,337,2,214,0.0,160.0,107.0,1,123,0.0,123.0,123.0
143972.0,17,2,180,1,90,0.0,90.0,90.0,1,90,0.0,90.0,90.0
263199.0,6,10,1221,6,636,52639.8,298.0,106.0,4,585,86478.66666666666,379.0,146.25
18360.0,6,11,1133,6,602,3357.4,264.0,100.33333333333331,5,531,3371.5,259.0,106.2
2546026.0,6,25,7573,14,3735,195848.15384615384,1514.0,266.7857142857143,11,3838,227048.8,1514.0,348.90909090909093
1306730.0,6,4,264,2,132,0.0,66.0,66.0,2,132,0.0,66.0,66.0
103459124.0,17,14,864,7,432,17168011.333333332,174.0,61.71428571428572,7,432,17166829.333333332,174.0,61.71428571428572
1028513.0,6,11,1134,6,558,205702.60000000003,220.0,93.0,5,576,255917.5,304.0,115.2
38205.0,6,14,4740,7,653,6152.0,249.0,93.28571428571428,7,4087,6229.833333333333,1514.0,583.8571428571429
108102939.0,17,5,955,5,955,27025734.75,191.0,191.0,0,0,0.0,0.0,0.0
85362.0,6,14,4740,7,653,13771.166666666666,249.0,93.28571428571428,7,4087,11445.0,1514.0,583.8571428571429
153480.0,17,2,180,1,90,0.0,90.0,90.0,1,90,0.0,90.0,90.0
83.0,17,2,762,2,762,0.0,381.0,381.0,0,0,0.0,0.0,0.0
216894.0,6,3,426,2,280,0.0,214.0,140.0,1,146,0.0,146.0,146.0
51727858.0,6,8,2113,3,960,24537666.5,826.0,320.0,5,1153,12237564.0,885.0,230.6
32802274.0,6,26,7627,14,3735,196298.0769230769,1514.0,266.7857142857143,12,3892,2962429.4545454546,1514.0,324.3333333333333
72175.0,6,14,4740,7,653,11906.833333333334,249.0,93.28571428571428,7,4087,10678.666666666666,1514.0,583.8571428571429
146117.0,6,3,337,2,214,0.0,160.0,107.0,1,123,0.0,123.0,123.0
21428.0,17,2,582,1,83,0.0,83.0,83.0,1,499,0.0,499.0,499.0
243391.0,6,3,337,2,214,0.0,160.0,107.0,1,123,0.0,123.0,123.0
37839.0,6,10,2032,5,524,9244.25,252.0,104.8,5,1508,7819.25,1236.0,301.6
39661.0,6,10,2032,5,524,9586.0,252.0,104.8,5,1508,9297.0,1236.0,301.6
120475105.0,6,21,1585,11,840,9043729.3,95.0,76.36363636363636,10,745,13381033.666666666,95.0,74.5
233739.0,6,3,337,2,214,0.0,160.0,107.0,1,123,0.0,123.0,123.0
94468682.0,17,12,778,6,389,18801172.4,174.0,64.83333333333333,6,389,18800159.6,174.0,64.83333333333333
130696.0,6,3,337,2,214,0.0,160.0,107.0,1,123,0.0,123.0,123.0
105005221.0,17,13,1083,7,563,17500870.166666668,174.0,80.42857142857143,6,520,17000159.6,174.0,86.66666666666667
38624206.0,6,5,336,2,134,0.0,68.0,67.0,3,202,17910924.0,70.0,67.33333333333333
30092.0,6,10,2032,5,524,6386.0,252.0,104.8,5,1508,7254.25,1236.0,301.6
35247.0,6,14,4740,7,653,4982.5,249.0,93.28571428571428,7,4087,5733.166666666667,1514.0,583.8571428571429
90247552.0,6,12,1832,8,1016,12892507.42857143,188.0,127.0,4,816,30028477.0,204.0,204.0
769.0,17,4,438,2,148,0.0,74.0,74.0,2,290,0.0,147.0,145.0
39656.0,6,14,4740,7,653,6499.666666666667,249.0,93.28571428571428,7,4087,6100.5,1514.0,583.8571428571429
326811.0,17,4,1400,4,1400,108937.0,350.0,350.0,0,0,0.0,0.0,0.0
113520539.0,6,46,3036,23,1518,5160012.454545454,66.0,66.0,23,1518,5160012.318181818,66.0,66.0
144042.0,17,2,180,1,90,0.0,90.0,90.0,1,90,0.0,90.0,90.0
3580270.0,6,5,336,2,134,0.0,68.0,67.0,3,202,1474473.5,70.0,67.33333333333333
233122.0,6,3,337,2,214,0.0,160.0,107.0,1,123,0.0,123.0,123.0
111366598.0,6,200,22536,100,15640,1122741.686868687,284.0,156.4,100,6896,1122741.5555555555,140.0,68.96
91556.0,6,13,4519,6,512,18177.6,230.0,85.33333333333333,7,4007,12868.5,1514.0,572.4285714285714
26140.0,6,14,4740,7,653,4195.5,249.0,93.28571428571428,7,4087,4199.0,1514.0,583.8571428571429
207071.0,6,3,426,2,280,0.0,214.0,140.0,1,146,0.0,146.0,146.0
281931.0,17,2,363,1,79,0.0,79.0,79.0,1,284,0.0,284.0,284.0
3459.0,17,2,414,1,88,0.0,88.0,88.0,1,326,0.0,326.0,326.0
108112743.0,17,5,1005,5,1005,27028185.75,201.0,201.0,0,0,0.0,0.0,0.0
301550.0,6,6,412,4,272,100516.66666666669,74.0,68.0,2,140,0.0,74.0,70.0
146149.0,6,3,337,2,214,0.0,160.0,107.0,1,123,0.0,123.0,123.0
61105.0,6,10,2032,5,524,14982.75,252.0,104.8,5,1508,14603.25,1236.0,301.6
228252.0,17,2,180,1,90,0.0,90.0,90.0,1,90,0.0,90.0,90.0
2926034.0,6,12,2172,7,664,487501.6666666667,252.0,94.85714285714286,5,1508,2153.75,1236.0,301.6
242025.0,6,3,337,2,214,0.0,160.0,107.0,1,123,0.0,123.0,123.0
108330.0,17,2,286,2,286,0.0,143.0,143.0,0,0,0.0,0.0,0.0
2433.0,17,4,344,2,150,0.0,75.0,75.0,2,194,0.0,103.0,97.0
107763.0,17,2,286,2,286,0.0,143.0,143.0,0,0,0.0,0.0,0.0
137502.0,17,4,1400,4,1400,45834.0,350.0,350.0,0,0,0.0,0.0,0.0
108126360.0,17,5,1005,5,1005,27031590.0,201.0,201.0,0,0,0.0,0.0,0.0
18060.0,17,2,582,1,83,0.0,83.0,83.0,1,499,0.0,499.0,499.0
118742346.0,6,32,2252,16,1071,7916156.4,123.0,66.9375,16,1181,7236092.2,139.0,73.8125
90027094.0,17,28,13364,28,13364,3334336.814814815,501.0,477.2857142857143,0,0,0.0,0.0,0.0
38488.0,6,10,2032,5,524,9380.75,252.0,104.8,5,1508,9032.5,1236.0,301.6
228444.0,17,2,180,1,90,0.0,90.0,90.0,1,90,0.0,90.0,90.0
216276.0,17,2,180,1,90,0.0,90.0,90.0,1,90,0.0,90.0,90.0
73697.0,6,14,4740,7,653,12125.833333333334,249.0,93.28571428571428,7,4087,11284.833333333334,1514.0,583.8571428571429
317430.0,17,4,1400,4,1400,105810.0,350.0,350.0,0,0,0.0,0.0,0.0
61480.0,6,14,4740,7,653,10116.166666666666,249.0,93.28571428571428,7,4087,9994.666666666666,1514.0,583.8571428571429
8993.0,17,2,582,1,83,0.0,83.0,83.0,1,499,0.0,499.0,499.0
191130.0,17,2,180,1,90,0.0,90.0,90.0,1,90,0.0,90.0,90.0
2018.0,17,4,344,2,150,0.0,75.0,75.0,2,194,0.0,103.0,97.0
1734.0,17,2,664,1,322,0.0,322.0,322.0,1,342,0.0,342.0,342.0
320550.0,17,4,1400,4,1400,106850.0,350.0,350.0,0,0,0.0,0.0,0.0
224342.0,6,10,1221,6,636,44868.4,298.0,106.0,4,585,73679.33333333333,379.0,146.25
218150.0,6,3,426,2,280,0.0,214.0,140.0,1,146,0.0,146.0,146.0
120304740.0,6,221,25104,111,17622,1093679.4545454546,300.0,158.75675675675674,110,7482,1094134.623853211,140.0,68.01818181818182
121472.0,6,3,337,2,214,0.0,160.0,107.0,1,123,0.0,123.0,123.0
69863.0,6,14,4740,7,653,11516.833333333334,249.0,93.28571428571428,7,4087,11484.0,1514.0,583.8571428571429
24147.0,6,14,4740,7,653,3841.5,249.0,93.28571428571428,7,4087,3893.8333333333335,1514.0,583.8571428571429
304383.0,6,6,412,4,272,101461.0,74.0,68.0,2,140,0.0,74.0,70.0
146329.0,6,3,337,2,214,0.0,160.0,107.0,1,123,0.0,123.0,123.0
128897946.0,6,36,2602,19,1408,7160997.0,139.0,74.10526315789474,17,1194,7418533.25,123.0,70.23529411764706
245469.0,6,3,337,2,214,0.0,160.0,107.0,1,123,0.0,123.0,123.0
15306.0,6,10,1067,5,536,2455.5,264.0,107.2,5,531,3200.75,259.0,106.2
212386.0,6,10,1221,6,636,42477.2,298.0,106.0,4,585,69276.0,379.0,146.25
97553201.0,17,14,1126,7,563,16168128.166666666,174.0,80.42857142857143,7,563,16166828.833333334,174.0,80.42857142857143
65588.0,6,10,2032,5,524,16010.0,252.0,104.8,5,1508,10477.5,1236.0,301.6
444.0,17,2,508,2,508,0.0,257.0,254.0,0,0,0.0,0.0,0.0
128009342.0,17,15,907,8,475,18287048.85714286,174.0,59.375,7,432,18000190.833333332,174.0,61.71428571428572
29222.0,6,14,4740,7,653,3944.8333333333335,249.0,93.28571428571428,7,4087,4547.166666666667,1514.0,583.8571428571429
2844.0,17,2,224,1,76,0.0,76.0,76.0,1,148,0.0,148.0,148.0
2795467.0,6,2,132,1,66,0.0,66.0,66.0,1,66,0.0,66.0,66.0
121522.0,6,3,337,2,214,0.0,160.0,107.0,1,123,0.0,123.0,123.0
107833297.0,6,28,1860,14,966,8294869.0,123.0,69.0,14,894,8278217.538461538,123.0,63.85714285714285
197063.0,17,2,180,1,90,0.0,90.0,90.0,1,90,0.0,90.0,90.0
2490.0,17,4,344,2,150,0.0,75.0,75.0,2,194,0.0,103.0,97.0
217185.0,6,3,426,2,280,0.0,214.0,140.0,1,146,0.0,146.0,146.0
15218.0,6,10,2032,5,524,3478.0,252.0,104.8,5,1508,3534.0,1236.0,301.6
143859.0,17,2,180,1,90,0.0,90.0,90.0,1,90,0.0,90.0,90.0
206209.0,6,3,426,2,280,0.0,214.0,140.0,1,146,0.0,146.0,146.0
11548552.0,6,6,433,2,132,0.0,66.0,66.0,4,301,3849517.3333333335,103.0,75.25
869.0,17,4,438,2,148,0.0,74.0,74.0,2,290,0.0,147.0,145.0
79533.0,6,12,1328,7,797,13255.5,253.0,113.85714285714286,5,531,18015.0,259.0,106.2
135134569.0,17,6,1206,6,1206,27026913.8,201.0,201.0,0,0,0.0,0.0,0.0
120197322.0,6,19,1436,9,691,14999005.0,95.0,76.77777777777777,10,745,13332447.555555556,95.0,74.5
90284479.0,6,16,1192,8,596,12891267.142857144,95.0,74.5,8,596,12897329.714285716,95.0,74.5
30814.0,6,14,4740,7,653,5014.166666666667,249.0,93.28571428571428,7,4087,4445.833333333333,1514.0,583.8571428571429
303983.0,6,3,202,2,128,0.0,74.0,64.0,1,74,0.0,74.0,74.0
415386.0,17,2,176,1,80,0.0,80.0,80.0,1,96,0.0,96.0,96.0
308896.0,6,6,412,4,272,102965.33333333331,74.0,68.0,2,140,0.0,74.0,70.0
15398.0,6,10,2032,5,524,3611.75,252.0,104.8,5,1508,3618.25,1236.0,301.6
90534196.0,6,14,2240,8,1016,12933456.57142857,188.0,127.0,6,1224,18071471.8,204.0,204.0
3005500.0,6,12,2172,7,664,500417.6666666667,252.0,94.85714285714286,5,1508,2427.0,1236.0,301.6
82903155.0,17,13,4454,12,4104,6805093.090909091,342.0,342.0,1,350,0.0,350.0,350.0
2333.0,17,4,344,2,150,0.0,75.0,75.0,2,194,0.0,103.0,97.0
1149411.0,6,13,3000,8,2372,164201.57142857142,1514.0,296.5,5,628,219139.0,331.0,125.6
119747068.0,17,35,16705,35,16705,3521972.588235294,501.0,477.2857142857143,0,0,0.0,0.0,0.0
577637.0,6,4,508,2,238,0.0,172.0,119.0,2,270,0.0,135.0,135.0
33955.0,6,14,4740,7,653,4717.0,249.0,93.28571428571428,7,4087,5376.833333333333,1514.0,583.8571428571429
8217473.999999999,6,15,4814,8,727,1173817.7142857143,249.0,90.875,7,4087,13285.666666666666,1514.0,583.8571428571429
120230216.0,6,24,1829,13,989,9999793.583333334,95.0,76.07692307692308,11,840,12018410.1,95.0,76.36363636363636
1250384.0,6,7,499,3,198,617641.0,66.0,66.0,4,301,406755.6666666667,103.0,75.25
157208.0,17,2,414,1,88,0.0,88.0,88.0,1,326,0.0,326.0,326.0
221509.0,6,3,426,2,280,0.0,214.0,140.0,1,146,0.0,146.0,146.0
105053.0,17,2,286,2,286,0.0,143.0,143.0,0,0,0.0,0.0,0.0
119967869.0,6,220,25010,110,17454,1098646.9082568807,284.0,158.6727272727273,110,7556,1098648.1467889908,140.0,68.69090909090909
13903364.0,17,6,2052,6,2052,2780672.8,342.0,342.0,0,0,0.0,0.0,0.0
27944.0,6,10,2032,5,524,6769.0,252.0,104.8,5,1508,6413.0,1236.0,301.6
162320.0,17,2,180,1,90,0.0,90.0,90.0,1,90,0.0,90.0,90.0
3105.0,17,2,224,1,76,0.0,76.0,76.0,1,148,0.0,148.0,148.0
2802525.0,6,2,132,1,66,0.0,66.0,66.0,1,66,0.0,66.0,66.0
35741.0,6,14,4740,7,653,5385.833333333333,249.0,93.28571428571428,7,4087,5683.5,1514.0,583.8571428571429
306908.0,6,6,412,4,272,102302.66666666669,74.0,68.0,2,140,0.0,74.0,70.0
90256590.0,6,13,2036,8,1016,12893798.57142857,188.0,127.0,5,1020,22523066.75,204.0,204.0
121967582.0,17,14,864,7,432,17000168.333333332,174.0,61.71428571428572,7,432,17001078.333333332,174.0,61.71428571428572
110005553.0,17,13,821,7,432,18334258.83333333,174.0,61.71428571428572,6,389,18000182.0,174.0,64.83333333333333
103264.0,17,2,286,2,286,0.0,143.0,143.0,0,0,0.0,0.0,0.0
22163.0,6,10,2032,5,524,5014.75,252.0,104.8,5,1508,5270.75,1236.0,301.6
357.0,17,2,166,1,75,0.0,75.0,75.0,1,91,0.0,91.0,91.0
155858.0,6,2,132,1,66,0.0,66.0,66.0,1,66,0.0,66.0,66.0
118918316.0,6,35,2542,18,1348,6982499.05882353,139.0,74.88888888888889,17,1194,7418891.3125,123.0,70.23529411764706
121370.0,6,3,337,2,214,0.0,160.0,107.0,1,123,0.0,123.0,123.0
507.0,17,2,166,1,75,0.0,75.0,75.0,1,91,0.0,91.0,91.0
26018.0,6,14,4740,7,653,3516.6666666666665,249.0,93.28571428571428,7,4087,3409.6666666666665,1514.0,583.8571428571429
90053809.0,17,28,13364,28,13364,3335326.25925926,501.0,477.2857142857143,0,0,0.0,0.0,0.0
15637.000000000002,6,12,1393,6,796,2947.0,271.0,132.66666666666666,6,597,2521.8,259.0,99.5
207308.0,6,3,426,2,280,0.0,214.0,140.0,1,146,0.0,146.0,146.0
111758771.0,6,33,2296,17,1225,6971435.25,139.0,72.05882352941177,16,1071,7436191.533333333,123.0,66.9375
120063105.0,17,28,13364,28,13364,4446781.666666667,501.0,477.2857142857143,0,0,0.0,0.0,0.0
204914.0,17,2,762,2,762,0.0,381.0,381.0,0,0,0.0,0.0,0.0
232914.0,6,3,373,2,238,0.0,172.0,119.0,1,135,0.0,135.0,135.0
10486670.0,6,7,478,4,272,3450083.333333333,74.0,68.0,3,206,5175049.5,74.0,68.66666666666667
216800.0,17,2,180,1,90,0.0,90.0,90.0,1,90,0.0,90.0,90.0
103577.0,17,2,286,2,286,0.0,143.0,143.0,0,0,0.0,0.0,0.0
2391.0,17,4,344,2,150,0.0,75.0,75.0,2,194,0.0,103.0,97.0
241675.0,6,3,337,2,214,0.0,160.0,107.0,1,123,0.0,123.0,123.0
1778150.0,6,2,132,1,66,0.0,66.0,66.0,1,66,0.0,66.0,66.0
119751488.0,6,226,25656,113,17976,1067286.9910714286,284.0,159.0796460176991,113,7680,1067287.357142857,140.0,67.96460176991151
2731.0,17,4,344,2,150,0.0,75.0,75.0,2,194,0.0,103.0,97.0
2343441.0,6,49,23728,25,19797,97643.375,1514.0,791.88,24,3931,92204.47826086955,1514.0,163.79166666666666
119088.0,17,4,1524,4,1524,39696.0,381.0,381.0,0,0,0.0,0.0,0.0
120200692.0,6,218,24646,109,7490,1104376.3796296297,140.0,68.71559633027523,109,17156,1105502.7222222222,284.0,157.39449541284404
35805.0,6,14,4740,7,653,5373.666666666667,249.0,93.28571428571428,7,4087,5318.0,1514.0,583.8571428571429
2402.0,17,4,344,2,150,0.0,75.0,75.0,2,194,0.0,103.0,97.0
316.0,17,2,208,1,72,0.0,72.0,72.0,1,136,0.0,136.0,136.0
127012735.0,17,15,907,8,475,18144676.42857143,174.0,59.375,7,432,17833531.833333332,174.0,61.71428571428572
114271775.0,6,223,25134,112,17586,1029475.4504504504,284.0,157.01785714285714,111,7548,1029427.7090909092,140.0,68.0
2806016.0,6,3,1777,2,951,0.0,885.0,475.5,1,826,0.0,826.0,826.0
106593.0,17,2,286,2,286,0.0,143.0,143.0,0,0,0.0,0.0,0.0
16880.0,17,2,180,1,90,0.0,90.0,90.0,1,90,0.0,90.0,90.0
7113.0,17,2,582,1,83,0.0,83.0,83.0,1,499,0.0,499.0,499.0
301508.0,17,4,1524,4,1524,100502.66666666669,381.0,381.0,0,0,0.0,0.0,0.0
48800.0,6,14,4740,7,653,8005.833333333333,249.0,93.28571428571428,7,4087,7508.833333333333,1514.0,583.8571428571429
153431.0,17,2,180,1,90,0.0,90.0,90.0,1,90,0.0,90.0,90.0
9253.0,17,2,582,1,83,0.0,83.0,83.0,1,499,0.0,499.0,499.0
31997.0,6,12,1320,6,723,5851.0,253.0,120.5,6,597,5884.6,259.0,99.5
310681.0,17,4,1400,4,1400,103560.33333333331,350.0,350.0,0,0,0.0,0.0,0.0
297171.0,6,6,412,4,272,99057.0,74.0,68.0,2,140,0.0,74.0,70.0
851433.0,6,9,1096,6,625,170286.6,287.0,104.16666666666669,3,471,289400.0,331.0,157.0
119790008.0,6,24,1788,13,989,9982500.666666666,95.0,76.07692307692308,11,799,11952794.4,95.0,72.63636363636364
151604.0,17,2,414,1,88,0.0,88.0,88.0,1,326,0.0,326.0,326.0
36999.0,6,14,4740,7,653,5634.833333333333,249.0,93.28571428571428,7,4087,5572.0,1514.0,583.8571428571429
2043745.0,17,8,1640,4,312,681120.0,78.0,78.0,4,1328,681079.0,332.0,332.0
111601681.0,6,31,2182,16,1165,7425732.866666666,139.0,72.8125,15,1017,7956144.571428572,123.0,67.8
119862067.0,17,35,16705,35,16705,3525354.911764706,501.0,477.2857142857143,0,0,0.0,0.0,0.0
121488762.0,6,223,25278,112,17730,1094493.3513513512,284.0,158.30357142857142,111,7548,1077088.2727272727,140.0,68.0
190980.0,17,2,180,1,90,0.0,90.0,90.0,1,90,0.0,90.0,90.0
356189.0,17,2,180,1,90,0.0,90.0,90.0,1,90,0.0,90.0,90.0
66749.0,6,10,2032,5,524,16477.5,252.0,104.8,5,1508,14756.75,1236.0,301.6
10455694.0,6,6,412,3,206,5159641.5,74.0,68.66666666666667,3,206,5159542.0,74.0,68.66666666666667
119404510.0,17,35,16705,35,16705,3511897.3529411764,501.0,477.2857142857143,0,0,0.0,0.0,0.0
118035668.0,6,30,1974,15,1026,8415690.285714285,123.0,68.4,15,948,8415689.785714285,123.0,63.2
135143221.0,17,6,1146,6,1146,27028644.2,191.0,191.0,0,0,0.0,0.0,0.0
231359.0,17,2,180,1,90,0.0,90.0,90.0,1,90,0.0,90.0,90.0
324.0,17,2,174,1,79,0.0,79.0,79.0,1,95,0.0,95.0,95.0
462663.0,6,13,1386,7,789,77110.5,253.0,112.71428571428572,6,597,91685.6,259.0,99.5
114882820.0,6,31,2097,16,1071,7658854.666666667,123.0,66.9375,15,1026,8191179.142857143,123.0,68.4
935913.0,6,13,1420,7,789,155137.5,253.0,112.71428571428572,6,631,186679.6,293.0,105.16666666666669
115297101.0,6,217,24506,109,7416,1067565.75,140.0,68.03669724770643,108,17090,1067829.981308411,284.0,158.24074074074073
108102334.0,17,5,955,5,955,27025583.5,191.0,191.0,0,0,0.0,0.0,0.0
306429.0,6,6,412,4,272,102143.0,74.0,68.0,2,140,0.0,74.0,70.0
792.0,17,4,438,2,148,0.0,74.0,74.0,2,290,0.0,147.0,145.0
232820.0,6,10,1221,6,636,46564.0,298.0,106.0,4,585,75262.0,379.0,146.25
148568.0,17,2,414,1,88,0.0,88.0,88.0,1,326,0.0,326.0,326.0
1296359.0,6,4,264,2,132,0.0,66.0,66.0,2,132,0.0,66.0,66.0
90536431.0,6,15,2444,8,1016,12933775.857142856,188.0,127.0,7,1428,15062616.333333334,204.0,204.0
170588.0,6,13,1386,7,789,28431.33333333333,253.0,112.71428571428572,6,597,32651.6,259.0,99.5
871033.0,6,10,1334,6,797,174206.6,459.0,132.83333333333334,4,537,198627.66666666663,331.0,134.25
90252838.0,6,12,1832,8,1016,12893262.57142857,188.0,127.0,4,816,30030505.0,204.0,204.0
32144.0,6,14,4740,7,653,5233.833333333333,249.0,93.28571428571428,7,4087,5116.0,1514.0,583.8571428571429
218121.0,6,10,1221,6,636,43624.2,298.0,106.0,4,585,70605.66666666667,379.0,146.25
304174.0,6,6,412,4,272,101391.33333333331,74.0,68.0,2,140,0.0,74.0,70.0
234656.0,6,3,337,2,214,0.0,160.0,107.0,1,123,0.0,123.0,123.0
12817.0,6,10,2032,5,524,2999.75,252.0,104.8,5,1508,2525.75,1236.0,301.6
90045328.0,17,28,13364,28,13364,3335012.1481481483,501.0,477.2857142857143,0,0,0.0,0.0,0.0
111754358.0,6,30,1974,15,1026,7967038.642857143,123.0,68.4,15,948,7967037.285714285,123.0,63.2
74128089.0,6,9,842,9,842,9266011.125,97.0,93.55555555555556,0,0,0.0,0.0,0.0
4068.0,17,4,704,2,148,0.0,74.0,74.0,2,556,0.0,280.0,278.0
6457.0,17,2,239,1,82,0.0,82.0,82.0,1,157,0.0,157.0,157.0
40864.0,6,10,2032,5,524,9401.25,252.0,104.8,5,1508,8015.25,1236.0,301.6
119997015.0,6,21,1585,12,894,10908819.545454543,95.0,74.5,9,691,14968340.5,95.0,76.77777777777777
33762.0,6,10,2032,5,524,7899.0,252.0,104.8,5,1508,8186.5,1236.0,301.6
118006897.0,17,13,821,7,432,19667816.166666668,174.0,61.71428571428572,6,389,19600159.6,174.0,64.83333333333333
152254.0,17,2,414,1,88,0.0,88.0,88.0,1,326,0.0,326.0,326.0
120124383.0,6,208,23408,104,7160,1158389.0194174757,140.0,68.84615384615384,104,16248,1158272.6116504855,284.0,156.23076923076923
43773.0,6,14,4740,7,653,7176.333333333333,249.0,93.28571428571428,7,4087,5815.166666666667,1514.0,583.8571428571429
216893.0,6,3,426,2,280,0.0,214.0,140.0,1,146,0.0,146.0,146.0
220093.0,6,3,426,2,280,0.0,214.0,140.0,1,146,0.0,146.0,146.0
104006314.0,17,13,821,7,432,17334385.666666668,174.0,61.71428571428572,6,389,19972280.2,174.0,64.83333333333333
103483.0,17,2,286,2,286,0.0,143.0,143.0,0,0,0.0,0.0,0.0
51976.0,6,14,4740,7,653,8293.666666666666,249.0,93.28571428571428,7,4087,8517.833333333334,1514.0,583.8571428571429
309926.0,6,6,412,4,272,103308.66666666669,74.0,68.0,2,140,0.0,74.0,70.0
217862.0,6,3,426,2,280,0.0,214.0,140.0,1,146,0.0,146.0,146.0
106184.0,17,2,286,2,286,0.0,143.0,143.0,0,0,0.0,0.0,0.0
90020121.0,17,28,13364,28,13364,3334078.5555555555,501.0,477.2857142857143,0,0,0.0,0.0,0.0
106784748.0,6,35,2526,18,1332,6268759.176470588,123.0,74.0,17,1194,6660554.3125,123.0,70.23529411764706
147909.0,17,2,180,1,90,0.0,90.0,90.0,1,90,0.0,90.0,90.0
24693.0,6,10,2032,5,524,5701.75,252.0,104.8,5,1508,5789.5,1236.0,301.6
217777.0,6,3,426,2,280,0.0,214.0,140.0,1,146,0.0,146.0,146.0
65871.0,6,14,4740,7,653,10619.166666666666,249.0,93.28571428571428,7,4087,10438.333333333334,1514.0,583.8571428571429
1022073.0,6,11,1134,6,558,204414.60000000003,220.0,93.0,5,576,254608.5,304.0,115.2
3278281.0,6,3,1602,1,752,0.0,752.0,752.0,2,850,0.0,784.0,425.0
165740.0,17,2,414,1,88,0.0,88.0,88.0,1,326,0.0,326.0,326.0
21294.0,6,14,4740,7,653,3428.1666666666665,249.0,93.28571428571428,7,4087,3377.5,1514.0,583.8571428571429
120047687.0,17,29,13785,29,13785,4287417.392857143,501.0,475.3448275862069,0,0,0.0,0.0,0.0
104719.0,17,2,286,2,286,0.0,143.0,143.0,0,0,0.0,0.0,0.0
3784.0,17,4,438,2,148,0.0,74.0,74.0,2,290,0.0,147.0,145.0
40003.0,6,10,2032,5,524,9347.0,252.0,104.8,5,1508,9186.25,1236.0,301.6
104691459.0,17,14,864,7,432,17333511.333333332,174.0,61.71428571428572,7,432,17334319.166666668,174.0,61.71428571428572
106623.0,17,2,286,2,286,0.0,143.0,143.0,0,0,0.0,0.0,0.0
2106.0,17,4,344,2,150,0.0,75.0,75.0,2,194,0.0,103.0,97.0
32003.0,6,14,4740,7,653,4332.0,249.0,93.28571428571428,7,4087,5204.166666666667,1514.0,583.8571428571429
2590857.0,6,2,132,1,66,0.0,66.0,66.0,1,66,0.0,66.0,66.0
45952.0,6,14,4740,7,653,7491.0,249.0,93.28571428571428,7,4087,7333.166666666667,1514.0,583.8571428571429
128892124.0,6,35,2394,18,1269,7581889.647058823,123.0,70.5,17,1125,7418182.9375,123.0,66.17647058823529
31838.0,6,10,2032,5,524,6684.0,252.0,104.8,5,1508,7343.0,1236.0,301.6
2207.0,17,2,932,1,590,0.0,590.0,590.0,1,342,0.0,342.0,342.0
90042890.0,17,28,13364,28,13364,3334921.851851852,501.0,477.2857142857143,0,0,0.0,0.0,0.0
218324.0,6,10,1221,6,636,43664.8,298.0,106.0,4,585,71371.33333333333,379.0,146.25
39394.0,6,14,4740,7,653,5378.166666666667,249.0,93.28571428571428,7,4087,6343.666666666667,1514.0,583.8571428571429
109112752.0,6,41,3270,22,1761,5185576.80952381,123.0,80.04545454545455,19,1509,6049839.388888889,123.0,79.42105263157895
20137.0,17,2,582,1,83,0.0,83.0,83.0,1,499,0.0,499.0,499.0
143850.0,17,2,180,1,90,0.0,90.0,90.0,1,90,0.0,90.0,90.0
91807272.0,6,40,3232,22,1777,4360997.047619048,139.0,80.77272727272727,18,1455,5387116.294117647,123.0,80.83333333333333
511310.00000000006,6,5,336,2,134,0.0,68.0,67.0,3,202,192401.5,70.0,67.33333333333333
2993266.0,6,176,130273,92,120427,32893.03296703297,1510.0,1308.9891304347825,84,9846,32405.31325301205,1510.0,117.21428571428572
143500.0,6,10,1065,5,534,35511.5,262.0,106.8,5,531,2501.25,259.0,106.2
15526.0,6,10,2032,5,524,3247.25,252.0,104.8,5,1508,2258.25,1236.0,301.6
67864.0,6,14,4740,7,653,11059.833333333334,249.0,93.28571428571428,7,4087,11168.666666666666,1514.0,583.8571428571429
47491.0,6,12,1413,7,882,7915.166666666667,291.0,126.0,5,531,10331.75,259.0,106.2
143967.0,17,2,180,1,90,0.0,90.0,90.0,1,90,0.0,90.0,90.0
74663.0,6,10,2032,5,524,16822.25,252.0,104.8,5,1508,18250.75,1236.0,301.6
9880.0,17,4,823,2,163,0.0,89.0,81.5,2,660,0.0,443.0,330.0
103960.0,17,2,286,2,286,0.0,143.0,143.0,0,0,0.0,0.0,0.0
305219.0,6,6,412,4,272,101739.66666666669,74.0,68.0,2,140,0.0,74.0,70.0
304662.0,6,3,202,2,128,0.0,74.0,64.0,1,74,0.0,74.0,74.0
196814.0,17,2,180,1,90,0.0,90.0,90.0,1,90,0.0,90.0,90.0
113610724.0,6,46,3036,23,1518,5150441.5,66.0,66.0,23,1518,5150444.0,66.0,66.0
27286324.0,17,5,1710,5,1710,6821581.0,342.0,342.0,0,0,0.0,0.0,0.0
35345.0,6,14,4740,7,653,5772.666666666667,249.0,93.28571428571428,7,4087,5755.833333333333,1514.0,583.8571428571429
209029.0,6,3,426,2,280,0.0,214.0,140.0,1,146,0.0,146.0,146.0
37345.0,6,14,4740,7,653,6091.666666666667,249.0,93.28571428571428,7,4087,6064.0,1514.0,583.8571428571429
90005934.0,17,28,13364,28,13364,3333553.111111111,501.0,477.2857142857143,0,0,0.0,0.0,0.0
52291.0,6,10,2032,5,524,12826.75,252.0,104.8,5,1508,12608.5,1236.0,301.6
19770.0,6,14,4740,7,653,3181.333333333333,249.0,93.28571428571428,7,4087,3157.833333333333,1514.0,583.8571428571429
40465.0,6,14,4740,7,653,6366.666666666667,249.0,93.28571428571428,7,4087,6619.0,1514.0,583.8571428571429
0.0,17,1,86,1,86,0.0,86.0,86.0,0,0,0.0,0.0,0.0
141979.0,17,4,571,2,148,0.0,74.0,74.0,2,423,0.0,276.0,211.5
0.0,6,1,54,0,0,0.0,0.0,0.0,1,54,0.0,54.0,54.0
106005832.0,17,13,821,7,432,17667638.666666668,174.0,61.71428571428572,6,389,17200161.4,174.0,64.83333333333333
10359.0,6,10,1065,5,534,2367.5,262.0,106.8,5,531,2261.0,259.0,106.2
34460.0,6,14,4740,7,653,4250.166666666667,249.0,93.28571428571428,7,4087,5601.333333333333,1514.0,583.8571428571429
120123307.0,6,13,2036,8,1016,17137251.14285714,188.0,127.0,5,1020,22523441.5,204.0,204.0
2305.0,17,4,344,2,150,0.0,75.0,75.0,2,194,0.0,103.0,97.0
90045194.0,17,28,13364,28,13364,3335007.185185185,501.0,477.2857142857143,0,0,0.0,0.0,0.0
117305416.0,6,47,3102,24,1584,5088041.956521739,66.0,66.0,23,1518,5135817.7727272725,66.0,66.0
119597698.0,6,48,3168,24,1584,5199899.913043479,66.0,66.0,24,1584,5186210.739130435,66.0,66.0
1030437.0,6,11,1134,6,558,206087.4,220.0,93.0,5,576,256400.0,304.0,115.2
139673.0,6,2,132,1,66,0.0,66.0,66.0,1,66,0.0,66.0,66.0
1327028.0,6,4,264,2,132,0.0,66.0,66.0,2,132,0.0,66.0,66.0
136849.0,6,13,1386,7,789,22808.166666666668,253.0,112.71428571428572,6,597,20029.4,259.0,99.5
97783.0,17,2,762,2,762,0.0,381.0,381.0,0,0,0.0,0.0,0.0
129763442.0,17,14,864,7,432,18334531.83333333,174.0,61.71428571428572,7,432,18333482.666666668,174.0,61.71428571428572
5624101.0,6,5,336,2,134,0.0,68.0,67.0,3,202,1527583.5,70.0,67.33333333333333
109600188.0,6,34,2466,17,1272,6850011.75,123.0,74.82352941176471,17,1194,6836473.0625,123.0,70.23529411764706
135129383.0,17,6,1206,6,1206,27025876.6,201.0,201.0,0,0,0.0,0.0,0.0
320286.0,17,4,1400,4,1400,106762.0,350.0,350.0,0,0,0.0,0.0,0.0
135130618.0,17,6,1146,6,1146,27026123.6,191.0,191.0,0,0,0.0,0.0,0.0
121196132.0,6,224,25312,112,7688,1075291.4774774774,140.0,68.64285714285714,112,17624,1083968.7837837837,284.0,157.35714285714286
2312.0,17,4,344,2,150,0.0,75.0,75.0,2,194,0.0,103.0,97.0
51522946.0,6,8,2113,3,960,24542406.5,826.0,320.0,5,1153,12236700.25,885.0,230.6
50163.0,6,14,4740,7,653,7219.5,249.0,93.28571428571428,7,4087,7398.333333333333,1514.0,583.8571428571429
297656.0,6,6,412,4,272,99218.66666666669,74.0,68.0,2,140,0.0,74.0,70.0
22382.0,6,14,4740,7,653,3046.1666666666665,249.0,93.28571428571428,7,4087,3593.1666666666665,1514.0,583.8571428571429
259267.00000000003,6,10,1221,6,636,51853.4,298.0,106.0,4,585,81010.66666666667,379.0,146.25
2702.0,17,4,344,2,150,0.0,75.0,75.0,2,194,0.0,103.0,97.0
107231099.0,6,2222,1916108,700,46200,153406.43633762517,66.0,66.0,1522,1869908,70497.32938856016,1514.0,1228.586070959264
217688.0,6,3,426,2,280,0.0,214.0,140.0,1,146,0.0,146.0,146.0
864189.0,6,9,1196,6,725,172837.8,387.0,120.83333333333331,3,471,294164.0,331.0,157.0
1715249.0,6,23,6508,12,1529,155931.72727272726,357.0,127.41666666666669,11,4979,140712.8,1510.0,452.6363636363636
3034427.0,6,12,2172,7,664,505234.5,252.0,94.85714285714286,5,1508,6357.5,1236.0,301.6
2358.0,17,4,344,2,150,0.0,75.0,75.0,2,194,0.0,103.0,97.0
306.0,17,2,174,1,79,0.0,79.0,79.0,1,95,0.0,95.0,95.0
6386.0,17,4,823,2,163,0.0,89.0,81.5,2,660,0.0,443.0,330.0
146212.0,6,3,337,2,214,0.0,160.0,107.0,1,123,0.0,123.0,123.0
116631023.0,6,210,23864,105,16638,1119382.3653846155,390.0,158.45714285714286,105,7226,1119382.7307692308,140.0,68.81904761904762
78880.0,6,14,4740,7,653,12474.5,249.0,93.28571428571428,7,4087,12929.0,1514.0,583.8571428571429
216386.0,17,2,180,1,90,0.0,90.0,90.0,1,90,0.0,90.0,90.0
1553.0,17,2,180,1,90,0.0,90.0,90.0,1,90,0.0,90.0,90.0
282854.0,6,10,1221,6,636,56570.8,298.0,106.0,4,585,88526.0,379.0,146.25
135131723.0,17,6,1146,6,1146,27026344.6,191.0,191.0,0,0,0.0,0.0,0.0
205763.0,17,2,180,1,90,0.0,90.0,90.0,1,90,0.0,90.0,90.0
992352.0,17,5,961,3,234,495993.0,78.0,78.0,2,727,0.0,395.0,363.5
105231.0,17,2,700,2,700,0.0,350.0,350.0,0,0,0.0,0.0,0.0
47032.0,6,14,4740,7,653,6241.5,249.0,93.28571428571428,7,4087,7021.5,1514.0,583.8571428571429
106698.0,17,2,286,2,286,0.0,143.0,143.0,0,0,0.0,0.0,0.0
793.0,17,4,438,2,148,0.0,74.0,74.0,2,290,0.0,147.0,145.0
13006.0,6,11,2098,6,590,2522.2,252.0,98.33333333333331,5,1508,2938.25,1236.0,301.6
206085.0,6,3,426,2,280,0.0,214.0,140.0,1,146,0.0,146.0,146.0
712.0,17,2,508,2,508,0.0,257.0,254.0,0,0,0.0,0.0,0.0
3076640.0,6,159,127938,91,119148,34184.88888888889,1510.0,1309.3186813186812,68,8790,41218.53731343283,1510.0,129.26470588235293
45529.0,6,14,4740,7,653,7312.833333333333,249.0,93.28571428571428,7,4087,4791.333333333333,1514.0,583.8571428571429
112979648.0,6,45,2970,23,1518,5135438.545454546,66.0,66.0,22,1452,4963589.619047619,66.0,66.0
107147.0,17,2,286,2,286,0.0,143.0,143.0,0,0,0.0,0.0,0.0
232434.0,6,3,337,2,214,0.0,160.0,107.0,1,123,0.0,123.0,123.0
90023095.0,17,28,13364,28,13364,3334188.703703704,501.0,477.2857142857143,0,0,0.0,0.0,0.0
216364.0,17,2,180,1,90,0.0,90.0,90.0,1,90,0.0,90.0,90.0
112364849.0,6,33,2444,17,1304,7009312.5,139.0,76.70588235294117,16,1140,7476600.4,123.0,71.25
47269.0,6,13,1394,7,797,7355.666666666667,253.0,113.85714285714286,6,597,9041.2,259.0,99.5
120482495.0,6,219,24834,110,17418,1105343.990825688,284.0,158.34545454545454,109,7416,1106959.361111111,140.0,68.03669724770643
119339338.0,6,227,25472,114,7820,1056100.3362831858,140.0,68.59649122807018,113,17652,1056231.7589285714,284.0,156.21238938053096
108109880.0,17,5,1005,5,1005,27027470.0,201.0,201.0,0,0,0.0,0.0,0.0
220284.0,6,3,426,2,280,0.0,214.0,140.0,1,146,0.0,146.0,146.0
2793625.0,6,2,132,1,66,0.0,66.0,66.0,1,66,0.0,66.0,66.0
19511.0,6,20,7606,11,978,1951.1,310.0,88.9090909090909,9,6628,2158.75,1514.0,736.4444444444445
2375.0,17,4,344,2,150,0.0,75.0,75.0,2,194,0.0,103.0,97.0
113610678.0,6,46,3036,23,1518,5150438.863636363,66.0,66.0,23,1518,5150439.227272728,66.0,66.0
317.0,17,2,174,1,79,0.0,79.0,79.0,1,95,0.0,95.0,95.0
228173.0,17,2,180,1,90,0.0,90.0,90.0,1,90,0.0,90.0,90.0
30695.0,6,14,4740,7,653,4991.166666666667,249.0,93.28571428571428,7,4087,4924.666666666667,1514.0,583.8571428571429
864398.0,6,9,1196,6,725,172879.6,387.0,120.83333333333331,3,471,294313.0,331.0,157.0
3010484.0,6,11,2106,6,598,601852.6,252.0,99.66666666666669,5,1508,3062.75,1236.0,301.6
144900.0,17,2,180,1,70,0.0,70.0,70.0,1,110,0.0,110.0,110.0
102808.0,17,2,286,2,286,0.0,143.0,143.0,0,0,0.0,0.0,0.0
2451172.0,6,25,7573,14,3735,188551.6923076923,1514.0,266.7857142857143,11,3838,216894.4,1514.0,348.90909090909093
2245972.0,6,19,6869,10,1501,249552.44444444444,408.0,150.1,9,5368,237219.875,1514.0,596.4444444444445
2740412.0,6,3,1777,2,951,0.0,885.0,475.5,1,826,0.0,826.0,826.0
8945682.0,17,3,1034,2,684,0.0,342.0,342.0,1,350,0.0,350.0,350.0
93067064.0,6,30,2191,15,1086,6647647.428571428,123.0,72.4,15,1105,6632151.214285715,139.0,73.66666666666667
303140.0,6,2,132,1,66,0.0,66.0,66.0,1,66,0.0,66.0,66.0
90695193.0,6,21,1585,10,745,10077243.666666666,95.0,74.5,11,840,9043427.2,95.0,76.36363636363636
4469.0,17,2,626,1,72,0.0,72.0,72.0,1,554,0.0,554.0,554.0
310341.0,17,4,1400,4,1400,103447.0,350.0,350.0,0,0,0.0,0.0,0.0
2002063.0,6,18,6803,10,1501,222451.44444444444,408.0,150.1,8,5302,224070.7142857143,1514.0,662.75
331.0,17,2,182,1,75,0.0,75.0,75.0,1,107,0.0,107.0,107.0
205317.0,17,3,1143,3,1143,102658.5,381.0,381.0,0,0,0.0,0.0,0.0
90263259.0,6,12,1832,8,1016,12894751.285714284,188.0,127.0,4,816,30031527.0,204.0,204.0
1313786.0,6,4,264,2,132,0.0,66.0,66.0,2,132,0.0,66.0,66.0
302.0,17,2,174,1,79,0.0,79.0,79.0,1,95,0.0,95.0,95.0
33540.0,6,14,4740,7,653,5229.5,249.0,93.28571428571428,7,4087,5373.166666666667,1514.0,583.8571428571429
90530005.0,6,13,2036,8,1016,12932857.857142856,188.0,127.0,5,1020,22591384.5,204.0,204.0
2319.0,17,4,344,2,150,0.0,75.0,75.0,2,194,0.0,103.0,97.0
22843.0,6,10,2032,5,524,5299.5,252.0,104.8,5,1508,5332.25,1236.0,301.6
197583.0,17,2,180,1,90,0.0,90.0,90.0,1,90,0.0,90.0,90.0
0.0,17,1,44,1,44,0.0,44.0,44.0,0,0,0.0,0.0,0.0
2794379.0,6,2,132,1,66,0.0,66.0,66.0,1,66,0.0,66.0,66.0
1020958.0,6,11,1134,6,558,204191.6,220.0,93.0,5,576,254130.25,304.0,115.2
30279.0,6,10,2032,5,524,7181.25,252.0,104.8,5,1508,6579.5,1236.0,301.6
9292.0,17,2,507,1,86,0.0,86.0,86.0,1,421,0.0,421.0,421.0
115866549.0,6,48,3168,24,1584,5037676.043478261,66.0,66.0,24,1584,5028270.739130435,66.0,66.0
40130.0,6,14,4740,7,653,6465.333333333333,249.0,93.28571428571428,7,4087,6064.0,1514.0,583.8571428571429
108105617.0,17,5,1005,5,1005,27026404.25,201.0,201.0,0,0,0.0,0.0,0.0
108103126.0,17,5,955,5,955,27025781.5,191.0,191.0,0,0,0.0,0.0,0.0
22795.0,6,10,2032,5,524,4932.75,252.0,104.8,5,1508,4485.75,1236.0,301.6
304780.0,6,3,202,2,128,0.0,74.0,64.0,1,74,0.0,74.0,74.0
114355257.0,6,203,22952,102,6954,1132230.2673267326,140.0,68.17647058823529,101,15998,1133673.38,284.0,158.3960396039604
120140791.0,6,230,25994,115,7886,1046716.4210526316,140.0,68.57391304347826,115,18108,1051720.5,284.0,157.4608695652174
107898.0,17,2,286,2,286,0.0,143.0,143.0,0,0,0.0,0.0,0.0
310881.0,17,4,1400,4,1400,103627.0,350.0,350.0,0,0,0.0,0.0,0.0
123839821.0,6,48,3168,24,1584,4947566.652173913,66.0,66.0,24,1584,5349874.173913044,66.0,66.0
2445.0,17,4,344,2,150,0.0,75.0,75.0,2,194,0.0,103.0,97.0
5004733.0,17,4,849,2,166,0.0,83.0,83.0,2,683,0.0,499.0,341.5
1306899.0,6,4,264,2,132,0.0,66.0,66.0,2,132,0.0,66.0,66.0
147219.0,6,3,373,2,238,0.0,172.0,119.0,1,135,0.0,135.0,135.0
1063362.0,6,13,1479,7,882,177227.0,291.0,126.0,6,597,208615.4,259.0,99.5
119305960.0,6,29,1930,15,948,8521854.285714285,123.0,63.2,14,982,8393632.692307692,139.0,70.14285714285714
104520.0,17,2,762,2,762,0.0,381.0,381.0,0,0,0.0,0.0,0.0
90067705.0,17,27,12943,27,12943,3464142.5,501.0,479.3703703703704,0,0,0.0,0.0,0.0
153438.0,17,2,180,1,90,0.0,90.0,90.0,1,90,0.0,90.0,90.0
2604628.0,6,25,7573,14,3735,200356.0,1514.0,266.7857142857143,11,3838,234288.0,1514.0,348.90909090909093
1175517.0,6,13,3000,8,2372,167931.0,1514.0,296.5,5,628,224962.0,331.0,125.6
2412457.0,17,4,1752,4,1752,804152.3333333334,438.0,438.0,0,0,0.0,0.0,0.0
206082.0,6,3,426,2,280,0.0,214.0,140.0,1,146,0.0,146.0,146.0
97295804.0,17,14,1126,7,563,16165297.166666666,174.0,80.42857142857143,7,563,16166806.333333334,174.0,80.42857142857143
4244.0,17,2,614,1,72,0.0,72.0,72.0,1,542,0.0,542.0,542.0
106310.0,17,2,700,2,700,0.0,350.0,350.0,0,0,0.0,0.0,0.0
120121750.0,6,12,1832,8,1016,17137019.42857143,188.0,127.0,4,816,30030160.33333333,204.0,204.0
143856.0,17,2,180,1,90,0.0,90.0,90.0,1,90,0.0,90.0,90.0
284023.0,17,2,363,1,79,0.0,79.0,79.0,1,284,0.0,284.0,284.0
29978.0,6,10,2032,5,524,6770.5,252.0,104.8,5,1508,6550.5,1236.0,301.6
90285086.0,6,16,1192,8,596,12891940.0,95.0,74.5,8,596,12897204.0,95.0,74.5
171887.0,17,2,180,1,90,0.0,90.0,90.0,1,90,0.0,90.0,90.0
153509.0,17,2,180,1,90,0.0,90.0,90.0,1,90,0.0,90.0,90.0
135130810.0,17,6,1206,6,1206,27026162.0,201.0,201.0,0,0,0.0,0.0,0.0
228177.0,17,2,180,1,90,0.0,90.0,90.0,1,90,0.0,90.0,90.0
100372810.0,17,12,516,6,258,20001145.4,43.0,43.0,6,258,20000160.4,43.0,43.0
2386.0,17,4,344,2,150,0.0,75.0,75.0,2,194,0.0,103.0,97.0
309.0,17,2,168,1,76,0.0,76.0,76.0,1,92,0.0,92.0,92.0
38568.0,6,14,4740,7,653,5960.5,249.0,93.28571428571428,7,4087,6239.833333333333,1514.0,583.8571428571429
90285011.0,6,21,1585,11,840,9024511.4,95.0,76.36363636363636,10,745,9999658.777777778,95.0,74.5
207477.0,6,3,426,2,280,0.0,214.0,140.0,1,146,0.0,146.0,146.0
41385.0,6,14,4740,7,653,6329.5,249.0,93.28571428571428,7,4087,6275.0,1514.0,583.8571428571429
10450336.0,6,7,478,4,272,3438011.6666666665,74.0,68.0,3,206,5156923.5,74.0,68.66666666666667
172290.0,17,2,180,1,90,0.0,90.0,90.0,1,90,0.0,90.0,90.0
213589.0,17,2,180,1,90,0.0,90.0,90.0,1,90,0.0,90.0,90.0
9275.0,17,2,498,1,80,0.0,80.0,80.0,1,418,0.0,418.0,418.0
2312.0,17,4,344,2,150,0.0,75.0,75.0,2,194,0.0,103.0,97.0
41633.0,6,12,1320,6,723,6230.6,253.0,120.5,6,597,7661.2,259.0,99.5
252310.0,6,10,1221,6,636,50462.0,298.0,106.0,4,585,78726.66666666667,379.0,146.25
18030750.0,17,8,943,4,306,6010143.333333333,89.0,76.5,4,637,6010133.0,245.0,159.25
2087133.0,6,25,7610,13,2516,173927.75,1034.0,193.53846153846155,12,5094,161424.18181818182,1510.0,424.5
66864.0,6,14,4740,7,653,10752.166666666666,249.0,93.28571428571428,7,4087,10958.5,1514.0,583.8571428571429
75307156.0,17,28,42392,28,42392,2789153.925925926,1514.0,1514.0,0,0,0.0,0.0,0.0
62696.0,6,10,2032,5,524,15275.5,252.0,104.8,5,1508,14660.25,1236.0,301.6
218057.0,6,3,426,2,280,0.0,214.0,140.0,1,146,0.0,146.0,146.0
90257724.0,6,14,1964,8,1016,12893960.57142857,188.0,127.0,6,948,18011792.6,204.0,158.0
778.0,17,4,438,2,148,0.0,74.0,74.0,2,290,0.0,147.0,145.0
49455.0,6,14,4740,7,653,7986.333333333333,249.0,93.28571428571428,7,4087,7960.666666666667,1514.0,583.8571428571429
146215.0,6,3,337,2,214,0.0,160.0,107.0,1,123,0.0,123.0,123.0
135117819.0,17,6,1146,6,1146,27023563.8,191.0,191.0,0,0,0.0,0.0,0.0
109754280.0,6,34,2466,17,1272,6859642.5,123.0,74.82352941176471,17,1194,6846125.8125,123.0,70.23529411764706
1476281.0,17,16,1120,16,1120,98418.73333333334,70.0,70.0,0,0,0.0,0.0,0.0
1152008.0,6,13,3010,8,2382,164572.57142857142,1514.0,297.75,5,628,219847.75,331.0,125.6
143820.0,17,2,180,1,90,0.0,90.0,90.0,1,90,0.0,90.0,90.0
3605.0,17,4,438,2,148,0.0,74.0,74.0,2,290,0.0,147.0,145.0
26891.0,6,14,4740,7,653,4353.333333333333,249.0,93.28571428571428,7,4087,4346.833333333333,1514.0,583.8571428571429
46790883.0,6,8,1940,3,887,21967984.5,753.0,295.6666666666667,5,1053,11260084.75,785.0,210.6
35456.0,6,13,1386,7,789,5471.833333333333,253.0,112.71428571428572,6,597,6561.2,259.0,99.5
37177.0,6,13,1479,7,882,5928.666666666667,291.0,126.0,6,597,6480.4,259.0,99.5
90016828.0,17,27,12943,27,12943,3462185.6923076925,501.0,479.3703703703704,0,0,0.0,0.0,0.0
103242.0,17,2,286,2,286,0.0,143.0,143.0,0,0,0.0,0.0,0.0
298812.0,6,6,412,4,272,99604.0,74.0,68.0,2,140,0.0,74.0,70.0
2008622.0,17,4,525,2,150,0.0,75.0,75.0,2,375,0.0,284.0,187.5
50956.0,17,2,180,1,90,0.0,90.0,90.0,1,90,0.0,90.0,90.0
126008156.0,17,15,907,8,475,18001165.14285714,174.0,59.375,7,432,17579307.666666668,174.0,61.71428571428572
21399.0,17,2,582,1,83,0.0,83.0,83.0,1,499,0.0,499.0,499.0
108000875.0,17,14,864,7,432,18000145.833333332,174.0,61.71428571428572,7,432,17834050.666666668,174.0,61.71428571428572
9041.0,17,2,539,1,86,0.0,86.0,86.0,1,453,0.0,453.0,453.0
35765.0,17,2,582,1,83,0.0,83.0,83.0,1,499,0.0,499.0,499.0
120124791.0,6,15,2428,9,1204,15015598.875,188.0,133.77777777777777,6,1224,18018586.8,204.0,204.0
10460102.0,6,7,478,4,272,3441370.0,74.0,68.0,3,206,5161924.5,74.0,68.66666666666667
215690.0,6,10,1221,6,636,43138.0,298.0,106.0,4,585,69984.66666666667,379.0,146.25
303311.0,6,6,412,4,272,101103.66666666669,74.0,68.0,2,140,0.0,74.0,70.0
2098968.0,6,19,6869,11,1567,209896.8,408.0,142.45454545454547,8,5302,237596.14285714287,1514.0,662.75
321077.0,17,4,1400,4,1400,107025.66666666669,350.0,350.0,0,0,0.0,0.0,0.0
121917.0,6,3,337,2,214,0.0,160.0,107.0,1,123,0.0,123.0,123.0
2396.0,17,4,344,2,150,0.0,75.0,75.0,2,194,0.0,103.0,97.0
120178099.0,6,23,1775,11,840,11999707.2,95.0,76.36363636363636,12,935,10909094.727272728,95.0,77.91666666666667
519.0,17,2,762,2,762,0.0,381.0,381.0,0,0,0.0,0.0,0.0
355.0,17,2,166,1,75,0.0,75.0,75.0,1,91,0.0,91.0,91.0
252133.0,6,3,426,2,280,0.0,214.0,140.0,1,146,0.0,146.0,146.0
103451.0,17,2,286,2,286,0.0,143.0,143.0,0,0,0.0,0.0,0.0
199300.0,17,2,180,1,90,0.0,90.0,90.0,1,90,0.0,90.0,90.0
90258680.0,6,13,2036,8,1016,12894097.142857144,188.0,127.0,5,1020,22523372.75,204.0,204.0
120086730.0,17,28,13364,28,13364,4447656.666666667,501.0,477.2857142857143,0,0,0.0,0.0,0.0
94876545.0,6,189,21318,95,6492,1009324.9468085108,140.0,68.33684210526316,94,14826,1008938.2688172044,300.0,157.72340425531914
104707.0,17,2,286,2,286,0.0,143.0,143.0,0,0,0.0,0.0,0.0
90064562.0,17,28,13364,28,13364,3335724.5185185187,501.0,477.2857142857143,0,0,0.0,0.0,0.0
119420681.0,6,213,23918,107,7358,1126610.1981132077,140.0,68.76635514018692,106,16560,1128429.4,284.0,156.2264150943396
146134.0,6,3,337,2,214,0.0,160.0,107.0,1,123,0.0,123.0,123.0
228520.0,17,2,180,1,90,0.0,90.0,90.0,1,90,0.0,90.0,90.0
143914.0,17,2,180,1,90,0.0,90.0,90.0,1,90,0.0,90.0,90.0
246654.0,6,3,337,2,214,0.0,160.0,107.0,1,123,0.0,123.0,123.0
216418.0,17,2,180,1,90,0.0,90.0,90.0,1,90,0.0,90.0,90.0
38112.0,6,14,4740,7,653,5536.833333333333,249.0,93.28571428571428,7,4087,6136.833333333333,1514.0,583.8571428571429
2311.0,17,4,344,2,150,0.0,75.0,75.0,2,194,0.0,103.0,97.0
90652697.0,6,15,2302,9,1204,11316898.5,188.0,133.77777777777777,6,1098,18098036.8,204.0,183.0
39244.0,6,10,2032,5,524,9587.75,252.0,104.8,5,1508,9236.75,1236.0,301.6
313.0,17,2,156,1,78,0.0,78.0,78.0,1,78,0.0,78.0,78.0
146190.0,6,3,337,2,214,0.0,160.0,107.0,1,123,0.0,123.0,123.0
317.0,17,2,160,1,80,0.0,80.0,80.0,1,80,0.0,80.0,80.0
90923101.0,6,21,1585,11,840,9091830.2,95.0,76.36363636363636,10,745,10101948.666666666,95.0,74.5
103148.0,17,2,762,2,762,0.0,381.0,381.0,0,0,0.0,0.0,0.0
136498.0,6,13,1394,7,797,22749.666666666668,253.0,113.85714285714286,6,597,26013.8,259.0,99.5
123711985.0,6,49,3234,25,1650,5154666.041666667,66.0,66.0,24,1584,5087843.260869565,66.0,66.0
2790460.0,6,2,132,1,66,0.0,66.0,66.0,1,66,0.0,66.0,66.0
123839971.0,6,49,3234,25,1650,5159998.791666667,66.0,66.0,24,1584,5070509.347826087,66.0,66.0
33084.0,6,10,2032,5,524,8066.75,252.0,104.8,5,1508,7337.5,1236.0,301.6
1156993.0,6,13,3011,8,2383,165284.7142857143,1514.0,297.875,5,628,221101.75,331.0,125.6
10471930.0,6,7,478,4,272,3443328.6666666665,74.0,68.0,3,206,5164883.0,74.0,68.66666666666667
731491.0,6,5,367,2,132,0.0,66.0,66.0,3,235,365745.5,103.0,78.33333333333333
38597589.0,6,26,7627,14,3735,199389.7692307692,1514.0,266.7857142857143,12,3892,3489276.5454545454,1514.0,324.3333333333333
4302.0,17,2,598,1,72,0.0,72.0,72.0,1,526,0.0,526.0,526.0
97433425.0,6,25,1686,13,840,8119452.083333333,123.0,64.61538461538461,12,846,7931329.181818182,123.0,70.5
117425540.0,6,203,22936,102,7028,1162629.108910891,140.0,68.90196078431373,101,15908,1163844.65,284.0,157.5049504950495
312.0,17,2,174,1,79,0.0,79.0,79.0,1,95,0.0,95.0,95.0
248468.0,6,3,426,2,280,0.0,214.0,140.0,1,146,0.0,146.0,146.0
2421.0,17,2,762,2,762,0.0,381.0,381.0,0,0,0.0,0.0,0.0
205770.0,6,3,426,2,280,0.0,214.0,140.0,1,146,0.0,146.0,146.0
298952.0,6,6,412,4,272,99650.66666666669,74.0,68.0,2,140,0.0,74.0,70.0
120233.0,17,2,180,1,70,0.0,70.0,70.0,1,110,0.0,110.0,110.0
504353.00000000006,6,4,270,2,134,0.0,68.0,67.0,2,136,0.0,70.0,68.0
412.0,17,2,508,2,508,0.0,257.0,254.0,0,0,0.0,0.0,0.0
102500.0,17,2,286,2,286,0.0,143.0,143.0,0,0,0.0,0.0,0.0
100906.0,17,2,286,2,286,0.0,143.0,143.0,0,0,0.0,0.0,0.0
371524.0,17,2,363,1,75,0.0,75.0,75.0,1,288,0.0,288.0,288.0
250009.0,17,4,6056,4,6056,83336.33333333333,1514.0,1514.0,0,0,0.0,0.0,0.0
302306.0,6,6,412,4,272,100768.66666666669,74.0,68.0,2,140,0.0,74.0,70.0
142071.0,6,2,132,1,66,0.0,66.0,66.0,1,66,0.0,66.0,66.0
93008028.0,17,11,735,6,389,18601605.6,174.0,64.83333333333333,5,346,19868441.0,174.0,69.2
107165.0,17,2,286,2,286,0.0,143.0,143.0,0,0,0.0,0.0,0.0
108243.0,17,2,286,2,286,0.0,143.0,143.0,0,0,0.0,0.0,0.0
90312709.0,6,16,1192,8,596,12894596.142857144,95.0,74.5,8,596,12900450.142857144,95.0,74.5
2900951.0,6,11,2106,6,598,579919.2,252.0,99.66666666666669,5,1508,3091.75,1236.0,301.6
14896.0,6,14,4740,7,653,2326.0,249.0,93.28571428571428,7,4087,2347.1666666666665,1514.0,583.8571428571429
439054.0,6,11,1021,6,444,59147.4,162.0,74.0,5,577,73632.75,349.0,115.4
108105755.0,17,5,955,5,955,27026438.75,191.0,191.0,0,0,0.0,0.0,0.0
73392.0,6,14,4740,7,653,12085.833333333334,249.0,93.28571428571428,7,4087,10992.166666666666,1514.0,583.8571428571429
205907.0,17,2,180,1,90,0.0,90.0,90.0,1,90,0.0,90.0,90.0
392778.0,6,3,1604,1,753,0.0,753.0,753.0,2,851,0.0,785.0,425.5
381285.0,6,12,1373,7,714,63547.5,298.0,102.0,5,659,94340.5,379.0,131.8
120002769.0,6,23,1734,12,935,10909090.0,95.0,77.91666666666667,11,799,11999666.4,95.0,72.63636363636364
90064698.0,17,28,13364,28,13364,3335729.5555555555,501.0,477.2857142857143,0,0,0.0,0.0,0.0
12606.0,6,11,1132,6,556,2521.2,218.0,92.66666666666669,5,576,2341.0,304.0,115.2
2806784.0,6,2,132,1,66,0.0,66.0,66.0,1,66,0.0,66.0,66.0
1172816.0,6,13,3000,8,2372,167545.14285714287,1514.0,296.5,5,628,225070.25,331.0,125.6
29661.0,6,10,2032,5,524,7175.5,252.0,104.8,5,1508,5563.0,1236.0,301.6
299492.0,6,6,412,4,272,99830.66666666669,74.0,68.0,2,140,0.0,74.0,70.0
401.0,17,2,410,1,78,0.0,78.0,78.0,1,332,0.0,332.0,332.0
118036055.0,6,30,1974,15,1026,8415732.357142856,123.0,68.4,15,948,8415731.07142857,123.0,63.2
824.0,17,4,438,2,148,0.0,74.0,74.0,2,290,0.0,147.0,145.0
220233.0,6,10,1221,6,636,44046.6,298.0,106.0,4,585,72551.66666666667,379.0,146.25
1388.0,17,2,762,2,762,0.0,381.0,381.0,0,0,0.0,0.0,0.0
51012.0,6,12,1320,7,789,8502.0,253.0,112.71428571428572,5,531,10247.5,259.0,106.2
135136346.0,17,6,1206,6,1206,27027269.2,201.0,201.0,0,0,0.0,0.0,0.0
108071550.0,6,31,2182,16,1165,7190379.733333333,139.0,72.8125,15,1017,7703976.214285715,123.0,67.8
228265.0,17,2,180,1,90,0.0,90.0,90.0,1,90,0.0,90.0,90.0
209433.0,17,2,180,1,90,0.0,90.0,90.0,1,90,0.0,90.0,90.0
148510.0,6,3,337,2,214,0.0,160.0,107.0,1,123,0.0,123.0,123.0
209446.0,17,2,180,1,90,0.0,90.0,90.0,1,90,0.0,90.0,90.0
103186977.0,6,30,2122,15,1105,7370498.357142857,139.0,73.66666666666667,15,1017,7355051.428571428,123.0,67.8
308845.0,6,6,412,4,272,102948.33333333331,74.0,68.0,2,140,0.0,74.0,70.0
101889293.0,6,30,2106,15,1089,7263159.142857143,123.0,72.6,15,1017,7263160.428571428,123.0,67.8
4599049.0,6,4,270,2,134,0.0,68.0,67.0,2,136,0.0,70.0,68.0
28140.0,6,10,2032,5,524,5901.25,252.0,104.8,5,1508,6789.0,1236.0,301.6
2806090.0,6,2,132,1,66,0.0,66.0,66.0,1,66,0.0,66.0,66.0
100380685.0,17,12,778,6,389,20076137.0,174.0,64.83333333333333,6,389,19993541.8,174.0,64.83333333333333
304832.0,6,6,412,4,272,101610.66666666669,74.0,68.0,2,140,0.0,74.0,70.0
34159128.0,6,7,1874,3,887,17003551.5,753.0,295.6666666666667,4,987,11341065.0,785.0,246.75
502565.00000000006,6,5,336,2,134,0.0,68.0,67.0,3,202,194356.0,70.0,67.33333333333333
298731.0,6,6,412,4,272,99577.0,74.0,68.0,2,140,0.0,74.0,70.0
106292.0,17,2,700,2,700,0.0,350.0,350.0,0,0,0.0,0.0,0.0
296775.0,17,2,252,1,79,0.0,79.0,79.0,1,173,0.0,173.0,173.0
323.0,17,2,208,1,72,0.0,72.0,72.0,1,136,0.0,136.0,136.0
32195.0,6,14,4740,7,653,4799.833333333333,249.0,93.28571428571428,7,4087,5196.0,1514.0,583.8571428571429
193269.0,17,2,762,2,762,0.0,381.0,381.0,0,0,0.0,0.0,0.0
10499731.0,6,7,478,4,272,3454255.333333333,74.0,68.0,3,206,5181480.0,74.0,68.66666666666667
105566.0,17,2,286,2,286,0.0,143.0,143.0,0,0,0.0,0.0,0.0
111048831.0,6,32,2236,16,1165,7388854.933333334,139.0,72.8125,16,1071,7388854.066666666,123.0,66.9375
6052.0,17,4,344,2,150,0.0,75.0,75.0,2,194,0.0,103.0,97.0
108109126.0,17,5,1005,5,1005,27027281.5,201.0,201.0,0,0,0.0,0.0,0.0
300.0,17,2,164,1,82,0.0,82.0,82.0,1,82,0.0,82.0,82.0
134598.0,17,4,1400,4,1400,44866.0,350.0,350.0,0,0,0.0,0.0,0.0
4038.0,17,4,344,2,150,0.0,75.0,75.0,2,194,0.0,103.0,97.0
33971.0,6,14,4740,7,653,5541.166666666667,249.0,93.28571428571428,7,4087,5461.0,1514.0,583.8571428571429
24657.0,6,10,2032,5,524,5944.75,252.0,104.8,5,1508,5507.25,1236.0,301.6
108108186.0,17,5,955,5,955,27027046.5,191.0,191.0,0,0,0.0,0.0,0.0
20615.0,6,10,1065,5,534,4763.5,262.0,106.8,5,531,3834.5,259.0,106.2
199676.0,6,12,1373,7,714,33279.333333333336,298.0,102.0,5,659,48942.0,379.0,131.8
308805.0,17,4,704,2,148,0.0,74.0,74.0,2,556,0.0,280.0,278.0
39281.0,6,14,4740,7,653,6198.166666666667,249.0,93.28571428571428,7,4087,6401.833333333333,1514.0,583.8571428571429
204308.0,17,2,762,2,762,0.0,381.0,381.0,0,0,0.0,0.0,0.0
2040.0,17,4,344,2,150,0.0,75.0,75.0,2,194,0.0,103.0,97.0
1165462.0,6,13,3010,8,2382,166494.57142857142,1514.0,297.75,5,628,223184.25,331.0,125.6
112929.0,17,2,286,2,286,0.0,143.0,143.0,0,0,0.0,0.0,0.0
16564.0,6,11,1132,6,556,3242.4,218.0,92.66666666666669,5,576,3953.25,304.0,115.2
165031.0,17,2,414,1,88,0.0,88.0,88.0,1,326,0.0,326.0,326.0
365964.0,17,4,704,2,148,0.0,74.0,74.0,2,556,0.0,280.0,278.0
23260.0,6,14,4740,7,653,3728.8333333333335,249.0,93.28571428571428,7,4087,3699.3333333333335,1514.0,583.8571428571429
2327.0,17,4,344,2,150,0.0,75.0,75.0,2,194,0.0,103.0,97.0
110232131.0,6,197,22142,99,6830,1124817.663265306,140.0,68.98989898989899,98,15312,1125762.4845360825,284.0,156.24489795918367
2595884.0,6,2,132,1,66,0.0,66.0,66.0,1,66,0.0,66.0,66.0
45477.0,6,10,2032,5,524,11054.25,252.0,104.8,5,1508,9603.0,1236.0,301.6
26487.0,6,20,7606,11,978,2648.7,310.0,88.9090909090909,9,6628,3027.875,1514.0,736.4444444444445
111050617.0,6,30,1974,15,1026,7916768.571428572,123.0,68.4,15,948,7916769.142857143,123.0,63.2
116969780.0,6,48,3168,24,1584,5085642.608695652,66.0,66.0,24,1584,5073783.565217392,66.0,66.0
90315521.0,6,16,1192,8,596,12893826.714285716,95.0,74.5,8,596,12899580.0,95.0,74.5
147926.0,17,2,180,1,90,0.0,90.0,90.0,1,90,0.0,90.0,90.0
236994.0,6,3,373,2,238,0.0,172.0,119.0,1,135,0.0,135.0,135.0
45051.0,6,14,4740,7,653,7385.0,249.0,93.28571428571428,7,4087,6933.166666666667,1514.0,583.8571428571429
120269709.0,6,226,25406,113,7754,1066196.919642857,140.0,68.61946902654867,113,17652,1066292.0714285714,284.0,156.21238938053096
144344.0,6,2,132,1,66,0.0,66.0,66.0,1,66,0.0,66.0,66.0
206023.0,17,2,180,1,90,0.0,90.0,90.0,1,90,0.0,90.0,90.0
90032301.0,17,28,13364,28,13364,3334529.6666666665,501.0,477.2857142857143,0,0,0.0,0.0,0.0
503049.0,6,5,336,2,134,0.0,68.0,67.0,3,202,194608.0,70.0,67.33333333333333
23673365.0,6,5,1736,2,819,0.0,753.0,409.5,3,917,11765162.5,785.0,305.6666666666667
72694.0,6,14,4740,7,653,11997.166666666666,249.0,93.28571428571428,7,4087,11930.166666666666,1514.0,583.8571428571429
107396.0,17,2,286,2,286,0.0,143.0,143.0,0,0,0.0,0.0,0.0
153418.0,17,2,180,1,90,0.0,90.0,90.0,1,90,0.0,90.0,90.0
436337.0,6,2,132,1,66,0.0,66.0,66.0,1,66,0.0,66.0,66.0
376824.0,6,4,492,2,280,0.0,214.0,140.0,2,212,0.0,146.0,106.0
153484.0,17,2,180,1,90,0.0,90.0,90.0,1,90,0.0,90.0,90.0
2049052.0,17,6,1039,4,312,682888.3333333334,78.0,78.0,2,727,0.0,395.0,363.5
34296.0,6,14,4740,7,653,5595.166666666667,249.0,93.28571428571428,7,4087,5337.666666666667,1514.0,583.8571428571429
104083380.0,6,44,2904,22,1452,4956351.428571428,66.0,66.0,22,1452,4941611.476190476,66.0,66.0
297921.0,6,6,412,4,272,99307.0,74.0,68.0,2,140,0.0,74.0,70.0
145149.0,17,2,180,1,90,0.0,90.0,90.0,1,90,0.0,90.0,90.0
5625351.0,6,5,336,2,134,0.0,68.0,67.0,3,202,1527202.0,70.0,67.33333333333333
90049932.0,17,28,13364,28,13364,3335182.6666666665,501.0,477.2857142857143,0,0,0.0,0.0,0.0
388285.0,17,4,1524,4,1524,129428.33333333331,381.0,381.0,0,0,0.0,0.0,0.0
171818.0,17,2,1500,1,994,0.0,994.0,994.0,1,506,0.0,506.0,506.0
26515.0,6,10,1065,5,534,6099.0,262.0,106.8,5,531,6019.0,259.0,106.2
9601.0,17,2,582,1,83,0.0,83.0,83.0,1,499,0.0,499.0,499.0
2921396.0,6,156,123690,85,115159,31124.89285714286,1510.0,1354.8117647058823,71,8531,37348.485714285714,1510.0,120.15492957746478
317371.0,6,6,412,4,272,105790.33333333331,74.0,68.0,2,140,0.0,74.0,70.0
304371.0,6,6,412,4,272,101457.0,74.0,68.0,2,140,0.0,74.0,70.0
33895.0,6,14,4740,7,653,5478.666666666667,249.0,93.28571428571428,7,4087,5514.333333333333,1514.0,583.8571428571429
246310.0,6,3,337,2,214,0.0,160.0,107.0,1,123,0.0,123.0,123.0
104850.0,17,2,700,2,700,0.0,350.0,350.0,0,0,0.0,0.0,0.0
205754.0,6,10,1221,6,636,41150.8,298.0,106.0,4,585,67201.33333333333,379.0,146.25
33245.0,6,14,4740,7,653,5353.166666666667,249.0,93.28571428571428,7,4087,4652.833333333333,1514.0,583.8571428571429
147312.0,6,3,373,2,238,0.0,172.0,119.0,1,135,0.0,135.0,135.0
9166.0,17,2,498,1,80,0.0,80.0,80.0,1,418,0.0,418.0,418.0
121376.0,6,3,337,2,214,0.0,160.0,107.0,1,123,0.0,123.0,123.0
135120010.0,17,6,1146,6,1146,27024002.0,191.0,191.0,0,0,0.0,0.0,0.0
45455.0,6,14,4740,7,653,6401.5,249.0,93.28571428571428,7,4087,7318.833333333333,1514.0,583.8571428571429
44851.0,6,2,132,1,66,0.0,66.0,66.0,1,66,0.0,66.0,66.0
206033.0,6,3,426,2,280,0.0,214.0,140.0,1,146,0.0,146.0,146.0
42520.0,6,14,4740,7,653,6179.5,249.0,93.28571428571428,7,4087,6956.0,1514.0,583.8571428571429
1528732.0,6,4,276,2,128,0.0,74.0,64.0,2,148,0.0,74.0,74.0
228235.0,17,2,180,1,90,0.0,90.0,90.0,1,90,0.0,90.0,90.0
100868934.0,6,66,15424,35,7558,2960376.088235294,1514.0,215.94285714285715,31,7866,3355095.833333333,1514.0,253.7419354838709
203960.0,17,2,762,2,762,0.0,381.0,381.0,0,0,0.0,0.0,0.0
105829.0,17,2,700,2,700,0.0,350.0,350.0,0,0,0.0,0.0,0.0
236481.0,6,3,337,2,214,0.0,160.0,107.0,1,123,0.0,123.0,123.0
120401246.0,6,247,27926,124,19512,978871.918699187,284.0,157.3548387096774,123,8414,969981.2459016392,140.0,68.40650406504065
5625679.0,6,5,336,2,134,0.0,68.0,67.0,3,202,1528351.0,70.0,67.33333333333333
42596.0,6,10,2032,5,524,10088.5,252.0,104.8,5,1508,10402.75,1236.0,301.6
16268.999999999998,6,2,145,2,145,0.0,91.0,72.5,0,0,0.0,0.0,0.0
46524.0,6,14,4740,7,653,7630.333333333333,249.0,93.28571428571428,7,4087,7256.166666666667,1514.0,583.8571428571429
246094.0,6,3,337,2,214,0.0,160.0,107.0,1,123,0.0,123.0,123.0
101272314.0,17,12,516,6,258,20001937.0,43.0,43.0,6,258,20000153.8,43.0,43.0
135130299.0,17,6,1206,6,1206,27026059.8,201.0,201.0,0,0,0.0,0.0,0.0
206979.0,17,2,762,2,762,0.0,381.0,381.0,0,0,0.0,0.0,0.0
107092.0,17,2,286,2,286,0.0,143.0,143.0,0,0,0.0,0.0,0.0
232007.0,6,3,337,2,214,0.0,160.0,107.0,1,123,0.0,123.0,123.0
310.0,17,2,156,1,78,0.0,78.0,78.0,1,78,0.0,78.0,78.0
1309204.0,6,4,264,2,132,0.0,66.0,66.0,2,132,0.0,66.0,66.0
276557.0,6,12,1373,7,714,46092.833333333336,298.0,102.0,5,659,64795.5,379.0,131.8
31371.000000000004,6,14,4740,7,653,5106.166666666667,249.0,93.28571428571428,7,4087,4742.166666666667,1514.0,583.8571428571429
626654.0,17,5,961,3,234,313056.0,78.0,78.0,2,727,0.0,395.0,363.5
119547392.0,17,35,16705,35,16705,3516099.7647058824,501.0,477.2857142857143,0,0,0.0,0.0,0.0
206580.0,6,3,426,2,280,0.0,214.0,140.0,1,146,0.0,146.0,146.0
1397.0,17,5,550,5,550,349.25,110.0,110.0,0,0,0.0,0.0,0.0
9463.0,17,4,823,2,163,0.0,89.0,81.5,2,660,0.0,443.0,330.0
291996.0,17,2,180,1,90,0.0,90.0,90.0,1,90,0.0,90.0,90.0
143954.0,17,2,180,1,90,0.0,90.0,90.0,1,90,0.0,90.0,90.0
2364.0,17,4,344,2,150,0.0,75.0,75.0,2,194,0.0,103.0,97.0
122314679.0,6,48,3168,24,1584,5147253.826086956,66.0,66.0,24,1584,5060504.260869565,66.0,66.0
1301480.0,6,4,264,2,132,0.0,66.0,66.0,2,132,0.0,66.0,66.0
2470496.0,6,3,1604,1,753,0.0,753.0,753.0,2,851,0.0,785.0,425.5
120051472.0,6,24,1829,13,989,9999335.5,95.0,76.07692307692308,11,840,11981270.7,95.0,76.36363636363636
10509444.0,6,7,478,4,272,3457968.0,74.0,68.0,3,206,5186874.5,74.0,68.66666666666667
310.0,17,2,174,1,79,0.0,79.0,79.0,1,95,0.0,95.0,95.0
36988.0,6,14,4740,7,653,4816.5,249.0,93.28571428571428,7,4087,6028.0,1514.0,583.8571428571429
122975237.0,6,48,3168,24,1584,5213264.0,66.0,66.0,24,1584,5053815.913043479,66.0,66.0
207179.0,6,3,426,2,280,0.0,214.0,140.0,1,146,0.0,146.0,146.0
3175914.0,6,18,1495,9,921,358474.875,315.0,102.33333333333331,9,574,358445.875,78.0,63.77777777777778
0.0,17,1,90,1,90,0.0,90.0,90.0,0,0,0.0,0.0,0.0
305278.0,6,6,412,4,272,101759.33333333331,74.0,68.0,2,140,0.0,74.0,70.0
9536.0,17,2,539,1,86,0.0,86.0,86.0,1,453,0.0,453.0,453.0
1302494.0,6,4,264,2,132,0.0,66.0,66.0,2,132,0.0,66.0,66.0
1180324.0,6,13,3010,8,2382,168617.7142857143,1514.0,297.75,5,628,226208.25,331.0,125.6
304496.0,6,34,18616,18,1335,17911.529411764706,205.0,74.16666666666667,16,17281,19694.066666666666,1514.0,1080.0625
115732698.0,6,48,3168,24,1584,5031856.434782608,66.0,66.0,24,1584,5019872.695652174,66.0,66.0
108101384.0,17,5,955,5,955,27025346.0,191.0,191.0,0,0,0.0,0.0,0.0
113520404.0,6,46,3036,23,1518,5160002.409090909,66.0,66.0,23,1518,5160007.227272728,66.0,66.0
120091802.0,6,218,24534,109,7490,1104389.4537037036,140.0,68.71559633027523,109,17044,1105499.1851851852,284.0,156.36697247706422
91663424.0,6,23,1775,13,1030,7633479.5,95.0,79.23076923076923,10,745,10153914.777777778,95.0,74.5
90085377.0,6,12,1848,5,1020,22520456.0,204.0,204.0,7,828,15013835.666666666,188.0,118.28571428571428
415.0,17,2,174,1,79,0.0,79.0,79.0,1,95,0.0,95.0,95.0
309553.0,6,6,412,4,272,103184.33333333331,74.0,68.0,2,140,0.0,74.0,70.0
305625.0,6,6,412,4,272,101875.0,74.0,68.0,2,140,0.0,74.0,70.0
113609490.0,6,46,3036,23,1518,5150435.954545454,66.0,66.0,23,1518,5150437.045454546,66.0,66.0
114773816.0,6,213,24062,107,7284,1082771.849056604,140.0,68.07476635514018,106,16778,1083292.419047619,284.0,158.28301886792454
90061176.0,17,27,12943,27,12943,3463891.3846153845,501.0,479.3703703703704,0,0,0.0,0.0,0.0
1924214.0,6,18,6803,10,1501,213801.5555555556,408.0,150.1,8,5302,225714.2857142857,1514.0,662.75
95298.0,6,14,4740,7,653,15753.666666666666,249.0,93.28571428571428,7,4087,14288.833333333334,1514.0,583.8571428571429
43062.0,6,10,2032,5,524,10533.75,252.0,104.8,5,1508,9656.0,1236.0,301.6
1758432.0,6,22,6443,12,1529,159857.45454545456,357.0,127.41666666666669,10,4914,160196.0,1510.0,491.4
120123056.0,6,16,2632,9,1204,15015382.0,188.0,133.77777777777777,7,1428,15015500.166666666,204.0,204.0
2532665.0,6,30,9358,17,3897,158291.5625,1514.0,229.23529411764707,13,5461,189514.5833333333,1514.0,420.0769230769231
12353.0,6,10,1067,5,536,2134.5,264.0,107.2,5,531,2856.0,259.0,106.2
108104644.0,17,5,1005,5,1005,27026161.0,201.0,201.0,0,0,0.0,0.0,0.0
121424.0,6,3,337,2,214,0.0,160.0,107.0,1,123,0.0,123.0,123.0
312418.0,6,3,202,2,128,0.0,74.0,64.0,1,74,0.0,74.0,74.0
90512371.0,6,14,2240,8,1016,12930338.714285716,188.0,127.0,6,1224,18069656.4,204.0,204.0
9230.0,17,2,582,1,83,0.0,83.0,83.0,1,499,0.0,499.0,499.0
2798619.0,6,2,132,1,66,0.0,66.0,66.0,1,66,0.0,66.0,66.0
25249.0,17,2,582,1,83,0.0,83.0,83.0,1,499,0.0,499.0,499.0
90033729.0,17,28,13364,28,13364,3334582.5555555555,501.0,477.2857142857143,0,0,0.0,0.0,0.0
159191.0,6,3,337,2,214,0.0,160.0,107.0,1,123,0.0,123.0,123.0
466.0,17,2,762,2,762,0.0,381.0,381.0,0,0,0.0,0.0,0.0
5617225.0,6,5,336,2,134,0.0,68.0,67.0,3,202,1473344.5,70.0,67.33333333333333
34150.0,6,14,4740,7,653,5569.166666666667,249.0,93.28571428571428,7,4087,5383.666666666667,1514.0,583.8571428571429
114033931.0,6,48,3168,24,1584,4957997.0,66.0,66.0,24,1584,4944539.782608695,66.0,66.0
37740.0,6,14,4740,7,653,5746.0,249.0,93.28571428571428,7,4087,6153.333333333333,1514.0,583.8571428571429
36314.0,6,14,4740,7,653,5309.333333333333,249.0,93.28571428571428,7,4087,5469.333333333333,1514.0,583.8571428571429
153166.0,17,2,414,1,88,0.0,88.0,88.0,1,326,0.0,326.0,326.0
307125.0,6,6,412,4,272,102375.0,74.0,68.0,2,140,0.0,74.0,70.0
110969692.0,6,30,1974,15,1026,7911001.357142857,123.0,68.4,15,948,7910999.928571428,123.0,63.2
135129508.0,17,6,1146,6,1146,27025901.6,191.0,191.0,0,0,0.0,0.0,0.0
30205.0,6,14,4740,7,653,4298.333333333333,249.0,93.28571428571428,7,4087,4851.166666666667,1514.0,583.8571428571429
24755.0,6,14,4740,7,653,3496.5,249.0,93.28571428571428,7,4087,3983.0,1514.0,583.8571428571429
117542642.0,6,271,31114,135,21768,875578.2537313433,284.0,161.24444444444444,136,9346,869092.3333333334,140.0,68.72058823529412
3061888.0,6,29,8908,16,3694,204125.86666666667,1034.0,230.875,13,5214,227958.16666666663,1510.0,401.0769230769231
3902.0,17,4,344,2,150,0.0,75.0,75.0,2,194,0.0,103.0,97.0
108943.0,17,2,286,2,286,0.0,143.0,143.0,0,0,0.0,0.0,0.0
490483.0,6,5,336,2,134,0.0,68.0,67.0,3,202,194490.5,70.0,67.33333333333333
2411.0,17,2,762,2,762,0.0,381.0,381.0,0,0,0.0,0.0,0.0
313953.0,6,6,412,4,272,104651.0,74.0,68.0,2,140,0.0,74.0,70.0
38416.0,6,14,4740,7,653,4552.666666666667,249.0,93.28571428571428,7,4087,5838.0,1514.0,583.8571428571429
90383013.0,6,16,1192,8,596,12905132.57142857,95.0,74.5,8,596,12910701.0,95.0,74.5
115460784.0,6,34,2482,17,1288,7202799.5625,139.0,75.76470588235294,17,1194,7202795.4375,123.0,70.23529411764706
108215101.0,17,14,864,7,432,18003007.166666668,174.0,61.71428571428572,7,432,18000157.166666668,174.0,61.71428571428572
62905.0,17,3,1143,3,1143,31452.5,381.0,381.0,0,0,0.0,0.0,0.0
113440236.0,6,46,3036,23,1518,5156362.454545454,66.0,66.0,23,1518,5156362.954545454,66.0,66.0
162882.0,6,3,337,2,214,0.0,160.0,107.0,1,123,0.0,123.0,123.0
14632031.0,6,20,1607,10,975,1592637.888888889,315.0,97.5,10,632,1592603.4444444445,78.0,63.2
90017484.0,17,28,13364,28,13364,3333980.888888889,501.0,477.2857142857143,0,0,0.0,0.0,0.0
120464578.0,6,23,1775,13,1030,10038714.833333334,95.0,79.23076923076923,10,745,10102909.666666666,95.0,74.5
162246.0,17,2,180,1,90,0.0,90.0,90.0,1,90,0.0,90.0,90.0
42471.0,6,14,4740,7,653,6895.0,249.0,93.28571428571428,7,4087,6795.0,1514.0,583.8571428571429
874044.0,6,11,2643,7,742,145674.0,338.0,106.0,4,1901,199462.0,1514.0,475.25
50855.0,17,2,180,1,90,0.0,90.0,90.0,1,90,0.0,90.0,90.0
18462.0,6,11,2098,6,590,3112.0,252.0,98.33333333333331,5,1508,4325.75,1236.0,301.6
115133252.0,17,14,864,7,432,19168386.0,174.0,61.71428571428572,7,432,19166827.666666668,174.0,61.71428571428572
3170674.0,6,18,1495,9,921,358132.5,315.0,102.33333333333331,9,574,358103.375,78.0,63.77777777777778
135132968.0,17,6,1146,6,1146,27026593.6,191.0,191.0,0,0,0.0,0.0,0.0
2799432.0,6,2,132,1,66,0.0,66.0,66.0,1,66,0.0,66.0,66.0
505.0,17,2,508,2,508,0.0,257.0,254.0,0,0,0.0,0.0,0.0
43614.0,6,10,2032,5,524,10546.25,252.0,104.8,5,1508,9858.0,1236.0,301.6
2797417.0,6,2,132,1,66,0.0,66.0,66.0,1,66,0.0,66.0,66.0
124256126.0,17,14,1126,7,563,17500161.833333332,174.0,80.42857142857143,7,563,17500608.5,174.0,80.42857142857143
206411.0,6,3,426,2,280,0.0,214.0,140.0,1,146,0.0,146.0,146.0
303.0,17,2,174,1,79,0.0,79.0,79.0,1,95,0.0,95.0,95.0
339.0,17,2,267,1,83,0.0,83.0,83.0,1,184,0.0,184.0,184.0
90001499.0,17,12,778,6,389,17998244.2,174.0,64.83333333333333,6,389,18000167.0,174.0,64.83333333333333
34245.0,6,10,2032,5,524,8235.25,252.0,104.8,5,1508,8007.0,1236.0,301.6
250316.0,17,8,12112,8,12112,35759.42857142857,1514.0,1514.0,0,0,0.0,0.0,0.0
104843572.0,6,194,21870,97,6624,1083533.2916666667,140.0,68.28865979381443,97,15246,1072890.6458333333,284.0,157.17525773195877
6928.0,17,2,571,1,86,0.0,86.0,86.0,1,485,0.0,485.0,485.0
90311329.0,6,28,2008,14,1045,6947025.307692308,139.0,74.64285714285714,14,963,6930401.0,123.0,68.78571428571429
3916.0,17,2,582,1,83,0.0,83.0,83.0,1,499,0.0,499.0,499.0
13560.0,17,4,344,2,150,0.0,75.0,75.0,2,194,0.0,103.0,97.0
135127218.0,17,6,1146,6,1146,27025443.6,191.0,191.0,0,0,0.0,0.0,0.0
36568.0,6,14,4740,7,653,5046.666666666667,249.0,93.28571428571428,7,4087,5704.833333333333,1514.0,583.8571428571429
108096215.0,17,5,1005,5,1005,27024053.75,201.0,201.0,0,0,0.0,0.0,0.0
40189.0,6,14,4740,7,653,6538.333333333333,249.0,93.28571428571428,7,4087,6309.833333333333,1514.0,583.8571428571429
23420.0,6,10,2032,5,524,5622.25,252.0,104.8,5,1508,5502.25,1236.0,301.6
108107320.0,17,5,1005,5,1005,27026830.0,201.0,201.0,0,0,0.0,0.0,0.0
240988.0,6,3,337,2,214,0.0,160.0,107.0,1,123,0.0,123.0,123.0
3107611.0,17,3,1026,3,1026,1553805.5,342.0,342.0,0,0,0.0,0.0,0.0
54637.0,6,10,2032,5,524,12941.75,252.0,104.8,5,1508,12815.0,1236.0,301.6
93388189.0,6,25,1686,13,840,7782349.083333333,123.0,64.61538461538461,12,846,7562412.181818182,123.0,70.5
306.0,17,2,174,1,79,0.0,79.0,79.0,1,95,0.0,95.0,95.0
103661373.0,6,44,2904,22,1452,4936255.857142857,66.0,66.0,22,1452,4921935.238095238,66.0,66.0
3236027.0,6,164,125797,89,116545,36773.03409090909,1510.0,1309.494382022472,75,9252,39070.63513513513,1510.0,123.36
0.0,6,1,66,0,0,0.0,0.0,0.0,1,66,0.0,66.0,66.0
0.0,6,1,172,1,172,0.0,172.0,172.0,0,0,0.0,0.0,0.0
111164410.0,6,215,24352,108,7424,1038919.7196261684,140.0,68.74074074074075,107,16928,1038886.358490566,374.0,158.20560747663552
94736480.0,6,18,1503,9,853,11836423.625,257.0,94.77777777777776,9,650,11841743.75,95.0,72.22222222222223
294933.0,17,4,6056,4,6056,98311.0,1514.0,1514.0,0,0,0.0,0.0,0.0
50862.0,6,14,4740,7,653,7889.0,249.0,93.28571428571428,7,4087,8181.333333333333,1514.0,583.8571428571429
134059.0,6,3,337,2,214,0.0,160.0,107.0,1,123,0.0,123.0,123.0
449028.0,6,3,204,2,136,0.0,70.0,68.0,1,68,0.0,68.0,68.0
545.0,17,2,508,2,508,0.0,257.0,254.0,0,0,0.0,0.0,0.0
34663.0,6,14,4740,7,653,5657.5,249.0,93.28571428571428,7,4087,5379.5,1514.0,583.8571428571429
249497.0,17,4,6056,4,6056,83165.66666666667,1514.0,1514.0,0,0,0.0,0.0,0.0
90258119.0,6,14,2240,8,1016,12894017.0,188.0,127.0,6,1224,18018893.8,204.0,204.0
108109228.0,17,5,1005,5,1005,27027307.0,201.0,201.0,0,0,0.0,0.0,0.0
24408.0,6,14,4740,7,653,3144.333333333333,249.0,93.28571428571428,7,4087,3753.0,1514.0,583.8571428571429
216474.0,6,3,426,2,280,0.0,214.0,140.0,1,146,0.0,146.0,146.0
10539662.0,6,7,478,4,272,3467871.0,74.0,68.0,3,206,5201716.0,74.0,68.66666666666667
146606.0,6,3,337,2,214,0.0,160.0,107.0,1,123,0.0,123.0,123.0
376706.0,6,3,204,2,136,0.0,70.0,68.0,1,68,0.0,68.0,68.0
284423.0,17,2,363,1,79,0.0,79.0,79.0,1,284,0.0,284.0,284.0
504647.0,6,5,336,2,134,0.0,68.0,67.0,3,202,193250.0,70.0,67.33333333333333
779.0,17,4,438,2,148,0.0,74.0,74.0,2,290,0.0,147.0,145.0
2399.0,17,4,344,2,150,0.0,75.0,75.0,2,194,0.0,103.0,97.0
121465.0,6,3,337,2,214,0.0,160.0,107.0,1,123,0.0,123.0,123.0
10477925.0,6,7,478,4,272,3447202.0,74.0,68.0,3,206,5170709.0,74.0,68.66666666666667
90259245.0,6,12,1832,8,1016,12894177.857142856,188.0,127.0,4,816,30028929.33333333,204.0,204.0
4591498.0,6,8,550,4,278,1530499.3333333333,78.0,69.5,4,272,505453.0,70.0,68.0
2796288.0,6,2,132,1,66,0.0,66.0,66.0,1,66,0.0,66.0,66.0
427756.0,6,4,508,2,238,0.0,172.0,119.0,2,270,0.0,135.0,135.0
62567.0,6,14,4740,7,653,9589.0,249.0,93.28571428571428,7,4087,10291.833333333334,1514.0,583.8571428571429
38459.0,6,14,4740,7,653,6264.333333333333,249.0,93.28571428571428,7,4087,5233.833333333333,1514.0,583.8571428571429
113168097.0,6,47,3102,24,1584,4920341.434782608,66.0,66.0,23,1518,5143992.7727272725,66.0,66.0
2590405.0,6,2,132,1,66,0.0,66.0,66.0,1,66,0.0,66.0,66.0
17070.0,6,10,1810,5,358,3923.25,130.0,71.6,5,1452,3887.0,1224.0,290.4
108103668.0,17,5,1005,5,1005,27025917.0,201.0,201.0,0,0,0.0,0.0,0.0
316374.0,6,3,202,2,128,0.0,74.0,64.0,1,74,0.0,74.0,74.0
205733.0,17,2,180,1,90,0.0,90.0,90.0,1,90,0.0,90.0,90.0
128608762.0,6,36,2596,18,1248,6977851.117647059,123.0,69.33333333333333,18,1348,7117601.529411765,139.0,74.88888888888889
108103941.0,17,5,1005,5,1005,27025985.25,201.0,201.0,0,0,0.0,0.0,0.0
103481425.0,6,44,2904,22,1452,4927686.904761905,66.0,66.0,22,1452,4914561.904761905,66.0,66.0
208743.0,6,3,426,2,280,0.0,214.0,140.0,1,146,0.0,146.0,146.0
108102825.0,17,5,955,5,955,27025706.25,191.0,191.0,0,0,0.0,0.0,0.0
16546.0,6,10,2032,5,524,3887.25,252.0,104.8,5,1508,3667.5,1236.0,301.6
599399.0,17,2,346,1,78,0.0,78.0,78.0,1,268,0.0,268.0,268.0
10508537.0,6,7,478,4,272,3457354.333333333,74.0,68.0,3,206,5185922.5,74.0,68.66666666666667
25545.0,6,10,2032,5,524,6161.0,252.0,104.8,5,1508,6108.25,1236.0,301.6
108113321.0,17,5,1005,5,1005,27028330.25,201.0,201.0,0,0,0.0,0.0,0.0
307913.0,6,6,412,4,272,102637.66666666669,74.0,68.0,2,140,0.0,74.0,70.0
44039.0,6,10,2032,5,524,10787.5,252.0,104.8,5,1508,10426.0,1236.0,301.6
90046507.0,17,27,12943,27,12943,3463327.1923076925,501.0,479.3703703703704,0,0,0.0,0.0,0.0
315016.0,6,3,202,2,128,0.0,74.0,64.0,1,74,0.0,74.0,74.0
146119.0,6,3,337,2,214,0.0,160.0,107.0,1,123,0.0,123.0,123.0
115284569.0,6,390,49958,195,13166,590600.0824742268,140.0,67.51794871794871,195,36792,594175.9432989691,300.0,188.6769230769231
298386.0,6,6,412,4,272,99462.0,74.0,68.0,2,140,0.0,74.0,70.0
2436.0,17,4,344,2,150,0.0,75.0,75.0,2,194,0.0,103.0,97.0
171820.0,17,2,180,1,90,0.0,90.0,90.0,1,90,0.0,90.0,90.0
280424.0,17,2,363,1,79,0.0,79.0,79.0,1,284,0.0,284.0,284.0
2457.0,17,4,344,2,150,0.0,75.0,75.0,2,194,0.0,103.0,97.0
622.0,17,2,762,2,762,0.0,381.0,381.0,0,0,0.0,0.0,0.0
313042.0,6,3,202,2,128,0.0,74.0,64.0,1,74,0.0,74.0,74.0
1310078.0,6,4,264,2,132,0.0,66.0,66.0,2,132,0.0,66.0,66.0
16831.0,17,2,180,1,90,0.0,90.0,90.0,1,90,0.0,90.0,90.0
102978.0,17,2,286,2,286,0.0,143.0,143.0,0,0,0.0,0.0,0.0
98785.0,17,2,762,2,762,0.0,381.0,381.0,0,0,0.0,0.0,0.0
1131800.0,6,20,6434,12,1921,102890.90909090907,620.0,160.08333333333334,8,4513,132914.14285714287,1514.0,564.125
1314237.0,6,4,264,2,132,0.0,66.0,66.0,2,132,0.0,66.0,66.0
90281303.0,6,16,1192,8,596,12890363.142857144,95.0,74.5,8,596,12895564.142857144,95.0,74.5
40598.0,6,14,4740,7,653,6228.5,249.0,93.28571428571428,7,4087,6613.333333333333,1514.0,583.8571428571429
205560.0,17,2,762,2,762,0.0,381.0,381.0,0,0,0.0,0.0,0.0
25855.0,6,10,2032,5,524,5311.75,252.0,104.8,5,1508,6064.75,1236.0,301.6
0.0,6,1,66,1,66,0.0,66.0,66.0,0,0,0.0,0.0,0.0
106045069.0,6,189,21376,95,14950,1128139.0319148935,284.0,157.3684210526316,94,6426,1130362.5913978494,140.0,68.36170212765957
149105.0,17,2,414,1,88,0.0,88.0,88.0,1,326,0.0,326.0,326.0
117051597.0,6,31,2166,16,1149,7789047.4,123.0,71.8125,15,1017,8345409.0,123.0,67.8
254386.0,6,3,337,2,214,0.0,160.0,107.0,1,123,0.0,123.0,123.0
300564.0,6,6,412,4,272,100188.0,74.0,68.0,2,140,0.0,74.0,70.0
120147390.0,6,254,28530,127,8604,946988.253968254,140.0,67.74803149606299,127,19926,947139.8571428572,284.0,156.8976377952756
90256306.0,6,16,2368,9,1204,11282038.25,188.0,133.77777777777777,7,1164,15015440.5,204.0,166.28571428571428
100438.0,17,2,762,2,762,0.0,381.0,381.0,0,0,0.0,0.0,0.0
40252.0,6,10,2032,5,524,9585.0,252.0,104.8,5,1508,9128.0,1236.0,301.6
2323.0,17,4,344,2,150,0.0,75.0,75.0,2,194,0.0,103.0,97.0
108104201.0,17,5,1005,5,1005,27026050.25,201.0,201.0,0,0,0.0,0.0,0.0
52769.0,6,10,2032,5,524,12928.5,252.0,104.8,5,1508,12009.75,1236.0,301.6
187737.0,17,2,180,1,90,0.0,90.0,90.0,1,90,0.0,90.0,90.0
2367.0,17,4,344,2,150,0.0,75.0,75.0,2,194,0.0,103.0,97.0
458372.0,6,6,758,3,410,215892.0,172.0,136.66666666666666,3,348,169303.0,135.0,116.0
236391.0,6,3,373,2,238,0.0,172.0,119.0,1,135,0.0,135.0,135.0
4147.0,17,2,598,1,72,0.0,72.0,72.0,1,526,0.0,526.0,526.0
33527.0,6,10,2032,5,524,8156.5,252.0,104.8,5,1508,7792.5,1236.0,301.6
2689617.0,6,49,23716,25,19785,112067.375,1514.0,791.4,24,3931,107475.78260869563,1514.0,163.79166666666666
90515936.0,6,14,2240,8,1016,12930848.0,188.0,127.0,6,1224,18070552.6,204.0,204.0
309260.0,6,6,412,4,272,103086.66666666669,74.0,68.0,2,140,0.0,74.0,70.0
108101488.0,17,5,1005,5,1005,27025372.0,201.0,201.0,0,0,0.0,0.0,0.0
242226.0,6,3,337,2,214,0.0,160.0,107.0,1,123,0.0,123.0,123.0
240291.0,6,11,1131,6,600,47903.8,262.0,100.0,5,531,3421.5,259.0,106.2
583401.0,6,4,508,2,238,0.0,172.0,119.0,2,270,0.0,135.0,135.0
16978.0,17,2,180,1,90,0.0,90.0,90.0,1,90,0.0,90.0,90.0
90301067.0,6,16,1192,8,596,12893332.714285716,95.0,74.5,8,596,12898616.57142857,95.0,74.5
90032699.0,17,28,13364,28,13364,3334544.407407407,501.0,477.2857142857143,0,0,0.0,0.0,0.0
117313391.0,6,32,2220,16,1149,7820892.733333333,123.0,71.8125,16,1071,7806474.666666667,123.0,66.9375
107961.0,17,2,286,2,286,0.0,143.0,143.0,0,0,0.0,0.0,0.0
320041.0,6,6,544,3,350,80424.0,210.0,116.66666666666669,3,194,80460.5,74.0,64.66666666666667
25071.0,6,10,2032,5,524,5867.5,252.0,104.8,5,1508,5994.0,1236.0,301.6
120760587.0,6,19,1477,9,732,15095073.375,95.0,81.33333333333333,10,745,13303279.666666666,95.0,74.5
190071.0,17,4,1524,4,1524,63357.0,381.0,381.0,0,0,0.0,0.0,0.0
299930.0,6,6,412,4,272,99976.66666666669,74.0,68.0,2,140,0.0,74.0,70.0
0.0,17,1,44,1,44,0.0,44.0,44.0,0,0,0.0,0.0,0.0
77898.0,17,3,1143,3,1143,38949.0,381.0,381.0,0,0,0.0,0.0,0.0
228276.0,17,2,180,1,90,0.0,90.0,90.0,1,90,0.0,90.0,90.0
137860.0,6,2,132,1,66,0.0,66.0,66.0,1,66,0.0,66.0,66.0
135139591.0,17,6,1206,6,1206,27027918.2,201.0,201.0,0,0,0.0,0.0,0.0
120030884.0,17,28,13364,28,13364,4445588.296296297,501.0,477.2857142857143,0,0,0.0,0.0,0.0
90289377.0,6,16,1192,8,596,12891867.285714284,95.0,74.5,8,596,12897848.42857143,95.0,74.5
90256434.0,6,16,2368,9,1204,11282054.25,188.0,133.77777777777777,7,1164,15015576.5,204.0,166.28571428571428
109830257.0,6,28,1860,14,966,8431887.384615384,123.0,69.0,14,894,8429256.461538462,123.0,63.85714285714285
123630663.0,6,49,3234,25,1650,5151277.625,66.0,66.0,24,1584,5041693.869565218,66.0,66.0
207174.0,6,3,426,2,280,0.0,214.0,140.0,1,146,0.0,146.0,146.0
320926.0,17,2,180,1,90,0.0,90.0,90.0,1,90,0.0,90.0,90.0
204776.0,17,2,762,2,762,0.0,381.0,381.0,0,0,0.0,0.0,0.0
270727.0,6,10,1221,6,636,54145.4,298.0,106.0,4,585,84379.66666666667,379.0,146.25
212165.0,6,12,1373,7,714,35360.833333333336,298.0,102.0,5,659,52376.5,379.0,131.8
1405491.0,17,7,490,7,490,234248.5,70.0,70.0,0,0,0.0,0.0,0.0
90773157.0,6,19,1436,10,745,10080727.777777778,95.0,74.5,9,691,11344885.0,95.0,76.77777777777777
90016064.0,17,28,13364,28,13364,3333928.296296296,501.0,477.2857142857143,0,0,0.0,0.0,0.0
1868.0,17,2,192,1,88,0.0,88.0,88.0,1,104,0.0,104.0,104.0
26914621.0,17,5,1710,5,1710,6728655.25,342.0,342.0,0,0,0.0,0.0,0.0
164948.0,17,4,1400,4,1400,54982.66666666666,350.0,350.0,0,0,0.0,0.0,0.0
143850.0,17,2,180,1,90,0.0,90.0,90.0,1,90,0.0,90.0,90.0
108114125.0,17,5,955,5,955,27028531.25,191.0,191.0,0,0,0.0,0.0,0.0
205865.0,17,2,180,1,90,0.0,90.0,90.0,1,90,0.0,90.0,90.0
135130116.0,17,6,1206,6,1206,27026023.2,201.0,201.0,0,0,0.0,0.0,0.0
2337.0,17,4,344,2,150,0.0,75.0,75.0,2,194,0.0,103.0,97.0
0.0,17,1,44,1,44,0.0,44.0,44.0,0,0,0.0,0.0,0.0
320514.0,17,4,1400,4,1400,106838.0,350.0,350.0,0,0,0.0,0.0,0.0
495027.0,6,5,336,2,134,0.0,68.0,67.0,3,202,192637.5,70.0,67.33333333333333
2312556.0,6,25,7573,14,3735,177888.92307692306,1514.0,266.7857142857143,11,3838,206622.5,1514.0,348.90909090909093
1034395.0,6,11,1134,6,558,206879.0,220.0,93.0,5,576,256430.25,304.0,115.2
205687.0,17,2,180,1,90,0.0,90.0,90.0,1,90,0.0,90.0,90.0
116001053.0,17,15,1169,8,606,16571579.0,174.0,75.75,7,563,16000374.666666666,174.0,80.42857142857143
18526.0,6,10,2032,5,524,3856.0,252.0,104.8,5,1508,3712.75,1236.0,301.6
2734684.0,6,25,7573,14,3735,210360.3076923077,1514.0,266.7857142857143,11,3838,247344.2,1514.0,348.90909090909093
59597.0,6,14,4740,7,653,9824.5,249.0,93.28571428571428,7,4087,9750.666666666666,1514.0,583.8571428571429
14603.0,17,4,344,2,150,0.0,75.0,75.0,2,194,0.0,103.0,97.0
14510.0,6,14,4740,7,653,2179.0,249.0,93.28571428571428,7,4087,2232.5,1514.0,583.8571428571429
96407838.0,6,183,20604,92,6294,1059426.7912087913,140.0,68.41304347826087,91,14310,1064713.2222222222,284.0,157.25274725274724
120623912.0,6,47,3102,23,1518,5152000.2727272725,66.0,66.0,24,1584,5244506.782608695,66.0,66.0
251196.0,6,3,373,2,238,0.0,172.0,119.0,1,135,0.0,135.0,135.0
325.0,17,2,160,1,80,0.0,80.0,80.0,1,80,0.0,80.0,80.0
52089.0,6,14,4740,7,653,8435.833333333334,249.0,93.28571428571428,7,4087,8272.0,1514.0,583.8571428571429
258680.00000000003,6,3,337,2,214,0.0,160.0,107.0,1,123,0.0,123.0,123.0
120185.0,17,2,180,1,70,0.0,70.0,70.0,1,110,0.0,110.0,110.0
1689728.0,6,20,7599,11,1469,168972.8,583.0,133.54545454545453,9,6130,179467.375,1484.0,681.1111111111111
0.0,17,1,44,1,44,0.0,44.0,44.0,0,0,0.0,0.0,0.0
2824565.0,6,3,1604,2,851,0.0,785.0,425.5,1,753,0.0,753.0,753.0
99717.0,6,12,1320,7,789,16619.5,253.0,112.71428571428572,5,531,22226.5,259.0,106.2
2579102.0,6,2,132,1,66,0.0,66.0,66.0,1,66,0.0,66.0,66.0
526308.0,6,3,204,1,68,0.0,68.0,68.0,2,136,0.0,70.0,68.0
120122149.0,6,12,1832,8,1016,17137157.14285714,188.0,127.0,4,816,30030832.0,204.0,204.0
206790.0,6,3,426,2,280,0.0,214.0,140.0,1,146,0.0,146.0,146.0
23513.0,6,10,2032,5,524,5014.25,252.0,104.8,5,1508,5169.25,1236.0,301.6
108104833.0,17,5,955,5,955,27026208.25,191.0,191.0,0,0,0.0,0.0,0.0
91700209.0,6,25,1924,14,1084,7050468.384615385,95.0,77.42857142857143,11,840,9141673.8,95.0,76.36363636363636
75480.0,6,14,4740,7,653,12460.333333333334,249.0,93.28571428571428,7,4087,12282.333333333334,1514.0,583.8571428571429
37787.0,6,14,4740,7,653,6126.5,249.0,93.28571428571428,7,4087,6080.5,1514.0,583.8571428571429
125001294.0,17,15,907,8,475,17857327.714285713,174.0,59.375,7,432,17501237.0,174.0,61.71428571428572
41123.0,6,14,4740,7,653,6622.833333333333,249.0,93.28571428571428,7,4087,5897.333333333333,1514.0,583.8571428571429
362.0,17,2,174,1,79,0.0,79.0,79.0,1,95,0.0,95.0,95.0
303671.0,6,2,132,1,66,0.0,66.0,66.0,1,66,0.0,66.0,66.0
302.0,17,2,156,1,78,0.0,78.0,78.0,1,78,0.0,78.0,78.0
108105665.0,17,5,955,5,955,27026416.25,191.0,191.0,0,0,0.0,0.0,0.0
110303268.0,6,32,2236,16,1165,7339145.266666667,139.0,72.8125,16,1071,7339170.6,123.0,66.9375
119364758.0,6,20,1490,11,840,11931589.8,95.0,76.36363636363636,9,650,14917311.0,95.0,72.22222222222223
439185.0,6,11,1021,6,444,59094.2,162.0,74.0,5,577,73677.5,349.0,115.4
22773.0,6,11,1133,6,602,4281.8,264.0,100.33333333333331,5,531,5091.25,259.0,106.2
153483.0,17,2,180,1,90,0.0,90.0,90.0,1,90,0.0,90.0,90.0
209555.0,17,2,180,1,90,0.0,90.0,90.0,1,90,0.0,90.0,90.0
90061499.0,17,28,13364,28,13364,3335611.074074074,501.0,477.2857142857143,0,0,0.0,0.0,0.0
48309.0,6,10,2032,5,524,11314.0,252.0,104.8,5,1508,8770.75,1236.0,301.6
841071.0,6,9,1118,6,586,168214.2,248.0,97.66666666666669,3,532,282630.0,392.0,177.33333333333334
19587.0,6,11,2098,6,590,3607.2,252.0,98.33333333333331,5,1508,4486.75,1236.0,301.6
153481.0,17,2,180,1,90,0.0,90.0,90.0,1,90,0.0,90.0,90.0
96799781.0,6,28,1992,14,1029,7429535.0,123.0,73.5,14,963,7429533.769230769,123.0,68.78571428571429
118493718.0,6,237,26710,119,8150,1004184.0508474576,140.0,68.4873949579832,118,18560,1003909.5128205128,284.0,157.28813559322035
329836.0,6,6,412,4,272,109945.33333333331,74.0,68.0,2,140,0.0,74.0,70.0
2338.0,17,4,344,2,150,0.0,75.0,75.0,2,194,0.0,103.0,97.0
20030.0,17,2,582,1,83,0.0,83.0,83.0,1,499,0.0,499.0,499.0
112148165.0,6,199,22492,100,6896,1132809.7474747477,140.0,68.96,99,15596,1133876.1734693877,284.0,157.53535353535352
305397.0,6,6,412,4,272,101799.0,74.0,68.0,2,140,0.0,74.0,70.0
135128268.0,17,6,1146,6,1146,27025653.6,191.0,191.0,0,0,0.0,0.0,0.0
351890.0,17,2,582,1,83,0.0,83.0,83.0,1,499,0.0,499.0,499.0
32681085.000000004,6,5,336,2,134,0.0,68.0,67.0,3,202,14950602.5,70.0,67.33333333333333
105915.0,17,2,700,2,700,0.0,350.0,350.0,0,0,0.0,0.0,0.0
108108380.0,17,5,955,5,955,27027095.0,191.0,191.0,0,0,0.0,0.0,0.0
29464.0,6,10,2032,5,524,6622.0,252.0,104.8,5,1508,6480.75,1236.0,301.6
209953.0,17,2,762,2,762,0.0,381.0,381.0,0,0,0.0,0.0,0.0
217781.0,6,3,426,2,280,0.0,214.0,140.0,1,146,0.0,146.0,146.0
123285372.0,6,31,2097,16,1149,8219024.8,123.0,71.8125,15,948,8241348.214285715,123.0,63.2
119439057.0,6,204,23092,102,16064,1180433.504950495,284.0,157.49019607843138,102,7028,1180433.4554455446,140.0,68.90196078431373
299898.0,6,6,412,4,272,99966.0,74.0,68.0,2,140,0.0,74.0,70.0
307111.0,6,6,412,4,272,102370.33333333331,74.0,68.0,2,140,0.0,74.0,70.0
22918.0,6,10,2032,5,524,4346.5,252.0,104.8,5,1508,5398.5,1236.0,301.6
10486923.0,6,7,478,4,272,3450062.6666666665,74.0,68.0,3,206,5174990.0,74.0,68.66666666666667
264.0,17,3,1050,3,1050,132.0,350.0,350.0,0,0,0.0,0.0,0.0
143925.0,17,2,180,1,90,0.0,90.0,90.0,1,90,0.0,90.0,90.0
228184.0,17,2,180,1,90,0.0,90.0,90.0,1,90,0.0,90.0,90.0
90357.0,17,2,762,2,762,0.0,381.0,381.0,0,0,0.0,0.0,0.0
108102338.0,17,5,955,5,955,27025584.5,191.0,191.0,0,0,0.0,0.0,0.0
2059.0,17,4,344,2,150,0.0,75.0,75.0,2,194,0.0,103.0,97.0
119001391.0,17,13,821,7,432,19833565.166666668,174.0,61.71428571428572,6,389,19802072.6,174.0,64.83333333333333
4804162.0,6,5,336,2,134,0.0,68.0,67.0,3,202,1525709.5,70.0,67.33333333333333
102849080.0,6,28,1876,14,982,7894866.230769231,139.0,70.14285714285714,14,894,7894867.461538462,123.0,63.85714285714285
10483305.0,6,7,478,4,272,3447190.6666666665,74.0,68.0,3,206,5170669.0,74.0,68.66666666666667
20824.0,6,10,2032,5,524,4838.5,252.0,104.8,5,1508,4623.5,1236.0,301.6
23298.0,6,14,4740,7,653,3311.0,249.0,93.28571428571428,7,4087,3477.0,1514.0,583.8571428571429
1308549.0,6,4,264,2,132,0.0,66.0,66.0,2,132,0.0,66.0,66.0
88149.0,6,2,132,1,66,0.0,66.0,66.0,1,66,0.0,66.0,66.0
38497.0,6,14,4740,7,653,6120.166666666667,249.0,93.28571428571428,7,4087,6103.833333333333,1514.0,583.8571428571429
321612.0,17,4,1400,4,1400,107204.0,350.0,350.0,0,0,0.0,0.0,0.0
2720606.0,6,24,6591,13,1603,226717.16666666663,357.0,123.3076923076923,11,4988,240364.8,1510.0,453.45454545454544
120086286.0,6,244,27564,122,8274,985724.9669421487,140.0,67.81967213114754,122,19290,985800.4545454546,284.0,158.11475409836066
105074949.0,17,15,5130,15,5130,7505353.5,342.0,342.0,0,0,0.0,0.0,0.0
90920908.0,6,247,29508,124,8406,739194.3739837399,140.0,67.79032258064517,123,21102,736814.8360655737,284.0,171.5609756097561
53868.0,6,14,4740,7,653,8470.833333333334,249.0,93.28571428571428,7,4087,8838.666666666666,1514.0,583.8571428571429
107837146.0,6,28,1860,14,966,8278545.692307692,123.0,69.0,14,894,8278448.846153846,123.0,63.85714285714285
134922.0,6,2,132,1,66,0.0,66.0,66.0,1,66,0.0,66.0,66.0
0.0,6,1,54,0,0,0.0,0.0,0.0,1,54,0.0,54.0,54.0
135140599.0,17,6,1146,6,1146,27028119.8,191.0,191.0,0,0,0.0,0.0,0.0
19295.0,6,14,4740,7,653,3105.1666666666665,249.0,93.28571428571428,7,4087,3078.1666666666665,1514.0,583.8571428571429
118787826.0,6,35,2542,18,1348,6974824.294117647,139.0,74.88888888888889,17,1194,7410748.125,123.0,70.23529411764706
205714.0,17,2,180,1,90,0.0,90.0,90.0,1,90,0.0,90.0,90.0
502842.0,6,5,336,2,134,0.0,68.0,67.0,3,202,188796.0,70.0,67.33333333333333
21821.0,6,10,2032,5,524,5240.5,252.0,104.8,5,1508,5158.75,1236.0,301.6
2413.0,17,4,344,2,150,0.0,75.0,75.0,2,194,0.0,103.0,97.0
5828406.0,6,4,270,2,134,0.0,68.0,67.0,2,136,0.0,70.0,68.0
10525587.0,6,7,478,4,272,3461884.0,74.0,68.0,3,206,5192724.0,74.0,68.66666666666667
17079.0,17,2,180,1,90,0.0,90.0,90.0,1,90,0.0,90.0,90.0
90209334.0,6,16,1192,8,596,12852745.42857143,95.0,74.5,8,596,12857800.142857144,95.0,74.5
300545.0,6,6,412,4,272,100181.66666666669,74.0,68.0,2,140,0.0,74.0,70.0
2077301.0,6,19,6869,11,1567,207730.1,408.0,142.45454545454547,8,5302,234897.0,1514.0,662.75
306982.0,6,6,412,4,272,102327.33333333331,74.0,68.0,2,140,0.0,74.0,70.0
135135075.0,17,6,1146,6,1146,27027015.0,191.0,191.0,0,0,0.0,0.0,0.0
1277.0,17,2,762,2,762,0.0,381.0,381.0,0,0,0.0,0.0,0.0
217737.0,6,3,426,2,280,0.0,214.0,140.0,1,146,0.0,146.0,146.0
63894.00000000001,6,14,4740,7,653,10468.166666666666,249.0,93.28571428571428,7,4087,9344.333333333334,1514.0,583.8571428571429
52344.0,6,14,4740,7,653,8277.833333333334,249.0,93.28571428571428,7,4087,8554.166666666666,1514.0,583.8571428571429
5617090.0,6,5,336,2,134,0.0,68.0,67.0,3,202,1523618.5,70.0,67.33333333333333
34745.0,6,10,2032,5,524,7767.25,252.0,104.8,5,1508,5274.0,1236.0,301.6
90293218.0,6,16,1192,8,596,12893163.714285716,95.0,74.5,8,596,12897722.857142856,95.0,74.5
214352.0,6,10,1221,6,636,42870.4,298.0,106.0,4,585,70212.66666666667,379.0,146.25
302384.0,6,2,132,1,66,0.0,66.0,66.0,1,66,0.0,66.0,66.0
4447.0,17,4,438,2,148,0.0,74.0,74.0,2,290,0.0,147.0,145.0
4449.0,17,2,180,1,90,0.0,90.0,90.0,1,90,0.0,90.0,90.0
299185.0,6,6,412,4,272,99728.33333333331,74.0,68.0,2,140,0.0,74.0,70.0
120122771.0,6,15,2428,9,1204,15015346.375,188.0,133.77777777777777,6,1224,18018367.8,204.0,204.0
6934.0,17,2,582,1,83,0.0,83.0,83.0,1,499,0.0,499.0,499.0
117282.0,17,2,286,2,286,0.0,143.0,143.0,0,0,0.0,0.0,0.0
307162.0,6,6,412,4,272,102387.33333333331,74.0,68.0,2,140,0.0,74.0,70.0
17420.0,6,10,2032,5,524,3696.5,252.0,104.8,5,1508,3896.75,1236.0,301.6
50295.0,6,14,4740,7,653,7832.166666666667,249.0,93.28571428571428,7,4087,7586.666666666667,1514.0,583.8571428571429
26331370.0,6,5,1909,2,892,0.0,826.0,446.0,3,1017,13095849.0,885.0,339.0
44128.0,6,14,4740,7,653,5215.666666666667,249.0,93.28571428571428,7,4087,7040.166666666667,1514.0,583.8571428571429
319143.0,17,6,2100,6,2100,63828.6,350.0,350.0,0,0,0.0,0.0,0.0
216371.0,17,2,180,1,90,0.0,90.0,90.0,1,90,0.0,90.0,90.0
4709.0,17,4,813,2,144,0.0,72.0,72.0,2,669,0.0,542.0,334.5
105332.0,17,2,700,2,700,0.0,350.0,350.0,0,0,0.0,0.0,0.0
2940037.0,6,12,2172,7,664,489404.1666666667,252.0,94.85714285714286,5,1508,2752.75,1236.0,301.6
107144195.0,6,207,23370,104,7098,1040234.9029126214,140.0,68.25,103,16272,1031158.6862745098,284.0,157.98058252427185
10325.0,17,4,823,2,163,0.0,89.0,81.5,2,660,0.0,443.0,330.0
119774862.0,6,292,33034,146,23176,824549.9034482759,284.0,158.73972602739727,146,9858,824549.7793103448,140.0,67.52054794520548
112355967.0,6,32,2236,16,1165,7475983.733333333,139.0,72.8125,16,1071,7475995.133333334,123.0,66.9375
146204.0,6,3,337,2,214,0.0,160.0,107.0,1,123,0.0,123.0,123.0
101086.0,17,2,286,2,286,0.0,143.0,143.0,0,0,0.0,0.0,0.0
43941.0,6,14,4740,7,653,7197.333333333333,249.0,93.28571428571428,7,4087,5861.166666666667,1514.0,583.8571428571429
119515361.0,6,212,23868,106,16576,1136191.8476190476,284.0,156.37735849056602,106,7292,1136191.2095238096,140.0,68.79245283018868
319.0,17,2,174,1,79,0.0,79.0,79.0,1,95,0.0,95.0,95.0
2267.0,17,4,344,2,150,0.0,75.0,75.0,2,194,0.0,103.0,97.0
120000099.0,6,27,2956,14,1506,9230776.846153846,426.0,107.57142857142856,13,1450,9914778.916666666,336.0,111.53846153846152
155592.0,6,3,337,2,214,0.0,160.0,107.0,1,123,0.0,123.0,123.0
249616.0,6,3,337,2,214,0.0,160.0,107.0,1,123,0.0,123.0,123.0
3781617.0,6,5,336,2,134,0.0,68.0,67.0,3,202,1525563.5,70.0,67.33333333333333
108106598.0,17,5,1005,5,1005,27026649.5,201.0,201.0,0,0,0.0,0.0,0.0
2096409.0,6,25,7065,13,2047,174700.75,575.0,157.46153846153845,12,5018,162072.45454545456,1510.0,418.1666666666667
124007190.0,17,15,907,8,475,17715312.85714286,174.0,59.375,7,432,17333493.5,174.0,61.71428571428572
211295.0,17,2,626,1,72,0.0,72.0,72.0,1,554,0.0,554.0,554.0
306.0,17,2,174,1,79,0.0,79.0,79.0,1,95,0.0,95.0,95.0
1213163.0,6,11,1134,6,558,242632.6,220.0,93.0,5,576,301551.5,304.0,115.2
17503.0,17,4,823,2,163,0.0,89.0,81.5,2,660,0.0,443.0,330.0
390915.0,6,3,1604,1,753,0.0,753.0,753.0,2,851,0.0,785.0,425.5
50472.0,6,14,4740,7,653,7952.666666666667,249.0,93.28571428571428,7,4087,7864.5,1514.0,583.8571428571429
111867757.0,6,32,2220,16,1149,7443471.733333333,123.0,71.8125,16,1071,7443471.666666667,123.0,66.9375
34732.0,6,14,4740,7,653,5554.333333333333,249.0,93.28571428571428,7,4087,5644.5,1514.0,583.8571428571429
2186952.0,6,2,132,1,66,0.0,66.0,66.0,1,66,0.0,66.0,66.0
120259246.0,6,235,26578,118,18560,1027856.8034188034,284.0,157.28813559322035,117,8018,1029042.3103448276,140.0,68.52991452991454
90336978.0,6,25,1702,13,840,7528081.5,123.0,64.61538461538461,12,862,7286119.727272727,139.0,71.83333333333333
23982281.0,17,5,1718,4,1368,639249.0,342.0,342.0,1,350,0.0,350.0,350.0
108105427.0,17,5,955,5,955,27026356.75,191.0,191.0,0,0,0.0,0.0,0.0
122154.0,6,3,337,2,214,0.0,160.0,107.0,1,123,0.0,123.0,123.0
246757.0,17,4,6056,4,6056,82252.33333333333,1514.0,1514.0,0,0,0.0,0.0,0.0
120084624.0,6,381,44706,191,12828,632024.3368421053,140.0,67.16230366492147,190,31878,629911.1957671958,284.0,167.77894736842106
305725.0,6,6,412,4,272,101908.33333333331,74.0,68.0,2,140,0.0,74.0,70.0
60520.0,6,14,4740,7,653,9390.666666666666,249.0,93.28571428571428,7,4087,9934.0,1514.0,583.8571428571429
5063.0,17,2,473,1,78,0.0,78.0,78.0,1,395,0.0,395.0,395.0
311376.0,17,4,1400,4,1400,103792.0,350.0,350.0,0,0,0.0,0.0,0.0
12853.0,6,11,1133,6,602,2252.0,264.0,100.33333333333331,5,531,2921.75,259.0,106.2
90022522.0,17,28,13364,28,13364,3334167.4814814813,501.0,477.2857142857143,0,0,0.0,0.0,0.0
135134843.0,17,6,1146,6,1146,27026968.6,191.0,191.0,0,0,0.0,0.0,0.0
17766.0,6,10,2032,5,524,3147.0,252.0,104.8,5,1508,4134.25,1236.0,301.6
10528704.0,6,7,478,4,272,3464234.6666666665,74.0,68.0,3,206,5196221.5,74.0,68.66666666666667
2354.0,17,4,344,2,150,0.0,75.0,75.0,2,194,0.0,103.0,97.0
54132.0,6,14,4740,7,653,7734.333333333333,249.0,93.28571428571428,7,4087,8729.333333333334,1514.0,583.8571428571429
303543.0,6,6,412,4,272,101181.0,74.0,68.0,2,140,0.0,74.0,70.0
165265.0,6,14,4740,7,653,27252.166666666668,249.0,93.28571428571428,7,4087,25791.33333333333,1514.0,583.8571428571429
35183.0,6,14,4740,7,653,5425.833333333333,249.0,93.28571428571428,7,4087,4968.666666666667,1514.0,583.8571428571429
123610498.0,6,49,3234,25,1650,5150437.416666667,66.0,66.0,24,1584,5090534.956521739,66.0,66.0
172101.0,17,2,180,1,90,0.0,90.0,90.0,1,90,0.0,90.0,90.0
196889.0,17,2,180,1,90,0.0,90.0,90.0,1,90,0.0,90.0,90.0
2346.0,17,4,344,2,150,0.0,75.0,75.0,2,194,0.0,103.0,97.0
1430049.0,17,16,1120,16,1120,95336.6,70.0,70.0,0,0,0.0,0.0,0.0
3566.0,17,4,571,2,148,0.0,74.0,74.0,2,423,0.0,280.0,211.5
144730.0,17,2,180,1,70,0.0,70.0,70.0,1,110,0.0,110.0,110.0
123610525.0,6,49,3234,25,1650,5150438.541666667,66.0,66.0,24,1584,5087990.695652174,66.0,66.0
244481.0,6,3,337,2,214,0.0,160.0,107.0,1,123,0.0,123.0,123.0
108974.0,17,2,700,2,700,0.0,350.0,350.0,0,0,0.0,0.0,0.0
205834.0,17,2,180,1,90,0.0,90.0,90.0,1,90,0.0,90.0,90.0
113168102.0,6,46,3036,23,1518,5143992.863636363,66.0,66.0,23,1518,5143982.954545454,66.0,66.0
103365.0,17,2,286,2,286,0.0,143.0,143.0,0,0,0.0,0.0,0.0
120105727.0,6,14,2224,9,1204,15013215.875,188.0,133.77777777777777,5,1020,22518744.75,204.0,204.0
108751055.0,6,32,2236,16,1165,7250070.333333333,139.0,72.8125,16,1071,7235636.266666667,123.0,66.9375
2024081.0,17,4,525,2,150,0.0,75.0,75.0,2,375,0.0,284.0,187.5
506.00000000000006,17,2,508,2,508,0.0,257.0,254.0,0,0,0.0,0.0,0.0
143952.0,17,2,180,1,90,0.0,90.0,90.0,1,90,0.0,90.0,90.0
375903.0,6,10,1221,6,636,75180.6,298.0,106.0,4,585,124107.66666666669,379.0,146.25
148832400.0,6,21,1585,10,745,13235093.111111112,95.0,74.5,11,840,14862691.3,95.0,76.36363636363636
508263.0,6,5,336,2,134,0.0,68.0,67.0,3,202,194609.0,70.0,67.33333333333333
20316.0,6,10,2032,5,524,4763.75,252.0,104.8,5,1508,4795.75,1236.0,301.6
94181030.0,6,39,2574,20,1320,4940674.578947368,66.0,66.0,19,1254,5151383.5,66.0,66.0
254718.0,6,3,337,2,214,0.0,160.0,107.0,1,123,0.0,123.0,123.0
59437.0,6,14,4740,7,653,9785.333333333334,249.0,93.28571428571428,7,4087,8360.166666666666,1514.0,583.8571428571429
2395.0,17,4,344,2,150,0.0,75.0,75.0,2,194,0.0,103.0,97.0
285322.0,17,2,363,1,79,0.0,79.0,79.0,1,284,0.0,284.0,284.0
22522.0,6,19,7540,11,978,2252.2,310.0,88.9090909090909,8,6562,2913.285714285714,1514.0,820.25
2919550.0,6,3,1604,1,753,0.0,753.0,753.0,2,851,0.0,785.0,425.5
196955.0,17,2,180,1,90,0.0,90.0,90.0,1,90,0.0,90.0,90.0
90051447.0,17,28,13364,28,13364,3335238.777777778,501.0,477.2857142857143,0,0,0.0,0.0,0.0
996736.0,6,13,1428,7,797,165496.33333333334,253.0,113.85714285714286,6,631,198725.8,293.0,105.16666666666669
45855.0,6,14,4740,7,653,7398.833333333333,249.0,93.28571428571428,7,4087,7337.0,1514.0,583.8571428571429
166677.0,17,4,704,2,148,0.0,74.0,74.0,2,556,0.0,280.0,278.0
108106474.0,17,5,955,5,955,27026618.5,191.0,191.0,0,0,0.0,0.0,0.0
452098.0,17,4,360,2,140,0.0,70.0,70.0,2,220,0.0,110.0,110.0
3073149.0,6,3,204,2,134,0.0,68.0,67.0,1,70,0.0,70.0,70.0
179045.0,17,2,363,1,75,0.0,75.0,75.0,1,288,0.0,288.0,288.0
200312.0,6,10,1221,6,636,40062.4,298.0,106.0,4,585,65623.33333333333,379.0,146.25
106861.0,17,2,286,2,286,0.0,143.0,143.0,0,0,0.0,0.0,0.0
440278.0,6,3,204,2,136,0.0,70.0,68.0,1,68,0.0,68.0,68.0
774.0,17,4,438,2,148,0.0,74.0,74.0,2,290,0.0,147.0,145.0
147933.0,17,2,180,1,90,0.0,90.0,90.0,1,90,0.0,90.0,90.0
2798697.0,6,2,132,1,66,0.0,66.0,66.0,1,66,0.0,66.0,66.0
108108223.0,17,5,1005,5,1005,27027055.75,201.0,201.0,0,0,0.0,0.0,0.0
5612282.0,6,5,336,2,134,0.0,68.0,67.0,3,202,1526788.5,70.0,67.33333333333333
114171103.0,6,32,2236,16,1165,7597009.266666667,139.0,72.8125,16,1071,7597004.533333333,123.0,66.9375
34667.0,6,14,4740,7,653,5378.833333333333,249.0,93.28571428571428,7,4087,5465.5,1514.0,583.8571428571429
18053.0,6,11,1132,6,556,3383.6,218.0,92.66666666666669,5,576,3631.25,304.0,115.2
11871.0,6,10,1067,5,536,2678.25,264.0,107.2,5,531,2560.25,259.0,106.2
444732.0,6,10,967,5,390,75070.25,162.0,78.0,5,577,75010.25,349.0,115.4
144908.0,17,2,180,1,70,0.0,70.0,70.0,1,110,0.0,110.0,110.0
106962.0,17,2,286,2,286,0.0,143.0,143.0,0,0,0.0,0.0,0.0
769.0,17,4,438,2,148,0.0,74.0,74.0,2,290,0.0,147.0,145.0
109974308.0,6,30,1990,15,1042,7839898.571428572,139.0,69.46666666666667,15,948,7839901.285714285,123.0,63.2
90254510.0,6,12,1832,8,1016,12893501.42857143,188.0,127.0,4,816,30026984.0,204.0,204.0
120065724.0,17,28,13364,28,13364,4446878.666666667,501.0,477.2857142857143,0,0,0.0,0.0,0.0
311747.0,6,6,412,4,272,103915.66666666669,74.0,68.0,2,140,0.0,74.0,70.0
320156.0,17,4,1400,4,1400,106718.66666666669,350.0,350.0,0,0,0.0,0.0,0.0
2413.0,17,4,344,2,150,0.0,75.0,75.0,2,194,0.0,103.0,97.0
90213135.0,6,16,1192,8,596,12852830.714285716,95.0,74.5,8,596,12858269.857142856,95.0,74.5
90060843.0,17,28,13364,28,13364,3335586.777777778,501.0,477.2857142857143,0,0,0.0,0.0,0.0
47763.0,6,14,4740,7,653,7297.333333333333,249.0,93.28571428571428,7,4087,7826.166666666667,1514.0,583.8571428571429
217732.0,6,3,426,2,280,0.0,214.0,140.0,1,146,0.0,146.0,146.0
207042.0,6,3,426,2,280,0.0,214.0,140.0,1,146,0.0,146.0,146.0
311636.0,17,4,1400,4,1400,103878.66666666669,350.0,350.0,0,0,0.0,0.0,0.0
108104291.0,17,5,955,5,955,27026072.75,191.0,191.0,0,0,0.0,0.0,0.0
298304.0,6,6,412,4,272,99434.66666666669,74.0,68.0,2,140,0.0,74.0,70.0
105165.0,6,10,2032,5,524,19888.75,252.0,104.8,5,1508,25931.25,1236.0,301.6
153412.0,17,2,180,1,90,0.0,90.0,90.0,1,90,0.0,90.0,90.0
311812.0,17,4,1400,4,1400,103937.33333333331,350.0,350.0,0,0,0.0,0.0,0.0
108112671.0,17,5,1005,5,1005,27028167.75,201.0,201.0,0,0,0.0,0.0,0.0
300720.0,6,6,412,4,272,100240.0,74.0,68.0,2,140,0.0,74.0,70.0
90039292.0,17,28,13364,28,13364,3334788.592592593,501.0,477.2857142857143,0,0,0.0,0.0,0.0
70180.0,6,10,2032,5,524,17186.0,252.0,104.8,5,1508,13618.5,1236.0,301.6
2386077.0,6,49,23728,25,19797,99419.875,1514.0,791.88,24,3931,94050.65217391304,1514.0,163.79166666666666
1324719.0,6,4,264,2,132,0.0,66.0,66.0,2,132,0.0,66.0,66.0
25164.0,6,11,1133,6,602,4532.4,264.0,100.33333333333331,5,531,4828.25,259.0,106.2
90714770.0,6,21,1626,12,894,8246797.272727272,95.0,74.5,9,732,11310286.75,95.0,81.33333333333333
120120815.0,6,16,2632,9,1204,15015101.875,188.0,133.77777777777777,7,1428,15060921.666666666,204.0,204.0
2417.0,17,4,344,2,150,0.0,75.0,75.0,2,194,0.0,103.0,97.0
90299698.0,6,16,1192,8,596,12893243.285714284,95.0,74.5,8,596,12898949.714285716,95.0,74.5
312458.0,6,3,202,2,128,0.0,74.0,64.0,1,74,0.0,74.0,74.0
10460985.0,6,7,478,4,272,3441636.6666666665,74.0,68.0,3,206,5162392.5,74.0,68.66666666666667
105075958.0,17,14,1126,7,563,17500121.333333332,174.0,80.42857142857143,7,563,17500627.333333332,174.0,80.42857142857143
344807.0,17,2,180,1,90,0.0,90.0,90.0,1,90,0.0,90.0,90.0
143977.0,17,2,180,1,90,0.0,90.0,90.0,1,90,0.0,90.0,90.0
228340.0,17,2,180,1,90,0.0,90.0,90.0,1,90,0.0,90.0,90.0
830823.0,6,9,1118,6,586,166164.6,248.0,97.66666666666669,3,532,279033.0,392.0,177.33333333333334
123456104.0,6,49,3234,25,1650,5144004.333333333,66.0,66.0,24,1584,5097131.608695652,66.0,66.0
1190449.0,6,13,3011,8,2383,170064.14285714287,1514.0,297.875,5,628,228803.75,331.0,125.6
92736322.0,6,38,2508,19,1254,5152002.833333333,66.0,66.0,19,1254,5152003.555555556,66.0,66.0
117313630.0,6,207,23268,104,7160,1138967.281553398,140.0,68.84615384615384,103,16108,1140184.803921569,284.0,156.38834951456312
120130201.0,6,14,2240,6,1224,24026040.2,204.0,204.0,8,1016,17136807.14285714,188.0,127.0
29746.0,6,14,4740,7,653,4799.666666666667,249.0,93.28571428571428,7,4087,4694.833333333333,1514.0,583.8571428571429
3361.0,17,2,762,2,762,0.0,381.0,381.0,0,0,0.0,0.0,0.0
869467.0,6,12,2710,7,743,144911.16666666666,339.0,106.14285714285714,5,1967,149267.25,1514.0,393.4
38293.0,6,10,2032,5,524,9257.75,252.0,104.8,5,1508,9236.25,1236.0,301.6
107170.0,17,2,286,2,286,0.0,143.0,143.0,0,0,0.0,0.0,0.0
221085.0,17,2,414,1,88,0.0,88.0,88.0,1,326,0.0,326.0,326.0
15761.0,6,11,2098,6,590,3152.2,252.0,98.33333333333331,5,1508,3267.75,1236.0,301.6
3577460.0,6,5,336,2,134,0.0,68.0,67.0,3,202,1422590.5,70.0,67.33333333333333
146093.0,6,3,337,2,214,0.0,160.0,107.0,1,123,0.0,123.0,123.0
82.0,17,2,762,2,762,0.0,381.0,381.0,0,0,0.0,0.0,0.0
46832.0,6,10,2032,5,524,9755.25,252.0,104.8,5,1508,10474.75,1236.0,301.6
112535659.0,6,46,3036,23,1518,5105444.5,66.0,66.0,23,1518,5105449.2727272725,66.0,66.0
99935747.0,17,12,778,6,389,19987149.4,174.0,64.83333333333333,6,389,19887694.6,174.0,64.83333333333333
333.0,17,2,166,1,75,0.0,75.0,75.0,1,91,0.0,91.0,91.0
2021.0,17,4,344,2,150,0.0,75.0,75.0,2,194,0.0,103.0,97.0
367.0,17,2,762,2,762,0.0,381.0,381.0,0,0,0.0,0.0,0.0
2370.0,17,4,344,2,150,0.0,75.0,75.0,2,194,0.0,103.0,97.0
302634.0,6,3,202,2,128,0.0,74.0,64.0,1,74,0.0,74.0,74.0
46111127.0,6,8,1307,8,1307,6587303.857142857,172.0,163.375,0,0,0.0,0.0,0.0
98672056.0,6,40,2640,20,1320,5193266.105263158,66.0,66.0,20,1320,5177022.263157895,66.0,66.0
206400.0,6,3,426,2,280,0.0,214.0,140.0,1,146,0.0,146.0,146.0
108105449.0,17,5,1005,5,1005,27026362.25,201.0,201.0,0,0,0.0,0.0,0.0
2481.0,17,4,344,2,150,0.0,75.0,75.0,2,194,0.0,103.0,97.0
41874.0,6,10,2032,5,524,10080.25,252.0,104.8,5,1508,10012.0,1236.0,301.6
0.0,6,1,66,1,66,0.0,66.0,66.0,0,0,0.0,0.0,0.0
218599.0,6,3,426,2,280,0.0,214.0,140.0,1,146,0.0,146.0,146.0
44337.0,6,14,4740,7,653,7189.5,249.0,93.28571428571428,7,4087,6348.666666666667,1514.0,583.8571428571429
233045.0,6,3,337,2,214,0.0,160.0,107.0,1,123,0.0,123.0,123.0
10475094.0,6,7,478,4,272,3444551.333333333,74.0,68.0,3,206,5166664.5,74.0,68.66666666666667
3615.0,17,2,762,2,762,0.0,381.0,381.0,0,0,0.0,0.0,0.0
90291307.0,6,16,1192,8,596,12892372.285714284,95.0,74.5,8,596,12898344.0,95.0,74.5
90218335.0,6,16,1192,8,596,12852184.57142857,95.0,74.5,8,596,12857444.57142857,95.0,74.5
153425.0,17,2,180,1,90,0.0,90.0,90.0,1,90,0.0,90.0,90.0
208394.0,6,10,1221,6,636,41678.8,298.0,106.0,4,585,67992.33333333333,379.0,146.25
300915.0,6,6,412,4,272,100305.0,74.0,68.0,2,140,0.0,74.0,70.0
305.0,17,2,174,1,79,0.0,79.0,79.0,1,95,0.0,95.0,95.0
